t_id, iteration_count, request_count, request_start_time, request_end_time, request_processing_time
0,120,1,-721657745,-721657744,1
0,400,2,-721643677,-721643655,22
0,401,3,-721643627,-721643605,22
0,402,4,-721643576,-721643554,22
0,403,5,-721643526,-721643504,22
0,404,6,-721643475,-721643456,19
0,404,7,-721643475,-721643453,22
0,405,8,-721643424,-721643404,20
0,405,9,-721643424,-721643402,22
0,406,10,-721643373,-721643351,22
0,407,11,-721643322,-721643300,22
0,408,12,-721643272,-721643256,16
0,408,13,-721643272,-721643250,22
0,409,14,-721643221,-721643204,17
0,409,15,-721643221,-721643199,22
0,411,16,-721643121,-721643101,20
0,412,17,-721643070,-721643055,15
0,413,18,-721643020,-721643005,15
0,415,19,-721642919,-721642900,19
0,416,20,-721642869,-721642856,13
0,417,21,-721642819,-721642806,13
0,419,22,-721642718,-721642701,17
0,420,23,-721642668,-721642657,11
0,421,24,-721642617,-721642605,12
0,423,25,-721642517,-721642502,15
0,424,26,-721642466,-721642456,10
0,425,27,-721642416,-721642406,10
0,427,28,-721642315,-721642301,14
0,428,29,-721642265,-721642257,8
0,429,30,-721642215,-721642206,9
0,431,31,-721642114,-721642101,13
0,432,32,-721642064,-721642057,7
0,433,33,-721642013,-721642005,8
0,435,34,-721641913,-721641902,11
0,436,35,-721641862,-721641856,6
0,437,36,-721641812,-721641806,6
0,439,37,-721641711,-721641702,9
0,440,38,-721641661,-721641658,3
0,441,39,-721641611,-721641606,5
0,443,40,-721641510,-721641502,8
0,444,41,-721641460,-721641458,2
0,445,42,-721641410,-721641406,4
0,447,43,-721641309,-721641301,8
0,448,44,-721641259,-721641258,1
0,449,45,-721641208,-721641205,3
0,451,46,-721641108,-721641102,6
0,451,47,-721641108,-721641058,50
0,453,48,-721641007,-721641006,1
0,455,49,-721640907,-721640901,6
0,455,50,-721640907,-721640857,50
0,457,51,-721640806,-721640806,0
0,459,52,-721640705,-721640702,3
0,459,53,-721640705,-721640657,48
0,460,54,-721640655,-721640606,49
0,463,55,-721640504,-721640502,2
0,463,56,-721640504,-721640458,46
0,464,57,-721640454,-721640406,48
0,467,58,-721640303,-721640301,2
0,467,59,-721640303,-721640258,45
0,468,60,-721640253,-721640206,47
0,471,61,-721640102,-721640102,0
0,471,62,-721640102,-721640058,44
0,472,63,-721640051,-721640005,46
0,474,64,-721639951,-721639901,50
0,475,65,-721639901,-721639858,43
0,476,66,-721639850,-721639805,45
0,478,67,-721639750,-721639702,48
0,479,68,-721639699,-721639657,42
0,480,69,-721639649,-721639606,43
0,482,70,-721639549,-721639502,47
0,483,71,-721639498,-721639457,41
0,484,72,-721639448,-721639406,42
0,486,73,-721639347,-721639301,46
0,487,74,-721639297,-721639257,40
0,488,75,-721639247,-721639206,41
0,490,76,-721639146,-721639101,45
0,491,77,-721639096,-721639057,39
0,492,78,-721639046,-721639006,40
0,494,79,-721638945,-721638901,44
0,495,80,-721638895,-721638857,38
0,496,81,-721638844,-721638805,39
0,498,82,-721638744,-721638703,41
0,499,83,-721638693,-721638657,36
0,500,84,-721638643,-721638606,37
0,502,85,-721638542,-721638502,40
0,503,86,-721638492,-721638458,34
0,504,87,-721638442,-721638406,36
0,506,88,-721638341,-721638302,39
0,507,89,-721638291,-721638257,34
0,508,90,-721638240,-721638205,35
0,510,91,-721638140,-721638102,38
0,511,92,-721638089,-721638057,32
0,512,93,-721638039,-721638005,34
0,514,94,-721637938,-721637901,37
0,515,95,-721637888,-721637858,30
0,516,96,-721637838,-721637805,33
0,518,97,-721637737,-721637702,35
0,519,98,-721637687,-721637658,29
0,520,99,-721637636,-721637604,32
0,522,100,-721637536,-721637502,34
0,523,101,-721637485,-721637457,28
0,524,102,-721637435,-721637404,31
0,526,103,-721637334,-721637301,33
0,527,104,-721637284,-721637258,26
0,528,105,-721637234,-721637204,30
0,530,106,-721637133,-721637101,32
0,531,107,-721637083,-721637058,25
0,532,108,-721637032,-721637003,29
0,534,109,-721636932,-721636902,30
0,535,110,-721636881,-721636857,24
0,536,111,-721636831,-721636804,27
0,538,112,-721636730,-721636702,28
0,539,113,-721636680,-721636658,22
0,540,114,-721636630,-721636604,26
0,542,115,-721636529,-721636503,26
0,543,116,-721636478,-721636457,21
0,544,117,-721636428,-721636404,24
0,546,118,-721636327,-721636301,26
0,547,119,-721636277,-721636258,19
0,548,120,-721636226,-721636203,23
0,550,121,-721636126,-721636102,24
0,551,122,-721636075,-721636057,18
0,552,123,-721636025,-721636004,21
0,554,124,-721635924,-721635901,23
0,555,125,-721635874,-721635857,17
0,556,126,-721635823,-721635805,18
0,558,127,-721635723,-721635703,20
0,559,128,-721635672,-721635658,14
0,560,129,-721635620,-721635604,16
0,562,130,-721635520,-721635503,17
0,563,131,-721635469,-721635457,12
0,564,132,-721635419,-721635405,14
0,566,133,-721635319,-721635301,18
0,567,134,-721635268,-721635257,11
0,568,135,-721635218,-721635205,13
0,570,136,-721635117,-721635101,16
0,571,137,-721635067,-721635057,10
0,572,138,-721635017,-721635005,12
0,574,139,-721634916,-721634901,15
0,575,140,-721634866,-721634857,9
0,576,141,-721634816,-721634806,10
0,578,142,-721634715,-721634702,13
0,579,143,-721634665,-721634658,7
0,580,144,-721634614,-721634605,9
0,582,145,-721634514,-721634502,12
0,583,146,-721634463,-721634458,5
0,584,147,-721634413,-721634405,8
0,586,148,-721634312,-721634301,11
0,587,149,-721634262,-721634258,4
0,588,150,-721634212,-721634205,7
0,590,151,-721634111,-721634102,9
0,591,152,-721634060,-721634057,3
0,592,153,-721634010,-721634005,5
0,594,154,-721633909,-721633901,8
0,595,155,-721633859,-721633858,1
0,596,156,-721633809,-721633806,3
0,598,157,-721633708,-721633702,6
0,598,158,-721633708,-721633658,50
0,600,159,-721633607,-721633605,2
0,602,160,-721633507,-721633503,4
0,602,161,-721633507,-721633458,49
0,604,162,-721633406,-721633406,0
0,606,163,-721633305,-721633301,4
0,606,164,-721633305,-721633257,48
0,607,165,-721633255,-721633206,49
0,610,166,-721633104,-721633101,3
0,610,167,-721633104,-721633058,46
0,611,168,-721633054,-721633006,48
0,614,169,-721632903,-721632901,2
0,614,170,-721632903,-721632858,45
0,615,171,-721632853,-721632806,47
0,618,172,-721632702,-721632702,0
0,618,173,-721632702,-721632658,44
0,619,174,-721632651,-721632605,46
0,621,175,-721632551,-721632501,50
0,622,176,-721632500,-721632457,43
0,623,177,-721632450,-721632405,45
0,625,178,-721632349,-721632301,48
0,626,179,-721632299,-721632258,41
0,627,180,-721632249,-721632205,44
0,629,181,-721632148,-721632101,47
0,630,182,-721632098,-721632058,40
0,631,183,-721632047,-721632004,43
0,633,184,-721631947,-721631901,46
0,634,185,-721631896,-721631857,39
0,635,186,-721631846,-721631804,42
0,637,187,-721631745,-721631702,43
0,638,188,-721631695,-721631658,37
0,639,189,-721631645,-721631604,41
0,641,190,-721631544,-721631502,42
0,642,191,-721631494,-721631458,36
0,643,192,-721631444,-721631403,41
0,645,193,-721631343,-721631302,41
0,646,194,-721631293,-721631257,36
0,647,195,-721631242,-721631203,39
0,649,196,-721631142,-721631102,40
0,650,197,-721631091,-721631057,34
0,651,198,-721631041,-721631004,37
0,653,199,-721630940,-721630901,39
0,654,200,-721630890,-721630857,33
0,655,201,-721630839,-721630803,36
0,657,202,-721630739,-721630703,36
0,658,203,-721630689,-721630657,32
0,659,204,-721630638,-721630603,35
0,661,205,-721630538,-721630503,35
0,662,206,-721630487,-721630457,30
0,663,207,-721630437,-721630403,34
0,665,208,-721630336,-721630301,35
0,666,209,-721630286,-721630258,28
0,667,210,-721630235,-721630202,33
0,669,211,-721630135,-721630102,33
0,670,212,-721630084,-721630057,27
0,671,213,-721630034,-721630003,31
0,673,214,-721629933,-721629901,32
0,674,215,-721629883,-721629858,25
0,675,216,-721629833,-721629803,30
0,677,217,-721629732,-721629702,30
0,678,218,-721629682,-721629658,24
0,679,219,-721629632,-721629602,30
0,681,220,-721629531,-721629502,29
0,682,221,-721629481,-721629458,23
0,683,222,-721629430,-721629403,27
0,685,223,-721629330,-721629301,29
0,686,224,-721629279,-721629256,23
0,687,225,-721629229,-721629203,26
0,689,226,-721629128,-721629101,27
0,690,227,-721629078,-721629056,22
0,691,228,-721629028,-721629003,25
0,693,229,-721628927,-721628901,26
0,694,230,-721628877,-721628856,21
0,695,231,-721628826,-721628802,24
0,697,232,-721628726,-721628703,23
0,698,233,-721628675,-721628656,19
0,699,234,-721628625,-721628603,22
0,701,235,-721628524,-721628502,22
0,702,236,-721628474,-721628456,18
0,703,237,-721628424,-721628402,22
0,705,238,-721628323,-721628301,22
0,706,239,-721628273,-721628256,17
0,707,240,-721628222,-721628202,20
0,709,241,-721628122,-721628100,22
0,710,242,-721628071,-721628055,16
0,711,243,-721628021,-721628002,19
0,713,244,-721627920,-721627900,20
0,714,245,-721627870,-721627855,15
0,715,246,-721627819,-721627802,17
0,717,247,-721627718,-721627701,17
0,718,248,-721627668,-721627656,12
0,719,249,-721627618,-721627601,17
0,721,250,-721627517,-721627501,16
0,722,251,-721627467,-721627455,12
0,723,252,-721627416,-721627402,14
0,725,253,-721627315,-721627301,14
0,726,254,-721627265,-721627256,9
0,727,255,-721627215,-721627202,13
0,729,256,-721627114,-721627101,13
0,730,257,-721627064,-721627056,8
0,731,258,-721627013,-721627001,12
0,733,259,-721626913,-721626902,11
0,734,260,-721626863,-721626856,7
0,735,261,-721626812,-721626802,10
0,737,262,-721626712,-721626703,9
0,738,263,-721626661,-721626656,5
0,739,264,-721626611,-721626602,9
0,741,265,-721626510,-721626502,8
0,742,266,-721626460,-721626456,4
0,743,267,-721626410,-721626402,8
0,745,268,-721626309,-721626301,8
0,746,269,-721626259,-721626256,3
0,747,270,-721626208,-721626201,7
0,749,271,-721626108,-721626101,7
0,750,272,-721626057,-721626055,2
0,751,273,-721626007,-721626002,5
0,753,274,-721625906,-721625900,6
0,754,275,-721625856,-721625855,1
0,755,276,-721625806,-721625802,4
0,757,277,-721625705,-721625701,4
0,757,278,-721625705,-721625655,50
0,759,279,-721625605,-721625602,3
0,761,280,-721625504,-721625501,3
0,761,281,-721625504,-721625455,49
0,763,282,-721625404,-721625402,2
0,765,283,-721625303,-721625301,2
0,765,284,-721625303,-721625255,48
0,767,285,-721625202,-721625201,1
0,769,286,-721625102,-721625102,0
0,769,287,-721625102,-721625055,47
0,770,288,-721625051,-721625002,49
0,772,289,-721624951,-721624901,50
0,773,290,-721624900,-721624854,46
0,774,291,-721624850,-721624802,48
0,776,292,-721624749,-721624702,47
0,777,293,-721624699,-721624655,44
0,778,294,-721624649,-721624601,48
0,780,295,-721624548,-721624503,45
0,781,296,-721624497,-721624454,43
0,782,297,-721624447,-721624402,45
0,784,298,-721624346,-721624301,45
0,785,299,-721624296,-721624255,41
0,786,300,-721624246,-721624202,44
0,788,301,-721624145,-721624101,44
0,789,302,-721624095,-721624055,40
0,790,303,-721624044,-721624001,43
0,792,304,-721623944,-721623900,44
0,793,305,-721623893,-721623854,39
0,794,306,-721623843,-721623801,42
0,796,307,-721623742,-721623701,41
0,797,308,-721623692,-721623655,37
0,798,309,-721623642,-721623601,41
0,800,310,-721623541,-721623501,40
0,801,311,-721623491,-721623455,36
0,802,312,-721623440,-721623400,40
0,805,313,-721623289,-721623254,35
0,806,314,-721623239,-721623200,39
0,809,315,-721623088,-721623054,34
0,810,316,-721623038,-721623000,38
0,813,317,-721622887,-721622854,33
0,814,318,-721622837,-721622800,37
0,817,319,-721622686,-721622655,31
0,818,320,-721622635,-721622599,36
0,821,321,-721622485,-721622454,31
0,822,322,-721622434,-721622399,35
0,825,323,-721622283,-721622255,28
0,826,324,-721622233,-721622200,33
0,829,325,-721622081,-721622054,27
0,830,326,-721622031,-721622000,31
0,833,327,-721621880,-721621854,26
0,834,328,-721621830,-721621800,30
0,837,329,-721621679,-721621656,23
0,838,330,-721621629,-721621600,29
0,841,331,-721621478,-721621456,22
0,845,332,-721621276,-721621255,21
0,846,333,-721621226,-721621200,26
0,849,334,-721621075,-721621056,19
0,850,335,-721621024,-721620999,25
0,853,336,-721620873,-721620856,17
0,854,337,-721620822,-721620800,22
0,857,338,-721620671,-721620657,14
0,858,339,-721620620,-721620599,21
0,861,340,-721620470,-721620456,14
0,862,341,-721620419,-721620399,20
0,865,342,-721620268,-721620257,11
0,866,343,-721620218,-721620199,19
0,869,344,-721620067,-721620056,11
0,870,345,-721620016,-721619998,18
0,873,346,-721619865,-721619856,9
0,874,347,-721619815,-721619800,15
0,877,348,-721619664,-721619658,6
0,878,349,-721619614,-721619600,14
0,881,350,-721619463,-721619458,5
0,882,351,-721619412,-721619399,13
0,885,352,-721619261,-721619257,4
0,886,353,-721619211,-721619200,11
0,889,354,-721619060,-721619058,2
0,890,355,-721619010,-721619000,10
0,893,356,-721618859,-721618858,1
0,894,357,-721618808,-721618800,8
0,897,358,-721618657,-721618657,0
0,898,359,-721618607,-721618600,7
0,900,360,-721618506,-721618457,49
0,902,361,-721618406,-721618400,6
0,904,362,-721618305,-721618257,48
0,906,363,-721618205,-721618200,5
0,908,364,-721618104,-721618057,47
0,910,365,-721618003,-721617999,4
0,912,366,-721617903,-721617857,46
0,914,367,-721617802,-721617800,2
0,916,368,-721617702,-721617657,45
0,918,369,-721617601,-721617600,1
0,920,370,-721617500,-721617457,43
0,922,371,-721617400,-721617400,0
0,924,372,-721617299,-721617258,41
0,925,373,-721617249,-721617200,49
0,928,374,-721617098,-721617057,41
0,932,375,-721616896,-721616858,38
0,933,376,-721616846,-721616798,48
0,936,377,-721616695,-721616658,37
0,937,378,-721616644,-721616598,46
0,940,379,-721616494,-721616457,37
0,941,380,-721616443,-721616398,45
0,944,381,-721616292,-721616257,35
0,945,382,-721616242,-721616198,44
0,948,383,-721616091,-721616057,34
0,949,384,-721616041,-721615998,43
0,952,385,-721615890,-721615857,33
0,953,386,-721615840,-721615797,43
0,956,387,-721615689,-721615658,31
0,957,388,-721615638,-721615597,41
0,960,389,-721615487,-721615457,30
0,961,390,-721615437,-721615398,39
0,964,391,-721615286,-721615257,29
0,965,392,-721615236,-721615198,38
0,968,393,-721615085,-721615056,29
0,969,394,-721615035,-721614997,38
0,972,395,-721614883,-721614857,26
0,973,396,-721614833,-721614798,35
0,976,397,-721614682,-721614658,24
0,977,398,-721614631,-721614597,34
0,980,399,-721614480,-721614457,23
0,981,400,-721614430,-721614398,32
0,984,401,-721614279,-721614258,21
0,985,402,-721614229,-721614198,31
0,988,403,-721614078,-721614058,20
0,989,404,-721614027,-721613997,30
0,992,405,-721613876,-721613857,19
0,993,406,-721613826,-721613798,28
0,996,407,-721613675,-721613657,18
0,997,408,-721613624,-721613597,27
0,1000,409,-721613473,-721613457,16
0,1001,410,-721613423,-721613397,26
0,1004,411,-721613272,-721613258,14
0,1005,412,-721613222,-721613197,25
0,1008,413,-721613071,-721613058,13
0,1009,414,-721613021,-721612997,24
0,1012,415,-721612870,-721612858,12
0,1013,416,-721612819,-721612797,22
0,1016,417,-721612667,-721612657,10
0,1017,418,-721612617,-721612598,19
0,1020,419,-721612466,-721612457,9
0,1021,420,-721612416,-721612398,18
0,1024,421,-721612265,-721612257,8
0,1025,422,-721612214,-721612197,17
0,1028,423,-721612064,-721612057,7
0,1029,424,-721612013,-721611998,15
0,1032,425,-721611862,-721611856,6
0,1033,426,-721611812,-721611799,13
0,1036,427,-721611661,-721611656,5
0,1037,428,-721611610,-721611598,12
0,1040,429,-721611459,-721611457,2
0,1041,430,-721611409,-721611399,10
0,1044,431,-721611258,-721611257,1
0,1045,432,-721611207,-721611198,9
0,1048,433,-721611056,-721611056,0
0,1051,434,-721610905,-721610856,49
0,1053,435,-721610805,-721610798,7
0,1055,436,-721610704,-721610658,46
0,1057,437,-721610603,-721610598,5
0,1059,438,-721610502,-721610457,45
0,1061,439,-721610401,-721610399,2
0,1063,440,-721610300,-721610257,43
0,1065,441,-721610199,-721610199,0
0,1067,442,-721610098,-721610056,42
0,1068,443,-721610048,-721609998,50
0,1071,444,-721609896,-721609855,41
0,1072,445,-721609846,-721609799,47
0,1075,446,-721609695,-721609656,39
0,1076,447,-721609645,-721609599,46
0,1079,448,-721609494,-721609456,38
0,1080,449,-721609444,-721609399,45
0,1083,450,-721609293,-721609256,37
0,1084,451,-721609242,-721609198,44
0,1087,452,-721609091,-721609055,36
0,1088,453,-721609041,-721608999,42
0,1091,454,-721608890,-721608856,34
0,1092,455,-721608840,-721608799,41
0,1095,456,-721608689,-721608657,32
0,1096,457,-721608638,-721608598,40
0,1099,458,-721608487,-721608457,30
0,1100,459,-721608436,-721608399,37
0,1103,460,-721608285,-721608257,28
0,1104,461,-721608235,-721608199,36
0,1107,462,-721608084,-721608057,27
0,1108,463,-721608033,-721607998,35
0,1111,464,-721607882,-721607857,25
0,1112,465,-721607832,-721607799,33
0,1115,466,-721607681,-721607658,23
0,1116,467,-721607631,-721607598,33
0,1119,468,-721607480,-721607457,23
0,1120,469,-721607429,-721607398,31
0,1123,470,-721607278,-721607257,21
0,1124,471,-721607228,-721607198,30
0,1127,472,-721607077,-721607057,20
0,1128,473,-721607026,-721606997,29
0,1131,474,-721606876,-721606857,19
0,1132,475,-721606825,-721606797,28
0,1135,476,-721606674,-721606657,17
0,1136,477,-721606624,-721606597,27
0,1139,478,-721606473,-721606457,16
0,1140,479,-721606422,-721606396,26
0,1143,480,-721606271,-721606257,14
0,1144,481,-721606221,-721606196,25
0,1147,482,-721606070,-721606057,13
0,1148,483,-721606020,-721605996,24
0,1151,484,-721605869,-721605857,12
0,1152,485,-721605818,-721605796,22
0,1155,486,-721605667,-721605657,10
0,1156,487,-721605617,-721605597,20
0,1159,488,-721605466,-721605458,8
0,1160,489,-721605416,-721605397,19
0,1163,490,-721605265,-721605258,7
0,1164,491,-721605214,-721605196,18
0,1167,492,-721605063,-721605057,6
0,1168,493,-721605013,-721604997,16
0,1171,494,-721604862,-721604858,4
0,1172,495,-721604812,-721604798,14
0,1175,496,-721604661,-721604658,3
0,1176,497,-721604610,-721604597,13
0,1179,498,-721604459,-721604457,2
0,1180,499,-721604409,-721604398,11
0,1183,500,-721604258,-721604258,0
0,1184,501,-721604208,-721604198,10
0,1186,502,-721604107,-721604058,49
0,1188,503,-721604006,-721603997,9
0,1190,504,-721603906,-721603858,48
0,1192,505,-721603805,-721603798,7
0,1194,506,-721603702,-721603658,44
0,1196,507,-721603601,-721603597,4
0,1198,508,-721603501,-721603458,43
0,1200,509,-721603400,-721603398,2
0,1202,510,-721603299,-721603257,42
0,1204,511,-721603199,-721603198,1
0,1206,512,-721603098,-721603058,40
0,1207,513,-721603048,-721602998,50
0,1210,514,-721602897,-721602858,39
0,1214,515,-721602695,-721602657,38
0,1215,516,-721602645,-721602598,47
0,1218,517,-721602493,-721602456,37
0,1219,518,-721602443,-721602398,45
0,1222,519,-721602292,-721602257,35
0,1223,520,-721602242,-721602198,44
0,1226,521,-721602090,-721602056,34
0,1226,522,-721602090,-721602050,40
0,1227,523,-721602040,-721601998,42
0,1230,524,-721601889,-721601850,39
0,1231,525,-721601839,-721601798,41
0,1234,526,-721601688,-721601658,30
0,1234,527,-721601688,-721601652,36
0,1235,528,-721601638,-721601598,40
0,1238,529,-721601487,-721601458,29
0,1238,530,-721601487,-721601452,35
0,1239,531,-721601436,-721601397,39
0,1242,532,-721601286,-721601257,29
0,1242,533,-721601286,-721601250,36
0,1243,534,-721601235,-721601197,38
0,1246,535,-721601084,-721601058,26
0,1246,536,-721601084,-721601051,33
0,1247,537,-721601034,-721600997,37
0,1250,538,-721600883,-721600858,25
0,1250,539,-721600883,-721600851,32
0,1251,540,-721600832,-721600796,36
0,1254,541,-721600681,-721600657,24
0,1254,542,-721600681,-721600651,30
0,1255,543,-721600631,-721600597,34
0,1258,544,-721600480,-721600457,23
0,1258,545,-721600480,-721600452,28
0,1259,546,-721600430,-721600397,33
0,1262,547,-721600279,-721600256,23
0,1262,548,-721600279,-721600251,28
0,1263,549,-721600228,-721600196,32
0,1266,550,-721600078,-721600056,22
0,1266,551,-721600078,-721600050,28
0,1267,552,-721600027,-721599996,31
0,1270,553,-721599876,-721599856,20
0,1270,554,-721599876,-721599850,26
0,1271,555,-721599826,-721599796,30
0,1274,556,-721599675,-721599657,18
0,1274,557,-721599675,-721599652,23
0,1275,558,-721599625,-721599595,30
0,1278,559,-721599474,-721599456,18
0,1278,560,-721599474,-721599452,22
0,1279,561,-721599423,-721599395,28
0,1282,562,-721599272,-721599250,22
0,1283,563,-721599222,-721599195,27
0,1286,564,-721599071,-721599057,14
0,1286,565,-721599071,-721599051,20
0,1287,566,-721599021,-721598995,26
0,1290,567,-721598870,-721598857,13
0,1290,568,-721598870,-721598851,19
0,1291,569,-721598819,-721598795,24
0,1294,570,-721598668,-721598657,11
0,1294,571,-721598668,-721598651,17
0,1295,572,-721598618,-721598596,22
0,1298,573,-721598467,-721598458,9
0,1298,574,-721598467,-721598452,15
0,1299,575,-721598417,-721598396,21
0,1301,576,-721598316,-721598301,15
0,1302,577,-721598266,-721598258,8
0,1302,578,-721598266,-721598251,15
0,1303,579,-721598216,-721598196,20
0,1305,580,-721598115,-721598101,14
0,1306,581,-721598065,-721598058,7
0,1306,582,-721598065,-721598051,14
0,1307,583,-721598014,-721597995,19
0,1309,584,-721597914,-721597902,12
0,1310,585,-721597864,-721597857,7
0,1311,586,-721597813,-721597796,17
0,1313,587,-721597713,-721597703,10
0,1314,588,-721597662,-721597658,4
0,1314,589,-721597662,-721597652,10
0,1315,590,-721597612,-721597596,16
0,1317,591,-721597510,-721597502,8
0,1318,592,-721597460,-721597458,2
0,1318,593,-721597460,-721597452,8
0,1319,594,-721597410,-721597396,14
0,1321,595,-721597309,-721597302,7
0,1322,596,-721597259,-721597257,2
0,1322,597,-721597259,-721597250,9
0,1323,598,-721597208,-721597195,13
0,1325,599,-721597107,-721597101,6
0,1325,600,-721597107,-721597058,49
0,1326,601,-721597057,-721597051,6
0,1327,602,-721597007,-721596995,12
0,1329,603,-721596906,-721596901,5
0,1329,604,-721596906,-721596858,48
0,1330,605,-721596856,-721596851,5
0,1331,606,-721596805,-721596794,11
0,1333,607,-721596705,-721596701,4
0,1333,608,-721596705,-721596657,48
0,1334,609,-721596654,-721596651,3
0,1335,610,-721596604,-721596595,9
0,1337,611,-721596503,-721596501,2
0,1337,612,-721596503,-721596457,46
0,1338,613,-721596453,-721596452,1
0,1339,614,-721596403,-721596395,8
0,1341,615,-721596302,-721596257,45
0,1342,616,-721596252,-721596251,1
0,1343,617,-721596202,-721596195,7
0,1344,618,-721596152,-721596101,51
0,1345,619,-721596101,-721596058,43
0,1345,620,-721596101,-721596051,50
0,1347,621,-721596000,-721595995,5
0,1348,622,-721595950,-721595902,48
0,1349,623,-721595899,-721595857,42
0,1349,624,-721595899,-721595850,49
0,1351,625,-721595799,-721595795,4
0,1352,626,-721595748,-721595702,46
0,1353,627,-721595698,-721595652,46
0,1356,628,-721595547,-721595502,45
0,1357,629,-721595497,-721595457,40
0,1357,630,-721595497,-721595452,45
0,1359,631,-721595396,-721595395,1
0,1360,632,-721595345,-721595301,44
0,1361,633,-721595295,-721595258,37
0,1361,634,-721595295,-721595251,44
0,1363,635,-721595195,-721595195,0
0,1364,636,-721595144,-721595101,43
0,1365,637,-721595094,-721595058,36
0,1365,638,-721595094,-721595051,43
0,1366,639,-721595044,-721594995,49
0,1368,640,-721594943,-721594901,42
0,1369,641,-721594893,-721594858,35
0,1369,642,-721594893,-721594851,42
0,1370,643,-721594842,-721594794,48
0,1372,644,-721594742,-721594701,41
0,1373,645,-721594691,-721594657,34
0,1374,646,-721594641,-721594595,46
0,1376,647,-721594540,-721594501,39
0,1377,648,-721594490,-721594458,32
0,1377,649,-721594490,-721594452,38
0,1378,650,-721594439,-721594394,45
0,1380,651,-721594339,-721594302,37
0,1381,652,-721594288,-721594257,31
0,1381,653,-721594288,-721594250,38
0,1382,654,-721594238,-721594195,43
0,1384,655,-721594137,-721594101,36
0,1385,656,-721594087,-721594058,29
0,1385,657,-721594087,-721594051,36
0,1386,658,-721594036,-721593994,42
0,1388,659,-721593936,-721593902,34
0,1389,660,-721593886,-721593858,28
0,1389,661,-721593886,-721593851,35
0,1390,662,-721593835,-721593794,41
0,1392,663,-721593735,-721593703,32
0,1393,664,-721593684,-721593657,27
0,1393,665,-721593684,-721593651,33
0,1394,666,-721593634,-721593594,40
0,1396,667,-721593533,-721593502,31
0,1397,668,-721593483,-721593452,31
0,1398,669,-721593433,-721593394,39
0,1400,670,-721593332,-721593301,31
0,1401,671,-721593282,-721593256,26
0,1401,672,-721593282,-721593251,31
0,1402,673,-721593231,-721593193,38
0,1404,674,-721593131,-721593101,30
0,1405,675,-721593080,-721593055,25
0,1405,676,-721593080,-721593050,30
0,1406,677,-721593030,-721592993,37
0,1408,678,-721592929,-721592900,29
0,1409,679,-721592879,-721592856,23
0,1409,680,-721592879,-721592851,28
0,1410,681,-721592829,-721592793,36
0,1412,682,-721592728,-721592701,27
0,1413,683,-721592678,-721592656,22
0,1413,684,-721592678,-721592651,27
0,1414,685,-721592627,-721592592,35
0,1416,686,-721592527,-721592500,27
0,1417,687,-721592476,-721592456,20
0,1417,688,-721592476,-721592451,25
0,1418,689,-721592426,-721592393,33
0,1420,690,-721592325,-721592300,25
0,1421,691,-721592275,-721592257,18
0,1421,692,-721592275,-721592251,24
0,1422,693,-721592224,-721592192,32
0,1424,694,-721592124,-721592101,23
0,1425,695,-721592073,-721592056,17
0,1425,696,-721592073,-721592050,23
0,1426,697,-721592023,-721591993,30
0,1428,698,-721591922,-721591900,22
0,1429,699,-721591872,-721591856,16
0,1429,700,-721591872,-721591850,22
0,1430,701,-721591821,-721591793,28
0,1431,702,-721591771,-721591756,15
0,1432,703,-721591720,-721591701,19
0,1433,704,-721591670,-721591657,13
0,1433,705,-721591670,-721591652,18
0,1434,706,-721591619,-721591592,27
0,1435,707,-721591569,-721591555,14
0,1436,708,-721591519,-721591501,18
0,1437,709,-721591469,-721591456,13
0,1437,710,-721591469,-721591452,17
0,1438,711,-721591418,-721591393,25
0,1439,712,-721591368,-721591355,13
0,1440,713,-721591318,-721591300,18
0,1441,714,-721591267,-721591256,11
0,1441,715,-721591267,-721591250,17
0,1442,716,-721591217,-721591193,24
0,1444,717,-721591116,-721591100,16
0,1445,718,-721591066,-721591056,10
0,1445,719,-721591066,-721591050,16
0,1446,720,-721591016,-721590993,23
0,1448,721,-721590915,-721590901,14
0,1449,722,-721590864,-721590855,9
0,1449,723,-721590864,-721590849,15
0,1450,724,-721590814,-721590794,20
0,1452,725,-721590713,-721590701,12
0,1453,726,-721590663,-721590657,6
0,1453,727,-721590663,-721590651,12
0,1454,728,-721590613,-721590594,19
0,1456,729,-721590512,-721590501,11
0,1457,730,-721590462,-721590457,5
0,1457,731,-721590462,-721590451,11
0,1458,732,-721590412,-721590394,18
0,1460,733,-721590311,-721590302,9
0,1461,734,-721590260,-721590256,4
0,1461,735,-721590260,-721590251,9
0,1462,736,-721590209,-721590193,16
0,1464,737,-721590109,-721590102,7
0,1465,738,-721590058,-721590056,2
0,1465,739,-721590058,-721590050,8
0,1466,740,-721590008,-721589993,15
0,1468,741,-721589908,-721589902,6
0,1469,742,-721589857,-721589856,1
0,1469,743,-721589857,-721589850,7
0,1470,744,-721589807,-721589794,13
0,1472,745,-721589706,-721589702,4
0,1472,746,-721589706,-721589657,49
0,1473,747,-721589656,-721589652,4
0,1474,748,-721589606,-721589594,12
0,1476,749,-721589505,-721589502,3
0,1476,750,-721589505,-721589457,48
0,1478,751,-721589405,-721589394,11
0,1480,752,-721589304,-721589301,3
0,1480,753,-721589304,-721589257,47
0,1481,754,-721589254,-721589250,4
0,1482,755,-721589203,-721589193,10
0,1484,756,-721589103,-721589102,1
0,1484,757,-721589103,-721589057,46
0,1485,758,-721589053,-721589050,3
0,1486,759,-721589002,-721588993,9
0,1488,760,-721588902,-721588902,0
0,1488,761,-721588902,-721588857,45
0,1489,762,-721588851,-721588850,1
0,1490,763,-721588801,-721588793,8
0,1491,764,-721588751,-721588703,48
0,1492,765,-721588700,-721588657,43
0,1492,766,-721588700,-721588651,49
0,1494,767,-721588600,-721588593,7
0,1495,768,-721588549,-721588502,47
0,1496,769,-721588499,-721588458,41
0,1496,770,-721588499,-721588452,47
0,1498,771,-721588398,-721588392,6
0,1499,772,-721588348,-721588301,47
0,1500,773,-721588298,-721588258,40
0,1500,774,-721588298,-721588251,47
0,1502,775,-721588197,-721588192,5
0,1503,776,-721588147,-721588101,46
0,1504,777,-721588097,-721588058,39
0,1504,778,-721588097,-721588051,46
0,1506,779,-721587996,-721587993,3
0,1507,780,-721587945,-721587901,44
0,1508,781,-721587895,-721587858,37
0,1508,782,-721587895,-721587851,44
0,1510,783,-721587793,-721587792,1
0,1511,784,-721587743,-721587702,41
0,1512,785,-721587693,-721587658,35
0,1512,786,-721587693,-721587652,41
0,1513,787,-721587643,-721587593,50
0,1515,788,-721587542,-721587503,39
0,1516,789,-721587492,-721587458,34
0,1516,790,-721587492,-721587452,40
0,1517,791,-721587441,-721587392,49
0,1519,792,-721587339,-721587301,38
0,1520,793,-721587289,-721587258,31
0,1520,794,-721587289,-721587251,38
0,1521,795,-721587239,-721587193,46
0,1523,796,-721587138,-721587101,37
0,1524,797,-721587088,-721587058,30
0,1524,798,-721587088,-721587051,37
0,1525,799,-721587038,-721586993,45
0,1527,800,-721586937,-721586902,35
0,1528,801,-721586887,-721586857,30
0,1528,802,-721586887,-721586851,36
0,1529,803,-721586835,-721586792,43
0,1531,804,-721586735,-721586703,32
0,1532,805,-721586684,-721586658,26
0,1532,806,-721586684,-721586651,33
0,1533,807,-721586634,-721586592,42
0,1535,808,-721586533,-721586502,31
0,1536,809,-721586483,-721586458,25
0,1536,810,-721586483,-721586451,32
0,1537,811,-721586433,-721586392,41
0,1539,812,-721586332,-721586302,30
0,1540,813,-721586282,-721586257,25
0,1540,814,-721586282,-721586250,32
0,1541,815,-721586231,-721586191,40
0,1543,816,-721586131,-721586102,29
0,1544,817,-721586080,-721586057,23
0,1544,818,-721586080,-721586050,30
0,1545,819,-721586030,-721585991,39
0,1547,820,-721585930,-721585901,29
0,1548,821,-721585879,-721585857,22
0,1548,822,-721585879,-721585850,29
0,1549,823,-721585829,-721585791,38
0,1551,824,-721585728,-721585702,26
0,1552,825,-721585678,-721585658,20
0,1552,826,-721585678,-721585651,27
0,1553,827,-721585628,-721585591,37
0,1555,828,-721585527,-721585502,25
0,1556,829,-721585477,-721585458,19
0,1556,830,-721585477,-721585451,26
0,1557,831,-721585427,-721585390,37
0,1559,832,-721585326,-721585301,25
0,1560,833,-721585276,-721585258,18
0,1560,834,-721585276,-721585251,25
0,1561,835,-721585225,-721585190,35
0,1563,836,-721585125,-721585101,24
0,1564,837,-721585074,-721585057,17
0,1564,838,-721585074,-721585050,24
0,1567,839,-721584923,-721584900,23
0,1568,840,-721584873,-721584858,15
0,1568,841,-721584873,-721584851,22
0,1569,842,-721584823,-721584792,31
0,1572,843,-721584672,-721584658,14
0,1572,844,-721584672,-721584652,20
0,1573,845,-721584621,-721584591,30
0,1575,846,-721584521,-721584501,20
0,1576,847,-721584470,-721584457,13
0,1576,848,-721584470,-721584451,19
0,1577,849,-721584420,-721584392,28
0,1579,850,-721584319,-721584301,18
0,1580,851,-721584269,-721584258,11
0,1580,852,-721584269,-721584251,18
0,1581,853,-721584219,-721584192,27
0,1583,854,-721584118,-721584101,17
0,1584,855,-721584068,-721584051,17
0,1585,856,-721584017,-721583991,26
0,1587,857,-721583916,-721583901,15
0,1588,858,-721583866,-721583858,8
0,1588,859,-721583866,-721583851,15
0,1589,860,-721583816,-721583792,24
0,1591,861,-721583715,-721583702,13
0,1592,862,-721583665,-721583658,7
0,1593,863,-721583614,-721583591,23
0,1595,864,-721583514,-721583503,11
0,1596,865,-721583463,-721583457,6
0,1596,866,-721583463,-721583451,12
0,1597,867,-721583413,-721583392,21
0,1599,868,-721583312,-721583301,11
0,1600,869,-721583262,-721583258,4
0,1600,870,-721583262,-721583251,11
0,1601,871,-721583211,-721583191,20
0,1603,872,-721583110,-721583101,9
0,1604,873,-721583060,-721583058,2
0,1604,874,-721583060,-721583051,9
0,1605,875,-721583010,-721582991,19
0,1607,876,-721582909,-721582901,8
0,1608,877,-721582859,-721582857,2
0,1608,878,-721582859,-721582850,9
0,1609,879,-721582808,-721582791,17
0,1611,880,-721582707,-721582701,6
0,1611,881,-721582707,-721582657,50
0,1612,882,-721582657,-721582652,5
0,1613,883,-721582607,-721582591,16
0,1615,884,-721582506,-721582501,5
0,1615,885,-721582506,-721582457,49
0,1616,886,-721582456,-721582452,4
0,1617,887,-721582405,-721582390,15
0,1619,888,-721582305,-721582302,3
0,1619,889,-721582305,-721582257,48
0,1620,890,-721582255,-721582251,4
0,1621,891,-721582204,-721582190,14
0,1623,892,-721582104,-721582102,2
0,1623,893,-721582104,-721582057,47
0,1624,894,-721582053,-721582050,3
0,1625,895,-721582003,-721581991,12
0,1627,896,-721581902,-721581901,1
0,1627,897,-721581902,-721581856,46
0,1628,898,-721581852,-721581851,1
0,1629,899,-721581802,-721581791,11
0,1630,900,-721581751,-721581702,49
0,1631,901,-721581701,-721581658,43
0,1631,902,-721581701,-721581652,49
0,1633,903,-721581600,-721581590,10
0,1634,904,-721581550,-721581502,48
0,1635,905,-721581499,-721581457,42
0,1635,906,-721581499,-721581451,48
0,1637,907,-721581399,-721581390,9
0,1639,908,-721581298,-721581257,41
0,1639,909,-721581298,-721581251,47
0,1641,910,-721581197,-721581191,6
0,1642,911,-721581147,-721581101,46
0,1643,912,-721581096,-721581056,40
0,1643,913,-721581096,-721581050,46
0,1645,914,-721580996,-721580991,5
0,1646,915,-721580945,-721580900,45
0,1647,916,-721580895,-721580857,38
0,1647,917,-721580895,-721580851,44
0,1649,918,-721580794,-721580791,3
0,1650,919,-721580744,-721580702,42
0,1651,920,-721580693,-721580657,36
0,1651,921,-721580693,-721580651,42
0,1653,922,-721580593,-721580591,2
0,1654,923,-721580543,-721580502,41
0,1655,924,-721580492,-721580457,35
0,1655,925,-721580492,-721580451,41
0,1657,926,-721580392,-721580391,1
0,1658,927,-721580341,-721580301,40
0,1659,928,-721580291,-721580257,34
0,1659,929,-721580291,-721580251,40
0,1660,930,-721580241,-721580191,50
0,1662,931,-721580140,-721580101,39
0,1663,932,-721580090,-721580057,33
0,1663,933,-721580090,-721580051,39
0,1664,934,-721580039,-721579990,49
0,1666,935,-721579939,-721579902,37
0,1667,936,-721579888,-721579856,32
0,1667,937,-721579888,-721579850,38
0,1668,938,-721579838,-721579790,48
0,1670,939,-721579737,-721579702,35
0,1671,940,-721579687,-721579657,30
0,1671,941,-721579687,-721579651,36
0,1672,942,-721579637,-721579590,47
0,1674,943,-721579536,-721579502,34
0,1675,944,-721579486,-721579457,29
0,1676,945,-721579436,-721579389,47
0,1678,946,-721579335,-721579301,34
0,1679,947,-721579285,-721579257,28
0,1679,948,-721579285,-721579250,35
0,1680,949,-721579234,-721579189,45
0,1682,950,-721579134,-721579102,32
0,1683,951,-721579083,-721579056,27
0,1683,952,-721579083,-721579050,33
0,1684,953,-721579033,-721578990,43
0,1686,954,-721578932,-721578901,31
0,1687,955,-721578882,-721578857,25
0,1687,956,-721578882,-721578851,31
0,1688,957,-721578832,-721578790,42
0,1690,958,-721578731,-721578702,29
0,1691,959,-721578681,-721578658,23
0,1691,960,-721578681,-721578652,29
0,1692,961,-721578630,-721578589,41
0,1694,962,-721578530,-721578503,27
0,1695,963,-721578479,-721578457,22
0,1695,964,-721578479,-721578451,28
0,1696,965,-721578429,-721578390,39
0,1698,966,-721578328,-721578301,27
0,1699,967,-721578278,-721578257,21
0,1699,968,-721578278,-721578251,27
0,1700,969,-721578228,-721578190,38
0,1702,970,-721578127,-721578101,26
0,1703,971,-721578077,-721578057,20
0,1703,972,-721578077,-721578051,26
0,1706,973,-721577926,-721577901,25
0,1707,974,-721577876,-721577857,19
0,1707,975,-721577876,-721577851,25
0,1708,976,-721577825,-721577789,36
0,1710,977,-721577724,-721577701,23
0,1711,978,-721577674,-721577658,16
0,1711,979,-721577674,-721577652,22
0,1712,980,-721577624,-721577589,35
0,1714,981,-721577523,-721577501,22
0,1715,982,-721577473,-721577458,15
0,1715,983,-721577473,-721577452,21
0,1716,984,-721577422,-721577388,34
0,1718,985,-721577322,-721577302,20
0,1719,986,-721577272,-721577257,15
0,1719,987,-721577272,-721577250,22
0,1720,988,-721577221,-721577188,33
0,1722,989,-721577121,-721577102,19
0,1723,990,-721577070,-721577057,13
0,1723,991,-721577070,-721577050,20
0,1724,992,-721577020,-721576988,32
0,1726,993,-721576919,-721576901,18
0,1727,994,-721576869,-721576857,12
0,1727,995,-721576869,-721576851,18
0,1728,996,-721576819,-721576789,30
0,1730,997,-721576718,-721576702,16
0,1731,998,-721576668,-721576658,10
0,1731,999,-721576668,-721576652,16
0,1732,1000,-721576617,-721576588,29
0,1734,1001,-721576517,-721576502,15
0,1735,1002,-721576466,-721576457,9
0,1735,1003,-721576466,-721576451,15
0,1736,1004,-721576416,-721576388,28
0,1738,1005,-721576316,-721576301,15
0,1739,1006,-721576265,-721576257,8
0,1739,1007,-721576265,-721576250,15
0,1740,1008,-721576215,-721576188,27
0,1742,1009,-721576114,-721576101,13
0,1743,1010,-721576064,-721576051,13
0,1744,1011,-721576014,-721575988,26
0,1746,1012,-721575913,-721575901,12
0,1747,1013,-721575863,-721575856,7
0,1747,1014,-721575863,-721575851,12
0,1748,1015,-721575812,-721575788,24
0,1750,1016,-721575712,-721575703,9
0,1751,1017,-721575661,-721575657,4
0,1751,1018,-721575661,-721575651,10
0,1752,1019,-721575611,-721575589,22
0,1754,1020,-721575510,-721575502,8
0,1755,1021,-721575460,-721575458,2
0,1755,1022,-721575460,-721575452,8
0,1756,1023,-721575410,-721575389,21
0,1758,1024,-721575309,-721575301,8
0,1759,1025,-721575259,-721575258,1
0,1759,1026,-721575259,-721575251,8
0,1760,1027,-721575208,-721575188,20
0,1762,1028,-721575108,-721575102,6
0,1762,1029,-721575108,-721575058,50
0,1763,1030,-721575058,-721575051,7
0,1764,1031,-721575007,-721574988,19
0,1766,1032,-721574907,-721574902,5
0,1766,1033,-721574907,-721574858,49
0,1767,1034,-721574856,-721574850,6
0,1768,1035,-721574806,-721574788,18
0,1770,1036,-721574706,-721574702,4
0,1770,1037,-721574706,-721574657,49
0,1771,1038,-721574655,-721574651,4
0,1772,1039,-721574605,-721574588,17
0,1774,1040,-721574505,-721574502,3
0,1774,1041,-721574505,-721574457,48
0,1775,1042,-721574454,-721574451,3
0,1776,1043,-721574404,-721574388,16
0,1778,1044,-721574303,-721574301,2
0,1778,1045,-721574303,-721574257,46
0,1779,1046,-721574253,-721574251,2
0,1780,1047,-721574203,-721574188,15
0,1782,1048,-721574102,-721574101,1
0,1782,1049,-721574102,-721574057,45
0,1783,1050,-721574052,-721574051,1
0,1784,1051,-721574002,-721573988,14
0,1786,1052,-721573901,-721573858,43
0,1786,1053,-721573901,-721573851,50
0,1788,1054,-721573801,-721573788,13
0,1789,1055,-721573750,-721573702,48
0,1790,1056,-721573700,-721573657,43
0,1790,1057,-721573700,-721573652,48
0,1792,1058,-721573599,-721573588,11
0,1793,1059,-721573549,-721573502,47
0,1794,1060,-721573498,-721573457,41
0,1794,1061,-721573498,-721573451,47
0,1796,1062,-721573398,-721573388,10
0,1797,1063,-721573348,-721573301,47
0,1798,1064,-721573297,-721573258,39
0,1798,1065,-721573297,-721573250,47
0,1800,1066,-721573197,-721573188,9
0,1801,1067,-721573146,-721573101,45
0,1802,1068,-721573096,-721573058,38
0,1802,1069,-721573096,-721573050,46
0,1804,1070,-721572995,-721572987,8
0,1805,1071,-721572945,-721572901,44
0,1806,1072,-721572895,-721572858,37
0,1806,1073,-721572895,-721572850,45
0,1808,1074,-721572794,-721572788,6
0,1809,1075,-721572744,-721572703,41
0,1810,1076,-721572694,-721572650,44
0,1812,1077,-721572593,-721572588,5
0,1813,1078,-721572543,-721572503,40
0,1814,1079,-721572492,-721572450,42
0,1816,1080,-721572392,-721572388,4
0,1817,1081,-721572341,-721572301,40
0,1818,1082,-721572291,-721572251,40
0,1820,1083,-721572190,-721572187,3
0,1821,1084,-721572140,-721572101,39
0,1822,1085,-721572090,-721572050,40
0,1824,1086,-721571989,-721571987,2
0,1825,1087,-721571939,-721571901,38
0,1826,1088,-721571889,-721571850,39
0,1828,1089,-721571788,-721571787,1
0,1829,1090,-721571738,-721571703,35
0,1830,1091,-721571688,-721571651,37
0,1832,1092,-721571587,-721571587,0
0,1833,1093,-721571537,-721571503,34
0,1834,1094,-721571486,-721571451,35
0,1835,1095,-721571436,-721571387,49
0,1837,1096,-721571336,-721571301,35
0,1838,1097,-721571285,-721571250,35
0,1839,1098,-721571235,-721571187,48
0,1841,1099,-721571134,-721571101,33
0,1842,1100,-721571084,-721571050,34
0,1843,1101,-721571034,-721570986,48
0,1845,1102,-721570933,-721570902,31
0,1846,1103,-721570882,-721570849,33
0,1847,1104,-721570832,-721570787,45
0,1849,1105,-721570732,-721570702,30
0,1850,1106,-721570681,-721570650,31
0,1853,1107,-721570530,-721570502,28
0,1854,1108,-721570480,-721570450,30
0,1857,1109,-721570329,-721570301,28
0,1858,1110,-721570279,-721570250,29
0,1861,1111,-721570128,-721570101,27
0,1862,1112,-721570077,-721570049,28
0,1865,1113,-721569926,-721569900,26
0,1866,1114,-721569876,-721569850,26
0,1869,1115,-721569725,-721569701,24
0,1870,1116,-721569675,-721569651,24
0,1873,1117,-721569524,-721569501,23
0,1874,1118,-721569474,-721569451,23
0,1877,1119,-721569323,-721569302,21
0,1878,1120,-721569273,-721569250,23
0,1881,1121,-721569121,-721569101,20
0,1882,1122,-721569071,-721569051,20
0,1885,1123,-721568920,-721568901,19
0,1886,1124,-721568870,-721568851,19
0,1889,1125,-721568719,-721568703,16
0,1890,1126,-721568668,-721568651,17
0,1893,1127,-721568517,-721568502,15
0,1894,1128,-721568467,-721568452,15
0,1897,1129,-721568316,-721568301,15
0,1898,1130,-721568266,-721568251,15
0,1901,1131,-721568115,-721568101,14
0,1902,1132,-721568065,-721568051,14
0,1905,1133,-721567914,-721567902,12
0,1906,1134,-721567863,-721567850,13
0,1909,1135,-721567712,-721567702,10
0,1910,1136,-721567662,-721567651,11
0,1913,1137,-721567511,-721567502,9
0,1914,1138,-721567461,-721567450,11
0,1917,1139,-721567310,-721567302,8
0,1918,1140,-721567259,-721567250,9
0,1921,1141,-721567109,-721567102,7
0,1922,1142,-721567058,-721567050,8
0,1925,1143,-721566908,-721566901,7
0,1926,1144,-721566857,-721566850,7
0,1929,1145,-721566707,-721566702,5
0,1930,1146,-721566656,-721566651,5
0,1933,1147,-721566505,-721566502,3
0,1934,1148,-721566455,-721566452,3
0,1937,1149,-721566304,-721566301,3
0,1938,1150,-721566254,-721566251,3
0,1941,1151,-721566103,-721566101,2
0,1942,1152,-721566053,-721566051,2
0,1945,1153,-721565902,-721565901,1
0,1946,1154,-721565852,-721565851,1
0,1948,1155,-721565751