t_id, iteration_count, request_count, request_start_time, request_end_time, request_processing_time
0,263,1,3578691771,3578691817,46
0,264,2,3578691822,3578691865,43
0,265,3,3578691872,3578691913,41
0,266,4,3578691923,3578691963,40
0,267,5,3578691973,3578692014,41
0,267,6,3578691973,3578692017,44
0,268,7,3578692023,3578692065,42
0,269,8,3578692074,3578692115,41
0,270,9,3578692125,3578692166,41
0,271,10,3578692175,3578692213,38
0,271,11,3578692175,3578692217,42
0,271,12,3578692175,3578692217,42
0,272,13,3578692226,3578692267,41
0,273,14,3578692277,3578692316,39
0,273,15,3578692277,3578692318,41
0,274,16,3578692327,3578692366,39
0,274,17,3578692327,3578692369,42
0,275,18,3578692378,3578692414,36
0,275,19,3578692378,3578692417,39
0,275,20,3578692378,3578692419,41
0,276,21,3578692429,3578692468,39
0,276,22,3578692429,3578692470,41
0,277,23,3578692479,3578692514,35
0,277,24,3578692479,3578692520,41
0,278,25,3578692530,3578692566,36
0,278,26,3578692530,3578692571,41
0,279,27,3578692580,3578692612,32
0,279,28,3578692580,3578692617,37
0,279,29,3578692580,3578692622,42
0,280,30,3578692631,3578692667,36
0,280,31,3578692631,3578692672,41
0,281,32,3578692682,3578692715,33
0,281,33,3578692682,3578692723,41
0,282,34,3578692732,3578692766,34
0,282,35,3578692732,3578692771,39
0,282,36,3578692732,3578692774,42
0,283,37,3578692783,3578692813,30
0,283,38,3578692783,3578692816,33
0,283,39,3578692783,3578692824,41
0,284,40,3578692834,3578692867,33
0,284,41,3578692834,3578692873,39
0,284,42,3578692834,3578692875,41
0,285,43,3578692885,3578692916,31
0,285,44,3578692885,3578692926,41
0,286,45,3578692935,3578692966,31
0,286,46,3578692935,3578692971,36
0,286,47,3578692935,3578692974,39
0,286,48,3578692935,3578692976,41
0,287,49,3578692986,3578693013,27
0,287,50,3578692986,3578693016,30
0,287,51,3578692986,3578693025,39
0,287,52,3578692986,3578693027,41
0,288,53,3578693036,3578693067,31
0,288,54,3578693036,3578693072,36
0,288,55,3578693036,3578693078,42
0,289,56,3578693087,3578693116,29
0,289,57,3578693087,3578693126,39
0,289,58,3578693087,3578693128,41
0,290,59,3578693138,3578693166,28
0,290,60,3578693138,3578693171,33
0,290,61,3578693138,3578693174,36
0,290,62,3578693138,3578693180,42
0,291,63,3578693188,3578693213,25
0,291,64,3578693188,3578693217,29
0,291,65,3578693188,3578693225,37
0,291,66,3578693188,3578693230,42
0,292,67,3578693239,3578693267,28
0,292,68,3578693239,3578693273,34
0,292,69,3578693239,3578693280,41
0,293,70,3578693290,3578693316,26
0,293,71,3578693290,3578693326,36
0,293,72,3578693290,3578693331,41
0,294,73,3578693341,3578693366,25
0,294,74,3578693341,3578693371,30
0,294,75,3578693341,3578693374,33
0,294,76,3578693341,3578693382,41
0,295,77,3578693391,3578693412,21
0,295,78,3578693391,3578693417,26
0,295,79,3578693391,3578693425,34
0,295,80,3578693391,3578693429,38
0,295,81,3578693391,3578693432,41
0,296,82,3578693442,3578693467,25
0,296,83,3578693442,3578693473,31
0,296,84,3578693442,3578693483,41
0,297,85,3578693492,3578693514,22
0,297,86,3578693492,3578693524,32
0,297,87,3578693492,3578693533,41
0,298,88,3578693543,3578693565,22
0,298,89,3578693543,3578693570,27
0,298,90,3578693543,3578693573,30
0,298,91,3578693543,3578693581,38
0,298,92,3578693543,3578693584,41
0,299,93,3578693594,3578693612,18
0,299,94,3578693594,3578693617,23
0,299,95,3578693594,3578693624,30
0,299,96,3578693594,3578693629,35
0,299,97,3578693594,3578693635,41
0,300,98,3578693644,3578693666,22
0,300,99,3578693644,3578693672,28
0,300,100,3578693644,3578693685,41
0,301,101,3578693695,3578693715,20
0,301,102,3578693695,3578693725,30
0,301,103,3578693695,3578693736,41
0,302,104,3578693746,3578693765,19
0,302,105,3578693746,3578693771,25
0,302,106,3578693746,3578693773,27
0,302,107,3578693746,3578693782,36
0,302,108,3578693746,3578693787,41
0,303,109,3578693797,3578693812,15
0,303,110,3578693797,3578693817,20
0,303,111,3578693797,3578693823,26
0,303,112,3578693797,3578693829,32
0,303,113,3578693797,3578693835,38
0,303,114,3578693797,3578693837,40
0,304,115,3578693848,3578693866,18
0,304,116,3578693848,3578693873,25
0,304,117,3578693848,3578693888,40
0,305,118,3578693898,3578693915,17
0,305,119,3578693898,3578693925,27
0,305,120,3578693898,3578693939,41
0,306,121,3578693949,3578693965,16
0,306,122,3578693949,3578693971,22
0,306,123,3578693949,3578693973,24
0,306,124,3578693949,3578693982,33
0,306,125,3578693949,3578693989,40
0,307,126,3578694000,3578694013,13
0,307,127,3578694000,3578694017,17
0,307,128,3578694000,3578694024,24
0,307,129,3578694000,3578694029,29
0,307,130,3578694000,3578694035,35
0,307,131,3578694000,3578694040,40
0,308,132,3578694051,3578694066,15
0,308,133,3578694051,3578694074,23
0,308,134,3578694051,3578694088,37
0,308,135,3578694051,3578694091,40
0,309,136,3578694101,3578694115,14
0,309,137,3578694101,3578694124,23
0,309,138,3578694101,3578694141,40
0,310,139,3578694152,3578694165,13
0,310,140,3578694152,3578694171,19
0,310,141,3578694152,3578694173,21
0,310,142,3578694152,3578694182,30
0,310,143,3578694152,3578694190,38
0,310,144,3578694152,3578694192,40
0,311,145,3578694202,3578694212,10
0,311,146,3578694202,3578694217,15
0,311,147,3578694202,3578694225,23
0,311,148,3578694202,3578694229,27
0,311,149,3578694202,3578694235,33
0,311,150,3578694202,3578694243,41
0,312,151,3578694253,3578694266,13
0,312,152,3578694253,3578694274,21
0,312,153,3578694253,3578694288,35
0,312,154,3578694253,3578694293,40
0,313,155,3578694304,3578694316,12
0,313,156,3578694304,3578694325,21
0,313,157,3578694304,3578694342,38
0,313,158,3578694304,3578694344,40
0,314,159,3578694355,3578694365,10
0,314,160,3578694355,3578694371,16
0,314,161,3578694355,3578694373,18
0,314,162,3578694355,3578694382,27
0,314,163,3578694355,3578694391,36
0,314,164,3578694355,3578694395,40
0,315,165,3578694405,3578694412,7
0,315,166,3578694405,3578694417,12
0,315,167,3578694405,3578694424,19
0,315,168,3578694405,3578694428,23
0,315,169,3578694405,3578694436,31
0,315,170,3578694405,3578694445,40
0,316,171,3578694456,3578694467,11
0,316,172,3578694456,3578694474,18
0,316,173,3578694456,3578694488,32
0,316,174,3578694456,3578694496,40
0,317,175,3578694507,3578694514,7
0,317,176,3578694507,3578694524,17
0,317,177,3578694507,3578694542,35
0,317,178,3578694507,3578694543,36
0,317,179,3578694507,3578694547,40
0,318,180,3578694558,3578694564,6
0,318,181,3578694558,3578694570,12
0,318,182,3578694558,3578694572,14
0,318,183,3578694558,3578694581,23
0,318,184,3578694558,3578694590,32
0,318,185,3578694558,3578694597,39
0,319,186,3578694609,3578694612,3
0,319,187,3578694609,3578694616,7
0,319,188,3578694609,3578694623,14
0,319,189,3578694609,3578694628,19
0,319,190,3578694609,3578694635,26
0,319,191,3578694609,3578694648,39
0,320,192,3578694659,3578694666,7
0,320,193,3578694659,3578694673,14
0,320,194,3578694659,3578694689,30
0,320,195,3578694659,3578694698,39
0,321,196,3578694710,3578694715,5
0,321,197,3578694710,3578694724,14
0,321,198,3578694710,3578694741,31
0,321,199,3578694710,3578694743,33
0,321,200,3578694710,3578694749,39
0,322,201,3578694761,3578694764,3
0,322,202,3578694761,3578694770,9
0,322,203,3578694761,3578694773,12
0,322,204,3578694761,3578694781,20
0,322,205,3578694761,3578694791,30
0,322,206,3578694761,3578694800,39
0,323,207,3578694812,3578694812,0
0,323,208,3578694812,3578694816,4
0,323,209,3578694812,3578694824,12
0,323,210,3578694812,3578694828,16
0,323,211,3578694812,3578694835,23
0,323,212,3578694812,3578694851,39
0,324,213,3578694863,3578694866,3
0,324,214,3578694863,3578694874,11
0,324,215,3578694863,3578694888,25
0,324,216,3578694863,3578694901,38
0,325,217,3578694914,3578694915,1
0,325,218,3578694914,3578694925,11
0,325,219,3578694914,3578694942,28
0,325,220,3578694914,3578694943,29
0,325,221,3578694914,3578694952,38
0,325,222,3578694914,3578694964,50
0,326,223,3578694965,3578694971,6
0,326,224,3578694965,3578694972,7
0,326,225,3578694965,3578694980,15
0,326,226,3578694965,3578694991,26
0,326,227,3578694965,3578695002,37
0,326,228,3578694965,3578695013,48
0,327,229,3578695016,3578695016,0
0,327,230,3578695016,3578695023,7
0,327,231,3578695016,3578695028,12
0,327,232,3578695016,3578695036,20
0,327,233,3578695016,3578695051,35
0,327,234,3578695016,3578695053,37
0,327,235,3578695016,3578695066,50
0,328,236,3578695067,3578695075,8
0,328,237,3578695067,3578695089,22
0,328,238,3578695067,3578695104,37
0,328,239,3578695067,3578695115,48
0,329,240,3578695117,3578695125,8
0,329,241,3578695117,3578695143,26
0,329,242,3578695117,3578695143,26
0,329,243,3578695117,3578695154,37
0,329,244,3578695117,3578695165,48
0,330,245,3578695168,3578695170,2
0,330,246,3578695168,3578695173,5
0,330,247,3578695168,3578695181,13
0,330,248,3578695168,3578695191,23
0,330,249,3578695168,3578695202,34
0,330,250,3578695168,3578695205,37
0,330,251,3578695168,3578695213,45
0,330,252,3578695168,3578695216,48
0,331,253,3578695219,3578695224,5
0,331,254,3578695219,3578695229,10
0,331,255,3578695219,3578695236,17
0,331,256,3578695219,3578695251,32
0,331,257,3578695219,3578695256,37
0,331,258,3578695219,3578695266,47
0,332,259,3578695270,3578695275,5
0,332,260,3578695270,3578695289,19
0,332,261,3578695270,3578695304,34
0,332,262,3578695270,3578695306,36
0,332,263,3578695270,3578695315,45
0,333,264,3578695321,3578695325,4
0,333,265,3578695321,3578695343,22
0,333,266,3578695321,3578695344,23
0,333,267,3578695321,3578695357,36
0,333,268,3578695321,3578695365,44
0,333,269,3578695321,3578695370,49
0,334,270,3578695372,3578695373,1
0,334,271,3578695372,3578695381,9
0,334,272,3578695372,3578695391,19
0,334,273,3578695372,3578695402,30
0,334,274,3578695372,3578695408,36
0,334,275,3578695372,3578695412,40
0,334,276,3578695372,3578695416,44
0,335,277,3578695423,3578695424,1
0,335,278,3578695423,3578695429,6
0,335,279,3578695423,3578695437,14
0,335,280,3578695423,3578695451,28
0,335,281,3578695423,3578695458,35
0,335,282,3578695423,3578695467,44
0,336,283,3578695474,3578695474,0
0,336,284,3578695474,3578695489,15
0,336,285,3578695474,3578695503,29
0,336,286,3578695474,3578695506,32
0,336,287,3578695474,3578695509,35
0,336,288,3578695474,3578695513,39
0,336,289,3578695474,3578695524,50
0,337,290,3578695525,3578695541,16
0,337,291,3578695525,3578695556,31
0,337,292,3578695525,3578695560,35
0,337,293,3578695525,3578695564,39
0,337,294,3578695525,3578695569,44
0,337,295,3578695525,3578695572,47
0,338,296,3578695576,3578695581,5
0,338,297,3578695576,3578695591,15
0,338,298,3578695576,3578695602,26
0,338,299,3578695576,3578695607,31
0,338,300,3578695576,3578695610,34
0,338,301,3578695576,3578695612,36
0,338,302,3578695576,3578695615,39
0,338,303,3578695576,3578695624,48
0,339,304,3578695627,3578695628,1
0,339,305,3578695627,3578695636,9
0,339,306,3578695627,3578695650,23
0,339,307,3578695627,3578695661,34
0,339,308,3578695627,3578695665,38
0,339,309,3578695627,3578695675,48
0,340,310,3578695678,3578695689,11
0,340,311,3578695678,3578695704,26
0,340,312,3578695678,3578695706,28
0,340,313,3578695678,3578695712,34
0,340,314,3578695678,3578695713,35
0,340,315,3578695678,3578695724,46
0,341,316,3578695728,3578695741,13
0,341,317,3578695728,3578695756,28
0,341,318,3578695728,3578695760,32
0,341,319,3578695728,3578695762,34
0,341,320,3578695728,3578695764,36
0,341,321,3578695728,3578695769,41
0,341,322,3578695728,3578695773,45
0,342,323,3578695779,3578695781,2
0,342,324,3578695779,3578695791,12
0,342,325,3578695779,3578695802,23
0,342,326,3578695779,3578695807,28
0,342,327,3578695779,3578695812,33
0,342,328,3578695779,3578695813,34
0,342,329,3578695779,3578695815,36
0,342,330,3578695779,3578695825,46
0,342,331,3578695779,3578695828,49
0,343,332,3578695830,3578695836,6
0,343,333,3578695830,3578695850,20
0,343,334,3578695830,3578695861,31
0,343,335,3578695830,3578695863,33
0,343,336,3578695830,3578695865,35
0,343,337,3578695830,3578695875,45
0,344,338,3578695881,3578695889,8
0,344,339,3578695881,3578695904,23
0,344,340,3578695881,3578695906,25
0,344,341,3578695881,3578695912,31
0,344,342,3578695881,3578695914,33
0,344,343,3578695881,3578695914,33
0,344,344,3578695881,3578695925,44
0,345,345,3578695931,3578695941,10
0,345,346,3578695931,3578695943,12
0,345,347,3578695931,3578695956,25
0,345,348,3578695931,3578695961,30
0,345,349,3578695931,3578695962,31
0,345,350,3578695931,3578695964,33
0,345,351,3578695931,3578695965,34
0,345,352,3578695931,3578695969,38
0,345,353,3578695931,3578695973,42
0,345,354,3578695931,3578695980,49
0,346,355,3578695982,3578695990,8
0,346,356,3578695982,3578696001,19
0,346,357,3578695982,3578696007,25
0,346,358,3578695982,3578696013,31
0,346,359,3578695982,3578696015,33
0,346,360,3578695982,3578696016,34
0,346,361,3578695982,3578696025,43
0,346,362,3578695982,3578696027,45
0,347,363,3578696033,3578696036,3
0,347,364,3578696033,3578696050,17
0,347,365,3578696033,3578696061,28
0,347,366,3578696033,3578696064,31
0,347,367,3578696033,3578696066,33
0,347,368,3578696033,3578696066,33
0,347,369,3578696033,3578696076,43
0,348,370,3578696083,3578696089,6
0,348,371,3578696083,3578696104,21
0,348,372,3578696083,3578696105,22
0,348,373,3578696083,3578696111,28
0,348,374,3578696083,3578696114,31
0,348,375,3578696083,3578696117,34
0,348,376,3578696083,3578696124,41
0,349,377,3578696134,3578696142,8
0,349,378,3578696134,3578696143,9
0,349,379,3578696134,3578696156,22
0,349,380,3578696134,3578696162,28
0,349,381,3578696134,3578696163,29
0,349,382,3578696134,3578696165,31
0,349,383,3578696134,3578696168,34
0,349,384,3578696134,3578696169,35
0,349,385,3578696134,3578696173,39
0,349,386,3578696134,3578696180,46
0,350,387,3578696185,3578696190,5
0,350,388,3578696185,3578696202,17
0,350,389,3578696185,3578696207,22
0,350,390,3578696185,3578696213,28
0,350,391,3578696185,3578696215,30
0,350,392,3578696185,3578696218,33
0,350,393,3578696185,3578696226,41
0,350,394,3578696185,3578696229,44
0,351,395,3578696236,3578696236,0
0,351,396,3578696236,3578696250,14
0,351,397,3578696236,3578696261,25
0,351,398,3578696236,3578696263,27
0,351,399,3578696236,3578696266,30
0,351,400,3578696236,3578696269,33
0,351,401,3578696236,3578696275,39
0,352,402,3578696287,3578696289,2
0,352,403,3578696287,3578696305,18
0,352,404,3578696287,3578696305,18
0,352,405,3578696287,3578696311,24
0,352,406,3578696287,3578696315,28
0,352,407,3578696287,3578696317,30
0,352,408,3578696287,3578696319,32
0,352,409,3578696287,3578696325,38
0,353,410,3578696338,3578696343,5
0,353,411,3578696338,3578696343,5
0,353,412,3578696338,3578696356,18
0,353,413,3578696338,3578696362,24
0,353,414,3578696338,3578696364,26
0,353,415,3578696338,3578696365,27
0,353,416,3578696338,3578696369,31
0,353,417,3578696338,3578696370,32
0,353,418,3578696338,3578696373,35
0,353,419,3578696338,3578696380,42
0,354,420,3578696389,3578696391,2
0,354,421,3578696389,3578696402,13
0,354,422,3578696389,3578696407,18
0,354,423,3578696389,3578696413,24
0,354,424,3578696389,3578696415,26
0,354,425,3578696389,3578696421,32
0,354,426,3578696389,3578696427,38
0,354,427,3578696389,3578696429,40
0,354,428,3578696389,3578696436,47
0,355,429,3578696440,3578696450,10
0,355,430,3578696440,3578696461,21
0,355,431,3578696440,3578696463,23
0,355,432,3578696440,3578696466,26
0,355,433,3578696440,3578696471,31
0,355,434,3578696440,3578696475,35
0,355,435,3578696440,3578696490,50
0,356,436,3578696491,3578696504,13
0,356,437,3578696491,3578696504,13
0,356,438,3578696491,3578696510,19
0,356,439,3578696491,3578696514,23
0,356,440,3578696491,3578696517,26
0,356,441,3578696491,3578696522,31
0,356,442,3578696491,3578696523,32
0,357,443,3578696542,3578696542,0
0,357,444,3578696542,3578696542,0
0,357,445,3578696542,3578696555,13
0,357,446,3578696542,3578696561,19
0,357,447,3578696542,3578696563,21
0,357,448,3578696542,3578696564,22
0,357,449,3578696542,3578696569,27
0,357,450,3578696542,3578696572,30
0,357,451,3578696542,3578696573,31
0,357,452,3578696542,3578696580,38
0,357,453,3578696542,3578696590,48
0,358,454,3578696593,3578696601,8
0,358,455,3578696593,3578696605,12
0,358,456,3578696593,3578696611,18
0,358,457,3578696593,3578696614,21
0,358,458,3578696593,3578696623,30
0,358,459,3578696593,3578696627,34
0,358,460,3578696593,3578696628,35
0,358,461,3578696593,3578696634,41
0,359,462,3578696644,3578696648,4
0,359,463,3578696644,3578696660,16
0,359,464,3578696644,3578696663,19
0,359,465,3578696644,3578696665,21
0,359,466,3578696644,3578696674,30
0,359,467,3578696644,3578696675,31
0,359,468,3578696644,3578696690,46
0,360,469,3578696695,3578696704,9
0,360,470,3578696695,3578696705,10
0,360,471,3578696695,3578696710,15
0,360,472,3578696695,3578696714,19
0,360,473,3578696695,3578696718,23
0,360,474,3578696695,3578696724,29
0,360,475,3578696695,3578696724,29
0,360,476,3578696695,3578696742,47
0,360,477,3578696695,3578696742,47
0,361,478,3578696746,3578696755,9
0,361,479,3578696746,3578696761,15
0,361,480,3578696746,3578696764,18
0,361,481,3578696746,3578696764,18
0,361,482,3578696746,3578696769,23
0,361,483,3578696746,3578696773,27
0,361,484,3578696746,3578696775,29
0,361,485,3578696746,3578696780,34
0,361,486,3578696746,3578696791,45
0,362,487,3578696797,3578696801,4
0,362,488,3578696797,3578696806,9
0,362,489,3578696797,3578696812,15
0,362,490,3578696797,3578696815,18
0,362,491,3578696797,3578696826,29
0,362,492,3578696797,3578696826,29
0,362,493,3578696797,3578696828,31
0,362,494,3578696797,3578696835,38
0,363,495,3578696848,3578696849,1
0,363,496,3578696848,3578696860,12
0,363,497,3578696848,3578696863,15
0,363,498,3578696848,3578696865,17
0,363,499,3578696848,3578696876,28
0,363,500,3578696848,3578696876,28
0,363,501,3578696848,3578696890,42
0,364,502,3578696899,3578696904,5
0,364,503,3578696899,3578696905,6
0,364,504,3578696899,3578696910,11
0,364,505,3578696899,3578696914,15
0,364,506,3578696899,3578696918,19
0,364,507,3578696899,3578696925,26
0,364,508,3578696899,3578696927,28
0,364,509,3578696899,3578696942,43
0,364,510,3578696899,3578696942,43
0,365,511,3578696950,3578696955,5
0,365,512,3578696950,3578696961,11
0,365,513,3578696950,3578696964,14
0,365,514,3578696950,3578696965,15
0,365,515,3578696950,3578696969,19
0,365,516,3578696950,3578696973,23
0,365,517,3578696950,3578696978,28
0,365,518,3578696950,3578696980,30
0,365,519,3578696950,3578696991,41
0,366,520,3578697001,3578697001,0
0,366,521,3578697001,3578697006,5
0,366,522,3578697001,3578697013,12
0,366,523,3578697001,3578697015,14
0,366,524,3578697001,3578697026,25
0,366,525,3578697001,3578697028,27
0,366,526,3578697001,3578697028,27
0,366,527,3578697001,3578697036,35
0,366,528,3578697001,3578697050,49
0,367,529,3578697052,3578697060,8
0,367,530,3578697052,3578697062,10
0,367,531,3578697052,3578697065,13
0,367,532,3578697052,3578697076,24
0,367,533,3578697052,3578697079,27
0,367,534,3578697052,3578697090,38
0,368,535,3578697103,3578697105,2
0,368,536,3578697103,3578697105,2
0,368,537,3578697103,3578697111,8
0,368,538,3578697103,3578697114,11
0,368,539,3578697103,3578697118,15
0,368,540,3578697103,3578697126,23
0,368,541,3578697103,3578697130,27
0,368,542,3578697103,3578697142,39
0,368,543,3578697103,3578697143,40
0,369,544,3578697154,3578697155,1
0,369,545,3578697154,3578697161,7
0,369,546,3578697154,3578697165,11
0,369,547,3578697154,3578697166,12
0,369,548,3578697154,3578697169,15
0,369,549,3578697154,3578697173,19
0,369,550,3578697154,3578697179,25
0,369,551,3578697154,3578697180,26
0,369,552,3578697154,3578697191,37
0,369,553,3578697154,3578697202,48
0,370,554,3578697205,3578697206,1
0,370,555,3578697205,3578697213,8
0,370,556,3578697205,3578697215,10
0,370,557,3578697205,3578697226,21
0,370,558,3578697205,3578697229,24
0,370,559,3578697205,3578697231,26
0,370,560,3578697205,3578697236,31
0,370,561,3578697205,3578697251,46
0,371,562,3578697256,3578697260,4
0,371,563,3578697256,3578697263,7
0,371,564,3578697256,3578697267,11
0,371,565,3578697256,3578697275,19
0,371,566,3578697256,3578697281,25
0,371,567,3578697256,3578697290,34
0,371,568,3578697256,3578697305,49
0,371,569,3578697256,3578697306,50
0,372,570,3578697307,3578697311,4
0,372,571,3578697307,3578697314,7
0,372,572,3578697307,3578697318,11
0,372,573,3578697307,3578697326,19
0,372,574,3578697307,3578697332,25
0,372,575,3578697307,3578697343,36
0,372,576,3578697307,3578697344,37
0,372,577,3578697307,3578697356,49
0,373,578,3578697358,3578697361,3
0,373,579,3578697358,3578697366,8
0,373,580,3578697358,3578697366,8
0,373,581,3578697358,3578697369,11
0,373,582,3578697358,3578697372,14
0,373,583,3578697358,3578697381,23
0,373,584,3578697358,3578697381,23
0,373,585,3578697358,3578697383,25
0,373,586,3578697358,3578697390,32
0,373,587,3578697358,3578697402,44
0,373,588,3578697358,3578697406,48
0,374,589,3578697409,3578697412,3
0,374,590,3578697409,3578697415,6
0,374,591,3578697409,3578697426,17
0,374,592,3578697409,3578697428,19
0,374,593,3578697409,3578697433,24
0,374,594,3578697409,3578697436,27
0,374,595,3578697409,3578697451,42
0,375,596,3578697460,3578697460,0
0,375,597,3578697460,3578697463,3
0,375,598,3578697460,3578697466,6
0,375,599,3578697460,3578697476,16
0,375,600,3578697460,3578697484,24
0,375,601,3578697460,3578697490,30
0,375,602,3578697460,3578697505,45
0,375,603,3578697460,3578697505,45
0,376,604,3578697511,3578697511,0
0,376,605,3578697511,3578697513,2
0,376,606,3578697511,3578697517,6
0,376,607,3578697511,3578697525,14
0,376,608,3578697511,3578697534,23
0,376,609,3578697511,3578697542,31
0,376,610,3578697511,3578697543,32
0,376,611,3578697511,3578697555,44
0,376,612,3578697511,3578697560,49
0,377,613,3578697561,3578697565,4
0,377,614,3578697561,3578697565,4
0,377,615,3578697561,3578697569,8
0,377,616,3578697561,3578697572,11
0,377,617,3578697561,3578697579,18
0,377,618,3578697561,3578697579,18
0,377,619,3578697561,3578697585,24
0,377,620,3578697561,3578697589,28
0,377,621,3578697561,3578697601,40
0,377,622,3578697561,3578697606,45
0,378,623,3578697613,3578697613,0
0,378,624,3578697613,3578697614,1
0,378,625,3578697613,3578697626,13
0,378,626,3578697613,3578697628,15
0,378,627,3578697613,3578697634,21
0,378,628,3578697613,3578697635,22
0,378,629,3578697613,3578697649,36
0,378,630,3578697613,3578697659,46
0,378,631,3578697613,3578697661,48
0,379,632,3578697664,3578697665,1
0,379,633,3578697664,3578697676,12
0,379,634,3578697664,3578697684,20
0,379,635,3578697664,3578697687,23
0,379,636,3578697664,3578697690,26
0,379,637,3578697664,3578697705,41
0,379,638,3578697664,3578697705,41
0,379,639,3578697664,3578697710,46
0,379,640,3578697664,3578697713,49
0,380,641,3578697715,3578697717,2
0,380,642,3578697715,3578697725,10
0,380,643,3578697715,3578697735,20
0,380,644,3578697715,3578697737,22
0,380,645,3578697715,3578697742,27
0,380,646,3578697715,3578697743,28
0,380,647,3578697715,3578697755,40
0,380,648,3578697715,3578697760,45
0,381,649,3578697766,3578697766,0
0,381,650,3578697766,3578697766,0
0,381,651,3578697766,3578697769,3
0,381,652,3578697766,3578697773,7
0,381,653,3578697766,3578697779,13
0,381,654,3578697766,3578697780,14
0,381,655,3578697766,3578697785,19
0,381,656,3578697766,3578697788,22
0,381,657,3578697766,3578697790,24
0,381,658,3578697766,3578697800,34
0,381,659,3578697766,3578697805,39
0,381,660,3578697766,3578697812,46
0,381,661,3578697766,3578697815,49
0,382,662,3578697817,3578697826,9
0,382,663,3578697817,3578697828,11
0,382,664,3578697817,3578697835,18
0,382,665,3578697817,3578697838,21
0,382,666,3578697817,3578697850,33
0,382,667,3578697817,3578697859,42
0,382,668,3578697817,3578697862,45
0,382,669,3578697817,3578697865,48
0,383,670,3578697868,3578697876,8
0,383,671,3578697868,3578697885,17
0,383,672,3578697868,3578697889,21
0,383,673,3578697868,3578697890,22
0,383,674,3578697868,3578697905,37
0,383,675,3578697868,3578697906,38
0,383,676,3578697868,3578697911,43
0,383,677,3578697868,3578697913,45
0,383,678,3578697868,3578697917,49
0,384,679,3578697919,3578697925,6
0,384,680,3578697919,3578697935,16
0,384,681,3578697919,3578697940,21
0,384,682,3578697919,3578697942,23
0,384,683,3578697919,3578697943,24
0,384,684,3578697919,3578697955,36
0,384,685,3578697919,3578697960,41
0,384,686,3578697919,3578697966,47
0,384,687,3578697919,3578697966,47
0,384,688,3578697919,3578697969,50
0,385,689,3578697970,3578697973,3
0,385,690,3578697970,3578697979,9
0,385,691,3578697970,3578697979,9
0,385,692,3578697970,3578697985,15
0,385,693,3578697970,3578697988,18
0,385,694,3578697970,3578697990,20
0,385,695,3578697970,3578697990,20
0,385,696,3578697970,3578698001,31
0,385,697,3578697970,3578698006,36
0,385,698,3578697970,3578698013,43
0,385,699,3578697970,3578698015,45
0,386,700,3578698021,3578698026,5
0,386,701,3578698021,3578698028,7
0,386,702,3578698021,3578698035,14
0,386,703,3578698021,3578698041,20
0,386,704,3578698021,3578698050,29
0,386,705,3578698021,3578698059,38
0,386,706,3578698021,3578698062,41
0,386,707,3578698021,3578698065,44
0,387,708,3578698072,3578698075,3
0,387,709,3578698072,3578698085,13
0,387,710,3578698072,3578698089,17
0,387,711,3578698072,3578698090,18
0,387,712,3578698072,3578698091,19
0,387,713,3578698072,3578698105,33
0,387,714,3578698072,3578698105,33
0,387,715,3578698072,3578698110,38
0,387,716,3578698072,3578698114,42
0,387,717,3578698072,3578698117,45
0,388,718,3578698123,3578698124,1
0,388,719,3578698123,3578698134,11
0,388,720,3578698123,3578698142,19
0,388,721,3578698123,3578698142,19
0,388,722,3578698123,3578698143,20
0,388,723,3578698123,3578698155,32
0,388,724,3578698123,3578698160,37
0,388,725,3578698123,3578698166,43
0,388,726,3578698123,3578698166,43
0,388,727,3578698123,3578698169,46
0,388,728,3578698123,3578698173,50
0,389,729,3578698174,3578698179,5
0,389,730,3578698174,3578698179,5
0,389,731,3578698174,3578698185,11
0,389,732,3578698174,3578698188,14
0,389,733,3578698174,3578698190,16
0,389,734,3578698174,3578698192,18
0,389,735,3578698174,3578698201,27
0,389,736,3578698174,3578698206,32
0,389,737,3578698174,3578698213,39
0,389,738,3578698174,3578698215,41
0,390,739,3578698225,3578698227,2
0,390,740,3578698225,3578698229,4
0,390,741,3578698225,3578698236,11
0,390,742,3578698225,3578698243,18
0,390,743,3578698225,3578698250,25
0,390,744,3578698225,3578698259,34
0,390,745,3578698225,3578698262,37
0,390,746,3578698225,3578698266,41
0,391,747,3578698276,3578698276,0
0,391,748,3578698276,3578698285,9
0,391,749,3578698276,3578698289,13
0,391,750,3578698276,3578698290,14
0,391,751,3578698276,3578698293,17
0,391,752,3578698276,3578698305,29
0,391,753,3578698276,3578698306,30
0,391,754,3578698276,3578698311,35
0,391,755,3578698276,3578698315,39
0,391,756,3578698276,3578698318,42
0,391,757,3578698276,3578698324,48
0,392,758,3578698327,3578698334,7
0,392,759,3578698327,3578698343,16
0,392,760,3578698327,3578698344,17
0,392,761,3578698327,3578698344,17
0,392,762,3578698327,3578698356,29
0,392,763,3578698327,3578698360,33
0,392,764,3578698327,3578698365,38
0,392,765,3578698327,3578698366,39
0,392,766,3578698327,3578698369,42
0,392,767,3578698327,3578698373,46
0,393,768,3578698379,3578698379,0
0,393,769,3578698379,3578698380,1
0,393,770,3578698379,3578698385,6
0,393,771,3578698379,3578698388,9
0,393,772,3578698379,3578698390,11
0,393,773,3578698379,3578698395,16
0,393,774,3578698379,3578698401,22
0,393,775,3578698379,3578698406,27
0,393,776,3578698379,3578698413,34
0,393,777,3578698379,3578698415,36
0,393,778,3578698379,3578698426,47
0,393,779,3578698379,3578698428,49
0,394,780,3578698430,3578698436,6
0,394,781,3578698430,3578698445,15
0,394,782,3578698430,3578698450,20
0,394,783,3578698430,3578698459,29
0,394,784,3578698430,3578698463,33
0,394,785,3578698430,3578698466,36
0,394,786,3578698430,3578698476,46
0,395,787,3578698481,3578698484,3
0,395,788,3578698481,3578698488,7
0,395,789,3578698481,3578698489,8
0,395,790,3578698481,3578698492,11
0,395,791,3578698481,3578698496,15
0,395,792,3578698481,3578698504,23
0,395,793,3578698481,3578698505,24
0,395,794,3578698481,3578698511,30
0,395,795,3578698481,3578698513,32
0,395,796,3578698481,3578698517,36
0,395,797,3578698481,3578698524,43
0,396,798,3578698532,3578698534,2
0,396,799,3578698532,3578698542,10
0,396,800,3578698532,3578698543,11
0,396,801,3578698532,3578698544,12
0,396,802,3578698532,3578698546,14
0,396,803,3578698532,3578698555,23
0,396,804,3578698532,3578698558,26
0,396,805,3578698532,3578698565,33
0,396,806,3578698532,3578698565,33
0,396,807,3578698532,3578698569,37
0,396,808,3578698532,3578698573,41
0,396,809,3578698532,3578698578,46
0,396,810,3578698532,3578698580,48
0,397,811,3578698583,3578698584,1
0,397,812,3578698583,3578698586,3
0,397,813,3578698583,3578698590,7
0,397,814,3578698583,3578698594,11
0,397,815,3578698583,3578698597,14
0,397,816,3578698583,3578698600,17
0,397,817,3578698583,3578698606,23
0,397,818,3578698583,3578698613,30
0,397,819,3578698583,3578698614,31
0,397,820,3578698583,3578698628,45
0,398,821,3578698634,3578698635,1
0,398,822,3578698634,3578698647,13
0,398,823,3578698634,3578698649,15
0,398,824,3578698634,3578698659,25
0,398,825,3578698634,3578698662,28
0,398,826,3578698634,3578698665,31
0,398,827,3578698634,3578698676,42
0,399,828,3578698685,3578698685,0
0,399,829,3578698685,3578698688,3
0,399,830,3578698685,3578698689,4
0,399,831,3578698685,3578698692,7
0,399,832,3578698685,3578698699,14
0,399,833,3578698685,3578698704,19
0,399,834,3578698685,3578698705,20
0,399,835,3578698685,3578698710,25
0,399,836,3578698685,3578698713,28
0,399,837,3578698685,3578698716,31
0,399,838,3578698685,3578698723,38
0,399,839,3578698685,3578698733,48
0,400,840,3578698736,3578698742,6
0,400,841,3578698736,3578698742,6
0,400,842,3578698736,3578698743,7
0,400,843,3578698736,3578698749,13
0,400,844,3578698736,3578698755,19
0,400,845,3578698736,3578698758,22
0,400,846,3578698736,3578698764,28
0,400,847,3578698736,3578698765,29
0,400,848,3578698736,3578698769,33
0,400,849,3578698736,3578698774,38
0,400,850,3578698736,3578698778,42
0,400,851,3578698736,3578698780,44
0,400,852,3578698736,3578698784,48
0,401,853,3578698787,3578698787,0
0,401,854,3578698787,3578698789,2
0,401,855,3578698787,3578698794,7
0,401,856,3578698787,3578698798,11
0,401,857,3578698787,3578698800,13
0,401,858,3578698787,3578698801,14
0,401,859,3578698787,3578698806,19
0,401,860,3578698787,3578698813,26
0,401,861,3578698787,3578698815,28
0,401,862,3578698787,3578698828,41
0,401,863,3578698787,3578698834,47
0,402,864,3578698838,3578698850,12
0,402,865,3578698838,3578698850,12
0,402,866,3578698838,3578698859,21
0,402,867,3578698838,3578698863,25
0,402,868,3578698838,3578698866,28
0,402,869,3578698838,3578698876,38
0,402,870,3578698838,3578698884,46
0,402,871,3578698838,3578698888,50
0,403,872,3578698889,3578698889,0
0,403,873,3578698889,3578698893,4
0,403,874,3578698889,3578698901,12
0,403,875,3578698889,3578698904,15
0,403,876,3578698889,3578698906,17
0,403,877,3578698889,3578698911,22
0,403,878,3578698889,3578698913,24
0,403,879,3578698889,3578698917,28
0,403,880,3578698889,3578698925,36
0,403,881,3578698889,3578698934,45
0,404,882,3578698940,3578698942,2
0,404,883,3578698940,3578698943,3
0,404,884,3578698940,3578698943,3
0,404,885,3578698940,3578698951,11
0,404,886,3578698940,3578698955,15
0,404,887,3578698940,3578698959,19
0,404,888,3578698940,3578698964,24
0,404,889,3578698940,3578698965,25
0,404,890,3578698940,3578698969,29
0,404,891,3578698940,3578698974,34
0,404,892,3578698940,3578698979,39
0,404,893,3578698940,3578698981,41
0,404,894,3578698940,3578698984,44
0,404,895,3578698940,3578698987,47
0,405,896,3578698991,3578698991,0
0,405,897,3578698991,3578698994,3
0,405,898,3578698991,3578698998,7
0,405,899,3578698991,3578699001,10
0,405,900,3578698991,3578699002,11
0,405,901,3578698991,3578699007,16
0,405,902,3578698991,3578699013,22
0,405,903,3578698991,3578699015,24
0,405,904,3578698991,3578699025,34
0,405,905,3578698991,3578699027,36
0,405,906,3578698991,3578699034,43
0,406,907,3578699042,3578699050,8
0,406,908,3578699042,3578699052,10
0,406,909,3578699042,3578699059,17
0,406,910,3578699042,3578699063,21
0,406,911,3578699042,3578699066,24
0,406,912,3578699042,3578699076,34
0,406,913,3578699042,3578699084,42
0,406,914,3578699042,3578699088,46
0,406,915,3578699042,3578699089,47
0,407,916,3578699093,3578699093,0
0,407,917,3578699093,3578699103,10
0,407,918,3578699093,3578699104,11
0,407,919,3578699093,3578699105,12
0,407,920,3578699093,3578699112,19
0,407,921,3578699093,3578699114,21
0,407,922,3578699093,3578699117,24
0,407,923,3578699093,3578699125,32
0,407,924,3578699093,3578699134,41
0,407,925,3578699093,3578699142,49
0,407,926,3578699093,3578699143,50
0,408,927,3578699144,3578699144,0
0,408,928,3578699144,3578699154,10
0,408,929,3578699144,3578699155,11
0,408,930,3578699144,3578699159,15
0,408,931,3578699144,3578699164,20
0,408,932,3578699144,3578699165,21
0,408,933,3578699144,3578699169,25
0,408,934,3578699144,3578699174,30
0,408,935,3578699144,3578699179,35
0,408,936,3578699144,3578699181,37
0,408,937,3578699144,3578699184,40
0,408,938,3578699144,3578699187,43
0,408,939,3578699144,3578699189,45
0,408,940,3578699144,3578699194,50
0,409,941,3578699196,3578699198,2
0,409,942,3578699196,3578699201,5
0,409,943,3578699196,3578699202,6
0,409,944,3578699196,3578699204,8
0,409,945,3578699196,3578699207,11
0,409,946,3578699196,3578699213,17
0,409,947,3578699196,3578699215,19
0,409,948,3578699196,3578699225,29
0,409,949,3578699196,3578699228,32
0,409,950,3578699196,3578699235,39
0,410,951,3578699246,3578699249,3
0,410,952,3578699246,3578699255,9
0,410,953,3578699246,3578699259,13
0,410,954,3578699246,3578699263,17
0,410,955,3578699246,3578699267,21
0,410,956,3578699246,3578699275,29
0,410,957,3578699246,3578699284,38
0,410,958,3578699246,3578699288,42
0,410,959,3578699246,3578699289,43
0,410,960,3578699246,3578699292,46
0,411,961,3578699297,3578699303,6
0,411,962,3578699297,3578699304,7
0,411,963,3578699297,3578699305,8
0,411,964,3578699297,3578699305,8
0,411,965,3578699297,3578699311,14
0,411,966,3578699297,3578699315,18
0,411,967,3578699297,3578699317,20
0,411,968,3578699297,3578699324,27
0,411,969,3578699297,3578699333,36
0,411,970,3578699297,3578699343,46
0,411,971,3578699297,3578699343,46
0,411,972,3578699297,3578699343,46
0,412,973,3578699348,3578699354,6
0,412,974,3578699348,3578699356,8
0,412,975,3578699348,3578699356,8
0,412,976,3578699348,3578699359,11
0,412,977,3578699348,3578699364,16
0,412,978,3578699348,3578699365,17
0,412,979,3578699348,3578699369,21
0,412,980,3578699348,3578699374,26
0,412,981,3578699348,3578699379,31
0,412,982,3578699348,3578699381,33
0,412,983,3578699348,3578699384,36
0,412,984,3578699348,3578699387,39
0,412,985,3578699348,3578699390,42
0,412,986,3578699348,3578699394,46
0,412,987,3578699348,3578699398,50
0,413,988,3578699399,3578699401,2
0,413,989,3578699399,3578699402,3
0,413,990,3578699399,3578699406,7
0,413,991,3578699399,3578699407,8
0,413,992,3578699399,3578699414,15
0,413,993,3578699399,3578699415,16
0,413,994,3578699399,3578699416,17
0,413,995,3578699399,3578699425,26
0,413,996,3578699399,3578699429,30
0,413,997,3578699399,3578699434,35
0,414,998,3578699451,3578699451,0
0,414,999,3578699451,3578699457,6
0,414,1000,3578699451,3578699460,9
0,414,1001,3578699451,3578699463,12
0,414,1002,3578699451,3578699466,15
0,414,1003,3578699451,3578699476,25
0,414,1004,3578699451,3578699484,33
0,414,1005,3578699451,3578699488,37
0,414,1006,3578699451,3578699489,38
0,414,1007,3578699451,3578699492,41
0,415,1008,3578699502,3578699502,0
0,415,1009,3578699502,3578699504,2
0,415,1010,3578699502,3578699505,3
0,415,1011,3578699502,3578699508,6
0,415,1012,3578699502,3578699510,8
0,415,1013,3578699502,3578699513,11
0,415,1014,3578699502,3578699517,15
0,415,1015,3578699502,3578699524,22
0,415,1016,3578699502,3578699533,31
0,415,1017,3578699502,3578699542,40
0,415,1018,3578699502,3578699542,40
0,415,1019,3578699502,3578699543,41
0,416,1020,3578699553,3578699554,1
0,416,1021,3578699553,3578699555,2
0,416,1022,3578699553,3578699557,4
0,416,1023,3578699553,3578699558,5
0,416,1024,3578699553,3578699564,11
0,416,1025,3578699553,3578699564,11
0,416,1026,3578699553,3578699569,16
0,416,1027,3578699553,3578699572,19
0,416,1028,3578699553,3578699578,25
0,416,1029,3578699553,3578699579,26
0,416,1030,3578699553,3578699583,30
0,416,1031,3578699553,3578699586,33
0,416,1032,3578699553,3578699588,35
0,416,1033,3578699553,3578699593,40
0,416,1034,3578699553,3578699597,44
0,416,1035,3578699553,3578699601,48
0,416,1036,3578699553,3578699601,48
0,417,1037,3578699604,3578699605,1
0,417,1038,3578699604,3578699606,2
0,417,1039,3578699604,3578699609,5
0,417,1040,3578699604,3578699612,8
0,417,1041,3578699604,3578699614,10
0,417,1042,3578699604,3578699615,11
0,417,1043,3578699604,3578699625,21
0,417,1044,3578699604,3578699628,24
0,417,1045,3578699604,3578699634,30
0,417,1046,3578699604,3578699649,45
0,418,1047,3578699655,3578699659,4
0,418,1048,3578699655,3578699659,4
0,418,1049,3578699655,3578699662,7
0,418,1050,3578699655,3578699666,11
0,418,1051,3578699655,3578699676,21
0,418,1052,3578699655,3578699684,29
0,418,1053,3578699655,3578699688,33
0,418,1054,3578699655,3578699689,34
0,418,1055,3578699655,3578699692,37
0,418,1056,3578699655,3578699702,47
0,418,1057,3578699655,3578699704,49
0,418,1058,3578699655,3578699704,49
0,419,1059,3578699706,3578699710,4
0,419,1060,3578699706,3578699711,5
0,419,1061,3578699706,3578699713,7
0,419,1062,3578699706,3578699718,12
0,419,1063,3578699706,3578699725,19
0,419,1064,3578699706,3578699734,28
0,419,1065,3578699706,3578699742,36
0,419,1066,3578699706,3578699742,36
0,419,1067,3578699706,3578699743,37
0,419,1068,3578699706,3578699754,48
0,419,1069,3578699706,3578699755,49
0,420,1070,3578699757,3578699758,1
0,420,1071,3578699757,3578699758,1
0,420,1072,3578699757,3578699761,4
0,420,1073,3578699757,3578699763,6
0,420,1074,3578699757,3578699764,7
0,420,1075,3578699757,3578699769,12
0,420,1076,3578699757,3578699773,16
0,420,1077,3578699757,3578699779,22
0,420,1078,3578699757,3578699780,23
0,420,1079,3578699757,3578699783,26
0,420,1080,3578699757,3578699787,30
0,420,1081,3578699757,3578699788,31
0,420,1082,3578699757,3578699793,36
0,420,1083,3578699757,3578699797,40
0,420,1084,3578699757,3578699800,43
0,420,1085,3578699757,3578699801,44
0,420,1086,3578699757,3578699806,49
0,420,1087,3578699757,3578699806,49
0,421,1088,3578699808,3578699811,3
0,421,1089,3578699808,3578699813,5
0,421,1090,3578699808,3578699814,6
0,421,1091,3578699808,3578699815,7
0,421,1092,3578699808,3578699824,16
0,421,1093,3578699808,3578699827,19
0,421,1094,3578699808,3578699834,26
0,421,1095,3578699808,3578699849,41
0,422,1096,3578699860,3578699860,0
0,422,1097,3578699860,3578699862,2
0,422,1098,3578699860,3578699862,2
0,422,1099,3578699860,3578699865,5
0,422,1100,3578699860,3578699875,15
0,422,1101,3578699860,3578699884,24
0,422,1102,3578699860,3578699888,28
0,422,1103,3578699860,3578699890,30
0,422,1104,3578699860,3578699892,32
0,422,1105,3578699860,3578699902,42
0,422,1106,3578699860,3578699904,44
0,422,1107,3578699860,3578699904,44
0,423,1108,3578699912,3578699912,0
0,423,1109,3578699912,3578699912,0
0,423,1110,3578699912,3578699913,1
0,423,1111,3578699912,3578699917,5
0,423,1112,3578699912,3578699924,12
0,423,1113,3578699912,3578699934,22
0,423,1114,3578699912,3578699942,30
0,423,1115,3578699912,3578699942,30
0,423,1116,3578699912,3578699943,31
0,423,1117,3578699912,3578699953,41
0,423,1118,3578699912,3578699955,43
0,423,1119,3578699912,3578699958,46
0,423,1120,3578699912,3578699958,46
0,424,1121,3578699963,3578699964,1
0,424,1122,3578699963,3578699964,1
0,424,1123,3578699963,3578699965,2
0,424,1124,3578699963,3578699969,6
0,424,1125,3578699963,3578699973,10
0,424,1126,3578699963,3578699979,16
0,424,1127,3578699963,3578699980,17
0,424,1128,3578699963,3578699984,21
0,424,1129,3578699963,3578699986,23
0,424,1130,3578699963,3578699988,25
0,424,1131,3578699963,3578699993,30
0,424,1132,3578699963,3578699997,34
0,424,1133,3578699963,3578700000,37
0,424,1134,3578699963,3578700001,38
0,424,1135,3578699963,3578700005,42
0,424,1136,3578699963,3578700006,43
0,425,1137,3578700014,3578700014,0
0,425,1138,3578700014,3578700014,0
0,425,1139,3578700014,3578700015,1
0,425,1140,3578700014,3578700015,1
0,425,1141,3578700014,3578700024,10
0,425,1142,3578700014,3578700028,14
0,425,1143,3578700014,3578700034,20
0,425,1144,3578700014,3578700050,36
0,425,1145,3578700014,3578700060,46
0,425,1146,3578700014,3578700062,48
0,425,1147,3578700014,3578700064,50
0,426,1148,3578700065,3578700065,0
0,426,1149,3578700065,3578700076,11
0,426,1150,3578700065,3578700084,19
0,426,1151,3578700065,3578700087,22
0,426,1152,3578700065,3578700089,24
0,426,1153,3578700065,3578700093,28
0,426,1154,3578700065,3578700102,37
0,426,1155,3578700065,3578700104,39
0,426,1156,3578700065,3578700105,40
0,426,1157,3578700065,3578700111,46
0,426,1158,3578700065,3578700114,49
0,427,1159,3578700117,3578700117,0
0,427,1160,3578700117,3578700118,1
0,427,1161,3578700117,3578700124,7
0,427,1162,3578700117,3578700134,17
0,427,1163,3578700117,3578700142,25
0,427,1164,3578700117,3578700143,26
0,427,1165,3578700117,3578700154,37
0,427,1166,3578700117,3578700155,38
0,427,1167,3578700117,3578700157,40
0,427,1168,3578700117,3578700158,41
0,427,1169,3578700117,3578700163,46
0,427,1170,3578700117,3578700164,47
0,427,1171,3578700117,3578700165,48
0,427,1172,3578700117,3578700166,49
0,428,1173,3578700168,3578700169,1
0,428,1174,3578700168,3578700173,5
0,428,1175,3578700168,3578700180,12
0,428,1176,3578700168,3578700180,12
0,428,1177,3578700168,3578700183,15
0,428,1178,3578700168,3578700186,18
0,428,1179,3578700168,3578700188,20
0,428,1180,3578700168,3578700193,25
0,428,1181,3578700168,3578700197,29
0,428,1182,3578700168,3578700201,33
0,428,1183,3578700168,3578700201,33
0,428,1184,3578700168,3578700205,37
0,428,1185,3578700168,3578700206,38
0,428,1186,3578700168,3578700214,46
0,428,1187,3578700168,3578700215,47
0,428,1188,3578700168,3578700215,47
0,428,1189,3578700168,3578700217,49
0,429,1190,3578700219,3578700224,5
0,429,1191,3578700219,3578700229,10
0,429,1192,3578700219,3578700234,15
0,429,1193,3578700219,3578700250,31
0,429,1194,3578700219,3578700260,41
0,429,1195,3578700219,3578700263,44
0,429,1196,3578700219,3578700266,47
0,429,1197,3578700219,3578700267,48
0,430,1198,3578700271,3578700277,6
0,430,1199,3578700271,3578700284,13
0,430,1200,3578700271,3578700288,17
0,430,1201,3578700271,3578700289,18
0,430,1202,3578700271,3578700292,21
0,430,1203,3578700271,3578700302,31
0,430,1204,3578700271,3578700304,33
0,430,1205,3578700271,3578700305,34
0,430,1206,3578700271,3578700312,41
0,430,1207,3578700271,3578700315,44
0,430,1208,3578700271,3578700317,46
0,430,1209,3578700271,3578700318,47
0,431,1210,3578700322,3578700324,2
0,431,1211,3578700322,3578700334,12
0,431,1212,3578700322,3578700343,21
0,431,1213,3578700322,3578700343,21
0,431,1214,3578700322,3578700353,31
0,431,1215,3578700322,3578700356,34
0,431,1216,3578700322,3578700358,36
0,431,1217,3578700322,3578700358,36
0,431,1218,3578700322,3578700363,41
0,431,1219,3578700322,3578700364,42
0,431,1220,3578700322,3578700365,43
0,431,1221,3578700322,3578700368,46
0,431,1222,3578700322,3578700369,47
0,432,1223,3578700373,3578700373,0
0,432,1224,3578700373,3578700381,8
0,432,1225,3578700373,3578700381,8
0,432,1226,3578700373,3578700383,10
0,432,1227,3578700373,3578700387,14
0,432,1228,3578700373,3578700389,16
0,432,1229,3578700373,3578700394,21
0,432,1230,3578700373,3578700397,24
0,432,1231,3578700373,3578700401,28
0,432,1232,3578700373,3578700401,28
0,432,1233,3578700373,3578700405,32
0,432,1234,3578700373,3578700406,33
0,432,1235,3578700373,3578700414,41
0,432,1236,3578700373,3578700415,42
0,432,1237,3578700373,3578700415,42
0,432,1238,3578700373,3578700419,46
0,433,1239,3578700424,3578700424,0
0,433,1240,3578700424,3578700429,5
0,433,1241,3578700424,3578700434,10
0,433,1242,3578700424,3578700450,26
0,433,1243,3578700424,3578700460,36
0,433,1244,3578700424,3578700463,39
0,433,1245,3578700424,3578700466,42
0,433,1246,3578700424,3578700469,45
0,434,1247,3578700475,3578700478,3
0,434,1248,3578700475,3578700483,8
0,434,1249,3578700475,3578700486,11
0,434,1250,3578700475,3578700488,13
0,434,1251,3578700475,3578700492,17
0,434,1252,3578700475,3578700501,26
0,434,1253,3578700475,3578700503,28
0,434,1254,3578700475,3578700505,30
0,434,1255,3578700475,3578700510,35
0,434,1256,3578700475,3578700514,39
0,434,1257,3578700475,3578700517,42
0,434,1258,3578700475,3578700520,45
0,434,1259,3578700475,3578700524,49
0,435,1260,3578700526,3578700534,8
0,435,1261,3578700526,3578700542,16
0,435,1262,3578700526,3578700542,16
0,435,1263,3578700526,3578700543,17
0,435,1264,3578700526,3578700553,27
0,435,1265,3578700526,3578700555,29
0,435,1266,3578700526,3578700557,31
0,435,1267,3578700526,3578700558,32
0,435,1268,3578700526,3578700562,36
0,435,1269,3578700526,3578700563,37
0,435,1270,3578700526,3578700564,38
0,435,1271,3578700526,3578700569,43
0,435,1272,3578700526,3578700570,44
0,435,1273,3578700526,3578700571,45
0,436,1274,3578700577,3578700580,3
0,436,1275,3578700577,3578700580,3
0,436,1276,3578700577,3578700583,6
0,436,1277,3578700577,3578700586,9
0,436,1278,3578700577,3578700588,11
0,436,1279,3578700577,3578700593,16
0,436,1280,3578700577,3578700596,19
0,436,1281,3578700577,3578700600,23
0,436,1282,3578700577,3578700600,23
0,436,1283,3578700577,3578700605,28
0,436,1284,3578700577,3578700613,36
0,436,1285,3578700577,3578700614,37
0,436,1286,3578700577,3578700614,37
0,436,1287,3578700577,3578700621,44
0,436,1288,3578700577,3578700623,46
0,437,1289,3578700629,3578700629,0
0,437,1290,3578700629,3578700633,4
0,437,1291,3578700629,3578700649,20
0,437,1292,3578700629,3578700659,30
0,437,1293,3578700629,3578700663,34
0,437,1294,3578700629,3578700665,36
0,437,1295,3578700629,3578700671,42
0,437,1296,3578700629,3578700678,49
0,438,1297,3578700680,3578700683,3
0,438,1298,3578700680,3578700686,6
0,438,1299,3578700680,3578700688,8
0,438,1300,3578700680,3578700693,13
0,438,1301,3578700680,3578700703,23
0,438,1302,3578700680,3578700704,24
0,438,1303,3578700680,3578700711,31
0,438,1304,3578700680,3578700713,33
0,438,1305,3578700680,3578700718,38
0,438,1306,3578700680,3578700719,39
0,438,1307,3578700680,3578700722,42
0,438,1308,3578700680,3578700724,44
0,439,1309,3578700732,3578700733,1
0,439,1310,3578700732,3578700742,10
0,439,1311,3578700732,3578700742,10
0,439,1312,3578700732,3578700742,10
0,439,1313,3578700732,3578700752,20
0,439,1314,3578700732,3578700755,23
0,439,1315,3578700732,3578700757,25
0,439,1316,3578700732,3578700758,26
0,439,1317,3578700732,3578700762,30
0,439,1318,3578700732,3578700763,31
0,439,1319,3578700732,3578700764,32
0,439,1320,3578700732,3578700769,37
0,439,1321,3578700732,3578700773,41
0,439,1322,3578700732,3578700773,41
0,439,1323,3578700732,3578700779,47
0,439,1324,3578700732,3578700780,48
0,440,1325,3578700783,3578700783,0
0,440,1326,3578700783,3578700787,4
0,440,1327,3578700783,3578700787,4
0,440,1328,3578700783,3578700793,10
0,440,1329,3578700783,3578700796,13
0,440,1330,3578700783,3578700800,17
0,440,1331,3578700783,3578700801,18
0,440,1332,3578700783,3578700806,23
0,440,1333,3578700783,3578700813,30
0,440,1334,3578700783,3578700815,32
0,440,1335,3578700783,3578700815,32
0,440,1336,3578700783,3578700823,40
0,440,1337,3578700783,3578700824,41
0,440,1338,3578700783,3578700827,44
0,441,1339,3578700834,3578700834,0
0,441,1340,3578700834,3578700850,16
0,441,1341,3578700834,3578700860,26
0,441,1342,3578700834,3578700862,28
0,441,1343,3578700834,3578700866,32
0,441,1344,3578700834,3578700871,37
0,441,1345,3578700834,3578700874,40
0,441,1346,3578700834,3578700877,43
0,441,1347,3578700834,3578700883,49
0,442,1348,3578700885,3578700888,3
0,442,1349,3578700885,3578700888,3
0,442,1350,3578700885,3578700893,8
0,442,1351,3578700885,3578700903,18
0,442,1352,3578700885,3578700904,19
0,442,1353,3578700885,3578700911,26
0,442,1354,3578700885,3578700913,28
0,442,1355,3578700885,3578700918,33
0,442,1356,3578700885,3578700919,34
0,442,1357,3578700885,3578700924,39
0,442,1358,3578700885,3578700924,39
0,442,1359,3578700885,3578700934,49
0,443,1360,3578700937,3578700942,5
0,443,1361,3578700937,3578700942,5
0,443,1362,3578700937,3578700942,5
0,443,1363,3578700937,3578700952,15
0,443,1364,3578700937,3578700955,18
0,443,1365,3578700937,3578700957,20
0,443,1366,3578700937,3578700958,21
0,443,1367,3578700937,3578700962,25
0,443,1368,3578700937,3578700963,26
0,443,1369,3578700937,3578700964,27
0,443,1370,3578700937,3578700969,32
0,443,1371,3578700937,3578700972,35
0,443,1372,3578700937,3578700973,36
0,443,1373,3578700937,3578700975,38
0,443,1374,3578700937,3578700979,42
0,443,1375,3578700937,3578700980,43
0,443,1376,3578700937,3578700983,46
0,443,1377,3578700937,3578700987,50
0,444,1378,3578700989,3578700989,0
0,444,1379,3578700989,3578700993,4
0,444,1380,3578700989,3578700996,7
0,444,1381,3578700989,3578701001,12
0,444,1382,3578700989,3578701002,13
0,444,1383,3578700989,3578701006,17
0,444,1384,3578700989,3578701006,17
0,444,1385,3578700989,3578701013,24
0,444,1386,3578700989,3578701014,25
0,444,1387,3578700989,3578701015,26
0,444,1388,3578700989,3578701024,35
0,444,1389,3578700989,3578701026,37
0,444,1390,3578700989,3578701027,38
0,444,1391,3578700989,3578701033,44
0,445,1392,3578701041,3578701049,8
0,445,1393,3578701041,3578701060,19
0,445,1394,3578701041,3578701062,21
0,445,1395,3578701041,3578701065,24
0,445,1396,3578701041,3578701072,31
0,445,1397,3578701041,3578701074,33
0,445,1398,3578701041,3578701076,35
0,445,1399,3578701041,3578701077,36
0,445,1400,3578701041,3578701083,42
0,445,1401,3578701041,3578701088,47
0,445,1402,3578701041,3578701088,47
0,446,1403,3578701093,3578701093,0
0,446,1404,3578701093,3578701102,9
0,446,1405,3578701093,3578701104,11
0,446,1406,3578701093,3578701104,11
0,446,1407,3578701093,3578701110,17
0,446,1408,3578701093,3578701115,22
0,446,1409,3578701093,3578701117,24
0,446,1410,3578701093,3578701120,27
0,446,1411,3578701093,3578701125,32
0,446,1412,3578701093,3578701127,34
0,446,1413,3578701093,3578701133,40
0,446,1414,3578701093,3578701142,49
0,446,1415,3578701093,3578701142,49
0,446,1416,3578701093,3578701142,49
0,447,1417,3578701145,3578701153,8
0,447,1418,3578701145,3578701155,10
0,447,1419,3578701145,3578701157,12
0,447,1420,3578701145,3578701158,13
0,447,1421,3578701145,3578701162,17
0,447,1422,3578701145,3578701163,18
0,447,1423,3578701145,3578701165,20
0,447,1424,3578701145,3578701170,25
0,447,1425,3578701145,3578701173,28
0,447,1426,3578701145,3578701173,28
0,447,1427,3578701145,3578701175,30
0,447,1428,3578701145,3578701177,32
0,447,1429,3578701145,3578701179,34
0,447,1430,3578701145,3578701179,34
0,447,1431,3578701145,3578701183,38
0,447,1432,3578701145,3578701187,42
0,447,1433,3578701145,3578701188,43
0,447,1434,3578701145,3578701192,47
0,448,1435,3578701197,3578701197,0
0,448,1436,3578701197,3578701201,4
0,448,1437,3578701197,3578701201,4
0,448,1438,3578701197,3578701205,8
0,448,1439,3578701197,3578701205,8
0,448,1440,3578701197,3578701213,16
0,448,1441,3578701197,3578701215,18
0,448,1442,3578701197,3578701215,18
0,448,1443,3578701197,3578701223,26
0,448,1444,3578701197,3578701228,31
0,448,1445,3578701197,3578701228,31
0,448,1446,3578701197,3578701233,36
0,449,1447,3578701249,3578701250,1
0,449,1448,3578701249,3578701260,11
0,449,1449,3578701249,3578701263,14
0,449,1450,3578701249,3578701267,18
0,449,1451,3578701249,3578701271,22
0,449,1452,3578701249,3578701274,25
0,449,1453,3578701249,3578701278,29
0,449,1454,3578701249,3578701278,29
0,449,1455,3578701249,3578701283,34
0,449,1456,3578701249,3578701288,39
0,449,1457,3578701249,3578701288,39
0,449,1458,3578701249,3578701293,44
0,450,1459,3578701300,3578701302,2
0,450,1460,3578701300,3578701304,4
0,450,1461,3578701300,3578701306,6
0,450,1462,3578701300,3578701310,10
0,450,1463,3578701300,3578701314,14
0,450,1464,3578701300,3578701317,17
0,450,1465,3578701300,3578701319,19
0,450,1466,3578701300,3578701325,25
0,450,1467,3578701300,3578701329,29
0,450,1468,3578701300,3578701334,34
0,450,1469,3578701300,3578701343,43
0,450,1470,3578701300,3578701343,43
0,450,1471,3578701300,3578701343,43
0,451,1472,3578701352,3578701353,1
0,451,1473,3578701352,3578701356,4
0,451,1474,3578701352,3578701358,6
0,451,1475,3578701352,3578701358,6
0,451,1476,3578701352,3578701362,10
0,451,1477,3578701352,3578701363,11
0,451,1478,3578701352,3578701365,13
0,451,1479,3578701352,3578701369,17
0,451,1480,3578701352,3578701373,21
0,451,1481,3578701352,3578701373,21
0,451,1482,3578701352,3578701375,23
0,451,1483,3578701352,3578701379,27
0,451,1484,3578701352,3578701380,28
0,451,1485,3578701352,3578701381,29
0,451,1486,3578701352,3578701384,32
0,451,1487,3578701352,3578701387,35
0,451,1488,3578701352,3578701388,36
0,451,1489,3578701352,3578701393,41
0,451,1490,3578701352,3578701396,44
0,451,1491,3578701352,3578701401,49
0,451,1492,3578701352,3578701401,49
0,452,1493,3578701404,3578701406,2
0,452,1494,3578701404,3578701406,2
0,452,1495,3578701404,3578701412,8
0,452,1496,3578701404,3578701416,12
0,452,1497,3578701404,3578701423,19
0,452,1498,3578701404,3578701429,25
0,452,1499,3578701404,3578701430,26
0,452,1500,3578701404,3578701433,29
0,452,1501,3578701404,3578701450,46
0,453,1502,3578701455,3578701460,5
0,453,1503,3578701455,3578701463,8
0,453,1504,3578701455,3578701466,11
0,453,1505,3578701455,3578701472,17
0,453,1506,3578701455,3578701474,19
0,453,1507,3578701455,3578701477,22
0,453,1508,3578701455,3578701481,26
0,453,1509,3578701455,3578701483,28
0,453,1510,3578701455,3578701488,33
0,453,1511,3578701455,3578701488,33
0,453,1512,3578701455,3578701494,39
0,453,1513,3578701455,3578701502,47
0,454,1514,3578701507,3578701507,0
0,454,1515,3578701507,3578701510,3
0,454,1516,3578701507,3578701514,7
0,454,1517,3578701507,3578701517,10
0,454,1518,3578701507,3578701519,12
0,454,1519,3578701507,3578701524,17
0,454,1520,3578701507,3578701531,24
0,454,1521,3578701507,3578701532,25
0,454,1522,3578701507,3578701541,34
0,454,1523,3578701507,3578701542,35
0,454,1524,3578701507,3578701542,35
0,454,1525,3578701507,3578701552,45
0,454,1526,3578701507,3578701555,48
0,454,1527,3578701507,3578701556,49
0,455,1528,3578701559,3578701559,0
0,455,1529,3578701559,3578701561,2
0,455,1530,3578701559,3578701563,4
0,455,1531,3578701559,3578701564,5
0,455,1532,3578701559,3578701569,10
0,455,1533,3578701559,3578701572,13
0,455,1534,3578701559,3578701572,13
0,455,1535,3578701559,3578701574,15
0,455,1536,3578701559,3578701578,19
0,455,1537,3578701559,3578701579,20
0,455,1538,3578701559,3578701582,23
0,455,1539,3578701559,3578701583,24
0,455,1540,3578701559,3578701586,27
0,455,1541,3578701559,3578701587,28
0,455,1542,3578701559,3578701593,34
0,455,1543,3578701559,3578701595,36
0,455,1544,3578701559,3578701600,41
0,455,1545,3578701559,3578701601,42
0,455,1546,3578701559,3578701605,46
0,455,1547,3578701559,3578701606,47
0,456,1548,3578701611,3578701611,0
0,456,1549,3578701611,3578701614,3
0,456,1550,3578701611,3578701627,16
0,456,1551,3578701611,3578701632,21
0,456,1552,3578701611,3578701633,22
0,456,1553,3578701611,3578701648,37
0,456,1554,3578701611,3578701659,48
0,457,1555,3578701662,3578701662,0
0,457,1556,3578701662,3578701665,3
0,457,1557,3578701662,3578701672,10
0,457,1558,3578701662,3578701674,12
0,457,1559,3578701662,3578701677,15
0,457,1560,3578701662,3578701683,21
0,457,1561,3578701662,3578701684,22
0,457,1562,3578701662,3578701688,26
0,457,1563,3578701662,3578701688,26
0,457,1564,3578701662,3578701694,32
0,457,1565,3578701662,3578701702,40
0,457,1566,3578701662,3578701704,42
0,457,1567,3578701662,3578701707,45
0,457,1568,3578701662,3578701711,49
0,458,1569,3578701714,3578701714,0
0,458,1570,3578701714,3578701717,3
0,458,1571,3578701714,3578701719,5
0,458,1572,3578701714,3578701724,10
0,458,1573,3578701714,3578701732,18
0,458,1574,3578701714,3578701734,20
0,458,1575,3578701714,3578701741,27
0,458,1576,3578701714,3578701742,28
0,458,1577,3578701714,3578701742,28
0,458,1578,3578701714,3578701752,38
0,458,1579,3578701714,3578701755,41
0,458,1580,3578701714,3578701757,43
0,458,1581,3578701714,3578701757,43
0,458,1582,3578701714,3578701761,47
0,458,1583,3578701714,3578701763,49
0,459,1584,3578701766,3578701766,0
0,459,1585,3578701766,3578701769,3
0,459,1586,3578701766,3578701772,6
0,459,1587,3578701766,3578701773,7
0,459,1588,3578701766,3578701773,7
0,459,1589,3578701766,3578701778,12
0,459,1590,3578701766,3578701779,13
0,459,1591,3578701766,3578701782,16
0,459,1592,3578701766,3578701783,17
0,459,1593,3578701766,3578701784,18
0,459,1594,3578701766,3578701787,21
0,459,1595,3578701766,3578701787,21
0,459,1596,3578701766,3578701793,27
0,459,1597,3578701766,3578701795,29
0,459,1598,3578701766,3578701800,34
0,459,1599,3578701766,3578701801,35
0,459,1600,3578701766,3578701805,39
0,459,1601,3578701766,3578701805,39
0,459,1602,3578701766,3578701811,45
0,459,1603,3578701766,3578701815,49
0,460,1604,3578701817,3578701828,11
0,460,1605,3578701817,3578701833,16
0,460,1606,3578701817,3578701833,16
0,460,1607,3578701817,3578701835,18
0,460,1608,3578701817,3578701850,33
0,460,1609,3578701817,3578701859,42
0,460,1610,3578701817,3578701862,45
0,460,1611,3578701817,3578701865,48
0,461,1612,3578701869,3578701872,3
0,461,1613,3578701869,3578701874,5
0,461,1614,3578701869,3578701878,9
0,461,1615,3578701869,3578701884,15
0,461,1616,3578701869,3578701886,17
0,461,1617,3578701869,3578701888,19
0,461,1618,3578701869,3578701888,19
0,461,1619,3578701869,3578701894,25
0,461,1620,3578701869,3578701903,34
0,461,1621,3578701869,3578701905,36
0,461,1622,3578701869,3578701907,38
0,461,1623,3578701869,3578701910,41
0,461,1624,3578701869,3578701913,44
0,461,1625,3578701869,3578701917,48
0,461,1626,3578701869,3578701918,49
0,462,1627,3578701921,3578701925,4
0,462,1628,3578701921,3578701932,11
0,462,1629,3578701921,3578701936,15
0,462,1630,3578701921,3578701941,20
0,462,1631,3578701921,3578701942,21
0,462,1632,3578701921,3578701942,21
0,462,1633,3578701921,3578701951,30
0,462,1634,3578701921,3578701955,34
0,462,1635,3578701921,3578701956,35
0,462,1636,3578701921,3578701958,37
0,462,1637,3578701921,3578701961,40
0,462,1638,3578701921,3578701963,42
0,462,1639,3578701921,3578701964,43
0,462,1640,3578701921,3578701969,48
0,463,1641,3578701972,3578701972,0
0,463,1642,3578701972,3578701973,1
0,463,1643,3578701972,3578701974,2
0,463,1644,3578701972,3578701978,6
0,463,1645,3578701972,3578701980,8
0,463,1646,3578701972,3578701982,10
0,463,1647,3578701972,3578701983,11
0,463,1648,3578701972,3578701986,14
0,463,1649,3578701972,3578701987,15
0,463,1650,3578701972,3578701988,16
0,463,1651,3578701972,3578701992,20
0,463,1652,3578701972,3578701996,24
0,463,1653,3578701972,3578702001,29
0,463,1654,3578701972,3578702001,29
0,463,1655,3578701972,3578702005,33
0,463,1656,3578701972,3578702006,34
0,463,1657,3578701972,3578702013,41
0,463,1658,3578701972,3578702015,43
0,463,1659,3578701972,3578702015,43
0,464,1660,3578702024,3578702024,0
0,464,1661,3578702024,3578702028,4
0,464,1662,3578702024,3578702033,9
0,464,1663,3578702024,3578702033,9
0,464,1664,3578702024,3578702037,13
0,464,1665,3578702024,3578702049,25
0,464,1666,3578702024,3578702059,35
0,464,1667,3578702024,3578702063,39
0,464,1668,3578702024,3578702065,41
0,464,1669,3578702024,3578702072,48
0,465,1670,3578702076,3578702076,0
0,465,1671,3578702076,3578702078,2
0,465,1672,3578702076,3578702084,8
0,465,1673,3578702076,3578702087,11
0,465,1674,3578702076,3578702088,12
0,465,1675,3578702076,3578702088,12
0,465,1676,3578702076,3578702094,18
0,465,1677,3578702076,3578702103,27
0,465,1678,3578702076,3578702105,29
0,465,1679,3578702076,3578702106,30
0,465,1680,3578702076,3578702111,35
0,465,1681,3578702076,3578702114,38
0,465,1682,3578702076,3578702117,41
0,465,1683,3578702076,3578702118,42
0,465,1684,3578702076,3578702125,49
0,466,1685,3578702127,3578702133,6
0,466,1686,3578702127,3578702136,9
0,466,1687,3578702127,3578702139,12
0,466,1688,3578702127,3578702142,15
0,466,1689,3578702127,3578702142,15
0,466,1690,3578702127,3578702143,16
0,466,1691,3578702127,3578702153,26
0,466,1692,3578702127,3578702155,28
0,466,1693,3578702127,3578702156,29
0,466,1694,3578702127,3578702158,31
0,466,1695,3578702127,3578702162,35
0,466,1696,3578702127,3578702163,36
0,466,1697,3578702127,3578702165,38
0,466,1698,3578702127,3578702169,42
0,466,1699,3578702127,3578702172,45
0,466,1700,3578702127,3578702173,46
0,466,1701,3578702127,3578702174,47
0,467,1702,3578702179,3578702179,0
0,467,1703,3578702179,3578702180,1
0,467,1704,3578702179,3578702182,3
0,467,1705,3578702179,3578702183,4
0,467,1706,3578702179,3578702187,8
0,467,1707,3578702179,3578702189,10
0,467,1708,3578702179,3578702189,10
0,467,1709,3578702179,3578702193,14
0,467,1710,3578702179,3578702195,16
0,467,1711,3578702179,3578702201,22
0,467,1712,3578702179,3578702201,22
0,467,1713,3578702179,3578702205,26
0,467,1714,3578702179,3578702206,27
0,467,1715,3578702179,3578702213,34
0,467,1716,3578702179,3578702215,36
0,467,1717,3578702179,3578702215,36
0,467,1718,3578702179,3578702223,44
0,467,1719,3578702179,3578702228,49
0,468,1720,3578702230,3578702232,2
0,468,1721,3578702230,3578702233,3
0,468,1722,3578702230,3578702240,10
0,468,1723,3578702230,3578702250,20
0,468,1724,3578702230,3578702259,29
0,468,1725,3578702230,3578702263,33
0,468,1726,3578702230,3578702267,37
0,468,1727,3578702230,3578702271,41
0,468,1728,3578702230,3578702273,43
0,468,1729,3578702230,3578702278,48
0,469,1730,3578702282,3578702284,2
0,469,1731,3578702282,3578702288,6
0,469,1732,3578702282,3578702288,6
0,469,1733,3578702282,3578702288,6
0,469,1734,3578702282,3578702290,8
0,469,1735,3578702282,3578702294,12
0,469,1736,3578702282,3578702303,21
0,469,1737,3578702282,3578702305,23
0,469,1738,3578702282,3578702306,24
0,469,1739,3578702282,3578702310,28
0,469,1740,3578702282,3578702315,33
0,469,1741,3578702282,3578702317,35
0,469,1742,3578702282,3578702319,37
0,469,1743,3578702282,3578702325,43
0,470,1744,3578702334,3578702334,0
0,470,1745,3578702334,3578702336,2
0,470,1746,3578702334,3578702341,7
0,470,1747,3578702334,3578702341,7
0,470,1748,3578702334,3578702343,9
0,470,1749,3578702334,3578702343,9
0,470,1750,3578702334,3578702352,18
0,470,1751,3578702334,3578702356,22
0,470,1752,3578702334,3578702358,24
0,470,1753,3578702334,3578702361,27
0,470,1754,3578702334,3578702363,29
0,470,1755,3578702334,3578702365,31
0,470,1756,3578702334,3578702369,35
0,470,1757,3578702334,3578702371,37
0,470,1758,3578702334,3578702373,39
0,470,1759,3578702334,3578702374,40
0,470,1760,3578702334,3578702379,45
0,470,1761,3578702334,3578702381,47
0,470,1762,3578702334,3578702382,48
0,470,1763,3578702334,3578702383,49
0,471,1764,3578702386,3578702387,1
0,471,1765,3578702386,3578702389,3
0,471,1766,3578702386,3578702392,6
0,471,1767,3578702386,3578702394,8
0,471,1768,3578702386,3578702395,9
0,471,1769,3578702386,3578702401,15
0,471,1770,3578702386,3578702401,15
0,471,1771,3578702386,3578702405,19
0,471,1772,3578702386,3578702407,21
0,471,1773,3578702386,3578702413,27
0,471,1774,3578702386,3578702415,29
0,471,1775,3578702386,3578702415,29
0,471,1776,3578702386,3578702423,37
0,471,1777,3578702386,3578702428,42
0,471,1778,3578702386,3578702432,46
0,471,1779,3578702386,3578702433,47
0,472,1780,3578702438,3578702440,2
0,472,1781,3578702438,3578702442,4
0,472,1782,3578702438,3578702450,12
0,472,1783,3578702438,3578702459,21
0,472,1784,3578702438,3578702464,26
0,472,1785,3578702438,3578702466,28
0,472,1786,3578702438,3578702471,33
0,472,1787,3578702438,3578702474,36
0,472,1788,3578702438,3578702478,40
0,472,1789,3578702438,3578702484,46
0,472,1790,3578702438,3578702488,50
0,473,1791,3578702489,3578702489,0
0,473,1792,3578702489,3578702490,1
0,473,1793,3578702489,3578702493,4
0,473,1794,3578702489,3578702493,4
0,473,1795,3578702489,3578702503,14
0,473,1796,3578702489,3578702504,15
0,473,1797,3578702489,3578702506,17
0,473,1798,3578702489,3578702509,20
0,473,1799,3578702489,3578702513,24
0,473,1800,3578702489,3578702515,26
0,473,1801,3578702489,3578702517,28
0,473,1802,3578702489,3578702525,36
0,473,1803,3578702489,3578702532,43
0,473,1804,3578702489,3578702535,46
0,474,1805,3578702541,3578702541,0
0,474,1806,3578702541,3578702541,0
0,474,1807,3578702541,3578702542,1
0,474,1808,3578702541,3578702542,1
0,474,1809,3578702541,3578702543,2
0,474,1810,3578702541,3578702552,11
0,474,1811,3578702541,3578702556,15
0,474,1812,3578702541,3578702558,17
0,474,1813,3578702541,3578702560,19
0,474,1814,3578702541,3578702562,21
0,474,1815,3578702541,3578702564,23
0,474,1816,3578702541,3578702569,28
0,474,1817,3578702541,3578702570,29
0,474,1818,3578702541,3578702572,31
0,474,1819,3578702541,3578702573,32
0,474,1820,3578702541,3578702579,38
0,474,1821,3578702541,3578702580,39
0,474,1822,3578702541,3578702582,41
0,474,1823,3578702541,3578702584,43
0,474,1824,3578702541,3578702585,44
0,474,1825,3578702541,3578702587,46
0,475,1826,3578702593,3578702593,0
0,475,1827,3578702593,3578702594,1
0,475,1828,3578702593,3578702595,2
0,475,1829,3578702593,3578702600,7
0,475,1830,3578702593,3578702601,8
0,475,1831,3578702593,3578702605,12
0,475,1832,3578702593,3578702606,13
0,475,1833,3578702593,3578702611,18
0,475,1834,3578702593,3578702614,21
0,475,1835,3578702593,3578702615,22
0,475,1836,3578702593,3578702623,30
0,475,1837,3578702593,3578702628,35
0,475,1838,3578702593,3578702632,39
0,475,1839,3578702593,3578702633,40
0,475,1840,3578702593,3578702639,46
0,476,1841,3578702645,3578702645,0
0,476,1842,3578702645,3578702648,3
0,476,1843,3578702645,3578702659,14
0,476,1844,3578702645,3578702662,17
0,476,1845,3578702645,3578702665,20
0,476,1846,3578702645,3578702671,26
0,476,1847,3578702645,3578702674,29
0,476,1848,3578702645,3578702677,32
0,476,1849,3578702645,3578702684,39
0,476,1850,3578702645,3578702687,42
0,476,1851,3578702645,3578702689,44
0,476,1852,3578702645,3578702689,44
0,476,1853,3578702645,3578702692,47
0,476,1854,3578702645,3578702693,48
0,477,1855,3578702697,3578702697,0
0,477,1856,3578702697,3578702702,5
0,477,1857,3578702697,3578702704,7
0,477,1858,3578702697,3578702705,8
0,477,1859,3578702697,3578702711,14
0,477,1860,3578702697,3578702714,17
0,477,1861,3578702697,3578702716,19
0,477,1862,3578702697,3578702718,21
0,477,1863,3578702697,3578702724,27
0,477,1864,3578702697,3578702732,35
0,477,1865,3578702697,3578702736,39
0,477,1866,3578702697,3578702740,43
0,477,1867,3578702697,3578702741,44
0,477,1868,3578702697,3578702742,45
0,477,1869,3578702697,3578702742,45
0,477,1870,3578702697,3578702746,49
0,478,1871,3578702749,3578702752,3
0,478,1872,3578702749,3578702757,8
0,478,1873,3578702749,3578702757,8
0,478,1874,3578702749,3578702761,12
0,478,1875,3578702749,3578702762,13
0,478,1876,3578702749,3578702764,15
0,478,1877,3578702749,3578702769,20
0,478,1878,3578702749,3578702772,23
0,478,1879,3578702749,3578702773,24
0,478,1880,3578702749,3578702773,24
0,478,1881,3578702749,3578702778,29
0,478,1882,3578702749,3578702779,30
0,478,1883,3578702749,3578702782,33
0,478,1884,3578702749,3578702783,34
0,478,1885,3578702749,3578702787,38
0,478,1886,3578702749,3578702787,38
0,478,1887,3578702749,3578702793,44
0,478,1888,3578702749,3578702795,46
0,478,1889,3578702749,3578702795,46
0,478,1890,3578702749,3578702798,49
0,479,1891,3578702801,3578702801,0
0,479,1892,3578702801,3578702801,0
0,479,1893,3578702801,3578702805,4
0,479,1894,3578702801,3578702805,4
0,479,1895,3578702801,3578702811,10
0,479,1896,3578702801,3578702815,14
0,479,1897,3578702801,3578702815,14
0,479,1898,3578702801,3578702824,23
0,479,1899,3578702801,3578702828,27
0,479,1900,3578702801,3578702831,30
0,479,1901,3578702801,3578702832,31
0,479,1902,3578702801,3578702839,38
0,479,1903,3578702801,3578702849,48
0,479,1904,3578702801,3578702849,48
0,480,1905,3578702853,3578702859,6
0,480,1906,3578702853,3578702863,10
0,480,1907,3578702853,3578702865,12
0,480,1908,3578702853,3578702871,18
0,480,1909,3578702853,3578702874,21
0,480,1910,3578702853,3578702878,25
0,480,1911,3578702853,3578702883,30
0,480,1912,3578702853,3578702888,35
0,480,1913,3578702853,3578702889,36
0,480,1914,3578702853,3578702889,36
0,480,1915,3578702853,3578702893,40
0,480,1916,3578702853,3578702893,40
0,480,1917,3578702853,3578702900,47
0,480,1918,3578702853,3578702902,49
0,481,1919,3578702904,3578702905,1
0,481,1920,3578702904,3578702906,2
0,481,1921,3578702904,3578702910,6
0,481,1922,3578702904,3578702913,9
0,481,1923,3578702904,3578702915,11
0,481,1924,3578702904,3578702917,13
0,481,1925,3578702904,3578702924,20
0,481,1926,3578702904,3578702932,28
0,481,1927,3578702904,3578702935,31
0,481,1928,3578702904,3578702940,36
0,481,1929,3578702904,3578702941,37
0,481,1930,3578702904,3578702942,38
0,481,1931,3578702904,3578702942,38
0,481,1932,3578702904,3578702951,47
0,481,1933,3578702904,3578702951,47
0,482,1934,3578702956,3578702957,1
0,482,1935,3578702956,3578702958,2
0,482,1936,3578702956,3578702961,5
0,482,1937,3578702956,3578702962,6
0,482,1938,3578702956,3578702964,8
0,482,1939,3578702956,3578702970,14
0,482,1940,3578702956,3578702972,16
0,482,1941,3578702956,3578702973,17
0,482,1942,3578702956,3578702974,18
0,482,1943,3578702956,3578702978,22
0,482,1944,3578702956,3578702980,24
0,482,1945,3578702956,3578702982,26
0,482,1946,3578702956,3578702983,27
0,482,1947,3578702956,3578702987,31
0,482,1948,3578702956,3578702989,33
0,482,1949,3578702956,3578702992,36
0,482,1950,3578702956,3578702994,38
0,482,1951,3578702956,3578702995,39
0,482,1952,3578702956,3578702997,41
0,482,1953,3578702956,3578703001,45
0,482,1954,3578702956,3578703001,45
0,482,1955,3578702956,3578703002,46
0,482,1956,3578702956,3578703004,48
0,482,1957,3578702956,3578703006,50
0,483,1958,3578703008,3578703012,4
0,483,1959,3578703008,3578703014,6
0,483,1960,3578703008,3578703015,7
0,483,1961,3578703008,3578703023,15
0,483,1962,3578703008,3578703028,20
0,483,1963,3578703008,3578703032,24
0,483,1964,3578703008,3578703033,25
0,483,1965,3578703008,3578703039,31
0,483,1966,3578703008,3578703050,42
0,483,1967,3578703008,3578703051,43
0,484,1968,3578703060,3578703060,0
0,484,1969,3578703060,3578703063,3
0,484,1970,3578703060,3578703065,5
0,484,1971,3578703060,3578703071,11
0,484,1972,3578703060,3578703074,14
0,484,1973,3578703060,3578703078,18
0,484,1974,3578703060,3578703084,24
0,484,1975,3578703060,3578703088,28
0,484,1976,3578703060,3578703089,29
0,484,1977,3578703060,3578703089,29
0,484,1978,3578703060,3578703092,32
0,484,1979,3578703060,3578703093,33
0,484,1980,3578703060,3578703102,42
0,484,1981,3578703060,3578703102,42
0,484,1982,3578703060,3578703105,45
0,484,1983,3578703060,3578703106,46
0,485,1984,3578703112,3578703112,0
0,485,1985,3578703112,3578703115,3
0,485,1986,3578703112,3578703116,4
0,485,1987,3578703112,3578703117,5
0,485,1988,3578703112,3578703125,13
0,485,1989,3578703112,3578703132,20
0,485,1990,3578703112,3578703135,23
0,485,1991,3578703112,3578703141,29
0,485,1992,3578703112,3578703141,29
0,485,1993,3578703112,3578703142,30
0,485,1994,3578703112,3578703142,30
0,485,1995,3578703112,3578703152,40
0,485,1996,3578703112,3578703153,41
0,485,1997,3578703112,3578703156,44
0,485,1998,3578703112,3578703158,46
0,485,1999,3578703112,3578703161,49
0,485,2000,3578703112,3578703162,50
0,486,2001,3578703164,3578703165,1
0,486,2002,3578703164,3578703169,5
0,486,2003,3578703164,3578703171,7
0,486,2004,3578703164,3578703172,8
0,486,2005,3578703164,3578703174,10
0,486,2006,3578703164,3578703180,16
0,486,2007,3578703164,3578703181,17
0,486,2008,3578703164,3578703182,18
0,486,2009,3578703164,3578703184,20
0,486,2010,3578703164,3578703186,22
0,486,2011,3578703164,3578703188,24
0,486,2012,3578703164,3578703193,29
0,486,2013,3578703164,3578703194,30
0,486,2014,3578703164,3578703195,31
0,486,2015,3578703164,3578703197,33
0,486,2016,3578703164,3578703201,37
0,486,2017,3578703164,3578703201,37
0,486,2018,3578703164,3578703203,39
0,486,2019,3578703164,3578703204,40
0,486,2020,3578703164,3578703205,41
0,486,2021,3578703164,3578703213,49
0,487,2022,3578703216,3578703216,0
0,487,2023,3578703216,3578703216,0
0,487,2024,3578703216,3578703224,8
0,487,2025,3578703216,3578703228,12
0,487,2026,3578703216,3578703232,16
0,487,2027,3578703216,3578703233,17
0,487,2028,3578703216,3578703239,23
0,487,2029,3578703216,3578703249,33
0,487,2030,3578703216,3578703254,38
0,487,2031,3578703216,3578703256,40
0,487,2032,3578703216,3578703259,43
0,487,2033,3578703216,3578703263,47
0,488,2034,3578703269,3578703269,0
0,488,2035,3578703269,3578703271,2
0,488,2036,3578703269,3578703273,4
0,488,2037,3578703269,3578703277,8
0,488,2038,3578703269,3578703284,15
0,488,2039,3578703269,3578703288,19
0,488,2040,3578703269,3578703289,20
0,488,2041,3578703269,3578703289,20
0,488,2042,3578703269,3578703293,24
0,488,2043,3578703269,3578703293,24
0,488,2044,3578703269,3578703302,33
0,488,2045,3578703269,3578703304,35
0,488,2046,3578703269,3578703305,36
0,488,2047,3578703269,3578703306,37
0,488,2048,3578703269,3578703311,42
0,488,2049,3578703269,3578703315,46
0,488,2050,3578703269,3578703316,47
0,488,2051,3578703269,3578703318,49
0,489,2052,3578703321,3578703324,3
0,489,2053,3578703321,3578703333,12
0,489,2054,3578703321,3578703335,14
0,489,2055,3578703321,3578703340,19
0,489,2056,3578703321,3578703341,20
0,489,2057,3578703321,3578703343,22
0,489,2058,3578703321,3578703343,22
0,489,2059,3578703321,3578703352,31
0,489,2060,3578703321,3578703353,32
0,489,2061,3578703321,3578703355,34
0,489,2062,3578703321,3578703357,36
0,489,2063,3578703321,3578703357,36
0,489,2064,3578703321,3578703361,40
0,489,2065,3578703321,3578703365,44
0,489,2066,3578703321,3578703369,48
0,490,2067,3578703373,3578703373,0
0,490,2068,3578703373,3578703374,1
0,490,2069,3578703373,3578703380,7
0,490,2070,3578703373,3578703381,8
0,490,2071,3578703373,3578703382,9
0,490,2072,3578703373,3578703383,10
0,490,2073,3578703373,3578703387,14
0,490,2074,3578703373,3578703394,21
0,490,2075,3578703373,3578703394,21
0,490,2076,3578703373,3578703395,22
0,490,2077,3578703373,3578703398,25
0,490,2078,3578703373,3578703401,28
0,490,2079,3578703373,3578703402,29
0,490,2080,3578703373,3578703406,33
0,490,2081,3578703373,3578703406,33
0,490,2082,3578703373,3578703407,34
0,490,2083,3578703373,3578703413,40
0,490,2084,3578703373,3578703415,42
0,490,2085,3578703373,3578703416,43
0,491,2086,3578703425,3578703425,0
0,491,2087,3578703425,3578703428,3
0,491,2088,3578703425,3578703432,7
0,491,2089,3578703425,3578703433,8
0,491,2090,3578703425,3578703439,14
0,491,2091,3578703425,3578703449,24
0,491,2092,3578703425,3578703454,29
0,491,2093,3578703425,3578703456,31
0,491,2094,3578703425,3578703457,32
0,491,2095,3578703425,3578703459,34
0,491,2096,3578703425,3578703462,37
0,491,2097,3578703425,3578703466,41
0,491,2098,3578703425,3578703471,46
0,491,2099,3578703425,3578703473,48
0,492,2100,3578703477,3578703478,1
0,492,2101,3578703477,3578703483,6
0,492,2102,3578703477,3578703487,10
0,492,2103,3578703477,3578703488,11
0,492,2104,3578703477,3578703489,12
0,492,2105,3578703477,3578703491,14
0,492,2106,3578703477,3578703492,15
0,492,2107,3578703477,3578703501,24
0,492,2108,3578703477,3578703504,27
0,492,2109,3578703477,3578703505,28
0,492,2110,3578703477,3578703507,30
0,492,2111,3578703477,3578703511,34
0,492,2112,3578703477,3578703515,38
0,492,2113,3578703477,3578703515,38
0,492,2114,3578703477,3578703518,41
0,492,2115,3578703477,3578703523,46
0,493,2116,3578703529,3578703532,3
0,493,2117,3578703529,3578703534,5
0,493,2118,3578703529,3578703539,10
0,493,2119,3578703529,3578703541,12
0,493,2120,3578703529,3578703542,13
0,493,2121,3578703529,3578703542,13
0,493,2122,3578703529,3578703551,22
0,493,2123,3578703529,3578703552,23
0,493,2124,3578703529,3578703556,27
0,493,2125,3578703529,3578703557,28
0,493,2126,3578703529,3578703558,29
0,493,2127,3578703529,3578703560,31
0,493,2128,3578703529,3578703563,34
0,493,2129,3578703529,3578703569,40
0,493,2130,3578703529,3578703570,41
0,493,2131,3578703529,3578703573,44
0,493,2132,3578703529,3578703579,50
0,494,2133,3578703581,3578703581,0
0,494,2134,3578703581,3578703582,1
0,494,2135,3578703581,3578703583,2
0,494,2136,3578703581,3578703586,5
0,494,2137,3578703581,3578703588,7
0,494,2138,3578703581,3578703593,12
0,494,2139,3578703581,3578703593,12
0,494,2140,3578703581,3578703596,15
0,494,2141,3578703581,3578703597,16
0,494,2142,3578703581,3578703600,19
0,494,2143,3578703581,3578703601,20
0,494,2144,3578703581,3578703605,24
0,494,2145,3578703581,3578703607,26
0,494,2146,3578703581,3578703608,27
0,494,2147,3578703581,3578703612,31
0,494,2148,3578703581,3578703614,33
0,494,2149,3578703581,3578703622,41
0,494,2150,3578703581,3578703628,47
0,494,2151,3578703581,3578703631,50
0,495,2152,3578703633,3578703633,0
0,495,2153,3578703633,3578703638,5
0,495,2154,3578703633,3578703648,15
0,495,2155,3578703633,3578703654,21
0,495,2156,3578703633,3578703656,23
0,495,2157,3578703633,3578703656,23
0,495,2158,3578703633,3578703658,25
0,495,2159,3578703633,3578703659,26
0,495,2160,3578703633,3578703662,29
0,495,2161,3578703633,3578703665,32
0,495,2162,3578703633,3578703669,36
0,495,2163,3578703633,3578703674,41
0,495,2164,3578703633,3578703678,45
0,496,2165,3578703685,3578703685,0
0,496,2166,3578703685,3578703686,1
0,496,2167,3578703685,3578703688,3
0,496,2168,3578703685,3578703688,3
0,496,2169,3578703685,3578703691,6
0,496,2170,3578703685,3578703692,7
0,496,2171,3578703685,3578703702,17
0,496,2172,3578703685,3578703704,19
0,496,2173,3578703685,3578703705,20
0,496,2174,3578703685,3578703709,24
0,496,2175,3578703685,3578703710,25
0,496,2176,3578703685,3578703714,29
0,496,2177,3578703685,3578703714,29
0,496,2178,3578703685,3578703717,32
0,496,2179,3578703685,3578703724,39
0,496,2180,3578703685,3578703733,48
0,496,2181,3578703685,3578703734,49
0,497,2182,3578703737,3578703740,3
0,497,2183,3578703737,3578703740,3
0,497,2184,3578703737,3578703742,5
0,497,2185,3578703737,3578703742,5
0,497,2186,3578703737,3578703751,14
0,497,2187,3578703737,3578703752,15
0,497,2188,3578703737,3578703756,19
0,497,2189,3578703737,3578703758,21
0,497,2190,3578703737,3578703760,23
0,497,2191,3578703737,3578703762,25
0,497,2192,3578703737,3578703764,27
0,497,2193,3578703737,3578703769,32
0,497,2194,3578703737,3578703771,34
0,497,2195,3578703737,3578703772,35
0,497,2196,3578703737,3578703773,36
0,497,2197,3578703737,3578703779,42
0,497,2198,3578703737,3578703780,43
0,497,2199,3578703737,3578703781,44
0,497,2200,3578703737,3578703783,46
0,497,2201,3578703737,3578703786,49
0,498,2202,3578703789,3578703789,0
0,498,2203,3578703789,3578703793,4
0,498,2204,3578703789,3578703793,4
0,498,2205,3578703789,3578703796,7
0,498,2206,3578703789,3578703797,8
0,498,2207,3578703789,3578703801,12
0,498,2208,3578703789,3578703801,12
0,498,2209,3578703789,3578703805,16
0,498,2210,3578703789,3578703807,18
0,498,2211,3578703789,3578703810,21
0,498,2212,3578703789,3578703812,23
0,498,2213,3578703789,3578703815,26
0,498,2214,3578703789,3578703824,35
0,498,2215,3578703789,3578703828,39
0,498,2216,3578703789,3578703831,42
0,498,2217,3578703789,3578703833,44
0,498,2218,3578703789,3578703838,49
0,499,2219,3578703840,3578703850,10
0,499,2220,3578703840,3578703854,14
0,499,2221,3578703840,3578703856,16
0,499,2222,3578703840,3578703856,16
0,499,2223,3578703840,3578703859,19
0,499,2224,3578703840,3578703861,21
0,499,2225,3578703840,3578703863,23
0,499,2226,3578703840,3578703865,25
0,499,2227,3578703840,3578703870,30
0,499,2228,3578703840,3578703874,34
0,499,2229,3578703840,3578703877,37
0,499,2230,3578703840,3578703883,43
0,499,2231,3578703840,3578703888,48
0,499,2232,3578703840,3578703888,48
0,499,2233,3578703840,3578703888,48
0,500,2234,3578703892,3578703892,0
0,500,2235,3578703892,3578703892,0
0,500,2236,3578703892,3578703903,11
0,500,2237,3578703892,3578703905,13
0,500,2238,3578703892,3578703905,13
0,500,2239,3578703892,3578703910,18
0,500,2240,3578703892,3578703910,18
0,500,2241,3578703892,3578703912,20
0,500,2242,3578703892,3578703914,22
0,500,2243,3578703892,3578703914,22
0,500,2244,3578703892,3578703917,25
0,500,2245,3578703892,3578703925,33
0,500,2246,3578703892,3578703933,41
0,500,2247,3578703892,3578703935,43
0,500,2248,3578703892,3578703940,48
0,500,2249,3578703892,3578703941,49
0,501,2250,3578703943,3578703943,0
0,501,2251,3578703943,3578703943,0
0,501,2252,3578703943,3578703952,9
0,501,2253,3578703943,3578703952,9
0,501,2254,3578703943,3578703956,13
0,501,2255,3578703943,3578703958,15
0,501,2256,3578703943,3578703960,17
0,501,2257,3578703943,3578703961,18
0,501,2258,3578703943,3578703962,19
0,501,2259,3578703943,3578703964,21
0,501,2260,3578703943,3578703969,26
0,501,2261,3578703943,3578703972,29
0,501,2262,3578703943,3578703972,29
0,501,2263,3578703943,3578703974,31
0,501,2264,3578703943,3578703978,35
0,501,2265,3578703943,3578703979,36
0,501,2266,3578703943,3578703981,38
0,501,2267,3578703943,3578703983,40
0,501,2268,3578703943,3578703987,44
0,501,2269,3578703943,3578703988,45
0,502,2270,3578703995,3578703995,0
0,502,2271,3578703995,3578703995,0
0,502,2272,3578703995,3578703996,1
0,502,2273,3578703995,3578703997,2
0,502,2274,3578703995,3578704001,6
0,502,2275,3578703995,3578704001,6
0,502,2276,3578703995,3578704005,10
0,502,2277,3578703995,3578704006,11
0,502,2278,3578703995,3578704013,18
0,502,2279,3578703995,3578704013,18
0,502,2280,3578703995,3578704015,20
0,502,2281,3578703995,3578704015,20
0,502,2282,3578703995,3578704023,28
0,502,2283,3578703995,3578704029,34
0,502,2284,3578703995,3578704031,36
0,502,2285,3578703995,3578704033,38
0,502,2286,3578703995,3578704038,43
0,503,2287,3578704047,3578704049,2
0,503,2288,3578704047,3578704054,7
0,503,2289,3578704047,3578704056,9
0,503,2290,3578704047,3578704056,9
0,503,2291,3578704047,3578704059,12
0,503,2292,3578704047,3578704064,17
0,503,2293,3578704047,3578704064,17
0,503,2294,3578704047,3578704065,18
0,503,2295,3578704047,3578704070,23
0,503,2296,3578704047,3578704074,27
0,503,2297,3578704047,3578704078,31
0,503,2298,3578704047,3578704083,36
0,503,2299,3578704047,3578704088,41
0,503,2300,3578704047,3578704088,41
0,503,2301,3578704047,3578704088,41
0,503,2302,3578704047,3578704092,45
0,503,2303,3578704047,3578704092,45
0,504,2304,3578704098,3578704102,4
0,504,2305,3578704098,3578704104,6
0,504,2306,3578704098,3578704105,7
0,504,2307,3578704098,3578704109,11
0,504,2308,3578704098,3578704110,12
0,504,2309,3578704098,3578704114,16
0,504,2310,3578704098,3578704114,16
0,504,2311,3578704098,3578704115,17
0,504,2312,3578704098,3578704118,20
0,504,2313,3578704098,3578704125,27
0,504,2314,3578704098,3578704133,35
0,504,2315,3578704098,3578704135,37
0,504,2316,3578704098,3578704140,42
0,504,2317,3578704098,3578704140,42
0,504,2318,3578704098,3578704142,44
0,504,2319,3578704098,3578704142,44
0,505,2320,3578704150,3578704152,2
0,505,2321,3578704150,3578704153,3
0,505,2322,3578704150,3578704157,7
0,505,2323,3578704150,3578704157,7
0,505,2324,3578704150,3578704160,10
0,505,2325,3578704150,3578704161,11
0,505,2326,3578704150,3578704162,12
0,505,2327,3578704150,3578704165,15
0,505,2328,3578704150,3578704165,15
0,505,2329,3578704150,3578704169,19
0,505,2330,3578704150,3578704172,22
0,505,2331,3578704150,3578704173,23
0,505,2332,3578704150,3578704174,24
0,505,2333,3578704150,3578704179,29
0,505,2334,3578704150,3578704180,30
0,505,2335,3578704150,3578704181,31
0,505,2336,3578704150,3578704183,33
0,505,2337,3578704150,3578704187,37
0,505,2338,3578704150,3578704189,39
0,505,2339,3578704150,3578704193,43
0,505,2340,3578704150,3578704196,46
0,505,2341,3578704150,3578704197,47
0,506,2342,3578704202,3578704202,0
0,506,2343,3578704202,3578704202,0
0,506,2344,3578704202,3578704205,3
0,506,2345,3578704202,3578704207,5
0,506,2346,3578704202,3578704213,11
0,506,2347,3578704202,3578704215,13
0,506,2348,3578704202,3578704215,13
0,506,2349,3578704202,3578704216,14
0,506,2350,3578704202,3578704223,21
0,506,2351,3578704202,3578704228,26
0,506,2352,3578704202,3578704231,29
0,506,2353,3578704202,3578704233,31
0,506,2354,3578704202,3578704239,37
0,506,2355,3578704202,3578704250,48
0,507,2356,3578704254,3578704254,0
0,507,2357,3578704254,3578704256,2
0,507,2358,3578704254,3578704256,2
0,507,2359,3578704254,3578704259,5
0,507,2360,3578704254,3578704263,9
0,507,2361,3578704254,3578704266,12
0,507,2362,3578704254,3578704267,13
0,507,2363,3578704254,3578704270,16
0,507,2364,3578704254,3578704274,20
0,507,2365,3578704254,3578704279,25
0,507,2366,3578704254,3578704284,30
0,507,2367,3578704254,3578704288,34
0,507,2368,3578704254,3578704288,34
0,507,2369,3578704254,3578704288,34
0,507,2370,3578704254,3578704291,37
0,507,2371,3578704254,3578704293,39
0,507,2372,3578704254,3578704302,48
0,508,2373,3578704306,3578704306,0
0,508,2374,3578704306,3578704306,0
0,508,2375,3578704306,3578704309,3
0,508,2376,3578704306,3578704310,4
0,508,2377,3578704306,3578704315,9
0,508,2378,3578704306,3578704316,10
0,508,2379,3578704306,3578704317,11
0,508,2380,3578704306,3578704318,12
0,508,2381,3578704306,3578704324,18
0,508,2382,3578704306,3578704334,28
0,508,2383,3578704306,3578704335,29
0,508,2384,3578704306,3578704340,34
0,508,2385,3578704306,3578704341,35
0,508,2386,3578704306,3578704343,37
0,508,2387,3578704306,3578704343,37
0,508,2388,3578704306,3578704352,46
0,508,2389,3578704306,3578704353,47
0,509,2390,3578704358,3578704358,0
0,509,2391,3578704358,3578704358,0
0,509,2392,3578704358,3578704360,2
0,509,2393,3578704358,3578704361,3
0,509,2394,3578704358,3578704362,4
0,509,2395,3578704358,3578704365,7
0,509,2396,3578704358,3578704367,9
0,509,2397,3578704358,3578704370,12
0,509,2398,3578704358,3578704372,14
0,509,2399,3578704358,3578704373,15
0,509,2400,3578704358,3578704374,16
0,509,2401,3578704358,3578704379,21
0,509,2402,3578704358,3578704381,23
0,509,2403,3578704358,3578704381,23
0,509,2404,3578704358,3578704383,25
0,509,2405,3578704358,3578704387,29
0,509,2406,3578704358,3578704389,31
0,509,2407,3578704358,3578704393,35
0,509,2408,3578704358,3578704393,35
0,509,2409,3578704358,3578704396,38
0,509,2410,3578704358,3578704396,38
0,509,2411,3578704358,3578704402,44
0,509,2412,3578704358,3578704405,47
0,509,2413,3578704358,3578704407,49
0,510,2414,3578704410,3578704413,3
0,510,2415,3578704410,3578704415,5
0,510,2416,3578704410,3578704416,6
0,510,2417,3578704410,3578704418,8
0,510,2418,3578704410,3578704424,14
0,510,2419,3578704410,3578704428,18
0,510,2420,3578704410,3578704431,21
0,510,2421,3578704410,3578704433,23
0,510,2422,3578704410,3578704439,29
0,510,2423,3578704410,3578704449,39
0,510,2424,3578704410,3578704454,44
0,510,2425,3578704410,3578704457,47
0,510,2426,3578704410,3578704457,47
0,510,2427,3578704410,3578704459,49
0,511,2428,3578704462,3578704464,2
0,511,2429,3578704462,3578704466,4
0,511,2430,3578704462,3578704467,5
0,511,2431,3578704462,3578704468,6
0,511,2432,3578704462,3578704470,8
0,511,2433,3578704462,3578704474,12
0,511,2434,3578704462,3578704480,18
0,511,2435,3578704462,3578704484,22
0,511,2436,3578704462,3578704488,26
0,511,2437,3578704462,3578704488,26
0,511,2438,3578704462,3578704488,26
0,511,2439,3578704462,3578704492,30
0,511,2440,3578704462,3578704493,31
0,511,2441,3578704462,3578704502,40
0,511,2442,3578704462,3578704505,43
0,511,2443,3578704462,3578704505,43
0,511,2444,3578704462,3578704510,48
0,511,2445,3578704462,3578704511,49
0,512,2446,3578704514,3578704514,0
0,512,2447,3578704514,3578704515,1
0,512,2448,3578704514,3578704516,2
0,512,2449,3578704514,3578704518,4
0,512,2450,3578704514,3578704519,5
0,512,2451,3578704514,3578704523,9
0,512,2452,3578704514,3578704532,18
0,512,2453,3578704514,3578704534,20
0,512,2454,3578704514,3578704539,25
0,512,2455,3578704514,3578704539,25
0,512,2456,3578704514,3578704542,28
0,512,2457,3578704514,3578704542,28
0,512,2458,3578704514,3578704551,37
0,512,2459,3578704514,3578704552,38
0,512,2460,3578704514,3578704557,43
0,512,2461,3578704514,3578704558,44
0,512,2462,3578704514,3578704559,45
0,512,2463,3578704514,3578704560,46
0,512,2464,3578704514,3578704561,47
0,512,2465,3578704514,3578704564,50
0,513,2466,3578704566,3578704569,3
0,513,2467,3578704566,3578704570,4
0,513,2468,3578704566,3578704570,4
0,513,2469,3578704566,3578704571,5
0,513,2470,3578704566,3578704573,7
0,513,2471,3578704566,3578704578,12
0,513,2472,3578704566,3578704580,14
0,513,2473,3578704566,3578704580,14
0,513,2474,3578704566,3578704583,17
0,513,2475,3578704566,3578704586,20
0,513,2476,3578704566,3578704587,21
0,513,2477,3578704566,3578704592,26
0,513,2478,3578704566,3578704593,27
0,513,2479,3578704566,3578704595,29
0,513,2480,3578704566,3578704596,30
0,513,2481,3578704566,3578704600,34
0,513,2482,3578704566,3578704605,39
0,513,2483,3578704566,3578704605,39
0,513,2484,3578704566,3578704612,46
0,513,2485,3578704566,3578704614,48
0,513,2486,3578704566,3578704616,50
0,514,2487,3578704618,3578704620,2
0,514,2488,3578704618,3578704622,4
0,514,2489,3578704618,3578704628,10
0,514,2490,3578704618,3578704631,13
0,514,2491,3578704618,3578704632,14
0,514,2492,3578704618,3578704637,19
0,514,2493,3578704618,3578704649,31
0,514,2494,3578704618,3578704653,35
0,514,2495,3578704618,3578704655,37
0,514,2496,3578704618,3578704656,38
0,514,2497,3578704618,3578704659,41
0,514,2498,3578704618,3578704662,44
0,514,2499,3578704618,3578704665,47
0,514,2500,3578704618,3578704667,49
0,515,2501,3578704671,3578704671,0
0,515,2502,3578704671,3578704671,0
0,515,2503,3578704671,3578704671,0
0,515,2504,3578704671,3578704674,3
0,515,2505,3578704671,3578704680,9
0,515,2506,3578704671,3578704684,13
0,515,2507,3578704671,3578704688,17
0,515,2508,3578704671,3578704688,17
0,515,2509,3578704671,3578704689,18
0,515,2510,3578704671,3578704692,21
0,515,2511,3578704671,3578704692,21
0,515,2512,3578704671,3578704702,31
0,515,2513,3578704671,3578704705,34
0,515,2514,3578704671,3578704705,34
0,515,2515,3578704671,3578704710,39
0,515,2516,3578704671,3578704711,40
0,515,2517,3578704671,3578704714,43
0,515,2518,3578704671,3578704716,45
0,515,2519,3578704671,3578704716,45
0,515,2520,3578704671,3578704718,47
0,516,2521,3578704723,3578704723,0
0,516,2522,3578704723,3578704724,1
0,516,2523,3578704723,3578704732,9
0,516,2524,3578704723,3578704734,11
0,516,2525,3578704723,3578704739,16
0,516,2526,3578704723,3578704739,16
0,516,2527,3578704723,3578704742,19
0,516,2528,3578704723,3578704743,20
0,516,2529,3578704723,3578704752,29
0,516,2530,3578704723,3578704752,29
0,516,2531,3578704723,3578704757,34
0,516,2532,3578704723,3578704759,36
0,516,2533,3578704723,3578704759,36
0,516,2534,3578704723,3578704762,39
0,516,2535,3578704723,3578704762,39
0,516,2536,3578704723,3578704764,41
0,516,2537,3578704723,3578704769,46
0,516,2538,3578704723,3578704772,49
0,516,2539,3578704723,3578704772,49
0,516,2540,3578704723,3578704772,49
0,516,2541,3578704723,3578704773,50
0,517,2542,3578704775,3578704778,3
0,517,2543,3578704775,3578704780,5
0,517,2544,3578704775,3578704781,6
0,517,2545,3578704775,3578704783,8
0,517,2546,3578704775,3578704787,12
0,517,2547,3578704775,3578704788,13
0,517,2548,3578704775,3578704792,17
0,517,2549,3578704775,3578704793,18
0,517,2550,3578704775,3578704795,20
0,517,2551,3578704775,3578704796,21
0,517,2552,3578704775,3578704800,25
0,517,2553,3578704775,3578704801,26
0,517,2554,3578704775,3578704804,29
0,517,2555,3578704775,3578704806,31
0,517,2556,3578704775,3578704812,37
0,517,2557,3578704775,3578704815,40
0,517,2558,3578704775,3578704823,48
0,517,2559,3578704775,3578704824,49
0,518,2560,3578704827,3578704828,1
0,518,2561,3578704827,3578704831,4
0,518,2562,3578704827,3578704833,6
0,518,2563,3578704827,3578704838,11
0,518,2564,3578704827,3578704849,22
0,518,2565,3578704827,3578704853,26
0,518,2566,3578704827,3578704855,28
0,518,2567,3578704827,3578704856,29
0,518,2568,3578704827,3578704859,32
0,518,2569,3578704827,3578704862,35
0,518,2570,3578704827,3578704865,38
0,518,2571,3578704827,3578704866,39
0,518,2572,3578704827,3578704868,41
0,518,2573,3578704827,3578704871,44
0,518,2574,3578704827,3578704871,44
0,518,2575,3578704827,3578704874,47
0,518,2576,3578704827,3578704875,48
0,519,2577,3578704879,3578704880,1
0,519,2578,3578704879,3578704885,6
0,519,2579,3578704879,3578704888,9
0,519,2580,3578704879,3578704888,9
0,519,2581,3578704879,3578704888,9
0,519,2582,3578704879,3578704892,13
0,519,2583,3578704879,3578704893,14
0,519,2584,3578704879,3578704903,24
0,519,2585,3578704879,3578704905,26
0,519,2586,3578704879,3578704905,26
0,519,2587,3578704879,3578704911,32
0,519,2588,3578704879,3578704911,32
0,519,2589,3578704879,3578704915,36
0,519,2590,3578704879,3578704916,37
0,519,2591,3578704879,3578704916,37
0,519,2592,3578704879,3578704918,39
0,519,2593,3578704879,3578704924,45
0,519,2594,3578704879,3578704925,46
0,520,2595,3578704931,3578704932,1
0,520,2596,3578704931,3578704935,4
0,520,2597,3578704931,3578704939,8
0,520,2598,3578704931,3578704939,8
0,520,2599,3578704931,3578704942,11
0,520,2600,3578704931,3578704943,12
0,520,2601,3578704931,3578704952,21
0,520,2602,3578704931,3578704952,21
0,520,2603,3578704931,3578704955,24
0,520,2604,3578704931,3578704956,25
0,520,2605,3578704931,3578704959,28
0,520,2606,3578704931,3578704959,28
0,520,2607,3578704931,3578704961,30
0,520,2608,3578704931,3578704961,30
0,520,2609,3578704931,3578704964,33
0,520,2610,3578704931,3578704970,39
0,520,2611,3578704931,3578704971,40
0,520,2612,3578704931,3578704973,42
0,520,2613,3578704931,3578704974,43
0,520,2614,3578704931,3578704975,44
0,520,2615,3578704931,3578704979,48
0,520,2616,3578704931,3578704980,49
0,521,2617,3578704983,3578704983,0
0,521,2618,3578704983,3578704984,1
0,521,2619,3578704983,3578704986,3
0,521,2620,3578704983,3578704989,6
0,521,2621,3578704983,3578704992,9
0,521,2622,3578704983,3578704994,11
0,521,2623,3578704983,3578704995,12
0,521,2624,3578704983,3578704997,14
0,521,2625,3578704983,3578705001,18
0,521,2626,3578704983,3578705005,22
0,521,2627,3578704983,3578705006,23
0,521,2628,3578704983,3578705013,30
0,521,2629,3578704983,3578705015,32
0,521,2630,3578704983,3578705023,40
0,521,2631,3578704983,3578705025,42
0,521,2632,3578704983,3578705029,46
0,521,2633,3578704983,3578705031,48
0,522,2634,3578705035,3578705035,0
0,522,2635,3578705035,3578705038,3
0,522,2636,3578705035,3578705050,15
0,522,2637,3578705035,3578705053,18
0,522,2638,3578705035,3578705055,20
0,522,2639,3578705035,3578705056,21
0,522,2640,3578705035,3578705059,24
0,522,2641,3578705035,3578705063,28
0,522,2642,3578705035,3578705065,30
0,522,2643,3578705035,3578705066,31
0,522,2644,3578705035,3578705067,32
0,522,2645,3578705035,3578705071,36
0,522,2646,3578705035,3578705071,36
0,522,2647,3578705035,3578705075,40
0,522,2648,3578705035,3578705076,41
0,522,2649,3578705035,3578705081,46
0,522,2650,3578705035,3578705084,49
0,523,2651,3578705087,3578705088,1
0,523,2652,3578705087,3578705088,1
0,523,2653,3578705087,3578705089,2
0,523,2654,3578705087,3578705092,5
0,523,2655,3578705087,3578705092,5
0,523,2656,3578705087,3578705103,16
0,523,2657,3578705087,3578705105,18
0,523,2658,3578705087,3578705106,19
0,523,2659,3578705087,3578705110,23
0,523,2660,3578705087,3578705111,24
0,523,2661,3578705087,3578705115,28
0,523,2662,3578705087,3578705116,29
0,523,2663,3578705087,3578705116,29
0,523,2664,3578705087,3578705118,31
0,523,2665,3578705087,3578705124,37
0,523,2666,3578705087,3578705127,40
0,523,2667,3578705087,3578705133,46
0,523,2668,3578705087,3578705136,49
0,524,2669,3578705139,3578705139,0
0,524,2670,3578705139,3578705141,2
0,524,2671,3578705139,3578705153,14
0,524,2672,3578705139,3578705153,14
0,524,2673,3578705139,3578705155,16
0,524,2674,3578705139,3578705157,18
0,524,2675,3578705139,3578705158,19
0,524,2676,3578705139,3578705158,19
0,524,2677,3578705139,3578705161,22
0,524,2678,3578705139,3578705162,23
0,524,2679,3578705139,3578705165,26
0,524,2680,3578705139,3578705170,31
0,524,2681,3578705139,3578705172,33
0,524,2682,3578705139,3578705173,34
0,524,2683,3578705139,3578705174,35
0,524,2684,3578705139,3578705177,38
0,524,2685,3578705139,3578705179,40
0,524,2686,3578705139,3578705180,41
0,524,2687,3578705139,3578705180,41
0,524,2688,3578705139,3578705184,45
0,524,2689,3578705139,3578705186,47
0,524,2690,3578705139,3578705189,50
0,525,2691,3578705191,3578705192,1
0,525,2692,3578705191,3578705194,3
0,525,2693,3578705191,3578705196,5
0,525,2694,3578705191,3578705201,10
0,525,2695,3578705191,3578705205,14
0,525,2696,3578705191,3578705205,14
0,525,2697,3578705191,3578705213,22
0,525,2698,3578705191,3578705215,24
0,525,2699,3578705191,3578705215,24
0,525,2700,3578705191,3578705223,32
0,525,2701,3578705191,3578705228,37
0,525,2702,3578705191,3578705228,37
0,525,2703,3578705191,3578705231,40
0,525,2704,3578705191,3578705233,42
0,525,2705,3578705191,3578705239,48
0,526,2706,3578705244,3578705250,6
0,526,2707,3578705244,3578705253,9
0,526,2708,3578705244,3578705255,11
0,526,2709,3578705244,3578705257,13
0,526,2710,3578705244,3578705259,15
0,526,2711,3578705244,3578705262,18
0,526,2712,3578705244,3578705265,21
0,526,2713,3578705244,3578705266,22
0,526,2714,3578705244,3578705267,23
0,526,2715,3578705244,3578705270,26
0,526,2716,3578705244,3578705271,27
0,526,2717,3578705244,3578705274,30
0,526,2718,3578705244,3578705279,35
0,526,2719,3578705244,3578705281,37
0,526,2720,3578705244,3578705284,40
0,526,2721,3578705244,3578705288,44
0,526,2722,3578705244,3578705288,44
0,526,2723,3578705244,3578705288,44
0,526,2724,3578705244,3578705291,47
0,526,2725,3578705244,3578705293,49
0,527,2726,3578705296,3578705303,7
0,527,2727,3578705296,3578705305,9
0,527,2728,3578705296,3578705305,9
0,527,2729,3578705296,3578705311,15
0,527,2730,3578705296,3578705312,16
0,527,2731,3578705296,3578705315,19
0,527,2732,3578705296,3578705315,19
0,527,2733,3578705296,3578705316,20
0,527,2734,3578705296,3578705318,22
0,527,2735,3578705296,3578705324,28
0,527,2736,3578705296,3578705326,30
0,527,2737,3578705296,3578705329,33
0,527,2738,3578705296,3578705333,37
0,527,2739,3578705296,3578705336,40
0,527,2740,3578705296,3578705340,44
0,527,2741,3578705296,3578705340,44
0,528,2742,3578705349,3578705352,3
0,528,2743,3578705349,3578705353,4
0,528,2744,3578705349,3578705356,7
0,528,2745,3578705349,3578705357,8
0,528,2746,3578705349,3578705358,9
0,528,2747,3578705349,3578705358,9
0,528,2748,3578705349,3578705361,12
0,528,2749,3578705349,3578705362,13
0,528,2750,3578705349,3578705365,16
0,528,2751,3578705349,3578705370,21
0,528,2752,3578705349,3578705372,23
0,528,2753,3578705349,3578705373,24
0,528,2754,3578705349,3578705374,25
0,528,2755,3578705349,3578705379,30
0,528,2756,3578705349,3578705380,31
0,528,2757,3578705349,3578705380,31
0,528,2758,3578705349,3578705380,31
0,528,2759,3578705349,3578705384,35
0,528,2760,3578705349,3578705387,38
0,528,2761,3578705349,3578705389,40
0,528,2762,3578705349,3578705393,44
0,528,2763,3578705349,3578705394,45
0,528,2764,3578705349,3578705395,46
0,528,2765,3578705349,3578705397,48
0,529,2766,3578705401,3578705402,1
0,529,2767,3578705401,3578705406,5
0,529,2768,3578705401,3578705406,5
0,529,2769,3578705401,3578705413,12
0,529,2770,3578705401,3578705415,14
0,529,2771,3578705401,3578705416,15
0,529,2772,3578705401,3578705423,22
0,529,2773,3578705401,3578705429,28
0,529,2774,3578705401,3578705430,29
0,529,2775,3578705401,3578705431,30
0,529,2776,3578705401,3578705433,32
0,529,2777,3578705401,3578705439,38
0,529,2778,3578705401,3578705449,48
0,530,2779,3578705454,3578705454,0
0,530,2780,3578705454,3578705456,2
0,530,2781,3578705454,3578705457,3
0,530,2782,3578705454,3578705459,5
0,530,2783,3578705454,3578705463,9
0,530,2784,3578705454,3578705465,11
0,530,2785,3578705454,3578705467,13
0,530,2786,3578705454,3578705468,14
0,530,2787,3578705454,3578705470,16
0,530,2788,3578705454,3578705471,17
0,530,2789,3578705454,3578705475,21
0,530,2790,3578705454,3578705479,25
0,530,2791,3578705454,3578705481,27
0,530,2792,3578705454,3578705481,27
0,530,2793,3578705454,3578705485,31
0,530,2794,3578705454,3578705488,34
0,530,2795,3578705454,3578705488,34
0,530,2796,3578705454,3578705489,35
0,530,2797,3578705454,3578705492,38
0,530,2798,3578705454,3578705492,38
0,530,2799,3578705454,3578705503,49
0,531,2800,3578705506,3578705506,0
0,531,2801,3578705506,3578705506,0
0,531,2802,3578705506,3578705510,4
0,531,2803,3578705506,3578705511,5
0,531,2804,3578705506,3578705514,8
0,531,2805,3578705506,3578705514,8
0,531,2806,3578705506,3578705515,9
0,531,2807,3578705506,3578705518,12
0,531,2808,3578705506,3578705523,17
0,531,2809,3578705506,3578705526,20
0,531,2810,3578705506,3578705532,26
0,531,2811,3578705506,3578705532,26
0,531,2812,3578705506,3578705535,29
0,531,2813,3578705506,3578705539,33
0,531,2814,3578705506,3578705539,33
0,531,2815,3578705506,3578705542,36
0,531,2816,3578705506,3578705542,36
0,531,2817,3578705506,3578705551,45
0,531,2818,3578705506,3578705552,46
0,531,2819,3578705506,3578705555,49
0,531,2820,3578705506,3578705556,50
0,532,2821,3578705558,3578705558,0
0,532,2822,3578705558,3578705558,0
0,532,2823,3578705558,3578705560,2
0,532,2824,3578705558,3578705560,2
0,532,2825,3578705558,3578705564,6
0,532,2826,3578705558,3578705570,12
0,532,2827,3578705558,3578705571,13
0,532,2828,3578705558,3578705572,14
0,532,2829,3578705558,3578705573,15
0,532,2830,3578705558,3578705578,20
0,532,2831,3578705558,3578705580,22
0,532,2832,3578705558,3578705580,22
0,532,2833,3578705558,3578705582,24
0,532,2834,3578705558,3578705583,25
0,532,2835,3578705558,3578705586,28
0,532,2836,3578705558,3578705588,30
0,532,2837,3578705558,3578705592,34
0,532,2838,3578705558,3578705592,34
0,532,2839,3578705558,3578705595,37
0,532,2840,3578705558,3578705595,37
0,532,2841,3578705558,3578705600,42
0,532,2842,3578705558,3578705601,43
0,532,2843,3578705558,3578705605,47
0,532,2844,3578705558,3578705606,48
0,533,2845,3578705610,3578705612,2
0,533,2846,3578705610,3578705614,4
0,533,2847,3578705610,3578705614,4
0,533,2848,3578705610,3578705621,11
0,533,2849,3578705610,3578705623,13
0,533,2850,3578705610,3578705627,17
0,533,2851,3578705610,3578705631,21
0,533,2852,3578705610,3578705633,23
0,533,2853,3578705610,3578705633,23
0,533,2854,3578705610,3578705638,28
0,533,2855,3578705610,3578705649,39
0,533,2856,3578705610,3578705652,42
0,533,2857,3578705610,3578705655,45
0,533,2858,3578705610,3578705657,47
0,533,2859,3578705610,3578705659,49
0,534,2860,3578705661,3578705662,1
0,534,2861,3578705661,3578705664,3
0,534,2862,3578705661,3578705666,5
0,534,2863,3578705661,3578705667,6
0,534,2864,3578705661,3578705669,8
0,534,2865,3578705661,3578705670,9
0,534,2866,3578705661,3578705675,14
0,534,2867,3578705661,3578705678,17
0,534,2868,3578705661,3578705681,20
0,534,2869,3578705661,3578705684,23
0,534,2870,3578705661,3578705685,24
0,534,2871,3578705661,3578705688,27
0,534,2872,3578705661,3578705688,27
0,534,2873,3578705661,3578705688,27
0,534,2874,3578705661,3578705692,31
0,534,2875,3578705661,3578705693,32
0,534,2876,3578705661,3578705703,42
0,534,2877,3578705661,3578705705,44
0,534,2878,3578705661,3578705705,44
0,534,2879,3578705661,3578705710,49
0,534,2880,3578705661,3578705711,50
0,535,2881,3578705713,3578705714,1
0,535,2882,3578705713,3578705714,1
0,535,2883,3578705713,3578705715,2
0,535,2884,3578705713,3578705718,5
0,535,2885,3578705713,3578705724,11
0,535,2886,3578705713,3578705727,14
0,535,2887,3578705713,3578705732,19
0,535,2888,3578705713,3578705733,20
0,535,2889,3578705713,3578705734,21
0,535,2890,3578705713,3578705735,22
0,535,2891,3578705713,3578705739,26
0,535,2892,3578705713,3578705739,26
0,535,2893,3578705713,3578705742,29
0,535,2894,3578705713,3578705742,29
0,535,2895,3578705713,3578705751,38
0,535,2896,3578705713,3578705752,39
0,535,2897,3578705713,3578705755,42
0,535,2898,3578705713,3578705756,43
0,535,2899,3578705713,3578705759,46
0,535,2900,3578705713,3578705759,46
0,535,2901,3578705713,3578705761,48
0,535,2902,3578705713,3578705761,48
0,536,2903,3578705765,3578705765,0
0,536,2904,3578705765,3578705769,4
0,536,2905,3578705765,3578705772,7
0,536,2906,3578705765,3578705773,8
0,536,2907,3578705765,3578705773,8
0,536,2908,3578705765,3578705778,13
0,536,2909,3578705765,3578705779,14
0,536,2910,3578705765,3578705780,15
0,536,2911,3578705765,3578705783,18
0,536,2912,3578705765,3578705785,20
0,536,2913,3578705765,3578705786,21
0,536,2914,3578705765,3578705789,24
0,536,2915,3578705765,3578705792,27
0,536,2916,3578705765,3578705793,28
0,536,2917,3578705765,3578705795,30
0,536,2918,3578705765,3578705797,32
0,536,2919,3578705765,3578705800,35
0,536,2920,3578705765,3578705800,35
0,536,2921,3578705765,3578705805,40
0,536,2922,3578705765,3578705807,42
0,536,2923,3578705765,3578705811,46
0,536,2924,3578705765,3578705815,50
0,537,2925,3578705817,3578705817,0
0,537,2926,3578705817,3578705821,4
0,537,2927,3578705817,3578705823,6
0,537,2928,3578705817,3578705828,11
0,537,2929,3578705817,3578705830,13
0,537,2930,3578705817,3578705833,16
0,537,2931,3578705817,3578705833,16
0,537,2932,3578705817,3578705835,18
0,537,2933,3578705817,3578705838,21
0,537,2934,3578705817,3578705850,33
0,537,2935,3578705817,3578705852,35
0,537,2936,3578705817,3578705854,37
0,537,2937,3578705817,3578705857,40
0,537,2938,3578705817,3578705859,42
0,537,2939,3578705817,3578705863,46
0,537,2940,3578705817,3578705864,47
0,537,2941,3578705817,3578705866,49
0,538,2942,3578705869,3578705869,0
0,538,2943,3578705869,3578705869,0
0,538,2944,3578705869,3578705870,1
0,538,2945,3578705869,3578705875,6
0,538,2946,3578705869,3578705879,10
0,538,2947,3578705869,3578705881,12
0,538,2948,3578705869,3578705885,16
0,538,2949,3578705869,3578705886,17
0,538,2950,3578705869,3578705888,19
0,538,2951,3578705869,3578705888,19
0,538,2952,3578705869,3578705888,19
0,538,2953,3578705869,3578705892,23
0,538,2954,3578705869,3578705892,23
0,538,2955,3578705869,3578705904,35
0,538,2956,3578705869,3578705905,36
0,538,2957,3578705869,3578705905,36
0,538,2958,3578705869,3578705911,42
0,538,2959,3578705869,3578705911,42
0,538,2960,3578705869,3578705913,44
0,538,2961,3578705869,3578705914,45
0,538,2962,3578705869,3578705915,46
0,538,2963,3578705869,3578705917,48
0,539,2964,3578705921,3578705925,4
0,539,2965,3578705921,3578705927,6
0,539,2966,3578705921,3578705932,11
0,539,2967,3578705921,3578705936,15
0,539,2968,3578705921,3578705937,16
0,539,2969,3578705921,3578705939,18
0,539,2970,3578705921,3578705940,19
0,539,2971,3578705921,3578705942,21
0,539,2972,3578705921,3578705942,21
0,539,2973,3578705921,3578705952,31
0,539,2974,3578705921,3578705952,31
0,539,2975,3578705921,3578705955,34
0,539,2976,3578705921,3578705956,35
0,539,2977,3578705921,3578705959,38
0,539,2978,3578705921,3578705959,38
0,539,2979,3578705921,3578705961,40
0,539,2980,3578705921,3578705961,40
0,539,2981,3578705921,3578705965,44
0,539,2982,3578705921,3578705969,48
0,540,2983,3578705973,3578705973,0
0,540,2984,3578705973,3578705973,0
0,540,2985,3578705973,3578705974,1
0,540,2986,3578705973,3578705978,5
0,540,2987,3578705973,3578705980,7
0,540,2988,3578705973,3578705980,7
0,540,2989,3578705973,3578705983,10
0,540,2990,3578705973,3578705987,14
0,540,2991,3578705973,3578705987,14
0,540,2992,3578705973,3578705989,16
0,540,2993,3578705973,3578705992,19
0,540,2994,3578705973,3578705992,19
0,540,2995,3578705973,3578705995,22
0,540,2996,3578705973,3578705996,23
0,540,2997,3578705973,3578706001,28
0,540,2998,3578705973,3578706002,29
0,540,2999,3578705973,3578706004,31
0,540,3000,3578705973,3578706007,34
0,540,3001,3578705973,3578706013,40
0,540,3002,3578705973,3578706015,42
0,540,3003,3578705973,3578706015,42
0,540,3004,3578705973,3578706021,48
0,541,3005,3578706025,3578706025,0
0,541,3006,3578706025,3578706027,2
0,541,3007,3578706025,3578706031,6
0,541,3008,3578706025,3578706033,8
0,541,3009,3578706025,3578706033,8
0,541,3010,3578706025,3578706035,10
0,541,3011,3578706025,3578706037,12
0,541,3012,3578706025,3578706038,13
0,541,3013,3578706025,3578706050,25
0,541,3014,3578706025,3578706052,27
0,541,3015,3578706025,3578706054,29
0,541,3016,3578706025,3578706057,32
0,541,3017,3578706025,3578706059,34
0,541,3018,3578706025,3578706063,38
0,541,3019,3578706025,3578706064,39
0,541,3020,3578706025,3578706066,41
0,541,3021,3578706025,3578706067,42
0,541,3022,3578706025,3578706069,44
0,541,3023,3578706025,3578706070,45
0,542,3024,3578706077,3578706077,0
0,542,3025,3578706077,3578706079,2
0,542,3026,3578706077,3578706081,4
0,542,3027,3578706077,3578706085,8
0,542,3028,3578706077,3578706086,9
0,542,3029,3578706077,3578706087,10
0,542,3030,3578706077,3578706088,11
0,542,3031,3578706077,3578706089,12
0,542,3032,3578706077,3578706089,12
0,542,3033,3578706077,3578706092,15
0,542,3034,3578706077,3578706092,15
0,542,3035,3578706077,3578706105,28
0,542,3036,3578706077,3578706105,28
0,542,3037,3578706077,3578706111,34
0,542,3038,3578706077,3578706112,35
0,542,3039,3578706077,3578706114,37
0,542,3040,3578706077,3578706114,37
0,542,3041,3578706077,3578706116,39
0,542,3042,3578706077,3578706117,40
0,542,3043,3578706077,3578706124,47
0,542,3044,3578706077,3578706126,49
0,543,3045,3578706130,3578706133,3
0,543,3046,3578706130,3578706135,5
0,543,3047,3578706130,3578706139,9
0,543,3048,3578706130,3578706140,10
0,543,3049,3578706130,3578706141,11
0,543,3050,3578706130,3578706142,12
0,543,3051,3578706130,3578706142,12
0,543,3052,3578706130,3578706151,21
0,543,3053,3578706130,3578706153,23
0,543,3054,3578706130,3578706155,25
0,543,3055,3578706130,3578706156,26
0,543,3056,3578706130,3578706158,28
0,543,3057,3578706130,3578706158,28
0,543,3058,3578706130,3578706161,31
0,543,3059,3578706130,3578706162,32
0,543,3060,3578706130,3578706165,35
0,543,3061,3578706130,3578706169,39
0,543,3062,3578706130,3578706172,42
0,543,3063,3578706130,3578706173,43
0,543,3064,3578706130,3578706174,44
0,543,3065,3578706130,3578706179,49
0,544,3066,3578706182,3578706182,0
0,544,3067,3578706182,3578706182,0
0,544,3068,3578706182,3578706183,1
0,544,3069,3578706182,3578706186,4
0,544,3070,3578706182,3578706187,5
0,544,3071,3578706182,3578706189,7
0,544,3072,3578706182,3578706190,8
0,544,3073,3578706182,3578706192,10
0,544,3074,3578706182,3578706193,11
0,544,3075,3578706182,3578706196,14
0,544,3076,3578706182,3578706197,15
0,544,3077,3578706182,3578706201,19
0,544,3078,3578706182,3578706203,21
0,544,3079,3578706182,3578706205,23
0,544,3080,3578706182,3578706207,25
0,544,3081,3578706182,3578706212,30
0,544,3082,3578706182,3578706216,34
0,544,3083,3578706182,3578706216,34
0,544,3084,3578706182,3578706221,39
0,544,3085,3578706182,3578706223,41
0,544,3086,3578706182,3578706229,47
0,544,3087,3578706182,3578706231,49
0,545,3088,3578706234,3578706234,0
0,545,3089,3578706234,3578706234,0
0,545,3090,3578706234,3578706235,1
0,545,3091,3578706234,3578706239,5
0,545,3092,3578706234,3578706240,6
0,545,3093,3578706234,3578706250,16
0,545,3094,3578706234,3578706253,19
0,545,3095,3578706234,3578706254,20
0,545,3096,3578706234,3578706258,24
0,545,3097,3578706234,3578706259,25
0,545,3098,3578706234,3578706263,29
0,545,3099,3578706234,3578706265,31
0,545,3100,3578706234,3578706266,32
0,545,3101,3578706234,3578706267,33
0,545,3102,3578706234,3578706270,36
0,545,3103,3578706234,3578706270,36
0,545,3104,3578706234,3578706275,41
0,545,3105,3578706234,3578706279,45
0,545,3106,3578706234,3578706282,48
0,546,3107,3578706286,3578706286,0
0,546,3108,3578706286,3578706286,0
0,546,3109,3578706286,3578706288,2
0,546,3110,3578706286,3578706288,2
0,546,3111,3578706286,3578706289,3
0,546,3112,3578706286,3578706290,4
0,546,3113,3578706286,3578706291,5
0,546,3114,3578706286,3578706292,6
0,546,3115,3578706286,3578706293,7
0,546,3116,3578706286,3578706305,19
0,546,3117,3578706286,3578706305,19
0,546,3118,3578706286,3578706311,25
0,546,3119,3578706286,3578706312,26
0,546,3120,3578706286,3578706314,28
0,546,3121,3578706286,3578706315,29
0,546,3122,3578706286,3578706316,30
0,546,3123,3578706286,3578706318,32
0,546,3124,3578706286,3578706324,38
0,546,3125,3578706286,3578706327,41
0,546,3126,3578706286,3578706333,47
0,546,3127,3578706286,3578706333,47
0,546,3128,3578706286,3578706336,50
0,547,3129,3578706339,3578706340,1
0,547,3130,3578706339,3578706341,2
0,547,3131,3578706339,3578706342,3
0,547,3132,3578706339,3578706343,4
0,547,3133,3578706339,3578706343,4
0,547,3134,3578706339,3578706352,13
0,547,3135,3578706339,3578706352,13
0,547,3136,3578706339,3578706356,17
0,547,3137,3578706339,3578706356,17
0,547,3138,3578706339,3578706358,19
0,547,3139,3578706339,3578706358,19
0,547,3140,3578706339,3578706361,22
0,547,3141,3578706339,3578706362,23
0,547,3142,3578706339,3578706369,30
0,547,3143,3578706339,3578706371,32
0,547,3144,3578706339,3578706373,34
0,547,3145,3578706339,3578706374,35
0,547,3146,3578706339,3578706379,40
0,547,3147,3578706339,3578706380,41
0,547,3148,3578706339,3578706381,42
0,547,3149,3578706339,3578706383,44
0,547,3150,3578706339,3578706387,48
0,547,3151,3578706339,3578706387,48
0,547,3152,3578706339,3578706389,50
0,548,3153,3578706392,3578706392,0
0,548,3154,3578706392,3578706392,0
0,548,3155,3578706392,3578706394,2
0,548,3156,3578706392,3578706395,3
0,548,3157,3578706392,3578706397,5
0,548,3158,3578706392,3578706401,9
0,548,3159,3578706392,3578706404,12
0,548,3160,3578706392,3578706406,14
0,548,3161,3578706392,3578706406,14
0,548,3162,3578706392,3578706413,21
0,548,3163,3578706392,3578706416,24
0,548,3164,3578706392,3578706416,24
0,548,3165,3578706392,3578706421,29
0,548,3166,3578706392,3578706423,31
0,548,3167,3578706392,3578706429,37
0,548,3168,3578706392,3578706432,40
0,548,3169,3578706392,3578706433,41
0,548,3170,3578706392,3578706434,42
0,548,3171,3578706392,3578706436,44
0,548,3172,3578706392,3578706439,47
0,549,3173,3578706445,3578706445,0
0,549,3174,3578706445,3578706449,4
0,549,3175,3578706445,3578706453,8
0,549,3176,3578706445,3578706455,10
0,549,3177,3578706445,3578706457,12
0,549,3178,3578706445,3578706459,14
0,549,3179,3578706445,3578706462,17
0,549,3180,3578706445,3578706465,20
0,549,3181,3578706445,3578706466,21
0,549,3182,3578706445,3578706467,22
0,549,3183,3578706445,3578706470,25
0,549,3184,3578706445,3578706470,25
0,549,3185,3578706445,3578706475,30
0,549,3186,3578706445,3578706479,34
0,549,3187,3578706445,3578706482,37
0,549,3188,3578706445,3578706486,41
0,549,3189,3578706445,3578706487,42
0,549,3190,3578706445,3578706488,43
0,549,3191,3578706445,3578706488,43
0,549,3192,3578706445,3578706489,44
0,549,3193,3578706445,3578706490,45
0,549,3194,3578706445,3578706492,47
0,549,3195,3578706445,3578706493,48
0,549,3196,3578706445,3578706494,49
0,550,3197,3578706498,3578706503,5
0,550,3198,3578706498,3578706504,6
0,550,3199,3578706498,3578706505,7
0,550,3200,3578706498,3578706509,11
0,550,3201,3578706498,3578706510,12
0,550,3202,3578706498,3578706514,16
0,550,3203,3578706498,3578706515,17
0,550,3204,3578706498,3578706515,17
0,550,3205,3578706498,3578706518,20
0,550,3206,3578706498,3578706523,25
0,550,3207,3578706498,3578706527,29
0,550,3208,3578706498,3578706532,34
0,550,3209,3578706498,3578706533,35
0,550,3210,3578706498,3578706534,36
0,550,3211,3578706498,3578706539,41
0,550,3212,3578706498,3578706540,42
0,550,3213,3578706498,3578706542,44
0,550,3214,3578706498,3578706543,45
0,550,3215,3578706498,3578706544,46
0,551,3216,3578706551,3578706551,0
0,551,3217,3578706551,3578706551,0
0,551,3218,3578706551,3578706555,4
0,551,3219,3578706551,3578706556,5
0,551,3220,3578706551,3578706558,7
0,551,3221,3578706551,3578706558,7
0,551,3222,3578706551,3578706561,10
0,551,3223,3578706551,3578706561,10
0,551,3224,3578706551,3578706569,18
0,551,3225,3578706551,3578706571,20
0,551,3226,3578706551,3578706572,21
0,551,3227,3578706551,3578706573,22
0,551,3228,3578706551,3578706578,27
0,551,3229,3578706551,3578706579,28
0,551,3230,3578706551,3578706580,29
0,551,3231,3578706551,3578706583,32
0,551,3232,3578706551,3578706586,35
0,551,3233,3578706551,3578706586,35
0,551,3234,3578706551,3578706588,37
0,551,3235,3578706551,3578706592,41
0,551,3236,3578706551,3578706593,42
0,551,3237,3578706551,3578706595,44
0,551,3238,3578706551,3578706596,45
0,551,3239,3578706551,3578706596,45
0,551,3240,3578706551,3578706600,49
0,552,3241,3578706603,3578706603,0
0,552,3242,3578706603,3578706605,2
0,552,3243,3578706603,3578706606,3
0,552,3244,3578706603,3578706611,8
0,552,3245,3578706603,3578706615,12
0,552,3246,3578706603,3578706615,12
0,552,3247,3578706603,3578706621,18
0,552,3248,3578706603,3578706622,19
0,552,3249,3578706603,3578706628,25
0,552,3250,3578706603,3578706631,28
0,552,3251,3578706603,3578706632,29
0,552,3252,3578706603,3578706633,30
0,552,3253,3578706603,3578706635,32
0,552,3254,3578706603,3578706638,35
0,552,3255,3578706603,3578706643,40
0,552,3256,3578706603,3578706648,45
0,552,3257,3578706603,3578706649,46
0,552,3258,3578706603,3578706652,49
0,553,3259,3578706655,3578706655,0
0,553,3260,3578706655,3578706657,2
0,553,3261,3578706655,3578706659,4
0,553,3262,3578706655,3578706661,6
0,553,3263,3578706655,3578706664,9
0,553,3264,3578706655,3578706665,10
0,553,3265,3578706655,3578706667,12
0,553,3266,3578706655,3578706669,14
0,553,3267,3578706655,3578706669,14
0,553,3268,3578706655,3578706675,20
0,553,3269,3578706655,3578706679,24
0,553,3270,3578706655,3578706681,26
0,553,3271,3578706655,3578706686,31
0,553,3272,3578706655,3578706686,31
0,553,3273,3578706655,3578706688,33
0,553,3274,3578706655,3578706688,33
0,553,3275,3578706655,3578706689,34
0,553,3276,3578706655,3578706690,35
0,553,3277,3578706655,3578706692,37
0,553,3278,3578706655,3578706693,38
0,553,3279,3578706655,3578706694,39
0,553,3280,3578706655,3578706699,44
0,553,3281,3578706655,3578706703,48
0,553,3282,3578706655,3578706705,50
0,554,3283,3578706708,3578706708,0
0,554,3284,3578706708,3578706711,3
0,554,3285,3578706708,3578706711,3
0,554,3286,3578706708,3578706714,6
0,554,3287,3578706708,3578706714,6
0,554,3288,3578706708,3578706715,7
0,554,3289,3578706708,3578706718,10
0,554,3290,3578706708,3578706723,15
0,554,3291,3578706708,3578706727,19
0,554,3292,3578706708,3578706732,24
0,554,3293,3578706708,3578706733,25
0,554,3294,3578706708,3578706734,26
0,554,3295,3578706708,3578706739,31
0,554,3296,3578706708,3578706739,31
0,554,3297,3578706708,3578706742,34
0,554,3298,3578706708,3578706743,35
0,554,3299,3578706708,3578706749,41
0,554,3300,3578706708,3578706750,42
0,554,3301,3578706708,3578706752,44
0,554,3302,3578706708,3578706755,47
0,554,3303,3578706708,3578706757,49
0,555,3304,3578706761,3578706761,0
0,555,3305,3578706761,3578706761,0
0,555,3306,3578706761,3578706761,0
0,555,3307,3578706761,3578706761,0
0,555,3308,3578706761,3578706769,8
0,555,3309,3578706761,3578706771,10
0,555,3310,3578706761,3578706773,12
0,555,3311,3578706761,3578706773,12
0,555,3312,3578706761,3578706778,17
0,555,3313,3578706761,3578706780,19
0,555,3314,3578706761,3578706780,19
0,555,3315,3578706761,3578706784,23
0,555,3316,3578706761,3578706787,26
0,555,3317,3578706761,3578706787,26
0,555,3318,3578706761,3578706789,28
0,555,3319,3578706761,3578706792,31
0,555,3320,3578706761,3578706793,32
0,555,3321,3578706761,3578706795,34
0,555,3322,3578706761,3578706796,35
0,555,3323,3578706761,3578706799,38
0,555,3324,3578706761,3578706800,39
0,555,3325,3578706761,3578706802,41
0,555,3326,3578706761,3578706804,43
0,555,3327,3578706761,3578706806,45
0,556,3328,3578706814,3578706814,0
0,556,3329,3578706814,3578706815,1
0,556,3330,3578706814,3578706815,1
0,556,3331,3578706814,3578706822,8
0,556,3332,3578706814,3578706824,10
0,556,3333,3578706814,3578706828,14
0,556,3334,3578706814,3578706831,17
0,556,3335,3578706814,3578706831,17
0,556,3336,3578706814,3578706833,19
0,556,3337,3578706814,3578706835,21
0,556,3338,3578706814,3578706838,24
0,556,3339,3578706814,3578706843,29
0,556,3340,3578706814,3578706849,35
0,556,3341,3578706814,3578706850,36
0,556,3342,3578706814,3578706852,38
0,556,3343,3578706814,3578706854,40
0,556,3344,3578706814,3578706856,42
0,556,3345,3578706814,3578706859,45
0,556,3346,3578706814,3578706863,49
0,557,3347,3578706867,3578706867,0
0,557,3348,3578706867,3578706867,0
0,557,3349,3578706867,3578706867,0
0,557,3350,3578706867,3578706869,2
0,557,3351,3578706867,3578706869,2
0,557,3352,3578706867,3578706876,9
0,557,3353,3578706867,3578706879,12
0,557,3354,3578706867,3578706882,15
0,557,3355,3578706867,3578706886,19
0,557,3356,3578706867,3578706886,19
0,557,3357,3578706867,3578706888,21
0,557,3358,3578706867,3578706889,22
0,557,3359,3578706867,3578706889,22
0,557,3360,3578706867,3578706890,23
0,557,3361,3578706867,3578706892,25
0,557,3362,3578706867,3578706893,26
0,557,3363,3578706867,3578706894,27
0,557,3364,3578706867,3578706899,32
0,557,3365,3578706867,3578706900,33
0,557,3366,3578706867,3578706903,36
0,557,3367,3578706867,3578706905,38
0,557,3368,3578706867,3578706905,38
0,557,3369,3578706867,3578706910,43
0,557,3370,3578706867,3578706910,43
0,557,3371,3578706867,3578706914,47
0,557,3372,3578706867,3578706914,47
0,557,3373,3578706867,3578706916,49
0,558,3374,3578706919,3578706919,0
0,558,3375,3578706919,3578706925,6
0,558,3376,3578706919,3578706927,8
0,558,3377,3578706919,3578706932,13
0,558,3378,3578706919,3578706932,13
0,558,3379,3578706919,3578706935,16
0,558,3380,3578706919,3578706939,20
0,558,3381,3578706919,3578706940,21
0,558,3382,3578706919,3578706942,23
0,558,3383,3578706919,3578706943,24
0,558,3384,3578706919,3578706951,32
0,558,3385,3578706919,3578706951,32
0,558,3386,3578706919,3578706951,32
0,558,3387,3578706919,3578706955,36
0,558,3388,3578706919,3578706956,37
0,558,3389,3578706919,3578706959,40
0,558,3390,3578706919,3578706960,41
0,558,3391,3578706919,3578706961,42
0,558,3392,3578706919,3578706962,43
0,558,3393,3578706919,3578706964,45
0,558,3394,3578706919,3578706969,50
0,559,3395,3578706971,3578706972,1
0,559,3396,3578706971,3578706973,2
0,559,3397,3578706971,3578706974,3
0,559,3398,3578706971,3578706979,8
0,559,3399,3578706971,3578706980,9
0,559,3400,3578706971,3578706980,9
0,559,3401,3578706971,3578706984,13
0,559,3402,3578706971,3578706986,15
0,559,3403,3578706971,3578706987,16
0,559,3404,3578706971,3578706989,18
0,559,3405,3578706971,3578706992,21
0,559,3406,3578706971,3578706992,21
0,559,3407,3578706971,3578706995,24
0,559,3408,3578706971,3578706997,26
0,559,3409,3578706971,3578707001,30
0,559,3410,3578706971,3578707002,31
0,559,3411,3578706971,3578707003,32
0,559,3412,3578706971,3578707004,33
0,559,3413,3578706971,3578707006,35
0,559,3414,3578706971,3578707013,42
0,559,3415,3578706971,3578707016,45
0,559,3416,3578706971,3578707016,45
0,560,3417,3578707023,3578707023,0
0,560,3418,3578707023,3578707024,1
0,560,3419,3578707023,3578707027,4
0,560,3420,3578707023,3578707032,9
0,560,3421,3578707023,3578707032,9
0,560,3422,3578707023,3578707033,10
0,560,3423,3578707023,3578707036,13
0,560,3424,3578707023,3578707038,15
0,560,3425,3578707023,3578707043,20
0,560,3426,3578707023,3578707050,27
0,560,3427,3578707023,3578707051,28
0,560,3428,3578707023,3578707052,29
0,560,3429,3578707023,3578707054,31
0,560,3430,3578707023,3578707056,33
0,560,3431,3578707023,3578707059,36
0,560,3432,3578707023,3578707062,39
0,560,3433,3578707023,3578707064,41
0,560,3434,3578707023,3578707065,42
0,560,3435,3578707023,3578707068,45
0,560,3436,3578707023,3578707070,47
0,560,3437,3578707023,3578707070,47
0,561,3438,3578707076,3578707076,0
0,561,3439,3578707076,3578707080,4
0,561,3440,3578707076,3578707082,6
0,561,3441,3578707076,3578707086,10
0,561,3442,3578707076,3578707087,11
0,561,3443,3578707076,3578707088,12
0,561,3444,3578707076,3578707089,13
0,561,3445,3578707076,3578707089,13
0,561,3446,3578707076,3578707089,13
0,561,3447,3578707076,3578707092,16
0,561,3448,3578707076,3578707093,17
0,561,3449,3578707076,3578707094,18
0,561,3450,3578707076,3578707099,23
0,561,3451,3578707076,3578707103,27
0,561,3452,3578707076,3578707103,27
0,561,3453,3578707076,3578707104,28
0,561,3454,3578707076,3578707105,29
0,561,3455,3578707076,3578707110,34
0,561,3456,3578707076,3578707111,35
0,561,3457,3578707076,3578707115,39
0,561,3458,3578707076,3578707116,40
0,561,3459,3578707076,3578707116,40
0,561,3460,3578707076,3578707118,42
0,561,3461,3578707076,3578707124,48
0,562,3462,3578707129,3578707129,0
0,562,3463,3578707129,3578707132,3
0,562,3464,3578707129,3578707132,3
0,562,3465,3578707129,3578707135,6
0,562,3466,3578707129,3578707139,10
0,562,3467,3578707129,3578707140,11
0,562,3468,3578707129,3578707143,14
0,562,3469,3578707129,3578707151,22
0,562,3470,3578707129,3578707153,24
0,562,3471,3578707129,3578707154,25
0,562,3472,3578707129,3578707155,26
0,562,3473,3578707129,3578707157,28
0,562,3474,3578707129,3578707158,29
0,562,3475,3578707129,3578707160,31
0,562,3476,3578707129,3578707161,32
0,562,3477,3578707129,3578707161,32
0,562,3478,3578707129,3578707165,36
0,562,3479,3578707129,3578707169,40
0,562,3480,3578707129,3578707171,42
0,562,3481,3578707129,3578707173,44
0,562,3482,3578707129,3578707174,45
0,562,3483,3578707129,3578707179,50
0,563,3484,3578707182,3578707182,0
0,563,3485,3578707182,3578707184,2
0,563,3486,3578707182,3578707187,5
0,563,3487,3578707182,3578707187,5
0,563,3488,3578707182,3578707189,7
0,563,3489,3578707182,3578707192,10
0,563,3490,3578707182,3578707192,10
0,563,3491,3578707182,3578707195,13
0,563,3492,3578707182,3578707197,15
0,563,3493,3578707182,3578707201,19
0,563,3494,3578707182,3578707203,21
0,563,3495,3578707182,3578707204,22
0,563,3496,3578707182,3578707205,23
0,563,3497,3578707182,3578707206,24
0,563,3498,3578707182,3578707213,31
0,563,3499,3578707182,3578707216,34
0,563,3500,3578707182,3578707216,34
0,563,3501,3578707182,3578707221,39
0,563,3502,3578707182,3578707224,42
0,563,3503,3578707182,3578707228,46
0,563,3504,3578707182,3578707232,50
0,564,3505,3578707234,3578707234,0
0,564,3506,3578707234,3578707234,0
0,564,3507,3578707234,3578707236,2
0,564,3508,3578707234,3578707239,5
0,564,3509,3578707234,3578707243,9
0,564,3510,3578707234,3578707250,16
0,564,3511,3578707234,3578707255,21
0,564,3512,3578707234,3578707255,21
0,564,3513,3578707234,3578707256,22
0,564,3514,3578707234,3578707259,25
0,564,3515,3578707234,3578707262,28
0,564,3516,3578707234,3578707265,31
0,564,3517,3578707234,3578707267,33
0,564,3518,3578707234,3578707268,34
0,564,3519,3578707234,3578707270,36
0,564,3520,3578707234,3578707270,36
0,564,3521,3578707234,3578707275,41
0,564,3522,3578707234,3578707280,46
0,564,3523,3578707234,3578707283,49
0,565,3524,3578707287,3578707287,0
0,565,3525,3578707287,3578707287,0
0,565,3526,3578707287,3578707288,1
0,565,3527,3578707287,3578707289,2
0,565,3528,3578707287,3578707290,3
0,565,3529,3578707287,3578707290,3
0,565,3530,3578707287,3578707292,5
0,565,3531,3578707287,3578707292,5
0,565,3532,3578707287,3578707294,7
0,565,3533,3578707287,3578707299,12
0,565,3534,3578707287,3578707303,16
0,565,3535,3578707287,3578707303,16
0,565,3536,3578707287,3578707305,18
0,565,3537,3578707287,3578707305,18
0,565,3538,3578707287,3578707306,19
0,565,3539,3578707287,3578707310,23
0,565,3540,3578707287,3578707311,24
0,565,3541,3578707287,3578707315,28
0,565,3542,3578707287,3578707316,29
0,565,3543,3578707287,3578707316,29
0,565,3544,3578707287,3578707318,31
0,565,3545,3578707287,3578707324,37
0,565,3546,3578707287,3578707327,40
0,565,3547,3578707287,3578707332,45
0,565,3548,3578707287,3578707333,46
0,565,3549,3578707287,3578707336,49
0,566,3550,3578707340,3578707340,0
0,566,3551,3578707340,3578707340,0
0,566,3552,3578707340,3578707343,3
0,566,3553,3578707340,3578707351,11
0,566,3554,3578707340,3578707353,13
0,566,3555,3578707340,3578707356,16
0,566,3556,3578707340,3578707357,17
0,566,3557,3578707340,3578707357,17
0,566,3558,3578707340,3578707359,19
0,566,3559,3578707340,3578707360,20
0,566,3560,3578707340,3578707361,21
0,566,3561,3578707340,3578707361,21
0,566,3562,3578707340,3578707365,25
0,566,3563,3578707340,3578707369,29
0,566,3564,3578707340,3578707372,32
0,566,3565,3578707340,3578707373,33
0,566,3566,3578707340,3578707374,34
0,566,3567,3578707340,3578707380,40
0,566,3568,3578707340,3578707380,40
0,566,3569,3578707340,3578707381,41
0,566,3570,3578707340,3578707384,44
0,566,3571,3578707340,3578707387,47
0,566,3572,3578707340,3578707388,48
0,566,3573,3578707340,3578707390,50
0,567,3574,3578707392,3578707393,1
0,567,3575,3578707392,3578707394,2
0,567,3576,3578707392,3578707395,3
0,567,3577,3578707392,3578707397,5
0,567,3578,3578707392,3578707401,9
0,567,3579,3578707392,3578707403,11
0,567,3580,3578707392,3578707406,14
0,567,3581,3578707392,3578707407,15
0,567,3582,3578707392,3578707407,15
0,567,3583,3578707392,3578707413,21
0,567,3584,3578707392,3578707416,24
0,567,3585,3578707392,3578707416,24
0,567,3586,3578707392,3578707422,30
0,567,3587,3578707392,3578707423,31
0,567,3588,3578707392,3578707429,37
0,567,3589,3578707392,3578707432,40
0,567,3590,3578707392,3578707433,41
0,567,3591,3578707392,3578707434,42
0,567,3592,3578707392,3578707435,43
0,567,3593,3578707392,3578707439,47
0,568,3594,3578707445,3578707445,0
0,568,3595,3578707445,3578707450,5
0,568,3596,3578707445,3578707450,5
0,568,3597,3578707445,3578707456,11
0,568,3598,3578707445,3578707458,13
0,568,3599,3578707445,3578707458,13
0,568,3600,3578707445,3578707459,14
0,568,3601,3578707445,3578707463,18
0,568,3602,3578707445,3578707466,21
0,568,3603,3578707445,3578707467,22
0,568,3604,3578707445,3578707469,24
0,568,3605,3578707445,3578707470,25
0,568,3606,3578707445,3578707476,31
0,568,3607,3578707445,3578707480,35
0,568,3608,3578707445,3578707482,37
0,568,3609,3578707445,3578707487,42
0,568,3610,3578707445,3578707487,42
0,568,3611,3578707445,3578707489,44
0,568,3612,3578707445,3578707489,44
0,568,3613,3578707445,3578707489,44
0,568,3614,3578707445,3578707491,46
0,568,3615,3578707445,3578707492,47
0,568,3616,3578707445,3578707492,47
0,568,3617,3578707445,3578707494,49
0,569,3618,3578707497,3578707498,1
0,569,3619,3578707497,3578707502,5
0,569,3620,3578707497,3578707502,5
0,569,3621,3578707497,3578707503,6
0,569,3622,3578707497,3578707504,7
0,569,3623,3578707497,3578707508,11
0,569,3624,3578707497,3578707510,13
0,569,3625,3578707497,3578707511,14
0,569,3626,3578707497,3578707515,18
0,569,3627,3578707497,3578707515,18
0,569,3628,3578707497,3578707515,18
0,569,3629,3578707497,3578707518,21
0,569,3630,3578707497,3578707523,26
0,569,3631,3578707497,3578707526,29
0,569,3632,3578707497,3578707531,34
0,569,3633,3578707497,3578707532,35
0,569,3634,3578707497,3578707536,39
0,569,3635,3578707497,3578707539,42
0,569,3636,3578707497,3578707539,42
0,569,3637,3578707497,3578707542,45
0,569,3638,3578707497,3578707542,45
0,570,3639,3578707549,3578707550,1
0,570,3640,3578707549,3578707555,6
0,570,3641,3578707549,3578707556,7
0,570,3642,3578707549,3578707556,7
0,570,3643,3578707549,3578707558,9
0,570,3644,3578707549,3578707559,10
0,570,3645,3578707549,3578707559,10
0,570,3646,3578707549,3578707560,11
0,570,3647,3578707549,3578707560,11
0,570,3648,3578707549,3578707564,15
0,570,3649,3578707549,3578707569,20
0,570,3650,3578707549,3578707570,21
0,570,3651,3578707549,3578707571,22
0,570,3652,3578707549,3578707573,24
0,570,3653,3578707549,3578707579,30
0,570,3654,3578707549,3578707580,31
0,570,3655,3578707549,3578707581,32
0,570,3656,3578707549,3578707584,35
0,570,3657,3578707549,3578707586,37
0,570,3658,3578707549,3578707586,37
0,570,3659,3578707549,3578707588,39
0,570,3660,3578707549,3578707592,43
0,570,3661,3578707549,3578707593,44
0,570,3662,3578707549,3578707596,47
0,570,3663,3578707549,3578707596,47
0,571,3664,3578707602,3578707602,0
0,571,3665,3578707602,3578707602,0
0,571,3666,3578707602,3578707604,2
0,571,3667,3578707602,3578707605,3
0,571,3668,3578707602,3578707610,8
0,571,3669,3578707602,3578707613,11
0,571,3670,3578707602,3578707614,12
0,571,3671,3578707602,3578707615,13
0,571,3672,3578707602,3578707622,20
0,571,3673,3578707602,3578707623,21
0,571,3674,3578707602,3578707627,25
0,571,3675,3578707602,3578707631,29
0,571,3676,3578707602,3578707632,30
0,571,3677,3578707602,3578707633,31
0,571,3678,3578707602,3578707634,32
0,571,3679,3578707602,3578707638,36
0,571,3680,3578707602,3578707645,43
0,571,3681,3578707602,3578707649,47
0,571,3682,3578707602,3578707650,48
0,572,3683,3578707654,3578707654,0
0,572,3684,3578707654,3578707654,0
0,572,3685,3578707654,3578707657,3
0,572,3686,3578707654,3578707659,5
0,572,3687,3578707654,3578707660,6
0,572,3688,3578707654,3578707661,7
0,572,3689,3578707654,3578707665,11
0,572,3690,3578707654,3578707665,11
0,572,3691,3578707654,3578707667,13
0,572,3692,3578707654,3578707669,15
0,572,3693,3578707654,3578707670,16
0,572,3694,3578707654,3578707676,22
0,572,3695,3578707654,3578707680,26
0,572,3696,3578707654,3578707683,29
0,572,3697,3578707654,3578707687,33
0,572,3698,3578707654,3578707687,33
0,572,3699,3578707654,3578707689,35
0,572,3700,3578707654,3578707689,35
0,572,3701,3578707654,3578707690,36
0,572,3702,3578707654,3578707691,37
0,572,3703,3578707654,3578707692,38
0,572,3704,3578707654,3578707692,38
0,572,3705,3578707654,3578707693,39
0,572,3706,3578707654,3578707698,44
0,572,3707,3578707654,3578707702,48
0,572,3708,3578707654,3578707702,48
0,572,3709,3578707654,3578707703,49
0,572,3710,3578707654,3578707704,50
0,573,3711,3578707707,3578707710,3
0,573,3712,3578707707,3578707711,4
0,573,3713,3578707707,3578707711,4
0,573,3714,3578707707,3578707714,7
0,573,3715,3578707707,3578707715,8
0,573,3716,3578707707,3578707716,9
0,573,3717,3578707707,3578707718,11
0,573,3718,3578707707,3578707727,20
0,573,3719,3578707707,3578707731,24
0,573,3720,3578707707,3578707733,26
0,573,3721,3578707707,3578707735,28
0,573,3722,3578707707,3578707739,32
0,573,3723,3578707707,3578707739,32
0,573,3724,3578707707,3578707742,35
0,573,3725,3578707707,3578707742,35
0,573,3726,3578707707,3578707750,43
0,573,3727,3578707707,3578707756,49
0,573,3728,3578707707,3578707756,49
0,573,3729,3578707707,3578707756,49
0,574,3730,3578707760,3578707760,0
0,574,3731,3578707760,3578707760,0
0,574,3732,3578707760,3578707760,0
0,574,3733,3578707760,3578707761,1
0,574,3734,3578707760,3578707761,1
0,574,3735,3578707760,3578707764,4
0,574,3736,3578707760,3578707769,9
0,574,3737,3578707760,3578707772,12
0,574,3738,3578707760,3578707773,13
0,574,3739,3578707760,3578707773,13
0,574,3740,3578707760,3578707779,19
0,574,3741,3578707760,3578707780,20
0,574,3742,3578707760,3578707781,21
0,574,3743,3578707760,3578707783,23
0,574,3744,3578707760,3578707786,26
0,574,3745,3578707760,3578707787,27
0,574,3746,3578707760,3578707789,29
0,574,3747,3578707760,3578707792,32
0,574,3748,3578707760,3578707792,32
0,574,3749,3578707760,3578707795,35
0,574,3750,3578707760,3578707797,37
0,574,3751,3578707760,3578707800,40
0,574,3752,3578707760,3578707802,42
0,574,3753,3578707760,3578707804,44
0,574,3754,3578707760,3578707806,46
0,575,3755,3578707813,3578707813,0
0,575,3756,3578707813,3578707813,0
0,575,3757,3578707813,3578707815,2
0,575,3758,3578707813,3578707815,2
0,575,3759,3578707813,3578707821,8
0,575,3760,3578707813,3578707824,11
0,575,3761,3578707813,3578707828,15
0,575,3762,3578707813,3578707831,18
0,575,3763,3578707813,3578707832,19
0,575,3764,3578707813,3578707833,20
0,575,3765,3578707813,3578707834,21
0,575,3766,3578707813,3578707838,25
0,575,3767,3578707813,3578707845,32
0,575,3768,3578707813,3578707849,36
0,575,3769,3578707813,3578707850,37
0,575,3770,3578707813,3578707853,40
0,575,3771,3578707813,3578707854,41
0,575,3772,3578707813,3578707857,44
0,575,3773,3578707813,3578707859,46
0,575,3774,3578707813,3578707862,49
0,575,3775,3578707813,3578707863,50
0,576,3776,3578707866,3578707866,0
0,576,3777,3578707866,3578707866,0
0,576,3778,3578707866,3578707867,1
0,576,3779,3578707866,3578707869,3
0,576,3780,3578707866,3578707870,4
0,576,3781,3578707866,3578707875,9
0,576,3782,3578707866,3578707880,14
0,576,3783,3578707866,3578707883,17
0,576,3784,3578707866,3578707887,21
0,576,3785,3578707866,3578707888,22
0,576,3786,3578707866,3578707889,23
0,576,3787,3578707866,3578707890,24
0,576,3788,3578707866,3578707890,24
0,576,3789,3578707866,3578707891,25
0,576,3790,3578707866,3578707892,26
0,576,3791,3578707866,3578707892,26
0,576,3792,3578707866,3578707894,28
0,576,3793,3578707866,3578707898,32
0,576,3794,3578707866,3578707902,36
0,576,3795,3578707866,3578707902,36
0,576,3796,3578707866,3578707904,38
0,576,3797,3578707866,3578707904,38
0,576,3798,3578707866,3578707911,45
0,576,3799,3578707866,3578707911,45
0,576,3800,3578707866,3578707913,47
0,576,3801,3578707866,3578707914,48
0,576,3802,3578707866,3578707915,49
0,576,3803,3578707866,3578707915,49
0,577,3804,3578707918,3578707918,0
0,577,3805,3578707918,3578707927,9
0,577,3806,3578707918,3578707930,12
0,577,3807,3578707918,3578707936,18
0,577,3808,3578707918,3578707939,21
0,577,3809,3578707918,3578707940,22
0,577,3810,3578707918,3578707942,24
0,577,3811,3578707918,3578707942,24
0,577,3812,3578707918,3578707950,32
0,577,3813,3578707918,3578707952,34
0,577,3814,3578707918,3578707956,38
0,577,3815,3578707918,3578707956,38
0,577,3816,3578707918,3578707957,39
0,577,3817,3578707918,3578707959,41
0,577,3818,3578707918,3578707960,42
0,577,3819,3578707918,3578707961,43
0,577,3820,3578707918,3578707961,43
0,577,3821,3578707918,3578707961,43
0,577,3822,3578707918,3578707964,46
0,577,3823,3578707918,3578707964,46
0,578,3824,3578707971,3578707971,0
0,578,3825,3578707971,3578707972,1
0,578,3826,3578707971,3578707973,2
0,578,3827,3578707971,3578707974,3
0,578,3828,3578707971,3578707980,9
0,578,3829,3578707971,3578707980,9
0,578,3830,3578707971,3578707982,11
0,578,3831,3578707971,3578707986,15
0,578,3832,3578707971,3578707987,16
0,578,3833,3578707971,3578707989,18
0,578,3834,3578707971,3578707992,21
0,578,3835,3578707971,3578707993,22
0,578,3836,3578707971,3578707995,24
0,578,3837,3578707971,3578707996,25
0,578,3838,3578707971,3578708001,30
0,578,3839,3578707971,3578708001,30
0,578,3840,3578707971,3578708004,33
0,578,3841,3578707971,3578708006,35
0,578,3842,3578707971,3578708013,42
0,578,3843,3578707971,3578708014,43
0,578,3844,3578707971,3578708015,44
0,578,3845,3578707971,3578708016,45
0,578,3846,3578707971,3578708021,50
0,579,3847,3578708024,3578708024,0
0,579,3848,3578708024,3578708027,3
0,579,3849,3578708024,3578708031,7
0,579,3850,3578708024,3578708032,8
0,579,3851,3578708024,3578708033,9
0,579,3852,3578708024,3578708034,10
0,579,3853,3578708024,3578708038,14
0,579,3854,3578708024,3578708045,21
0,579,3855,3578708024,3578708050,26
0,579,3856,3578708024,3578708050,26
0,579,3857,3578708024,3578708053,29
0,579,3858,3578708024,3578708054,30
0,579,3859,3578708024,3578708057,33
0,579,3860,3578708024,3578708059,35
0,579,3861,3578708024,3578708063,39
0,579,3862,3578708024,3578708065,41
0,579,3863,3578708024,3578708066,42
0,579,3864,3578708024,3578708066,42
0,579,3865,3578708024,3578708067,43
0,579,3866,3578708024,3578708069,45
0,579,3867,3578708024,3578708070,46
0,580,3868,3578708077,3578708077,0
0,580,3869,3578708077,3578708080,3
0,580,3870,3578708077,3578708083,6
0,580,3871,3578708077,3578708087,10
0,580,3872,3578708077,3578708087,10
0,580,3873,3578708077,3578708089,12
0,580,3874,3578708077,3578708089,12
0,580,3875,3578708077,3578708090,13
0,580,3876,3578708077,3578708091,14
0,580,3877,3578708077,3578708092,15
0,580,3878,3578708077,3578708092,15
0,580,3879,3578708077,3578708094,17
0,580,3880,3578708077,3578708098,21
0,580,3881,3578708077,3578708102,25
0,580,3882,3578708077,3578708103,26
0,580,3883,3578708077,3578708104,27
0,580,3884,3578708077,3578708104,27
0,580,3885,3578708077,3578708110,33
0,580,3886,3578708077,3578708111,34
0,580,3887,3578708077,3578708114,37
0,580,3888,3578708077,3578708115,38
0,580,3889,3578708077,3578708116,39
0,580,3890,3578708077,3578708116,39
0,580,3891,3578708077,3578708117,40
0,580,3892,3578708077,3578708124,47
0,580,3893,3578708077,3578708126,49
0,581,3894,3578708130,3578708131,1
0,581,3895,3578708130,3578708135,5
0,581,3896,3578708130,3578708140,10
0,581,3897,3578708130,3578708140,10
0,581,3898,3578708130,3578708142,12
0,581,3899,3578708130,3578708142,12
0,581,3900,3578708130,3578708151,21
0,581,3901,3578708130,3578708152,22
0,581,3902,3578708130,3578708155,25
0,581,3903,3578708130,3578708156,26
0,581,3904,3578708130,3578708156,26
0,581,3905,3578708130,3578708160,30
0,581,3906,3578708130,3578708161,31
0,581,3907,3578708130,3578708161,31
0,581,3908,3578708130,3578708162,32
0,581,3909,3578708130,3578708167,37
0,581,3910,3578708130,3578708169,39
0,581,3911,3578708130,3578708171,41
0,581,3912,3578708130,3578708173,43
0,581,3913,3578708130,3578708174,44
0,581,3914,3578708130,3578708179,49
0,582,3915,3578708184,3578708184,0
0,582,3916,3578708184,3578708184,0
0,582,3917,3578708184,3578708184,0
0,582,3918,3578708184,3578708186,2
0,582,3919,3578708184,3578708187,3
0,582,3920,3578708184,3578708189,5
0,582,3921,3578708184,3578708192,8
0,582,3922,3578708184,3578708192,8
0,582,3923,3578708184,3578708195,11
0,582,3924,3578708184,3578708196,12
0,582,3925,3578708184,3578708201,17
0,582,3926,3578708184,3578708202,18
0,582,3927,3578708184,3578708204,20
0,582,3928,3578708184,3578708206,22
0,582,3929,3578708184,3578708212,28
0,582,3930,3578708184,3578708215,31
0,582,3931,3578708184,3578708215,31
0,582,3932,3578708184,3578708216,32
0,582,3933,3578708184,3578708217,33
0,582,3934,3578708184,3578708221,37
0,582,3935,3578708184,3578708224,40
0,582,3936,3578708184,3578708228,44
0,582,3937,3578708184,3578708230,46
0,582,3938,3578708184,3578708232,48
0,582,3939,3578708184,3578708232,48
0,582,3940,3578708184,3578708234,50
0,583,3941,3578708236,3578708239,3
0,583,3942,3578708236,3578708245,9
0,583,3943,3578708236,3578708249,13
0,583,3944,3578708236,3578708249,13
0,583,3945,3578708236,3578708253,17
0,583,3946,3578708236,3578708254,18
0,583,3947,3578708236,3578708258,22
0,583,3948,3578708236,3578708259,23
0,583,3949,3578708236,3578708262,26
0,583,3950,3578708236,3578708265,29
0,583,3951,3578708236,3578708266,30
0,583,3952,3578708236,3578708268,32
0,583,3953,3578708236,3578708268,32
0,583,3954,3578708236,3578708269,33
0,583,3955,3578708236,3578708269,33
0,583,3956,3578708236,3578708276,40
0,583,3957,3578708236,3578708279,43
0,583,3958,3578708236,3578708283,47
0,584,3959,3578708289,3578708289,0
0,584,3960,3578708289,3578708289,0
0,584,3961,3578708289,3578708289,0
0,584,3962,3578708289,3578708290,1
0,584,3963,3578708289,3578708291,2
0,584,3964,3578708289,3578708292,3
0,584,3965,3578708289,3578708292,3
0,584,3966,3578708289,3578708292,3
0,584,3967,3578708289,3578708294,5
0,584,3968,3578708289,3578708298,9
0,584,3969,3578708289,3578708302,13
0,584,3970,3578708289,3578708304,15
0,584,3971,3578708289,3578708305,16
0,584,3972,3578708289,3578708311,22
0,584,3973,3578708289,3578708315,26
0,584,3974,3578708289,3578708316,27
0,584,3975,3578708289,3578708316,27
0,584,3976,3578708289,3578708317,28
0,584,3977,3578708289,3578708318,29
0,584,3978,3578708289,3578708325,36
0,584,3979,3578708289,3578708327,38
0,584,3980,3578708289,3578708330,41
0,584,3981,3578708289,3578708332,43
0,584,3982,3578708289,3578708335,46
0,585,3983,3578708342,3578708342,0
0,585,3984,3578708342,3578708342,0
0,585,3985,3578708342,3578708343,1
0,585,3986,3578708342,3578708343,1
0,585,3987,3578708342,3578708351,9
0,585,3988,3578708342,3578708353,11
0,585,3989,3578708342,3578708356,14
0,585,3990,3578708342,3578708356,14
0,585,3991,3578708342,3578708357,15
0,585,3992,3578708342,3578708360,18
0,585,3993,3578708342,3578708361,19
0,585,3994,3578708342,3578708361,19
0,585,3995,3578708342,3578708361,19
0,585,3996,3578708342,3578708370,28
0,585,3997,3578708342,3578708370,28
0,585,3998,3578708342,3578708372,30
0,585,3999,3578708342,3578708374,32
0,585,4000,3578708342,3578708374,32
0,585,4001,3578708342,3578708379,37
0,585,4002,3578708342,3578708380,38
0,585,4003,3578708342,3578708383,41
0,585,4004,3578708342,3578708387,45
0,585,4005,3578708342,3578708387,45
0,585,4006,3578708342,3578708390,48
0,586,4007,3578708395,3578708395,0
0,586,4008,3578708395,3578708395,0
0,586,4009,3578708395,3578708395,0
0,586,4010,3578708395,3578708397,2
0,586,4011,3578708395,3578708401,6
0,586,4012,3578708395,3578708401,6
0,586,4013,3578708395,3578708406,11
0,586,4014,3578708395,3578708407,12
0,586,4015,3578708395,3578708412,17
0,586,4016,3578708395,3578708415,20
0,586,4017,3578708395,3578708415,20
0,586,4018,3578708395,3578708417,22
0,586,4019,3578708395,3578708417,22
0,586,4020,3578708395,3578708420,25
0,586,4021,3578708395,3578708421,26
0,586,4022,3578708395,3578708423,28
0,586,4023,3578708395,3578708429,34
0,586,4024,3578708395,3578708430,35
0,586,4025,3578708395,3578708432,37
0,586,4026,3578708395,3578708433,38
0,586,4027,3578708395,3578708434,39
0,586,4028,3578708395,3578708439,44
0,587,4029,3578708448,3578708448,0
0,587,4030,3578708448,3578708450,2
0,587,4031,3578708448,3578708450,2
0,587,4032,3578708448,3578708453,5
0,587,4033,3578708448,3578708455,7
0,587,4034,3578708448,3578708459,11
0,587,4035,3578708448,3578708462,14
0,587,4036,3578708448,3578708465,17
0,587,4037,3578708448,3578708466,18
0,587,4038,3578708448,3578708467,19
0,587,4039,3578708448,3578708468,20
0,587,4040,3578708448,3578708469,21
0,587,4041,3578708448,3578708469,21
0,587,4042,3578708448,3578708470,22
0,587,4043,3578708448,3578708476,28
0,587,4044,3578708448,3578708479,31
0,587,4045,3578708448,3578708483,35
0,587,4046,3578708448,3578708486,38
0,587,4047,3578708448,3578708487,39
0,587,4048,3578708448,3578708489,41
0,587,4049,3578708448,3578708489,41
0,587,4050,3578708448,3578708491,43
0,587,4051,3578708448,3578708492,44
0,587,4052,3578708448,3578708492,44
0,587,4053,3578708448,3578708493,45
0,587,4054,3578708448,3578708495,47
0,588,4055,3578708500,3578708500,0
0,588,4056,3578708500,3578708501,1
0,588,4057,3578708500,3578708503,3
0,588,4058,3578708500,3578708505,5
0,588,4059,3578708500,3578708509,9
0,588,4060,3578708500,3578708509,9
0,588,4061,3578708500,3578708513,13
0,588,4062,3578708500,3578708515,15
0,588,4063,3578708500,3578708516,16
0,588,4064,3578708500,3578708517,17
0,588,4065,3578708500,3578708521,21
0,588,4066,3578708500,3578708523,23
0,588,4067,3578708500,3578708526,26
0,588,4068,3578708500,3578708530,30
0,588,4069,3578708500,3578708533,33
0,588,4070,3578708500,3578708534,34
0,588,4071,3578708500,3578708540,40
0,588,4072,3578708500,3578708540,40
0,588,4073,3578708500,3578708542,42
0,588,4074,3578708500,3578708542,42
0,589,4075,3578708553,3578708553,0
0,589,4076,3578708553,3578708553,0
0,589,4077,3578708553,3578708554,1
0,589,4078,3578708553,3578708556,3
0,589,4079,3578708553,3578708556,3
0,589,4080,3578708553,3578708559,6
0,589,4081,3578708553,3578708560,7
0,589,4082,3578708553,3578708561,8
0,589,4083,3578708553,3578708561,8
0,589,4084,3578708553,3578708564,11
0,589,4085,3578708553,3578708569,16
0,589,4086,3578708553,3578708571,18
0,589,4087,3578708553,3578708572,19
0,589,4088,3578708553,3578708572,19
0,589,4089,3578708553,3578708573,20
0,589,4090,3578708553,3578708578,25
0,589,4091,3578708553,3578708580,27
0,589,4092,3578708553,3578708581,28
0,589,4093,3578708553,3578708583,30
0,589,4094,3578708553,3578708585,32
0,589,4095,3578708553,3578708589,36
0,589,4096,3578708553,3578708592,39
0,589,4097,3578708553,3578708593,40
0,589,4098,3578708553,3578708595,42
0,589,4099,3578708553,3578708596,43
0,589,4100,3578708553,3578708600,47
0,589,4101,3578708553,3578708600,47
0,590,4102,3578708606,3578708606,0
0,590,4103,3578708606,3578708606,0
0,590,4104,3578708606,3578708612,6
0,590,4105,3578708606,3578708614,8
0,590,4106,3578708606,3578708615,9
0,590,4107,3578708606,3578708615,9
0,590,4108,3578708606,3578708616,10
0,590,4109,3578708606,3578708619,13
0,590,4110,3578708606,3578708621,15
0,590,4111,3578708606,3578708622,16
0,590,4112,3578708606,3578708622,16
0,590,4113,3578708606,3578708628,22
0,590,4114,3578708606,3578708630,24
0,590,4115,3578708606,3578708631,25
0,590,4116,3578708606,3578708632,26
0,590,4117,3578708606,3578708633,27
0,590,4118,3578708606,3578708638,32
0,590,4119,3578708606,3578708644,38
0,590,4120,3578708606,3578708649,43
0,590,4121,3578708606,3578708649,43
0,590,4122,3578708606,3578708652,46
0,590,4123,3578708606,3578708654,48
0,591,4124,3578708659,3578708659,0
0,591,4125,3578708659,3578708659,0
0,591,4126,3578708659,3578708662,3
0,591,4127,3578708659,3578708664,5
0,591,4128,3578708659,3578708665,6
0,591,4129,3578708659,3578708667,8
0,591,4130,3578708659,3578708667,8
0,591,4131,3578708659,3578708669,10
0,591,4132,3578708659,3578708670,11
0,591,4133,3578708659,3578708673,14
0,591,4134,3578708659,3578708677,18
0,591,4135,3578708659,3578708680,21
0,591,4136,3578708659,3578708682,23
0,591,4137,3578708659,3578708687,28
0,591,4138,3578708659,3578708687,28
0,591,4139,3578708659,3578708689,30
0,591,4140,3578708659,3578708690,31
0,591,4141,3578708659,3578708691,32
0,591,4142,3578708659,3578708692,33
0,591,4143,3578708659,3578708692,33
0,591,4144,3578708659,3578708693,34
0,591,4145,3578708659,3578708695,36
0,591,4146,3578708659,3578708698,39
0,591,4147,3578708659,3578708701,42
0,591,4148,3578708659,3578708703,44
0,591,4149,3578708659,3578708704,45
0,591,4150,3578708659,3578708709,50
0,592,4151,3578708712,3578708712,0
0,592,4152,3578708712,3578708714,2
0,592,4153,3578708712,3578708716,4
0,592,4154,3578708712,3578708716,4
0,592,4155,3578708712,3578708718,6
0,592,4156,3578708712,3578708722,10
0,592,4157,3578708712,3578708724,12
0,592,4158,3578708712,3578708724,12
0,592,4159,3578708712,3578708726,14
0,592,4160,3578708712,3578708730,18
0,592,4161,3578708712,3578708732,20
0,592,4162,3578708712,3578708734,22
0,592,4163,3578708712,3578708739,27
0,592,4164,3578708712,3578708739,27
0,592,4165,3578708712,3578708742,30
0,592,4166,3578708712,3578708742,30
0,592,4167,3578708712,3578708751,39
0,592,4168,3578708712,3578708752,40
0,592,4169,3578708712,3578708754,42
0,592,4170,3578708712,3578708756,44
0,592,4171,3578708712,3578708756,44
0,592,4172,3578708712,3578708759,47
0,592,4173,3578708712,3578708759,47
0,592,4174,3578708712,3578708761,49
0,592,4175,3578708712,3578708761,49
0,592,4176,3578708712,3578708761,49
0,593,4177,3578708765,3578708765,0
0,593,4178,3578708765,3578708770,5
0,593,4179,3578708765,3578708772,7
0,593,4180,3578708765,3578708772,7
0,593,4181,3578708765,3578708773,8
0,593,4182,3578708765,3578708773,8
0,593,4183,3578708765,3578708774,9
0,593,4184,3578708765,3578708779,14
0,593,4185,3578708765,3578708780,15
0,593,4186,3578708765,3578708782,17
0,593,4187,3578708765,3578708783,18
0,593,4188,3578708765,3578708786,21
0,593,4189,3578708765,3578708786,21
0,593,4190,3578708765,3578708789,24
0,593,4191,3578708765,3578708792,27
0,593,4192,3578708765,3578708792,27
0,593,4193,3578708765,3578708795,30
0,593,4194,3578708765,3578708796,31
0,593,4195,3578708765,3578708800,35
0,593,4196,3578708765,3578708801,36
0,593,4197,3578708765,3578708805,40
0,593,4198,3578708765,3578708806,41
0,593,4199,3578708765,3578708812,47
0,593,4200,3578708765,3578708814,49
0,593,4201,3578708765,3578708815,50
0,594,4202,3578708817,3578708817,0
0,594,4203,3578708817,3578708817,0
0,594,4204,3578708817,3578708819,2
0,594,4205,3578708817,3578708822,5
0,594,4206,3578708817,3578708823,6
0,594,4207,3578708817,3578708825,8
0,594,4208,3578708817,3578708828,11
0,594,4209,3578708817,3578708830,13
0,594,4210,3578708817,3578708831,14
0,594,4211,3578708817,3578708833,16
0,594,4212,3578708817,3578708834,17
0,594,4213,3578708817,3578708838,21
0,594,4214,3578708817,3578708845,28
0,594,4215,3578708817,3578708849,32
0,594,4216,3578708817,3578708850,33
0,594,4217,3578708817,3578708852,35
0,594,4218,3578708817,3578708854,37
0,594,4219,3578708817,3578708858,41
0,594,4220,3578708817,3578708859,42
0,594,4221,3578708817,3578708862,45
0,594,4222,3578708817,3578708864,47
0,594,4223,3578708817,3578708865,48
0,594,4224,3578708817,3578708866,49
0,594,4225,3578708817,3578708867,50
0,595,4226,3578708870,3578708870,0
0,595,4227,3578708870,3578708870,0
0,595,4228,3578708870,3578708875,5
0,595,4229,3578708870,3578708876,6
0,595,4230,3578708870,3578708880,10
0,595,4231,3578708870,3578708883,13
0,595,4232,3578708870,3578708887,17
0,595,4233,3578708870,3578708887,17
0,595,4234,3578708870,3578708890,20
0,595,4235,3578708870,3578708890,20
0,595,4236,3578708870,3578708892,22
0,595,4237,3578708870,3578708893,23
0,595,4238,3578708870,3578708893,23
0,595,4239,3578708870,3578708895,25
0,595,4240,3578708870,3578708898,28
0,595,4241,3578708870,3578708901,31
0,595,4242,3578708870,3578708901,31
0,595,4243,3578708870,3578708903,33
0,595,4244,3578708870,3578708904,34
0,595,4245,3578708870,3578708909,39
0,595,4246,3578708870,3578708911,41
0,595,4247,3578708870,3578708913,43
0,595,4248,3578708870,3578708915,45
0,595,4249,3578708870,3578708916,46
0,595,4250,3578708870,3578708917,47
0,596,4251,3578708923,3578708923,0
0,596,4252,3578708923,3578708925,2
0,596,4253,3578708923,3578708926,3
0,596,4254,3578708923,3578708926,3
0,596,4255,3578708923,3578708929,6
0,596,4256,3578708923,3578708932,9
0,596,4257,3578708923,3578708935,12
0,596,4258,3578708923,3578708939,16
0,596,4259,3578708923,3578708939,16
0,596,4260,3578708923,3578708942,19
0,596,4261,3578708923,3578708942,19
0,596,4262,3578708923,3578708952,29
0,596,4263,3578708923,3578708952,29
0,596,4264,3578708923,3578708954,31
0,596,4265,3578708923,3578708956,33
0,596,4266,3578708923,3578708959,36
0,596,4267,3578708923,3578708959,36
0,596,4268,3578708923,3578708961,38
0,596,4269,3578708923,3578708961,38
0,596,4270,3578708923,3578708962,39
0,596,4271,3578708923,3578708964,41
0,596,4272,3578708923,3578708969,46
0,596,4273,3578708923,3578708971,48
0,596,4274,3578708923,3578708972,49
0,596,4275,3578708923,3578708972,49
0,597,4276,3578708976,3578708976,0
0,597,4277,3578708976,3578708977,1
0,597,4278,3578708976,3578708978,2
0,597,4279,3578708976,3578708980,4
0,597,4280,3578708976,3578708982,6
0,597,4281,3578708976,3578708983,7
0,597,4282,3578708976,3578708986,10
0,597,4283,3578708976,3578708987,11
0,597,4284,3578708976,3578708988,12
0,597,4285,3578708976,3578708992,16
0,597,4286,3578708976,3578708992,16
0,597,4287,3578708976,3578708996,20
0,597,4288,3578708976,3578708996,20
0,597,4289,3578708976,3578709001,25
0,597,4290,3578708976,3578709002,26
0,597,4291,3578708976,3578709006,30
0,597,4292,3578708976,3578709006,30
0,597,4293,3578708976,3578709013,37
0,597,4294,3578708976,3578709014,38
0,597,4295,3578708976,3578709015,39
0,597,4296,3578708976,3578709015,39
0,597,4297,3578708976,3578709016,40
0,597,4298,3578708976,3578709020,44
0,597,4299,3578708976,3578709021,45
0,597,4300,3578708976,3578709024,48
0,597,4301,3578708976,3578709025,49
0,598,4302,3578709029,3578709029,0
0,598,4303,3578709029,3578709029,0
0,598,4304,3578709029,3578709031,2
0,598,4305,3578709029,3578709031,2
0,598,4306,3578709029,3578709033,4
0,598,4307,3578709029,3578709034,5
0,598,4308,3578709029,3578709039,10
0,598,4309,3578709029,3578709044,15
0,598,4310,3578709029,3578709049,20
0,598,4311,3578709029,3578709050,21
0,598,4312,3578709029,3578709053,24
0,598,4313,3578709029,3578709055,26
0,598,4314,3578709029,3578709058,29
0,598,4315,3578709029,3578709059,30
0,598,4316,3578709029,3578709063,34
0,598,4317,3578709029,3578709064,35
0,598,4318,3578709029,3578709065,36
0,598,4319,3578709029,3578709066,37
0,598,4320,3578709029,3578709067,38
0,598,4321,3578709029,3578709069,40
0,598,4322,3578709029,3578709069,40
0,598,4323,3578709029,3578709077,48
0,598,4324,3578709029,3578709078,49
0,599,4325,3578709082,3578709082,0
0,599,4326,3578709082,3578709083,1
0,599,4327,3578709082,3578709087,5
0,599,4328,3578709082,3578709088,6
0,599,4329,3578709082,3578709089,7
0,599,4330,3578709082,3578709091,9
0,599,4331,3578709082,3578709092,10
0,599,4332,3578709082,3578709093,11
0,599,4333,3578709082,3578709093,11
0,599,4334,3578709082,3578709095,13
0,599,4335,3578709082,3578709098,16
0,599,4336,3578709082,3578709102,20
0,599,4337,3578709082,3578709102,20
0,599,4338,3578709082,3578709103,21
0,599,4339,3578709082,3578709104,22
0,599,4340,3578709082,3578709110,28
0,599,4341,3578709082,3578709111,29
0,599,4342,3578709082,3578709115,33
0,599,4343,3578709082,3578709115,33
0,599,4344,3578709082,3578709116,34
0,599,4345,3578709082,3578709117,35
0,599,4346,3578709082,3578709121,39
0,599,4347,3578709082,3578709125,43
0,599,4348,3578709082,3578709125,43
0,599,4349,3578709082,3578709129,47
0,599,4350,3578709082,3578709130,48
0,600,4351,3578709135,3578709135,0
0,600,4352,3578709135,3578709136,1
0,600,4353,3578709135,3578709139,4
0,600,4354,3578709135,3578709140,5
0,600,4355,3578709135,3578709142,7
0,600,4356,3578709135,3578709142,7
0,600,4357,3578709135,3578709152,17
0,600,4358,3578709135,3578709153,18
0,600,4359,3578709135,3578709155,20
0,600,4360,3578709135,3578709157,22
0,600,4361,3578709135,3578709158,23
0,600,4362,3578709135,3578709159,24
0,600,4363,3578709135,3578709160,25
0,600,4364,3578709135,3578709161,26
0,600,4365,3578709135,3578709162,27
0,600,4366,3578709135,3578709165,30
0,600,4367,3578709135,3578709170,35
0,600,4368,3578709135,3578709172,37
0,600,4369,3578709135,3578709172,37
0,600,4370,3578709135,3578709174,39
0,600,4371,3578709135,3578709179,44
0,600,4372,3578709135,3578709180,45
0,600,4373,3578709135,3578709180,45
0,600,4374,3578709135,3578709181,46
0,600,4375,3578709135,3578709183,48
0,601,4376,3578709188,3578709188,0
0,601,4377,3578709188,3578709188,0
0,601,4378,3578709188,3578709188,0
0,601,4379,3578709188,3578709193,5
0,601,4380,3578709188,3578709193,5
0,601,4381,3578709188,3578709196,8
0,601,4382,3578709188,3578709197,9
0,601,4383,3578709188,3578709201,13
0,601,4384,3578709188,3578709202,14
0,601,4385,3578709188,3578709206,18
0,601,4386,3578709188,3578709207,19
0,601,4387,3578709188,3578709213,25
0,601,4388,3578709188,3578709215,27
0,601,4389,3578709188,3578709215,27
0,601,4390,3578709188,3578709216,28
0,601,4391,3578709188,3578709217,29
0,601,4392,3578709188,3578709220,32
0,601,4393,3578709188,3578709221,33
0,601,4394,3578709188,3578709224,36
0,601,4395,3578709188,3578709226,38
0,601,4396,3578709188,3578709228,40
0,601,4397,3578709188,3578709231,43
0,601,4398,3578709188,3578709232,44
0,601,4399,3578709188,3578709233,45
0,601,4400,3578709188,3578709233,45
0,601,4401,3578709188,3578709235,47
0,602,4402,3578709241,3578709241,0
0,602,4403,3578709241,3578709244,3
0,602,4404,3578709241,3578709249,8
0,602,4405,3578709241,3578709250,9
0,602,4406,3578709241,3578709253,12
0,602,4407,3578709241,3578709256,15
0,602,4408,3578709241,3578709257,16
0,602,4409,3578709241,3578709259,18
0,602,4410,3578709241,3578709262,21
0,602,4411,3578709241,3578709265,24
0,602,4412,3578709241,3578709266,25
0,602,4413,3578709241,3578709266,25
0,602,4414,3578709241,3578709267,26
0,602,4415,3578709241,3578709269,28
0,602,4416,3578709241,3578709269,28
0,602,4417,3578709241,3578709277,36
0,602,4418,3578709241,3578709280,39
0,602,4419,3578709241,3578709283,42
0,602,4420,3578709241,3578709285,44
0,602,4421,3578709241,3578709287,46
0,602,4422,3578709241,3578709288,47
0,602,4423,3578709241,3578709289,48
0,602,4424,3578709241,3578709291,50
0,603,4425,3578709294,3578709294,0
0,603,4426,3578709294,3578709294,0
0,603,4427,3578709294,3578709295,1
0,603,4428,3578709294,3578709296,2
0,603,4429,3578709294,3578709299,5
0,603,4430,3578709294,3578709302,8
0,603,4431,3578709294,3578709302,8
0,603,4432,3578709294,3578709303,9
0,603,4433,3578709294,3578709305,11
0,603,4434,3578709294,3578709310,16
0,603,4435,3578709294,3578709311,17
0,603,4436,3578709294,3578709315,21
0,603,4437,3578709294,3578709316,22
0,603,4438,3578709294,3578709316,22
0,603,4439,3578709294,3578709317,23
0,603,4440,3578709294,3578709322,28
0,603,4441,3578709294,3578709324,30
0,603,4442,3578709294,3578709326,32
0,603,4443,3578709294,3578709330,36
0,603,4444,3578709294,3578709334,40
0,603,4445,3578709294,3578709337,43
0,603,4446,3578709294,3578709340,46
0,603,4447,3578709294,3578709340,46
0,603,4448,3578709294,3578709343,49
0,603,4449,3578709294,3578709343,49
0,604,4450,3578709347,3578709352,5
0,604,4451,3578709347,3578709352,5
0,604,4452,3578709347,3578709356,9
0,604,4453,3578709347,3578709357,10
0,604,4454,3578709347,3578709357,10
0,604,4455,3578709347,3578709359,12
0,604,4456,3578709347,3578709360,13
0,604,4457,3578709347,3578709361,14
0,604,4458,3578709347,3578709361,14
0,604,4459,3578709347,3578709362,15
0,604,4460,3578709347,3578709365,18
0,604,4461,3578709347,3578709371,24
0,604,4462,3578709347,3578709372,25
0,604,4463,3578709347,3578709372,25
0,604,4464,3578709347,3578709374,27
0,604,4465,3578709347,3578709379,32
0,604,4466,3578709347,3578709380,33
0,604,4467,3578709347,3578709381,34
0,604,4468,3578709347,3578709381,34
0,604,4469,3578709347,3578709383,36
0,604,4470,3578709347,3578709384,37
0,604,4471,3578709347,3578709387,40
0,604,4472,3578709347,3578709387,40
0,604,4473,3578709347,3578709388,41
0,604,4474,3578709347,3578709392,45
0,604,4475,3578709347,3578709393,46
0,604,4476,3578709347,3578709396,49
0,604,4477,3578709347,3578709397,50
0,605,4478,3578709400,3578709401,1
0,605,4479,3578709400,3578709401,1
0,605,4480,3578709400,3578709405,5
0,605,4481,3578709400,3578709406,6
0,605,4482,3578709400,3578709413,13
0,605,4483,3578709400,3578709415,15
0,605,4484,3578709400,3578709415,15
0,605,4485,3578709400,3578709416,16
0,605,4486,3578709400,3578709418,18
0,605,4487,3578709400,3578709419,19
0,605,4488,3578709400,3578709422,22
0,605,4489,3578709400,3578709423,23
0,605,4490,3578709400,3578709425,25
0,605,4491,3578709400,3578709428,28
0,605,4492,3578709400,3578709431,31
0,605,4493,3578709400,3578709432,32
0,605,4494,3578709400,3578709433,33
0,605,4495,3578709400,3578709435,35
0,605,4496,3578709400,3578709435,35
0,605,4497,3578709400,3578709440,40
0,605,4498,3578709400,3578709444,44
0,605,4499,3578709400,3578709450,50
0,605,4500,3578709400,3578709450,50
0,606,4501,3578709453,3578709453,0
0,606,4502,3578709453,3578709455,2
0,606,4503,3578709453,3578709458,5
0,606,4504,3578709453,3578709459,6
0,606,4505,3578709453,3578709462,9
0,606,4506,3578709453,3578709465,12
0,606,4507,3578709453,3578709466,13
0,606,4508,3578709453,3578709467,14
0,606,4509,3578709453,3578709467,14
0,606,4510,3578709453,3578709469,16
0,606,4511,3578709453,3578709469,16
0,606,4512,3578709453,3578709477,24
0,606,4513,3578709453,3578709480,27
0,606,4514,3578709453,3578709484,31
0,606,4515,3578709453,3578709486,33
0,606,4516,3578709453,3578709487,34
0,606,4517,3578709453,3578709487,34
0,606,4518,3578709453,3578709489,36
0,606,4519,3578709453,3578709491,38
0,606,4520,3578709453,3578709492,39
0,606,4521,3578709453,3578709494,41
0,606,4522,3578709453,3578709495,42
0,606,4523,3578709453,3578709496,43
0,606,4524,3578709453,3578709499,46
0,606,4525,3578709453,3578709502,49
0,606,4526,3578709453,3578709502,49
0,606,4527,3578709453,3578709503,50
0,607,4528,3578709506,3578709506,0
0,607,4529,3578709506,3578709509,3
0,607,4530,3578709506,3578709510,4
0,607,4531,3578709506,3578709513,7
0,607,4532,3578709506,3578709514,8
0,607,4533,3578709506,3578709517,11
0,607,4534,3578709506,3578709521,15
0,607,4535,3578709506,3578709524,18
0,607,4536,3578709506,3578709525,19
0,607,4537,3578709506,3578709530,24
0,607,4538,3578709506,3578709533,27
0,607,4539,3578709506,3578709536,30
0,607,4540,3578709506,3578709536,30
0,607,4541,3578709506,3578709539,33
0,607,4542,3578709506,3578709539,33
0,607,4543,3578709506,3578709542,36
0,607,4544,3578709506,3578709542,36
0,607,4545,3578709506,3578709551,45
0,607,4546,3578709506,3578709552,46
0,607,4547,3578709506,3578709556,50
0,608,4548,3578709559,3578709559,0
0,608,4549,3578709559,3578709559,0
0,608,4550,3578709559,3578709559,0
0,608,4551,3578709559,3578709559,0
0,608,4552,3578709559,3578709560,1
0,608,4553,3578709559,3578709560,1
0,608,4554,3578709559,3578709562,3
0,608,4555,3578709559,3578709564,5
0,608,4556,3578709559,3578709570,11
0,608,4557,3578709559,3578709571,12
0,608,4558,3578709559,3578709571,12
0,608,4559,3578709559,3578709573,14
0,608,4560,3578709559,3578709578,19
0,608,4561,3578709559,3578709579,20
0,608,4562,3578709559,3578709580,21
0,608,4563,3578709559,3578709580,21
0,608,4564,3578709559,3578709583,24
0,608,4565,3578709559,3578709583,24
0,608,4566,3578709559,3578709586,27
0,608,4567,3578709559,3578709586,27
0,608,4568,3578709559,3578709587,28
0,608,4569,3578709559,3578709588,29
0,608,4570,3578709559,3578709592,33
0,608,4571,3578709559,3578709593,34
0,608,4572,3578709559,3578709595,36
0,608,4573,3578709559,3578709596,37
0,608,4574,3578709559,3578709600,41
0,608,4575,3578709559,3578709605,46
0,608,4576,3578709559,3578709606,47
0,609,4577,3578709612,3578709612,0
0,609,4578,3578709612,3578709614,2
0,609,4579,3578709612,3578709614,2
0,609,4580,3578709612,3578709616,4
0,609,4581,3578709612,3578709619,7
0,609,4582,3578709612,3578709621,9
0,609,4583,3578709612,3578709622,10
0,609,4584,3578709612,3578709624,12
0,609,4585,3578709612,3578709628,16
0,609,4586,3578709612,3578709630,18
0,609,4587,3578709612,3578709631,19
0,609,4588,3578709612,3578709633,21
0,609,4589,3578709612,3578709633,21
0,609,4590,3578709612,3578709638,26
0,609,4591,3578709612,3578709639,27
0,609,4592,3578709612,3578709643,31
0,609,4593,3578709612,3578709649,37
0,609,4594,3578709612,3578709649,37
0,609,4595,3578709612,3578709652,40
0,609,4596,3578709612,3578709654,42
0,609,4597,3578709612,3578709657,45
0,609,4598,3578709612,3578709659,47
0,609,4599,3578709612,3578709661,49
0,610,4600,3578709665,3578709665,0
0,610,4601,3578709665,3578709665,0
0,610,4602,3578709665,3578709666,1
0,610,4603,3578709665,3578709666,1
0,610,4604,3578709665,3578709669,4
0,610,4605,3578709665,3578709670,5
0,610,4606,3578709665,3578709677,12
0,610,4607,3578709665,3578709680,15
0,610,4608,3578709665,3578709684,19
0,610,4609,3578709665,3578709687,22
0,610,4610,3578709665,3578709688,23
0,610,4611,3578709665,3578709688,23
0,610,4612,3578709665,3578709689,24
0,610,4613,3578709665,3578709691,26
0,610,4614,3578709665,3578709693,28
0,610,4615,3578709665,3578709694,29
0,610,4616,3578709665,3578709695,30
0,610,4617,3578709665,3578709696,31
0,610,4618,3578709665,3578709699,34
0,610,4619,3578709665,3578709702,37
0,610,4620,3578709665,3578709702,37
0,610,4621,3578709665,3578709703,38
0,610,4622,3578709665,3578709704,39
0,610,4623,3578709665,3578709709,44
0,610,4624,3578709665,3578709711,46
0,610,4625,3578709665,3578709714,49
0,610,4626,3578709665,3578709715,50
0,611,4627,3578709718,3578709718,0
0,611,4628,3578709718,3578709720,2
0,611,4629,3578709718,3578709724,6
0,611,4630,3578709718,3578709725,7
0,611,4631,3578709718,3578709730,12
0,611,4632,3578709718,3578709733,15
0,611,4633,3578709718,3578709733,15
0,611,4634,3578709718,3578709735,17
0,611,4635,3578709718,3578709739,21
0,611,4636,3578709718,3578709739,21
0,611,4637,3578709718,3578709739,21
0,611,4638,3578709718,3578709742,24
0,611,4639,3578709718,3578709742,24
0,611,4640,3578709718,3578709751,33
0,611,4641,3578709718,3578709752,34
0,611,4642,3578709718,3578709756,38
0,611,4643,3578709718,3578709756,38
0,611,4644,3578709718,3578709757,39
0,611,4645,3578709718,3578709757,39
0,611,4646,3578709718,3578709760,42
0,611,4647,3578709718,3578709760,42
0,611,4648,3578709718,3578709764,46
0,612,4649,3578709771,3578709771,0
0,612,4650,3578709771,3578709771,0
0,612,4651,3578709771,3578709772,1
0,612,4652,3578709771,3578709773,2
0,612,4653,3578709771,3578709773,2
0,612,4654,3578709771,3578709778,7
0,612,4655,3578709771,3578709779,8
0,612,4656,3578709771,3578709780,9
0,612,4657,3578709771,3578709780,9
0,612,4658,3578709771,3578709783,12
0,612,4659,3578709771,3578709784,13
0,612,4660,3578709771,3578709787,16
0,612,4661,3578709771,3578709787,16
0,612,4662,3578709771,3578709788,17
0,612,4663,3578709771,3578709789,18
0,612,4664,3578709771,3578709792,21
0,612,4665,3578709771,3578709793,22
0,612,4666,3578709771,3578709795,24
0,612,4667,3578709771,3578709796,25
0,612,4668,3578709771,3578709800,29
0,612,4669,3578709771,3578709805,34
0,612,4670,3578709771,3578709806,35
0,612,4671,3578709771,3578709812,41
0,612,4672,3578709771,3578709814,43
0,612,4673,3578709771,3578709815,44
0,612,4674,3578709771,3578709817,46
0,612,4675,3578709771,3578709819,48
0,613,4676,3578709824,3578709824,0
0,613,4677,3578709824,3578709824,0
0,613,4678,3578709824,3578709824,0
0,613,4679,3578709824,3578709827,3
0,613,4680,3578709824,3578709831,7
0,613,4681,3578709824,3578709831,7
0,613,4682,3578709824,3578709832,8
0,613,4683,3578709824,3578709835,11
0,613,4684,3578709824,3578709838,14
0,613,4685,3578709824,3578709840,16
0,613,4686,3578709824,3578709840,16
0,613,4687,3578709824,3578709843,19
0,613,4688,3578709824,3578709849,25
0,613,4689,3578709824,3578709849,25
0,613,4690,3578709824,3578709855,31
0,613,4691,3578709824,3578709856,32
0,613,4692,3578709824,3578709859,35
0,613,4693,3578709824,3578709862,38
0,613,4694,3578709824,3578709864,40
0,613,4695,3578709824,3578709866,42
0,613,4696,3578709824,3578709866,42
0,613,4697,3578709824,3578709867,43
0,613,4698,3578709824,3578709869,45
0,613,4699,3578709824,3578709869,45
0,614,4700,3578709877,3578709877,0
0,614,4701,3578709877,3578709879,2
0,614,4702,3578709877,3578709884,7
0,614,4703,3578709877,3578709887,10
0,614,4704,3578709877,3578709888,11
0,614,4705,3578709877,3578709889,12
0,614,4706,3578709877,3578709891,14
0,614,4707,3578709877,3578709891,14
0,614,4708,3578709877,3578709893,16
0,614,4709,3578709877,3578709895,18
0,614,4710,3578709877,3578709895,18
0,614,4711,3578709877,3578709896,19
0,614,4712,3578709877,3578709899,22
0,614,4713,3578709877,3578709902,25
0,614,4714,3578709877,3578709902,25
0,614,4715,3578709877,3578709902,25
0,614,4716,3578709877,3578709905,28
0,614,4717,3578709877,3578709910,33
0,614,4718,3578709877,3578709910,33
0,614,4719,3578709877,3578709914,37
0,614,4720,3578709877,3578709914,37
0,614,4721,3578709877,3578709915,38
0,614,4722,3578709877,3578709918,41
0,614,4723,3578709877,3578709920,43
0,614,4724,3578709877,3578709924,47
0,614,4725,3578709877,3578709926,49
0,615,4726,3578709930,3578709930,0
0,615,4727,3578709930,3578709932,2
0,615,4728,3578709930,3578709933,3
0,615,4729,3578709930,3578709936,6
0,615,4730,3578709930,3578709939,9
0,615,4731,3578709930,3578709939,9
0,615,4732,3578709930,3578709942,12
0,615,4733,3578709930,3578709942,12
0,615,4734,3578709930,3578709942,12
0,615,4735,3578709930,3578709951,21
0,615,4736,3578709930,3578709952,22
0,615,4737,3578709930,3578709956,26
0,615,4738,3578709930,3578709956,26
0,615,4739,3578709930,3578709957,27
0,615,4740,3578709930,3578709958,28
0,615,4741,3578709930,3578709960,30
0,615,4742,3578709930,3578709961,31
0,615,4743,3578709930,3578709961,31
0,615,4744,3578709930,3578709964,34
0,615,4745,3578709930,3578709971,41
0,615,4746,3578709930,3578709972,42
0,615,4747,3578709930,3578709972,42
0,615,4748,3578709930,3578709974,44
0,615,4749,3578709930,3578709978,48
0,615,4750,3578709930,3578709980,50
0,616,4751,3578709983,3578709983,0
0,616,4752,3578709983,3578709983,0
0,616,4753,3578709983,3578709983,0
0,616,4754,3578709983,3578709984,1
0,616,4755,3578709983,3578709986,3
0,616,4756,3578709983,3578709987,4
0,616,4757,3578709983,3578709989,6
0,616,4758,3578709983,3578709992,9
0,616,4759,3578709983,3578709993,10
0,616,4760,3578709983,3578709993,10
0,616,4761,3578709983,3578709995,12
0,616,4762,3578709983,3578709997,14
0,616,4763,3578709983,3578710002,19
0,616,4764,3578709983,3578710005,22
0,616,4765,3578709983,3578710006,23
0,616,4766,3578709983,3578710013,30
0,616,4767,3578709983,3578710015,32
0,616,4768,3578709983,3578710015,32
0,616,4769,3578709983,3578710018,35
0,616,4770,3578709983,3578710019,36
0,616,4771,3578709983,3578710021,38
0,616,4772,3578709983,3578710024,41
0,616,4773,3578709983,3578710024,41
0,616,4774,3578709983,3578710028,45
0,616,4775,3578709983,3578710031,48
0,616,4776,3578709983,3578710031,48
0,617,4777,3578710036,3578710036,0
0,617,4778,3578710036,3578710036,0
0,617,4779,3578710036,3578710038,2
0,617,4780,3578710036,3578710040,4
0,617,4781,3578710036,3578710040,4
0,617,4782,3578710036,3578710043,7
0,617,4783,3578710036,3578710043,7
0,617,4784,3578710036,3578710049,13
0,617,4785,3578710036,3578710050,14
0,617,4786,3578710036,3578710055,19
0,617,4787,3578710036,3578710057,21
0,617,4788,3578710036,3578710059,23
0,617,4789,3578710036,3578710062,26
0,617,4790,3578710036,3578710064,28
0,617,4791,3578710036,3578710066,30
0,617,4792,3578710036,3578710066,30
0,617,4793,3578710036,3578710067,31
0,617,4794,3578710036,3578710069,33
0,617,4795,3578710036,3578710069,33
0,617,4796,3578710036,3578710076,40
0,617,4797,3578710036,3578710079,43
0,617,4798,3578710036,3578710084,48
0,618,4799,3578710088,3578710088,0
0,618,4800,3578710088,3578710088,0
0,618,4801,3578710088,3578710089,1
0,618,4802,3578710088,3578710089,1
0,618,4803,3578710088,3578710091,3
0,618,4804,3578710088,3578710093,5
0,618,4805,3578710088,3578710094,6
0,618,4806,3578710088,3578710095,7
0,618,4807,3578710088,3578710095,7
0,618,4808,3578710088,3578710096,8
0,618,4809,3578710088,3578710099,11
0,618,4810,3578710088,3578710102,14
0,618,4811,3578710088,3578710102,14
0,618,4812,3578710088,3578710103,15
0,618,4813,3578710088,3578710105,17
0,618,4814,3578710088,3578710110,22
0,618,4815,3578710088,3578710110,22
0,618,4816,3578710088,3578710114,26
0,618,4817,3578710088,3578710115,27
0,618,4818,3578710088,3578710116,28
0,618,4819,3578710088,3578710118,30
0,618,4820,3578710088,3578710120,32
0,618,4821,3578710088,3578710124,36
0,618,4822,3578710088,3578710126,38
0,618,4823,3578710088,3578710130,42
0,618,4824,3578710088,3578710132,44
0,618,4825,3578710088,3578710133,45
0,618,4826,3578710088,3578710136,48
0,619,4827,3578710141,3578710141,0
0,619,4828,3578710141,3578710141,0
0,619,4829,3578710141,3578710142,1
0,619,4830,3578710141,3578710142,1
0,619,4831,3578710141,3578710143,2
0,619,4832,3578710141,3578710144,3
0,619,4833,3578710141,3578710152,11
0,619,4834,3578710141,3578710153,12
0,619,4835,3578710141,3578710156,15
0,619,4836,3578710141,3578710156,15
0,619,4837,3578710141,3578710158,17
0,619,4838,3578710141,3578710160,19
0,619,4839,3578710141,3578710160,19
0,619,4840,3578710141,3578710161,20
0,619,4841,3578710141,3578710161,20
0,619,4842,3578710141,3578710165,24
0,619,4843,3578710141,3578710170,29
0,619,4844,3578710141,3578710172,31
0,619,4845,3578710141,3578710173,32
0,619,4846,3578710141,3578710174,33
0,619,4847,3578710141,3578710180,39
0,619,4848,3578710141,3578710180,39
0,619,4849,3578710141,3578710180,39
0,619,4850,3578710141,3578710181,40
0,619,4851,3578710141,3578710183,42
0,619,4852,3578710141,3578710184,43
0,619,4853,3578710141,3578710187,46
0,619,4854,3578710141,3578710187,46
0,619,4855,3578710141,3578710189,48
0,620,4856,3578710194,3578710194,0
0,620,4857,3578710194,3578710194,0
0,620,4858,3578710194,3578710195,1
0,620,4859,3578710194,3578710195,1
0,620,4860,3578710194,3578710196,2
0,620,4861,3578710194,3578710201,7
0,620,4862,3578710194,3578710205,11
0,620,4863,3578710194,3578710206,12
0,620,4864,3578710194,3578710214,20
0,620,4865,3578710194,3578710215,21
0,620,4866,3578710194,3578710215,21
0,620,4867,3578710194,3578710216,22
0,620,4868,3578710194,3578710217,23
0,620,4869,3578710194,3578710219,25
0,620,4870,3578710194,3578710221,27
0,620,4871,3578710194,3578710224,30
0,620,4872,3578710194,3578710224,30
0,620,4873,3578710194,3578710228,34
0,620,4874,3578710194,3578710230,36
0,620,4875,3578710194,3578710231,37
0,620,4876,3578710194,3578710233,39
0,620,4877,3578710194,3578710235,41
0,620,4878,3578710194,3578710238,44
0,620,4879,3578710194,3578710240,46
0,620,4880,3578710194,3578710241,47
0,620,4881,3578710194,3578710243,49
0,621,4882,3578710247,3578710247,0
0,621,4883,3578710247,3578710249,2
0,621,4884,3578710247,3578710249,2
0,621,4885,3578710247,3578710253,6
0,621,4886,3578710247,3578710255,8
0,621,4887,3578710247,3578710256,9
0,621,4888,3578710247,3578710259,12
0,621,4889,3578710247,3578710263,16
0,621,4890,3578710247,3578710265,18
0,621,4891,3578710247,3578710267,20
0,621,4892,3578710247,3578710267,20
0,621,4893,3578710247,3578710267,20
0,621,4894,3578710247,3578710269,22
0,621,4895,3578710247,3578710270,23
0,621,4896,3578710247,3578710276,29
0,621,4897,3578710247,3578710280,33
0,621,4898,3578710247,3578710284,37
0,621,4899,3578710247,3578710287,40
0,621,4900,3578710247,3578710288,41
0,621,4901,3578710247,3578710289,42
0,621,4902,3578710247,3578710289,42
0,621,4903,3578710247,3578710290,43
0,621,4904,3578710247,3578710292,45
0,621,4905,3578710247,3578710294,47
0,621,4906,3578710247,3578710295,48
0,621,4907,3578710247,3578710296,49
0,621,4908,3578710247,3578710296,49
0,622,4909,3578710301,3578710301,0
0,622,4910,3578710301,3578710302,1
0,622,4911,3578710301,3578710304,3
0,622,4912,3578710301,3578710306,5
0,622,4913,3578710301,3578710310,9
0,622,4914,3578710301,3578710311,10
0,622,4915,3578710301,3578710314,13
0,622,4916,3578710301,3578710316,15
0,622,4917,3578710301,3578710317,16
0,622,4918,3578710301,3578710318,17
0,622,4919,3578710301,3578710321,20
0,622,4920,3578710301,3578710325,24
0,622,4921,3578710301,3578710326,25
0,622,4922,3578710301,3578710329,28
0,622,4923,3578710301,3578710332,31
0,622,4924,3578710301,3578710333,32
0,622,4925,3578710301,3578710336,35
0,622,4926,3578710301,3578710340,39
0,622,4927,3578710301,3578710342,41
0,622,4928,3578710301,3578710343,42
0,622,4929,3578710301,3578710343,42
0,622,4930,3578710301,3578710347,46
0,623,4931,3578710354,3578710354,0
0,623,4932,3578710354,3578710354,0
0,623,4933,3578710354,3578710355,1
0,623,4934,3578710354,3578710356,2
0,623,4935,3578710354,3578710357,3
0,623,4936,3578710354,3578710358,4
0,623,4937,3578710354,3578710360,6
0,623,4938,3578710354,3578710360,6
0,623,4939,3578710354,3578710361,7
0,623,4940,3578710354,3578710361,7
0,623,4941,3578710354,3578710365,11
0,623,4942,3578710354,3578710370,16
0,623,4943,3578710354,3578710371,17
0,623,4944,3578710354,3578710372,18
0,623,4945,3578710354,3578710373,19
0,623,4946,3578710354,3578710374,20
0,623,4947,3578710354,3578710379,25
0,623,4948,3578710354,3578710380,26
0,623,4949,3578710354,3578710381,27
0,623,4950,3578710354,3578710381,27
0,623,4951,3578710354,3578710383,29
0,623,4952,3578710354,3578710384,30
0,623,4953,3578710354,3578710387,33
0,623,4954,3578710354,3578710388,34
0,623,4955,3578710354,3578710388,34
0,623,4956,3578710354,3578710392,38
0,623,4957,3578710354,3578710393,39
0,623,4958,3578710354,3578710395,41
0,623,4959,3578710354,3578710397,43
0,623,4960,3578710354,3578710398,44
0,623,4961,3578710354,3578710401,47
0,623,4962,3578710354,3578710402,48
0,624,4963,3578710406,3578710406,0
0,624,4964,3578710406,3578710407,1
0,624,4965,3578710406,3578710413,7
0,624,4966,3578710406,3578710415,9
0,624,4967,3578710406,3578710415,9
0,624,4968,3578710406,3578710415,9
0,624,4969,3578710406,3578710417,11
0,624,4970,3578710406,3578710419,13
0,624,4971,3578710406,3578710421,15
0,624,4972,3578710406,3578710423,17
0,624,4973,3578710406,3578710424,18
0,624,4974,3578710406,3578710429,23
0,624,4975,3578710406,3578710430,24
0,624,4976,3578710406,3578710431,25
0,624,4977,3578710406,3578710433,27
0,624,4978,3578710406,3578710435,29
0,624,4979,3578710406,3578710438,32
0,624,4980,3578710406,3578710440,34
0,624,4981,3578710406,3578710442,36
0,624,4982,3578710406,3578710444,38
0,624,4983,3578710406,3578710449,43
0,624,4984,3578710406,3578710450,44
0,624,4985,3578710406,3578710451,45
0,624,4986,3578710406,3578710453,47
0,624,4987,3578710406,3578710455,49
0,625,4988,3578710459,3578710459,0
0,625,4989,3578710459,3578710459,0
0,625,4990,3578710459,3578710463,4
0,625,4991,3578710459,3578710465,6
0,625,4992,3578710459,3578710466,7
0,625,4993,3578710459,3578710467,8
0,625,4994,3578710459,3578710467,8
0,625,4995,3578710459,3578710469,10
0,625,4996,3578710459,3578710470,11
0,625,4997,3578710459,3578710477,18
0,625,4998,3578710459,3578710480,21
0,625,4999,3578710459,3578710483,24
0,625,5000,3578710459,3578710488,29
0,625,5001,3578710459,3578710488,29
0,625,5002,3578710459,3578710489,30
0,625,5003,3578710459,3578710489,30
0,625,5004,3578710459,3578710491,32
0,625,5005,3578710459,3578710493,34
0,625,5006,3578710459,3578710494,35
0,625,5007,3578710459,3578710495,36
0,625,5008,3578710459,3578710496,37
0,625,5009,3578710459,3578710500,41
0,625,5010,3578710459,3578710501,42
0,625,5011,3578710459,3578710502,43
0,625,5012,3578710459,3578710502,43
0,625,5013,3578710459,3578710504,45
0,625,5014,3578710459,3578710506,47
0,626,5015,3578710513,3578710513,0
0,626,5016,3578710513,3578710513,0
0,626,5017,3578710513,3578710514,1
0,626,5018,3578710513,3578710515,2
0,626,5019,3578710513,3578710516,3
0,626,5020,3578710513,3578710518,5
0,626,5021,3578710513,3578710519,6
0,626,5022,3578710513,3578710523,10
0,626,5023,3578710513,3578710525,12
0,626,5024,3578710513,3578710530,17
0,626,5025,3578710513,3578710532,19
0,626,5026,3578710513,3578710533,20
0,626,5027,3578710513,3578710535,22
0,626,5028,3578710513,3578710539,26
0,626,5029,3578710513,3578710539,26
0,626,5030,3578710513,3578710541,28
0,626,5031,3578710513,3578710542,29
0,626,5032,3578710513,3578710543,30
0,626,5033,3578710513,3578710550,37
0,626,5034,3578710513,3578710551,38
0,626,5035,3578710513,3578710551,38
0,626,5036,3578710513,3578710554,41
0,626,5037,3578710513,3578710555,42
0,626,5038,3578710513,3578710556,43
0,626,5039,3578710513,3578710558,45
0,626,5040,3578710513,3578710559,46
0,626,5041,3578710513,3578710559,46
0,626,5042,3578710513,3578710560,47
0,626,5043,3578710513,3578710561,48
0,627,5044,3578710567,3578710567,0
0,627,5045,3578710567,3578710569,2
0,627,5046,3578710567,3578710570,3
0,627,5047,3578710567,3578710571,4
0,627,5048,3578710567,3578710572,5
0,627,5049,3578710567,3578710573,6
0,627,5050,3578710567,3578710578,11
0,627,5051,3578710567,3578710579,12
0,627,5052,3578710567,3578710579,12
0,627,5053,3578710567,3578710580,13
0,627,5054,3578710567,3578710583,16
0,627,5055,3578710567,3578710583,16
0,627,5056,3578710567,3578710586,19
0,627,5057,3578710567,3578710587,20
0,627,5058,3578710567,3578710588,21
0,627,5059,3578710567,3578710592,25
0,627,5060,3578710567,3578710593,26
0,627,5061,3578710567,3578710595,28
0,627,5062,3578710567,3578710596,29
0,627,5063,3578710567,3578710600,33
0,627,5064,3578710567,3578710600,33
0,627,5065,3578710567,3578710601,34
0,627,5066,3578710567,3578710605,38
0,627,5067,3578710567,3578710606,39
0,627,5068,3578710567,3578710612,45
0,627,5069,3578710567,3578710614,47
0,627,5070,3578710567,3578710614,47
0,627,5071,3578710567,3578710615,48
0,627,5072,3578710567,3578710616,49
0,628,5073,3578710620,3578710620,0
0,628,5074,3578710620,3578710623,3
0,628,5075,3578710620,3578710623,3
0,628,5076,3578710620,3578710628,8
0,628,5077,3578710620,3578710631,11
0,628,5078,3578710620,3578710631,11
0,628,5079,3578710620,3578710633,13
0,628,5080,3578710620,3578710635,15
0,628,5081,3578710620,3578710636,16
0,628,5082,3578710620,3578710640,20
0,628,5083,3578710620,3578710641,21
0,628,5084,3578710620,3578710644,24
0,628,5085,3578710620,3578710648,28
0,628,5086,3578710620,3578710648,28
0,628,5087,3578710620,3578710650,30
0,628,5088,3578710620,3578710651,31
0,628,5089,3578710620,3578710652,32
0,628,5090,3578710620,3578710654,34
0,628,5091,3578710620,3578710657,37
0,628,5092,3578710620,3578710659,39
0,628,5093,3578710620,3578710662,42
0,628,5094,3578710620,3578710664,44
0,628,5095,3578710620,3578710665,45
0,628,5096,3578710620,3578710666,46
0,628,5097,3578710620,3578710667,47
0,628,5098,3578710620,3578710669,49
0,628,5099,3578710620,3578710670,50
0,629,5100,3578710673,3578710677,4
0,629,5101,3578710673,3578710679,6
0,629,5102,3578710673,3578710684,11
0,629,5103,3578710673,3578710687,14
0,629,5104,3578710673,3578710688,15
0,629,5105,3578710673,3578710689,16
0,629,5106,3578710673,3578710689,16
0,629,5107,3578710673,3578710691,18
0,629,5108,3578710673,3578710693,20
0,629,5109,3578710673,3578710695,22
0,629,5110,3578710673,3578710695,22
0,629,5111,3578710673,3578710696,23
0,629,5112,3578710673,3578710700,27
0,629,5113,3578710673,3578710702,29
0,629,5114,3578710673,3578710702,29
0,629,5115,3578710673,3578710702,29
0,629,5116,3578710673,3578710704,31
0,629,5117,3578710673,3578710707,34
0,629,5118,3578710673,3578710711,38
0,629,5119,3578710673,3578710711,38
0,629,5120,3578710673,3578710714,41
0,629,5121,3578710673,3578710715,42
0,629,5122,3578710673,3578710715,42
0,629,5123,3578710673,3578710718,45
0,630,5124,3578710727,3578710727,0
0,630,5125,3578710727,3578710727,0
0,630,5126,3578710727,3578710729,2
0,630,5127,3578710727,3578710732,5
0,630,5128,3578710727,3578710733,6
0,630,5129,3578710727,3578710736,9
0,630,5130,3578710727,3578710739,12
0,630,5131,3578710727,3578710739,12
0,630,5132,3578710727,3578710741,14
0,630,5133,3578710727,3578710742,15
0,630,5134,3578710727,3578710742,15
0,630,5135,3578710727,3578710752,25
0,630,5136,3578710727,3578710752,25
0,630,5137,3578710727,3578710753,26
0,630,5138,3578710727,3578710755,28
0,630,5139,3578710727,3578710755,28
0,630,5140,3578710727,3578710759,32
0,630,5141,3578710727,3578710760,33
0,630,5142,3578710727,3578710760,33
0,630,5143,3578710727,3578710761,34
0,630,5144,3578710727,3578710761,34
0,630,5145,3578710727,3578710764,37
0,630,5146,3578710727,3578710770,43
0,630,5147,3578710727,3578710771,44
0,630,5148,3578710727,3578710772,45
0,630,5149,3578710727,3578710773,46
0,631,5150,3578710780,3578710780,0
0,631,5151,3578710780,3578710780,0
0,631,5152,3578710780,3578710780,0
0,631,5153,3578710780,3578710780,0
0,631,5154,3578710780,3578710783,3
0,631,5155,3578710780,3578710784,4
0,631,5156,3578710780,3578710786,6
0,631,5157,3578710780,3578710787,7
0,631,5158,3578710780,3578710787,7
0,631,5159,3578710780,3578710792,12
0,631,5160,3578710780,3578710793,13
0,631,5161,3578710780,3578710795,15
0,631,5162,3578710780,3578710796,16
0,631,5163,3578710780,3578710800,20
0,631,5164,3578710780,3578710803,23
0,631,5165,3578710780,3578710804,24
0,631,5166,3578710780,3578710806,26
0,631,5167,3578710780,3578710813,33
0,631,5168,3578710780,3578710814,34
0,631,5169,3578710780,3578710815,35
0,631,5170,3578710780,3578710815,35
0,631,5171,3578710780,3578710816,36
0,631,5172,3578710780,3578710818,38
0,631,5173,3578710780,3578710824,44
0,631,5174,3578710780,3578710824,44
0,631,5175,3578710780,3578710827,47
0,632,5176,3578710833,3578710833,0
0,632,5177,3578710833,3578710833,0
0,632,5178,3578710833,3578710833,0
0,632,5179,3578710833,3578710834,1
0,632,5180,3578710833,3578710837,4
0,632,5181,3578710833,3578710840,7
0,632,5182,3578710833,3578710840,7
0,632,5183,3578710833,3578710843,10
0,632,5184,3578710833,3578710849,16
0,632,5185,3578710833,3578710849,16
0,632,5186,3578710833,3578710849,16
0,632,5187,3578710833,3578710852,19
0,632,5188,3578710833,3578710854,21
0,632,5189,3578710833,3578710854,21
0,632,5190,3578710833,3578710857,24
0,632,5191,3578710833,3578710859,26
0,632,5192,3578710833,3578710862,29
0,632,5193,3578710833,3578710864,31
0,632,5194,3578710833,3578710865,32
0,632,5195,3578710833,3578710866,33
0,632,5196,3578710833,3578710866,33
0,632,5197,3578710833,3578710869,36
0,632,5198,3578710833,3578710870,37
0,632,5199,3578710833,3578710876,43
0,632,5200,3578710833,3578710880,47
0,633,5201,3578710886,3578710886,0
0,633,5202,3578710886,3578710887,1
0,633,5203,3578710886,3578710888,2
0,633,5204,3578710886,3578710889,3
0,633,5205,3578710886,3578710889,3
0,633,5206,3578710886,3578710891,5
0,633,5207,3578710886,3578710893,7
0,633,5208,3578710886,3578710895,9
0,633,5209,3578710886,3578710895,9
0,633,5210,3578710886,3578710896,10
0,633,5211,3578710886,3578710900,14
0,633,5212,3578710886,3578710902,16
0,633,5213,3578710886,3578710902,16
0,633,5214,3578710886,3578710902,16
0,633,5215,3578710886,3578710905,19
0,633,5216,3578710886,3578710905,19
0,633,5217,3578710886,3578710907,21
0,633,5218,3578710886,3578710911,25
0,633,5219,3578710886,3578710911,25
0,633,5220,3578710886,3578710914,28
0,633,5221,3578710886,3578710915,29
0,633,5222,3578710886,3578710916,30
0,633,5223,3578710886,3578710918,32
0,633,5224,3578710886,3578710924,38
0,633,5225,3578710886,3578710925,39
0,633,5226,3578710886,3578710930,44
0,633,5227,3578710886,3578710933,47
0,633,5228,3578710886,3578710933,47
0,633,5229,3578710886,3578710935,49
0,634,5230,3578710939,3578710939,0
0,634,5231,3578710939,3578710939,0
0,634,5232,3578710939,3578710941,2
0,634,5233,3578710939,3578710942,3
0,634,5234,3578710939,3578710943,4
0,634,5235,3578710939,3578710951,12
0,634,5236,3578710939,3578710952,13
0,634,5237,3578710939,3578710954,15
0,634,5238,3578710939,3578710955,16
0,634,5239,3578710939,3578710955,16
0,634,5240,3578710939,3578710956,17
0,634,5241,3578710939,3578710959,20
0,634,5242,3578710939,3578710959,20
0,634,5243,3578710939,3578710961,22
0,634,5244,3578710939,3578710961,22
0,634,5245,3578710939,3578710962,23
0,634,5246,3578710939,3578710964,25
0,634,5247,3578710939,3578710969,30
0,634,5248,3578710939,3578710970,31
0,634,5249,3578710939,3578710972,33
0,634,5250,3578710939,3578710972,33
0,634,5251,3578710939,3578710974,35
0,634,5252,3578710939,3578710978,39
0,634,5253,3578710939,3578710979,40
0,634,5254,3578710939,3578710979,40
0,634,5255,3578710939,3578710980,41
0,634,5256,3578710939,3578710983,44
0,634,5257,3578710939,3578710983,44
0,634,5258,3578710939,3578710986,47
0,634,5259,3578710939,3578710987,48
0,635,5260,3578710992,3578710992,0
0,635,5261,3578710992,3578710992,0
0,635,5262,3578710992,3578710992,0
0,635,5263,3578710992,3578710995,3
0,635,5264,3578710992,3578710996,4
0,635,5265,3578710992,3578711002,10
0,635,5266,3578710992,3578711004,12
0,635,5267,3578710992,3578711004,12
0,635,5268,3578710992,3578711006,14
0,635,5269,3578710992,3578711007,15
0,635,5270,3578710992,3578711013,21
0,635,5271,3578710992,3578711014,22
0,635,5272,3578710992,3578711015,23
0,635,5273,3578710992,3578711015,23
0,635,5274,3578710992,3578711016,24
0,635,5275,3578710992,3578711018,26
0,635,5276,3578710992,3578711024,32
0,635,5277,3578710992,3578711025,33
0,635,5278,3578710992,3578711027,35
0,635,5279,3578710992,3578711030,38
0,635,5280,3578710992,3578711032,40
0,635,5281,3578710992,3578711032,40
0,635,5282,3578710992,3578711034,42
0,635,5283,3578710992,3578711037,45
0,635,5284,3578710992,3578711040,48
0,635,5285,3578710992,3578711040,48
0,636,5286,3578711045,3578711045,0
0,636,5287,3578711045,3578711049,4
0,636,5288,3578711045,3578711050,5
0,636,5289,3578711045,3578711050,5
0,636,5290,3578711045,3578711052,7
0,636,5291,3578711045,3578711054,9
0,636,5292,3578711045,3578711057,12
0,636,5293,3578711045,3578711058,13
0,636,5294,3578711045,3578711059,14
0,636,5295,3578711045,3578711063,18
0,636,5296,3578711045,3578711064,19
0,636,5297,3578711045,3578711066,21
0,636,5298,3578711045,3578711066,21
0,636,5299,3578711045,3578711066,21
0,636,5300,3578711045,3578711069,24
0,636,5301,3578711045,3578711069,24
0,636,5302,3578711045,3578711077,32
0,636,5303,3578711045,3578711079,34
0,636,5304,3578711045,3578711086,41
0,636,5305,3578711045,3578711088,43
0,636,5306,3578711045,3578711088,43
0,636,5307,3578711045,3578711089,44
0,636,5308,3578711045,3578711089,44
0,636,5309,3578711045,3578711091,46
0,636,5310,3578711045,3578711093,48
0,636,5311,3578711045,3578711095,50
0,637,5312,3578711098,3578711098,0
0,637,5313,3578711098,3578711098,0
0,637,5314,3578711098,3578711100,2
0,637,5315,3578711098,3578711102,4
0,637,5316,3578711098,3578711102,4
0,637,5317,3578711098,3578711102,4
0,637,5318,3578711098,3578711105,7
0,637,5319,3578711098,3578711106,8
0,637,5320,3578711098,3578711107,9
0,637,5321,3578711098,3578711107,9
0,637,5322,3578711098,3578711112,14
0,637,5323,3578711098,3578711112,14
0,637,5324,3578711098,3578711115,17
0,637,5325,3578711098,3578711116,18
0,637,5326,3578711098,3578711117,19
0,637,5327,3578711098,3578711120,22
0,637,5328,3578711098,3578711125,27
0,637,5329,3578711098,3578711126,28
0,637,5330,3578711098,3578711130,32
0,637,5331,3578711098,3578711132,34
0,637,5332,3578711098,3578711133,35
0,637,5333,3578711098,3578711136,38
0,637,5334,3578711098,3578711139,41
0,637,5335,3578711098,3578711140,42
0,637,5336,3578711098,3578711141,43
0,637,5337,3578711098,3578711142,44
0,637,5338,3578711098,3578711142,44
0,638,5339,3578711151,3578711151,0
0,638,5340,3578711151,3578711153,2
0,638,5341,3578711151,3578711154,3
0,638,5342,3578711151,3578711155,4
0,638,5343,3578711151,3578711156,5
0,638,5344,3578711151,3578711158,7
0,638,5345,3578711151,3578711159,8
0,638,5346,3578711151,3578711159,8
0,638,5347,3578711151,3578711161,10
0,638,5348,3578711151,3578711161,10
0,638,5349,3578711151,3578711162,11
0,638,5350,3578711151,3578711165,14
0,638,5351,3578711151,3578711169,18
0,638,5352,3578711151,3578711170,19
0,638,5353,3578711151,3578711172,21
0,638,5354,3578711151,3578711173,22
0,638,5355,3578711151,3578711174,23
0,638,5356,3578711151,3578711179,28
0,638,5357,3578711151,3578711179,28
0,638,5358,3578711151,3578711179,28
0,638,5359,3578711151,3578711180,29
0,638,5360,3578711151,3578711183,32
0,638,5361,3578711151,3578711183,32
0,638,5362,3578711151,3578711186,35
0,638,5363,3578711151,3578711187,36
0,638,5364,3578711151,3578711189,38
0,638,5365,3578711151,3578711192,41
0,638,5366,3578711151,3578711193,42
0,638,5367,3578711151,3578711195,44
0,638,5368,3578711151,3578711197,46
0,639,5369,3578711204,3578711204,0
0,639,5370,3578711204,3578711204,0
0,639,5371,3578711204,3578711205,1
0,639,5372,3578711204,3578711206,2
0,639,5373,3578711204,3578711207,3
0,639,5374,3578711204,3578711209,5
0,639,5375,3578711204,3578711213,9
0,639,5376,3578711204,3578711215,11
0,639,5377,3578711204,3578711215,11
0,639,5378,3578711204,3578711217,13
0,639,5379,3578711204,3578711218,14
0,639,5380,3578711204,3578711224,20
0,639,5381,3578711204,3578711224,20
0,639,5382,3578711204,3578711229,25
0,639,5383,3578711204,3578711231,27
0,639,5384,3578711204,3578711232,28
0,639,5385,3578711204,3578711233,29
0,639,5386,3578711204,3578711235,31
0,639,5387,3578711204,3578711237,33
0,639,5388,3578711204,3578711239,35
0,639,5389,3578711204,3578711240,36
0,639,5390,3578711204,3578711243,39
0,639,5391,3578711204,3578711249,45
0,639,5392,3578711204,3578711249,45
0,639,5393,3578711204,3578711249,45
0,639,5394,3578711204,3578711253,49
0,640,5395,3578711257,3578711257,0
0,640,5396,3578711257,3578711257,0
0,640,5397,3578711257,3578711259,2
0,640,5398,3578711257,3578711260,3
0,640,5399,3578711257,3578711262,5
0,640,5400,3578711257,3578711265,8
0,640,5401,3578711257,3578711266,9
0,640,5402,3578711257,3578711267,10
0,640,5403,3578711257,3578711267,10
0,640,5404,3578711257,3578711270,13
0,640,5405,3578711257,3578711277,20
0,640,5406,3578711257,3578711280,23
0,640,5407,3578711257,3578711286,29
0,640,5408,3578711257,3578711289,32
0,640,5409,3578711257,3578711289,32
0,640,5410,3578711257,3578711289,32
0,640,5411,3578711257,3578711291,34
0,640,5412,3578711257,3578711293,36
0,640,5413,3578711257,3578711295,38
0,640,5414,3578711257,3578711295,38
0,640,5415,3578711257,3578711296,39
0,640,5416,3578711257,3578711300,43
0,640,5417,3578711257,3578711302,45
0,640,5418,3578711257,3578711302,45
0,640,5419,3578711257,3578711303,46
0,640,5420,3578711257,3578711305,48
0,640,5421,3578711257,3578711306,49
0,640,5422,3578711257,3578711306,49
0,641,5423,3578711310,3578711310,0
0,641,5424,3578711310,3578711312,2
0,641,5425,3578711310,3578711312,2
0,641,5426,3578711310,3578711315,5
0,641,5427,3578711310,3578711315,5
0,641,5428,3578711310,3578711316,6
0,641,5429,3578711310,3578711317,7
0,641,5430,3578711310,3578711319,9
0,641,5431,3578711310,3578711325,15
0,641,5432,3578711310,3578711330,20
0,641,5433,3578711310,3578711332,22
0,641,5434,3578711310,3578711333,23
0,641,5435,3578711310,3578711336,26
0,641,5436,3578711310,3578711340,30
0,641,5437,3578711310,3578711341,31
0,641,5438,3578711310,3578711341,31
0,641,5439,3578711310,3578711343,33
0,641,5440,3578711310,3578711343,33
0,641,5441,3578711310,3578711351,41
0,641,5442,3578711310,3578711352,42
0,641,5443,3578711310,3578711356,46
0,641,5444,3578711310,3578711356,46
0,641,5445,3578711310,3578711357,47
0,641,5446,3578711310,3578711359,49
0,642,5447,3578711364,3578711364,0
0,642,5448,3578711364,3578711364,0
0,642,5449,3578711364,3578711364,0
0,642,5450,3578711364,3578711364,0
0,642,5451,3578711364,3578711364,0
0,642,5452,3578711364,3578711365,1
0,642,5453,3578711364,3578711369,5
0,642,5454,3578711364,3578711369,5
0,642,5455,3578711364,3578711372,8
0,642,5456,3578711364,3578711374,10
0,642,5457,3578711364,3578711374,10
0,642,5458,3578711364,3578711379,15
0,642,5459,3578711364,3578711379,15
0,642,5460,3578711364,3578711380,16
0,642,5461,3578711364,3578711381,17
0,642,5462,3578711364,3578711383,19
0,642,5463,3578711364,3578711383,19
0,642,5464,3578711364,3578711386,22
0,642,5465,3578711364,3578711387,23
0,642,5466,3578711364,3578711389,25
0,642,5467,3578711364,3578711392,28
0,642,5468,3578711364,3578711394,30
0,642,5469,3578711364,3578711395,31
0,642,5470,3578711364,3578711397,33
0,642,5471,3578711364,3578711401,37
0,642,5472,3578711364,3578711401,37
0,642,5473,3578711364,3578711404,40
0,642,5474,3578711364,3578711406,42
0,642,5475,3578711364,3578711407,43
0,642,5476,3578711364,3578711408,44
0,642,5477,3578711364,3578711412,48
0,642,5478,3578711364,3578711413,49
0,643,5479,3578711418,3578711418,0
0,643,5480,3578711418,3578711418,0
0,643,5481,3578711418,3578711418,0
0,643,5482,3578711418,3578711419,1
0,643,5483,3578711418,3578711424,6
0,643,5484,3578711418,3578711425,7
0,643,5485,3578711418,3578711428,10
0,643,5486,3578711418,3578711431,13
0,643,5487,3578711418,3578711432,14
0,643,5488,3578711418,3578711434,16
0,643,5489,3578711418,3578711435,17
0,643,5490,3578711418,3578711437,19
0,643,5491,3578711418,3578711440,22
0,643,5492,3578711418,3578711441,23
0,643,5493,3578711418,3578711444,26
0,643,5494,3578711418,3578711449,31
0,643,5495,3578711418,3578711449,31
0,643,5496,3578711418,3578711449,31
0,643,5497,3578711418,3578711453,35
0,643,5498,3578711418,3578711455,37
0,643,5499,3578711418,3578711457,39
0,643,5500,3578711418,3578711459,41
0,643,5501,3578711418,3578711460,42
0,643,5502,3578711418,3578711462,44
0,643,5503,3578711418,3578711462,44
0,643,5504,3578711418,3578711465,47
0,643,5505,3578711418,3578711467,49
0,643,5506,3578711418,3578711467,49
0,643,5507,3578711418,3578711468,50
0,644,5508,3578711471,3578711471,0
0,644,5509,3578711471,3578711471,0
0,644,5510,3578711471,3578711476,5
0,644,5511,3578711471,3578711480,9
0,644,5512,3578711471,3578711486,15
0,644,5513,3578711471,3578711489,18
0,644,5514,3578711471,3578711489,18
0,644,5515,3578711471,3578711489,18
0,644,5516,3578711471,3578711492,21
0,644,5517,3578711471,3578711493,22
0,644,5518,3578711471,3578711494,23
0,644,5519,3578711471,3578711495,24
0,644,5520,3578711471,3578711496,25
0,644,5521,3578711471,3578711500,29
0,644,5522,3578711471,3578711502,31
0,644,5523,3578711471,3578711502,31
0,644,5524,3578711471,3578711502,31
0,644,5525,3578711471,3578711505,34
0,644,5526,3578711471,3578711506,35
0,644,5527,3578711471,3578711506,35
0,644,5528,3578711471,3578711511,40
0,644,5529,3578711471,3578711512,41
0,644,5530,3578711471,3578711515,44
0,644,5531,3578711471,3578711515,44
0,644,5532,3578711471,3578711516,45
0,644,5533,3578711471,3578711516,45
0,644,5534,3578711471,3578711519,48
0,644,5535,3578711471,3578711520,49
0,645,5536,3578711524,3578711524,0
0,645,5537,3578711524,3578711530,6
0,645,5538,3578711524,3578711532,8
0,645,5539,3578711524,3578711533,9
0,645,5540,3578711524,3578711536,12
0,645,5541,3578711524,3578711539,15
0,645,5542,3578711524,3578711539,15
0,645,5543,3578711524,3578711540,16
0,645,5544,3578711524,3578711542,18
0,645,5545,3578711524,3578711542,18
0,645,5546,3578711524,3578711550,26
0,645,5547,3578711524,3578711552,28
0,645,5548,3578711524,3578711555,31
0,645,5549,3578711524,3578711556,32
0,645,5550,3578711524,3578711557,33
0,645,5551,3578711524,3578711559,35
0,645,5552,3578711524,3578711559,35
0,645,5553,3578711524,3578711559,35
0,645,5554,3578711524,3578711560,36
0,645,5555,3578711524,3578711560,36
0,645,5556,3578711524,3578711564,40
0,645,5557,3578711524,3578711567,43
0,645,5558,3578711524,3578711570,46
0,645,5559,3578711524,3578711570,46
0,645,5560,3578711524,3578711572,48
0,645,5561,3578711524,3578711573,49
0,645,5562,3578711524,3578711574,50
0,646,5563,3578711578,3578711578,0
0,646,5564,3578711578,3578711578,0
0,646,5565,3578711578,3578711579,1
0,646,5566,3578711578,3578711580,2
0,646,5567,3578711578,3578711583,5
0,646,5568,3578711578,3578711583,5
0,646,5569,3578711578,3578711585,7
0,646,5570,3578711578,3578711586,8
0,646,5571,3578711578,3578711588,10
0,646,5572,3578711578,3578711592,14
0,646,5573,3578711578,3578711593,15
0,646,5574,3578711578,3578711595,17
0,646,5575,3578711578,3578711596,18
0,646,5576,3578711578,3578711600,22
0,646,5577,3578711578,3578711601,23
0,646,5578,3578711578,3578711603,25
0,646,5579,3578711578,3578711605,27
0,646,5580,3578711578,3578711606,28
0,646,5581,3578711578,3578711607,29
0,646,5582,3578711578,3578711610,32
0,646,5583,3578711578,3578711611,33
0,646,5584,3578711578,3578711614,36
0,646,5585,3578711578,3578711615,37
0,646,5586,3578711578,3578711615,37
0,646,5587,3578711578,3578711617,39
0,646,5588,3578711578,3578711618,40
0,646,5589,3578711578,3578711623,45
0,646,5590,3578711578,3578711624,46
0,646,5591,3578711578,3578711628,50
0,647,5592,3578711631,3578711631,0
0,647,5593,3578711631,3578711631,0
0,647,5594,3578711631,3578711633,2
0,647,5595,3578711631,3578711633,2
0,647,5596,3578711631,3578711636,5
0,647,5597,3578711631,3578711639,8
0,647,5598,3578711631,3578711639,8
0,647,5599,3578711631,3578711643,12
0,647,5600,3578711631,3578711648,17
0,647,5601,3578711631,3578711649,18
0,647,5602,3578711631,3578711649,18
0,647,5603,3578711631,3578711652,21
0,647,5604,3578711631,3578711654,23
0,647,5605,3578711631,3578711656,25
0,647,5606,3578711631,3578711658,27
0,647,5607,3578711631,3578711659,28
0,647,5608,3578711631,3578711661,30
0,647,5609,3578711631,3578711664,33
0,647,5610,3578711631,3578711666,35
0,647,5611,3578711631,3578711666,35
0,647,5612,3578711631,3578711666,35
0,647,5613,3578711631,3578711667,36
0,647,5614,3578711631,3578711669,38
0,647,5615,3578711631,3578711669,38
0,647,5616,3578711631,3578711676,45
0,647,5617,3578711631,3578711679,48
0,648,5618,3578711685,3578711685,0
0,648,5619,3578711685,3578711689,4
0,648,5620,3578711685,3578711689,4
0,648,5621,3578711685,3578711689,4
0,648,5622,3578711685,3578711692,7
0,648,5623,3578711685,3578711693,8
0,648,5624,3578711685,3578711694,9
0,648,5625,3578711685,3578711695,10
0,648,5626,3578711685,3578711696,11
0,648,5627,3578711685,3578711700,15
0,648,5628,3578711685,3578711702,17
0,648,5629,3578711685,3578711702,17
0,648,5630,3578711685,3578711702,17
0,648,5631,3578711685,3578711705,20
0,648,5632,3578711685,3578711706,21
0,648,5633,3578711685,3578711706,21
0,648,5634,3578711685,3578711711,26
0,648,5635,3578711685,3578711712,27
0,648,5636,3578711685,3578711715,30
0,648,5637,3578711685,3578711716,31
0,648,5638,3578711685,3578711717,32
0,648,5639,3578711685,3578711718,33
0,648,5640,3578711685,3578711719,34
0,648,5641,3578711685,3578711720,35
0,648,5642,3578711685,3578711723,38
0,648,5643,3578711685,3578711724,39
0,648,5644,3578711685,3578711730,45
0,648,5645,3578711685,3578711732,47
0,648,5646,3578711685,3578711733,48
0,649,5647,3578711738,3578711738,0
0,649,5648,3578711738,3578711739,1
0,649,5649,3578711738,3578711740,2
0,649,5650,3578711738,3578711740,2
0,649,5651,3578711738,3578711742,4
0,649,5652,3578711738,3578711742,4
0,649,5653,3578711738,3578711751,13
0,649,5654,3578711738,3578711751,13
0,649,5655,3578711738,3578711754,16
0,649,5656,3578711738,3578711756,18
0,649,5657,3578711738,3578711756,18
0,649,5658,3578711738,3578711759,21
0,649,5659,3578711738,3578711759,21
0,649,5660,3578711738,3578711761,23
0,649,5661,3578711738,3578711761,23
0,649,5662,3578711738,3578711761,23
0,649,5663,3578711738,3578711764,26
0,649,5664,3578711738,3578711768,30
0,649,5665,3578711738,3578711770,32
0,649,5666,3578711738,3578711770,32
0,649,5667,3578711738,3578711771,33
0,649,5668,3578711738,3578711773,35
0,649,5669,3578711738,3578711774,36
0,649,5670,3578711738,3578711778,40
0,649,5671,3578711738,3578711779,41
0,649,5672,3578711738,3578711779,41
0,649,5673,3578711738,3578711781,43
0,649,5674,3578711738,3578711782,44
0,649,5675,3578711738,3578711783,45
0,649,5676,3578711738,3578711785,47
0,649,5677,3578711738,3578711787,49
0,650,5678,3578711791,3578711791,0
0,650,5679,3578711791,3578711792,1
0,650,5680,3578711791,3578711793,2
0,650,5681,3578711791,3578711795,4
0,650,5682,3578711791,3578711797,6
0,650,5683,3578711791,3578711800,9
0,650,5684,3578711791,3578711801,10
0,650,5685,3578711791,3578711802,11
0,650,5686,3578711791,3578711804,13
0,650,5687,3578711791,3578711806,15
0,650,5688,3578711791,3578711806,15
0,650,5689,3578711791,3578711811,20
0,650,5690,3578711791,3578711812,21
0,650,5691,3578711791,3578711815,24
0,650,5692,3578711791,3578711815,24
0,650,5693,3578711791,3578711815,24
0,650,5694,3578711791,3578711818,27
0,650,5695,3578711791,3578711819,28
0,650,5696,3578711791,3578711823,32
0,650,5697,3578711791,3578711824,33
0,650,5698,3578711791,3578711828,37
0,650,5699,3578711791,3578711831,40
0,650,5700,3578711791,3578711832,41
0,650,5701,3578711791,3578711833,42
0,650,5702,3578711791,3578711834,43
0,650,5703,3578711791,3578711836,45
0,650,5704,3578711791,3578711839,48
0,650,5705,3578711791,3578711840,49
0,651,5706,3578711844,3578711844,0
0,651,5707,3578711844,3578711849,5
0,651,5708,3578711844,3578711849,5
0,651,5709,3578711844,3578711850,6
0,651,5710,3578711844,3578711852,8
0,651,5711,3578711844,3578711854,10
0,651,5712,3578711844,3578711856,12
0,651,5713,3578711844,3578711859,15
0,651,5714,3578711844,3578711859,15
0,651,5715,3578711844,3578711862,18
0,651,5716,3578711844,3578711864,20
0,651,5717,3578711844,3578711866,22
0,651,5718,3578711844,3578711866,22
0,651,5719,3578711844,3578711867,23
0,651,5720,3578711844,3578711869,25
0,651,5721,3578711844,3578711869,25
0,651,5722,3578711844,3578711870,26
0,651,5723,3578711844,3578711876,32
0,651,5724,3578711844,3578711880,36
0,651,5725,3578711844,3578711885,41
0,651,5726,3578711844,3578711888,44
0,651,5727,3578711844,3578711889,45
0,651,5728,3578711844,3578711889,45
0,651,5729,3578711844,3578711889,45
0,651,5730,3578711844,3578711892,48
0,651,5731,3578711844,3578711893,49
0,652,5732,3578711898,3578711898,0
0,652,5733,3578711898,3578711898,0
0,652,5734,3578711898,3578711898,0
0,652,5735,3578711898,3578711900,2
0,652,5736,3578711898,3578711902,4
0,652,5737,3578711898,3578711902,4
0,652,5738,3578711898,3578711905,7
0,652,5739,3578711898,3578711905,7
0,652,5740,3578711898,3578711907,9
0,652,5741,3578711898,3578711911,13
0,652,5742,3578711898,3578711912,14
0,652,5743,3578711898,3578711915,17
0,652,5744,3578711898,3578711915,17
0,652,5745,3578711898,3578711916,18
0,652,5746,3578711898,3578711919,21
0,652,5747,3578711898,3578711920,22
0,652,5748,3578711898,3578711920,22
0,652,5749,3578711898,3578711925,27
0,652,5750,3578711898,3578711925,27
0,652,5751,3578711898,3578711930,32
0,652,5752,3578711898,3578711932,34
0,652,5753,3578711898,3578711933,35
0,652,5754,3578711898,3578711935,37
0,652,5755,3578711898,3578711940,42
0,652,5756,3578711898,3578711940,42
0,652,5757,3578711898,3578711941,43
0,652,5758,3578711898,3578711942,44
0,652,5759,3578711898,3578711942,44
0,653,5760,3578711951,3578711951,0
0,653,5761,3578711951,3578711952,1
0,653,5762,3578711951,3578711954,3
0,653,5763,3578711951,3578711956,5
0,653,5764,3578711951,3578711956,5
0,653,5765,3578711951,3578711959,8
0,653,5766,3578711951,3578711959,8
0,653,5767,3578711951,3578711961,10
0,653,5768,3578711951,3578711961,10
0,653,5769,3578711951,3578711961,10
0,653,5770,3578711951,3578711964,13
0,653,5771,3578711951,3578711970,19
0,653,5772,3578711951,3578711971,20
0,653,5773,3578711951,3578711971,20
0,653,5774,3578711951,3578711972,21
0,653,5775,3578711951,3578711975,24
0,653,5776,3578711951,3578711975,24
0,653,5777,3578711951,3578711978,27
0,653,5778,3578711951,3578711979,28
0,653,5779,3578711951,3578711979,28
0,653,5780,3578711951,3578711980,29
0,653,5781,3578711951,3578711982,31
0,653,5782,3578711951,3578711983,32
0,653,5783,3578711951,3578711986,35
0,653,5784,3578711951,3578711987,36
0,653,5785,3578711951,3578711991,40
0,653,5786,3578711951,3578711992,41
0,653,5787,3578711951,3578711992,41
0,653,5788,3578711951,3578711995,44
0,653,5789,3578711951,3578711997,46
0,654,5790,3578712004,3578712004,0
0,654,5791,3578712004,3578712004,0
0,654,5792,3578712004,3578712004,0
0,654,5793,3578712004,3578712006,2
0,654,5794,3578712004,3578712007,3
0,654,5795,3578712004,3578712011,7
0,654,5796,3578712004,3578712013,9
0,654,5797,3578712004,3578712015,11
0,654,5798,3578712004,3578712016,12
0,654,5799,3578712004,3578712016,12
0,654,5800,3578712004,3578712019,15
0,654,5801,3578712004,3578712020,16
0,654,5802,3578712004,3578712022,18
0,654,5803,3578712004,3578712023,19
0,654,5804,3578712004,3578712025,21
0,654,5805,3578712004,3578712027,23
0,654,5806,3578712004,3578712031,27
0,654,5807,3578712004,3578712032,28
0,654,5808,3578712004,3578712033,29
0,654,5809,3578712004,3578712035,31
0,654,5810,3578712004,3578712039,35
0,654,5811,3578712004,3578712040,36
0,654,5812,3578712004,3578712043,39
0,654,5813,3578712004,3578712048,44
0,654,5814,3578712004,3578712049,45
0,654,5815,3578712004,3578712049,45
0,654,5816,3578712004,3578712052,48
0,655,5817,3578712057,3578712057,0
0,655,5818,3578712057,3578712057,0
0,655,5819,3578712057,3578712059,2
0,655,5820,3578712057,3578712059,2
0,655,5821,3578712057,3578712064,7
0,655,5822,3578712057,3578712065,8
0,655,5823,3578712057,3578712066,9
0,655,5824,3578712057,3578712067,10
0,655,5825,3578712057,3578712069,12
0,655,5826,3578712057,3578712070,13
0,655,5827,3578712057,3578712073,16
0,655,5828,3578712057,3578712077,20
0,655,5829,3578712057,3578712081,24
0,655,5830,3578712057,3578712086,29
0,655,5831,3578712057,3578712088,31
0,655,5832,3578712057,3578712088,31
0,655,5833,3578712057,3578712089,32
0,655,5834,3578712057,3578712090,33
0,655,5835,3578712057,3578712092,35
0,655,5836,3578712057,3578712092,35
0,655,5837,3578712057,3578712095,38
0,655,5838,3578712057,3578712096,39
0,655,5839,3578712057,3578712096,39
0,655,5840,3578712057,3578712100,43
0,655,5841,3578712057,3578712102,45
0,655,5842,3578712057,3578712102,45
0,655,5843,3578712057,3578712105,48
0,655,5844,3578712057,3578712106,49
0,655,5845,3578712057,3578712106,49
0,656,5846,3578712110,3578712111,1
0,656,5847,3578712110,3578712112,2
0,656,5848,3578712110,3578712114,4
0,656,5849,3578712110,3578712116,6
0,656,5850,3578712110,3578712117,7
0,656,5851,3578712110,3578712119,9
0,656,5852,3578712110,3578712120,10
0,656,5853,3578712110,3578712120,10
0,656,5854,3578712110,3578712123,13
0,656,5855,3578712110,3578712124,14
0,656,5856,3578712110,3578712126,16
0,656,5857,3578712110,3578712130,20
0,656,5858,3578712110,3578712132,22
0,656,5859,3578712110,3578712133,23
0,656,5860,3578712110,3578712135,25
0,656,5861,3578712110,3578712140,30
0,656,5862,3578712110,3578712141,31
0,656,5863,3578712110,3578712141,31
0,656,5864,3578712110,3578712142,32
0,656,5865,3578712110,3578712142,32
0,656,5866,3578712110,3578712152,42
0,656,5867,3578712110,3578712152,42
0,656,5868,3578712110,3578712154,44
0,656,5869,3578712110,3578712156,46
0,656,5870,3578712110,3578712159,49
0,656,5871,3578712110,3578712159,49
0,657,5872,3578712163,3578712163,0
0,657,5873,3578712163,3578712163,0
0,657,5874,3578712163,3578712163,0
0,657,5875,3578712163,3578712165,2
0,657,5876,3578712163,3578712170,7
0,657,5877,3578712163,3578712171,8
0,657,5878,3578712163,3578712172,9
0,657,5879,3578712163,3578712174,11
0,657,5880,3578712163,3578712175,12
0,657,5881,3578712163,3578712175,12
0,657,5882,3578712163,3578712179,16
0,657,5883,3578712163,3578712179,16
0,657,5884,3578712163,3578712180,17
0,657,5885,3578712163,3578712180,17
0,657,5886,3578712163,3578712182,19
0,657,5887,3578712163,3578712183,20
0,657,5888,3578712163,3578712186,23
0,657,5889,3578712163,3578712187,24
0,657,5890,3578712163,3578712190,27
0,657,5891,3578712163,3578712193,30
0,657,5892,3578712163,3578712193,30
0,657,5893,3578712163,3578712196,33
0,657,5894,3578712163,3578712197,34
0,657,5895,3578712163,3578712202,39
0,657,5896,3578712163,3578712202,39
0,657,5897,3578712163,3578712205,42
0,657,5898,3578712163,3578712206,43
0,657,5899,3578712163,3578712206,43
0,657,5900,3578712163,3578712210,47
0,657,5901,3578712163,3578712213,50
0,658,5902,3578712217,3578712217,0
0,658,5903,3578712217,3578712217,0
0,658,5904,3578712217,3578712217,0
0,658,5905,3578712217,3578712217,0
0,658,5906,3578712217,3578712219,2
0,658,5907,3578712217,3578712221,4
0,658,5908,3578712217,3578712224,7
0,658,5909,3578712217,3578712224,7
0,658,5910,3578712217,3578712224,7
0,658,5911,3578712217,3578712228,11
0,658,5912,3578712217,3578712231,14
0,658,5913,3578712217,3578712232,15
0,658,5914,3578712217,3578712233,16
0,658,5915,3578712217,3578712235,18
0,658,5916,3578712217,3578712239,22
0,658,5917,3578712217,3578712240,23
0,658,5918,3578712217,3578712243,26
0,658,5919,3578712217,3578712248,31
0,658,5920,3578712217,3578712249,32
0,658,5921,3578712217,3578712249,32
0,658,5922,3578712217,3578712253,36
0,658,5923,3578712217,3578712254,37
0,658,5924,3578712217,3578712256,39
0,658,5925,3578712217,3578712259,42
0,658,5926,3578712217,3578712259,42
0,658,5927,3578712217,3578712265,48
0,658,5928,3578712217,3578712266,49
0,658,5929,3578712217,3578712267,50
0,659,5930,3578712271,3578712271,0
0,659,5931,3578712271,3578712271,0
0,659,5932,3578712271,3578712271,0
0,659,5933,3578712271,3578712275,4
0,659,5934,3578712271,3578712277,6
0,659,5935,3578712271,3578712280,9
0,659,5936,3578712271,3578712285,14
0,659,5937,3578712271,3578712288,17
0,659,5938,3578712271,3578712289,18
0,659,5939,3578712271,3578712289,18
0,659,5940,3578712271,3578712289,18
0,659,5941,3578712271,3578712292,21
0,659,5942,3578712271,3578712293,22
0,659,5943,3578712271,3578712295,24
0,659,5944,3578712271,3578712296,25
0,659,5945,3578712271,3578712296,25
0,659,5946,3578712271,3578712300,29
0,659,5947,3578712271,3578712302,31
0,659,5948,3578712271,3578712303,32
0,659,5949,3578712271,3578712305,34
0,659,5950,3578712271,3578712306,35
0,659,5951,3578712271,3578712307,36
0,659,5952,3578712271,3578712311,40
0,659,5953,3578712271,3578712313,42
0,659,5954,3578712271,3578712314,43
0,659,5955,3578712271,3578712316,45
0,659,5956,3578712271,3578712317,46
0,659,5957,3578712271,3578712319,48
0,659,5958,3578712271,3578712320,49
0,659,5959,3578712271,3578712321,50
0,660,5960,3578712324,3578712325,1
0,660,5961,3578712324,3578712326,2
0,660,5962,3578712324,3578712326,2
0,660,5963,3578712324,3578712330,6
0,660,5964,3578712324,3578712333,9
0,660,5965,3578712324,3578712336,12
0,660,5966,3578712324,3578712340,16
0,660,5967,3578712324,3578712341,17
0,660,5968,3578712324,3578712341,17
0,660,5969,3578712324,3578712343,19
0,660,5970,3578712324,3578712343,19
0,660,5971,3578712324,3578712351,27
0,660,5972,3578712324,3578712353,29
0,660,5973,3578712324,3578712356,32
0,660,5974,3578712324,3578712356,32
0,660,5975,3578712324,3578712357,33
0,660,5976,3578712324,3578712359,35
0,660,5977,3578712324,3578712359,35
0,660,5978,3578712324,3578712360,36
0,660,5979,3578712324,3578712361,37
0,660,5980,3578712324,3578712361,37
0,660,5981,3578712324,3578712365,41
0,660,5982,3578712324,3578712370,46
0,660,5983,3578712324,3578712371,47
0,660,5984,3578712324,3578712372,48
0,661,5985,3578712379,3578712379,0
0,661,5986,3578712379,3578712379,0
0,661,5987,3578712379,3578712379,0
0,661,5988,3578712379,3578712379,0
0,661,5989,3578712379,3578712380,1
0,661,5990,3578712379,3578712380,1
0,661,5991,3578712379,3578712381,2
0,661,5992,3578712379,3578712383,4
0,661,5993,3578712379,3578712384,5
0,661,5994,3578712379,3578712386,7
0,661,5995,3578712379,3578712387,8
0,661,5996,3578712379,3578712390,11
0,661,5997,3578712379,3578712392,13
0,661,5998,3578712379,3578712394,15
0,661,5999,3578712379,3578712396,17
0,661,6000,3578712379,3578712396,17
0,661,6001,3578712379,3578712401,22
0,661,6002,3578712379,3578712402,23
0,661,6003,3578712379,3578712402,23
0,661,6004,3578712379,3578712405,26
0,661,6005,3578712379,3578712406,27
0,661,6006,3578712379,3578712406,27
0,661,6007,3578712379,3578712410,31
0,661,6008,3578712379,3578712413,34
0,661,6009,3578712379,3578712415,36
0,661,6010,3578712379,3578712416,37
0,661,6011,3578712379,3578712416,37
0,661,6012,3578712379,3578712416,37
0,661,6013,3578712379,3578712419,40
0,661,6014,3578712379,3578712421,42
0,661,6015,3578712379,3578712423,44
0,661,6016,3578712379,3578712424,45
0,661,6017,3578712379,3578712427,48
0,661,6018,3578712379,3578712428,49
0,662,6019,3578712432,3578712432,0
0,662,6020,3578712432,3578712432,0
0,662,6021,3578712432,3578712433,1
0,662,6022,3578712432,3578712434,2
0,662,6023,3578712432,3578712436,4
0,662,6024,3578712432,3578712439,7
0,662,6025,3578712432,3578712440,8
0,662,6026,3578712432,3578712444,12
0,662,6027,3578712432,3578712449,17
0,662,6028,3578712432,3578712450,18
0,662,6029,3578712432,3578712450,18
0,662,6030,3578712432,3578712453,21
0,662,6031,3578712432,3578712455,23
0,662,6032,3578712432,3578712458,26
0,662,6033,3578712432,3578712458,26
0,662,6034,3578712432,3578712459,27
0,662,6035,3578712432,3578712465,33
0,662,6036,3578712432,3578712466,34
0,662,6037,3578712432,3578712467,35
0,662,6038,3578712432,3578712468,36
0,662,6039,3578712432,3578712469,37
0,662,6040,3578712432,3578712469,37
0,662,6041,3578712432,3578712475,43
0,662,6042,3578712432,3578712477,45
0,662,6043,3578712432,3578712478,46
0,662,6044,3578712432,3578712481,49
0,663,6045,3578712486,3578712486,0
0,663,6046,3578712486,3578712487,1
0,663,6047,3578712486,3578712488,2
0,663,6048,3578712486,3578712488,2
0,663,6049,3578712486,3578712491,5
0,663,6050,3578712486,3578712491,5
0,663,6051,3578712486,3578712494,8
0,663,6052,3578712486,3578712495,9
0,663,6053,3578712486,3578712495,9
0,663,6054,3578712486,3578712499,13
0,663,6055,3578712486,3578712501,15
0,663,6056,3578712486,3578712501,15
0,663,6057,3578712486,3578712504,18
0,663,6058,3578712486,3578712505,19
0,663,6059,3578712486,3578712505,19
0,663,6060,3578712486,3578712510,24
0,663,6061,3578712486,3578712512,26
0,663,6062,3578712486,3578712514,28
0,663,6063,3578712486,3578712515,29
0,663,6064,3578712486,3578712516,30
0,663,6065,3578712486,3578712517,31
0,663,6066,3578712486,3578712520,34
0,663,6067,3578712486,3578712520,34
0,663,6068,3578712486,3578712524,38
0,663,6069,3578712486,3578712525,39
0,663,6070,3578712486,3578712529,43
0,663,6071,3578712486,3578712529,43
0,663,6072,3578712486,3578712532,46
0,663,6073,3578712486,3578712532,46
0,663,6074,3578712486,3578712535,49
0,664,6075,3578712539,3578712539,0
0,664,6076,3578712539,3578712540,1
0,664,6077,3578712539,3578712540,1
0,664,6078,3578712539,3578712542,3
0,664,6079,3578712539,3578712542,3
0,664,6080,3578712539,3578712550,11
0,664,6081,3578712539,3578712552,13
0,664,6082,3578712539,3578712554,15
0,664,6083,3578712539,3578712556,17
0,664,6084,3578712539,3578712556,17
0,664,6085,3578712539,3578712558,19
0,664,6086,3578712539,3578712558,19
0,664,6087,3578712539,3578712560,21
0,664,6088,3578712539,3578712560,21
0,664,6089,3578712539,3578712560,21
0,664,6090,3578712539,3578712564,25
0,664,6091,3578712539,3578712569,30
0,664,6092,3578712539,3578712570,31
0,664,6093,3578712539,3578712571,32
0,664,6094,3578712539,3578712573,34
0,664,6095,3578712539,3578712574,35
0,664,6096,3578712539,3578712579,40
0,664,6097,3578712539,3578712579,40
0,664,6098,3578712539,3578712580,41
0,664,6099,3578712539,3578712580,41
0,664,6100,3578712539,3578712581,42
0,664,6101,3578712539,3578712582,43
0,664,6102,3578712539,3578712583,44
0,664,6103,3578712539,3578712585,46
0,664,6104,3578712539,3578712586,47
0,665,6105,3578712593,3578712593,0
0,665,6106,3578712593,3578712593,0
0,665,6107,3578712593,3578712593,0
0,665,6108,3578712593,3578712595,2
0,665,6109,3578712593,3578712596,3
0,665,6110,3578712593,3578712600,7
0,665,6111,3578712593,3578712601,8
0,665,6112,3578712593,3578712601,8
0,665,6113,3578712593,3578712605,12
0,665,6114,3578712593,3578712605,12
0,665,6115,3578712593,3578712606,13
0,665,6116,3578712593,3578712610,17
0,665,6117,3578712593,3578712612,19
0,665,6118,3578712593,3578712614,21
0,665,6119,3578712593,3578712615,22
0,665,6120,3578712593,3578712616,23
0,665,6121,3578712593,3578712619,26
0,665,6122,3578712593,3578712619,26
0,665,6123,3578712593,3578712623,30
0,665,6124,3578712593,3578712628,35
0,665,6125,3578712593,3578712630,37
0,665,6126,3578712593,3578712630,37
0,665,6127,3578712593,3578712631,38
0,665,6128,3578712593,3578712632,39
0,665,6129,3578712593,3578712633,40
0,665,6130,3578712593,3578712636,43
0,665,6131,3578712593,3578712638,45
0,665,6132,3578712593,3578712638,45
0,666,6133,3578712647,3578712647,0
0,666,6134,3578712647,3578712648,1
0,666,6135,3578712647,3578712648,1
0,666,6136,3578712647,3578712648,1
0,666,6137,3578712647,3578712652,5
0,666,6138,3578712647,3578712654,7
0,666,6139,3578712647,3578712656,9
0,666,6140,3578712647,3578712658,11
0,666,6141,3578712647,3578712659,12
0,666,6142,3578712647,3578712662,15
0,666,6143,3578712647,3578712664,17
0,666,6144,3578712647,3578712665,18
0,666,6145,3578712647,3578712666,19
0,666,6146,3578712647,3578712667,20
0,666,6147,3578712647,3578712669,22
0,666,6148,3578712647,3578712670,23
0,666,6149,3578712647,3578712675,28
0,666,6150,3578712647,3578712676,29
0,666,6151,3578712647,3578712680,33
0,666,6152,3578712647,3578712681,34
0,666,6153,3578712647,3578712685,38
0,666,6154,3578712647,3578712687,40
0,666,6155,3578712647,3578712688,41
0,666,6156,3578712647,3578712688,41
0,666,6157,3578712647,3578712691,44
0,666,6158,3578712647,3578712692,45
0,666,6159,3578712647,3578712693,46
0,666,6160,3578712647,3578712695,48
0,666,6161,3578712647,3578712695,48
0,667,6162,3578712701,3578712701,0
0,667,6163,3578712701,3578712701,0
0,667,6164,3578712701,3578712701,0
0,667,6165,3578712701,3578712702,1
0,667,6166,3578712701,3578712704,3
0,667,6167,3578712701,3578712704,3
0,667,6168,3578712701,3578712706,5
0,667,6169,3578712701,3578712711,10
0,667,6170,3578712701,3578712712,11
0,667,6171,3578712701,3578712713,12
0,667,6172,3578712701,3578712716,15
0,667,6173,3578712701,3578712718,17
0,667,6174,3578712701,3578712720,19
0,667,6175,3578712701,3578712720,19
0,667,6176,3578712701,3578712724,23
0,667,6177,3578712701,3578712725,24
0,667,6178,3578712701,3578712729,28
0,667,6179,3578712701,3578712730,29
0,667,6180,3578712701,3578712731,30
0,667,6181,3578712701,3578712732,31
0,667,6182,3578712701,3578712733,32
0,667,6183,3578712701,3578712735,34
0,667,6184,3578712701,3578712739,38
0,667,6185,3578712701,3578712740,39
0,667,6186,3578712701,3578712741,40
0,667,6187,3578712701,3578712742,41
0,667,6188,3578712701,3578712742,41
0,667,6189,3578712701,3578712751,50
0,668,6190,3578712754,3578712754,0
0,668,6191,3578712754,3578712755,1
0,668,6192,3578712754,3578712756,2
0,668,6193,3578712754,3578712757,3
0,668,6194,3578712754,3578712758,4
0,668,6195,3578712754,3578712759,5
0,668,6196,3578712754,3578712760,6
0,668,6197,3578712754,3578712761,7
0,668,6198,3578712754,3578712762,8
0,668,6199,3578712754,3578712764,10
0,668,6200,3578712754,3578712769,15
0,668,6201,3578712754,3578712770,16
0,668,6202,3578712754,3578712772,18
0,668,6203,3578712754,3578712773,19
0,668,6204,3578712754,3578712774,20
0,668,6205,3578712754,3578712778,24
0,668,6206,3578712754,3578712778,24
0,668,6207,3578712754,3578712780,26
0,668,6208,3578712754,3578712780,26
0,668,6209,3578712754,3578712781,27
0,668,6210,3578712754,3578712782,28
0,668,6211,3578712754,3578712782,28
0,668,6212,3578712754,3578712783,29
0,668,6213,3578712754,3578712785,31
0,668,6214,3578712754,3578712787,33
0,668,6215,3578712754,3578712789,35
0,668,6216,3578712754,3578712792,38
0,668,6217,3578712754,3578712793,39
0,668,6218,3578712754,3578712795,41
0,668,6219,3578712754,3578712796,42
0,668,6220,3578712754,3578712800,46
0,668,6221,3578712754,3578712802,48
0,668,6222,3578712754,3578712803,49
0,669,6223,3578712808,3578712808,0
0,669,6224,3578712808,3578712808,0
0,669,6225,3578712808,3578712810,2
0,669,6226,3578712808,3578712811,3
0,669,6227,3578712808,3578712814,6
0,669,6228,3578712808,3578712815,7
0,669,6229,3578712808,3578712816,8
0,669,6230,3578712808,3578712819,11
0,669,6231,3578712808,3578712819,11
0,669,6232,3578712808,3578712824,16
0,669,6233,3578712808,3578712828,20
0,669,6234,3578712808,3578712831,23
0,669,6235,3578712808,3578712831,23
0,669,6236,3578712808,3578712833,25
0,669,6237,3578712808,3578712833,25
0,669,6238,3578712808,3578712835,27
0,669,6239,3578712808,3578712836,28
0,669,6240,3578712808,3578712838,30
0,669,6241,3578712808,3578712839,31
0,669,6242,3578712808,3578712844,36
0,669,6243,3578712808,3578712848,40
0,669,6244,3578712808,3578712849,41
0,669,6245,3578712808,3578712850,42
0,669,6246,3578712808,3578712852,44
0,669,6247,3578712808,3578712854,46
0,669,6248,3578712808,3578712857,49
0,669,6249,3578712808,3578712857,49
0,670,6250,3578712862,3578712862,0
0,670,6251,3578712862,3578712863,1
0,670,6252,3578712862,3578712864,2
0,670,6253,3578712862,3578712865,3
0,670,6254,3578712862,3578712866,4
0,670,6255,3578712862,3578712868,6
0,670,6256,3578712862,3578712869,7
0,670,6257,3578712862,3578712870,8
0,670,6258,3578712862,3578712875,13
0,670,6259,3578712862,3578712877,15
0,670,6260,3578712862,3578712881,19
0,670,6261,3578712862,3578712883,21
0,670,6262,3578712862,3578712886,24
0,670,6263,3578712862,3578712887,25
0,670,6264,3578712862,3578712888,26
0,670,6265,3578712862,3578712888,26
0,670,6266,3578712862,3578712888,26
0,670,6267,3578712862,3578712891,29
0,670,6268,3578712862,3578712892,30
0,670,6269,3578712862,3578712894,32
0,670,6270,3578712862,3578712895,33
0,670,6271,3578712862,3578712895,33
0,670,6272,3578712862,3578712899,37
0,670,6273,3578712862,3578712901,39
0,670,6274,3578712862,3578712901,39
0,670,6275,3578712862,3578712901,39
0,670,6276,3578712862,3578712904,42
0,670,6277,3578712862,3578712905,43
0,670,6278,3578712862,3578712906,44
0,671,6279,3578712915,3578712915,0
0,671,6280,3578712915,3578712915,0
0,671,6281,3578712915,3578712915,0
0,671,6282,3578712915,3578712915,0
0,671,6283,3578712915,3578712918,3
0,671,6284,3578712915,3578712919,4
0,671,6285,3578712915,3578712919,4
0,671,6286,3578712915,3578712924,9
0,671,6287,3578712915,3578712925,10
0,671,6288,3578712915,3578712929,14
0,671,6289,3578712915,3578712931,16
0,671,6290,3578712915,3578712932,17
0,671,6291,3578712915,3578712933,18
0,671,6292,3578712915,3578712933,18
0,671,6293,3578712915,3578712934,19
0,671,6294,3578712915,3578712935,20
0,671,6295,3578712915,3578712939,24
0,671,6296,3578712915,3578712940,25
0,671,6297,3578712915,3578712941,26
0,671,6298,3578712915,3578712942,27
0,671,6299,3578712915,3578712942,27
0,671,6300,3578712915,3578712950,35
0,671,6301,3578712915,3578712952,37
0,671,6302,3578712915,3578712955,40
0,671,6303,3578712915,3578712956,41
0,671,6304,3578712915,3578712957,42
0,671,6305,3578712915,3578712958,43
0,671,6306,3578712915,3578712959,44
0,671,6307,3578712915,3578712960,45
0,671,6308,3578712915,3578712961,46
0,671,6309,3578712915,3578712962,47
0,671,6310,3578712915,3578712964,49
0,672,6311,3578712968,3578712969,1
0,672,6312,3578712968,3578712970,2
0,672,6313,3578712968,3578712972,4
0,672,6314,3578712968,3578712974,6
0,672,6315,3578712968,3578712974,6
0,672,6316,3578712968,3578712978,10
0,672,6317,3578712968,3578712978,10
0,672,6318,3578712968,3578712979,11
0,672,6319,3578712968,3578712980,12
0,672,6320,3578712968,3578712981,13
0,672,6321,3578712968,3578712982,14
0,672,6322,3578712968,3578712983,15
0,672,6323,3578712968,3578712985,17
0,672,6324,3578712968,3578712986,18
0,672,6325,3578712968,3578712987,19
0,672,6326,3578712968,3578712990,22
0,672,6327,3578712968,3578712992,24
0,672,6328,3578712968,3578712994,26
0,672,6329,3578712968,3578712995,27
0,672,6330,3578712968,3578712997,29
0,672,6331,3578712968,3578713001,33
0,672,6332,3578712968,3578713002,34
0,672,6333,3578712968,3578713003,35
0,672,6334,3578712968,3578713005,37
0,672,6335,3578712968,3578713006,38
0,672,6336,3578712968,3578713009,41
0,672,6337,3578712968,3578713013,45
0,672,6338,3578712968,3578713015,47
0,672,6339,3578712968,3578713015,47
0,672,6340,3578712968,3578713016,48
0,673,6341,3578713022,3578713022,0
0,673,6342,3578713022,3578713022,0
0,673,6343,3578713022,3578713023,1
0,673,6344,3578713022,3578713024,2
0,673,6345,3578713022,3578713028,6
0,673,6346,3578713022,3578713030,8
0,673,6347,3578713022,3578713031,9
0,673,6348,3578713022,3578713033,11
0,673,6349,3578713022,3578713035,13
0,673,6350,3578713022,3578713036,14
0,673,6351,3578713022,3578713038,16
0,673,6352,3578713022,3578713039,17
0,673,6353,3578713022,3578713044,22
0,673,6354,3578713022,3578713049,27
0,673,6355,3578713022,3578713049,27
0,673,6356,3578713022,3578713050,28
0,673,6357,3578713022,3578713052,30
0,673,6358,3578713022,3578713054,32
0,673,6359,3578713022,3578713056,34
0,673,6360,3578713022,3578713057,35
0,673,6361,3578713022,3578713059,37
0,673,6362,3578713022,3578713063,41
0,673,6363,3578713022,3578713064,42
0,673,6364,3578713022,3578713065,43
0,673,6365,3578713022,3578713066,44
0,673,6366,3578713022,3578713068,46
0,673,6367,3578713022,3578713069,47
0,673,6368,3578713022,3578713070,48
0,674,6369,3578713076,3578713076,0
0,674,6370,3578713076,3578713077,1
0,674,6371,3578713076,3578713081,5
0,674,6372,3578713076,3578713085,9
0,674,6373,3578713076,3578713086,10
0,674,6374,3578713076,3578713087,11
0,674,6375,3578713076,3578713088,12
0,674,6376,3578713076,3578713089,13
0,674,6377,3578713076,3578713089,13
0,674,6378,3578713076,3578713091,15
0,674,6379,3578713076,3578713091,15
0,674,6380,3578713076,3578713094,18
0,674,6381,3578713076,3578713095,19
0,674,6382,3578713076,3578713095,19
0,674,6383,3578713076,3578713099,23
0,674,6384,3578713076,3578713101,25
0,674,6385,3578713076,3578713102,26
0,674,6386,3578713076,3578713102,26
0,674,6387,3578713076,3578713103,27
0,674,6388,3578713076,3578713105,29
0,674,6389,3578713076,3578713105,29
0,674,6390,3578713076,3578713112,36
0,674,6391,3578713076,3578713112,36
0,674,6392,3578713076,3578713115,39
0,674,6393,3578713076,3578713116,40
0,674,6394,3578713076,3578713118,42
0,674,6395,3578713076,3578713119,43
0,674,6396,3578713076,3578713119,43
0,674,6397,3578713076,3578713125,49
0,674,6398,3578713076,3578713125,49
0,675,6399,3578713129,3578713129,0
0,675,6400,3578713129,3578713131,2
0,675,6401,3578713129,3578713132,3
0,675,6402,3578713129,3578713133,4
0,675,6403,3578713129,3578713134,5
0,675,6404,3578713129,3578713135,6
0,675,6405,3578713129,3578713137,8
0,675,6406,3578713129,3578713139,10
0,675,6407,3578713129,3578713140,11
0,675,6408,3578713129,3578713141,12
0,675,6409,3578713129,3578713142,13
0,675,6410,3578713129,3578713142,13
0,675,6411,3578713129,3578713152,23
0,675,6412,3578713129,3578713153,24
0,675,6413,3578713129,3578713155,26
0,675,6414,3578713129,3578713156,27
0,675,6415,3578713129,3578713156,27
0,675,6416,3578713129,3578713158,29
0,675,6417,3578713129,3578713159,30
0,675,6418,3578713129,3578713161,32
0,675,6419,3578713129,3578713162,33
0,675,6420,3578713129,3578713163,34
0,675,6421,3578713129,3578713165,36
0,675,6422,3578713129,3578713169,40
0,675,6423,3578713129,3578713170,41
0,675,6424,3578713129,3578713172,43
0,675,6425,3578713129,3578713174,45
0,675,6426,3578713129,3578713175,46
0,676,6427,3578713182,3578713182,0
0,676,6428,3578713182,3578713182,0
0,676,6429,3578713182,3578713182,0
0,676,6430,3578713182,3578713182,0
0,676,6431,3578713182,3578713182,0
0,676,6432,3578713182,3578713182,0
0,676,6433,3578713182,3578713183,1
0,676,6434,3578713182,3578713186,4
0,676,6435,3578713182,3578713187,5
0,676,6436,3578713182,3578713188,6
0,676,6437,3578713182,3578713189,7
0,676,6438,3578713182,3578713192,10
0,676,6439,3578713182,3578713194,12
0,676,6440,3578713182,3578713196,14
0,676,6441,3578713182,3578713197,15
0,676,6442,3578713182,3578713201,19
0,676,6443,3578713182,3578713202,20
0,676,6444,3578713182,3578713203,21
0,676,6445,3578713182,3578713205,23
0,676,6446,3578713182,3578713206,24
0,676,6447,3578713182,3578713207,25
0,676,6448,3578713182,3578713209,27
0,676,6449,3578713182,3578713214,32
0,676,6450,3578713182,3578713215,33
0,676,6451,3578713182,3578713216,34
0,676,6452,3578713182,3578713216,34
0,676,6453,3578713182,3578713217,35
0,676,6454,3578713182,3578713218,36
0,676,6455,3578713182,3578713220,38
0,676,6456,3578713182,3578713223,41
0,676,6457,3578713182,3578713224,42
0,676,6458,3578713182,3578713229,47
0,676,6459,3578713182,3578713231,49
0,676,6460,3578713182,3578713231,49
0,677,6461,3578713235,3578713235,0
0,677,6462,3578713235,3578713235,0
0,677,6463,3578713235,3578713238,3
0,677,6464,3578713235,3578713239,4
0,677,6465,3578713235,3578713240,5
0,677,6466,3578713235,3578713243,8
0,677,6467,3578713235,3578713248,13
0,677,6468,3578713235,3578713249,14
0,677,6469,3578713235,3578713249,14
0,677,6470,3578713235,3578713253,18
0,677,6471,3578713235,3578713254,19
0,677,6472,3578713235,3578713256,21
0,677,6473,3578713235,3578713259,24
0,677,6474,3578713235,3578713259,24
0,677,6475,3578713235,3578713262,27
0,677,6476,3578713235,3578713265,30
0,677,6477,3578713235,3578713266,31
0,677,6478,3578713235,3578713267,32
0,677,6479,3578713235,3578713268,33
0,677,6480,3578713235,3578713269,34
0,677,6481,3578713235,3578713270,35
0,677,6482,3578713235,3578713276,41
0,677,6483,3578713235,3578713276,41
0,677,6484,3578713235,3578713281,46
0,678,6485,3578713289,3578713289,0
0,678,6486,3578713289,3578713289,0
0,678,6487,3578713289,3578713289,0
0,678,6488,3578713289,3578713289,0
0,678,6489,3578713289,3578713289,0
0,678,6490,3578713289,3578713289,0
0,678,6491,3578713289,3578713291,2
0,678,6492,3578713289,3578713292,3
0,678,6493,3578713289,3578713295,6
0,678,6494,3578713289,3578713295,6
0,678,6495,3578713289,3578713295,6
0,678,6496,3578713289,3578713299,10
0,678,6497,3578713289,3578713301,12
0,678,6498,3578713289,3578713302,13
0,678,6499,3578713289,3578713302,13
0,678,6500,3578713289,3578713304,15
0,678,6501,3578713289,3578713305,16
0,678,6502,3578713289,3578713306,17
0,678,6503,3578713289,3578713312,23
0,678,6504,3578713289,3578713315,26
0,678,6505,3578713289,3578713316,27
0,678,6506,3578713289,3578713318,29
0,678,6507,3578713289,3578713320,31
0,678,6508,3578713289,3578713320,31
0,678,6509,3578713289,3578713325,36
0,678,6510,3578713289,3578713326,37
0,678,6511,3578713289,3578713329,40
0,678,6512,3578713289,3578713330,41
0,678,6513,3578713289,3578713332,43
0,678,6514,3578713289,3578713333,44
0,678,6515,3578713289,3578713333,44
0,678,6516,3578713289,3578713336,47
0,679,6517,3578713342,3578713342,0
0,679,6518,3578713342,3578713342,0
0,679,6519,3578713342,3578713342,0
0,679,6520,3578713342,3578713343,1
0,679,6521,3578713342,3578713344,2
0,679,6522,3578713342,3578713351,9
0,679,6523,3578713342,3578713353,11
0,679,6524,3578713342,3578713355,13
0,679,6525,3578713342,3578713356,14
0,679,6526,3578713342,3578713357,15
0,679,6527,3578713342,3578713358,16
0,679,6528,3578713342,3578713359,17
0,679,6529,3578713342,3578713360,18
0,679,6530,3578713342,3578713361,19
0,679,6531,3578713342,3578713362,20
0,679,6532,3578713342,3578713365,23
0,679,6533,3578713342,3578713370,28
0,679,6534,3578713342,3578713370,28
0,679,6535,3578713342,3578713372,30
0,679,6536,3578713342,3578713375,33
0,679,6537,3578713342,3578713375,33
0,679,6538,3578713342,3578713379,37
0,679,6539,3578713342,3578713379,37
0,679,6540,3578713342,3578713380,38
0,679,6541,3578713342,3578713381,39
0,679,6542,3578713342,3578713381,39
0,679,6543,3578713342,3578713383,41
0,679,6544,3578713342,3578713384,42
0,679,6545,3578713342,3578713386,44
0,679,6546,3578713342,3578713387,45
0,679,6547,3578713342,3578713389,47
0,679,6548,3578713342,3578713390,48
0,679,6549,3578713342,3578713392,50
0,680,6550,3578713395,3578713395,0
0,680,6551,3578713395,3578713395,0
0,680,6552,3578713395,3578713396,1
0,680,6553,3578713395,3578713401,6
0,680,6554,3578713395,3578713402,7
0,680,6555,3578713395,3578713402,7
0,680,6556,3578713395,3578713406,11
0,680,6557,3578713395,3578713406,11
0,680,6558,3578713395,3578713406,11
0,680,6559,3578713395,3578713411,16
0,680,6560,3578713395,3578713414,19
0,680,6561,3578713395,3578713415,20
0,680,6562,3578713395,3578713415,20
0,680,6563,3578713395,3578713416,21
0,680,6564,3578713395,3578713417,22
0,680,6565,3578713395,3578713419,24
0,680,6566,3578713395,3578713421,26
0,680,6567,3578713395,3578713423,28
0,680,6568,3578713395,3578713424,29
0,680,6569,3578713395,3578713428,33
0,680,6570,3578713395,3578713431,36
0,680,6571,3578713395,3578713431,36
0,680,6572,3578713395,3578713433,38
0,680,6573,3578713395,3578713435,40
0,680,6574,3578713395,3578713436,41
0,680,6575,3578713395,3578713438,43
0,680,6576,3578713395,3578713440,45
0,680,6577,3578713395,3578713441,46
0,680,6578,3578713395,3578713444,49
0,681,6579,3578713449,3578713449,0
0,681,6580,3578713449,3578713450,1
0,681,6581,3578713449,3578713450,1
0,681,6582,3578713449,3578713452,3
0,681,6583,3578713449,3578713455,6
0,681,6584,3578713449,3578713457,8
0,681,6585,3578713449,3578713459,10
0,681,6586,3578713449,3578713459,10
0,681,6587,3578713449,3578713462,13
0,681,6588,3578713449,3578713465,16
0,681,6589,3578713449,3578713466,17
0,681,6590,3578713449,3578713467,18
0,681,6591,3578713449,3578713468,19
0,681,6592,3578713449,3578713469,20
0,681,6593,3578713449,3578713469,20
0,681,6594,3578713449,3578713477,28
0,681,6595,3578713449,3578713477,28
0,681,6596,3578713449,3578713480,31
0,681,6597,3578713449,3578713486,37
0,681,6598,3578713449,3578713487,38
0,681,6599,3578713449,3578713488,39
0,681,6600,3578713449,3578713488,39
0,681,6601,3578713449,3578713489,40
0,681,6602,3578713449,3578713491,42
0,681,6603,3578713449,3578713493,44
0,681,6604,3578713449,3578713493,44
0,681,6605,3578713449,3578713495,46
0,681,6606,3578713449,3578713495,46
0,681,6607,3578713449,3578713495,46
0,682,6608,3578713502,3578713502,0
0,682,6609,3578713502,3578713502,0
0,682,6610,3578713502,3578713502,0
0,682,6611,3578713502,3578713502,0
0,682,6612,3578713502,3578713503,1
0,682,6613,3578713502,3578713504,2
0,682,6614,3578713502,3578713504,2
0,682,6615,3578713502,3578713512,10
0,682,6616,3578713502,3578713514,12
0,682,6617,3578713502,3578713515,13
0,682,6618,3578713502,3578713517,15
0,682,6619,3578713502,3578713518,16
0,682,6620,3578713502,3578713519,17
0,682,6621,3578713502,3578713524,22
0,682,6622,3578713502,3578713525,23
0,682,6623,3578713502,3578713528,26
0,682,6624,3578713502,3578713530,28
0,682,6625,3578713502,3578713531,29
0,682,6626,3578713502,3578713533,31
0,682,6627,3578713502,3578713533,31
0,682,6628,3578713502,3578713534,32
0,682,6629,3578713502,3578713540,38
0,682,6630,3578713502,3578713540,38
0,682,6631,3578713502,3578713542,40
0,682,6632,3578713502,3578713542,40
0,682,6633,3578713502,3578713546,44
0,682,6634,3578713502,3578713550,48
0,682,6635,3578713502,3578713552,50
0,683,6636,3578713555,3578713555,0
0,683,6637,3578713555,3578713556,1
0,683,6638,3578713555,3578713556,1
0,683,6639,3578713555,3578713558,3
0,683,6640,3578713555,3578713558,3
0,683,6641,3578713555,3578713560,5
0,683,6642,3578713555,3578713561,6
0,683,6643,3578713555,3578713561,6
0,683,6644,3578713555,3578713565,10
0,683,6645,3578713555,3578713569,14
0,683,6646,3578713555,3578713570,15
0,683,6647,3578713555,3578713570,15
0,683,6648,3578713555,3578713574,19
0,683,6649,3578713555,3578713574,19
0,683,6650,3578713555,3578713578,23
0,683,6651,3578713555,3578713579,24
0,683,6652,3578713555,3578713579,24
0,683,6653,3578713555,3578713580,25
0,683,6654,3578713555,3578713583,28
0,683,6655,3578713555,3578713583,28
0,683,6656,3578713555,3578713585,30
0,683,6657,3578713555,3578713586,31
0,683,6658,3578713555,3578713589,34
0,683,6659,3578713555,3578713589,34
0,683,6660,3578713555,3578713592,37
0,683,6661,3578713555,3578713594,39
0,683,6662,3578713555,3578713595,40
0,683,6663,3578713555,3578713596,41
0,683,6664,3578713555,3578713596,41
0,683,6665,3578713555,3578713600,45
0,683,6666,3578713555,3578713601,46
0,683,6667,3578713555,3578713605,50
0,684,6668,3578713609,3578713609,0
0,684,6669,3578713609,3578713609,0
0,684,6670,3578713609,3578713610,1
0,684,6671,3578713609,3578713612,3
0,684,6672,3578713609,3578713614,5
0,684,6673,3578713609,3578713615,6
0,684,6674,3578713609,3578713615,6
0,684,6675,3578713609,3578713615,6
0,684,6676,3578713609,3578713618,9
0,684,6677,3578713609,3578713619,10
0,684,6678,3578713609,3578713622,13
0,684,6679,3578713609,3578713623,14
0,684,6680,3578713609,3578713628,19
0,684,6681,3578713609,3578713630,21
0,684,6682,3578713609,3578713631,22
0,684,6683,3578713609,3578713633,24
0,684,6684,3578713609,3578713634,25
0,684,6685,3578713609,3578713636,27
0,684,6686,3578713609,3578713638,29
0,684,6687,3578713609,3578713639,30
0,684,6688,3578713609,3578713640,31
0,684,6689,3578713609,3578713644,35
0,684,6690,3578713609,3578713645,36
0,684,6691,3578713609,3578713648,39
0,684,6692,3578713609,3578713649,40
0,684,6693,3578713609,3578713652,43
0,684,6694,3578713609,3578713655,46
0,684,6695,3578713609,3578713658,49
0,684,6696,3578713609,3578713659,50
0,685,6697,3578713664,3578713664,0
0,685,6698,3578713664,3578713664,0
0,685,6699,3578713664,3578713666,2
0,685,6700,3578713664,3578713667,3
0,685,6701,3578713664,3578713667,3
0,685,6702,3578713664,3578713669,5
0,685,6703,3578713664,3578713669,5
0,685,6704,3578713664,3578713676,12
0,685,6705,3578713664,3578713677,13
0,685,6706,3578713664,3578713681,17
0,685,6707,3578713664,3578713687,23
0,685,6708,3578713664,3578713688,24
0,685,6709,3578713664,3578713688,24
0,685,6710,3578713664,3578713688,24
0,685,6711,3578713664,3578713690,26
0,685,6712,3578713664,3578713690,26
0,685,6713,3578713664,3578713695,31
0,685,6714,3578713664,3578713695,31
0,685,6715,3578713664,3578713695,31
0,685,6716,3578713664,3578713696,32
0,685,6717,3578713664,3578713699,35
0,685,6718,3578713664,3578713701,37
0,685,6719,3578713664,3578713701,37
0,685,6720,3578713664,3578713701,37
0,685,6721,3578713664,3578713704,40
0,685,6722,3578713664,3578713704,40
0,685,6723,3578713664,3578713705,41
0,685,6724,3578713664,3578713711,47
0,685,6725,3578713664,3578713712,48
0,685,6726,3578713664,3578713713,49
0,685,6727,3578713664,3578713714,50
0,686,6728,3578713718,3578713718,0
0,686,6729,3578713718,3578713718,0
0,686,6730,3578713718,3578713719,1
0,686,6731,3578713718,3578713720,2
0,686,6732,3578713718,3578713724,6
0,686,6733,3578713718,3578713726,8
0,686,6734,3578713718,3578713728,10
0,686,6735,3578713718,3578713729,11
0,686,6736,3578713718,3578713730,12
0,686,6737,3578713718,3578713732,14
0,686,6738,3578713718,3578713733,15
0,686,6739,3578713718,3578713734,16
0,686,6740,3578713718,3578713739,21
0,686,6741,3578713718,3578713740,22
0,686,6742,3578713718,3578713740,22
0,686,6743,3578713718,3578713742,24
0,686,6744,3578713718,3578713742,24
0,686,6745,3578713718,3578713746,28
0,686,6746,3578713718,3578713747,29
0,686,6747,3578713718,3578713751,33
0,686,6748,3578713718,3578713752,34
0,686,6749,3578713718,3578713754,36
0,686,6750,3578713718,3578713756,38
0,686,6751,3578713718,3578713757,39
0,686,6752,3578713718,3578713758,40
0,686,6753,3578713718,3578713759,41
0,686,6754,3578713718,3578713760,42
0,686,6755,3578713718,3578713761,43
0,686,6756,3578713718,3578713761,43
0,686,6757,3578713718,3578713765,47
0,687,6758,3578713772,3578713772,0
0,687,6759,3578713772,3578713772,0
0,687,6760,3578713772,3578713772,0
0,687,6761,3578713772,3578713774,2
0,687,6762,3578713772,3578713774,2
0,687,6763,3578713772,3578713778,6
0,687,6764,3578713772,3578713778,6
0,687,6765,3578713772,3578713780,8
0,687,6766,3578713772,3578713780,8
0,687,6767,3578713772,3578713783,11
0,687,6768,3578713772,3578713783,11
0,687,6769,3578713772,3578713787,15
0,687,6770,3578713772,3578713788,16
0,687,6771,3578713772,3578713789,17
0,687,6772,3578713772,3578713792,20
0,687,6773,3578713772,3578713794,22
0,687,6774,3578713772,3578713795,23
0,687,6775,3578713772,3578713797,25
0,687,6776,3578713772,3578713797,25
0,687,6777,3578713772,3578713800,28
0,687,6778,3578713772,3578713800,28
0,687,6779,3578713772,3578713803,31
0,687,6780,3578713772,3578713805,33
0,687,6781,3578713772,3578713805,33
0,687,6782,3578713772,3578713810,38
0,687,6783,3578713772,3578713813,41
0,687,6784,3578713772,3578713814,42
0,687,6785,3578713772,3578713815,43
0,687,6786,3578713772,3578713816,44
0,687,6787,3578713772,3578713816,44
0,687,6788,3578713772,3578713818,46
0,687,6789,3578713772,3578713819,47
0,688,6790,3578713861,3578713861,0
0,688,6791,3578713861,3578713861,0
0,688,6792,3578713861,3578713861,0
0,688,6793,3578713861,3578713861,0
0,688,6794,3578713861,3578713861,0
0,688,6795,3578713861,3578713861,0
0,688,6796,3578713861,3578713861,0
0,688,6797,3578713861,3578713861,0
0,688,6798,3578713861,3578713861,0
0,688,6799,3578713861,3578713861,0
0,688,6800,3578713861,3578713861,0
0,688,6801,3578713861,3578713861,0
0,688,6802,3578713861,3578713861,0
0,688,6803,3578713861,3578713861,0
0,688,6804,3578713861,3578713861,0
0,688,6805,3578713861,3578713861,0
0,688,6806,3578713861,3578713861,0
0,688,6807,3578713861,3578713861,0
0,688,6808,3578713861,3578713861,0
0,688,6809,3578713861,3578713861,0
0,688,6810,3578713861,3578713861,0
0,688,6811,3578713861,3578713862,1
0,688,6812,3578713861,3578713864,3
0,688,6813,3578713861,3578713866,5
0,688,6814,3578713861,3578713867,6
0,688,6815,3578713861,3578713867,6
0,688,6816,3578713861,3578713869,8
0,688,6817,3578713861,3578713870,9
0,688,6818,3578713861,3578713877,16
0,688,6819,3578713861,3578713878,17
0,688,6820,3578713861,3578713881,20
0,688,6821,3578713861,3578713886,25
0,688,6822,3578713861,3578713888,27
0,688,6823,3578713861,3578713888,27
0,688,6824,3578713861,3578713888,27
0,688,6825,3578713861,3578713890,29
0,688,6826,3578713861,3578713891,30
0,688,6827,3578713861,3578713894,33
0,688,6828,3578713861,3578713895,34
0,688,6829,3578713861,3578713896,35
0,688,6830,3578713861,3578713899,38
0,688,6831,3578713861,3578713899,38
0,688,6832,3578713861,3578713901,40
0,688,6833,3578713861,3578713901,40
0,688,6834,3578713861,3578713901,40
0,688,6835,3578713861,3578713904,43
0,688,6836,3578713861,3578713904,43
0,688,6837,3578713861,3578713905,44
0,688,6838,3578713861,3578713911,50
0,689,6839,3578713916,3578713916,0
0,689,6840,3578713916,3578713916,0
0,689,6841,3578713916,3578713916,0
0,689,6842,3578713916,3578713916,0
0,689,6843,3578713916,3578713918,2
0,689,6844,3578713916,3578713919,3
0,689,6845,3578713916,3578713919,3
0,689,6846,3578713916,3578713925,9
0,689,6847,3578713916,3578713925,9
0,689,6848,3578713916,3578713928,12
0,689,6849,3578713916,3578713930,14
0,689,6850,3578713916,3578713931,15
0,689,6851,3578713916,3578713932,16
0,689,6852,3578713916,3578713933,17
0,689,6853,3578713916,3578713939,23
0,689,6854,3578713916,3578713940,24
0,689,6855,3578713916,3578713941,25
0,689,6856,3578713916,3578713942,26
0,689,6857,3578713916,3578713942,26
0,689,6858,3578713916,3578713946,30
0,689,6859,3578713916,3578713947,31
0,689,6860,3578713916,3578713949,33
0,689,6861,3578713916,3578713951,35
0,689,6862,3578713916,3578713952,36
0,689,6863,3578713916,3578713954,38
0,689,6864,3578713916,3578713956,40
0,689,6865,3578713916,3578713956,40
0,689,6866,3578713916,3578713958,42
0,689,6867,3578713916,3578713959,43
0,689,6868,3578713916,3578713961,45
0,689,6869,3578713916,3578713961,45
0,689,6870,3578713916,3578713961,45
0,689,6871,3578713916,3578713965,49
0,690,6872,3578713969,3578713969,0
0,690,6873,3578713969,3578713970,1
0,690,6874,3578713969,3578713972,3
0,690,6875,3578713969,3578713973,4
0,690,6876,3578713969,3578713974,5
0,690,6877,3578713969,3578713978,9
0,690,6878,3578713969,3578713978,9
0,690,6879,3578713969,3578713979,10
0,690,6880,3578713969,3578713980,11
0,690,6881,3578713969,3578713980,11
0,690,6882,3578713969,3578713982,13
0,690,6883,3578713969,3578713983,14
0,690,6884,3578713969,3578713985,16
0,690,6885,3578713969,3578713986,17
0,690,6886,3578713969,3578713987,18
0,690,6887,3578713969,3578713988,19
0,690,6888,3578713969,3578713990,21
0,690,6889,3578713969,3578713992,23
0,690,6890,3578713969,3578713994,25
0,690,6891,3578713969,3578713996,27
0,690,6892,3578713969,3578713998,29
0,690,6893,3578713969,3578714000,31
0,690,6894,3578713969,3578714001,32
0,690,6895,3578713969,3578714001,32
0,690,6896,3578713969,3578714003,34
0,690,6897,3578713969,3578714005,36
0,690,6898,3578713969,3578714006,37
0,690,6899,3578713969,3578714006,37
0,690,6900,3578713969,3578714010,41
0,690,6901,3578713969,3578714013,44
0,690,6902,3578713969,3578714015,46
0,690,6903,3578713969,3578714015,46
0,690,6904,3578713969,3578714015,46
0,690,6905,3578713969,3578714016,47
0,690,6906,3578713969,3578714018,49
0,691,6907,3578714022,3578714022,0
0,691,6908,3578714022,3578714023,1
0,691,6909,3578714022,3578714024,2
0,691,6910,3578714022,3578714028,6
0,691,6911,3578714022,3578714030,8
0,691,6912,3578714022,3578714031,9
0,691,6913,3578714022,3578714033,11
0,691,6914,3578714022,3578714034,12
0,691,6915,3578714022,3578714036,14
0,691,6916,3578714022,3578714038,16
0,691,6917,3578714022,3578714039,17
0,691,6918,3578714022,3578714040,18
0,691,6919,3578714022,3578714043,21
0,691,6920,3578714022,3578714049,27
0,691,6921,3578714022,3578714049,27
0,691,6922,3578714022,3578714050,28
0,691,6923,3578714022,3578714050,28
0,691,6924,3578714022,3578714052,30
0,691,6925,3578714022,3578714054,32
0,691,6926,3578714022,3578714056,34
0,691,6927,3578714022,3578714058,36
0,691,6928,3578714022,3578714059,37
0,691,6929,3578714022,3578714062,40
0,691,6930,3578714022,3578714065,43
0,691,6931,3578714022,3578714066,44
0,691,6932,3578714022,3578714067,45
0,691,6933,3578714022,3578714067,45
0,691,6934,3578714022,3578714069,47
0,691,6935,3578714022,3578714069,47
0,692,6936,3578714075,3578714077,2
0,692,6937,3578714075,3578714078,3
0,692,6938,3578714075,3578714081,6
0,692,6939,3578714075,3578714086,11
0,692,6940,3578714075,3578714088,13
0,692,6941,3578714075,3578714088,13
0,692,6942,3578714075,3578714088,13
0,692,6943,3578714075,3578714090,15
0,692,6944,3578714075,3578714091,16
0,692,6945,3578714075,3578714094,19
0,692,6946,3578714075,3578714095,20
0,692,6947,3578714075,3578714096,21
0,692,6948,3578714075,3578714099,24
0,692,6949,3578714075,3578714099,24
0,692,6950,3578714075,3578714101,26
0,692,6951,3578714075,3578714101,26
0,692,6952,3578714075,3578714102,27
0,692,6953,3578714075,3578714103,28
0,692,6954,3578714075,3578714104,29
0,692,6955,3578714075,3578714104,29
0,692,6956,3578714075,3578714105,30
0,692,6957,3578714075,3578714112,37
0,692,6958,3578714075,3578714112,37
0,692,6959,3578714075,3578714115,40
0,692,6960,3578714075,3578714115,40
0,692,6961,3578714075,3578714116,41
0,692,6962,3578714075,3578714117,42
0,692,6963,3578714075,3578714120,45
0,692,6964,3578714075,3578714120,45
0,693,6965,3578714128,3578714128,0
0,693,6966,3578714128,3578714128,0
0,693,6967,3578714128,3578714128,0
0,693,6968,3578714128,3578714130,2
0,693,6969,3578714128,3578714130,2
0,693,6970,3578714128,3578714132,4
0,693,6971,3578714128,3578714132,4
0,693,6972,3578714128,3578714140,12
0,693,6973,3578714128,3578714140,12
0,693,6974,3578714128,3578714141,13
0,693,6975,3578714128,3578714142,14
0,693,6976,3578714128,3578714142,14
0,693,6977,3578714128,3578714147,19
0,693,6978,3578714128,3578714147,19
0,693,6979,3578714128,3578714149,21
0,693,6980,3578714128,3578714152,24
0,693,6981,3578714128,3578714152,24
0,693,6982,3578714128,3578714153,25
0,693,6983,3578714128,3578714154,26
0,693,6984,3578714128,3578714156,28
0,693,6985,3578714128,3578714156,28
0,693,6986,3578714128,3578714158,30
0,693,6987,3578714128,3578714159,31
0,693,6988,3578714128,3578714162,34
0,693,6989,3578714128,3578714162,34
0,693,6990,3578714128,3578714162,34
0,693,6991,3578714128,3578714164,36
0,693,6992,3578714128,3578714169,41
0,693,6993,3578714128,3578714171,43
0,693,6994,3578714128,3578714171,43
0,693,6995,3578714128,3578714174,46
0,693,6996,3578714128,3578714174,46
0,694,6997,3578714182,3578714182,0
0,694,6998,3578714182,3578714182,0
0,694,6999,3578714182,3578714182,0
0,694,7000,3578714182,3578714182,0
0,694,7001,3578714182,3578714182,0
0,694,7002,3578714182,3578714182,0
0,694,7003,3578714182,3578714183,1
0,694,7004,3578714182,3578714184,2
0,694,7005,3578714182,3578714186,4
0,694,7006,3578714182,3578714187,5
0,694,7007,3578714182,3578714188,6
0,694,7008,3578714182,3578714190,8
0,694,7009,3578714182,3578714193,11
0,694,7010,3578714182,3578714194,12
0,694,7011,3578714182,3578714196,14
0,694,7012,3578714182,3578714198,16
0,694,7013,3578714182,3578714201,19
0,694,7014,3578714182,3578714202,20
0,694,7015,3578714182,3578714202,20
0,694,7016,3578714182,3578714203,21
0,694,7017,3578714182,3578714205,23
0,694,7018,3578714182,3578714206,24
0,694,7019,3578714182,3578714206,24
0,694,7020,3578714182,3578714209,27
0,694,7021,3578714182,3578714213,31
0,694,7022,3578714182,3578714215,33
0,694,7023,3578714182,3578714215,33
0,694,7024,3578714182,3578714216,34
0,694,7025,3578714182,3578714217,35
0,694,7026,3578714182,3578714218,36
0,694,7027,3578714182,3578714220,38
0,694,7028,3578714182,3578714221,39
0,694,7029,3578714182,3578714223,41
0,694,7030,3578714182,3578714225,43
0,694,7031,3578714182,3578714231,49
0,694,7032,3578714182,3578714231,49
0,695,7033,3578714236,3578714236,0
0,695,7034,3578714236,3578714236,0
0,695,7035,3578714236,3578714236,0
0,695,7036,3578714236,3578714236,0
0,695,7037,3578714236,3578714239,3
0,695,7038,3578714236,3578714239,3
0,695,7039,3578714236,3578714240,4
0,695,7040,3578714236,3578714243,7
0,695,7041,3578714236,3578714249,13
0,695,7042,3578714236,3578714249,13
0,695,7043,3578714236,3578714250,14
0,695,7044,3578714236,3578714253,17
0,695,7045,3578714236,3578714253,17
0,695,7046,3578714236,3578714255,19
0,695,7047,3578714236,3578714256,20
0,695,7048,3578714236,3578714258,22
0,695,7049,3578714236,3578714259,23
0,695,7050,3578714236,3578714263,27
0,695,7051,3578714236,3578714265,29
0,695,7052,3578714236,3578714266,30
0,695,7053,3578714236,3578714267,31
0,695,7054,3578714236,3578714268,32
0,695,7055,3578714236,3578714269,33
0,695,7056,3578714236,3578714269,33
0,695,7057,3578714236,3578714277,41
0,695,7058,3578714236,3578714278,42
0,695,7059,3578714236,3578714280,44
0,696,7060,3578714290,3578714290,0
0,696,7061,3578714290,3578714290,0
0,696,7062,3578714290,3578714290,0
0,696,7063,3578714290,3578714290,0
0,696,7064,3578714290,3578714290,0
0,696,7065,3578714290,3578714291,1
0,696,7066,3578714290,3578714293,3
0,696,7067,3578714290,3578714295,5
0,696,7068,3578714290,3578714295,5
0,696,7069,3578714290,3578714296,6
0,696,7070,3578714290,3578714299,9
0,696,7071,3578714290,3578714300,10
0,696,7072,3578714290,3578714301,11
0,696,7073,3578714290,3578714303,13
0,696,7074,3578714290,3578714303,13
0,696,7075,3578714290,3578714304,14
0,696,7076,3578714290,3578714304,14
0,696,7077,3578714290,3578714304,14
0,696,7078,3578714290,3578714306,16
0,696,7079,3578714290,3578714311,21
0,696,7080,3578714290,3578714312,22
0,696,7081,3578714290,3578714315,25
0,696,7082,3578714290,3578714316,26
0,696,7083,3578714290,3578714316,26
0,696,7084,3578714290,3578714318,28
0,696,7085,3578714290,3578714320,30
0,696,7086,3578714290,3578714321,31
0,696,7087,3578714290,3578714325,35
0,696,7088,3578714290,3578714326,36
0,696,7089,3578714290,3578714328,38
0,696,7090,3578714290,3578714330,40
0,696,7091,3578714290,3578714330,40
0,696,7092,3578714290,3578714332,42
0,696,7093,3578714290,3578714333,43
0,696,7094,3578714290,3578714335,45
0,696,7095,3578714290,3578714340,50
0,697,7096,3578714344,3578714344,0
0,697,7097,3578714344,3578714344,0
0,697,7098,3578714344,3578714344,0
0,697,7099,3578714344,3578714344,0
0,697,7100,3578714344,3578714347,3
0,697,7101,3578714344,3578714347,3
0,697,7102,3578714344,3578714349,5
0,697,7103,3578714344,3578714352,8
0,697,7104,3578714344,3578714353,9
0,697,7105,3578714344,3578714355,11
0,697,7106,3578714344,3578714355,11
0,697,7107,3578714344,3578714356,12
0,697,7108,3578714344,3578714356,12
0,697,7109,3578714344,3578714358,14
0,697,7110,3578714344,3578714359,15
0,697,7111,3578714344,3578714362,18
0,697,7112,3578714344,3578714362,18
0,697,7113,3578714344,3578714363,19
0,697,7114,3578714344,3578714365,21
0,697,7115,3578714344,3578714369,25
0,697,7116,3578714344,3578714371,27
0,697,7117,3578714344,3578714371,27
0,697,7118,3578714344,3578714374,30
0,697,7119,3578714344,3578714374,30
0,697,7120,3578714344,3578714379,35
0,697,7121,3578714344,3578714379,35
0,697,7122,3578714344,3578714380,36
0,697,7123,3578714344,3578714380,36
0,697,7124,3578714344,3578714381,37
0,697,7125,3578714344,3578714383,39
0,697,7126,3578714344,3578714384,40
0,697,7127,3578714344,3578714385,41
0,697,7128,3578714344,3578714386,42
0,697,7129,3578714344,3578714387,43
0,697,7130,3578714344,3578714388,44
0,697,7131,3578714344,3578714389,45
0,697,7132,3578714344,3578714392,48
0,698,7133,3578714398,3578714398,0
0,698,7134,3578714398,3578714398,0
0,698,7135,3578714398,3578714398,0
0,698,7136,3578714398,3578714401,3
0,698,7137,3578714398,3578714402,4
0,698,7138,3578714398,3578714403,5
0,698,7139,3578714398,3578714405,7
0,698,7140,3578714398,3578714405,7
0,698,7141,3578714398,3578714406,8
0,698,7142,3578714398,3578714407,9
0,698,7143,3578714398,3578714410,12
0,698,7144,3578714398,3578714412,14
0,698,7145,3578714398,3578714415,17
0,698,7146,3578714398,3578714415,17
0,698,7147,3578714398,3578714416,18
0,698,7148,3578714398,3578714416,18
0,698,7149,3578714398,3578714419,21
0,698,7150,3578714398,3578714419,21
0,698,7151,3578714398,3578714421,23
0,698,7152,3578714398,3578714424,26
0,698,7153,3578714398,3578714425,27
0,698,7154,3578714398,3578714429,31
0,698,7155,3578714398,3578714430,32
0,698,7156,3578714398,3578714431,33
0,698,7157,3578714398,3578714434,36
0,698,7158,3578714398,3578714435,37
0,698,7159,3578714398,3578714436,38
0,698,7160,3578714398,3578714439,41
0,698,7161,3578714398,3578714439,41
0,698,7162,3578714398,3578714440,42
0,698,7163,3578714398,3578714444,46
0,699,7164,3578714452,3578714452,0
0,699,7165,3578714452,3578714452,0
0,699,7166,3578714452,3578714452,0
0,699,7167,3578714452,3578714453,1
0,699,7168,3578714452,3578714456,4
0,699,7169,3578714452,3578714456,4
0,699,7170,3578714452,3578714457,5
0,699,7171,3578714452,3578714459,7
0,699,7172,3578714452,3578714463,11
0,699,7173,3578714452,3578714465,13
0,699,7174,3578714452,3578714466,14
0,699,7175,3578714452,3578714468,16
0,699,7176,3578714452,3578714468,16
0,699,7177,3578714452,3578714469,17
0,699,7178,3578714452,3578714470,18
0,699,7179,3578714452,3578714477,25
0,699,7180,3578714452,3578714478,26
0,699,7181,3578714452,3578714481,29
0,699,7182,3578714452,3578714487,35
0,699,7183,3578714452,3578714488,36
0,699,7184,3578714452,3578714490,38
0,699,7185,3578714452,3578714490,38
0,699,7186,3578714452,3578714490,38
0,699,7187,3578714452,3578714491,39
0,699,7188,3578714452,3578714493,41
0,699,7189,3578714452,3578714494,42
0,699,7190,3578714452,3578714495,43
0,699,7191,3578714452,3578714496,44
0,699,7192,3578714452,3578714499,47
0,699,7193,3578714452,3578714499,47
0,699,7194,3578714452,3578714501,49
0,700,7195,3578714506,3578714506,0
0,700,7196,3578714506,3578714506,0
0,700,7197,3578714506,3578714506,0
0,700,7198,3578714506,3578714506,0
0,700,7199,3578714506,3578714506,0
0,700,7200,3578714506,3578714507,1
0,700,7201,3578714506,3578714510,4
0,700,7202,3578714506,3578714511,5
0,700,7203,3578714506,3578714515,9
0,700,7204,3578714506,3578714515,9
0,700,7205,3578714506,3578714515,9
0,700,7206,3578714506,3578714518,12
0,700,7207,3578714506,3578714519,13
0,700,7208,3578714506,3578714520,14
0,700,7209,3578714506,3578714525,19
0,700,7210,3578714506,3578714525,19
0,700,7211,3578714506,3578714527,21
0,700,7212,3578714506,3578714529,23
0,700,7213,3578714506,3578714532,26
0,700,7214,3578714506,3578714532,26
0,700,7215,3578714506,3578714534,28
0,700,7216,3578714506,3578714539,33
0,700,7217,3578714506,3578714540,34
0,700,7218,3578714506,3578714541,35
0,700,7219,3578714506,3578714542,36
0,700,7220,3578714506,3578714543,37
0,700,7221,3578714506,3578714546,40
0,700,7222,3578714506,3578714546,40
0,700,7223,3578714506,3578714548,42
0,700,7224,3578714506,3578714550,44
0,700,7225,3578714506,3578714552,46
0,700,7226,3578714506,3578714554,48
0,700,7227,3578714506,3578714555,49
0,701,7228,3578714559,3578714559,0
0,701,7229,3578714559,3578714559,0
0,701,7230,3578714559,3578714559,0
0,701,7231,3578714559,3578714559,0
0,701,7232,3578714559,3578714561,2
0,701,7233,3578714559,3578714561,2
0,701,7234,3578714559,3578714563,4
0,701,7235,3578714559,3578714564,5
0,701,7236,3578714559,3578714569,10
0,701,7237,3578714559,3578714570,11
0,701,7238,3578714559,3578714570,11
0,701,7239,3578714559,3578714573,14
0,701,7240,3578714559,3578714574,15
0,701,7241,3578714559,3578714578,19
0,701,7242,3578714559,3578714579,20
0,701,7243,3578714559,3578714579,20
0,701,7244,3578714559,3578714579,20
0,701,7245,3578714559,3578714580,21
0,701,7246,3578714559,3578714582,23
0,701,7247,3578714559,3578714583,24
0,701,7248,3578714559,3578714585,26
0,701,7249,3578714559,3578714586,27
0,701,7250,3578714559,3578714586,27
0,701,7251,3578714559,3578714588,29
0,701,7252,3578714559,3578714588,29
0,701,7253,3578714559,3578714592,33
0,701,7254,3578714559,3578714594,35
0,701,7255,3578714559,3578714596,37
0,701,7256,3578714559,3578714597,38
0,701,7257,3578714559,3578714600,41
0,701,7258,3578714559,3578714601,42
0,701,7259,3578714559,3578714602,43
0,701,7260,3578714559,3578714606,47
0,701,7261,3578714559,3578714608,49
0,702,7262,3578714613,3578714613,0
0,702,7263,3578714613,3578714613,0
0,702,7264,3578714613,3578714614,1
0,702,7265,3578714613,3578714614,1
0,702,7266,3578714613,3578714616,3
0,702,7267,3578714613,3578714618,5
0,702,7268,3578714613,3578714618,5
0,702,7269,3578714613,3578714622,9
0,702,7270,3578714613,3578714622,9
0,702,7271,3578714613,3578714624,11
0,702,7272,3578714613,3578714628,15
0,702,7273,3578714613,3578714631,18
0,702,7274,3578714613,3578714631,18
0,702,7275,3578714613,3578714633,20
0,702,7276,3578714613,3578714633,20
0,702,7277,3578714613,3578714636,23
0,702,7278,3578714613,3578714638,25
0,702,7279,3578714613,3578714638,25
0,702,7280,3578714613,3578714639,26
0,702,7281,3578714613,3578714648,35
0,702,7282,3578714613,3578714649,36
0,702,7283,3578714613,3578714649,36
0,702,7284,3578714613,3578714652,39
0,702,7285,3578714613,3578714655,42
0,702,7286,3578714613,3578714656,43
0,702,7287,3578714613,3578714657,44
0,702,7288,3578714613,3578714659,46
0,702,7289,3578714613,3578714661,48
0,703,7290,3578714667,3578714667,0
0,703,7291,3578714667,3578714667,0
0,703,7292,3578714667,3578714667,0
0,703,7293,3578714667,3578714667,0
0,703,7294,3578714667,3578714669,2
0,703,7295,3578714667,3578714670,3
0,703,7296,3578714667,3578714677,10
0,703,7297,3578714667,3578714678,11
0,703,7298,3578714667,3578714681,14
0,703,7299,3578714667,3578714687,20
0,703,7300,3578714667,3578714689,22
0,703,7301,3578714667,3578714690,23
0,703,7302,3578714667,3578714690,23
0,703,7303,3578714667,3578714691,24
0,703,7304,3578714667,3578714694,27
0,703,7305,3578714667,3578714694,27
0,703,7306,3578714667,3578714695,28
0,703,7307,3578714667,3578714696,29
0,703,7308,3578714667,3578714699,32
0,703,7309,3578714667,3578714700,33
0,703,7310,3578714667,3578714701,34
0,703,7311,3578714667,3578714703,36
0,703,7312,3578714667,3578714703,36
0,703,7313,3578714667,3578714704,37
0,703,7314,3578714667,3578714704,37
0,703,7315,3578714667,3578714704,37
0,703,7316,3578714667,3578714710,43
0,703,7317,3578714667,3578714710,43
0,703,7318,3578714667,3578714710,43
0,703,7319,3578714667,3578714714,47
0,703,7320,3578714667,3578714715,48
0,703,7321,3578714667,3578714715,48
0,704,7322,3578714721,3578714721,0
0,704,7323,3578714721,3578714721,0
0,704,7324,3578714721,3578714721,0
0,704,7325,3578714721,3578714725,4
0,704,7326,3578714721,3578714726,5
0,704,7327,3578714721,3578714727,6
0,704,7328,3578714721,3578714729,8
0,704,7329,3578714721,3578714732,11
0,704,7330,3578714721,3578714732,11
0,704,7331,3578714721,3578714739,18
0,704,7332,3578714721,3578714740,19
0,704,7333,3578714721,3578714742,21
0,704,7334,3578714721,3578714742,21
0,704,7335,3578714721,3578714743,22
0,704,7336,3578714721,3578714745,24
0,704,7337,3578714721,3578714746,25
0,704,7338,3578714721,3578714748,27
0,704,7339,3578714721,3578714751,30
0,704,7340,3578714721,3578714752,31
0,704,7341,3578714721,3578714755,34
0,704,7342,3578714721,3578714755,34
0,704,7343,3578714721,3578714758,37
0,704,7344,3578714721,3578714759,38
0,704,7345,3578714721,3578714759,38
0,704,7346,3578714721,3578714761,40
0,704,7347,3578714721,3578714761,40
0,704,7348,3578714721,3578714762,41
0,704,7349,3578714721,3578714764,43
0,704,7350,3578714721,3578714764,43
0,704,7351,3578714721,3578714769,48
0,704,7352,3578714721,3578714770,49
0,705,7353,3578714776,3578714776,0
0,705,7354,3578714776,3578714776,0
0,705,7355,3578714776,3578714776,0
0,705,7356,3578714776,3578714778,2
0,705,7357,3578714776,3578714778,2
0,705,7358,3578714776,3578714779,3
0,705,7359,3578714776,3578714779,3
0,705,7360,3578714776,3578714780,4
0,705,7361,3578714776,3578714783,7
0,705,7362,3578714776,3578714783,7
0,705,7363,3578714776,3578714785,9
0,705,7364,3578714776,3578714785,9
0,705,7365,3578714776,3578714787,11
0,705,7366,3578714776,3578714788,12
0,705,7367,3578714776,3578714788,12
0,705,7368,3578714776,3578714792,16
0,705,7369,3578714776,3578714794,18
0,705,7370,3578714776,3578714796,20
0,705,7371,3578714776,3578714796,20
0,705,7372,3578714776,3578714800,24
0,705,7373,3578714776,3578714801,25
0,705,7374,3578714776,3578714802,26
0,705,7375,3578714776,3578714805,29
0,705,7376,3578714776,3578714806,30
0,705,7377,3578714776,3578714810,34
0,705,7378,3578714776,3578714812,36
0,705,7379,3578714776,3578714813,37
0,705,7380,3578714776,3578714814,38
0,705,7381,3578714776,3578714815,39
0,705,7382,3578714776,3578714815,39
0,705,7383,3578714776,3578714818,42
0,705,7384,3578714776,3578714818,42
0,705,7385,3578714776,3578714822,46
0,705,7386,3578714776,3578714824,48
0,705,7387,3578714776,3578714824,48
0,706,7388,3578714831,3578714831,0
0,706,7389,3578714831,3578714831,0
0,706,7390,3578714831,3578714831,0
0,706,7391,3578714831,3578714833,2
0,706,7392,3578714831,3578714833,2
0,706,7393,3578714831,3578714834,3
0,706,7394,3578714831,3578714836,5
0,706,7395,3578714831,3578714839,8
0,706,7396,3578714831,3578714839,8
0,706,7397,3578714831,3578714839,8
0,706,7398,3578714831,3578714843,12
0,706,7399,3578714831,3578714848,17
0,706,7400,3578714831,3578714850,19
0,706,7401,3578714831,3578714850,19
0,706,7402,3578714831,3578714852,21
0,706,7403,3578714831,3578714855,24
0,706,7404,3578714831,3578714856,25
0,706,7405,3578714831,3578714858,27
0,706,7406,3578714831,3578714859,28
0,706,7407,3578714831,3578714862,31
0,706,7408,3578714831,3578714863,32
0,706,7409,3578714831,3578714864,33
0,706,7410,3578714831,3578714865,34
0,706,7411,3578714831,3578714867,36
0,706,7412,3578714831,3578714867,36
0,706,7413,3578714831,3578714869,38
0,706,7414,3578714831,3578714870,39
0,706,7415,3578714831,3578714878,47
0,706,7416,3578714831,3578714878,47
0,707,7417,3578714885,3578714885,0
0,707,7418,3578714885,3578714888,3
0,707,7419,3578714885,3578714890,5
0,707,7420,3578714885,3578714890,5
0,707,7421,3578714885,3578714890,5
0,707,7422,3578714885,3578714891,6
0,707,7423,3578714885,3578714894,9
0,707,7424,3578714885,3578714895,10
0,707,7425,3578714885,3578714896,11
0,707,7426,3578714885,3578714896,11
0,707,7427,3578714885,3578714899,14
0,707,7428,3578714885,3578714900,15
0,707,7429,3578714885,3578714902,17
0,707,7430,3578714885,3578714903,18
0,707,7431,3578714885,3578714903,18
0,707,7432,3578714885,3578714903,18
0,707,7433,3578714885,3578714904,19
0,707,7434,3578714885,3578714905,20
0,707,7435,3578714885,3578714911,26
0,707,7436,3578714885,3578714911,26
0,707,7437,3578714885,3578714911,26
0,707,7438,3578714885,3578714914,29
0,707,7439,3578714885,3578714915,30
0,707,7440,3578714885,3578714915,30
0,707,7441,3578714885,3578714915,30
0,707,7442,3578714885,3578714918,33
0,707,7443,3578714885,3578714920,35
0,707,7444,3578714885,3578714920,35
0,707,7445,3578714885,3578714925,40
0,707,7446,3578714885,3578714926,41
0,707,7447,3578714885,3578714926,41
0,707,7448,3578714885,3578714930,45
0,707,7449,3578714885,3578714931,46
0,707,7450,3578714885,3578714932,47
0,707,7451,3578714885,3578714932,47
0,708,7452,3578714939,3578714939,0
0,708,7453,3578714939,3578714940,1
0,708,7454,3578714939,3578714941,2
0,708,7455,3578714939,3578714942,3
0,708,7456,3578714939,3578714943,4
0,708,7457,3578714939,3578714946,7
0,708,7458,3578714939,3578714946,7
0,708,7459,3578714939,3578714949,10
0,708,7460,3578714939,3578714950,11
0,708,7461,3578714939,3578714952,13
0,708,7462,3578714939,3578714954,15
0,708,7463,3578714939,3578714955,16
0,708,7464,3578714939,3578714957,18
0,708,7465,3578714939,3578714958,19
0,708,7466,3578714939,3578714959,20
0,708,7467,3578714939,3578714960,21
0,708,7468,3578714939,3578714961,22
0,708,7469,3578714939,3578714963,24
0,708,7470,3578714939,3578714964,25
0,708,7471,3578714939,3578714964,25
0,708,7472,3578714939,3578714964,25
0,708,7473,3578714939,3578714969,30
0,708,7474,3578714939,3578714970,31
0,708,7475,3578714939,3578714971,32
0,708,7476,3578714939,3578714974,35
0,708,7477,3578714939,3578714974,35
0,708,7478,3578714939,3578714978,39
0,708,7479,3578714939,3578714979,40
0,708,7480,3578714939,3578714979,40
0,708,7481,3578714939,3578714979,40
0,708,7482,3578714939,3578714980,41
0,708,7483,3578714939,3578714983,44
0,708,7484,3578714939,3578714984,45
0,708,7485,3578714939,3578714985,46
0,708,7486,3578714939,3578714986,47
0,708,7487,3578714939,3578714987,48
0,708,7488,3578714939,3578714989,50
0,709,7489,3578714993,3578714993,0
0,709,7490,3578714993,3578714993,0
0,709,7491,3578714993,3578714995,2
0,709,7492,3578714993,3578714996,3
0,709,7493,3578714993,3578714997,4
0,709,7494,3578714993,3578715001,8
0,709,7495,3578714993,3578715002,9
0,709,7496,3578714993,3578715003,10
0,709,7497,3578714993,3578715005,12
0,709,7498,3578714993,3578715005,12
0,709,7499,3578714993,3578715006,13
0,709,7500,3578714993,3578715009,16
0,709,7501,3578714993,3578715013,20
0,709,7502,3578714993,3578715013,20
0,709,7503,3578714993,3578715015,22
0,709,7504,3578714993,3578715015,22
0,709,7505,3578714993,3578715015,22
0,709,7506,3578714993,3578715016,23
0,709,7507,3578714993,3578715019,26
0,709,7508,3578714993,3578715023,30
0,709,7509,3578714993,3578715024,31
0,709,7510,3578714993,3578715024,31
0,709,7511,3578714993,3578715027,34
0,709,7512,3578714993,3578715031,38
0,709,7513,3578714993,3578715031,38
0,709,7514,3578714993,3578715033,40
0,709,7515,3578714993,3578715033,40
0,709,7516,3578714993,3578715034,41
0,709,7517,3578714993,3578715035,42
0,709,7518,3578714993,3578715039,46
0,709,7519,3578714993,3578715039,46
0,709,7520,3578714993,3578715039,46
0,710,7521,3578715047,3578715047,0
0,710,7522,3578715047,3578715050,3
0,710,7523,3578715047,3578715051,4
0,710,7524,3578715047,3578715052,5
0,710,7525,3578715047,3578715056,9
0,710,7526,3578715047,3578715056,9
0,710,7527,3578715047,3578715057,10
0,710,7528,3578715047,3578715059,12
0,710,7529,3578715047,3578715063,16
0,710,7530,3578715047,3578715063,16
0,710,7531,3578715047,3578715064,17
0,710,7532,3578715047,3578715065,18
0,710,7533,3578715047,3578715065,18
0,710,7534,3578715047,3578715067,20
0,710,7535,3578715047,3578715067,20
0,710,7536,3578715047,3578715069,22
0,710,7537,3578715047,3578715070,23
0,710,7538,3578715047,3578715077,30
0,710,7539,3578715047,3578715078,31
0,710,7540,3578715047,3578715082,35
0,710,7541,3578715047,3578715087,40
0,710,7542,3578715047,3578715088,41
0,710,7543,3578715047,3578715090,43
0,710,7544,3578715047,3578715090,43
0,710,7545,3578715047,3578715090,43
0,710,7546,3578715047,3578715091,44
0,710,7547,3578715047,3578715093,46
0,710,7548,3578715047,3578715095,48
0,710,7549,3578715047,3578715096,49
0,710,7550,3578715047,3578715096,49
0,711,7551,3578715101,3578715101,0
0,711,7552,3578715101,3578715101,0
0,711,7553,3578715101,3578715101,0
0,711,7554,3578715101,3578715103,2
0,711,7555,3578715101,3578715103,2
0,711,7556,3578715101,3578715104,3
0,711,7557,3578715101,3578715104,3
0,711,7558,3578715101,3578715104,3
0,711,7559,3578715101,3578715110,9
0,711,7560,3578715101,3578715111,10
0,711,7561,3578715101,3578715112,11
0,711,7562,3578715101,3578715115,14
0,711,7563,3578715101,3578715115,14
0,711,7564,3578715101,3578715115,14
0,711,7565,3578715101,3578715116,15
0,711,7566,3578715101,3578715117,16
0,711,7567,3578715101,3578715119,18
0,711,7568,3578715101,3578715119,18
0,711,7569,3578715101,3578715125,24
0,711,7570,3578715101,3578715126,25
0,711,7571,3578715101,3578715127,26
0,711,7572,3578715101,3578715130,29
0,711,7573,3578715101,3578715131,30
0,711,7574,3578715101,3578715132,31
0,711,7575,3578715101,3578715133,32
0,711,7576,3578715101,3578715139,38
0,711,7577,3578715101,3578715141,40
0,711,7578,3578715101,3578715142,41
0,711,7579,3578715101,3578715142,41
0,711,7580,3578715101,3578715144,43
0,711,7581,3578715101,3578715145,44
0,711,7582,3578715101,3578715146,45
0,711,7583,3578715101,3578715149,48
0,712,7584,3578715155,3578715155,0
0,712,7585,3578715155,3578715155,0
0,712,7586,3578715155,3578715155,0
0,712,7587,3578715155,3578715155,0
0,712,7588,3578715155,3578715158,3
0,712,7589,3578715155,3578715158,3
0,712,7590,3578715155,3578715159,4
0,712,7591,3578715155,3578715161,6
0,712,7592,3578715155,3578715162,7
0,712,7593,3578715155,3578715163,8
0,712,7594,3578715155,3578715164,9
0,712,7595,3578715155,3578715165,10
0,712,7596,3578715155,3578715167,12
0,712,7597,3578715155,3578715169,14
0,712,7598,3578715155,3578715169,14
0,712,7599,3578715155,3578715171,16
0,712,7600,3578715155,3578715174,19
0,712,7601,3578715155,3578715175,20
0,712,7602,3578715155,3578715178,23
0,712,7603,3578715155,3578715179,24
0,712,7604,3578715155,3578715179,24
0,712,7605,3578715155,3578715179,24
0,712,7606,3578715155,3578715181,26
0,712,7607,3578715155,3578715183,28
0,712,7608,3578715155,3578715183,28
0,712,7609,3578715155,3578715185,30
0,712,7610,3578715155,3578715187,32
0,712,7611,3578715155,3578715188,33
0,712,7612,3578715155,3578715189,34
0,712,7613,3578715155,3578715192,37
0,712,7614,3578715155,3578715195,40
0,712,7615,3578715155,3578715196,41
0,712,7616,3578715155,3578715197,42
0,712,7617,3578715155,3578715201,46
0,712,7618,3578715155,3578715201,46
0,712,7619,3578715155,3578715203,48
0,713,7620,3578715209,3578715209,0
0,713,7621,3578715209,3578715209,0
0,713,7622,3578715209,3578715209,0
0,713,7623,3578715209,3578715210,1
0,713,7624,3578715209,3578715212,3
0,713,7625,3578715209,3578715213,4
0,713,7626,3578715209,3578715216,7
0,713,7627,3578715209,3578715216,7
0,713,7628,3578715209,3578715216,7
0,713,7629,3578715209,3578715216,7
0,713,7630,3578715209,3578715218,9
0,713,7631,3578715209,3578715219,10
0,713,7632,3578715209,3578715222,13
0,713,7633,3578715209,3578715223,14
0,713,7634,3578715209,3578715224,15
0,713,7635,3578715209,3578715229,20
0,713,7636,3578715209,3578715231,22
0,713,7637,3578715209,3578715231,22
0,713,7638,3578715209,3578715233,24
0,713,7639,3578715209,3578715234,25
0,713,7640,3578715209,3578715235,26
0,713,7641,3578715209,3578715236,27
0,713,7642,3578715209,3578715239,30
0,713,7643,3578715209,3578715239,30
0,713,7644,3578715209,3578715240,31
0,713,7645,3578715209,3578715246,37
0,713,7646,3578715209,3578715248,39
0,713,7647,3578715209,3578715250,41
0,713,7648,3578715209,3578715250,41
0,713,7649,3578715209,3578715253,44
0,713,7650,3578715209,3578715255,46
0,713,7651,3578715209,3578715256,47
0,713,7652,3578715209,3578715258,49
0,714,7653,3578715263,3578715263,0
0,714,7654,3578715263,3578715263,0
0,714,7655,3578715263,3578715263,0
0,714,7656,3578715263,3578715265,2
0,714,7657,3578715263,3578715266,3
0,714,7658,3578715263,3578715267,4
0,714,7659,3578715263,3578715267,4
0,714,7660,3578715263,3578715268,5
0,714,7661,3578715263,3578715269,6
0,714,7662,3578715263,3578715270,7
0,714,7663,3578715263,3578715277,14
0,714,7664,3578715263,3578715278,15
0,714,7665,3578715263,3578715281,18
0,714,7666,3578715263,3578715287,24
0,714,7667,3578715263,3578715288,25
0,714,7668,3578715263,3578715290,27
0,714,7669,3578715263,3578715290,27
0,714,7670,3578715263,3578715291,28
0,714,7671,3578715263,3578715293,30
0,714,7672,3578715263,3578715295,32
0,714,7673,3578715263,3578715296,33
0,714,7674,3578715263,3578715296,33
0,714,7675,3578715263,3578715299,36
0,714,7676,3578715263,3578715300,37
0,714,7677,3578715263,3578715301,38
0,714,7678,3578715263,3578715303,40
0,714,7679,3578715263,3578715303,40
0,714,7680,3578715263,3578715304,41
0,714,7681,3578715263,3578715304,41
0,714,7682,3578715263,3578715306,43
0,714,7683,3578715263,3578715310,47
0,714,7684,3578715263,3578715310,47
0,714,7685,3578715263,3578715311,48
0,715,7686,3578715317,3578715317,0
0,715,7687,3578715317,3578715317,0
0,715,7688,3578715317,3578715317,0
0,715,7689,3578715317,3578715318,1
0,715,7690,3578715317,3578715319,2
0,715,7691,3578715317,3578715319,2
0,715,7692,3578715317,3578715319,2
0,715,7693,3578715317,3578715325,8
0,715,7694,3578715317,3578715326,9
0,715,7695,3578715317,3578715327,10
0,715,7696,3578715317,3578715330,13
0,715,7697,3578715317,3578715331,14
0,715,7698,3578715317,3578715333,16
0,715,7699,3578715317,3578715333,16
0,715,7700,3578715317,3578715335,18
0,715,7701,3578715317,3578715340,23
0,715,7702,3578715317,3578715341,24
0,715,7703,3578715317,3578715342,25
0,715,7704,3578715317,3578715343,26
0,715,7705,3578715317,3578715345,28
0,715,7706,3578715317,3578715345,28
0,715,7707,3578715317,3578715346,29
0,715,7708,3578715317,3578715349,32
0,715,7709,3578715317,3578715352,35
0,715,7710,3578715317,3578715352,35
0,715,7711,3578715317,3578715355,38
0,715,7712,3578715317,3578715356,39
0,715,7713,3578715317,3578715357,40
0,715,7714,3578715317,3578715358,41
0,715,7715,3578715317,3578715361,44
0,715,7716,3578715317,3578715363,46
0,715,7717,3578715317,3578715364,47
0,715,7718,3578715317,3578715365,48
0,716,7719,3578715370,3578715371,1
0,716,7720,3578715370,3578715371,1
0,716,7721,3578715370,3578715371,1
0,716,7722,3578715370,3578715371,1
0,716,7723,3578715370,3578715375,5
0,716,7724,3578715370,3578715376,6
0,716,7725,3578715370,3578715378,8
0,716,7726,3578715370,3578715380,10
0,716,7727,3578715370,3578715381,11
0,716,7728,3578715370,3578715382,12
0,716,7729,3578715370,3578715383,13
0,716,7730,3578715370,3578715384,14
0,716,7731,3578715370,3578715385,15
0,716,7732,3578715370,3578715387,17
0,716,7733,3578715370,3578715388,18
0,716,7734,3578715370,3578715390,20
0,716,7735,3578715370,3578715392,22
0,716,7736,3578715370,3578715395,25
0,716,7737,3578715370,3578715396,26
0,716,7738,3578715370,3578715397,27
0,716,7739,3578715370,3578715401,31
0,716,7740,3578715370,3578715401,31
0,716,7741,3578715370,3578715402,32
0,716,7742,3578715370,3578715406,36
0,716,7743,3578715370,3578715406,36
0,716,7744,3578715370,3578715407,37
0,716,7745,3578715370,3578715411,41
0,716,7746,3578715370,3578715413,43
0,716,7747,3578715370,3578715413,43
0,716,7748,3578715370,3578715415,45
0,716,7749,3578715370,3578715416,46
0,716,7750,3578715370,3578715416,46
0,716,7751,3578715370,3578715417,47
0,716,7752,3578715370,3578715418,48
0,717,7753,3578715425,3578715425,0
0,717,7754,3578715425,3578715425,0
0,717,7755,3578715425,3578715425,0
0,717,7756,3578715425,3578715425,0
0,717,7757,3578715425,3578715428,3
0,717,7758,3578715425,3578715431,6
0,717,7759,3578715425,3578715431,6
0,717,7760,3578715425,3578715433,8
0,717,7761,3578715425,3578715434,9
0,717,7762,3578715425,3578715435,10
0,717,7763,3578715425,3578715435,10
0,717,7764,3578715425,3578715440,15
0,717,7765,3578715425,3578715440,15
0,717,7766,3578715425,3578715440,15
0,717,7767,3578715425,3578715446,21
0,717,7768,3578715425,3578715449,24
0,717,7769,3578715425,3578715450,25
0,717,7770,3578715425,3578715451,26
0,717,7771,3578715425,3578715452,27
0,717,7772,3578715425,3578715455,30
0,717,7773,3578715425,3578715457,32
0,717,7774,3578715425,3578715459,34
0,717,7775,3578715425,3578715459,34
0,717,7776,3578715425,3578715463,38
0,717,7777,3578715425,3578715463,38
0,717,7778,3578715425,3578715465,40
0,717,7779,3578715425,3578715466,41
0,717,7780,3578715425,3578715466,41
0,717,7781,3578715425,3578715468,43
0,717,7782,3578715425,3578715469,44
0,717,7783,3578715425,3578715471,46
0,717,7784,3578715425,3578715471,46
0,718,7785,3578715479,3578715479,0
0,718,7786,3578715479,3578715481,2
0,718,7787,3578715479,3578715487,8
0,718,7788,3578715479,3578715488,9
0,718,7789,3578715479,3578715488,9
0,718,7790,3578715479,3578715489,10
0,718,7791,3578715479,3578715490,11
0,718,7792,3578715479,3578715491,12
0,718,7793,3578715479,3578715493,14
0,718,7794,3578715479,3578715494,15
0,718,7795,3578715479,3578715495,16
0,718,7796,3578715479,3578715496,17
0,718,7797,3578715479,3578715498,19
0,718,7798,3578715479,3578715499,20
0,718,7799,3578715479,3578715500,21
0,718,7800,3578715479,3578715502,23
0,718,7801,3578715479,3578715503,24
0,718,7802,3578715479,3578715503,24
0,718,7803,3578715479,3578715505,26
0,718,7804,3578715479,3578715509,30
0,718,7805,3578715479,3578715510,31
0,718,7806,3578715479,3578715511,32
0,718,7807,3578715479,3578715514,35
0,718,7808,3578715479,3578715515,36
0,718,7809,3578715479,3578715515,36
0,718,7810,3578715479,3578715518,39
0,718,7811,3578715479,3578715518,39
0,718,7812,3578715479,3578715519,40
0,718,7813,3578715479,3578715522,43
0,718,7814,3578715479,3578715524,45
0,718,7815,3578715479,3578715525,46
0,718,7816,3578715479,3578715527,48
0,719,7817,3578715533,3578715533,0
0,719,7818,3578715533,3578715533,0
0,719,7819,3578715533,3578715533,0
0,719,7820,3578715533,3578715533,0
0,719,7821,3578715533,3578715534,1
0,719,7822,3578715533,3578715539,6
0,719,7823,3578715533,3578715540,7
0,719,7824,3578715533,3578715541,8
0,719,7825,3578715533,3578715542,9
0,719,7826,3578715533,3578715543,10
0,719,7827,3578715533,3578715545,12
0,719,7828,3578715533,3578715545,12
0,719,7829,3578715533,3578715549,16
0,719,7830,3578715533,3578715551,18
0,719,7831,3578715533,3578715552,19
0,719,7832,3578715533,3578715554,21
0,719,7833,3578715533,3578715555,22
0,719,7834,3578715533,3578715557,24
0,719,7835,3578715533,3578715558,25
0,719,7836,3578715533,3578715559,26
0,719,7837,3578715533,3578715561,28
0,719,7838,3578715533,3578715561,28
0,719,7839,3578715533,3578715563,30
0,719,7840,3578715533,3578715564,31
0,719,7841,3578715533,3578715569,36
0,719,7842,3578715533,3578715569,36
0,719,7843,3578715533,3578715570,37
0,719,7844,3578715533,3578715574,41
0,719,7845,3578715533,3578715575,42
0,719,7846,3578715533,3578715576,43
0,719,7847,3578715533,3578715578,45
0,719,7848,3578715533,3578715578,45
0,719,7849,3578715533,3578715579,46
0,719,7850,3578715533,3578715581,48
0,719,7851,3578715533,3578715583,50
0,720,7852,3578715587,3578715587,0
0,720,7853,3578715587,3578715587,0
0,720,7854,3578715587,3578715587,0
0,720,7855,3578715587,3578715587,0
0,720,7856,3578715587,3578715588,1
0,720,7857,3578715587,3578715592,5
0,720,7858,3578715587,3578715594,7
0,720,7859,3578715587,3578715595,8
0,720,7860,3578715587,3578715595,8
0,720,7861,3578715587,3578715600,13
0,720,7862,3578715587,3578715601,14
0,720,7863,3578715587,3578715602,15
0,720,7864,3578715587,3578715604,17
0,720,7865,3578715587,3578715605,18
0,720,7866,3578715587,3578715606,19
0,720,7867,3578715587,3578715609,22
0,720,7868,3578715587,3578715612,25
0,720,7869,3578715587,3578715612,25
0,720,7870,3578715587,3578715614,27
0,720,7871,3578715587,3578715615,28
0,720,7872,3578715587,3578715615,28
0,720,7873,3578715587,3578715616,29
0,720,7874,3578715587,3578715618,31
0,720,7875,3578715587,3578715618,31
0,720,7876,3578715587,3578715622,35
0,720,7877,3578715587,3578715623,36
0,720,7878,3578715587,3578715623,36
0,720,7879,3578715587,3578715626,39
0,720,7880,3578715587,3578715627,40
0,720,7881,3578715587,3578715631,44
0,720,7882,3578715587,3578715631,44
0,720,7883,3578715587,3578715632,45
0,720,7884,3578715587,3578715633,46
0,720,7885,3578715587,3578715634,47
0,720,7886,3578715587,3578715635,48
0,721,7887,3578715642,3578715642,0
0,721,7888,3578715642,3578715642,0
0,721,7889,3578715642,3578715642,0
0,721,7890,3578715642,3578715649,7
0,721,7891,3578715642,3578715649,7
0,721,7892,3578715642,3578715651,9
0,721,7893,3578715642,3578715652,10
0,721,7894,3578715642,3578715655,13
0,721,7895,3578715642,3578715656,14
0,721,7896,3578715642,3578715658,16
0,721,7897,3578715642,3578715659,17
0,721,7898,3578715642,3578715662,20
0,721,7899,3578715642,3578715662,20
0,721,7900,3578715642,3578715664,22
0,721,7901,3578715642,3578715666,24
0,721,7902,3578715642,3578715666,24
0,721,7903,3578715642,3578715666,24
0,721,7904,3578715642,3578715669,27
0,721,7905,3578715642,3578715669,27
0,721,7906,3578715642,3578715676,34
0,721,7907,3578715642,3578715676,34
0,721,7908,3578715642,3578715677,35
0,721,7909,3578715642,3578715681,39
0,721,7910,3578715642,3578715688,46
0,721,7911,3578715642,3578715688,46
0,721,7912,3578715642,3578715689,47
0,721,7913,3578715642,3578715689,47
0,721,7914,3578715642,3578715690,48
0,721,7915,3578715642,3578715690,48
0,722,7916,3578715696,3578715696,0
0,722,7917,3578715696,3578715696,0
0,722,7918,3578715696,3578715696,0
0,722,7919,3578715696,3578715698,2
0,722,7920,3578715696,3578715699,3
0,722,7921,3578715696,3578715701,5
0,722,7922,3578715696,3578715702,6
0,722,7923,3578715696,3578715703,7
0,722,7924,3578715696,3578715704,8
0,722,7925,3578715696,3578715705,9
0,722,7926,3578715696,3578715710,14
0,722,7927,3578715696,3578715711,15
0,722,7928,3578715696,3578715711,15
0,722,7929,3578715696,3578715715,19
0,722,7930,3578715696,3578715715,19
0,722,7931,3578715696,3578715715,19
0,722,7932,3578715696,3578715718,22
0,722,7933,3578715696,3578715719,23
0,722,7934,3578715696,3578715720,24
0,722,7935,3578715696,3578715722,26
0,722,7936,3578715696,3578715724,28
0,722,7937,3578715696,3578715725,29
0,722,7938,3578715696,3578715726,30
0,722,7939,3578715696,3578715727,31
0,722,7940,3578715696,3578715730,34
0,722,7941,3578715696,3578715731,35
0,722,7942,3578715696,3578715732,36
0,722,7943,3578715696,3578715732,36
0,722,7944,3578715696,3578715735,39
0,722,7945,3578715696,3578715739,43
0,722,7946,3578715696,3578715739,43
0,722,7947,3578715696,3578715741,45
0,722,7948,3578715696,3578715742,46
0,722,7949,3578715696,3578715743,47
0,722,7950,3578715696,3578715744,48
0,722,7951,3578715696,3578715746,50
0,723,7952,3578715751,3578715751,0
0,723,7953,3578715751,3578715751,0
0,723,7954,3578715751,3578715751,0
0,723,7955,3578715751,3578715754,3
0,723,7956,3578715751,3578715755,4
0,723,7957,3578715751,3578715757,6
0,723,7958,3578715751,3578715758,7
0,723,7959,3578715751,3578715759,8
0,723,7960,3578715751,3578715760,9
0,723,7961,3578715751,3578715761,10
0,723,7962,3578715751,3578715762,11
0,723,7963,3578715751,3578715763,12
0,723,7964,3578715751,3578715764,13
0,723,7965,3578715751,3578715769,18
0,723,7966,3578715751,3578715769,18
0,723,7967,3578715751,3578715770,19
0,723,7968,3578715751,3578715772,21
0,723,7969,3578715751,3578715774,23
0,723,7970,3578715751,3578715775,24
0,723,7971,3578715751,3578715777,26
0,723,7972,3578715751,3578715777,26
0,723,7973,3578715751,3578715778,27
0,723,7974,3578715751,3578715778,27
0,723,7975,3578715751,3578715781,30
0,723,7976,3578715751,3578715782,31
0,723,7977,3578715751,3578715785,34
0,723,7978,3578715751,3578715785,34
0,723,7979,3578715751,3578715786,35
0,723,7980,3578715751,3578715787,36
0,723,7981,3578715751,3578715788,37
0,723,7982,3578715751,3578715789,38
0,723,7983,3578715751,3578715792,41
0,723,7984,3578715751,3578715794,43
0,723,7985,3578715751,3578715795,44
0,723,7986,3578715751,3578715797,46
0,723,7987,3578715751,3578715800,49
0,723,7988,3578715751,3578715800,49
0,724,7989,3578715805,3578715805,0
0,724,7990,3578715805,3578715805,0
0,724,7991,3578715805,3578715805,0
0,724,7992,3578715805,3578715806,1
0,724,7993,3578715805,3578715809,4
0,724,7994,3578715805,3578715812,7
0,724,7995,3578715805,3578715812,7
0,724,7996,3578715805,3578715815,10
0,724,7997,3578715805,3578715815,10
0,724,7998,3578715805,3578715815,10
0,724,7999,3578715805,3578715818,13
0,724,8000,3578715805,3578715818,13
0,724,8001,3578715805,3578715822,17
0,724,8002,3578715805,3578715824,19
0,724,8003,3578715805,3578715824,19
0,724,8004,3578715805,3578715827,22
0,724,8005,3578715805,3578715828,23
0,724,8006,3578715805,3578715831,26
0,724,8007,3578715805,3578715831,26
0,724,8008,3578715805,3578715832,27
0,724,8009,3578715805,3578715833,28
0,724,8010,3578715805,3578715836,31
0,724,8011,3578715805,3578715839,34
0,724,8012,3578715805,3578715839,34
0,724,8013,3578715805,3578715839,34
0,724,8014,3578715805,3578715849,44
0,724,8015,3578715805,3578715849,44
0,724,8016,3578715805,3578715851,46
0,724,8017,3578715805,3578715852,47
0,724,8018,3578715805,3578715854,49
0,725,8019,3578715859,3578715859,0
0,725,8020,3578715859,3578715859,0
0,725,8021,3578715859,3578715859,0
0,725,8022,3578715859,3578715862,3
0,725,8023,3578715859,3578715862,3
0,725,8024,3578715859,3578715864,5
0,725,8025,3578715859,3578715866,7
0,725,8026,3578715859,3578715866,7
0,725,8027,3578715859,3578715867,8
0,725,8028,3578715859,3578715869,10
0,725,8029,3578715859,3578715870,11
0,725,8030,3578715859,3578715876,17
0,725,8031,3578715859,3578715876,17
0,725,8032,3578715859,3578715878,19
0,725,8033,3578715859,3578715882,23
0,725,8034,3578715859,3578715887,28
0,725,8035,3578715859,3578715889,30
0,725,8036,3578715859,3578715889,30
0,725,8037,3578715859,3578715890,31
0,725,8038,3578715859,3578715891,32
0,725,8039,3578715859,3578715891,32
0,725,8040,3578715859,3578715894,35
0,725,8041,3578715859,3578715895,36
0,725,8042,3578715859,3578715896,37
0,725,8043,3578715859,3578715898,39
0,725,8044,3578715859,3578715899,40
0,725,8045,3578715859,3578715902,43
0,725,8046,3578715859,3578715902,43
0,725,8047,3578715859,3578715902,43
0,725,8048,3578715859,3578715904,45
0,725,8049,3578715859,3578715904,45
0,725,8050,3578715859,3578715905,46
0,726,8051,3578715913,3578715913,0
0,726,8052,3578715913,3578715913,0
0,726,8053,3578715913,3578715913,0
0,726,8054,3578715913,3578715914,1
0,726,8055,3578715913,3578715914,1
0,726,8056,3578715913,3578715915,2
0,726,8057,3578715913,3578715918,5
0,726,8058,3578715913,3578715919,6
0,726,8059,3578715913,3578715920,7
0,726,8060,3578715913,3578715924,11
0,726,8061,3578715913,3578715925,12
0,726,8062,3578715913,3578715926,13
0,726,8063,3578715913,3578715926,13
0,726,8064,3578715913,3578715929,16
0,726,8065,3578715913,3578715931,18
0,726,8066,3578715913,3578715931,18
0,726,8067,3578715913,3578715932,19
0,726,8068,3578715913,3578715933,20
0,726,8069,3578715913,3578715935,22
0,726,8070,3578715913,3578715939,26
0,726,8071,3578715913,3578715939,26
0,726,8072,3578715913,3578715940,27
0,726,8073,3578715913,3578715943,30
0,726,8074,3578715913,3578715945,32
0,726,8075,3578715913,3578715946,33
0,726,8076,3578715913,3578715948,35
0,726,8077,3578715913,3578715950,37
0,726,8078,3578715913,3578715952,39
0,726,8079,3578715913,3578715954,41
0,726,8080,3578715913,3578715955,42
0,726,8081,3578715913,3578715957,44
0,726,8082,3578715913,3578715959,46
0,726,8083,3578715913,3578715960,47
0,726,8084,3578715913,3578715961,48
0,726,8085,3578715913,3578715961,48
0,727,8086,3578715967,3578715967,0
0,727,8087,3578715967,3578715967,0
0,727,8088,3578715967,3578715969,2
0,727,8089,3578715967,3578715970,3
0,727,8090,3578715967,3578715970,3
0,727,8091,3578715967,3578715973,6
0,727,8092,3578715967,3578715973,6
0,727,8093,3578715967,3578715974,7
0,727,8094,3578715967,3578715977,10
0,727,8095,3578715967,3578715977,10
0,727,8096,3578715967,3578715978,11
0,727,8097,3578715967,3578715979,12
0,727,8098,3578715967,3578715979,12
0,727,8099,3578715967,3578715980,13
0,727,8100,3578715967,3578715981,14
0,727,8101,3578715967,3578715982,15
0,727,8102,3578715967,3578715985,18
0,727,8103,3578715967,3578715985,18
0,727,8104,3578715967,3578715986,19
0,727,8105,3578715967,3578715987,20
0,727,8106,3578715967,3578715988,21
0,727,8107,3578715967,3578715988,21
0,727,8108,3578715967,3578715992,25
0,727,8109,3578715967,3578715994,27
0,727,8110,3578715967,3578715995,28
0,727,8111,3578715967,3578715996,29
0,727,8112,3578715967,3578716001,34
0,727,8113,3578715967,3578716002,35
0,727,8114,3578715967,3578716003,36
0,727,8115,3578715967,3578716004,37
0,727,8116,3578715967,3578716005,38
0,727,8117,3578715967,3578716006,39
0,727,8118,3578715967,3578716009,42
0,727,8119,3578715967,3578716012,45
0,727,8120,3578715967,3578716014,47
0,727,8121,3578715967,3578716015,48
0,727,8122,3578715967,3578716015,48
0,727,8123,3578715967,3578716016,49
0,728,8124,3578716021,3578716021,0
0,728,8125,3578716021,3578716021,0
0,728,8126,3578716021,3578716022,1
0,728,8127,3578716021,3578716024,3
0,728,8128,3578716021,3578716024,3
0,728,8129,3578716021,3578716028,7
0,728,8130,3578716021,3578716031,10
0,728,8131,3578716021,3578716031,10
0,728,8132,3578716021,3578716032,11
0,728,8133,3578716021,3578716033,12
0,728,8134,3578716021,3578716033,12
0,728,8135,3578716021,3578716036,15
0,728,8136,3578716021,3578716039,18
0,728,8137,3578716021,3578716039,18
0,728,8138,3578716021,3578716039,18
0,728,8139,3578716021,3578716048,27
0,728,8140,3578716021,3578716051,30
0,728,8141,3578716021,3578716052,31
0,728,8142,3578716021,3578716054,33
0,728,8143,3578716021,3578716057,36
0,728,8144,3578716021,3578716057,36
0,728,8145,3578716021,3578716059,38
0,728,8146,3578716021,3578716062,41
0,728,8147,3578716021,3578716063,42
0,728,8148,3578716021,3578716064,43
0,728,8149,3578716021,3578716066,45
0,728,8150,3578716021,3578716066,45
0,728,8151,3578716021,3578716067,46
0,728,8152,3578716021,3578716069,48
0,728,8153,3578716021,3578716070,49
0,729,8154,3578716075,3578716076,1
0,729,8155,3578716075,3578716077,2
0,729,8156,3578716075,3578716081,6
0,729,8157,3578716075,3578716081,6
0,729,8158,3578716075,3578716088,13
0,729,8159,3578716075,3578716088,13
0,729,8160,3578716075,3578716089,14
0,729,8161,3578716075,3578716090,15
0,729,8162,3578716075,3578716091,16
0,729,8163,3578716075,3578716092,17
0,729,8164,3578716075,3578716093,18
0,729,8165,3578716075,3578716094,19
0,729,8166,3578716075,3578716094,19
0,729,8167,3578716075,3578716096,21
0,729,8168,3578716075,3578716098,23
0,729,8169,3578716075,3578716099,24
0,729,8170,3578716075,3578716102,27
0,729,8171,3578716075,3578716102,27
0,729,8172,3578716075,3578716102,27
0,729,8173,3578716075,3578716103,28
0,729,8174,3578716075,3578716104,29
0,729,8175,3578716075,3578716105,30
0,729,8176,3578716075,3578716110,35
0,729,8177,3578716075,3578716111,36
0,729,8178,3578716075,3578716111,36
0,729,8179,3578716075,3578716114,39
0,729,8180,3578716075,3578716115,40
0,729,8181,3578716075,3578716116,41
0,729,8182,3578716075,3578716119,44
0,729,8183,3578716075,3578716120,45
0,729,8184,3578716075,3578716120,45
0,729,8185,3578716075,3578716122,47
0,730,8186,3578716128,3578716128,0
0,730,8187,3578716128,3578716128,0
0,730,8188,3578716128,3578716128,0
0,730,8189,3578716128,3578716128,0
0,730,8190,3578716128,3578716129,1
0,730,8191,3578716128,3578716131,3
0,730,8192,3578716128,3578716132,4
0,730,8193,3578716128,3578716132,4
0,730,8194,3578716128,3578716132,4
0,730,8195,3578716128,3578716133,5
0,730,8196,3578716128,3578716135,7
0,730,8197,3578716128,3578716139,11
0,730,8198,3578716128,3578716140,12
0,730,8199,3578716128,3578716140,12
0,730,8200,3578716128,3578716143,15
0,730,8201,3578716128,3578716144,16
0,730,8202,3578716128,3578716145,17
0,730,8203,3578716128,3578716148,20
0,730,8204,3578716128,3578716152,24
0,730,8205,3578716128,3578716152,24
0,730,8206,3578716128,3578716154,26
0,730,8207,3578716128,3578716155,27
0,730,8208,3578716128,3578716157,29
0,730,8209,3578716128,3578716159,31
0,730,8210,3578716128,3578716159,31
0,730,8211,3578716128,3578716161,33
0,730,8212,3578716128,3578716161,33
0,730,8213,3578716128,3578716161,33
0,730,8214,3578716128,3578716164,36
0,730,8215,3578716128,3578716165,37
0,730,8216,3578716128,3578716169,41
0,730,8217,3578716128,3578716170,42
0,730,8218,3578716128,3578716170,42
0,730,8219,3578716128,3578716173,45
0,730,8220,3578716128,3578716174,46
0,730,8221,3578716128,3578716175,47
0,730,8222,3578716128,3578716177,49
0,730,8223,3578716128,3578716177,49
0,731,8224,3578716183,3578716183,0
0,731,8225,3578716183,3578716183,0
0,731,8226,3578716183,3578716183,0
0,731,8227,3578716183,3578716183,0
0,731,8228,3578716183,3578716183,0
0,731,8229,3578716183,3578716183,0
0,731,8230,3578716183,3578716185,2
0,731,8231,3578716183,3578716185,2
0,731,8232,3578716183,3578716187,4
0,731,8233,3578716183,3578716187,4
0,731,8234,3578716183,3578716189,6
0,731,8235,3578716183,3578716192,9
0,731,8236,3578716183,3578716195,12
0,731,8237,3578716183,3578716195,12
0,731,8238,3578716183,3578716197,14
0,731,8239,3578716183,3578716201,18
0,731,8240,3578716183,3578716202,19
0,731,8241,3578716183,3578716202,19
0,731,8242,3578716183,3578716205,22
0,731,8243,3578716183,3578716205,22
0,731,8244,3578716183,3578716205,22
0,731,8245,3578716183,3578716210,27
0,731,8246,3578716183,3578716212,29
0,731,8247,3578716183,3578716213,30
0,731,8248,3578716183,3578716215,32
0,731,8249,3578716183,3578716216,33
0,731,8250,3578716183,3578716216,33
0,731,8251,3578716183,3578716217,34
0,731,8252,3578716183,3578716218,35
0,731,8253,3578716183,3578716218,35
0,731,8254,3578716183,3578716222,39
0,731,8255,3578716183,3578716223,40
0,731,8256,3578716183,3578716224,41
0,731,8257,3578716183,3578716228,45
0,731,8258,3578716183,3578716230,47
0,731,8259,3578716183,3578716231,48
0,731,8260,3578716183,3578716232,49
0,731,8261,3578716183,3578716233,50
0,732,8262,3578716238,3578716238,0
0,732,8263,3578716238,3578716238,0
0,732,8264,3578716238,3578716238,0
0,732,8265,3578716238,3578716239,1
0,732,8266,3578716238,3578716239,1
0,732,8267,3578716238,3578716240,2
0,732,8268,3578716238,3578716245,7
0,732,8269,3578716238,3578716249,11
0,732,8270,3578716238,3578716249,11
0,732,8271,3578716238,3578716251,13
0,732,8272,3578716238,3578716253,15
0,732,8273,3578716238,3578716255,17
0,732,8274,3578716238,3578716257,19
0,732,8275,3578716238,3578716258,20
0,732,8276,3578716238,3578716259,21
0,732,8277,3578716238,3578716262,24
0,732,8278,3578716238,3578716262,24
0,732,8279,3578716238,3578716265,27
0,732,8280,3578716238,3578716266,28
0,732,8281,3578716238,3578716266,28
0,732,8282,3578716238,3578716269,31
0,732,8283,3578716238,3578716269,31
0,732,8284,3578716238,3578716276,38
0,732,8285,3578716238,3578716276,38
0,732,8286,3578716238,3578716281,43
0,732,8287,3578716238,3578716284,46
0,732,8288,3578716238,3578716288,50
0,733,8289,3578716293,3578716293,0
0,733,8290,3578716293,3578716293,0
0,733,8291,3578716293,3578716293,0
0,733,8292,3578716293,3578716293,0
0,733,8293,3578716293,3578716293,0
0,733,8294,3578716293,3578716293,0
0,733,8295,3578716293,3578716294,1
0,733,8296,3578716293,3578716295,2
0,733,8297,3578716293,3578716296,3
0,733,8298,3578716293,3578716298,5
0,733,8299,3578716293,3578716299,6
0,733,8300,3578716293,3578716302,9
0,733,8301,3578716293,3578716302,9
0,733,8302,3578716293,3578716302,9
0,733,8303,3578716293,3578716304,11
0,733,8304,3578716293,3578716304,11
0,733,8305,3578716293,3578716306,13
0,733,8306,3578716293,3578716310,17
0,733,8307,3578716293,3578716311,18
0,733,8308,3578716293,3578716311,18
0,733,8309,3578716293,3578716316,23
0,733,8310,3578716293,3578716316,23
0,733,8311,3578716293,3578716319,26
0,733,8312,3578716293,3578716319,26
0,733,8313,3578716293,3578716319,26
0,733,8314,3578716293,3578716322,29
0,733,8315,3578716293,3578716326,33
0,733,8316,3578716293,3578716326,33
0,733,8317,3578716293,3578716327,34
0,733,8318,3578716293,3578716327,34
0,733,8319,3578716293,3578716330,37
0,733,8320,3578716293,3578716332,39
0,733,8321,3578716293,3578716332,39
0,733,8322,3578716293,3578716332,39
0,733,8323,3578716293,3578716332,39
0,733,8324,3578716293,3578716335,42
0,733,8325,3578716293,3578716336,43
0,733,8326,3578716293,3578716340,47
0,733,8327,3578716293,3578716340,47
0,733,8328,3578716293,3578716341,48
0,734,8329,3578716347,3578716347,0
0,734,8330,3578716347,3578716347,0
0,734,8331,3578716347,3578716347,0
0,734,8332,3578716347,3578716347,0
0,734,8333,3578716347,3578716348,1
0,734,8334,3578716347,3578716352,5
0,734,8335,3578716347,3578716353,6
0,734,8336,3578716347,3578716355,8
0,734,8337,3578716347,3578716356,9
0,734,8338,3578716347,3578716357,10
0,734,8339,3578716347,3578716358,11
0,734,8340,3578716347,3578716359,12
0,734,8341,3578716347,3578716361,14
0,734,8342,3578716347,3578716361,14
0,734,8343,3578716347,3578716362,15
0,734,8344,3578716347,3578716363,16
0,734,8345,3578716347,3578716365,18
0,734,8346,3578716347,3578716369,22
0,734,8347,3578716347,3578716370,23
0,734,8348,3578716347,3578716370,23
0,734,8349,3578716347,3578716372,25
0,734,8350,3578716347,3578716373,26
0,734,8351,3578716347,3578716374,27
0,734,8352,3578716347,3578716377,30
0,734,8353,3578716347,3578716377,30
0,734,8354,3578716347,3578716378,31
0,734,8355,3578716347,3578716380,33
0,734,8356,3578716347,3578716381,34
0,734,8357,3578716347,3578716381,34
0,734,8358,3578716347,3578716381,34
0,734,8359,3578716347,3578716383,36
0,734,8360,3578716347,3578716384,37
0,734,8361,3578716347,3578716385,38
0,734,8362,3578716347,3578716385,38
0,734,8363,3578716347,3578716386,39
0,734,8364,3578716347,3578716387,40
0,734,8365,3578716347,3578716387,40
0,734,8366,3578716347,3578716390,43
0,734,8367,3578716347,3578716392,45
0,734,8368,3578716347,3578716395,48
0,734,8369,3578716347,3578716396,49
0,734,8370,3578716347,3578716396,49
0,735,8371,3578716401,3578716401,0
0,735,8372,3578716401,3578716402,1
0,735,8373,3578716401,3578716403,2
0,735,8374,3578716401,3578716405,4
0,735,8375,3578716401,3578716406,5
0,735,8376,3578716401,3578716407,6
0,735,8377,3578716401,3578716410,9
0,735,8378,3578716401,3578716412,11
0,735,8379,3578716401,3578716413,12
0,735,8380,3578716401,3578716415,14
0,735,8381,3578716401,3578716416,15
0,735,8382,3578716401,3578716416,15
0,735,8383,3578716401,3578716418,17
0,735,8384,3578716401,3578716418,17
0,735,8385,3578716401,3578716419,18
0,735,8386,3578716401,3578716422,21
0,735,8387,3578716401,3578716423,22
0,735,8388,3578716401,3578716424,23
0,735,8389,3578716401,3578716429,28
0,735,8390,3578716401,3578716430,29
0,735,8391,3578716401,3578716431,30
0,735,8392,3578716401,3578716433,32
0,735,8393,3578716401,3578716433,32
0,735,8394,3578716401,3578716434,33
0,735,8395,3578716401,3578716434,33
0,735,8396,3578716401,3578716436,35
0,735,8397,3578716401,3578716439,38
0,735,8398,3578716401,3578716440,39
0,735,8399,3578716401,3578716440,39
0,735,8400,3578716401,3578716441,40
0,735,8401,3578716401,3578716445,44
0,735,8402,3578716401,3578716449,48
0,735,8403,3578716401,3578716449,48
0,735,8404,3578716401,3578716450,49
0,736,8405,3578716456,3578716456,0
0,736,8406,3578716456,3578716456,0
0,736,8407,3578716456,3578716458,2
0,736,8408,3578716456,3578716459,3
0,736,8409,3578716456,3578716459,3
0,736,8410,3578716456,3578716462,6
0,736,8411,3578716456,3578716463,7
0,736,8412,3578716456,3578716465,9
0,736,8413,3578716456,3578716466,10
0,736,8414,3578716456,3578716467,11
0,736,8415,3578716456,3578716469,13
0,736,8416,3578716456,3578716470,14
0,736,8417,3578716456,3578716477,21
0,736,8418,3578716456,3578716477,21
0,736,8419,3578716456,3578716482,26
0,736,8420,3578716456,3578716484,28
0,736,8421,3578716456,3578716488,32
0,736,8422,3578716456,3578716489,33
0,736,8423,3578716456,3578716491,35
0,736,8424,3578716456,3578716491,35
0,736,8425,3578716456,3578716491,35
0,736,8426,3578716456,3578716492,36
0,736,8427,3578716456,3578716493,37
0,736,8428,3578716456,3578716494,38
0,736,8429,3578716456,3578716495,39
0,736,8430,3578716456,3578716495,39
0,736,8431,3578716456,3578716496,40
0,736,8432,3578716456,3578716498,42
0,736,8433,3578716456,3578716498,42
0,736,8434,3578716456,3578716502,46
0,736,8435,3578716456,3578716503,47
0,736,8436,3578716456,3578716503,47
0,736,8437,3578716456,3578716504,48
0,736,8438,3578716456,3578716505,49
0,737,8439,3578716513,3578716513,0
0,737,8440,3578716513,3578716513,0
0,737,8441,3578716513,3578716513,0
0,737,8442,3578716513,3578716515,2
0,737,8443,3578716513,3578716516,3
0,737,8444,3578716513,3578716518,5
0,737,8445,3578716513,3578716519,6
0,737,8446,3578716513,3578716524,11
0,737,8447,3578716513,3578716525,12
0,737,8448,3578716513,3578716526,13
0,737,8449,3578716513,3578716526,13
0,737,8450,3578716513,3578716528,15
0,737,8451,3578716513,3578716531,18
0,737,8452,3578716513,3578716531,18
0,737,8453,3578716513,3578716532,19
0,737,8454,3578716513,3578716533,20
0,737,8455,3578716513,3578716535,22
0,737,8456,3578716513,3578716539,26
0,737,8457,3578716513,3578716540,27
0,737,8458,3578716513,3578716540,27
0,737,8459,3578716513,3578716542,29
0,737,8460,3578716513,3578716542,29
0,737,8461,3578716513,3578716543,30
0,737,8462,3578716513,3578716544,31
0,737,8463,3578716513,3578716545,32
0,737,8464,3578716513,3578716547,34
0,737,8465,3578716513,3578716551,38
0,737,8466,3578716513,3578716552,39
0,737,8467,3578716513,3578716554,41
0,737,8468,3578716513,3578716555,42
0,737,8469,3578716513,3578716556,43
0,737,8470,3578716513,3578716557,44
0,737,8471,3578716513,3578716558,45
0,737,8472,3578716513,3578716559,46
0,737,8473,3578716513,3578716561,48
0,737,8474,3578716513,3578716561,48
0,737,8475,3578716513,3578716562,49
0,738,8476,3578716567,3578716567,0
0,738,8477,3578716567,3578716568,1
0,738,8478,3578716567,3578716569,2
0,738,8479,3578716567,3578716570,3
0,738,8480,3578716567,3578716571,4
0,738,8481,3578716567,3578716572,5
0,738,8482,3578716567,3578716573,6
0,738,8483,3578716567,3578716576,9
0,738,8484,3578716567,3578716576,9
0,738,8485,3578716567,3578716578,11
0,738,8486,3578716567,3578716579,12
0,738,8487,3578716567,3578716579,12
0,738,8488,3578716567,3578716580,13
0,738,8489,3578716567,3578716580,13
0,738,8490,3578716567,3578716581,14
0,738,8491,3578716567,3578716582,15
0,738,8492,3578716567,3578716584,17
0,738,8493,3578716567,3578716585,18
0,738,8494,3578716567,3578716586,19
0,738,8495,3578716567,3578716586,19
0,738,8496,3578716567,3578716587,20
0,738,8497,3578716567,3578716589,22
0,738,8498,3578716567,3578716592,25
0,738,8499,3578716567,3578716594,27
0,738,8500,3578716567,3578716594,27
0,738,8501,3578716567,3578716596,29
0,738,8502,3578716567,3578716596,29
0,738,8503,3578716567,3578716600,33
0,738,8504,3578716567,3578716601,34
0,738,8505,3578716567,3578716602,35
0,738,8506,3578716567,3578716604,37
0,738,8507,3578716567,3578716605,38
0,738,8508,3578716567,3578716606,39
0,738,8509,3578716567,3578716610,43
0,738,8510,3578716567,3578716611,44
0,738,8511,3578716567,3578716612,45
0,738,8512,3578716567,3578716614,47
0,738,8513,3578716567,3578716614,47
0,738,8514,3578716567,3578716615,48
0,738,8515,3578716567,3578716616,49
0,739,8516,3578716621,3578716621,0
0,739,8517,3578716621,3578716622,1
0,739,8518,3578716621,3578716622,1
0,739,8519,3578716621,3578716628,7
0,739,8520,3578716621,3578716630,9
0,739,8521,3578716621,3578716631,10
0,739,8522,3578716621,3578716632,11
0,739,8523,3578716621,3578716633,12
0,739,8524,3578716621,3578716633,12
0,739,8525,3578716621,3578716634,13
0,739,8526,3578716621,3578716638,17
0,739,8527,3578716621,3578716639,18
0,739,8528,3578716621,3578716639,18
0,739,8529,3578716621,3578716645,24
0,739,8530,3578716621,3578716645,24
0,739,8531,3578716621,3578716648,27
0,739,8532,3578716621,3578716649,28
0,739,8533,3578716621,3578716650,29
0,739,8534,3578716621,3578716653,32
0,739,8535,3578716621,3578716655,34
0,739,8536,3578716621,3578716657,36
0,739,8537,3578716621,3578716658,37
0,739,8538,3578716621,3578716659,38
0,739,8539,3578716621,3578716661,40
0,739,8540,3578716621,3578716662,41
0,739,8541,3578716621,3578716664,43
0,739,8542,3578716621,3578716665,44
0,739,8543,3578716621,3578716666,45
0,739,8544,3578716621,3578716666,45
0,739,8545,3578716621,3578716669,48
0,739,8546,3578716621,3578716669,48
0,740,8547,3578716675,3578716677,2
0,740,8548,3578716675,3578716677,2
0,740,8549,3578716675,3578716682,7
0,740,8550,3578716675,3578716685,10
0,740,8551,3578716675,3578716688,13
0,740,8552,3578716675,3578716689,14
0,740,8553,3578716675,3578716690,15
0,740,8554,3578716675,3578716691,16
0,740,8555,3578716675,3578716692,17
0,740,8556,3578716675,3578716694,19
0,740,8557,3578716675,3578716694,19
0,740,8558,3578716675,3578716695,20
0,740,8559,3578716675,3578716696,21
0,740,8560,3578716675,3578716696,21
0,740,8561,3578716675,3578716698,23
0,740,8562,3578716675,3578716698,23
0,740,8563,3578716675,3578716702,27
0,740,8564,3578716675,3578716703,28
0,740,8565,3578716675,3578716703,28
0,740,8566,3578716675,3578716705,30
0,740,8567,3578716675,3578716710,35
0,740,8568,3578716675,3578716711,36
0,740,8569,3578716675,3578716711,36
0,740,8570,3578716675,3578716713,38
0,740,8571,3578716675,3578716715,40
0,740,8572,3578716675,3578716715,40
0,740,8573,3578716675,3578716718,43
0,740,8574,3578716675,3578716721,46
0,740,8575,3578716675,3578716724,49
0,740,8576,3578716675,3578716725,50
0,741,8577,3578716729,3578716729,0
0,741,8578,3578716729,3578716729,0
0,741,8579,3578716729,3578716729,0
0,741,8580,3578716729,3578716731,2
0,741,8581,3578716729,3578716731,2
0,741,8582,3578716729,3578716731,2
0,741,8583,3578716729,3578716732,3
0,741,8584,3578716729,3578716734,5
0,741,8585,3578716729,3578716735,6
0,741,8586,3578716729,3578716739,10
0,741,8587,3578716729,3578716740,11
0,741,8588,3578716729,3578716740,11
0,741,8589,3578716729,3578716742,13
0,741,8590,3578716729,3578716742,13
0,741,8591,3578716729,3578716744,15
0,741,8592,3578716729,3578716745,16
0,741,8593,3578716729,3578716746,17
0,741,8594,3578716729,3578716747,18
0,741,8595,3578716729,3578716751,22
0,741,8596,3578716729,3578716752,23
0,741,8597,3578716729,3578716754,25
0,741,8598,3578716729,3578716755,26
0,741,8599,3578716729,3578716756,27
0,741,8600,3578716729,3578716758,29
0,741,8601,3578716729,3578716759,30
0,741,8602,3578716729,3578716760,31
0,741,8603,3578716729,3578716760,31
0,741,8604,3578716729,3578716761,32
0,741,8605,3578716729,3578716764,35
0,741,8606,3578716729,3578716764,35
0,741,8607,3578716729,3578716768,39
0,741,8608,3578716729,3578716769,40
0,741,8609,3578716729,3578716770,41
0,741,8610,3578716729,3578716772,43
0,741,8611,3578716729,3578716773,44
0,741,8612,3578716729,3578716774,45
0,741,8613,3578716729,3578716776,47
0,741,8614,3578716729,3578716777,48
0,741,8615,3578716729,3578716779,50
0,742,8616,3578716783,3578716783,0
0,742,8617,3578716783,3578716783,0
0,742,8618,3578716783,3578716783,0
0,742,8619,3578716783,3578716783,0
0,742,8620,3578716783,3578716783,0
0,742,8621,3578716783,3578716783,0
0,742,8622,3578716783,3578716785,2
0,742,8623,3578716783,3578716785,2
0,742,8624,3578716783,3578716786,3
0,742,8625,3578716783,3578716787,4
0,742,8626,3578716783,3578716787,4
0,742,8627,3578716783,3578716790,7
0,742,8628,3578716783,3578716793,10
0,742,8629,3578716783,3578716794,11
0,742,8630,3578716783,3578716796,13
0,742,8631,3578716783,3578716797,14
0,742,8632,3578716783,3578716797,14
0,742,8633,3578716783,3578716800,17
0,742,8634,3578716783,3578716801,18
0,742,8635,3578716783,3578716803,20
0,742,8636,3578716783,3578716805,22
0,742,8637,3578716783,3578716805,22
0,742,8638,3578716783,3578716805,22
0,742,8639,3578716783,3578716812,29
0,742,8640,3578716783,3578716815,32
0,742,8641,3578716783,3578716815,32
0,742,8642,3578716783,3578716815,32
0,742,8643,3578716783,3578716816,33
0,742,8644,3578716783,3578716819,36
0,742,8645,3578716783,3578716820,37
0,742,8646,3578716783,3578716821,38
0,742,8647,3578716783,3578716823,40
0,742,8648,3578716783,3578716824,41
0,742,8649,3578716783,3578716829,46
0,742,8650,3578716783,3578716829,46
0,742,8651,3578716783,3578716831,48
0,742,8652,3578716783,3578716832,49
0,742,8653,3578716783,3578716833,50
0,743,8654,3578716838,3578716838,0
0,743,8655,3578716838,3578716838,0
0,743,8656,3578716838,3578716839,1
0,743,8657,3578716838,3578716839,1
0,743,8658,3578716838,3578716840,2
0,743,8659,3578716838,3578716844,6
0,743,8660,3578716838,3578716848,10
0,743,8661,3578716838,3578716849,11
0,743,8662,3578716838,3578716850,12
0,743,8663,3578716838,3578716853,15
0,743,8664,3578716838,3578716855,17
0,743,8665,3578716838,3578716856,18
0,743,8666,3578716838,3578716859,21
0,743,8667,3578716838,3578716859,21
0,743,8668,3578716838,3578716862,24
0,743,8669,3578716838,3578716862,24
0,743,8670,3578716838,3578716864,26
0,743,8671,3578716838,3578716865,27
0,743,8672,3578716838,3578716866,28
0,743,8673,3578716838,3578716867,29
0,743,8674,3578716838,3578716869,31
0,743,8675,3578716838,3578716869,31
0,743,8676,3578716838,3578716877,39
0,743,8677,3578716838,3578716877,39
0,743,8678,3578716838,3578716881,43
0,743,8679,3578716838,3578716885,47
0,744,8680,3578716892,3578716892,0
0,744,8681,3578716892,3578716892,0
0,744,8682,3578716892,3578716892,0
0,744,8683,3578716892,3578716892,0
0,744,8684,3578716892,3578716893,1
0,744,8685,3578716892,3578716894,2
0,744,8686,3578716892,3578716894,2
0,744,8687,3578716892,3578716896,4
0,744,8688,3578716892,3578716898,6
0,744,8689,3578716892,3578716899,7
0,744,8690,3578716892,3578716899,7
0,744,8691,3578716892,3578716902,10
0,744,8692,3578716892,3578716902,10
0,744,8693,3578716892,3578716903,11
0,744,8694,3578716892,3578716904,12
0,744,8695,3578716892,3578716905,13
0,744,8696,3578716892,3578716910,18
0,744,8697,3578716892,3578716911,19
0,744,8698,3578716892,3578716912,20
0,744,8699,3578716892,3578716914,22
0,744,8700,3578716892,3578716916,24
0,744,8701,3578716892,3578716919,27
0,744,8702,3578716892,3578716921,29
0,744,8703,3578716892,3578716924,32
0,744,8704,3578716892,3578716925,33
0,744,8705,3578716892,3578716927,35
0,744,8706,3578716892,3578716928,36
0,744,8707,3578716892,3578716928,36
0,744,8708,3578716892,3578716928,36
0,744,8709,3578716892,3578716931,39
0,744,8710,3578716892,3578716931,39
0,744,8711,3578716892,3578716931,39
0,744,8712,3578716892,3578716933,41
0,744,8713,3578716892,3578716934,42
0,744,8714,3578716892,3578716936,44
0,744,8715,3578716892,3578716939,47
0,744,8716,3578716892,3578716939,47
0,744,8717,3578716892,3578716940,48
0,744,8718,3578716892,3578716942,50
0,745,8719,3578716946,3578716946,0
0,745,8720,3578716946,3578716946,0
0,745,8721,3578716946,3578716946,0
0,745,8722,3578716946,3578716947,1
0,745,8723,3578716946,3578716948,2
0,745,8724,3578716946,3578716949,3
0,745,8725,3578716946,3578716951,5
0,745,8726,3578716946,3578716952,6
0,745,8727,3578716946,3578716954,8
0,745,8728,3578716946,3578716955,9
0,745,8729,3578716946,3578716957,11
0,745,8730,3578716946,3578716958,12
0,745,8731,3578716946,3578716961,15
0,745,8732,3578716946,3578716961,15
0,745,8733,3578716946,3578716961,15
0,745,8734,3578716946,3578716964,18
0,745,8735,3578716946,3578716964,18
0,745,8736,3578716946,3578716967,21
0,745,8737,3578716946,3578716969,23
0,745,8738,3578716946,3578716972,26
0,745,8739,3578716946,3578716973,27
0,745,8740,3578716946,3578716976,30
0,745,8741,3578716946,3578716977,31
0,745,8742,3578716946,3578716979,33
0,745,8743,3578716946,3578716979,33
0,745,8744,3578716946,3578716980,34
0,745,8745,3578716946,3578716981,35
0,745,8746,3578716946,3578716982,36
0,745,8747,3578716946,3578716982,36
0,745,8748,3578716946,3578716983,37
0,745,8749,3578716946,3578716984,38
0,745,8750,3578716946,3578716985,39
0,745,8751,3578716946,3578716986,40
0,745,8752,3578716946,3578716987,41
0,745,8753,3578716946,3578716988,42
0,745,8754,3578716946,3578716990,44
0,745,8755,3578716946,3578716993,47
0,745,8756,3578716946,3578716993,47
0,745,8757,3578716946,3578716996,50
0,746,8758,3578717001,3578717001,0
0,746,8759,3578717001,3578717001,0
0,746,8760,3578717001,3578717001,0
0,746,8761,3578717001,3578717004,3
0,746,8762,3578717001,3578717005,4
0,746,8763,3578717001,3578717005,4
0,746,8764,3578717001,3578717006,5
0,746,8765,3578717001,3578717010,9
0,746,8766,3578717001,3578717012,11
0,746,8767,3578717001,3578717013,12
0,746,8768,3578717001,3578717015,14
0,746,8769,3578717001,3578717015,14
0,746,8770,3578717001,3578717016,15
0,746,8771,3578717001,3578717016,15
0,746,8772,3578717001,3578717019,18
0,746,8773,3578717001,3578717020,19
0,746,8774,3578717001,3578717021,20
0,746,8775,3578717001,3578717023,22
0,746,8776,3578717001,3578717024,23
0,746,8777,3578717001,3578717029,28
0,746,8778,3578717001,3578717030,29
0,746,8779,3578717001,3578717031,30
0,746,8780,3578717001,3578717032,31
0,746,8781,3578717001,3578717033,32
0,746,8782,3578717001,3578717034,33
0,746,8783,3578717001,3578717034,33
0,746,8784,3578717001,3578717035,34
0,746,8785,3578717001,3578717039,38
0,746,8786,3578717001,3578717039,38
0,746,8787,3578717001,3578717040,39
0,746,8788,3578717001,3578717044,43
0,746,8789,3578717001,3578717049,48
0,746,8790,3578717001,3578717049,48
0,746,8791,3578717001,3578717049,48
0,746,8792,3578717001,3578717051,50
0,747,8793,3578717056,3578717056,0
0,747,8794,3578717056,3578717056,0
0,747,8795,3578717056,3578717056,0
0,747,8796,3578717056,3578717059,3
0,747,8797,3578717056,3578717059,3
0,747,8798,3578717056,3578717062,6
0,747,8799,3578717056,3578717062,6
0,747,8800,3578717056,3578717064,8
0,747,8801,3578717056,3578717065,9
0,747,8802,3578717056,3578717066,10
0,747,8803,3578717056,3578717067,11
0,747,8804,3578717056,3578717067,11
0,747,8805,3578717056,3578717069,13
0,747,8806,3578717056,3578717069,13
0,747,8807,3578717056,3578717076,20
0,747,8808,3578717056,3578717077,21
0,747,8809,3578717056,3578717081,25
0,747,8810,3578717056,3578717085,29
0,747,8811,3578717056,3578717088,32
0,747,8812,3578717056,3578717090,34
0,747,8813,3578717056,3578717090,34
0,747,8814,3578717056,3578717091,35
0,747,8815,3578717056,3578717093,37
0,747,8816,3578717056,3578717094,38
0,747,8817,3578717056,3578717095,39
0,747,8818,3578717056,3578717095,39
0,747,8819,3578717056,3578717096,40
0,747,8820,3578717056,3578717098,42
0,747,8821,3578717056,3578717099,43
0,747,8822,3578717056,3578717101,45
0,747,8823,3578717056,3578717102,46
0,747,8824,3578717056,3578717103,47
0,747,8825,3578717056,3578717104,48
0,747,8826,3578717056,3578717105,49
0,747,8827,3578717056,3578717106,50
0,748,8828,3578717110,3578717110,0
0,748,8829,3578717110,3578717112,2
0,748,8830,3578717110,3578717112,2
0,748,8831,3578717110,3578717116,6
0,748,8832,3578717110,3578717116,6
0,748,8833,3578717110,3578717120,10
0,748,8834,3578717110,3578717122,12
0,748,8835,3578717110,3578717124,14
0,748,8836,3578717110,3578717126,16
0,748,8837,3578717110,3578717127,17
0,748,8838,3578717110,3578717128,18
0,748,8839,3578717110,3578717128,18
0,748,8840,3578717110,3578717129,19
0,748,8841,3578717110,3578717130,20
0,748,8842,3578717110,3578717130,20
0,748,8843,3578717110,3578717131,21
0,748,8844,3578717110,3578717133,23
0,748,8845,3578717110,3578717133,23
0,748,8846,3578717110,3578717135,25
0,748,8847,3578717110,3578717139,29
0,748,8848,3578717110,3578717141,31
0,748,8849,3578717110,3578717141,31
0,748,8850,3578717110,3578717142,32
0,748,8851,3578717110,3578717142,32
0,748,8852,3578717110,3578717144,34
0,748,8853,3578717110,3578717146,36
0,748,8854,3578717110,3578717146,36
0,748,8855,3578717110,3578717148,38
0,748,8856,3578717110,3578717152,42
0,748,8857,3578717110,3578717152,42
0,748,8858,3578717110,3578717153,43
0,748,8859,3578717110,3578717154,44
0,748,8860,3578717110,3578717155,45
0,748,8861,3578717110,3578717157,47
0,748,8862,3578717110,3578717158,48
0,748,8863,3578717110,3578717159,49
0,749,8864,3578717165,3578717165,0
0,749,8865,3578717165,3578717165,0
0,749,8866,3578717165,3578717165,0
0,749,8867,3578717165,3578717165,0
0,749,8868,3578717165,3578717165,0
0,749,8869,3578717165,3578717168,3
0,749,8870,3578717165,3578717169,4
0,749,8871,3578717165,3578717170,5
0,749,8872,3578717165,3578717172,7
0,749,8873,3578717165,3578717173,8
0,749,8874,3578717165,3578717176,11
0,749,8875,3578717165,3578717177,12
0,749,8876,3578717165,3578717179,14
0,749,8877,3578717165,3578717179,14
0,749,8878,3578717165,3578717180,15
0,749,8879,3578717165,3578717181,16
0,749,8880,3578717165,3578717182,17
0,749,8881,3578717165,3578717182,17
0,749,8882,3578717165,3578717183,18
0,749,8883,3578717165,3578717184,19
0,749,8884,3578717165,3578717185,20
0,749,8885,3578717165,3578717186,21
0,749,8886,3578717165,3578717186,21
0,749,8887,3578717165,3578717188,23
0,749,8888,3578717165,3578717190,25
0,749,8889,3578717165,3578717194,29
0,749,8890,3578717165,3578717194,29
0,749,8891,3578717165,3578717196,31
0,749,8892,3578717165,3578717201,36
0,749,8893,3578717165,3578717202,37
0,749,8894,3578717165,3578717203,38
0,749,8895,3578717165,3578717205,40
0,749,8896,3578717165,3578717205,40
0,749,8897,3578717165,3578717205,40
0,749,8898,3578717165,3578717207,42
0,749,8899,3578717165,3578717209,44
0,749,8900,3578717165,3578717212,47
0,749,8901,3578717165,3578717213,48
0,750,8902,3578717221,3578717221,0
0,750,8903,3578717221,3578717221,0
0,750,8904,3578717221,3578717221,0
0,750,8905,3578717221,3578717221,0
0,750,8906,3578717221,3578717221,0
0,750,8907,3578717221,3578717221,0
0,750,8908,3578717221,3578717223,2
0,750,8909,3578717221,3578717224,3
0,750,8910,3578717221,3578717228,7
0,750,8911,3578717221,3578717230,9
0,750,8912,3578717221,3578717231,10
0,750,8913,3578717221,3578717232,11
0,750,8914,3578717221,3578717233,12
0,750,8915,3578717221,3578717234,13
0,750,8916,3578717221,3578717234,13
0,750,8917,3578717221,3578717236,15
0,750,8918,3578717221,3578717239,18
0,750,8919,3578717221,3578717239,18
0,750,8920,3578717221,3578717244,23
0,750,8921,3578717221,3578717249,28
0,750,8922,3578717221,3578717249,28
0,750,8923,3578717221,3578717250,29
0,750,8924,3578717221,3578717250,29
0,750,8925,3578717221,3578717253,32
0,750,8926,3578717221,3578717255,34
0,750,8927,3578717221,3578717256,35
0,750,8928,3578717221,3578717256,35
0,750,8929,3578717221,3578717258,37
0,750,8930,3578717221,3578717259,38
0,750,8931,3578717221,3578717262,41
0,750,8932,3578717221,3578717265,44
0,750,8933,3578717221,3578717266,45
0,750,8934,3578717221,3578717266,45
0,750,8935,3578717221,3578717267,46
0,750,8936,3578717221,3578717268,47
0,750,8937,3578717221,3578717269,48
0,750,8938,3578717221,3578717270,49
0,751,8939,3578717275,3578717277,2
0,751,8940,3578717275,3578717277,2
0,751,8941,3578717275,3578717282,7
0,751,8942,3578717275,3578717285,10
0,751,8943,3578717275,3578717288,13
0,751,8944,3578717275,3578717291,16
0,751,8945,3578717275,3578717291,16
0,751,8946,3578717275,3578717291,16
0,751,8947,3578717275,3578717291,16
0,751,8948,3578717275,3578717292,17
0,751,8949,3578717275,3578717294,19
0,751,8950,3578717275,3578717295,20
0,751,8951,3578717275,3578717295,20
0,751,8952,3578717275,3578717296,21
0,751,8953,3578717275,3578717298,23
0,751,8954,3578717275,3578717298,23
0,751,8955,3578717275,3578717302,27
0,751,8956,3578717275,3578717303,28
0,751,8957,3578717275,3578717304,29
0,751,8958,3578717275,3578717305,30
0,751,8959,3578717275,3578717305,30
0,751,8960,3578717275,3578717305,30
0,751,8961,3578717275,3578717305,30
0,751,8962,3578717275,3578717310,35
0,751,8963,3578717275,3578717312,37
0,751,8964,3578717275,3578717315,40
0,751,8965,3578717275,3578717316,41
0,751,8966,3578717275,3578717319,44
0,751,8967,3578717275,3578717322,47
0,751,8968,3578717275,3578717324,49
0,752,8969,3578717329,3578717329,0
0,752,8970,3578717329,3578717329,0
0,752,8971,3578717329,3578717329,0
0,752,8972,3578717329,3578717329,0
0,752,8973,3578717329,3578717330,1
0,752,8974,3578717329,3578717331,2
0,752,8975,3578717329,3578717333,4
0,752,8976,3578717329,3578717334,5
0,752,8977,3578717329,3578717335,6
0,752,8978,3578717329,3578717340,11
0,752,8979,3578717329,3578717340,11
0,752,8980,3578717329,3578717341,12
0,752,8981,3578717329,3578717343,14
0,752,8982,3578717329,3578717343,14
0,752,8983,3578717329,3578717345,16
0,752,8984,3578717329,3578717345,16
0,752,8985,3578717329,3578717347,18
0,752,8986,3578717329,3578717348,19
0,752,8987,3578717329,3578717351,22
0,752,8988,3578717329,3578717352,23
0,752,8989,3578717329,3578717355,26
0,752,8990,3578717329,3578717356,27
0,752,8991,3578717329,3578717356,27
0,752,8992,3578717329,3578717357,28
0,752,8993,3578717329,3578717358,29
0,752,8994,3578717329,3578717359,30
0,752,8995,3578717329,3578717361,32
0,752,8996,3578717329,3578717362,33
0,752,8997,3578717329,3578717363,34
0,752,8998,3578717329,3578717365,36
0,752,8999,3578717329,3578717369,40
0,752,9000,3578717329,3578717369,40
0,752,9001,3578717329,3578717370,41
0,752,9002,3578717329,3578717372,43
0,752,9003,3578717329,3578717372,43
0,752,9004,3578717329,3578717373,44
0,752,9005,3578717329,3578717376,47
0,752,9006,3578717329,3578717377,48
0,752,9007,3578717329,3578717379,50
0,753,9008,3578717383,3578717383,0
0,753,9009,3578717383,3578717383,0
0,753,9010,3578717383,3578717383,0
0,753,9011,3578717383,3578717383,0
0,753,9012,3578717383,3578717384,1
0,753,9013,3578717383,3578717384,1
0,753,9014,3578717383,3578717385,2
0,753,9015,3578717383,3578717385,2
0,753,9016,3578717383,3578717386,3
0,753,9017,3578717383,3578717387,4
0,753,9018,3578717383,3578717389,6
0,753,9019,3578717383,3578717389,6
0,753,9020,3578717383,3578717393,10
0,753,9021,3578717383,3578717394,11
0,753,9022,3578717383,3578717396,13
0,753,9023,3578717383,3578717401,18
0,753,9024,3578717383,3578717401,18
0,753,9025,3578717383,3578717404,21
0,753,9026,3578717383,3578717405,22
0,753,9027,3578717383,3578717406,23
0,753,9028,3578717383,3578717406,23
0,753,9029,3578717383,3578717411,28
0,753,9030,3578717383,3578717412,29
0,753,9031,3578717383,3578717413,30
0,753,9032,3578717383,3578717415,32
0,753,9033,3578717383,3578717416,33
0,753,9034,3578717383,3578717416,33
0,753,9035,3578717383,3578717416,33
0,753,9036,3578717383,3578717418,35
0,753,9037,3578717383,3578717420,37
0,753,9038,3578717383,3578717422,39
0,753,9039,3578717383,3578717423,40
0,753,9040,3578717383,3578717424,41
0,753,9041,3578717383,3578717429,46
0,753,9042,3578717383,3578717430,47
0,753,9043,3578717383,3578717431,48
0,753,9044,3578717383,3578717432,49
0,753,9045,3578717383,3578717433,50
0,754,9046,3578717437,3578717437,0
0,754,9047,3578717437,3578717437,0
0,754,9048,3578717437,3578717437,0
0,754,9049,3578717437,3578717439,2
0,754,9050,3578717437,3578717440,3
0,754,9051,3578717437,3578717444,7
0,754,9052,3578717437,3578717448,11
0,754,9053,3578717437,3578717450,13
0,754,9054,3578717437,3578717450,13
0,754,9055,3578717437,3578717453,16
0,754,9056,3578717437,3578717456,19
0,754,9057,3578717437,3578717457,20
0,754,9058,3578717437,3578717458,21
0,754,9059,3578717437,3578717458,21
0,754,9060,3578717437,3578717459,22
0,754,9061,3578717437,3578717462,25
0,754,9062,3578717437,3578717466,29
0,754,9063,3578717437,3578717466,29
0,754,9064,3578717437,3578717466,29
0,754,9065,3578717437,3578717467,30
0,754,9066,3578717437,3578717468,31
0,754,9067,3578717437,3578717469,32
0,754,9068,3578717437,3578717469,32
0,754,9069,3578717437,3578717477,40
0,754,9070,3578717437,3578717478,41
0,754,9071,3578717437,3578717481,44
0,754,9072,3578717437,3578717486,49
0,755,9073,3578717491,3578717491,0
0,755,9074,3578717491,3578717491,0
0,755,9075,3578717491,3578717491,0
0,755,9076,3578717491,3578717491,0
0,755,9077,3578717491,3578717491,0
0,755,9078,3578717491,3578717492,1
0,755,9079,3578717491,3578717493,2
0,755,9080,3578717491,3578717494,3
0,755,9081,3578717491,3578717494,3
0,755,9082,3578717491,3578717495,4
0,755,9083,3578717491,3578717496,5
0,755,9084,3578717491,3578717498,7
0,755,9085,3578717491,3578717501,10
0,755,9086,3578717491,3578717501,10
0,755,9087,3578717491,3578717502,11
0,755,9088,3578717491,3578717503,12
0,755,9089,3578717491,3578717504,13
0,755,9090,3578717491,3578717505,14
0,755,9091,3578717491,3578717505,14
0,755,9092,3578717491,3578717508,17
0,755,9093,3578717491,3578717510,19
0,755,9094,3578717491,3578717511,20
0,755,9095,3578717491,3578717511,20
0,755,9096,3578717491,3578717514,23
0,755,9097,3578717491,3578717515,24
0,755,9098,3578717491,3578717515,24
0,755,9099,3578717491,3578717518,27
0,755,9100,3578717491,3578717521,30
0,755,9101,3578717491,3578717523,32
0,755,9102,3578717491,3578717527,36
0,755,9103,3578717491,3578717527,36
0,755,9104,3578717491,3578717527,36
0,755,9105,3578717491,3578717527,36
0,755,9106,3578717491,3578717528,37
0,755,9107,3578717491,3578717530,39
0,755,9108,3578717491,3578717532,41
0,755,9109,3578717491,3578717532,41
0,755,9110,3578717491,3578717534,43
0,755,9111,3578717491,3578717539,48
0,755,9112,3578717491,3578717540,49
0,755,9113,3578717491,3578717540,49
0,755,9114,3578717491,3578717540,49
0,756,9115,3578717545,3578717545,0
0,756,9116,3578717545,3578717545,0
0,756,9117,3578717545,3578717545,0
0,756,9118,3578717545,3578717545,0
0,756,9119,3578717545,3578717546,1
0,756,9120,3578717545,3578717547,2
0,756,9121,3578717545,3578717551,6
0,756,9122,3578717545,3578717552,7
0,756,9123,3578717545,3578717555,10
0,756,9124,3578717545,3578717555,10
0,756,9125,3578717545,3578717557,12
0,756,9126,3578717545,3578717558,13
0,756,9127,3578717545,3578717558,13
0,756,9128,3578717545,3578717558,13
0,756,9129,3578717545,3578717560,15
0,756,9130,3578717545,3578717561,16
0,756,9131,3578717545,3578717563,18
0,756,9132,3578717545,3578717563,18
0,756,9133,3578717545,3578717564,19
0,756,9134,3578717545,3578717568,23
0,756,9135,3578717545,3578717570,25
0,756,9136,3578717545,3578717570,25
0,756,9137,3578717545,3578717571,26
0,756,9138,3578717545,3578717572,27
0,756,9139,3578717545,3578717573,28
0,756,9140,3578717545,3578717575,30
0,756,9141,3578717545,3578717576,31
0,756,9142,3578717545,3578717578,33
0,756,9143,3578717545,3578717579,34
0,756,9144,3578717545,3578717580,35
0,756,9145,3578717545,3578717581,36
0,756,9146,3578717545,3578717581,36
0,756,9147,3578717545,3578717582,37
0,756,9148,3578717545,3578717583,38
0,756,9149,3578717545,3578717584,39
0,756,9150,3578717545,3578717585,40
0,756,9151,3578717545,3578717585,40
0,756,9152,3578717545,3578717586,41
0,756,9153,3578717545,3578717588,43
0,756,9154,3578717545,3578717592,47
0,756,9155,3578717545,3578717593,48
0,756,9156,3578717545,3578717595,50
0,757,9157,3578717600,3578717600,0
0,757,9158,3578717600,3578717600,0
0,757,9159,3578717600,3578717600,0
0,757,9160,3578717600,3578717603,3
0,757,9161,3578717600,3578717605,5
0,757,9162,3578717600,3578717609,9
0,757,9163,3578717600,3578717610,10
0,757,9164,3578717600,3578717611,11
0,757,9165,3578717600,3578717611,11
0,757,9166,3578717600,3578717614,14
0,757,9167,3578717600,3578717614,14
0,757,9168,3578717600,3578717615,15
0,757,9169,3578717600,3578717616,16
0,757,9170,3578717600,3578717617,17
0,757,9171,3578717600,3578717619,19
0,757,9172,3578717600,3578717622,22
0,757,9173,3578717600,3578717622,22
0,757,9174,3578717600,3578717623,23
0,757,9175,3578717600,3578717628,28
0,757,9176,3578717600,3578717629,29
0,757,9177,3578717600,3578717631,31
0,757,9178,3578717600,3578717631,31
0,757,9179,3578717600,3578717633,33
0,757,9180,3578717600,3578717634,34
0,757,9181,3578717600,3578717636,36
0,757,9182,3578717600,3578717638,38
0,757,9183,3578717600,3578717639,39
0,757,9184,3578717600,3578717639,39
0,757,9185,3578717600,3578717644,44
0,757,9186,3578717600,3578717647,47
0,757,9187,3578717600,3578717649,49
0,757,9188,3578717600,3578717649,49
0,757,9189,3578717600,3578717650,50
0,758,9190,3578717654,3578717654,0
0,758,9191,3578717654,3578717655,1
0,758,9192,3578717654,3578717656,2
0,758,9193,3578717654,3578717658,4
0,758,9194,3578717654,3578717659,5
0,758,9195,3578717654,3578717660,6
0,758,9196,3578717654,3578717662,8
0,758,9197,3578717654,3578717662,8
0,758,9198,3578717654,3578717665,11
0,758,9199,3578717654,3578717665,11
0,758,9200,3578717654,3578717665,11
0,758,9201,3578717654,3578717666,12
0,758,9202,3578717654,3578717667,13
0,758,9203,3578717654,3578717669,15
0,758,9204,3578717654,3578717669,15
0,758,9205,3578717654,3578717678,24
0,758,9206,3578717654,3578717678,24
0,758,9207,3578717654,3578717681,27
0,758,9208,3578717654,3578717685,31
0,758,9209,3578717654,3578717690,36
0,758,9210,3578717654,3578717690,36
0,758,9211,3578717654,3578717690,36
0,758,9212,3578717654,3578717691,37
0,758,9213,3578717654,3578717693,39
0,758,9214,3578717654,3578717694,40
0,758,9215,3578717654,3578717694,40
0,758,9216,3578717654,3578717695,41
0,758,9217,3578717654,3578717698,44
0,758,9218,3578717654,3578717698,44
0,758,9219,3578717654,3578717701,47
0,758,9220,3578717654,3578717701,47
0,758,9221,3578717654,3578717702,48
0,758,9222,3578717654,3578717703,49
0,758,9223,3578717654,3578717703,49
0,759,9224,3578717709,3578717709,0
0,759,9225,3578717709,3578717709,0
0,759,9226,3578717709,3578717709,0
0,759,9227,3578717709,3578717710,1
0,759,9228,3578717709,3578717710,1
0,759,9229,3578717709,3578717712,3
0,759,9230,3578717709,3578717712,3
0,759,9231,3578717709,3578717715,6
0,759,9232,3578717709,3578717715,6
0,759,9233,3578717709,3578717715,6
0,759,9234,3578717709,3578717719,10
0,759,9235,3578717709,3578717724,15
0,759,9236,3578717709,3578717727,18
0,759,9237,3578717709,3578717727,18
0,759,9238,3578717709,3578717727,18
0,759,9239,3578717709,3578717727,18
0,759,9240,3578717709,3578717728,19
0,759,9241,3578717709,3578717730,21
0,759,9242,3578717709,3578717730,21
0,759,9243,3578717709,3578717732,23
0,759,9244,3578717709,3578717732,23
0,759,9245,3578717709,3578717735,26
0,759,9246,3578717709,3578717739,30
0,759,9247,3578717709,3578717740,31
0,759,9248,3578717709,3578717740,31
0,759,9249,3578717709,3578717742,33
0,759,9250,3578717709,3578717744,35
0,759,9251,3578717709,3578717745,36
0,759,9252,3578717709,3578717745,36
0,759,9253,3578717709,3578717746,37
0,759,9254,3578717709,3578717748,39
0,759,9255,3578717709,3578717751,42
0,759,9256,3578717709,3578717752,43
0,759,9257,3578717709,3578717755,46
0,759,9258,3578717709,3578717755,46
0,759,9259,3578717709,3578717757,48
0,759,9260,3578717709,3578717758,49
0,760,9261,3578717764,3578717764,0
0,760,9262,3578717764,3578717764,0
0,760,9263,3578717764,3578717764,0
0,760,9264,3578717764,3578717764,0
0,760,9265,3578717764,3578717764,0
0,760,9266,3578717764,3578717764,0
0,760,9267,3578717764,3578717764,0
0,760,9268,3578717764,3578717769,5
0,760,9269,3578717764,3578717770,6
0,760,9270,3578717764,3578717770,6
0,760,9271,3578717764,3578717771,7
0,760,9272,3578717764,3578717773,9
0,760,9273,3578717764,3578717773,9
0,760,9274,3578717764,3578717776,12
0,760,9275,3578717764,3578717776,12
0,760,9276,3578717764,3578717778,14
0,760,9277,3578717764,3578717779,15
0,760,9278,3578717764,3578717780,16
0,760,9279,3578717764,3578717781,17
0,760,9280,3578717764,3578717781,17
0,760,9281,3578717764,3578717783,19
0,760,9282,3578717764,3578717783,19
0,760,9283,3578717764,3578717784,20
0,760,9284,3578717764,3578717785,21
0,760,9285,3578717764,3578717785,21
0,760,9286,3578717764,3578717786,22
0,760,9287,3578717764,3578717788,24
0,760,9288,3578717764,3578717792,28
0,760,9289,3578717764,3578717793,29
0,760,9290,3578717764,3578717795,31
0,760,9291,3578717764,3578717797,33
0,760,9292,3578717764,3578717800,36
0,760,9293,3578717764,3578717801,37
0,760,9294,3578717764,3578717803,39
0,760,9295,3578717764,3578717805,41
0,760,9296,3578717764,3578717806,42
0,760,9297,3578717764,3578717809,45
0,760,9298,3578717764,3578717810,46
0,760,9299,3578717764,3578717811,47
0,760,9300,3578717764,3578717812,48
0,760,9301,3578717764,3578717813,49
0,761,9302,3578717818,3578717818,0
0,761,9303,3578717818,3578717818,0
0,761,9304,3578717818,3578717818,0
0,761,9305,3578717818,3578717818,0
0,761,9306,3578717818,3578717819,1
0,761,9307,3578717818,3578717819,1
0,761,9308,3578717818,3578717823,5
0,761,9309,3578717818,3578717824,6
0,761,9310,3578717818,3578717828,10
0,761,9311,3578717818,3578717829,11
0,761,9312,3578717818,3578717831,13
0,761,9313,3578717818,3578717831,13
0,761,9314,3578717818,3578717833,15
0,761,9315,3578717818,3578717835,17
0,761,9316,3578717818,3578717835,17
0,761,9317,3578717818,3578717835,17
0,761,9318,3578717818,3578717838,20
0,761,9319,3578717818,3578717839,21
0,761,9320,3578717818,3578717840,22
0,761,9321,3578717818,3578717843,25
0,761,9322,3578717818,3578717849,31
0,761,9323,3578717818,3578717849,31
0,761,9324,3578717818,3578717849,31
0,761,9325,3578717818,3578717852,34
0,761,9326,3578717818,3578717855,37
0,761,9327,3578717818,3578717856,38
0,761,9328,3578717818,3578717858,40
0,761,9329,3578717818,3578717862,44
0,761,9330,3578717818,3578717862,44
0,761,9331,3578717818,3578717862,44
0,761,9332,3578717818,3578717865,47
0,761,9333,3578717818,3578717865,47
0,761,9334,3578717818,3578717865,47
0,761,9335,3578717818,3578717866,48
0,761,9336,3578717818,3578717867,49
0,762,9337,3578717873,3578717873,0
0,762,9338,3578717873,3578717873,0
0,762,9339,3578717873,3578717877,4
0,762,9340,3578717873,3578717878,5
0,762,9341,3578717873,3578717885,12
0,762,9342,3578717873,3578717889,16
0,762,9343,3578717873,3578717890,17
0,762,9344,3578717873,3578717891,18
0,762,9345,3578717873,3578717891,18
0,762,9346,3578717873,3578717892,19
0,762,9347,3578717873,3578717894,21
0,762,9348,3578717873,3578717894,21
0,762,9349,3578717873,3578717894,21
0,762,9350,3578717873,3578717894,21
0,762,9351,3578717873,3578717898,25
0,762,9352,3578717873,3578717898,25
0,762,9353,3578717873,3578717901,28
0,762,9354,3578717873,3578717902,29
0,762,9355,3578717873,3578717904,31
0,762,9356,3578717873,3578717905,32
0,762,9357,3578717873,3578717905,32
0,762,9358,3578717873,3578717908,35
0,762,9359,3578717873,3578717910,37
0,762,9360,3578717873,3578717911,38
0,762,9361,3578717873,3578717912,39
0,762,9362,3578717873,3578717913,40
0,762,9363,3578717873,3578717914,41
0,762,9364,3578717873,3578717915,42
0,762,9365,3578717873,3578717915,42
0,762,9366,3578717873,3578717919,46
0,762,9367,3578717873,3578717921,48
0,763,9368,3578717928,3578717928,0
0,763,9369,3578717928,3578717928,0
0,763,9370,3578717928,3578717928,0
0,763,9371,3578717928,3578717928,0
0,763,9372,3578717928,3578717928,0
0,763,9373,3578717928,3578717929,1
0,763,9374,3578717928,3578717930,2
0,763,9375,3578717928,3578717930,2
0,763,9376,3578717928,3578717931,3
0,763,9377,3578717928,3578717932,4
0,763,9378,3578717928,3578717932,4
0,763,9379,3578717928,3578717935,7
0,763,9380,3578717928,3578717940,12
0,763,9381,3578717928,3578717940,12
0,763,9382,3578717928,3578717940,12
0,763,9383,3578717928,3578717942,14
0,763,9384,3578717928,3578717944,16
0,763,9385,3578717928,3578717945,17
0,763,9386,3578717928,3578717945,17
0,763,9387,3578717928,3578717946,18
0,763,9388,3578717928,3578717949,21
0,763,9389,3578717928,3578717951,23
0,763,9390,3578717928,3578717952,24
0,763,9391,3578717928,3578717955,27
0,763,9392,3578717928,3578717955,27
0,763,9393,3578717928,3578717957,29
0,763,9394,3578717928,3578717958,30
0,763,9395,3578717928,3578717959,31
0,763,9396,3578717928,3578717961,33
0,763,9397,3578717928,3578717961,33
0,763,9398,3578717928,3578717963,35
0,763,9399,3578717928,3578717964,36
0,763,9400,3578717928,3578717964,36
0,763,9401,3578717928,3578717966,38
0,763,9402,3578717928,3578717969,41
0,763,9403,3578717928,3578717970,42
0,763,9404,3578717928,3578717970,42
0,763,9405,3578717928,3578717971,43
0,763,9406,3578717928,3578717973,45
0,763,9407,3578717928,3578717973,45
0,763,9408,3578717928,3578717976,48
0,763,9409,3578717928,3578717976,48
0,764,9410,3578717983,3578717983,0
0,764,9411,3578717983,3578717983,0
0,764,9412,3578717983,3578717983,0
0,764,9413,3578717983,3578717983,0
0,764,9414,3578717983,3578717983,0
0,764,9415,3578717983,3578717983,0
0,764,9416,3578717983,3578717984,1
0,764,9417,3578717983,3578717984,1
0,764,9418,3578717983,3578717985,2
0,764,9419,3578717983,3578717986,3
0,764,9420,3578717983,3578717987,4
0,764,9421,3578717983,3578717988,5
0,764,9422,3578717983,3578717988,5
0,764,9423,3578717983,3578717992,9
0,764,9424,3578717983,3578717992,9
0,764,9425,3578717983,3578717995,12
0,764,9426,3578717983,3578717997,14
0,764,9427,3578717983,3578718001,18
0,764,9428,3578717983,3578718002,19
0,764,9429,3578717983,3578718003,20
0,764,9430,3578717983,3578718005,22
0,764,9431,3578717983,3578718006,23
0,764,9432,3578717983,3578718006,23
0,764,9433,3578717983,3578718009,26
0,764,9434,3578717983,3578718010,27
0,764,9435,3578717983,3578718012,29
0,764,9436,3578717983,3578718014,31
0,764,9437,3578717983,3578718015,32
0,764,9438,3578717983,3578718015,32
0,764,9439,3578717983,3578718016,33
0,764,9440,3578717983,3578718018,35
0,764,9441,3578717983,3578718018,35
0,764,9442,3578717983,3578718022,39
0,764,9443,3578717983,3578718024,41
0,764,9444,3578717983,3578718024,41
0,764,9445,3578717983,3578718028,45
0,764,9446,3578717983,3578718030,47
0,764,9447,3578717983,3578718031,48
0,764,9448,3578717983,3578718031,48
0,765,9449,3578718037,3578718037,0
0,765,9450,3578718037,3578718037,0
0,765,9451,3578718037,3578718037,0
0,765,9452,3578718037,3578718038,1
0,765,9453,3578718037,3578718039,2
0,765,9454,3578718037,3578718040,3
0,765,9455,3578718037,3578718043,6
0,765,9456,3578718037,3578718049,12
0,765,9457,3578718037,3578718050,13
0,765,9458,3578718037,3578718050,13
0,765,9459,3578718037,3578718050,13
0,765,9460,3578718037,3578718053,16
0,765,9461,3578718037,3578718054,17
0,765,9462,3578718037,3578718057,20
0,765,9463,3578718037,3578718058,21
0,765,9464,3578718037,3578718062,25
0,765,9465,3578718037,3578718062,25
0,765,9466,3578718037,3578718065,28
0,765,9467,3578718037,3578718065,28
0,765,9468,3578718037,3578718065,28
0,765,9469,3578718037,3578718065,28
0,765,9470,3578718037,3578718066,29
0,765,9471,3578718037,3578718067,30
0,765,9472,3578718037,3578718069,32
0,765,9473,3578718037,3578718069,32
0,765,9474,3578718037,3578718077,40
0,765,9475,3578718037,3578718079,42
0,765,9476,3578718037,3578718082,45
0,765,9477,3578718037,3578718085,48
0,766,9478,3578718091,3578718091,0
0,766,9479,3578718091,3578718091,0
0,766,9480,3578718091,3578718091,0
0,766,9481,3578718091,3578718091,0
0,766,9482,3578718091,3578718093,2
0,766,9483,3578718091,3578718094,3
0,766,9484,3578718091,3578718094,3
0,766,9485,3578718091,3578718095,4
0,766,9486,3578718091,3578718098,7
0,766,9487,3578718091,3578718098,7
0,766,9488,3578718091,3578718102,11
0,766,9489,3578718091,3578718102,11
0,766,9490,3578718091,3578718104,13
0,766,9491,3578718091,3578718104,13
0,766,9492,3578718091,3578718105,14
0,766,9493,3578718091,3578718108,17
0,766,9494,3578718091,3578718109,18
0,766,9495,3578718091,3578718112,21
0,766,9496,3578718091,3578718112,21
0,766,9497,3578718091,3578718115,24
0,766,9498,3578718091,3578718115,24
0,766,9499,3578718091,3578718116,25
0,766,9500,3578718091,3578718116,25
0,766,9501,3578718091,3578718120,29
0,766,9502,3578718091,3578718121,30
0,766,9503,3578718091,3578718124,33
0,766,9504,3578718091,3578718127,36
0,766,9505,3578718091,3578718127,36
0,766,9506,3578718091,3578718127,36
0,766,9507,3578718091,3578718129,38
0,766,9508,3578718091,3578718129,38
0,766,9509,3578718091,3578718130,39
0,766,9510,3578718091,3578718132,41
0,766,9511,3578718091,3578718132,41
0,766,9512,3578718091,3578718136,45
0,766,9513,3578718091,3578718140,49
0,766,9514,3578718091,3578718140,49
0,766,9515,3578718091,3578718141,50
0,767,9516,3578718145,3578718145,0
0,767,9517,3578718145,3578718145,0
0,767,9518,3578718145,3578718145,0
0,767,9519,3578718145,3578718145,0
0,767,9520,3578718145,3578718145,0
0,767,9521,3578718145,3578718146,1
0,767,9522,3578718145,3578718149,4
0,767,9523,3578718145,3578718151,6
0,767,9524,3578718145,3578718152,7
0,767,9525,3578718145,3578718154,9
0,767,9526,3578718145,3578718155,10
0,767,9527,3578718145,3578718156,11
0,767,9528,3578718145,3578718158,13
0,767,9529,3578718145,3578718159,14
0,767,9530,3578718145,3578718161,16
0,767,9531,3578718145,3578718161,16
0,767,9532,3578718145,3578718163,18
0,767,9533,3578718145,3578718164,19
0,767,9534,3578718145,3578718165,20
0,767,9535,3578718145,3578718167,22
0,767,9536,3578718145,3578718169,24
0,767,9537,3578718145,3578718170,25
0,767,9538,3578718145,3578718170,25
0,767,9539,3578718145,3578718172,27
0,767,9540,3578718145,3578718173,28
0,767,9541,3578718145,3578718174,29
0,767,9542,3578718145,3578718176,31
0,767,9543,3578718145,3578718176,31
0,767,9544,3578718145,3578718179,34
0,767,9545,3578718145,3578718179,34
0,767,9546,3578718145,3578718182,37
0,767,9547,3578718145,3578718182,37
0,767,9548,3578718145,3578718182,37
0,767,9549,3578718145,3578718183,38
0,767,9550,3578718145,3578718184,39
0,767,9551,3578718145,3578718185,40
0,767,9552,3578718145,3578718185,40
0,767,9553,3578718145,3578718186,41
0,767,9554,3578718145,3578718187,42
0,767,9555,3578718145,3578718188,43
0,767,9556,3578718145,3578718189,44
0,767,9557,3578718145,3578718193,48
0,768,9558,3578718199,3578718199,0
0,768,9559,3578718199,3578718199,0
0,768,9560,3578718199,3578718200,1
0,768,9561,3578718199,3578718201,2
0,768,9562,3578718199,3578718201,2
0,768,9563,3578718199,3578718202,3
0,768,9564,3578718199,3578718205,6
0,768,9565,3578718199,3578718205,6
0,768,9566,3578718199,3578718206,7
0,768,9567,3578718199,3578718209,10
0,768,9568,3578718199,3578718212,13
0,768,9569,3578718199,3578718215,16
0,768,9570,3578718199,3578718216,17
0,768,9571,3578718199,3578718216,17
0,768,9572,3578718199,3578718216,17
0,768,9573,3578718199,3578718218,19
0,768,9574,3578718199,3578718218,19
0,768,9575,3578718199,3578718219,20
0,768,9576,3578718199,3578718221,22
0,768,9577,3578718199,3578718223,24
0,768,9578,3578718199,3578718225,26
0,768,9579,3578718199,3578718229,30
0,768,9580,3578718199,3578718230,31
0,768,9581,3578718199,3578718231,32
0,768,9582,3578718199,3578718231,32
0,768,9583,3578718199,3578718234,35
0,768,9584,3578718199,3578718236,37
0,768,9585,3578718199,3578718237,38
0,768,9586,3578718199,3578718239,40
0,768,9587,3578718199,3578718239,40
0,768,9588,3578718199,3578718240,41
0,768,9589,3578718199,3578718244,45
0,768,9590,3578718199,3578718249,50
0,769,9591,3578718254,3578718254,0
0,769,9592,3578718254,3578718254,0
0,769,9593,3578718254,3578718254,0
0,769,9594,3578718254,3578718255,1
0,769,9595,3578718254,3578718255,1
0,769,9596,3578718254,3578718256,2
0,769,9597,3578718254,3578718259,5
0,769,9598,3578718254,3578718262,8
0,769,9599,3578718254,3578718263,9
0,769,9600,3578718254,3578718265,11
0,769,9601,3578718254,3578718265,11
0,769,9602,3578718254,3578718266,12
0,769,9603,3578718254,3578718267,13
0,769,9604,3578718254,3578718267,13
0,769,9605,3578718254,3578718268,14
0,769,9606,3578718254,3578718269,15
0,769,9607,3578718254,3578718269,15
0,769,9608,3578718254,3578718278,24
0,769,9609,3578718254,3578718279,25
0,769,9610,3578718254,3578718286,32
0,769,9611,3578718254,3578718290,36
0,769,9612,3578718254,3578718290,36
0,769,9613,3578718254,3578718290,36
0,769,9614,3578718254,3578718291,37
0,769,9615,3578718254,3578718291,37
0,769,9616,3578718254,3578718294,40
0,769,9617,3578718254,3578718294,40
0,769,9618,3578718254,3578718294,40
0,769,9619,3578718254,3578718295,41
0,769,9620,3578718254,3578718298,44
0,769,9621,3578718254,3578718299,45
0,769,9622,3578718254,3578718302,48
0,769,9623,3578718254,3578718302,48
0,770,9624,3578718309,3578718309,0
0,770,9625,3578718309,3578718309,0
0,770,9626,3578718309,3578718309,0
0,770,9627,3578718309,3578718309,0
0,770,9628,3578718309,3578718310,1
0,770,9629,3578718309,3578718311,2
0,770,9630,3578718309,3578718312,3
0,770,9631,3578718309,3578718315,6
0,770,9632,3578718309,3578718316,7
0,770,9633,3578718309,3578718316,7
0,770,9634,3578718309,3578718319,10
0,770,9635,3578718309,3578718321,12
0,770,9636,3578718309,3578718321,12
0,770,9637,3578718309,3578718325,16
0,770,9638,3578718309,3578718327,18
0,770,9639,3578718309,3578718327,18
0,770,9640,3578718309,3578718327,18
0,770,9641,3578718309,3578718329,20
0,770,9642,3578718309,3578718329,20
0,770,9643,3578718309,3578718330,21
0,770,9644,3578718309,3578718332,23
0,770,9645,3578718309,3578718333,24
0,770,9646,3578718309,3578718334,25
0,770,9647,3578718309,3578718336,27
0,770,9648,3578718309,3578718340,31
0,770,9649,3578718309,3578718340,31
0,770,9650,3578718309,3578718341,32
0,770,9651,3578718309,3578718341,32
0,770,9652,3578718309,3578718343,34
0,770,9653,3578718309,3578718344,35
0,770,9654,3578718309,3578718345,36
0,770,9655,3578718309,3578718346,37
0,770,9656,3578718309,3578718346,37
0,770,9657,3578718309,3578718350,41
0,770,9658,3578718309,3578718352,43
0,770,9659,3578718309,3578718353,44
0,770,9660,3578718309,3578718355,46
0,770,9661,3578718309,3578718356,47
0,770,9662,3578718309,3578718356,47
0,770,9663,3578718309,3578718358,49
0,770,9664,3578718309,3578718359,50
0,771,9665,3578718363,3578718363,0
0,771,9666,3578718363,3578718363,0
0,771,9667,3578718363,3578718363,0
0,771,9668,3578718363,3578718365,2
0,771,9669,3578718363,3578718365,2
0,771,9670,3578718363,3578718369,6
0,771,9671,3578718363,3578718370,7
0,771,9672,3578718363,3578718370,7
0,771,9673,3578718363,3578718370,7
0,771,9674,3578718363,3578718372,9
0,771,9675,3578718363,3578718373,10
0,771,9676,3578718363,3578718376,13
0,771,9677,3578718363,3578718376,13
0,771,9678,3578718363,3578718379,16
0,771,9679,3578718363,3578718379,16
0,771,9680,3578718363,3578718381,18
0,771,9681,3578718363,3578718382,19
0,771,9682,3578718363,3578718383,20
0,771,9683,3578718363,3578718385,22
0,771,9684,3578718363,3578718385,22
0,771,9685,3578718363,3578718385,22
0,771,9686,3578718363,3578718386,23
0,771,9687,3578718363,3578718387,24
0,771,9688,3578718363,3578718389,26
0,771,9689,3578718363,3578718390,27
0,771,9690,3578718363,3578718394,31
0,771,9691,3578718363,3578718398,35
0,771,9692,3578718363,3578718401,38
0,771,9693,3578718363,3578718401,38
0,771,9694,3578718363,3578718402,39
0,771,9695,3578718363,3578718403,40
0,771,9696,3578718363,3578718405,42
0,771,9697,3578718363,3578718406,43
0,771,9698,3578718363,3578718407,44
0,771,9699,3578718363,3578718409,46
0,771,9700,3578718363,3578718411,48
0,771,9701,3578718363,3578718412,49
0,771,9702,3578718363,3578718412,49
0,772,9703,3578718418,3578718418,0
0,772,9704,3578718418,3578718418,0
0,772,9705,3578718418,3578718418,0
0,772,9706,3578718418,3578718418,0
0,772,9707,3578718418,3578718418,0
0,772,9708,3578718418,3578718420,2
0,772,9709,3578718418,3578718421,3
0,772,9710,3578718418,3578718422,4
0,772,9711,3578718418,3578718424,6
0,772,9712,3578718418,3578718425,7
0,772,9713,3578718418,3578718428,10
0,772,9714,3578718418,3578718430,12
0,772,9715,3578718418,3578718431,13
0,772,9716,3578718418,3578718431,13
0,772,9717,3578718418,3578718434,16
0,772,9718,3578718418,3578718435,17
0,772,9719,3578718418,3578718436,18
0,772,9720,3578718418,3578718436,18
0,772,9721,3578718418,3578718439,21
0,772,9722,3578718418,3578718440,22
0,772,9723,3578718418,3578718441,23
0,772,9724,3578718418,3578718445,27
0,772,9725,3578718418,3578718449,31
0,772,9726,3578718418,3578718450,32
0,772,9727,3578718418,3578718450,32
0,772,9728,3578718418,3578718452,34
0,772,9729,3578718418,3578718453,35
0,772,9730,3578718418,3578718455,37
0,772,9731,3578718418,3578718455,37
0,772,9732,3578718418,3578718458,40
0,772,9733,3578718418,3578718458,40
0,772,9734,3578718418,3578718460,42
0,772,9735,3578718418,3578718462,44
0,772,9736,3578718418,3578718462,44
0,772,9737,3578718418,3578718465,47
0,772,9738,3578718418,3578718465,47
0,772,9739,3578718418,3578718466,48
0,772,9740,3578718418,3578718467,49
0,772,9741,3578718418,3578718468,50
0,773,9742,3578718473,3578718473,0
0,773,9743,3578718473,3578718473,0
0,773,9744,3578718473,3578718473,0
0,773,9745,3578718473,3578718477,4
0,773,9746,3578718473,3578718478,5
0,773,9747,3578718473,3578718486,13
0,773,9748,3578718473,3578718490,17
0,773,9749,3578718473,3578718490,17
0,773,9750,3578718473,3578718491,18
0,773,9751,3578718473,3578718491,18
0,773,9752,3578718473,3578718491,18
0,773,9753,3578718473,3578718493,20
0,773,9754,3578718473,3578718494,21
0,773,9755,3578718473,3578718495,22
0,773,9756,3578718473,3578718495,22
0,773,9757,3578718473,3578718498,25
0,773,9758,3578718473,3578718499,26
0,773,9759,3578718473,3578718502,29
0,773,9760,3578718473,3578718502,29
0,773,9761,3578718473,3578718502,29
0,773,9762,3578718473,3578718503,30
0,773,9763,3578718473,3578718504,31
0,773,9764,3578718473,3578718505,32
0,773,9765,3578718473,3578718506,33
0,773,9766,3578718473,3578718508,35
0,773,9767,3578718473,3578718510,37
0,773,9768,3578718473,3578718512,39
0,773,9769,3578718473,3578718515,42
0,773,9770,3578718473,3578718516,43
0,773,9771,3578718473,3578718516,43
0,773,9772,3578718473,3578718521,48
0,773,9773,3578718473,3578718521,48
0,773,9774,3578718473,3578718522,49
0,774,9775,3578718528,3578718528,0
0,774,9776,3578718528,3578718528,0
0,774,9777,3578718528,3578718528,0
0,774,9778,3578718528,3578718528,0
0,774,9779,3578718528,3578718528,0
0,774,9780,3578718528,3578718530,2
0,774,9781,3578718528,3578718531,3
0,774,9782,3578718528,3578718532,4
0,774,9783,3578718528,3578718532,4
0,774,9784,3578718528,3578718535,7
0,774,9785,3578718528,3578718539,11
0,774,9786,3578718528,3578718539,11
0,774,9787,3578718528,3578718539,11
0,774,9788,3578718528,3578718540,12
0,774,9789,3578718528,3578718542,14
0,774,9790,3578718528,3578718543,15
0,774,9791,3578718528,3578718544,16
0,774,9792,3578718528,3578718544,16
0,774,9793,3578718528,3578718544,16
0,774,9794,3578718528,3578718548,20
0,774,9795,3578718528,3578718551,23
0,774,9796,3578718528,3578718551,23
0,774,9797,3578718528,3578718554,26
0,774,9798,3578718528,3578718555,27
0,774,9799,3578718528,3578718557,29
0,774,9800,3578718528,3578718558,30
0,774,9801,3578718528,3578718558,30
0,774,9802,3578718528,3578718560,32
0,774,9803,3578718528,3578718560,32
0,774,9804,3578718528,3578718563,35
0,774,9805,3578718528,3578718563,35
0,774,9806,3578718528,3578718564,36
0,774,9807,3578718528,3578718568,40
0,774,9808,3578718528,3578718570,42
0,774,9809,3578718528,3578718570,42
0,774,9810,3578718528,3578718571,43
0,774,9811,3578718528,3578718573,45
0,774,9812,3578718528,3578718573,45
0,774,9813,3578718528,3578718575,47
0,774,9814,3578718528,3578718575,47
0,774,9815,3578718528,3578718578,50
0,775,9816,3578718584,3578718584,0
0,775,9817,3578718584,3578718584,0
0,775,9818,3578718584,3578718584,0
0,775,9819,3578718584,3578718584,0
0,775,9820,3578718584,3578718584,0
0,775,9821,3578718584,3578718584,0
0,775,9822,3578718584,3578718584,0
0,775,9823,3578718584,3578718585,1
0,775,9824,3578718584,3578718585,1
0,775,9825,3578718584,3578718586,2
0,775,9826,3578718584,3578718587,3
0,775,9827,3578718584,3578718588,4
0,775,9828,3578718584,3578718593,9
0,775,9829,3578718584,3578718596,12
0,775,9830,3578718584,3578718596,12
0,775,9831,3578718584,3578718600,16
0,775,9832,3578718584,3578718600,16
0,775,9833,3578718584,3578718602,18
0,775,9834,3578718584,3578718604,20
0,775,9835,3578718584,3578718605,21
0,775,9836,3578718584,3578718606,22
0,775,9837,3578718584,3578718608,24
0,775,9838,3578718584,3578718610,26
0,775,9839,3578718584,3578718611,27
0,775,9840,3578718584,3578718611,27
0,775,9841,3578718584,3578718614,30
0,775,9842,3578718584,3578718614,30
0,775,9843,3578718584,3578718615,31
0,775,9844,3578718584,3578718615,31
0,775,9845,3578718584,3578718617,33
0,775,9846,3578718584,3578718619,35
0,775,9847,3578718584,3578718621,37
0,775,9848,3578718584,3578718623,39
0,775,9849,3578718584,3578718623,39
0,775,9850,3578718584,3578718624,40
0,775,9851,3578718584,3578718628,44
0,775,9852,3578718584,3578718629,45
0,775,9853,3578718584,3578718631,47
0,775,9854,3578718584,3578718631,47
0,775,9855,3578718584,3578718634,50
0,776,9856,3578718638,3578718638,0
0,776,9857,3578718638,3578718638,0
0,776,9858,3578718638,3578718638,0
0,776,9859,3578718638,3578718640,2
0,776,9860,3578718638,3578718644,6
0,776,9861,3578718638,3578718649,11
0,776,9862,3578718638,3578718649,11
0,776,9863,3578718638,3578718650,12
0,776,9864,3578718638,3578718652,14
0,776,9865,3578718638,3578718654,16
0,776,9866,3578718638,3578718654,16
0,776,9867,3578718638,3578718657,19
0,776,9868,3578718638,3578718657,19
0,776,9869,3578718638,3578718661,23
0,776,9870,3578718638,3578718662,24
0,776,9871,3578718638,3578718664,26
0,776,9872,3578718638,3578718665,27
0,776,9873,3578718638,3578718665,27
0,776,9874,3578718638,3578718666,28
0,776,9875,3578718638,3578718667,29
0,776,9876,3578718638,3578718669,31
0,776,9877,3578718638,3578718670,32
0,776,9878,3578718638,3578718677,39
0,776,9879,3578718638,3578718678,40
0,776,9880,3578718638,3578718679,41
0,776,9881,3578718638,3578718685,47
0,777,9882,3578718693,3578718693,0
0,777,9883,3578718693,3578718693,0
0,777,9884,3578718693,3578718693,0
0,777,9885,3578718693,3578718693,0
0,777,9886,3578718693,3578718693,0
0,777,9887,3578718693,3578718693,0
0,777,9888,3578718693,3578718694,1
0,777,9889,3578718693,3578718694,1
0,777,9890,3578718693,3578718695,2
0,777,9891,3578718693,3578718695,2
0,777,9892,3578718693,3578718698,5
0,777,9893,3578718693,3578718699,6
0,777,9894,3578718693,3578718702,9
0,777,9895,3578718693,3578718702,9
0,777,9896,3578718693,3578718703,10
0,777,9897,3578718693,3578718704,11
0,777,9898,3578718693,3578718704,11
0,777,9899,3578718693,3578718705,12
0,777,9900,3578718693,3578718705,12
0,777,9901,3578718693,3578718708,15
0,777,9902,3578718693,3578718709,16
0,777,9903,3578718693,3578718711,18
0,777,9904,3578718693,3578718711,18
0,777,9905,3578718693,3578718714,21
0,777,9906,3578718693,3578718715,22
0,777,9907,3578718693,3578718716,23
0,777,9908,3578718693,3578718720,27
0,777,9909,3578718693,3578718721,28
0,777,9910,3578718693,3578718725,32
0,777,9911,3578718693,3578718726,33
0,777,9912,3578718693,3578718727,34
0,777,9913,3578718693,3578718727,34
0,777,9914,3578718693,3578718727,34
0,777,9915,3578718693,3578718727,34
0,777,9916,3578718693,3578718730,37
0,777,9917,3578718693,3578718731,38
0,777,9918,3578718693,3578718731,38
0,777,9919,3578718693,3578718732,39
0,777,9920,3578718693,3578718732,39
0,777,9921,3578718693,3578718733,40
0,777,9922,3578718693,3578718735,42
0,777,9923,3578718693,3578718739,46
0,777,9924,3578718693,3578718740,47
0,777,9925,3578718693,3578718742,49
0,778,9926,3578718747,3578718747,0
0,778,9927,3578718747,3578718747,0
0,778,9928,3578718747,3578718747,0
0,778,9929,3578718747,3578718747,0
0,778,9930,3578718747,3578718748,1
0,778,9931,3578718747,3578718751,4
0,778,9932,3578718747,3578718752,5
0,778,9933,3578718747,3578718755,8
0,778,9934,3578718747,3578718755,8
0,778,9935,3578718747,3578718758,11
0,778,9936,3578718747,3578718758,11
0,778,9937,3578718747,3578718759,12
0,778,9938,3578718747,3578718761,14
0,778,9939,3578718747,3578718761,14
0,778,9940,3578718747,3578718764,17
0,778,9941,3578718747,3578718764,17
0,778,9942,3578718747,3578718768,21
0,778,9943,3578718747,3578718769,22
0,778,9944,3578718747,3578718770,23
0,778,9945,3578718747,3578718772,25
0,778,9946,3578718747,3578718772,25
0,778,9947,3578718747,3578718773,26
0,778,9948,3578718747,3578718776,29
0,778,9949,3578718747,3578718776,29
0,778,9950,3578718747,3578718779,32
0,778,9951,3578718747,3578718779,32
0,778,9952,3578718747,3578718781,34
0,778,9953,3578718747,3578718781,34
0,778,9954,3578718747,3578718782,35
0,778,9955,3578718747,3578718782,35
0,778,9956,3578718747,3578718783,36
0,778,9957,3578718747,3578718785,38
0,778,9958,3578718747,3578718785,38
0,778,9959,3578718747,3578718786,39
0,778,9960,3578718747,3578718786,39
0,778,9961,3578718747,3578718787,40
0,778,9962,3578718747,3578718787,40
0,778,9963,3578718747,3578718788,41
0,778,9964,3578718747,3578718792,45
0,778,9965,3578718747,3578718792,45
0,778,9966,3578718747,3578718796,49
0,778,9967,3578718747,3578718797,50
0,779,9968,3578718803,3578718803,0
0,779,9969,3578718803,3578718803,0
0,779,9970,3578718803,3578718803,0
0,779,9971,3578718803,3578718803,0
0,779,9972,3578718803,3578718804,1
0,779,9973,3578718803,3578718805,2
0,779,9974,3578718803,3578718806,3
0,779,9975,3578718803,3578718808,5
0,779,9976,3578718803,3578718810,7
0,779,9977,3578718803,3578718812,9
0,779,9978,3578718803,3578718813,10
0,779,9979,3578718803,3578718815,12
0,779,9980,3578718803,3578718815,12
0,779,9981,3578718803,3578718815,12
0,779,9982,3578718803,3578718818,15
0,779,9983,3578718803,3578718819,16
0,779,9984,3578718803,3578718821,18
0,779,9985,3578718803,3578718824,21
0,779,9986,3578718803,3578718829,26
0,779,9987,3578718803,3578718829,26
0,779,9988,3578718803,3578718831,28
0,779,9989,3578718803,3578718831,28
0,779,9990,3578718803,3578718834,31
0,779,9991,3578718803,3578718834,31
0,779,9992,3578718803,3578718834,31
0,779,9993,3578718803,3578718837,34
0,779,9994,3578718803,3578718838,35
0,779,9995,3578718803,3578718840,37
0,779,9996,3578718803,3578718844,41
0,779,9997,3578718803,3578718849,46
0,779,9998,3578718803,3578718850,47
0,779,9999,3578718803,3578718851,48
0,779,10000,3578718803,3578718852,49
0,780,10001,3578718858,3578718858,0
0,780,10002,3578718858,3578718858,0
0,780,10003,3578718858,3578718858,0
0,780,10004,3578718858,3578718858,0
0,780,10005,3578718858,3578718862,4
0,780,10006,3578718858,3578718862,4
0,780,10007,3578718858,3578718864,6
0,780,10008,3578718858,3578718865,7
0,780,10009,3578718858,3578718865,7
0,780,10010,3578718858,3578718866,8
0,780,10011,3578718858,3578718867,9
0,780,10012,3578718858,3578718869,11
0,780,10013,3578718858,3578718870,12
0,780,10014,3578718858,3578718877,19
0,780,10015,3578718858,3578718878,20
0,780,10016,3578718858,3578718880,22
0,780,10017,3578718858,3578718881,23
0,780,10018,3578718858,3578718885,27
0,780,10019,3578718858,3578718885,27
0,780,10020,3578718858,3578718890,32
0,780,10021,3578718858,3578718890,32
0,780,10022,3578718858,3578718890,32
0,780,10023,3578718858,3578718891,33
0,780,10024,3578718858,3578718892,34
0,780,10025,3578718858,3578718893,35
0,780,10026,3578718858,3578718894,36
0,780,10027,3578718858,3578718894,36
0,780,10028,3578718858,3578718895,37
0,780,10029,3578718858,3578718896,38
0,780,10030,3578718858,3578718898,40
0,780,10031,3578718858,3578718899,41
0,780,10032,3578718858,3578718902,44
0,780,10033,3578718858,3578718902,44
0,780,10034,3578718858,3578718903,45
0,780,10035,3578718858,3578718904,46
0,780,10036,3578718858,3578718904,46
0,780,10037,3578718858,3578718905,47
0,780,10038,3578718858,3578718905,47
0,780,10039,3578718858,3578718908,50
0,781,10040,3578718912,3578718912,0
0,781,10041,3578718912,3578718912,0
0,781,10042,3578718912,3578718912,0
0,781,10043,3578718912,3578718915,3
0,781,10044,3578718912,3578718916,4
0,781,10045,3578718912,3578718920,8
0,781,10046,3578718912,3578718921,9
0,781,10047,3578718912,3578718924,12
0,781,10048,3578718912,3578718926,14
0,781,10049,3578718912,3578718927,15
0,781,10050,3578718912,3578718928,16
0,781,10051,3578718912,3578718928,16
0,781,10052,3578718912,3578718928,16
0,781,10053,3578718912,3578718930,18
0,781,10054,3578718912,3578718931,19
0,781,10055,3578718912,3578718931,19
0,781,10056,3578718912,3578718933,21
0,781,10057,3578718912,3578718935,23
0,781,10058,3578718912,3578718935,23
0,781,10059,3578718912,3578718939,27
0,781,10060,3578718912,3578718940,28
0,781,10061,3578718912,3578718942,30
0,781,10062,3578718912,3578718944,32
0,781,10063,3578718912,3578718945,33
0,781,10064,3578718912,3578718946,34
0,781,10065,3578718912,3578718946,34
0,781,10066,3578718912,3578718948,36
0,781,10067,3578718912,3578718952,40
0,781,10068,3578718912,3578718953,41
0,781,10069,3578718912,3578718956,44
0,781,10070,3578718912,3578718956,44
0,781,10071,3578718912,3578718958,46
0,781,10072,3578718912,3578718959,47
0,781,10073,3578718912,3578718959,47
0,781,10074,3578718912,3578718961,49
0,781,10075,3578718912,3578718961,49
0,782,10076,3578718967,3578718967,0
0,782,10077,3578718967,3578718967,0
0,782,10078,3578718967,3578718969,2
0,782,10079,3578718967,3578718969,2
0,782,10080,3578718967,3578718970,3
0,782,10081,3578718967,3578718971,4
0,782,10082,3578718967,3578718972,5
0,782,10083,3578718967,3578718972,5
0,782,10084,3578718967,3578718976,9
0,782,10085,3578718967,3578718976,9
0,782,10086,3578718967,3578718978,11
0,782,10087,3578718967,3578718979,12
0,782,10088,3578718967,3578718981,14
0,782,10089,3578718967,3578718981,14
0,782,10090,3578718967,3578718982,15
0,782,10091,3578718967,3578718983,16
0,782,10092,3578718967,3578718983,16
0,782,10093,3578718967,3578718985,18
0,782,10094,3578718967,3578718986,19
0,782,10095,3578718967,3578718986,19
0,782,10096,3578718967,3578718986,19
0,782,10097,3578718967,3578718986,19
0,782,10098,3578718967,3578718988,21
0,782,10099,3578718967,3578718988,21
0,782,10100,3578718967,3578718992,25
0,782,10101,3578718967,3578718993,26
0,782,10102,3578718967,3578718996,29
0,782,10103,3578718967,3578718997,30
0,782,10104,3578718967,3578719001,34
0,782,10105,3578718967,3578719001,34
0,782,10106,3578718967,3578719002,35
0,782,10107,3578718967,3578719003,36
0,782,10108,3578718967,3578719004,37
0,782,10109,3578718967,3578719006,39
0,782,10110,3578718967,3578719006,39
0,782,10111,3578718967,3578719008,41
0,782,10112,3578718967,3578719010,43
0,782,10113,3578718967,3578719013,46
0,782,10114,3578718967,3578719014,47
0,782,10115,3578718967,3578719015,48
0,782,10116,3578718967,3578719015,48
0,782,10117,3578718967,3578719015,48
0,782,10118,3578718967,3578719016,49
0,783,10119,3578719022,3578719022,0
0,783,10120,3578719022,3578719022,0
0,783,10121,3578719022,3578719022,0
0,783,10122,3578719022,3578719023,1
0,783,10123,3578719022,3578719024,2
0,783,10124,3578719022,3578719029,7
0,783,10125,3578719022,3578719029,7
0,783,10126,3578719022,3578719031,9
0,783,10127,3578719022,3578719031,9
0,783,10128,3578719022,3578719034,12
0,783,10129,3578719022,3578719036,14
0,783,10130,3578719022,3578719036,14
0,783,10131,3578719022,3578719037,15
0,783,10132,3578719022,3578719038,16
0,783,10133,3578719022,3578719040,18
0,783,10134,3578719022,3578719045,23
0,783,10135,3578719022,3578719050,28
0,783,10136,3578719022,3578719050,28
0,783,10137,3578719022,3578719051,29
0,783,10138,3578719022,3578719052,30
0,783,10139,3578719022,3578719054,32
0,783,10140,3578719022,3578719056,34
0,783,10141,3578719022,3578719057,35
0,783,10142,3578719022,3578719057,35
0,783,10143,3578719022,3578719062,40
0,783,10144,3578719022,3578719062,40
0,783,10145,3578719022,3578719064,42
0,783,10146,3578719022,3578719065,43
0,783,10147,3578719022,3578719066,44
0,783,10148,3578719022,3578719066,44
0,783,10149,3578719022,3578719067,45
0,783,10150,3578719022,3578719069,47
0,783,10151,3578719022,3578719070,48
0,784,10152,3578719077,3578719077,0
0,784,10153,3578719077,3578719078,1
0,784,10154,3578719077,3578719080,3
0,784,10155,3578719077,3578719081,4
0,784,10156,3578719077,3578719085,8
0,784,10157,3578719077,3578719088,11
0,784,10158,3578719077,3578719090,13
0,784,10159,3578719077,3578719090,13
0,784,10160,3578719077,3578719092,15
0,784,10161,3578719077,3578719092,15
0,784,10162,3578719077,3578719094,17
0,784,10163,3578719077,3578719094,17
0,784,10164,3578719077,3578719094,17
0,784,10165,3578719077,3578719095,18
0,784,10166,3578719077,3578719097,20
0,784,10167,3578719077,3578719098,21
0,784,10168,3578719077,3578719099,22
0,784,10169,3578719077,3578719102,25
0,784,10170,3578719077,3578719102,25
0,784,10171,3578719077,3578719104,27
0,784,10172,3578719077,3578719104,27
0,784,10173,3578719077,3578719104,27
0,784,10174,3578719077,3578719105,28
0,784,10175,3578719077,3578719105,28
0,784,10176,3578719077,3578719107,30
0,784,10177,3578719077,3578719109,32
0,784,10178,3578719077,3578719111,34
0,784,10179,3578719077,3578719112,35
0,784,10180,3578719077,3578719116,39
0,784,10181,3578719077,3578719116,39
0,784,10182,3578719077,3578719121,44
0,784,10183,3578719077,3578719121,44
0,784,10184,3578719077,3578719124,47
0,784,10185,3578719077,3578719126,49
0,784,10186,3578719077,3578719127,50
0,785,10187,3578719131,3578719131,0
0,785,10188,3578719131,3578719131,0
0,785,10189,3578719131,3578719131,0
0,785,10190,3578719131,3578719131,0
0,785,10191,3578719131,3578719131,0
0,785,10192,3578719131,3578719133,2
0,785,10193,3578719131,3578719133,2
0,785,10194,3578719131,3578719135,4
0,785,10195,3578719131,3578719139,8
0,785,10196,3578719131,3578719139,8
0,785,10197,3578719131,3578719140,9
0,785,10198,3578719131,3578719140,9
0,785,10199,3578719131,3578719142,11
0,785,10200,3578719131,3578719144,13
0,785,10201,3578719131,3578719145,14
0,785,10202,3578719131,3578719146,15
0,785,10203,3578719131,3578719147,16
0,785,10204,3578719131,3578719148,17
0,785,10205,3578719131,3578719151,20
0,785,10206,3578719131,3578719152,21
0,785,10207,3578719131,3578719155,24
0,785,10208,3578719131,3578719156,25
0,785,10209,3578719131,3578719158,27
0,785,10210,3578719131,3578719158,27
0,785,10211,3578719131,3578719159,28
0,785,10212,3578719131,3578719161,30
0,785,10213,3578719131,3578719161,30
0,785,10214,3578719131,3578719164,33
0,785,10215,3578719131,3578719165,34
0,785,10216,3578719131,3578719169,38
0,785,10217,3578719131,3578719169,38
0,785,10218,3578719131,3578719170,39
0,785,10219,3578719131,3578719172,41
0,785,10220,3578719131,3578719172,41
0,785,10221,3578719131,3578719176,45
0,785,10222,3578719131,3578719179,48
0,786,10223,3578719186,3578719186,0
0,786,10224,3578719186,3578719186,0
0,786,10225,3578719186,3578719186,0
0,786,10226,3578719186,3578719186,0
0,786,10227,3578719186,3578719186,0
0,786,10228,3578719186,3578719186,0
0,786,10229,3578719186,3578719186,0
0,786,10230,3578719186,3578719187,1
0,786,10231,3578719186,3578719188,2
0,786,10232,3578719186,3578719189,3
0,786,10233,3578719186,3578719192,6
0,786,10234,3578719186,3578719193,7
0,786,10235,3578719186,3578719196,10
0,786,10236,3578719186,3578719197,11
0,786,10237,3578719186,3578719201,15
0,786,10238,3578719186,3578719201,15
0,786,10239,3578719186,3578719201,15
0,786,10240,3578719186,3578719203,17
0,786,10241,3578719186,3578719204,18
0,786,10242,3578719186,3578719205,19
0,786,10243,3578719186,3578719206,20
0,786,10244,3578719186,3578719208,22
0,786,10245,3578719186,3578719210,24
0,786,10246,3578719186,3578719213,27
0,786,10247,3578719186,3578719214,28
0,786,10248,3578719186,3578719215,29
0,786,10249,3578719186,3578719215,29
0,786,10250,3578719186,3578719216,30
0,786,10251,3578719186,3578719217,31
0,786,10252,3578719186,3578719219,33
0,786,10253,3578719186,3578719219,33
0,786,10254,3578719186,3578719221,35
0,786,10255,3578719186,3578719223,37
0,786,10256,3578719186,3578719224,38
0,786,10257,3578719186,3578719229,43
0,786,10258,3578719186,3578719230,44
0,786,10259,3578719186,3578719231,45
0,786,10260,3578719186,3578719231,45
0,786,10261,3578719186,3578719234,48
0,786,10262,3578719186,3578719235,49
0,787,10263,3578719240,3578719240,0
0,787,10264,3578719240,3578719240,0
0,787,10265,3578719240,3578719240,0
0,787,10266,3578719240,3578719240,0
0,787,10267,3578719240,3578719240,0
0,787,10268,3578719240,3578719240,0
0,787,10269,3578719240,3578719244,4
0,787,10270,3578719240,3578719250,10
0,787,10271,3578719240,3578719250,10
0,787,10272,3578719240,3578719251,11
0,787,10273,3578719240,3578719253,13
0,787,10274,3578719240,3578719255,15
0,787,10275,3578719240,3578719256,16
0,787,10276,3578719240,3578719257,17
0,787,10277,3578719240,3578719259,19
0,787,10278,3578719240,3578719259,19
0,787,10279,3578719240,3578719262,22
0,787,10280,3578719240,3578719262,22
0,787,10281,3578719240,3578719265,25
0,787,10282,3578719240,3578719265,25
0,787,10283,3578719240,3578719266,26
0,787,10284,3578719240,3578719266,26
0,787,10285,3578719240,3578719267,27
0,787,10286,3578719240,3578719269,29
0,787,10287,3578719240,3578719269,29
0,787,10288,3578719240,3578719278,38
0,787,10289,3578719240,3578719280,40
0,787,10290,3578719240,3578719282,42
0,787,10291,3578719240,3578719286,46
0,788,10292,3578719294,3578719294,0
0,788,10293,3578719294,3578719294,0
0,788,10294,3578719294,3578719294,0
0,788,10295,3578719294,3578719294,0
0,788,10296,3578719294,3578719294,0
0,788,10297,3578719294,3578719294,0
0,788,10298,3578719294,3578719294,0
0,788,10299,3578719294,3578719294,0
0,788,10300,3578719294,3578719296,2
0,788,10301,3578719294,3578719297,3
0,788,10302,3578719294,3578719298,4
0,788,10303,3578719294,3578719302,8
0,788,10304,3578719294,3578719302,8
0,788,10305,3578719294,3578719304,10
0,788,10306,3578719294,3578719304,10
0,788,10307,3578719294,3578719305,11
0,788,10308,3578719294,3578719305,11
0,788,10309,3578719294,3578719307,13
0,788,10310,3578719294,3578719309,15
0,788,10311,3578719294,3578719311,17
0,788,10312,3578719294,3578719314,20
0,788,10313,3578719294,3578719316,22
0,788,10314,3578719294,3578719316,22
0,788,10315,3578719294,3578719321,27
0,788,10316,3578719294,3578719321,27
0,788,10317,3578719294,3578719324,30
0,788,10318,3578719294,3578719326,32
0,788,10319,3578719294,3578719327,33
0,788,10320,3578719294,3578719327,33
0,788,10321,3578719294,3578719328,34
0,788,10322,3578719294,3578719329,35
0,788,10323,3578719294,3578719330,36
0,788,10324,3578719294,3578719331,37
0,788,10325,3578719294,3578719333,39
0,788,10326,3578719294,3578719333,39
0,788,10327,3578719294,3578719340,46
0,788,10328,3578719294,3578719340,46
0,788,10329,3578719294,3578719340,46
0,788,10330,3578719294,3578719341,47
0,788,10331,3578719294,3578719342,48
0,788,10332,3578719294,3578719343,49
0,789,10333,3578719349,3578719349,0
0,789,10334,3578719349,3578719349,0
0,789,10335,3578719349,3578719349,0
0,789,10336,3578719349,3578719349,0
0,789,10337,3578719349,3578719349,0
0,789,10338,3578719349,3578719352,3
0,789,10339,3578719349,3578719353,4
0,789,10340,3578719349,3578719356,7
0,789,10341,3578719349,3578719356,7
0,789,10342,3578719349,3578719357,8
0,789,10343,3578719349,3578719358,9
0,789,10344,3578719349,3578719359,10
0,789,10345,3578719349,3578719360,11
0,789,10346,3578719349,3578719361,12
0,789,10347,3578719349,3578719362,13
0,789,10348,3578719349,3578719364,15
0,789,10349,3578719349,3578719369,20
0,789,10350,3578719349,3578719369,20
0,789,10351,3578719349,3578719370,21
0,789,10352,3578719349,3578719372,23
0,789,10353,3578719349,3578719373,24
0,789,10354,3578719349,3578719373,24
0,789,10355,3578719349,3578719376,27
0,789,10356,3578719349,3578719376,27
0,789,10357,3578719349,3578719379,30
0,789,10358,3578719349,3578719381,32
0,789,10359,3578719349,3578719382,33
0,789,10360,3578719349,3578719382,33
0,789,10361,3578719349,3578719383,34
0,789,10362,3578719349,3578719385,36
0,789,10363,3578719349,3578719386,37
0,789,10364,3578719349,3578719386,37
0,789,10365,3578719349,3578719387,38
0,789,10366,3578719349,3578719389,40
0,789,10367,3578719349,3578719392,43
0,789,10368,3578719349,3578719392,43
0,789,10369,3578719349,3578719394,45
0,789,10370,3578719349,3578719397,48
0,790,10371,3578719405,3578719405,0
0,790,10372,3578719405,3578719405,0
0,790,10373,3578719405,3578719405,0
0,790,10374,3578719405,3578719405,0
0,790,10375,3578719405,3578719407,2
0,790,10376,3578719405,3578719407,2
0,790,10377,3578719405,3578719408,3
0,790,10378,3578719405,3578719410,5
0,790,10379,3578719405,3578719413,8
0,790,10380,3578719405,3578719414,9
0,790,10381,3578719405,3578719415,10
0,790,10382,3578719405,3578719416,11
0,790,10383,3578719405,3578719416,11
0,790,10384,3578719405,3578719416,11
0,790,10385,3578719405,3578719419,14
0,790,10386,3578719405,3578719420,15
0,790,10387,3578719405,3578719421,16
0,790,10388,3578719405,3578719423,18
0,790,10389,3578719405,3578719424,19
0,790,10390,3578719405,3578719429,24
0,790,10391,3578719405,3578719430,25
0,790,10392,3578719405,3578719431,26
0,790,10393,3578719405,3578719432,27
0,790,10394,3578719405,3578719434,29
0,790,10395,3578719405,3578719435,30
0,790,10396,3578719405,3578719436,31
0,790,10397,3578719405,3578719439,34
0,790,10398,3578719405,3578719439,34
0,790,10399,3578719405,3578719440,35
0,790,10400,3578719405,3578719444,39
0,790,10401,3578719405,3578719445,40
0,790,10402,3578719405,3578719450,45
0,790,10403,3578719405,3578719451,46
0,790,10404,3578719405,3578719451,46
0,790,10405,3578719405,3578719453,48
0,790,10406,3578719405,3578719454,49
0,791,10407,3578719462,3578719462,0
0,791,10408,3578719462,3578719462,0
0,791,10409,3578719462,3578719462,0
0,791,10410,3578719462,3578719462,0
0,791,10411,3578719462,3578719462,0
0,791,10412,3578719462,3578719463,1
0,791,10413,3578719462,3578719465,3
0,791,10414,3578719462,3578719465,3
0,791,10415,3578719462,3578719466,4
0,791,10416,3578719462,3578719466,4
0,791,10417,3578719462,3578719467,5
0,791,10418,3578719462,3578719469,7
0,791,10419,3578719462,3578719470,8
0,791,10420,3578719462,3578719477,15
0,791,10421,3578719462,3578719481,19
0,791,10422,3578719462,3578719482,20
0,791,10423,3578719462,3578719486,24
0,791,10424,3578719462,3578719490,28
0,791,10425,3578719462,3578719491,29
0,791,10426,3578719462,3578719493,31
0,791,10427,3578719462,3578719493,31
0,791,10428,3578719462,3578719493,31
0,791,10429,3578719462,3578719493,31
0,791,10430,3578719462,3578719493,31
0,791,10431,3578719462,3578719494,32
0,791,10432,3578719462,3578719496,34
0,791,10433,3578719462,3578719497,35
0,791,10434,3578719462,3578719497,35
0,791,10435,3578719462,3578719500,38
0,791,10436,3578719462,3578719502,40
0,791,10437,3578719462,3578719502,40
0,791,10438,3578719462,3578719504,42
0,791,10439,3578719462,3578719505,43
0,791,10440,3578719462,3578719505,43
0,791,10441,3578719462,3578719508,46
0,791,10442,3578719462,3578719510,48
0,791,10443,3578719462,3578719511,49
0,791,10444,3578719462,3578719512,50
0,792,10445,3578719518,3578719518,0
0,792,10446,3578719518,3578719518,0
0,792,10447,3578719518,3578719518,0
0,792,10448,3578719518,3578719520,2
0,792,10449,3578719518,3578719520,2
0,792,10450,3578719518,3578719524,6
0,792,10451,3578719518,3578719525,7
0,792,10452,3578719518,3578719526,8
0,792,10453,3578719518,3578719527,9
0,792,10454,3578719518,3578719527,9
0,792,10455,3578719518,3578719528,10
0,792,10456,3578719518,3578719529,11
0,792,10457,3578719518,3578719529,11
0,792,10458,3578719518,3578719530,12
0,792,10459,3578719518,3578719531,13
0,792,10460,3578719518,3578719532,14
0,792,10461,3578719518,3578719539,21
0,792,10462,3578719518,3578719539,21
0,792,10463,3578719518,3578719540,22
0,792,10464,3578719518,3578719540,22
0,792,10465,3578719518,3578719542,24
0,792,10466,3578719518,3578719543,25
0,792,10467,3578719518,3578719544,26
0,792,10468,3578719518,3578719546,28
0,792,10469,3578719518,3578719546,28
0,792,10470,3578719518,3578719547,29
0,792,10471,3578719518,3578719551,33
0,792,10472,3578719518,3578719552,34
0,792,10473,3578719518,3578719555,37
0,792,10474,3578719518,3578719555,37
0,792,10475,3578719518,3578719555,37
0,792,10476,3578719518,3578719558,40
0,792,10477,3578719518,3578719558,40
0,792,10478,3578719518,3578719559,41
0,792,10479,3578719518,3578719560,42
0,792,10480,3578719518,3578719560,42
0,792,10481,3578719518,3578719562,44
0,792,10482,3578719518,3578719562,44
0,792,10483,3578719518,3578719568,50
0,793,10484,3578719572,3578719572,0
0,793,10485,3578719572,3578719572,0
0,793,10486,3578719572,3578719572,0
0,793,10487,3578719572,3578719572,0
0,793,10488,3578719572,3578719572,0
0,793,10489,3578719572,3578719575,3
0,793,10490,3578719572,3578719575,3
0,793,10491,3578719572,3578719579,7
0,793,10492,3578719572,3578719579,7
0,793,10493,3578719572,3578719580,8
0,793,10494,3578719572,3578719581,9
0,793,10495,3578719572,3578719581,9
0,793,10496,3578719572,3578719582,10
0,793,10497,3578719572,3578719584,12
0,793,10498,3578719572,3578719585,13
0,793,10499,3578719572,3578719585,13
0,793,10500,3578719572,3578719586,14
0,793,10501,3578719572,3578719586,14
0,793,10502,3578719572,3578719591,19
0,793,10503,3578719572,3578719593,21
0,793,10504,3578719572,3578719595,23
0,793,10505,3578719572,3578719597,25
0,793,10506,3578719572,3578719600,28
0,793,10507,3578719572,3578719600,28
0,793,10508,3578719572,3578719601,29
0,793,10509,3578719572,3578719603,31
0,793,10510,3578719572,3578719605,33
0,793,10511,3578719572,3578719606,34
0,793,10512,3578719572,3578719606,34
0,793,10513,3578719572,3578719607,35
0,793,10514,3578719572,3578719609,37
0,793,10515,3578719572,3578719611,39
0,793,10516,3578719572,3578719612,40
0,793,10517,3578719572,3578719613,41
0,793,10518,3578719572,3578719614,42
0,793,10519,3578719572,3578719615,43
0,793,10520,3578719572,3578719615,43
0,793,10521,3578719572,3578719615,43
0,793,10522,3578719572,3578719618,46
0,793,10523,3578719572,3578719618,46
0,793,10524,3578719572,3578719621,49
0,794,10525,3578719628,3578719628,0
0,794,10526,3578719628,3578719628,0
0,794,10527,3578719628,3578719628,0
0,794,10528,3578719628,3578719629,1
0,794,10529,3578719628,3578719630,2
0,794,10530,3578719628,3578719631,3
0,794,10531,3578719628,3578719633,5
0,794,10532,3578719628,3578719633,5
0,794,10533,3578719628,3578719636,8
0,794,10534,3578719628,3578719638,10
0,794,10535,3578719628,3578719640,12
0,794,10536,3578719628,3578719643,15
0,794,10537,3578719628,3578719644,16
0,794,10538,3578719628,3578719644,16
0,794,10539,3578719628,3578719649,21
0,794,10540,3578719628,3578719649,21
0,794,10541,3578719628,3578719650,22
0,794,10542,3578719628,3578719652,24
0,794,10543,3578719628,3578719653,25
0,794,10544,3578719628,3578719656,28
0,794,10545,3578719628,3578719657,29
0,794,10546,3578719628,3578719657,29
0,794,10547,3578719628,3578719659,31
0,794,10548,3578719628,3578719661,33
0,794,10549,3578719628,3578719661,33
0,794,10550,3578719628,3578719664,36
0,794,10551,3578719628,3578719664,36
0,794,10552,3578719628,3578719665,37
0,794,10553,3578719628,3578719666,38
0,794,10554,3578719628,3578719666,38
0,794,10555,3578719628,3578719667,39
0,794,10556,3578719628,3578719669,41
0,794,10557,3578719628,3578719670,42
0,794,10558,3578719628,3578719677,49
0,795,10559,3578719684,3578719684,0
0,795,10560,3578719684,3578719684,0
0,795,10561,3578719684,3578719686,2
0,795,10562,3578719684,3578719690,6
0,795,10563,3578719684,3578719691,7
0,795,10564,3578719684,3578719693,9
0,795,10565,3578719684,3578719693,9
0,795,10566,3578719684,3578719693,9
0,795,10567,3578719684,3578719693,9
0,795,10568,3578719684,3578719693,9
0,795,10569,3578719684,3578719694,10
0,795,10570,3578719684,3578719696,12
0,795,10571,3578719684,3578719697,13
0,795,10572,3578719684,3578719698,14
0,795,10573,3578719684,3578719699,15
0,795,10574,3578719684,3578719702,18
0,795,10575,3578719684,3578719703,19
0,795,10576,3578719684,3578719703,19
0,795,10577,3578719684,3578719705,21
0,795,10578,3578719684,3578719705,21
0,795,10579,3578719684,3578719706,22
0,795,10580,3578719684,3578719708,24
0,795,10581,3578719684,3578719710,26
0,795,10582,3578719684,3578719712,28
0,795,10583,3578719684,3578719712,28
0,795,10584,3578719684,3578719714,30
0,795,10585,3578719684,3578719716,32
0,795,10586,3578719684,3578719716,32
0,795,10587,3578719684,3578719720,36
0,795,10588,3578719684,3578719720,36
0,795,10589,3578719684,3578719725,41
0,795,10590,3578719684,3578719726,42
0,795,10591,3578719684,3578719727,43
0,795,10592,3578719684,3578719727,43
0,795,10593,3578719684,3578719728,44
0,795,10594,3578719684,3578719730,46
0,795,10595,3578719684,3578719730,46
0,795,10596,3578719684,3578719732,48
0,795,10597,3578719684,3578719733,49
0,796,10598,3578719738,3578719738,0
0,796,10599,3578719738,3578719739,1
0,796,10600,3578719738,3578719739,1
0,796,10601,3578719738,3578719739,1
0,796,10602,3578719738,3578719740,2
0,796,10603,3578719738,3578719742,4
0,796,10604,3578719738,3578719744,6
0,796,10605,3578719738,3578719744,6
0,796,10606,3578719738,3578719745,7
0,796,10607,3578719738,3578719746,8
0,796,10608,3578719738,3578719746,8
0,796,10609,3578719738,3578719747,9
0,796,10610,3578719738,3578719750,12
0,796,10611,3578719738,3578719752,14
0,796,10612,3578719738,3578719755,17
0,796,10613,3578719738,3578719755,17
0,796,10614,3578719738,3578719755,17
0,796,10615,3578719738,3578719758,20
0,796,10616,3578719738,3578719758,20
0,796,10617,3578719738,3578719759,21
0,796,10618,3578719738,3578719761,23
0,796,10619,3578719738,3578719762,24
0,796,10620,3578719738,3578719763,25
0,796,10621,3578719738,3578719763,25
0,796,10622,3578719738,3578719764,26
0,796,10623,3578719738,3578719768,30
0,796,10624,3578719738,3578719769,31
0,796,10625,3578719738,3578719770,32
0,796,10626,3578719738,3578719772,34
0,796,10627,3578719738,3578719772,34
0,796,10628,3578719738,3578719775,37
0,796,10629,3578719738,3578719775,37
0,796,10630,3578719738,3578719779,41
0,796,10631,3578719738,3578719780,42
0,796,10632,3578719738,3578719781,43
0,796,10633,3578719738,3578719783,45
0,796,10634,3578719738,3578719784,46
0,796,10635,3578719738,3578719785,47
0,796,10636,3578719738,3578719786,48
0,796,10637,3578719738,3578719786,48
0,796,10638,3578719738,3578719786,48
0,796,10639,3578719738,3578719788,50
0,797,10640,3578719793,3578719793,0
0,797,10641,3578719793,3578719793,0
0,797,10642,3578719793,3578719793,0
0,797,10643,3578719793,3578719794,1
0,797,10644,3578719793,3578719795,2
0,797,10645,3578719793,3578719796,3
0,797,10646,3578719793,3578719800,7
0,797,10647,3578719793,3578719800,7
0,797,10648,3578719793,3578719801,8
0,797,10649,3578719793,3578719802,9
0,797,10650,3578719793,3578719805,12
0,797,10651,3578719793,3578719805,12
0,797,10652,3578719793,3578719806,13
0,797,10653,3578719793,3578719807,14
0,797,10654,3578719793,3578719810,17
0,797,10655,3578719793,3578719812,19
0,797,10656,3578719793,3578719813,20
0,797,10657,3578719793,3578719814,21
0,797,10658,3578719793,3578719815,22
0,797,10659,3578719793,3578719815,22
0,797,10660,3578719793,3578719815,22
0,797,10661,3578719793,3578719816,23
0,797,10662,3578719793,3578719818,25
0,797,10663,3578719793,3578719818,25
0,797,10664,3578719793,3578719822,29
0,797,10665,3578719793,3578719824,31
0,797,10666,3578719793,3578719824,31
0,797,10667,3578719793,3578719827,34
0,797,10668,3578719793,3578719829,36
0,797,10669,3578719793,3578719831,38
0,797,10670,3578719793,3578719831,38
0,797,10671,3578719793,3578719832,39
0,797,10672,3578719793,3578719834,41
0,797,10673,3578719793,3578719836,43
0,797,10674,3578719793,3578719836,43
0,797,10675,3578719793,3578719838,45
0,797,10676,3578719793,3578719839,46
0,797,10677,3578719793,3578719839,46
0,797,10678,3578719793,3578719843,50
0,798,10679,3578719847,3578719847,0
0,798,10680,3578719847,3578719847,0
0,798,10681,3578719847,3578719849,2
0,798,10682,3578719847,3578719850,3
0,798,10683,3578719847,3578719850,3
0,798,10684,3578719847,3578719852,5
0,798,10685,3578719847,3578719854,7
0,798,10686,3578719847,3578719856,9
0,798,10687,3578719847,3578719856,9
0,798,10688,3578719847,3578719858,11
0,798,10689,3578719847,3578719858,11
0,798,10690,3578719847,3578719862,15
0,798,10691,3578719847,3578719863,16
0,798,10692,3578719847,3578719864,17
0,798,10693,3578719847,3578719864,17
0,798,10694,3578719847,3578719864,17
0,798,10695,3578719847,3578719865,18
0,798,10696,3578719847,3578719866,19
0,798,10697,3578719847,3578719866,19
0,798,10698,3578719847,3578719867,20
0,798,10699,3578719847,3578719869,22
0,798,10700,3578719847,3578719869,22
0,798,10701,3578719847,3578719877,30
0,798,10702,3578719847,3578719883,36
0,798,10703,3578719847,3578719883,36
0,798,10704,3578719847,3578719885,38
0,798,10705,3578719847,3578719890,43
0,798,10706,3578719847,3578719891,44
0,798,10707,3578719847,3578719893,46
0,798,10708,3578719847,3578719893,46
0,798,10709,3578719847,3578719893,46
0,798,10710,3578719847,3578719894,47
0,798,10711,3578719847,3578719894,47
0,798,10712,3578719847,3578719894,47
0,798,10713,3578719847,3578719895,48
0,798,10714,3578719847,3578719896,49
0,799,10715,3578719901,3578719901,0
0,799,10716,3578719901,3578719901,0
0,799,10717,3578719901,3578719901,0
0,799,10718,3578719901,3578719902,1
0,799,10719,3578719901,3578719903,2
0,799,10720,3578719901,3578719904,3
0,799,10721,3578719901,3578719904,3
0,799,10722,3578719901,3578719905,4
0,799,10723,3578719901,3578719905,4
0,799,10724,3578719901,3578719905,4
0,799,10725,3578719901,3578719907,6
0,799,10726,3578719901,3578719910,9
0,799,10727,3578719901,3578719912,11
0,799,10728,3578719901,3578719914,13
0,799,10729,3578719901,3578719915,14
0,799,10730,3578719901,3578719916,15
0,799,10731,3578719901,3578719916,15
0,799,10732,3578719901,3578719920,19
0,799,10733,3578719901,3578719920,19
0,799,10734,3578719901,3578719924,23
0,799,10735,3578719901,3578719925,24
0,799,10736,3578719901,3578719926,25
0,799,10737,3578719901,3578719926,25
0,799,10738,3578719901,3578719928,27
0,799,10739,3578719901,3578719928,27
0,799,10740,3578719901,3578719930,29
0,799,10741,3578719901,3578719930,29
0,799,10742,3578719901,3578719932,31
0,799,10743,3578719901,3578719933,32
0,799,10744,3578719901,3578719935,34
0,799,10745,3578719901,3578719939,38
0,799,10746,3578719901,3578719939,38
0,799,10747,3578719901,3578719940,39
0,799,10748,3578719901,3578719940,39
0,799,10749,3578719901,3578719942,41
0,799,10750,3578719901,3578719944,43
0,799,10751,3578719901,3578719944,43
0,799,10752,3578719901,3578719944,43
0,799,10753,3578719901,3578719946,45
0,799,10754,3578719901,3578719946,45
0,799,10755,3578719901,3578719949,48
0,799,10756,3578719901,3578719950,49
0,800,10757,3578719956,3578719956,0
0,800,10758,3578719956,3578719956,0
0,800,10759,3578719956,3578719956,0
0,800,10760,3578719956,3578719956,0
0,800,10761,3578719956,3578719958,2
0,800,10762,3578719956,3578719958,2
0,800,10763,3578719956,3578719958,2
0,800,10764,3578719956,3578719961,5
0,800,10765,3578719956,3578719963,7
0,800,10766,3578719956,3578719963,7
0,800,10767,3578719956,3578719964,8
0,800,10768,3578719956,3578719964,8
0,800,10769,3578719956,3578719966,10
0,800,10770,3578719956,3578719968,12
0,800,10771,3578719956,3578719969,13
0,800,10772,3578719956,3578719972,16
0,800,10773,3578719956,3578719972,16
0,800,10774,3578719956,3578719973,17
0,800,10775,3578719956,3578719975,19
0,800,10776,3578719956,3578719976,20
0,800,10777,3578719956,3578719979,23
0,800,10778,3578719956,3578719979,23
0,800,10779,3578719956,3578719980,24
0,800,10780,3578719956,3578719981,25
0,800,10781,3578719956,3578719982,26
0,800,10782,3578719956,3578719984,28
0,800,10783,3578719956,3578719985,29
0,800,10784,3578719956,3578719986,30
0,800,10785,3578719956,3578719986,30
0,800,10786,3578719956,3578719987,31
0,800,10787,3578719956,3578719988,32
0,800,10788,3578719956,3578719989,33
0,800,10789,3578719956,3578719991,35
0,800,10790,3578719956,3578719992,36
0,800,10791,3578719956,3578719995,39
0,800,10792,3578719956,3578719996,40
0,800,10793,3578719956,3578720001,45
0,800,10794,3578719956,3578720001,45
0,800,10795,3578719956,3578720002,46
0,800,10796,3578719956,3578720003,47
0,800,10797,3578719956,3578720005,49
0,800,10798,3578719956,3578720006,50
0,801,10799,3578720010,3578720010,0
0,801,10800,3578720010,3578720010,0
0,801,10801,3578720010,3578720012,2
0,801,10802,3578720010,3578720014,4
0,801,10803,3578720010,3578720015,5
0,801,10804,3578720010,3578720015,5
0,801,10805,3578720010,3578720016,6
0,801,10806,3578720010,3578720016,6
0,801,10807,3578720010,3578720018,8
0,801,10808,3578720010,3578720019,9
0,801,10809,3578720010,3578720021,11
0,801,10810,3578720010,3578720023,13
0,801,10811,3578720010,3578720024,14
0,801,10812,3578720010,3578720027,17
0,801,10813,3578720010,3578720030,20
0,801,10814,3578720010,3578720031,21
0,801,10815,3578720010,3578720031,21
0,801,10816,3578720010,3578720032,22
0,801,10817,3578720010,3578720034,24
0,801,10818,3578720010,3578720036,26
0,801,10819,3578720010,3578720036,26
0,801,10820,3578720010,3578720039,29
0,801,10821,3578720010,3578720039,29
0,801,10822,3578720010,3578720043,33
0,801,10823,3578720010,3578720044,34
0,801,10824,3578720010,3578720044,34
0,801,10825,3578720010,3578720049,39
0,801,10826,3578720010,3578720049,39
0,801,10827,3578720010,3578720050,40
0,801,10828,3578720010,3578720052,42
0,801,10829,3578720010,3578720054,44
0,801,10830,3578720010,3578720056,46
0,801,10831,3578720010,3578720057,47
0,801,10832,3578720010,3578720058,48
0,801,10833,3578720010,3578720059,49
0,802,10834,3578720065,3578720065,0
0,802,10835,3578720065,3578720065,0
0,802,10836,3578720065,3578720065,0
0,802,10837,3578720065,3578720067,2
0,802,10838,3578720065,3578720067,2
0,802,10839,3578720065,3578720067,2
0,802,10840,3578720065,3578720069,4
0,802,10841,3578720065,3578720070,5
0,802,10842,3578720065,3578720077,12
0,802,10843,3578720065,3578720078,13
0,802,10844,3578720065,3578720082,17
0,802,10845,3578720065,3578720083,18
0,802,10846,3578720065,3578720085,20
0,802,10847,3578720065,3578720091,26
0,802,10848,3578720065,3578720091,26
0,802,10849,3578720065,3578720093,28
0,802,10850,3578720065,3578720093,28
0,802,10851,3578720065,3578720094,29
0,802,10852,3578720065,3578720094,29
0,802,10853,3578720065,3578720095,30
0,802,10854,3578720065,3578720096,31
0,802,10855,3578720065,3578720097,32
0,802,10856,3578720065,3578720098,33
0,802,10857,3578720065,3578720100,35
0,802,10858,3578720065,3578720102,37
0,802,10859,3578720065,3578720103,38
0,802,10860,3578720065,3578720104,39
0,802,10861,3578720065,3578720104,39
0,802,10862,3578720065,3578720105,40
0,802,10863,3578720065,3578720105,40
0,802,10864,3578720065,3578720105,40
0,802,10865,3578720065,3578720108,43
0,802,10866,3578720065,3578720109,44
0,802,10867,3578720065,3578720112,47
0,802,10868,3578720065,3578720114,49
0,803,10869,3578720121,3578720121,0
0,803,10870,3578720121,3578720121,0
0,803,10871,3578720121,3578720121,0
0,803,10872,3578720121,3578720121,0
0,803,10873,3578720121,3578720121,0
0,803,10874,3578720121,3578720126,5
0,803,10875,3578720121,3578720126,5
0,803,10876,3578720121,3578720126,5
0,803,10877,3578720121,3578720127,6
0,803,10878,3578720121,3578720128,7
0,803,10879,3578720121,3578720129,8
0,803,10880,3578720121,3578720130,9
0,803,10881,3578720121,3578720131,10
0,803,10882,3578720121,3578720132,11
0,803,10883,3578720121,3578720134,13
0,803,10884,3578720121,3578720135,14
0,803,10885,3578720121,3578720139,18
0,803,10886,3578720121,3578720140,19
0,803,10887,3578720121,3578720141,20
0,803,10888,3578720121,3578720141,20
0,803,10889,3578720121,3578720142,21
0,803,10890,3578720121,3578720144,23
0,803,10891,3578720121,3578720145,24
0,803,10892,3578720121,3578720145,24
0,803,10893,3578720121,3578720145,24
0,803,10894,3578720121,3578720148,27
0,803,10895,3578720121,3578720152,31
0,803,10896,3578720121,3578720152,31
0,803,10897,3578720121,3578720154,33
0,803,10898,3578720121,3578720155,34
0,803,10899,3578720121,3578720156,35
0,803,10900,3578720121,3578720158,37
0,803,10901,3578720121,3578720158,37
0,803,10902,3578720121,3578720159,38
0,803,10903,3578720121,3578720161,40
0,803,10904,3578720121,3578720162,41
0,803,10905,3578720121,3578720163,42
0,803,10906,3578720121,3578720163,42
0,803,10907,3578720121,3578720164,43
0,803,10908,3578720121,3578720165,44
0,803,10909,3578720121,3578720168,47
0,803,10910,3578720121,3578720169,48
0,803,10911,3578720121,3578720169,48
0,804,10912,3578720176,3578720176,0
0,804,10913,3578720176,3578720176,0
0,804,10914,3578720176,3578720176,0
0,804,10915,3578720176,3578720176,0
0,804,10916,3578720176,3578720179,3
0,804,10917,3578720176,3578720180,4
0,804,10918,3578720176,3578720180,4
0,804,10919,3578720176,3578720182,6
0,804,10920,3578720176,3578720182,6
0,804,10921,3578720176,3578720184,8
0,804,10922,3578720176,3578720185,9
0,804,10923,3578720176,3578720186,10
0,804,10924,3578720176,3578720186,10
0,804,10925,3578720176,3578720189,13
0,804,10926,3578720176,3578720189,13
0,804,10927,3578720176,3578720191,15
0,804,10928,3578720176,3578720192,16
0,804,10929,3578720176,3578720196,20
0,804,10930,3578720176,3578720196,20
0,804,10931,3578720176,3578720197,21
0,804,10932,3578720176,3578720201,25
0,804,10933,3578720176,3578720202,26
0,804,10934,3578720176,3578720203,27
0,804,10935,3578720176,3578720205,29
0,804,10936,3578720176,3578720206,30
0,804,10937,3578720176,3578720206,30
0,804,10938,3578720176,3578720208,32
0,804,10939,3578720176,3578720212,36
0,804,10940,3578720176,3578720213,37
0,804,10941,3578720176,3578720215,39
0,804,10942,3578720176,3578720215,39
0,804,10943,3578720176,3578720216,40
0,804,10944,3578720176,3578720216,40
0,804,10945,3578720176,3578720217,41
0,804,10946,3578720176,3578720218,42
0,804,10947,3578720176,3578720218,42
0,804,10948,3578720176,3578720219,43
0,804,10949,3578720176,3578720221,45
0,804,10950,3578720176,3578720223,47
0,804,10951,3578720176,3578720224,48
0,805,10952,3578720231,3578720231,0
0,805,10953,3578720231,3578720231,0
0,805,10954,3578720231,3578720231,0
0,805,10955,3578720231,3578720231,0
0,805,10956,3578720231,3578720233,2
0,805,10957,3578720231,3578720235,4
0,805,10958,3578720231,3578720235,4
0,805,10959,3578720231,3578720236,5
0,805,10960,3578720231,3578720239,8
0,805,10961,3578720231,3578720240,9
0,805,10962,3578720231,3578720243,12
0,805,10963,3578720231,3578720243,12
0,805,10964,3578720231,3578720244,13
0,805,10965,3578720231,3578720250,19
0,805,10966,3578720231,3578720250,19
0,805,10967,3578720231,3578720253,22
0,805,10968,3578720231,3578720255,24
0,805,10969,3578720231,3578720256,25
0,805,10970,3578720231,3578720256,25
0,805,10971,3578720231,3578720259,28
0,805,10972,3578720231,3578720259,28
0,805,10973,3578720231,3578720263,32
0,805,10974,3578720231,3578720265,34
0,805,10975,3578720231,3578720266,35
0,805,10976,3578720231,3578720266,35
0,805,10977,3578720231,3578720267,36
0,805,10978,3578720231,3578720267,36
0,805,10979,3578720231,3578720267,36
0,805,10980,3578720231,3578720268,37
0,805,10981,3578720231,3578720269,38
0,805,10982,3578720231,3578720270,39
0,805,10983,3578720231,3578720270,39
0,805,10984,3578720231,3578720277,46
0,805,10985,3578720231,3578720279,48
0,806,10986,3578720287,3578720287,0
0,806,10987,3578720287,3578720287,0
0,806,10988,3578720287,3578720287,0
0,806,10989,3578720287,3578720291,4
0,806,10990,3578720287,3578720293,6
0,806,10991,3578720287,3578720293,6
0,806,10992,3578720287,3578720294,7
0,806,10993,3578720287,3578720294,7
0,806,10994,3578720287,3578720294,7
0,806,10995,3578720287,3578720294,7
0,806,10996,3578720287,3578720296,9
0,806,10997,3578720287,3578720296,9
0,806,10998,3578720287,3578720297,10
0,806,10999,3578720287,3578720298,11
0,806,11000,3578720287,3578720300,13
0,806,11001,3578720287,3578720302,15
0,806,11002,3578720287,3578720303,16
0,806,11003,3578720287,3578720304,17
0,806,11004,3578720287,3578720305,18
0,806,11005,3578720287,3578720305,18
0,806,11006,3578720287,3578720305,18
0,806,11007,3578720287,3578720305,18
0,806,11008,3578720287,3578720308,21
0,806,11009,3578720287,3578720310,23
0,806,11010,3578720287,3578720312,25
0,806,11011,3578720287,3578720312,25
0,806,11012,3578720287,3578720316,29
0,806,11013,3578720287,3578720317,30
0,806,11014,3578720287,3578720319,32
0,806,11015,3578720287,3578720320,33
0,806,11016,3578720287,3578720324,37
0,806,11017,3578720287,3578720326,39
0,806,11018,3578720287,3578720326,39
0,806,11019,3578720287,3578720326,39
0,806,11020,3578720287,3578720326,39
0,806,11021,3578720287,3578720329,42
0,806,11022,3578720287,3578720329,42
0,806,11023,3578720287,3578720329,42
0,806,11024,3578720287,3578720331,44
0,806,11025,3578720287,3578720331,44
0,806,11026,3578720287,3578720332,45
0,806,11027,3578720287,3578720333,46
0,806,11028,3578720287,3578720336,49
0,807,11029,3578720343,3578720343,0
0,807,11030,3578720343,3578720343,0
0,807,11031,3578720343,3578720343,0
0,807,11032,3578720343,3578720343,0
0,807,11033,3578720343,3578720343,0
0,807,11034,3578720343,3578720344,1
0,807,11035,3578720343,3578720344,1
0,807,11036,3578720343,3578720345,2
0,807,11037,3578720343,3578720346,3
0,807,11038,3578720343,3578720348,5
0,807,11039,3578720343,3578720351,8
0,807,11040,3578720343,3578720353,10
0,807,11041,3578720343,3578720354,11
0,807,11042,3578720343,3578720355,12
0,807,11043,3578720343,3578720356,13
0,807,11044,3578720343,3578720358,15
0,807,11045,3578720343,3578720359,16
0,807,11046,3578720343,3578720359,16
0,807,11047,3578720343,3578720360,17
0,807,11048,3578720343,3578720361,18
0,807,11049,3578720343,3578720362,19
0,807,11050,3578720343,3578720363,20
0,807,11051,3578720343,3578720363,20
0,807,11052,3578720343,3578720364,21
0,807,11053,3578720343,3578720365,22
0,807,11054,3578720343,3578720369,26
0,807,11055,3578720343,3578720369,26
0,807,11056,3578720343,3578720369,26
0,807,11057,3578720343,3578720371,28
0,807,11058,3578720343,3578720373,30
0,807,11059,3578720343,3578720373,30
0,807,11060,3578720343,3578720373,30
0,807,11061,3578720343,3578720375,32
0,807,11062,3578720343,3578720376,33
0,807,11063,3578720343,3578720379,36
0,807,11064,3578720343,3578720380,37
0,807,11065,3578720343,3578720381,38
0,807,11066,3578720343,3578720382,39
0,807,11067,3578720343,3578720383,40
0,807,11068,3578720343,3578720384,41
0,807,11069,3578720343,3578720386,43
0,807,11070,3578720343,3578720387,44
0,807,11071,3578720343,3578720387,44
0,807,11072,3578720343,3578720388,45
0,807,11073,3578720343,3578720390,47
0,807,11074,3578720343,3578720391,48
0,807,11075,3578720343,3578720393,50
0,808,11076,3578720397,3578720397,0
0,808,11077,3578720397,3578720397,0
0,808,11078,3578720397,3578720397,0
0,808,11079,3578720397,3578720403,6
0,808,11080,3578720397,3578720404,7
0,808,11081,3578720397,3578720405,8
0,808,11082,3578720397,3578720405,8
0,808,11083,3578720397,3578720407,10
0,808,11084,3578720397,3578720408,11
0,808,11085,3578720397,3578720410,13
0,808,11086,3578720397,3578720412,15
0,808,11087,3578720397,3578720413,16
0,808,11088,3578720397,3578720415,18
0,808,11089,3578720397,3578720415,18
0,808,11090,3578720397,3578720416,19
0,808,11091,3578720397,3578720416,19
0,808,11092,3578720397,3578720416,19
0,808,11093,3578720397,3578720418,21
0,808,11094,3578720397,3578720420,23
0,808,11095,3578720397,3578720423,26
0,808,11096,3578720397,3578720424,27
0,808,11097,3578720397,3578720424,27
0,808,11098,3578720397,3578720428,31
0,808,11099,3578720397,3578720431,34
0,808,11100,3578720397,3578720431,34
0,808,11101,3578720397,3578720432,35
0,808,11102,3578720397,3578720432,35
0,808,11103,3578720397,3578720435,38
0,808,11104,3578720397,3578720436,39
0,808,11105,3578720397,3578720436,39
0,808,11106,3578720397,3578720439,42
0,808,11107,3578720397,3578720440,43
0,808,11108,3578720397,3578720440,43
0,808,11109,3578720397,3578720444,47
0,808,11110,3578720397,3578720444,47
0,808,11111,3578720397,3578720445,48
0,809,11112,3578720452,3578720452,0
0,809,11113,3578720452,3578720452,0
0,809,11114,3578720452,3578720454,2
0,809,11115,3578720452,3578720455,3
0,809,11116,3578720452,3578720456,4
0,809,11117,3578720452,3578720457,5
0,809,11118,3578720452,3578720459,7
0,809,11119,3578720452,3578720463,11
0,809,11120,3578720452,3578720463,11
0,809,11121,3578720452,3578720465,13
0,809,11122,3578720452,3578720466,14
0,809,11123,3578720452,3578720467,15
0,809,11124,3578720452,3578720467,15
0,809,11125,3578720452,3578720468,16
0,809,11126,3578720452,3578720468,16
0,809,11127,3578720452,3578720468,16
0,809,11128,3578720452,3578720469,17
0,809,11129,3578720452,3578720469,17
0,809,11130,3578720452,3578720474,22
0,809,11131,3578720452,3578720478,26
0,809,11132,3578720452,3578720480,28
0,809,11133,3578720452,3578720482,30
0,809,11134,3578720452,3578720483,31
0,809,11135,3578720452,3578720485,33
0,809,11136,3578720452,3578720491,39
0,809,11137,3578720452,3578720493,41
0,809,11138,3578720452,3578720493,41
0,809,11139,3578720452,3578720494,42
0,809,11140,3578720452,3578720494,42
0,809,11141,3578720452,3578720494,42
0,809,11142,3578720452,3578720495,43
0,809,11143,3578720452,3578720496,44
0,809,11144,3578720452,3578720496,44
0,809,11145,3578720452,3578720497,45
0,809,11146,3578720452,3578720498,46
0,809,11147,3578720452,3578720500,48
0,810,11148,3578720506,3578720506,0
0,810,11149,3578720506,3578720506,0
0,810,11150,3578720506,3578720506,0
0,810,11151,3578720506,3578720506,0
0,810,11152,3578720506,3578720506,0
0,810,11153,3578720506,3578720506,0
0,810,11154,3578720506,3578720506,0
0,810,11155,3578720506,3578720507,1
0,810,11156,3578720506,3578720509,3
0,810,11157,3578720506,3578720511,5
0,810,11158,3578720506,3578720511,5
0,810,11159,3578720506,3578720514,8
0,810,11160,3578720506,3578720514,8
0,810,11161,3578720506,3578720516,10
0,810,11162,3578720506,3578720519,13
0,810,11163,3578720506,3578720520,14
0,810,11164,3578720506,3578720523,17
0,810,11165,3578720506,3578720524,18
0,810,11166,3578720506,3578720525,19
0,810,11167,3578720506,3578720525,19
0,810,11168,3578720506,3578720525,19
0,810,11169,3578720506,3578720527,21
0,810,11170,3578720506,3578720527,21
0,810,11171,3578720506,3578720528,22
0,810,11172,3578720506,3578720530,24
0,810,11173,3578720506,3578720530,24
0,810,11174,3578720506,3578720532,26
0,810,11175,3578720506,3578720532,26
0,810,11176,3578720506,3578720535,29
0,810,11177,3578720506,3578720539,33
0,810,11178,3578720506,3578720539,33
0,810,11179,3578720506,3578720539,33
0,810,11180,3578720506,3578720540,34
0,810,11181,3578720506,3578720542,36
0,810,11182,3578720506,3578720543,37
0,810,11183,3578720506,3578720543,37
0,810,11184,3578720506,3578720544,38
0,810,11185,3578720506,3578720544,38
0,810,11186,3578720506,3578720545,39
0,810,11187,3578720506,3578720548,42
0,810,11188,3578720506,3578720551,45
0,810,11189,3578720506,3578720552,46
0,810,11190,3578720506,3578720554,48
0,810,11191,3578720506,3578720555,49
0,810,11192,3578720506,3578720555,49
0,811,11193,3578720561,3578720561,0
0,811,11194,3578720561,3578720561,0
0,811,11195,3578720561,3578720561,0
0,811,11196,3578720561,3578720561,0
0,811,11197,3578720561,3578720561,0
0,811,11198,3578720561,3578720562,1
0,811,11199,3578720561,3578720562,1
0,811,11200,3578720561,3578720562,1
0,811,11201,3578720561,3578720563,2
0,811,11202,3578720561,3578720564,3
0,811,11203,3578720561,3578720567,6
0,811,11204,3578720561,3578720568,7
0,811,11205,3578720561,3578720569,8
0,811,11206,3578720561,3578720570,9
0,811,11207,3578720561,3578720571,10
0,811,11208,3578720561,3578720571,10
0,811,11209,3578720561,3578720572,11
0,811,11210,3578720561,3578720574,13
0,811,11211,3578720561,3578720575,14
0,811,11212,3578720561,3578720576,15
0,811,11213,3578720561,3578720579,18
0,811,11214,3578720561,3578720579,18
0,811,11215,3578720561,3578720580,19
0,811,11216,3578720561,3578720581,20
0,811,11217,3578720561,3578720582,21
0,811,11218,3578720561,3578720583,22
0,811,11219,3578720561,3578720584,23
0,811,11220,3578720561,3578720585,24
0,811,11221,3578720561,3578720586,25
0,811,11222,3578720561,3578720587,26
0,811,11223,3578720561,3578720589,28
0,811,11224,3578720561,3578720590,29
0,811,11225,3578720561,3578720592,31
0,811,11226,3578720561,3578720595,34
0,811,11227,3578720561,3578720595,34
0,811,11228,3578720561,3578720595,34
0,811,11229,3578720561,3578720601,40
0,811,11230,3578720561,3578720603,42
0,811,11231,3578720561,3578720603,42
0,811,11232,3578720561,3578720604,43
0,811,11233,3578720561,3578720605,44
0,811,11234,3578720561,3578720605,44
0,811,11235,3578720561,3578720607,46
0,811,11236,3578720561,3578720609,48
0,812,11237,3578720616,3578720616,0
0,812,11238,3578720616,3578720616,0
0,812,11239,3578720616,3578720616,0
0,812,11240,3578720616,3578720616,0
0,812,11241,3578720616,3578720616,0
0,812,11242,3578720616,3578720616,0
0,812,11243,3578720616,3578720616,0
0,812,11244,3578720616,3578720618,2
0,812,11245,3578720616,3578720618,2
0,812,11246,3578720616,3578720621,5
0,812,11247,3578720616,3578720622,6
0,812,11248,3578720616,3578720623,7
0,812,11249,3578720616,3578720623,7
0,812,11250,3578720616,3578720628,12
0,812,11251,3578720616,3578720628,12
0,812,11252,3578720616,3578720631,15
0,812,11253,3578720616,3578720631,15
0,812,11254,3578720616,3578720631,15
0,812,11255,3578720616,3578720633,17
0,812,11256,3578720616,3578720634,18
0,812,11257,3578720616,3578720636,20
0,812,11258,3578720616,3578720636,20
0,812,11259,3578720616,3578720639,23
0,812,11260,3578720616,3578720639,23
0,812,11261,3578720616,3578720639,23
0,812,11262,3578720616,3578720643,27
0,812,11263,3578720616,3578720643,27
0,812,11264,3578720616,3578720643,27
0,812,11265,3578720616,3578720648,32
0,812,11266,3578720616,3578720649,33
0,812,11267,3578720616,3578720649,33
0,812,11268,3578720616,3578720653,37
0,812,11269,3578720616,3578720653,37
0,812,11270,3578720616,3578720656,40
0,812,11271,3578720616,3578720656,40
0,812,11272,3578720616,3578720658,42
0,812,11273,3578720616,3578720662,46
0,812,11274,3578720616,3578720663,47
0,812,11275,3578720616,3578720664,48
0,812,11276,3578720616,3578720665,49
0,812,11277,3578720616,3578720666,50
0,813,11278,3578720671,3578720671,0
0,813,11279,3578720671,3578720671,0
0,813,11280,3578720671,3578720671,0
0,813,11281,3578720671,3578720671,0
0,813,11282,3578720671,3578720671,0
0,813,11283,3578720671,3578720673,2
0,813,11284,3578720671,3578720678,7
0,813,11285,3578720671,3578720678,7
0,813,11286,3578720671,3578720680,9
0,813,11287,3578720671,3578720682,11
0,813,11288,3578720671,3578720683,12
0,813,11289,3578720671,3578720685,14
0,813,11290,3578720671,3578720691,20
0,813,11291,3578720671,3578720693,22
0,813,11292,3578720671,3578720693,22
0,813,11293,3578720671,3578720694,23
0,813,11294,3578720671,3578720694,23
0,813,11295,3578720671,3578720694,23
0,813,11296,3578720671,3578720696,25
0,813,11297,3578720671,3578720696,25
0,813,11298,3578720671,3578720698,27
0,813,11299,3578720671,3578720698,27
0,813,11300,3578720671,3578720700,29
0,813,11301,3578720671,3578720702,31
0,813,11302,3578720671,3578720703,32
0,813,11303,3578720671,3578720705,34
0,813,11304,3578720671,3578720706,35
0,813,11305,3578720671,3578720706,35
0,813,11306,3578720671,3578720706,35
0,813,11307,3578720671,3578720706,35
0,813,11308,3578720671,3578720707,36
0,813,11309,3578720671,3578720709,38
0,813,11310,3578720671,3578720710,39
0,813,11311,3578720671,3578720711,40
0,813,11312,3578720671,3578720714,43
0,813,11313,3578720671,3578720714,43
0,813,11314,3578720671,3578720716,45
0,813,11315,3578720671,3578720720,49
0,813,11316,3578720671,3578720720,49
0,813,11317,3578720671,3578720720,49
0,814,11318,3578720727,3578720727,0
0,814,11319,3578720727,3578720727,0
0,814,11320,3578720727,3578720727,0
0,814,11321,3578720727,3578720727,0
0,814,11322,3578720727,3578720727,0
0,814,11323,3578720727,3578720727,0
0,814,11324,3578720727,3578720728,1
0,814,11325,3578720727,3578720728,1
0,814,11326,3578720727,3578720728,1
0,814,11327,3578720727,3578720729,2
0,814,11328,3578720727,3578720730,3
0,814,11329,3578720727,3578720731,4
0,814,11330,3578720727,3578720732,5
0,814,11331,3578720727,3578720734,7
0,814,11332,3578720727,3578720739,12
0,814,11333,3578720727,3578720740,13
0,814,11334,3578720727,3578720742,15
0,814,11335,3578720727,3578720743,16
0,814,11336,3578720727,3578720744,17
0,814,11337,3578720727,3578720744,17
0,814,11338,3578720727,3578720745,18
0,814,11339,3578720727,3578720745,18
0,814,11340,3578720727,3578720748,21
0,814,11341,3578720727,3578720751,24
0,814,11342,3578720727,3578720752,25
0,814,11343,3578720727,3578720753,26
0,814,11344,3578720727,3578720755,28
0,814,11345,3578720727,3578720755,28
0,814,11346,3578720727,3578720758,31
0,814,11347,3578720727,3578720758,31
0,814,11348,3578720727,3578720759,32
0,814,11349,3578720727,3578720760,33
0,814,11350,3578720727,3578720762,35
0,814,11351,3578720727,3578720762,35
0,814,11352,3578720727,3578720763,36
0,814,11353,3578720727,3578720764,37
0,814,11354,3578720727,3578720764,37
0,814,11355,3578720727,3578720768,41
0,814,11356,3578720727,3578720768,41
0,814,11357,3578720727,3578720769,42
0,814,11358,3578720727,3578720770,43
0,814,11359,3578720727,3578720771,44
0,814,11360,3578720727,3578720773,46
0,814,11361,3578720727,3578720773,46
0,814,11362,3578720727,3578720773,46
0,814,11363,3578720727,3578720774,47
0,814,11364,3578720727,3578720775,48
0,814,11365,3578720727,3578720776,49
0,815,11366,3578720783,3578720783,0
0,815,11367,3578720783,3578720783,0
0,815,11368,3578720783,3578720783,0
0,815,11369,3578720783,3578720783,0
0,815,11370,3578720783,3578720783,0
0,815,11371,3578720783,3578720783,0
0,815,11372,3578720783,3578720783,0
0,815,11373,3578720783,3578720783,0
0,815,11374,3578720783,3578720785,2
0,815,11375,3578720783,3578720785,2
0,815,11376,3578720783,3578720787,4
0,815,11377,3578720783,3578720787,4
0,815,11378,3578720783,3578720788,5
0,815,11379,3578720783,3578720790,7
0,815,11380,3578720783,3578720792,9
0,815,11381,3578720783,3578720794,11
0,815,11382,3578720783,3578720795,12
0,815,11383,3578720783,3578720796,13
0,815,11384,3578720783,3578720801,18
0,815,11385,3578720783,3578720801,18
0,815,11386,3578720783,3578720803,20
0,815,11387,3578720783,3578720804,21
0,815,11388,3578720783,3578720804,21
0,815,11389,3578720783,3578720805,22
0,815,11390,3578720783,3578720805,22
0,815,11391,3578720783,3578720807,24
0,815,11392,3578720783,3578720810,27
0,815,11393,3578720783,3578720811,28
0,815,11394,3578720783,3578720812,29
0,815,11395,3578720783,3578720814,31
0,815,11396,3578720783,3578720815,32
0,815,11397,3578720783,3578720815,32
0,815,11398,3578720783,3578720815,32
0,815,11399,3578720783,3578720816,33
0,815,11400,3578720783,3578720818,35
0,815,11401,3578720783,3578720819,36
0,815,11402,3578720783,3578720820,37
0,815,11403,3578720783,3578720821,38
0,815,11404,3578720783,3578720823,40
0,815,11405,3578720783,3578720824,41
0,815,11406,3578720783,3578720824,41
0,815,11407,3578720783,3578720827,44
0,815,11408,3578720783,3578720830,47
0,815,11409,3578720783,3578720831,48
0,815,11410,3578720783,3578720831,48
0,815,11411,3578720783,3578720831,48
0,816,11412,3578720838,3578720838,0
0,816,11413,3578720838,3578720838,0
0,816,11414,3578720838,3578720838,0
0,816,11415,3578720838,3578720838,0
0,816,11416,3578720838,3578720839,1
0,816,11417,3578720838,3578720839,1
0,816,11418,3578720838,3578720839,1
0,816,11419,3578720838,3578720843,5
0,816,11420,3578720838,3578720844,6
0,816,11421,3578720838,3578720845,7
0,816,11422,3578720838,3578720849,11
0,816,11423,3578720838,3578720849,11
0,816,11424,3578720838,3578720850,12
0,816,11425,3578720838,3578720853,15
0,816,11426,3578720838,3578720854,16
0,816,11427,3578720838,3578720855,17
0,816,11428,3578720838,3578720857,19
0,816,11429,3578720838,3578720857,19
0,816,11430,3578720838,3578720860,22
0,816,11431,3578720838,3578720862,24
0,816,11432,3578720838,3578720863,25
0,816,11433,3578720838,3578720864,26
0,816,11434,3578720838,3578720865,27
0,816,11435,3578720838,3578720866,28
0,816,11436,3578720838,3578720866,28
0,816,11437,3578720838,3578720866,28
0,816,11438,3578720838,3578720866,28
0,816,11439,3578720838,3578720869,31
0,816,11440,3578720838,3578720869,31
0,816,11441,3578720838,3578720870,32
0,816,11442,3578720838,3578720874,36
0,816,11443,3578720838,3578720877,39
0,816,11444,3578720838,3578720880,42
0,816,11445,3578720838,3578720880,42
0,816,11446,3578720838,3578720883,45
0,816,11447,3578720838,3578720885,47
0,817,11448,3578720893,3578720893,0
0,817,11449,3578720893,3578720893,0
0,817,11450,3578720893,3578720893,0
0,817,11451,3578720893,3578720893,0
0,817,11452,3578720893,3578720894,1
0,817,11453,3578720893,3578720895,2
0,817,11454,3578720893,3578720896,3
0,817,11455,3578720893,3578720896,3
0,817,11456,3578720893,3578720896,3
0,817,11457,3578720893,3578720897,4
0,817,11458,3578720893,3578720898,5
0,817,11459,3578720893,3578720900,7
0,817,11460,3578720893,3578720902,9
0,817,11461,3578720893,3578720903,10
0,817,11462,3578720893,3578720905,12
0,817,11463,3578720893,3578720906,13
0,817,11464,3578720893,3578720906,13
0,817,11465,3578720893,3578720907,14
0,817,11466,3578720893,3578720909,16
0,817,11467,3578720893,3578720910,17
0,817,11468,3578720893,3578720911,18
0,817,11469,3578720893,3578720913,20
0,817,11470,3578720893,3578720915,22
0,817,11471,3578720893,3578720916,23
0,817,11472,3578720893,3578720920,27
0,817,11473,3578720893,3578720920,27
0,817,11474,3578720893,3578720920,27
0,817,11475,3578720893,3578720923,30
0,817,11476,3578720893,3578720925,32
0,817,11477,3578720893,3578720925,32
0,817,11478,3578720893,3578720926,33
0,817,11479,3578720893,3578720926,33
0,817,11480,3578720893,3578720927,34
0,817,11481,3578720893,3578720929,36
0,817,11482,3578720893,3578720930,37
0,817,11483,3578720893,3578720930,37
0,817,11484,3578720893,3578720931,38
0,817,11485,3578720893,3578720932,39
0,817,11486,3578720893,3578720933,40
0,817,11487,3578720893,3578720935,42
0,817,11488,3578720893,3578720939,46
0,817,11489,3578720893,3578720940,47
0,817,11490,3578720893,3578720940,47
0,817,11491,3578720893,3578720940,47
0,817,11492,3578720893,3578720942,49
0,817,11493,3578720893,3578720943,50
0,818,11494,3578720948,3578720948,0
0,818,11495,3578720948,3578720948,0
0,818,11496,3578720948,3578720948,0
0,818,11497,3578720948,3578720948,0
0,818,11498,3578720948,3578720948,0
0,818,11499,3578720948,3578720950,2
0,818,11500,3578720948,3578720951,3
0,818,11501,3578720948,3578720952,4
0,818,11502,3578720948,3578720954,6
0,818,11503,3578720948,3578720955,7
0,818,11504,3578720948,3578720957,9
0,818,11505,3578720948,3578720958,10
0,818,11506,3578720948,3578720959,11
0,818,11507,3578720948,3578720961,13
0,818,11508,3578720948,3578720962,14
0,818,11509,3578720948,3578720962,14
0,818,11510,3578720948,3578720963,15
0,818,11511,3578720948,3578720964,16
0,818,11512,3578720948,3578720964,16
0,818,11513,3578720948,3578720968,20
0,818,11514,3578720948,3578720968,20
0,818,11515,3578720948,3578720969,21
0,818,11516,3578720948,3578720970,22
0,818,11517,3578720948,3578720972,24
0,818,11518,3578720948,3578720972,24
0,818,11519,3578720948,3578720974,26
0,818,11520,3578720948,3578720974,26
0,818,11521,3578720948,3578720974,26
0,818,11522,3578720948,3578720975,27
0,818,11523,3578720948,3578720979,31
0,818,11524,3578720948,3578720979,31
0,818,11525,3578720948,3578720980,32
0,818,11526,3578720948,3578720980,32
0,818,11527,3578720948,3578720981,33
0,818,11528,3578720948,3578720983,35
0,818,11529,3578720948,3578720983,35
0,818,11530,3578720948,3578720984,36
0,818,11531,3578720948,3578720985,37
0,818,11532,3578720948,3578720986,38
0,818,11533,3578720948,3578720987,39
0,818,11534,3578720948,3578720988,40
0,818,11535,3578720948,3578720989,41
0,818,11536,3578720948,3578720990,42
0,818,11537,3578720948,3578720992,44
0,818,11538,3578720948,3578720995,47
0,818,11539,3578720948,3578720995,47
0,818,11540,3578720948,3578720996,48
0,819,11541,3578721004,3578721004,0
0,819,11542,3578721004,3578721004,0
0,819,11543,3578721004,3578721004,0
0,819,11544,3578721004,3578721005,1
0,819,11545,3578721004,3578721005,1
0,819,11546,3578721004,3578721005,1
0,819,11547,3578721004,3578721005,1
0,819,11548,3578721004,3578721010,6
0,819,11549,3578721004,3578721012,8
0,819,11550,3578721004,3578721013,9
0,819,11551,3578721004,3578721015,11
0,819,11552,3578721004,3578721015,11
0,819,11553,3578721004,3578721016,12
0,819,11554,3578721004,3578721016,12
0,819,11555,3578721004,3578721018,14
0,819,11556,3578721004,3578721019,15
0,819,11557,3578721004,3578721020,16
0,819,11558,3578721004,3578721021,17
0,819,11559,3578721004,3578721023,19
0,819,11560,3578721004,3578721023,19
0,819,11561,3578721004,3578721028,24
0,819,11562,3578721004,3578721030,26
0,819,11563,3578721004,3578721031,27
0,819,11564,3578721004,3578721032,28
0,819,11565,3578721004,3578721033,29
0,819,11566,3578721004,3578721034,30
0,819,11567,3578721004,3578721036,32
0,819,11568,3578721004,3578721037,33
0,819,11569,3578721004,3578721037,33
0,819,11570,3578721004,3578721039,35
0,819,11571,3578721004,3578721039,35
0,819,11572,3578721004,3578721044,40
0,819,11573,3578721004,3578721045,41
0,819,11574,3578721004,3578721049,45
0,819,11575,3578721004,3578721049,45
0,819,11576,3578721004,3578721049,45
0,819,11577,3578721004,3578721053,49
0,820,11578,3578721059,3578721059,0
0,820,11579,3578721059,3578721059,0
0,820,11580,3578721059,3578721059,0
0,820,11581,3578721059,3578721060,1
0,820,11582,3578721059,3578721062,3
0,820,11583,3578721059,3578721063,4
0,820,11584,3578721059,3578721064,5
0,820,11585,3578721059,3578721065,6
0,820,11586,3578721059,3578721066,7
0,820,11587,3578721059,3578721067,8
0,820,11588,3578721059,3578721067,8
0,820,11589,3578721059,3578721069,10
0,820,11590,3578721059,3578721069,10
0,820,11591,3578721059,3578721069,10
0,820,11592,3578721059,3578721074,15
0,820,11593,3578721059,3578721077,18
0,820,11594,3578721059,3578721080,21
0,820,11595,3578721059,3578721083,24
0,820,11596,3578721059,3578721083,24
0,820,11597,3578721059,3578721084,25
0,820,11598,3578721059,3578721086,27
0,820,11599,3578721059,3578721092,33
0,820,11600,3578721059,3578721092,33
0,820,11601,3578721059,3578721093,34
0,820,11602,3578721059,3578721093,34
0,820,11603,3578721059,3578721094,35
0,820,11604,3578721059,3578721095,36
0,820,11605,3578721059,3578721096,37
0,820,11606,3578721059,3578721096,37
0,820,11607,3578721059,3578721097,38
0,820,11608,3578721059,3578721097,38
0,820,11609,3578721059,3578721098,39
0,820,11610,3578721059,3578721100,41
0,820,11611,3578721059,3578721104,45
0,820,11612,3578721059,3578721105,46
0,820,11613,3578721059,3578721106,47
0,820,11614,3578721059,3578721106,47
0,820,11615,3578721059,3578721108,49
0,821,11616,3578721115,3578721115,0
0,821,11617,3578721115,3578721115,0
0,821,11618,3578721115,3578721115,0
0,821,11619,3578721115,3578721115,0
0,821,11620,3578721115,3578721115,0
0,821,11621,3578721115,3578721116,1
0,821,11622,3578721115,3578721119,4
0,821,11623,3578721115,3578721120,5
0,821,11624,3578721115,3578721120,5
0,821,11625,3578721115,3578721123,8
0,821,11626,3578721115,3578721126,11
0,821,11627,3578721115,3578721126,11
0,821,11628,3578721115,3578721126,11
0,821,11629,3578721115,3578721126,11
0,821,11630,3578721115,3578721127,12
0,821,11631,3578721115,3578721128,13
0,821,11632,3578721115,3578721129,14
0,821,11633,3578721115,3578721130,15
0,821,11634,3578721115,3578721130,15
0,821,11635,3578721115,3578721131,16
0,821,11636,3578721115,3578721133,18
0,821,11637,3578721115,3578721134,19
0,821,11638,3578721115,3578721135,20
0,821,11639,3578721115,3578721139,24
0,821,11640,3578721115,3578721140,25
0,821,11641,3578721115,3578721141,26
0,821,11642,3578721115,3578721141,26
0,821,11643,3578721115,3578721142,27
0,821,11644,3578721115,3578721143,28
0,821,11645,3578721115,3578721144,29
0,821,11646,3578721115,3578721145,30
0,821,11647,3578721115,3578721145,30
0,821,11648,3578721115,3578721149,34
0,821,11649,3578721115,3578721151,36
0,821,11650,3578721115,3578721152,37
0,821,11651,3578721115,3578721152,37
0,821,11652,3578721115,3578721154,39
0,821,11653,3578721115,3578721154,39
0,821,11654,3578721115,3578721155,40
0,821,11655,3578721115,3578721157,42
0,821,11656,3578721115,3578721158,43
0,821,11657,3578721115,3578721159,44
0,821,11658,3578721115,3578721161,46
0,821,11659,3578721115,3578721162,47
0,821,11660,3578721115,3578721162,47
0,821,11661,3578721115,3578721164,49
0,821,11662,3578721115,3578721164,49
0,821,11663,3578721115,3578721165,50
0,822,11664,3578721171,3578721171,0
0,822,11665,3578721171,3578721171,0
0,822,11666,3578721171,3578721171,0
0,822,11667,3578721171,3578721171,0
0,822,11668,3578721171,3578721172,1
0,822,11669,3578721171,3578721173,2
0,822,11670,3578721171,3578721173,2
0,822,11671,3578721171,3578721174,3
0,822,11672,3578721171,3578721176,5
0,822,11673,3578721171,3578721176,5
0,822,11674,3578721171,3578721179,8
0,822,11675,3578721171,3578721179,8
0,822,11676,3578721171,3578721179,8
0,822,11677,3578721171,3578721180,9
0,822,11678,3578721171,3578721182,11
0,822,11679,3578721171,3578721182,11
0,822,11680,3578721171,3578721184,13
0,822,11681,3578721171,3578721185,14
0,822,11682,3578721171,3578721186,15
0,822,11683,3578721171,3578721187,16
0,822,11684,3578721171,3578721187,16
0,822,11685,3578721171,3578721188,17
0,822,11686,3578721171,3578721190,19
0,822,11687,3578721171,3578721192,21
0,822,11688,3578721171,3578721195,24
0,822,11689,3578721171,3578721196,25
0,822,11690,3578721171,3578721197,26
0,822,11691,3578721171,3578721201,30
0,822,11692,3578721171,3578721203,32
0,822,11693,3578721171,3578721203,32
0,822,11694,3578721171,3578721205,34
0,822,11695,3578721171,3578721206,35
0,822,11696,3578721171,3578721206,35
0,822,11697,3578721171,3578721208,37
0,822,11698,3578721171,3578721210,39
0,822,11699,3578721171,3578721212,41
0,822,11700,3578721171,3578721212,41
0,822,11701,3578721171,3578721215,44
0,822,11702,3578721171,3578721216,45
0,822,11703,3578721171,3578721217,46
0,822,11704,3578721171,3578721217,46
0,822,11705,3578721171,3578721219,48
0,822,11706,3578721171,3578721220,49
0,823,11707,3578721226,3578721226,0
0,823,11708,3578721226,3578721226,0
0,823,11709,3578721226,3578721226,0
0,823,11710,3578721226,3578721228,2
0,823,11711,3578721226,3578721231,5
0,823,11712,3578721226,3578721231,5
0,823,11713,3578721226,3578721232,6
0,823,11714,3578721226,3578721234,8
0,823,11715,3578721226,3578721236,10
0,823,11716,3578721226,3578721236,10
0,823,11717,3578721226,3578721236,10
0,823,11718,3578721226,3578721237,11
0,823,11719,3578721226,3578721239,13
0,823,11720,3578721226,3578721239,13
0,823,11721,3578721226,3578721239,13
0,823,11722,3578721226,3578721243,17
0,823,11723,3578721226,3578721246,20
0,823,11724,3578721226,3578721248,22
0,823,11725,3578721226,3578721250,24
0,823,11726,3578721226,3578721250,24
0,823,11727,3578721226,3578721253,27
0,823,11728,3578721226,3578721255,29
0,823,11729,3578721226,3578721257,31
0,823,11730,3578721226,3578721258,32
0,823,11731,3578721226,3578721260,34
0,823,11732,3578721226,3578721263,37
0,823,11733,3578721226,3578721263,37
0,823,11734,3578721226,3578721265,39
0,823,11735,3578721226,3578721265,39
0,823,11736,3578721226,3578721266,40
0,823,11737,3578721226,3578721266,40
0,823,11738,3578721226,3578721267,41
0,823,11739,3578721226,3578721267,41
0,823,11740,3578721226,3578721269,43
0,823,11741,3578721226,3578721270,44
0,823,11742,3578721226,3578721270,44
0,823,11743,3578721226,3578721273,47
0,824,11744,3578721281,3578721281,0
0,824,11745,3578721281,3578721281,0
0,824,11746,3578721281,3578721283,2
0,824,11747,3578721281,3578721283,2
0,824,11748,3578721281,3578721286,5
0,824,11749,3578721281,3578721287,6
0,824,11750,3578721281,3578721292,11
0,824,11751,3578721281,3578721293,12
0,824,11752,3578721281,3578721293,12
0,824,11753,3578721281,3578721294,13
0,824,11754,3578721281,3578721294,13
0,824,11755,3578721281,3578721295,14
0,824,11756,3578721281,3578721296,15
0,824,11757,3578721281,3578721297,16
0,824,11758,3578721281,3578721298,17
0,824,11759,3578721281,3578721299,18
0,824,11760,3578721281,3578721300,19
0,824,11761,3578721281,3578721303,22
0,824,11762,3578721281,3578721304,23
0,824,11763,3578721281,3578721305,24
0,824,11764,3578721281,3578721306,25
0,824,11765,3578721281,3578721306,25
0,824,11766,3578721281,3578721307,26
0,824,11767,3578721281,3578721307,26
0,824,11768,3578721281,3578721308,27
0,824,11769,3578721281,3578721309,28
0,824,11770,3578721281,3578721310,29
0,824,11771,3578721281,3578721311,30
0,824,11772,3578721281,3578721314,33
0,824,11773,3578721281,3578721316,35
0,824,11774,3578721281,3578721316,35
0,824,11775,3578721281,3578721319,38
0,824,11776,3578721281,3578721319,38
0,824,11777,3578721281,3578721320,39
0,824,11778,3578721281,3578721323,42
0,824,11779,3578721281,3578721325,44
0,824,11780,3578721281,3578721325,44
0,824,11781,3578721281,3578721326,45
0,824,11782,3578721281,3578721326,45
0,824,11783,3578721281,3578721327,46
0,824,11784,3578721281,3578721328,47
0,824,11785,3578721281,3578721329,48
0,824,11786,3578721281,3578721330,49
0,825,11787,3578721336,3578721336,0
0,825,11788,3578721336,3578721336,0
0,825,11789,3578721336,3578721336,0
0,825,11790,3578721336,3578721338,2
0,825,11791,3578721336,3578721340,4
0,825,11792,3578721336,3578721341,5
0,825,11793,3578721336,3578721341,5
0,825,11794,3578721336,3578721341,5
0,825,11795,3578721336,3578721343,7
0,825,11796,3578721336,3578721343,7
0,825,11797,3578721336,3578721345,9
0,825,11798,3578721336,3578721345,9
0,825,11799,3578721336,3578721346,10
0,825,11800,3578721336,3578721349,13
0,825,11801,3578721336,3578721350,14
0,825,11802,3578721336,3578721352,16
0,825,11803,3578721336,3578721353,17
0,825,11804,3578721336,3578721354,18
0,825,11805,3578721336,3578721355,19
0,825,11806,3578721336,3578721356,20
0,825,11807,3578721336,3578721357,21
0,825,11808,3578721336,3578721358,22
0,825,11809,3578721336,3578721359,23
0,825,11810,3578721336,3578721362,26
0,825,11811,3578721336,3578721362,26
0,825,11812,3578721336,3578721363,27
0,825,11813,3578721336,3578721363,27
0,825,11814,3578721336,3578721364,28
0,825,11815,3578721336,3578721365,29
0,825,11816,3578721336,3578721368,32
0,825,11817,3578721336,3578721369,33
0,825,11818,3578721336,3578721370,34
0,825,11819,3578721336,3578721372,36
0,825,11820,3578721336,3578721372,36
0,825,11821,3578721336,3578721373,37
0,825,11822,3578721336,3578721374,38
0,825,11823,3578721336,3578721375,39
0,825,11824,3578721336,3578721376,40
0,825,11825,3578721336,3578721379,43
0,825,11826,3578721336,3578721379,43
0,825,11827,3578721336,3578721380,44
0,825,11828,3578721336,3578721381,45
0,825,11829,3578721336,3578721382,46
0,825,11830,3578721336,3578721385,49
0,826,11831,3578721393,3578721393,0
0,826,11832,3578721393,3578721393,0
0,826,11833,3578721393,3578721393,0
0,826,11834,3578721393,3578721393,0
0,826,11835,3578721393,3578721393,0
0,826,11836,3578721393,3578721393,0
0,826,11837,3578721393,3578721393,0
0,826,11838,3578721393,3578721393,0
0,826,11839,3578721393,3578721396,3
0,826,11840,3578721393,3578721396,3
0,826,11841,3578721393,3578721401,8
0,826,11842,3578721393,3578721403,10
0,826,11843,3578721393,3578721404,11
0,826,11844,3578721393,3578721406,13
0,826,11845,3578721393,3578721406,13
0,826,11846,3578721393,3578721406,13
0,826,11847,3578721393,3578721411,18
0,826,11848,3578721393,3578721412,19
0,826,11849,3578721393,3578721413,20
0,826,11850,3578721393,3578721415,22
0,826,11851,3578721393,3578721416,23
0,826,11852,3578721393,3578721416,23
0,826,11853,3578721393,3578721416,23
0,826,11854,3578721393,3578721417,24
0,826,11855,3578721393,3578721419,26
0,826,11856,3578721393,3578721419,26
0,826,11857,3578721393,3578721420,27
0,826,11858,3578721393,3578721421,28
0,826,11859,3578721393,3578721423,30
0,826,11860,3578721393,3578721424,31
0,826,11861,3578721393,3578721425,32
0,826,11862,3578721393,3578721429,36
0,826,11863,3578721393,3578721432,39
0,826,11864,3578721393,3578721432,39
0,826,11865,3578721393,3578721432,39
0,826,11866,3578721393,3578721434,41
0,826,11867,3578721393,3578721436,43
0,826,11868,3578721393,3578721436,43
0,826,11869,3578721393,3578721437,44
0,826,11870,3578721393,3578721439,46
0,826,11871,3578721393,3578721439,46
0,826,11872,3578721393,3578721439,46
0,826,11873,3578721393,3578721441,48
0,827,11874,3578721448,3578721448,0
0,827,11875,3578721448,3578721448,0
0,827,11876,3578721448,3578721450,2
0,827,11877,3578721448,3578721450,2
0,827,11878,3578721448,3578721451,3
0,827,11879,3578721448,3578721453,5
0,827,11880,3578721448,3578721455,7
0,827,11881,3578721448,3578721457,9
0,827,11882,3578721448,3578721459,11
0,827,11883,3578721448,3578721460,12
0,827,11884,3578721448,3578721463,15
0,827,11885,3578721448,3578721465,17
0,827,11886,3578721448,3578721466,18
0,827,11887,3578721448,3578721466,18
0,827,11888,3578721448,3578721466,18
0,827,11889,3578721448,3578721467,19
0,827,11890,3578721448,3578721468,20
0,827,11891,3578721448,3578721469,21
0,827,11892,3578721448,3578721469,21
0,827,11893,3578721448,3578721470,22
0,827,11894,3578721448,3578721474,26
0,827,11895,3578721448,3578721477,29
0,827,11896,3578721448,3578721480,32
0,827,11897,3578721448,3578721483,35
0,827,11898,3578721448,3578721483,35
0,827,11899,3578721448,3578721486,38
0,827,11900,3578721448,3578721487,39
0,827,11901,3578721448,3578721489,41
0,827,11902,3578721448,3578721492,44
0,827,11903,3578721448,3578721492,44
0,827,11904,3578721448,3578721493,45
0,827,11905,3578721448,3578721493,45
0,827,11906,3578721448,3578721494,46
0,827,11907,3578721448,3578721494,46
0,827,11908,3578721448,3578721496,48
0,827,11909,3578721448,3578721497,49
0,827,11910,3578721448,3578721497,49
0,827,11911,3578721448,3578721498,50
0,828,11912,3578721504,3578721504,0
0,828,11913,3578721504,3578721504,0
0,828,11914,3578721504,3578721504,0
0,828,11915,3578721504,3578721504,0
0,828,11916,3578721504,3578721505,1
0,828,11917,3578721504,3578721505,1
0,828,11918,3578721504,3578721505,1
0,828,11919,3578721504,3578721506,2
0,828,11920,3578721504,3578721506,2
0,828,11921,3578721504,3578721507,3
0,828,11922,3578721504,3578721509,5
0,828,11923,3578721504,3578721509,5
0,828,11924,3578721504,3578721510,6
0,828,11925,3578721504,3578721513,9
0,828,11926,3578721504,3578721515,11
0,828,11927,3578721504,3578721518,14
0,828,11928,3578721504,3578721519,15
0,828,11929,3578721504,3578721520,16
0,828,11930,3578721504,3578721522,18
0,828,11931,3578721504,3578721524,20
0,828,11932,3578721504,3578721525,21
0,828,11933,3578721504,3578721526,22
0,828,11934,3578721504,3578721526,22
0,828,11935,3578721504,3578721527,23
0,828,11936,3578721504,3578721527,23
0,828,11937,3578721504,3578721528,24
0,828,11938,3578721504,3578721530,26
0,828,11939,3578721504,3578721530,26
0,828,11940,3578721504,3578721532,28
0,828,11941,3578721504,3578721532,28
0,828,11942,3578721504,3578721534,30
0,828,11943,3578721504,3578721539,35
0,828,11944,3578721504,3578721539,35
0,828,11945,3578721504,3578721539,35
0,828,11946,3578721504,3578721540,36
0,828,11947,3578721504,3578721541,37
0,828,11948,3578721504,3578721543,39
0,828,11949,3578721504,3578721543,39
0,828,11950,3578721504,3578721545,41
0,828,11951,3578721504,3578721545,41
0,828,11952,3578721504,3578721546,42
0,828,11953,3578721504,3578721547,43
0,828,11954,3578721504,3578721550,46
0,828,11955,3578721504,3578721550,46
0,828,11956,3578721504,3578721551,47
0,828,11957,3578721504,3578721552,48
0,828,11958,3578721504,3578721554,50
0,829,11959,3578721560,3578721560,0
0,829,11960,3578721560,3578721560,0
0,829,11961,3578721560,3578721560,0
0,829,11962,3578721560,3578721560,0
0,829,11963,3578721560,3578721560,0
0,829,11964,3578721560,3578721561,1
0,829,11965,3578721560,3578721561,1
0,829,11966,3578721560,3578721561,1
0,829,11967,3578721560,3578721562,2
0,829,11968,3578721560,3578721563,3
0,829,11969,3578721560,3578721564,4
0,829,11970,3578721560,3578721568,8
0,829,11971,3578721560,3578721568,8
0,829,11972,3578721560,3578721569,9
0,829,11973,3578721560,3578721571,11
0,829,11974,3578721560,3578721572,12
0,829,11975,3578721560,3578721572,12
0,829,11976,3578721560,3578721575,15
0,829,11977,3578721560,3578721575,15
0,829,11978,3578721560,3578721578,18
0,829,11979,3578721560,3578721579,19
0,829,11980,3578721560,3578721580,20
0,829,11981,3578721560,3578721580,20
0,829,11982,3578721560,3578721581,21
0,829,11983,3578721560,3578721582,22
0,829,11984,3578721560,3578721585,25
0,829,11985,3578721560,3578721585,25
0,829,11986,3578721560,3578721586,26
0,829,11987,3578721560,3578721586,26
0,829,11988,3578721560,3578721590,30
0,829,11989,3578721560,3578721590,30
0,829,11990,3578721560,3578721594,34
0,829,11991,3578721560,3578721595,35
0,829,11992,3578721560,3578721595,35
0,829,11993,3578721560,3578721596,36
0,829,11994,3578721560,3578721601,41
0,829,11995,3578721560,3578721602,42
0,829,11996,3578721560,3578721603,43
0,829,11997,3578721560,3578721605,45
0,829,11998,3578721560,3578721605,45
0,829,11999,3578721560,3578721606,46
0,829,12000,3578721560,3578721606,46
0,829,12001,3578721560,3578721607,47
0,829,12002,3578721560,3578721609,49
0,830,12003,3578721615,3578721615,0
0,830,12004,3578721615,3578721616,1
0,830,12005,3578721615,3578721616,1
0,830,12006,3578721615,3578721616,1
0,830,12007,3578721615,3578721616,1
0,830,12008,3578721615,3578721616,1
0,830,12009,3578721615,3578721617,2
0,830,12010,3578721615,3578721618,3
0,830,12011,3578721615,3578721619,4
0,830,12012,3578721615,3578721619,4
0,830,12013,3578721615,3578721621,6
0,830,12014,3578721615,3578721622,7
0,830,12015,3578721615,3578721622,7
0,830,12016,3578721615,3578721623,8
0,830,12017,3578721615,3578721628,13
0,830,12018,3578721615,3578721631,16
0,830,12019,3578721615,3578721631,16
0,830,12020,3578721615,3578721631,16
0,830,12021,3578721615,3578721635,20
0,830,12022,3578721615,3578721635,20
0,830,12023,3578721615,3578721636,21
0,830,12024,3578721615,3578721638,23
0,830,12025,3578721615,3578721639,24
0,830,12026,3578721615,3578721639,24
0,830,12027,3578721615,3578721643,28
0,830,12028,3578721615,3578721643,28
0,830,12029,3578721615,3578721644,29
0,830,12030,3578721615,3578721645,30
0,830,12031,3578721615,3578721649,34
0,830,12032,3578721615,3578721649,34
0,830,12033,3578721615,3578721650,35
0,830,12034,3578721615,3578721652,37
0,830,12035,3578721615,3578721656,41
0,830,12036,3578721615,3578721658,43
0,830,12037,3578721615,3578721659,44
0,830,12038,3578721615,3578721662,47
0,830,12039,3578721615,3578721664,49
0,831,12040,3578721670,3578721670,0
0,831,12041,3578721670,3578721670,0
0,831,12042,3578721670,3578721670,0
0,831,12043,3578721670,3578721670,0
0,831,12044,3578721670,3578721670,0
0,831,12045,3578721670,3578721670,0
0,831,12046,3578721670,3578721670,0
0,831,12047,3578721670,3578721670,0
0,831,12048,3578721670,3578721674,4
0,831,12049,3578721670,3578721677,7
0,831,12050,3578721670,3578721680,10
0,831,12051,3578721670,3578721683,13
0,831,12052,3578721670,3578721683,13
0,831,12053,3578721670,3578721686,16
0,831,12054,3578721670,3578721687,17
0,831,12055,3578721670,3578721689,19
0,831,12056,3578721670,3578721692,22
0,831,12057,3578721670,3578721693,23
0,831,12058,3578721670,3578721693,23
0,831,12059,3578721670,3578721694,24
0,831,12060,3578721670,3578721694,24
0,831,12061,3578721670,3578721696,26
0,831,12062,3578721670,3578721697,27
0,831,12063,3578721670,3578721697,27
0,831,12064,3578721670,3578721698,28
0,831,12065,3578721670,3578721699,29
0,831,12066,3578721670,3578721699,29
0,831,12067,3578721670,3578721702,32
0,831,12068,3578721670,3578721703,33
0,831,12069,3578721670,3578721705,35
0,831,12070,3578721670,3578721705,35
0,831,12071,3578721670,3578721706,36
0,831,12072,3578721670,3578721706,36
0,831,12073,3578721670,3578721706,36
0,831,12074,3578721670,3578721707,37
0,831,12075,3578721670,3578721709,39
0,831,12076,3578721670,3578721709,39
0,831,12077,3578721670,3578721711,41
0,831,12078,3578721670,3578721714,44
0,831,12079,3578721670,3578721715,45
0,831,12080,3578721670,3578721717,47
0,831,12081,3578721670,3578721719,49
0,831,12082,3578721670,3578721719,49
0,832,12083,3578721725,3578721725,0
0,832,12084,3578721725,3578721725,0
0,832,12085,3578721725,3578721725,0
0,832,12086,3578721725,3578721725,0
0,832,12087,3578721725,3578721726,1
0,832,12088,3578721725,3578721726,1
0,832,12089,3578721725,3578721727,2
0,832,12090,3578721725,3578721728,3
0,832,12091,3578721725,3578721728,3
0,832,12092,3578721725,3578721730,5
0,832,12093,3578721725,3578721730,5
0,832,12094,3578721725,3578721731,6
0,832,12095,3578721725,3578721734,9
0,832,12096,3578721725,3578721739,14
0,832,12097,3578721725,3578721739,14
0,832,12098,3578721725,3578721740,15
0,832,12099,3578721725,3578721741,16
0,832,12100,3578721725,3578721742,17
0,832,12101,3578721725,3578721743,18
0,832,12102,3578721725,3578721744,19
0,832,12103,3578721725,3578721745,20
0,832,12104,3578721725,3578721745,20
0,832,12105,3578721725,3578721746,21
0,832,12106,3578721725,3578721747,22
0,832,12107,3578721725,3578721750,25
0,832,12108,3578721725,3578721750,25
0,832,12109,3578721725,3578721752,27
0,832,12110,3578721725,3578721752,27
0,832,12111,3578721725,3578721754,29
0,832,12112,3578721725,3578721754,29
0,832,12113,3578721725,3578721757,32
0,832,12114,3578721725,3578721758,33
0,832,12115,3578721725,3578721759,34
0,832,12116,3578721725,3578721761,36
0,832,12117,3578721725,3578721761,36
0,832,12118,3578721725,3578721761,36
0,832,12119,3578721725,3578721761,36
0,832,12120,3578721725,3578721763,38
0,832,12121,3578721725,3578721763,38
0,832,12122,3578721725,3578721764,39
0,832,12123,3578721725,3578721768,43
0,832,12124,3578721725,3578721768,43
0,832,12125,3578721725,3578721769,44
0,832,12126,3578721725,3578721772,47
0,832,12127,3578721725,3578721772,47
0,832,12128,3578721725,3578721773,48
0,832,12129,3578721725,3578721773,48
0,832,12130,3578721725,3578721773,48
0,833,12131,3578721780,3578721780,0
0,833,12132,3578721780,3578721780,0
0,833,12133,3578721780,3578721780,0
0,833,12134,3578721780,3578721780,0
0,833,12135,3578721780,3578721780,0
0,833,12136,3578721780,3578721780,0
0,833,12137,3578721780,3578721781,1
0,833,12138,3578721780,3578721782,2
0,833,12139,3578721780,3578721785,5
0,833,12140,3578721780,3578721785,5
0,833,12141,3578721780,3578721786,6
0,833,12142,3578721780,3578721787,7
0,833,12143,3578721780,3578721788,8
0,833,12144,3578721780,3578721790,10
0,833,12145,3578721780,3578721790,10
0,833,12146,3578721780,3578721795,15
0,833,12147,3578721780,3578721795,15
0,833,12148,3578721780,3578721796,16
0,833,12149,3578721780,3578721796,16
0,833,12150,3578721780,3578721803,23
0,833,12151,3578721780,3578721803,23
0,833,12152,3578721780,3578721805,25
0,833,12153,3578721780,3578721806,26
0,833,12154,3578721780,3578721806,26
0,833,12155,3578721780,3578721810,30
0,833,12156,3578721780,3578721812,32
0,833,12157,3578721780,3578721813,33
0,833,12158,3578721780,3578721815,35
0,833,12159,3578721780,3578721815,35
0,833,12160,3578721780,3578721815,35
0,833,12161,3578721780,3578721815,35
0,833,12162,3578721780,3578721816,36
0,833,12163,3578721780,3578721817,37
0,833,12164,3578721780,3578721819,39
0,833,12165,3578721780,3578721819,39
0,833,12166,3578721780,3578721822,42
0,833,12167,3578721780,3578721824,44
0,833,12168,3578721780,3578721824,44
0,833,12169,3578721780,3578721828,48
0,834,12170,3578721835,3578721835,0
0,834,12171,3578721835,3578721835,0
0,834,12172,3578721835,3578721835,0
0,834,12173,3578721835,3578721835,0
0,834,12174,3578721835,3578721835,0
0,834,12175,3578721835,3578721835,0
0,834,12176,3578721835,3578721839,4
0,834,12177,3578721835,3578721839,4
0,834,12178,3578721835,3578721840,5
0,834,12179,3578721835,3578721843,8
0,834,12180,3578721835,3578721844,9
0,834,12181,3578721835,3578721845,10
0,834,12182,3578721835,3578721846,11
0,834,12183,3578721835,3578721849,14
0,834,12184,3578721835,3578721850,15
0,834,12185,3578721835,3578721852,17
0,834,12186,3578721835,3578721853,18
0,834,12187,3578721835,3578721858,23
0,834,12188,3578721835,3578721862,27
0,834,12189,3578721835,3578721864,29
0,834,12190,3578721835,3578721865,30
0,834,12191,3578721835,3578721867,32
0,834,12192,3578721835,3578721867,32
0,834,12193,3578721835,3578721867,32
0,834,12194,3578721835,3578721867,32
0,834,12195,3578721835,3578721868,33
0,834,12196,3578721835,3578721869,34
0,834,12197,3578721835,3578721869,34
0,834,12198,3578721835,3578721874,39
0,834,12199,3578721835,3578721880,45
0,834,12200,3578721835,3578721883,48
0,835,12201,3578721891,3578721891,0
0,835,12202,3578721891,3578721891,0
0,835,12203,3578721891,3578721891,0
0,835,12204,3578721891,3578721892,1
0,835,12205,3578721891,3578721893,2
0,835,12206,3578721891,3578721894,3
0,835,12207,3578721891,3578721894,3
0,835,12208,3578721891,3578721894,3
0,835,12209,3578721891,3578721895,4
0,835,12210,3578721891,3578721895,4
0,835,12211,3578721891,3578721896,5
0,835,12212,3578721891,3578721897,6
0,835,12213,3578721891,3578721898,7
0,835,12214,3578721891,3578721898,7
0,835,12215,3578721891,3578721899,8
0,835,12216,3578721891,3578721899,8
0,835,12217,3578721891,3578721900,9
0,835,12218,3578721891,3578721902,11
0,835,12219,3578721891,3578721904,13
0,835,12220,3578721891,3578721905,14
0,835,12221,3578721891,3578721905,14
0,835,12222,3578721891,3578721905,14
0,835,12223,3578721891,3578721905,14
0,835,12224,3578721891,3578721907,16
0,835,12225,3578721891,3578721907,16
0,835,12226,3578721891,3578721909,18
0,835,12227,3578721891,3578721910,19
0,835,12228,3578721891,3578721912,21
0,835,12229,3578721891,3578721914,23
0,835,12230,3578721891,3578721917,26
0,835,12231,3578721891,3578721919,28
0,835,12232,3578721891,3578721919,28
0,835,12233,3578721891,3578721920,29
0,835,12234,3578721891,3578721923,32
0,835,12235,3578721891,3578721925,34
0,835,12236,3578721891,3578721925,34
0,835,12237,3578721891,3578721926,35
0,835,12238,3578721891,3578721927,36
0,835,12239,3578721891,3578721927,36
0,835,12240,3578721891,3578721928,37
0,835,12241,3578721891,3578721928,37
0,835,12242,3578721891,3578721930,39
0,835,12243,3578721891,3578721930,39
0,835,12244,3578721891,3578721931,40
0,835,12245,3578721891,3578721932,41
0,835,12246,3578721891,3578721932,41
0,835,12247,3578721891,3578721935,44
0,835,12248,3578721891,3578721939,48
0,835,12249,3578721891,3578721940,49
0,835,12250,3578721891,3578721940,49
0,835,12251,3578721891,3578721940,49
0,835,12252,3578721891,3578721941,50
0,836,12253,3578721946,3578721946,0
0,836,12254,3578721946,3578721946,0
0,836,12255,3578721946,3578721946,0
0,836,12256,3578721946,3578721946,0
0,836,12257,3578721946,3578721946,0
0,836,12258,3578721946,3578721946,0
0,836,12259,3578721946,3578721946,0
0,836,12260,3578721946,3578721947,1
0,836,12261,3578721946,3578721949,3
0,836,12262,3578721946,3578721951,5
0,836,12263,3578721946,3578721952,6
0,836,12264,3578721946,3578721953,7
0,836,12265,3578721946,3578721955,9
0,836,12266,3578721946,3578721955,9
0,836,12267,3578721946,3578721958,12
0,836,12268,3578721946,3578721958,12
0,836,12269,3578721946,3578721961,15
0,836,12270,3578721946,3578721961,15
0,836,12271,3578721946,3578721961,15
0,836,12272,3578721946,3578721962,16
0,836,12273,3578721946,3578721962,16
0,836,12274,3578721946,3578721963,17
0,836,12275,3578721946,3578721965,19
0,836,12276,3578721946,3578721968,22
0,836,12277,3578721946,3578721968,22
0,836,12278,3578721946,3578721969,23
0,836,12279,3578721946,3578721970,24
0,836,12280,3578721946,3578721972,26
0,836,12281,3578721946,3578721972,26
0,836,12282,3578721946,3578721973,27
0,836,12283,3578721946,3578721974,28
0,836,12284,3578721946,3578721975,29
0,836,12285,3578721946,3578721978,32
0,836,12286,3578721946,3578721980,34
0,836,12287,3578721946,3578721981,35
0,836,12288,3578721946,3578721982,36
0,836,12289,3578721946,3578721985,39
0,836,12290,3578721946,3578721986,40
0,836,12291,3578721946,3578721987,41
0,836,12292,3578721946,3578721987,41
0,836,12293,3578721946,3578721988,42
0,836,12294,3578721946,3578721990,44
0,836,12295,3578721946,3578721991,45
0,836,12296,3578721946,3578721992,46
0,836,12297,3578721946,3578721995,49
0,836,12298,3578721946,3578721995,49
0,836,12299,3578721946,3578721995,49
0,836,12300,3578721946,3578721997,51
0,837,12301,3578722002,3578722002,0
0,837,12302,3578722002,3578722003,1
0,837,12303,3578722002,3578722005,3
0,837,12304,3578722002,3578722005,3
0,837,12305,3578722002,3578722006,4
0,837,12306,3578722002,3578722007,5
0,837,12307,3578722002,3578722009,7
0,837,12308,3578722002,3578722012,10
0,837,12309,3578722002,3578722014,12
0,837,12310,3578722002,3578722015,13
0,837,12311,3578722002,3578722015,13
0,837,12312,3578722002,3578722015,13
0,837,12313,3578722002,3578722015,13
0,837,12314,3578722002,3578722017,15
0,837,12315,3578722002,3578722017,15
0,837,12316,3578722002,3578722018,16
0,837,12317,3578722002,3578722022,20
0,837,12318,3578722002,3578722025,23
0,837,12319,3578722002,3578722029,27
0,837,12320,3578722002,3578722031,29
0,837,12321,3578722002,3578722031,29
0,837,12322,3578722002,3578722032,30
0,837,12323,3578722002,3578722033,31
0,837,12324,3578722002,3578722035,33
0,837,12325,3578722002,3578722036,34
0,837,12326,3578722002,3578722039,37
0,837,12327,3578722002,3578722039,37
0,837,12328,3578722002,3578722046,44
0,837,12329,3578722002,3578722048,46
0,837,12330,3578722002,3578722050,48
0,837,12331,3578722002,3578722050,48
0,837,12332,3578722002,3578722052,50
0,838,12333,3578722057,3578722057,0
0,838,12334,3578722057,3578722057,0
0,838,12335,3578722057,3578722058,1
0,838,12336,3578722057,3578722059,2
0,838,12337,3578722057,3578722062,5
0,838,12338,3578722057,3578722064,7
0,838,12339,3578722057,3578722065,8
0,838,12340,3578722057,3578722066,9
0,838,12341,3578722057,3578722067,10
0,838,12342,3578722057,3578722067,10
0,838,12343,3578722057,3578722068,11
0,838,12344,3578722057,3578722069,12
0,838,12345,3578722057,3578722070,13
0,838,12346,3578722057,3578722075,18
0,838,12347,3578722057,3578722077,20
0,838,12348,3578722057,3578722080,23
0,838,12349,3578722057,3578722083,26
0,838,12350,3578722057,3578722086,29
0,838,12351,3578722057,3578722086,29
0,838,12352,3578722057,3578722089,32
0,838,12353,3578722057,3578722092,35
0,838,12354,3578722057,3578722093,36
0,838,12355,3578722057,3578722094,37
0,838,12356,3578722057,3578722094,37
0,838,12357,3578722057,3578722095,38
0,838,12358,3578722057,3578722095,38
0,838,12359,3578722057,3578722098,41
0,838,12360,3578722057,3578722098,41
0,838,12361,3578722057,3578722098,41
0,838,12362,3578722057,3578722099,42
0,838,12363,3578722057,3578722099,42
0,838,12364,3578722057,3578722099,42
0,838,12365,3578722057,3578722100,43
0,838,12366,3578722057,3578722102,45
0,838,12367,3578722057,3578722104,47
0,838,12368,3578722057,3578722105,48
0,838,12369,3578722057,3578722105,48
0,838,12370,3578722057,3578722106,49
0,838,12371,3578722057,3578722106,49
0,838,12372,3578722057,3578722106,49
0,838,12373,3578722057,3578722107,50
0,839,12374,3578722113,3578722113,0
0,839,12375,3578722113,3578722113,0
0,839,12376,3578722113,3578722113,0
0,839,12377,3578722113,3578722114,1
0,839,12378,3578722113,3578722115,2
0,839,12379,3578722113,3578722116,3
0,839,12380,3578722113,3578722119,6
0,839,12381,3578722113,3578722119,6
0,839,12382,3578722113,3578722123,10
0,839,12383,3578722113,3578722125,12
0,839,12384,3578722113,3578722125,12
0,839,12385,3578722113,3578722126,13
0,839,12386,3578722113,3578722128,15
0,839,12387,3578722113,3578722128,15
0,839,12388,3578722113,3578722128,15
0,839,12389,3578722113,3578722129,16
0,839,12390,3578722113,3578722130,17
0,839,12391,3578722113,3578722132,19
0,839,12392,3578722113,3578722133,20
0,839,12393,3578722113,3578722135,22
0,839,12394,3578722113,3578722139,26
0,839,12395,3578722113,3578722140,27
0,839,12396,3578722113,3578722141,28
0,839,12397,3578722113,3578722141,28
0,839,12398,3578722113,3578722143,30
0,839,12399,3578722113,3578722144,31
0,839,12400,3578722113,3578722144,31
0,839,12401,3578722113,3578722145,32
0,839,12402,3578722113,3578722146,33
0,839,12403,3578722113,3578722146,33
0,839,12404,3578722113,3578722149,36
0,839,12405,3578722113,3578722151,38
0,839,12406,3578722113,3578722151,38
0,839,12407,3578722113,3578722151,38
0,839,12408,3578722113,3578722152,39
0,839,12409,3578722113,3578722153,40
0,839,12410,3578722113,3578722154,41
0,839,12411,3578722113,3578722155,42
0,839,12412,3578722113,3578722158,45
0,839,12413,3578722113,3578722158,45
0,839,12414,3578722113,3578722160,47
0,839,12415,3578722113,3578722161,48
0,839,12416,3578722113,3578722161,48
0,839,12417,3578722113,3578722162,49
0,839,12418,3578722113,3578722163,50
0,840,12419,3578722168,3578722168,0
0,840,12420,3578722168,3578722168,0
0,840,12421,3578722168,3578722168,0
0,840,12422,3578722168,3578722168,0
0,840,12423,3578722168,3578722169,1
0,840,12424,3578722168,3578722170,2
0,840,12425,3578722168,3578722171,3
0,840,12426,3578722168,3578722173,5
0,840,12427,3578722168,3578722173,5
0,840,12428,3578722168,3578722174,6
0,840,12429,3578722168,3578722174,6
0,840,12430,3578722168,3578722175,7
0,840,12431,3578722168,3578722176,8
0,840,12432,3578722168,3578722179,11
0,840,12433,3578722168,3578722179,11
0,840,12434,3578722168,3578722180,12
0,840,12435,3578722168,3578722180,12
0,840,12436,3578722168,3578722182,14
0,840,12437,3578722168,3578722182,14
0,840,12438,3578722168,3578722185,17
0,840,12439,3578722168,3578722186,18
0,840,12440,3578722168,3578722187,19
0,840,12441,3578722168,3578722187,19
0,840,12442,3578722168,3578722189,21
0,840,12443,3578722168,3578722190,22
0,840,12444,3578722168,3578722192,24
0,840,12445,3578722168,3578722195,27
0,840,12446,3578722168,3578722195,27
0,840,12447,3578722168,3578722195,27
0,840,12448,3578722168,3578722197,29
0,840,12449,3578722168,3578722202,34
0,840,12450,3578722168,3578722203,35
0,840,12451,3578722168,3578722204,36
0,840,12452,3578722168,3578722205,37
0,840,12453,3578722168,3578722205,37
0,840,12454,3578722168,3578722206,38
0,840,12455,3578722168,3578722206,38
0,840,12456,3578722168,3578722209,41
0,840,12457,3578722168,3578722212,44
0,840,12458,3578722168,3578722214,46
0,840,12459,3578722168,3578722215,47
0,840,12460,3578722168,3578722215,47
0,840,12461,3578722168,3578722216,48
0,840,12462,3578722168,3578722216,48
0,840,12463,3578722168,3578722218,50
0,841,12464,3578722224,3578722224,0
0,841,12465,3578722224,3578722224,0
0,841,12466,3578722224,3578722224,0
0,841,12467,3578722224,3578722224,0
0,841,12468,3578722224,3578722224,0
0,841,12469,3578722224,3578722228,4
0,841,12470,3578722224,3578722231,7
0,841,12471,3578722224,3578722231,7
0,841,12472,3578722224,3578722232,8
0,841,12473,3578722224,3578722232,8
0,841,12474,3578722224,3578722235,11
0,841,12475,3578722224,3578722239,15
0,841,12476,3578722224,3578722240,16
0,841,12477,3578722224,3578722240,16
0,841,12478,3578722224,3578722243,19
0,841,12479,3578722224,3578722244,20
0,841,12480,3578722224,3578722246,22
0,841,12481,3578722224,3578722248,24
0,841,12482,3578722224,3578722248,24
0,841,12483,3578722224,3578722249,25
0,841,12484,3578722224,3578722251,27
0,841,12485,3578722224,3578722253,29
0,841,12486,3578722224,3578722256,32
0,841,12487,3578722224,3578722259,35
0,841,12488,3578722224,3578722259,35
0,841,12489,3578722224,3578722262,38
0,841,12490,3578722224,3578722263,39
0,841,12491,3578722224,3578722265,41
0,841,12492,3578722224,3578722266,42
0,841,12493,3578722224,3578722266,42
0,841,12494,3578722224,3578722267,43
0,841,12495,3578722224,3578722267,43
0,841,12496,3578722224,3578722267,43
0,841,12497,3578722224,3578722269,45
0,841,12498,3578722224,3578722269,45
0,841,12499,3578722224,3578722270,46
0,842,12500,3578722280,3578722280,0
0,842,12501,3578722280,3578722280,0
0,842,12502,3578722280,3578722280,0
0,842,12503,3578722280,3578722283,3
0,842,12504,3578722280,3578722286,6
0,842,12505,3578722280,3578722287,7
0,842,12506,3578722280,3578722290,10
0,842,12507,3578722280,3578722292,12
0,842,12508,3578722280,3578722294,14
0,842,12509,3578722280,3578722294,14
0,842,12510,3578722280,3578722294,14
0,842,12511,3578722280,3578722295,15
0,842,12512,3578722280,3578722296,16
0,842,12513,3578722280,3578722296,16
0,842,12514,3578722280,3578722297,17
0,842,12515,3578722280,3578722297,17
0,842,12516,3578722280,3578722298,18
0,842,12517,3578722280,3578722299,19
0,842,12518,3578722280,3578722299,19
0,842,12519,3578722280,3578722299,19
0,842,12520,3578722280,3578722301,21
0,842,12521,3578722280,3578722302,22
0,842,12522,3578722280,3578722303,23
0,842,12523,3578722280,3578722305,25
0,842,12524,3578722280,3578722305,25
0,842,12525,3578722280,3578722305,25
0,842,12526,3578722280,3578722305,25
0,842,12527,3578722280,3578722306,26
0,842,12528,3578722280,3578722307,27
0,842,12529,3578722280,3578722307,27
0,842,12530,3578722280,3578722309,29
0,842,12531,3578722280,3578722310,30
0,842,12532,3578722280,3578722312,32
0,842,12533,3578722280,3578722314,34
0,842,12534,3578722280,3578722316,36
0,842,12535,3578722280,3578722318,38
0,842,12536,3578722280,3578722320,40
0,842,12537,3578722280,3578722320,40
0,842,12538,3578722280,3578722320,40
0,842,12539,3578722280,3578722323,43
0,842,12540,3578722280,3578722325,45
0,842,12541,3578722280,3578722325,45
0,842,12542,3578722280,3578722326,46
0,842,12543,3578722280,3578722328,48
0,842,12544,3578722280,3578722328,48
0,842,12545,3578722280,3578722329,49
0,842,12546,3578722280,3578722329,49
0,843,12547,3578722336,3578722336,0
0,843,12548,3578722336,3578722336,0
0,843,12549,3578722336,3578722336,0
0,843,12550,3578722336,3578722336,0
0,843,12551,3578722336,3578722340,4
0,843,12552,3578722336,3578722340,4
0,843,12553,3578722336,3578722341,5
0,843,12554,3578722336,3578722341,5
0,843,12555,3578722336,3578722343,7
0,843,12556,3578722336,3578722344,8
0,843,12557,3578722336,3578722344,8
0,843,12558,3578722336,3578722345,9
0,843,12559,3578722336,3578722346,10
0,843,12560,3578722336,3578722346,10
0,843,12561,3578722336,3578722348,12
0,843,12562,3578722336,3578722350,14
0,843,12563,3578722336,3578722351,15
0,843,12564,3578722336,3578722352,16
0,843,12565,3578722336,3578722352,16
0,843,12566,3578722336,3578722353,17
0,843,12567,3578722336,3578722354,18
0,843,12568,3578722336,3578722356,20
0,843,12569,3578722336,3578722356,20
0,843,12570,3578722336,3578722357,21
0,843,12571,3578722336,3578722358,22
0,843,12572,3578722336,3578722359,23
0,843,12573,3578722336,3578722360,24
0,843,12574,3578722336,3578722361,25
0,843,12575,3578722336,3578722362,26
0,843,12576,3578722336,3578722362,26
0,843,12577,3578722336,3578722362,26
0,843,12578,3578722336,3578722363,27
0,843,12579,3578722336,3578722365,29
0,843,12580,3578722336,3578722368,32
0,843,12581,3578722336,3578722370,34
0,843,12582,3578722336,3578722372,36
0,843,12583,3578722336,3578722372,36
0,843,12584,3578722336,3578722373,37
0,843,12585,3578722336,3578722373,37
0,843,12586,3578722336,3578722376,40
0,843,12587,3578722336,3578722379,43
0,843,12588,3578722336,3578722380,44
0,843,12589,3578722336,3578722380,44
0,843,12590,3578722336,3578722381,45
0,843,12591,3578722336,3578722382,46
0,843,12592,3578722336,3578722386,50
0,844,12593,3578722392,3578722392,0
0,844,12594,3578722392,3578722392,0
0,844,12595,3578722392,3578722392,0
0,844,12596,3578722392,3578722392,0
0,844,12597,3578722392,3578722392,0
0,844,12598,3578722392,3578722393,1
0,844,12599,3578722392,3578722394,2
0,844,12600,3578722392,3578722394,2
0,844,12601,3578722392,3578722397,5
0,844,12602,3578722392,3578722403,11
0,844,12603,3578722392,3578722403,11
0,844,12604,3578722392,3578722403,11
0,844,12605,3578722392,3578722405,13
0,844,12606,3578722392,3578722406,14
0,844,12607,3578722392,3578722406,14
0,844,12608,3578722392,3578722406,14
0,844,12609,3578722392,3578722407,15
0,844,12610,3578722392,3578722407,15
0,844,12611,3578722392,3578722411,19
0,844,12612,3578722392,3578722412,20
0,844,12613,3578722392,3578722414,22
0,844,12614,3578722392,3578722416,24
0,844,12615,3578722392,3578722416,24
0,844,12616,3578722392,3578722416,24
0,844,12617,3578722392,3578722418,26
0,844,12618,3578722392,3578722419,27
0,844,12619,3578722392,3578722419,27
0,844,12620,3578722392,3578722419,27
0,844,12621,3578722392,3578722421,29
0,844,12622,3578722392,3578722422,30
0,844,12623,3578722392,3578722424,32
0,844,12624,3578722392,3578722425,33
0,844,12625,3578722392,3578722429,37
0,844,12626,3578722392,3578722431,39
0,844,12627,3578722392,3578722433,41
0,844,12628,3578722392,3578722433,41
0,844,12629,3578722392,3578722433,41
0,844,12630,3578722392,3578722435,43
0,844,12631,3578722392,3578722437,45
0,844,12632,3578722392,3578722440,48
0,844,12633,3578722392,3578722440,48
0,844,12634,3578722392,3578722441,49
0,845,12635,3578722447,3578722447,0
0,845,12636,3578722447,3578722447,0
0,845,12637,3578722447,3578722447,0
0,845,12638,3578722447,3578722449,2
0,845,12639,3578722447,3578722449,2
0,845,12640,3578722447,3578722451,4
0,845,12641,3578722447,3578722453,6
0,845,12642,3578722447,3578722456,9
0,845,12643,3578722447,3578722456,9
0,845,12644,3578722447,3578722457,10
0,845,12645,3578722447,3578722459,12
0,845,12646,3578722447,3578722462,15
0,845,12647,3578722447,3578722462,15
0,845,12648,3578722447,3578722465,18
0,845,12649,3578722447,3578722467,20
0,845,12650,3578722447,3578722467,20
0,845,12651,3578722447,3578722467,20
0,845,12652,3578722447,3578722467,20
0,845,12653,3578722447,3578722469,22
0,845,12654,3578722447,3578722469,22
0,845,12655,3578722447,3578722469,22
0,845,12656,3578722447,3578722476,29
0,845,12657,3578722447,3578722477,30
0,845,12658,3578722447,3578722480,33
0,845,12659,3578722447,3578722482,35
0,845,12660,3578722447,3578722484,37
0,845,12661,3578722447,3578722487,40
0,845,12662,3578722447,3578722487,40
0,845,12663,3578722447,3578722489,42
0,845,12664,3578722447,3578722491,44
0,845,12665,3578722447,3578722494,47
0,845,12666,3578722447,3578722494,47
0,845,12667,3578722447,3578722495,48
0,845,12668,3578722447,3578722495,48
0,845,12669,3578722447,3578722496,49
0,845,12670,3578722447,3578722496,49
0,845,12671,3578722447,3578722497,50
0,846,12672,3578722502,3578722502,0
0,846,12673,3578722502,3578722502,0
0,846,12674,3578722502,3578722502,0
0,846,12675,3578722502,3578722502,0
0,846,12676,3578722502,3578722502,0
0,846,12677,3578722502,3578722502,0
0,846,12678,3578722502,3578722503,1
0,846,12679,3578722502,3578722504,2
0,846,12680,3578722502,3578722504,2
0,846,12681,3578722502,3578722505,3
0,846,12682,3578722502,3578722505,3
0,846,12683,3578722502,3578722505,3
0,846,12684,3578722502,3578722506,4
0,846,12685,3578722502,3578722506,4
0,846,12686,3578722502,3578722507,5
0,846,12687,3578722502,3578722509,7
0,846,12688,3578722502,3578722509,7
0,846,12689,3578722502,3578722510,8
0,846,12690,3578722502,3578722513,11
0,846,12691,3578722502,3578722515,13
0,846,12692,3578722502,3578722516,14
0,846,12693,3578722502,3578722518,16
0,846,12694,3578722502,3578722519,17
0,846,12695,3578722502,3578722520,18
0,846,12696,3578722502,3578722522,20
0,846,12697,3578722502,3578722524,22
0,846,12698,3578722502,3578722525,23
0,846,12699,3578722502,3578722527,25
0,846,12700,3578722502,3578722527,25
0,846,12701,3578722502,3578722528,26
0,846,12702,3578722502,3578722528,26
0,846,12703,3578722502,3578722530,28
0,846,12704,3578722502,3578722530,28
0,846,12705,3578722502,3578722531,29
0,846,12706,3578722502,3578722534,32
0,846,12707,3578722502,3578722539,37
0,846,12708,3578722502,3578722539,37
0,846,12709,3578722502,3578722539,37
0,846,12710,3578722502,3578722540,38
0,846,12711,3578722502,3578722540,38
0,846,12712,3578722502,3578722542,40
0,846,12713,3578722502,3578722543,41
0,846,12714,3578722502,3578722543,41
0,846,12715,3578722502,3578722544,42
0,846,12716,3578722502,3578722545,43
0,846,12717,3578722502,3578722545,43
0,846,12718,3578722502,3578722547,45
0,846,12719,3578722502,3578722548,46
0,846,12720,3578722502,3578722550,48
0,846,12721,3578722502,3578722551,49
0,846,12722,3578722502,3578722551,49
0,847,12723,3578722558,3578722558,0
0,847,12724,3578722558,3578722558,0
0,847,12725,3578722558,3578722558,0
0,847,12726,3578722558,3578722558,0
0,847,12727,3578722558,3578722558,0
0,847,12728,3578722558,3578722558,0
0,847,12729,3578722558,3578722560,2
0,847,12730,3578722558,3578722560,2
0,847,12731,3578722558,3578722561,3
0,847,12732,3578722558,3578722561,3
0,847,12733,3578722558,3578722562,4
0,847,12734,3578722558,3578722563,5
0,847,12735,3578722558,3578722564,6
0,847,12736,3578722558,3578722568,10
0,847,12737,3578722558,3578722570,12
0,847,12738,3578722558,3578722570,12
0,847,12739,3578722558,3578722572,14
0,847,12740,3578722558,3578722572,14
0,847,12741,3578722558,3578722573,15
0,847,12742,3578722558,3578722573,15
0,847,12743,3578722558,3578722575,17
0,847,12744,3578722558,3578722575,17
0,847,12745,3578722558,3578722578,20
0,847,12746,3578722558,3578722579,21
0,847,12747,3578722558,3578722579,21
0,847,12748,3578722558,3578722581,23
0,847,12749,3578722558,3578722582,24
0,847,12750,3578722558,3578722585,27
0,847,12751,3578722558,3578722586,28
0,847,12752,3578722558,3578722586,28
0,847,12753,3578722558,3578722587,29
0,847,12754,3578722558,3578722590,32
0,847,12755,3578722558,3578722591,33
0,847,12756,3578722558,3578722593,35
0,847,12757,3578722558,3578722593,35
0,847,12758,3578722558,3578722594,36
0,847,12759,3578722558,3578722595,37
0,847,12760,3578722558,3578722596,38
0,847,12761,3578722558,3578722602,44
0,847,12762,3578722558,3578722602,44
0,847,12763,3578722558,3578722602,44
0,847,12764,3578722558,3578722605,47
0,847,12765,3578722558,3578722605,47
0,847,12766,3578722558,3578722605,47
0,847,12767,3578722558,3578722605,47
0,847,12768,3578722558,3578722608,50
0,848,12769,3578722614,3578722614,0
0,848,12770,3578722614,3578722614,0
0,848,12771,3578722614,3578722614,0
0,848,12772,3578722614,3578722615,1
0,848,12773,3578722614,3578722615,1
0,848,12774,3578722614,3578722616,2
0,848,12775,3578722614,3578722617,3
0,848,12776,3578722614,3578722618,4
0,848,12777,3578722614,3578722618,4
0,848,12778,3578722614,3578722621,7
0,848,12779,3578722614,3578722622,8
0,848,12780,3578722614,3578722623,9
0,848,12781,3578722614,3578722624,10
0,848,12782,3578722614,3578722628,14
0,848,12783,3578722614,3578722631,17
0,848,12784,3578722614,3578722631,17
0,848,12785,3578722614,3578722632,18
0,848,12786,3578722614,3578722633,19
0,848,12787,3578722614,3578722636,22
0,848,12788,3578722614,3578722636,22
0,848,12789,3578722614,3578722638,24
0,848,12790,3578722614,3578722639,25
0,848,12791,3578722614,3578722639,25
0,848,12792,3578722614,3578722643,29
0,848,12793,3578722614,3578722643,29
0,848,12794,3578722614,3578722646,32
0,848,12795,3578722614,3578722647,33
0,848,12796,3578722614,3578722648,34
0,848,12797,3578722614,3578722648,34
0,848,12798,3578722614,3578722650,36
0,848,12799,3578722614,3578722652,38
0,848,12800,3578722614,3578722655,41
0,848,12801,3578722614,3578722655,41
0,848,12802,3578722614,3578722657,43
0,848,12803,3578722614,3578722658,44
0,848,12804,3578722614,3578722659,45
0,848,12805,3578722614,3578722661,47
0,848,12806,3578722614,3578722661,47
0,849,12807,3578722669,3578722669,0
0,849,12808,3578722669,3578722669,0
0,849,12809,3578722669,3578722669,0
0,849,12810,3578722669,3578722669,0
0,849,12811,3578722669,3578722669,0
0,849,12812,3578722669,3578722669,0
0,849,12813,3578722669,3578722676,7
0,849,12814,3578722669,3578722677,8
0,849,12815,3578722669,3578722680,11
0,849,12816,3578722669,3578722682,13
0,849,12817,3578722669,3578722684,15
0,849,12818,3578722669,3578722687,18
0,849,12819,3578722669,3578722690,21
0,849,12820,3578722669,3578722694,25
0,849,12821,3578722669,3578722694,25
0,849,12822,3578722669,3578722695,26
0,849,12823,3578722669,3578722695,26
0,849,12824,3578722669,3578722696,27
0,849,12825,3578722669,3578722697,28
0,849,12826,3578722669,3578722697,28
0,849,12827,3578722669,3578722697,28
0,849,12828,3578722669,3578722698,29
0,849,12829,3578722669,3578722698,29
0,849,12830,3578722669,3578722699,30
0,849,12831,3578722669,3578722700,31
0,849,12832,3578722669,3578722700,31
0,849,12833,3578722669,3578722702,33
0,849,12834,3578722669,3578722704,35
0,849,12835,3578722669,3578722704,35
0,849,12836,3578722669,3578722704,35
0,849,12837,3578722669,3578722705,36
0,849,12838,3578722669,3578722706,37
0,849,12839,3578722669,3578722706,37
0,849,12840,3578722669,3578722706,37
0,849,12841,3578722669,3578722706,37
0,849,12842,3578722669,3578722708,39
0,849,12843,3578722669,3578722709,40
0,849,12844,3578722669,3578722710,41
0,849,12845,3578722669,3578722711,42
0,849,12846,3578722669,3578722714,45
0,849,12847,3578722669,3578722715,46
0,849,12848,3578722669,3578722717,48
0,849,12849,3578722669,3578722719,50
0,850,12850,3578722726,3578722726,0
0,850,12851,3578722726,3578722726,0
0,850,12852,3578722726,3578722726,0
0,850,12853,3578722726,3578722726,0
0,850,12854,3578722726,3578722726,0
0,850,12855,3578722726,3578722726,0
0,850,12856,3578722726,3578722727,1
0,850,12857,3578722726,3578722728,2
0,850,12858,3578722726,3578722728,2
0,850,12859,3578722726,3578722729,3
0,850,12860,3578722726,3578722730,4
0,850,12861,3578722726,3578722730,4
0,850,12862,3578722726,3578722731,5
0,850,12863,3578722726,3578722732,6
0,850,12864,3578722726,3578722733,7
0,850,12865,3578722726,3578722734,8
0,850,12866,3578722726,3578722739,13
0,850,12867,3578722726,3578722739,13
0,850,12868,3578722726,3578722740,14
0,850,12869,3578722726,3578722740,14
0,850,12870,3578722726,3578722742,16
0,850,12871,3578722726,3578722743,17
0,850,12872,3578722726,3578722743,17
0,850,12873,3578722726,3578722744,18
0,850,12874,3578722726,3578722745,19
0,850,12875,3578722726,3578722745,19
0,850,12876,3578722726,3578722746,20
0,850,12877,3578722726,3578722748,22
0,850,12878,3578722726,3578722749,23
0,850,12879,3578722726,3578722750,24
0,850,12880,3578722726,3578722751,25
0,850,12881,3578722726,3578722751,25
0,850,12882,3578722726,3578722753,27
0,850,12883,3578722726,3578722755,29
0,850,12884,3578722726,3578722755,29
0,850,12885,3578722726,3578722757,31
0,850,12886,3578722726,3578722758,32
0,850,12887,3578722726,3578722759,33
0,850,12888,3578722726,3578722761,35
0,850,12889,3578722726,3578722761,35
0,850,12890,3578722726,3578722761,35
0,850,12891,3578722726,3578722761,35
0,850,12892,3578722726,3578722762,36
0,850,12893,3578722726,3578722762,36
0,850,12894,3578722726,3578722763,37
0,850,12895,3578722726,3578722764,38
0,850,12896,3578722726,3578722768,42
0,850,12897,3578722726,3578722769,43
0,850,12898,3578722726,3578722770,44
0,850,12899,3578722726,3578722772,46
0,850,12900,3578722726,3578722772,46
0,850,12901,3578722726,3578722773,47
0,850,12902,3578722726,3578722773,47
0,850,12903,3578722726,3578722773,47
0,850,12904,3578722726,3578722775,49
0,851,12905,3578722782,3578722782,0
0,851,12906,3578722782,3578722782,0
0,851,12907,3578722782,3578722782,0
0,851,12908,3578722782,3578722782,0
0,851,12909,3578722782,3578722783,1
0,851,12910,3578722782,3578722783,1
0,851,12911,3578722782,3578722785,3
0,851,12912,3578722782,3578722786,4
0,851,12913,3578722782,3578722787,5
0,851,12914,3578722782,3578722788,6
0,851,12915,3578722782,3578722789,7
0,851,12916,3578722782,3578722790,8
0,851,12917,3578722782,3578722792,10
0,851,12918,3578722782,3578722793,11
0,851,12919,3578722782,3578722794,12
0,851,12920,3578722782,3578722796,14
0,851,12921,3578722782,3578722802,20
0,851,12922,3578722782,3578722803,21
0,851,12923,3578722782,3578722803,21
0,851,12924,3578722782,3578722804,22
0,851,12925,3578722782,3578722804,22
0,851,12926,3578722782,3578722805,23
0,851,12927,3578722782,3578722806,24
0,851,12928,3578722782,3578722807,25
0,851,12929,3578722782,3578722812,30
0,851,12930,3578722782,3578722812,30
0,851,12931,3578722782,3578722814,32
0,851,12932,3578722782,3578722814,32
0,851,12933,3578722782,3578722814,32
0,851,12934,3578722782,3578722815,33
0,851,12935,3578722782,3578722815,33
0,851,12936,3578722782,3578722816,34
0,851,12937,3578722782,3578722818,36
0,851,12938,3578722782,3578722818,36
0,851,12939,3578722782,3578722819,37
0,851,12940,3578722782,3578722821,39
0,851,12941,3578722782,3578722822,40
0,851,12942,3578722782,3578722824,42
0,851,12943,3578722782,3578722825,43
0,851,12944,3578722782,3578722828,46
0,851,12945,3578722782,3578722831,49
0,851,12946,3578722782,3578722832,50
0,852,12947,3578722838,3578722838,0
0,852,12948,3578722838,3578722838,0
0,852,12949,3578722838,3578722838,0
0,852,12950,3578722838,3578722838,0
0,852,12951,3578722838,3578722838,0
0,852,12952,3578722838,3578722839,1
0,852,12953,3578722838,3578722839,1
0,852,12954,3578722838,3578722840,2
0,852,12955,3578722838,3578722843,5
0,852,12956,3578722838,3578722843,5
0,852,12957,3578722838,3578722846,8
0,852,12958,3578722838,3578722847,9
0,852,12959,3578722838,3578722849,11
0,852,12960,3578722838,3578722850,12
0,852,12961,3578722838,3578722852,14
0,852,12962,3578722838,3578722855,17
0,852,12963,3578722838,3578722855,17
0,852,12964,3578722838,3578722858,20
0,852,12965,3578722838,3578722859,21
0,852,12966,3578722838,3578722862,24
0,852,12967,3578722838,3578722863,25
0,852,12968,3578722838,3578722863,25
0,852,12969,3578722838,3578722864,26
0,852,12970,3578722838,3578722865,27
0,852,12971,3578722838,3578722866,28
0,852,12972,3578722838,3578722866,28
0,852,12973,3578722838,3578722867,29
0,852,12974,3578722838,3578722868,30
0,852,12975,3578722838,3578722869,31
0,852,12976,3578722838,3578722869,31
0,852,12977,3578722838,3578722869,31
0,852,12978,3578722838,3578722876,38
0,852,12979,3578722838,3578722881,43
0,852,12980,3578722838,3578722883,45
0,852,12981,3578722838,3578722884,46
0,852,12982,3578722838,3578722886,48
0,852,12983,3578722838,3578722886,48
0,853,12984,3578722894,3578722894,0
0,853,12985,3578722894,3578722894,0
0,853,12986,3578722894,3578722894,0
0,853,12987,3578722894,3578722895,1
0,853,12988,3578722894,3578722896,2
0,853,12989,3578722894,3578722896,2
0,853,12990,3578722894,3578722896,2
0,853,12991,3578722894,3578722897,3
0,853,12992,3578722894,3578722897,3
0,853,12993,3578722894,3578722898,4
0,853,12994,3578722894,3578722898,4
0,853,12995,3578722894,3578722899,5
0,853,12996,3578722894,3578722899,5
0,853,12997,3578722894,3578722900,6
0,853,12998,3578722894,3578722901,7
0,853,12999,3578722894,3578722902,8
0,853,13000,3578722894,3578722904,10
0,853,13001,3578722894,3578722904,10
0,853,13002,3578722894,3578722905,11
0,853,13003,3578722894,3578722905,11
0,853,13004,3578722894,3578722906,12
0,853,13005,3578722894,3578722906,12
0,853,13006,3578722894,3578722906,12
0,853,13007,3578722894,3578722907,13
0,853,13008,3578722894,3578722908,14
0,853,13009,3578722894,3578722909,15
0,853,13010,3578722894,3578722910,16
0,853,13011,3578722894,3578722911,17
0,853,13012,3578722894,3578722914,20
0,853,13013,3578722894,3578722915,21
0,853,13014,3578722894,3578722915,21
0,853,13015,3578722894,3578722916,22
0,853,13016,3578722894,3578722919,25
0,853,13017,3578722894,3578722921,27
0,853,13018,3578722894,3578722922,28
0,853,13019,3578722894,3578722924,30
0,853,13020,3578722894,3578722925,31
0,853,13021,3578722894,3578722927,33
0,853,13022,3578722894,3578722927,33
0,853,13023,3578722894,3578722927,33
0,853,13024,3578722894,3578722928,34
0,853,13025,3578722894,3578722928,34
0,853,13026,3578722894,3578722930,36
0,853,13027,3578722894,3578722930,36
0,853,13028,3578722894,3578722931,37
0,853,13029,3578722894,3578722932,38
0,853,13030,3578722894,3578722936,42
0,853,13031,3578722894,3578722939,45
0,853,13032,3578722894,3578722939,45
0,853,13033,3578722894,3578722940,46
0,853,13034,3578722894,3578722940,46
0,853,13035,3578722894,3578722942,48
0,853,13036,3578722894,3578722943,49
0,853,13037,3578722894,3578722943,49
0,853,13038,3578722894,3578722944,50
0,854,13039,3578722950,3578722950,0
0,854,13040,3578722950,3578722950,0
0,854,13041,3578722950,3578722950,0
0,854,13042,3578722950,3578722950,0
0,854,13043,3578722950,3578722950,0
0,854,13044,3578722950,3578722950,0
0,854,13045,3578722950,3578722951,1
0,854,13046,3578722950,3578722952,2
0,854,13047,3578722950,3578722952,2
0,854,13048,3578722950,3578722955,5
0,854,13049,3578722950,3578722956,6
0,854,13050,3578722950,3578722957,7
0,854,13051,3578722950,3578722958,8
0,854,13052,3578722950,3578722960,10
0,854,13053,3578722950,3578722962,12
0,854,13054,3578722950,3578722962,12
0,854,13055,3578722950,3578722962,12
0,854,13056,3578722950,3578722962,12
0,854,13057,3578722950,3578722963,13
0,854,13058,3578722950,3578722964,14
0,854,13059,3578722950,3578722964,14
0,854,13060,3578722950,3578722967,17
0,854,13061,3578722950,3578722969,19
0,854,13062,3578722950,3578722969,19
0,854,13063,3578722950,3578722970,20
0,854,13064,3578722950,3578722971,21
0,854,13065,3578722950,3578722972,22
0,854,13066,3578722950,3578722973,23
0,854,13067,3578722950,3578722973,23
0,854,13068,3578722950,3578722974,24
0,854,13069,3578722950,3578722974,24
0,854,13070,3578722950,3578722976,26
0,854,13071,3578722950,3578722978,28
0,854,13072,3578722950,3578722979,29
0,854,13073,3578722950,3578722979,29
0,854,13074,3578722950,3578722980,30
0,854,13075,3578722950,3578722981,31
0,854,13076,3578722950,3578722983,33
0,854,13077,3578722950,3578722985,35
0,854,13078,3578722950,3578722986,36
0,854,13079,3578722950,3578722987,37
0,854,13080,3578722950,3578722988,38
0,854,13081,3578722950,3578722990,40
0,854,13082,3578722950,3578722990,40
0,854,13083,3578722950,3578722992,42
0,854,13084,3578722950,3578722993,43
0,854,13085,3578722950,3578722994,44
0,854,13086,3578722950,3578722994,44
0,854,13087,3578722950,3578722995,45
0,854,13088,3578722950,3578722997,47
0,855,13089,3578723007,3578723007,0
0,855,13090,3578723007,3578723007,0
0,855,13091,3578723007,3578723007,0
0,855,13092,3578723007,3578723007,0
0,855,13093,3578723007,3578723007,0
0,855,13094,3578723007,3578723007,0
0,855,13095,3578723007,3578723007,0
0,855,13096,3578723007,3578723012,5
0,855,13097,3578723007,3578723012,5
0,855,13098,3578723007,3578723014,7
0,855,13099,3578723007,3578723015,8
0,855,13100,3578723007,3578723015,8
0,855,13101,3578723007,3578723015,8
0,855,13102,3578723007,3578723015,8
0,855,13103,3578723007,3578723016,9
0,855,13104,3578723007,3578723018,11
0,855,13105,3578723007,3578723018,11
0,855,13106,3578723007,3578723019,12
0,855,13107,3578723007,3578723021,14
0,855,13108,3578723007,3578723023,16
0,855,13109,3578723007,3578723024,17
0,855,13110,3578723007,3578723026,19
0,855,13111,3578723007,3578723029,22
0,855,13112,3578723007,3578723031,24
0,855,13113,3578723007,3578723032,25
0,855,13114,3578723007,3578723032,25
0,855,13115,3578723007,3578723034,27
0,855,13116,3578723007,3578723036,29
0,855,13117,3578723007,3578723036,29
0,855,13118,3578723007,3578723039,32
0,855,13119,3578723007,3578723039,32
0,855,13120,3578723007,3578723040,33
0,855,13121,3578723007,3578723043,36
0,855,13122,3578723007,3578723044,37
0,855,13123,3578723007,3578723047,40
0,855,13124,3578723007,3578723048,41
0,855,13125,3578723007,3578723048,41
0,855,13126,3578723007,3578723050,43
0,855,13127,3578723007,3578723051,44
0,855,13128,3578723007,3578723052,45
0,855,13129,3578723007,3578723055,48
0,856,13130,3578723063,3578723063,0
0,856,13131,3578723063,3578723063,0
0,856,13132,3578723063,3578723063,0
0,856,13133,3578723063,3578723063,0
0,856,13134,3578723063,3578723063,0
0,856,13135,3578723063,3578723063,0
0,856,13136,3578723063,3578723064,1
0,856,13137,3578723063,3578723066,3
0,856,13138,3578723063,3578723066,3
0,856,13139,3578723063,3578723066,3
0,856,13140,3578723063,3578723067,4
0,856,13141,3578723063,3578723067,4
0,856,13142,3578723063,3578723067,4
0,856,13143,3578723063,3578723069,6
0,856,13144,3578723063,3578723070,7
0,856,13145,3578723063,3578723070,7
0,856,13146,3578723063,3578723077,14
0,856,13147,3578723063,3578723077,14
0,856,13148,3578723063,3578723080,17
0,856,13149,3578723063,3578723083,20
0,856,13150,3578723063,3578723084,21
0,856,13151,3578723063,3578723086,23
0,856,13152,3578723063,3578723086,23
0,856,13153,3578723063,3578723091,28
0,856,13154,3578723063,3578723094,31
0,856,13155,3578723063,3578723095,32
0,856,13156,3578723063,3578723095,32
0,856,13157,3578723063,3578723096,33
0,856,13158,3578723063,3578723096,33
0,856,13159,3578723063,3578723097,34
0,856,13160,3578723063,3578723097,34
0,856,13161,3578723063,3578723098,35
0,856,13162,3578723063,3578723098,35
0,856,13163,3578723063,3578723098,35
0,856,13164,3578723063,3578723099,36
0,856,13165,3578723063,3578723100,37
0,856,13166,3578723063,3578723100,37
0,856,13167,3578723063,3578723104,41
0,856,13168,3578723063,3578723105,42
0,856,13169,3578723063,3578723105,42
0,856,13170,3578723063,3578723105,42
0,856,13171,3578723063,3578723106,43
0,856,13172,3578723063,3578723106,43
0,856,13173,3578723063,3578723107,44
0,856,13174,3578723063,3578723108,45
0,856,13175,3578723063,3578723109,46
0,856,13176,3578723063,3578723110,47
0,856,13177,3578723063,3578723112,49
0,857,13178,3578723117,3578723117,0
0,857,13179,3578723117,3578723117,0
0,857,13180,3578723117,3578723117,0
0,857,13181,3578723117,3578723120,3
0,857,13182,3578723117,3578723121,4
0,857,13183,3578723117,3578723122,5
0,857,13184,3578723117,3578723124,7
0,857,13185,3578723117,3578723126,9
0,857,13186,3578723117,3578723127,10
0,857,13187,3578723117,3578723128,11
0,857,13188,3578723117,3578723128,11
0,857,13189,3578723117,3578723129,12
0,857,13190,3578723117,3578723130,13
0,857,13191,3578723117,3578723131,14
0,857,13192,3578723117,3578723132,15
0,857,13193,3578723117,3578723132,15
0,857,13194,3578723117,3578723137,20
0,857,13195,3578723117,3578723139,22
0,857,13196,3578723117,3578723140,23
0,857,13197,3578723117,3578723141,24
0,857,13198,3578723117,3578723142,25
0,857,13199,3578723117,3578723143,26
0,857,13200,3578723117,3578723143,26
0,857,13201,3578723117,3578723143,26
0,857,13202,3578723117,3578723145,28
0,857,13203,3578723117,3578723146,29
0,857,13204,3578723117,3578723147,30
0,857,13205,3578723117,3578723148,31
0,857,13206,3578723117,3578723149,32
0,857,13207,3578723117,3578723151,34
0,857,13208,3578723117,3578723152,35
0,857,13209,3578723117,3578723153,36
0,857,13210,3578723117,3578723153,36
0,857,13211,3578723117,3578723155,38
0,857,13212,3578723117,3578723155,38
0,857,13213,3578723117,3578723157,40
0,857,13214,3578723117,3578723158,41
0,857,13215,3578723117,3578723158,41
0,857,13216,3578723117,3578723161,44
0,857,13217,3578723117,3578723161,44
0,857,13218,3578723117,3578723161,44
0,857,13219,3578723117,3578723162,45
0,857,13220,3578723117,3578723162,45
0,857,13221,3578723117,3578723163,46
0,857,13222,3578723117,3578723163,46
0,857,13223,3578723117,3578723165,48
0,858,13224,3578723173,3578723173,0
0,858,13225,3578723173,3578723173,0
0,858,13226,3578723173,3578723173,0
0,858,13227,3578723173,3578723173,0
0,858,13228,3578723173,3578723173,0
0,858,13229,3578723173,3578723173,0
0,858,13230,3578723173,3578723173,0
0,858,13231,3578723173,3578723173,0
0,858,13232,3578723173,3578723174,1
0,858,13233,3578723173,3578723174,1
0,858,13234,3578723173,3578723179,6
0,858,13235,3578723173,3578723179,6
0,858,13236,3578723173,3578723180,7
0,858,13237,3578723173,3578723180,7
0,858,13238,3578723173,3578723180,7
0,858,13239,3578723173,3578723182,9
0,858,13240,3578723173,3578723185,12
0,858,13241,3578723173,3578723186,13
0,858,13242,3578723173,3578723187,14
0,858,13243,3578723173,3578723189,16
0,858,13244,3578723173,3578723191,18
0,858,13245,3578723173,3578723193,20
0,858,13246,3578723173,3578723194,21
0,858,13247,3578723173,3578723194,21
0,858,13248,3578723173,3578723194,21
0,858,13249,3578723173,3578723202,29
0,858,13250,3578723173,3578723203,30
0,858,13251,3578723173,3578723204,31
0,858,13252,3578723173,3578723205,32
0,858,13253,3578723173,3578723206,33
0,858,13254,3578723173,3578723206,33
0,858,13255,3578723173,3578723207,34
0,858,13256,3578723173,3578723207,34
0,858,13257,3578723173,3578723211,38
0,858,13258,3578723173,3578723212,39
0,858,13259,3578723173,3578723214,41
0,858,13260,3578723173,3578723215,42
0,858,13261,3578723173,3578723215,42
0,858,13262,3578723173,3578723215,42
0,858,13263,3578723173,3578723217,44
0,858,13264,3578723173,3578723218,45
0,858,13265,3578723173,3578723218,45
0,858,13266,3578723173,3578723219,46
0,858,13267,3578723173,3578723219,46
0,858,13268,3578723173,3578723219,46
0,858,13269,3578723173,3578723221,48
0,859,13270,3578723228,3578723228,0
0,859,13271,3578723228,3578723228,0
0,859,13272,3578723228,3578723228,0
0,859,13273,3578723228,3578723229,1
0,859,13274,3578723228,3578723231,3
0,859,13275,3578723228,3578723232,4
0,859,13276,3578723228,3578723233,5
0,859,13277,3578723228,3578723234,6
0,859,13278,3578723228,3578723236,8
0,859,13279,3578723228,3578723237,9
0,859,13280,3578723228,3578723240,12
0,859,13281,3578723228,3578723240,12
0,859,13282,3578723228,3578723240,12
0,859,13283,3578723228,3578723243,15
0,859,13284,3578723228,3578723247,19
0,859,13285,3578723228,3578723247,19
0,859,13286,3578723228,3578723250,22
0,859,13287,3578723228,3578723251,23
0,859,13288,3578723228,3578723253,25
0,859,13289,3578723228,3578723255,27
0,859,13290,3578723228,3578723255,27
0,859,13291,3578723228,3578723257,29
0,859,13292,3578723228,3578723259,31
0,859,13293,3578723228,3578723259,31
0,859,13294,3578723228,3578723262,34
0,859,13295,3578723228,3578723263,35
0,859,13296,3578723228,3578723264,36
0,859,13297,3578723228,3578723266,38
0,859,13298,3578723228,3578723266,38
0,859,13299,3578723228,3578723267,39
0,859,13300,3578723228,3578723267,39
0,859,13301,3578723228,3578723267,39
0,859,13302,3578723228,3578723267,39
0,859,13303,3578723228,3578723269,41
0,859,13304,3578723228,3578723269,41
0,859,13305,3578723228,3578723270,42
0,859,13306,3578723228,3578723270,42
0,859,13307,3578723228,3578723276,48
0,859,13308,3578723228,3578723277,49
0,860,13309,3578723284,3578723284,0
0,860,13310,3578723284,3578723284,0
0,860,13311,3578723284,3578723284,0
0,860,13312,3578723284,3578723286,2
0,860,13313,3578723284,3578723287,3
0,860,13314,3578723284,3578723291,7
0,860,13315,3578723284,3578723292,8
0,860,13316,3578723284,3578723294,10
0,860,13317,3578723284,3578723295,11
0,860,13318,3578723284,3578723297,13
0,860,13319,3578723284,3578723297,13
0,860,13320,3578723284,3578723298,14
0,860,13321,3578723284,3578723298,14
0,860,13322,3578723284,3578723299,15
0,860,13323,3578723284,3578723299,15
0,860,13324,3578723284,3578723300,16
0,860,13325,3578723284,3578723301,17
0,860,13326,3578723284,3578723302,18
0,860,13327,3578723284,3578723304,20
0,860,13328,3578723284,3578723305,21
0,860,13329,3578723284,3578723306,22
0,860,13330,3578723284,3578723306,22
0,860,13331,3578723284,3578723307,23
0,860,13332,3578723284,3578723307,23
0,860,13333,3578723284,3578723307,23
0,860,13334,3578723284,3578723309,25
0,860,13335,3578723284,3578723309,25
0,860,13336,3578723284,3578723309,25
0,860,13337,3578723284,3578723312,28
0,860,13338,3578723284,3578723315,31
0,860,13339,3578723284,3578723316,32
0,860,13340,3578723284,3578723316,32
0,860,13341,3578723284,3578723317,33
0,860,13342,3578723284,3578723318,34
0,860,13343,3578723284,3578723320,36
0,860,13344,3578723284,3578723320,36
0,860,13345,3578723284,3578723323,39
0,860,13346,3578723284,3578723323,39
0,860,13347,3578723284,3578723324,40
0,860,13348,3578723284,3578723326,42
0,860,13349,3578723284,3578723326,42
0,860,13350,3578723284,3578723329,45
0,860,13351,3578723284,3578723329,45
0,860,13352,3578723284,3578723329,45
0,860,13353,3578723284,3578723330,46
0,860,13354,3578723284,3578723331,47
0,860,13355,3578723284,3578723333,49
0,860,13356,3578723284,3578723333,49
0,861,13357,3578723339,3578723340,1
0,861,13358,3578723339,3578723340,1
0,861,13359,3578723339,3578723340,1
0,861,13360,3578723339,3578723341,2
0,861,13361,3578723339,3578723341,2
0,861,13362,3578723339,3578723343,4
0,861,13363,3578723339,3578723343,4
0,861,13364,3578723339,3578723343,4
0,861,13365,3578723339,3578723344,5
0,861,13366,3578723339,3578723345,6
0,861,13367,3578723339,3578723346,7
0,861,13368,3578723339,3578723346,7
0,861,13369,3578723339,3578723349,10
0,861,13370,3578723339,3578723349,10
0,861,13371,3578723339,3578723351,12
0,861,13372,3578723339,3578723352,13
0,861,13373,3578723339,3578723353,14
0,861,13374,3578723339,3578723355,16
0,861,13375,3578723339,3578723356,17
0,861,13376,3578723339,3578723357,18
0,861,13377,3578723339,3578723357,18
0,861,13378,3578723339,3578723359,20
0,861,13379,3578723339,3578723361,22
0,861,13380,3578723339,3578723361,22
0,861,13381,3578723339,3578723361,22
0,861,13382,3578723339,3578723362,23
0,861,13383,3578723339,3578723362,23
0,861,13384,3578723339,3578723363,24
0,861,13385,3578723339,3578723363,24
0,861,13386,3578723339,3578723365,26
0,861,13387,3578723339,3578723369,30
0,861,13388,3578723339,3578723369,30
0,861,13389,3578723339,3578723370,31
0,861,13390,3578723339,3578723370,31
0,861,13391,3578723339,3578723372,33
0,861,13392,3578723339,3578723372,33
0,861,13393,3578723339,3578723372,33
0,861,13394,3578723339,3578723373,34
0,861,13395,3578723339,3578723374,35
0,861,13396,3578723339,3578723374,35
0,861,13397,3578723339,3578723376,37
0,861,13398,3578723339,3578723377,38
0,861,13399,3578723339,3578723379,40
0,861,13400,3578723339,3578723379,40
0,861,13401,3578723339,3578723380,41
0,861,13402,3578723339,3578723381,42
0,861,13403,3578723339,3578723381,42
0,861,13404,3578723339,3578723382,43
0,861,13405,3578723339,3578723383,44
0,861,13406,3578723339,3578723385,46
0,861,13407,3578723339,3578723386,47
0,861,13408,3578723339,3578723386,47
0,862,13409,3578723398,3578723398,0
0,862,13410,3578723398,3578723398,0
0,862,13411,3578723398,3578723398,0
0,862,13412,3578723398,3578723398,0
0,862,13413,3578723398,3578723398,0
0,862,13414,3578723398,3578723398,0
0,862,13415,3578723398,3578723398,0
0,862,13416,3578723398,3578723398,0
0,862,13417,3578723398,3578723398,0
0,862,13418,3578723398,3578723402,4
0,862,13419,3578723398,3578723404,6
0,862,13420,3578723398,3578723404,6
0,862,13421,3578723398,3578723405,7
0,862,13422,3578723398,3578723406,8
0,862,13423,3578723398,3578723406,8
0,862,13424,3578723398,3578723408,10
0,862,13425,3578723398,3578723412,14
0,862,13426,3578723398,3578723412,14
0,862,13427,3578723398,3578723414,16
0,862,13428,3578723398,3578723415,17
0,862,13429,3578723398,3578723415,17
0,862,13430,3578723398,3578723416,18
0,862,13431,3578723398,3578723417,19
0,862,13432,3578723398,3578723419,21
0,862,13433,3578723398,3578723419,21
0,862,13434,3578723398,3578723419,21
0,862,13435,3578723398,3578723420,22
0,862,13436,3578723398,3578723422,24
0,862,13437,3578723398,3578723424,26
0,862,13438,3578723398,3578723424,26
0,862,13439,3578723398,3578723426,28
0,862,13440,3578723398,3578723429,31
0,862,13441,3578723398,3578723429,31
0,862,13442,3578723398,3578723431,33
0,862,13443,3578723398,3578723432,34
0,862,13444,3578723398,3578723432,34
0,862,13445,3578723398,3578723434,36
0,862,13446,3578723398,3578723435,37
0,862,13447,3578723398,3578723437,39
0,862,13448,3578723398,3578723439,41
0,862,13449,3578723398,3578723440,42
0,862,13450,3578723398,3578723440,42
0,862,13451,3578723398,3578723447,49
0,862,13452,3578723398,3578723448,50
0,863,13453,3578723453,3578723453,0
0,863,13454,3578723453,3578723453,0
0,863,13455,3578723453,3578723453,0
0,863,13456,3578723453,3578723453,0
0,863,13457,3578723453,3578723455,2
0,863,13458,3578723453,3578723456,3
0,863,13459,3578723453,3578723457,4
0,863,13460,3578723453,3578723459,6
0,863,13461,3578723453,3578723459,6
0,863,13462,3578723453,3578723462,9
0,863,13463,3578723453,3578723463,10
0,863,13464,3578723453,3578723464,11
0,863,13465,3578723453,3578723466,13
0,863,13466,3578723453,3578723466,13
0,863,13467,3578723453,3578723466,13
0,863,13468,3578723453,3578723466,13
0,863,13469,3578723453,3578723467,14
0,863,13470,3578723453,3578723468,15
0,863,13471,3578723453,3578723469,16
0,863,13472,3578723453,3578723470,17
0,863,13473,3578723453,3578723470,17
0,863,13474,3578723453,3578723477,24
0,863,13475,3578723453,3578723477,24
0,863,13476,3578723453,3578723480,27
0,863,13477,3578723453,3578723483,30
0,863,13478,3578723453,3578723484,31
0,863,13479,3578723453,3578723486,33
0,863,13480,3578723453,3578723487,34
0,863,13481,3578723453,3578723492,39
0,863,13482,3578723453,3578723494,41
0,863,13483,3578723453,3578723496,43
0,863,13484,3578723453,3578723497,44
0,863,13485,3578723453,3578723498,45
0,863,13486,3578723453,3578723499,46
0,863,13487,3578723453,3578723499,46
0,863,13488,3578723453,3578723499,46
0,863,13489,3578723453,3578723500,47
0,863,13490,3578723453,3578723501,48
0,864,13491,3578723509,3578723509,0
0,864,13492,3578723509,3578723509,0
0,864,13493,3578723509,3578723509,0
0,864,13494,3578723509,3578723509,0
0,864,13495,3578723509,3578723509,0
0,864,13496,3578723509,3578723509,0
0,864,13497,3578723509,3578723509,0
0,864,13498,3578723509,3578723509,0
0,864,13499,3578723509,3578723509,0
0,864,13500,3578723509,3578723509,0
0,864,13501,3578723509,3578723509,0
0,864,13502,3578723509,3578723512,3
0,864,13503,3578723509,3578723514,5
0,864,13504,3578723509,3578723514,5
0,864,13505,3578723509,3578723516,7
0,864,13506,3578723509,3578723517,8
0,864,13507,3578723509,3578723518,9
0,864,13508,3578723509,3578723520,11
0,864,13509,3578723509,3578723523,14
0,864,13510,3578723509,3578723524,15
0,864,13511,3578723509,3578723524,15
0,864,13512,3578723509,3578723525,16
0,864,13513,3578723509,3578723527,18
0,864,13514,3578723509,3578723528,19
0,864,13515,3578723509,3578723528,19
0,864,13516,3578723509,3578723528,19
0,864,13517,3578723509,3578723529,20
0,864,13518,3578723509,3578723530,21
0,864,13519,3578723509,3578723530,21
0,864,13520,3578723509,3578723530,21
0,864,13521,3578723509,3578723532,23
0,864,13522,3578723509,3578723533,24
0,864,13523,3578723509,3578723536,27
0,864,13524,3578723509,3578723539,30
0,864,13525,3578723509,3578723539,30
0,864,13526,3578723509,3578723539,30
0,864,13527,3578723509,3578723540,31
0,864,13528,3578723509,3578723540,31
0,864,13529,3578723509,3578723542,33
0,864,13530,3578723509,3578723542,33
0,864,13531,3578723509,3578723542,33
0,864,13532,3578723509,3578723544,35
0,864,13533,3578723509,3578723544,35
0,864,13534,3578723509,3578723545,36
0,864,13535,3578723509,3578723545,36
0,864,13536,3578723509,3578723548,39
0,864,13537,3578723509,3578723548,39
0,864,13538,3578723509,3578723550,41
0,864,13539,3578723509,3578723551,42
0,864,13540,3578723509,3578723552,43
0,864,13541,3578723509,3578723552,43
0,864,13542,3578723509,3578723554,45
0,864,13543,3578723509,3578723555,46
0,864,13544,3578723509,3578723556,47
0,864,13545,3578723509,3578723558,49
0,865,13546,3578723565,3578723565,0
0,865,13547,3578723565,3578723565,0
0,865,13548,3578723565,3578723565,0
0,865,13549,3578723565,3578723565,0
0,865,13550,3578723565,3578723565,0
0,865,13551,3578723565,3578723565,0
0,865,13552,3578723565,3578723565,0
0,865,13553,3578723565,3578723565,0
0,865,13554,3578723565,3578723566,1
0,865,13555,3578723565,3578723568,3
0,865,13556,3578723565,3578723569,4
0,865,13557,3578723565,3578723570,5
0,865,13558,3578723565,3578723571,6
0,865,13559,3578723565,3578723572,7
0,865,13560,3578723565,3578723572,7
0,865,13561,3578723565,3578723572,7
0,865,13562,3578723565,3578723574,9
0,865,13563,3578723565,3578723579,14
0,865,13564,3578723565,3578723579,14
0,865,13565,3578723565,3578723579,14
0,865,13566,3578723565,3578723579,14
0,865,13567,3578723565,3578723580,15
0,865,13568,3578723565,3578723581,16
0,865,13569,3578723565,3578723582,17
0,865,13570,3578723565,3578723585,20
0,865,13571,3578723565,3578723585,20
0,865,13572,3578723565,3578723586,21
0,865,13573,3578723565,3578723589,24
0,865,13574,3578723565,3578723590,25
0,865,13575,3578723565,3578723591,26
0,865,13576,3578723565,3578723592,27
0,865,13577,3578723565,3578723593,28
0,865,13578,3578723565,3578723593,28
0,865,13579,3578723565,3578723593,28
0,865,13580,3578723565,3578723596,31
0,865,13581,3578723565,3578723599,34
0,865,13582,3578723565,3578723601,36
0,865,13583,3578723565,3578723603,38
0,865,13584,3578723565,3578723604,39
0,865,13585,3578723565,3578723605,40
0,865,13586,3578723565,3578723605,40
0,865,13587,3578723565,3578723606,41
0,865,13588,3578723565,3578723607,42
0,865,13589,3578723565,3578723607,42
0,865,13590,3578723565,3578723611,46
0,865,13591,3578723565,3578723611,46
0,865,13592,3578723565,3578723614,49
0,865,13593,3578723565,3578723615,50
0,866,13594,3578723621,3578723621,0
0,866,13595,3578723621,3578723621,0
0,866,13596,3578723621,3578723621,0
0,866,13597,3578723621,3578723621,0
0,866,13598,3578723621,3578723621,0
0,866,13599,3578723621,3578723622,1
0,866,13600,3578723621,3578723623,2
0,866,13601,3578723621,3578723624,3
0,866,13602,3578723621,3578723625,4
0,866,13603,3578723621,3578723628,7
0,866,13604,3578723621,3578723630,9
0,866,13605,3578723621,3578723631,10
0,866,13606,3578723621,3578723631,10
0,866,13607,3578723621,3578723632,11
0,866,13608,3578723621,3578723633,12
0,866,13609,3578723621,3578723636,15
0,866,13610,3578723621,3578723636,15
0,866,13611,3578723621,3578723638,17
0,866,13612,3578723621,3578723639,18
0,866,13613,3578723621,3578723639,18
0,866,13614,3578723621,3578723647,26
0,866,13615,3578723621,3578723647,26
0,866,13616,3578723621,3578723648,27
0,866,13617,3578723621,3578723649,28
0,866,13618,3578723621,3578723649,28
0,866,13619,3578723621,3578723652,31
0,866,13620,3578723621,3578723654,33
0,866,13621,3578723621,3578723654,33
0,866,13622,3578723621,3578723656,35
0,866,13623,3578723621,3578723657,36
0,866,13624,3578723621,3578723659,38
0,866,13625,3578723621,3578723662,41
0,866,13626,3578723621,3578723662,41
0,866,13627,3578723621,3578723663,42
0,866,13628,3578723621,3578723665,44
0,866,13629,3578723621,3578723665,44
0,866,13630,3578723621,3578723666,45
0,866,13631,3578723621,3578723666,45
0,866,13632,3578723621,3578723667,46
0,866,13633,3578723621,3578723667,46
0,866,13634,3578723621,3578723669,48
0,866,13635,3578723621,3578723670,49
0,866,13636,3578723621,3578723670,49
0,867,13637,3578723676,3578723677,1
0,867,13638,3578723676,3578723680,4
0,867,13639,3578723676,3578723683,7
0,867,13640,3578723676,3578723685,9
0,867,13641,3578723676,3578723686,10
0,867,13642,3578723676,3578723687,11
0,867,13643,3578723676,3578723692,16
0,867,13644,3578723676,3578723692,16
0,867,13645,3578723676,3578723694,18
0,867,13646,3578723676,3578723696,20
0,867,13647,3578723676,3578723697,21
0,867,13648,3578723676,3578723698,22
0,867,13649,3578723676,3578723699,23
0,867,13650,3578723676,3578723699,23
0,867,13651,3578723676,3578723699,23
0,867,13652,3578723676,3578723701,25
0,867,13653,3578723676,3578723702,26
0,867,13654,3578723676,3578723702,26
0,867,13655,3578723676,3578723704,28
0,867,13656,3578723676,3578723705,29
0,867,13657,3578723676,3578723706,30
0,867,13658,3578723676,3578723706,30
0,867,13659,3578723676,3578723706,30
0,867,13660,3578723676,3578723707,31
0,867,13661,3578723676,3578723707,31
0,867,13662,3578723676,3578723708,32
0,867,13663,3578723676,3578723709,33
0,867,13664,3578723676,3578723709,33
0,867,13665,3578723676,3578723709,33
0,867,13666,3578723676,3578723712,36
0,867,13667,3578723676,3578723714,38
0,867,13668,3578723676,3578723715,39
0,867,13669,3578723676,3578723715,39
0,867,13670,3578723676,3578723716,40
0,867,13671,3578723676,3578723718,42
0,867,13672,3578723676,3578723720,44
0,867,13673,3578723676,3578723723,47
0,867,13674,3578723676,3578723723,47
0,867,13675,3578723676,3578723725,49
0,867,13676,3578723676,3578723725,49
0,868,13677,3578723733,3578723733,0
0,868,13678,3578723733,3578723733,0
0,868,13679,3578723733,3578723733,0
0,868,13680,3578723733,3578723733,0
0,868,13681,3578723733,3578723733,0
0,868,13682,3578723733,3578723733,0
0,868,13683,3578723733,3578723733,0
0,868,13684,3578723733,3578723733,0
0,868,13685,3578723733,3578723733,0
0,868,13686,3578723733,3578723736,3
0,868,13687,3578723733,3578723739,6
0,868,13688,3578723733,3578723740,7
0,868,13689,3578723733,3578723740,7
0,868,13690,3578723733,3578723742,9
0,868,13691,3578723733,3578723742,9
0,868,13692,3578723733,3578723743,10
0,868,13693,3578723733,3578723744,11
0,868,13694,3578723733,3578723745,12
0,868,13695,3578723733,3578723745,12
0,868,13696,3578723733,3578723746,13
0,868,13697,3578723733,3578723748,15
0,868,13698,3578723733,3578723749,16
0,868,13699,3578723733,3578723749,16
0,868,13700,3578723733,3578723751,18
0,868,13701,3578723733,3578723752,19
0,868,13702,3578723733,3578723753,20
0,868,13703,3578723733,3578723754,21
0,868,13704,3578723733,3578723755,22
0,868,13705,3578723733,3578723756,23
0,868,13706,3578723733,3578723757,24
0,868,13707,3578723733,3578723759,26
0,868,13708,3578723733,3578723760,27
0,868,13709,3578723733,3578723760,27
0,868,13710,3578723733,3578723761,28
0,868,13711,3578723733,3578723761,28
0,868,13712,3578723733,3578723761,28
0,868,13713,3578723733,3578723762,29
0,868,13714,3578723733,3578723764,31
0,868,13715,3578723733,3578723764,31
0,868,13716,3578723733,3578723767,34
0,868,13717,3578723733,3578723768,35
0,868,13718,3578723733,3578723769,36
0,868,13719,3578723733,3578723769,36
0,868,13720,3578723733,3578723770,37
0,868,13721,3578723733,3578723772,39
0,868,13722,3578723733,3578723773,40
0,868,13723,3578723733,3578723773,40
0,868,13724,3578723733,3578723773,40
0,868,13725,3578723733,3578723773,40
0,868,13726,3578723733,3578723773,40
0,868,13727,3578723733,3578723775,42
0,868,13728,3578723733,3578723779,46
0,868,13729,3578723733,3578723780,47
0,868,13730,3578723733,3578723780,47
0,868,13731,3578723733,3578723780,47
0,868,13732,3578723733,3578723783,50
0,869,13733,3578723791,3578723791,0
0,869,13734,3578723791,3578723791,0
0,869,13735,3578723791,3578723791,0
0,869,13736,3578723791,3578723791,0
0,869,13737,3578723791,3578723791,0
0,869,13738,3578723791,3578723791,0
0,869,13739,3578723791,3578723791,0
0,869,13740,3578723791,3578723792,1
0,869,13741,3578723791,3578723792,1
0,869,13742,3578723791,3578723793,2
0,869,13743,3578723791,3578723794,3
0,869,13744,3578723791,3578723796,5
0,869,13745,3578723791,3578723797,6
0,869,13746,3578723791,3578723798,7
0,869,13747,3578723791,3578723801,10
0,869,13748,3578723791,3578723803,12
0,869,13749,3578723791,3578723804,13
0,869,13750,3578723791,3578723805,14
0,869,13751,3578723791,3578723805,14
0,869,13752,3578723791,3578723805,14
0,869,13753,3578723791,3578723807,16
0,869,13754,3578723791,3578723810,19
0,869,13755,3578723791,3578723812,21
0,869,13756,3578723791,3578723814,23
0,869,13757,3578723791,3578723815,24
0,869,13758,3578723791,3578723815,24
0,869,13759,3578723791,3578723815,24
0,869,13760,3578723791,3578723818,27
0,869,13761,3578723791,3578723818,27
0,869,13762,3578723791,3578723819,28
0,869,13763,3578723791,3578723819,28
0,869,13764,3578723791,3578723824,33
0,869,13765,3578723791,3578723826,35
0,869,13766,3578723791,3578723828,37
0,869,13767,3578723791,3578723831,40
0,869,13768,3578723791,3578723831,40
0,869,13769,3578723791,3578723832,41
0,869,13770,3578723791,3578723833,42
0,869,13771,3578723791,3578723835,44
0,869,13772,3578723791,3578723837,46
0,869,13773,3578723791,3578723840,49
0,869,13774,3578723791,3578723840,49
0,869,13775,3578723791,3578723840,49
0,870,13776,3578723848,3578723848,0
0,870,13777,3578723848,3578723848,0
0,870,13778,3578723848,3578723848,0
0,870,13779,3578723848,3578723848,0
0,870,13780,3578723848,3578723849,1
0,870,13781,3578723848,3578723850,2
0,870,13782,3578723848,3578723852,4
0,870,13783,3578723848,3578723854,6
0,870,13784,3578723848,3578723855,7
0,870,13785,3578723848,3578723858,10
0,870,13786,3578723848,3578723859,11
0,870,13787,3578723848,3578723862,14
0,870,13788,3578723848,3578723862,14
0,870,13789,3578723848,3578723863,15
0,870,13790,3578723848,3578723865,17
0,870,13791,3578723848,3578723865,17
0,870,13792,3578723848,3578723866,18
0,870,13793,3578723848,3578723867,19
0,870,13794,3578723848,3578723869,21
0,870,13795,3578723848,3578723869,21
0,870,13796,3578723848,3578723870,22
0,870,13797,3578723848,3578723876,28
0,870,13798,3578723848,3578723877,29
0,870,13799,3578723848,3578723880,32
0,870,13800,3578723848,3578723883,35
0,870,13801,3578723848,3578723884,36
0,870,13802,3578723848,3578723885,37
0,870,13803,3578723848,3578723886,38
0,870,13804,3578723848,3578723887,39
0,870,13805,3578723848,3578723892,44
0,870,13806,3578723848,3578723894,46
0,870,13807,3578723848,3578723895,47
0,870,13808,3578723848,3578723896,48
0,870,13809,3578723848,3578723896,48
0,870,13810,3578723848,3578723897,49
0,870,13811,3578723848,3578723898,50
0,871,13812,3578723905,3578723905,0
0,871,13813,3578723905,3578723905,0
0,871,13814,3578723905,3578723905,0
0,871,13815,3578723905,3578723905,0
0,871,13816,3578723905,3578723905,0
0,871,13817,3578723905,3578723905,0
0,871,13818,3578723905,3578723905,0
0,871,13819,3578723905,3578723905,0
0,871,13820,3578723905,3578723905,0
0,871,13821,3578723905,3578723906,1
0,871,13822,3578723905,3578723906,1
0,871,13823,3578723905,3578723906,1
0,871,13824,3578723905,3578723907,2
0,871,13825,3578723905,3578723907,2
0,871,13826,3578723905,3578723908,3
0,871,13827,3578723905,3578723909,4
0,871,13828,3578723905,3578723909,4
0,871,13829,3578723905,3578723910,5
0,871,13830,3578723905,3578723913,8
0,871,13831,3578723905,3578723915,10
0,871,13832,3578723905,3578723916,11
0,871,13833,3578723905,3578723916,11
0,871,13834,3578723905,3578723920,15
0,871,13835,3578723905,3578723920,15
0,871,13836,3578723905,3578723923,18
0,871,13837,3578723905,3578723923,18
0,871,13838,3578723905,3578723925,20
0,871,13839,3578723905,3578723925,20
0,871,13840,3578723905,3578723927,22
0,871,13841,3578723905,3578723929,24
0,871,13842,3578723905,3578723929,24
0,871,13843,3578723905,3578723930,25
0,871,13844,3578723905,3578723930,25
0,871,13845,3578723905,3578723931,26
0,871,13846,3578723905,3578723932,27
0,871,13847,3578723905,3578723937,32
0,871,13848,3578723905,3578723937,32
0,871,13849,3578723905,3578723940,35
0,871,13850,3578723905,3578723940,35
0,871,13851,3578723905,3578723941,36
0,871,13852,3578723905,3578723942,37
0,871,13853,3578723905,3578723942,37
0,871,13854,3578723905,3578723943,38
0,871,13855,3578723905,3578723945,40
0,871,13856,3578723905,3578723945,40
0,871,13857,3578723905,3578723948,43
0,871,13858,3578723905,3578723949,44
0,871,13859,3578723905,3578723950,45
0,871,13860,3578723905,3578723950,45
0,871,13861,3578723905,3578723953,48
0,871,13862,3578723905,3578723955,50
0,872,13863,3578723961,3578723961,0
0,872,13864,3578723961,3578723961,0
0,872,13865,3578723961,3578723961,0
0,872,13866,3578723961,3578723961,0
0,872,13867,3578723961,3578723961,0
0,872,13868,3578723961,3578723961,0
0,872,13869,3578723961,3578723961,0
0,872,13870,3578723961,3578723961,0
0,872,13871,3578723961,3578723962,1
0,872,13872,3578723961,3578723962,1
0,872,13873,3578723961,3578723964,3
0,872,13874,3578723961,3578723964,3
0,872,13875,3578723961,3578723968,7
0,872,13876,3578723961,3578723969,8
0,872,13877,3578723961,3578723969,8
0,872,13878,3578723961,3578723969,8
0,872,13879,3578723961,3578723970,9
0,872,13880,3578723961,3578723972,11
0,872,13881,3578723961,3578723973,12
0,872,13882,3578723961,3578723973,12
0,872,13883,3578723961,3578723973,12
0,872,13884,3578723961,3578723973,12
0,872,13885,3578723961,3578723974,13
0,872,13886,3578723961,3578723979,18
0,872,13887,3578723961,3578723980,19
0,872,13888,3578723961,3578723980,19
0,872,13889,3578723961,3578723980,19
0,872,13890,3578723961,3578723982,21
0,872,13891,3578723961,3578723983,22
0,872,13892,3578723961,3578723984,23
0,872,13893,3578723961,3578723987,26
0,872,13894,3578723961,3578723987,26
0,872,13895,3578723961,3578723987,26
0,872,13896,3578723961,3578723990,29
0,872,13897,3578723961,3578723990,29
0,872,13898,3578723961,3578723992,31
0,872,13899,3578723961,3578723993,32
0,872,13900,3578723961,3578723994,33
0,872,13901,3578723961,3578723994,33
0,872,13902,3578723961,3578723996,35
0,872,13903,3578723961,3578723997,36
0,872,13904,3578723961,3578723999,38
0,872,13905,3578723961,3578724003,42
0,872,13906,3578723961,3578724005,44
0,872,13907,3578723961,3578724005,44
0,872,13908,3578723961,3578724005,44
0,872,13909,3578723961,3578724005,44
0,872,13910,3578723961,3578724008,47
0,872,13911,3578723961,3578724008,47
0,872,13912,3578723961,3578724011,50
0,873,13913,3578724017,3578724017,0
0,873,13914,3578724017,3578724017,0
0,873,13915,3578724017,3578724017,0
0,873,13916,3578724017,3578724017,0
0,873,13917,3578724017,3578724017,0
0,873,13918,3578724017,3578724017,0
0,873,13919,3578724017,3578724017,0
0,873,13920,3578724017,3578724018,1
0,873,13921,3578724017,3578724019,2
0,873,13922,3578724017,3578724019,2
0,873,13923,3578724017,3578724024,7
0,873,13924,3578724017,3578724025,8
0,873,13925,3578724017,3578724027,10
0,873,13926,3578724017,3578724028,11
0,873,13927,3578724017,3578724031,14
0,873,13928,3578724017,3578724031,14
0,873,13929,3578724017,3578724032,15
0,873,13930,3578724017,3578724034,17
0,873,13931,3578724017,3578724036,19
0,873,13932,3578724017,3578724036,19
0,873,13933,3578724017,3578724037,20
0,873,13934,3578724017,3578724039,22
0,873,13935,3578724017,3578724039,22
0,873,13936,3578724017,3578724040,23
0,873,13937,3578724017,3578724043,26
0,873,13938,3578724017,3578724048,31
0,873,13939,3578724017,3578724048,31
0,873,13940,3578724017,3578724049,32
0,873,13941,3578724017,3578724050,33
0,873,13942,3578724017,3578724054,37
0,873,13943,3578724017,3578724057,40
0,873,13944,3578724017,3578724057,40
0,873,13945,3578724017,3578724059,42
0,873,13946,3578724017,3578724062,45
0,873,13947,3578724017,3578724063,46
0,873,13948,3578724017,3578724063,46
0,873,13949,3578724017,3578724065,48
0,873,13950,3578724017,3578724066,49
0,873,13951,3578724017,3578724066,49
0,873,13952,3578724017,3578724067,50
0,874,13953,3578724073,3578724073,0
0,874,13954,3578724073,3578724073,0
0,874,13955,3578724073,3578724073,0
0,874,13956,3578724073,3578724073,0
0,874,13957,3578724073,3578724077,4
0,874,13958,3578724073,3578724080,7
0,874,13959,3578724073,3578724084,11
0,874,13960,3578724073,3578724084,11
0,874,13961,3578724073,3578724085,12
0,874,13962,3578724073,3578724086,13
0,874,13963,3578724073,3578724087,14
0,874,13964,3578724073,3578724088,15
0,874,13965,3578724073,3578724091,18
0,874,13966,3578724073,3578724092,19
0,874,13967,3578724073,3578724095,22
0,874,13968,3578724073,3578724095,22
0,874,13969,3578724073,3578724096,23
0,874,13970,3578724073,3578724096,23
0,874,13971,3578724073,3578724097,24
0,874,13972,3578724073,3578724097,24
0,874,13973,3578724073,3578724098,25
0,874,13974,3578724073,3578724099,26
0,874,13975,3578724073,3578724099,26
0,874,13976,3578724073,3578724099,26
0,874,13977,3578724073,3578724100,27
0,874,13978,3578724073,3578724101,28
0,874,13979,3578724073,3578724103,30
0,874,13980,3578724073,3578724103,30
0,874,13981,3578724073,3578724104,31
0,874,13982,3578724073,3578724105,32
0,874,13983,3578724073,3578724105,32
0,874,13984,3578724073,3578724106,33
0,874,13985,3578724073,3578724106,33
0,874,13986,3578724073,3578724107,34
0,874,13987,3578724073,3578724107,34
0,874,13988,3578724073,3578724107,34
0,874,13989,3578724073,3578724109,36
0,874,13990,3578724073,3578724109,36
0,874,13991,3578724073,3578724110,37
0,874,13992,3578724073,3578724114,41
0,874,13993,3578724073,3578724114,41
0,874,13994,3578724073,3578724115,42
0,874,13995,3578724073,3578724116,43
0,874,13996,3578724073,3578724116,43
0,874,13997,3578724073,3578724117,44
0,874,13998,3578724073,3578724120,47
0,874,13999,3578724073,3578724121,48
0,875,14000,3578724129,3578724129,0
0,875,14001,3578724129,3578724129,0
0,875,14002,3578724129,3578724129,0
0,875,14003,3578724129,3578724129,0
0,875,14004,3578724129,3578724129,0
0,875,14005,3578724129,3578724129,0
0,875,14006,3578724129,3578724129,0
0,875,14007,3578724129,3578724130,1
0,875,14008,3578724129,3578724131,2
0,875,14009,3578724129,3578724131,2
0,875,14010,3578724129,3578724132,3
0,875,14011,3578724129,3578724133,4
0,875,14012,3578724129,3578724136,7
0,875,14013,3578724129,3578724139,10
0,875,14014,3578724129,3578724140,11
0,875,14015,3578724129,3578724141,12
0,875,14016,3578724129,3578724142,13
0,875,14017,3578724129,3578724142,13
0,875,14018,3578724129,3578724143,14
0,875,14019,3578724129,3578724144,15
0,875,14020,3578724129,3578724146,17
0,875,14021,3578724129,3578724146,17
0,875,14022,3578724129,3578724148,19
0,875,14023,3578724129,3578724148,19
0,875,14024,3578724129,3578724151,22
0,875,14025,3578724129,3578724153,24
0,875,14026,3578724129,3578724153,24
0,875,14027,3578724129,3578724154,25
0,875,14028,3578724129,3578724155,26
0,875,14029,3578724129,3578724156,27
0,875,14030,3578724129,3578724158,29
0,875,14031,3578724129,3578724159,30
0,875,14032,3578724129,3578724160,31
0,875,14033,3578724129,3578724161,32
0,875,14034,3578724129,3578724161,32
0,875,14035,3578724129,3578724162,33
0,875,14036,3578724129,3578724162,33
0,875,14037,3578724129,3578724162,33
0,875,14038,3578724129,3578724164,35
0,875,14039,3578724129,3578724165,36
0,875,14040,3578724129,3578724168,39
0,875,14041,3578724129,3578724169,40
0,875,14042,3578724129,3578724169,40
0,875,14043,3578724129,3578724170,41
0,875,14044,3578724129,3578724172,43
0,875,14045,3578724129,3578724173,44
0,875,14046,3578724129,3578724173,44
0,875,14047,3578724129,3578724173,44
0,875,14048,3578724129,3578724173,44
0,875,14049,3578724129,3578724174,45
0,875,14050,3578724129,3578724176,47
0,876,14051,3578724186,3578724186,0
0,876,14052,3578724186,3578724186,0
0,876,14053,3578724186,3578724186,0
0,876,14054,3578724186,3578724186,0
0,876,14055,3578724186,3578724186,0
0,876,14056,3578724186,3578724186,0
0,876,14057,3578724186,3578724186,0
0,876,14058,3578724186,3578724186,0
0,876,14059,3578724186,3578724186,0
0,876,14060,3578724186,3578724187,1
0,876,14061,3578724186,3578724187,1
0,876,14062,3578724186,3578724189,3
0,876,14063,3578724186,3578724190,4
0,876,14064,3578724186,3578724191,5
0,876,14065,3578724186,3578724193,7
0,876,14066,3578724186,3578724194,8
0,876,14067,3578724186,3578724194,8
0,876,14068,3578724186,3578724194,8
0,876,14069,3578724186,3578724197,11
0,876,14070,3578724186,3578724197,11
0,876,14071,3578724186,3578724199,13
0,876,14072,3578724186,3578724203,17
0,876,14073,3578724186,3578724205,19
0,876,14074,3578724186,3578724205,19
0,876,14075,3578724186,3578724206,20
0,876,14076,3578724186,3578724206,20
0,876,14077,3578724186,3578724208,22
0,876,14078,3578724186,3578724214,28
0,876,14079,3578724186,3578724215,29
0,876,14080,3578724186,3578724215,29
0,876,14081,3578724186,3578724215,29
0,876,14082,3578724186,3578724216,30
0,876,14083,3578724186,3578724218,32
0,876,14084,3578724186,3578724219,33
0,876,14085,3578724186,3578724219,33
0,876,14086,3578724186,3578724220,34
0,876,14087,3578724186,3578724224,38
0,876,14088,3578724186,3578724226,40
0,876,14089,3578724186,3578724227,41
0,876,14090,3578724186,3578724229,43
0,876,14091,3578724186,3578724231,45
0,876,14092,3578724186,3578724232,46
0,876,14093,3578724186,3578724233,47
0,876,14094,3578724186,3578724236,50
0,877,14095,3578724243,3578724243,0
0,877,14096,3578724243,3578724243,0
0,877,14097,3578724243,3578724243,0
0,877,14098,3578724243,3578724243,0
0,877,14099,3578724243,3578724243,0
0,877,14100,3578724243,3578724243,0
0,877,14101,3578724243,3578724248,5
0,877,14102,3578724243,3578724248,5
0,877,14103,3578724243,3578724249,6
0,877,14104,3578724243,3578724249,6
0,877,14105,3578724243,3578724250,7
0,877,14106,3578724243,3578724253,10
0,877,14107,3578724243,3578724255,12
0,877,14108,3578724243,3578724256,13
0,877,14109,3578724243,3578724259,16
0,877,14110,3578724243,3578724259,16
0,877,14111,3578724243,3578724262,19
0,877,14112,3578724243,3578724263,20
0,877,14113,3578724243,3578724265,22
0,877,14114,3578724243,3578724266,23
0,877,14115,3578724243,3578724267,24
0,877,14116,3578724243,3578724267,24
0,877,14117,3578724243,3578724268,25
0,877,14118,3578724243,3578724270,27
0,877,14119,3578724243,3578724270,27
0,877,14120,3578724243,3578724270,27
0,877,14121,3578724243,3578724277,34
0,877,14122,3578724243,3578724278,35
0,877,14123,3578724243,3578724280,37
0,877,14124,3578724243,3578724283,40
0,877,14125,3578724243,3578724284,41
0,877,14126,3578724243,3578724286,43
0,877,14127,3578724243,3578724286,43
0,877,14128,3578724243,3578724288,45
0,877,14129,3578724243,3578724288,45
0,877,14130,3578724243,3578724291,48
0,877,14131,3578724243,3578724292,49
0,878,14132,3578724299,3578724299,0
0,878,14133,3578724299,3578724299,0
0,878,14134,3578724299,3578724299,0
0,878,14135,3578724299,3578724299,0
0,878,14136,3578724299,3578724299,0
0,878,14137,3578724299,3578724299,0
0,878,14138,3578724299,3578724300,1
0,878,14139,3578724299,3578724300,1
0,878,14140,3578724299,3578724300,1
0,878,14141,3578724299,3578724300,1
0,878,14142,3578724299,3578724302,3
0,878,14143,3578724299,3578724304,5
0,878,14144,3578724299,3578724304,5
0,878,14145,3578724299,3578724305,6
0,878,14146,3578724299,3578724306,7
0,878,14147,3578724299,3578724306,7
0,878,14148,3578724299,3578724306,7
0,878,14149,3578724299,3578724307,8
0,878,14150,3578724299,3578724307,8
0,878,14151,3578724299,3578724308,9
0,878,14152,3578724299,3578724309,10
0,878,14153,3578724299,3578724309,10
0,878,14154,3578724299,3578724310,11
0,878,14155,3578724299,3578724313,14
0,878,14156,3578724299,3578724315,16
0,878,14157,3578724299,3578724316,17
0,878,14158,3578724299,3578724316,17
0,878,14159,3578724299,3578724318,19
0,878,14160,3578724299,3578724320,21
0,878,14161,3578724299,3578724320,21
0,878,14162,3578724299,3578724323,24
0,878,14163,3578724299,3578724323,24
0,878,14164,3578724299,3578724325,26
0,878,14165,3578724299,3578724326,27
0,878,14166,3578724299,3578724327,28
0,878,14167,3578724299,3578724329,30
0,878,14168,3578724299,3578724329,30
0,878,14169,3578724299,3578724329,30
0,878,14170,3578724299,3578724330,31
0,878,14171,3578724299,3578724331,32
0,878,14172,3578724299,3578724331,32
0,878,14173,3578724299,3578724333,34
0,878,14174,3578724299,3578724334,35
0,878,14175,3578724299,3578724336,37
0,878,14176,3578724299,3578724339,40
0,878,14177,3578724299,3578724340,41
0,878,14178,3578724299,3578724341,42
0,878,14179,3578724299,3578724341,42
0,878,14180,3578724299,3578724342,43
0,878,14181,3578724299,3578724343,44
0,878,14182,3578724299,3578724343,44
0,878,14183,3578724299,3578724344,45
0,878,14184,3578724299,3578724346,47
0,878,14185,3578724299,3578724347,48
0,879,14186,3578724356,3578724356,0
0,879,14187,3578724356,3578724356,0
0,879,14188,3578724356,3578724356,0
0,879,14189,3578724356,3578724356,0
0,879,14190,3578724356,3578724356,0
0,879,14191,3578724356,3578724356,0
0,879,14192,3578724356,3578724356,0
0,879,14193,3578724356,3578724356,0
0,879,14194,3578724356,3578724359,3
0,879,14195,3578724356,3578724359,3
0,879,14196,3578724356,3578724361,5
0,879,14197,3578724356,3578724361,5
0,879,14198,3578724356,3578724361,5
0,879,14199,3578724356,3578724362,6
0,879,14200,3578724356,3578724362,6
0,879,14201,3578724356,3578724364,8
0,879,14202,3578724356,3578724365,9
0,879,14203,3578724356,3578724368,12
0,879,14204,3578724356,3578724369,13
0,879,14205,3578724356,3578724369,13
0,879,14206,3578724356,3578724369,13
0,879,14207,3578724356,3578724370,14
0,879,14208,3578724356,3578724372,16
0,879,14209,3578724356,3578724373,17
0,879,14210,3578724356,3578724374,18
0,879,14211,3578724356,3578724374,18
0,879,14212,3578724356,3578724374,18
0,879,14213,3578724356,3578724380,24
0,879,14214,3578724356,3578724380,24
0,879,14215,3578724356,3578724380,24
0,879,14216,3578724356,3578724381,25
0,879,14217,3578724356,3578724382,26
0,879,14218,3578724356,3578724383,27
0,879,14219,3578724356,3578724383,27
0,879,14220,3578724356,3578724383,27
0,879,14221,3578724356,3578724385,29
0,879,14222,3578724356,3578724387,31
0,879,14223,3578724356,3578724387,31
0,879,14224,3578724356,3578724390,34
0,879,14225,3578724356,3578724391,35
0,879,14226,3578724356,3578724392,36
0,879,14227,3578724356,3578724393,37
0,879,14228,3578724356,3578724394,38
0,879,14229,3578724356,3578724394,38
0,879,14230,3578724356,3578724395,39
0,879,14231,3578724356,3578724396,40
0,879,14232,3578724356,3578724397,41
0,879,14233,3578724356,3578724400,44
0,879,14234,3578724356,3578724401,45
0,879,14235,3578724356,3578724403,47
0,879,14236,3578724356,3578724405,49
0,879,14237,3578724356,3578724406,50
0,880,14238,3578724413,3578724413,0
0,880,14239,3578724413,3578724413,0
0,880,14240,3578724413,3578724413,0
0,880,14241,3578724413,3578724413,0
0,880,14242,3578724413,3578724413,0
0,880,14243,3578724413,3578724413,0
0,880,14244,3578724413,3578724414,1
0,880,14245,3578724413,3578724415,2
0,880,14246,3578724413,3578724415,2
0,880,14247,3578724413,3578724415,2
0,880,14248,3578724413,3578724416,3
0,880,14249,3578724413,3578724418,5
0,880,14250,3578724413,3578724418,5
0,880,14251,3578724413,3578724420,7
0,880,14252,3578724413,3578724423,10
0,880,14253,3578724413,3578724425,12
0,880,14254,3578724413,3578724428,15
0,880,14255,3578724413,3578724429,16
0,880,14256,3578724413,3578724431,18
0,880,14257,3578724413,3578724432,19
0,880,14258,3578724413,3578724432,19
0,880,14259,3578724413,3578724434,21
0,880,14260,3578724413,3578724436,23
0,880,14261,3578724413,3578724436,23
0,880,14262,3578724413,3578724440,27
0,880,14263,3578724413,3578724440,27
0,880,14264,3578724413,3578724441,28
0,880,14265,3578724413,3578724444,31
0,880,14266,3578724413,3578724446,33
0,880,14267,3578724413,3578724449,36
0,880,14268,3578724413,3578724449,36
0,880,14269,3578724413,3578724450,37
0,880,14270,3578724413,3578724450,37
0,880,14271,3578724413,3578724453,40
0,880,14272,3578724413,3578724455,42
0,880,14273,3578724413,3578724455,42
0,880,14274,3578724413,3578724458,45
0,880,14275,3578724413,3578724459,46
0,880,14276,3578724413,3578724459,46
0,880,14277,3578724413,3578724462,49
0,880,14278,3578724413,3578724462,49
0,880,14279,3578724413,3578724462,49
0,881,14280,3578724469,3578724470,1
0,881,14281,3578724469,3578724470,1
0,881,14282,3578724469,3578724470,1
0,881,14283,3578724469,3578724470,1
0,881,14284,3578724469,3578724470,1
0,881,14285,3578724469,3578724470,1
0,881,14286,3578724469,3578724470,1
0,881,14287,3578724469,3578724470,1
0,881,14288,3578724469,3578724470,1
0,881,14289,3578724469,3578724477,8
0,881,14290,3578724469,3578724479,10
0,881,14291,3578724469,3578724480,11
0,881,14292,3578724469,3578724484,15
0,881,14293,3578724469,3578724484,15
0,881,14294,3578724469,3578724486,17
0,881,14295,3578724469,3578724486,17
0,881,14296,3578724469,3578724488,19
0,881,14297,3578724469,3578724488,19
0,881,14298,3578724469,3578724492,23
0,881,14299,3578724469,3578724492,23
0,881,14300,3578724469,3578724496,27
0,881,14301,3578724469,3578724497,28
0,881,14302,3578724469,3578724497,28
0,881,14303,3578724469,3578724498,29
0,881,14304,3578724469,3578724499,30
0,881,14305,3578724469,3578724500,31
0,881,14306,3578724469,3578724500,31
0,881,14307,3578724469,3578724500,31
0,881,14308,3578724469,3578724500,31
0,881,14309,3578724469,3578724502,33
0,881,14310,3578724469,3578724503,34
0,881,14311,3578724469,3578724503,34
0,881,14312,3578724469,3578724504,35
0,881,14313,3578724469,3578724504,35
0,881,14314,3578724469,3578724505,36
0,881,14315,3578724469,3578724506,37
0,881,14316,3578724469,3578724506,37
0,881,14317,3578724469,3578724506,37
0,881,14318,3578724469,3578724506,37
0,881,14319,3578724469,3578724507,38
0,881,14320,3578724469,3578724509,40
0,881,14321,3578724469,3578724509,40
0,881,14322,3578724469,3578724510,41
0,881,14323,3578724469,3578724514,45
0,881,14324,3578724469,3578724514,45
0,881,14325,3578724469,3578724516,47
0,881,14326,3578724469,3578724516,47
0,881,14327,3578724469,3578724518,49
0,882,14328,3578724526,3578724526,0
0,882,14329,3578724526,3578724526,0
0,882,14330,3578724526,3578724526,0
0,882,14331,3578724526,3578724526,0
0,882,14332,3578724526,3578724526,0
0,882,14333,3578724526,3578724526,0
0,882,14334,3578724526,3578724528,2
0,882,14335,3578724526,3578724529,3
0,882,14336,3578724526,3578724529,3
0,882,14337,3578724526,3578724530,4
0,882,14338,3578724526,3578724530,4
0,882,14339,3578724526,3578724530,4
0,882,14340,3578724526,3578724532,6
0,882,14341,3578724526,3578724533,7
0,882,14342,3578724526,3578724535,9
0,882,14343,3578724526,3578724539,13
0,882,14344,3578724526,3578724539,13
0,882,14345,3578724526,3578724540,14
0,882,14346,3578724526,3578724540,14
0,882,14347,3578724526,3578724540,14
0,882,14348,3578724526,3578724542,16
0,882,14349,3578724526,3578724542,16
0,882,14350,3578724526,3578724542,16
0,882,14351,3578724526,3578724544,18
0,882,14352,3578724526,3578724545,19
0,882,14353,3578724526,3578724546,20
0,882,14354,3578724526,3578724547,21
0,882,14355,3578724526,3578724551,25
0,882,14356,3578724526,3578724553,27
0,882,14357,3578724526,3578724554,28
0,882,14358,3578724526,3578724555,29
0,882,14359,3578724526,3578724556,30
0,882,14360,3578724526,3578724558,32
0,882,14361,3578724526,3578724558,32
0,882,14362,3578724526,3578724560,34
0,882,14363,3578724526,3578724560,34
0,882,14364,3578724526,3578724561,35
0,882,14365,3578724526,3578724561,35
0,882,14366,3578724526,3578724561,35
0,882,14367,3578724526,3578724561,35
0,882,14368,3578724526,3578724564,38
0,882,14369,3578724526,3578724564,38
0,882,14370,3578724526,3578724567,41
0,882,14371,3578724526,3578724568,42
0,882,14372,3578724526,3578724569,43
0,882,14373,3578724526,3578724569,43
0,882,14374,3578724526,3578724571,45
0,882,14375,3578724526,3578724572,46
0,882,14376,3578724526,3578724573,47
0,882,14377,3578724526,3578724573,47
0,882,14378,3578724526,3578724574,48
0,882,14379,3578724526,3578724574,48
0,883,14380,3578724582,3578724582,0
0,883,14381,3578724582,3578724582,0
0,883,14382,3578724582,3578724582,0
0,883,14383,3578724582,3578724582,0
0,883,14384,3578724582,3578724582,0
0,883,14385,3578724582,3578724582,0
0,883,14386,3578724582,3578724583,1
0,883,14387,3578724582,3578724583,1
0,883,14388,3578724582,3578724585,3
0,883,14389,3578724582,3578724585,3
0,883,14390,3578724582,3578724586,4
0,883,14391,3578724582,3578724588,6
0,883,14392,3578724582,3578724590,8
0,883,14393,3578724582,3578724591,9
0,883,14394,3578724582,3578724592,10
0,883,14395,3578724582,3578724593,11
0,883,14396,3578724582,3578724593,11
0,883,14397,3578724582,3578724593,11
0,883,14398,3578724582,3578724595,13
0,883,14399,3578724582,3578724596,14
0,883,14400,3578724582,3578724598,16
0,883,14401,3578724582,3578724600,18
0,883,14402,3578724582,3578724602,20
0,883,14403,3578724582,3578724604,22
0,883,14404,3578724582,3578724605,23
0,883,14405,3578724582,3578724605,23
0,883,14406,3578724582,3578724606,24
0,883,14407,3578724582,3578724607,25
0,883,14408,3578724582,3578724607,25
0,883,14409,3578724582,3578724611,29
0,883,14410,3578724582,3578724611,29
0,883,14411,3578724582,3578724614,32
0,883,14412,3578724582,3578724615,33
0,883,14413,3578724582,3578724615,33
0,883,14414,3578724582,3578724615,33
0,883,14415,3578724582,3578724616,34
0,883,14416,3578724582,3578724618,36
0,883,14417,3578724582,3578724618,36
0,883,14418,3578724582,3578724620,38
0,883,14419,3578724582,3578724622,40
0,883,14420,3578724582,3578724624,42
0,883,14421,3578724582,3578724627,45
0,883,14422,3578724582,3578724628,46
0,883,14423,3578724582,3578724631,49
0,883,14424,3578724582,3578724631,49
0,883,14425,3578724582,3578724631,49
0,884,14426,3578724638,3578724638,0
0,884,14427,3578724638,3578724638,0
0,884,14428,3578724638,3578724639,1
0,884,14429,3578724638,3578724640,2
0,884,14430,3578724638,3578724641,3
0,884,14431,3578724638,3578724643,5
0,884,14432,3578724638,3578724647,9
0,884,14433,3578724638,3578724647,9
0,884,14434,3578724638,3578724649,11
0,884,14435,3578724638,3578724649,11
0,884,14436,3578724638,3578724649,11
0,884,14437,3578724638,3578724652,14
0,884,14438,3578724638,3578724654,16
0,884,14439,3578724638,3578724654,16
0,884,14440,3578724638,3578724657,19
0,884,14441,3578724638,3578724658,20
0,884,14442,3578724638,3578724659,21
0,884,14443,3578724638,3578724661,23
0,884,14444,3578724638,3578724662,24
0,884,14445,3578724638,3578724664,26
0,884,14446,3578724638,3578724665,27
0,884,14447,3578724638,3578724665,27
0,884,14448,3578724638,3578724666,28
0,884,14449,3578724638,3578724666,28
0,884,14450,3578724638,3578724669,31
0,884,14451,3578724638,3578724669,31
0,884,14452,3578724638,3578724669,31
0,884,14453,3578724638,3578724676,38
0,884,14454,3578724638,3578724680,42
0,884,14455,3578724638,3578724684,46
0,884,14456,3578724638,3578724684,46
0,884,14457,3578724638,3578724686,48
0,884,14458,3578724638,3578724686,48
0,884,14459,3578724638,3578724687,49
0,884,14460,3578724638,3578724688,50
0,885,14461,3578724693,3578724693,0
0,885,14462,3578724693,3578724696,3
0,885,14463,3578724693,3578724696,3
0,885,14464,3578724693,3578724697,4
0,885,14465,3578724693,3578724697,4
0,885,14466,3578724693,3578724699,6
0,885,14467,3578724693,3578724700,7
0,885,14468,3578724693,3578724700,7
0,885,14469,3578724693,3578724700,7
0,885,14470,3578724693,3578724700,7
0,885,14471,3578724693,3578724701,8
0,885,14472,3578724693,3578724704,11
0,885,14473,3578724693,3578724704,11
0,885,14474,3578724693,3578724705,12
0,885,14475,3578724693,3578724706,13
0,885,14476,3578724693,3578724706,13
0,885,14477,3578724693,3578724707,14
0,885,14478,3578724693,3578724707,14
0,885,14479,3578724693,3578724707,14
0,885,14480,3578724693,3578724707,14
0,885,14481,3578724693,3578724709,16
0,885,14482,3578724693,3578724709,16
0,885,14483,3578724693,3578724709,16
0,885,14484,3578724693,3578724711,18
0,885,14485,3578724693,3578724714,21
0,885,14486,3578724693,3578724716,23
0,885,14487,3578724693,3578724716,23
0,885,14488,3578724693,3578724717,24
0,885,14489,3578724693,3578724720,27
0,885,14490,3578724693,3578724721,28
0,885,14491,3578724693,3578724723,30
0,885,14492,3578724693,3578724723,30
0,885,14493,3578724693,3578724725,32
0,885,14494,3578724693,3578724725,32
0,885,14495,3578724693,3578724728,35
0,885,14496,3578724693,3578724728,35
0,885,14497,3578724693,3578724729,36
0,885,14498,3578724693,3578724730,37
0,885,14499,3578724693,3578724730,37
0,885,14500,3578724693,3578724730,37
0,885,14501,3578724693,3578724731,38
0,885,14502,3578724693,3578724733,40
0,885,14503,3578724693,3578724733,40
0,885,14504,3578724693,3578724736,43
0,885,14505,3578724693,3578724739,46
0,885,14506,3578724693,3578724739,46
0,885,14507,3578724693,3578724740,47
0,885,14508,3578724693,3578724740,47
0,885,14509,3578724693,3578724742,49
0,885,14510,3578724693,3578724742,49
0,885,14511,3578724693,3578724743,50
0,886,14512,3578724749,3578724749,0
0,886,14513,3578724749,3578724749,0
0,886,14514,3578724749,3578724749,0
0,886,14515,3578724749,3578724749,0
0,886,14516,3578724749,3578724749,0
0,886,14517,3578724749,3578724750,1
0,886,14518,3578724749,3578724751,2
0,886,14519,3578724749,3578724753,4
0,886,14520,3578724749,3578724755,6
0,886,14521,3578724749,3578724755,6
0,886,14522,3578724749,3578724757,8
0,886,14523,3578724749,3578724758,9
0,886,14524,3578724749,3578724759,10
0,886,14525,3578724749,3578724760,11
0,886,14526,3578724749,3578724760,11
0,886,14527,3578724749,3578724761,12
0,886,14528,3578724749,3578724761,12
0,886,14529,3578724749,3578724761,12
0,886,14530,3578724749,3578724762,13
0,886,14531,3578724749,3578724762,13
0,886,14532,3578724749,3578724764,15
0,886,14533,3578724749,3578724764,15
0,886,14534,3578724749,3578724767,18
0,886,14535,3578724749,3578724768,19
0,886,14536,3578724749,3578724768,19
0,886,14537,3578724749,3578724769,20
0,886,14538,3578724749,3578724770,21
0,886,14539,3578724749,3578724771,22
0,886,14540,3578724749,3578724772,23
0,886,14541,3578724749,3578724772,23
0,886,14542,3578724749,3578724773,24
0,886,14543,3578724749,3578724773,24
0,886,14544,3578724749,3578724779,30
0,886,14545,3578724749,3578724780,31
0,886,14546,3578724749,3578724781,32
0,886,14547,3578724749,3578724782,33
0,886,14548,3578724749,3578724782,33
0,886,14549,3578724749,3578724783,34
0,886,14550,3578724749,3578724785,36
0,886,14551,3578724749,3578724786,37
0,886,14552,3578724749,3578724787,38
0,886,14553,3578724749,3578724789,40
0,886,14554,3578724749,3578724791,42
0,886,14555,3578724749,3578724791,42
0,886,14556,3578724749,3578724793,44
0,886,14557,3578724749,3578724793,44
0,886,14558,3578724749,3578724794,45
0,886,14559,3578724749,3578724795,46
0,886,14560,3578724749,3578724797,48
0,886,14561,3578724749,3578724798,49
0,887,14562,3578724805,3578724805,0
0,887,14563,3578724805,3578724805,0
0,887,14564,3578724805,3578724805,0
0,887,14565,3578724805,3578724805,0
0,887,14566,3578724805,3578724807,2
0,887,14567,3578724805,3578724807,2
0,887,14568,3578724805,3578724808,3
0,887,14569,3578724805,3578724809,4
0,887,14570,3578724805,3578724809,4
0,887,14571,3578724805,3578724812,7
0,887,14572,3578724805,3578724814,9
0,887,14573,3578724805,3578724815,10
0,887,14574,3578724805,3578724815,10
0,887,14575,3578724805,3578724815,10
0,887,14576,3578724805,3578724816,11
0,887,14577,3578724805,3578724818,13
0,887,14578,3578724805,3578724819,14
0,887,14579,3578724805,3578724819,14
0,887,14580,3578724805,3578724820,15
0,887,14581,3578724805,3578724822,17
0,887,14582,3578724805,3578724824,19
0,887,14583,3578724805,3578724827,22
0,887,14584,3578724805,3578724828,23
0,887,14585,3578724805,3578724831,26
0,887,14586,3578724805,3578724831,26
0,887,14587,3578724805,3578724832,27
0,887,14588,3578724805,3578724834,29
0,887,14589,3578724805,3578724835,30
0,887,14590,3578724805,3578724836,31
0,887,14591,3578724805,3578724839,34
0,887,14592,3578724805,3578724839,34
0,887,14593,3578724805,3578724841,36
0,887,14594,3578724805,3578724848,43
0,887,14595,3578724805,3578724849,44
0,887,14596,3578724805,3578724849,44
0,887,14597,3578724805,3578724850,45
0,887,14598,3578724805,3578724852,47
0,887,14599,3578724805,3578724854,49
0,887,14600,3578724805,3578724854,49
0,888,14601,3578724862,3578724862,0
0,888,14602,3578724862,3578724862,0
0,888,14603,3578724862,3578724862,0
0,888,14604,3578724862,3578724862,0
0,888,14605,3578724862,3578724863,1
0,888,14606,3578724862,3578724864,2
0,888,14607,3578724862,3578724865,3
0,888,14608,3578724862,3578724865,3
0,888,14609,3578724862,3578724866,4
0,888,14610,3578724862,3578724867,5
0,888,14611,3578724862,3578724867,5
0,888,14612,3578724862,3578724869,7
0,888,14613,3578724862,3578724869,7
0,888,14614,3578724862,3578724870,8
0,888,14615,3578724862,3578724876,14
0,888,14616,3578724862,3578724878,16
0,888,14617,3578724862,3578724880,18
0,888,14618,3578724862,3578724884,22
0,888,14619,3578724862,3578724885,23
0,888,14620,3578724862,3578724886,24
0,888,14621,3578724862,3578724886,24
0,888,14622,3578724862,3578724888,26
0,888,14623,3578724862,3578724888,26
0,888,14624,3578724862,3578724891,29
0,888,14625,3578724862,3578724892,30
0,888,14626,3578724862,3578724896,34
0,888,14627,3578724862,3578724896,34
0,888,14628,3578724862,3578724897,35
0,888,14629,3578724862,3578724897,35
0,888,14630,3578724862,3578724898,36
0,888,14631,3578724862,3578724899,37
0,888,14632,3578724862,3578724900,38
0,888,14633,3578724862,3578724900,38
0,888,14634,3578724862,3578724900,38
0,888,14635,3578724862,3578724901,39
0,888,14636,3578724862,3578724903,41
0,888,14637,3578724862,3578724905,43
0,888,14638,3578724862,3578724905,43
0,888,14639,3578724862,3578724905,43
0,888,14640,3578724862,3578724905,43
0,888,14641,3578724862,3578724906,44
0,888,14642,3578724862,3578724906,44
0,888,14643,3578724862,3578724907,45
0,888,14644,3578724862,3578724907,45
0,888,14645,3578724862,3578724907,45
0,888,14646,3578724862,3578724908,46
0,888,14647,3578724862,3578724908,46
0,888,14648,3578724862,3578724909,47
0,888,14649,3578724862,3578724909,47
0,888,14650,3578724862,3578724910,48
0,888,14651,3578724862,3578724911,49
0,889,14652,3578724919,3578724919,0
0,889,14653,3578724919,3578724919,0
0,889,14654,3578724919,3578724919,0
0,889,14655,3578724919,3578724919,0
0,889,14656,3578724919,3578724919,0
0,889,14657,3578724919,3578724919,0
0,889,14658,3578724919,3578724921,2
0,889,14659,3578724919,3578724921,2
0,889,14660,3578724919,3578724923,4
0,889,14661,3578724919,3578724923,4
0,889,14662,3578724919,3578724925,6
0,889,14663,3578724919,3578724925,6
0,889,14664,3578724919,3578724927,8
0,889,14665,3578724919,3578724929,10
0,889,14666,3578724919,3578724929,10
0,889,14667,3578724919,3578724930,11
0,889,14668,3578724919,3578724930,11
0,889,14669,3578724919,3578724930,11
0,889,14670,3578724919,3578724931,12
0,889,14671,3578724919,3578724933,14
0,889,14672,3578724919,3578724934,15
0,889,14673,3578724919,3578724936,17
0,889,14674,3578724919,3578724939,20
0,889,14675,3578724919,3578724941,22
0,889,14676,3578724919,3578724941,22
0,889,14677,3578724919,3578724941,22
0,889,14678,3578724919,3578724942,23
0,889,14679,3578724919,3578724943,24
0,889,14680,3578724919,3578724943,24
0,889,14681,3578724919,3578724945,26
0,889,14682,3578724919,3578724945,26
0,889,14683,3578724919,3578724948,29
0,889,14684,3578724919,3578724949,30
0,889,14685,3578724919,3578724950,31
0,889,14686,3578724919,3578724952,33
0,889,14687,3578724919,3578724954,35
0,889,14688,3578724919,3578724955,36
0,889,14689,3578724919,3578724955,36
0,889,14690,3578724919,3578724957,38
0,889,14691,3578724919,3578724958,39
0,889,14692,3578724919,3578724959,40
0,889,14693,3578724919,3578724961,42
0,889,14694,3578724919,3578724961,42
0,889,14695,3578724919,3578724961,42
0,889,14696,3578724919,3578724961,42
0,889,14697,3578724919,3578724961,42
0,889,14698,3578724919,3578724962,43
0,889,14699,3578724919,3578724962,43
0,889,14700,3578724919,3578724964,45
0,889,14701,3578724919,3578724964,45
0,889,14702,3578724919,3578724967,48
0,889,14703,3578724919,3578724968,49
0,889,14704,3578724919,3578724968,49
0,890,14705,3578724976,3578724976,0
0,890,14706,3578724976,3578724976,0
0,890,14707,3578724976,3578724976,0
0,890,14708,3578724976,3578724976,0
0,890,14709,3578724976,3578724976,0
0,890,14710,3578724976,3578724976,0
0,890,14711,3578724976,3578724976,0
0,890,14712,3578724976,3578724976,0
0,890,14713,3578724976,3578724979,3
0,890,14714,3578724976,3578724979,3
0,890,14715,3578724976,3578724980,4
0,890,14716,3578724976,3578724981,5
0,890,14717,3578724976,3578724981,5
0,890,14718,3578724976,3578724983,7
0,890,14719,3578724976,3578724985,9
0,890,14720,3578724976,3578724986,10
0,890,14721,3578724976,3578724987,11
0,890,14722,3578724976,3578724989,13
0,890,14723,3578724976,3578724990,14
0,890,14724,3578724976,3578724992,16
0,890,14725,3578724976,3578724993,17
0,890,14726,3578724976,3578724993,17
0,890,14727,3578724976,3578724996,20
0,890,14728,3578724976,3578724997,21
0,890,14729,3578724976,3578724998,22
0,890,14730,3578724976,3578725001,25
0,890,14731,3578724976,3578725004,28
0,890,14732,3578724976,3578725005,29
0,890,14733,3578724976,3578725006,30
0,890,14734,3578724976,3578725006,30
0,890,14735,3578724976,3578725008,32
0,890,14736,3578724976,3578725008,32
0,890,14737,3578724976,3578725012,36
0,890,14738,3578724976,3578725012,36
0,890,14739,3578724976,3578725013,37
0,890,14740,3578724976,3578725015,39
0,890,14741,3578724976,3578725015,39
0,890,14742,3578724976,3578725015,39
0,890,14743,3578724976,3578725016,40
0,890,14744,3578724976,3578725016,40
0,890,14745,3578724976,3578725018,42
0,890,14746,3578724976,3578725020,44
0,890,14747,3578724976,3578725020,44
0,890,14748,3578724976,3578725021,45
0,890,14749,3578724976,3578725022,46
0,890,14750,3578724976,3578725024,48
0,891,14751,3578725033,3578725033,0
0,891,14752,3578725033,3578725033,0
0,891,14753,3578725033,3578725033,0
0,891,14754,3578725033,3578725033,0
0,891,14755,3578725033,3578725033,0
0,891,14756,3578725033,3578725035,2
0,891,14757,3578725033,3578725035,2
0,891,14758,3578725033,3578725036,3
0,891,14759,3578725033,3578725040,7
0,891,14760,3578725033,3578725040,7
0,891,14761,3578725033,3578725042,9
0,891,14762,3578725033,3578725043,10
0,891,14763,3578725033,3578725047,14
0,891,14764,3578725033,3578725048,15
0,891,14765,3578725033,3578725049,16
0,891,14766,3578725033,3578725050,17
0,891,14767,3578725033,3578725052,19
0,891,14768,3578725033,3578725053,20
0,891,14769,3578725033,3578725054,21
0,891,14770,3578725033,3578725060,27
0,891,14771,3578725033,3578725060,27
0,891,14772,3578725033,3578725062,29
0,891,14773,3578725033,3578725063,30
0,891,14774,3578725033,3578725064,31
0,891,14775,3578725033,3578725065,32
0,891,14776,3578725033,3578725066,33
0,891,14777,3578725033,3578725066,33
0,891,14778,3578725033,3578725066,33
0,891,14779,3578725033,3578725067,34
0,891,14780,3578725033,3578725069,36
0,891,14781,3578725033,3578725069,36
0,891,14782,3578725033,3578725070,37
0,891,14783,3578725033,3578725080,47
0,892,14784,3578725089,3578725089,0
0,892,14785,3578725089,3578725089,0
0,892,14786,3578725089,3578725089,0
0,892,14787,3578725089,3578725089,0
0,892,14788,3578725089,3578725089,0
0,892,14789,3578725089,3578725089,0
0,892,14790,3578725089,3578725091,2
0,892,14791,3578725089,3578725096,7
0,892,14792,3578725089,3578725096,7
0,892,14793,3578725089,3578725098,9
0,892,14794,3578725089,3578725098,9
0,892,14795,3578725089,3578725099,10
0,892,14796,3578725089,3578725100,11
0,892,14797,3578725089,3578725100,11
0,892,14798,3578725089,3578725101,12
0,892,14799,3578725089,3578725101,12
0,892,14800,3578725089,3578725101,12
0,892,14801,3578725089,3578725102,13
0,892,14802,3578725089,3578725105,16
0,892,14803,3578725089,3578725105,16
0,892,14804,3578725089,3578725105,16
0,892,14805,3578725089,3578725106,17
0,892,14806,3578725089,3578725106,17
0,892,14807,3578725089,3578725106,17
0,892,14808,3578725089,3578725107,18
0,892,14809,3578725089,3578725107,18
0,892,14810,3578725089,3578725107,18
0,892,14811,3578725089,3578725108,19
0,892,14812,3578725089,3578725109,20
0,892,14813,3578725089,3578725109,20
0,892,14814,3578725089,3578725110,21
0,892,14815,3578725089,3578725110,21
0,892,14816,3578725089,3578725114,25
0,892,14817,3578725089,3578725115,26
0,892,14818,3578725089,3578725116,27
0,892,14819,3578725089,3578725116,27
0,892,14820,3578725089,3578725119,30
0,892,14821,3578725089,3578725121,32
0,892,14822,3578725089,3578725121,32
0,892,14823,3578725089,3578725123,34
0,892,14824,3578725089,3578725124,35
0,892,14825,3578725089,3578725125,36
0,892,14826,3578725089,3578725126,37
0,892,14827,3578725089,3578725127,38
0,892,14828,3578725089,3578725128,39
0,892,14829,3578725089,3578725129,40
0,892,14830,3578725089,3578725130,41
0,892,14831,3578725089,3578725131,42
0,892,14832,3578725089,3578725131,42
0,892,14833,3578725089,3578725131,42
0,892,14834,3578725089,3578725131,42
0,892,14835,3578725089,3578725132,43
0,892,14836,3578725089,3578725134,45
0,892,14837,3578725089,3578725136,47
0,892,14838,3578725089,3578725138,49
0,892,14839,3578725089,3578725139,50
0,893,14840,3578725145,3578725145,0
0,893,14841,3578725145,3578725145,0
0,893,14842,3578725145,3578725145,0
0,893,14843,3578725145,3578725145,0
0,893,14844,3578725145,3578725146,1
0,893,14845,3578725145,3578725146,1
0,893,14846,3578725145,3578725146,1
0,893,14847,3578725145,3578725146,1
0,893,14848,3578725145,3578725149,4
0,893,14849,3578725145,3578725150,5
0,893,14850,3578725145,3578725151,6
0,893,14851,3578725145,3578725154,9
0,893,14852,3578725145,3578725154,9
0,893,14853,3578725145,3578725155,10
0,893,14854,3578725145,3578725156,11
0,893,14855,3578725145,3578725158,13
0,893,14856,3578725145,3578725159,14
0,893,14857,3578725145,3578725160,15
0,893,14858,3578725145,3578725161,16
0,893,14859,3578725145,3578725161,16
0,893,14860,3578725145,3578725161,16
0,893,14861,3578725145,3578725162,17
0,893,14862,3578725145,3578725162,17
0,893,14863,3578725145,3578725165,20
0,893,14864,3578725145,3578725165,20
0,893,14865,3578725145,3578725166,21
0,893,14866,3578725145,3578725167,22
0,893,14867,3578725145,3578725168,23
0,893,14868,3578725145,3578725168,23
0,893,14869,3578725145,3578725170,25
0,893,14870,3578725145,3578725172,27
0,893,14871,3578725145,3578725172,27
0,893,14872,3578725145,3578725173,28
0,893,14873,3578725145,3578725173,28
0,893,14874,3578725145,3578725174,29
0,893,14875,3578725145,3578725174,29
0,893,14876,3578725145,3578725179,34
0,893,14877,3578725145,3578725179,34
0,893,14878,3578725145,3578725180,35
0,893,14879,3578725145,3578725180,35
0,893,14880,3578725145,3578725181,36
0,893,14881,3578725145,3578725182,37
0,893,14882,3578725145,3578725182,37
0,893,14883,3578725145,3578725183,38
0,893,14884,3578725145,3578725186,41
0,893,14885,3578725145,3578725186,41
0,893,14886,3578725145,3578725187,42
0,893,14887,3578725145,3578725189,44
0,893,14888,3578725145,3578725191,46
0,893,14889,3578725145,3578725192,47
0,893,14890,3578725145,3578725192,47
0,893,14891,3578725145,3578725192,47
0,893,14892,3578725145,3578725193,48
0,893,14893,3578725145,3578725194,49
0,894,14894,3578725201,3578725201,0
0,894,14895,3578725201,3578725201,0
0,894,14896,3578725201,3578725201,0
0,894,14897,3578725201,3578725204,3
0,894,14898,3578725201,3578725206,5
0,894,14899,3578725201,3578725206,5
0,894,14900,3578725201,3578725207,6
0,894,14901,3578725201,3578725208,7
0,894,14902,3578725201,3578725208,7
0,894,14903,3578725201,3578725211,10
0,894,14904,3578725201,3578725212,11
0,894,14905,3578725201,3578725215,14
0,894,14906,3578725201,3578725215,14
0,894,14907,3578725201,3578725215,14
0,894,14908,3578725201,3578725215,14
0,894,14909,3578725201,3578725217,16
0,894,14910,3578725201,3578725217,16
0,894,14911,3578725201,3578725218,17
0,894,14912,3578725201,3578725219,18
0,894,14913,3578725201,3578725222,21
0,894,14914,3578725201,3578725222,21
0,894,14915,3578725201,3578725225,24
0,894,14916,3578725201,3578725228,27
0,894,14917,3578725201,3578725229,28
0,894,14918,3578725201,3578725231,30
0,894,14919,3578725201,3578725232,31
0,894,14920,3578725201,3578725233,32
0,894,14921,3578725201,3578725233,32
0,894,14922,3578725201,3578725234,33
0,894,14923,3578725201,3578725236,35
0,894,14924,3578725201,3578725236,35
0,894,14925,3578725201,3578725239,38
0,894,14926,3578725201,3578725240,39
0,894,14927,3578725201,3578725242,41
0,894,14928,3578725201,3578725243,42
0,894,14929,3578725201,3578725248,47
0,894,14930,3578725201,3578725248,47
0,894,14931,3578725201,3578725250,49
0,894,14932,3578725201,3578725250,49
0,895,14933,3578725258,3578725258,0
0,895,14934,3578725258,3578725258,0
0,895,14935,3578725258,3578725258,0
0,895,14936,3578725258,3578725258,0
0,895,14937,3578725258,3578725260,2
0,895,14938,3578725258,3578725261,3
0,895,14939,3578725258,3578725262,4
0,895,14940,3578725258,3578725262,4
0,895,14941,3578725258,3578725265,7
0,895,14942,3578725258,3578725267,9
0,895,14943,3578725258,3578725267,9
0,895,14944,3578725258,3578725267,9
0,895,14945,3578725258,3578725267,9
0,895,14946,3578725258,3578725268,10
0,895,14947,3578725258,3578725269,11
0,895,14948,3578725258,3578725270,12
0,895,14949,3578725258,3578725271,13
0,895,14950,3578725258,3578725277,19
0,895,14951,3578725258,3578725278,20
0,895,14952,3578725258,3578725280,22
0,895,14953,3578725258,3578725284,26
0,895,14954,3578725258,3578725285,27
0,895,14955,3578725258,3578725286,28
0,895,14956,3578725258,3578725287,29
0,895,14957,3578725258,3578725288,30
0,895,14958,3578725258,3578725288,30
0,895,14959,3578725258,3578725291,33
0,895,14960,3578725258,3578725292,34
0,895,14961,3578725258,3578725296,38
0,895,14962,3578725258,3578725296,38
0,895,14963,3578725258,3578725298,40
0,895,14964,3578725258,3578725298,40
0,895,14965,3578725258,3578725299,41
0,895,14966,3578725258,3578725300,42
0,895,14967,3578725258,3578725300,42
0,895,14968,3578725258,3578725301,43
0,895,14969,3578725258,3578725302,44
0,895,14970,3578725258,3578725302,44
0,895,14971,3578725258,3578725302,44
0,895,14972,3578725258,3578725303,45
0,895,14973,3578725258,3578725305,47
0,895,14974,3578725258,3578725305,47
0,895,14975,3578725258,3578725305,47
0,895,14976,3578725258,3578725306,48
0,895,14977,3578725258,3578725306,48
0,895,14978,3578725258,3578725307,49
0,895,14979,3578725258,3578725307,49
0,895,14980,3578725258,3578725307,49
0,895,14981,3578725258,3578725307,49
0,895,14982,3578725258,3578725308,50
0,896,14983,3578725314,3578725314,0
0,896,14984,3578725314,3578725314,0
0,896,14985,3578725314,3578725314,0
0,896,14986,3578725314,3578725315,1
0,896,14987,3578725314,3578725316,2
0,896,14988,3578725314,3578725316,2
0,896,14989,3578725314,3578725317,3
0,896,14990,3578725314,3578725319,5
0,896,14991,3578725314,3578725319,5
0,896,14992,3578725314,3578725320,6
0,896,14993,3578725314,3578725321,7
0,896,14994,3578725314,3578725322,8
0,896,14995,3578725314,3578725323,9
0,896,14996,3578725314,3578725324,10
0,896,14997,3578725314,3578725325,11
0,896,14998,3578725314,3578725326,12
0,896,14999,3578725314,3578725326,12
0,896,15000,3578725314,3578725328,14
0,896,15001,3578725314,3578725329,15
0,896,15002,3578725314,3578725330,16
0,896,15003,3578725314,3578725330,16
0,896,15004,3578725314,3578725331,17
0,896,15005,3578725314,3578725331,17
0,896,15006,3578725314,3578725331,17
0,896,15007,3578725314,3578725333,19
0,896,15008,3578725314,3578725334,20
0,896,15009,3578725314,3578725336,22
0,896,15010,3578725314,3578725339,25
0,896,15011,3578725314,3578725340,26
0,896,15012,3578725314,3578725341,27
0,896,15013,3578725314,3578725343,29
0,896,15014,3578725314,3578725343,29
0,896,15015,3578725314,3578725343,29
0,896,15016,3578725314,3578725344,30
0,896,15017,3578725314,3578725344,30
0,896,15018,3578725314,3578725346,32
0,896,15019,3578725314,3578725346,32
0,896,15020,3578725314,3578725349,35
0,896,15021,3578725314,3578725350,36
0,896,15022,3578725314,3578725351,37
0,896,15023,3578725314,3578725353,39
0,896,15024,3578725314,3578725356,42
0,896,15025,3578725314,3578725356,42
0,896,15026,3578725314,3578725359,45
0,896,15027,3578725314,3578725361,47
0,896,15028,3578725314,3578725361,47
0,896,15029,3578725314,3578725361,47
0,896,15030,3578725314,3578725361,47
0,896,15031,3578725314,3578725362,48
0,896,15032,3578725314,3578725362,48
0,897,15033,3578725371,3578725371,0
0,897,15034,3578725371,3578725371,0
0,897,15035,3578725371,3578725371,0
0,897,15036,3578725371,3578725371,0
0,897,15037,3578725371,3578725371,0
0,897,15038,3578725371,3578725371,0
0,897,15039,3578725371,3578725371,0
0,897,15040,3578725371,3578725371,0
0,897,15041,3578725371,3578725372,1
0,897,15042,3578725371,3578725373,2
0,897,15043,3578725371,3578725373,2
0,897,15044,3578725371,3578725373,2
0,897,15045,3578725371,3578725374,3
0,897,15046,3578725371,3578725376,5
0,897,15047,3578725371,3578725378,7
0,897,15048,3578725371,3578725380,9
0,897,15049,3578725371,3578725380,9
0,897,15050,3578725371,3578725381,10
0,897,15051,3578725371,3578725381,10
0,897,15052,3578725371,3578725382,11
0,897,15053,3578725371,3578725382,11
0,897,15054,3578725371,3578725384,13
0,897,15055,3578725371,3578725385,14
0,897,15056,3578725371,3578725386,15
0,897,15057,3578725371,3578725387,16
0,897,15058,3578725371,3578725390,19
0,897,15059,3578725371,3578725391,20
0,897,15060,3578725371,3578725394,23
0,897,15061,3578725371,3578725394,23
0,897,15062,3578725371,3578725394,23
0,897,15063,3578725371,3578725398,27
0,897,15064,3578725371,3578725399,28
0,897,15065,3578725371,3578725401,30
0,897,15066,3578725371,3578725404,33
0,897,15067,3578725371,3578725406,35
0,897,15068,3578725371,3578725407,36
0,897,15069,3578725371,3578725408,37
0,897,15070,3578725371,3578725409,38
0,897,15071,3578725371,3578725412,41
0,897,15072,3578725371,3578725413,42
0,897,15073,3578725371,3578725415,44
0,897,15074,3578725371,3578725415,44
0,897,15075,3578725371,3578725415,44
0,897,15076,3578725371,3578725418,47
0,897,15077,3578725371,3578725419,48
0,897,15078,3578725371,3578725420,49
0,897,15079,3578725371,3578725420,49
0,897,15080,3578725371,3578725421,50
0,898,15081,3578725429,3578725429,0
0,898,15082,3578725429,3578725429,0
0,898,15083,3578725429,3578725429,0
0,898,15084,3578725429,3578725429,0
0,898,15085,3578725429,3578725430,1
0,898,15086,3578725429,3578725431,2
0,898,15087,3578725429,3578725432,3
0,898,15088,3578725429,3578725433,4
0,898,15089,3578725429,3578725435,6
0,898,15090,3578725429,3578725436,7
0,898,15091,3578725429,3578725436,7
0,898,15092,3578725429,3578725439,10
0,898,15093,3578725429,3578725440,11
0,898,15094,3578725429,3578725443,14
0,898,15095,3578725429,3578725445,16
0,898,15096,3578725429,3578725449,20
0,898,15097,3578725429,3578725450,21
0,898,15098,3578725429,3578725450,21
0,898,15099,3578725429,3578725451,22
0,898,15100,3578725429,3578725453,24
0,898,15101,3578725429,3578725454,25
0,898,15102,3578725429,3578725455,26
0,898,15103,3578725429,3578725461,32
0,898,15104,3578725429,3578725462,33
0,898,15105,3578725429,3578725462,33
0,898,15106,3578725429,3578725463,34
0,898,15107,3578725429,3578725465,36
0,898,15108,3578725429,3578725466,37
0,898,15109,3578725429,3578725466,37
0,898,15110,3578725429,3578725467,38
0,898,15111,3578725429,3578725467,38
0,898,15112,3578725429,3578725467,38
0,898,15113,3578725429,3578725468,39
0,898,15114,3578725429,3578725469,40
0,898,15115,3578725429,3578725469,40
0,898,15116,3578725429,3578725472,43
0,898,15117,3578725429,3578725472,43
0,898,15118,3578725429,3578725477,48
0,899,15119,3578725485,3578725485,0
0,899,15120,3578725485,3578725485,0
0,899,15121,3578725485,3578725485,0
0,899,15122,3578725485,3578725486,1
0,899,15123,3578725485,3578725486,1
0,899,15124,3578725485,3578725487,2
0,899,15125,3578725485,3578725488,3
0,899,15126,3578725485,3578725491,6
0,899,15127,3578725485,3578725496,11
0,899,15128,3578725485,3578725496,11
0,899,15129,3578725485,3578725497,12
0,899,15130,3578725485,3578725498,13
0,899,15131,3578725485,3578725498,13
0,899,15132,3578725485,3578725498,13
0,899,15133,3578725485,3578725499,14
0,899,15134,3578725485,3578725499,14
0,899,15135,3578725485,3578725499,14
0,899,15136,3578725485,3578725501,16
0,899,15137,3578725485,3578725501,16
0,899,15138,3578725485,3578725502,17
0,899,15139,3578725485,3578725504,19
0,899,15140,3578725485,3578725504,19
0,899,15141,3578725485,3578725505,20
0,899,15142,3578725485,3578725505,20
0,899,15143,3578725485,3578725505,20
0,899,15144,3578725485,3578725505,20
0,899,15145,3578725485,3578725505,20
0,899,15146,3578725485,3578725506,21
0,899,15147,3578725485,3578725507,22
0,899,15148,3578725485,3578725507,22
0,899,15149,3578725485,3578725508,23
0,899,15150,3578725485,3578725509,24
0,899,15151,3578725485,3578725509,24
0,899,15152,3578725485,3578725510,25
0,899,15153,3578725485,3578725513,28
0,899,15154,3578725485,3578725514,29
0,899,15155,3578725485,3578725515,30
0,899,15156,3578725485,3578725516,31
0,899,15157,3578725485,3578725517,32
0,899,15158,3578725485,3578725519,34
0,899,15159,3578725485,3578725521,36
0,899,15160,3578725485,3578725521,36
0,899,15161,3578725485,3578725522,37
0,899,15162,3578725485,3578725523,38
0,899,15163,3578725485,3578725523,38
0,899,15164,3578725485,3578725524,39
0,899,15165,3578725485,3578725525,40
0,899,15166,3578725485,3578725527,42
0,899,15167,3578725485,3578725527,42
0,899,15168,3578725485,3578725528,43
0,899,15169,3578725485,3578725528,43
0,899,15170,3578725485,3578725530,45
0,899,15171,3578725485,3578725530,45
0,899,15172,3578725485,3578725531,46
0,899,15173,3578725485,3578725532,47
0,899,15174,3578725485,3578725534,49
0,899,15175,3578725485,3578725535,50
0,900,15176,3578725542,3578725542,0
0,900,15177,3578725542,3578725542,0
0,900,15178,3578725542,3578725542,0
0,900,15179,3578725542,3578725542,0
0,900,15180,3578725542,3578725543,1
0,900,15181,3578725542,3578725544,2
0,900,15182,3578725542,3578725544,2
0,900,15183,3578725542,3578725544,2
0,900,15184,3578725542,3578725548,6
0,900,15185,3578725542,3578725549,7
0,900,15186,3578725542,3578725551,9
0,900,15187,3578725542,3578725553,11
0,900,15188,3578725542,3578725555,13
0,900,15189,3578725542,3578725557,15
0,900,15190,3578725542,3578725559,17
0,900,15191,3578725542,3578725560,18
0,900,15192,3578725542,3578725560,18
0,900,15193,3578725542,3578725560,18
0,900,15194,3578725542,3578725561,19
0,900,15195,3578725542,3578725561,19
0,900,15196,3578725542,3578725561,19
0,900,15197,3578725542,3578725561,19
0,900,15198,3578725542,3578725561,19
0,900,15199,3578725542,3578725563,21
0,900,15200,3578725542,3578725565,23
0,900,15201,3578725542,3578725566,24
0,900,15202,3578725542,3578725566,24
0,900,15203,3578725542,3578725568,26
0,900,15204,3578725542,3578725568,26
0,900,15205,3578725542,3578725570,28
0,900,15206,3578725542,3578725570,28
0,900,15207,3578725542,3578725572,30
0,900,15208,3578725542,3578725572,30
0,900,15209,3578725542,3578725572,30
0,900,15210,3578725542,3578725573,31
0,900,15211,3578725542,3578725573,31
0,900,15212,3578725542,3578725574,32
0,900,15213,3578725542,3578725575,33
0,900,15214,3578725542,3578725576,34
0,900,15215,3578725542,3578725579,37
0,900,15216,3578725542,3578725579,37
0,900,15217,3578725542,3578725579,37
0,900,15218,3578725542,3578725580,38
0,900,15219,3578725542,3578725580,38
0,900,15220,3578725542,3578725581,39
0,900,15221,3578725542,3578725583,41
0,900,15222,3578725542,3578725584,42
0,900,15223,3578725542,3578725585,43
0,900,15224,3578725542,3578725587,45
0,900,15225,3578725542,3578725591,49
0,900,15226,3578725542,3578725591,49
0,900,15227,3578725542,3578725592,50
0,901,15228,3578725599,3578725599,0
0,901,15229,3578725599,3578725599,0
0,901,15230,3578725599,3578725599,0
0,901,15231,3578725599,3578725599,0
0,901,15232,3578725599,3578725599,0
0,901,15233,3578725599,3578725603,4
0,901,15234,3578725599,3578725605,6
0,901,15235,3578725599,3578725606,7
0,901,15236,3578725599,3578725606,7
0,901,15237,3578725599,3578725607,8
0,901,15238,3578725599,3578725607,8
0,901,15239,3578725599,3578725609,10
0,901,15240,3578725599,3578725611,12
0,901,15241,3578725599,3578725612,13
0,901,15242,3578725599,3578725614,15
0,901,15243,3578725599,3578725614,15
0,901,15244,3578725599,3578725615,16
0,901,15245,3578725599,3578725617,18
0,901,15246,3578725599,3578725617,18
0,901,15247,3578725599,3578725618,19
0,901,15248,3578725599,3578725619,20
0,901,15249,3578725599,3578725620,21
0,901,15250,3578725599,3578725621,22
0,901,15251,3578725599,3578725621,22
0,901,15252,3578725599,3578725625,26
0,901,15253,3578725599,3578725628,29
0,901,15254,3578725599,3578725629,30
0,901,15255,3578725599,3578725630,31
0,901,15256,3578725599,3578725631,32
0,901,15257,3578725599,3578725631,32
0,901,15258,3578725599,3578725632,33
0,901,15259,3578725599,3578725635,36
0,901,15260,3578725599,3578725635,36
0,901,15261,3578725599,3578725638,39
0,901,15262,3578725599,3578725639,40
0,901,15263,3578725599,3578725642,43
0,901,15264,3578725599,3578725643,44
0,901,15265,3578725599,3578725648,49
0,901,15266,3578725599,3578725648,49
0,901,15267,3578725599,3578725649,50
0,902,15268,3578725655,3578725655,0
0,902,15269,3578725655,3578725655,0
0,902,15270,3578725655,3578725655,0
0,902,15271,3578725655,3578725657,2
0,902,15272,3578725655,3578725660,5
0,902,15273,3578725655,3578725660,5
0,902,15274,3578725655,3578725661,6
0,902,15275,3578725655,3578725664,9
0,902,15276,3578725655,3578725665,10
0,902,15277,3578725655,3578725665,10
0,902,15278,3578725655,3578725666,11
0,902,15279,3578725655,3578725666,11
0,902,15280,3578725655,3578725666,11
0,902,15281,3578725655,3578725667,12
0,902,15282,3578725655,3578725669,14
0,902,15283,3578725655,3578725670,15
0,902,15284,3578725655,3578725672,17
0,902,15285,3578725655,3578725677,22
0,902,15286,3578725655,3578725678,23
0,902,15287,3578725655,3578725679,24
0,902,15288,3578725655,3578725681,26
0,902,15289,3578725655,3578725684,29
0,902,15290,3578725655,3578725684,29
0,902,15291,3578725655,3578725685,30
0,902,15292,3578725655,3578725686,31
0,902,15293,3578725655,3578725687,32
0,902,15294,3578725655,3578725688,33
0,902,15295,3578725655,3578725691,36
0,902,15296,3578725655,3578725692,37
0,902,15297,3578725655,3578725695,40
0,902,15298,3578725655,3578725697,42
0,902,15299,3578725655,3578725697,42
0,902,15300,3578725655,3578725697,42
0,902,15301,3578725655,3578725699,44
0,902,15302,3578725655,3578725699,44
0,902,15303,3578725655,3578725699,44
0,902,15304,3578725655,3578725700,45
0,902,15305,3578725655,3578725701,46
0,902,15306,3578725655,3578725702,47
0,902,15307,3578725655,3578725702,47
0,902,15308,3578725655,3578725702,47
0,902,15309,3578725655,3578725704,49
0,902,15310,3578725655,3578725704,49
0,902,15311,3578725655,3578725705,50
0,903,15312,3578725712,3578725712,0
0,903,15313,3578725712,3578725712,0
0,903,15314,3578725712,3578725712,0
0,903,15315,3578725712,3578725712,0
0,903,15316,3578725712,3578725712,0
0,903,15317,3578725712,3578725712,0
0,903,15318,3578725712,3578725712,0
0,903,15319,3578725712,3578725712,0
0,903,15320,3578725712,3578725712,0
0,903,15321,3578725712,3578725712,0
0,903,15322,3578725712,3578725712,0
0,903,15323,3578725712,3578725713,1
0,903,15324,3578725712,3578725715,3
0,903,15325,3578725712,3578725715,3
0,903,15326,3578725712,3578725715,3
0,903,15327,3578725712,3578725716,4
0,903,15328,3578725712,3578725718,6
0,903,15329,3578725712,3578725719,7
0,903,15330,3578725712,3578725721,9
0,903,15331,3578725712,3578725722,10
0,903,15332,3578725712,3578725723,11
0,903,15333,3578725712,3578725725,13
0,903,15334,3578725712,3578725725,13
0,903,15335,3578725712,3578725727,15
0,903,15336,3578725712,3578725728,16
0,903,15337,3578725712,3578725729,17
0,903,15338,3578725712,3578725731,19
0,903,15339,3578725712,3578725731,19
0,903,15340,3578725712,3578725731,19
0,903,15341,3578725712,3578725731,19
0,903,15342,3578725712,3578725732,20
0,903,15343,3578725712,3578725735,23
0,903,15344,3578725712,3578725735,23
0,903,15345,3578725712,3578725739,27
0,903,15346,3578725712,3578725739,27
0,903,15347,3578725712,3578725739,27
0,903,15348,3578725712,3578725742,30
0,903,15349,3578725712,3578725743,31
0,903,15350,3578725712,3578725744,32
0,903,15351,3578725712,3578725744,32
0,903,15352,3578725712,3578725744,32
0,903,15353,3578725712,3578725745,33
0,903,15354,3578725712,3578725746,34
0,903,15355,3578725712,3578725748,36
0,903,15356,3578725712,3578725750,38
0,903,15357,3578725712,3578725750,38
0,903,15358,3578725712,3578725751,39
0,903,15359,3578725712,3578725753,41
0,903,15360,3578725712,3578725754,42
0,903,15361,3578725712,3578725757,45
0,903,15362,3578725712,3578725759,47
0,903,15363,3578725712,3578725759,47
0,903,15364,3578725712,3578725760,48
0,903,15365,3578725712,3578725760,48
0,903,15366,3578725712,3578725761,49
0,903,15367,3578725712,3578725761,49
0,903,15368,3578725712,3578725761,49
0,903,15369,3578725712,3578725761,49
0,903,15370,3578725712,3578725762,50
0,904,15371,3578725769,3578725769,0
0,904,15372,3578725769,3578725769,0
0,904,15373,3578725769,3578725769,0
0,904,15374,3578725769,3578725769,0
0,904,15375,3578725769,3578725769,0
0,904,15376,3578725769,3578725769,0
0,904,15377,3578725769,3578725770,1
0,904,15378,3578725769,3578725771,2
0,904,15379,3578725769,3578725772,3
0,904,15380,3578725769,3578725773,4
0,904,15381,3578725769,3578725773,4
0,904,15382,3578725769,3578725773,4
0,904,15383,3578725769,3578725779,10
0,904,15384,3578725769,3578725779,10
0,904,15385,3578725769,3578725780,11
0,904,15386,3578725769,3578725780,11
0,904,15387,3578725769,3578725781,12
0,904,15388,3578725769,3578725782,13
0,904,15389,3578725769,3578725782,13
0,904,15390,3578725769,3578725783,14
0,904,15391,3578725769,3578725786,17
0,904,15392,3578725769,3578725787,18
0,904,15393,3578725769,3578725788,19
0,904,15394,3578725769,3578725790,21
0,904,15395,3578725769,3578725793,24
0,904,15396,3578725769,3578725794,25
0,904,15397,3578725769,3578725795,26
0,904,15398,3578725769,3578725796,27
0,904,15399,3578725769,3578725798,29
0,904,15400,3578725769,3578725799,30
0,904,15401,3578725769,3578725803,34
0,904,15402,3578725769,3578725804,35
0,904,15403,3578725769,3578725806,37
0,904,15404,3578725769,3578725807,38
0,904,15405,3578725769,3578725807,38
0,904,15406,3578725769,3578725808,39
0,904,15407,3578725769,3578725809,40
0,904,15408,3578725769,3578725812,43
0,904,15409,3578725769,3578725814,45
0,904,15410,3578725769,3578725814,45
0,904,15411,3578725769,3578725815,46
0,904,15412,3578725769,3578725815,46
0,904,15413,3578725769,3578725817,48
0,904,15414,3578725769,3578725817,48
0,904,15415,3578725769,3578725818,49
0,904,15416,3578725769,3578725819,50
0,905,15417,3578725825,3578725825,0
0,905,15418,3578725825,3578725825,0
0,905,15419,3578725825,3578725825,0
0,905,15420,3578725825,3578725829,4
0,905,15421,3578725825,3578725829,4
0,905,15422,3578725825,3578725830,5
0,905,15423,3578725825,3578725831,6
0,905,15424,3578725825,3578725831,6
0,905,15425,3578725825,3578725833,8
0,905,15426,3578725825,3578725836,11
0,905,15427,3578725825,3578725836,11
0,905,15428,3578725825,3578725839,14
0,905,15429,3578725825,3578725841,16
0,905,15430,3578725825,3578725842,17
0,905,15431,3578725825,3578725843,18
0,905,15432,3578725825,3578725848,23
0,905,15433,3578725825,3578725849,24
0,905,15434,3578725825,3578725849,24
0,905,15435,3578725825,3578725849,24
0,905,15436,3578725825,3578725849,24
0,905,15437,3578725825,3578725852,27
0,905,15438,3578725825,3578725854,29
0,905,15439,3578725825,3578725854,29
0,905,15440,3578725825,3578725860,35
0,905,15441,3578725825,3578725860,35
0,905,15442,3578725825,3578725861,36
0,905,15443,3578725825,3578725862,37
0,905,15444,3578725825,3578725863,38
0,905,15445,3578725825,3578725864,39
0,905,15446,3578725825,3578725865,40
0,905,15447,3578725825,3578725866,41
0,905,15448,3578725825,3578725866,41
0,905,15449,3578725825,3578725866,41
0,905,15450,3578725825,3578725867,42
0,905,15451,3578725825,3578725868,43
0,905,15452,3578725825,3578725869,44
0,905,15453,3578725825,3578725870,45
0,905,15454,3578725825,3578725871,46
0,906,15455,3578725882,3578725882,0
0,906,15456,3578725882,3578725882,0
0,906,15457,3578725882,3578725882,0
0,906,15458,3578725882,3578725884,2
0,906,15459,3578725882,3578725885,3
0,906,15460,3578725882,3578725887,5
0,906,15461,3578725882,3578725887,5
0,906,15462,3578725882,3578725888,6
0,906,15463,3578725882,3578725892,10
0,906,15464,3578725882,3578725895,13
0,906,15465,3578725882,3578725897,15
0,906,15466,3578725882,3578725897,15
0,906,15467,3578725882,3578725898,16
0,906,15468,3578725882,3578725898,16
0,906,15469,3578725882,3578725899,17
0,906,15470,3578725882,3578725899,17
0,906,15471,3578725882,3578725900,18
0,906,15472,3578725882,3578725902,20
0,906,15473,3578725882,3578725903,21
0,906,15474,3578725882,3578725904,22
0,906,15475,3578725882,3578725904,22
0,906,15476,3578725882,3578725905,23
0,906,15477,3578725882,3578725905,23
0,906,15478,3578725882,3578725905,23
0,906,15479,3578725882,3578725905,23
0,906,15480,3578725882,3578725906,24
0,906,15481,3578725882,3578725906,24
0,906,15482,3578725882,3578725907,25
0,906,15483,3578725882,3578725908,26
0,906,15484,3578725882,3578725909,27
0,906,15485,3578725882,3578725910,28
0,906,15486,3578725882,3578725910,28
0,906,15487,3578725882,3578725914,32
0,906,15488,3578725882,3578725914,32
0,906,15489,3578725882,3578725915,33
0,906,15490,3578725882,3578725915,33
0,906,15491,3578725882,3578725916,34
0,906,15492,3578725882,3578725918,36
0,906,15493,3578725882,3578725919,37
0,906,15494,3578725882,3578725920,38
0,906,15495,3578725882,3578725921,39
0,906,15496,3578725882,3578725922,40
0,906,15497,3578725882,3578725923,41
0,906,15498,3578725882,3578725924,42
0,906,15499,3578725882,3578725925,43
0,906,15500,3578725882,3578725928,46
0,906,15501,3578725882,3578725928,46
0,906,15502,3578725882,3578725929,47
0,906,15503,3578725882,3578725930,48
0,906,15504,3578725882,3578725931,49
0,906,15505,3578725882,3578725931,49
0,906,15506,3578725882,3578725931,49
0,906,15507,3578725882,3578725932,50
0,907,15508,3578725940,3578725940,0
0,907,15509,3578725940,3578725940,0
0,907,15510,3578725940,3578725940,0
0,907,15511,3578725940,3578725940,0
0,907,15512,3578725940,3578725940,0
0,907,15513,3578725940,3578725940,0
0,907,15514,3578725940,3578725943,3
0,907,15515,3578725940,3578725943,3
0,907,15516,3578725940,3578725944,4
0,907,15517,3578725940,3578725944,4
0,907,15518,3578725940,3578725944,4
0,907,15519,3578725940,3578725945,5
0,907,15520,3578725940,3578725946,6
0,907,15521,3578725940,3578725949,9
0,907,15522,3578725940,3578725950,10
0,907,15523,3578725940,3578725950,10
0,907,15524,3578725940,3578725954,14
0,907,15525,3578725940,3578725954,14
0,907,15526,3578725940,3578725958,18
0,907,15527,3578725940,3578725958,18
0,907,15528,3578725940,3578725960,20
0,907,15529,3578725940,3578725960,20
0,907,15530,3578725940,3578725961,21
0,907,15531,3578725940,3578725962,22
0,907,15532,3578725940,3578725962,22
0,907,15533,3578725940,3578725962,22
0,907,15534,3578725940,3578725962,22
0,907,15535,3578725940,3578725963,23
0,907,15536,3578725940,3578725965,25
0,907,15537,3578725940,3578725967,27
0,907,15538,3578725940,3578725968,28
0,907,15539,3578725940,3578725968,28
0,907,15540,3578725940,3578725970,30
0,907,15541,3578725940,3578725970,30
0,907,15542,3578725940,3578725971,31
0,907,15543,3578725940,3578725972,32
0,907,15544,3578725940,3578725972,32
0,907,15545,3578725940,3578725973,33
0,907,15546,3578725940,3578725973,33
0,907,15547,3578725940,3578725974,34
0,907,15548,3578725940,3578725976,36
0,907,15549,3578725940,3578725978,38
0,907,15550,3578725940,3578725979,39
0,907,15551,3578725940,3578725980,40
0,907,15552,3578725940,3578725980,40
0,907,15553,3578725940,3578725980,40
0,907,15554,3578725940,3578725981,41
0,907,15555,3578725940,3578725982,42
0,907,15556,3578725940,3578725983,43
0,907,15557,3578725940,3578725984,44
0,907,15558,3578725940,3578725984,44
0,907,15559,3578725940,3578725985,45
0,907,15560,3578725940,3578725986,46
0,907,15561,3578725940,3578725988,48
0,907,15562,3578725940,3578725989,49
0,908,15563,3578725996,3578725996,0
0,908,15564,3578725996,3578725996,0
0,908,15565,3578725996,3578725996,0
0,908,15566,3578725996,3578725996,0
0,908,15567,3578725996,3578725996,0
0,908,15568,3578725996,3578725996,0
0,908,15569,3578725996,3578725996,0
0,908,15570,3578725996,3578725999,3
0,908,15571,3578725996,3578725999,3
0,908,15572,3578725996,3578726001,5
0,908,15573,3578725996,3578726004,8
0,908,15574,3578725996,3578726004,8
0,908,15575,3578725996,3578726006,10
0,908,15576,3578725996,3578726007,11
0,908,15577,3578725996,3578726007,11
0,908,15578,3578725996,3578726007,11
0,908,15579,3578725996,3578726009,13
0,908,15580,3578725996,3578726009,13
0,908,15581,3578725996,3578726010,14
0,908,15582,3578725996,3578726014,18
0,908,15583,3578725996,3578726015,19
0,908,15584,3578725996,3578726015,19
0,908,15585,3578725996,3578726017,21
0,908,15586,3578725996,3578726019,23
0,908,15587,3578725996,3578726020,24
0,908,15588,3578725996,3578726021,25
0,908,15589,3578725996,3578726022,26
0,908,15590,3578725996,3578726025,29
0,908,15591,3578725996,3578726029,33
0,908,15592,3578725996,3578726030,34
0,908,15593,3578725996,3578726030,34
0,908,15594,3578725996,3578726031,35
0,908,15595,3578725996,3578726033,37
0,908,15596,3578725996,3578726033,37
0,908,15597,3578725996,3578726034,38
0,908,15598,3578725996,3578726035,39
0,908,15599,3578725996,3578726035,39
0,908,15600,3578725996,3578726035,39
0,908,15601,3578725996,3578726039,43
0,908,15602,3578725996,3578726040,44
0,908,15603,3578725996,3578726043,47
0,908,15604,3578725996,3578726043,47
0,909,15605,3578726053,3578726053,0
0,909,15606,3578726053,3578726054,1
0,909,15607,3578726053,3578726054,1
0,909,15608,3578726053,3578726054,1
0,909,15609,3578726053,3578726054,1
0,909,15610,3578726053,3578726054,1
0,909,15611,3578726053,3578726054,1
0,909,15612,3578726053,3578726058,5
0,909,15613,3578726053,3578726059,6
0,909,15614,3578726053,3578726062,9
0,909,15615,3578726053,3578726063,10
0,909,15616,3578726053,3578726064,11
0,909,15617,3578726053,3578726064,11
0,909,15618,3578726053,3578726066,13
0,909,15619,3578726053,3578726066,13
0,909,15620,3578726053,3578726067,14
0,909,15621,3578726053,3578726067,14
0,909,15622,3578726053,3578726067,14
0,909,15623,3578726053,3578726069,16
0,909,15624,3578726053,3578726071,18
0,909,15625,3578726053,3578726072,19
0,909,15626,3578726053,3578726079,26
0,909,15627,3578726053,3578726079,26
0,909,15628,3578726053,3578726081,28
0,909,15629,3578726053,3578726084,31
0,909,15630,3578726053,3578726085,32
0,909,15631,3578726053,3578726086,33
0,909,15632,3578726053,3578726087,34
0,909,15633,3578726053,3578726087,34
0,909,15634,3578726053,3578726088,35
0,909,15635,3578726053,3578726091,38
0,909,15636,3578726053,3578726092,39
0,909,15637,3578726053,3578726097,44
0,909,15638,3578726053,3578726098,45
0,909,15639,3578726053,3578726098,45
0,909,15640,3578726053,3578726098,45
0,909,15641,3578726053,3578726099,46
0,909,15642,3578726053,3578726100,47
0,909,15643,3578726053,3578726100,47
0,909,15644,3578726053,3578726102,49
0,909,15645,3578726053,3578726102,49
0,909,15646,3578726053,3578726103,50
0,910,15647,3578726111,3578726111,0
0,910,15648,3578726111,3578726111,0
0,910,15649,3578726111,3578726111,0
0,910,15650,3578726111,3578726111,0
0,910,15651,3578726111,3578726111,0
0,910,15652,3578726111,3578726111,0
0,910,15653,3578726111,3578726111,0
0,910,15654,3578726111,3578726111,0
0,910,15655,3578726111,3578726111,0
0,910,15656,3578726111,3578726111,0
0,910,15657,3578726111,3578726111,0
0,910,15658,3578726111,3578726111,0
0,910,15659,3578726111,3578726111,0
0,910,15660,3578726111,3578726111,0
0,910,15661,3578726111,3578726115,4
0,910,15662,3578726111,3578726116,5
0,910,15663,3578726111,3578726116,5
0,910,15664,3578726111,3578726116,5
0,910,15665,3578726111,3578726118,7
0,910,15666,3578726111,3578726119,8
0,910,15667,3578726111,3578726121,10
0,910,15668,3578726111,3578726121,10
0,910,15669,3578726111,3578726122,11
0,910,15670,3578726111,3578726123,12
0,910,15671,3578726111,3578726125,14
0,910,15672,3578726111,3578726125,14
0,910,15673,3578726111,3578726126,15
0,910,15674,3578726111,3578726128,17
0,910,15675,3578726111,3578726129,18
0,910,15676,3578726111,3578726130,19
0,910,15677,3578726111,3578726130,19
0,910,15678,3578726111,3578726131,20
0,910,15679,3578726111,3578726131,20
0,910,15680,3578726111,3578726131,20
0,910,15681,3578726111,3578726132,21
0,910,15682,3578726111,3578726132,21
0,910,15683,3578726111,3578726135,24
0,910,15684,3578726111,3578726135,24
0,910,15685,3578726111,3578726139,28
0,910,15686,3578726111,3578726139,28
0,910,15687,3578726111,3578726142,31
0,910,15688,3578726111,3578726144,33
0,910,15689,3578726111,3578726144,33
0,910,15690,3578726111,3578726144,33
0,910,15691,3578726111,3578726144,33
0,910,15692,3578726111,3578726146,35
0,910,15693,3578726111,3578726146,35
0,910,15694,3578726111,3578726150,39
0,910,15695,3578726111,3578726151,40
0,910,15696,3578726111,3578726151,40
0,910,15697,3578726111,3578726153,42
0,910,15698,3578726111,3578726154,43
0,910,15699,3578726111,3578726154,43
0,910,15700,3578726111,3578726158,47
0,910,15701,3578726111,3578726160,49
0,910,15702,3578726111,3578726160,49
0,910,15703,3578726111,3578726161,50
0,911,15704,3578726168,3578726168,0
0,911,15705,3578726168,3578726168,0
0,911,15706,3578726168,3578726168,0
0,911,15707,3578726168,3578726168,0
0,911,15708,3578726168,3578726168,0
0,911,15709,3578726168,3578726168,0
0,911,15710,3578726168,3578726168,0
0,911,15711,3578726168,3578726168,0
0,911,15712,3578726168,3578726168,0
0,911,15713,3578726168,3578726169,1
0,911,15714,3578726168,3578726169,1
0,911,15715,3578726168,3578726170,2
0,911,15716,3578726168,3578726171,3
0,911,15717,3578726168,3578726171,3
0,911,15718,3578726168,3578726172,4
0,911,15719,3578726168,3578726172,4
0,911,15720,3578726168,3578726172,4
0,911,15721,3578726168,3578726173,5
0,911,15722,3578726168,3578726176,8
0,911,15723,3578726168,3578726179,11
0,911,15724,3578726168,3578726179,11
0,911,15725,3578726168,3578726180,12
0,911,15726,3578726168,3578726180,12
0,911,15727,3578726168,3578726181,13
0,911,15728,3578726168,3578726181,13
0,911,15729,3578726168,3578726182,14
0,911,15730,3578726168,3578726182,14
0,911,15731,3578726168,3578726184,16
0,911,15732,3578726168,3578726185,17
0,911,15733,3578726168,3578726185,17
0,911,15734,3578726168,3578726186,18
0,911,15735,3578726168,3578726189,21
0,911,15736,3578726168,3578726190,22
0,911,15737,3578726168,3578726190,22
0,911,15738,3578726168,3578726191,23
0,911,15739,3578726168,3578726193,25
0,911,15740,3578726168,3578726194,26
0,911,15741,3578726168,3578726194,26
0,911,15742,3578726168,3578726196,28
0,911,15743,3578726168,3578726199,31
0,911,15744,3578726168,3578726200,32
0,911,15745,3578726168,3578726201,33
0,911,15746,3578726168,3578726204,36
0,911,15747,3578726168,3578726204,36
0,911,15748,3578726168,3578726206,38
0,911,15749,3578726168,3578726207,39
0,911,15750,3578726168,3578726207,39
0,911,15751,3578726168,3578726207,39
0,911,15752,3578726168,3578726209,41
0,911,15753,3578726168,3578726209,41
0,911,15754,3578726168,3578726210,42
0,911,15755,3578726168,3578726212,44
0,911,15756,3578726168,3578726215,47
0,911,15757,3578726168,3578726216,48
0,912,15758,3578726225,3578726225,0
0,912,15759,3578726225,3578726225,0
0,912,15760,3578726225,3578726225,0
0,912,15761,3578726225,3578726225,0
0,912,15762,3578726225,3578726225,0
0,912,15763,3578726225,3578726229,4
0,912,15764,3578726225,3578726230,5
0,912,15765,3578726225,3578726230,5
0,912,15766,3578726225,3578726231,6
0,912,15767,3578726225,3578726234,9
0,912,15768,3578726225,3578726235,10
0,912,15769,3578726225,3578726235,10
0,912,15770,3578726225,3578726236,11
0,912,15771,3578726225,3578726239,14
0,912,15772,3578726225,3578726241,16
0,912,15773,3578726225,3578726241,16
0,912,15774,3578726225,3578726243,18
0,912,15775,3578726225,3578726243,18
0,912,15776,3578726225,3578726249,24
0,912,15777,3578726225,3578726250,25
0,912,15778,3578726225,3578726253,28
0,912,15779,3578726225,3578726254,29
0,912,15780,3578726225,3578726254,29
0,912,15781,3578726225,3578726260,35
0,912,15782,3578726225,3578726262,37
0,912,15783,3578726225,3578726262,37
0,912,15784,3578726225,3578726263,38
0,912,15785,3578726225,3578726265,40
0,912,15786,3578726225,3578726266,41
0,912,15787,3578726225,3578726266,41
0,912,15788,3578726225,3578726267,42
0,912,15789,3578726225,3578726267,42
0,912,15790,3578726225,3578726268,43
0,912,15791,3578726225,3578726269,44
0,912,15792,3578726225,3578726272,47
0,912,15793,3578726225,3578726272,47
0,913,15794,3578726281,3578726281,0
0,913,15795,3578726281,3578726281,0
0,913,15796,3578726281,3578726281,0
0,913,15797,3578726281,3578726284,3
0,913,15798,3578726281,3578726287,6
0,913,15799,3578726281,3578726287,6
0,913,15800,3578726281,3578726287,6
0,913,15801,3578726281,3578726288,7
0,913,15802,3578726281,3578726292,11
0,913,15803,3578726281,3578726292,11
0,913,15804,3578726281,3578726296,15
0,913,15805,3578726281,3578726297,16
0,913,15806,3578726281,3578726298,17
0,913,15807,3578726281,3578726298,17
0,913,15808,3578726281,3578726299,18
0,913,15809,3578726281,3578726299,18
0,913,15810,3578726281,3578726299,18
0,913,15811,3578726281,3578726300,19
0,913,15812,3578726281,3578726302,21
0,913,15813,3578726281,3578726302,21
0,913,15814,3578726281,3578726303,22
0,913,15815,3578726281,3578726304,23
0,913,15816,3578726281,3578726304,23
0,913,15817,3578726281,3578726305,24
0,913,15818,3578726281,3578726305,24
0,913,15819,3578726281,3578726305,24
0,913,15820,3578726281,3578726306,25
0,913,15821,3578726281,3578726306,25
0,913,15822,3578726281,3578726307,26
0,913,15823,3578726281,3578726307,26
0,913,15824,3578726281,3578726308,27
0,913,15825,3578726281,3578726309,28
0,913,15826,3578726281,3578726309,28
0,913,15827,3578726281,3578726309,28
0,913,15828,3578726281,3578726310,29
0,913,15829,3578726281,3578726314,33
0,913,15830,3578726281,3578726315,34
0,913,15831,3578726281,3578726316,35
0,913,15832,3578726281,3578726316,35
0,913,15833,3578726281,3578726316,35
0,913,15834,3578726281,3578726319,38
0,913,15835,3578726281,3578726321,40
0,913,15836,3578726281,3578726322,41
0,913,15837,3578726281,3578726323,42
0,913,15838,3578726281,3578726325,44
0,913,15839,3578726281,3578726326,45
0,913,15840,3578726281,3578726327,46
0,913,15841,3578726281,3578726328,47
0,913,15842,3578726281,3578726329,48
0,913,15843,3578726281,3578726330,49
0,913,15844,3578726281,3578726330,49
0,913,15845,3578726281,3578726331,50
0,914,15846,3578726337,3578726337,0
0,914,15847,3578726337,3578726337,0
0,914,15848,3578726337,3578726338,1
0,914,15849,3578726337,3578726338,1
0,914,15850,3578726337,3578726338,1
0,914,15851,3578726337,3578726338,1
0,914,15852,3578726337,3578726339,2
0,914,15853,3578726337,3578726341,4
0,914,15854,3578726337,3578726341,4
0,914,15855,3578726337,3578726343,6
0,914,15856,3578726337,3578726343,6
0,914,15857,3578726337,3578726344,7
0,914,15858,3578726337,3578726344,7
0,914,15859,3578726337,3578726344,7
0,914,15860,3578726337,3578726345,8
0,914,15861,3578726337,3578726346,9
0,914,15862,3578726337,3578726349,12
0,914,15863,3578726337,3578726351,14
0,914,15864,3578726337,3578726352,15
0,914,15865,3578726337,3578726354,17
0,914,15866,3578726337,3578726355,18
0,914,15867,3578726337,3578726357,20
0,914,15868,3578726337,3578726359,22
0,914,15869,3578726337,3578726360,23
0,914,15870,3578726337,3578726360,23
0,914,15871,3578726337,3578726361,24
0,914,15872,3578726337,3578726362,25
0,914,15873,3578726337,3578726362,25
0,914,15874,3578726337,3578726362,25
0,914,15875,3578726337,3578726362,25
0,914,15876,3578726337,3578726362,25
0,914,15877,3578726337,3578726364,27
0,914,15878,3578726337,3578726366,29
0,914,15879,3578726337,3578726367,30
0,914,15880,3578726337,3578726368,31
0,914,15881,3578726337,3578726368,31
0,914,15882,3578726337,3578726369,32
0,914,15883,3578726337,3578726370,33
0,914,15884,3578726337,3578726371,34
0,914,15885,3578726337,3578726372,35
0,914,15886,3578726337,3578726372,35
0,914,15887,3578726337,3578726373,36
0,914,15888,3578726337,3578726373,36
0,914,15889,3578726337,3578726374,37
0,914,15890,3578726337,3578726376,39
0,914,15891,3578726337,3578726378,41
0,914,15892,3578726337,3578726379,42
0,914,15893,3578726337,3578726380,43
0,914,15894,3578726337,3578726381,44
0,914,15895,3578726337,3578726381,44
0,914,15896,3578726337,3578726381,44
0,914,15897,3578726337,3578726382,45
0,914,15898,3578726337,3578726384,47
0,914,15899,3578726337,3578726385,48
0,914,15900,3578726337,3578726385,48
0,914,15901,3578726337,3578726386,49
0,915,15902,3578726394,3578726394,0
0,915,15903,3578726394,3578726394,0
0,915,15904,3578726394,3578726394,0
0,915,15905,3578726394,3578726394,0
0,915,15906,3578726394,3578726394,0
0,915,15907,3578726394,3578726394,0
0,915,15908,3578726394,3578726394,0
0,915,15909,3578726394,3578726394,0
0,915,15910,3578726394,3578726394,0
0,915,15911,3578726394,3578726397,3
0,915,15912,3578726394,3578726399,5
0,915,15913,3578726394,3578726400,6
0,915,15914,3578726394,3578726401,7
0,915,15915,3578726394,3578726405,11
0,915,15916,3578726394,3578726406,12
0,915,15917,3578726394,3578726406,12
0,915,15918,3578726394,3578726407,13
0,915,15919,3578726394,3578726407,13
0,915,15920,3578726394,3578726407,13
0,915,15921,3578726394,3578726408,14
0,915,15922,3578726394,3578726409,15
0,915,15923,3578726394,3578726411,17
0,915,15924,3578726394,3578726413,19
0,915,15925,3578726394,3578726415,21
0,915,15926,3578726394,3578726415,21
0,915,15927,3578726394,3578726415,21
0,915,15928,3578726394,3578726416,22
0,915,15929,3578726394,3578726416,22
0,915,15930,3578726394,3578726419,25
0,915,15931,3578726394,3578726419,25
0,915,15932,3578726394,3578726420,26
0,915,15933,3578726394,3578726422,28
0,915,15934,3578726394,3578726422,28
0,915,15935,3578726394,3578726426,32
0,915,15936,3578726394,3578726429,35
0,915,15937,3578726394,3578726430,36
0,915,15938,3578726394,3578726431,37
0,915,15939,3578726394,3578726431,37
0,915,15940,3578726394,3578726434,40
0,915,15941,3578726394,3578726435,41
0,915,15942,3578726394,3578726436,42
0,915,15943,3578726394,3578726436,42
0,915,15944,3578726394,3578726440,46
0,915,15945,3578726394,3578726440,46
0,915,15946,3578726394,3578726441,47
0,915,15947,3578726394,3578726444,50
0,916,15948,3578726453,3578726453,0
0,916,15949,3578726453,3578726453,0
0,916,15950,3578726453,3578726453,0
0,916,15951,3578726453,3578726453,0
0,916,15952,3578726453,3578726453,0
0,916,15953,3578726453,3578726453,0
0,916,15954,3578726453,3578726455,2
0,916,15955,3578726453,3578726455,2
0,916,15956,3578726453,3578726457,4
0,916,15957,3578726453,3578726459,6
0,916,15958,3578726453,3578726462,9
0,916,15959,3578726453,3578726463,10
0,916,15960,3578726453,3578726465,12
0,916,15961,3578726453,3578726465,12
0,916,15962,3578726453,3578726466,13
0,916,15963,3578726453,3578726467,14
0,916,15964,3578726453,3578726467,14
0,916,15965,3578726453,3578726468,15
0,916,15966,3578726453,3578726468,15
0,916,15967,3578726453,3578726469,16
0,916,15968,3578726453,3578726472,19
0,916,15969,3578726453,3578726473,20
0,916,15970,3578726453,3578726479,26
0,916,15971,3578726453,3578726481,28
0,916,15972,3578726453,3578726481,28
0,916,15973,3578726453,3578726484,31
0,916,15974,3578726453,3578726485,32
0,916,15975,3578726453,3578726486,33
0,916,15976,3578726453,3578726487,34
0,916,15977,3578726453,3578726487,34
0,916,15978,3578726453,3578726488,35
0,916,15979,3578726453,3578726492,39
0,916,15980,3578726453,3578726492,39
0,916,15981,3578726453,3578726496,43
0,916,15982,3578726453,3578726496,43
0,916,15983,3578726453,3578726497,44
0,916,15984,3578726453,3578726498,45
0,916,15985,3578726453,3578726498,45
0,916,15986,3578726453,3578726499,46
0,916,15987,3578726453,3578726500,47
0,916,15988,3578726453,3578726500,47
0,916,15989,3578726453,3578726500,47
0,916,15990,3578726453,3578726501,48
0,916,15991,3578726453,3578726502,49
0,916,15992,3578726453,3578726502,49
0,917,15993,3578726510,3578726510,0
0,917,15994,3578726510,3578726510,0
0,917,15995,3578726510,3578726510,0
0,917,15996,3578726510,3578726510,0
0,917,15997,3578726510,3578726510,0
0,917,15998,3578726510,3578726510,0
0,917,15999,3578726510,3578726510,0
0,917,16000,3578726510,3578726510,0
0,917,16001,3578726510,3578726510,0
0,917,16002,3578726510,3578726510,0
0,917,16003,3578726510,3578726511,1
0,917,16004,3578726510,3578726511,1
0,917,16005,3578726510,3578726511,1
0,917,16006,3578726510,3578726511,1
0,917,16007,3578726510,3578726513,3
0,917,16008,3578726510,3578726514,4
0,917,16009,3578726510,3578726514,4
0,917,16010,3578726510,3578726514,4
0,917,16011,3578726510,3578726515,5
0,917,16012,3578726510,3578726516,6
0,917,16013,3578726510,3578726516,6
0,917,16014,3578726510,3578726520,10
0,917,16015,3578726510,3578726520,10
0,917,16016,3578726510,3578726522,12
0,917,16017,3578726510,3578726523,13
0,917,16018,3578726510,3578726524,14
0,917,16019,3578726510,3578726524,14
0,917,16020,3578726510,3578726527,17
0,917,16021,3578726510,3578726528,18
0,917,16022,3578726510,3578726529,19
0,917,16023,3578726510,3578726530,20
0,917,16024,3578726510,3578726530,20
0,917,16025,3578726510,3578726531,21
0,917,16026,3578726510,3578726531,21
0,917,16027,3578726510,3578726531,21
0,917,16028,3578726510,3578726531,21
0,917,16029,3578726510,3578726534,24
0,917,16030,3578726510,3578726535,25
0,917,16031,3578726510,3578726539,29
0,917,16032,3578726510,3578726540,30
0,917,16033,3578726510,3578726540,30
0,917,16034,3578726510,3578726541,31
0,917,16035,3578726510,3578726543,33
0,917,16036,3578726510,3578726543,33
0,917,16037,3578726510,3578726544,34
0,917,16038,3578726510,3578726545,35
0,917,16039,3578726510,3578726545,35
0,917,16040,3578726510,3578726546,36
0,917,16041,3578726510,3578726548,38
0,917,16042,3578726510,3578726550,40
0,917,16043,3578726510,3578726551,41
0,917,16044,3578726510,3578726553,43
0,917,16045,3578726510,3578726553,43
0,917,16046,3578726510,3578726554,44
0,917,16047,3578726510,3578726557,47
0,917,16048,3578726510,3578726559,49
0,918,16049,3578726568,3578726568,0
0,918,16050,3578726568,3578726568,0
0,918,16051,3578726568,3578726568,0
0,918,16052,3578726568,3578726568,0
0,918,16053,3578726568,3578726568,0
0,918,16054,3578726568,3578726568,0
0,918,16055,3578726568,3578726568,0
0,918,16056,3578726568,3578726568,0
0,918,16057,3578726568,3578726568,0
0,918,16058,3578726568,3578726568,0
0,918,16059,3578726568,3578726570,2
0,918,16060,3578726568,3578726571,3
0,918,16061,3578726568,3578726571,3
0,918,16062,3578726568,3578726571,3
0,918,16063,3578726568,3578726572,4
0,918,16064,3578726568,3578726572,4
0,918,16065,3578726568,3578726573,5
0,918,16066,3578726568,3578726575,7
0,918,16067,3578726568,3578726578,10
0,918,16068,3578726568,3578726578,10
0,918,16069,3578726568,3578726580,12
0,918,16070,3578726568,3578726580,12
0,918,16071,3578726568,3578726581,13
0,918,16072,3578726568,3578726581,13
0,918,16073,3578726568,3578726581,13
0,918,16074,3578726568,3578726582,14
0,918,16075,3578726568,3578726584,16
0,918,16076,3578726568,3578726584,16
0,918,16077,3578726568,3578726585,17
0,918,16078,3578726568,3578726586,18
0,918,16079,3578726568,3578726588,20
0,918,16080,3578726568,3578726589,21
0,918,16081,3578726568,3578726590,22
0,918,16082,3578726568,3578726590,22
0,918,16083,3578726568,3578726591,23
0,918,16084,3578726568,3578726593,25
0,918,16085,3578726568,3578726594,26
0,918,16086,3578726568,3578726594,26
0,918,16087,3578726568,3578726596,28
0,918,16088,3578726568,3578726598,30
0,918,16089,3578726568,3578726599,31
0,918,16090,3578726568,3578726599,31
0,918,16091,3578726568,3578726604,36
0,918,16092,3578726568,3578726605,37
0,918,16093,3578726568,3578726606,38
0,918,16094,3578726568,3578726608,40
0,918,16095,3578726568,3578726608,40
0,918,16096,3578726568,3578726610,42
0,918,16097,3578726568,3578726611,43
0,918,16098,3578726568,3578726614,46
0,918,16099,3578726568,3578726614,46
0,918,16100,3578726568,3578726615,47
0,918,16101,3578726568,3578726615,47
0,918,16102,3578726568,3578726616,48
0,919,16103,3578726626,3578726626,0
0,919,16104,3578726626,3578726626,0
0,919,16105,3578726626,3578726626,0
0,919,16106,3578726626,3578726626,0
0,919,16107,3578726626,3578726626,0
0,919,16108,3578726626,3578726629,3
0,919,16109,3578726626,3578726630,4
0,919,16110,3578726626,3578726630,4
0,919,16111,3578726626,3578726631,5
0,919,16112,3578726626,3578726633,7
0,919,16113,3578726626,3578726634,8
0,919,16114,3578726626,3578726634,8
0,919,16115,3578726626,3578726636,10
0,919,16116,3578726626,3578726639,13
0,919,16117,3578726626,3578726640,14
0,919,16118,3578726626,3578726641,15
0,919,16119,3578726626,3578726643,17
0,919,16120,3578726626,3578726643,17
0,919,16121,3578726626,3578726647,21
0,919,16122,3578726626,3578726650,24
0,919,16123,3578726626,3578726650,24
0,919,16124,3578726626,3578726650,24
0,919,16125,3578726626,3578726652,26
0,919,16126,3578726626,3578726653,27
0,919,16127,3578726626,3578726654,28
0,919,16128,3578726626,3578726654,28
0,919,16129,3578726626,3578726656,30
0,919,16130,3578726626,3578726658,32
0,919,16131,3578726626,3578726660,34
0,919,16132,3578726626,3578726662,36
0,919,16133,3578726626,3578726663,37
0,919,16134,3578726626,3578726664,38
0,919,16135,3578726626,3578726665,39
0,919,16136,3578726626,3578726665,39
0,919,16137,3578726626,3578726665,39
0,919,16138,3578726626,3578726666,40
0,919,16139,3578726626,3578726667,41
0,919,16140,3578726626,3578726668,42
0,919,16141,3578726626,3578726670,44
0,919,16142,3578726626,3578726671,45
0,919,16143,3578726626,3578726673,47
0,920,16144,3578726683,3578726683,0
0,920,16145,3578726683,3578726683,0
0,920,16146,3578726683,3578726683,0
0,920,16147,3578726683,3578726685,2
0,920,16148,3578726683,3578726685,2
0,920,16149,3578726683,3578726686,3
0,920,16150,3578726683,3578726688,5
0,920,16151,3578726683,3578726689,6
0,920,16152,3578726683,3578726691,8
0,920,16153,3578726683,3578726697,14
0,920,16154,3578726683,3578726698,15
0,920,16155,3578726683,3578726698,15
0,920,16156,3578726683,3578726699,16
0,920,16157,3578726683,3578726699,16
0,920,16158,3578726683,3578726700,17
0,920,16159,3578726683,3578726700,17
0,920,16160,3578726683,3578726701,18
0,920,16161,3578726683,3578726702,19
0,920,16162,3578726683,3578726703,20
0,920,16163,3578726683,3578726704,21
0,920,16164,3578726683,3578726704,21
0,920,16165,3578726683,3578726705,22
0,920,16166,3578726683,3578726705,22
0,920,16167,3578726683,3578726706,23
0,920,16168,3578726683,3578726706,23
0,920,16169,3578726683,3578726706,23
0,920,16170,3578726683,3578726706,23
0,920,16171,3578726683,3578726707,24
0,920,16172,3578726683,3578726707,24
0,920,16173,3578726683,3578726707,24
0,920,16174,3578726683,3578726708,25
0,920,16175,3578726683,3578726708,25
0,920,16176,3578726683,3578726710,27
0,920,16177,3578726683,3578726711,28
0,920,16178,3578726683,3578726714,31
0,920,16179,3578726683,3578726714,31
0,920,16180,3578726683,3578726714,31
0,920,16181,3578726683,3578726715,32
0,920,16182,3578726683,3578726715,32
0,920,16183,3578726683,3578726717,34
0,920,16184,3578726683,3578726721,38
0,920,16185,3578726683,3578726722,39
0,920,16186,3578726683,3578726722,39
0,920,16187,3578726683,3578726725,42
0,920,16188,3578726683,3578726727,44
0,920,16189,3578726683,3578726728,45
0,920,16190,3578726683,3578726730,47
0,920,16191,3578726683,3578726731,48
0,920,16192,3578726683,3578726731,48
0,920,16193,3578726683,3578726731,48
0,920,16194,3578726683,3578726731,48
0,920,16195,3578726683,3578726732,49
0,921,16196,3578726739,3578726739,0
0,921,16197,3578726739,3578726739,0
0,921,16198,3578726739,3578726741,2
0,921,16199,3578726739,3578726741,2
0,921,16200,3578726739,3578726743,4
0,921,16201,3578726739,3578726743,4
0,921,16202,3578726739,3578726743,4
0,921,16203,3578726739,3578726744,5
0,921,16204,3578726739,3578726745,6
0,921,16205,3578726739,3578726745,6
0,921,16206,3578726739,3578726748,9
0,921,16207,3578726739,3578726750,11
0,921,16208,3578726739,3578726751,12
0,921,16209,3578726739,3578726753,14
0,921,16210,3578726739,3578726754,15
0,921,16211,3578726739,3578726756,17
0,921,16212,3578726739,3578726756,17
0,921,16213,3578726739,3578726759,20
0,921,16214,3578726739,3578726759,20
0,921,16215,3578726739,3578726761,22
0,921,16216,3578726739,3578726761,22
0,921,16217,3578726739,3578726761,22
0,921,16218,3578726739,3578726761,22
0,921,16219,3578726739,3578726762,23
0,921,16220,3578726739,3578726762,23
0,921,16221,3578726739,3578726765,26
0,921,16222,3578726739,3578726765,26
0,921,16223,3578726739,3578726766,27
0,921,16224,3578726739,3578726768,29
0,921,16225,3578726739,3578726768,29
0,921,16226,3578726739,3578726770,31
0,921,16227,3578726739,3578726771,32
0,921,16228,3578726739,3578726772,33
0,921,16229,3578726739,3578726773,34
0,921,16230,3578726739,3578726773,34
0,921,16231,3578726739,3578726773,34
0,921,16232,3578726739,3578726776,37
0,921,16233,3578726739,3578726779,40
0,921,16234,3578726739,3578726779,40
0,921,16235,3578726739,3578726779,40
0,921,16236,3578726739,3578726780,41
0,921,16237,3578726739,3578726781,42
0,921,16238,3578726739,3578726781,42
0,921,16239,3578726739,3578726782,43
0,921,16240,3578726739,3578726782,43
0,921,16241,3578726739,3578726785,46
0,921,16242,3578726739,3578726785,46
0,921,16243,3578726739,3578726786,47
0,921,16244,3578726739,3578726788,49
0,922,16245,3578726796,3578726796,0
0,922,16246,3578726796,3578726796,0
0,922,16247,3578726796,3578726796,0
0,922,16248,3578726796,3578726796,0
0,922,16249,3578726796,3578726796,0
0,922,16250,3578726796,3578726796,0
0,922,16251,3578726796,3578726796,0
0,922,16252,3578726796,3578726796,0
0,922,16253,3578726796,3578726796,0
0,922,16254,3578726796,3578726799,3
0,922,16255,3578726796,3578726799,3
0,922,16256,3578726796,3578726805,9
0,922,16257,3578726796,3578726806,10
0,922,16258,3578726796,3578726806,10
0,922,16259,3578726796,3578726807,11
0,922,16260,3578726796,3578726807,11
0,922,16261,3578726796,3578726808,12
0,922,16262,3578726796,3578726808,12
0,922,16263,3578726796,3578726808,12
0,922,16264,3578726796,3578726809,13
0,922,16265,3578726796,3578726812,16
0,922,16266,3578726796,3578726815,19
0,922,16267,3578726796,3578726815,19
0,922,16268,3578726796,3578726815,19
0,922,16269,3578726796,3578726815,19
0,922,16270,3578726796,3578726816,20
0,922,16271,3578726796,3578726818,22
0,922,16272,3578726796,3578726818,22
0,922,16273,3578726796,3578726819,23
0,922,16274,3578726796,3578726821,25
0,922,16275,3578726796,3578726822,26
0,922,16276,3578726796,3578726826,30
0,922,16277,3578726796,3578726830,34
0,922,16278,3578726796,3578726830,34
0,922,16279,3578726796,3578726831,35
0,922,16280,3578726796,3578726833,37
0,922,16281,3578726796,3578726833,37
0,922,16282,3578726796,3578726834,38
0,922,16283,3578726796,3578726834,38
0,922,16284,3578726796,3578726836,40
0,922,16285,3578726796,3578726839,43
0,922,16286,3578726796,3578726839,43
0,922,16287,3578726796,3578726842,46
0,922,16288,3578726796,3578726843,47
0,923,16289,3578726853,3578726853,0
0,923,16290,3578726853,3578726853,0
0,923,16291,3578726853,3578726853,0
0,923,16292,3578726853,3578726853,0
0,923,16293,3578726853,3578726853,0
0,923,16294,3578726853,3578726853,0
0,923,16295,3578726853,3578726854,1
0,923,16296,3578726853,3578726854,1
0,923,16297,3578726853,3578726858,5
0,923,16298,3578726853,3578726859,6
0,923,16299,3578726853,3578726860,7
0,923,16300,3578726853,3578726862,9
0,923,16301,3578726853,3578726862,9
0,923,16302,3578726853,3578726863,10
0,923,16303,3578726853,3578726864,11
0,923,16304,3578726853,3578726864,11
0,923,16305,3578726853,3578726865,12
0,923,16306,3578726853,3578726865,12
0,923,16307,3578726853,3578726866,13
0,923,16308,3578726853,3578726867,14
0,923,16309,3578726853,3578726868,15
0,923,16310,3578726853,3578726870,17
0,923,16311,3578726853,3578726872,19
0,923,16312,3578726853,3578726873,20
0,923,16313,3578726853,3578726879,26
0,923,16314,3578726853,3578726881,28
0,923,16315,3578726853,3578726881,28
0,923,16316,3578726853,3578726885,32
0,923,16317,3578726853,3578726886,33
0,923,16318,3578726853,3578726886,33
0,923,16319,3578726853,3578726887,34
0,923,16320,3578726853,3578726888,35
0,923,16321,3578726853,3578726889,36
0,923,16322,3578726853,3578726892,39
0,923,16323,3578726853,3578726892,39
0,923,16324,3578726853,3578726897,44
0,923,16325,3578726853,3578726898,45
0,923,16326,3578726853,3578726899,46
0,923,16327,3578726853,3578726899,46
0,923,16328,3578726853,3578726901,48
0,923,16329,3578726853,3578726901,48
0,923,16330,3578726853,3578726901,48
0,923,16331,3578726853,3578726902,49
0,923,16332,3578726853,3578726902,49
0,924,16333,3578726909,3578726909,0
0,924,16334,3578726909,3578726909,0
0,924,16335,3578726909,3578726909,0
0,924,16336,3578726909,3578726909,0
0,924,16337,3578726909,3578726909,0
0,924,16338,3578726909,3578726909,0
0,924,16339,3578726909,3578726909,0
0,924,16340,3578726909,3578726909,0
0,924,16341,3578726909,3578726909,0
0,924,16342,3578726909,3578726909,0
0,924,16343,3578726909,3578726909,0
0,924,16344,3578726909,3578726909,0
0,924,16345,3578726909,3578726910,1
0,924,16346,3578726909,3578726910,1
0,924,16347,3578726909,3578726910,1
0,924,16348,3578726909,3578726911,2
0,924,16349,3578726909,3578726914,5
0,924,16350,3578726909,3578726914,5
0,924,16351,3578726909,3578726915,6
0,924,16352,3578726909,3578726915,6
0,924,16353,3578726909,3578726916,7
0,924,16354,3578726909,3578726917,8
0,924,16355,3578726909,3578726919,10
0,924,16356,3578726909,3578726920,11
0,924,16357,3578726909,3578726921,12
0,924,16358,3578726909,3578726922,13
0,924,16359,3578726909,3578726923,14
0,924,16360,3578726909,3578726925,16
0,924,16361,3578726909,3578726927,18
0,924,16362,3578726909,3578726929,20
0,924,16363,3578726909,3578726929,20
0,924,16364,3578726909,3578726931,22
0,924,16365,3578726909,3578726931,22
0,924,16366,3578726909,3578726932,23
0,924,16367,3578726909,3578726933,24
0,924,16368,3578726909,3578726934,25
0,924,16369,3578726909,3578726935,26
0,924,16370,3578726909,3578726938,29
0,924,16371,3578726909,3578726941,32
0,924,16372,3578726909,3578726942,33
0,924,16373,3578726909,3578726943,34
0,924,16374,3578726909,3578726943,34
0,924,16375,3578726909,3578726943,34
0,924,16376,3578726909,3578726944,35
0,924,16377,3578726909,3578726944,35
0,924,16378,3578726909,3578726946,37
0,924,16379,3578726909,3578726948,39
0,924,16380,3578726909,3578726950,41
0,924,16381,3578726909,3578726952,43
0,924,16382,3578726909,3578726953,44
0,924,16383,3578726909,3578726953,44
0,924,16384,3578726909,3578726954,45
0,924,16385,3578726909,3578726957,48
0,924,16386,3578726909,3578726958,49
0,924,16387,3578726909,3578726959,50
0,925,16388,3578726967,3578726967,0
0,925,16389,3578726967,3578726967,0
0,925,16390,3578726967,3578726967,0
0,925,16391,3578726967,3578726967,0
0,925,16392,3578726967,3578726967,0
0,925,16393,3578726967,3578726967,0
0,925,16394,3578726967,3578726967,0
0,925,16395,3578726967,3578726967,0
0,925,16396,3578726967,3578726967,0
0,925,16397,3578726967,3578726967,0
0,925,16398,3578726967,3578726967,0
0,925,16399,3578726967,3578726967,0
0,925,16400,3578726967,3578726968,1
0,925,16401,3578726967,3578726968,1
0,925,16402,3578726967,3578726970,3
0,925,16403,3578726967,3578726971,4
0,925,16404,3578726967,3578726971,4
0,925,16405,3578726967,3578726972,5
0,925,16406,3578726967,3578726972,5
0,925,16407,3578726967,3578726973,6
0,925,16408,3578726967,3578726974,7
0,925,16409,3578726967,3578726976,9
0,925,16410,3578726967,3578726978,11
0,925,16411,3578726967,3578726979,12
0,925,16412,3578726967,3578726979,12
0,925,16413,3578726967,3578726981,14
0,925,16414,3578726967,3578726982,15
0,925,16415,3578726967,3578726982,15
0,925,16416,3578726967,3578726983,16
0,925,16417,3578726967,3578726984,17
0,925,16418,3578726967,3578726984,17
0,925,16419,3578726967,3578726985,18
0,925,16420,3578726967,3578726986,19
0,925,16421,3578726967,3578726988,21
0,925,16422,3578726967,3578726990,23
0,925,16423,3578726967,3578726991,24
0,925,16424,3578726967,3578726991,24
0,925,16425,3578726967,3578726993,26
0,925,16426,3578726967,3578726994,27
0,925,16427,3578726967,3578726994,27
0,925,16428,3578726967,3578726994,27
0,925,16429,3578726967,3578726996,29
0,925,16430,3578726967,3578726998,31
0,925,16431,3578726967,3578726999,32
0,925,16432,3578726967,3578727005,38
0,925,16433,3578726967,3578727005,38
0,925,16434,3578726967,3578727006,39
0,925,16435,3578726967,3578727008,41
0,925,16436,3578726967,3578727008,41
0,925,16437,3578726967,3578727009,42
0,925,16438,3578726967,3578727009,42
0,925,16439,3578726967,3578727010,43
0,925,16440,3578726967,3578727013,46
0,925,16441,3578726967,3578727015,48
0,925,16442,3578726967,3578727015,48
0,925,16443,3578726967,3578727015,48
0,925,16444,3578726967,3578727016,49
0,926,16445,3578727024,3578727024,0
0,926,16446,3578727024,3578727024,0
0,926,16447,3578727024,3578727024,0
0,926,16448,3578727024,3578727024,0
0,926,16449,3578727024,3578727024,0
0,926,16450,3578727024,3578727024,0
0,926,16451,3578727024,3578727025,1
0,926,16452,3578727024,3578727030,6
0,926,16453,3578727024,3578727031,7
0,926,16454,3578727024,3578727031,7
0,926,16455,3578727024,3578727034,10
0,926,16456,3578727024,3578727035,11
0,926,16457,3578727024,3578727035,11
0,926,16458,3578727024,3578727035,11
0,926,16459,3578727024,3578727039,15
0,926,16460,3578727024,3578727040,16
0,926,16461,3578727024,3578727042,18
0,926,16462,3578727024,3578727043,19
0,926,16463,3578727024,3578727048,24
0,926,16464,3578727024,3578727049,25
0,926,16465,3578727024,3578727051,27
0,926,16466,3578727024,3578727051,27
0,926,16467,3578727024,3578727053,29
0,926,16468,3578727024,3578727054,30
0,926,16469,3578727024,3578727057,33
0,926,16470,3578727024,3578727058,34
0,926,16471,3578727024,3578727058,34
0,926,16472,3578727024,3578727060,36
0,926,16473,3578727024,3578727060,36
0,926,16474,3578727024,3578727062,38
0,926,16475,3578727024,3578727062,38
0,926,16476,3578727024,3578727063,39
0,926,16477,3578727024,3578727064,40
0,926,16478,3578727024,3578727065,41
0,926,16479,3578727024,3578727065,41
0,926,16480,3578727024,3578727066,42
0,926,16481,3578727024,3578727067,43
0,926,16482,3578727024,3578727068,44
0,926,16483,3578727024,3578727069,45
0,926,16484,3578727024,3578727071,47
0,926,16485,3578727024,3578727072,48
0,926,16486,3578727024,3578727073,49
0,927,16487,3578727080,3578727080,0
0,927,16488,3578727080,3578727081,1
0,927,16489,3578727080,3578727081,1
0,927,16490,3578727080,3578727085,5
0,927,16491,3578727080,3578727086,6
0,927,16492,3578727080,3578727087,7
0,927,16493,3578727080,3578727088,8
0,927,16494,3578727080,3578727090,10
0,927,16495,3578727080,3578727091,11
0,927,16496,3578727080,3578727092,12
0,927,16497,3578727080,3578727096,16
0,927,16498,3578727080,3578727097,17
0,927,16499,3578727080,3578727098,18
0,927,16500,3578727080,3578727099,19
0,927,16501,3578727080,3578727099,19
0,927,16502,3578727080,3578727101,21
0,927,16503,3578727080,3578727101,21
0,927,16504,3578727080,3578727102,22
0,927,16505,3578727080,3578727102,22
0,927,16506,3578727080,3578727103,23
0,927,16507,3578727080,3578727104,24
0,927,16508,3578727080,3578727105,25
0,927,16509,3578727080,3578727105,25
0,927,16510,3578727080,3578727106,26
0,927,16511,3578727080,3578727107,27
0,927,16512,3578727080,3578727107,27
0,927,16513,3578727080,3578727107,27
0,927,16514,3578727080,3578727107,27
0,927,16515,3578727080,3578727108,28
0,927,16516,3578727080,3578727108,28
0,927,16517,3578727080,3578727108,28
0,927,16518,3578727080,3578727110,30
0,927,16519,3578727080,3578727111,31
0,927,16520,3578727080,3578727113,33
0,927,16521,3578727080,3578727114,34
0,927,16522,3578727080,3578727114,34
0,927,16523,3578727080,3578727115,35
0,927,16524,3578727080,3578727115,35
0,927,16525,3578727080,3578727116,36
0,927,16526,3578727080,3578727117,37
0,927,16527,3578727080,3578727120,40
0,927,16528,3578727080,3578727121,41
0,927,16529,3578727080,3578727123,43
0,927,16530,3578727080,3578727123,43
0,927,16531,3578727080,3578727126,46
0,927,16532,3578727080,3578727126,46
0,927,16533,3578727080,3578727129,49
0,927,16534,3578727080,3578727129,49
0,928,16535,3578727138,3578727138,0
0,928,16536,3578727138,3578727138,0
0,928,16537,3578727138,3578727138,0
0,928,16538,3578727138,3578727138,0
0,928,16539,3578727138,3578727138,0
0,928,16540,3578727138,3578727138,0
0,928,16541,3578727138,3578727138,0
0,928,16542,3578727138,3578727139,1
0,928,16543,3578727138,3578727141,3
0,928,16544,3578727138,3578727142,4
0,928,16545,3578727138,3578727143,5
0,928,16546,3578727138,3578727143,5
0,928,16547,3578727138,3578727143,5
0,928,16548,3578727138,3578727145,7
0,928,16549,3578727138,3578727145,7
0,928,16550,3578727138,3578727148,10
0,928,16551,3578727138,3578727151,13
0,928,16552,3578727138,3578727151,13
0,928,16553,3578727138,3578727153,15
0,928,16554,3578727138,3578727154,16
0,928,16555,3578727138,3578727157,19
0,928,16556,3578727138,3578727159,21
0,928,16557,3578727138,3578727159,21
0,928,16558,3578727138,3578727161,23
0,928,16559,3578727138,3578727161,23
0,928,16560,3578727138,3578727162,24
0,928,16561,3578727138,3578727162,24
0,928,16562,3578727138,3578727162,24
0,928,16563,3578727138,3578727163,25
0,928,16564,3578727138,3578727163,25
0,928,16565,3578727138,3578727164,26
0,928,16566,3578727138,3578727166,28
0,928,16567,3578727138,3578727167,29
0,928,16568,3578727138,3578727167,29
0,928,16569,3578727138,3578727168,30
0,928,16570,3578727138,3578727168,30
0,928,16571,3578727138,3578727170,32
0,928,16572,3578727138,3578727170,32
0,928,16573,3578727138,3578727170,32
0,928,16574,3578727138,3578727171,33
0,928,16575,3578727138,3578727171,33
0,928,16576,3578727138,3578727172,34
0,928,16577,3578727138,3578727174,36
0,928,16578,3578727138,3578727174,36
0,928,16579,3578727138,3578727176,38
0,928,16580,3578727138,3578727178,40
0,928,16581,3578727138,3578727179,41
0,928,16582,3578727138,3578727179,41
0,928,16583,3578727138,3578727180,42
0,928,16584,3578727138,3578727181,43
0,928,16585,3578727138,3578727181,43
0,928,16586,3578727138,3578727182,44
0,928,16587,3578727138,3578727182,44
0,928,16588,3578727138,3578727183,45
0,928,16589,3578727138,3578727185,47
0,928,16590,3578727138,3578727185,47
0,928,16591,3578727138,3578727186,48
0,929,16592,3578727194,3578727194,0
0,929,16593,3578727194,3578727194,0
0,929,16594,3578727194,3578727194,0
0,929,16595,3578727194,3578727194,0
0,929,16596,3578727194,3578727194,0
0,929,16597,3578727194,3578727194,0
0,929,16598,3578727194,3578727194,0
0,929,16599,3578727194,3578727195,1
0,929,16600,3578727194,3578727196,2
0,929,16601,3578727194,3578727196,2
0,929,16602,3578727194,3578727199,5
0,929,16603,3578727194,3578727200,6
0,929,16604,3578727194,3578727201,7
0,929,16605,3578727194,3578727205,11
0,929,16606,3578727194,3578727206,12
0,929,16607,3578727194,3578727209,15
0,929,16608,3578727194,3578727209,15
0,929,16609,3578727194,3578727209,15
0,929,16610,3578727194,3578727209,15
0,929,16611,3578727194,3578727210,16
0,929,16612,3578727194,3578727212,18
0,929,16613,3578727194,3578727215,21
0,929,16614,3578727194,3578727215,21
0,929,16615,3578727194,3578727215,21
0,929,16616,3578727194,3578727216,22
0,929,16617,3578727194,3578727217,23
0,929,16618,3578727194,3578727218,24
0,929,16619,3578727194,3578727218,24
0,929,16620,3578727194,3578727219,25
0,929,16621,3578727194,3578727221,27
0,929,16622,3578727194,3578727221,27
0,929,16623,3578727194,3578727221,27
0,929,16624,3578727194,3578727224,30
0,929,16625,3578727194,3578727226,32
0,929,16626,3578727194,3578727230,36
0,929,16627,3578727194,3578727230,36
0,929,16628,3578727194,3578727231,37
0,929,16629,3578727194,3578727231,37
0,929,16630,3578727194,3578727234,40
0,929,16631,3578727194,3578727235,41
0,929,16632,3578727194,3578727236,42
0,929,16633,3578727194,3578727239,45
0,929,16634,3578727194,3578727240,46
0,929,16635,3578727194,3578727243,49
0,929,16636,3578727194,3578727244,50
0,930,16637,3578727251,3578727251,0
0,930,16638,3578727251,3578727251,0
0,930,16639,3578727251,3578727251,0
0,930,16640,3578727251,3578727251,0
0,930,16641,3578727251,3578727251,0
0,930,16642,3578727251,3578727251,0
0,930,16643,3578727251,3578727252,1
0,930,16644,3578727251,3578727254,3
0,930,16645,3578727251,3578727254,3
0,930,16646,3578727251,3578727257,6
0,930,16647,3578727251,3578727259,8
0,930,16648,3578727251,3578727261,10
0,930,16649,3578727251,3578727262,11
0,930,16650,3578727251,3578727262,11
0,930,16651,3578727251,3578727263,12
0,930,16652,3578727251,3578727265,14
0,930,16653,3578727251,3578727265,14
0,930,16654,3578727251,3578727266,15
0,930,16655,3578727251,3578727267,16
0,930,16656,3578727251,3578727268,17
0,930,16657,3578727251,3578727268,17
0,930,16658,3578727251,3578727268,17
0,930,16659,3578727251,3578727269,18
0,930,16660,3578727251,3578727271,20
0,930,16661,3578727251,3578727272,21
0,930,16662,3578727251,3578727273,22
0,930,16663,3578727251,3578727280,29
0,930,16664,3578727251,3578727281,30
0,930,16665,3578727251,3578727285,34
0,930,16666,3578727251,3578727286,35
0,930,16667,3578727251,3578727287,36
0,930,16668,3578727251,3578727287,36
0,930,16669,3578727251,3578727288,37
0,930,16670,3578727251,3578727290,39
0,930,16671,3578727251,3578727292,41
0,930,16672,3578727251,3578727292,41
0,930,16673,3578727251,3578727297,46
0,930,16674,3578727251,3578727298,47
0,930,16675,3578727251,3578727299,48
0,930,16676,3578727251,3578727299,48
0,930,16677,3578727251,3578727299,48
0,930,16678,3578727251,3578727301,50
0,931,16679,3578727308,3578727308,0
0,931,16680,3578727308,3578727308,0
0,931,16681,3578727308,3578727308,0
0,931,16682,3578727308,3578727308,0
0,931,16683,3578727308,3578727308,0
0,931,16684,3578727308,3578727308,0
0,931,16685,3578727308,3578727308,0
0,931,16686,3578727308,3578727308,0
0,931,16687,3578727308,3578727308,0
0,931,16688,3578727308,3578727308,0
0,931,16689,3578727308,3578727308,0
0,931,16690,3578727308,3578727308,0
0,931,16691,3578727308,3578727308,0
0,931,16692,3578727308,3578727308,0
0,931,16693,3578727308,3578727308,0
0,931,16694,3578727308,3578727308,0
0,931,16695,3578727308,3578727308,0
0,931,16696,3578727308,3578727308,0
0,931,16697,3578727308,3578727310,2
0,931,16698,3578727308,3578727310,2
0,931,16699,3578727308,3578727314,6
0,931,16700,3578727308,3578727314,6
0,931,16701,3578727308,3578727316,8
0,931,16702,3578727308,3578727316,8
0,931,16703,3578727308,3578727318,10
0,931,16704,3578727308,3578727319,11
0,931,16705,3578727308,3578727320,12
0,931,16706,3578727308,3578727320,12
0,931,16707,3578727308,3578727321,13
0,931,16708,3578727308,3578727323,15
0,931,16709,3578727308,3578727323,15
0,931,16710,3578727308,3578727326,18
0,931,16711,3578727308,3578727326,18
0,931,16712,3578727308,3578727329,21
0,931,16713,3578727308,3578727329,21
0,931,16714,3578727308,3578727331,23
0,931,16715,3578727308,3578727331,23
0,931,16716,3578727308,3578727331,23
0,931,16717,3578727308,3578727332,24
0,931,16718,3578727308,3578727333,25
0,931,16719,3578727308,3578727333,25
0,931,16720,3578727308,3578727335,27
0,931,16721,3578727308,3578727335,27
0,931,16722,3578727308,3578727339,31
0,931,16723,3578727308,3578727341,33
0,931,16724,3578727308,3578727343,35
0,931,16725,3578727308,3578727343,35
0,931,16726,3578727308,3578727343,35
0,931,16727,3578727308,3578727343,35
0,931,16728,3578727308,3578727346,38
0,931,16729,3578727308,3578727346,38
0,931,16730,3578727308,3578727348,40
0,931,16731,3578727308,3578727351,43
0,931,16732,3578727308,3578727352,44
0,931,16733,3578727308,3578727353,45
0,931,16734,3578727308,3578727354,46
0,931,16735,3578727308,3578727355,47
0,931,16736,3578727308,3578727356,48
0,931,16737,3578727308,3578727358,50
0,932,16738,3578727364,3578727364,0
0,932,16739,3578727364,3578727364,0
0,932,16740,3578727364,3578727364,0
0,932,16741,3578727364,3578727364,0
0,932,16742,3578727364,3578727364,0
0,932,16743,3578727364,3578727364,0
0,932,16744,3578727364,3578727364,0
0,932,16745,3578727364,3578727364,0
0,932,16746,3578727364,3578727364,0
0,932,16747,3578727364,3578727366,2
0,932,16748,3578727364,3578727367,3
0,932,16749,3578727364,3578727367,3
0,932,16750,3578727364,3578727367,3
0,932,16751,3578727364,3578727369,5
0,932,16752,3578727364,3578727370,6
0,932,16753,3578727364,3578727371,7
0,932,16754,3578727364,3578727371,7
0,932,16755,3578727364,3578727371,7
0,932,16756,3578727364,3578727372,8
0,932,16757,3578727364,3578727372,8
0,932,16758,3578727364,3578727374,10
0,932,16759,3578727364,3578727375,11
0,932,16760,3578727364,3578727379,15
0,932,16761,3578727364,3578727379,15
0,932,16762,3578727364,3578727380,16
0,932,16763,3578727364,3578727380,16
0,932,16764,3578727364,3578727381,17
0,932,16765,3578727364,3578727382,18
0,932,16766,3578727364,3578727382,18
0,932,16767,3578727364,3578727382,18
0,932,16768,3578727364,3578727383,19
0,932,16769,3578727364,3578727384,20
0,932,16770,3578727364,3578727385,21
0,932,16771,3578727364,3578727386,22
0,932,16772,3578727364,3578727389,25
0,932,16773,3578727364,3578727391,27
0,932,16774,3578727364,3578727392,28
0,932,16775,3578727364,3578727392,28
0,932,16776,3578727364,3578727392,28
0,932,16777,3578727364,3578727394,30
0,932,16778,3578727364,3578727395,31
0,932,16779,3578727364,3578727396,32
0,932,16780,3578727364,3578727396,32
0,932,16781,3578727364,3578727399,35
0,932,16782,3578727364,3578727400,36
0,932,16783,3578727364,3578727402,38
0,932,16784,3578727364,3578727406,42
0,932,16785,3578727364,3578727406,42
0,932,16786,3578727364,3578727407,43
0,932,16787,3578727364,3578727409,45
0,932,16788,3578727364,3578727409,45
0,932,16789,3578727364,3578727410,46
0,932,16790,3578727364,3578727412,48
0,933,16791,3578727422,3578727422,0
0,933,16792,3578727422,3578727422,0
0,933,16793,3578727422,3578727422,0
0,933,16794,3578727422,3578727422,0
0,933,16795,3578727422,3578727422,0
0,933,16796,3578727422,3578727422,0
0,933,16797,3578727422,3578727422,0
0,933,16798,3578727422,3578727422,0
0,933,16799,3578727422,3578727422,0
0,933,16800,3578727422,3578727422,0
0,933,16801,3578727422,3578727424,2
0,933,16802,3578727422,3578727426,4
0,933,16803,3578727422,3578727429,7
0,933,16804,3578727422,3578727430,8
0,933,16805,3578727422,3578727431,9
0,933,16806,3578727422,3578727431,9
0,933,16807,3578727422,3578727434,12
0,933,16808,3578727422,3578727435,13
0,933,16809,3578727422,3578727439,17
0,933,16810,3578727422,3578727441,19
0,933,16811,3578727422,3578727443,21
0,933,16812,3578727422,3578727443,21
0,933,16813,3578727422,3578727444,22
0,933,16814,3578727422,3578727444,22
0,933,16815,3578727422,3578727447,25
0,933,16816,3578727422,3578727449,27
0,933,16817,3578727422,3578727450,28
0,933,16818,3578727422,3578727451,29
0,933,16819,3578727422,3578727453,31
0,933,16820,3578727422,3578727455,33
0,933,16821,3578727422,3578727458,36
0,933,16822,3578727422,3578727458,36
0,933,16823,3578727422,3578727459,37
0,933,16824,3578727422,3578727462,40
0,933,16825,3578727422,3578727462,40
0,933,16826,3578727422,3578727462,40
0,933,16827,3578727422,3578727463,41
0,933,16828,3578727422,3578727465,43
0,933,16829,3578727422,3578727467,45
0,933,16830,3578727422,3578727467,45
0,933,16831,3578727422,3578727468,46
0,933,16832,3578727422,3578727468,46
0,933,16833,3578727422,3578727468,46
0,933,16834,3578727422,3578727471,49
0,933,16835,3578727422,3578727471,49
0,933,16836,3578727422,3578727472,50
0,934,16837,3578727480,3578727480,0
0,934,16838,3578727480,3578727480,0
0,934,16839,3578727480,3578727480,0
0,934,16840,3578727480,3578727484,4
0,934,16841,3578727480,3578727485,5
0,934,16842,3578727480,3578727487,7
0,934,16843,3578727480,3578727488,8
0,934,16844,3578727480,3578727489,9
0,934,16845,3578727480,3578727490,10
0,934,16846,3578727480,3578727491,11
0,934,16847,3578727480,3578727496,16
0,934,16848,3578727480,3578727497,17
0,934,16849,3578727480,3578727498,18
0,934,16850,3578727480,3578727498,18
0,934,16851,3578727480,3578727498,18
0,934,16852,3578727480,3578727500,20
0,934,16853,3578727480,3578727502,22
0,934,16854,3578727480,3578727504,24
0,934,16855,3578727480,3578727504,24
0,934,16856,3578727480,3578727504,24
0,934,16857,3578727480,3578727504,24
0,934,16858,3578727480,3578727506,26
0,934,16859,3578727480,3578727506,26
0,934,16860,3578727480,3578727506,26
0,934,16861,3578727480,3578727506,26
0,934,16862,3578727480,3578727506,26
0,934,16863,3578727480,3578727506,26
0,934,16864,3578727480,3578727506,26
0,934,16865,3578727480,3578727507,27
0,934,16866,3578727480,3578727508,28
0,934,16867,3578727480,3578727508,28
0,934,16868,3578727480,3578727509,29
0,934,16869,3578727480,3578727510,30
0,934,16870,3578727480,3578727512,32
0,934,16871,3578727480,3578727513,33
0,934,16872,3578727480,3578727514,34
0,934,16873,3578727480,3578727515,35
0,934,16874,3578727480,3578727516,36
0,934,16875,3578727480,3578727517,37
0,934,16876,3578727480,3578727518,38
0,934,16877,3578727480,3578727519,39
0,934,16878,3578727480,3578727519,39
0,934,16879,3578727480,3578727520,40
0,934,16880,3578727480,3578727522,42
0,934,16881,3578727480,3578727523,43
0,934,16882,3578727480,3578727523,43
0,934,16883,3578727480,3578727524,44
0,934,16884,3578727480,3578727525,45
0,934,16885,3578727480,3578727527,47
0,934,16886,3578727480,3578727528,48
0,934,16887,3578727480,3578727530,50
0,935,16888,3578727537,3578727537,0
0,935,16889,3578727537,3578727537,0
0,935,16890,3578727537,3578727537,0
0,935,16891,3578727537,3578727537,0
0,935,16892,3578727537,3578727537,0
0,935,16893,3578727537,3578727537,0
0,935,16894,3578727537,3578727537,0
0,935,16895,3578727537,3578727539,2
0,935,16896,3578727537,3578727540,3
0,935,16897,3578727537,3578727542,5
0,935,16898,3578727537,3578727542,5
0,935,16899,3578727537,3578727543,6
0,935,16900,3578727537,3578727543,6
0,935,16901,3578727537,3578727544,7
0,935,16902,3578727537,3578727545,8
0,935,16903,3578727537,3578727547,10
0,935,16904,3578727537,3578727551,14
0,935,16905,3578727537,3578727551,14
0,935,16906,3578727537,3578727553,16
0,935,16907,3578727537,3578727554,17
0,935,16908,3578727537,3578727558,21
0,935,16909,3578727537,3578727559,22
0,935,16910,3578727537,3578727561,24
0,935,16911,3578727537,3578727561,24
0,935,16912,3578727537,3578727561,24
0,935,16913,3578727537,3578727562,25
0,935,16914,3578727537,3578727563,26
0,935,16915,3578727537,3578727564,27
0,935,16916,3578727537,3578727566,29
0,935,16917,3578727537,3578727566,29
0,935,16918,3578727537,3578727567,30
0,935,16919,3578727537,3578727567,30
0,935,16920,3578727537,3578727567,30
0,935,16921,3578727537,3578727570,33
0,935,16922,3578727537,3578727570,33
0,935,16923,3578727537,3578727570,33
0,935,16924,3578727537,3578727571,34
0,935,16925,3578727537,3578727572,35
0,935,16926,3578727537,3578727573,36
0,935,16927,3578727537,3578727573,36
0,935,16928,3578727537,3578727574,37
0,935,16929,3578727537,3578727575,38
0,935,16930,3578727537,3578727578,41
0,935,16931,3578727537,3578727579,42
0,935,16932,3578727537,3578727579,42
0,935,16933,3578727537,3578727580,43
0,935,16934,3578727537,3578727581,44
0,935,16935,3578727537,3578727581,44
0,935,16936,3578727537,3578727581,44
0,935,16937,3578727537,3578727583,46
0,935,16938,3578727537,3578727583,46
0,935,16939,3578727537,3578727585,48
0,936,16940,3578727595,3578727595,0
0,936,16941,3578727595,3578727595,0
0,936,16942,3578727595,3578727595,0
0,936,16943,3578727595,3578727595,0
0,936,16944,3578727595,3578727595,0
0,936,16945,3578727595,3578727595,0
0,936,16946,3578727595,3578727595,0
0,936,16947,3578727595,3578727595,0
0,936,16948,3578727595,3578727595,0
0,936,16949,3578727595,3578727595,0
0,936,16950,3578727595,3578727597,2
0,936,16951,3578727595,3578727599,4
0,936,16952,3578727595,3578727601,6
0,936,16953,3578727595,3578727604,9
0,936,16954,3578727595,3578727604,9
0,936,16955,3578727595,3578727605,10
0,936,16956,3578727595,3578727608,13
0,936,16957,3578727595,3578727609,14
0,936,16958,3578727595,3578727609,14
0,936,16959,3578727595,3578727609,14
0,936,16960,3578727595,3578727611,16
0,936,16961,3578727595,3578727614,19
0,936,16962,3578727595,3578727614,19
0,936,16963,3578727595,3578727614,19
0,936,16964,3578727595,3578727615,20
0,936,16965,3578727595,3578727617,22
0,936,16966,3578727595,3578727618,23
0,936,16967,3578727595,3578727618,23
0,936,16968,3578727595,3578727619,24
0,936,16969,3578727595,3578727620,25
0,936,16970,3578727595,3578727620,25
0,936,16971,3578727595,3578727622,27
0,936,16972,3578727595,3578727623,28
0,936,16973,3578727595,3578727626,31
0,936,16974,3578727595,3578727626,31
0,936,16975,3578727595,3578727629,34
0,936,16976,3578727595,3578727629,34
0,936,16977,3578727595,3578727630,35
0,936,16978,3578727595,3578727631,36
0,936,16979,3578727595,3578727633,38
0,936,16980,3578727595,3578727633,38
0,936,16981,3578727595,3578727634,39
0,936,16982,3578727595,3578727634,39
0,936,16983,3578727595,3578727638,43
0,936,16984,3578727595,3578727640,45
0,936,16985,3578727595,3578727642,47
0,936,16986,3578727595,3578727642,47
0,936,16987,3578727595,3578727643,48
0,937,16988,3578727651,3578727651,0
0,937,16989,3578727651,3578727651,0
0,937,16990,3578727651,3578727652,1
0,937,16991,3578727651,3578727653,2
0,937,16992,3578727651,3578727654,3
0,937,16993,3578727651,3578727657,6
0,937,16994,3578727651,3578727658,7
0,937,16995,3578727651,3578727658,7
0,937,16996,3578727651,3578727661,10
0,937,16997,3578727651,3578727661,10
0,937,16998,3578727651,3578727661,10
0,937,16999,3578727651,3578727662,11
0,937,17000,3578727651,3578727664,13
0,937,17001,3578727651,3578727664,13
0,937,17002,3578727651,3578727665,14
0,937,17003,3578727651,3578727667,16
0,937,17004,3578727651,3578727667,16
0,937,17005,3578727651,3578727667,16
0,937,17006,3578727651,3578727667,16
0,937,17007,3578727651,3578727670,19
0,937,17008,3578727651,3578727671,20
0,937,17009,3578727651,3578727672,21
0,937,17010,3578727651,3578727674,23
0,937,17011,3578727651,3578727679,28
0,937,17012,3578727651,3578727679,28
0,937,17013,3578727651,3578727680,29
0,937,17014,3578727651,3578727680,29
0,937,17015,3578727651,3578727686,35
0,937,17016,3578727651,3578727687,36
0,937,17017,3578727651,3578727688,37
0,937,17018,3578727651,3578727689,38
0,937,17019,3578727651,3578727691,40
0,937,17020,3578727651,3578727691,40
0,937,17021,3578727651,3578727695,44
0,937,17022,3578727651,3578727697,46
0,937,17023,3578727651,3578727697,46
0,937,17024,3578727651,3578727698,47
0,937,17025,3578727651,3578727699,48
0,937,17026,3578727651,3578727699,48
0,937,17027,3578727651,3578727701,50
0,938,17028,3578727709,3578727709,0
0,938,17029,3578727709,3578727709,0
0,938,17030,3578727709,3578727709,0
0,938,17031,3578727709,3578727709,0
0,938,17032,3578727709,3578727709,0
0,938,17033,3578727709,3578727709,0
0,938,17034,3578727709,3578727709,0
0,938,17035,3578727709,3578727709,0
0,938,17036,3578727709,3578727709,0
0,938,17037,3578727709,3578727709,0
0,938,17038,3578727709,3578727709,0
0,938,17039,3578727709,3578727709,0
0,938,17040,3578727709,3578727709,0
0,938,17041,3578727709,3578727709,0
0,938,17042,3578727709,3578727709,0
0,938,17043,3578727709,3578727710,1
0,938,17044,3578727709,3578727710,1
0,938,17045,3578727709,3578727713,4
0,938,17046,3578727709,3578727714,5
0,938,17047,3578727709,3578727714,5
0,938,17048,3578727709,3578727715,6
0,938,17049,3578727709,3578727715,6
0,938,17050,3578727709,3578727716,7
0,938,17051,3578727709,3578727718,9
0,938,17052,3578727709,3578727719,10
0,938,17053,3578727709,3578727719,10
0,938,17054,3578727709,3578727720,11
0,938,17055,3578727709,3578727723,14
0,938,17056,3578727709,3578727723,14
0,938,17057,3578727709,3578727725,16
0,938,17058,3578727709,3578727726,17
0,938,17059,3578727709,3578727727,18
0,938,17060,3578727709,3578727727,18
0,938,17061,3578727709,3578727727,18
0,938,17062,3578727709,3578727728,19
0,938,17063,3578727709,3578727730,21
0,938,17064,3578727709,3578727731,22
0,938,17065,3578727709,3578727731,22
0,938,17066,3578727709,3578727732,23
0,938,17067,3578727709,3578727732,23
0,938,17068,3578727709,3578727734,25
0,938,17069,3578727709,3578727734,25
0,938,17070,3578727709,3578727738,29
0,938,17071,3578727709,3578727740,31
0,938,17072,3578727709,3578727742,33
0,938,17073,3578727709,3578727742,33
0,938,17074,3578727709,3578727743,34
0,938,17075,3578727709,3578727744,35
0,938,17076,3578727709,3578727744,35
0,938,17077,3578727709,3578727745,36
0,938,17078,3578727709,3578727746,37
0,938,17079,3578727709,3578727748,39
0,938,17080,3578727709,3578727751,42
0,938,17081,3578727709,3578727751,42
0,938,17082,3578727709,3578727752,43
0,938,17083,3578727709,3578727753,44
0,938,17084,3578727709,3578727754,45
0,938,17085,3578727709,3578727758,49
0,938,17086,3578727709,3578727759,50
0,939,17087,3578727766,3578727766,0
0,939,17088,3578727766,3578727766,0
0,939,17089,3578727766,3578727766,0
0,939,17090,3578727766,3578727766,0
0,939,17091,3578727766,3578727766,0
0,939,17092,3578727766,3578727766,0
0,939,17093,3578727766,3578727766,0
0,939,17094,3578727766,3578727767,1
0,939,17095,3578727766,3578727767,1
0,939,17096,3578727766,3578727768,2
0,939,17097,3578727766,3578727768,2
0,939,17098,3578727766,3578727771,5
0,939,17099,3578727766,3578727771,5
0,939,17100,3578727766,3578727772,6
0,939,17101,3578727766,3578727773,7
0,939,17102,3578727766,3578727773,7
0,939,17103,3578727766,3578727773,7
0,939,17104,3578727766,3578727775,9
0,939,17105,3578727766,3578727776,10
0,939,17106,3578727766,3578727777,11
0,939,17107,3578727766,3578727779,13
0,939,17108,3578727766,3578727779,13
0,939,17109,3578727766,3578727780,14
0,939,17110,3578727766,3578727781,15
0,939,17111,3578727766,3578727782,16
0,939,17112,3578727766,3578727782,16
0,939,17113,3578727766,3578727782,16
0,939,17114,3578727766,3578727782,16
0,939,17115,3578727766,3578727784,18
0,939,17116,3578727766,3578727786,20
0,939,17117,3578727766,3578727789,23
0,939,17118,3578727766,3578727790,24
0,939,17119,3578727766,3578727791,25
0,939,17120,3578727766,3578727791,25
0,939,17121,3578727766,3578727791,25
0,939,17122,3578727766,3578727794,28
0,939,17123,3578727766,3578727795,29
0,939,17124,3578727766,3578727795,29
0,939,17125,3578727766,3578727797,31
0,939,17126,3578727766,3578727798,32
0,939,17127,3578727766,3578727801,35
0,939,17128,3578727766,3578727804,38
0,939,17129,3578727766,3578727804,38
0,939,17130,3578727766,3578727805,39
0,939,17131,3578727766,3578727806,40
0,939,17132,3578727766,3578727809,43
0,939,17133,3578727766,3578727809,43
0,939,17134,3578727766,3578727810,44
0,939,17135,3578727766,3578727812,46
0,939,17136,3578727766,3578727814,48
0,939,17137,3578727766,3578727815,49
0,939,17138,3578727766,3578727816,50
0,940,17139,3578727823,3578727823,0
0,940,17140,3578727823,3578727823,0
0,940,17141,3578727823,3578727823,0
0,940,17142,3578727823,3578727823,0
0,940,17143,3578727823,3578727823,0
0,940,17144,3578727823,3578727823,0
0,940,17145,3578727823,3578727823,0
0,940,17146,3578727823,3578727826,3
0,940,17147,3578727823,3578727828,5
0,940,17148,3578727823,3578727829,6
0,940,17149,3578727823,3578727830,7
0,940,17150,3578727823,3578727831,8
0,940,17151,3578727823,3578727831,8
0,940,17152,3578727823,3578727833,10
0,940,17153,3578727823,3578727834,11
0,940,17154,3578727823,3578727835,12
0,940,17155,3578727823,3578727836,13
0,940,17156,3578727823,3578727839,16
0,940,17157,3578727823,3578727840,17
0,940,17158,3578727823,3578727842,19
0,940,17159,3578727823,3578727843,20
0,940,17160,3578727823,3578727843,20
0,940,17161,3578727823,3578727848,25
0,940,17162,3578727823,3578727849,26
0,940,17163,3578727823,3578727851,28
0,940,17164,3578727823,3578727852,29
0,940,17165,3578727823,3578727854,31
0,940,17166,3578727823,3578727854,31
0,940,17167,3578727823,3578727854,31
0,940,17168,3578727823,3578727858,35
0,940,17169,3578727823,3578727858,35
0,940,17170,3578727823,3578727861,38
0,940,17171,3578727823,3578727861,38
0,940,17172,3578727823,3578727862,39
0,940,17173,3578727823,3578727863,40
0,940,17174,3578727823,3578727864,41
0,940,17175,3578727823,3578727865,42
0,940,17176,3578727823,3578727866,43
0,940,17177,3578727823,3578727867,44
0,940,17178,3578727823,3578727867,44
0,940,17179,3578727823,3578727867,44
0,940,17180,3578727823,3578727868,45
0,940,17181,3578727823,3578727870,47
0,940,17182,3578727823,3578727870,47
0,940,17183,3578727823,3578727872,49
0,941,17184,3578727881,3578727881,0
0,941,17185,3578727881,3578727881,0
0,941,17186,3578727881,3578727881,0
0,941,17187,3578727881,3578727881,0
0,941,17188,3578727881,3578727881,0
0,941,17189,3578727881,3578727881,0
0,941,17190,3578727881,3578727885,4
0,941,17191,3578727881,3578727886,5
0,941,17192,3578727881,3578727889,8
0,941,17193,3578727881,3578727889,8
0,941,17194,3578727881,3578727891,10
0,941,17195,3578727881,3578727891,10
0,941,17196,3578727881,3578727896,15
0,941,17197,3578727881,3578727897,16
0,941,17198,3578727881,3578727898,17
0,941,17199,3578727881,3578727898,17
0,941,17200,3578727881,3578727899,18
0,941,17201,3578727881,3578727900,19
0,941,17202,3578727881,3578727901,20
0,941,17203,3578727881,3578727902,21
0,941,17204,3578727881,3578727904,23
0,941,17205,3578727881,3578727904,23
0,941,17206,3578727881,3578727905,24
0,941,17207,3578727881,3578727905,24
0,941,17208,3578727881,3578727905,24
0,941,17209,3578727881,3578727906,25
0,941,17210,3578727881,3578727906,25
0,941,17211,3578727881,3578727906,25
0,941,17212,3578727881,3578727907,26
0,941,17213,3578727881,3578727907,26
0,941,17214,3578727881,3578727907,26
0,941,17215,3578727881,3578727908,27
0,941,17216,3578727881,3578727908,27
0,941,17217,3578727881,3578727908,27
0,941,17218,3578727881,3578727909,28
0,941,17219,3578727881,3578727909,28
0,941,17220,3578727881,3578727910,29
0,941,17221,3578727881,3578727912,31
0,941,17222,3578727881,3578727913,32
0,941,17223,3578727881,3578727915,34
0,941,17224,3578727881,3578727915,34
0,941,17225,3578727881,3578727916,35
0,941,17226,3578727881,3578727918,37
0,941,17227,3578727881,3578727918,37
0,941,17228,3578727881,3578727919,38
0,941,17229,3578727881,3578727920,39
0,941,17230,3578727881,3578727923,42
0,941,17231,3578727881,3578727923,42
0,941,17232,3578727881,3578727925,44
0,941,17233,3578727881,3578727926,45
0,941,17234,3578727881,3578727927,46
0,941,17235,3578727881,3578727928,47
0,941,17236,3578727881,3578727928,47
0,941,17237,3578727881,3578727930,49
0,941,17238,3578727881,3578727930,49
0,941,17239,3578727881,3578727931,50
0,942,17240,3578727939,3578727939,0
0,942,17241,3578727939,3578727939,0
0,942,17242,3578727939,3578727939,0
0,942,17243,3578727939,3578727939,0
0,942,17244,3578727939,3578727939,0
0,942,17245,3578727939,3578727939,0
0,942,17246,3578727939,3578727939,0
0,942,17247,3578727939,3578727940,1
0,942,17248,3578727939,3578727941,2
0,942,17249,3578727939,3578727942,3
0,942,17250,3578727939,3578727942,3
0,942,17251,3578727939,3578727943,4
0,942,17252,3578727939,3578727943,4
0,942,17253,3578727939,3578727944,5
0,942,17254,3578727939,3578727944,5
0,942,17255,3578727939,3578727946,7
0,942,17256,3578727939,3578727948,9
0,942,17257,3578727939,3578727951,12
0,942,17258,3578727939,3578727951,12
0,942,17259,3578727939,3578727954,15
0,942,17260,3578727939,3578727957,18
0,942,17261,3578727939,3578727959,20
0,942,17262,3578727939,3578727959,20
0,942,17263,3578727939,3578727961,22
0,942,17264,3578727939,3578727961,22
0,942,17265,3578727939,3578727962,23
0,942,17266,3578727939,3578727962,23
0,942,17267,3578727939,3578727962,23
0,942,17268,3578727939,3578727963,24
0,942,17269,3578727939,3578727965,26
0,942,17270,3578727939,3578727966,27
0,942,17271,3578727939,3578727967,28
0,942,17272,3578727939,3578727967,28
0,942,17273,3578727939,3578727968,29
0,942,17274,3578727939,3578727968,29
0,942,17275,3578727939,3578727971,32
0,942,17276,3578727939,3578727971,32
0,942,17277,3578727939,3578727971,32
0,942,17278,3578727939,3578727972,33
0,942,17279,3578727939,3578727973,34
0,942,17280,3578727939,3578727973,34
0,942,17281,3578727939,3578727974,35
0,942,17282,3578727939,3578727978,39
0,942,17283,3578727939,3578727978,39
0,942,17284,3578727939,3578727979,40
0,942,17285,3578727939,3578727980,41
0,942,17286,3578727939,3578727981,42
0,942,17287,3578727939,3578727981,42
0,942,17288,3578727939,3578727981,42
0,942,17289,3578727939,3578727981,42
0,942,17290,3578727939,3578727981,42
0,942,17291,3578727939,3578727985,46
0,942,17292,3578727939,3578727987,48
0,943,17293,3578727996,3578727996,0
0,943,17294,3578727996,3578727996,0
0,943,17295,3578727996,3578727996,0
0,943,17296,3578727996,3578727996,0
0,943,17297,3578727996,3578727996,0
0,943,17298,3578727996,3578727996,0
0,943,17299,3578727996,3578727996,0
0,943,17300,3578727996,3578727998,2
0,943,17301,3578727996,3578727998,2
0,943,17302,3578727996,3578728001,5
0,943,17303,3578727996,3578728004,8
0,943,17304,3578727996,3578728005,9
0,943,17305,3578727996,3578728005,9
0,943,17306,3578727996,3578728006,10
0,943,17307,3578727996,3578728008,12
0,943,17308,3578727996,3578728009,13
0,943,17309,3578727996,3578728010,14
0,943,17310,3578727996,3578728010,14
0,943,17311,3578727996,3578728012,16
0,943,17312,3578727996,3578728016,20
0,943,17313,3578727996,3578728018,22
0,943,17314,3578727996,3578728019,23
0,943,17315,3578727996,3578728019,23
0,943,17316,3578727996,3578728020,24
0,943,17317,3578727996,3578728020,24
0,943,17318,3578727996,3578728020,24
0,943,17319,3578727996,3578728022,26
0,943,17320,3578727996,3578728023,27
0,943,17321,3578727996,3578728026,30
0,943,17322,3578727996,3578728030,34
0,943,17323,3578727996,3578728030,34
0,943,17324,3578727996,3578728031,35
0,943,17325,3578727996,3578728031,35
0,943,17326,3578727996,3578728032,36
0,943,17327,3578727996,3578728034,38
0,943,17328,3578727996,3578728034,38
0,943,17329,3578727996,3578728035,39
0,943,17330,3578727996,3578728036,40
0,943,17331,3578727996,3578728039,43
0,943,17332,3578727996,3578728041,45
0,943,17333,3578727996,3578728042,46
0,943,17334,3578727996,3578728043,47
0,943,17335,3578727996,3578728044,48
0,944,17336,3578728056,3578728056,0
0,944,17337,3578728056,3578728056,0
0,944,17338,3578728056,3578728056,0
0,944,17339,3578728056,3578728056,0
0,944,17340,3578728056,3578728056,0
0,944,17341,3578728056,3578728056,0
0,944,17342,3578728056,3578728056,0
0,944,17343,3578728056,3578728056,0
0,944,17344,3578728056,3578728056,0
0,944,17345,3578728056,3578728057,1
0,944,17346,3578728056,3578728057,1
0,944,17347,3578728056,3578728061,5
0,944,17348,3578728056,3578728061,5
0,944,17349,3578728056,3578728062,6
0,944,17350,3578728056,3578728063,7
0,944,17351,3578728056,3578728064,8
0,944,17352,3578728056,3578728065,9
0,944,17353,3578728056,3578728066,10
0,944,17354,3578728056,3578728066,10
0,944,17355,3578728056,3578728067,11
0,944,17356,3578728056,3578728068,12
0,944,17357,3578728056,3578728070,14
0,944,17358,3578728056,3578728070,14
0,944,17359,3578728056,3578728073,17
0,944,17360,3578728056,3578728077,21
0,944,17361,3578728056,3578728079,23
0,944,17362,3578728056,3578728080,24
0,944,17363,3578728056,3578728080,24
0,944,17364,3578728056,3578728080,24
0,944,17365,3578728056,3578728081,25
0,944,17366,3578728056,3578728084,28
0,944,17367,3578728056,3578728085,29
0,944,17368,3578728056,3578728086,30
0,944,17369,3578728056,3578728087,31
0,944,17370,3578728056,3578728087,31
0,944,17371,3578728056,3578728089,33
0,944,17372,3578728056,3578728090,34
0,944,17373,3578728056,3578728091,35
0,944,17374,3578728056,3578728091,35
0,944,17375,3578728056,3578728096,40
0,944,17376,3578728056,3578728098,42
0,944,17377,3578728056,3578728098,42
0,944,17378,3578728056,3578728100,44
0,944,17379,3578728056,3578728100,44
0,944,17380,3578728056,3578728101,45
0,944,17381,3578728056,3578728102,46
0,944,17382,3578728056,3578728102,46
0,944,17383,3578728056,3578728104,48
0,944,17384,3578728056,3578728104,48
0,944,17385,3578728056,3578728105,49
0,944,17386,3578728056,3578728105,49
0,944,17387,3578728056,3578728106,50
0,945,17388,3578728114,3578728114,0
0,945,17389,3578728114,3578728114,0
0,945,17390,3578728114,3578728114,0
0,945,17391,3578728114,3578728114,0
0,945,17392,3578728114,3578728114,0
0,945,17393,3578728114,3578728114,0
0,945,17394,3578728114,3578728115,1
0,945,17395,3578728114,3578728115,1
0,945,17396,3578728114,3578728115,1
0,945,17397,3578728114,3578728115,1
0,945,17398,3578728114,3578728115,1
0,945,17399,3578728114,3578728115,1
0,945,17400,3578728114,3578728115,1
0,945,17401,3578728114,3578728116,2
0,945,17402,3578728114,3578728116,2
0,945,17403,3578728114,3578728116,2
0,945,17404,3578728114,3578728117,3
0,945,17405,3578728114,3578728119,5
0,945,17406,3578728114,3578728120,6
0,945,17407,3578728114,3578728123,9
0,945,17408,3578728114,3578728123,9
0,945,17409,3578728114,3578728126,12
0,945,17410,3578728114,3578728127,13
0,945,17411,3578728114,3578728127,13
0,945,17412,3578728114,3578728128,14
0,945,17413,3578728114,3578728131,17
0,945,17414,3578728114,3578728131,17
0,945,17415,3578728114,3578728131,17
0,945,17416,3578728114,3578728132,18
0,945,17417,3578728114,3578728132,18
0,945,17418,3578728114,3578728133,19
0,945,17419,3578728114,3578728134,20
0,945,17420,3578728114,3578728135,21
0,945,17421,3578728114,3578728135,21
0,945,17422,3578728114,3578728140,26
0,945,17423,3578728114,3578728140,26
0,945,17424,3578728114,3578728141,27
0,945,17425,3578728114,3578728143,29
0,945,17426,3578728114,3578728143,29
0,945,17427,3578728114,3578728143,29
0,945,17428,3578728114,3578728143,29
0,945,17429,3578728114,3578728144,30
0,945,17430,3578728114,3578728145,31
0,945,17431,3578728114,3578728146,32
0,945,17432,3578728114,3578728148,34
0,945,17433,3578728114,3578728151,37
0,945,17434,3578728114,3578728152,38
0,945,17435,3578728114,3578728153,39
0,945,17436,3578728114,3578728154,40
0,945,17437,3578728114,3578728157,43
0,945,17438,3578728114,3578728159,45
0,945,17439,3578728114,3578728160,46
0,945,17440,3578728114,3578728161,47
0,945,17441,3578728114,3578728162,48
0,945,17442,3578728114,3578728162,48
0,945,17443,3578728114,3578728163,49
0,945,17444,3578728114,3578728163,49
0,946,17445,3578728170,3578728170,0
0,946,17446,3578728170,3578728170,0
0,946,17447,3578728170,3578728170,0
0,946,17448,3578728170,3578728170,0
0,946,17449,3578728170,3578728170,0
0,946,17450,3578728170,3578728170,0
0,946,17451,3578728170,3578728171,1
0,946,17452,3578728170,3578728171,1
0,946,17453,3578728170,3578728172,2
0,946,17454,3578728170,3578728172,2
0,946,17455,3578728170,3578728172,2
0,946,17456,3578728170,3578728172,2
0,946,17457,3578728170,3578728174,4
0,946,17458,3578728170,3578728175,5
0,946,17459,3578728170,3578728176,6
0,946,17460,3578728170,3578728178,8
0,946,17461,3578728170,3578728179,9
0,946,17462,3578728170,3578728180,10
0,946,17463,3578728170,3578728181,11
0,946,17464,3578728170,3578728181,11
0,946,17465,3578728170,3578728182,12
0,946,17466,3578728170,3578728182,12
0,946,17467,3578728170,3578728182,12
0,946,17468,3578728170,3578728183,13
0,946,17469,3578728170,3578728185,15
0,946,17470,3578728170,3578728185,15
0,946,17471,3578728170,3578728186,16
0,946,17472,3578728170,3578728187,17
0,946,17473,3578728170,3578728191,21
0,946,17474,3578728170,3578728191,21
0,946,17475,3578728170,3578728191,21
0,946,17476,3578728170,3578728191,21
0,946,17477,3578728170,3578728192,22
0,946,17478,3578728170,3578728194,24
0,946,17479,3578728170,3578728195,25
0,946,17480,3578728170,3578728198,28
0,946,17481,3578728170,3578728199,29
0,946,17482,3578728170,3578728201,31
0,946,17483,3578728170,3578728204,34
0,946,17484,3578728170,3578728205,35
0,946,17485,3578728170,3578728205,35
0,946,17486,3578728170,3578728206,36
0,946,17487,3578728170,3578728209,39
0,946,17488,3578728170,3578728209,39
0,946,17489,3578728170,3578728209,39
0,946,17490,3578728170,3578728212,42
0,946,17491,3578728170,3578728215,45
0,946,17492,3578728170,3578728216,46
0,946,17493,3578728170,3578728217,47
0,946,17494,3578728170,3578728218,48
0,946,17495,3578728170,3578728218,48
0,946,17496,3578728170,3578728218,48
0,946,17497,3578728170,3578728219,49
0,947,17498,3578728227,3578728227,0
0,947,17499,3578728227,3578728227,0
0,947,17500,3578728227,3578728227,0
0,947,17501,3578728227,3578728227,0
0,947,17502,3578728227,3578728229,2
0,947,17503,3578728227,3578728231,4
0,947,17504,3578728227,3578728231,4
0,947,17505,3578728227,3578728231,4
0,947,17506,3578728227,3578728234,7
0,947,17507,3578728227,3578728234,7
0,947,17508,3578728227,3578728234,7
0,947,17509,3578728227,3578728235,8
0,947,17510,3578728227,3578728238,11
0,947,17511,3578728227,3578728240,13
0,947,17512,3578728227,3578728242,15
0,947,17513,3578728227,3578728242,15
0,947,17514,3578728227,3578728243,16
0,947,17515,3578728227,3578728243,16
0,947,17516,3578728227,3578728247,20
0,947,17517,3578728227,3578728250,23
0,947,17518,3578728227,3578728251,24
0,947,17519,3578728227,3578728253,26
0,947,17520,3578728227,3578728254,27
0,947,17521,3578728227,3578728255,28
0,947,17522,3578728227,3578728255,28
0,947,17523,3578728227,3578728257,30
0,947,17524,3578728227,3578728259,32
0,947,17525,3578728227,3578728261,34
0,947,17526,3578728227,3578728262,35
0,947,17527,3578728227,3578728262,35
0,947,17528,3578728227,3578728263,36
0,947,17529,3578728227,3578728264,37
0,947,17530,3578728227,3578728265,38
0,947,17531,3578728227,3578728267,40
0,947,17532,3578728227,3578728267,40
0,947,17533,3578728227,3578728267,40
0,947,17534,3578728227,3578728268,41
0,947,17535,3578728227,3578728268,41
0,947,17536,3578728227,3578728270,43
0,947,17537,3578728227,3578728270,43
0,947,17538,3578728227,3578728273,46
0,948,17539,3578728284,3578728284,0
0,948,17540,3578728284,3578728284,0
0,948,17541,3578728284,3578728284,0
0,948,17542,3578728284,3578728284,0
0,948,17543,3578728284,3578728284,0
0,948,17544,3578728284,3578728285,1
0,948,17545,3578728284,3578728285,1
0,948,17546,3578728284,3578728286,2
0,948,17547,3578728284,3578728286,2
0,948,17548,3578728284,3578728287,3
0,948,17549,3578728284,3578728289,5
0,948,17550,3578728284,3578728289,5
0,948,17551,3578728284,3578728290,6
0,948,17552,3578728284,3578728291,7
0,948,17553,3578728284,3578728291,7
0,948,17554,3578728284,3578728295,11
0,948,17555,3578728284,3578728296,12
0,948,17556,3578728284,3578728298,14
0,948,17557,3578728284,3578728299,15
0,948,17558,3578728284,3578728300,16
0,948,17559,3578728284,3578728300,16
0,948,17560,3578728284,3578728301,17
0,948,17561,3578728284,3578728302,18
0,948,17562,3578728284,3578728304,20
0,948,17563,3578728284,3578728304,20
0,948,17564,3578728284,3578728304,20
0,948,17565,3578728284,3578728305,21
0,948,17566,3578728284,3578728306,22
0,948,17567,3578728284,3578728306,22
0,948,17568,3578728284,3578728306,22
0,948,17569,3578728284,3578728306,22
0,948,17570,3578728284,3578728307,23
0,948,17571,3578728284,3578728307,23
0,948,17572,3578728284,3578728307,23
0,948,17573,3578728284,3578728307,23
0,948,17574,3578728284,3578728308,24
0,948,17575,3578728284,3578728308,24
0,948,17576,3578728284,3578728309,25
0,948,17577,3578728284,3578728309,25
0,948,17578,3578728284,3578728310,26
0,948,17579,3578728284,3578728311,27
0,948,17580,3578728284,3578728313,29
0,948,17581,3578728284,3578728314,30
0,948,17582,3578728284,3578728315,31
0,948,17583,3578728284,3578728316,32
0,948,17584,3578728284,3578728316,32
0,948,17585,3578728284,3578728318,34
0,948,17586,3578728284,3578728318,34
0,948,17587,3578728284,3578728320,36
0,948,17588,3578728284,3578728320,36
0,948,17589,3578728284,3578728323,39
0,948,17590,3578728284,3578728323,39
0,948,17591,3578728284,3578728326,42
0,948,17592,3578728284,3578728328,44
0,948,17593,3578728284,3578728328,44
0,948,17594,3578728284,3578728328,44
0,948,17595,3578728284,3578728331,47
0,948,17596,3578728284,3578728331,47
0,948,17597,3578728284,3578728332,48
0,948,17598,3578728284,3578728333,49
0,948,17599,3578728284,3578728333,49
0,948,17600,3578728284,3578728333,49
0,949,17601,3578728343,3578728343,0
0,949,17602,3578728343,3578728343,0
0,949,17603,3578728343,3578728343,0
0,949,17604,3578728343,3578728343,0
0,949,17605,3578728343,3578728343,0
0,949,17606,3578728343,3578728343,0
0,949,17607,3578728343,3578728343,0
0,949,17608,3578728343,3578728343,0
0,949,17609,3578728343,3578728343,0
0,949,17610,3578728343,3578728344,1
0,949,17611,3578728343,3578728344,1
0,949,17612,3578728343,3578728345,2
0,949,17613,3578728343,3578728348,5
0,949,17614,3578728343,3578728352,9
0,949,17615,3578728343,3578728352,9
0,949,17616,3578728343,3578728353,10
0,949,17617,3578728343,3578728355,12
0,949,17618,3578728343,3578728358,15
0,949,17619,3578728343,3578728358,15
0,949,17620,3578728343,3578728359,16
0,949,17621,3578728343,3578728361,18
0,949,17622,3578728343,3578728361,18
0,949,17623,3578728343,3578728362,19
0,949,17624,3578728343,3578728362,19
0,949,17625,3578728343,3578728362,19
0,949,17626,3578728343,3578728363,20
0,949,17627,3578728343,3578728366,23
0,949,17628,3578728343,3578728366,23
0,949,17629,3578728343,3578728368,25
0,949,17630,3578728343,3578728368,25
0,949,17631,3578728343,3578728369,26
0,949,17632,3578728343,3578728369,26
0,949,17633,3578728343,3578728371,28
0,949,17634,3578728343,3578728371,28
0,949,17635,3578728343,3578728372,29
0,949,17636,3578728343,3578728373,30
0,949,17637,3578728343,3578728373,30
0,949,17638,3578728343,3578728373,30
0,949,17639,3578728343,3578728376,33
0,949,17640,3578728343,3578728378,35
0,949,17641,3578728343,3578728379,36
0,949,17642,3578728343,3578728379,36
0,949,17643,3578728343,3578728381,38
0,949,17644,3578728343,3578728381,38
0,949,17645,3578728343,3578728382,39
0,949,17646,3578728343,3578728382,39
0,949,17647,3578728343,3578728382,39
0,949,17648,3578728343,3578728383,40
0,949,17649,3578728343,3578728384,41
0,949,17650,3578728343,3578728385,42
0,949,17651,3578728343,3578728386,43
0,949,17652,3578728343,3578728390,47
0,949,17653,3578728343,3578728390,47
0,949,17654,3578728343,3578728391,48
0,949,17655,3578728343,3578728392,49
0,949,17656,3578728343,3578728392,49
0,949,17657,3578728343,3578728392,49
0,950,17658,3578728401,3578728401,0
0,950,17659,3578728401,3578728401,0
0,950,17660,3578728401,3578728401,0
0,950,17661,3578728401,3578728401,0
0,950,17662,3578728401,3578728401,0
0,950,17663,3578728401,3578728401,0
0,950,17664,3578728401,3578728401,0
0,950,17665,3578728401,3578728404,3
0,950,17666,3578728401,3578728405,4
0,950,17667,3578728401,3578728406,5
0,950,17668,3578728401,3578728406,5
0,950,17669,3578728401,3578728409,8
0,950,17670,3578728401,3578728409,8
0,950,17671,3578728401,3578728409,8
0,950,17672,3578728401,3578728410,9
0,950,17673,3578728401,3578728411,10
0,950,17674,3578728401,3578728413,12
0,950,17675,3578728401,3578728416,15
0,950,17676,3578728401,3578728416,15
0,950,17677,3578728401,3578728416,15
0,950,17678,3578728401,3578728419,18
0,950,17679,3578728401,3578728419,18
0,950,17680,3578728401,3578728419,18
0,950,17681,3578728401,3578728420,19
0,950,17682,3578728401,3578728420,19
0,950,17683,3578728401,3578728422,21
0,950,17684,3578728401,3578728424,23
0,950,17685,3578728401,3578728428,27
0,950,17686,3578728401,3578728429,28
0,950,17687,3578728401,3578728430,29
0,950,17688,3578728401,3578728431,30
0,950,17689,3578728401,3578728431,30
0,950,17690,3578728401,3578728433,32
0,950,17691,3578728401,3578728434,33
0,950,17692,3578728401,3578728435,34
0,950,17693,3578728401,3578728436,35
0,950,17694,3578728401,3578728440,39
0,950,17695,3578728401,3578728441,40
0,950,17696,3578728401,3578728442,41
0,950,17697,3578728401,3578728443,42
0,950,17698,3578728401,3578728443,42
0,950,17699,3578728401,3578728444,43
0,950,17700,3578728401,3578728444,43
0,950,17701,3578728401,3578728447,46
0,950,17702,3578728401,3578728449,48
0,950,17703,3578728401,3578728449,48
0,950,17704,3578728401,3578728451,50
0,951,17705,3578728461,3578728461,0
0,951,17706,3578728461,3578728461,0
0,951,17707,3578728461,3578728461,0
0,951,17708,3578728461,3578728461,0
0,951,17709,3578728461,3578728461,0
0,951,17710,3578728461,3578728461,0
0,951,17711,3578728461,3578728461,0
0,951,17712,3578728461,3578728462,1
0,951,17713,3578728461,3578728462,1
0,951,17714,3578728461,3578728463,2
0,951,17715,3578728461,3578728465,4
0,951,17716,3578728461,3578728465,4
0,951,17717,3578728461,3578728467,6
0,951,17718,3578728461,3578728467,6
0,951,17719,3578728461,3578728467,6
0,951,17720,3578728461,3578728467,6
0,951,17721,3578728461,3578728468,7
0,951,17722,3578728461,3578728470,9
0,951,17723,3578728461,3578728471,10
0,951,17724,3578728461,3578728473,12
0,951,17725,3578728461,3578728478,17
0,951,17726,3578728461,3578728480,19
0,951,17727,3578728461,3578728480,19
0,951,17728,3578728461,3578728481,20
0,951,17729,3578728461,3578728481,20
0,951,17730,3578728461,3578728481,20
0,951,17731,3578728461,3578728484,23
0,951,17732,3578728461,3578728485,24
0,951,17733,3578728461,3578728486,25
0,951,17734,3578728461,3578728487,26
0,951,17735,3578728461,3578728487,26
0,951,17736,3578728461,3578728489,28
0,951,17737,3578728461,3578728490,29
0,951,17738,3578728461,3578728490,29
0,951,17739,3578728461,3578728491,30
0,951,17740,3578728461,3578728491,30
0,951,17741,3578728461,3578728492,31
0,951,17742,3578728461,3578728495,34
0,951,17743,3578728461,3578728497,36
0,951,17744,3578728461,3578728498,37
0,951,17745,3578728461,3578728499,38
0,951,17746,3578728461,3578728499,38
0,951,17747,3578728461,3578728500,39
0,951,17748,3578728461,3578728500,39
0,951,17749,3578728461,3578728503,42
0,951,17750,3578728461,3578728503,42
0,951,17751,3578728461,3578728503,42
0,951,17752,3578728461,3578728503,42
0,951,17753,3578728461,3578728504,43
0,951,17754,3578728461,3578728506,45
0,951,17755,3578728461,3578728506,45
0,951,17756,3578728461,3578728506,45
0,951,17757,3578728461,3578728506,45
0,951,17758,3578728461,3578728506,45
0,951,17759,3578728461,3578728506,45
0,951,17760,3578728461,3578728506,45
0,951,17761,3578728461,3578728507,46
0,951,17762,3578728461,3578728507,46
0,951,17763,3578728461,3578728508,47
0,951,17764,3578728461,3578728508,47
0,951,17765,3578728461,3578728509,48
0,951,17766,3578728461,3578728509,48
0,952,17767,3578728516,3578728516,0
0,952,17768,3578728516,3578728516,0
0,952,17769,3578728516,3578728516,0
0,952,17770,3578728516,3578728516,0
0,952,17771,3578728516,3578728516,0
0,952,17772,3578728516,3578728516,0
0,952,17773,3578728516,3578728517,1
0,952,17774,3578728516,3578728518,2
0,952,17775,3578728516,3578728519,3
0,952,17776,3578728516,3578728522,6
0,952,17777,3578728516,3578728523,7
0,952,17778,3578728516,3578728526,10
0,952,17779,3578728516,3578728526,10
0,952,17780,3578728516,3578728526,10
0,952,17781,3578728516,3578728527,11
0,952,17782,3578728516,3578728530,14
0,952,17783,3578728516,3578728531,15
0,952,17784,3578728516,3578728531,15
0,952,17785,3578728516,3578728532,16
0,952,17786,3578728516,3578728533,17
0,952,17787,3578728516,3578728535,19
0,952,17788,3578728516,3578728535,19
0,952,17789,3578728516,3578728539,23
0,952,17790,3578728516,3578728541,25
0,952,17791,3578728516,3578728542,26
0,952,17792,3578728516,3578728542,26
0,952,17793,3578728516,3578728543,27
0,952,17794,3578728516,3578728544,28
0,952,17795,3578728516,3578728545,29
0,952,17796,3578728516,3578728545,29
0,952,17797,3578728516,3578728545,29
0,952,17798,3578728516,3578728547,31
0,952,17799,3578728516,3578728551,35
0,952,17800,3578728516,3578728552,36
0,952,17801,3578728516,3578728552,36
0,952,17802,3578728516,3578728553,37
0,952,17803,3578728516,3578728555,39
0,952,17804,3578728516,3578728557,41
0,952,17805,3578728516,3578728558,42
0,952,17806,3578728516,3578728559,43
0,952,17807,3578728516,3578728559,43
0,952,17808,3578728516,3578728560,44
0,952,17809,3578728516,3578728561,45
0,952,17810,3578728516,3578728561,45
0,952,17811,3578728516,3578728562,46
0,952,17812,3578728516,3578728562,46
0,952,17813,3578728516,3578728565,49
0,952,17814,3578728516,3578728565,49
0,952,17815,3578728516,3578728566,50
0,953,17816,3578728573,3578728573,0
0,953,17817,3578728573,3578728573,0
0,953,17818,3578728573,3578728573,0
0,953,17819,3578728573,3578728573,0
0,953,17820,3578728573,3578728573,0
0,953,17821,3578728573,3578728573,0
0,953,17822,3578728573,3578728573,0
0,953,17823,3578728573,3578728573,0
0,953,17824,3578728573,3578728573,0
0,953,17825,3578728573,3578728573,0
0,953,17826,3578728573,3578728574,1
0,953,17827,3578728573,3578728574,1
0,953,17828,3578728573,3578728577,4
0,953,17829,3578728573,3578728578,5
0,953,17830,3578728573,3578728578,5
0,953,17831,3578728573,3578728580,7
0,953,17832,3578728573,3578728580,7
0,953,17833,3578728573,3578728581,8
0,953,17834,3578728573,3578728581,8
0,953,17835,3578728573,3578728581,8
0,953,17836,3578728573,3578728583,10
0,953,17837,3578728573,3578728585,12
0,953,17838,3578728573,3578728585,12
0,953,17839,3578728573,3578728585,12
0,953,17840,3578728573,3578728589,16
0,953,17841,3578728573,3578728590,17
0,953,17842,3578728573,3578728590,17
0,953,17843,3578728573,3578728591,18
0,953,17844,3578728573,3578728592,19
0,953,17845,3578728573,3578728592,19
0,953,17846,3578728573,3578728594,21
0,953,17847,3578728573,3578728595,22
0,953,17848,3578728573,3578728597,24
0,953,17849,3578728573,3578728598,25
0,953,17850,3578728573,3578728600,27
0,953,17851,3578728573,3578728604,31
0,953,17852,3578728573,3578728604,31
0,953,17853,3578728573,3578728605,32
0,953,17854,3578728573,3578728608,35
0,953,17855,3578728573,3578728609,36
0,953,17856,3578728573,3578728609,36
0,953,17857,3578728573,3578728610,37
0,953,17858,3578728573,3578728612,39
0,953,17859,3578728573,3578728615,42
0,953,17860,3578728573,3578728615,42
0,953,17861,3578728573,3578728618,45
0,953,17862,3578728573,3578728619,46
0,953,17863,3578728573,3578728619,46
0,953,17864,3578728573,3578728620,47
0,953,17865,3578728573,3578728621,48
0,954,17866,3578728631,3578728631,0
0,954,17867,3578728631,3578728631,0
0,954,17868,3578728631,3578728631,0
0,954,17869,3578728631,3578728631,0
0,954,17870,3578728631,3578728631,0
0,954,17871,3578728631,3578728631,0
0,954,17872,3578728631,3578728633,2
0,954,17873,3578728631,3578728634,3
0,954,17874,3578728631,3578728635,4
0,954,17875,3578728631,3578728639,8
0,954,17876,3578728631,3578728641,10
0,954,17877,3578728631,3578728642,11
0,954,17878,3578728631,3578728642,11
0,954,17879,3578728631,3578728643,12
0,954,17880,3578728631,3578728643,12
0,954,17881,3578728631,3578728646,15
0,954,17882,3578728631,3578728646,15
0,954,17883,3578728631,3578728648,17
0,954,17884,3578728631,3578728649,18
0,954,17885,3578728631,3578728650,19
0,954,17886,3578728631,3578728652,21
0,954,17887,3578728631,3578728654,23
0,954,17888,3578728631,3578728656,25
0,954,17889,3578728631,3578728656,25
0,954,17890,3578728631,3578728656,25
0,954,17891,3578728631,3578728657,26
0,954,17892,3578728631,3578728658,27
0,954,17893,3578728631,3578728660,29
0,954,17894,3578728631,3578728660,29
0,954,17895,3578728631,3578728662,31
0,954,17896,3578728631,3578728662,31
0,954,17897,3578728631,3578728664,33
0,954,17898,3578728631,3578728665,34
0,954,17899,3578728631,3578728665,34
0,954,17900,3578728631,3578728666,35
0,954,17901,3578728631,3578728667,36
0,954,17902,3578728631,3578728667,36
0,954,17903,3578728631,3578728667,36
0,954,17904,3578728631,3578728669,38
0,954,17905,3578728631,3578728670,39
0,954,17906,3578728631,3578728673,42
0,954,17907,3578728631,3578728678,47
0,954,17908,3578728631,3578728679,48
0,954,17909,3578728631,3578728680,49
0,955,17910,3578728688,3578728688,0
0,955,17911,3578728688,3578728688,0
0,955,17912,3578728688,3578728688,0
0,955,17913,3578728688,3578728688,0
0,955,17914,3578728688,3578728688,0
0,955,17915,3578728688,3578728688,0
0,955,17916,3578728688,3578728688,0
0,955,17917,3578728688,3578728689,1
0,955,17918,3578728688,3578728690,2
0,955,17919,3578728688,3578728691,3
0,955,17920,3578728688,3578728691,3
0,955,17921,3578728688,3578728692,4
0,955,17922,3578728688,3578728696,8
0,955,17923,3578728688,3578728696,8
0,955,17924,3578728688,3578728696,8
0,955,17925,3578728688,3578728699,11
0,955,17926,3578728688,3578728700,12
0,955,17927,3578728688,3578728700,12
0,955,17928,3578728688,3578728701,13
0,955,17929,3578728688,3578728704,16
0,955,17930,3578728688,3578728704,16
0,955,17931,3578728688,3578728704,16
0,955,17932,3578728688,3578728705,17
0,955,17933,3578728688,3578728706,18
0,955,17934,3578728688,3578728706,18
0,955,17935,3578728688,3578728706,18
0,955,17936,3578728688,3578728706,18
0,955,17937,3578728688,3578728707,19
0,955,17938,3578728688,3578728707,19
0,955,17939,3578728688,3578728707,19
0,955,17940,3578728688,3578728707,19
0,955,17941,3578728688,3578728708,20
0,955,17942,3578728688,3578728709,21
0,955,17943,3578728688,3578728709,21
0,955,17944,3578728688,3578728709,21
0,955,17945,3578728688,3578728710,22
0,955,17946,3578728688,3578728712,24
0,955,17947,3578728688,3578728714,26
0,955,17948,3578728688,3578728715,27
0,955,17949,3578728688,3578728715,27
0,955,17950,3578728688,3578728715,27
0,955,17951,3578728688,3578728715,27
0,955,17952,3578728688,3578728717,29
0,955,17953,3578728688,3578728717,29
0,955,17954,3578728688,3578728718,30
0,955,17955,3578728688,3578728719,31
0,955,17956,3578728688,3578728720,32
0,955,17957,3578728688,3578728722,34
0,955,17958,3578728688,3578728725,37
0,955,17959,3578728688,3578728726,38
0,955,17960,3578728688,3578728727,39
0,955,17961,3578728688,3578728727,39
0,955,17962,3578728688,3578728728,40
0,955,17963,3578728688,3578728730,42
0,955,17964,3578728688,3578728730,42
0,955,17965,3578728688,3578728731,43
0,955,17966,3578728688,3578728732,44
0,955,17967,3578728688,3578728732,44
0,955,17968,3578728688,3578728735,47
0,955,17969,3578728688,3578728736,48
0,956,17970,3578728745,3578728745,0
0,956,17971,3578728745,3578728745,0
0,956,17972,3578728745,3578728745,0
0,956,17973,3578728745,3578728745,0
0,956,17974,3578728745,3578728745,0
0,956,17975,3578728745,3578728745,0
0,956,17976,3578728745,3578728745,0
0,956,17977,3578728745,3578728745,0
0,956,17978,3578728745,3578728745,0
0,956,17979,3578728745,3578728747,2
0,956,17980,3578728745,3578728747,2
0,956,17981,3578728745,3578728752,7
0,956,17982,3578728745,3578728752,7
0,956,17983,3578728745,3578728753,8
0,956,17984,3578728745,3578728755,10
0,956,17985,3578728745,3578728758,13
0,956,17986,3578728745,3578728759,14
0,956,17987,3578728745,3578728759,14
0,956,17988,3578728745,3578728759,14
0,956,17989,3578728745,3578728760,15
0,956,17990,3578728745,3578728760,15
0,956,17991,3578728745,3578728761,16
0,956,17992,3578728745,3578728762,17
0,956,17993,3578728745,3578728762,17
0,956,17994,3578728745,3578728763,18
0,956,17995,3578728745,3578728766,21
0,956,17996,3578728745,3578728767,22
0,956,17997,3578728745,3578728767,22
0,956,17998,3578728745,3578728767,22
0,956,17999,3578728745,3578728767,22
0,956,18000,3578728745,3578728768,23
0,956,18001,3578728745,3578728770,25
0,956,18002,3578728745,3578728771,26
0,956,18003,3578728745,3578728771,26
0,956,18004,3578728745,3578728772,27
0,956,18005,3578728745,3578728773,28
0,956,18006,3578728745,3578728773,28
0,956,18007,3578728745,3578728773,28
0,956,18008,3578728745,3578728774,29
0,956,18009,3578728745,3578728778,33
0,956,18010,3578728745,3578728778,33
0,956,18011,3578728745,3578728778,33
0,956,18012,3578728745,3578728781,36
0,956,18013,3578728745,3578728781,36
0,956,18014,3578728745,3578728781,36
0,956,18015,3578728745,3578728782,37
0,956,18016,3578728745,3578728782,37
0,956,18017,3578728745,3578728783,38
0,956,18018,3578728745,3578728785,40
0,956,18019,3578728745,3578728786,41
0,956,18020,3578728745,3578728790,45
0,956,18021,3578728745,3578728790,45
0,956,18022,3578728745,3578728790,45
0,956,18023,3578728745,3578728791,46
0,956,18024,3578728745,3578728792,47
0,956,18025,3578728745,3578728794,49
0,956,18026,3578728745,3578728794,49
0,956,18027,3578728745,3578728795,50
0,957,18028,3578728802,3578728802,0
0,957,18029,3578728802,3578728802,0
0,957,18030,3578728802,3578728802,0
0,957,18031,3578728802,3578728803,1
0,957,18032,3578728802,3578728803,1
0,957,18033,3578728802,3578728803,1
0,957,18034,3578728802,3578728804,2
0,957,18035,3578728802,3578728805,3
0,957,18036,3578728802,3578728805,3
0,957,18037,3578728802,3578728807,5
0,957,18038,3578728802,3578728809,7
0,957,18039,3578728802,3578728809,7
0,957,18040,3578728802,3578728809,7
0,957,18041,3578728802,3578728809,7
0,957,18042,3578728802,3578728810,8
0,957,18043,3578728802,3578728814,12
0,957,18044,3578728802,3578728814,12
0,957,18045,3578728802,3578728815,13
0,957,18046,3578728802,3578728815,13
0,957,18047,3578728802,3578728817,15
0,957,18048,3578728802,3578728818,16
0,957,18049,3578728802,3578728818,16
0,957,18050,3578728802,3578728820,18
0,957,18051,3578728802,3578728820,18
0,957,18052,3578728802,3578728820,18
0,957,18053,3578728802,3578728825,23
0,957,18054,3578728802,3578728827,25
0,957,18055,3578728802,3578728829,27
0,957,18056,3578728802,3578728830,28
0,957,18057,3578728802,3578728830,28
0,957,18058,3578728802,3578728831,29
0,957,18059,3578728802,3578728834,32
0,957,18060,3578728802,3578728835,33
0,957,18061,3578728802,3578728836,34
0,957,18062,3578728802,3578728839,37
0,957,18063,3578728802,3578728842,40
0,957,18064,3578728802,3578728842,40
0,957,18065,3578728802,3578728843,41
0,957,18066,3578728802,3578728843,41
0,957,18067,3578728802,3578728843,41
0,957,18068,3578728802,3578728846,44
0,957,18069,3578728802,3578728847,45
0,957,18070,3578728802,3578728848,46
0,957,18071,3578728802,3578728848,46
0,957,18072,3578728802,3578728849,47
0,957,18073,3578728802,3578728850,48
0,958,18074,3578728862,3578728862,0
0,958,18075,3578728862,3578728862,0
0,958,18076,3578728862,3578728862,0
0,958,18077,3578728862,3578728863,1
0,958,18078,3578728862,3578728863,1
0,958,18079,3578728862,3578728863,1
0,958,18080,3578728862,3578728863,1
0,958,18081,3578728862,3578728863,1
0,958,18082,3578728862,3578728863,1
0,958,18083,3578728862,3578728864,2
0,958,18084,3578728862,3578728864,2
0,958,18085,3578728862,3578728865,3
0,958,18086,3578728862,3578728867,5
0,958,18087,3578728862,3578728867,5
0,958,18088,3578728862,3578728867,5
0,958,18089,3578728862,3578728867,5
0,958,18090,3578728862,3578728869,7
0,958,18091,3578728862,3578728870,8
0,958,18092,3578728862,3578728873,11
0,958,18093,3578728862,3578728878,16
0,958,18094,3578728862,3578728879,17
0,958,18095,3578728862,3578728880,18
0,958,18096,3578728862,3578728881,19
0,958,18097,3578728862,3578728881,19
0,958,18098,3578728862,3578728881,19
0,958,18099,3578728862,3578728884,22
0,958,18100,3578728862,3578728885,23
0,958,18101,3578728862,3578728886,24
0,958,18102,3578728862,3578728888,26
0,958,18103,3578728862,3578728889,27
0,958,18104,3578728862,3578728890,28
0,958,18105,3578728862,3578728891,29
0,958,18106,3578728862,3578728891,29
0,958,18107,3578728862,3578728892,30
0,958,18108,3578728862,3578728895,33
0,958,18109,3578728862,3578728897,35
0,958,18110,3578728862,3578728899,37
0,958,18111,3578728862,3578728899,37
0,958,18112,3578728862,3578728899,37
0,958,18113,3578728862,3578728900,38
0,958,18114,3578728862,3578728900,38
0,958,18115,3578728862,3578728901,39
0,958,18116,3578728862,3578728903,41
0,958,18117,3578728862,3578728904,42
0,958,18118,3578728862,3578728904,42
0,958,18119,3578728862,3578728905,43
0,958,18120,3578728862,3578728905,43
0,958,18121,3578728862,3578728906,44
0,958,18122,3578728862,3578728907,45
0,958,18123,3578728862,3578728907,45
0,958,18124,3578728862,3578728907,45
0,958,18125,3578728862,3578728907,45
0,958,18126,3578728862,3578728907,45
0,958,18127,3578728862,3578728907,45
0,958,18128,3578728862,3578728907,45
0,958,18129,3578728862,3578728908,46
0,958,18130,3578728862,3578728908,46
0,958,18131,3578728862,3578728908,46
0,958,18132,3578728862,3578728909,47
0,958,18133,3578728862,3578728910,48
0,958,18134,3578728862,3578728912,50
0,959,18135,3578728919,3578728919,0
0,959,18136,3578728919,3578728919,0
0,959,18137,3578728919,3578728919,0
0,959,18138,3578728919,3578728919,0
0,959,18139,3578728919,3578728919,0
0,959,18140,3578728919,3578728919,0
0,959,18141,3578728919,3578728919,0
0,959,18142,3578728919,3578728920,1
0,959,18143,3578728919,3578728920,1
0,959,18144,3578728919,3578728922,3
0,959,18145,3578728919,3578728922,3
0,959,18146,3578728919,3578728926,7
0,959,18147,3578728919,3578728926,7
0,959,18148,3578728919,3578728927,8
0,959,18149,3578728919,3578728927,8
0,959,18150,3578728919,3578728929,10
0,959,18151,3578728919,3578728930,11
0,959,18152,3578728919,3578728931,12
0,959,18153,3578728919,3578728931,12
0,959,18154,3578728919,3578728932,13
0,959,18155,3578728919,3578728933,14
0,959,18156,3578728919,3578728933,14
0,959,18157,3578728919,3578728934,15
0,959,18158,3578728919,3578728935,16
0,959,18159,3578728919,3578728940,21
0,959,18160,3578728919,3578728940,21
0,959,18161,3578728919,3578728941,22
0,959,18162,3578728919,3578728943,24
0,959,18163,3578728919,3578728943,24
0,959,18164,3578728919,3578728944,25
0,959,18165,3578728919,3578728944,25
0,959,18166,3578728919,3578728944,25
0,959,18167,3578728919,3578728945,26
0,959,18168,3578728919,3578728948,29
0,959,18169,3578728919,3578728948,29
0,959,18170,3578728919,3578728951,32
0,959,18171,3578728919,3578728952,33
0,959,18172,3578728919,3578728952,33
0,959,18173,3578728919,3578728952,33
0,959,18174,3578728919,3578728953,34
0,959,18175,3578728919,3578728955,36
0,959,18176,3578728919,3578728958,39
0,959,18177,3578728919,3578728959,40
0,959,18178,3578728919,3578728959,40
0,959,18179,3578728919,3578728960,41
0,959,18180,3578728919,3578728961,42
0,959,18181,3578728919,3578728962,43
0,959,18182,3578728919,3578728962,43
0,959,18183,3578728919,3578728962,43
0,959,18184,3578728919,3578728963,44
0,959,18185,3578728919,3578728967,48
0,959,18186,3578728919,3578728967,48
0,959,18187,3578728919,3578728967,48
0,959,18188,3578728919,3578728967,48
0,959,18189,3578728919,3578728968,49
0,959,18190,3578728919,3578728968,49
0,960,18191,3578728976,3578728976,0
0,960,18192,3578728976,3578728976,0
0,960,18193,3578728976,3578728976,0
0,960,18194,3578728976,3578728976,0
0,960,18195,3578728976,3578728976,0
0,960,18196,3578728976,3578728976,0
0,960,18197,3578728976,3578728976,0
0,960,18198,3578728976,3578728978,2
0,960,18199,3578728976,3578728978,2
0,960,18200,3578728976,3578728979,3
0,960,18201,3578728976,3578728981,5
0,960,18202,3578728976,3578728981,5
0,960,18203,3578728976,3578728981,5
0,960,18204,3578728976,3578728981,5
0,960,18205,3578728976,3578728984,8
0,960,18206,3578728976,3578728985,9
0,960,18207,3578728976,3578728987,11
0,960,18208,3578728976,3578728990,14
0,960,18209,3578728976,3578728991,15
0,960,18210,3578728976,3578728992,16
0,960,18211,3578728976,3578728993,17
0,960,18212,3578728976,3578728994,18
0,960,18213,3578728976,3578728995,19
0,960,18214,3578728976,3578728999,23
0,960,18215,3578728976,3578728999,23
0,960,18216,3578728976,3578729001,25
0,960,18217,3578728976,3578729004,28
0,960,18218,3578728976,3578729005,29
0,960,18219,3578728976,3578729005,29
0,960,18220,3578728976,3578729007,31
0,960,18221,3578728976,3578729009,33
0,960,18222,3578728976,3578729010,34
0,960,18223,3578728976,3578729010,34
0,960,18224,3578728976,3578729010,34
0,960,18225,3578728976,3578729013,37
0,960,18226,3578728976,3578729015,39
0,960,18227,3578728976,3578729016,40
0,960,18228,3578728976,3578729016,40
0,960,18229,3578728976,3578729018,42
0,960,18230,3578728976,3578729018,42
0,960,18231,3578728976,3578729019,43
0,960,18232,3578728976,3578729019,43
0,960,18233,3578728976,3578729019,43
0,960,18234,3578728976,3578729020,44
0,960,18235,3578728976,3578729024,48
0,960,18236,3578728976,3578729025,49
0,961,18237,3578729035,3578729035,0
0,961,18238,3578729035,3578729035,0
0,961,18239,3578729035,3578729035,0
0,961,18240,3578729035,3578729035,0
0,961,18241,3578729035,3578729035,0
0,961,18242,3578729035,3578729035,0
0,961,18243,3578729035,3578729035,0
0,961,18244,3578729035,3578729039,4
0,961,18245,3578729035,3578729042,7
0,961,18246,3578729035,3578729043,8
0,961,18247,3578729035,3578729043,8
0,961,18248,3578729035,3578729043,8
0,961,18249,3578729035,3578729043,8
0,961,18250,3578729035,3578729047,12
0,961,18251,3578729035,3578729047,12
0,961,18252,3578729035,3578729048,13
0,961,18253,3578729035,3578729050,15
0,961,18254,3578729035,3578729050,15
0,961,18255,3578729035,3578729052,17
0,961,18256,3578729035,3578729054,19
0,961,18257,3578729035,3578729056,21
0,961,18258,3578729035,3578729056,21
0,961,18259,3578729035,3578729057,22
0,961,18260,3578729035,3578729058,23
0,961,18261,3578729035,3578729058,23
0,961,18262,3578729035,3578729061,26
0,961,18263,3578729035,3578729062,27
0,961,18264,3578729035,3578729063,28
0,961,18265,3578729035,3578729063,28
0,961,18266,3578729035,3578729064,29
0,961,18267,3578729035,3578729065,30
0,961,18268,3578729035,3578729065,30
0,961,18269,3578729035,3578729067,32
0,961,18270,3578729035,3578729067,32
0,961,18271,3578729035,3578729067,32
0,961,18272,3578729035,3578729068,33
0,961,18273,3578729035,3578729069,34
0,961,18274,3578729035,3578729070,35
0,961,18275,3578729035,3578729079,44
0,961,18276,3578729035,3578729079,44
0,961,18277,3578729035,3578729080,45
0,961,18278,3578729035,3578729081,46
0,961,18279,3578729035,3578729081,46
0,961,18280,3578729035,3578729085,50
0,962,18281,3578729092,3578729092,0
0,962,18282,3578729092,3578729092,0
0,962,18283,3578729092,3578729092,0
0,962,18284,3578729092,3578729092,0
0,962,18285,3578729092,3578729092,0
0,962,18286,3578729092,3578729092,0
0,962,18287,3578729092,3578729092,0
0,962,18288,3578729092,3578729092,0
0,962,18289,3578729092,3578729092,0
0,962,18290,3578729092,3578729096,4
0,962,18291,3578729092,3578729097,5
0,962,18292,3578729092,3578729099,7
0,962,18293,3578729092,3578729100,8
0,962,18294,3578729092,3578729100,8
0,962,18295,3578729092,3578729101,9
0,962,18296,3578729092,3578729103,11
0,962,18297,3578729092,3578729104,12
0,962,18298,3578729092,3578729105,13
0,962,18299,3578729092,3578729105,13
0,962,18300,3578729092,3578729106,14
0,962,18301,3578729092,3578729106,14
0,962,18302,3578729092,3578729107,15
0,962,18303,3578729092,3578729107,15
0,962,18304,3578729092,3578729107,15
0,962,18305,3578729092,3578729107,15
0,962,18306,3578729092,3578729107,15
0,962,18307,3578729092,3578729108,16
0,962,18308,3578729092,3578729108,16
0,962,18309,3578729092,3578729108,16
0,962,18310,3578729092,3578729108,16
0,962,18311,3578729092,3578729109,17
0,962,18312,3578729092,3578729110,18
0,962,18313,3578729092,3578729112,20
0,962,18314,3578729092,3578729115,23
0,962,18315,3578729092,3578729116,24
0,962,18316,3578729092,3578729116,24
0,962,18317,3578729092,3578729116,24
0,962,18318,3578729092,3578729117,25
0,962,18319,3578729092,3578729117,25
0,962,18320,3578729092,3578729118,26
0,962,18321,3578729092,3578729119,27
0,962,18322,3578729092,3578729119,27
0,962,18323,3578729092,3578729119,27
0,962,18324,3578729092,3578729120,28
0,962,18325,3578729092,3578729122,30
0,962,18326,3578729092,3578729122,30
0,962,18327,3578729092,3578729126,34
0,962,18328,3578729092,3578729126,34
0,962,18329,3578729092,3578729127,35
0,962,18330,3578729092,3578729128,36
0,962,18331,3578729092,3578729130,38
0,962,18332,3578729092,3578729130,38
0,962,18333,3578729092,3578729131,39
0,962,18334,3578729092,3578729131,39
0,962,18335,3578729092,3578729132,40
0,962,18336,3578729092,3578729134,42
0,962,18337,3578729092,3578729134,42
0,962,18338,3578729092,3578729135,43
0,962,18339,3578729092,3578729136,44
0,962,18340,3578729092,3578729139,47
0,962,18341,3578729092,3578729139,47
0,962,18342,3578729092,3578729141,49
0,963,18343,3578729150,3578729150,0
0,963,18344,3578729150,3578729150,0
0,963,18345,3578729150,3578729150,0
0,963,18346,3578729150,3578729150,0
0,963,18347,3578729150,3578729150,0
0,963,18348,3578729150,3578729150,0
0,963,18349,3578729150,3578729150,0
0,963,18350,3578729150,3578729150,0
0,963,18351,3578729150,3578729151,1
0,963,18352,3578729150,3578729153,3
0,963,18353,3578729150,3578729153,3
0,963,18354,3578729150,3578729154,4
0,963,18355,3578729150,3578729158,8
0,963,18356,3578729150,3578729159,9
0,963,18357,3578729150,3578729159,9
0,963,18358,3578729150,3578729160,10
0,963,18359,3578729150,3578729161,11
0,963,18360,3578729150,3578729161,11
0,963,18361,3578729150,3578729162,12
0,963,18362,3578729150,3578729162,12
0,963,18363,3578729150,3578729163,13
0,963,18364,3578729150,3578729164,14
0,963,18365,3578729150,3578729167,17
0,963,18366,3578729150,3578729167,17
0,963,18367,3578729150,3578729168,18
0,963,18368,3578729150,3578729168,18
0,963,18369,3578729150,3578729168,18
0,963,18370,3578729150,3578729168,18
0,963,18371,3578729150,3578729171,21
0,963,18372,3578729150,3578729172,22
0,963,18373,3578729150,3578729173,23
0,963,18374,3578729150,3578729173,23
0,963,18375,3578729150,3578729174,24
0,963,18376,3578729150,3578729174,24
0,963,18377,3578729150,3578729174,24
0,963,18378,3578729150,3578729175,25
0,963,18379,3578729150,3578729179,29
0,963,18380,3578729150,3578729179,29
0,963,18381,3578729150,3578729179,29
0,963,18382,3578729150,3578729181,31
0,963,18383,3578729150,3578729182,32
0,963,18384,3578729150,3578729182,32
0,963,18385,3578729150,3578729182,32
0,963,18386,3578729150,3578729183,33
0,963,18387,3578729150,3578729185,35
0,963,18388,3578729150,3578729186,36
0,963,18389,3578729150,3578729186,36
0,963,18390,3578729150,3578729189,39
0,963,18391,3578729150,3578729190,40
0,963,18392,3578729150,3578729191,41
0,963,18393,3578729150,3578729192,42
0,963,18394,3578729150,3578729193,43
0,963,18395,3578729150,3578729194,44
0,963,18396,3578729150,3578729194,44
0,963,18397,3578729150,3578729195,45
0,963,18398,3578729150,3578729196,46
0,963,18399,3578729150,3578729198,48
0,963,18400,3578729150,3578729198,48
0,963,18401,3578729150,3578729199,49
0,964,18402,3578729208,3578729208,0
0,964,18403,3578729208,3578729208,0
0,964,18404,3578729208,3578729208,0
0,964,18405,3578729208,3578729208,0
0,964,18406,3578729208,3578729208,0
0,964,18407,3578729208,3578729209,1
0,964,18408,3578729208,3578729210,2
0,964,18409,3578729208,3578729211,3
0,964,18410,3578729208,3578729211,3
0,964,18411,3578729208,3578729213,5
0,964,18412,3578729208,3578729214,6
0,964,18413,3578729208,3578729215,7
0,964,18414,3578729208,3578729216,8
0,964,18415,3578729208,3578729216,8
0,964,18416,3578729208,3578729218,10
0,964,18417,3578729208,3578729219,11
0,964,18418,3578729208,3578729219,11
0,964,18419,3578729208,3578729219,11
0,964,18420,3578729208,3578729220,12
0,964,18421,3578729208,3578729221,13
0,964,18422,3578729208,3578729224,16
0,964,18423,3578729208,3578729226,18
0,964,18424,3578729208,3578729229,21
0,964,18425,3578729208,3578729230,22
0,964,18426,3578729208,3578729231,23
0,964,18427,3578729208,3578729232,24
0,964,18428,3578729208,3578729232,24
0,964,18429,3578729208,3578729233,25
0,964,18430,3578729208,3578729233,25
0,964,18431,3578729208,3578729234,26
0,964,18432,3578729208,3578729234,26
0,964,18433,3578729208,3578729236,28
0,964,18434,3578729208,3578729239,31
0,964,18435,3578729208,3578729242,34
0,964,18436,3578729208,3578729243,35
0,964,18437,3578729208,3578729243,35
0,964,18438,3578729208,3578729244,36
0,964,18439,3578729208,3578729244,36
0,964,18440,3578729208,3578729246,38
0,964,18441,3578729208,3578729248,40
0,964,18442,3578729208,3578729249,41
0,964,18443,3578729208,3578729250,42
0,964,18444,3578729208,3578729250,42
0,964,18445,3578729208,3578729250,42
0,964,18446,3578729208,3578729253,45
0,964,18447,3578729208,3578729254,46
0,964,18448,3578729208,3578729256,48
0,964,18449,3578729208,3578729257,49
0,964,18450,3578729208,3578729259,51
0,965,18451,3578729267,3578729267,0
0,965,18452,3578729267,3578729267,0
0,965,18453,3578729267,3578729267,0
0,965,18454,3578729267,3578729267,0
0,965,18455,3578729267,3578729267,0
0,965,18456,3578729267,3578729267,0
0,965,18457,3578729267,3578729267,0
0,965,18458,3578729267,3578729267,0
0,965,18459,3578729267,3578729267,0
0,965,18460,3578729267,3578729267,0
0,965,18461,3578729267,3578729267,0
0,965,18462,3578729267,3578729268,1
0,965,18463,3578729267,3578729268,1
0,965,18464,3578729267,3578729269,2
0,965,18465,3578729267,3578729270,3
0,965,18466,3578729267,3578729273,6
0,965,18467,3578729267,3578729278,11
0,965,18468,3578729267,3578729279,12
0,965,18469,3578729267,3578729280,13
0,965,18470,3578729267,3578729281,14
0,965,18471,3578729267,3578729281,14
0,965,18472,3578729267,3578729284,17
0,965,18473,3578729267,3578729285,18
0,965,18474,3578729267,3578729287,20
0,965,18475,3578729267,3578729289,22
0,965,18476,3578729267,3578729289,22
0,965,18477,3578729267,3578729291,24
0,965,18478,3578729267,3578729291,24
0,965,18479,3578729267,3578729291,24
0,965,18480,3578729267,3578729292,25
0,965,18481,3578729267,3578729295,28
0,965,18482,3578729267,3578729296,29
0,965,18483,3578729267,3578729298,31
0,965,18484,3578729267,3578729300,33
0,965,18485,3578729267,3578729300,33
0,965,18486,3578729267,3578729301,34
0,965,18487,3578729267,3578729303,36
0,965,18488,3578729267,3578729304,37
0,965,18489,3578729267,3578729304,37
0,965,18490,3578729267,3578729305,38
0,965,18491,3578729267,3578729306,39
0,965,18492,3578729267,3578729306,39
0,965,18493,3578729267,3578729306,39
0,965,18494,3578729267,3578729306,39
0,965,18495,3578729267,3578729307,40
0,965,18496,3578729267,3578729307,40
0,965,18497,3578729267,3578729308,41
0,965,18498,3578729267,3578729308,41
0,965,18499,3578729267,3578729308,41
0,965,18500,3578729267,3578729308,41
0,965,18501,3578729267,3578729308,41
0,965,18502,3578729267,3578729308,41
0,965,18503,3578729267,3578729308,41
0,965,18504,3578729267,3578729309,42
0,965,18505,3578729267,3578729310,43
0,965,18506,3578729267,3578729312,45
0,965,18507,3578729267,3578729315,48
0,965,18508,3578729267,3578729316,49
0,965,18509,3578729267,3578729316,49
0,965,18510,3578729267,3578729316,49
0,965,18511,3578729267,3578729316,49
0,966,18512,3578729325,3578729325,0
0,966,18513,3578729325,3578729325,0
0,966,18514,3578729325,3578729325,0
0,966,18515,3578729325,3578729325,0
0,966,18516,3578729325,3578729325,0
0,966,18517,3578729325,3578729325,0
0,966,18518,3578729325,3578729325,0
0,966,18519,3578729325,3578729325,0
0,966,18520,3578729325,3578729326,1
0,966,18521,3578729325,3578729326,1
0,966,18522,3578729325,3578729327,2
0,966,18523,3578729325,3578729328,3
0,966,18524,3578729325,3578729330,5
0,966,18525,3578729325,3578729330,5
0,966,18526,3578729325,3578729332,7
0,966,18527,3578729325,3578729333,8
0,966,18528,3578729325,3578729334,9
0,966,18529,3578729325,3578729335,10
0,966,18530,3578729325,3578729336,11
0,966,18531,3578729325,3578729340,15
0,966,18532,3578729325,3578729341,16
0,966,18533,3578729325,3578729341,16
0,966,18534,3578729325,3578729343,18
0,966,18535,3578729325,3578729343,18
0,966,18536,3578729325,3578729344,19
0,966,18537,3578729325,3578729344,19
0,966,18538,3578729325,3578729345,20
0,966,18539,3578729325,3578729346,21
0,966,18540,3578729325,3578729348,23
0,966,18541,3578729325,3578729349,24
0,966,18542,3578729325,3578729352,27
0,966,18543,3578729325,3578729352,27
0,966,18544,3578729325,3578729353,28
0,966,18545,3578729325,3578729353,28
0,966,18546,3578729325,3578729356,31
0,966,18547,3578729325,3578729358,33
0,966,18548,3578729325,3578729360,35
0,966,18549,3578729325,3578729360,35
0,966,18550,3578729325,3578729361,36
0,966,18551,3578729325,3578729362,37
0,966,18552,3578729325,3578729362,37
0,966,18553,3578729325,3578729363,38
0,966,18554,3578729325,3578729363,38
0,966,18555,3578729325,3578729367,42
0,966,18556,3578729325,3578729367,42
0,966,18557,3578729325,3578729367,42
0,966,18558,3578729325,3578729368,43
0,966,18559,3578729325,3578729368,43
0,966,18560,3578729325,3578729369,44
0,966,18561,3578729325,3578729370,45
0,966,18562,3578729325,3578729371,46
0,966,18563,3578729325,3578729373,48
0,966,18564,3578729325,3578729373,48
0,966,18565,3578729325,3578729374,49
0,966,18566,3578729325,3578729374,49
0,966,18567,3578729325,3578729374,49
0,967,18568,3578729383,3578729383,0
0,967,18569,3578729383,3578729383,0
0,967,18570,3578729383,3578729383,0
0,967,18571,3578729383,3578729383,0
0,967,18572,3578729383,3578729383,0
0,967,18573,3578729383,3578729383,0
0,967,18574,3578729383,3578729383,0
0,967,18575,3578729383,3578729383,0
0,967,18576,3578729383,3578729383,0
0,967,18577,3578729383,3578729385,2
0,967,18578,3578729383,3578729386,3
0,967,18579,3578729383,3578729386,3
0,967,18580,3578729383,3578729386,3
0,967,18581,3578729383,3578729389,6
0,967,18582,3578729383,3578729391,8
0,967,18583,3578729383,3578729392,9
0,967,18584,3578729383,3578729392,9
0,967,18585,3578729383,3578729393,10
0,967,18586,3578729383,3578729394,11
0,967,18587,3578729383,3578729394,11
0,967,18588,3578729383,3578729395,12
0,967,18589,3578729383,3578729398,15
0,967,18590,3578729383,3578729399,16
0,967,18591,3578729383,3578729401,18
0,967,18592,3578729383,3578729404,21
0,967,18593,3578729383,3578729406,23
0,967,18594,3578729383,3578729406,23
0,967,18595,3578729383,3578729407,24
0,967,18596,3578729383,3578729410,27
0,967,18597,3578729383,3578729410,27
0,967,18598,3578729383,3578729411,28
0,967,18599,3578729383,3578729414,31
0,967,18600,3578729383,3578729416,33
0,967,18601,3578729383,3578729416,33
0,967,18602,3578729383,3578729416,33
0,967,18603,3578729383,3578729418,35
0,967,18604,3578729383,3578729418,35
0,967,18605,3578729383,3578729419,36
0,967,18606,3578729383,3578729420,37
0,967,18607,3578729383,3578729420,37
0,967,18608,3578729383,3578729420,37
0,967,18609,3578729383,3578729422,39
0,967,18610,3578729383,3578729424,41
0,967,18611,3578729383,3578729426,43
0,967,18612,3578729383,3578729430,47
0,967,18613,3578729383,3578729430,47
0,967,18614,3578729383,3578729432,49
0,967,18615,3578729383,3578729432,49
0,967,18616,3578729383,3578729433,50
0,968,18617,3578729442,3578729442,0
0,968,18618,3578729442,3578729442,0
0,968,18619,3578729442,3578729442,0
0,968,18620,3578729442,3578729442,0
0,968,18621,3578729442,3578729442,0
0,968,18622,3578729442,3578729443,1
0,968,18623,3578729442,3578729443,1
0,968,18624,3578729442,3578729444,2
0,968,18625,3578729442,3578729444,2
0,968,18626,3578729442,3578729445,3
0,968,18627,3578729442,3578729447,5
0,968,18628,3578729442,3578729449,7
0,968,18629,3578729442,3578729450,8
0,968,18630,3578729442,3578729450,8
0,968,18631,3578729442,3578729454,12
0,968,18632,3578729442,3578729455,13
0,968,18633,3578729442,3578729455,13
0,968,18634,3578729442,3578729457,15
0,968,18635,3578729442,3578729457,15
0,968,18636,3578729442,3578729459,17
0,968,18637,3578729442,3578729460,18
0,968,18638,3578729442,3578729461,19
0,968,18639,3578729442,3578729463,21
0,968,18640,3578729442,3578729463,21
0,968,18641,3578729442,3578729464,22
0,968,18642,3578729442,3578729465,23
0,968,18643,3578729442,3578729465,23
0,968,18644,3578729442,3578729466,24
0,968,18645,3578729442,3578729467,25
0,968,18646,3578729442,3578729467,25
0,968,18647,3578729442,3578729469,27
0,968,18648,3578729442,3578729469,27
0,968,18649,3578729442,3578729469,27
0,968,18650,3578729442,3578729470,28
0,968,18651,3578729442,3578729470,28
0,968,18652,3578729442,3578729473,31
0,968,18653,3578729442,3578729479,37
0,968,18654,3578729442,3578729480,38
0,968,18655,3578729442,3578729480,38
0,968,18656,3578729442,3578729482,40
0,968,18657,3578729442,3578729484,42
0,968,18658,3578729442,3578729485,43
0,968,18659,3578729442,3578729486,44
0,968,18660,3578729442,3578729488,46
0,968,18661,3578729442,3578729489,47
0,968,18662,3578729442,3578729489,47
0,968,18663,3578729442,3578729490,48
0,968,18664,3578729442,3578729492,50
0,969,18665,3578729499,3578729499,0
0,969,18666,3578729499,3578729499,0
0,969,18667,3578729499,3578729499,0
0,969,18668,3578729499,3578729499,0
0,969,18669,3578729499,3578729499,0
0,969,18670,3578729499,3578729499,0
0,969,18671,3578729499,3578729500,1
0,969,18672,3578729499,3578729501,2
0,969,18673,3578729499,3578729503,4
0,969,18674,3578729499,3578729504,5
0,969,18675,3578729499,3578729504,5
0,969,18676,3578729499,3578729505,6
0,969,18677,3578729499,3578729506,7
0,969,18678,3578729499,3578729506,7
0,969,18679,3578729499,3578729506,7
0,969,18680,3578729499,3578729507,8
0,969,18681,3578729499,3578729507,8
0,969,18682,3578729499,3578729507,8
0,969,18683,3578729499,3578729507,8
0,969,18684,3578729499,3578729507,8
0,969,18685,3578729499,3578729507,8
0,969,18686,3578729499,3578729508,9
0,969,18687,3578729499,3578729508,9
0,969,18688,3578729499,3578729508,9
0,969,18689,3578729499,3578729509,10
0,969,18690,3578729499,3578729509,10
0,969,18691,3578729499,3578729511,12
0,969,18692,3578729499,3578729514,15
0,969,18693,3578729499,3578729515,16
0,969,18694,3578729499,3578729516,17
0,969,18695,3578729499,3578729516,17
0,969,18696,3578729499,3578729517,18
0,969,18697,3578729499,3578729519,20
0,969,18698,3578729499,3578729519,20
0,969,18699,3578729499,3578729520,21
0,969,18700,3578729499,3578729522,23
0,969,18701,3578729499,3578729523,24
0,969,18702,3578729499,3578729525,26
0,969,18703,3578729499,3578729525,26
0,969,18704,3578729499,3578729527,28
0,969,18705,3578729499,3578729527,28
0,969,18706,3578729499,3578729529,30
0,969,18707,3578729499,3578729530,31
0,969,18708,3578729499,3578729530,31
0,969,18709,3578729499,3578729532,33
0,969,18710,3578729499,3578729532,33
0,969,18711,3578729499,3578729534,35
0,969,18712,3578729499,3578729534,35
0,969,18713,3578729499,3578729535,36
0,969,18714,3578729499,3578729539,40
0,969,18715,3578729499,3578729541,42
0,969,18716,3578729499,3578729542,43
0,969,18717,3578729499,3578729542,43
0,969,18718,3578729499,3578729544,45
0,969,18719,3578729499,3578729544,45
0,969,18720,3578729499,3578729544,45
0,969,18721,3578729499,3578729545,46
0,969,18722,3578729499,3578729547,48
0,969,18723,3578729499,3578729547,48
0,970,18724,3578729556,3578729556,0
0,970,18725,3578729556,3578729556,0
0,970,18726,3578729556,3578729556,0
0,970,18727,3578729556,3578729558,2
0,970,18728,3578729556,3578729559,3
0,970,18729,3578729556,3578729559,3
0,970,18730,3578729556,3578729560,4
0,970,18731,3578729556,3578729560,4
0,970,18732,3578729556,3578729560,4
0,970,18733,3578729556,3578729561,5
0,970,18734,3578729556,3578729561,5
0,970,18735,3578729556,3578729563,7
0,970,18736,3578729556,3578729563,7
0,970,18737,3578729556,3578729566,10
0,970,18738,3578729556,3578729567,11
0,970,18739,3578729556,3578729567,11
0,970,18740,3578729556,3578729568,12
0,970,18741,3578729556,3578729569,13
0,970,18742,3578729556,3578729571,15
0,970,18743,3578729556,3578729571,15
0,970,18744,3578729556,3578729572,16
0,970,18745,3578729556,3578729573,17
0,970,18746,3578729556,3578729573,17
0,970,18747,3578729556,3578729573,17
0,970,18748,3578729556,3578729575,19
0,970,18749,3578729556,3578729577,21
0,970,18750,3578729556,3578729578,22
0,970,18751,3578729556,3578729579,23
0,970,18752,3578729556,3578729580,24
0,970,18753,3578729556,3578729581,25
0,970,18754,3578729556,3578729581,25
0,970,18755,3578729556,3578729582,26
0,970,18756,3578729556,3578729583,27
0,970,18757,3578729556,3578729585,29
0,970,18758,3578729556,3578729585,29
0,970,18759,3578729556,3578729586,30
0,970,18760,3578729556,3578729586,30
0,970,18761,3578729556,3578729589,33
0,970,18762,3578729556,3578729590,34
0,970,18763,3578729556,3578729590,34
0,970,18764,3578729556,3578729590,34
0,970,18765,3578729556,3578729592,36
0,970,18766,3578729556,3578729592,36
0,970,18767,3578729556,3578729595,39
0,970,18768,3578729556,3578729595,39
0,970,18769,3578729556,3578729598,42
0,970,18770,3578729556,3578729598,42
0,970,18771,3578729556,3578729599,43
0,970,18772,3578729556,3578729600,44
0,970,18773,3578729556,3578729604,48
0,970,18774,3578729556,3578729605,49
0,970,18775,3578729556,3578729605,49
0,971,18776,3578729613,3578729613,0
0,971,18777,3578729613,3578729613,0
0,971,18778,3578729613,3578729613,0
0,971,18779,3578729613,3578729613,0
0,971,18780,3578729613,3578729613,0
0,971,18781,3578729613,3578729613,0
0,971,18782,3578729613,3578729613,0
0,971,18783,3578729613,3578729614,1
0,971,18784,3578729613,3578729614,1
0,971,18785,3578729613,3578729615,2
0,971,18786,3578729613,3578729618,5
0,971,18787,3578729613,3578729618,5
0,971,18788,3578729613,3578729618,5
0,971,18789,3578729613,3578729619,6
0,971,18790,3578729613,3578729619,6
0,971,18791,3578729613,3578729621,8
0,971,18792,3578729613,3578729622,9
0,971,18793,3578729613,3578729623,10
0,971,18794,3578729613,3578729625,12
0,971,18795,3578729613,3578729628,15
0,971,18796,3578729613,3578729629,16
0,971,18797,3578729613,3578729631,18
0,971,18798,3578729613,3578729631,18
0,971,18799,3578729613,3578729632,19
0,971,18800,3578729613,3578729634,21
0,971,18801,3578729613,3578729634,21
0,971,18802,3578729613,3578729634,21
0,971,18803,3578729613,3578729636,23
0,971,18804,3578729613,3578729639,26
0,971,18805,3578729613,3578729642,29
0,971,18806,3578729613,3578729643,30
0,971,18807,3578729613,3578729643,30
0,971,18808,3578729613,3578729645,32
0,971,18809,3578729613,3578729649,36
0,971,18810,3578729613,3578729649,36
0,971,18811,3578729613,3578729649,36
0,971,18812,3578729613,3578729653,40
0,971,18813,3578729613,3578729654,41
0,971,18814,3578729613,3578729655,42
0,971,18815,3578729613,3578729656,43
0,971,18816,3578729613,3578729658,45
0,971,18817,3578729613,3578729659,46
0,971,18818,3578729613,3578729660,47
0,971,18819,3578729613,3578729661,48
0,971,18820,3578729613,3578729662,49
0,971,18821,3578729613,3578729663,50
0,972,18822,3578729670,3578729670,0
0,972,18823,3578729670,3578729670,0
0,972,18824,3578729670,3578729670,0
0,972,18825,3578729670,3578729670,0
0,972,18826,3578729670,3578729670,0
0,972,18827,3578729670,3578729670,0
0,972,18828,3578729670,3578729670,0
0,972,18829,3578729670,3578729670,0
0,972,18830,3578729670,3578729670,0
0,972,18831,3578729670,3578729670,0
0,972,18832,3578729670,3578729673,3
0,972,18833,3578729670,3578729679,9
0,972,18834,3578729670,3578729680,10
0,972,18835,3578729670,3578729680,10
0,972,18836,3578729670,3578729681,11
0,972,18837,3578729670,3578729681,11
0,972,18838,3578729670,3578729683,13
0,972,18839,3578729670,3578729685,15
0,972,18840,3578729670,3578729685,15
0,972,18841,3578729670,3578729686,16
0,972,18842,3578729670,3578729687,17
0,972,18843,3578729670,3578729689,19
0,972,18844,3578729670,3578729690,20
0,972,18845,3578729670,3578729691,21
0,972,18846,3578729670,3578729692,22
0,972,18847,3578729670,3578729692,22
0,972,18848,3578729670,3578729693,23
0,972,18849,3578729670,3578729695,25
0,972,18850,3578729670,3578729695,25
0,972,18851,3578729670,3578729698,28
0,972,18852,3578729670,3578729698,28
0,972,18853,3578729670,3578729699,29
0,972,18854,3578729670,3578729700,30
0,972,18855,3578729670,3578729700,30
0,972,18856,3578729670,3578729702,32
0,972,18857,3578729670,3578729703,33
0,972,18858,3578729670,3578729704,34
0,972,18859,3578729670,3578729704,34
0,972,18860,3578729670,3578729706,36
0,972,18861,3578729670,3578729706,36
0,972,18862,3578729670,3578729706,36
0,972,18863,3578729670,3578729707,37
0,972,18864,3578729670,3578729707,37
0,972,18865,3578729670,3578729707,37
0,972,18866,3578729670,3578729707,37
0,972,18867,3578729670,3578729707,37
0,972,18868,3578729670,3578729708,38
0,972,18869,3578729670,3578729708,38
0,972,18870,3578729670,3578729708,38
0,972,18871,3578729670,3578729709,39
0,972,18872,3578729670,3578729709,39
0,972,18873,3578729670,3578729710,40
0,972,18874,3578729670,3578729711,41
0,972,18875,3578729670,3578729714,44
0,972,18876,3578729670,3578729714,44
0,972,18877,3578729670,3578729715,45
0,972,18878,3578729670,3578729716,46
0,972,18879,3578729670,3578729716,46
0,972,18880,3578729670,3578729717,47
0,972,18881,3578729670,3578729718,48
0,972,18882,3578729670,3578729719,49
0,972,18883,3578729670,3578729719,49
0,972,18884,3578729670,3578729720,50
0,973,18885,3578729730,3578729730,0
0,973,18886,3578729730,3578729730,0
0,973,18887,3578729730,3578729730,0
0,973,18888,3578729730,3578729730,0
0,973,18889,3578729730,3578729730,0
0,973,18890,3578729730,3578729730,0
0,973,18891,3578729730,3578729730,0
0,973,18892,3578729730,3578729730,0
0,973,18893,3578729730,3578729730,0
0,973,18894,3578729730,3578729731,1
0,973,18895,3578729730,3578729731,1
0,973,18896,3578729730,3578729733,3
0,973,18897,3578729730,3578729733,3
0,973,18898,3578729730,3578729734,4
0,973,18899,3578729730,3578729734,4
0,973,18900,3578729730,3578729735,5
0,973,18901,3578729730,3578729739,9
0,973,18902,3578729730,3578729739,9
0,973,18903,3578729730,3578729740,10
0,973,18904,3578729730,3578729742,12
0,973,18905,3578729730,3578729743,13
0,973,18906,3578729730,3578729744,14
0,973,18907,3578729730,3578729745,15
0,973,18908,3578729730,3578729745,15
0,973,18909,3578729730,3578729746,16
0,973,18910,3578729730,3578729747,17
0,973,18911,3578729730,3578729747,17
0,973,18912,3578729730,3578729753,23
0,973,18913,3578729730,3578729753,23
0,973,18914,3578729730,3578729753,23
0,973,18915,3578729730,3578729754,24
0,973,18916,3578729730,3578729758,28
0,973,18917,3578729730,3578729759,29
0,973,18918,3578729730,3578729760,30
0,973,18919,3578729730,3578729760,30
0,973,18920,3578729730,3578729760,30
0,973,18921,3578729730,3578729760,30
0,973,18922,3578729730,3578729761,31
0,973,18923,3578729730,3578729762,32
0,973,18924,3578729730,3578729762,32
0,973,18925,3578729730,3578729763,33
0,973,18926,3578729730,3578729766,36
0,973,18927,3578729730,3578729767,37
0,973,18928,3578729730,3578729767,37
0,973,18929,3578729730,3578729768,38
0,973,18930,3578729730,3578729768,38
0,973,18931,3578729730,3578729770,40
0,973,18932,3578729730,3578729772,42
0,973,18933,3578729730,3578729772,42
0,973,18934,3578729730,3578729773,43
0,973,18935,3578729730,3578729773,43
0,973,18936,3578729730,3578729773,43
0,973,18937,3578729730,3578729773,43
0,973,18938,3578729730,3578729773,43
0,973,18939,3578729730,3578729775,45
0,973,18940,3578729730,3578729775,45
0,973,18941,3578729730,3578729778,48
0,973,18942,3578729730,3578729779,49
0,973,18943,3578729730,3578729779,49
0,974,18944,3578729792,3578729792,0
0,974,18945,3578729792,3578729792,0
0,974,18946,3578729792,3578729792,0
0,974,18947,3578729792,3578729792,0
0,974,18948,3578729792,3578729792,0
0,974,18949,3578729792,3578729792,0
0,974,18950,3578729792,3578729792,0
0,974,18951,3578729792,3578729792,0
0,974,18952,3578729792,3578729792,0
0,974,18953,3578729792,3578729792,0
0,974,18954,3578729792,3578729792,0
0,974,18955,3578729792,3578729792,0
0,974,18956,3578729792,3578729792,0
0,974,18957,3578729792,3578729793,1
0,974,18958,3578729792,3578729794,2
0,974,18959,3578729792,3578729798,6
0,974,18960,3578729792,3578729798,6
0,974,18961,3578729792,3578729799,7
0,974,18962,3578729792,3578729800,8
0,974,18963,3578729792,3578729805,13
0,974,18964,3578729792,3578729805,13
0,974,18965,3578729792,3578729805,13
0,974,18966,3578729792,3578729805,13
0,974,18967,3578729792,3578729806,14
0,974,18968,3578729792,3578729810,18
0,974,18969,3578729792,3578729811,19
0,974,18970,3578729792,3578729812,20
0,974,18971,3578729792,3578729812,20
0,974,18972,3578729792,3578729813,21
0,974,18973,3578729792,3578729815,23
0,974,18974,3578729792,3578729817,25
0,974,18975,3578729792,3578729817,25
0,974,18976,3578729792,3578729818,26
0,974,18977,3578729792,3578729818,26
0,974,18978,3578729792,3578729819,27
0,974,18979,3578729792,3578729821,29
0,974,18980,3578729792,3578729822,30
0,974,18981,3578729792,3578729824,32
0,974,18982,3578729792,3578729825,33
0,974,18983,3578729792,3578729825,33
0,974,18984,3578729792,3578729828,36
0,974,18985,3578729792,3578729829,37
0,974,18986,3578729792,3578729832,40
0,974,18987,3578729792,3578729832,40
0,974,18988,3578729792,3578729832,40
0,974,18989,3578729792,3578729832,40
0,974,18990,3578729792,3578729834,42
0,974,18991,3578729792,3578729834,42
0,974,18992,3578729792,3578729836,44
0,974,18993,3578729792,3578729840,48
0,975,18994,3578729852,3578729852,0
0,975,18995,3578729852,3578729852,0
0,975,18996,3578729852,3578729852,0
0,975,18997,3578729852,3578729852,0
0,975,18998,3578729852,3578729852,0
0,975,18999,3578729852,3578729852,0
0,975,19000,3578729852,3578729852,0
0,975,19001,3578729852,3578729852,0
0,975,19002,3578729852,3578729852,0
0,975,19003,3578729852,3578729852,0
0,975,19004,3578729852,3578729854,2
0,975,19005,3578729852,3578729854,2
0,975,19006,3578729852,3578729855,3
0,975,19007,3578729852,3578729857,5
0,975,19008,3578729852,3578729857,5
0,975,19009,3578729852,3578729858,6
0,975,19010,3578729852,3578729859,7
0,975,19011,3578729852,3578729862,10
0,975,19012,3578729852,3578729862,10
0,975,19013,3578729852,3578729862,10
0,975,19014,3578729852,3578729863,11
0,975,19015,3578729852,3578729864,12
0,975,19016,3578729852,3578729865,13
0,975,19017,3578729852,3578729866,14
0,975,19018,3578729852,3578729867,15
0,975,19019,3578729852,3578729867,15
0,975,19020,3578729852,3578729867,15
0,975,19021,3578729852,3578729869,17
0,975,19022,3578729852,3578729869,17
0,975,19023,3578729852,3578729869,17
0,975,19024,3578729852,3578729870,18
0,975,19025,3578729852,3578729873,21
0,975,19026,3578729852,3578729876,24
0,975,19027,3578729852,3578729880,28
0,975,19028,3578729852,3578729880,28
0,975,19029,3578729852,3578729881,29
0,975,19030,3578729852,3578729882,30
0,975,19031,3578729852,3578729882,30
0,975,19032,3578729852,3578729884,32
0,975,19033,3578729852,3578729885,33
0,975,19034,3578729852,3578729887,35
0,975,19035,3578729852,3578729887,35
0,975,19036,3578729852,3578729889,37
0,975,19037,3578729852,3578729889,37
0,975,19038,3578729852,3578729891,39
0,975,19039,3578729852,3578729891,39
0,975,19040,3578729852,3578729892,40
0,975,19041,3578729852,3578729893,41
0,975,19042,3578729852,3578729895,43
0,975,19043,3578729852,3578729898,46
0,975,19044,3578729852,3578729900,48
0,975,19045,3578729852,3578729900,48
0,975,19046,3578729852,3578729900,48
0,976,19047,3578729909,3578729909,0
0,976,19048,3578729909,3578729909,0
0,976,19049,3578729909,3578729909,0
0,976,19050,3578729909,3578729909,0
0,976,19051,3578729909,3578729909,0
0,976,19052,3578729909,3578729909,0
0,976,19053,3578729909,3578729909,0
0,976,19054,3578729909,3578729909,0
0,976,19055,3578729909,3578729909,0
0,976,19056,3578729909,3578729909,0
0,976,19057,3578729909,3578729909,0
0,976,19058,3578729909,3578729909,0
0,976,19059,3578729909,3578729909,0
0,976,19060,3578729909,3578729909,0
0,976,19061,3578729909,3578729909,0
0,976,19062,3578729909,3578729909,0
0,976,19063,3578729909,3578729909,0
0,976,19064,3578729909,3578729909,0
0,976,19065,3578729909,3578729911,2
0,976,19066,3578729909,3578729915,6
0,976,19067,3578729909,3578729915,6
0,976,19068,3578729909,3578729915,6
0,976,19069,3578729909,3578729916,7
0,976,19070,3578729909,3578729916,7
0,976,19071,3578729909,3578729917,8
0,976,19072,3578729909,3578729917,8
0,976,19073,3578729909,3578729918,9
0,976,19074,3578729909,3578729919,10
0,976,19075,3578729909,3578729920,11
0,976,19076,3578729909,3578729923,14
0,976,19077,3578729909,3578729923,14
0,976,19078,3578729909,3578729924,15
0,976,19079,3578729909,3578729925,16
0,976,19080,3578729909,3578729926,17
0,976,19081,3578729909,3578729927,18
0,976,19082,3578729909,3578729930,21
0,976,19083,3578729909,3578729930,21
0,976,19084,3578729909,3578729931,22
0,976,19085,3578729909,3578729931,22
0,976,19086,3578729909,3578729932,23
0,976,19087,3578729909,3578729933,24
0,976,19088,3578729909,3578729934,25
0,976,19089,3578729909,3578729935,26
0,976,19090,3578729909,3578729939,30
0,976,19091,3578729909,3578729940,31
0,976,19092,3578729909,3578729941,32
0,976,19093,3578729909,3578729942,33
0,976,19094,3578729909,3578729943,34
0,976,19095,3578729909,3578729944,35
0,976,19096,3578729909,3578729945,36
0,976,19097,3578729909,3578729945,36
0,976,19098,3578729909,3578729947,38
0,976,19099,3578729909,3578729947,38
0,976,19100,3578729909,3578729951,42
0,976,19101,3578729909,3578729953,44
0,976,19102,3578729909,3578729953,44
0,976,19103,3578729909,3578729954,45
0,976,19104,3578729909,3578729959,50
0,977,19105,3578729968,3578729968,0
0,977,19106,3578729968,3578729968,0
0,977,19107,3578729968,3578729968,0
0,977,19108,3578729968,3578729968,0
0,977,19109,3578729968,3578729968,0
0,977,19110,3578729968,3578729968,0
0,977,19111,3578729968,3578729968,0
0,977,19112,3578729968,3578729968,0
0,977,19113,3578729968,3578729968,0
0,977,19114,3578729968,3578729968,0
0,977,19115,3578729968,3578729968,0
0,977,19116,3578729968,3578729968,0
0,977,19117,3578729968,3578729970,2
0,977,19118,3578729968,3578729972,4
0,977,19119,3578729968,3578729972,4
0,977,19120,3578729968,3578729972,4
0,977,19121,3578729968,3578729973,5
0,977,19122,3578729968,3578729973,5
0,977,19123,3578729968,3578729973,5
0,977,19124,3578729968,3578729975,7
0,977,19125,3578729968,3578729976,8
0,977,19126,3578729968,3578729979,11
0,977,19127,3578729968,3578729979,11
0,977,19128,3578729968,3578729980,12
0,977,19129,3578729968,3578729981,13
0,977,19130,3578729968,3578729981,13
0,977,19131,3578729968,3578729984,16
0,977,19132,3578729968,3578729984,16
0,977,19133,3578729968,3578729985,17
0,977,19134,3578729968,3578729986,18
0,977,19135,3578729968,3578729987,19
0,977,19136,3578729968,3578729987,19
0,977,19137,3578729968,3578729990,22
0,977,19138,3578729968,3578729991,23
0,977,19139,3578729968,3578729991,23
0,977,19140,3578729968,3578729993,25
0,977,19141,3578729968,3578729993,25
0,977,19142,3578729968,3578729993,25
0,977,19143,3578729968,3578729994,26
0,977,19144,3578729968,3578729995,27
0,977,19145,3578729968,3578729996,28
0,977,19146,3578729968,3578729999,31
0,977,19147,3578729968,3578729999,31
0,977,19148,3578729968,3578730001,33
0,977,19149,3578729968,3578730004,36
0,977,19150,3578729968,3578730005,37
0,977,19151,3578729968,3578730006,38
0,977,19152,3578729968,3578730006,38
0,977,19153,3578729968,3578730006,38
0,977,19154,3578729968,3578730010,42
0,977,19155,3578729968,3578730010,42
0,977,19156,3578729968,3578730011,43
0,977,19157,3578729968,3578730012,44
0,977,19158,3578729968,3578730013,45
0,977,19159,3578729968,3578730013,45
0,977,19160,3578729968,3578730017,49
0,977,19161,3578729968,3578730017,49
0,977,19162,3578729968,3578730018,50
0,978,19163,3578730024,3578730024,0
0,978,19164,3578730024,3578730024,0
0,978,19165,3578730024,3578730025,1
0,978,19166,3578730024,3578730025,1
0,978,19167,3578730024,3578730025,1
0,978,19168,3578730024,3578730025,1
0,978,19169,3578730024,3578730026,2
0,978,19170,3578730024,3578730028,4
0,978,19171,3578730024,3578730031,7
0,978,19172,3578730024,3578730032,8
0,978,19173,3578730024,3578730032,8
0,978,19174,3578730024,3578730032,8
0,978,19175,3578730024,3578730034,10
0,978,19176,3578730024,3578730035,11
0,978,19177,3578730024,3578730035,11
0,978,19178,3578730024,3578730036,12
0,978,19179,3578730024,3578730040,16
0,978,19180,3578730024,3578730042,18
0,978,19181,3578730024,3578730042,18
0,978,19182,3578730024,3578730042,18
0,978,19183,3578730024,3578730043,19
0,978,19184,3578730024,3578730043,19
0,978,19185,3578730024,3578730047,23
0,978,19186,3578730024,3578730048,24
0,978,19187,3578730024,3578730049,25
0,978,19188,3578730024,3578730050,26
0,978,19189,3578730024,3578730050,26
0,978,19190,3578730024,3578730054,30
0,978,19191,3578730024,3578730054,30
0,978,19192,3578730024,3578730054,30
0,978,19193,3578730024,3578730057,33
0,978,19194,3578730024,3578730057,33
0,978,19195,3578730024,3578730058,34
0,978,19196,3578730024,3578730062,38
0,978,19197,3578730024,3578730062,38
0,978,19198,3578730024,3578730062,38
0,978,19199,3578730024,3578730063,39
0,978,19200,3578730024,3578730064,40
0,978,19201,3578730024,3578730065,41
0,978,19202,3578730024,3578730066,42
0,978,19203,3578730024,3578730066,42
0,978,19204,3578730024,3578730067,43
0,978,19205,3578730024,3578730067,43
0,978,19206,3578730024,3578730069,45
0,978,19207,3578730024,3578730069,45
0,978,19208,3578730024,3578730069,45
0,978,19209,3578730024,3578730070,46
0,978,19210,3578730024,3578730073,49
0,979,19211,3578730081,3578730081,0
0,979,19212,3578730081,3578730081,0
0,979,19213,3578730081,3578730081,0
0,979,19214,3578730081,3578730081,0
0,979,19215,3578730081,3578730082,1
0,979,19216,3578730081,3578730082,1
0,979,19217,3578730081,3578730085,4
0,979,19218,3578730081,3578730085,4
0,979,19219,3578730081,3578730086,5
0,979,19220,3578730081,3578730087,6
0,979,19221,3578730081,3578730087,6
0,979,19222,3578730081,3578730089,8
0,979,19223,3578730081,3578730090,9
0,979,19224,3578730081,3578730091,10
0,979,19225,3578730081,3578730092,11
0,979,19226,3578730081,3578730092,11
0,979,19227,3578730081,3578730093,12
0,979,19228,3578730081,3578730095,14
0,979,19229,3578730081,3578730096,15
0,979,19230,3578730081,3578730098,17
0,979,19231,3578730081,3578730098,17
0,979,19232,3578730081,3578730099,18
0,979,19233,3578730081,3578730100,19
0,979,19234,3578730081,3578730101,20
0,979,19235,3578730081,3578730102,21
0,979,19236,3578730081,3578730104,23
0,979,19237,3578730081,3578730106,25
0,979,19238,3578730081,3578730107,26
0,979,19239,3578730081,3578730107,26
0,979,19240,3578730081,3578730107,26
0,979,19241,3578730081,3578730107,26
0,979,19242,3578730081,3578730107,26
0,979,19243,3578730081,3578730108,27
0,979,19244,3578730081,3578730108,27
0,979,19245,3578730081,3578730108,27
0,979,19246,3578730081,3578730108,27
0,979,19247,3578730081,3578730109,28
0,979,19248,3578730081,3578730109,28
0,979,19249,3578730081,3578730109,28
0,979,19250,3578730081,3578730109,28
0,979,19251,3578730081,3578730110,29
0,979,19252,3578730081,3578730111,30
0,979,19253,3578730081,3578730114,33
0,979,19254,3578730081,3578730115,34
0,979,19255,3578730081,3578730116,35
0,979,19256,3578730081,3578730116,35
0,979,19257,3578730081,3578730116,35
0,979,19258,3578730081,3578730117,36
0,979,19259,3578730081,3578730117,36
0,979,19260,3578730081,3578730118,37
0,979,19261,3578730081,3578730120,39
0,979,19262,3578730081,3578730120,39
0,979,19263,3578730081,3578730120,39
0,979,19264,3578730081,3578730122,41
0,979,19265,3578730081,3578730123,42
0,979,19266,3578730081,3578730125,44
0,979,19267,3578730081,3578730126,45
0,979,19268,3578730081,3578730126,45
0,979,19269,3578730081,3578730127,46
0,979,19270,3578730081,3578730128,47
0,979,19271,3578730081,3578730129,48
0,979,19272,3578730081,3578730130,49
0,980,19273,3578730139,3578730139,0
0,980,19274,3578730139,3578730139,0
0,980,19275,3578730139,3578730139,0
0,980,19276,3578730139,3578730139,0
0,980,19277,3578730139,3578730139,0
0,980,19278,3578730139,3578730139,0
0,980,19279,3578730139,3578730139,0
0,980,19280,3578730139,3578730139,0
0,980,19281,3578730139,3578730139,0
0,980,19282,3578730139,3578730140,1
0,980,19283,3578730139,3578730140,1
0,980,19284,3578730139,3578730143,4
0,980,19285,3578730139,3578730143,4
0,980,19286,3578730139,3578730145,6
0,980,19287,3578730139,3578730145,6
0,980,19288,3578730139,3578730145,6
0,980,19289,3578730139,3578730147,8
0,980,19290,3578730139,3578730147,8
0,980,19291,3578730139,3578730149,10
0,980,19292,3578730139,3578730151,12
0,980,19293,3578730139,3578730153,14
0,980,19294,3578730139,3578730153,14
0,980,19295,3578730139,3578730153,14
0,980,19296,3578730139,3578730154,15
0,980,19297,3578730139,3578730159,20
0,980,19298,3578730139,3578730160,21
0,980,19299,3578730139,3578730161,22
0,980,19300,3578730139,3578730161,22
0,980,19301,3578730139,3578730162,23
0,980,19302,3578730139,3578730163,24
0,980,19303,3578730139,3578730164,25
0,980,19304,3578730139,3578730166,27
0,980,19305,3578730139,3578730167,28
0,980,19306,3578730139,3578730168,29
0,980,19307,3578730139,3578730169,30
0,980,19308,3578730139,3578730170,31
0,980,19309,3578730139,3578730172,33
0,980,19310,3578730139,3578730173,34
0,980,19311,3578730139,3578730173,34
0,980,19312,3578730139,3578730173,34
0,980,19313,3578730139,3578730173,34
0,980,19314,3578730139,3578730174,35
0,980,19315,3578730139,3578730176,37
0,980,19316,3578730139,3578730179,40
0,980,19317,3578730139,3578730179,40
0,980,19318,3578730139,3578730181,42
0,980,19319,3578730139,3578730184,45
0,980,19320,3578730139,3578730185,46
0,980,19321,3578730139,3578730185,46
0,980,19322,3578730139,3578730187,48
0,980,19323,3578730139,3578730187,48
0,980,19324,3578730139,3578730189,50
0,981,19325,3578730196,3578730197,1
0,981,19326,3578730196,3578730197,1
0,981,19327,3578730196,3578730197,1
0,981,19328,3578730196,3578730197,1
0,981,19329,3578730196,3578730197,1
0,981,19330,3578730196,3578730197,1
0,981,19331,3578730196,3578730198,2
0,981,19332,3578730196,3578730199,3
0,981,19333,3578730196,3578730199,3
0,981,19334,3578730196,3578730201,5
0,981,19335,3578730196,3578730204,8
0,981,19336,3578730196,3578730204,8
0,981,19337,3578730196,3578730205,9
0,981,19338,3578730196,3578730207,11
0,981,19339,3578730196,3578730209,13
0,981,19340,3578730196,3578730211,15
0,981,19341,3578730196,3578730213,17
0,981,19342,3578730196,3578730213,17
0,981,19343,3578730196,3578730214,18
0,981,19344,3578730196,3578730215,19
0,981,19345,3578730196,3578730216,20
0,981,19346,3578730196,3578730217,21
0,981,19347,3578730196,3578730218,22
0,981,19348,3578730196,3578730218,22
0,981,19349,3578730196,3578730219,23
0,981,19350,3578730196,3578730219,23
0,981,19351,3578730196,3578730221,25
0,981,19352,3578730196,3578730222,26
0,981,19353,3578730196,3578730223,27
0,981,19354,3578730196,3578730224,28
0,981,19355,3578730196,3578730227,31
0,981,19356,3578730196,3578730228,32
0,981,19357,3578730196,3578730231,35
0,981,19358,3578730196,3578730232,36
0,981,19359,3578730196,3578730233,37
0,981,19360,3578730196,3578730233,37
0,981,19361,3578730196,3578730234,38
0,981,19362,3578730196,3578730235,39
0,981,19363,3578730196,3578730236,40
0,981,19364,3578730196,3578730240,44
0,981,19365,3578730196,3578730240,44
0,981,19366,3578730196,3578730242,46
0,981,19367,3578730196,3578730243,47
0,981,19368,3578730196,3578730243,47
0,981,19369,3578730196,3578730246,50
0,982,19370,3578730254,3578730254,0
0,982,19371,3578730254,3578730254,0
0,982,19372,3578730254,3578730254,0
0,982,19373,3578730254,3578730254,0
0,982,19374,3578730254,3578730254,0
0,982,19375,3578730254,3578730254,0
0,982,19376,3578730254,3578730255,1
0,982,19377,3578730254,3578730257,3
0,982,19378,3578730254,3578730258,4
0,982,19379,3578730254,3578730259,5
0,982,19380,3578730254,3578730262,8
0,982,19381,3578730254,3578730262,8
0,982,19382,3578730254,3578730263,9
0,982,19383,3578730254,3578730263,9
0,982,19384,3578730254,3578730265,11
0,982,19385,3578730254,3578730265,11
0,982,19386,3578730254,3578730267,13
0,982,19387,3578730254,3578730267,13
0,982,19388,3578730254,3578730267,13
0,982,19389,3578730254,3578730267,13
0,982,19390,3578730254,3578730269,15
0,982,19391,3578730254,3578730269,15
0,982,19392,3578730254,3578730269,15
0,982,19393,3578730254,3578730271,17
0,982,19394,3578730254,3578730279,25
0,982,19395,3578730254,3578730280,26
0,982,19396,3578730254,3578730280,26
0,982,19397,3578730254,3578730281,27
0,982,19398,3578730254,3578730282,28
0,982,19399,3578730254,3578730282,28
0,982,19400,3578730254,3578730285,31
0,982,19401,3578730254,3578730285,31
0,982,19402,3578730254,3578730286,32
0,982,19403,3578730254,3578730287,33
0,982,19404,3578730254,3578730287,33
0,982,19405,3578730254,3578730289,35
0,982,19406,3578730254,3578730289,35
0,982,19407,3578730254,3578730291,37
0,982,19408,3578730254,3578730291,37
0,982,19409,3578730254,3578730292,38
0,982,19410,3578730254,3578730292,38
0,982,19411,3578730254,3578730293,39
0,982,19412,3578730254,3578730297,43
0,982,19413,3578730254,3578730297,43
0,982,19414,3578730254,3578730298,44
0,982,19415,3578730254,3578730300,46
0,982,19416,3578730254,3578730300,46
0,982,19417,3578730254,3578730301,47
0,983,19418,3578730314,3578730314,0
0,983,19419,3578730314,3578730314,0
0,983,19420,3578730314,3578730314,0
0,983,19421,3578730314,3578730314,0
0,983,19422,3578730314,3578730314,0
0,983,19423,3578730314,3578730314,0
0,983,19424,3578730314,3578730314,0
0,983,19425,3578730314,3578730314,0
0,983,19426,3578730314,3578730314,0
0,983,19427,3578730314,3578730314,0
0,983,19428,3578730314,3578730314,0
0,983,19429,3578730314,3578730314,0
0,983,19430,3578730314,3578730314,0
0,983,19431,3578730314,3578730314,0
0,983,19432,3578730314,3578730314,0
0,983,19433,3578730314,3578730315,1
0,983,19434,3578730314,3578730315,1
0,983,19435,3578730314,3578730316,2
0,983,19436,3578730314,3578730316,2
0,983,19437,3578730314,3578730317,3
0,983,19438,3578730314,3578730317,3
0,983,19439,3578730314,3578730318,4
0,983,19440,3578730314,3578730319,5
0,983,19441,3578730314,3578730319,5
0,983,19442,3578730314,3578730320,6
0,983,19443,3578730314,3578730322,8
0,983,19444,3578730314,3578730323,9
0,983,19445,3578730314,3578730325,11
0,983,19446,3578730314,3578730325,11
0,983,19447,3578730314,3578730326,12
0,983,19448,3578730314,3578730327,13
0,983,19449,3578730314,3578730328,14
0,983,19450,3578730314,3578730329,15
0,983,19451,3578730314,3578730331,17
0,983,19452,3578730314,3578730331,17
0,983,19453,3578730314,3578730333,19
0,983,19454,3578730314,3578730334,20
0,983,19455,3578730314,3578730335,21
0,983,19456,3578730314,3578730336,22
0,983,19457,3578730314,3578730339,25
0,983,19458,3578730314,3578730341,27
0,983,19459,3578730314,3578730341,27
0,983,19460,3578730314,3578730341,27
0,983,19461,3578730314,3578730343,29
0,983,19462,3578730314,3578730343,29
0,983,19463,3578730314,3578730344,30
0,983,19464,3578730314,3578730345,31
0,983,19465,3578730314,3578730345,31
0,983,19466,3578730314,3578730346,32
0,983,19467,3578730314,3578730347,33
0,983,19468,3578730314,3578730347,33
0,983,19469,3578730314,3578730348,34
0,983,19470,3578730314,3578730351,37
0,983,19471,3578730314,3578730353,39
0,983,19472,3578730314,3578730353,39
0,983,19473,3578730314,3578730355,41
0,983,19474,3578730314,3578730358,44
0,983,19475,3578730314,3578730360,46
0,983,19476,3578730314,3578730361,47
0,983,19477,3578730314,3578730361,47
0,983,19478,3578730314,3578730361,47
0,983,19479,3578730314,3578730362,48
0,983,19480,3578730314,3578730363,49
0,983,19481,3578730314,3578730364,50
0,984,19482,3578730372,3578730372,0
0,984,19483,3578730372,3578730372,0
0,984,19484,3578730372,3578730372,0
0,984,19485,3578730372,3578730372,0
0,984,19486,3578730372,3578730372,0
0,984,19487,3578730372,3578730372,0
0,984,19488,3578730372,3578730372,0
0,984,19489,3578730372,3578730373,1
0,984,19490,3578730372,3578730373,1
0,984,19491,3578730372,3578730373,1
0,984,19492,3578730372,3578730373,1
0,984,19493,3578730372,3578730373,1
0,984,19494,3578730372,3578730374,2
0,984,19495,3578730372,3578730375,3
0,984,19496,3578730372,3578730377,5
0,984,19497,3578730372,3578730379,7
0,984,19498,3578730372,3578730380,8
0,984,19499,3578730372,3578730380,8
0,984,19500,3578730372,3578730381,9
0,984,19501,3578730372,3578730381,9
0,984,19502,3578730372,3578730385,13
0,984,19503,3578730372,3578730385,13
0,984,19504,3578730372,3578730387,15
0,984,19505,3578730372,3578730388,16
0,984,19506,3578730372,3578730389,17
0,984,19507,3578730372,3578730390,18
0,984,19508,3578730372,3578730391,19
0,984,19509,3578730372,3578730392,20
0,984,19510,3578730372,3578730393,21
0,984,19511,3578730372,3578730394,22
0,984,19512,3578730372,3578730398,26
0,984,19513,3578730372,3578730398,26
0,984,19514,3578730372,3578730399,27
0,984,19515,3578730372,3578730399,27
0,984,19516,3578730372,3578730401,29
0,984,19517,3578730372,3578730402,30
0,984,19518,3578730372,3578730404,32
0,984,19519,3578730372,3578730405,33
0,984,19520,3578730372,3578730405,33
0,984,19521,3578730372,3578730407,35
0,984,19522,3578730372,3578730411,39
0,984,19523,3578730372,3578730411,39
0,984,19524,3578730372,3578730411,39
0,984,19525,3578730372,3578730413,41
0,984,19526,3578730372,3578730413,41
0,984,19527,3578730372,3578730415,43
0,984,19528,3578730372,3578730416,44
0,984,19529,3578730372,3578730417,45
0,984,19530,3578730372,3578730419,47
0,984,19531,3578730372,3578730419,47
0,984,19532,3578730372,3578730420,48
0,985,19533,3578730431,3578730431,0
0,985,19534,3578730431,3578730431,0
0,985,19535,3578730431,3578730431,0
0,985,19536,3578730431,3578730431,0
0,985,19537,3578730431,3578730432,1
0,985,19538,3578730431,3578730432,1
0,985,19539,3578730431,3578730433,2
0,985,19540,3578730431,3578730433,2
0,985,19541,3578730431,3578730434,3
0,985,19542,3578730431,3578730435,4
0,985,19543,3578730431,3578730435,4
0,985,19544,3578730431,3578730440,9
0,985,19545,3578730431,3578730442,11
0,985,19546,3578730431,3578730442,11
0,985,19547,3578730431,3578730443,12
0,985,19548,3578730431,3578730444,13
0,985,19549,3578730431,3578730446,15
0,985,19550,3578730431,3578730447,16
0,985,19551,3578730431,3578730449,18
0,985,19552,3578730431,3578730449,18
0,985,19553,3578730431,3578730450,19
0,985,19554,3578730431,3578730450,19
0,985,19555,3578730431,3578730453,22
0,985,19556,3578730431,3578730455,24
0,985,19557,3578730431,3578730457,26
0,985,19558,3578730431,3578730458,27
0,985,19559,3578730431,3578730459,28
0,985,19560,3578730431,3578730460,29
0,985,19561,3578730431,3578730463,32
0,985,19562,3578730431,3578730463,32
0,985,19563,3578730431,3578730463,32
0,985,19564,3578730431,3578730463,32
0,985,19565,3578730431,3578730464,33
0,985,19566,3578730431,3578730465,34
0,985,19567,3578730431,3578730467,36
0,985,19568,3578730431,3578730467,36
0,985,19569,3578730431,3578730467,36
0,985,19570,3578730431,3578730468,37
0,985,19571,3578730431,3578730468,37
0,985,19572,3578730431,3578730469,38
0,985,19573,3578730431,3578730469,38
0,985,19574,3578730431,3578730472,41
0,985,19575,3578730431,3578730473,42
0,985,19576,3578730431,3578730479,48
0,985,19577,3578730431,3578730480,49
0,985,19578,3578730431,3578730481,50
0,986,19579,3578730489,3578730489,0
0,986,19580,3578730489,3578730489,0
0,986,19581,3578730489,3578730489,0
0,986,19582,3578730489,3578730489,0
0,986,19583,3578730489,3578730489,0
0,986,19584,3578730489,3578730489,0
0,986,19585,3578730489,3578730489,0
0,986,19586,3578730489,3578730489,0
0,986,19587,3578730489,3578730489,0
0,986,19588,3578730489,3578730490,1
0,986,19589,3578730489,3578730490,1
0,986,19590,3578730489,3578730491,2
0,986,19591,3578730489,3578730491,2
0,986,19592,3578730489,3578730492,3
0,986,19593,3578730489,3578730495,6
0,986,19594,3578730489,3578730497,8
0,986,19595,3578730489,3578730497,8
0,986,19596,3578730489,3578730497,8
0,986,19597,3578730489,3578730498,9
0,986,19598,3578730489,3578730499,10
0,986,19599,3578730489,3578730499,10
0,986,19600,3578730489,3578730500,11
0,986,19601,3578730489,3578730501,12
0,986,19602,3578730489,3578730503,14
0,986,19603,3578730489,3578730505,16
0,986,19604,3578730489,3578730505,16
0,986,19605,3578730489,3578730506,17
0,986,19606,3578730489,3578730506,17
0,986,19607,3578730489,3578730507,18
0,986,19608,3578730489,3578730507,18
0,986,19609,3578730489,3578730507,18
0,986,19610,3578730489,3578730507,18
0,986,19611,3578730489,3578730507,18
0,986,19612,3578730489,3578730508,19
0,986,19613,3578730489,3578730508,19
0,986,19614,3578730489,3578730509,20
0,986,19615,3578730489,3578730509,20
0,986,19616,3578730489,3578730509,20
0,986,19617,3578730489,3578730510,21
0,986,19618,3578730489,3578730511,22
0,986,19619,3578730489,3578730514,25
0,986,19620,3578730489,3578730514,25
0,986,19621,3578730489,3578730515,26
0,986,19622,3578730489,3578730515,26
0,986,19623,3578730489,3578730516,27
0,986,19624,3578730489,3578730516,27
0,986,19625,3578730489,3578730517,28
0,986,19626,3578730489,3578730518,29
0,986,19627,3578730489,3578730518,29
0,986,19628,3578730489,3578730519,30
0,986,19629,3578730489,3578730520,31
0,986,19630,3578730489,3578730522,33
0,986,19631,3578730489,3578730523,34
0,986,19632,3578730489,3578730523,34
0,986,19633,3578730489,3578730524,35
0,986,19634,3578730489,3578730525,36
0,986,19635,3578730489,3578730527,38
0,986,19636,3578730489,3578730527,38
0,986,19637,3578730489,3578730529,40
0,986,19638,3578730489,3578730530,41
0,986,19639,3578730489,3578730530,41
0,986,19640,3578730489,3578730530,41
0,986,19641,3578730489,3578730532,43
0,986,19642,3578730489,3578730533,44
0,986,19643,3578730489,3578730533,44
0,986,19644,3578730489,3578730534,45
0,986,19645,3578730489,3578730535,46
0,986,19646,3578730489,3578730535,46
0,986,19647,3578730489,3578730539,50
0,987,19648,3578730546,3578730546,0
0,987,19649,3578730546,3578730546,0
0,987,19650,3578730546,3578730546,0
0,987,19651,3578730546,3578730546,0
0,987,19652,3578730546,3578730546,0
0,987,19653,3578730546,3578730546,0
0,987,19654,3578730546,3578730546,0
0,987,19655,3578730546,3578730546,0
0,987,19656,3578730546,3578730547,1
0,987,19657,3578730546,3578730547,1
0,987,19658,3578730546,3578730547,1
0,987,19659,3578730546,3578730550,4
0,987,19660,3578730546,3578730550,4
0,987,19661,3578730546,3578730552,6
0,987,19662,3578730546,3578730552,6
0,987,19663,3578730546,3578730553,7
0,987,19664,3578730546,3578730555,9
0,987,19665,3578730546,3578730558,12
0,987,19666,3578730546,3578730558,12
0,987,19667,3578730546,3578730559,13
0,987,19668,3578730546,3578730560,14
0,987,19669,3578730546,3578730561,15
0,987,19670,3578730546,3578730561,15
0,987,19671,3578730546,3578730562,16
0,987,19672,3578730546,3578730562,16
0,987,19673,3578730546,3578730563,17
0,987,19674,3578730546,3578730565,19
0,987,19675,3578730546,3578730566,20
0,987,19676,3578730546,3578730567,21
0,987,19677,3578730546,3578730568,22
0,987,19678,3578730546,3578730569,23
0,987,19679,3578730546,3578730571,25
0,987,19680,3578730546,3578730572,26
0,987,19681,3578730546,3578730572,26
0,987,19682,3578730546,3578730573,27
0,987,19683,3578730546,3578730573,27
0,987,19684,3578730546,3578730575,29
0,987,19685,3578730546,3578730576,30
0,987,19686,3578730546,3578730578,32
0,987,19687,3578730546,3578730579,33
0,987,19688,3578730546,3578730579,33
0,987,19689,3578730546,3578730580,34
0,987,19690,3578730546,3578730580,34
0,987,19691,3578730546,3578730581,35
0,987,19692,3578730546,3578730584,38
0,987,19693,3578730546,3578730585,39
0,987,19694,3578730546,3578730587,41
0,987,19695,3578730546,3578730587,41
0,987,19696,3578730546,3578730588,42
0,987,19697,3578730546,3578730590,44
0,987,19698,3578730546,3578730590,44
0,987,19699,3578730546,3578730591,45
0,987,19700,3578730546,3578730592,46
0,987,19701,3578730546,3578730593,47
0,987,19702,3578730546,3578730594,48
0,987,19703,3578730546,3578730594,48
0,988,19704,3578730605,3578730605,0
0,988,19705,3578730605,3578730605,0
0,988,19706,3578730605,3578730605,0
0,988,19707,3578730605,3578730605,0
0,988,19708,3578730605,3578730605,0
0,988,19709,3578730605,3578730605,0
0,988,19710,3578730605,3578730605,0
0,988,19711,3578730605,3578730605,0
0,988,19712,3578730605,3578730605,0
0,988,19713,3578730605,3578730605,0
0,988,19714,3578730605,3578730605,0
0,988,19715,3578730605,3578730606,1
0,988,19716,3578730605,3578730610,5
0,988,19717,3578730605,3578730611,6
0,988,19718,3578730605,3578730611,6
0,988,19719,3578730605,3578730612,7
0,988,19720,3578730605,3578730614,9
0,988,19721,3578730605,3578730614,9
0,988,19722,3578730605,3578730616,11
0,988,19723,3578730605,3578730616,11
0,988,19724,3578730605,3578730618,13
0,988,19725,3578730605,3578730618,13
0,988,19726,3578730605,3578730619,14
0,988,19727,3578730605,3578730619,14
0,988,19728,3578730605,3578730621,16
0,988,19729,3578730605,3578730624,19
0,988,19730,3578730605,3578730626,21
0,988,19731,3578730605,3578730629,24
0,988,19732,3578730605,3578730629,24
0,988,19733,3578730605,3578730632,27
0,988,19734,3578730605,3578730632,27
0,988,19735,3578730605,3578730632,27
0,988,19736,3578730605,3578730633,28
0,988,19737,3578730605,3578730635,30
0,988,19738,3578730605,3578730636,31
0,988,19739,3578730605,3578730638,33
0,988,19740,3578730605,3578730641,36
0,988,19741,3578730605,3578730642,37
0,988,19742,3578730605,3578730643,38
0,988,19743,3578730605,3578730644,39
0,988,19744,3578730605,3578730645,40
0,988,19745,3578730605,3578730648,43
0,988,19746,3578730605,3578730648,43
0,988,19747,3578730605,3578730649,44
0,988,19748,3578730605,3578730650,45
0,988,19749,3578730605,3578730652,47
0,988,19750,3578730605,3578730653,48
0,988,19751,3578730605,3578730654,49
0,988,19752,3578730605,3578730654,49
0,989,19753,3578730664,3578730665,1
0,989,19754,3578730664,3578730665,1
0,989,19755,3578730664,3578730665,1
0,989,19756,3578730664,3578730665,1
0,989,19757,3578730664,3578730665,1
0,989,19758,3578730664,3578730665,1
0,989,19759,3578730664,3578730665,1
0,989,19760,3578730664,3578730665,1
0,989,19761,3578730664,3578730665,1
0,989,19762,3578730664,3578730665,1
0,989,19763,3578730664,3578730665,1
0,989,19764,3578730664,3578730666,2
0,989,19765,3578730664,3578730667,3
0,989,19766,3578730664,3578730668,4
0,989,19767,3578730664,3578730668,4
0,989,19768,3578730664,3578730669,5
0,989,19769,3578730664,3578730669,5
0,989,19770,3578730664,3578730672,8
0,989,19771,3578730664,3578730673,9
0,989,19772,3578730664,3578730679,15
0,989,19773,3578730664,3578730680,16
0,989,19774,3578730664,3578730681,17
0,989,19775,3578730664,3578730681,17
0,989,19776,3578730664,3578730682,18
0,989,19777,3578730664,3578730683,19
0,989,19778,3578730664,3578730684,20
0,989,19779,3578730664,3578730685,21
0,989,19780,3578730664,3578730686,22
0,989,19781,3578730664,3578730686,22
0,989,19782,3578730664,3578730687,23
0,989,19783,3578730664,3578730688,24
0,989,19784,3578730664,3578730689,25
0,989,19785,3578730664,3578730690,26
0,989,19786,3578730664,3578730691,27
0,989,19787,3578730664,3578730691,27
0,989,19788,3578730664,3578730693,29
0,989,19789,3578730664,3578730696,32
0,989,19790,3578730664,3578730696,32
0,989,19791,3578730664,3578730697,33
0,989,19792,3578730664,3578730697,33
0,989,19793,3578730664,3578730699,35
0,989,19794,3578730664,3578730700,36
0,989,19795,3578730664,3578730700,36
0,989,19796,3578730664,3578730701,37
0,989,19797,3578730664,3578730703,39
0,989,19798,3578730664,3578730704,40
0,989,19799,3578730664,3578730705,41
0,989,19800,3578730664,3578730705,41
0,989,19801,3578730664,3578730706,42
0,989,19802,3578730664,3578730706,42
0,989,19803,3578730664,3578730706,42
0,989,19804,3578730664,3578730707,43
0,989,19805,3578730664,3578730707,43
0,989,19806,3578730664,3578730707,43
0,989,19807,3578730664,3578730707,43
0,989,19808,3578730664,3578730708,44
0,989,19809,3578730664,3578730708,44
0,989,19810,3578730664,3578730708,44
0,989,19811,3578730664,3578730709,45
0,989,19812,3578730664,3578730709,45
0,989,19813,3578730664,3578730709,45
0,989,19814,3578730664,3578730710,46
0,989,19815,3578730664,3578730710,46
0,989,19816,3578730664,3578730711,47
0,990,19817,3578730723,3578730723,0
0,990,19818,3578730723,3578730723,0
0,990,19819,3578730723,3578730723,0
0,990,19820,3578730723,3578730723,0
0,990,19821,3578730723,3578730723,0
0,990,19822,3578730723,3578730723,0
0,990,19823,3578730723,3578730723,0
0,990,19824,3578730723,3578730723,0
0,990,19825,3578730723,3578730723,0
0,990,19826,3578730723,3578730723,0
0,990,19827,3578730723,3578730723,0
0,990,19828,3578730723,3578730723,0
0,990,19829,3578730723,3578730724,1
0,990,19830,3578730723,3578730725,2
0,990,19831,3578730723,3578730726,3
0,990,19832,3578730723,3578730727,4
0,990,19833,3578730723,3578730727,4
0,990,19834,3578730723,3578730729,6
0,990,19835,3578730723,3578730730,7
0,990,19836,3578730723,3578730731,8
0,990,19837,3578730723,3578730732,9
0,990,19838,3578730723,3578730733,10
0,990,19839,3578730723,3578730733,10
0,990,19840,3578730723,3578730734,11
0,990,19841,3578730723,3578730734,11
0,990,19842,3578730723,3578730735,12
0,990,19843,3578730723,3578730739,16
0,990,19844,3578730723,3578730739,16
0,990,19845,3578730723,3578730740,17
0,990,19846,3578730723,3578730742,19
0,990,19847,3578730723,3578730743,20
0,990,19848,3578730723,3578730744,21
0,990,19849,3578730723,3578730744,21
0,990,19850,3578730723,3578730745,22
0,990,19851,3578730723,3578730745,22
0,990,19852,3578730723,3578730746,23
0,990,19853,3578730723,3578730747,24
0,990,19854,3578730723,3578730748,25
0,990,19855,3578730723,3578730751,28
0,990,19856,3578730723,3578730752,29
0,990,19857,3578730723,3578730752,29
0,990,19858,3578730723,3578730753,30
0,990,19859,3578730723,3578730754,31
0,990,19860,3578730723,3578730758,35
0,990,19861,3578730723,3578730759,36
0,990,19862,3578730723,3578730760,37
0,990,19863,3578730723,3578730761,38
0,990,19864,3578730723,3578730761,38
0,990,19865,3578730723,3578730762,39
0,990,19866,3578730723,3578730763,40
0,990,19867,3578730723,3578730764,41
0,990,19868,3578730723,3578730765,42
0,990,19869,3578730723,3578730766,43
0,990,19870,3578730723,3578730767,44
0,990,19871,3578730723,3578730768,45
0,990,19872,3578730723,3578730769,46
0,990,19873,3578730723,3578730771,48
0,990,19874,3578730723,3578730772,49
0,990,19875,3578730723,3578730773,50
0,991,19876,3578730781,3578730781,0
0,991,19877,3578730781,3578730781,0
0,991,19878,3578730781,3578730781,0
0,991,19879,3578730781,3578730781,0
0,991,19880,3578730781,3578730781,0
0,991,19881,3578730781,3578730781,0
0,991,19882,3578730781,3578730781,0
0,991,19883,3578730781,3578730781,0
0,991,19884,3578730781,3578730781,0
0,991,19885,3578730781,3578730785,4
0,991,19886,3578730781,3578730785,4
0,991,19887,3578730781,3578730786,5
0,991,19888,3578730781,3578730788,7
0,991,19889,3578730781,3578730789,8
0,991,19890,3578730781,3578730789,8
0,991,19891,3578730781,3578730790,9
0,991,19892,3578730781,3578730791,10
0,991,19893,3578730781,3578730792,11
0,991,19894,3578730781,3578730794,13
0,991,19895,3578730781,3578730794,13
0,991,19896,3578730781,3578730797,16
0,991,19897,3578730781,3578730797,16
0,991,19898,3578730781,3578730799,18
0,991,19899,3578730781,3578730799,18
0,991,19900,3578730781,3578730800,19
0,991,19901,3578730781,3578730802,21
0,991,19902,3578730781,3578730804,23
0,991,19903,3578730781,3578730804,23
0,991,19904,3578730781,3578730805,24
0,991,19905,3578730781,3578730805,24
0,991,19906,3578730781,3578730806,25
0,991,19907,3578730781,3578730809,28
0,991,19908,3578730781,3578730810,29
0,991,19909,3578730781,3578730811,30
0,991,19910,3578730781,3578730811,30
0,991,19911,3578730781,3578730812,31
0,991,19912,3578730781,3578730812,31
0,991,19913,3578730781,3578730815,34
0,991,19914,3578730781,3578730815,34
0,991,19915,3578730781,3578730816,35
0,991,19916,3578730781,3578730816,35
0,991,19917,3578730781,3578730818,37
0,991,19918,3578730781,3578730818,37
0,991,19919,3578730781,3578730819,38
0,991,19920,3578730781,3578730819,38
0,991,19921,3578730781,3578730821,40
0,991,19922,3578730781,3578730821,40
0,991,19923,3578730781,3578730824,43
0,991,19924,3578730781,3578730825,44
0,991,19925,3578730781,3578730826,45
0,991,19926,3578730781,3578730829,48
0,991,19927,3578730781,3578730829,48
0,992,19928,3578730839,3578730839,0
0,992,19929,3578730839,3578730839,0
0,992,19930,3578730839,3578730839,0
0,992,19931,3578730839,3578730839,0
0,992,19932,3578730839,3578730839,0
0,992,19933,3578730839,3578730839,0
0,992,19934,3578730839,3578730840,1
0,992,19935,3578730839,3578730841,2
0,992,19936,3578730839,3578730843,4
0,992,19937,3578730839,3578730843,4
0,992,19938,3578730839,3578730844,5
0,992,19939,3578730839,3578730845,6
0,992,19940,3578730839,3578730846,7
0,992,19941,3578730839,3578730848,9
0,992,19942,3578730839,3578730849,10
0,992,19943,3578730839,3578730850,11
0,992,19944,3578730839,3578730853,14
0,992,19945,3578730839,3578730854,15
0,992,19946,3578730839,3578730854,15
0,992,19947,3578730839,3578730857,18
0,992,19948,3578730839,3578730857,18
0,992,19949,3578730839,3578730858,19
0,992,19950,3578730839,3578730858,19
0,992,19951,3578730839,3578730859,20
0,992,19952,3578730839,3578730862,23
0,992,19953,3578730839,3578730862,23
0,992,19954,3578730839,3578730863,24
0,992,19955,3578730839,3578730863,24
0,992,19956,3578730839,3578730864,25
0,992,19957,3578730839,3578730865,26
0,992,19958,3578730839,3578730866,27
0,992,19959,3578730839,3578730866,27
0,992,19960,3578730839,3578730868,29
0,992,19961,3578730839,3578730869,30
0,992,19962,3578730839,3578730869,30
0,992,19963,3578730839,3578730870,31
0,992,19964,3578730839,3578730872,33
0,992,19965,3578730839,3578730873,34
0,992,19966,3578730839,3578730879,40
0,992,19967,3578730839,3578730881,42
0,992,19968,3578730839,3578730881,42
0,992,19969,3578730839,3578730881,42
0,992,19970,3578730839,3578730882,43
0,992,19971,3578730839,3578730883,44
0,992,19972,3578730839,3578730884,45
0,992,19973,3578730839,3578730885,46
0,992,19974,3578730839,3578730885,46
0,992,19975,3578730839,3578730886,47
0,992,19976,3578730839,3578730887,48
0,992,19977,3578730839,3578730887,48
0,992,19978,3578730839,3578730888,49
0,992,19979,3578730839,3578730889,50
0,993,19980,3578730896,3578730896,0
0,993,19981,3578730896,3578730897,1
0,993,19982,3578730896,3578730897,1
0,993,19983,3578730896,3578730897,1
0,993,19984,3578730896,3578730897,1
0,993,19985,3578730896,3578730897,1
0,993,19986,3578730896,3578730897,1
0,993,19987,3578730896,3578730897,1
0,993,19988,3578730896,3578730898,2
0,993,19989,3578730896,3578730899,3
0,993,19990,3578730896,3578730900,4
0,993,19991,3578730896,3578730901,5
0,993,19992,3578730896,3578730901,5
0,993,19993,3578730896,3578730905,9
0,993,19994,3578730896,3578730905,9
0,993,19995,3578730896,3578730906,10
0,993,19996,3578730896,3578730906,10
0,993,19997,3578730896,3578730906,10
0,993,19998,3578730896,3578730907,11
0,993,19999,3578730896,3578730907,11
0,993,20000,3578730896,3578730907,11
0,993,20001,3578730896,3578730908,12
0,993,20002,3578730896,3578730908,12
0,993,20003,3578730896,3578730908,12
0,993,20004,3578730896,3578730908,12
0,993,20005,3578730896,3578730909,13
0,993,20006,3578730896,3578730909,13
0,993,20007,3578730896,3578730910,14
0,993,20008,3578730896,3578730910,14
0,993,20009,3578730896,3578730910,14
0,993,20010,3578730896,3578730911,15
0,993,20011,3578730896,3578730914,18
0,993,20012,3578730896,3578730914,18
0,993,20013,3578730896,3578730915,19
0,993,20014,3578730896,3578730915,19
0,993,20015,3578730896,3578730916,20
0,993,20016,3578730896,3578730917,21
0,993,20017,3578730896,3578730917,21
0,993,20018,3578730896,3578730918,22
0,993,20019,3578730896,3578730918,22
0,993,20020,3578730896,3578730919,23
0,993,20021,3578730896,3578730920,24
0,993,20022,3578730896,3578730922,26
0,993,20023,3578730896,3578730922,26
0,993,20024,3578730896,3578730924,28
0,993,20025,3578730896,3578730926,30
0,993,20026,3578730896,3578730927,31
0,993,20027,3578730896,3578730927,31
0,993,20028,3578730896,3578730928,32
0,993,20029,3578730896,3578730929,33
0,993,20030,3578730896,3578730930,34
0,993,20031,3578730896,3578730931,35
0,993,20032,3578730896,3578730931,35
0,993,20033,3578730896,3578730932,36
0,993,20034,3578730896,3578730934,38
0,993,20035,3578730896,3578730936,40
0,993,20036,3578730896,3578730936,40
0,993,20037,3578730896,3578730941,45
0,993,20038,3578730896,3578730941,45
0,993,20039,3578730896,3578730943,47
0,993,20040,3578730896,3578730943,47
0,993,20041,3578730896,3578730944,48
0,993,20042,3578730896,3578730944,48
0,993,20043,3578730896,3578730944,48
0,993,20044,3578730896,3578730945,49
0,994,20045,3578730953,3578730953,0
0,994,20046,3578730953,3578730953,0
0,994,20047,3578730953,3578730953,0
0,994,20048,3578730953,3578730953,0
0,994,20049,3578730953,3578730955,2
0,994,20050,3578730953,3578730959,6
0,994,20051,3578730953,3578730959,6
0,994,20052,3578730953,3578730960,7
0,994,20053,3578730953,3578730960,7
0,994,20054,3578730953,3578730961,8
0,994,20055,3578730953,3578730961,8
0,994,20056,3578730953,3578730962,9
0,994,20057,3578730953,3578730963,10
0,994,20058,3578730953,3578730963,10
0,994,20059,3578730953,3578730965,12
0,994,20060,3578730953,3578730966,13
0,994,20061,3578730953,3578730967,14
0,994,20062,3578730953,3578730967,14
0,994,20063,3578730953,3578730968,15
0,994,20064,3578730953,3578730969,16
0,994,20065,3578730953,3578730971,18
0,994,20066,3578730953,3578730972,19
0,994,20067,3578730953,3578730973,20
0,994,20068,3578730953,3578730974,21
0,994,20069,3578730953,3578730975,22
0,994,20070,3578730953,3578730978,25
0,994,20071,3578730953,3578730979,26
0,994,20072,3578730953,3578730981,28
0,994,20073,3578730953,3578730981,28
0,994,20074,3578730953,3578730981,28
0,994,20075,3578730953,3578730985,32
0,994,20076,3578730953,3578730985,32
0,994,20077,3578730953,3578730986,33
0,994,20078,3578730953,3578730987,34
0,994,20079,3578730953,3578730988,35
0,994,20080,3578730953,3578730988,35
0,994,20081,3578730953,3578730990,37
0,994,20082,3578730953,3578730990,37
0,994,20083,3578730953,3578730991,38
0,994,20084,3578730953,3578730992,39
0,994,20085,3578730953,3578730994,41
0,994,20086,3578730953,3578730994,41
0,994,20087,3578730953,3578730995,42
0,994,20088,3578730953,3578730997,44
0,994,20089,3578730953,3578730998,45
0,994,20090,3578730953,3578730999,46
0,994,20091,3578730953,3578730999,46
0,994,20092,3578730953,3578731001,48
0,994,20093,3578730953,3578731002,49
0,995,20094,3578731011,3578731011,0
0,995,20095,3578731011,3578731011,0
0,995,20096,3578731011,3578731011,0
0,995,20097,3578731011,3578731011,0
0,995,20098,3578731011,3578731011,0
0,995,20099,3578731011,3578731011,0
0,995,20100,3578731011,3578731011,0
0,995,20101,3578731011,3578731011,0
0,995,20102,3578731011,3578731011,0
0,995,20103,3578731011,3578731012,1
0,995,20104,3578731011,3578731013,2
0,995,20105,3578731011,3578731016,5
0,995,20106,3578731011,3578731016,5
0,995,20107,3578731011,3578731017,6
0,995,20108,3578731011,3578731018,7
0,995,20109,3578731011,3578731018,7
0,995,20110,3578731011,3578731019,8
0,995,20111,3578731011,3578731019,8
0,995,20112,3578731011,3578731020,9
0,995,20113,3578731011,3578731021,10
0,995,20114,3578731011,3578731022,11
0,995,20115,3578731011,3578731024,13
0,995,20116,3578731011,3578731026,15
0,995,20117,3578731011,3578731029,18
0,995,20118,3578731011,3578731030,19
0,995,20119,3578731011,3578731033,22
0,995,20120,3578731011,3578731034,23
0,995,20121,3578731011,3578731035,24
0,995,20122,3578731011,3578731035,24
0,995,20123,3578731011,3578731036,25
0,995,20124,3578731011,3578731036,25
0,995,20125,3578731011,3578731040,29
0,995,20126,3578731011,3578731041,30
0,995,20127,3578731011,3578731043,32
0,995,20128,3578731011,3578731045,34
0,995,20129,3578731011,3578731045,34
0,995,20130,3578731011,3578731047,36
0,995,20131,3578731011,3578731049,38
0,995,20132,3578731011,3578731050,39
0,995,20133,3578731011,3578731050,39
0,995,20134,3578731011,3578731053,42
0,995,20135,3578731011,3578731053,42
0,995,20136,3578731011,3578731054,43
0,995,20137,3578731011,3578731057,46
0,995,20138,3578731011,3578731058,47
0,995,20139,3578731011,3578731058,47
0,995,20140,3578731011,3578731058,47
0,995,20141,3578731011,3578731059,48
0,996,20142,3578731069,3578731069,0
0,996,20143,3578731069,3578731069,0
0,996,20144,3578731069,3578731069,0
0,996,20145,3578731069,3578731069,0
0,996,20146,3578731069,3578731069,0
0,996,20147,3578731069,3578731069,0
0,996,20148,3578731069,3578731069,0
0,996,20149,3578731069,3578731069,0
0,996,20150,3578731069,3578731069,0
0,996,20151,3578731069,3578731069,0
0,996,20152,3578731069,3578731069,0
0,996,20153,3578731069,3578731069,0
0,996,20154,3578731069,3578731069,0
0,996,20155,3578731069,3578731073,4
0,996,20156,3578731069,3578731073,4
0,996,20157,3578731069,3578731080,11
0,996,20158,3578731069,3578731080,11
0,996,20159,3578731069,3578731081,12
0,996,20160,3578731069,3578731082,13
0,996,20161,3578731069,3578731082,13
0,996,20162,3578731069,3578731083,14
0,996,20163,3578731069,3578731084,15
0,996,20164,3578731069,3578731085,16
0,996,20165,3578731069,3578731086,17
0,996,20166,3578731069,3578731086,17
0,996,20167,3578731069,3578731087,18
0,996,20168,3578731069,3578731088,19
0,996,20169,3578731069,3578731089,20
0,996,20170,3578731069,3578731089,20
0,996,20171,3578731069,3578731091,22
0,996,20172,3578731069,3578731091,22
0,996,20173,3578731069,3578731092,23
0,996,20174,3578731069,3578731093,24
0,996,20175,3578731069,3578731094,25
0,996,20176,3578731069,3578731097,28
0,996,20177,3578731069,3578731097,28
0,996,20178,3578731069,3578731097,28
0,996,20179,3578731069,3578731098,29
0,996,20180,3578731069,3578731099,30
0,996,20181,3578731069,3578731099,30
0,996,20182,3578731069,3578731101,32
0,996,20183,3578731069,3578731105,36
0,996,20184,3578731069,3578731105,36
0,996,20185,3578731069,3578731105,36
0,996,20186,3578731069,3578731106,37
0,996,20187,3578731069,3578731106,37
0,996,20188,3578731069,3578731107,38
0,996,20189,3578731069,3578731107,38
0,996,20190,3578731069,3578731107,38
0,996,20191,3578731069,3578731108,39
0,996,20192,3578731069,3578731108,39
0,996,20193,3578731069,3578731108,39
0,996,20194,3578731069,3578731109,40
0,996,20195,3578731069,3578731110,41
0,996,20196,3578731069,3578731110,41
0,996,20197,3578731069,3578731110,41
0,996,20198,3578731069,3578731110,41
0,996,20199,3578731069,3578731111,42
0,996,20200,3578731069,3578731112,43
0,996,20201,3578731069,3578731112,43
0,996,20202,3578731069,3578731115,46
0,996,20203,3578731069,3578731116,47
0,996,20204,3578731069,3578731116,47
0,996,20205,3578731069,3578731116,47
0,996,20206,3578731069,3578731117,48
0,996,20207,3578731069,3578731117,48
0,996,20208,3578731069,3578731118,49
0,996,20209,3578731069,3578731119,50
0,997,20210,3578731129,3578731129,0
0,997,20211,3578731129,3578731129,0
0,997,20212,3578731129,3578731129,0
0,997,20213,3578731129,3578731129,0
0,997,20214,3578731129,3578731129,0
0,997,20215,3578731129,3578731129,0
0,997,20216,3578731129,3578731129,0
0,997,20217,3578731129,3578731129,0
0,997,20218,3578731129,3578731130,1
0,997,20219,3578731129,3578731131,2
0,997,20220,3578731129,3578731131,2
0,997,20221,3578731129,3578731131,2
0,997,20222,3578731129,3578731131,2
0,997,20223,3578731129,3578731132,3
0,997,20224,3578731129,3578731133,4
0,997,20225,3578731129,3578731136,7
0,997,20226,3578731129,3578731136,7
0,997,20227,3578731129,3578731138,9
0,997,20228,3578731129,3578731141,12
0,997,20229,3578731129,3578731141,12
0,997,20230,3578731129,3578731143,14
0,997,20231,3578731129,3578731144,15
0,997,20232,3578731129,3578731144,15
0,997,20233,3578731129,3578731144,15
0,997,20234,3578731129,3578731145,16
0,997,20235,3578731129,3578731148,19
0,997,20236,3578731129,3578731148,19
0,997,20237,3578731129,3578731150,21
0,997,20238,3578731129,3578731152,23
0,997,20239,3578731129,3578731153,24
0,997,20240,3578731129,3578731155,26
0,997,20241,3578731129,3578731160,31
0,997,20242,3578731129,3578731160,31
0,997,20243,3578731129,3578731160,31
0,997,20244,3578731129,3578731161,32
0,997,20245,3578731129,3578731161,32
0,997,20246,3578731129,3578731162,33
0,997,20247,3578731129,3578731163,34
0,997,20248,3578731129,3578731163,34
0,997,20249,3578731129,3578731164,35
0,997,20250,3578731129,3578731166,37
0,997,20251,3578731129,3578731167,38
0,997,20252,3578731129,3578731167,38
0,997,20253,3578731129,3578731167,38
0,997,20254,3578731129,3578731168,39
0,997,20255,3578731129,3578731168,39
0,997,20256,3578731129,3578731169,40
0,997,20257,3578731129,3578731172,43
0,997,20258,3578731129,3578731172,43
0,997,20259,3578731129,3578731174,45
0,997,20260,3578731129,3578731174,45
0,997,20261,3578731129,3578731175,46
0,997,20262,3578731129,3578731179,50
0,998,20263,3578731189,3578731189,0
0,998,20264,3578731189,3578731189,0
0,998,20265,3578731189,3578731189,0
0,998,20266,3578731189,3578731189,0
0,998,20267,3578731189,3578731189,0
0,998,20268,3578731189,3578731189,0
0,998,20269,3578731189,3578731190,1
0,998,20270,3578731189,3578731191,2
0,998,20271,3578731189,3578731191,2
0,998,20272,3578731189,3578731192,3
0,998,20273,3578731189,3578731194,5
0,998,20274,3578731189,3578731194,5
0,998,20275,3578731189,3578731194,5
0,998,20276,3578731189,3578731198,9
0,998,20277,3578731189,3578731198,9
0,998,20278,3578731189,3578731199,10
0,998,20279,3578731189,3578731200,11
0,998,20280,3578731189,3578731201,12
0,998,20281,3578731189,3578731202,13
0,998,20282,3578731189,3578731205,16
0,998,20283,3578731189,3578731206,17
0,998,20284,3578731189,3578731206,17
0,998,20285,3578731189,3578731207,18
0,998,20286,3578731189,3578731209,20
0,998,20287,3578731189,3578731209,20
0,998,20288,3578731189,3578731210,21
0,998,20289,3578731189,3578731211,22
0,998,20290,3578731189,3578731211,22
0,998,20291,3578731189,3578731212,23
0,998,20292,3578731189,3578731212,23
0,998,20293,3578731189,3578731215,26
0,998,20294,3578731189,3578731216,27
0,998,20295,3578731189,3578731216,27
0,998,20296,3578731189,3578731217,28
0,998,20297,3578731189,3578731219,30
0,998,20298,3578731189,3578731219,30
0,998,20299,3578731189,3578731219,30
0,998,20300,3578731189,3578731220,31
0,998,20301,3578731189,3578731220,31
0,998,20302,3578731189,3578731222,33
0,998,20303,3578731189,3578731225,36
0,998,20304,3578731189,3578731227,38
0,998,20305,3578731189,3578731230,41
0,998,20306,3578731189,3578731230,41
0,998,20307,3578731189,3578731232,43
0,998,20308,3578731189,3578731232,43
0,998,20309,3578731189,3578731233,44
0,998,20310,3578731189,3578731234,45
0,998,20311,3578731189,3578731234,45
0,998,20312,3578731189,3578731236,47
0,998,20313,3578731189,3578731237,48
0,998,20314,3578731189,3578731237,48
0,999,20315,3578731247,3578731247,0
0,999,20316,3578731247,3578731247,0
0,999,20317,3578731247,3578731247,0
0,999,20318,3578731247,3578731247,0
0,999,20319,3578731247,3578731248,1
0,999,20320,3578731247,3578731249,2
0,999,20321,3578731247,3578731249,2
0,999,20322,3578731247,3578731250,3
0,999,20323,3578731247,3578731253,6
0,999,20324,3578731247,3578731254,7
0,999,20325,3578731247,3578731254,7
0,999,20326,3578731247,3578731257,10
0,999,20327,3578731247,3578731258,11
0,999,20328,3578731247,3578731258,11
0,999,20329,3578731247,3578731258,11
0,999,20330,3578731247,3578731259,12
0,999,20331,3578731247,3578731262,15
0,999,20332,3578731247,3578731262,15
0,999,20333,3578731247,3578731265,18
0,999,20334,3578731247,3578731265,18
0,999,20335,3578731247,3578731265,18
0,999,20336,3578731247,3578731266,19
0,999,20337,3578731247,3578731266,19
0,999,20338,3578731247,3578731268,21
0,999,20339,3578731247,3578731268,21
0,999,20340,3578731247,3578731269,22
0,999,20341,3578731247,3578731269,22
0,999,20342,3578731247,3578731269,22
0,999,20343,3578731247,3578731270,23
0,999,20344,3578731247,3578731270,23
0,999,20345,3578731247,3578731273,26
0,999,20346,3578731247,3578731273,26
0,999,20347,3578731247,3578731279,32
0,999,20348,3578731247,3578731280,33
0,999,20349,3578731247,3578731281,34
0,999,20350,3578731247,3578731281,34
0,999,20351,3578731247,3578731282,35
0,999,20352,3578731247,3578731284,37
0,999,20353,3578731247,3578731285,38
0,999,20354,3578731247,3578731286,39
0,999,20355,3578731247,3578731287,40
0,999,20356,3578731247,3578731287,40
0,999,20357,3578731247,3578731287,40
0,999,20358,3578731247,3578731288,41
0,999,20359,3578731247,3578731289,42
0,999,20360,3578731247,3578731289,42
0,999,20361,3578731247,3578731291,44
0,999,20362,3578731247,3578731291,44
0,999,20363,3578731247,3578731291,44
0,999,20364,3578731247,3578731293,46
0,999,20365,3578731247,3578731294,47
0,999,20366,3578731247,3578731296,49
0,999,20367,3578731247,3578731297,50
0,1000,20368,3578731305,3578731305,0
0,1000,20369,3578731305,3578731305,0
0,1000,20370,3578731305,3578731305,0
0,1000,20371,3578731305,3578731305,0
0,1000,20372,3578731305,3578731305,0
0,1000,20373,3578731305,3578731305,0
0,1000,20374,3578731305,3578731305,0
0,1000,20375,3578731305,3578731306,1
0,1000,20376,3578731305,3578731306,1
0,1000,20377,3578731305,3578731307,2
0,1000,20378,3578731305,3578731308,3
0,1000,20379,3578731305,3578731308,3
0,1000,20380,3578731305,3578731308,3
0,1000,20381,3578731305,3578731308,3
0,1000,20382,3578731305,3578731308,3
0,1000,20383,3578731305,3578731309,4
0,1000,20384,3578731305,3578731309,4
0,1000,20385,3578731305,3578731309,4
0,1000,20386,3578731305,3578731310,5
0,1000,20387,3578731305,3578731310,5
0,1000,20388,3578731305,3578731310,5
0,1000,20389,3578731305,3578731311,6
0,1000,20390,3578731305,3578731313,8
0,1000,20391,3578731305,3578731315,10
0,1000,20392,3578731305,3578731316,11
0,1000,20393,3578731305,3578731316,11
0,1000,20394,3578731305,3578731316,11
0,1000,20395,3578731305,3578731317,12
0,1000,20396,3578731305,3578731318,13
0,1000,20397,3578731305,3578731318,13
0,1000,20398,3578731305,3578731319,14
0,1000,20399,3578731305,3578731320,15
0,1000,20400,3578731305,3578731322,17
0,1000,20401,3578731305,3578731323,18
0,1000,20402,3578731305,3578731325,20
0,1000,20403,3578731305,3578731328,23
0,1000,20404,3578731305,3578731328,23
0,1000,20405,3578731305,3578731329,24
0,1000,20406,3578731305,3578731331,26
0,1000,20407,3578731305,3578731331,26
0,1000,20408,3578731305,3578731331,26
0,1000,20409,3578731305,3578731331,26
0,1000,20410,3578731305,3578731333,28
0,1000,20411,3578731305,3578731333,28
0,1000,20412,3578731305,3578731333,28
0,1000,20413,3578731305,3578731336,31
0,1000,20414,3578731305,3578731337,32
0,1000,20415,3578731305,3578731339,34
0,1000,20416,3578731305,3578731341,36
0,1000,20417,3578731305,3578731341,36
0,1000,20418,3578731305,3578731343,38
0,1000,20419,3578731305,3578731344,39
0,1000,20420,3578731305,3578731344,39
0,1000,20421,3578731305,3578731344,39
0,1000,20422,3578731305,3578731345,40
0,1000,20423,3578731305,3578731345,40
0,1000,20424,3578731305,3578731347,42
0,1000,20425,3578731305,3578731348,43
0,1000,20426,3578731305,3578731351,46
0,1000,20427,3578731305,3578731351,46
0,1000,20428,3578731305,3578731352,47
0,1000,20429,3578731305,3578731353,48
0,1001,20430,3578731364,3578731364,0
0,1001,20431,3578731364,3578731364,0
0,1001,20432,3578731364,3578731364,0
0,1001,20433,3578731364,3578731364,0
0,1001,20434,3578731364,3578731364,0
0,1001,20435,3578731364,3578731364,0
0,1001,20436,3578731364,3578731364,0
0,1001,20437,3578731364,3578731364,0
0,1001,20438,3578731364,3578731364,0
0,1001,20439,3578731364,3578731364,0
0,1001,20440,3578731364,3578731365,1
0,1001,20441,3578731364,3578731365,1
0,1001,20442,3578731364,3578731367,3
0,1001,20443,3578731364,3578731367,3
0,1001,20444,3578731364,3578731368,4
0,1001,20445,3578731364,3578731368,4
0,1001,20446,3578731364,3578731368,4
0,1001,20447,3578731364,3578731369,5
0,1001,20448,3578731364,3578731369,5
0,1001,20449,3578731364,3578731372,8
0,1001,20450,3578731364,3578731373,9
0,1001,20451,3578731364,3578731373,9
0,1001,20452,3578731364,3578731373,9
0,1001,20453,3578731364,3578731374,10
0,1001,20454,3578731364,3578731375,11
0,1001,20455,3578731364,3578731376,12
0,1001,20456,3578731364,3578731379,15
0,1001,20457,3578731364,3578731382,18
0,1001,20458,3578731364,3578731382,18
0,1001,20459,3578731364,3578731383,19
0,1001,20460,3578731364,3578731386,22
0,1001,20461,3578731364,3578731386,22
0,1001,20462,3578731364,3578731388,24
0,1001,20463,3578731364,3578731388,24
0,1001,20464,3578731364,3578731390,26
0,1001,20465,3578731364,3578731391,27
0,1001,20466,3578731364,3578731391,27
0,1001,20467,3578731364,3578731392,28
0,1001,20468,3578731364,3578731392,28
0,1001,20469,3578731364,3578731393,29
0,1001,20470,3578731364,3578731394,30
0,1001,20471,3578731364,3578731398,34
0,1001,20472,3578731364,3578731399,35
0,1001,20473,3578731364,3578731400,36
0,1001,20474,3578731364,3578731401,37
0,1001,20475,3578731364,3578731401,37
0,1001,20476,3578731364,3578731402,38
0,1001,20477,3578731364,3578731405,41
0,1001,20478,3578731364,3578731405,41
0,1001,20479,3578731364,3578731406,42
0,1001,20480,3578731364,3578731410,46
0,1001,20481,3578731364,3578731410,46
0,1001,20482,3578731364,3578731411,47
0,1001,20483,3578731364,3578731411,47
0,1001,20484,3578731364,3578731412,48
0,1001,20485,3578731364,3578731412,48
0,1001,20486,3578731364,3578731412,48
0,1002,20487,3578731424,3578731424,0
0,1002,20488,3578731424,3578731424,0
0,1002,20489,3578731424,3578731424,0
0,1002,20490,3578731424,3578731424,0
0,1002,20491,3578731424,3578731424,0
0,1002,20492,3578731424,3578731424,0
0,1002,20493,3578731424,3578731424,0
0,1002,20494,3578731424,3578731424,0
0,1002,20495,3578731424,3578731424,0
0,1002,20496,3578731424,3578731424,0
0,1002,20497,3578731424,3578731425,1
0,1002,20498,3578731424,3578731428,4
0,1002,20499,3578731424,3578731430,6
0,1002,20500,3578731424,3578731433,9
0,1002,20501,3578731424,3578731433,9
0,1002,20502,3578731424,3578731433,9
0,1002,20503,3578731424,3578731434,10
0,1002,20504,3578731424,3578731436,12
0,1002,20505,3578731424,3578731436,12
0,1002,20506,3578731424,3578731437,13
0,1002,20507,3578731424,3578731441,17
0,1002,20508,3578731424,3578731441,17
0,1002,20509,3578731424,3578731442,18
0,1002,20510,3578731424,3578731444,20
0,1002,20511,3578731424,3578731446,22
0,1002,20512,3578731424,3578731448,24
0,1002,20513,3578731424,3578731449,25
0,1002,20514,3578731424,3578731450,26
0,1002,20515,3578731424,3578731450,26
0,1002,20516,3578731424,3578731453,29
0,1002,20517,3578731424,3578731455,31
0,1002,20518,3578731424,3578731455,31
0,1002,20519,3578731424,3578731457,33
0,1002,20520,3578731424,3578731457,33
0,1002,20521,3578731424,3578731459,35
0,1002,20522,3578731424,3578731459,35
0,1002,20523,3578731424,3578731463,39
0,1002,20524,3578731424,3578731463,39
0,1002,20525,3578731424,3578731465,41
0,1002,20526,3578731424,3578731465,41
0,1002,20527,3578731424,3578731465,41
0,1002,20528,3578731424,3578731466,42
0,1002,20529,3578731424,3578731467,43
0,1002,20530,3578731424,3578731467,43
0,1002,20531,3578731424,3578731469,45
0,1002,20532,3578731424,3578731469,45
0,1002,20533,3578731424,3578731469,45
0,1002,20534,3578731424,3578731469,45
0,1002,20535,3578731424,3578731470,46
0,1002,20536,3578731424,3578731473,49
0,1002,20537,3578731424,3578731473,49
0,1003,20538,3578731485,3578731485,0
0,1003,20539,3578731485,3578731485,0
0,1003,20540,3578731485,3578731485,0
0,1003,20541,3578731485,3578731485,0
0,1003,20542,3578731485,3578731485,0
0,1003,20543,3578731485,3578731485,0
0,1003,20544,3578731485,3578731485,0
0,1003,20545,3578731485,3578731485,0
0,1003,20546,3578731485,3578731485,0
0,1003,20547,3578731485,3578731486,1
0,1003,20548,3578731485,3578731486,1
0,1003,20549,3578731485,3578731488,3
0,1003,20550,3578731485,3578731488,3
0,1003,20551,3578731485,3578731488,3
0,1003,20552,3578731485,3578731490,5
0,1003,20553,3578731485,3578731490,5
0,1003,20554,3578731485,3578731491,6
0,1003,20555,3578731485,3578731494,9
0,1003,20556,3578731485,3578731496,11
0,1003,20557,3578731485,3578731496,11
0,1003,20558,3578731485,3578731496,11
0,1003,20559,3578731485,3578731498,13
0,1003,20560,3578731485,3578731500,15
0,1003,20561,3578731485,3578731500,15
0,1003,20562,3578731485,3578731501,16
0,1003,20563,3578731485,3578731504,19
0,1003,20564,3578731485,3578731504,19
0,1003,20565,3578731485,3578731505,20
0,1003,20566,3578731485,3578731505,20
0,1003,20567,3578731485,3578731505,20
0,1003,20568,3578731485,3578731505,20
0,1003,20569,3578731485,3578731506,21
0,1003,20570,3578731485,3578731506,21
0,1003,20571,3578731485,3578731507,22
0,1003,20572,3578731485,3578731507,22
0,1003,20573,3578731485,3578731507,22
0,1003,20574,3578731485,3578731507,22
0,1003,20575,3578731485,3578731507,22
0,1003,20576,3578731485,3578731508,23
0,1003,20577,3578731485,3578731508,23
0,1003,20578,3578731485,3578731509,24
0,1003,20579,3578731485,3578731510,25
0,1003,20580,3578731485,3578731510,25
0,1003,20581,3578731485,3578731513,28
0,1003,20582,3578731485,3578731515,30
0,1003,20583,3578731485,3578731515,30
0,1003,20584,3578731485,3578731515,30
0,1003,20585,3578731485,3578731516,31
0,1003,20586,3578731485,3578731517,32
0,1003,20587,3578731485,3578731518,33
0,1003,20588,3578731485,3578731520,35
0,1003,20589,3578731485,3578731520,35
0,1003,20590,3578731485,3578731522,37
0,1003,20591,3578731485,3578731522,37
0,1003,20592,3578731485,3578731523,38
0,1003,20593,3578731485,3578731524,39
0,1003,20594,3578731485,3578731527,42
0,1003,20595,3578731485,3578731528,43
0,1003,20596,3578731485,3578731528,43
0,1003,20597,3578731485,3578731530,45
0,1003,20598,3578731485,3578731530,45
0,1003,20599,3578731485,3578731530,45
0,1003,20600,3578731485,3578731530,45
0,1003,20601,3578731485,3578731531,46
0,1003,20602,3578731485,3578731532,47
0,1003,20603,3578731485,3578731533,48
0,1003,20604,3578731485,3578731535,50
0,1004,20605,3578731543,3578731543,0
0,1004,20606,3578731543,3578731543,0
0,1004,20607,3578731543,3578731543,0
0,1004,20608,3578731543,3578731543,0
0,1004,20609,3578731543,3578731543,0
0,1004,20610,3578731543,3578731543,0
0,1004,20611,3578731543,3578731544,1
0,1004,20612,3578731543,3578731544,1
0,1004,20613,3578731543,3578731544,1
0,1004,20614,3578731543,3578731545,2
0,1004,20615,3578731543,3578731546,3
0,1004,20616,3578731543,3578731547,4
0,1004,20617,3578731543,3578731550,7
0,1004,20618,3578731543,3578731550,7
0,1004,20619,3578731543,3578731551,8
0,1004,20620,3578731543,3578731552,9
0,1004,20621,3578731543,3578731555,12
0,1004,20622,3578731543,3578731559,16
0,1004,20623,3578731543,3578731559,16
0,1004,20624,3578731543,3578731560,17
0,1004,20625,3578731543,3578731561,18
0,1004,20626,3578731543,3578731561,18
0,1004,20627,3578731543,3578731561,18
0,1004,20628,3578731543,3578731563,20
0,1004,20629,3578731543,3578731564,21
0,1004,20630,3578731543,3578731564,21
0,1004,20631,3578731543,3578731566,23
0,1004,20632,3578731543,3578731566,23
0,1004,20633,3578731543,3578731567,24
0,1004,20634,3578731543,3578731568,25
0,1004,20635,3578731543,3578731569,26
0,1004,20636,3578731543,3578731569,26
0,1004,20637,3578731543,3578731570,27
0,1004,20638,3578731543,3578731571,28
0,1004,20639,3578731543,3578731572,29
0,1004,20640,3578731543,3578731572,29
0,1004,20641,3578731543,3578731573,30
0,1004,20642,3578731543,3578731574,31
0,1004,20643,3578731543,3578731575,32
0,1004,20644,3578731543,3578731575,32
0,1004,20645,3578731543,3578731577,34
0,1004,20646,3578731543,3578731578,35
0,1004,20647,3578731543,3578731579,36
0,1004,20648,3578731543,3578731581,38
0,1004,20649,3578731543,3578731582,39
0,1004,20650,3578731543,3578731585,42
0,1004,20651,3578731543,3578731585,42
0,1004,20652,3578731543,3578731587,44
0,1004,20653,3578731543,3578731587,44
0,1004,20654,3578731543,3578731589,46
0,1004,20655,3578731543,3578731590,47
0,1004,20656,3578731543,3578731590,47
0,1004,20657,3578731543,3578731592,49
0,1004,20658,3578731543,3578731593,50
0,1004,20659,3578731543,3578731593,50
0,1005,20660,3578731602,3578731602,0
0,1005,20661,3578731602,3578731602,0
0,1005,20662,3578731602,3578731602,0
0,1005,20663,3578731602,3578731602,0
0,1005,20664,3578731602,3578731602,0
0,1005,20665,3578731602,3578731602,0
0,1005,20666,3578731602,3578731602,0
0,1005,20667,3578731602,3578731604,2
0,1005,20668,3578731602,3578731605,3
0,1005,20669,3578731602,3578731605,3
0,1005,20670,3578731602,3578731606,4
0,1005,20671,3578731602,3578731608,6
0,1005,20672,3578731602,3578731609,7
0,1005,20673,3578731602,3578731610,8
0,1005,20674,3578731602,3578731610,8
0,1005,20675,3578731602,3578731611,9
0,1005,20676,3578731602,3578731612,10
0,1005,20677,3578731602,3578731613,11
0,1005,20678,3578731602,3578731614,12
0,1005,20679,3578731602,3578731615,13
0,1005,20680,3578731602,3578731616,14
0,1005,20681,3578731602,3578731617,15
0,1005,20682,3578731602,3578731617,15
0,1005,20683,3578731602,3578731619,17
0,1005,20684,3578731602,3578731619,17
0,1005,20685,3578731602,3578731619,17
0,1005,20686,3578731602,3578731620,18
0,1005,20687,3578731602,3578731620,18
0,1005,20688,3578731602,3578731621,19
0,1005,20689,3578731602,3578731625,23
0,1005,20690,3578731602,3578731627,25
0,1005,20691,3578731602,3578731627,25
0,1005,20692,3578731602,3578731629,27
0,1005,20693,3578731602,3578731629,27
0,1005,20694,3578731602,3578731632,30
0,1005,20695,3578731602,3578731633,31
0,1005,20696,3578731602,3578731633,31
0,1005,20697,3578731602,3578731634,32
0,1005,20698,3578731602,3578731635,33
0,1005,20699,3578731602,3578731636,34
0,1005,20700,3578731602,3578731636,34
0,1005,20701,3578731602,3578731640,38
0,1005,20702,3578731602,3578731640,38
0,1005,20703,3578731602,3578731641,39
0,1005,20704,3578731602,3578731642,40
0,1005,20705,3578731602,3578731643,41
0,1005,20706,3578731602,3578731645,43
0,1005,20707,3578731602,3578731648,46
0,1005,20708,3578731602,3578731649,47
0,1005,20709,3578731602,3578731649,47
0,1005,20710,3578731602,3578731652,50
0,1006,20711,3578731660,3578731660,0
0,1006,20712,3578731660,3578731660,0
0,1006,20713,3578731660,3578731660,0
0,1006,20714,3578731660,3578731660,0
0,1006,20715,3578731660,3578731660,0
0,1006,20716,3578731660,3578731660,0
0,1006,20717,3578731660,3578731660,0
0,1006,20718,3578731660,3578731662,2
0,1006,20719,3578731660,3578731662,2
0,1006,20720,3578731660,3578731664,4
0,1006,20721,3578731660,3578731664,4
0,1006,20722,3578731660,3578731664,4
0,1006,20723,3578731660,3578731665,5
0,1006,20724,3578731660,3578731666,6
0,1006,20725,3578731660,3578731666,6
0,1006,20726,3578731660,3578731668,8
0,1006,20727,3578731660,3578731668,8
0,1006,20728,3578731660,3578731669,9
0,1006,20729,3578731660,3578731669,9
0,1006,20730,3578731660,3578731669,9
0,1006,20731,3578731660,3578731673,13
0,1006,20732,3578731660,3578731674,14
0,1006,20733,3578731660,3578731680,20
0,1006,20734,3578731660,3578731680,20
0,1006,20735,3578731660,3578731681,21
0,1006,20736,3578731660,3578731681,21
0,1006,20737,3578731660,3578731682,22
0,1006,20738,3578731660,3578731683,23
0,1006,20739,3578731660,3578731683,23
0,1006,20740,3578731660,3578731683,23
0,1006,20741,3578731660,3578731684,24
0,1006,20742,3578731660,3578731685,25
0,1006,20743,3578731660,3578731685,25
0,1006,20744,3578731660,3578731686,26
0,1006,20745,3578731660,3578731687,27
0,1006,20746,3578731660,3578731688,28
0,1006,20747,3578731660,3578731688,28
0,1006,20748,3578731660,3578731689,29
0,1006,20749,3578731660,3578731690,30
0,1006,20750,3578731660,3578731690,30
0,1006,20751,3578731660,3578731691,31
0,1006,20752,3578731660,3578731695,35
0,1006,20753,3578731660,3578731696,36
0,1006,20754,3578731660,3578731696,36
0,1006,20755,3578731660,3578731696,36
0,1006,20756,3578731660,3578731698,38
0,1006,20757,3578731660,3578731698,38
0,1006,20758,3578731660,3578731700,40
0,1006,20759,3578731660,3578731700,40
0,1006,20760,3578731660,3578731701,41
0,1006,20761,3578731660,3578731704,44
0,1006,20762,3578731660,3578731704,44
0,1006,20763,3578731660,3578731705,45
0,1006,20764,3578731660,3578731705,45
0,1006,20765,3578731660,3578731705,45
0,1006,20766,3578731660,3578731705,45
0,1006,20767,3578731660,3578731706,46
0,1006,20768,3578731660,3578731707,47
0,1006,20769,3578731660,3578731707,47
0,1006,20770,3578731660,3578731707,47
0,1006,20771,3578731660,3578731708,48
0,1006,20772,3578731660,3578731708,48
0,1006,20773,3578731660,3578731708,48
0,1006,20774,3578731660,3578731708,48
0,1006,20775,3578731660,3578731708,48
0,1006,20776,3578731660,3578731709,49
0,1006,20777,3578731660,3578731710,50
0,1007,20778,3578731718,3578731718,0
0,1007,20779,3578731718,3578731718,0
0,1007,20780,3578731718,3578731718,0
0,1007,20781,3578731718,3578731718,0
0,1007,20782,3578731718,3578731718,0
0,1007,20783,3578731718,3578731718,0
0,1007,20784,3578731718,3578731718,0
0,1007,20785,3578731718,3578731718,0
0,1007,20786,3578731718,3578731718,0
0,1007,20787,3578731718,3578731718,0
0,1007,20788,3578731718,3578731720,2
0,1007,20789,3578731718,3578731722,4
0,1007,20790,3578731718,3578731723,5
0,1007,20791,3578731718,3578731725,7
0,1007,20792,3578731718,3578731727,9
0,1007,20793,3578731718,3578731727,9
0,1007,20794,3578731718,3578731728,10
0,1007,20795,3578731718,3578731729,11
0,1007,20796,3578731718,3578731730,12
0,1007,20797,3578731718,3578731730,12
0,1007,20798,3578731718,3578731731,13
0,1007,20799,3578731718,3578731731,13
0,1007,20800,3578731718,3578731731,13
0,1007,20801,3578731718,3578731733,15
0,1007,20802,3578731718,3578731733,15
0,1007,20803,3578731718,3578731736,18
0,1007,20804,3578731718,3578731737,19
0,1007,20805,3578731718,3578731738,20
0,1007,20806,3578731718,3578731739,21
0,1007,20807,3578731718,3578731741,23
0,1007,20808,3578731718,3578731742,24
0,1007,20809,3578731718,3578731743,25
0,1007,20810,3578731718,3578731744,26
0,1007,20811,3578731718,3578731744,26
0,1007,20812,3578731718,3578731744,26
0,1007,20813,3578731718,3578731745,27
0,1007,20814,3578731718,3578731745,27
0,1007,20815,3578731718,3578731747,29
0,1007,20816,3578731718,3578731747,29
0,1007,20817,3578731718,3578731750,32
0,1007,20818,3578731718,3578731752,34
0,1007,20819,3578731718,3578731753,35
0,1007,20820,3578731718,3578731755,37
0,1007,20821,3578731718,3578731758,40
0,1007,20822,3578731718,3578731758,40
0,1007,20823,3578731718,3578731759,41
0,1007,20824,3578731718,3578731761,43
0,1007,20825,3578731718,3578731761,43
0,1007,20826,3578731718,3578731762,44
0,1007,20827,3578731718,3578731762,44
0,1007,20828,3578731718,3578731763,45
0,1007,20829,3578731718,3578731765,47
0,1007,20830,3578731718,3578731765,47
0,1007,20831,3578731718,3578731766,48
0,1007,20832,3578731718,3578731766,48
0,1007,20833,3578731718,3578731768,50
0,1008,20834,3578731776,3578731776,0
0,1008,20835,3578731776,3578731776,0
0,1008,20836,3578731776,3578731776,0
0,1008,20837,3578731776,3578731776,0
0,1008,20838,3578731776,3578731776,0
0,1008,20839,3578731776,3578731776,0
0,1008,20840,3578731776,3578731776,0
0,1008,20841,3578731776,3578731776,0
0,1008,20842,3578731776,3578731776,0
0,1008,20843,3578731776,3578731776,0
0,1008,20844,3578731776,3578731778,2
0,1008,20845,3578731776,3578731778,2
0,1008,20846,3578731776,3578731779,3
0,1008,20847,3578731776,3578731781,5
0,1008,20848,3578731776,3578731781,5
0,1008,20849,3578731776,3578731782,6
0,1008,20850,3578731776,3578731783,7
0,1008,20851,3578731776,3578731785,9
0,1008,20852,3578731776,3578731785,9
0,1008,20853,3578731776,3578731786,10
0,1008,20854,3578731776,3578731787,11
0,1008,20855,3578731776,3578731787,11
0,1008,20856,3578731776,3578731789,13
0,1008,20857,3578731776,3578731790,14
0,1008,20858,3578731776,3578731791,15
0,1008,20859,3578731776,3578731791,15
0,1008,20860,3578731776,3578731792,16
0,1008,20861,3578731776,3578731793,17
0,1008,20862,3578731776,3578731794,18
0,1008,20863,3578731776,3578731798,22
0,1008,20864,3578731776,3578731799,23
0,1008,20865,3578731776,3578731799,23
0,1008,20866,3578731776,3578731800,24
0,1008,20867,3578731776,3578731801,25
0,1008,20868,3578731776,3578731804,28
0,1008,20869,3578731776,3578731804,28
0,1008,20870,3578731776,3578731805,29
0,1008,20871,3578731776,3578731806,30
0,1008,20872,3578731776,3578731809,33
0,1008,20873,3578731776,3578731809,33
0,1008,20874,3578731776,3578731810,34
0,1008,20875,3578731776,3578731810,34
0,1008,20876,3578731776,3578731812,36
0,1008,20877,3578731776,3578731812,36
0,1008,20878,3578731776,3578731813,37
0,1008,20879,3578731776,3578731813,37
0,1008,20880,3578731776,3578731814,38
0,1008,20881,3578731776,3578731815,39
0,1008,20882,3578731776,3578731816,40
0,1008,20883,3578731776,3578731816,40
0,1008,20884,3578731776,3578731817,41
0,1008,20885,3578731776,3578731819,43
0,1008,20886,3578731776,3578731819,43
0,1008,20887,3578731776,3578731819,43
0,1008,20888,3578731776,3578731820,44
0,1008,20889,3578731776,3578731820,44
0,1008,20890,3578731776,3578731821,45
0,1008,20891,3578731776,3578731825,49
0,1009,20892,3578731836,3578731836,0
0,1009,20893,3578731836,3578731836,0
0,1009,20894,3578731836,3578731836,0
0,1009,20895,3578731836,3578731836,0
0,1009,20896,3578731836,3578731836,0
0,1009,20897,3578731836,3578731836,0
0,1009,20898,3578731836,3578731836,0
0,1009,20899,3578731836,3578731836,0
0,1009,20900,3578731836,3578731836,0
0,1009,20901,3578731836,3578731837,1
0,1009,20902,3578731836,3578731840,4
0,1009,20903,3578731836,3578731841,5
0,1009,20904,3578731836,3578731842,6
0,1009,20905,3578731836,3578731843,7
0,1009,20906,3578731836,3578731845,9
0,1009,20907,3578731836,3578731848,12
0,1009,20908,3578731836,3578731848,12
0,1009,20909,3578731836,3578731848,12
0,1009,20910,3578731836,3578731849,13
0,1009,20911,3578731836,3578731849,13
0,1009,20912,3578731836,3578731852,16
0,1009,20913,3578731836,3578731855,19
0,1009,20914,3578731836,3578731856,20
0,1009,20915,3578731836,3578731857,21
0,1009,20916,3578731836,3578731858,22
0,1009,20917,3578731836,3578731858,22
0,1009,20918,3578731836,3578731858,22
0,1009,20919,3578731836,3578731862,26
0,1009,20920,3578731836,3578731863,27
0,1009,20921,3578731836,3578731864,28
0,1009,20922,3578731836,3578731864,28
0,1009,20923,3578731836,3578731865,29
0,1009,20924,3578731836,3578731865,29
0,1009,20925,3578731836,3578731867,31
0,1009,20926,3578731836,3578731868,32
0,1009,20927,3578731836,3578731868,32
0,1009,20928,3578731836,3578731869,33
0,1009,20929,3578731836,3578731869,33
0,1009,20930,3578731836,3578731869,33
0,1009,20931,3578731836,3578731870,34
0,1009,20932,3578731836,3578731873,37
0,1009,20933,3578731836,3578731874,38
0,1009,20934,3578731836,3578731880,44
0,1009,20935,3578731836,3578731880,44
0,1009,20936,3578731836,3578731881,45
0,1009,20937,3578731836,3578731881,45
0,1009,20938,3578731836,3578731882,46
0,1009,20939,3578731836,3578731882,46
0,1009,20940,3578731836,3578731883,47
0,1009,20941,3578731836,3578731884,48
0,1009,20942,3578731836,3578731884,48
0,1009,20943,3578731836,3578731885,49
0,1009,20944,3578731836,3578731886,50
0,1010,20945,3578731894,3578731894,0
0,1010,20946,3578731894,3578731894,0
0,1010,20947,3578731894,3578731894,0
0,1010,20948,3578731894,3578731894,0
0,1010,20949,3578731894,3578731894,0
0,1010,20950,3578731894,3578731894,0
0,1010,20951,3578731894,3578731896,2
0,1010,20952,3578731894,3578731896,2
0,1010,20953,3578731894,3578731896,2
0,1010,20954,3578731894,3578731896,2
0,1010,20955,3578731894,3578731898,4
0,1010,20956,3578731894,3578731900,6
0,1010,20957,3578731894,3578731901,7
0,1010,20958,3578731894,3578731901,7
0,1010,20959,3578731894,3578731904,10
0,1010,20960,3578731894,3578731904,10
0,1010,20961,3578731894,3578731905,11
0,1010,20962,3578731894,3578731905,11
0,1010,20963,3578731894,3578731905,11
0,1010,20964,3578731894,3578731906,12
0,1010,20965,3578731894,3578731907,13
0,1010,20966,3578731894,3578731908,14
0,1010,20967,3578731894,3578731908,14
0,1010,20968,3578731894,3578731908,14
0,1010,20969,3578731894,3578731908,14
0,1010,20970,3578731894,3578731908,14
0,1010,20971,3578731894,3578731909,15
0,1010,20972,3578731894,3578731909,15
0,1010,20973,3578731894,3578731909,15
0,1010,20974,3578731894,3578731910,16
0,1010,20975,3578731894,3578731912,18
0,1010,20976,3578731894,3578731914,20
0,1010,20977,3578731894,3578731914,20
0,1010,20978,3578731894,3578731915,21
0,1010,20979,3578731894,3578731915,21
0,1010,20980,3578731894,3578731916,22
0,1010,20981,3578731894,3578731916,22
0,1010,20982,3578731894,3578731918,24
0,1010,20983,3578731894,3578731918,24
0,1010,20984,3578731894,3578731918,24
0,1010,20985,3578731894,3578731920,26
0,1010,20986,3578731894,3578731920,26
0,1010,20987,3578731894,3578731922,28
0,1010,20988,3578731894,3578731926,32
0,1010,20989,3578731894,3578731927,33
0,1010,20990,3578731894,3578731928,34
0,1010,20991,3578731894,3578731930,36
0,1010,20992,3578731894,3578731930,36
0,1010,20993,3578731894,3578731931,37
0,1010,20994,3578731894,3578731931,37
0,1010,20995,3578731894,3578731933,39
0,1010,20996,3578731894,3578731934,40
0,1010,20997,3578731894,3578731934,40
0,1010,20998,3578731894,3578731936,42
0,1010,20999,3578731894,3578731936,42
0,1010,21000,3578731894,3578731939,45
0,1010,21001,3578731894,3578731940,46
0,1010,21002,3578731894,3578731941,47
0,1010,21003,3578731894,3578731942,48
0,1010,21004,3578731894,3578731943,49
0,1011,21005,3578731954,3578731954,0
0,1011,21006,3578731954,3578731954,0
0,1011,21007,3578731954,3578731954,0
0,1011,21008,3578731954,3578731954,0
0,1011,21009,3578731954,3578731954,0
0,1011,21010,3578731954,3578731954,0
0,1011,21011,3578731954,3578731954,0
0,1011,21012,3578731954,3578731955,1
0,1011,21013,3578731954,3578731955,1
0,1011,21014,3578731954,3578731955,1
0,1011,21015,3578731954,3578731955,1
0,1011,21016,3578731954,3578731958,4
0,1011,21017,3578731954,3578731959,5
0,1011,21018,3578731954,3578731959,5
0,1011,21019,3578731954,3578731961,7
0,1011,21020,3578731954,3578731961,7
0,1011,21021,3578731954,3578731962,8
0,1011,21022,3578731954,3578731963,9
0,1011,21023,3578731954,3578731963,9
0,1011,21024,3578731954,3578731964,10
0,1011,21025,3578731954,3578731964,10
0,1011,21026,3578731954,3578731966,12
0,1011,21027,3578731954,3578731967,13
0,1011,21028,3578731954,3578731968,14
0,1011,21029,3578731954,3578731968,14
0,1011,21030,3578731954,3578731969,15
0,1011,21031,3578731954,3578731971,17
0,1011,21032,3578731954,3578731972,18
0,1011,21033,3578731954,3578731973,19
0,1011,21034,3578731954,3578731973,19
0,1011,21035,3578731954,3578731973,19
0,1011,21036,3578731954,3578731974,20
0,1011,21037,3578731954,3578731974,20
0,1011,21038,3578731954,3578731975,21
0,1011,21039,3578731954,3578731976,22
0,1011,21040,3578731954,3578731978,24
0,1011,21041,3578731954,3578731978,24
0,1011,21042,3578731954,3578731979,25
0,1011,21043,3578731954,3578731981,27
0,1011,21044,3578731954,3578731981,27
0,1011,21045,3578731954,3578731982,28
0,1011,21046,3578731954,3578731984,30
0,1011,21047,3578731954,3578731985,31
0,1011,21048,3578731954,3578731986,32
0,1011,21049,3578731954,3578731987,33
0,1011,21050,3578731954,3578731988,34
0,1011,21051,3578731954,3578731989,35
0,1011,21052,3578731954,3578731990,36
0,1011,21053,3578731954,3578731991,37
0,1011,21054,3578731954,3578731991,37
0,1011,21055,3578731954,3578731993,39
0,1011,21056,3578731954,3578731994,40
0,1011,21057,3578731954,3578731999,45
0,1011,21058,3578731954,3578731999,45
0,1011,21059,3578731954,3578731999,45
0,1011,21060,3578731954,3578732001,47
0,1011,21061,3578731954,3578732002,48
0,1011,21062,3578731954,3578732002,48
0,1012,21063,3578732013,3578732013,0
0,1012,21064,3578732013,3578732013,0
0,1012,21065,3578732013,3578732013,0
0,1012,21066,3578732013,3578732013,0
0,1012,21067,3578732013,3578732013,0
0,1012,21068,3578732013,3578732013,0
0,1012,21069,3578732013,3578732013,0
0,1012,21070,3578732013,3578732013,0
0,1012,21071,3578732013,3578732013,0
0,1012,21072,3578732013,3578732014,1
0,1012,21073,3578732013,3578732015,2
0,1012,21074,3578732013,3578732016,3
0,1012,21075,3578732013,3578732016,3
0,1012,21076,3578732013,3578732017,4
0,1012,21077,3578732013,3578732019,6
0,1012,21078,3578732013,3578732019,6
0,1012,21079,3578732013,3578732020,7
0,1012,21080,3578732013,3578732020,7
0,1012,21081,3578732013,3578732021,8
0,1012,21082,3578732013,3578732021,8
0,1012,21083,3578732013,3578732025,12
0,1012,21084,3578732013,3578732028,15
0,1012,21085,3578732013,3578732029,16
0,1012,21086,3578732013,3578732030,17
0,1012,21087,3578732013,3578732031,18
0,1012,21088,3578732013,3578732031,18
0,1012,21089,3578732013,3578732032,19
0,1012,21090,3578732013,3578732033,20
0,1012,21091,3578732013,3578732034,21
0,1012,21092,3578732013,3578732035,22
0,1012,21093,3578732013,3578732035,22
0,1012,21094,3578732013,3578732036,23
0,1012,21095,3578732013,3578732038,25
0,1012,21096,3578732013,3578732039,26
0,1012,21097,3578732013,3578732039,26
0,1012,21098,3578732013,3578732042,29
0,1012,21099,3578732013,3578732042,29
0,1012,21100,3578732013,3578732043,30
0,1012,21101,3578732013,3578732044,31
0,1012,21102,3578732013,3578732048,35
0,1012,21103,3578732013,3578732048,35
0,1012,21104,3578732013,3578732049,36
0,1012,21105,3578732013,3578732050,37
0,1012,21106,3578732013,3578732050,37
0,1012,21107,3578732013,3578732054,41
0,1012,21108,3578732013,3578732056,43
0,1012,21109,3578732013,3578732056,43
0,1012,21110,3578732013,3578732057,44
0,1012,21111,3578732013,3578732058,45
0,1012,21112,3578732013,3578732059,46
0,1012,21113,3578732013,3578732062,49
0,1012,21114,3578732013,3578732063,50
0,1013,21115,3578732072,3578732072,0
0,1013,21116,3578732072,3578732072,0
0,1013,21117,3578732072,3578732072,0
0,1013,21118,3578732072,3578732072,0
0,1013,21119,3578732072,3578732072,0
0,1013,21120,3578732072,3578732072,0
0,1013,21121,3578732072,3578732072,0
0,1013,21122,3578732072,3578732072,0
0,1013,21123,3578732072,3578732072,0
0,1013,21124,3578732072,3578732073,1
0,1013,21125,3578732072,3578732076,4
0,1013,21126,3578732072,3578732081,9
0,1013,21127,3578732072,3578732082,10
0,1013,21128,3578732072,3578732084,12
0,1013,21129,3578732072,3578732084,12
0,1013,21130,3578732072,3578732085,13
0,1013,21131,3578732072,3578732086,14
0,1013,21132,3578732072,3578732087,15
0,1013,21133,3578732072,3578732087,15
0,1013,21134,3578732072,3578732088,16
0,1013,21135,3578732072,3578732088,16
0,1013,21136,3578732072,3578732090,18
0,1013,21137,3578732072,3578732090,18
0,1013,21138,3578732072,3578732091,19
0,1013,21139,3578732072,3578732091,19
0,1013,21140,3578732072,3578732094,22
0,1013,21141,3578732072,3578732095,23
0,1013,21142,3578732072,3578732096,24
0,1013,21143,3578732072,3578732096,24
0,1013,21144,3578732072,3578732096,24
0,1013,21145,3578732072,3578732096,24
0,1013,21146,3578732072,3578732097,25
0,1013,21147,3578732072,3578732100,28
0,1013,21148,3578732072,3578732101,29
0,1013,21149,3578732072,3578732103,31
0,1013,21150,3578732072,3578732104,32
0,1013,21151,3578732072,3578732105,33
0,1013,21152,3578732072,3578732105,33
0,1013,21153,3578732072,3578732106,34
0,1013,21154,3578732072,3578732106,34
0,1013,21155,3578732072,3578732106,34
0,1013,21156,3578732072,3578732108,36
0,1013,21157,3578732072,3578732108,36
0,1013,21158,3578732072,3578732108,36
0,1013,21159,3578732072,3578732108,36
0,1013,21160,3578732072,3578732108,36
0,1013,21161,3578732072,3578732109,37
0,1013,21162,3578732072,3578732109,37
0,1013,21163,3578732072,3578732109,37
0,1013,21164,3578732072,3578732110,38
0,1013,21165,3578732072,3578732112,40
0,1013,21166,3578732072,3578732114,42
0,1013,21167,3578732072,3578732114,42
0,1013,21168,3578732072,3578732115,43
0,1013,21169,3578732072,3578732116,44
0,1013,21170,3578732072,3578732116,44
0,1013,21171,3578732072,3578732116,44
0,1013,21172,3578732072,3578732118,46
0,1013,21173,3578732072,3578732118,46
0,1013,21174,3578732072,3578732118,46
0,1013,21175,3578732072,3578732120,48
0,1014,21176,3578732129,3578732129,0
0,1014,21177,3578732129,3578732129,0
0,1014,21178,3578732129,3578732129,0
0,1014,21179,3578732129,3578732129,0
0,1014,21180,3578732129,3578732129,0
0,1014,21181,3578732129,3578732129,0
0,1014,21182,3578732129,3578732130,1
0,1014,21183,3578732129,3578732131,2
0,1014,21184,3578732129,3578732131,2
0,1014,21185,3578732129,3578732131,2
0,1014,21186,3578732129,3578732133,4
0,1014,21187,3578732129,3578732135,6
0,1014,21188,3578732129,3578732136,7
0,1014,21189,3578732129,3578732139,10
0,1014,21190,3578732129,3578732140,11
0,1014,21191,3578732129,3578732140,11
0,1014,21192,3578732129,3578732140,11
0,1014,21193,3578732129,3578732143,14
0,1014,21194,3578732129,3578732143,14
0,1014,21195,3578732129,3578732144,15
0,1014,21196,3578732129,3578732145,16
0,1014,21197,3578732129,3578732145,16
0,1014,21198,3578732129,3578732146,17
0,1014,21199,3578732129,3578732146,17
0,1014,21200,3578732129,3578732148,19
0,1014,21201,3578732129,3578732150,21
0,1014,21202,3578732129,3578732151,22
0,1014,21203,3578732129,3578732153,24
0,1014,21204,3578732129,3578732153,24
0,1014,21205,3578732129,3578732154,25
0,1014,21206,3578732129,3578732158,29
0,1014,21207,3578732129,3578732158,29
0,1014,21208,3578732129,3578732159,30
0,1014,21209,3578732129,3578732161,32
0,1014,21210,3578732129,3578732161,32
0,1014,21211,3578732129,3578732161,32
0,1014,21212,3578732129,3578732161,32
0,1014,21213,3578732129,3578732162,33
0,1014,21214,3578732129,3578732162,33
0,1014,21215,3578732129,3578732164,35
0,1014,21216,3578732129,3578732164,35
0,1014,21217,3578732129,3578732165,36
0,1014,21218,3578732129,3578732166,37
0,1014,21219,3578732129,3578732168,39
0,1014,21220,3578732129,3578732168,39
0,1014,21221,3578732129,3578732168,39
0,1014,21222,3578732129,3578732169,40
0,1014,21223,3578732129,3578732171,42
0,1014,21224,3578732129,3578732173,44
0,1014,21225,3578732129,3578732173,44
0,1014,21226,3578732129,3578732173,44
0,1014,21227,3578732129,3578732174,45
0,1014,21228,3578732129,3578732175,46
0,1014,21229,3578732129,3578732175,46
0,1014,21230,3578732129,3578732175,46
0,1014,21231,3578732129,3578732175,46
0,1014,21232,3578732129,3578732178,49
0,1014,21233,3578732129,3578732179,50
0,1015,21234,3578732186,3578732186,0
0,1015,21235,3578732186,3578732186,0
0,1015,21236,3578732186,3578732186,0
0,1015,21237,3578732186,3578732186,0
0,1015,21238,3578732186,3578732186,0
0,1015,21239,3578732186,3578732186,0
0,1015,21240,3578732186,3578732187,1
0,1015,21241,3578732186,3578732188,2
0,1015,21242,3578732186,3578732189,3
0,1015,21243,3578732186,3578732190,4
0,1015,21244,3578732186,3578732191,5
0,1015,21245,3578732186,3578732191,5
0,1015,21246,3578732186,3578732191,5
0,1015,21247,3578732186,3578732193,7
0,1015,21248,3578732186,3578732193,7
0,1015,21249,3578732186,3578732193,7
0,1015,21250,3578732186,3578732194,8
0,1015,21251,3578732186,3578732198,12
0,1015,21252,3578732186,3578732199,13
0,1015,21253,3578732186,3578732199,13
0,1015,21254,3578732186,3578732201,15
0,1015,21255,3578732186,3578732202,16
0,1015,21256,3578732186,3578732202,16
0,1015,21257,3578732186,3578732205,19
0,1015,21258,3578732186,3578732205,19
0,1015,21259,3578732186,3578732206,20
0,1015,21260,3578732186,3578732206,20
0,1015,21261,3578732186,3578732209,23
0,1015,21262,3578732186,3578732209,23
0,1015,21263,3578732186,3578732210,24
0,1015,21264,3578732186,3578732210,24
0,1015,21265,3578732186,3578732212,26
0,1015,21266,3578732186,3578732213,27
0,1015,21267,3578732186,3578732215,29
0,1015,21268,3578732186,3578732219,33
0,1015,21269,3578732186,3578732219,33
0,1015,21270,3578732186,3578732219,33
0,1015,21271,3578732186,3578732221,35
0,1015,21272,3578732186,3578732221,35
0,1015,21273,3578732186,3578732222,36
0,1015,21274,3578732186,3578732225,39
0,1015,21275,3578732186,3578732229,43
0,1015,21276,3578732186,3578732229,43
0,1015,21277,3578732186,3578732230,44
0,1015,21278,3578732186,3578732232,46
0,1015,21279,3578732186,3578732232,46
0,1015,21280,3578732186,3578732233,47
0,1015,21281,3578732186,3578732233,47
0,1015,21282,3578732186,3578732235,49
0,1015,21283,3578732186,3578732235,49
0,1016,21284,3578732244,3578732244,0
0,1016,21285,3578732244,3578732244,0
0,1016,21286,3578732244,3578732244,0
0,1016,21287,3578732244,3578732244,0
0,1016,21288,3578732244,3578732244,0
0,1016,21289,3578732244,3578732244,0
0,1016,21290,3578732244,3578732244,0
0,1016,21291,3578732244,3578732244,0
0,1016,21292,3578732244,3578732245,1
0,1016,21293,3578732244,3578732249,5
0,1016,21294,3578732244,3578732249,5
0,1016,21295,3578732244,3578732249,5
0,1016,21296,3578732244,3578732250,6
0,1016,21297,3578732244,3578732250,6
0,1016,21298,3578732244,3578732255,11
0,1016,21299,3578732244,3578732256,12
0,1016,21300,3578732244,3578732256,12
0,1016,21301,3578732244,3578732257,13
0,1016,21302,3578732244,3578732258,14
0,1016,21303,3578732244,3578732258,14
0,1016,21304,3578732244,3578732259,15
0,1016,21305,3578732244,3578732262,18
0,1016,21306,3578732244,3578732263,19
0,1016,21307,3578732244,3578732264,20
0,1016,21308,3578732244,3578732264,20
0,1016,21309,3578732244,3578732265,21
0,1016,21310,3578732244,3578732267,23
0,1016,21311,3578732244,3578732267,23
0,1016,21312,3578732244,3578732267,23
0,1016,21313,3578732244,3578732268,24
0,1016,21314,3578732244,3578732269,25
0,1016,21315,3578732244,3578732270,26
0,1016,21316,3578732244,3578732270,26
0,1016,21317,3578732244,3578732270,26
0,1016,21318,3578732244,3578732271,27
0,1016,21319,3578732244,3578732273,29
0,1016,21320,3578732244,3578732276,32
0,1016,21321,3578732244,3578732280,36
0,1016,21322,3578732244,3578732281,37
0,1016,21323,3578732244,3578732281,37
0,1016,21324,3578732244,3578732281,37
0,1016,21325,3578732244,3578732283,39
0,1016,21326,3578732244,3578732283,39
0,1016,21327,3578732244,3578732284,40
0,1016,21328,3578732244,3578732285,41
0,1016,21329,3578732244,3578732285,41
0,1016,21330,3578732244,3578732287,43
0,1016,21331,3578732244,3578732288,44
0,1016,21332,3578732244,3578732290,46
0,1016,21333,3578732244,3578732290,46
0,1016,21334,3578732244,3578732292,48
0,1016,21335,3578732244,3578732293,49
0,1016,21336,3578732244,3578732294,50
0,1017,21337,3578732303,3578732303,0
0,1017,21338,3578732303,3578732303,0
0,1017,21339,3578732303,3578732303,0
0,1017,21340,3578732303,3578732303,0
0,1017,21341,3578732303,3578732303,0
0,1017,21342,3578732303,3578732303,0
0,1017,21343,3578732303,3578732303,0
0,1017,21344,3578732303,3578732303,0
0,1017,21345,3578732303,3578732304,1
0,1017,21346,3578732303,3578732304,1
0,1017,21347,3578732303,3578732304,1
0,1017,21348,3578732303,3578732306,3
0,1017,21349,3578732303,3578732306,3
0,1017,21350,3578732303,3578732306,3
0,1017,21351,3578732303,3578732308,5
0,1017,21352,3578732303,3578732308,5
0,1017,21353,3578732303,3578732308,5
0,1017,21354,3578732303,3578732309,6
0,1017,21355,3578732303,3578732309,6
0,1017,21356,3578732303,3578732309,6
0,1017,21357,3578732303,3578732309,6
0,1017,21358,3578732303,3578732310,7
0,1017,21359,3578732303,3578732310,7
0,1017,21360,3578732303,3578732313,10
0,1017,21361,3578732303,3578732315,12
0,1017,21362,3578732303,3578732315,12
0,1017,21363,3578732303,3578732315,12
0,1017,21364,3578732303,3578732315,12
0,1017,21365,3578732303,3578732315,12
0,1017,21366,3578732303,3578732316,13
0,1017,21367,3578732303,3578732317,14
0,1017,21368,3578732303,3578732318,15
0,1017,21369,3578732303,3578732319,16
0,1017,21370,3578732303,3578732320,17
0,1017,21371,3578732303,3578732320,17
0,1017,21372,3578732303,3578732323,20
0,1017,21373,3578732303,3578732323,20
0,1017,21374,3578732303,3578732323,20
0,1017,21375,3578732303,3578732325,22
0,1017,21376,3578732303,3578732328,25
0,1017,21377,3578732303,3578732328,25
0,1017,21378,3578732303,3578732329,26
0,1017,21379,3578732303,3578732330,27
0,1017,21380,3578732303,3578732330,27
0,1017,21381,3578732303,3578732331,28
0,1017,21382,3578732303,3578732331,28
0,1017,21383,3578732303,3578732331,28
0,1017,21384,3578732303,3578732333,30
0,1017,21385,3578732303,3578732335,32
0,1017,21386,3578732303,3578732336,33
0,1017,21387,3578732303,3578732339,36
0,1017,21388,3578732303,3578732340,37
0,1017,21389,3578732303,3578732341,38
0,1017,21390,3578732303,3578732341,38
0,1017,21391,3578732303,3578732342,39
0,1017,21392,3578732303,3578732343,40
0,1017,21393,3578732303,3578732344,41
0,1017,21394,3578732303,3578732344,41
0,1017,21395,3578732303,3578732345,42
0,1017,21396,3578732303,3578732345,42
0,1017,21397,3578732303,3578732346,43
0,1017,21398,3578732303,3578732346,43
0,1017,21399,3578732303,3578732346,43
0,1017,21400,3578732303,3578732348,45
0,1017,21401,3578732303,3578732350,47
0,1017,21402,3578732303,3578732351,48
0,1017,21403,3578732303,3578732352,49
0,1017,21404,3578732303,3578732352,49
0,1017,21405,3578732303,3578732353,50
0,1018,21406,3578732362,3578732362,0
0,1018,21407,3578732362,3578732362,0
0,1018,21408,3578732362,3578732362,0
0,1018,21409,3578732362,3578732362,0
0,1018,21410,3578732362,3578732362,0
0,1018,21411,3578732362,3578732362,0
0,1018,21412,3578732362,3578732362,0
0,1018,21413,3578732362,3578732362,0
0,1018,21414,3578732362,3578732362,0
0,1018,21415,3578732362,3578732363,1
0,1018,21416,3578732362,3578732363,1
0,1018,21417,3578732362,3578732364,2
0,1018,21418,3578732362,3578732365,3
0,1018,21419,3578732362,3578732366,4
0,1018,21420,3578732362,3578732367,5
0,1018,21421,3578732362,3578732367,5
0,1018,21422,3578732362,3578732369,7
0,1018,21423,3578732362,3578732369,7
0,1018,21424,3578732362,3578732371,9
0,1018,21425,3578732362,3578732373,11
0,1018,21426,3578732362,3578732373,11
0,1018,21427,3578732362,3578732374,12
0,1018,21428,3578732362,3578732375,13
0,1018,21429,3578732362,3578732375,13
0,1018,21430,3578732362,3578732375,13
0,1018,21431,3578732362,3578732376,14
0,1018,21432,3578732362,3578732379,17
0,1018,21433,3578732362,3578732379,17
0,1018,21434,3578732362,3578732379,17
0,1018,21435,3578732362,3578732381,19
0,1018,21436,3578732362,3578732382,20
0,1018,21437,3578732362,3578732385,23
0,1018,21438,3578732362,3578732386,24
0,1018,21439,3578732362,3578732386,24
0,1018,21440,3578732362,3578732387,25
0,1018,21441,3578732362,3578732388,26
0,1018,21442,3578732362,3578732389,27
0,1018,21443,3578732362,3578732390,28
0,1018,21444,3578732362,3578732391,29
0,1018,21445,3578732362,3578732391,29
0,1018,21446,3578732362,3578732393,31
0,1018,21447,3578732362,3578732394,32
0,1018,21448,3578732362,3578732394,32
0,1018,21449,3578732362,3578732395,33
0,1018,21450,3578732362,3578732398,36
0,1018,21451,3578732362,3578732400,38
0,1018,21452,3578732362,3578732400,38
0,1018,21453,3578732362,3578732401,39
0,1018,21454,3578732362,3578732402,40
0,1018,21455,3578732362,3578732402,40
0,1018,21456,3578732362,3578732405,43
0,1018,21457,3578732362,3578732406,44
0,1018,21458,3578732362,3578732406,44
0,1018,21459,3578732362,3578732408,46
0,1018,21460,3578732362,3578732409,47
0,1018,21461,3578732362,3578732410,48
0,1018,21462,3578732362,3578732410,48
0,1018,21463,3578732362,3578732411,49
0,1019,21464,3578732421,3578732421,0
0,1019,21465,3578732421,3578732421,0
0,1019,21466,3578732421,3578732421,0
0,1019,21467,3578732421,3578732421,0
0,1019,21468,3578732421,3578732421,0
0,1019,21469,3578732421,3578732421,0
0,1019,21470,3578732421,3578732421,0
0,1019,21471,3578732421,3578732421,0
0,1019,21472,3578732421,3578732422,1
0,1019,21473,3578732421,3578732422,1
0,1019,21474,3578732421,3578732425,4
0,1019,21475,3578732421,3578732426,5
0,1019,21476,3578732421,3578732428,7
0,1019,21477,3578732421,3578732432,11
0,1019,21478,3578732421,3578732433,12
0,1019,21479,3578732421,3578732434,13
0,1019,21480,3578732421,3578732434,13
0,1019,21481,3578732421,3578732435,14
0,1019,21482,3578732421,3578732436,15
0,1019,21483,3578732421,3578732436,15
0,1019,21484,3578732421,3578732439,18
0,1019,21485,3578732421,3578732439,18
0,1019,21486,3578732421,3578732441,20
0,1019,21487,3578732421,3578732441,20
0,1019,21488,3578732421,3578732442,21
0,1019,21489,3578732421,3578732443,22
0,1019,21490,3578732421,3578732444,23
0,1019,21491,3578732421,3578732444,23
0,1019,21492,3578732421,3578732448,27
0,1019,21493,3578732421,3578732449,28
0,1019,21494,3578732421,3578732449,28
0,1019,21495,3578732421,3578732449,28
0,1019,21496,3578732421,3578732450,29
0,1019,21497,3578732421,3578732450,29
0,1019,21498,3578732421,3578732453,32
0,1019,21499,3578732421,3578732456,35
0,1019,21500,3578732421,3578732456,35
0,1019,21501,3578732421,3578732456,35
0,1019,21502,3578732421,3578732457,36
0,1019,21503,3578732421,3578732458,37
0,1019,21504,3578732421,3578732458,37
0,1019,21505,3578732421,3578732462,41
0,1019,21506,3578732421,3578732463,42
0,1019,21507,3578732421,3578732464,43
0,1019,21508,3578732421,3578732464,43
0,1019,21509,3578732421,3578732465,44
0,1019,21510,3578732421,3578732467,46
0,1019,21511,3578732421,3578732467,46
0,1019,21512,3578732421,3578732467,46
0,1019,21513,3578732421,3578732469,48
0,1019,21514,3578732421,3578732470,49
0,1019,21515,3578732421,3578732470,49
0,1019,21516,3578732421,3578732471,50
0,1020,21517,3578732479,3578732479,0
0,1020,21518,3578732479,3578732479,0
0,1020,21519,3578732479,3578732479,0
0,1020,21520,3578732479,3578732480,1
0,1020,21521,3578732479,3578732480,1
0,1020,21522,3578732479,3578732481,2
0,1020,21523,3578732479,3578732481,2
0,1020,21524,3578732479,3578732482,3
0,1020,21525,3578732479,3578732483,4
0,1020,21526,3578732479,3578732484,5
0,1020,21527,3578732479,3578732485,6
0,1020,21528,3578732479,3578732486,7
0,1020,21529,3578732479,3578732486,7
0,1020,21530,3578732479,3578732487,8
0,1020,21531,3578732479,3578732489,10
0,1020,21532,3578732479,3578732489,10
0,1020,21533,3578732479,3578732490,11
0,1020,21534,3578732479,3578732492,13
0,1020,21535,3578732479,3578732493,14
0,1020,21536,3578732479,3578732494,15
0,1020,21537,3578732479,3578732496,17
0,1020,21538,3578732479,3578732498,19
0,1020,21539,3578732479,3578732498,19
0,1020,21540,3578732479,3578732498,19
0,1020,21541,3578732479,3578732500,21
0,1020,21542,3578732479,3578732501,22
0,1020,21543,3578732479,3578732501,22
0,1020,21544,3578732479,3578732502,23
0,1020,21545,3578732479,3578732502,23
0,1020,21546,3578732479,3578732503,24
0,1020,21547,3578732479,3578732504,25
0,1020,21548,3578732479,3578732505,26
0,1020,21549,3578732479,3578732505,26
0,1020,21550,3578732479,3578732505,26
0,1020,21551,3578732479,3578732505,26
0,1020,21552,3578732479,3578732505,26
0,1020,21553,3578732479,3578732507,28
0,1020,21554,3578732479,3578732507,28
0,1020,21555,3578732479,3578732507,28
0,1020,21556,3578732479,3578732508,29
0,1020,21557,3578732479,3578732508,29
0,1020,21558,3578732479,3578732508,29
0,1020,21559,3578732479,3578732508,29
0,1020,21560,3578732479,3578732509,30
0,1020,21561,3578732479,3578732510,31
0,1020,21562,3578732479,3578732512,33
0,1020,21563,3578732479,3578732515,36
0,1020,21564,3578732479,3578732515,36
0,1020,21565,3578732479,3578732515,36
0,1020,21566,3578732479,3578732515,36
0,1020,21567,3578732479,3578732515,36
0,1020,21568,3578732479,3578732516,37
0,1020,21569,3578732479,3578732517,38
0,1020,21570,3578732479,3578732517,38
0,1020,21571,3578732479,3578732517,38
0,1020,21572,3578732479,3578732520,41
0,1020,21573,3578732479,3578732520,41
0,1020,21574,3578732479,3578732521,42
0,1020,21575,3578732479,3578732522,43
0,1020,21576,3578732479,3578732522,43
0,1020,21577,3578732479,3578732524,45
0,1020,21578,3578732479,3578732527,48
0,1020,21579,3578732479,3578732528,49
0,1020,21580,3578732479,3578732528,49
0,1021,21581,3578732537,3578732537,0
0,1021,21582,3578732537,3578732537,0
0,1021,21583,3578732537,3578732537,0
0,1021,21584,3578732537,3578732537,0
0,1021,21585,3578732537,3578732537,0
0,1021,21586,3578732537,3578732537,0
0,1021,21587,3578732537,3578732537,0
0,1021,21588,3578732537,3578732537,0
0,1021,21589,3578732537,3578732539,2
0,1021,21590,3578732537,3578732539,2
0,1021,21591,3578732537,3578732539,2
0,1021,21592,3578732537,3578732541,4
0,1021,21593,3578732537,3578732541,4
0,1021,21594,3578732537,3578732542,5
0,1021,21595,3578732537,3578732544,7
0,1021,21596,3578732537,3578732544,7
0,1021,21597,3578732537,3578732544,7
0,1021,21598,3578732537,3578732545,8
0,1021,21599,3578732537,3578732545,8
0,1021,21600,3578732537,3578732546,9
0,1021,21601,3578732537,3578732547,10
0,1021,21602,3578732537,3578732549,12
0,1021,21603,3578732537,3578732549,12
0,1021,21604,3578732537,3578732550,13
0,1021,21605,3578732537,3578732551,14
0,1021,21606,3578732537,3578732552,15
0,1021,21607,3578732537,3578732553,16
0,1021,21608,3578732537,3578732555,18
0,1021,21609,3578732537,3578732557,20
0,1021,21610,3578732537,3578732558,21
0,1021,21611,3578732537,3578732558,21
0,1021,21612,3578732537,3578732559,22
0,1021,21613,3578732537,3578732560,23
0,1021,21614,3578732537,3578732560,23
0,1021,21615,3578732537,3578732561,24
0,1021,21616,3578732537,3578732563,26
0,1021,21617,3578732537,3578732563,26
0,1021,21618,3578732537,3578732563,26
0,1021,21619,3578732537,3578732565,28
0,1021,21620,3578732537,3578732565,28
0,1021,21621,3578732537,3578732567,30
0,1021,21622,3578732537,3578732567,30
0,1021,21623,3578732537,3578732568,31
0,1021,21624,3578732537,3578732569,32
0,1021,21625,3578732537,3578732570,33
0,1021,21626,3578732537,3578732572,35
0,1021,21627,3578732537,3578732573,36
0,1021,21628,3578732537,3578732573,36
0,1021,21629,3578732537,3578732574,37
0,1021,21630,3578732537,3578732574,37
0,1021,21631,3578732537,3578732574,37
0,1021,21632,3578732537,3578732575,38
0,1021,21633,3578732537,3578732578,41
0,1021,21634,3578732537,3578732578,41
0,1021,21635,3578732537,3578732578,41
0,1021,21636,3578732537,3578732580,43
0,1021,21637,3578732537,3578732584,47
0,1021,21638,3578732537,3578732585,48
0,1021,21639,3578732537,3578732585,48
0,1021,21640,3578732537,3578732586,49
0,1021,21641,3578732537,3578732587,50
0,1022,21642,3578732596,3578732596,0
0,1022,21643,3578732596,3578732596,0
0,1022,21644,3578732596,3578732596,0
0,1022,21645,3578732596,3578732596,0
0,1022,21646,3578732596,3578732596,0
0,1022,21647,3578732596,3578732596,0
0,1022,21648,3578732596,3578732596,0
0,1022,21649,3578732596,3578732597,1
0,1022,21650,3578732596,3578732599,3
0,1022,21651,3578732596,3578732600,4
0,1022,21652,3578732596,3578732600,4
0,1022,21653,3578732596,3578732601,5
0,1022,21654,3578732596,3578732601,5
0,1022,21655,3578732596,3578732601,5
0,1022,21656,3578732596,3578732604,8
0,1022,21657,3578732596,3578732605,9
0,1022,21658,3578732596,3578732605,9
0,1022,21659,3578732596,3578732606,10
0,1022,21660,3578732596,3578732608,12
0,1022,21661,3578732596,3578732609,13
0,1022,21662,3578732596,3578732609,13
0,1022,21663,3578732596,3578732610,14
0,1022,21664,3578732596,3578732611,15
0,1022,21665,3578732596,3578732612,16
0,1022,21666,3578732596,3578732614,18
0,1022,21667,3578732596,3578732614,18
0,1022,21668,3578732596,3578732615,19
0,1022,21669,3578732596,3578732616,20
0,1022,21670,3578732596,3578732616,20
0,1022,21671,3578732596,3578732617,21
0,1022,21672,3578732596,3578732617,21
0,1022,21673,3578732596,3578732619,23
0,1022,21674,3578732596,3578732619,23
0,1022,21675,3578732596,3578732621,25
0,1022,21676,3578732596,3578732621,25
0,1022,21677,3578732596,3578732625,29
0,1022,21678,3578732596,3578732625,29
0,1022,21679,3578732596,3578732628,32
0,1022,21680,3578732596,3578732628,32
0,1022,21681,3578732596,3578732629,33
0,1022,21682,3578732596,3578732631,35
0,1022,21683,3578732596,3578732631,35
0,1022,21684,3578732596,3578732631,35
0,1022,21685,3578732596,3578732633,37
0,1022,21686,3578732596,3578732633,37
0,1022,21687,3578732596,3578732635,39
0,1022,21688,3578732596,3578732636,40
0,1022,21689,3578732596,3578732636,40
0,1022,21690,3578732596,3578732638,42
0,1022,21691,3578732596,3578732638,42
0,1022,21692,3578732596,3578732640,44
0,1022,21693,3578732596,3578732641,45
0,1022,21694,3578732596,3578732642,46
0,1022,21695,3578732596,3578732642,46
0,1022,21696,3578732596,3578732642,46
0,1022,21697,3578732596,3578732644,48
0,1023,21698,3578732656,3578732656,0
0,1023,21699,3578732656,3578732656,0
0,1023,21700,3578732656,3578732656,0
0,1023,21701,3578732656,3578732656,0
0,1023,21702,3578732656,3578732656,0
0,1023,21703,3578732656,3578732656,0
0,1023,21704,3578732656,3578732656,0
0,1023,21705,3578732656,3578732656,0
0,1023,21706,3578732656,3578732656,0
0,1023,21707,3578732656,3578732657,1
0,1023,21708,3578732656,3578732657,1
0,1023,21709,3578732656,3578732658,2
0,1023,21710,3578732656,3578732662,6
0,1023,21711,3578732656,3578732663,7
0,1023,21712,3578732656,3578732663,7
0,1023,21713,3578732656,3578732663,7
0,1023,21714,3578732656,3578732664,8
0,1023,21715,3578732656,3578732666,10
0,1023,21716,3578732656,3578732666,10
0,1023,21717,3578732656,3578732666,10
0,1023,21718,3578732656,3578732669,13
0,1023,21719,3578732656,3578732669,13
0,1023,21720,3578732656,3578732669,13
0,1023,21721,3578732656,3578732670,14
0,1023,21722,3578732656,3578732675,19
0,1023,21723,3578732656,3578732675,19
0,1023,21724,3578732656,3578732679,23
0,1023,21725,3578732656,3578732680,24
0,1023,21726,3578732656,3578732681,25
0,1023,21727,3578732656,3578732681,25
0,1023,21728,3578732656,3578732681,25
0,1023,21729,3578732656,3578732682,26
0,1023,21730,3578732656,3578732683,27
0,1023,21731,3578732656,3578732683,27
0,1023,21732,3578732656,3578732684,28
0,1023,21733,3578732656,3578732684,28
0,1023,21734,3578732656,3578732685,29
0,1023,21735,3578732656,3578732687,31
0,1023,21736,3578732656,3578732690,34
0,1023,21737,3578732656,3578732691,35
0,1023,21738,3578732656,3578732691,35
0,1023,21739,3578732656,3578732694,38
0,1023,21740,3578732656,3578732694,38
0,1023,21741,3578732656,3578732696,40
0,1023,21742,3578732656,3578732697,41
0,1023,21743,3578732656,3578732698,42
0,1023,21744,3578732656,3578732699,43
0,1023,21745,3578732656,3578732699,43
0,1023,21746,3578732656,3578732700,44
0,1023,21747,3578732656,3578732700,44
0,1023,21748,3578732656,3578732702,46
0,1023,21749,3578732656,3578732703,47
0,1023,21750,3578732656,3578732703,47
0,1023,21751,3578732656,3578732704,48
0,1023,21752,3578732656,3578732705,49
0,1023,21753,3578732656,3578732705,49
0,1023,21754,3578732656,3578732705,49
0,1023,21755,3578732656,3578732705,49
0,1023,21756,3578732656,3578732705,49
0,1024,21757,3578732718,3578732718,0
0,1024,21758,3578732718,3578732718,0
0,1024,21759,3578732718,3578732718,0
0,1024,21760,3578732718,3578732718,0
0,1024,21761,3578732718,3578732718,0
0,1024,21762,3578732718,3578732718,0
0,1024,21763,3578732718,3578732718,0
0,1024,21764,3578732718,3578732718,0
0,1024,21765,3578732718,3578732718,0
0,1024,21766,3578732718,3578732718,0
0,1024,21767,3578732718,3578732718,0
0,1024,21768,3578732718,3578732718,0
0,1024,21769,3578732718,3578732718,0
0,1024,21770,3578732718,3578732718,0
0,1024,21771,3578732718,3578732718,0
0,1024,21772,3578732718,3578732718,0
0,1024,21773,3578732718,3578732718,0
0,1024,21774,3578732718,3578732718,0
0,1024,21775,3578732718,3578732718,0
0,1024,21776,3578732718,3578732720,2
0,1024,21777,3578732718,3578732720,2
0,1024,21778,3578732718,3578732722,4
0,1024,21779,3578732718,3578732726,8
0,1024,21780,3578732718,3578732727,9
0,1024,21781,3578732718,3578732728,10
0,1024,21782,3578732718,3578732728,10
0,1024,21783,3578732718,3578732729,11
0,1024,21784,3578732718,3578732730,12
0,1024,21785,3578732718,3578732731,13
0,1024,21786,3578732718,3578732731,13
0,1024,21787,3578732718,3578732732,14
0,1024,21788,3578732718,3578732735,17
0,1024,21789,3578732718,3578732735,17
0,1024,21790,3578732718,3578732736,18
0,1024,21791,3578732718,3578732739,21
0,1024,21792,3578732718,3578732740,22
0,1024,21793,3578732718,3578732740,22
0,1024,21794,3578732718,3578732741,23
0,1024,21795,3578732718,3578732743,25
0,1024,21796,3578732718,3578732744,26
0,1024,21797,3578732718,3578732744,26
0,1024,21798,3578732718,3578732744,26
0,1024,21799,3578732718,3578732746,28
0,1024,21800,3578732718,3578732746,28
0,1024,21801,3578732718,3578732747,29
0,1024,21802,3578732718,3578732747,29
0,1024,21803,3578732718,3578732749,31
0,1024,21804,3578732718,3578732750,32
0,1024,21805,3578732718,3578732751,33
0,1024,21806,3578732718,3578732753,35
0,1024,21807,3578732718,3578732754,36
0,1024,21808,3578732718,3578732755,37
0,1024,21809,3578732718,3578732757,39
0,1024,21810,3578732718,3578732759,41
0,1024,21811,3578732718,3578732759,41
0,1024,21812,3578732718,3578732759,41
0,1024,21813,3578732718,3578732760,42
0,1024,21814,3578732718,3578732761,43
0,1024,21815,3578732718,3578732762,44
0,1024,21816,3578732718,3578732762,44
0,1024,21817,3578732718,3578732763,45
0,1024,21818,3578732718,3578732764,46
0,1024,21819,3578732718,3578732765,47
0,1024,21820,3578732718,3578732765,47
0,1024,21821,3578732718,3578732766,48
0,1024,21822,3578732718,3578732768,50
0,1025,21823,3578732780,3578732780,0
0,1025,21824,3578732780,3578732780,0
0,1025,21825,3578732780,3578732780,0
0,1025,21826,3578732780,3578732780,0
0,1025,21827,3578732780,3578732780,0
0,1025,21828,3578732780,3578732780,0
0,1025,21829,3578732780,3578732780,0
0,1025,21830,3578732780,3578732780,0
0,1025,21831,3578732780,3578732780,0
0,1025,21832,3578732780,3578732780,0
0,1025,21833,3578732780,3578732780,0
0,1025,21834,3578732780,3578732780,0
0,1025,21835,3578732780,3578732780,0
0,1025,21836,3578732780,3578732781,1
0,1025,21837,3578732780,3578732782,2
0,1025,21838,3578732780,3578732785,5
0,1025,21839,3578732780,3578732785,5
0,1025,21840,3578732780,3578732785,5
0,1025,21841,3578732780,3578732786,6
0,1025,21842,3578732780,3578732787,7
0,1025,21843,3578732780,3578732787,7
0,1025,21844,3578732780,3578732788,8
0,1025,21845,3578732780,3578732789,9
0,1025,21846,3578732780,3578732790,10
0,1025,21847,3578732780,3578732791,11
0,1025,21848,3578732780,3578732793,13
0,1025,21849,3578732780,3578732793,13
0,1025,21850,3578732780,3578732794,14
0,1025,21851,3578732780,3578732798,18
0,1025,21852,3578732780,3578732798,18
0,1025,21853,3578732780,3578732800,20
0,1025,21854,3578732780,3578732800,20
0,1025,21855,3578732780,3578732801,21
0,1025,21856,3578732780,3578732801,21
0,1025,21857,3578732780,3578732805,25
0,1025,21858,3578732780,3578732805,25
0,1025,21859,3578732780,3578732805,25
0,1025,21860,3578732780,3578732806,26
0,1025,21861,3578732780,3578732808,28
0,1025,21862,3578732780,3578732809,29
0,1025,21863,3578732780,3578732809,29
0,1025,21864,3578732780,3578732809,29
0,1025,21865,3578732780,3578732811,31
0,1025,21866,3578732780,3578732813,33
0,1025,21867,3578732780,3578732814,34
0,1025,21868,3578732780,3578732814,34
0,1025,21869,3578732780,3578732815,35
0,1025,21870,3578732780,3578732815,35
0,1025,21871,3578732780,3578732816,36
0,1025,21872,3578732780,3578732817,37
0,1025,21873,3578732780,3578732819,39
0,1025,21874,3578732780,3578732819,39
0,1025,21875,3578732780,3578732819,39
0,1025,21876,3578732780,3578732820,40
0,1025,21877,3578732780,3578732821,41
0,1025,21878,3578732780,3578732821,41
0,1025,21879,3578732780,3578732824,44
0,1025,21880,3578732780,3578732826,46
0,1025,21881,3578732780,3578732827,47
0,1025,21882,3578732780,3578732828,48
0,1025,21883,3578732780,3578732828,48
0,1026,21884,3578732838,3578732838,0
0,1026,21885,3578732838,3578732838,0
0,1026,21886,3578732838,3578732838,0
0,1026,21887,3578732838,3578732838,0
0,1026,21888,3578732838,3578732838,0
0,1026,21889,3578732838,3578732838,0
0,1026,21890,3578732838,3578732838,0
0,1026,21891,3578732838,3578732839,1
0,1026,21892,3578732838,3578732840,2
0,1026,21893,3578732838,3578732840,2
0,1026,21894,3578732838,3578732842,4
0,1026,21895,3578732838,3578732842,4
0,1026,21896,3578732838,3578732842,4
0,1026,21897,3578732838,3578732844,6
0,1026,21898,3578732838,3578732847,9
0,1026,21899,3578732838,3578732848,10
0,1026,21900,3578732838,3578732848,10
0,1026,21901,3578732838,3578732848,10
0,1026,21902,3578732838,3578732852,14
0,1026,21903,3578732838,3578732855,17
0,1026,21904,3578732838,3578732855,17
0,1026,21905,3578732838,3578732857,19
0,1026,21906,3578732838,3578732858,20
0,1026,21907,3578732838,3578732858,20
0,1026,21908,3578732838,3578732859,21
0,1026,21909,3578732838,3578732862,24
0,1026,21910,3578732838,3578732863,25
0,1026,21911,3578732838,3578732863,25
0,1026,21912,3578732838,3578732863,25
0,1026,21913,3578732838,3578732864,26
0,1026,21914,3578732838,3578732866,28
0,1026,21915,3578732838,3578732866,28
0,1026,21916,3578732838,3578732866,28
0,1026,21917,3578732838,3578732867,29
0,1026,21918,3578732838,3578732867,29
0,1026,21919,3578732838,3578732870,32
0,1026,21920,3578732838,3578732870,32
0,1026,21921,3578732838,3578732870,32
0,1026,21922,3578732838,3578732870,32
0,1026,21923,3578732838,3578732875,37
0,1026,21924,3578732838,3578732875,37
0,1026,21925,3578732838,3578732880,42
0,1026,21926,3578732838,3578732880,42
0,1026,21927,3578732838,3578732881,43
0,1026,21928,3578732838,3578732881,43
0,1026,21929,3578732838,3578732882,44
0,1026,21930,3578732838,3578732882,44
0,1026,21931,3578732838,3578732883,45
0,1026,21932,3578732838,3578732884,46
0,1026,21933,3578732838,3578732884,46
0,1026,21934,3578732838,3578732884,46
0,1026,21935,3578732838,3578732885,47
0,1026,21936,3578732838,3578732886,48
0,1026,21937,3578732838,3578732887,49
0,1026,21938,3578732838,3578732887,49
0,1027,21939,3578732897,3578732897,0
0,1027,21940,3578732897,3578732897,0
0,1027,21941,3578732897,3578732897,0
0,1027,21942,3578732897,3578732897,0
0,1027,21943,3578732897,3578732897,0
0,1027,21944,3578732897,3578732897,0
0,1027,21945,3578732897,3578732897,0
0,1027,21946,3578732897,3578732897,0
0,1027,21947,3578732897,3578732897,0
0,1027,21948,3578732897,3578732898,1
0,1027,21949,3578732897,3578732898,1
0,1027,21950,3578732897,3578732899,2
0,1027,21951,3578732897,3578732900,3
0,1027,21952,3578732897,3578732901,4
0,1027,21953,3578732897,3578732902,5
0,1027,21954,3578732897,3578732903,6
0,1027,21955,3578732897,3578732904,7
0,1027,21956,3578732897,3578732905,8
0,1027,21957,3578732897,3578732905,8
0,1027,21958,3578732897,3578732905,8
0,1027,21959,3578732897,3578732906,9
0,1027,21960,3578732897,3578732906,9
0,1027,21961,3578732897,3578732908,11
0,1027,21962,3578732897,3578732908,11
0,1027,21963,3578732897,3578732908,11
0,1027,21964,3578732897,3578732908,11
0,1027,21965,3578732897,3578732909,12
0,1027,21966,3578732897,3578732909,12
0,1027,21967,3578732897,3578732909,12
0,1027,21968,3578732897,3578732910,13
0,1027,21969,3578732897,3578732912,15
0,1027,21970,3578732897,3578732912,15
0,1027,21971,3578732897,3578732914,17
0,1027,21972,3578732897,3578732914,17
0,1027,21973,3578732897,3578732915,18
0,1027,21974,3578732897,3578732915,18
0,1027,21975,3578732897,3578732916,19
0,1027,21976,3578732897,3578732916,19
0,1027,21977,3578732897,3578732917,20
0,1027,21978,3578732897,3578732918,21
0,1027,21979,3578732897,3578732918,21
0,1027,21980,3578732897,3578732920,23
0,1027,21981,3578732897,3578732921,24
0,1027,21982,3578732897,3578732923,26
0,1027,21983,3578732897,3578732923,26
0,1027,21984,3578732897,3578732925,28
0,1027,21985,3578732897,3578732927,30
0,1027,21986,3578732897,3578732928,31
0,1027,21987,3578732897,3578732929,32
0,1027,21988,3578732897,3578732930,33
0,1027,21989,3578732897,3578732930,33
0,1027,21990,3578732897,3578732930,33
0,1027,21991,3578732897,3578732931,34
0,1027,21992,3578732897,3578732933,36
0,1027,21993,3578732897,3578732935,38
0,1027,21994,3578732897,3578732936,39
0,1027,21995,3578732897,3578732937,40
0,1027,21996,3578732897,3578732939,42
0,1027,21997,3578732897,3578732940,43
0,1027,21998,3578732897,3578732940,43
0,1027,21999,3578732897,3578732942,45
0,1027,22000,3578732897,3578732942,45
0,1027,22001,3578732897,3578732943,46
0,1027,22002,3578732897,3578732944,47
0,1027,22003,3578732897,3578732945,48
0,1027,22004,3578732897,3578732945,48
0,1027,22005,3578732897,3578732947,50
0,1028,22006,3578732955,3578732955,0
0,1028,22007,3578732955,3578732955,0
0,1028,22008,3578732955,3578732955,0
0,1028,22009,3578732955,3578732955,0
0,1028,22010,3578732955,3578732955,0
0,1028,22011,3578732955,3578732955,0
0,1028,22012,3578732955,3578732956,1
0,1028,22013,3578732955,3578732958,3
0,1028,22014,3578732955,3578732958,3
0,1028,22015,3578732955,3578732960,5
0,1028,22016,3578732955,3578732961,6
0,1028,22017,3578732955,3578732961,6
0,1028,22018,3578732955,3578732961,6
0,1028,22019,3578732955,3578732961,6
0,1028,22020,3578732955,3578732962,7
0,1028,22021,3578732955,3578732963,8
0,1028,22022,3578732955,3578732963,8
0,1028,22023,3578732955,3578732963,8
0,1028,22024,3578732955,3578732964,9
0,1028,22025,3578732955,3578732965,10
0,1028,22026,3578732955,3578732965,10
0,1028,22027,3578732955,3578732967,12
0,1028,22028,3578732955,3578732968,13
0,1028,22029,3578732955,3578732968,13
0,1028,22030,3578732955,3578732969,14
0,1028,22031,3578732955,3578732970,15
0,1028,22032,3578732955,3578732971,16
0,1028,22033,3578732955,3578732974,19
0,1028,22034,3578732955,3578732974,19
0,1028,22035,3578732955,3578732974,19
0,1028,22036,3578732955,3578732976,21
0,1028,22037,3578732955,3578732976,21
0,1028,22038,3578732955,3578732978,23
0,1028,22039,3578732955,3578732979,24
0,1028,22040,3578732955,3578732980,25
0,1028,22041,3578732955,3578732980,25
0,1028,22042,3578732955,3578732981,26
0,1028,22043,3578732955,3578732985,30
0,1028,22044,3578732955,3578732985,30
0,1028,22045,3578732955,3578732986,31
0,1028,22046,3578732955,3578732987,32
0,1028,22047,3578732955,3578732988,33
0,1028,22048,3578732955,3578732988,33
0,1028,22049,3578732955,3578732988,33
0,1028,22050,3578732955,3578732989,34
0,1028,22051,3578732955,3578732991,36
0,1028,22052,3578732955,3578732991,36
0,1028,22053,3578732955,3578732993,38
0,1028,22054,3578732955,3578732993,38
0,1028,22055,3578732955,3578732994,39
0,1028,22056,3578732955,3578732994,39
0,1028,22057,3578732955,3578732998,43
0,1028,22058,3578732955,3578732998,43
0,1028,22059,3578732955,3578733000,45
0,1028,22060,3578732955,3578733001,46
0,1028,22061,3578732955,3578733001,46
0,1028,22062,3578732955,3578733001,46
0,1028,22063,3578732955,3578733005,50
0,1029,22064,3578733015,3578733015,0
0,1029,22065,3578733015,3578733015,0
0,1029,22066,3578733015,3578733015,0
0,1029,22067,3578733015,3578733015,0
0,1029,22068,3578733015,3578733015,0
0,1029,22069,3578733015,3578733015,0
0,1029,22070,3578733015,3578733015,0
0,1029,22071,3578733015,3578733015,0
0,1029,22072,3578733015,3578733015,0
0,1029,22073,3578733015,3578733015,0
0,1029,22074,3578733015,3578733016,1
0,1029,22075,3578733015,3578733016,1
0,1029,22076,3578733015,3578733016,1
0,1029,22077,3578733015,3578733016,1
0,1029,22078,3578733015,3578733018,3
0,1029,22079,3578733015,3578733018,3
0,1029,22080,3578733015,3578733019,4
0,1029,22081,3578733015,3578733019,4
0,1029,22082,3578733015,3578733020,5
0,1029,22083,3578733015,3578733020,5
0,1029,22084,3578733015,3578733021,6
0,1029,22085,3578733015,3578733025,10
0,1029,22086,3578733015,3578733028,13
0,1029,22087,3578733015,3578733028,13
0,1029,22088,3578733015,3578733029,14
0,1029,22089,3578733015,3578733032,17
0,1029,22090,3578733015,3578733034,19
0,1029,22091,3578733015,3578733034,19
0,1029,22092,3578733015,3578733035,20
0,1029,22093,3578733015,3578733035,20
0,1029,22094,3578733015,3578733036,21
0,1029,22095,3578733015,3578733037,22
0,1029,22096,3578733015,3578733037,22
0,1029,22097,3578733015,3578733038,23
0,1029,22098,3578733015,3578733039,24
0,1029,22099,3578733015,3578733040,25
0,1029,22100,3578733015,3578733041,26
0,1029,22101,3578733015,3578733041,26
0,1029,22102,3578733015,3578733042,27
0,1029,22103,3578733015,3578733043,28
0,1029,22104,3578733015,3578733043,28
0,1029,22105,3578733015,3578733044,29
0,1029,22106,3578733015,3578733048,33
0,1029,22107,3578733015,3578733048,33
0,1029,22108,3578733015,3578733049,34
0,1029,22109,3578733015,3578733049,34
0,1029,22110,3578733015,3578733050,35
0,1029,22111,3578733015,3578733052,37
0,1029,22112,3578733015,3578733055,40
0,1029,22113,3578733015,3578733055,40
0,1029,22114,3578733015,3578733057,42
0,1029,22115,3578733015,3578733057,42
0,1029,22116,3578733015,3578733058,43
0,1029,22117,3578733015,3578733059,44
0,1029,22118,3578733015,3578733059,44
0,1029,22119,3578733015,3578733062,47
0,1029,22120,3578733015,3578733063,48
0,1029,22121,3578733015,3578733063,48
0,1029,22122,3578733015,3578733063,48
0,1029,22123,3578733015,3578733064,49
0,1029,22124,3578733015,3578733065,50
0,1030,22125,3578733075,3578733075,0
0,1030,22126,3578733075,3578733075,0
0,1030,22127,3578733075,3578733075,0
0,1030,22128,3578733075,3578733075,0
0,1030,22129,3578733075,3578733075,0
0,1030,22130,3578733075,3578733075,0
0,1030,22131,3578733075,3578733075,0
0,1030,22132,3578733075,3578733075,0
0,1030,22133,3578733075,3578733075,0
0,1030,22134,3578733075,3578733075,0
0,1030,22135,3578733075,3578733077,2
0,1030,22136,3578733075,3578733080,5
0,1030,22137,3578733075,3578733080,5
0,1030,22138,3578733075,3578733080,5
0,1030,22139,3578733075,3578733080,5
0,1030,22140,3578733075,3578733082,7
0,1030,22141,3578733075,3578733082,7
0,1030,22142,3578733075,3578733083,8
0,1030,22143,3578733075,3578733083,8
0,1030,22144,3578733075,3578733084,9
0,1030,22145,3578733075,3578733085,10
0,1030,22146,3578733075,3578733087,12
0,1030,22147,3578733075,3578733087,12
0,1030,22148,3578733075,3578733087,12
0,1030,22149,3578733075,3578733088,13
0,1030,22150,3578733075,3578733089,14
0,1030,22151,3578733075,3578733090,15
0,1030,22152,3578733075,3578733091,16
0,1030,22153,3578733075,3578733092,17
0,1030,22154,3578733075,3578733093,18
0,1030,22155,3578733075,3578733094,19
0,1030,22156,3578733075,3578733095,20
0,1030,22157,3578733075,3578733097,22
0,1030,22158,3578733075,3578733097,22
0,1030,22159,3578733075,3578733097,22
0,1030,22160,3578733075,3578733099,24
0,1030,22161,3578733075,3578733099,24
0,1030,22162,3578733075,3578733100,25
0,1030,22163,3578733075,3578733101,26
0,1030,22164,3578733075,3578733103,28
0,1030,22165,3578733075,3578733103,28
0,1030,22166,3578733075,3578733105,30
0,1030,22167,3578733075,3578733105,30
0,1030,22168,3578733075,3578733107,32
0,1030,22169,3578733075,3578733107,32
0,1030,22170,3578733075,3578733108,33
0,1030,22171,3578733075,3578733108,33
0,1030,22172,3578733075,3578733108,33
0,1030,22173,3578733075,3578733109,34
0,1030,22174,3578733075,3578733109,34
0,1030,22175,3578733075,3578733109,34
0,1030,22176,3578733075,3578733109,34
0,1030,22177,3578733075,3578733110,35
0,1030,22178,3578733075,3578733112,37
0,1030,22179,3578733075,3578733113,38
0,1030,22180,3578733075,3578733115,40
0,1030,22181,3578733075,3578733115,40
0,1030,22182,3578733075,3578733115,40
0,1030,22183,3578733075,3578733115,40
0,1030,22184,3578733075,3578733116,41
0,1030,22185,3578733075,3578733116,41
0,1030,22186,3578733075,3578733117,42
0,1030,22187,3578733075,3578733119,44
0,1030,22188,3578733075,3578733119,44
0,1030,22189,3578733075,3578733120,45
0,1030,22190,3578733075,3578733120,45
0,1030,22191,3578733075,3578733122,47
0,1030,22192,3578733075,3578733122,47
0,1030,22193,3578733075,3578733122,47
0,1030,22194,3578733075,3578733125,50
0,1031,22195,3578733136,3578733136,0
0,1031,22196,3578733136,3578733136,0
0,1031,22197,3578733136,3578733136,0
0,1031,22198,3578733136,3578733136,0
0,1031,22199,3578733136,3578733136,0
0,1031,22200,3578733136,3578733136,0
0,1031,22201,3578733136,3578733136,0
0,1031,22202,3578733136,3578733136,0
0,1031,22203,3578733136,3578733136,0
0,1031,22204,3578733136,3578733136,0
0,1031,22205,3578733136,3578733137,1
0,1031,22206,3578733136,3578733138,2
0,1031,22207,3578733136,3578733140,4
0,1031,22208,3578733136,3578733141,5
0,1031,22209,3578733136,3578733141,5
0,1031,22210,3578733136,3578733141,5
0,1031,22211,3578733136,3578733144,8
0,1031,22212,3578733136,3578733144,8
0,1031,22213,3578733136,3578733145,9
0,1031,22214,3578733136,3578733145,9
0,1031,22215,3578733136,3578733146,10
0,1031,22216,3578733136,3578733147,11
0,1031,22217,3578733136,3578733148,12
0,1031,22218,3578733136,3578733149,13
0,1031,22219,3578733136,3578733151,15
0,1031,22220,3578733136,3578733153,17
0,1031,22221,3578733136,3578733154,18
0,1031,22222,3578733136,3578733155,19
0,1031,22223,3578733136,3578733158,22
0,1031,22224,3578733136,3578733159,23
0,1031,22225,3578733136,3578733159,23
0,1031,22226,3578733136,3578733160,24
0,1031,22227,3578733136,3578733161,25
0,1031,22228,3578733136,3578733161,25
0,1031,22229,3578733136,3578733161,25
0,1031,22230,3578733136,3578733163,27
0,1031,22231,3578733136,3578733163,27
0,1031,22232,3578733136,3578733164,28
0,1031,22233,3578733136,3578733165,29
0,1031,22234,3578733136,3578733165,29
0,1031,22235,3578733136,3578733167,31
0,1031,22236,3578733136,3578733168,32
0,1031,22237,3578733136,3578733168,32
0,1031,22238,3578733136,3578733168,32
0,1031,22239,3578733136,3578733169,33
0,1031,22240,3578733136,3578733170,34
0,1031,22241,3578733136,3578733171,35
0,1031,22242,3578733136,3578733173,37
0,1031,22243,3578733136,3578733173,37
0,1031,22244,3578733136,3578733174,38
0,1031,22245,3578733136,3578733174,38
0,1031,22246,3578733136,3578733176,40
0,1031,22247,3578733136,3578733179,43
0,1031,22248,3578733136,3578733180,44
0,1031,22249,3578733136,3578733181,45
0,1031,22250,3578733136,3578733181,45
0,1031,22251,3578733136,3578733183,47
0,1031,22252,3578733136,3578733185,49
0,1031,22253,3578733136,3578733185,49
0,1031,22254,3578733136,3578733186,50
0,1032,22255,3578733195,3578733195,0
0,1032,22256,3578733195,3578733195,0
0,1032,22257,3578733195,3578733195,0
0,1032,22258,3578733195,3578733195,0
0,1032,22259,3578733195,3578733195,0
0,1032,22260,3578733195,3578733195,0
0,1032,22261,3578733195,3578733195,0
0,1032,22262,3578733195,3578733195,0
0,1032,22263,3578733195,3578733195,0
0,1032,22264,3578733195,3578733198,3
0,1032,22265,3578733195,3578733198,3
0,1032,22266,3578733195,3578733200,5
0,1032,22267,3578733195,3578733200,5
0,1032,22268,3578733195,3578733201,6
0,1032,22269,3578733195,3578733201,6
0,1032,22270,3578733195,3578733204,9
0,1032,22271,3578733195,3578733205,10
0,1032,22272,3578733195,3578733206,11
0,1032,22273,3578733195,3578733206,11
0,1032,22274,3578733195,3578733207,12
0,1032,22275,3578733195,3578733209,14
0,1032,22276,3578733195,3578733210,15
0,1032,22277,3578733195,3578733210,15
0,1032,22278,3578733195,3578733212,17
0,1032,22279,3578733195,3578733214,19
0,1032,22280,3578733195,3578733215,20
0,1032,22281,3578733195,3578733216,21
0,1032,22282,3578733195,3578733216,21
0,1032,22283,3578733195,3578733217,22
0,1032,22284,3578733195,3578733219,24
0,1032,22285,3578733195,3578733219,24
0,1032,22286,3578733195,3578733219,24
0,1032,22287,3578733195,3578733220,25
0,1032,22288,3578733195,3578733220,25
0,1032,22289,3578733195,3578733220,25
0,1032,22290,3578733195,3578733221,26
0,1032,22291,3578733195,3578733221,26
0,1032,22292,3578733195,3578733224,29
0,1032,22293,3578733195,3578733226,31
0,1032,22294,3578733195,3578733227,32
0,1032,22295,3578733195,3578733230,35
0,1032,22296,3578733195,3578733232,37
0,1032,22297,3578733195,3578733232,37
0,1032,22298,3578733195,3578733234,39
0,1032,22299,3578733195,3578733235,40
0,1032,22300,3578733195,3578733235,40
0,1032,22301,3578733195,3578733235,40
0,1032,22302,3578733195,3578733237,42
0,1032,22303,3578733195,3578733238,43
0,1032,22304,3578733195,3578733239,44
0,1032,22305,3578733195,3578733240,45
0,1032,22306,3578733195,3578733241,46
0,1032,22307,3578733195,3578733241,46
0,1032,22308,3578733195,3578733242,47
0,1032,22309,3578733195,3578733242,47
0,1032,22310,3578733195,3578733243,48
0,1032,22311,3578733195,3578733244,49
0,1033,22312,3578733252,3578733252,0
0,1033,22313,3578733252,3578733252,0
0,1033,22314,3578733252,3578733252,0
0,1033,22315,3578733252,3578733252,0
0,1033,22316,3578733252,3578733252,0
0,1033,22317,3578733252,3578733253,1
0,1033,22318,3578733252,3578733256,4
0,1033,22319,3578733252,3578733256,4
0,1033,22320,3578733252,3578733257,5
0,1033,22321,3578733252,3578733257,5
0,1033,22322,3578733252,3578733258,6
0,1033,22323,3578733252,3578733259,7
0,1033,22324,3578733252,3578733259,7
0,1033,22325,3578733252,3578733262,10
0,1033,22326,3578733252,3578733262,10
0,1033,22327,3578733252,3578733263,11
0,1033,22328,3578733252,3578733263,11
0,1033,22329,3578733252,3578733265,13
0,1033,22330,3578733252,3578733266,14
0,1033,22331,3578733252,3578733267,15
0,1033,22332,3578733252,3578733267,15
0,1033,22333,3578733252,3578733267,15
0,1033,22334,3578733252,3578733268,16
0,1033,22335,3578733252,3578733269,17
0,1033,22336,3578733252,3578733269,17
0,1033,22337,3578733252,3578733269,17
0,1033,22338,3578733252,3578733269,17
0,1033,22339,3578733252,3578733271,19
0,1033,22340,3578733252,3578733271,19
0,1033,22341,3578733252,3578733273,21
0,1033,22342,3578733252,3578733275,23
0,1033,22343,3578733252,3578733276,24
0,1033,22344,3578733252,3578733280,28
0,1033,22345,3578733252,3578733280,28
0,1033,22346,3578733252,3578733280,28
0,1033,22347,3578733252,3578733280,28
0,1033,22348,3578733252,3578733282,30
0,1033,22349,3578733252,3578733282,30
0,1033,22350,3578733252,3578733283,31
0,1033,22351,3578733252,3578733283,31
0,1033,22352,3578733252,3578733284,32
0,1033,22353,3578733252,3578733284,32
0,1033,22354,3578733252,3578733286,34
0,1033,22355,3578733252,3578733288,36
0,1033,22356,3578733252,3578733289,37
0,1033,22357,3578733252,3578733290,38
0,1033,22358,3578733252,3578733291,39
0,1033,22359,3578733252,3578733292,40
0,1033,22360,3578733252,3578733293,41
0,1033,22361,3578733252,3578733294,42
0,1033,22362,3578733252,3578733295,43
0,1033,22363,3578733252,3578733297,45
0,1033,22364,3578733252,3578733297,45
0,1033,22365,3578733252,3578733297,45
0,1033,22366,3578733252,3578733299,47
0,1033,22367,3578733252,3578733299,47
0,1033,22368,3578733252,3578733300,48
0,1033,22369,3578733252,3578733301,49
0,1033,22370,3578733252,3578733302,50
0,1034,22371,3578733311,3578733311,0
0,1034,22372,3578733311,3578733311,0
0,1034,22373,3578733311,3578733311,0
0,1034,22374,3578733311,3578733311,0
0,1034,22375,3578733311,3578733311,0
0,1034,22376,3578733311,3578733311,0
0,1034,22377,3578733311,3578733311,0
0,1034,22378,3578733311,3578733311,0
0,1034,22379,3578733311,3578733311,0
0,1034,22380,3578733311,3578733311,0
0,1034,22381,3578733311,3578733311,0
0,1034,22382,3578733311,3578733311,0
0,1034,22383,3578733311,3578733311,0
0,1034,22384,3578733311,3578733312,1
0,1034,22385,3578733311,3578733315,4
0,1034,22386,3578733311,3578733315,4
0,1034,22387,3578733311,3578733315,4
0,1034,22388,3578733311,3578733315,4
0,1034,22389,3578733311,3578733316,5
0,1034,22390,3578733311,3578733316,5
0,1034,22391,3578733311,3578733316,5
0,1034,22392,3578733311,3578733317,6
0,1034,22393,3578733311,3578733319,8
0,1034,22394,3578733311,3578733319,8
0,1034,22395,3578733311,3578733319,8
0,1034,22396,3578733311,3578733320,9
0,1034,22397,3578733311,3578733321,10
0,1034,22398,3578733311,3578733322,11
0,1034,22399,3578733311,3578733324,13
0,1034,22400,3578733311,3578733325,14
0,1034,22401,3578733311,3578733329,18
0,1034,22402,3578733311,3578733330,19
0,1034,22403,3578733311,3578733331,20
0,1034,22404,3578733311,3578733331,20
0,1034,22405,3578733311,3578733332,21
0,1034,22406,3578733311,3578733332,21
0,1034,22407,3578733311,3578733333,22
0,1034,22408,3578733311,3578733333,22
0,1034,22409,3578733311,3578733335,24
0,1034,22410,3578733311,3578733336,25
0,1034,22411,3578733311,3578733337,26
0,1034,22412,3578733311,3578733339,28
0,1034,22413,3578733311,3578733339,28
0,1034,22414,3578733311,3578733341,30
0,1034,22415,3578733311,3578733341,30
0,1034,22416,3578733311,3578733344,33
0,1034,22417,3578733311,3578733344,33
0,1034,22418,3578733311,3578733345,34
0,1034,22419,3578733311,3578733345,34
0,1034,22420,3578733311,3578733345,34
0,1034,22421,3578733311,3578733347,36
0,1034,22422,3578733311,3578733347,36
0,1034,22423,3578733311,3578733348,37
0,1034,22424,3578733311,3578733350,39
0,1034,22425,3578733311,3578733351,40
0,1034,22426,3578733311,3578733352,41
0,1034,22427,3578733311,3578733352,41
0,1034,22428,3578733311,3578733353,42
0,1034,22429,3578733311,3578733354,43
0,1034,22430,3578733311,3578733355,44
0,1034,22431,3578733311,3578733358,47
0,1034,22432,3578733311,3578733359,48
0,1034,22433,3578733311,3578733359,48
0,1034,22434,3578733311,3578733360,49
0,1034,22435,3578733311,3578733361,50
0,1035,22436,3578733371,3578733371,0
0,1035,22437,3578733371,3578733371,0
0,1035,22438,3578733371,3578733371,0
0,1035,22439,3578733371,3578733371,0
0,1035,22440,3578733371,3578733371,0
0,1035,22441,3578733371,3578733371,0
0,1035,22442,3578733371,3578733371,0
0,1035,22443,3578733371,3578733371,0
0,1035,22444,3578733371,3578733371,0
0,1035,22445,3578733371,3578733371,0
0,1035,22446,3578733371,3578733371,0
0,1035,22447,3578733371,3578733371,0
0,1035,22448,3578733371,3578733371,0
0,1035,22449,3578733371,3578733371,0
0,1035,22450,3578733371,3578733372,1
0,1035,22451,3578733371,3578733373,2
0,1035,22452,3578733371,3578733373,2
0,1035,22453,3578733371,3578733374,3
0,1035,22454,3578733371,3578733374,3
0,1035,22455,3578733371,3578733376,5
0,1035,22456,3578733371,3578733379,8
0,1035,22457,3578733371,3578733380,9
0,1035,22458,3578733371,3578733381,10
0,1035,22459,3578733371,3578733382,11
0,1035,22460,3578733371,3578733383,12
0,1035,22461,3578733371,3578733386,15
0,1035,22462,3578733371,3578733388,17
0,1035,22463,3578733371,3578733388,17
0,1035,22464,3578733371,3578733388,17
0,1035,22465,3578733371,3578733389,18
0,1035,22466,3578733371,3578733390,19
0,1035,22467,3578733371,3578733391,20
0,1035,22468,3578733371,3578733392,21
0,1035,22469,3578733371,3578733394,23
0,1035,22470,3578733371,3578733394,23
0,1035,22471,3578733371,3578733395,24
0,1035,22472,3578733371,3578733398,27
0,1035,22473,3578733371,3578733399,28
0,1035,22474,3578733371,3578733400,29
0,1035,22475,3578733371,3578733401,30
0,1035,22476,3578733371,3578733401,30
0,1035,22477,3578733371,3578733402,31
0,1035,22478,3578733371,3578733404,33
0,1035,22479,3578733371,3578733406,35
0,1035,22480,3578733371,3578733407,36
0,1035,22481,3578733371,3578733410,39
0,1035,22482,3578733371,3578733410,39
0,1035,22483,3578733371,3578733411,40
0,1035,22484,3578733371,3578733411,40
0,1035,22485,3578733371,3578733412,41
0,1035,22486,3578733371,3578733414,43
0,1035,22487,3578733371,3578733416,45
0,1035,22488,3578733371,3578733416,45
0,1035,22489,3578733371,3578733416,45
0,1035,22490,3578733371,3578733417,46
0,1035,22491,3578733371,3578733419,48
0,1035,22492,3578733371,3578733420,49
0,1035,22493,3578733371,3578733420,49
0,1035,22494,3578733371,3578733421,50
0,1036,22495,3578733431,3578733431,0
0,1036,22496,3578733431,3578733431,0
0,1036,22497,3578733431,3578733431,0
0,1036,22498,3578733431,3578733431,0
0,1036,22499,3578733431,3578733431,0
0,1036,22500,3578733431,3578733431,0
0,1036,22501,3578733431,3578733431,0
0,1036,22502,3578733431,3578733431,0
0,1036,22503,3578733431,3578733433,2
0,1036,22504,3578733431,3578733434,3
0,1036,22505,3578733431,3578733434,3
0,1036,22506,3578733431,3578733434,3
0,1036,22507,3578733431,3578733438,7
0,1036,22508,3578733431,3578733438,7
0,1036,22509,3578733431,3578733439,8
0,1036,22510,3578733431,3578733439,8
0,1036,22511,3578733431,3578733440,9
0,1036,22512,3578733431,3578733441,10
0,1036,22513,3578733431,3578733442,11
0,1036,22514,3578733431,3578733443,12
0,1036,22515,3578733431,3578733444,13
0,1036,22516,3578733431,3578733444,13
0,1036,22517,3578733431,3578733447,16
0,1036,22518,3578733431,3578733448,17
0,1036,22519,3578733431,3578733449,18
0,1036,22520,3578733431,3578733449,18
0,1036,22521,3578733431,3578733450,19
0,1036,22522,3578733431,3578733453,22
0,1036,22523,3578733431,3578733456,25
0,1036,22524,3578733431,3578733457,26
0,1036,22525,3578733431,3578733457,26
0,1036,22526,3578733431,3578733458,27
0,1036,22527,3578733431,3578733458,27
0,1036,22528,3578733431,3578733459,28
0,1036,22529,3578733431,3578733460,29
0,1036,22530,3578733431,3578733461,30
0,1036,22531,3578733431,3578733463,32
0,1036,22532,3578733431,3578733464,33
0,1036,22533,3578733431,3578733465,34
0,1036,22534,3578733431,3578733466,35
0,1036,22535,3578733431,3578733466,35
0,1036,22536,3578733431,3578733467,36
0,1036,22537,3578733431,3578733467,36
0,1036,22538,3578733431,3578733468,37
0,1036,22539,3578733431,3578733469,38
0,1036,22540,3578733431,3578733469,38
0,1036,22541,3578733431,3578733470,39
0,1036,22542,3578733431,3578733470,39
0,1036,22543,3578733431,3578733472,41
0,1036,22544,3578733431,3578733473,42
0,1036,22545,3578733431,3578733473,42
0,1036,22546,3578733431,3578733475,44
0,1036,22547,3578733431,3578733476,45
0,1036,22548,3578733431,3578733479,48
0,1036,22549,3578733431,3578733480,49
0,1036,22550,3578733431,3578733480,49
0,1036,22551,3578733431,3578733481,50
0,1037,22552,3578733492,3578733492,0
0,1037,22553,3578733492,3578733492,0
0,1037,22554,3578733492,3578733492,0
0,1037,22555,3578733492,3578733492,0
0,1037,22556,3578733492,3578733492,0
0,1037,22557,3578733492,3578733492,0
0,1037,22558,3578733492,3578733492,0
0,1037,22559,3578733492,3578733492,0
0,1037,22560,3578733492,3578733492,0
0,1037,22561,3578733492,3578733492,0
0,1037,22562,3578733492,3578733492,0
0,1037,22563,3578733492,3578733492,0
0,1037,22564,3578733492,3578733493,1
0,1037,22565,3578733492,3578733494,2
0,1037,22566,3578733492,3578733494,2
0,1037,22567,3578733492,3578733496,4
0,1037,22568,3578733492,3578733497,5
0,1037,22569,3578733492,3578733497,5
0,1037,22570,3578733492,3578733498,6
0,1037,22571,3578733492,3578733499,7
0,1037,22572,3578733492,3578733501,9
0,1037,22573,3578733492,3578733501,9
0,1037,22574,3578733492,3578733503,11
0,1037,22575,3578733492,3578733504,12
0,1037,22576,3578733492,3578733504,12
0,1037,22577,3578733492,3578733505,13
0,1037,22578,3578733492,3578733505,13
0,1037,22579,3578733492,3578733507,15
0,1037,22580,3578733492,3578733507,15
0,1037,22581,3578733492,3578733508,16
0,1037,22582,3578733492,3578733508,16
0,1037,22583,3578733492,3578733508,16
0,1037,22584,3578733492,3578733509,17
0,1037,22585,3578733492,3578733511,19
0,1037,22586,3578733492,3578733511,19
0,1037,22587,3578733492,3578733512,20
0,1037,22588,3578733492,3578733515,23
0,1037,22589,3578733492,3578733515,23
0,1037,22590,3578733492,3578733515,23
0,1037,22591,3578733492,3578733515,23
0,1037,22592,3578733492,3578733516,24
0,1037,22593,3578733492,3578733516,24
0,1037,22594,3578733492,3578733516,24
0,1037,22595,3578733492,3578733518,26
0,1037,22596,3578733492,3578733518,26
0,1037,22597,3578733492,3578733520,28
0,1037,22598,3578733492,3578733522,30
0,1037,22599,3578733492,3578733523,31
0,1037,22600,3578733492,3578733523,31
0,1037,22601,3578733492,3578733524,32
0,1037,22602,3578733492,3578733524,32
0,1037,22603,3578733492,3578733527,35
0,1037,22604,3578733492,3578733528,36
0,1037,22605,3578733492,3578733530,38
0,1037,22606,3578733492,3578733530,38
0,1037,22607,3578733492,3578733530,38
0,1037,22608,3578733492,3578733531,39
0,1037,22609,3578733492,3578733531,39
0,1037,22610,3578733492,3578733532,40
0,1037,22611,3578733492,3578733533,41
0,1037,22612,3578733492,3578733535,43
0,1037,22613,3578733492,3578733538,46
0,1037,22614,3578733492,3578733538,46
0,1037,22615,3578733492,3578733540,48
0,1037,22616,3578733492,3578733540,48
0,1037,22617,3578733492,3578733540,48
0,1038,22618,3578733551,3578733551,0
0,1038,22619,3578733551,3578733551,0
0,1038,22620,3578733551,3578733551,0
0,1038,22621,3578733551,3578733551,0
0,1038,22622,3578733551,3578733551,0
0,1038,22623,3578733551,3578733551,0
0,1038,22624,3578733551,3578733551,0
0,1038,22625,3578733551,3578733551,0
0,1038,22626,3578733551,3578733551,0
0,1038,22627,3578733551,3578733552,1
0,1038,22628,3578733551,3578733552,1
0,1038,22629,3578733551,3578733553,2
0,1038,22630,3578733551,3578733555,4
0,1038,22631,3578733551,3578733558,7
0,1038,22632,3578733551,3578733558,7
0,1038,22633,3578733551,3578733558,7
0,1038,22634,3578733551,3578733560,9
0,1038,22635,3578733551,3578733560,9
0,1038,22636,3578733551,3578733563,12
0,1038,22637,3578733551,3578733563,12
0,1038,22638,3578733551,3578733563,12
0,1038,22639,3578733551,3578733564,13
0,1038,22640,3578733551,3578733564,13
0,1038,22641,3578733551,3578733565,14
0,1038,22642,3578733551,3578733566,15
0,1038,22643,3578733551,3578733566,15
0,1038,22644,3578733551,3578733566,15
0,1038,22645,3578733551,3578733568,17
0,1038,22646,3578733551,3578733569,18
0,1038,22647,3578733551,3578733570,19
0,1038,22648,3578733551,3578733570,19
0,1038,22649,3578733551,3578733573,22
0,1038,22650,3578733551,3578733573,22
0,1038,22651,3578733551,3578733573,22
0,1038,22652,3578733551,3578733573,22
0,1038,22653,3578733551,3578733576,25
0,1038,22654,3578733551,3578733576,25
0,1038,22655,3578733551,3578733578,27
0,1038,22656,3578733551,3578733579,28
0,1038,22657,3578733551,3578733580,29
0,1038,22658,3578733551,3578733580,29
0,1038,22659,3578733551,3578733582,31
0,1038,22660,3578733551,3578733582,31
0,1038,22661,3578733551,3578733585,34
0,1038,22662,3578733551,3578733587,36
0,1038,22663,3578733551,3578733587,36
0,1038,22664,3578733551,3578733587,36
0,1038,22665,3578733551,3578733588,37
0,1038,22666,3578733551,3578733589,38
0,1038,22667,3578733551,3578733590,39
0,1038,22668,3578733551,3578733592,41
0,1038,22669,3578733551,3578733593,42
0,1038,22670,3578733551,3578733595,44
0,1038,22671,3578733551,3578733597,46
0,1038,22672,3578733551,3578733598,47
0,1038,22673,3578733551,3578733600,49
0,1038,22674,3578733551,3578733600,49
0,1038,22675,3578733551,3578733600,49
0,1038,22676,3578733551,3578733601,50
0,1039,22677,3578733610,3578733610,0
0,1039,22678,3578733610,3578733610,0
0,1039,22679,3578733610,3578733610,0
0,1039,22680,3578733610,3578733610,0
0,1039,22681,3578733610,3578733610,0
0,1039,22682,3578733610,3578733610,0
0,1039,22683,3578733610,3578733610,0
0,1039,22684,3578733610,3578733610,0
0,1039,22685,3578733610,3578733611,1
0,1039,22686,3578733610,3578733612,2
0,1039,22687,3578733610,3578733613,3
0,1039,22688,3578733610,3578733614,4
0,1039,22689,3578733610,3578733615,5
0,1039,22690,3578733610,3578733616,6
0,1039,22691,3578733610,3578733617,7
0,1039,22692,3578733610,3578733618,8
0,1039,22693,3578733610,3578733619,9
0,1039,22694,3578733610,3578733619,9
0,1039,22695,3578733610,3578733620,10
0,1039,22696,3578733610,3578733620,10
0,1039,22697,3578733610,3578733621,11
0,1039,22698,3578733610,3578733624,14
0,1039,22699,3578733610,3578733626,16
0,1039,22700,3578733610,3578733628,18
0,1039,22701,3578733610,3578733628,18
0,1039,22702,3578733610,3578733630,20
0,1039,22703,3578733610,3578733631,21
0,1039,22704,3578733610,3578733632,22
0,1039,22705,3578733610,3578733633,23
0,1039,22706,3578733610,3578733634,24
0,1039,22707,3578733610,3578733634,24
0,1039,22708,3578733610,3578733637,27
0,1039,22709,3578733610,3578733637,27
0,1039,22710,3578733610,3578733638,28
0,1039,22711,3578733610,3578733638,28
0,1039,22712,3578733610,3578733640,30
0,1039,22713,3578733610,3578733641,31
0,1039,22714,3578733610,3578733641,31
0,1039,22715,3578733610,3578733642,32
0,1039,22716,3578733610,3578733643,33
0,1039,22717,3578733610,3578733644,34
0,1039,22718,3578733610,3578733647,37
0,1039,22719,3578733610,3578733647,37
0,1039,22720,3578733610,3578733649,39
0,1039,22721,3578733610,3578733649,39
0,1039,22722,3578733610,3578733649,39
0,1039,22723,3578733610,3578733652,42
0,1039,22724,3578733610,3578733654,44
0,1039,22725,3578733610,3578733656,46
0,1039,22726,3578733610,3578733657,47
0,1039,22727,3578733610,3578733657,47
0,1039,22728,3578733610,3578733657,47
0,1039,22729,3578733610,3578733658,48
0,1039,22730,3578733610,3578733659,49
0,1040,22731,3578733669,3578733669,0
0,1040,22732,3578733669,3578733669,0
0,1040,22733,3578733669,3578733669,0
0,1040,22734,3578733669,3578733669,0
0,1040,22735,3578733669,3578733669,0
0,1040,22736,3578733669,3578733669,0
0,1040,22737,3578733669,3578733669,0
0,1040,22738,3578733669,3578733669,0
0,1040,22739,3578733669,3578733669,0
0,1040,22740,3578733669,3578733669,0
0,1040,22741,3578733669,3578733669,0
0,1040,22742,3578733669,3578733669,0
0,1040,22743,3578733669,3578733670,1
0,1040,22744,3578733669,3578733672,3
0,1040,22745,3578733669,3578733673,4
0,1040,22746,3578733669,3578733673,4
0,1040,22747,3578733669,3578733675,6
0,1040,22748,3578733669,3578733676,7
0,1040,22749,3578733669,3578733677,8
0,1040,22750,3578733669,3578733679,10
0,1040,22751,3578733669,3578733680,11
0,1040,22752,3578733669,3578733681,12
0,1040,22753,3578733669,3578733681,12
0,1040,22754,3578733669,3578733682,13
0,1040,22755,3578733669,3578733683,14
0,1040,22756,3578733669,3578733683,14
0,1040,22757,3578733669,3578733685,16
0,1040,22758,3578733669,3578733685,16
0,1040,22759,3578733669,3578733685,16
0,1040,22760,3578733669,3578733685,16
0,1040,22761,3578733669,3578733687,18
0,1040,22762,3578733669,3578733689,20
0,1040,22763,3578733669,3578733690,21
0,1040,22764,3578733669,3578733690,21
0,1040,22765,3578733669,3578733691,22
0,1040,22766,3578733669,3578733693,24
0,1040,22767,3578733669,3578733694,25
0,1040,22768,3578733669,3578733695,26
0,1040,22769,3578733669,3578733696,27
0,1040,22770,3578733669,3578733697,28
0,1040,22771,3578733669,3578733698,29
0,1040,22772,3578733669,3578733698,29
0,1040,22773,3578733669,3578733698,29
0,1040,22774,3578733669,3578733699,30
0,1040,22775,3578733669,3578733701,32
0,1040,22776,3578733669,3578733701,32
0,1040,22777,3578733669,3578733702,33
0,1040,22778,3578733669,3578733703,34
0,1040,22779,3578733669,3578733704,35
0,1040,22780,3578733669,3578733704,35
0,1040,22781,3578733669,3578733705,36
0,1040,22782,3578733669,3578733706,37
0,1040,22783,3578733669,3578733707,38
0,1040,22784,3578733669,3578733707,38
0,1040,22785,3578733669,3578733708,39
0,1040,22786,3578733669,3578733709,40
0,1040,22787,3578733669,3578733709,40
0,1040,22788,3578733669,3578733709,40
0,1040,22789,3578733669,3578733709,40
0,1040,22790,3578733669,3578733710,41
0,1040,22791,3578733669,3578733711,42
0,1040,22792,3578733669,3578733711,42
0,1040,22793,3578733669,3578733711,42
0,1040,22794,3578733669,3578733714,45
0,1040,22795,3578733669,3578733714,45
0,1040,22796,3578733669,3578733715,46
0,1040,22797,3578733669,3578733715,46
0,1040,22798,3578733669,3578733715,46
0,1040,22799,3578733669,3578733716,47
0,1040,22800,3578733669,3578733716,47
0,1040,22801,3578733669,3578733717,48
0,1040,22802,3578733669,3578733717,48
0,1040,22803,3578733669,3578733719,50
0,1041,22804,3578733727,3578733727,0
0,1041,22805,3578733727,3578733728,1
0,1041,22806,3578733727,3578733728,1
0,1041,22807,3578733727,3578733728,1
0,1041,22808,3578733727,3578733728,1
0,1041,22809,3578733727,3578733728,1
0,1041,22810,3578733727,3578733730,3
0,1041,22811,3578733727,3578733730,3
0,1041,22812,3578733727,3578733731,4
0,1041,22813,3578733727,3578733731,4
0,1041,22814,3578733727,3578733732,5
0,1041,22815,3578733727,3578733732,5
0,1041,22816,3578733727,3578733734,7
0,1041,22817,3578733727,3578733738,11
0,1041,22818,3578733727,3578733739,12
0,1041,22819,3578733727,3578733740,13
0,1041,22820,3578733727,3578733740,13
0,1041,22821,3578733727,3578733743,16
0,1041,22822,3578733727,3578733744,17
0,1041,22823,3578733727,3578733744,17
0,1041,22824,3578733727,3578733745,18
0,1041,22825,3578733727,3578733748,21
0,1041,22826,3578733727,3578733748,21
0,1041,22827,3578733727,3578733749,22
0,1041,22828,3578733727,3578733752,25
0,1041,22829,3578733727,3578733753,26
0,1041,22830,3578733727,3578733753,26
0,1041,22831,3578733727,3578733755,28
0,1041,22832,3578733727,3578733758,31
0,1041,22833,3578733727,3578733758,31
0,1041,22834,3578733727,3578733759,32
0,1041,22835,3578733727,3578733759,32
0,1041,22836,3578733727,3578733761,34
0,1041,22837,3578733727,3578733761,34
0,1041,22838,3578733727,3578733763,36
0,1041,22839,3578733727,3578733763,36
0,1041,22840,3578733727,3578733763,36
0,1041,22841,3578733727,3578733764,37
0,1041,22842,3578733727,3578733765,38
0,1041,22843,3578733727,3578733766,39
0,1041,22844,3578733727,3578733767,40
0,1041,22845,3578733727,3578733767,40
0,1041,22846,3578733727,3578733769,42
0,1041,22847,3578733727,3578733770,43
0,1041,22848,3578733727,3578733770,43
0,1041,22849,3578733727,3578733772,45
0,1041,22850,3578733727,3578733773,46
0,1041,22851,3578733727,3578733773,46
0,1041,22852,3578733727,3578733774,47
0,1041,22853,3578733727,3578733775,48
0,1041,22854,3578733727,3578733776,49
0,1042,22855,3578733790,3578733790,0
0,1042,22856,3578733790,3578733790,0
0,1042,22857,3578733790,3578733790,0
0,1042,22858,3578733790,3578733790,0
0,1042,22859,3578733790,3578733790,0
0,1042,22860,3578733790,3578733790,0
0,1042,22861,3578733790,3578733790,0
0,1042,22862,3578733790,3578733790,0
0,1042,22863,3578733790,3578733790,0
0,1042,22864,3578733790,3578733790,0
0,1042,22865,3578733790,3578733790,0
0,1042,22866,3578733790,3578733790,0
0,1042,22867,3578733790,3578733790,0
0,1042,22868,3578733790,3578733790,0
0,1042,22869,3578733790,3578733792,2
0,1042,22870,3578733790,3578733793,3
0,1042,22871,3578733790,3578733794,4
0,1042,22872,3578733790,3578733794,4
0,1042,22873,3578733790,3578733795,5
0,1042,22874,3578733790,3578733797,7
0,1042,22875,3578733790,3578733799,9
0,1042,22876,3578733790,3578733800,10
0,1042,22877,3578733790,3578733800,10
0,1042,22878,3578733790,3578733801,11
0,1042,22879,3578733790,3578733801,11
0,1042,22880,3578733790,3578733804,14
0,1042,22881,3578733790,3578733804,14
0,1042,22882,3578733790,3578733804,14
0,1042,22883,3578733790,3578733806,16
0,1042,22884,3578733790,3578733808,18
0,1042,22885,3578733790,3578733808,18
0,1042,22886,3578733790,3578733809,19
0,1042,22887,3578733790,3578733810,20
0,1042,22888,3578733790,3578733812,22
0,1042,22889,3578733790,3578733812,22
0,1042,22890,3578733790,3578733813,23
0,1042,22891,3578733790,3578733814,24
0,1042,22892,3578733790,3578733814,24
0,1042,22893,3578733790,3578733814,24
0,1042,22894,3578733790,3578733817,27
0,1042,22895,3578733790,3578733819,29
0,1042,22896,3578733790,3578733820,30
0,1042,22897,3578733790,3578733820,30
0,1042,22898,3578733790,3578733821,31
0,1042,22899,3578733790,3578733821,31
0,1042,22900,3578733790,3578733822,32
0,1042,22901,3578733790,3578733824,34
0,1042,22902,3578733790,3578733826,36
0,1042,22903,3578733790,3578733827,37
0,1042,22904,3578733790,3578733828,38
0,1042,22905,3578733790,3578733829,39
0,1042,22906,3578733790,3578733830,40
0,1042,22907,3578733790,3578733831,41
0,1042,22908,3578733790,3578733832,42
0,1042,22909,3578733790,3578733834,44
0,1042,22910,3578733790,3578733835,45
0,1042,22911,3578733790,3578733835,45
0,1042,22912,3578733790,3578733836,46
0,1042,22913,3578733790,3578733837,47
0,1042,22914,3578733790,3578733838,48
0,1042,22915,3578733790,3578733839,49
0,1043,22916,3578733853,3578733853,0
0,1043,22917,3578733853,3578733853,0
0,1043,22918,3578733853,3578733853,0
0,1043,22919,3578733853,3578733853,0
0,1043,22920,3578733853,3578733853,0
0,1043,22921,3578733853,3578733853,0
0,1043,22922,3578733853,3578733853,0
0,1043,22923,3578733853,3578733853,0
0,1043,22924,3578733853,3578733853,0
0,1043,22925,3578733853,3578733853,0
0,1043,22926,3578733853,3578733853,0
0,1043,22927,3578733853,3578733853,0
0,1043,22928,3578733853,3578733853,0
0,1043,22929,3578733853,3578733853,0
0,1043,22930,3578733853,3578733855,2
0,1043,22931,3578733853,3578733856,3
0,1043,22932,3578733853,3578733857,4
0,1043,22933,3578733853,3578733857,4
0,1043,22934,3578733853,3578733857,4
0,1043,22935,3578733853,3578733859,6
0,1043,22936,3578733853,3578733859,6
0,1043,22937,3578733853,3578733862,9
0,1043,22938,3578733853,3578733864,11
0,1043,22939,3578733853,3578733864,11
0,1043,22940,3578733853,3578733865,12
0,1043,22941,3578733853,3578733865,12
0,1043,22942,3578733853,3578733866,13
0,1043,22943,3578733853,3578733866,13
0,1043,22944,3578733853,3578733866,13
0,1043,22945,3578733853,3578733867,14
0,1043,22946,3578733853,3578733868,15
0,1043,22947,3578733853,3578733869,16
0,1043,22948,3578733853,3578733869,16
0,1043,22949,3578733853,3578733870,17
0,1043,22950,3578733853,3578733873,20
0,1043,22951,3578733853,3578733873,20
0,1043,22952,3578733853,3578733873,20
0,1043,22953,3578733853,3578733875,22
0,1043,22954,3578733853,3578733877,24
0,1043,22955,3578733853,3578733877,24
0,1043,22956,3578733853,3578733879,26
0,1043,22957,3578733853,3578733880,27
0,1043,22958,3578733853,3578733880,27
0,1043,22959,3578733853,3578733881,28
0,1043,22960,3578733853,3578733881,28
0,1043,22961,3578733853,3578733882,29
0,1043,22962,3578733853,3578733883,30
0,1043,22963,3578733853,3578733883,30
0,1043,22964,3578733853,3578733885,32
0,1043,22965,3578733853,3578733885,32
0,1043,22966,3578733853,3578733885,32
0,1043,22967,3578733853,3578733886,33
0,1043,22968,3578733853,3578733887,34
0,1043,22969,3578733853,3578733887,34
0,1043,22970,3578733853,3578733888,35
0,1043,22971,3578733853,3578733890,37
0,1043,22972,3578733853,3578733890,37
0,1043,22973,3578733853,3578733891,38
0,1043,22974,3578733853,3578733894,41
0,1043,22975,3578733853,3578733894,41
0,1043,22976,3578733853,3578733895,42
0,1043,22977,3578733853,3578733896,43
0,1043,22978,3578733853,3578733897,44
0,1043,22979,3578733853,3578733897,44
0,1043,22980,3578733853,3578733898,45
0,1043,22981,3578733853,3578733898,45
0,1043,22982,3578733853,3578734000,147
0,1043,22983,3578733853,3578734000,147
0,1043,22984,3578733853,3578734000,147
0,1043,22985,3578733853,3578734000,147
0,1043,22986,3578733853,3578734000,147
0,1043,22987,3578733853,3578734000,147
0,1043,22988,3578733853,3578734000,147
0,1043,22989,3578733853,3578734000,147
0,1043,22990,3578733853,3578734000,147
0,1043,22991,3578733853,3578734000,147
0,1043,22992,3578733853,3578734000,147
0,1043,22993,3578733853,3578734000,147
0,1043,22994,3578733853,3578734000,147
0,1043,22995,3578733853,3578734000,147
0,1043,22996,3578733853,3578734001,148
0,1043,22997,3578733853,3578734001,148
0,1043,22998,3578733853,3578734001,148
0,1043,22999,3578733853,3578734001,148
0,1043,23000,3578733853,3578734001,148
0,1043,23001,3578733853,3578734001,148
0,1043,23002,3578733853,3578734001,148
0,1043,23003,3578733853,3578734001,148
0,1043,23004,3578733853,3578734001,148
0,1043,23005,3578733853,3578734001,148
0,1043,23006,3578733853,3578734001,148
0,1043,23007,3578733853,3578734001,148
0,1043,23008,3578733853,3578734001,148
0,1043,23009,3578733853,3578734001,148
0,1043,23010,3578733853,3578734001,148
0,1043,23011,3578733853,3578734001,148
0,1043,23012,3578733853,3578734001,148
0,1043,23013,3578733853,3578734001,148
0,1043,23014,3578733853,3578734001,148
0,1043,23015,3578733853,3578734001,148
0,1043,23016,3578733853,3578734001,148
0,1043,23017,3578733853,3578734001,148
0,1043,23018,3578733853,3578734001,148
0,1043,23019,3578733853,3578734001,148
0,1043,23020,3578733853,3578734001,148
0,1043,23021,3578733853,3578734001,148
0,1043,23022,3578733853,3578734001,148
0,1043,23023,3578733853,3578734001,148
0,1043,23024,3578733853,3578734001,148
0,1043,23025,3578733853,3578734001,148
0,1043,23026,3578733853,3578734001,148
0,1043,23027,3578733853,3578734001,148
0,1043,23028,3578733853,3578734001,148
0,1043,23029,3578733853,3578734001,148
0,1043,23030,3578733853,3578734001,148
0,1043,23031,3578733853,3578734001,148
0,1043,23032,3578733853,3578734001,148
0,1043,23033,3578733853,3578734001,148
0,1043,23034,3578733853,3578734001,148
0,1043,23035,3578733853,3578734001,148
0,1043,23036,3578733853,3578734001,148
0,1043,23037,3578733853,3578734001,148
0,1043,23038,3578733853,3578734001,148
0,1043,23039,3578733853,3578734001,148
0,1043,23040,3578733853,3578734001,148
0,1043,23041,3578733853,3578734001,148
0,1043,23042,3578733853,3578734001,148
0,1043,23043,3578733853,3578734001,148
0,1043,23044,3578733853,3578734001,148
0,1043,23045,3578733853,3578734001,148
0,1043,23046,3578733853,3578734001,148
0,1043,23047,3578733853,3578734001,148
0,1043,23048,3578733853,3578734001,148
0,1043,23049,3578733853,3578734001,148
0,1043,23050,3578733853,3578734001,148
0,1043,23051,3578733853,3578734001,148
0,1043,23052,3578733853,3578734001,148
0,1043,23053,3578733853,3578734001,148
0,1043,23054,3578733853,3578734001,148
0,1043,23055,3578733853,3578734001,148
0,1043,23056,3578733853,3578734001,148
0,1043,23057,3578733853,3578734001,148
0,1043,23058,3578733853,3578734001,148
0,1043,23059,3578733853,3578734001,148
0,1043,23060,3578733853,3578734001,148
0,1043,23061,3578733853,3578734001,148
0,1043,23062,3578733853,3578734001,148
0,1043,23063,3578733853,3578734001,148
0,1043,23064,3578733853,3578734001,148
0,1043,23065,3578733853,3578734001,148
0,1043,23066,3578733853,3578734001,148
0,1043,23067,3578733853,3578734001,148
0,1043,23068,3578733853,3578734001,148
0,1043,23069,3578733853,3578734001,148
0,1043,23070,3578733853,3578734001,148
0,1043,23071,3578733853,3578734001,148
0,1043,23072,3578733853,3578734001,148
0,1043,23073,3578733853,3578734001,148
0,1043,23074,3578733853,3578734001,148
0,1043,23075,3578733853,3578734001,148
0,1043,23076,3578733853,3578734001,148
0,1043,23077,3578733853,3578734001,148
0,1043,23078,3578733853,3578734001,148
0,1043,23079,3578733853,3578734001,148
0,1043,23080,3578733853,3578734001,148
0,1043,23081,3578733853,3578734001,148
0,1043,23082,3578733853,3578734001,148
0,1043,23083,3578733853,3578734001,148
0,1043,23084,3578733853,3578734001,148
0,1044,23085,3578734010,3578734010,0
0,1044,23086,3578734010,3578734010,0
0,1044,23087,3578734010,3578734010,0
0,1044,23088,3578734010,3578734010,0
0,1044,23089,3578734010,3578734010,0
0,1044,23090,3578734010,3578734010,0
0,1044,23091,3578734010,3578734010,0
0,1044,23092,3578734010,3578734010,0
0,1044,23093,3578734010,3578734010,0
0,1044,23094,3578734010,3578734010,0
0,1044,23095,3578734010,3578734010,0
0,1044,23096,3578734010,3578734011,1
0,1044,23097,3578734010,3578734012,2
0,1044,23098,3578734010,3578734014,4
0,1044,23099,3578734010,3578734014,4
0,1044,23100,3578734010,3578734015,5
0,1044,23101,3578734010,3578734015,5
0,1044,23102,3578734010,3578734017,7
0,1044,23103,3578734010,3578734019,9
0,1044,23104,3578734010,3578734019,9
0,1044,23105,3578734010,3578734020,10
0,1044,23106,3578734010,3578734021,11
0,1044,23107,3578734010,3578734021,11
0,1044,23108,3578734010,3578734021,11
0,1044,23109,3578734010,3578734022,12
0,1044,23110,3578734010,3578734024,14
0,1044,23111,3578734010,3578734026,16
0,1044,23112,3578734010,3578734028,18
0,1044,23113,3578734010,3578734029,19
0,1044,23114,3578734010,3578734030,20
0,1044,23115,3578734010,3578734031,21
0,1044,23116,3578734010,3578734032,22
0,1044,23117,3578734010,3578734034,24
0,1044,23118,3578734010,3578734034,24
0,1044,23119,3578734010,3578734036,26
0,1044,23120,3578734010,3578734036,26
0,1044,23121,3578734010,3578734037,27
0,1044,23122,3578734010,3578734037,27
0,1044,23123,3578734010,3578734038,28
0,1044,23124,3578734010,3578734039,29
0,1044,23125,3578734010,3578734040,30
0,1044,23126,3578734010,3578734041,31
0,1044,23127,3578734010,3578734041,31
0,1044,23128,3578734010,3578734043,33
0,1044,23129,3578734010,3578734043,33
0,1044,23130,3578734010,3578734043,33
0,1044,23131,3578734010,3578734044,34
0,1044,23132,3578734010,3578734045,35
0,1044,23133,3578734010,3578734047,37
0,1044,23134,3578734010,3578734048,38
0,1044,23135,3578734010,3578734049,39
0,1044,23136,3578734010,3578734050,40
0,1044,23137,3578734010,3578734050,40
0,1044,23138,3578734010,3578734052,42
0,1044,23139,3578734010,3578734055,45
0,1044,23140,3578734010,3578734056,46
0,1044,23141,3578734010,3578734057,47
0,1044,23142,3578734010,3578734058,48
0,1044,23143,3578734010,3578734058,48
0,1044,23144,3578734010,3578734058,48
0,1044,23145,3578734010,3578734059,49
0,1045,23146,3578734070,3578734070,0
0,1045,23147,3578734070,3578734070,0
0,1045,23148,3578734070,3578734070,0
0,1045,23149,3578734070,3578734070,0
0,1045,23150,3578734070,3578734070,0
0,1045,23151,3578734070,3578734070,0
0,1045,23152,3578734070,3578734070,0
0,1045,23153,3578734070,3578734070,0
0,1045,23154,3578734070,3578734070,0
0,1045,23155,3578734070,3578734071,1
0,1045,23156,3578734070,3578734073,3
0,1045,23157,3578734070,3578734073,3
0,1045,23158,3578734070,3578734073,3
0,1045,23159,3578734070,3578734075,5
0,1045,23160,3578734070,3578734076,6
0,1045,23161,3578734070,3578734077,7
0,1045,23162,3578734070,3578734079,9
0,1045,23163,3578734070,3578734081,11
0,1045,23164,3578734070,3578734081,11
0,1045,23165,3578734070,3578734081,11
0,1045,23166,3578734070,3578734081,11
0,1045,23167,3578734070,3578734082,12
0,1045,23168,3578734070,3578734083,13
0,1045,23169,3578734070,3578734084,14
0,1045,23170,3578734070,3578734085,15
0,1045,23171,3578734070,3578734085,15
0,1045,23172,3578734070,3578734086,16
0,1045,23173,3578734070,3578734086,16
0,1045,23174,3578734070,3578734087,17
0,1045,23175,3578734070,3578734087,17
0,1045,23176,3578734070,3578734089,19
0,1045,23177,3578734070,3578734089,19
0,1045,23178,3578734070,3578734090,20
0,1045,23179,3578734070,3578734091,21
0,1045,23180,3578734070,3578734093,23
0,1045,23181,3578734070,3578734094,24
0,1045,23182,3578734070,3578734095,25
0,1045,23183,3578734070,3578734095,25
0,1045,23184,3578734070,3578734097,27
0,1045,23185,3578734070,3578734097,27
0,1045,23186,3578734070,3578734098,28
0,1045,23187,3578734070,3578734099,29
0,1045,23188,3578734070,3578734099,29
0,1045,23189,3578734070,3578734100,30
0,1045,23190,3578734070,3578734102,32
0,1045,23191,3578734070,3578734102,32
0,1045,23192,3578734070,3578734103,33
0,1045,23193,3578734070,3578734104,34
0,1045,23194,3578734070,3578734105,35
0,1045,23195,3578734070,3578734105,35
0,1045,23196,3578734070,3578734105,35
0,1045,23197,3578734070,3578734105,35
0,1045,23198,3578734070,3578734107,37
0,1045,23199,3578734070,3578734107,37
0,1045,23200,3578734070,3578734107,37
0,1045,23201,3578734070,3578734108,38
0,1045,23202,3578734070,3578734109,39
0,1045,23203,3578734070,3578734109,39
0,1045,23204,3578734070,3578734110,40
0,1045,23205,3578734070,3578734110,40
0,1045,23206,3578734070,3578734110,40
0,1045,23207,3578734070,3578734113,43
0,1045,23208,3578734070,3578734114,44
0,1045,23209,3578734070,3578734115,45
0,1045,23210,3578734070,3578734116,46
0,1045,23211,3578734070,3578734116,46
0,1045,23212,3578734070,3578734117,47
0,1045,23213,3578734070,3578734117,47
0,1045,23214,3578734070,3578734117,47
0,1045,23215,3578734070,3578734118,48
0,1045,23216,3578734070,3578734118,48
0,1045,23217,3578734070,3578734119,49
0,1045,23218,3578734070,3578734120,50
0,1046,23219,3578734129,3578734129,0
0,1046,23220,3578734129,3578734129,0
0,1046,23221,3578734129,3578734129,0
0,1046,23222,3578734129,3578734129,0
0,1046,23223,3578734129,3578734129,0
0,1046,23224,3578734129,3578734129,0
0,1046,23225,3578734129,3578734129,0
0,1046,23226,3578734129,3578734131,2
0,1046,23227,3578734129,3578734131,2
0,1046,23228,3578734129,3578734131,2
0,1046,23229,3578734129,3578734131,2
0,1046,23230,3578734129,3578734132,3
0,1046,23231,3578734129,3578734134,5
0,1046,23232,3578734129,3578734134,5
0,1046,23233,3578734129,3578734135,6
0,1046,23234,3578734129,3578734138,9
0,1046,23235,3578734129,3578734139,10
0,1046,23236,3578734129,3578734139,10
0,1046,23237,3578734129,3578734140,11
0,1046,23238,3578734129,3578734141,12
0,1046,23239,3578734129,3578734141,12
0,1046,23240,3578734129,3578734143,14
0,1046,23241,3578734129,3578734143,14
0,1046,23242,3578734129,3578734144,15
0,1046,23243,3578734129,3578734145,16
0,1046,23244,3578734129,3578734147,18
0,1046,23245,3578734129,3578734148,19
0,1046,23246,3578734129,3578734149,20
0,1046,23247,3578734129,3578734149,20
0,1046,23248,3578734129,3578734151,22
0,1046,23249,3578734129,3578734152,23
0,1046,23250,3578734129,3578734153,24
0,1046,23251,3578734129,3578734153,24
0,1046,23252,3578734129,3578734153,24
0,1046,23253,3578734129,3578734155,26
0,1046,23254,3578734129,3578734159,30
0,1046,23255,3578734129,3578734159,30
0,1046,23256,3578734129,3578734159,30
0,1046,23257,3578734129,3578734161,32
0,1046,23258,3578734129,3578734161,32
0,1046,23259,3578734129,3578734161,32
0,1046,23260,3578734129,3578734161,32
0,1046,23261,3578734129,3578734163,34
0,1046,23262,3578734129,3578734163,34
0,1046,23263,3578734129,3578734164,35
0,1046,23264,3578734129,3578734165,36
0,1046,23265,3578734129,3578734166,37
0,1046,23266,3578734129,3578734167,38
0,1046,23267,3578734129,3578734168,39
0,1046,23268,3578734129,3578734169,40
0,1046,23269,3578734129,3578734170,41
0,1046,23270,3578734129,3578734170,41
0,1046,23271,3578734129,3578734171,42
0,1046,23272,3578734129,3578734173,44
0,1046,23273,3578734129,3578734173,44
0,1046,23274,3578734129,3578734174,45
0,1046,23275,3578734129,3578734174,45
0,1046,23276,3578734129,3578734176,47
0,1046,23277,3578734129,3578734177,48
0,1047,23278,3578734187,3578734187,0
0,1047,23279,3578734187,3578734187,0
0,1047,23280,3578734187,3578734187,0
0,1047,23281,3578734187,3578734187,0
0,1047,23282,3578734187,3578734187,0
0,1047,23283,3578734187,3578734187,0
0,1047,23284,3578734187,3578734188,1
0,1047,23285,3578734187,3578734188,1
0,1047,23286,3578734187,3578734188,1
0,1047,23287,3578734187,3578734189,2
0,1047,23288,3578734187,3578734189,2
0,1047,23289,3578734187,3578734190,3
0,1047,23290,3578734187,3578734193,6
0,1047,23291,3578734187,3578734194,7
0,1047,23292,3578734187,3578734195,8
0,1047,23293,3578734187,3578734196,9
0,1047,23294,3578734187,3578734197,10
0,1047,23295,3578734187,3578734198,11
0,1047,23296,3578734187,3578734199,12
0,1047,23297,3578734187,3578734200,13
0,1047,23298,3578734187,3578734201,14
0,1047,23299,3578734187,3578734202,15
0,1047,23300,3578734187,3578734203,16
0,1047,23301,3578734187,3578734204,17
0,1047,23302,3578734187,3578734205,18
0,1047,23303,3578734187,3578734206,19
0,1047,23304,3578734187,3578734209,22
0,1047,23305,3578734187,3578734209,22
0,1047,23306,3578734187,3578734210,23
0,1047,23307,3578734187,3578734211,24
0,1047,23308,3578734187,3578734212,25
0,1047,23309,3578734187,3578734212,25
0,1047,23310,3578734187,3578734214,27
0,1047,23311,3578734187,3578734214,27
0,1047,23312,3578734187,3578734215,28
0,1047,23313,3578734187,3578734216,29
0,1047,23314,3578734187,3578734217,30
0,1047,23315,3578734187,3578734218,31
0,1047,23316,3578734187,3578734219,32
0,1047,23317,3578734187,3578734220,33
0,1047,23318,3578734187,3578734220,33
0,1047,23319,3578734187,3578734221,34
0,1047,23320,3578734187,3578734221,34
0,1047,23321,3578734187,3578734221,34
0,1047,23322,3578734187,3578734222,35
0,1047,23323,3578734187,3578734224,37
0,1047,23324,3578734187,3578734227,40
0,1047,23325,3578734187,3578734228,41
0,1047,23326,3578734187,3578734229,42
0,1047,23327,3578734187,3578734230,43
0,1047,23328,3578734187,3578734231,44
0,1047,23329,3578734187,3578734232,45
0,1047,23330,3578734187,3578734233,46
0,1047,23331,3578734187,3578734234,47
0,1047,23332,3578734187,3578734234,47
0,1047,23333,3578734187,3578734235,48
0,1047,23334,3578734187,3578734236,49
0,1047,23335,3578734187,3578734237,50
0,1048,23336,3578734245,3578734245,0
0,1048,23337,3578734245,3578734245,0
0,1048,23338,3578734245,3578734245,0
0,1048,23339,3578734245,3578734245,0
0,1048,23340,3578734245,3578734245,0
0,1048,23341,3578734245,3578734245,0
0,1048,23342,3578734245,3578734245,0
0,1048,23343,3578734245,3578734245,0
0,1048,23344,3578734245,3578734245,0
0,1048,23345,3578734245,3578734246,1
0,1048,23346,3578734245,3578734247,2
0,1048,23347,3578734245,3578734248,3
0,1048,23348,3578734245,3578734248,3
0,1048,23349,3578734245,3578734249,4
0,1048,23350,3578734245,3578734250,5
0,1048,23351,3578734245,3578734251,6
0,1048,23352,3578734245,3578734253,8
0,1048,23353,3578734245,3578734255,10
0,1048,23354,3578734245,3578734256,11
0,1048,23355,3578734245,3578734257,12
0,1048,23356,3578734245,3578734258,13
0,1048,23357,3578734245,3578734258,13
0,1048,23358,3578734245,3578734259,14
0,1048,23359,3578734245,3578734260,15
0,1048,23360,3578734245,3578734262,17
0,1048,23361,3578734245,3578734265,20
0,1048,23362,3578734245,3578734266,21
0,1048,23363,3578734245,3578734266,21
0,1048,23364,3578734245,3578734267,22
0,1048,23365,3578734245,3578734267,22
0,1048,23366,3578734245,3578734268,23
0,1048,23367,3578734245,3578734269,24
0,1048,23368,3578734245,3578734269,24
0,1048,23369,3578734245,3578734270,25
0,1048,23370,3578734245,3578734271,26
0,1048,23371,3578734245,3578734273,28
0,1048,23372,3578734245,3578734274,29
0,1048,23373,3578734245,3578734274,29
0,1048,23374,3578734245,3578734275,30
0,1048,23375,3578734245,3578734276,31
0,1048,23376,3578734245,3578734277,32
0,1048,23377,3578734245,3578734280,35
0,1048,23378,3578734245,3578734280,35
0,1048,23379,3578734245,3578734281,36
0,1048,23380,3578734245,3578734281,36
0,1048,23381,3578734245,3578734281,36
0,1048,23382,3578734245,3578734282,37
0,1048,23383,3578734245,3578734283,38
0,1048,23384,3578734245,3578734284,39
0,1048,23385,3578734245,3578734284,39
0,1048,23386,3578734245,3578734285,40
0,1048,23387,3578734245,3578734286,41
0,1048,23388,3578734245,3578734286,41
0,1048,23389,3578734245,3578734287,42
0,1048,23390,3578734245,3578734289,44
0,1048,23391,3578734245,3578734290,45
0,1048,23392,3578734245,3578734291,46
0,1048,23393,3578734245,3578734291,46
0,1048,23394,3578734245,3578734294,49
0,1048,23395,3578734245,3578734294,49
0,1048,23396,3578734245,3578734294,49
0,1049,23397,3578734305,3578734305,0
0,1049,23398,3578734305,3578734305,0
0,1049,23399,3578734305,3578734305,0
0,1049,23400,3578734305,3578734305,0
0,1049,23401,3578734305,3578734305,0
0,1049,23402,3578734305,3578734305,0
0,1049,23403,3578734305,3578734305,0
0,1049,23404,3578734305,3578734305,0
0,1049,23405,3578734305,3578734305,0
0,1049,23406,3578734305,3578734305,0
0,1049,23407,3578734305,3578734305,0
0,1049,23408,3578734305,3578734305,0
0,1049,23409,3578734305,3578734306,1
0,1049,23410,3578734305,3578734307,2
0,1049,23411,3578734305,3578734307,2
0,1049,23412,3578734305,3578734308,3
0,1049,23413,3578734305,3578734308,3
0,1049,23414,3578734305,3578734308,3
0,1049,23415,3578734305,3578734308,3
0,1049,23416,3578734305,3578734311,6
0,1049,23417,3578734305,3578734311,6
0,1049,23418,3578734305,3578734311,6
0,1049,23419,3578734305,3578734311,6
0,1049,23420,3578734305,3578734314,9
0,1049,23421,3578734305,3578734314,9
0,1049,23422,3578734305,3578734315,10
0,1049,23423,3578734305,3578734315,10
0,1049,23424,3578734305,3578734316,11
0,1049,23425,3578734305,3578734316,11
0,1049,23426,3578734305,3578734318,13
0,1049,23427,3578734305,3578734318,13
0,1049,23428,3578734305,3578734318,13
0,1049,23429,3578734305,3578734319,14
0,1049,23430,3578734305,3578734319,14
0,1049,23431,3578734305,3578734320,15
0,1049,23432,3578734305,3578734320,15
0,1049,23433,3578734305,3578734323,18
0,1049,23434,3578734305,3578734324,19
0,1049,23435,3578734305,3578734326,21
0,1049,23436,3578734305,3578734328,23
0,1049,23437,3578734305,3578734328,23
0,1049,23438,3578734305,3578734329,24
0,1049,23439,3578734305,3578734331,26
0,1049,23440,3578734305,3578734331,26
0,1049,23441,3578734305,3578734331,26
0,1049,23442,3578734305,3578734331,26
0,1049,23443,3578734305,3578734332,27
0,1049,23444,3578734305,3578734333,28
0,1049,23445,3578734305,3578734335,30
0,1049,23446,3578734305,3578734335,30
0,1049,23447,3578734305,3578734338,33
0,1049,23448,3578734305,3578734339,34
0,1049,23449,3578734305,3578734339,34
0,1049,23450,3578734305,3578734340,35
0,1049,23451,3578734305,3578734340,35
0,1049,23452,3578734305,3578734341,36
0,1049,23453,3578734305,3578734342,37
0,1049,23454,3578734305,3578734344,39
0,1049,23455,3578734305,3578734344,39
0,1049,23456,3578734305,3578734345,40
0,1049,23457,3578734305,3578734346,41
0,1049,23458,3578734305,3578734347,42
0,1049,23459,3578734305,3578734348,43
0,1049,23460,3578734305,3578734349,44
0,1049,23461,3578734305,3578734349,44
0,1049,23462,3578734305,3578734350,45
0,1049,23463,3578734305,3578734351,46
0,1049,23464,3578734305,3578734352,47
0,1049,23465,3578734305,3578734352,47
0,1049,23466,3578734305,3578734353,48
0,1049,23467,3578734305,3578734353,48
0,1050,23468,3578734363,3578734363,0
0,1050,23469,3578734363,3578734363,0
0,1050,23470,3578734363,3578734363,0
0,1050,23471,3578734363,3578734363,0
0,1050,23472,3578734363,3578734363,0
0,1050,23473,3578734363,3578734363,0
0,1050,23474,3578734363,3578734363,0
0,1050,23475,3578734363,3578734363,0
0,1050,23476,3578734363,3578734364,1
0,1050,23477,3578734363,3578734365,2
0,1050,23478,3578734363,3578734365,2
0,1050,23479,3578734363,3578734365,2
0,1050,23480,3578734363,3578734365,2
0,1050,23481,3578734363,3578734366,3
0,1050,23482,3578734363,3578734367,4
0,1050,23483,3578734363,3578734367,4
0,1050,23484,3578734363,3578734369,6
0,1050,23485,3578734363,3578734370,7
0,1050,23486,3578734363,3578734370,7
0,1050,23487,3578734363,3578734372,9
0,1050,23488,3578734363,3578734372,9
0,1050,23489,3578734363,3578734374,11
0,1050,23490,3578734363,3578734374,11
0,1050,23491,3578734363,3578734376,13
0,1050,23492,3578734363,3578734377,14
0,1050,23493,3578734363,3578734379,16
0,1050,23494,3578734363,3578734382,19
0,1050,23495,3578734363,3578734383,20
0,1050,23496,3578734363,3578734383,20
0,1050,23497,3578734363,3578734384,21
0,1050,23498,3578734363,3578734384,21
0,1050,23499,3578734363,3578734387,24
0,1050,23500,3578734363,3578734388,25
0,1050,23501,3578734363,3578734388,25
0,1050,23502,3578734363,3578734388,25
0,1050,23503,3578734363,3578734389,26
0,1050,23504,3578734363,3578734389,26
0,1050,23505,3578734363,3578734393,30
0,1050,23506,3578734363,3578734394,31
0,1050,23507,3578734363,3578734395,32
0,1050,23508,3578734363,3578734397,34
0,1050,23509,3578734363,3578734398,35
0,1050,23510,3578734363,3578734398,35
0,1050,23511,3578734363,3578734400,37
0,1050,23512,3578734363,3578734401,38
0,1050,23513,3578734363,3578734401,38
0,1050,23514,3578734363,3578734402,39
0,1050,23515,3578734363,3578734404,41
0,1050,23516,3578734363,3578734405,42
0,1050,23517,3578734363,3578734406,43
0,1050,23518,3578734363,3578734406,43
0,1050,23519,3578734363,3578734406,43
0,1050,23520,3578734363,3578734406,43
0,1050,23521,3578734363,3578734409,46
0,1050,23522,3578734363,3578734409,46
0,1050,23523,3578734363,3578734411,48
0,1050,23524,3578734363,3578734411,48
0,1050,23525,3578734363,3578734413,50
0,1051,23526,3578734425,3578734425,0
0,1051,23527,3578734425,3578734425,0
0,1051,23528,3578734425,3578734425,0
0,1051,23529,3578734425,3578734425,0
0,1051,23530,3578734425,3578734425,0
0,1051,23531,3578734425,3578734425,0
0,1051,23532,3578734425,3578734425,0
0,1051,23533,3578734425,3578734425,0
0,1051,23534,3578734425,3578734425,0
0,1051,23535,3578734425,3578734425,0
0,1051,23536,3578734425,3578734425,0
0,1051,23537,3578734425,3578734425,0
0,1051,23538,3578734425,3578734425,0
0,1051,23539,3578734425,3578734427,2
0,1051,23540,3578734425,3578734428,3
0,1051,23541,3578734425,3578734430,5
0,1051,23542,3578734425,3578734430,5
0,1051,23543,3578734425,3578734431,6
0,1051,23544,3578734425,3578734433,8
0,1051,23545,3578734425,3578734433,8
0,1051,23546,3578734425,3578734434,9
0,1051,23547,3578734425,3578734434,9
0,1051,23548,3578734425,3578734436,11
0,1051,23549,3578734425,3578734436,11
0,1051,23550,3578734425,3578734437,12
0,1051,23551,3578734425,3578734437,12
0,1051,23552,3578734425,3578734439,14
0,1051,23553,3578734425,3578734440,15
0,1051,23554,3578734425,3578734441,16
0,1051,23555,3578734425,3578734442,17
0,1051,23556,3578734425,3578734442,17
0,1051,23557,3578734425,3578734443,18
0,1051,23558,3578734425,3578734444,19
0,1051,23559,3578734425,3578734446,21
0,1051,23560,3578734425,3578734447,22
0,1051,23561,3578734425,3578734448,23
0,1051,23562,3578734425,3578734450,25
0,1051,23563,3578734425,3578734450,25
0,1051,23564,3578734425,3578734451,26
0,1051,23565,3578734425,3578734451,26
0,1051,23566,3578734425,3578734453,28
0,1051,23567,3578734425,3578734455,30
0,1051,23568,3578734425,3578734457,32
0,1051,23569,3578734425,3578734458,33
0,1051,23570,3578734425,3578734458,33
0,1051,23571,3578734425,3578734459,34
0,1051,23572,3578734425,3578734459,34
0,1051,23573,3578734425,3578734460,35
0,1051,23574,3578734425,3578734462,37
0,1051,23575,3578734425,3578734462,37
0,1051,23576,3578734425,3578734465,40
0,1051,23577,3578734425,3578734466,41
0,1051,23578,3578734425,3578734466,41
0,1051,23579,3578734425,3578734467,42
0,1051,23580,3578734425,3578734467,42
0,1051,23581,3578734425,3578734467,42
0,1051,23582,3578734425,3578734469,44
0,1051,23583,3578734425,3578734470,45
0,1051,23584,3578734425,3578734470,45
0,1051,23585,3578734425,3578734471,46
0,1051,23586,3578734425,3578734473,48
0,1051,23587,3578734425,3578734474,49
0,1051,23588,3578734425,3578734475,50
0,1052,23589,3578734484,3578734484,0
0,1052,23590,3578734484,3578734484,0
0,1052,23591,3578734484,3578734484,0
0,1052,23592,3578734484,3578734484,0
0,1052,23593,3578734484,3578734484,0
0,1052,23594,3578734484,3578734484,0
0,1052,23595,3578734484,3578734484,0
0,1052,23596,3578734484,3578734484,0
0,1052,23597,3578734484,3578734484,0
0,1052,23598,3578734484,3578734484,0
0,1052,23599,3578734484,3578734484,0
0,1052,23600,3578734484,3578734484,0
0,1052,23601,3578734484,3578734484,0
0,1052,23602,3578734484,3578734485,1
0,1052,23603,3578734484,3578734485,1
0,1052,23604,3578734484,3578734486,2
0,1052,23605,3578734484,3578734489,5
0,1052,23606,3578734484,3578734489,5
0,1052,23607,3578734484,3578734490,6
0,1052,23608,3578734484,3578734490,6
0,1052,23609,3578734484,3578734492,8
0,1052,23610,3578734484,3578734493,9
0,1052,23611,3578734484,3578734494,10
0,1052,23612,3578734484,3578734496,12
0,1052,23613,3578734484,3578734498,14
0,1052,23614,3578734484,3578734498,14
0,1052,23615,3578734484,3578734499,15
0,1052,23616,3578734484,3578734499,15
0,1052,23617,3578734484,3578734499,15
0,1052,23618,3578734484,3578734501,17
0,1052,23619,3578734484,3578734501,17
0,1052,23620,3578734484,3578734504,20
0,1052,23621,3578734484,3578734505,21
0,1052,23622,3578734484,3578734505,21
0,1052,23623,3578734484,3578734506,22
0,1052,23624,3578734484,3578734506,22
0,1052,23625,3578734484,3578734507,23
0,1052,23626,3578734484,3578734507,23
0,1052,23627,3578734484,3578734507,23
0,1052,23628,3578734484,3578734507,23
0,1052,23629,3578734484,3578734508,24
0,1052,23630,3578734484,3578734508,24
0,1052,23631,3578734484,3578734509,25
0,1052,23632,3578734484,3578734510,26
0,1052,23633,3578734484,3578734510,26
0,1052,23634,3578734484,3578734510,26
0,1052,23635,3578734484,3578734513,29
0,1052,23636,3578734484,3578734514,30
0,1052,23637,3578734484,3578734514,30
0,1052,23638,3578734484,3578734515,31
0,1052,23639,3578734484,3578734515,31
0,1052,23640,3578734484,3578734517,33
0,1052,23641,3578734484,3578734517,33
0,1052,23642,3578734484,3578734517,33
0,1052,23643,3578734484,3578734518,34
0,1052,23644,3578734484,3578734518,34
0,1052,23645,3578734484,3578734518,34
0,1052,23646,3578734484,3578734520,36
0,1052,23647,3578734484,3578734523,39
0,1052,23648,3578734484,3578734525,41
0,1052,23649,3578734484,3578734525,41
0,1052,23650,3578734484,3578734527,43
0,1052,23651,3578734484,3578734528,44
0,1052,23652,3578734484,3578734530,46
0,1052,23653,3578734484,3578734530,46
0,1052,23654,3578734484,3578734530,46
0,1052,23655,3578734484,3578734531,47
0,1052,23656,3578734484,3578734531,47
0,1052,23657,3578734484,3578734532,48
0,1052,23658,3578734484,3578734534,50
0,1053,23659,3578734543,3578734543,0
0,1053,23660,3578734543,3578734543,0
0,1053,23661,3578734543,3578734543,0
0,1053,23662,3578734543,3578734543,0
0,1053,23663,3578734543,3578734543,0
0,1053,23664,3578734543,3578734543,0
0,1053,23665,3578734543,3578734543,0
0,1053,23666,3578734543,3578734543,0
0,1053,23667,3578734543,3578734543,0
0,1053,23668,3578734543,3578734545,2
0,1053,23669,3578734543,3578734545,2
0,1053,23670,3578734543,3578734546,3
0,1053,23671,3578734543,3578734548,5
0,1053,23672,3578734543,3578734548,5
0,1053,23673,3578734543,3578734548,5
0,1053,23674,3578734543,3578734549,6
0,1053,23675,3578734543,3578734550,7
0,1053,23676,3578734543,3578734552,9
0,1053,23677,3578734543,3578734552,9
0,1053,23678,3578734543,3578734552,9
0,1053,23679,3578734543,3578734553,10
0,1053,23680,3578734543,3578734553,10
0,1053,23681,3578734543,3578734555,12
0,1053,23682,3578734543,3578734558,15
0,1053,23683,3578734543,3578734559,16
0,1053,23684,3578734543,3578734560,17
0,1053,23685,3578734543,3578734560,17
0,1053,23686,3578734543,3578734560,17
0,1053,23687,3578734543,3578734560,17
0,1053,23688,3578734543,3578734563,20
0,1053,23689,3578734543,3578734564,21
0,1053,23690,3578734543,3578734564,21
0,1053,23691,3578734543,3578734565,22
0,1053,23692,3578734543,3578734565,22
0,1053,23693,3578734543,3578734566,23
0,1053,23694,3578734543,3578734567,24
0,1053,23695,3578734543,3578734567,24
0,1053,23696,3578734543,3578734568,25
0,1053,23697,3578734543,3578734568,25
0,1053,23698,3578734543,3578734569,26
0,1053,23699,3578734543,3578734571,28
0,1053,23700,3578734543,3578734573,30
0,1053,23701,3578734543,3578734573,30
0,1053,23702,3578734543,3578734573,30
0,1053,23703,3578734543,3578734573,30
0,1053,23704,3578734543,3578734573,30
0,1053,23705,3578734543,3578734575,32
0,1053,23706,3578734543,3578734577,34
0,1053,23707,3578734543,3578734578,35
0,1053,23708,3578734543,3578734581,38
0,1053,23709,3578734543,3578734581,38
0,1053,23710,3578734543,3578734583,40
0,1053,23711,3578734543,3578734583,40
0,1053,23712,3578734543,3578734585,42
0,1053,23713,3578734543,3578734587,44
0,1053,23714,3578734543,3578734587,44
0,1053,23715,3578734543,3578734588,45
0,1053,23716,3578734543,3578734588,45
0,1053,23717,3578734543,3578734588,45
0,1053,23718,3578734543,3578734589,46
0,1053,23719,3578734543,3578734592,49
0,1053,23720,3578734543,3578734593,50
0,1053,23721,3578734543,3578734593,50
0,1054,23722,3578734602,3578734602,0
0,1054,23723,3578734602,3578734602,0
0,1054,23724,3578734602,3578734602,0
0,1054,23725,3578734602,3578734602,0
0,1054,23726,3578734602,3578734602,0
0,1054,23727,3578734602,3578734603,1
0,1054,23728,3578734602,3578734604,2
0,1054,23729,3578734602,3578734604,2
0,1054,23730,3578734602,3578734604,2
0,1054,23731,3578734602,3578734605,3
0,1054,23732,3578734602,3578734605,3
0,1054,23733,3578734602,3578734608,6
0,1054,23734,3578734602,3578734608,6
0,1054,23735,3578734602,3578734610,8
0,1054,23736,3578734602,3578734610,8
0,1054,23737,3578734602,3578734611,9
0,1054,23738,3578734602,3578734613,11
0,1054,23739,3578734602,3578734614,12
0,1054,23740,3578734602,3578734615,13
0,1054,23741,3578734602,3578734615,13
0,1054,23742,3578734602,3578734615,13
0,1054,23743,3578734602,3578734616,14
0,1054,23744,3578734602,3578734618,16
0,1054,23745,3578734602,3578734619,17
0,1054,23746,3578734602,3578734620,18
0,1054,23747,3578734602,3578734621,19
0,1054,23748,3578734602,3578734621,19
0,1054,23749,3578734602,3578734622,20
0,1054,23750,3578734602,3578734623,21
0,1054,23751,3578734602,3578734626,24
0,1054,23752,3578734602,3578734628,26
0,1054,23753,3578734602,3578734628,26
0,1054,23754,3578734602,3578734629,27
0,1054,23755,3578734602,3578734631,29
0,1054,23756,3578734602,3578734632,30
0,1054,23757,3578734602,3578734633,31
0,1054,23758,3578734602,3578734633,31
0,1054,23759,3578734602,3578734633,31
0,1054,23760,3578734602,3578734636,34
0,1054,23761,3578734602,3578734636,34
0,1054,23762,3578734602,3578734637,35
0,1054,23763,3578734602,3578734638,36
0,1054,23764,3578734602,3578734638,36
0,1054,23765,3578734602,3578734640,38
0,1054,23766,3578734602,3578734641,39
0,1054,23767,3578734602,3578734642,40
0,1054,23768,3578734602,3578734643,41
0,1054,23769,3578734602,3578734644,42
0,1054,23770,3578734602,3578734645,43
0,1054,23771,3578734602,3578734647,45
0,1054,23772,3578734602,3578734648,46
0,1054,23773,3578734602,3578734649,47
0,1054,23774,3578734602,3578734650,48
0,1054,23775,3578734602,3578734650,48
0,1055,23776,3578734663,3578734663,0
0,1055,23777,3578734663,3578734663,0
0,1055,23778,3578734663,3578734663,0
0,1055,23779,3578734663,3578734663,0
0,1055,23780,3578734663,3578734663,0
0,1055,23781,3578734663,3578734663,0
0,1055,23782,3578734663,3578734663,0
0,1055,23783,3578734663,3578734663,0
0,1055,23784,3578734663,3578734663,0
0,1055,23785,3578734663,3578734663,0
0,1055,23786,3578734663,3578734663,0
0,1055,23787,3578734663,3578734664,1
0,1055,23788,3578734663,3578734664,1
0,1055,23789,3578734663,3578734665,2
0,1055,23790,3578734663,3578734666,3
0,1055,23791,3578734663,3578734666,3
0,1055,23792,3578734663,3578734666,3
0,1055,23793,3578734663,3578734667,4
0,1055,23794,3578734663,3578734668,5
0,1055,23795,3578734663,3578734669,6
0,1055,23796,3578734663,3578734670,7
0,1055,23797,3578734663,3578734671,8
0,1055,23798,3578734663,3578734673,10
0,1055,23799,3578734663,3578734674,11
0,1055,23800,3578734663,3578734675,12
0,1055,23801,3578734663,3578734676,13
0,1055,23802,3578734663,3578734676,13
0,1055,23803,3578734663,3578734677,14
0,1055,23804,3578734663,3578734679,16
0,1055,23805,3578734663,3578734680,17
0,1055,23806,3578734663,3578734680,17
0,1055,23807,3578734663,3578734681,18
0,1055,23808,3578734663,3578734681,18
0,1055,23809,3578734663,3578734682,19
0,1055,23810,3578734663,3578734683,20
0,1055,23811,3578734663,3578734683,20
0,1055,23812,3578734663,3578734684,21
0,1055,23813,3578734663,3578734684,21
0,1055,23814,3578734663,3578734685,22
0,1055,23815,3578734663,3578734685,22
0,1055,23816,3578734663,3578734686,23
0,1055,23817,3578734663,3578734686,23
0,1055,23818,3578734663,3578734688,25
0,1055,23819,3578734663,3578734689,26
0,1055,23820,3578734663,3578734689,26
0,1055,23821,3578734663,3578734689,26
0,1055,23822,3578734663,3578734689,26
0,1055,23823,3578734663,3578734692,29
0,1055,23824,3578734663,3578734693,30
0,1055,23825,3578734663,3578734694,31
0,1055,23826,3578734663,3578734695,32
0,1055,23827,3578734663,3578734696,33
0,1055,23828,3578734663,3578734698,35
0,1055,23829,3578734663,3578734699,36
0,1055,23830,3578734663,3578734699,36
0,1055,23831,3578734663,3578734699,36
0,1055,23832,3578734663,3578734699,36
0,1055,23833,3578734663,3578734701,38
0,1055,23834,3578734663,3578734701,38
0,1055,23835,3578734663,3578734704,41
0,1055,23836,3578734663,3578734704,41
0,1055,23837,3578734663,3578734704,41
0,1055,23838,3578734663,3578734706,43
0,1055,23839,3578734663,3578734706,43
0,1055,23840,3578734663,3578734706,43
0,1055,23841,3578734663,3578734706,43
0,1055,23842,3578734663,3578734707,44
0,1055,23843,3578734663,3578734707,44
0,1055,23844,3578734663,3578734708,45
0,1055,23845,3578734663,3578734709,46
0,1055,23846,3578734663,3578734710,47
0,1055,23847,3578734663,3578734710,47
0,1055,23848,3578734663,3578734710,47
0,1055,23849,3578734663,3578734713,50
0,1056,23850,3578734724,3578734724,0
0,1056,23851,3578734724,3578734724,0
0,1056,23852,3578734724,3578734724,0
0,1056,23853,3578734724,3578734724,0
0,1056,23854,3578734724,3578734724,0
0,1056,23855,3578734724,3578734724,0
0,1056,23856,3578734724,3578734724,0
0,1056,23857,3578734724,3578734724,0
0,1056,23858,3578734724,3578734724,0
0,1056,23859,3578734724,3578734724,0
0,1056,23860,3578734724,3578734724,0
0,1056,23861,3578734724,3578734725,1
0,1056,23862,3578734724,3578734726,2
0,1056,23863,3578734724,3578734727,3
0,1056,23864,3578734724,3578734727,3
0,1056,23865,3578734724,3578734728,4
0,1056,23866,3578734724,3578734730,6
0,1056,23867,3578734724,3578734730,6
0,1056,23868,3578734724,3578734730,6
0,1056,23869,3578734724,3578734730,6
0,1056,23870,3578734724,3578734731,7
0,1056,23871,3578734724,3578734731,7
0,1056,23872,3578734724,3578734734,10
0,1056,23873,3578734724,3578734734,10
0,1056,23874,3578734724,3578734738,14
0,1056,23875,3578734724,3578734739,15
0,1056,23876,3578734724,3578734739,15
0,1056,23877,3578734724,3578734740,16
0,1056,23878,3578734724,3578734740,16
0,1056,23879,3578734724,3578734742,18
0,1056,23880,3578734724,3578734743,19
0,1056,23881,3578734724,3578734744,20
0,1056,23882,3578734724,3578734745,21
0,1056,23883,3578734724,3578734746,22
0,1056,23884,3578734724,3578734746,22
0,1056,23885,3578734724,3578734747,23
0,1056,23886,3578734724,3578734748,24
0,1056,23887,3578734724,3578734748,24
0,1056,23888,3578734724,3578734748,24
0,1056,23889,3578734724,3578734750,26
0,1056,23890,3578734724,3578734752,28
0,1056,23891,3578734724,3578734753,29
0,1056,23892,3578734724,3578734753,29
0,1056,23893,3578734724,3578734753,29
0,1056,23894,3578734724,3578734755,31
0,1056,23895,3578734724,3578734757,33
0,1056,23896,3578734724,3578734758,34
0,1056,23897,3578734724,3578734759,35
0,1056,23898,3578734724,3578734760,36
0,1056,23899,3578734724,3578734760,36
0,1056,23900,3578734724,3578734760,36
0,1056,23901,3578734724,3578734760,36
0,1056,23902,3578734724,3578734763,39
0,1056,23903,3578734724,3578734763,39
0,1056,23904,3578734724,3578734764,40
0,1056,23905,3578734724,3578734764,40
0,1056,23906,3578734724,3578734765,41
0,1056,23907,3578734724,3578734765,41
0,1056,23908,3578734724,3578734765,41
0,1056,23909,3578734724,3578734767,43
0,1056,23910,3578734724,3578734767,43
0,1056,23911,3578734724,3578734768,44
0,1056,23912,3578734724,3578734769,45
0,1056,23913,3578734724,3578734770,46
0,1056,23914,3578734724,3578734770,46
0,1056,23915,3578734724,3578734772,48
0,1056,23916,3578734724,3578734772,48
0,1056,23917,3578734724,3578734773,49
0,1056,23918,3578734724,3578734773,49
0,1056,23919,3578734724,3578734774,50
0,1057,23920,3578734786,3578734786,0
0,1057,23921,3578734786,3578734786,0
0,1057,23922,3578734786,3578734786,0
0,1057,23923,3578734786,3578734786,0
0,1057,23924,3578734786,3578734786,0
0,1057,23925,3578734786,3578734786,0
0,1057,23926,3578734786,3578734786,0
0,1057,23927,3578734786,3578734786,0
0,1057,23928,3578734786,3578734786,0
0,1057,23929,3578734786,3578734787,1
0,1057,23930,3578734786,3578734788,2
0,1057,23931,3578734786,3578734788,2
0,1057,23932,3578734786,3578734789,3
0,1057,23933,3578734786,3578734789,3
0,1057,23934,3578734786,3578734793,7
0,1057,23935,3578734786,3578734794,8
0,1057,23936,3578734786,3578734794,8
0,1057,23937,3578734786,3578734796,10
0,1057,23938,3578734786,3578734798,12
0,1057,23939,3578734786,3578734800,14
0,1057,23940,3578734786,3578734801,15
0,1057,23941,3578734786,3578734803,17
0,1057,23942,3578734786,3578734803,17
0,1057,23943,3578734786,3578734804,18
0,1057,23944,3578734786,3578734804,18
0,1057,23945,3578734786,3578734805,19
0,1057,23946,3578734786,3578734805,19
0,1057,23947,3578734786,3578734806,20
0,1057,23948,3578734786,3578734808,22
0,1057,23949,3578734786,3578734808,22
0,1057,23950,3578734786,3578734808,22
0,1057,23951,3578734786,3578734812,26
0,1057,23952,3578734786,3578734813,27
0,1057,23953,3578734786,3578734813,27
0,1057,23954,3578734786,3578734814,28
0,1057,23955,3578734786,3578734815,29
0,1057,23956,3578734786,3578734815,29
0,1057,23957,3578734786,3578734818,32
0,1057,23958,3578734786,3578734819,33
0,1057,23959,3578734786,3578734820,34
0,1057,23960,3578734786,3578734821,35
0,1057,23961,3578734786,3578734821,35
0,1057,23962,3578734786,3578734821,35
0,1057,23963,3578734786,3578734823,37
0,1057,23964,3578734786,3578734824,38
0,1057,23965,3578734786,3578734825,39
0,1057,23966,3578734786,3578734828,42
0,1057,23967,3578734786,3578734828,42
0,1057,23968,3578734786,3578734829,43
0,1057,23969,3578734786,3578734832,46
0,1057,23970,3578734786,3578734832,46
0,1057,23971,3578734786,3578734832,46
0,1057,23972,3578734786,3578734833,47
0,1057,23973,3578734786,3578734834,48
0,1057,23974,3578734786,3578734836,50
0,1058,23975,3578734844,3578734844,0
0,1058,23976,3578734844,3578734844,0
0,1058,23977,3578734844,3578734844,0
0,1058,23978,3578734844,3578734844,0
0,1058,23979,3578734844,3578734844,0
0,1058,23980,3578734844,3578734844,0
0,1058,23981,3578734844,3578734844,0
0,1058,23982,3578734844,3578734844,0
0,1058,23983,3578734844,3578734844,0
0,1058,23984,3578734844,3578734844,0
0,1058,23985,3578734844,3578734845,1
0,1058,23986,3578734844,3578734847,3
0,1058,23987,3578734844,3578734848,4
0,1058,23988,3578734844,3578734848,4
0,1058,23989,3578734844,3578734849,5
0,1058,23990,3578734844,3578734850,6
0,1058,23991,3578734844,3578734850,6
0,1058,23992,3578734844,3578734852,8
0,1058,23993,3578734844,3578734854,10
0,1058,23994,3578734844,3578734857,13
0,1058,23995,3578734844,3578734857,13
0,1058,23996,3578734844,3578734859,15
0,1058,23997,3578734844,3578734859,15
0,1058,23998,3578734844,3578734859,15
0,1058,23999,3578734844,3578734859,15
0,1058,24000,3578734844,3578734861,17
0,1058,24001,3578734844,3578734862,18
0,1058,24002,3578734844,3578734863,19
0,1058,24003,3578734844,3578734864,20
0,1058,24004,3578734844,3578734865,21
0,1058,24005,3578734844,3578734865,21
0,1058,24006,3578734844,3578734865,21
0,1058,24007,3578734844,3578734866,22
0,1058,24008,3578734844,3578734866,22
0,1058,24009,3578734844,3578734867,23
0,1058,24010,3578734844,3578734867,23
0,1058,24011,3578734844,3578734869,25
0,1058,24012,3578734844,3578734870,26
0,1058,24013,3578734844,3578734870,26
0,1058,24014,3578734844,3578734872,28
0,1058,24015,3578734844,3578734873,29
0,1058,24016,3578734844,3578734874,30
0,1058,24017,3578734844,3578734875,31
0,1058,24018,3578734844,3578734875,31
0,1058,24019,3578734844,3578734876,32
0,1058,24020,3578734844,3578734877,33
0,1058,24021,3578734844,3578734880,36
0,1058,24022,3578734844,3578734880,36
0,1058,24023,3578734844,3578734880,36
0,1058,24024,3578734844,3578734880,36
0,1058,24025,3578734844,3578734881,37
0,1058,24026,3578734844,3578734882,38
0,1058,24027,3578734844,3578734882,38
0,1058,24028,3578734844,3578734884,40
0,1058,24029,3578734844,3578734884,40
0,1058,24030,3578734844,3578734884,40
0,1058,24031,3578734844,3578734885,41
0,1058,24032,3578734844,3578734886,42
0,1058,24033,3578734844,3578734886,42
0,1058,24034,3578734844,3578734888,44
0,1058,24035,3578734844,3578734889,45
0,1058,24036,3578734844,3578734889,45
0,1058,24037,3578734844,3578734889,45
0,1058,24038,3578734844,3578734890,46
0,1058,24039,3578734844,3578734893,49
0,1058,24040,3578734844,3578734894,50
0,1059,24041,3578734902,3578734902,0
0,1059,24042,3578734902,3578734902,0
0,1059,24043,3578734902,3578734902,0
0,1059,24044,3578734902,3578734902,0
0,1059,24045,3578734902,3578734902,0
0,1059,24046,3578734902,3578734902,0
0,1059,24047,3578734902,3578734902,0
0,1059,24048,3578734902,3578734902,0
0,1059,24049,3578734902,3578734902,0
0,1059,24050,3578734902,3578734902,0
0,1059,24051,3578734902,3578734902,0
0,1059,24052,3578734902,3578734902,0
0,1059,24053,3578734902,3578734904,2
0,1059,24054,3578734902,3578734904,2
0,1059,24055,3578734902,3578734904,2
0,1059,24056,3578734902,3578734905,3
0,1059,24057,3578734902,3578734907,5
0,1059,24058,3578734902,3578734907,5
0,1059,24059,3578734902,3578734907,5
0,1059,24060,3578734902,3578734909,7
0,1059,24061,3578734902,3578734909,7
0,1059,24062,3578734902,3578734910,8
0,1059,24063,3578734902,3578734911,9
0,1059,24064,3578734902,3578734913,11
0,1059,24065,3578734902,3578734915,13
0,1059,24066,3578734902,3578734915,13
0,1059,24067,3578734902,3578734915,13
0,1059,24068,3578734902,3578734916,14
0,1059,24069,3578734902,3578734917,15
0,1059,24070,3578734902,3578734917,15
0,1059,24071,3578734902,3578734918,16
0,1059,24072,3578734902,3578734918,16
0,1059,24073,3578734902,3578734918,16
0,1059,24074,3578734902,3578734919,17
0,1059,24075,3578734902,3578734920,18
0,1059,24076,3578734902,3578734920,18
0,1059,24077,3578734902,3578734922,20
0,1059,24078,3578734902,3578734925,23
0,1059,24079,3578734902,3578734926,24
0,1059,24080,3578734902,3578734927,25
0,1059,24081,3578734902,3578734927,25
0,1059,24082,3578734902,3578734927,25
0,1059,24083,3578734902,3578734930,28
0,1059,24084,3578734902,3578734930,28
0,1059,24085,3578734902,3578734931,29
0,1059,24086,3578734902,3578734931,29
0,1059,24087,3578734902,3578734934,32
0,1059,24088,3578734902,3578734935,33
0,1059,24089,3578734902,3578734935,33
0,1059,24090,3578734902,3578734938,36
0,1059,24091,3578734902,3578734939,37
0,1059,24092,3578734902,3578734939,37
0,1059,24093,3578734902,3578734940,38
0,1059,24094,3578734902,3578734940,38
0,1059,24095,3578734902,3578734943,41
0,1059,24096,3578734902,3578734943,41
0,1059,24097,3578734902,3578734944,42
0,1059,24098,3578734902,3578734944,42
0,1059,24099,3578734902,3578734945,43
0,1059,24100,3578734902,3578734948,46
0,1059,24101,3578734902,3578734948,46
0,1059,24102,3578734902,3578734948,46
0,1059,24103,3578734902,3578734949,47
0,1060,24104,3578734961,3578734961,0
0,1060,24105,3578734961,3578734961,0
0,1060,24106,3578734961,3578734961,0
0,1060,24107,3578734961,3578734961,0
0,1060,24108,3578734961,3578734961,0
0,1060,24109,3578734961,3578734961,0
0,1060,24110,3578734961,3578734961,0
0,1060,24111,3578734961,3578734961,0
0,1060,24112,3578734961,3578734961,0
0,1060,24113,3578734961,3578734961,0
0,1060,24114,3578734961,3578734961,0
0,1060,24115,3578734961,3578734961,0
0,1060,24116,3578734961,3578734961,0
0,1060,24117,3578734961,3578734962,1
0,1060,24118,3578734961,3578734964,3
0,1060,24119,3578734961,3578734964,3
0,1060,24120,3578734961,3578734964,3
0,1060,24121,3578734961,3578734965,4
0,1060,24122,3578734961,3578734965,4
0,1060,24123,3578734961,3578734966,5
0,1060,24124,3578734961,3578734966,5
0,1060,24125,3578734961,3578734967,6
0,1060,24126,3578734961,3578734968,7
0,1060,24127,3578734961,3578734969,8
0,1060,24128,3578734961,3578734969,8
0,1060,24129,3578734961,3578734971,10
0,1060,24130,3578734961,3578734973,12
0,1060,24131,3578734961,3578734973,12
0,1060,24132,3578734961,3578734974,13
0,1060,24133,3578734961,3578734974,13
0,1060,24134,3578734961,3578734974,13
0,1060,24135,3578734961,3578734976,15
0,1060,24136,3578734961,3578734976,15
0,1060,24137,3578734961,3578734979,18
0,1060,24138,3578734961,3578734981,20
0,1060,24139,3578734961,3578734981,20
0,1060,24140,3578734961,3578734982,21
0,1060,24141,3578734961,3578734982,21
0,1060,24142,3578734961,3578734987,26
0,1060,24143,3578734961,3578734987,26
0,1060,24144,3578734961,3578734988,27
0,1060,24145,3578734961,3578734990,29
0,1060,24146,3578734961,3578734990,29
0,1060,24147,3578734961,3578734990,29
0,1060,24148,3578734961,3578734993,32
0,1060,24149,3578734961,3578734993,32
0,1060,24150,3578734961,3578734994,33
0,1060,24151,3578734961,3578734997,36
0,1060,24152,3578734961,3578734997,36
0,1060,24153,3578734961,3578735000,39
0,1060,24154,3578734961,3578735001,40
0,1060,24155,3578734961,3578735003,42
0,1060,24156,3578734961,3578735004,43
0,1060,24157,3578734961,3578735004,43
0,1060,24158,3578734961,3578735005,44
0,1060,24159,3578734961,3578735005,44
0,1060,24160,3578734961,3578735008,47
0,1060,24161,3578734961,3578735009,48
0,1060,24162,3578734961,3578735010,49
0,1060,24163,3578734961,3578735010,49
0,1060,24164,3578734961,3578735011,50
0,1061,24165,3578735022,3578735022,0
0,1061,24166,3578735022,3578735022,0
0,1061,24167,3578735022,3578735022,0
0,1061,24168,3578735022,3578735022,0
0,1061,24169,3578735022,3578735022,0
0,1061,24170,3578735022,3578735022,0
0,1061,24171,3578735022,3578735022,0
0,1061,24172,3578735022,3578735022,0
0,1061,24173,3578735022,3578735022,0
0,1061,24174,3578735022,3578735022,0
0,1061,24175,3578735022,3578735022,0
0,1061,24176,3578735022,3578735022,0
0,1061,24177,3578735022,3578735022,0
0,1061,24178,3578735022,3578735023,1
0,1061,24179,3578735022,3578735024,2
0,1061,24180,3578735022,3578735025,3
0,1061,24181,3578735022,3578735028,6
0,1061,24182,3578735022,3578735029,7
0,1061,24183,3578735022,3578735029,7
0,1061,24184,3578735022,3578735032,10
0,1061,24185,3578735022,3578735032,10
0,1061,24186,3578735022,3578735033,11
0,1061,24187,3578735022,3578735033,11
0,1061,24188,3578735022,3578735034,12
0,1061,24189,3578735022,3578735036,14
0,1061,24190,3578735022,3578735037,15
0,1061,24191,3578735022,3578735037,15
0,1061,24192,3578735022,3578735037,15
0,1061,24193,3578735022,3578735038,16
0,1061,24194,3578735022,3578735040,18
0,1061,24195,3578735022,3578735040,18
0,1061,24196,3578735022,3578735041,19
0,1061,24197,3578735022,3578735043,21
0,1061,24198,3578735022,3578735044,22
0,1061,24199,3578735022,3578735045,23
0,1061,24200,3578735022,3578735048,26
0,1061,24201,3578735022,3578735049,27
0,1061,24202,3578735022,3578735049,27
0,1061,24203,3578735022,3578735050,28
0,1061,24204,3578735022,3578735050,28
0,1061,24205,3578735022,3578735052,30
0,1061,24206,3578735022,3578735054,32
0,1061,24207,3578735022,3578735056,34
0,1061,24208,3578735022,3578735058,36
0,1061,24209,3578735022,3578735059,37
0,1061,24210,3578735022,3578735059,37
0,1061,24211,3578735022,3578735060,38
0,1061,24212,3578735022,3578735060,38
0,1061,24213,3578735022,3578735061,39
0,1061,24214,3578735022,3578735063,41
0,1061,24215,3578735022,3578735064,42
0,1061,24216,3578735022,3578735065,43
0,1061,24217,3578735022,3578735066,44
0,1061,24218,3578735022,3578735066,44
0,1061,24219,3578735022,3578735067,45
0,1061,24220,3578735022,3578735067,45
0,1061,24221,3578735022,3578735068,46
0,1061,24222,3578735022,3578735069,47
0,1061,24223,3578735022,3578735069,47
0,1061,24224,3578735022,3578735070,48
0,1062,24225,3578735086,3578735086,0
0,1062,24226,3578735086,3578735086,0
0,1062,24227,3578735086,3578735086,0
0,1062,24228,3578735086,3578735086,0
0,1062,24229,3578735086,3578735087,1
0,1062,24230,3578735086,3578735087,1
0,1062,24231,3578735086,3578735087,1
0,1062,24232,3578735086,3578735087,1
0,1062,24233,3578735086,3578735087,1
0,1062,24234,3578735086,3578735087,1
0,1062,24235,3578735086,3578735087,1
0,1062,24236,3578735086,3578735087,1
0,1062,24237,3578735086,3578735087,1
0,1062,24238,3578735086,3578735087,1
0,1062,24239,3578735086,3578735087,1
0,1062,24240,3578735086,3578735087,1
0,1062,24241,3578735086,3578735087,1
0,1062,24242,3578735086,3578735087,1
0,1062,24243,3578735086,3578735087,1
0,1062,24244,3578735086,3578735087,1
0,1062,24245,3578735086,3578735087,1
0,1062,24246,3578735086,3578735088,2
0,1062,24247,3578735086,3578735089,3
0,1062,24248,3578735086,3578735089,3
0,1062,24249,3578735086,3578735090,4
0,1062,24250,3578735086,3578735090,4
0,1062,24251,3578735086,3578735092,6
0,1062,24252,3578735086,3578735094,8
0,1062,24253,3578735086,3578735094,8
0,1062,24254,3578735086,3578735095,9
0,1062,24255,3578735086,3578735098,12
0,1062,24256,3578735086,3578735098,12
0,1062,24257,3578735086,3578735099,13
0,1062,24258,3578735086,3578735099,13
0,1062,24259,3578735086,3578735101,15
0,1062,24260,3578735086,3578735101,15
0,1062,24261,3578735086,3578735101,15
0,1062,24262,3578735086,3578735101,15
0,1062,24263,3578735086,3578735102,16
0,1062,24264,3578735086,3578735102,16
0,1062,24265,3578735086,3578735104,18
0,1062,24266,3578735086,3578735104,18
0,1062,24267,3578735086,3578735104,18
0,1062,24268,3578735086,3578735105,19
0,1062,24269,3578735086,3578735106,20
0,1062,24270,3578735086,3578735106,20
0,1062,24271,3578735086,3578735107,21
0,1062,24272,3578735086,3578735107,21
0,1062,24273,3578735086,3578735109,23
0,1062,24274,3578735086,3578735109,23
0,1062,24275,3578735086,3578735110,24
0,1062,24276,3578735086,3578735110,24
0,1062,24277,3578735086,3578735111,25
0,1062,24278,3578735086,3578735113,27
0,1062,24279,3578735086,3578735115,29
0,1062,24280,3578735086,3578735115,29
0,1062,24281,3578735086,3578735115,29
0,1062,24282,3578735086,3578735115,29
0,1062,24283,3578735086,3578735116,30
0,1062,24284,3578735086,3578735116,30
0,1062,24285,3578735086,3578735116,30
0,1062,24286,3578735086,3578735117,31
0,1062,24287,3578735086,3578735118,32
0,1062,24288,3578735086,3578735118,32
0,1062,24289,3578735086,3578735119,33
0,1062,24290,3578735086,3578735120,34
0,1062,24291,3578735086,3578735120,34
0,1062,24292,3578735086,3578735120,34
0,1062,24293,3578735086,3578735123,37
0,1062,24294,3578735086,3578735123,37
0,1062,24295,3578735086,3578735125,39
0,1062,24296,3578735086,3578735127,41
0,1062,24297,3578735086,3578735128,42
0,1062,24298,3578735086,3578735128,42
0,1062,24299,3578735086,3578735128,42
0,1062,24300,3578735086,3578735130,44
0,1062,24301,3578735086,3578735131,45
0,1062,24302,3578735086,3578735131,45
0,1062,24303,3578735086,3578735131,45
0,1062,24304,3578735086,3578735131,45
0,1062,24305,3578735086,3578735131,45
0,1062,24306,3578735086,3578735131,45
0,1062,24307,3578735086,3578735134,48
0,1062,24308,3578735086,3578735135,49
0,1063,24309,3578735147,3578735147,0
0,1063,24310,3578735147,3578735147,0
0,1063,24311,3578735147,3578735147,0
0,1063,24312,3578735147,3578735147,0
0,1063,24313,3578735147,3578735147,0
0,1063,24314,3578735147,3578735147,0
0,1063,24315,3578735147,3578735147,0
0,1063,24316,3578735147,3578735147,0
0,1063,24317,3578735147,3578735147,0
0,1063,24318,3578735147,3578735147,0
0,1063,24319,3578735147,3578735147,0
0,1063,24320,3578735147,3578735148,1
0,1063,24321,3578735147,3578735149,2
0,1063,24322,3578735147,3578735150,3
0,1063,24323,3578735147,3578735151,4
0,1063,24324,3578735147,3578735152,5
0,1063,24325,3578735147,3578735153,6
0,1063,24326,3578735147,3578735154,7
0,1063,24327,3578735147,3578735155,8
0,1063,24328,3578735147,3578735156,9
0,1063,24329,3578735147,3578735158,11
0,1063,24330,3578735147,3578735158,11
0,1063,24331,3578735147,3578735159,12
0,1063,24332,3578735147,3578735160,13
0,1063,24333,3578735147,3578735160,13
0,1063,24334,3578735147,3578735161,14
0,1063,24335,3578735147,3578735161,14
0,1063,24336,3578735147,3578735161,14
0,1063,24337,3578735147,3578735161,14
0,1063,24338,3578735147,3578735163,16
0,1063,24339,3578735147,3578735164,17
0,1063,24340,3578735147,3578735165,18
0,1063,24341,3578735147,3578735165,18
0,1063,24342,3578735147,3578735166,19
0,1063,24343,3578735147,3578735166,19
0,1063,24344,3578735147,3578735168,21
0,1063,24345,3578735147,3578735168,21
0,1063,24346,3578735147,3578735169,22
0,1063,24347,3578735147,3578735170,23
0,1063,24348,3578735147,3578735171,24
0,1063,24349,3578735147,3578735171,24
0,1063,24350,3578735147,3578735172,25
0,1063,24351,3578735147,3578735173,26
0,1063,24352,3578735147,3578735173,26
0,1063,24353,3578735147,3578735173,26
0,1063,24354,3578735147,3578735174,27
0,1063,24355,3578735147,3578735176,29
0,1063,24356,3578735147,3578735177,30
0,1063,24357,3578735147,3578735179,32
0,1063,24358,3578735147,3578735182,35
0,1063,24359,3578735147,3578735182,35
0,1063,24360,3578735147,3578735182,35
0,1063,24361,3578735147,3578735183,36
0,1063,24362,3578735147,3578735187,40
0,1063,24363,3578735147,3578735188,41
0,1063,24364,3578735147,3578735188,41
0,1063,24365,3578735147,3578735189,42
0,1063,24366,3578735147,3578735189,42
0,1063,24367,3578735147,3578735190,43
0,1063,24368,3578735147,3578735193,46
0,1063,24369,3578735147,3578735194,47
0,1063,24370,3578735147,3578735194,47
0,1063,24371,3578735147,3578735197,50
0,1064,24372,3578735207,3578735207,0
0,1064,24373,3578735207,3578735207,0
0,1064,24374,3578735207,3578735207,0
0,1064,24375,3578735207,3578735207,0
0,1064,24376,3578735207,3578735207,0
0,1064,24377,3578735207,3578735207,0
0,1064,24378,3578735207,3578735207,0
0,1064,24379,3578735207,3578735207,0
0,1064,24380,3578735207,3578735207,0
0,1064,24381,3578735207,3578735207,0
0,1064,24382,3578735207,3578735207,0
0,1064,24383,3578735207,3578735207,0
0,1064,24384,3578735207,3578735209,2
0,1064,24385,3578735207,3578735209,2
0,1064,24386,3578735207,3578735210,3
0,1064,24387,3578735207,3578735212,5
0,1064,24388,3578735207,3578735214,7
0,1064,24389,3578735207,3578735214,7
0,1064,24390,3578735207,3578735214,7
0,1064,24391,3578735207,3578735216,9
0,1064,24392,3578735207,3578735216,9
0,1064,24393,3578735207,3578735218,11
0,1064,24394,3578735207,3578735218,11
0,1064,24395,3578735207,3578735221,14
0,1064,24396,3578735207,3578735221,14
0,1064,24397,3578735207,3578735221,14
0,1064,24398,3578735207,3578735221,14
0,1064,24399,3578735207,3578735222,15
0,1064,24400,3578735207,3578735224,17
0,1064,24401,3578735207,3578735225,18
0,1064,24402,3578735207,3578735226,19
0,1064,24403,3578735207,3578735228,21
0,1064,24404,3578735207,3578735229,22
0,1064,24405,3578735207,3578735230,23
0,1064,24406,3578735207,3578735232,25
0,1064,24407,3578735207,3578735232,25
0,1064,24408,3578735207,3578735233,26
0,1064,24409,3578735207,3578735233,26
0,1064,24410,3578735207,3578735234,27
0,1064,24411,3578735207,3578735236,29
0,1064,24412,3578735207,3578735237,30
0,1064,24413,3578735207,3578735237,30
0,1064,24414,3578735207,3578735238,31
0,1064,24415,3578735207,3578735239,32
0,1064,24416,3578735207,3578735239,32
0,1064,24417,3578735207,3578735240,33
0,1064,24418,3578735207,3578735242,35
0,1064,24419,3578735207,3578735243,36
0,1064,24420,3578735207,3578735244,37
0,1064,24421,3578735207,3578735246,39
0,1064,24422,3578735207,3578735247,40
0,1064,24423,3578735207,3578735248,41
0,1064,24424,3578735207,3578735249,42
0,1064,24425,3578735207,3578735249,42
0,1064,24426,3578735207,3578735250,43
0,1064,24427,3578735207,3578735250,43
0,1064,24428,3578735207,3578735250,43
0,1064,24429,3578735207,3578735253,46
0,1064,24430,3578735207,3578735255,48
0,1064,24431,3578735207,3578735256,49
0,1064,24432,3578735207,3578735257,50
0,1065,24433,3578735266,3578735266,0
0,1065,24434,3578735266,3578735266,0
0,1065,24435,3578735266,3578735266,0
0,1065,24436,3578735266,3578735266,0
0,1065,24437,3578735266,3578735266,0
0,1065,24438,3578735266,3578735266,0
0,1065,24439,3578735266,3578735266,0
0,1065,24440,3578735266,3578735266,0
0,1065,24441,3578735266,3578735266,0
0,1065,24442,3578735266,3578735266,0
0,1065,24443,3578735266,3578735267,1
0,1065,24444,3578735266,3578735267,1
0,1065,24445,3578735266,3578735267,1
0,1065,24446,3578735266,3578735268,2
0,1065,24447,3578735266,3578735271,5
0,1065,24448,3578735266,3578735271,5
0,1065,24449,3578735266,3578735274,8
0,1065,24450,3578735266,3578735274,8
0,1065,24451,3578735266,3578735274,8
0,1065,24452,3578735266,3578735275,9
0,1065,24453,3578735266,3578735276,10
0,1065,24454,3578735266,3578735278,12
0,1065,24455,3578735266,3578735280,14
0,1065,24456,3578735266,3578735280,14
0,1065,24457,3578735266,3578735281,15
0,1065,24458,3578735266,3578735281,15
0,1065,24459,3578735266,3578735282,16
0,1065,24460,3578735266,3578735283,17
0,1065,24461,3578735266,3578735283,17
0,1065,24462,3578735266,3578735284,18
0,1065,24463,3578735266,3578735284,18
0,1065,24464,3578735266,3578735285,19
0,1065,24465,3578735266,3578735286,20
0,1065,24466,3578735266,3578735286,20
0,1065,24467,3578735266,3578735286,20
0,1065,24468,3578735266,3578735287,21
0,1065,24469,3578735266,3578735288,22
0,1065,24470,3578735266,3578735289,23
0,1065,24471,3578735266,3578735289,23
0,1065,24472,3578735266,3578735290,24
0,1065,24473,3578735266,3578735291,25
0,1065,24474,3578735266,3578735292,26
0,1065,24475,3578735266,3578735293,27
0,1065,24476,3578735266,3578735294,28
0,1065,24477,3578735266,3578735297,31
0,1065,24478,3578735266,3578735298,32
0,1065,24479,3578735266,3578735298,32
0,1065,24480,3578735266,3578735298,32
0,1065,24481,3578735266,3578735301,35
0,1065,24482,3578735266,3578735301,35
0,1065,24483,3578735266,3578735301,35
0,1065,24484,3578735266,3578735301,35
0,1065,24485,3578735266,3578735302,36
0,1065,24486,3578735266,3578735302,36
0,1065,24487,3578735266,3578735303,37
0,1065,24488,3578735266,3578735305,39
0,1065,24489,3578735266,3578735305,39
0,1065,24490,3578735266,3578735305,39
0,1065,24491,3578735266,3578735306,40
0,1065,24492,3578735266,3578735306,40
0,1065,24493,3578735266,3578735307,41
0,1065,24494,3578735266,3578735307,41
0,1065,24495,3578735266,3578735308,42
0,1065,24496,3578735266,3578735308,42
0,1065,24497,3578735266,3578735309,43
0,1065,24498,3578735266,3578735309,43
0,1065,24499,3578735266,3578735311,45
0,1065,24500,3578735266,3578735313,47
0,1065,24501,3578735266,3578735314,48
0,1065,24502,3578735266,3578735315,49
0,1065,24503,3578735266,3578735315,49
0,1065,24504,3578735266,3578735315,49
0,1065,24505,3578735266,3578735316,50
0,1066,24506,3578735326,3578735326,0
0,1066,24507,3578735326,3578735326,0
0,1066,24508,3578735326,3578735326,0
0,1066,24509,3578735326,3578735326,0
0,1066,24510,3578735326,3578735326,0
0,1066,24511,3578735326,3578735326,0
0,1066,24512,3578735326,3578735326,0
0,1066,24513,3578735326,3578735326,0
0,1066,24514,3578735326,3578735326,0
0,1066,24515,3578735326,3578735328,2
0,1066,24516,3578735326,3578735328,2
0,1066,24517,3578735326,3578735330,4
0,1066,24518,3578735326,3578735331,5
0,1066,24519,3578735326,3578735331,5
0,1066,24520,3578735326,3578735331,5
0,1066,24521,3578735326,3578735332,6
0,1066,24522,3578735326,3578735335,9
0,1066,24523,3578735326,3578735339,13
0,1066,24524,3578735326,3578735340,14
0,1066,24525,3578735326,3578735341,15
0,1066,24526,3578735326,3578735341,15
0,1066,24527,3578735326,3578735341,15
0,1066,24528,3578735326,3578735342,16
0,1066,24529,3578735326,3578735343,17
0,1066,24530,3578735326,3578735344,18
0,1066,24531,3578735326,3578735344,18
0,1066,24532,3578735326,3578735344,18
0,1066,24533,3578735326,3578735348,22
0,1066,24534,3578735326,3578735348,22
0,1066,24535,3578735326,3578735351,25
0,1066,24536,3578735326,3578735352,26
0,1066,24537,3578735326,3578735352,26
0,1066,24538,3578735326,3578735353,27
0,1066,24539,3578735326,3578735354,28
0,1066,24540,3578735326,3578735356,30
0,1066,24541,3578735326,3578735356,30
0,1066,24542,3578735326,3578735357,31
0,1066,24543,3578735326,3578735358,32
0,1066,24544,3578735326,3578735360,34
0,1066,24545,3578735326,3578735361,35
0,1066,24546,3578735326,3578735361,35
0,1066,24547,3578735326,3578735361,35
0,1066,24548,3578735326,3578735361,35
0,1066,24549,3578735326,3578735362,36
0,1066,24550,3578735326,3578735363,37
0,1066,24551,3578735326,3578735364,38
0,1066,24552,3578735326,3578735365,39
0,1066,24553,3578735326,3578735366,40
0,1066,24554,3578735326,3578735366,40
0,1066,24555,3578735326,3578735367,41
0,1066,24556,3578735326,3578735368,42
0,1066,24557,3578735326,3578735370,44
0,1066,24558,3578735326,3578735372,46
0,1066,24559,3578735326,3578735372,46
0,1066,24560,3578735326,3578735373,47
0,1066,24561,3578735326,3578735373,47
0,1066,24562,3578735326,3578735374,48
0,1066,24563,3578735326,3578735376,50
0,1067,24564,3578735386,3578735386,0
0,1067,24565,3578735386,3578735386,0
0,1067,24566,3578735386,3578735386,0
0,1067,24567,3578735386,3578735386,0
0,1067,24568,3578735386,3578735386,0
0,1067,24569,3578735386,3578735386,0
0,1067,24570,3578735386,3578735386,0
0,1067,24571,3578735386,3578735386,0
0,1067,24572,3578735386,3578735386,0
0,1067,24573,3578735386,3578735386,0
0,1067,24574,3578735386,3578735388,2
0,1067,24575,3578735386,3578735388,2
0,1067,24576,3578735386,3578735389,3
0,1067,24577,3578735386,3578735389,3
0,1067,24578,3578735386,3578735390,4
0,1067,24579,3578735386,3578735390,4
0,1067,24580,3578735386,3578735391,5
0,1067,24581,3578735386,3578735393,7
0,1067,24582,3578735386,3578735394,8
0,1067,24583,3578735386,3578735394,8
0,1067,24584,3578735386,3578735395,9
0,1067,24585,3578735386,3578735397,11
0,1067,24586,3578735386,3578735397,11
0,1067,24587,3578735386,3578735398,12
0,1067,24588,3578735386,3578735401,15
0,1067,24589,3578735386,3578735401,15
0,1067,24590,3578735386,3578735404,18
0,1067,24591,3578735386,3578735405,19
0,1067,24592,3578735386,3578735405,19
0,1067,24593,3578735386,3578735405,19
0,1067,24594,3578735386,3578735406,20
0,1067,24595,3578735386,3578735406,20
0,1067,24596,3578735386,3578735406,20
0,1067,24597,3578735386,3578735409,23
0,1067,24598,3578735386,3578735409,23
0,1067,24599,3578735386,3578735410,24
0,1067,24600,3578735386,3578735410,24
0,1067,24601,3578735386,3578735411,25
0,1067,24602,3578735386,3578735412,26
0,1067,24603,3578735386,3578735414,28
0,1067,24604,3578735386,3578735414,28
0,1067,24605,3578735386,3578735415,29
0,1067,24606,3578735386,3578735415,29
0,1067,24607,3578735386,3578735416,30
0,1067,24608,3578735386,3578735416,30
0,1067,24609,3578735386,3578735418,32
0,1067,24610,3578735386,3578735419,33
0,1067,24611,3578735386,3578735421,35
0,1067,24612,3578735386,3578735421,35
0,1067,24613,3578735386,3578735422,36
0,1067,24614,3578735386,3578735422,36
0,1067,24615,3578735386,3578735424,38
0,1067,24616,3578735386,3578735426,40
0,1067,24617,3578735386,3578735429,43
0,1067,24618,3578735386,3578735432,46
0,1067,24619,3578735386,3578735432,46
0,1067,24620,3578735386,3578735432,46
0,1067,24621,3578735386,3578735432,46
0,1067,24622,3578735386,3578735434,48
0,1067,24623,3578735386,3578735436,50
0,1068,24624,3578735449,3578735449,0
0,1068,24625,3578735449,3578735449,0
0,1068,24626,3578735449,3578735449,0
0,1068,24627,3578735449,3578735449,0
0,1068,24628,3578735449,3578735449,0
0,1068,24629,3578735449,3578735449,0
0,1068,24630,3578735449,3578735449,0
0,1068,24631,3578735449,3578735449,0
0,1068,24632,3578735449,3578735449,0
0,1068,24633,3578735449,3578735449,0
0,1068,24634,3578735449,3578735449,0
0,1068,24635,3578735449,3578735449,0
0,1068,24636,3578735449,3578735449,0
0,1068,24637,3578735449,3578735449,0
0,1068,24638,3578735449,3578735449,0
0,1068,24639,3578735449,3578735449,0
0,1068,24640,3578735449,3578735450,1
0,1068,24641,3578735449,3578735450,1
0,1068,24642,3578735449,3578735450,1
0,1068,24643,3578735449,3578735453,4
0,1068,24644,3578735449,3578735455,6
0,1068,24645,3578735449,3578735456,7
0,1068,24646,3578735449,3578735458,9
0,1068,24647,3578735449,3578735459,10
0,1068,24648,3578735449,3578735459,10
0,1068,24649,3578735449,3578735460,11
0,1068,24650,3578735449,3578735460,11
0,1068,24651,3578735449,3578735462,13
0,1068,24652,3578735449,3578735463,14
0,1068,24653,3578735449,3578735464,15
0,1068,24654,3578735449,3578735465,16
0,1068,24655,3578735449,3578735465,16
0,1068,24656,3578735449,3578735466,17
0,1068,24657,3578735449,3578735467,18
0,1068,24658,3578735449,3578735467,18
0,1068,24659,3578735449,3578735468,19
0,1068,24660,3578735449,3578735468,19
0,1068,24661,3578735449,3578735472,23
0,1068,24662,3578735449,3578735472,23
0,1068,24663,3578735449,3578735474,25
0,1068,24664,3578735449,3578735474,25
0,1068,24665,3578735449,3578735475,26
0,1068,24666,3578735449,3578735475,26
0,1068,24667,3578735449,3578735475,26
0,1068,24668,3578735449,3578735478,29
0,1068,24669,3578735449,3578735479,30
0,1068,24670,3578735449,3578735480,31
0,1068,24671,3578735449,3578735482,33
0,1068,24672,3578735449,3578735482,33
0,1068,24673,3578735449,3578735483,34
0,1068,24674,3578735449,3578735483,34
0,1068,24675,3578735449,3578735484,35
0,1068,24676,3578735449,3578735485,36
0,1068,24677,3578735449,3578735486,37
0,1068,24678,3578735449,3578735486,37
0,1068,24679,3578735449,3578735487,38
0,1068,24680,3578735449,3578735488,39
0,1068,24681,3578735449,3578735489,40
0,1068,24682,3578735449,3578735490,41
0,1068,24683,3578735449,3578735491,42
0,1068,24684,3578735449,3578735493,44
0,1068,24685,3578735449,3578735493,44
0,1068,24686,3578735449,3578735493,44
0,1068,24687,3578735449,3578735498,49
0,1068,24688,3578735449,3578735498,49
0,1068,24689,3578735449,3578735499,50
0,1069,24690,3578735511,3578735511,0
0,1069,24691,3578735511,3578735511,0
0,1069,24692,3578735511,3578735511,0
0,1069,24693,3578735511,3578735511,0
0,1069,24694,3578735511,3578735511,0
0,1069,24695,3578735511,3578735511,0
0,1069,24696,3578735511,3578735511,0
0,1069,24697,3578735511,3578735511,0
0,1069,24698,3578735511,3578735511,0
0,1069,24699,3578735511,3578735511,0
0,1069,24700,3578735511,3578735511,0
0,1069,24701,3578735511,3578735511,0
0,1069,24702,3578735511,3578735511,0
0,1069,24703,3578735511,3578735511,0
0,1069,24704,3578735511,3578735511,0
0,1069,24705,3578735511,3578735511,0
0,1069,24706,3578735511,3578735511,0
0,1069,24707,3578735511,3578735512,1
0,1069,24708,3578735511,3578735513,2
0,1069,24709,3578735511,3578735514,3
0,1069,24710,3578735511,3578735514,3
0,1069,24711,3578735511,3578735515,4
0,1069,24712,3578735511,3578735515,4
0,1069,24713,3578735511,3578735515,4
0,1069,24714,3578735511,3578735516,5
0,1069,24715,3578735511,3578735517,6
0,1069,24716,3578735511,3578735520,9
0,1069,24717,3578735511,3578735520,9
0,1069,24718,3578735511,3578735522,11
0,1069,24719,3578735511,3578735523,12
0,1069,24720,3578735511,3578735524,13
0,1069,24721,3578735511,3578735525,14
0,1069,24722,3578735511,3578735527,16
0,1069,24723,3578735511,3578735527,16
0,1069,24724,3578735511,3578735528,17
0,1069,24725,3578735511,3578735529,18
0,1069,24726,3578735511,3578735530,19
0,1069,24727,3578735511,3578735530,19
0,1069,24728,3578735511,3578735530,19
0,1069,24729,3578735511,3578735531,20
0,1069,24730,3578735511,3578735534,23
0,1069,24731,3578735511,3578735535,24
0,1069,24732,3578735511,3578735539,28
0,1069,24733,3578735511,3578735539,28
0,1069,24734,3578735511,3578735540,29
0,1069,24735,3578735511,3578735540,29
0,1069,24736,3578735511,3578735540,29
0,1069,24737,3578735511,3578735541,30
0,1069,24738,3578735511,3578735542,31
0,1069,24739,3578735511,3578735544,33
0,1069,24740,3578735511,3578735544,33
0,1069,24741,3578735511,3578735545,34
0,1069,24742,3578735511,3578735545,34
0,1069,24743,3578735511,3578735547,36
0,1069,24744,3578735511,3578735548,37
0,1069,24745,3578735511,3578735549,38
0,1069,24746,3578735511,3578735551,40
0,1069,24747,3578735511,3578735552,41
0,1069,24748,3578735511,3578735552,41
0,1069,24749,3578735511,3578735553,42
0,1069,24750,3578735511,3578735555,44
0,1069,24751,3578735511,3578735555,44
0,1069,24752,3578735511,3578735557,46
0,1069,24753,3578735511,3578735557,46
0,1069,24754,3578735511,3578735558,47
0,1069,24755,3578735511,3578735558,47
0,1069,24756,3578735511,3578735559,48
0,1069,24757,3578735511,3578735560,49
0,1069,24758,3578735511,3578735560,49
0,1069,24759,3578735511,3578735560,49
0,1070,24760,3578735571,3578735571,0
0,1070,24761,3578735571,3578735571,0
0,1070,24762,3578735571,3578735571,0
0,1070,24763,3578735571,3578735571,0
0,1070,24764,3578735571,3578735571,0
0,1070,24765,3578735571,3578735571,0
0,1070,24766,3578735571,3578735571,0
0,1070,24767,3578735571,3578735571,0
0,1070,24768,3578735571,3578735571,0
0,1070,24769,3578735571,3578735571,0
0,1070,24770,3578735571,3578735571,0
0,1070,24771,3578735571,3578735571,0
0,1070,24772,3578735571,3578735572,1
0,1070,24773,3578735571,3578735573,2
0,1070,24774,3578735571,3578735573,2
0,1070,24775,3578735571,3578735573,2
0,1070,24776,3578735571,3578735573,2
0,1070,24777,3578735571,3578735575,4
0,1070,24778,3578735571,3578735576,5
0,1070,24779,3578735571,3578735579,8
0,1070,24780,3578735571,3578735580,9
0,1070,24781,3578735571,3578735580,9
0,1070,24782,3578735571,3578735581,10
0,1070,24783,3578735571,3578735581,10
0,1070,24784,3578735571,3578735582,11
0,1070,24785,3578735571,3578735585,14
0,1070,24786,3578735571,3578735587,16
0,1070,24787,3578735571,3578735587,16
0,1070,24788,3578735571,3578735588,17
0,1070,24789,3578735571,3578735589,18
0,1070,24790,3578735571,3578735589,18
0,1070,24791,3578735571,3578735589,18
0,1070,24792,3578735571,3578735590,19
0,1070,24793,3578735571,3578735590,19
0,1070,24794,3578735571,3578735591,20
0,1070,24795,3578735571,3578735592,21
0,1070,24796,3578735571,3578735593,22
0,1070,24797,3578735571,3578735593,22
0,1070,24798,3578735571,3578735596,25
0,1070,24799,3578735571,3578735596,25
0,1070,24800,3578735571,3578735598,27
0,1070,24801,3578735571,3578735600,29
0,1070,24802,3578735571,3578735600,29
0,1070,24803,3578735571,3578735603,32
0,1070,24804,3578735571,3578735603,32
0,1070,24805,3578735571,3578735604,33
0,1070,24806,3578735571,3578735605,34
0,1070,24807,3578735571,3578735605,34
0,1070,24808,3578735571,3578735605,34
0,1070,24809,3578735571,3578735606,35
0,1070,24810,3578735571,3578735608,37
0,1070,24811,3578735571,3578735608,37
0,1070,24812,3578735571,3578735610,39
0,1070,24813,3578735571,3578735611,40
0,1070,24814,3578735571,3578735612,41
0,1070,24815,3578735571,3578735613,42
0,1070,24816,3578735571,3578735614,43
0,1070,24817,3578735571,3578735614,43
0,1070,24818,3578735571,3578735615,44
0,1070,24819,3578735571,3578735615,44
0,1070,24820,3578735571,3578735617,46
0,1070,24821,3578735571,3578735618,47
0,1070,24822,3578735571,3578735619,48
0,1070,24823,3578735571,3578735619,48
0,1070,24824,3578735571,3578735620,49
0,1071,24825,3578735630,3578735630,0
0,1071,24826,3578735630,3578735630,0
0,1071,24827,3578735630,3578735630,0
0,1071,24828,3578735630,3578735630,0
0,1071,24829,3578735630,3578735630,0
0,1071,24830,3578735630,3578735630,0
0,1071,24831,3578735630,3578735630,0
0,1071,24832,3578735630,3578735631,1
0,1071,24833,3578735630,3578735632,2
0,1071,24834,3578735630,3578735632,2
0,1071,24835,3578735630,3578735633,3
0,1071,24836,3578735630,3578735633,3
0,1071,24837,3578735630,3578735636,6
0,1071,24838,3578735630,3578735636,6
0,1071,24839,3578735630,3578735638,8
0,1071,24840,3578735630,3578735639,9
0,1071,24841,3578735630,3578735640,10
0,1071,24842,3578735630,3578735641,11
0,1071,24843,3578735630,3578735641,11
0,1071,24844,3578735630,3578735643,13
0,1071,24845,3578735630,3578735643,13
0,1071,24846,3578735630,3578735643,13
0,1071,24847,3578735630,3578735644,14
0,1071,24848,3578735630,3578735645,15
0,1071,24849,3578735630,3578735646,16
0,1071,24850,3578735630,3578735647,17
0,1071,24851,3578735630,3578735648,18
0,1071,24852,3578735630,3578735648,18
0,1071,24853,3578735630,3578735649,19
0,1071,24854,3578735630,3578735649,19
0,1071,24855,3578735630,3578735649,19
0,1071,24856,3578735630,3578735653,23
0,1071,24857,3578735630,3578735654,24
0,1071,24858,3578735630,3578735656,26
0,1071,24859,3578735630,3578735656,26
0,1071,24860,3578735630,3578735657,27
0,1071,24861,3578735630,3578735658,28
0,1071,24862,3578735630,3578735659,29
0,1071,24863,3578735630,3578735660,30
0,1071,24864,3578735630,3578735660,30
0,1071,24865,3578735630,3578735661,31
0,1071,24866,3578735630,3578735662,32
0,1071,24867,3578735630,3578735664,34
0,1071,24868,3578735630,3578735664,34
0,1071,24869,3578735630,3578735665,35
0,1071,24870,3578735630,3578735666,36
0,1071,24871,3578735630,3578735666,36
0,1071,24872,3578735630,3578735666,36
0,1071,24873,3578735630,3578735667,37
0,1071,24874,3578735630,3578735668,38
0,1071,24875,3578735630,3578735672,42
0,1071,24876,3578735630,3578735673,43
0,1071,24877,3578735630,3578735674,44
0,1071,24878,3578735630,3578735674,44
0,1071,24879,3578735630,3578735675,45
0,1071,24880,3578735630,3578735675,45
0,1071,24881,3578735630,3578735676,46
0,1071,24882,3578735630,3578735677,47
0,1071,24883,3578735630,3578735678,48
0,1071,24884,3578735630,3578735680,50
0,1072,24885,3578735688,3578735688,0
0,1072,24886,3578735688,3578735688,0
0,1072,24887,3578735688,3578735688,0
0,1072,24888,3578735688,3578735688,0
0,1072,24889,3578735688,3578735688,0
0,1072,24890,3578735688,3578735688,0
0,1072,24891,3578735688,3578735688,0
0,1072,24892,3578735688,3578735688,0
0,1072,24893,3578735688,3578735688,0
0,1072,24894,3578735688,3578735688,0
0,1072,24895,3578735688,3578735688,0
0,1072,24896,3578735688,3578735688,0
0,1072,24897,3578735688,3578735689,1
0,1072,24898,3578735688,3578735690,2
0,1072,24899,3578735688,3578735691,3
0,1072,24900,3578735688,3578735691,3
0,1072,24901,3578735688,3578735693,5
0,1072,24902,3578735688,3578735693,5
0,1072,24903,3578735688,3578735693,5
0,1072,24904,3578735688,3578735694,6
0,1072,24905,3578735688,3578735695,7
0,1072,24906,3578735688,3578735697,9
0,1072,24907,3578735688,3578735698,10
0,1072,24908,3578735688,3578735698,10
0,1072,24909,3578735688,3578735699,11
0,1072,24910,3578735688,3578735701,13
0,1072,24911,3578735688,3578735701,13
0,1072,24912,3578735688,3578735701,13
0,1072,24913,3578735688,3578735702,14
0,1072,24914,3578735688,3578735703,15
0,1072,24915,3578735688,3578735703,15
0,1072,24916,3578735688,3578735703,15
0,1072,24917,3578735688,3578735704,16
0,1072,24918,3578735688,3578735704,16
0,1072,24919,3578735688,3578735705,17
0,1072,24920,3578735688,3578735705,17
0,1072,24921,3578735688,3578735706,18
0,1072,24922,3578735688,3578735707,19
0,1072,24923,3578735688,3578735707,19
0,1072,24924,3578735688,3578735708,20
0,1072,24925,3578735688,3578735709,21
0,1072,24926,3578735688,3578735709,21
0,1072,24927,3578735688,3578735710,22
0,1072,24928,3578735688,3578735710,22
0,1072,24929,3578735688,3578735710,22
0,1072,24930,3578735688,3578735713,25
0,1072,24931,3578735688,3578735713,25
0,1072,24932,3578735688,3578735714,26
0,1072,24933,3578735688,3578735715,27
0,1072,24934,3578735688,3578735715,27
0,1072,24935,3578735688,3578735715,27
0,1072,24936,3578735688,3578735715,27
0,1072,24937,3578735688,3578735716,28
0,1072,24938,3578735688,3578735716,28
0,1072,24939,3578735688,3578735718,30
0,1072,24940,3578735688,3578735718,30
0,1072,24941,3578735688,3578735718,30
0,1072,24942,3578735688,3578735720,32
0,1072,24943,3578735688,3578735720,32
0,1072,24944,3578735688,3578735722,34
0,1072,24945,3578735688,3578735723,35
0,1072,24946,3578735688,3578735723,35
0,1072,24947,3578735688,3578735725,37
0,1072,24948,3578735688,3578735727,39
0,1072,24949,3578735688,3578735727,39
0,1072,24950,3578735688,3578735727,39
0,1072,24951,3578735688,3578735728,40
0,1072,24952,3578735688,3578735729,41
0,1072,24953,3578735688,3578735730,42
0,1072,24954,3578735688,3578735730,42
0,1072,24955,3578735688,3578735730,42
0,1072,24956,3578735688,3578735731,43
0,1072,24957,3578735688,3578735732,44
0,1072,24958,3578735688,3578735733,45
0,1072,24959,3578735688,3578735734,46
0,1072,24960,3578735688,3578735734,46
0,1072,24961,3578735688,3578735736,48
0,1073,24962,3578735748,3578735749,1
0,1073,24963,3578735748,3578735749,1
0,1073,24964,3578735748,3578735749,1
0,1073,24965,3578735748,3578735749,1
0,1073,24966,3578735748,3578735749,1
0,1073,24967,3578735748,3578735749,1
0,1073,24968,3578735748,3578735749,1
0,1073,24969,3578735748,3578735749,1
0,1073,24970,3578735748,3578735749,1
0,1073,24971,3578735748,3578735749,1
0,1073,24972,3578735748,3578735749,1
0,1073,24973,3578735748,3578735749,1
0,1073,24974,3578735748,3578735749,1
0,1073,24975,3578735748,3578735750,2
0,1073,24976,3578735748,3578735751,3
0,1073,24977,3578735748,3578735752,4
0,1073,24978,3578735748,3578735752,4
0,1073,24979,3578735748,3578735753,5
0,1073,24980,3578735748,3578735755,7
0,1073,24981,3578735748,3578735756,8
0,1073,24982,3578735748,3578735756,8
0,1073,24983,3578735748,3578735757,9
0,1073,24984,3578735748,3578735758,10
0,1073,24985,3578735748,3578735759,11
0,1073,24986,3578735748,3578735760,12
0,1073,24987,3578735748,3578735761,13
0,1073,24988,3578735748,3578735761,13
0,1073,24989,3578735748,3578735761,13
0,1073,24990,3578735748,3578735763,15
0,1073,24991,3578735748,3578735763,15
0,1073,24992,3578735748,3578735764,16
0,1073,24993,3578735748,3578735765,17
0,1073,24994,3578735748,3578735766,18
0,1073,24995,3578735748,3578735766,18
0,1073,24996,3578735748,3578735769,21
0,1073,24997,3578735748,3578735769,21
0,1073,24998,3578735748,3578735772,24
0,1073,24999,3578735748,3578735773,25
0,1073,25000,3578735748,3578735773,25
0,1073,25001,3578735748,3578735773,25
0,1073,25002,3578735748,3578735774,26
0,1073,25003,3578735748,3578735776,28
0,1073,25004,3578735748,3578735777,29
0,1073,25005,3578735748,3578735779,31
0,1073,25006,3578735748,3578735780,32
0,1073,25007,3578735748,3578735781,33
0,1073,25008,3578735748,3578735781,33
0,1073,25009,3578735748,3578735782,34
0,1073,25010,3578735748,3578735783,35
0,1073,25011,3578735748,3578735785,37
0,1073,25012,3578735748,3578735787,39
0,1073,25013,3578735748,3578735788,40
0,1073,25014,3578735748,3578735788,40
0,1073,25015,3578735748,3578735789,41
0,1073,25016,3578735748,3578735789,41
0,1073,25017,3578735748,3578735789,41
0,1073,25018,3578735748,3578735790,42
0,1073,25019,3578735748,3578735791,43
0,1073,25020,3578735748,3578735792,44
0,1073,25021,3578735748,3578735793,45
0,1073,25022,3578735748,3578735793,45
0,1073,25023,3578735748,3578735794,46
0,1073,25024,3578735748,3578735796,48
0,1073,25025,3578735748,3578735797,49
0,1073,25026,3578735748,3578735798,50
0,1074,25027,3578735807,3578735807,0
0,1074,25028,3578735807,3578735807,0
0,1074,25029,3578735807,3578735807,0
0,1074,25030,3578735807,3578735807,0
0,1074,25031,3578735807,3578735807,0
0,1074,25032,3578735807,3578735807,0
0,1074,25033,3578735807,3578735807,0
0,1074,25034,3578735807,3578735807,0
0,1074,25035,3578735807,3578735807,0
0,1074,25036,3578735807,3578735808,1
0,1074,25037,3578735807,3578735808,1
0,1074,25038,3578735807,3578735809,2
0,1074,25039,3578735807,3578735809,2
0,1074,25040,3578735807,3578735810,3
0,1074,25041,3578735807,3578735812,5
0,1074,25042,3578735807,3578735813,6
0,1074,25043,3578735807,3578735814,7
0,1074,25044,3578735807,3578735814,7
0,1074,25045,3578735807,3578735815,8
0,1074,25046,3578735807,3578735815,8
0,1074,25047,3578735807,3578735818,11
0,1074,25048,3578735807,3578735819,12
0,1074,25049,3578735807,3578735820,13
0,1074,25050,3578735807,3578735820,13
0,1074,25051,3578735807,3578735821,14
0,1074,25052,3578735807,3578735822,15
0,1074,25053,3578735807,3578735822,15
0,1074,25054,3578735807,3578735824,17
0,1074,25055,3578735807,3578735825,18
0,1074,25056,3578735807,3578735828,21
0,1074,25057,3578735807,3578735828,21
0,1074,25058,3578735807,3578735828,21
0,1074,25059,3578735807,3578735831,24
0,1074,25060,3578735807,3578735832,25
0,1074,25061,3578735807,3578735835,28
0,1074,25062,3578735807,3578735836,29
0,1074,25063,3578735807,3578735836,29
0,1074,25064,3578735807,3578735839,32
0,1074,25065,3578735807,3578735839,32
0,1074,25066,3578735807,3578735840,33
0,1074,25067,3578735807,3578735841,34
0,1074,25068,3578735807,3578735841,34
0,1074,25069,3578735807,3578735841,34
0,1074,25070,3578735807,3578735843,36
0,1074,25071,3578735807,3578735844,37
0,1074,25072,3578735807,3578735844,37
0,1074,25073,3578735807,3578735844,37
0,1074,25074,3578735807,3578735845,38
0,1074,25075,3578735807,3578735846,39
0,1074,25076,3578735807,3578735846,39
0,1074,25077,3578735807,3578735848,41
0,1074,25078,3578735807,3578735848,41
0,1074,25079,3578735807,3578735849,42
0,1074,25080,3578735807,3578735850,43
0,1074,25081,3578735807,3578735853,46
0,1074,25082,3578735807,3578735855,48
0,1074,25083,3578735807,3578735856,49
0,1074,25084,3578735807,3578735857,50
0,1075,25085,3578735870,3578735870,0
0,1075,25086,3578735870,3578735870,0
0,1075,25087,3578735870,3578735870,0
0,1075,25088,3578735870,3578735870,0
0,1075,25089,3578735870,3578735870,0
0,1075,25090,3578735870,3578735870,0
0,1075,25091,3578735870,3578735870,0
0,1075,25092,3578735870,3578735870,0
0,1075,25093,3578735870,3578735870,0
0,1075,25094,3578735870,3578735870,0
0,1075,25095,3578735870,3578735870,0
0,1075,25096,3578735870,3578735872,2
0,1075,25097,3578735870,3578735873,3
0,1075,25098,3578735870,3578735874,4
0,1075,25099,3578735870,3578735875,5
0,1075,25100,3578735870,3578735875,5
0,1075,25101,3578735870,3578735875,5
0,1075,25102,3578735870,3578735876,6
0,1075,25103,3578735870,3578735877,7
0,1075,25104,3578735870,3578735878,8
0,1075,25105,3578735870,3578735880,10
0,1075,25106,3578735870,3578735881,11
0,1075,25107,3578735870,3578735881,11
0,1075,25108,3578735870,3578735882,12
0,1075,25109,3578735870,3578735882,12
0,1075,25110,3578735870,3578735883,13
0,1075,25111,3578735870,3578735883,13
0,1075,25112,3578735870,3578735884,14
0,1075,25113,3578735870,3578735886,16
0,1075,25114,3578735870,3578735886,16
0,1075,25115,3578735870,3578735887,17
0,1075,25116,3578735870,3578735887,17
0,1075,25117,3578735870,3578735888,18
0,1075,25118,3578735870,3578735890,20
0,1075,25119,3578735870,3578735890,20
0,1075,25120,3578735870,3578735890,20
0,1075,25121,3578735870,3578735891,21
0,1075,25122,3578735870,3578735893,23
0,1075,25123,3578735870,3578735893,23
0,1075,25124,3578735870,3578735894,24
0,1075,25125,3578735870,3578735895,25
0,1075,25126,3578735870,3578735895,25
0,1075,25127,3578735870,3578735898,28
0,1075,25128,3578735870,3578735898,28
0,1075,25129,3578735870,3578735899,29
0,1075,25130,3578735870,3578735901,31
0,1075,25131,3578735870,3578735901,31
0,1075,25132,3578735870,3578735902,32
0,1075,25133,3578735870,3578735902,32
0,1075,25134,3578735870,3578735903,33
0,1075,25135,3578735870,3578735903,33
0,1075,25136,3578735870,3578735903,33
0,1075,25137,3578735870,3578735904,34
0,1075,25138,3578735870,3578735905,35
0,1075,25139,3578735870,3578735905,35
0,1075,25140,3578735870,3578735906,36
0,1075,25141,3578735870,3578735907,37
0,1075,25142,3578735870,3578735907,37
0,1075,25143,3578735870,3578735907,37
0,1075,25144,3578735870,3578735908,38
0,1075,25145,3578735870,3578735908,38
0,1075,25146,3578735870,3578735909,39
0,1075,25147,3578735870,3578735910,40
0,1075,25148,3578735870,3578735910,40
0,1075,25149,3578735870,3578735913,43
0,1075,25150,3578735870,3578735914,44
0,1075,25151,3578735870,3578735915,45
0,1075,25152,3578735870,3578735915,45
0,1075,25153,3578735870,3578735915,45
0,1075,25154,3578735870,3578735915,45
0,1075,25155,3578735870,3578735916,46
0,1075,25156,3578735870,3578735916,46
0,1075,25157,3578735870,3578735918,48
0,1075,25158,3578735870,3578735918,48
0,1075,25159,3578735870,3578735920,50
0,1076,25160,3578735928,3578735928,0
0,1076,25161,3578735928,3578735928,0
0,1076,25162,3578735928,3578735929,1
0,1076,25163,3578735928,3578735929,1
0,1076,25164,3578735928,3578735929,1
0,1076,25165,3578735928,3578735929,1
0,1076,25166,3578735928,3578735929,1
0,1076,25167,3578735928,3578735929,1
0,1076,25168,3578735928,3578735929,1
0,1076,25169,3578735928,3578735930,2
0,1076,25170,3578735928,3578735930,2
0,1076,25171,3578735928,3578735931,3
0,1076,25172,3578735928,3578735931,3
0,1076,25173,3578735928,3578735934,6
0,1076,25174,3578735928,3578735934,6
0,1076,25175,3578735928,3578735935,7
0,1076,25176,3578735928,3578735936,8
0,1076,25177,3578735928,3578735939,11
0,1076,25178,3578735928,3578735940,12
0,1076,25179,3578735928,3578735940,12
0,1076,25180,3578735928,3578735940,12
0,1076,25181,3578735928,3578735941,13
0,1076,25182,3578735928,3578735942,14
0,1076,25183,3578735928,3578735943,15
0,1076,25184,3578735928,3578735943,15
0,1076,25185,3578735928,3578735944,16
0,1076,25186,3578735928,3578735944,16
0,1076,25187,3578735928,3578735946,18
0,1076,25188,3578735928,3578735946,18
0,1076,25189,3578735928,3578735947,19
0,1076,25190,3578735928,3578735948,20
0,1076,25191,3578735928,3578735949,21
0,1076,25192,3578735928,3578735950,22
0,1076,25193,3578735928,3578735951,23
0,1076,25194,3578735928,3578735951,23
0,1076,25195,3578735928,3578735952,24
0,1076,25196,3578735928,3578735952,24
0,1076,25197,3578735928,3578735953,25
0,1076,25198,3578735928,3578735956,28
0,1076,25199,3578735928,3578735956,28
0,1076,25200,3578735928,3578735956,28
0,1076,25201,3578735928,3578735957,29
0,1076,25202,3578735928,3578735958,30
0,1076,25203,3578735928,3578735959,31
0,1076,25204,3578735928,3578735960,32
0,1076,25205,3578735928,3578735961,33
0,1076,25206,3578735928,3578735961,33
0,1076,25207,3578735928,3578735961,33
0,1076,25208,3578735928,3578735963,35
0,1076,25209,3578735928,3578735963,35
0,1076,25210,3578735928,3578735964,36
0,1076,25211,3578735928,3578735964,36
0,1076,25212,3578735928,3578735965,37
0,1076,25213,3578735928,3578735967,39
0,1076,25214,3578735928,3578735967,39
0,1076,25215,3578735928,3578735969,41
0,1076,25216,3578735928,3578735969,41
0,1076,25217,3578735928,3578735969,41
0,1076,25218,3578735928,3578735972,44
0,1076,25219,3578735928,3578735973,45
0,1076,25220,3578735928,3578735974,46
0,1076,25221,3578735928,3578735974,46
0,1076,25222,3578735928,3578735974,46
0,1076,25223,3578735928,3578735976,48
0,1076,25224,3578735928,3578735977,49
0,1077,25225,3578735990,3578735990,0
0,1077,25226,3578735990,3578735990,0
0,1077,25227,3578735990,3578735990,0
0,1077,25228,3578735990,3578735990,0
0,1077,25229,3578735990,3578735990,0
0,1077,25230,3578735990,3578735990,0
0,1077,25231,3578735990,3578735990,0
0,1077,25232,3578735990,3578735990,0
0,1077,25233,3578735990,3578735990,0
0,1077,25234,3578735990,3578735990,0
0,1077,25235,3578735990,3578735990,0
0,1077,25236,3578735990,3578735990,0
0,1077,25237,3578735990,3578735990,0
0,1077,25238,3578735990,3578735990,0
0,1077,25239,3578735990,3578735990,0
0,1077,25240,3578735990,3578735990,0
0,1077,25241,3578735990,3578735991,1
0,1077,25242,3578735990,3578735992,2
0,1077,25243,3578735990,3578735993,3
0,1077,25244,3578735990,3578735993,3
0,1077,25245,3578735990,3578735994,4
0,1077,25246,3578735990,3578735996,6
0,1077,25247,3578735990,3578735998,8
0,1077,25248,3578735990,3578735999,9
0,1077,25249,3578735990,3578735999,9
0,1077,25250,3578735990,3578736000,10
0,1077,25251,3578735990,3578736001,11
0,1077,25252,3578735990,3578736004,14
0,1077,25253,3578735990,3578736005,15
0,1077,25254,3578735990,3578736006,16
0,1077,25255,3578735990,3578736006,16
0,1077,25256,3578735990,3578736006,16
0,1077,25257,3578735990,3578736006,16
0,1077,25258,3578735990,3578736008,18
0,1077,25259,3578735990,3578736009,19
0,1077,25260,3578735990,3578736009,19
0,1077,25261,3578735990,3578736010,20
0,1077,25262,3578735990,3578736012,22
0,1077,25263,3578735990,3578736013,23
0,1077,25264,3578735990,3578736014,24
0,1077,25265,3578735990,3578736014,24
0,1077,25266,3578735990,3578736015,25
0,1077,25267,3578735990,3578736015,25
0,1077,25268,3578735990,3578736017,27
0,1077,25269,3578735990,3578736017,27
0,1077,25270,3578735990,3578736019,29
0,1077,25271,3578735990,3578736020,30
0,1077,25272,3578735990,3578736020,30
0,1077,25273,3578735990,3578736021,31
0,1077,25274,3578735990,3578736022,32
0,1077,25275,3578735990,3578736023,33
0,1077,25276,3578735990,3578736024,34
0,1077,25277,3578735990,3578736025,35
0,1077,25278,3578735990,3578736028,38
0,1077,25279,3578735990,3578736028,38
0,1077,25280,3578735990,3578736030,40
0,1077,25281,3578735990,3578736031,41
0,1077,25282,3578735990,3578736032,42
0,1077,25283,3578735990,3578736035,45
0,1077,25284,3578735990,3578736036,46
0,1077,25285,3578735990,3578736037,47
0,1077,25286,3578735990,3578736039,49
0,1077,25287,3578735990,3578736040,50
0,1078,25288,3578736051,3578736051,0
0,1078,25289,3578736051,3578736051,0
0,1078,25290,3578736051,3578736051,0
0,1078,25291,3578736051,3578736051,0
0,1078,25292,3578736051,3578736051,0
0,1078,25293,3578736051,3578736051,0
0,1078,25294,3578736051,3578736051,0
0,1078,25295,3578736051,3578736051,0
0,1078,25296,3578736051,3578736051,0
0,1078,25297,3578736051,3578736051,0
0,1078,25298,3578736051,3578736051,0
0,1078,25299,3578736051,3578736051,0
0,1078,25300,3578736051,3578736051,0
0,1078,25301,3578736051,3578736051,0
0,1078,25302,3578736051,3578736053,2
0,1078,25303,3578736051,3578736055,4
0,1078,25304,3578736051,3578736056,5
0,1078,25305,3578736051,3578736058,7
0,1078,25306,3578736051,3578736060,9
0,1078,25307,3578736051,3578736060,9
0,1078,25308,3578736051,3578736061,10
0,1078,25309,3578736051,3578736062,11
0,1078,25310,3578736051,3578736065,14
0,1078,25311,3578736051,3578736065,14
0,1078,25312,3578736051,3578736065,14
0,1078,25313,3578736051,3578736066,15
0,1078,25314,3578736051,3578736066,15
0,1078,25315,3578736051,3578736067,16
0,1078,25316,3578736051,3578736067,16
0,1078,25317,3578736051,3578736067,16
0,1078,25318,3578736051,3578736071,20
0,1078,25319,3578736051,3578736074,23
0,1078,25320,3578736051,3578736074,23
0,1078,25321,3578736051,3578736075,24
0,1078,25322,3578736051,3578736075,24
0,1078,25323,3578736051,3578736076,25
0,1078,25324,3578736051,3578736077,26
0,1078,25325,3578736051,3578736077,26
0,1078,25326,3578736051,3578736078,27
0,1078,25327,3578736051,3578736080,29
0,1078,25328,3578736051,3578736080,29
0,1078,25329,3578736051,3578736081,30
0,1078,25330,3578736051,3578736082,31
0,1078,25331,3578736051,3578736083,32
0,1078,25332,3578736051,3578736083,32
0,1078,25333,3578736051,3578736084,33
0,1078,25334,3578736051,3578736084,33
0,1078,25335,3578736051,3578736084,33
0,1078,25336,3578736051,3578736085,34
0,1078,25337,3578736051,3578736086,35
0,1078,25338,3578736051,3578736086,35
0,1078,25339,3578736051,3578736087,36
0,1078,25340,3578736051,3578736088,37
0,1078,25341,3578736051,3578736089,38
0,1078,25342,3578736051,3578736090,39
0,1078,25343,3578736051,3578736090,39
0,1078,25344,3578736051,3578736092,41
0,1078,25345,3578736051,3578736093,42
0,1078,25346,3578736051,3578736093,42
0,1078,25347,3578736051,3578736095,44
0,1078,25348,3578736051,3578736097,46
0,1078,25349,3578736051,3578736098,47
0,1078,25350,3578736051,3578736099,48
0,1078,25351,3578736051,3578736099,48
0,1078,25352,3578736051,3578736100,49
0,1078,25353,3578736051,3578736101,50
0,1079,25354,3578736111,3578736111,0
0,1079,25355,3578736111,3578736111,0
0,1079,25356,3578736111,3578736111,0
0,1079,25357,3578736111,3578736111,0
0,1079,25358,3578736111,3578736111,0
0,1079,25359,3578736111,3578736111,0
0,1079,25360,3578736111,3578736111,0
0,1079,25361,3578736111,3578736111,0
0,1079,25362,3578736111,3578736111,0
0,1079,25363,3578736111,3578736111,0
0,1079,25364,3578736111,3578736111,0
0,1079,25365,3578736111,3578736111,0
0,1079,25366,3578736111,3578736111,0
0,1079,25367,3578736111,3578736111,0
0,1079,25368,3578736111,3578736111,0
0,1079,25369,3578736111,3578736111,0
0,1079,25370,3578736111,3578736114,3
0,1079,25371,3578736111,3578736114,3
0,1079,25372,3578736111,3578736114,3
0,1079,25373,3578736111,3578736115,4
0,1079,25374,3578736111,3578736115,4
0,1079,25375,3578736111,3578736116,5
0,1079,25376,3578736111,3578736116,5
0,1079,25377,3578736111,3578736116,5
0,1079,25378,3578736111,3578736117,6
0,1079,25379,3578736111,3578736118,7
0,1079,25380,3578736111,3578736119,8
0,1079,25381,3578736111,3578736123,12
0,1079,25382,3578736111,3578736124,13
0,1079,25383,3578736111,3578736125,14
0,1079,25384,3578736111,3578736125,14
0,1079,25385,3578736111,3578736127,16
0,1079,25386,3578736111,3578736129,18
0,1079,25387,3578736111,3578736130,19
0,1079,25388,3578736111,3578736131,20
0,1079,25389,3578736111,3578736131,20
0,1079,25390,3578736111,3578736132,21
0,1079,25391,3578736111,3578736135,24
0,1079,25392,3578736111,3578736135,24
0,1079,25393,3578736111,3578736136,25
0,1079,25394,3578736111,3578736139,28
0,1079,25395,3578736111,3578736140,29
0,1079,25396,3578736111,3578736141,30
0,1079,25397,3578736111,3578736141,30
0,1079,25398,3578736111,3578736141,30
0,1079,25399,3578736111,3578736142,31
0,1079,25400,3578736111,3578736143,32
0,1079,25401,3578736111,3578736143,32
0,1079,25402,3578736111,3578736144,33
0,1079,25403,3578736111,3578736144,33
0,1079,25404,3578736111,3578736145,34
0,1079,25405,3578736111,3578736146,35
0,1079,25406,3578736111,3578736147,36
0,1079,25407,3578736111,3578736148,37
0,1079,25408,3578736111,3578736148,37
0,1079,25409,3578736111,3578736150,39
0,1079,25410,3578736111,3578736151,40
0,1079,25411,3578736111,3578736151,40
0,1079,25412,3578736111,3578736152,41
0,1079,25413,3578736111,3578736152,41
0,1079,25414,3578736111,3578736153,42
0,1079,25415,3578736111,3578736156,45
0,1079,25416,3578736111,3578736156,45
0,1079,25417,3578736111,3578736156,45
0,1079,25418,3578736111,3578736158,47
0,1079,25419,3578736111,3578736159,48
0,1079,25420,3578736111,3578736159,48
0,1079,25421,3578736111,3578736160,49
0,1080,25422,3578736172,3578736172,0
0,1080,25423,3578736172,3578736172,0
0,1080,25424,3578736172,3578736172,0
0,1080,25425,3578736172,3578736172,0
0,1080,25426,3578736172,3578736172,0
0,1080,25427,3578736172,3578736172,0
0,1080,25428,3578736172,3578736172,0
0,1080,25429,3578736172,3578736172,0
0,1080,25430,3578736172,3578736172,0
0,1080,25431,3578736172,3578736172,0
0,1080,25432,3578736172,3578736172,0
0,1080,25433,3578736172,3578736172,0
0,1080,25434,3578736172,3578736172,0
0,1080,25435,3578736172,3578736172,0
0,1080,25436,3578736172,3578736173,1
0,1080,25437,3578736172,3578736173,1
0,1080,25438,3578736172,3578736174,2
0,1080,25439,3578736172,3578736174,2
0,1080,25440,3578736172,3578736174,2
0,1080,25441,3578736172,3578736177,5
0,1080,25442,3578736172,3578736179,7
0,1080,25443,3578736172,3578736180,8
0,1080,25444,3578736172,3578736182,10
0,1080,25445,3578736172,3578736182,10
0,1080,25446,3578736172,3578736182,10
0,1080,25447,3578736172,3578736183,11
0,1080,25448,3578736172,3578736185,13
0,1080,25449,3578736172,3578736188,16
0,1080,25450,3578736172,3578736188,16
0,1080,25451,3578736172,3578736189,17
0,1080,25452,3578736172,3578736189,17
0,1080,25453,3578736172,3578736189,17
0,1080,25454,3578736172,3578736190,18
0,1080,25455,3578736172,3578736191,19
0,1080,25456,3578736172,3578736191,19
0,1080,25457,3578736172,3578736192,20
0,1080,25458,3578736172,3578736192,20
0,1080,25459,3578736172,3578736193,21
0,1080,25460,3578736172,3578736193,21
0,1080,25461,3578736172,3578736193,21
0,1080,25462,3578736172,3578736194,22
0,1080,25463,3578736172,3578736197,25
0,1080,25464,3578736172,3578736199,27
0,1080,25465,3578736172,3578736199,27
0,1080,25466,3578736172,3578736200,28
0,1080,25467,3578736172,3578736201,29
0,1080,25468,3578736172,3578736202,30
0,1080,25469,3578736172,3578736206,34
0,1080,25470,3578736172,3578736206,34
0,1080,25471,3578736172,3578736206,34
0,1080,25472,3578736172,3578736207,35
0,1080,25473,3578736172,3578736208,36
0,1080,25474,3578736172,3578736209,37
0,1080,25475,3578736172,3578736210,38
0,1080,25476,3578736172,3578736210,38
0,1080,25477,3578736172,3578736213,41
0,1080,25478,3578736172,3578736214,42
0,1080,25479,3578736172,3578736215,43
0,1080,25480,3578736172,3578736215,43
0,1080,25481,3578736172,3578736216,44
0,1080,25482,3578736172,3578736216,44
0,1080,25483,3578736172,3578736219,47
0,1080,25484,3578736172,3578736219,47
0,1080,25485,3578736172,3578736219,47
0,1080,25486,3578736172,3578736220,48
0,1080,25487,3578736172,3578736221,49
0,1081,25488,3578736233,3578736233,0
0,1081,25489,3578736233,3578736233,0
0,1081,25490,3578736233,3578736233,0
0,1081,25491,3578736233,3578736233,0
0,1081,25492,3578736233,3578736233,0
0,1081,25493,3578736233,3578736233,0
0,1081,25494,3578736233,3578736235,2
0,1081,25495,3578736233,3578736237,4
0,1081,25496,3578736233,3578736240,7
0,1081,25497,3578736233,3578736241,8
0,1081,25498,3578736233,3578736241,8
0,1081,25499,3578736233,3578736242,9
0,1081,25500,3578736233,3578736243,10
0,1081,25501,3578736233,3578736245,12
0,1081,25502,3578736233,3578736246,13
0,1081,25503,3578736233,3578736246,13
0,1081,25504,3578736233,3578736246,13
0,1081,25505,3578736233,3578736247,14
0,1081,25506,3578736233,3578736248,15
0,1081,25507,3578736233,3578736249,16
0,1081,25508,3578736233,3578736250,17
0,1081,25509,3578736233,3578736251,18
0,1081,25510,3578736233,3578736253,20
0,1081,25511,3578736233,3578736255,22
0,1081,25512,3578736233,3578736257,24
0,1081,25513,3578736233,3578736258,25
0,1081,25514,3578736233,3578736259,26
0,1081,25515,3578736233,3578736260,27
0,1081,25516,3578736233,3578736261,28
0,1081,25517,3578736233,3578736263,30
0,1081,25518,3578736233,3578736263,30
0,1081,25519,3578736233,3578736265,32
0,1081,25520,3578736233,3578736265,32
0,1081,25521,3578736233,3578736265,32
0,1081,25522,3578736233,3578736266,33
0,1081,25523,3578736233,3578736267,34
0,1081,25524,3578736233,3578736267,34
0,1081,25525,3578736233,3578736268,35
0,1081,25526,3578736233,3578736268,35
0,1081,25527,3578736233,3578736272,39
0,1081,25528,3578736233,3578736275,42
0,1081,25529,3578736233,3578736275,42
0,1081,25530,3578736233,3578736275,42
0,1081,25531,3578736233,3578736276,43
0,1081,25532,3578736233,3578736277,44
0,1081,25533,3578736233,3578736277,44
0,1081,25534,3578736233,3578736280,47
0,1081,25535,3578736233,3578736281,48
0,1081,25536,3578736233,3578736282,49
0,1081,25537,3578736233,3578736283,50
0,1082,25538,3578736292,3578736292,0
0,1082,25539,3578736292,3578736292,0
0,1082,25540,3578736292,3578736292,0
0,1082,25541,3578736292,3578736292,0
0,1082,25542,3578736292,3578736292,0
0,1082,25543,3578736292,3578736292,0
0,1082,25544,3578736292,3578736292,0
0,1082,25545,3578736292,3578736292,0
0,1082,25546,3578736292,3578736292,0
0,1082,25547,3578736292,3578736292,0
0,1082,25548,3578736292,3578736292,0
0,1082,25549,3578736292,3578736292,0
0,1082,25550,3578736292,3578736293,1
0,1082,25551,3578736292,3578736293,1
0,1082,25552,3578736292,3578736293,1
0,1082,25553,3578736292,3578736294,2
0,1082,25554,3578736292,3578736295,3
0,1082,25555,3578736292,3578736298,6
0,1082,25556,3578736292,3578736298,6
0,1082,25557,3578736292,3578736298,6
0,1082,25558,3578736292,3578736302,10
0,1082,25559,3578736292,3578736302,10
0,1082,25560,3578736292,3578736302,10
0,1082,25561,3578736292,3578736303,11
0,1082,25562,3578736292,3578736303,11
0,1082,25563,3578736292,3578736305,13
0,1082,25564,3578736292,3578736305,13
0,1082,25565,3578736292,3578736305,13
0,1082,25566,3578736292,3578736306,14
0,1082,25567,3578736292,3578736306,14
0,1082,25568,3578736292,3578736307,15
0,1082,25569,3578736292,3578736308,16
0,1082,25570,3578736292,3578736309,17
0,1082,25571,3578736292,3578736309,17
0,1082,25572,3578736292,3578736310,18
0,1082,25573,3578736292,3578736310,18
0,1082,25574,3578736292,3578736313,21
0,1082,25575,3578736292,3578736314,22
0,1082,25576,3578736292,3578736314,22
0,1082,25577,3578736292,3578736315,23
0,1082,25578,3578736292,3578736316,24
0,1082,25579,3578736292,3578736316,24
0,1082,25580,3578736292,3578736316,24
0,1082,25581,3578736292,3578736316,24
0,1082,25582,3578736292,3578736317,25
0,1082,25583,3578736292,3578736317,25
0,1082,25584,3578736292,3578736319,27
0,1082,25585,3578736292,3578736319,27
0,1082,25586,3578736292,3578736322,30
0,1082,25587,3578736292,3578736325,33
0,1082,25588,3578736292,3578736326,34
0,1082,25589,3578736292,3578736327,35
0,1082,25590,3578736292,3578736328,36
0,1082,25591,3578736292,3578736330,38
0,1082,25592,3578736292,3578736330,38
0,1082,25593,3578736292,3578736331,39
0,1082,25594,3578736292,3578736331,39
0,1082,25595,3578736292,3578736331,39
0,1082,25596,3578736292,3578736333,41
0,1082,25597,3578736292,3578736335,43
0,1082,25598,3578736292,3578736336,44
0,1082,25599,3578736292,3578736336,44
0,1082,25600,3578736292,3578736340,48
0,1082,25601,3578736292,3578736340,48
0,1082,25602,3578736292,3578736340,48
0,1082,25603,3578736292,3578736342,50
0,1083,25604,3578736352,3578736352,0
0,1083,25605,3578736352,3578736352,0
0,1083,25606,3578736352,3578736352,0
0,1083,25607,3578736352,3578736352,0
0,1083,25608,3578736352,3578736352,0
0,1083,25609,3578736352,3578736352,0
0,1083,25610,3578736352,3578736352,0
0,1083,25611,3578736352,3578736352,0
0,1083,25612,3578736352,3578736352,0
0,1083,25613,3578736352,3578736352,0
0,1083,25614,3578736352,3578736353,1
0,1083,25615,3578736352,3578736353,1
0,1083,25616,3578736352,3578736353,1
0,1083,25617,3578736352,3578736353,1
0,1083,25618,3578736352,3578736355,3
0,1083,25619,3578736352,3578736355,3
0,1083,25620,3578736352,3578736356,4
0,1083,25621,3578736352,3578736356,4
0,1083,25622,3578736352,3578736358,6
0,1083,25623,3578736352,3578736359,7
0,1083,25624,3578736352,3578736359,7
0,1083,25625,3578736352,3578736361,9
0,1083,25626,3578736352,3578736361,9
0,1083,25627,3578736352,3578736362,10
0,1083,25628,3578736352,3578736363,11
0,1083,25629,3578736352,3578736364,12
0,1083,25630,3578736352,3578736364,12
0,1083,25631,3578736352,3578736366,14
0,1083,25632,3578736352,3578736366,14
0,1083,25633,3578736352,3578736367,15
0,1083,25634,3578736352,3578736367,15
0,1083,25635,3578736352,3578736367,15
0,1083,25636,3578736352,3578736368,16
0,1083,25637,3578736352,3578736370,18
0,1083,25638,3578736352,3578736373,21
0,1083,25639,3578736352,3578736374,22
0,1083,25640,3578736352,3578736374,22
0,1083,25641,3578736352,3578736374,22
0,1083,25642,3578736352,3578736375,23
0,1083,25643,3578736352,3578736377,25
0,1083,25644,3578736352,3578736379,27
0,1083,25645,3578736352,3578736379,27
0,1083,25646,3578736352,3578736381,29
0,1083,25647,3578736352,3578736381,29
0,1083,25648,3578736352,3578736382,30
0,1083,25649,3578736352,3578736388,36
0,1083,25650,3578736352,3578736388,36
0,1083,25651,3578736352,3578736389,37
0,1083,25652,3578736352,3578736389,37
0,1083,25653,3578736352,3578736389,37
0,1083,25654,3578736352,3578736390,38
0,1083,25655,3578736352,3578736390,38
0,1083,25656,3578736352,3578736391,39
0,1083,25657,3578736352,3578736392,40
0,1083,25658,3578736352,3578736392,40
0,1083,25659,3578736352,3578736394,42
0,1083,25660,3578736352,3578736394,42
0,1083,25661,3578736352,3578736394,42
0,1083,25662,3578736352,3578736396,44
0,1083,25663,3578736352,3578736399,47
0,1083,25664,3578736352,3578736399,47
0,1083,25665,3578736352,3578736401,49
0,1083,25666,3578736352,3578736402,50
0,1084,25667,3578736414,3578736414,0
0,1084,25668,3578736414,3578736414,0
0,1084,25669,3578736414,3578736414,0
0,1084,25670,3578736414,3578736414,0
0,1084,25671,3578736414,3578736414,0
0,1084,25672,3578736414,3578736414,0
0,1084,25673,3578736414,3578736414,0
0,1084,25674,3578736414,3578736414,0
0,1084,25675,3578736414,3578736414,0
0,1084,25676,3578736414,3578736414,0
0,1084,25677,3578736414,3578736414,0
0,1084,25678,3578736414,3578736414,0
0,1084,25679,3578736414,3578736414,0
0,1084,25680,3578736414,3578736414,0
0,1084,25681,3578736414,3578736415,1
0,1084,25682,3578736414,3578736415,1
0,1084,25683,3578736414,3578736415,1
0,1084,25684,3578736414,3578736419,5
0,1084,25685,3578736414,3578736419,5
0,1084,25686,3578736414,3578736420,6
0,1084,25687,3578736414,3578736420,6
0,1084,25688,3578736414,3578736420,6
0,1084,25689,3578736414,3578736422,8
0,1084,25690,3578736414,3578736423,9
0,1084,25691,3578736414,3578736426,12
0,1084,25692,3578736414,3578736426,12
0,1084,25693,3578736414,3578736428,14
0,1084,25694,3578736414,3578736432,18
0,1084,25695,3578736414,3578736432,18
0,1084,25696,3578736414,3578736434,20
0,1084,25697,3578736414,3578736436,22
0,1084,25698,3578736414,3578736439,25
0,1084,25699,3578736414,3578736440,26
0,1084,25700,3578736414,3578736442,28
0,1084,25701,3578736414,3578736442,28
0,1084,25702,3578736414,3578736442,28
0,1084,25703,3578736414,3578736444,30
0,1084,25704,3578736414,3578736444,30
0,1084,25705,3578736414,3578736446,32
0,1084,25706,3578736414,3578736446,32
0,1084,25707,3578736414,3578736446,32
0,1084,25708,3578736414,3578736447,33
0,1084,25709,3578736414,3578736450,36
0,1084,25710,3578736414,3578736450,36
0,1084,25711,3578736414,3578736451,37
0,1084,25712,3578736414,3578736453,39
0,1084,25713,3578736414,3578736457,43
0,1084,25714,3578736414,3578736458,44
0,1084,25715,3578736414,3578736458,44
0,1084,25716,3578736414,3578736459,45
0,1084,25717,3578736414,3578736460,46
0,1084,25718,3578736414,3578736461,47
0,1084,25719,3578736414,3578736461,47
0,1084,25720,3578736414,3578736463,49
0,1084,25721,3578736414,3578736463,49
0,1085,25722,3578736476,3578736476,0
0,1085,25723,3578736476,3578736476,0
0,1085,25724,3578736476,3578736476,0
0,1085,25725,3578736476,3578736476,0
0,1085,25726,3578736476,3578736476,0
0,1085,25727,3578736476,3578736476,0
0,1085,25728,3578736476,3578736476,0
0,1085,25729,3578736476,3578736476,0
0,1085,25730,3578736476,3578736476,0
0,1085,25731,3578736476,3578736476,0
0,1085,25732,3578736476,3578736476,0
0,1085,25733,3578736476,3578736476,0
0,1085,25734,3578736476,3578736477,1
0,1085,25735,3578736476,3578736477,1
0,1085,25736,3578736476,3578736477,1
0,1085,25737,3578736476,3578736479,3
0,1085,25738,3578736476,3578736480,4
0,1085,25739,3578736476,3578736480,4
0,1085,25740,3578736476,3578736482,6
0,1085,25741,3578736476,3578736483,7
0,1085,25742,3578736476,3578736484,8
0,1085,25743,3578736476,3578736484,8
0,1085,25744,3578736476,3578736484,8
0,1085,25745,3578736476,3578736484,8
0,1085,25746,3578736476,3578736485,9
0,1085,25747,3578736476,3578736487,11
0,1085,25748,3578736476,3578736487,11
0,1085,25749,3578736476,3578736488,12
0,1085,25750,3578736476,3578736489,13
0,1085,25751,3578736476,3578736490,14
0,1085,25752,3578736476,3578736491,15
0,1085,25753,3578736476,3578736492,16
0,1085,25754,3578736476,3578736492,16
0,1085,25755,3578736476,3578736493,17
0,1085,25756,3578736476,3578736494,18
0,1085,25757,3578736476,3578736495,19
0,1085,25758,3578736476,3578736495,19
0,1085,25759,3578736476,3578736497,21
0,1085,25760,3578736476,3578736498,22
0,1085,25761,3578736476,3578736499,23
0,1085,25762,3578736476,3578736499,23
0,1085,25763,3578736476,3578736502,26
0,1085,25764,3578736476,3578736502,26
0,1085,25765,3578736476,3578736502,26
0,1085,25766,3578736476,3578736502,26
0,1085,25767,3578736476,3578736504,28
0,1085,25768,3578736476,3578736505,29
0,1085,25769,3578736476,3578736506,30
0,1085,25770,3578736476,3578736506,30
0,1085,25771,3578736476,3578736506,30
0,1085,25772,3578736476,3578736506,30
0,1085,25773,3578736476,3578736507,31
0,1085,25774,3578736476,3578736508,32
0,1085,25775,3578736476,3578736508,32
0,1085,25776,3578736476,3578736509,33
0,1085,25777,3578736476,3578736509,33
0,1085,25778,3578736476,3578736510,34
0,1085,25779,3578736476,3578736510,34
0,1085,25780,3578736476,3578736514,38
0,1085,25781,3578736476,3578736514,38
0,1085,25782,3578736476,3578736515,39
0,1085,25783,3578736476,3578736515,39
0,1085,25784,3578736476,3578736515,39
0,1085,25785,3578736476,3578736516,40
0,1085,25786,3578736476,3578736516,40
0,1085,25787,3578736476,3578736516,40
0,1085,25788,3578736476,3578736518,42
0,1085,25789,3578736476,3578736519,43
0,1085,25790,3578736476,3578736520,44
0,1085,25791,3578736476,3578736522,46
0,1085,25792,3578736476,3578736523,47
0,1085,25793,3578736476,3578736525,49
0,1086,25794,3578736537,3578736537,0
0,1086,25795,3578736537,3578736537,0
0,1086,25796,3578736537,3578736537,0
0,1086,25797,3578736537,3578736537,0
0,1086,25798,3578736537,3578736537,0
0,1086,25799,3578736537,3578736537,0
0,1086,25800,3578736537,3578736537,0
0,1086,25801,3578736537,3578736537,0
0,1086,25802,3578736537,3578736537,0
0,1086,25803,3578736537,3578736537,0
0,1086,25804,3578736537,3578736537,0
0,1086,25805,3578736537,3578736537,0
0,1086,25806,3578736537,3578736539,2
0,1086,25807,3578736537,3578736539,2
0,1086,25808,3578736537,3578736540,3
0,1086,25809,3578736537,3578736541,4
0,1086,25810,3578736537,3578736541,4
0,1086,25811,3578736537,3578736542,5
0,1086,25812,3578736537,3578736542,5
0,1086,25813,3578736537,3578736543,6
0,1086,25814,3578736537,3578736544,7
0,1086,25815,3578736537,3578736544,7
0,1086,25816,3578736537,3578736546,9
0,1086,25817,3578736537,3578736547,10
0,1086,25818,3578736537,3578736547,10
0,1086,25819,3578736537,3578736548,11
0,1086,25820,3578736537,3578736550,13
0,1086,25821,3578736537,3578736551,14
0,1086,25822,3578736537,3578736551,14
0,1086,25823,3578736537,3578736552,15
0,1086,25824,3578736537,3578736552,15
0,1086,25825,3578736537,3578736554,17
0,1086,25826,3578736537,3578736555,18
0,1086,25827,3578736537,3578736558,21
0,1086,25828,3578736537,3578736558,21
0,1086,25829,3578736537,3578736559,22
0,1086,25830,3578736537,3578736560,23
0,1086,25831,3578736537,3578736560,23
0,1086,25832,3578736537,3578736562,25
0,1086,25833,3578736537,3578736563,26
0,1086,25834,3578736537,3578736563,26
0,1086,25835,3578736537,3578736563,26
0,1086,25836,3578736537,3578736565,28
0,1086,25837,3578736537,3578736566,29
0,1086,25838,3578736537,3578736566,29
0,1086,25839,3578736537,3578736566,29
0,1086,25840,3578736537,3578736567,30
0,1086,25841,3578736537,3578736572,35
0,1086,25842,3578736537,3578736573,36
0,1086,25843,3578736537,3578736573,36
0,1086,25844,3578736537,3578736573,36
0,1086,25845,3578736537,3578736574,37
0,1086,25846,3578736537,3578736576,39
0,1086,25847,3578736537,3578736578,41
0,1086,25848,3578736537,3578736580,43
0,1086,25849,3578736537,3578736580,43
0,1086,25850,3578736537,3578736581,44
0,1086,25851,3578736537,3578736581,44
0,1086,25852,3578736537,3578736585,48
0,1087,25853,3578736597,3578736597,0
0,1087,25854,3578736597,3578736597,0
0,1087,25855,3578736597,3578736597,0
0,1087,25856,3578736597,3578736597,0
0,1087,25857,3578736597,3578736597,0
0,1087,25858,3578736597,3578736597,0
0,1087,25859,3578736597,3578736597,0
0,1087,25860,3578736597,3578736597,0
0,1087,25861,3578736597,3578736597,0
0,1087,25862,3578736597,3578736597,0
0,1087,25863,3578736597,3578736597,0
0,1087,25864,3578736597,3578736597,0
0,1087,25865,3578736597,3578736597,0
0,1087,25866,3578736597,3578736597,0
0,1087,25867,3578736597,3578736598,1
0,1087,25868,3578736597,3578736598,1
0,1087,25869,3578736597,3578736600,3
0,1087,25870,3578736597,3578736601,4
0,1087,25871,3578736597,3578736602,5
0,1087,25872,3578736597,3578736604,7
0,1087,25873,3578736597,3578736604,7
0,1087,25874,3578736597,3578736605,8
0,1087,25875,3578736597,3578736605,8
0,1087,25876,3578736597,3578736605,8
0,1087,25877,3578736597,3578736608,11
0,1087,25878,3578736597,3578736608,11
0,1087,25879,3578736597,3578736611,14
0,1087,25880,3578736597,3578736611,14
0,1087,25881,3578736597,3578736611,14
0,1087,25882,3578736597,3578736613,16
0,1087,25883,3578736597,3578736613,16
0,1087,25884,3578736597,3578736614,17
0,1087,25885,3578736597,3578736614,17
0,1087,25886,3578736597,3578736615,18
0,1087,25887,3578736597,3578736616,19
0,1087,25888,3578736597,3578736618,21
0,1087,25889,3578736597,3578736619,22
0,1087,25890,3578736597,3578736619,22
0,1087,25891,3578736597,3578736619,22
0,1087,25892,3578736597,3578736619,22
0,1087,25893,3578736597,3578736621,24
0,1087,25894,3578736597,3578736621,24
0,1087,25895,3578736597,3578736625,28
0,1087,25896,3578736597,3578736625,28
0,1087,25897,3578736597,3578736627,30
0,1087,25898,3578736597,3578736627,30
0,1087,25899,3578736597,3578736631,34
0,1087,25900,3578736597,3578736632,35
0,1087,25901,3578736597,3578736632,35
0,1087,25902,3578736597,3578736634,37
0,1087,25903,3578736597,3578736637,40
0,1087,25904,3578736597,3578736638,41
0,1087,25905,3578736597,3578736639,42
0,1087,25906,3578736597,3578736641,44
0,1087,25907,3578736597,3578736641,44
0,1087,25908,3578736597,3578736641,44
0,1087,25909,3578736597,3578736643,46
0,1087,25910,3578736597,3578736644,47
0,1087,25911,3578736597,3578736644,47
0,1087,25912,3578736597,3578736644,47
0,1087,25913,3578736597,3578736645,48
0,1087,25914,3578736597,3578736646,49
0,1088,25915,3578736658,3578736658,0
0,1088,25916,3578736658,3578736658,0
0,1088,25917,3578736658,3578736658,0
0,1088,25918,3578736658,3578736658,0
0,1088,25919,3578736658,3578736658,0
0,1088,25920,3578736658,3578736658,0
0,1088,25921,3578736658,3578736658,0
0,1088,25922,3578736658,3578736658,0
0,1088,25923,3578736658,3578736658,0
0,1088,25924,3578736658,3578736658,0
0,1088,25925,3578736658,3578736659,1
0,1088,25926,3578736658,3578736661,3
0,1088,25927,3578736658,3578736662,4
0,1088,25928,3578736658,3578736663,5
0,1088,25929,3578736658,3578736663,5
0,1088,25930,3578736658,3578736664,6
0,1088,25931,3578736658,3578736665,7
0,1088,25932,3578736658,3578736666,8
0,1088,25933,3578736658,3578736666,8
0,1088,25934,3578736658,3578736666,8
0,1088,25935,3578736658,3578736666,8
0,1088,25936,3578736658,3578736667,9
0,1088,25937,3578736658,3578736673,15
0,1088,25938,3578736658,3578736675,17
0,1088,25939,3578736658,3578736675,17
0,1088,25940,3578736658,3578736675,17
0,1088,25941,3578736658,3578736677,19
0,1088,25942,3578736658,3578736678,20
0,1088,25943,3578736658,3578736678,20
0,1088,25944,3578736658,3578736679,21
0,1088,25945,3578736658,3578736679,21
0,1088,25946,3578736658,3578736679,21
0,1088,25947,3578736658,3578736682,24
0,1088,25948,3578736658,3578736682,24
0,1088,25949,3578736658,3578736682,24
0,1088,25950,3578736658,3578736683,25
0,1088,25951,3578736658,3578736684,26
0,1088,25952,3578736658,3578736684,26
0,1088,25953,3578736658,3578736684,26
0,1088,25954,3578736658,3578736684,26
0,1088,25955,3578736658,3578736685,27
0,1088,25956,3578736658,3578736687,29
0,1088,25957,3578736658,3578736688,30
0,1088,25958,3578736658,3578736688,30
0,1088,25959,3578736658,3578736689,31
0,1088,25960,3578736658,3578736691,33
0,1088,25961,3578736658,3578736692,34
0,1088,25962,3578736658,3578736692,34
0,1088,25963,3578736658,3578736693,35
0,1088,25964,3578736658,3578736694,36
0,1088,25965,3578736658,3578736695,37
0,1088,25966,3578736658,3578736696,38
0,1088,25967,3578736658,3578736697,39
0,1088,25968,3578736658,3578736699,41
0,1088,25969,3578736658,3578736699,41
0,1088,25970,3578736658,3578736701,43
0,1088,25971,3578736658,3578736702,44
0,1088,25972,3578736658,3578736702,44
0,1088,25973,3578736658,3578736702,44
0,1088,25974,3578736658,3578736703,45
0,1088,25975,3578736658,3578736704,46
0,1088,25976,3578736658,3578736705,47
0,1088,25977,3578736658,3578736706,48
0,1088,25978,3578736658,3578736706,48
0,1088,25979,3578736658,3578736707,49
0,1088,25980,3578736658,3578736707,49
0,1088,25981,3578736658,3578736707,49
0,1089,25982,3578736720,3578736720,0
0,1089,25983,3578736720,3578736720,0
0,1089,25984,3578736720,3578736720,0
0,1089,25985,3578736720,3578736720,0
0,1089,25986,3578736720,3578736720,0
0,1089,25987,3578736720,3578736720,0
0,1089,25988,3578736720,3578736720,0
0,1089,25989,3578736720,3578736720,0
0,1089,25990,3578736720,3578736720,0
0,1089,25991,3578736720,3578736720,0
0,1089,25992,3578736720,3578736720,0
0,1089,25993,3578736720,3578736720,0
0,1089,25994,3578736720,3578736720,0
0,1089,25995,3578736720,3578736720,0
0,1089,25996,3578736720,3578736720,0
0,1089,25997,3578736720,3578736720,0
0,1089,25998,3578736720,3578736720,0
0,1089,25999,3578736720,3578736720,0
0,1089,26000,3578736720,3578736722,2
0,1089,26001,3578736720,3578736723,3
0,1089,26002,3578736720,3578736724,4
0,1089,26003,3578736720,3578736725,5
0,1089,26004,3578736720,3578736726,6
0,1089,26005,3578736720,3578736726,6
0,1089,26006,3578736720,3578736728,8
0,1089,26007,3578736720,3578736730,10
0,1089,26008,3578736720,3578736730,10
0,1089,26009,3578736720,3578736731,11
0,1089,26010,3578736720,3578736731,11
0,1089,26011,3578736720,3578736731,11
0,1089,26012,3578736720,3578736734,14
0,1089,26013,3578736720,3578736735,15
0,1089,26014,3578736720,3578736735,15
0,1089,26015,3578736720,3578736738,18
0,1089,26016,3578736720,3578736739,19
0,1089,26017,3578736720,3578736740,20
0,1089,26018,3578736720,3578736740,20
0,1089,26019,3578736720,3578736741,21
0,1089,26020,3578736720,3578736742,22
0,1089,26021,3578736720,3578736742,22
0,1089,26022,3578736720,3578736743,23
0,1089,26023,3578736720,3578736743,23
0,1089,26024,3578736720,3578736744,24
0,1089,26025,3578736720,3578736744,24
0,1089,26026,3578736720,3578736746,26
0,1089,26027,3578736720,3578736747,27
0,1089,26028,3578736720,3578736747,27
0,1089,26029,3578736720,3578736750,30
0,1089,26030,3578736720,3578736751,31
0,1089,26031,3578736720,3578736752,32
0,1089,26032,3578736720,3578736752,32
0,1089,26033,3578736720,3578736753,33
0,1089,26034,3578736720,3578736754,34
0,1089,26035,3578736720,3578736756,36
0,1089,26036,3578736720,3578736758,38
0,1089,26037,3578736720,3578736761,41
0,1089,26038,3578736720,3578736761,41
0,1089,26039,3578736720,3578736762,42
0,1089,26040,3578736720,3578736763,43
0,1089,26041,3578736720,3578736764,44
0,1089,26042,3578736720,3578736765,45
0,1089,26043,3578736720,3578736765,45
0,1089,26044,3578736720,3578736766,46
0,1089,26045,3578736720,3578736766,46
0,1089,26046,3578736720,3578736767,47
0,1089,26047,3578736720,3578736767,47
0,1089,26048,3578736720,3578736768,48
0,1089,26049,3578736720,3578736768,48
0,1089,26050,3578736720,3578736769,49
0,1090,26051,3578736783,3578736783,0
0,1090,26052,3578736783,3578736783,0
0,1090,26053,3578736783,3578736783,0
0,1090,26054,3578736783,3578736783,0
0,1090,26055,3578736783,3578736783,0
0,1090,26056,3578736783,3578736783,0
0,1090,26057,3578736783,3578736783,0
0,1090,26058,3578736783,3578736783,0
0,1090,26059,3578736783,3578736783,0
0,1090,26060,3578736783,3578736783,0
0,1090,26061,3578736783,3578736783,0
0,1090,26062,3578736783,3578736783,0
0,1090,26063,3578736783,3578736787,4
0,1090,26064,3578736783,3578736788,5
0,1090,26065,3578736783,3578736789,6
0,1090,26066,3578736783,3578736789,6
0,1090,26067,3578736783,3578736789,6
0,1090,26068,3578736783,3578736790,7
0,1090,26069,3578736783,3578736792,9
0,1090,26070,3578736783,3578736792,9
0,1090,26071,3578736783,3578736792,9
0,1090,26072,3578736783,3578736793,10
0,1090,26073,3578736783,3578736793,10
0,1090,26074,3578736783,3578736794,11
0,1090,26075,3578736783,3578736795,12
0,1090,26076,3578736783,3578736798,15
0,1090,26077,3578736783,3578736799,16
0,1090,26078,3578736783,3578736800,17
0,1090,26079,3578736783,3578736802,19
0,1090,26080,3578736783,3578736802,19
0,1090,26081,3578736783,3578736804,21
0,1090,26082,3578736783,3578736805,22
0,1090,26083,3578736783,3578736805,22
0,1090,26084,3578736783,3578736805,22
0,1090,26085,3578736783,3578736805,22
0,1090,26086,3578736783,3578736805,22
0,1090,26087,3578736783,3578736808,25
0,1090,26088,3578736783,3578736808,25
0,1090,26089,3578736783,3578736809,26
0,1090,26090,3578736783,3578736811,28
0,1090,26091,3578736783,3578736812,29
0,1090,26092,3578736783,3578736813,30
0,1090,26093,3578736783,3578736813,30
0,1090,26094,3578736783,3578736814,31
0,1090,26095,3578736783,3578736815,32
0,1090,26096,3578736783,3578736816,33
0,1090,26097,3578736783,3578736816,33
0,1090,26098,3578736783,3578736816,33
0,1090,26099,3578736783,3578736818,35
0,1090,26100,3578736783,3578736819,36
0,1090,26101,3578736783,3578736819,36
0,1090,26102,3578736783,3578736819,36
0,1090,26103,3578736783,3578736821,38
0,1090,26104,3578736783,3578736822,39
0,1090,26105,3578736783,3578736826,43
0,1090,26106,3578736783,3578736827,44
0,1090,26107,3578736783,3578736829,46
0,1090,26108,3578736783,3578736831,48
0,1091,26109,3578736845,3578736845,0
0,1091,26110,3578736845,3578736845,0
0,1091,26111,3578736845,3578736845,0
0,1091,26112,3578736845,3578736845,0
0,1091,26113,3578736845,3578736845,0
0,1091,26114,3578736845,3578736845,0
0,1091,26115,3578736845,3578736845,0
0,1091,26116,3578736845,3578736845,0
0,1091,26117,3578736845,3578736845,0
0,1091,26118,3578736845,3578736845,0
0,1091,26119,3578736845,3578736845,0
0,1091,26120,3578736845,3578736845,0
0,1091,26121,3578736845,3578736845,0
0,1091,26122,3578736845,3578736845,0
0,1091,26123,3578736845,3578736845,0
0,1091,26124,3578736845,3578736845,0
0,1091,26125,3578736845,3578736847,2
0,1091,26126,3578736845,3578736849,4
0,1091,26127,3578736845,3578736849,4
0,1091,26128,3578736845,3578736850,5
0,1091,26129,3578736845,3578736852,7
0,1091,26130,3578736845,3578736854,9
0,1091,26131,3578736845,3578736856,11
0,1091,26132,3578736845,3578736856,11
0,1091,26133,3578736845,3578736857,12
0,1091,26134,3578736845,3578736858,13
0,1091,26135,3578736845,3578736859,14
0,1091,26136,3578736845,3578736860,15
0,1091,26137,3578736845,3578736860,15
0,1091,26138,3578736845,3578736863,18
0,1091,26139,3578736845,3578736863,18
0,1091,26140,3578736845,3578736863,18
0,1091,26141,3578736845,3578736864,19
0,1091,26142,3578736845,3578736865,20
0,1091,26143,3578736845,3578736866,21
0,1091,26144,3578736845,3578736866,21
0,1091,26145,3578736845,3578736867,22
0,1091,26146,3578736845,3578736867,22
0,1091,26147,3578736845,3578736867,22
0,1091,26148,3578736845,3578736867,22
0,1091,26149,3578736845,3578736872,27
0,1091,26150,3578736845,3578736875,30
0,1091,26151,3578736845,3578736875,30
0,1091,26152,3578736845,3578736876,31
0,1091,26153,3578736845,3578736877,32
0,1091,26154,3578736845,3578736878,33
0,1091,26155,3578736845,3578736878,33
0,1091,26156,3578736845,3578736880,35
0,1091,26157,3578736845,3578736880,35
0,1091,26158,3578736845,3578736881,36
0,1091,26159,3578736845,3578736882,37
0,1091,26160,3578736845,3578736883,38
0,1091,26161,3578736845,3578736883,38
0,1091,26162,3578736845,3578736884,39
0,1091,26163,3578736845,3578736884,39
0,1091,26164,3578736845,3578736884,39
0,1091,26165,3578736845,3578736884,39
0,1091,26166,3578736845,3578736884,39
0,1091,26167,3578736845,3578736887,42
0,1091,26168,3578736845,3578736887,42
0,1091,26169,3578736845,3578736888,43
0,1091,26170,3578736845,3578736889,44
0,1091,26171,3578736845,3578736891,46
0,1091,26172,3578736845,3578736891,46
0,1091,26173,3578736845,3578736893,48
0,1091,26174,3578736845,3578736893,48
0,1091,26175,3578736845,3578736893,48
0,1091,26176,3578736845,3578736895,50
0,1092,26177,3578736905,3578736905,0
0,1092,26178,3578736905,3578736905,0
0,1092,26179,3578736905,3578736905,0
0,1092,26180,3578736905,3578736905,0
0,1092,26181,3578736905,3578736905,0
0,1092,26182,3578736905,3578736905,0
0,1092,26183,3578736905,3578736905,0
0,1092,26184,3578736905,3578736905,0
0,1092,26185,3578736905,3578736905,0
0,1092,26186,3578736905,3578736905,0
0,1092,26187,3578736905,3578736905,0
0,1092,26188,3578736905,3578736906,1
0,1092,26189,3578736905,3578736907,2
0,1092,26190,3578736905,3578736907,2
0,1092,26191,3578736905,3578736907,2
0,1092,26192,3578736905,3578736908,3
0,1092,26193,3578736905,3578736909,4
0,1092,26194,3578736905,3578736909,4
0,1092,26195,3578736905,3578736909,4
0,1092,26196,3578736905,3578736913,8
0,1092,26197,3578736905,3578736913,8
0,1092,26198,3578736905,3578736915,10
0,1092,26199,3578736905,3578736915,10
0,1092,26200,3578736905,3578736915,10
0,1092,26201,3578736905,3578736916,11
0,1092,26202,3578736905,3578736916,11
0,1092,26203,3578736905,3578736916,11
0,1092,26204,3578736905,3578736917,12
0,1092,26205,3578736905,3578736918,13
0,1092,26206,3578736905,3578736920,15
0,1092,26207,3578736905,3578736920,15
0,1092,26208,3578736905,3578736920,15
0,1092,26209,3578736905,3578736922,17
0,1092,26210,3578736905,3578736923,18
0,1092,26211,3578736905,3578736924,19
0,1092,26212,3578736905,3578736924,19
0,1092,26213,3578736905,3578736925,20
0,1092,26214,3578736905,3578736926,21
0,1092,26215,3578736905,3578736927,22
0,1092,26216,3578736905,3578736927,22
0,1092,26217,3578736905,3578736929,24
0,1092,26218,3578736905,3578736930,25
0,1092,26219,3578736905,3578736931,26
0,1092,26220,3578736905,3578736931,26
0,1092,26221,3578736905,3578736934,29
0,1092,26222,3578736905,3578736937,32
0,1092,26223,3578736905,3578736938,33
0,1092,26224,3578736905,3578736939,34
0,1092,26225,3578736905,3578736941,36
0,1092,26226,3578736905,3578736941,36
0,1092,26227,3578736905,3578736941,36
0,1092,26228,3578736905,3578736943,38
0,1092,26229,3578736905,3578736943,38
0,1092,26230,3578736905,3578736943,38
0,1092,26231,3578736905,3578736943,38
0,1092,26232,3578736905,3578736944,39
0,1092,26233,3578736905,3578736945,40
0,1092,26234,3578736905,3578736946,41
0,1092,26235,3578736905,3578736946,41
0,1092,26236,3578736905,3578736948,43
0,1092,26237,3578736905,3578736948,43
0,1092,26238,3578736905,3578736948,43
0,1092,26239,3578736905,3578736950,45
0,1092,26240,3578736905,3578736952,47
0,1092,26241,3578736905,3578736952,47
0,1092,26242,3578736905,3578736953,48
0,1092,26243,3578736905,3578736953,48
0,1093,26244,3578736966,3578736966,0
0,1093,26245,3578736966,3578736966,0
0,1093,26246,3578736966,3578736966,0
0,1093,26247,3578736966,3578736966,0
0,1093,26248,3578736966,3578736966,0
0,1093,26249,3578736966,3578736966,0
0,1093,26250,3578736966,3578736966,0
0,1093,26251,3578736966,3578736966,0
0,1093,26252,3578736966,3578736966,0
0,1093,26253,3578736966,3578736966,0
0,1093,26254,3578736966,3578736966,0
0,1093,26255,3578736966,3578736966,0
0,1093,26256,3578736966,3578736966,0
0,1093,26257,3578736966,3578736966,0
0,1093,26258,3578736966,3578736966,0
0,1093,26259,3578736966,3578736967,1
0,1093,26260,3578736966,3578736967,1
0,1093,26261,3578736966,3578736968,2
0,1093,26262,3578736966,3578736969,3
0,1093,26263,3578736966,3578736970,4
0,1093,26264,3578736966,3578736973,7
0,1093,26265,3578736966,3578736973,7
0,1093,26266,3578736966,3578736973,7
0,1093,26267,3578736966,3578736974,8
0,1093,26268,3578736966,3578736974,8
0,1093,26269,3578736966,3578736974,8
0,1093,26270,3578736966,3578736976,10
0,1093,26271,3578736966,3578736977,11
0,1093,26272,3578736966,3578736978,12
0,1093,26273,3578736966,3578736979,13
0,1093,26274,3578736966,3578736981,15
0,1093,26275,3578736966,3578736981,15
0,1093,26276,3578736966,3578736981,15
0,1093,26277,3578736966,3578736988,22
0,1093,26278,3578736966,3578736988,22
0,1093,26279,3578736966,3578736989,23
0,1093,26280,3578736966,3578736989,23
0,1093,26281,3578736966,3578736989,23
0,1093,26282,3578736966,3578736989,23
0,1093,26283,3578736966,3578736992,26
0,1093,26284,3578736966,3578736992,26
0,1093,26285,3578736966,3578736992,26
0,1093,26286,3578736966,3578736992,26
0,1093,26287,3578736966,3578736993,27
0,1093,26288,3578736966,3578736994,28
0,1093,26289,3578736966,3578736994,28
0,1093,26290,3578736966,3578736996,30
0,1093,26291,3578736966,3578736998,32
0,1093,26292,3578736966,3578737000,34
0,1093,26293,3578736966,3578737000,34
0,1093,26294,3578736966,3578737002,36
0,1093,26295,3578736966,3578737002,36
0,1093,26296,3578736966,3578737005,39
0,1093,26297,3578736966,3578737005,39
0,1093,26298,3578736966,3578737005,39
0,1093,26299,3578736966,3578737006,40
0,1093,26300,3578736966,3578737006,40
0,1093,26301,3578736966,3578737006,40
0,1093,26302,3578736966,3578737008,42
0,1093,26303,3578736966,3578737009,43
0,1093,26304,3578736966,3578737009,43
0,1093,26305,3578736966,3578737011,45
0,1093,26306,3578736966,3578737011,45
0,1093,26307,3578736966,3578737012,46
0,1093,26308,3578736966,3578737013,47
0,1093,26309,3578736966,3578737014,48
0,1093,26310,3578736966,3578737014,48
0,1093,26311,3578736966,3578737015,49
0,1093,26312,3578736966,3578737016,50
0,1094,26313,3578737028,3578737028,0
0,1094,26314,3578737028,3578737028,0
0,1094,26315,3578737028,3578737028,0
0,1094,26316,3578737028,3578737028,0
0,1094,26317,3578737028,3578737028,0
0,1094,26318,3578737028,3578737028,0
0,1094,26319,3578737028,3578737028,0
0,1094,26320,3578737028,3578737028,0
0,1094,26321,3578737028,3578737028,0
0,1094,26322,3578737028,3578737028,0
0,1094,26323,3578737028,3578737028,0
0,1094,26324,3578737028,3578737028,0
0,1094,26325,3578737028,3578737029,1
0,1094,26326,3578737028,3578737030,2
0,1094,26327,3578737028,3578737031,3
0,1094,26328,3578737028,3578737033,5
0,1094,26329,3578737028,3578737034,6
0,1094,26330,3578737028,3578737035,7
0,1094,26331,3578737028,3578737037,9
0,1094,26332,3578737028,3578737039,11
0,1094,26333,3578737028,3578737039,11
0,1094,26334,3578737028,3578737040,12
0,1094,26335,3578737028,3578737040,12
0,1094,26336,3578737028,3578737041,13
0,1094,26337,3578737028,3578737042,14
0,1094,26338,3578737028,3578737044,16
0,1094,26339,3578737028,3578737044,16
0,1094,26340,3578737028,3578737045,17
0,1094,26341,3578737028,3578737046,18
0,1094,26342,3578737028,3578737046,18
0,1094,26343,3578737028,3578737047,19
0,1094,26344,3578737028,3578737049,21
0,1094,26345,3578737028,3578737049,21
0,1094,26346,3578737028,3578737050,22
0,1094,26347,3578737028,3578737052,24
0,1094,26348,3578737028,3578737056,28
0,1094,26349,3578737028,3578737057,29
0,1094,26350,3578737028,3578737058,30
0,1094,26351,3578737028,3578737058,30
0,1094,26352,3578737028,3578737059,31
0,1094,26353,3578737028,3578737060,32
0,1094,26354,3578737028,3578737061,33
0,1094,26355,3578737028,3578737062,34
0,1094,26356,3578737028,3578737063,35
0,1094,26357,3578737028,3578737063,35
0,1094,26358,3578737028,3578737065,37
0,1094,26359,3578737028,3578737066,38
0,1094,26360,3578737028,3578737067,39
0,1094,26361,3578737028,3578737068,40
0,1094,26362,3578737028,3578737068,40
0,1094,26363,3578737028,3578737073,45
0,1094,26364,3578737028,3578737075,47
0,1094,26365,3578737028,3578737075,47
0,1094,26366,3578737028,3578737075,47
0,1094,26367,3578737028,3578737077,49
0,1094,26368,3578737028,3578737077,49
0,1094,26369,3578737028,3578737078,50
0,1095,26370,3578737089,3578737089,0
0,1095,26371,3578737089,3578737089,0
0,1095,26372,3578737089,3578737089,0
0,1095,26373,3578737089,3578737089,0
0,1095,26374,3578737089,3578737089,0
0,1095,26375,3578737089,3578737089,0
0,1095,26376,3578737089,3578737089,0
0,1095,26377,3578737089,3578737089,0
0,1095,26378,3578737089,3578737089,0
0,1095,26379,3578737089,3578737089,0
0,1095,26380,3578737089,3578737089,0
0,1095,26381,3578737089,3578737089,0
0,1095,26382,3578737089,3578737089,0
0,1095,26383,3578737089,3578737089,0
0,1095,26384,3578737089,3578737090,1
0,1095,26385,3578737089,3578737091,2
0,1095,26386,3578737089,3578737092,3
0,1095,26387,3578737089,3578737093,4
0,1095,26388,3578737089,3578737094,5
0,1095,26389,3578737089,3578737094,5
0,1095,26390,3578737089,3578737096,7
0,1095,26391,3578737089,3578737096,7
0,1095,26392,3578737089,3578737099,10
0,1095,26393,3578737089,3578737101,12
0,1095,26394,3578737089,3578737102,13
0,1095,26395,3578737089,3578737102,13
0,1095,26396,3578737089,3578737103,14
0,1095,26397,3578737089,3578737104,15
0,1095,26398,3578737089,3578737105,16
0,1095,26399,3578737089,3578737106,17
0,1095,26400,3578737089,3578737107,18
0,1095,26401,3578737089,3578737107,18
0,1095,26402,3578737089,3578737107,18
0,1095,26403,3578737089,3578737107,18
0,1095,26404,3578737089,3578737108,19
0,1095,26405,3578737089,3578737109,20
0,1095,26406,3578737089,3578737109,20
0,1095,26407,3578737089,3578737109,20
0,1095,26408,3578737089,3578737110,21
0,1095,26409,3578737089,3578737113,24
0,1095,26410,3578737089,3578737114,25
0,1095,26411,3578737089,3578737115,26
0,1095,26412,3578737089,3578737116,27
0,1095,26413,3578737089,3578737116,27
0,1095,26414,3578737089,3578737116,27
0,1095,26415,3578737089,3578737116,27
0,1095,26416,3578737089,3578737117,28
0,1095,26417,3578737089,3578737117,28
0,1095,26418,3578737089,3578737118,29
0,1095,26419,3578737089,3578737119,30
0,1095,26420,3578737089,3578737120,31
0,1095,26421,3578737089,3578737120,31
0,1095,26422,3578737089,3578737123,34
0,1095,26423,3578737089,3578737123,34
0,1095,26424,3578737089,3578737124,35
0,1095,26425,3578737089,3578737126,37
0,1095,26426,3578737089,3578737126,37
0,1095,26427,3578737089,3578737126,37
0,1095,26428,3578737089,3578737129,40
0,1095,26429,3578737089,3578737130,41
0,1095,26430,3578737089,3578737130,41
0,1095,26431,3578737089,3578737130,41
0,1095,26432,3578737089,3578737131,42
0,1095,26433,3578737089,3578737131,42
0,1095,26434,3578737089,3578737132,43
0,1095,26435,3578737089,3578737134,45
0,1095,26436,3578737089,3578737137,48
0,1096,26437,3578737152,3578737152,0
0,1096,26438,3578737152,3578737152,0
0,1096,26439,3578737152,3578737152,0
0,1096,26440,3578737152,3578737152,0
0,1096,26441,3578737152,3578737152,0
0,1096,26442,3578737152,3578737152,0
0,1096,26443,3578737152,3578737152,0
0,1096,26444,3578737152,3578737152,0
0,1096,26445,3578737152,3578737152,0
0,1096,26446,3578737152,3578737152,0
0,1096,26447,3578737152,3578737152,0
0,1096,26448,3578737152,3578737152,0
0,1096,26449,3578737152,3578737152,0
0,1096,26450,3578737152,3578737152,0
0,1096,26451,3578737152,3578737152,0
0,1096,26452,3578737152,3578737152,0
0,1096,26453,3578737152,3578737153,1
0,1096,26454,3578737152,3578737153,1
0,1096,26455,3578737152,3578737153,1
0,1096,26456,3578737152,3578737153,1
0,1096,26457,3578737152,3578737157,5
0,1096,26458,3578737152,3578737158,6
0,1096,26459,3578737152,3578737158,6
0,1096,26460,3578737152,3578737158,6
0,1096,26461,3578737152,3578737159,7
0,1096,26462,3578737152,3578737159,7
0,1096,26463,3578737152,3578737161,9
0,1096,26464,3578737152,3578737161,9
0,1096,26465,3578737152,3578737162,10
0,1096,26466,3578737152,3578737163,11
0,1096,26467,3578737152,3578737165,13
0,1096,26468,3578737152,3578737165,13
0,1096,26469,3578737152,3578737166,14
0,1096,26470,3578737152,3578737166,14
0,1096,26471,3578737152,3578737166,14
0,1096,26472,3578737152,3578737167,15
0,1096,26473,3578737152,3578737168,16
0,1096,26474,3578737152,3578737169,17
0,1096,26475,3578737152,3578737170,18
0,1096,26476,3578737152,3578737173,21
0,1096,26477,3578737152,3578737174,22
0,1096,26478,3578737152,3578737174,22
0,1096,26479,3578737152,3578737174,22
0,1096,26480,3578737152,3578737174,22
0,1096,26481,3578737152,3578737175,23
0,1096,26482,3578737152,3578737178,26
0,1096,26483,3578737152,3578737178,26
0,1096,26484,3578737152,3578737179,27
0,1096,26485,3578737152,3578737180,28
0,1096,26486,3578737152,3578737181,29
0,1096,26487,3578737152,3578737181,29
0,1096,26488,3578737152,3578737182,30
0,1096,26489,3578737152,3578737187,35
0,1096,26490,3578737152,3578737188,36
0,1096,26491,3578737152,3578737189,37
0,1096,26492,3578737152,3578737189,37
0,1096,26493,3578737152,3578737190,38
0,1096,26494,3578737152,3578737190,38
0,1096,26495,3578737152,3578737191,39
0,1096,26496,3578737152,3578737192,40
0,1096,26497,3578737152,3578737192,40
0,1096,26498,3578737152,3578737192,40
0,1096,26499,3578737152,3578737193,41
0,1096,26500,3578737152,3578737193,41
0,1096,26501,3578737152,3578737194,42
0,1096,26502,3578737152,3578737195,43
0,1096,26503,3578737152,3578737195,43
0,1096,26504,3578737152,3578737200,48
0,1096,26505,3578737152,3578737200,48
0,1096,26506,3578737152,3578737202,50
0,1097,26507,3578737212,3578737212,0
0,1097,26508,3578737212,3578737212,0
0,1097,26509,3578737212,3578737212,0
0,1097,26510,3578737212,3578737212,0
0,1097,26511,3578737212,3578737212,0
0,1097,26512,3578737212,3578737212,0
0,1097,26513,3578737212,3578737212,0
0,1097,26514,3578737212,3578737212,0
0,1097,26515,3578737212,3578737212,0
0,1097,26516,3578737212,3578737212,0
0,1097,26517,3578737212,3578737213,1
0,1097,26518,3578737212,3578737214,2
0,1097,26519,3578737212,3578737214,2
0,1097,26520,3578737212,3578737216,4
0,1097,26521,3578737212,3578737216,4
0,1097,26522,3578737212,3578737216,4
0,1097,26523,3578737212,3578737216,4
0,1097,26524,3578737212,3578737216,4
0,1097,26525,3578737212,3578737218,6
0,1097,26526,3578737212,3578737219,7
0,1097,26527,3578737212,3578737219,7
0,1097,26528,3578737212,3578737220,8
0,1097,26529,3578737212,3578737220,8
0,1097,26530,3578737212,3578737223,11
0,1097,26531,3578737212,3578737225,13
0,1097,26532,3578737212,3578737225,13
0,1097,26533,3578737212,3578737227,15
0,1097,26534,3578737212,3578737229,17
0,1097,26535,3578737212,3578737230,18
0,1097,26536,3578737212,3578737231,19
0,1097,26537,3578737212,3578737231,19
0,1097,26538,3578737212,3578737233,21
0,1097,26539,3578737212,3578737233,21
0,1097,26540,3578737212,3578737234,22
0,1097,26541,3578737212,3578737236,24
0,1097,26542,3578737212,3578737237,25
0,1097,26543,3578737212,3578737239,27
0,1097,26544,3578737212,3578737240,28
0,1097,26545,3578737212,3578737240,28
0,1097,26546,3578737212,3578737241,29
0,1097,26547,3578737212,3578737242,30
0,1097,26548,3578737212,3578737242,30
0,1097,26549,3578737212,3578737244,32
0,1097,26550,3578737212,3578737245,33
0,1097,26551,3578737212,3578737246,34
0,1097,26552,3578737212,3578737247,35
0,1097,26553,3578737212,3578737248,36
0,1097,26554,3578737212,3578737249,37
0,1097,26555,3578737212,3578737249,37
0,1097,26556,3578737212,3578737250,38
0,1097,26557,3578737212,3578737250,38
0,1097,26558,3578737212,3578737253,41
0,1097,26559,3578737212,3578737256,44
0,1097,26560,3578737212,3578737256,44
0,1097,26561,3578737212,3578737259,47
0,1097,26562,3578737212,3578737260,48
0,1097,26563,3578737212,3578737260,48
0,1097,26564,3578737212,3578737262,50
0,1098,26565,3578737272,3578737272,0
0,1098,26566,3578737272,3578737272,0
0,1098,26567,3578737272,3578737272,0
0,1098,26568,3578737272,3578737272,0
0,1098,26569,3578737272,3578737272,0
0,1098,26570,3578737272,3578737272,0
0,1098,26571,3578737272,3578737272,0
0,1098,26572,3578737272,3578737272,0
0,1098,26573,3578737272,3578737272,0
0,1098,26574,3578737272,3578737273,1
0,1098,26575,3578737272,3578737275,3
0,1098,26576,3578737272,3578737275,3
0,1098,26577,3578737272,3578737277,5
0,1098,26578,3578737272,3578737277,5
0,1098,26579,3578737272,3578737278,6
0,1098,26580,3578737272,3578737279,7
0,1098,26581,3578737272,3578737279,7
0,1098,26582,3578737272,3578737280,8
0,1098,26583,3578737272,3578737282,10
0,1098,26584,3578737272,3578737282,10
0,1098,26585,3578737272,3578737282,10
0,1098,26586,3578737272,3578737284,12
0,1098,26587,3578737272,3578737284,12
0,1098,26588,3578737272,3578737285,13
0,1098,26589,3578737272,3578737287,15
0,1098,26590,3578737272,3578737288,16
0,1098,26591,3578737272,3578737288,16
0,1098,26592,3578737272,3578737289,17
0,1098,26593,3578737272,3578737291,19
0,1098,26594,3578737272,3578737291,19
0,1098,26595,3578737272,3578737292,20
0,1098,26596,3578737272,3578737293,21
0,1098,26597,3578737272,3578737294,22
0,1098,26598,3578737272,3578737295,23
0,1098,26599,3578737272,3578737295,23
0,1098,26600,3578737272,3578737296,24
0,1098,26601,3578737272,3578737297,25
0,1098,26602,3578737272,3578737299,27
0,1098,26603,3578737272,3578737301,29
0,1098,26604,3578737272,3578737302,30
0,1098,26605,3578737272,3578737302,30
0,1098,26606,3578737272,3578737302,30
0,1098,26607,3578737272,3578737305,33
0,1098,26608,3578737272,3578737305,33
0,1098,26609,3578737272,3578737306,34
0,1098,26610,3578737272,3578737306,34
0,1098,26611,3578737272,3578737307,35
0,1098,26612,3578737272,3578737308,36
0,1098,26613,3578737272,3578737308,36
0,1098,26614,3578737272,3578737308,36
0,1098,26615,3578737272,3578737308,36
0,1098,26616,3578737272,3578737309,37
0,1098,26617,3578737272,3578737309,37
0,1098,26618,3578737272,3578737309,37
0,1098,26619,3578737272,3578737311,39
0,1098,26620,3578737272,3578737312,40
0,1098,26621,3578737272,3578737314,42
0,1098,26622,3578737272,3578737315,43
0,1098,26623,3578737272,3578737316,44
0,1098,26624,3578737272,3578737316,44
0,1098,26625,3578737272,3578737317,45
0,1098,26626,3578737272,3578737317,45
0,1098,26627,3578737272,3578737317,45
0,1098,26628,3578737272,3578737319,47
0,1098,26629,3578737272,3578737320,48
0,1098,26630,3578737272,3578737320,48
0,1099,26631,3578737333,3578737333,0
0,1099,26632,3578737333,3578737333,0
0,1099,26633,3578737333,3578737333,0
0,1099,26634,3578737333,3578737333,0
0,1099,26635,3578737333,3578737333,0
0,1099,26636,3578737333,3578737333,0
0,1099,26637,3578737333,3578737333,0
0,1099,26638,3578737333,3578737333,0
0,1099,26639,3578737333,3578737333,0
0,1099,26640,3578737333,3578737333,0
0,1099,26641,3578737333,3578737333,0
0,1099,26642,3578737333,3578737333,0
0,1099,26643,3578737333,3578737333,0
0,1099,26644,3578737333,3578737333,0
0,1099,26645,3578737333,3578737334,1
0,1099,26646,3578737333,3578737337,4
0,1099,26647,3578737333,3578737340,7
0,1099,26648,3578737333,3578737340,7
0,1099,26649,3578737333,3578737341,8
0,1099,26650,3578737333,3578737342,9
0,1099,26651,3578737333,3578737342,9
0,1099,26652,3578737333,3578737343,10
0,1099,26653,3578737333,3578737343,10
0,1099,26654,3578737333,3578737343,10
0,1099,26655,3578737333,3578737343,10
0,1099,26656,3578737333,3578737344,11
0,1099,26657,3578737333,3578737344,11
0,1099,26658,3578737333,3578737345,12
0,1099,26659,3578737333,3578737346,13
0,1099,26660,3578737333,3578737346,13
0,1099,26661,3578737333,3578737348,15
0,1099,26662,3578737333,3578737351,18
0,1099,26663,3578737333,3578737353,20
0,1099,26664,3578737333,3578737353,20
0,1099,26665,3578737333,3578737354,21
0,1099,26666,3578737333,3578737354,21
0,1099,26667,3578737333,3578737355,22
0,1099,26668,3578737333,3578737356,23
0,1099,26669,3578737333,3578737357,24
0,1099,26670,3578737333,3578737358,25
0,1099,26671,3578737333,3578737359,26
0,1099,26672,3578737333,3578737359,26
0,1099,26673,3578737333,3578737360,27
0,1099,26674,3578737333,3578737361,28
0,1099,26675,3578737333,3578737361,28
0,1099,26676,3578737333,3578737361,28
0,1099,26677,3578737333,3578737362,29
0,1099,26678,3578737333,3578737363,30
0,1099,26679,3578737333,3578737364,31
0,1099,26680,3578737333,3578737364,31
0,1099,26681,3578737333,3578737365,32
0,1099,26682,3578737333,3578737365,32
0,1099,26683,3578737333,3578737367,34
0,1099,26684,3578737333,3578737367,34
0,1099,26685,3578737333,3578737367,34
0,1099,26686,3578737333,3578737370,37
0,1099,26687,3578737333,3578737372,39
0,1099,26688,3578737333,3578737373,40
0,1099,26689,3578737333,3578737374,41
0,1099,26690,3578737333,3578737374,41
0,1099,26691,3578737333,3578737374,41
0,1099,26692,3578737333,3578737374,41
0,1099,26693,3578737333,3578737375,42
0,1099,26694,3578737333,3578737377,44
0,1099,26695,3578737333,3578737378,45
0,1099,26696,3578737333,3578737379,46
0,1099,26697,3578737333,3578737379,46
0,1099,26698,3578737333,3578737380,47
0,1099,26699,3578737333,3578737381,48
0,1099,26700,3578737333,3578737382,49
0,1100,26701,3578737396,3578737396,0
0,1100,26702,3578737396,3578737396,0
0,1100,26703,3578737396,3578737396,0
0,1100,26704,3578737396,3578737396,0
0,1100,26705,3578737396,3578737396,0
0,1100,26706,3578737396,3578737396,0
0,1100,26707,3578737396,3578737396,0
0,1100,26708,3578737396,3578737396,0
0,1100,26709,3578737396,3578737396,0
0,1100,26710,3578737396,3578737396,0
0,1100,26711,3578737396,3578737396,0
0,1100,26712,3578737396,3578737396,0
0,1100,26713,3578737396,3578737396,0
0,1100,26714,3578737396,3578737396,0
0,1100,26715,3578737396,3578737396,0
0,1100,26716,3578737396,3578737396,0
0,1100,26717,3578737396,3578737396,0
0,1100,26718,3578737396,3578737401,5
0,1100,26719,3578737396,3578737402,6
0,1100,26720,3578737396,3578737402,6
0,1100,26721,3578737396,3578737403,7
0,1100,26722,3578737396,3578737405,9
0,1100,26723,3578737396,3578737405,9
0,1100,26724,3578737396,3578737405,9
0,1100,26725,3578737396,3578737405,9
0,1100,26726,3578737396,3578737406,10
0,1100,26727,3578737396,3578737406,10
0,1100,26728,3578737396,3578737406,10
0,1100,26729,3578737396,3578737407,11
0,1100,26730,3578737396,3578737409,13
0,1100,26731,3578737396,3578737411,15
0,1100,26732,3578737396,3578737411,15
0,1100,26733,3578737396,3578737414,18
0,1100,26734,3578737396,3578737414,18
0,1100,26735,3578737396,3578737414,18
0,1100,26736,3578737396,3578737415,19
0,1100,26737,3578737396,3578737416,20
0,1100,26738,3578737396,3578737416,20
0,1100,26739,3578737396,3578737416,20
0,1100,26740,3578737396,3578737417,21
0,1100,26741,3578737396,3578737419,23
0,1100,26742,3578737396,3578737419,23
0,1100,26743,3578737396,3578737419,23
0,1100,26744,3578737396,3578737420,24
0,1100,26745,3578737396,3578737423,27
0,1100,26746,3578737396,3578737423,27
0,1100,26747,3578737396,3578737424,28
0,1100,26748,3578737396,3578737425,29
0,1100,26749,3578737396,3578737429,33
0,1100,26750,3578737396,3578737430,34
0,1100,26751,3578737396,3578737431,35
0,1100,26752,3578737396,3578737432,36
0,1100,26753,3578737396,3578737433,37
0,1100,26754,3578737396,3578737433,37
0,1100,26755,3578737396,3578737433,37
0,1100,26756,3578737396,3578737434,38
0,1100,26757,3578737396,3578737436,40
0,1100,26758,3578737396,3578737436,40
0,1100,26759,3578737396,3578737440,44
0,1100,26760,3578737396,3578737440,44
0,1100,26761,3578737396,3578737440,44
0,1100,26762,3578737396,3578737441,45
0,1100,26763,3578737396,3578737441,45
0,1100,26764,3578737396,3578737442,46
0,1100,26765,3578737396,3578737444,48
0,1100,26766,3578737396,3578737444,48
0,1100,26767,3578737396,3578737445,49
0,1100,26768,3578737396,3578737446,50
0,1101,26769,3578737456,3578737456,0
0,1101,26770,3578737456,3578737456,0
0,1101,26771,3578737456,3578737456,0
0,1101,26772,3578737456,3578737456,0
0,1101,26773,3578737456,3578737456,0
0,1101,26774,3578737456,3578737456,0
0,1101,26775,3578737456,3578737456,0
0,1101,26776,3578737456,3578737457,1
0,1101,26777,3578737456,3578737460,4
0,1101,26778,3578737456,3578737460,4
0,1101,26779,3578737456,3578737460,4
0,1101,26780,3578737456,3578737461,5
0,1101,26781,3578737456,3578737462,6
0,1101,26782,3578737456,3578737463,7
0,1101,26783,3578737456,3578737464,8
0,1101,26784,3578737456,3578737465,9
0,1101,26785,3578737456,3578737468,12
0,1101,26786,3578737456,3578737468,12
0,1101,26787,3578737456,3578737469,13
0,1101,26788,3578737456,3578737473,17
0,1101,26789,3578737456,3578737475,19
0,1101,26790,3578737456,3578737476,20
0,1101,26791,3578737456,3578737477,21
0,1101,26792,3578737456,3578737477,21
0,1101,26793,3578737456,3578737478,22
0,1101,26794,3578737456,3578737478,22
0,1101,26795,3578737456,3578737479,23
0,1101,26796,3578737456,3578737480,24
0,1101,26797,3578737456,3578737480,24
0,1101,26798,3578737456,3578737482,26
0,1101,26799,3578737456,3578737482,26
0,1101,26800,3578737456,3578737482,26
0,1101,26801,3578737456,3578737483,27
0,1101,26802,3578737456,3578737484,28
0,1101,26803,3578737456,3578737484,28
0,1101,26804,3578737456,3578737484,28
0,1101,26805,3578737456,3578737485,29
0,1101,26806,3578737456,3578737485,29
0,1101,26807,3578737456,3578737487,31
0,1101,26808,3578737456,3578737488,32
0,1101,26809,3578737456,3578737489,33
0,1101,26810,3578737456,3578737489,33
0,1101,26811,3578737456,3578737491,35
0,1101,26812,3578737456,3578737491,35
0,1101,26813,3578737456,3578737493,37
0,1101,26814,3578737456,3578737493,37
0,1101,26815,3578737456,3578737494,38
0,1101,26816,3578737456,3578737495,39
0,1101,26817,3578737456,3578737496,40
0,1101,26818,3578737456,3578737497,41
0,1101,26819,3578737456,3578737499,43
0,1101,26820,3578737456,3578737502,46
0,1101,26821,3578737456,3578737502,46
0,1101,26822,3578737456,3578737502,46
0,1101,26823,3578737456,3578737502,46
0,1101,26824,3578737456,3578737502,46
0,1101,26825,3578737456,3578737505,49
0,1101,26826,3578737456,3578737506,50
0,1102,26827,3578737515,3578737515,0
0,1102,26828,3578737515,3578737515,0
0,1102,26829,3578737515,3578737515,0
0,1102,26830,3578737515,3578737515,0
0,1102,26831,3578737515,3578737515,0
0,1102,26832,3578737515,3578737515,0
0,1102,26833,3578737515,3578737515,0
0,1102,26834,3578737515,3578737515,0
0,1102,26835,3578737515,3578737515,0
0,1102,26836,3578737515,3578737515,0
0,1102,26837,3578737515,3578737515,0
0,1102,26838,3578737515,3578737515,0
0,1102,26839,3578737515,3578737515,0
0,1102,26840,3578737515,3578737515,0
0,1102,26841,3578737515,3578737515,0
0,1102,26842,3578737515,3578737516,1
0,1102,26843,3578737515,3578737516,1
0,1102,26844,3578737515,3578737518,3
0,1102,26845,3578737515,3578737519,4
0,1102,26846,3578737515,3578737520,5
0,1102,26847,3578737515,3578737520,5
0,1102,26848,3578737515,3578737522,7
0,1102,26849,3578737515,3578737522,7
0,1102,26850,3578737515,3578737525,10
0,1102,26851,3578737515,3578737526,11
0,1102,26852,3578737515,3578737527,12
0,1102,26853,3578737515,3578737528,13
0,1102,26854,3578737515,3578737529,14
0,1102,26855,3578737515,3578737530,15
0,1102,26856,3578737515,3578737530,15
0,1102,26857,3578737515,3578737530,15
0,1102,26858,3578737515,3578737530,15
0,1102,26859,3578737515,3578737532,17
0,1102,26860,3578737515,3578737533,18
0,1102,26861,3578737515,3578737533,18
0,1102,26862,3578737515,3578737536,21
0,1102,26863,3578737515,3578737538,23
0,1102,26864,3578737515,3578737539,24
0,1102,26865,3578737515,3578737539,24
0,1102,26866,3578737515,3578737540,25
0,1102,26867,3578737515,3578737541,26
0,1102,26868,3578737515,3578737542,27
0,1102,26869,3578737515,3578737542,27
0,1102,26870,3578737515,3578737542,27
0,1102,26871,3578737515,3578737542,27
0,1102,26872,3578737515,3578737543,28
0,1102,26873,3578737515,3578737543,28
0,1102,26874,3578737515,3578737544,29
0,1102,26875,3578737515,3578737544,29
0,1102,26876,3578737515,3578737545,30
0,1102,26877,3578737515,3578737545,30
0,1102,26878,3578737515,3578737547,32
0,1102,26879,3578737515,3578737548,33
0,1102,26880,3578737515,3578737550,35
0,1102,26881,3578737515,3578737552,37
0,1102,26882,3578737515,3578737556,41
0,1102,26883,3578737515,3578737557,42
0,1102,26884,3578737515,3578737557,42
0,1102,26885,3578737515,3578737557,42
0,1102,26886,3578737515,3578737557,42
0,1102,26887,3578737515,3578737557,42
0,1102,26888,3578737515,3578737557,42
0,1102,26889,3578737515,3578737558,43
0,1102,26890,3578737515,3578737558,43
0,1102,26891,3578737515,3578737559,44
0,1102,26892,3578737515,3578737559,44
0,1102,26893,3578737515,3578737560,45
0,1102,26894,3578737515,3578737560,45
0,1102,26895,3578737515,3578737561,46
0,1102,26896,3578737515,3578737562,47
0,1102,26897,3578737515,3578737563,48
0,1102,26898,3578737515,3578737563,48
0,1102,26899,3578737515,3578737565,50
0,1103,26900,3578737574,3578737574,0
0,1103,26901,3578737574,3578737574,0
0,1103,26902,3578737574,3578737574,0
0,1103,26903,3578737574,3578737574,0
0,1103,26904,3578737574,3578737574,0
0,1103,26905,3578737574,3578737574,0
0,1103,26906,3578737574,3578737574,0
0,1103,26907,3578737574,3578737574,0
0,1103,26908,3578737574,3578737574,0
0,1103,26909,3578737574,3578737574,0
0,1103,26910,3578737574,3578737574,0
0,1103,26911,3578737574,3578737575,1
0,1103,26912,3578737574,3578737576,2
0,1103,26913,3578737574,3578737577,3
0,1103,26914,3578737574,3578737578,4
0,1103,26915,3578737574,3578737579,5
0,1103,26916,3578737574,3578737580,6
0,1103,26917,3578737574,3578737581,7
0,1103,26918,3578737574,3578737581,7
0,1103,26919,3578737574,3578737582,8
0,1103,26920,3578737574,3578737584,10
0,1103,26921,3578737574,3578737586,12
0,1103,26922,3578737574,3578737587,13
0,1103,26923,3578737574,3578737588,14
0,1103,26924,3578737574,3578737588,14
0,1103,26925,3578737574,3578737588,14
0,1103,26926,3578737574,3578737589,15
0,1103,26927,3578737574,3578737589,15
0,1103,26928,3578737574,3578737590,16
0,1103,26929,3578737574,3578737590,16
0,1103,26930,3578737574,3578737591,17
0,1103,26931,3578737574,3578737591,17
0,1103,26932,3578737574,3578737592,18
0,1103,26933,3578737574,3578737593,19
0,1103,26934,3578737574,3578737593,19
0,1103,26935,3578737574,3578737594,20
0,1103,26936,3578737574,3578737595,21
0,1103,26937,3578737574,3578737600,26
0,1103,26938,3578737574,3578737601,27
0,1103,26939,3578737574,3578737601,27
0,1103,26940,3578737574,3578737602,28
0,1103,26941,3578737574,3578737604,30
0,1103,26942,3578737574,3578737604,30
0,1103,26943,3578737574,3578737604,30
0,1103,26944,3578737574,3578737605,31
0,1103,26945,3578737574,3578737606,32
0,1103,26946,3578737574,3578737606,32
0,1103,26947,3578737574,3578737607,33
0,1103,26948,3578737574,3578737608,34
0,1103,26949,3578737574,3578737610,36
0,1103,26950,3578737574,3578737611,37
0,1103,26951,3578737574,3578737612,38
0,1103,26952,3578737574,3578737612,38
0,1103,26953,3578737574,3578737613,39
0,1103,26954,3578737574,3578737614,40
0,1103,26955,3578737574,3578737614,40
0,1103,26956,3578737574,3578737615,41
0,1103,26957,3578737574,3578737615,41
0,1103,26958,3578737574,3578737618,44
0,1103,26959,3578737574,3578737618,44
0,1103,26960,3578737574,3578737619,45
0,1103,26961,3578737574,3578737619,45
0,1103,26962,3578737574,3578737619,45
0,1103,26963,3578737574,3578737622,48
0,1103,26964,3578737574,3578737623,49
0,1103,26965,3578737574,3578737623,49
0,1103,26966,3578737574,3578737624,50
0,1104,26967,3578737636,3578737636,0
0,1104,26968,3578737636,3578737636,0
0,1104,26969,3578737636,3578737636,0
0,1104,26970,3578737636,3578737636,0
0,1104,26971,3578737636,3578737636,0
0,1104,26972,3578737636,3578737636,0
0,1104,26973,3578737636,3578737636,0
0,1104,26974,3578737636,3578737636,0
0,1104,26975,3578737636,3578737636,0
0,1104,26976,3578737636,3578737636,0
0,1104,26977,3578737636,3578737636,0
0,1104,26978,3578737636,3578737637,1
0,1104,26979,3578737636,3578737639,3
0,1104,26980,3578737636,3578737639,3
0,1104,26981,3578737636,3578737640,4
0,1104,26982,3578737636,3578737641,5
0,1104,26983,3578737636,3578737641,5
0,1104,26984,3578737636,3578737642,6
0,1104,26985,3578737636,3578737643,7
0,1104,26986,3578737636,3578737643,7
0,1104,26987,3578737636,3578737643,7
0,1104,26988,3578737636,3578737645,9
0,1104,26989,3578737636,3578737645,9
0,1104,26990,3578737636,3578737646,10
0,1104,26991,3578737636,3578737646,10
0,1104,26992,3578737636,3578737648,12
0,1104,26993,3578737636,3578737649,13
0,1104,26994,3578737636,3578737650,14
0,1104,26995,3578737636,3578737654,18
0,1104,26996,3578737636,3578737656,20
0,1104,26997,3578737636,3578737656,20
0,1104,26998,3578737636,3578737656,20
0,1104,26999,3578737636,3578737659,23
0,1104,27000,3578737636,3578737659,23
0,1104,27001,3578737636,3578737659,23
0,1104,27002,3578737636,3578737660,24
0,1104,27003,3578737636,3578737662,26
0,1104,27004,3578737636,3578737662,26
0,1104,27005,3578737636,3578737664,28
0,1104,27006,3578737636,3578737665,29
0,1104,27007,3578737636,3578737666,30
0,1104,27008,3578737636,3578737666,30
0,1104,27009,3578737636,3578737667,31
0,1104,27010,3578737636,3578737667,31
0,1104,27011,3578737636,3578737668,32
0,1104,27012,3578737636,3578737673,37
0,1104,27013,3578737636,3578737675,39
0,1104,27014,3578737636,3578737676,40
0,1104,27015,3578737636,3578737677,41
0,1104,27016,3578737636,3578737678,42
0,1104,27017,3578737636,3578737678,42
0,1104,27018,3578737636,3578737679,43
0,1104,27019,3578737636,3578737680,44
0,1104,27020,3578737636,3578737681,45
0,1104,27021,3578737636,3578737682,46
0,1104,27022,3578737636,3578737682,46
0,1104,27023,3578737636,3578737683,47
0,1104,27024,3578737636,3578737684,48
0,1104,27025,3578737636,3578737684,48
0,1104,27026,3578737636,3578737684,48
0,1104,27027,3578737636,3578737684,48
0,1105,27028,3578737698,3578737698,0
0,1105,27029,3578737698,3578737698,0
0,1105,27030,3578737698,3578737698,0
0,1105,27031,3578737698,3578737698,0
0,1105,27032,3578737698,3578737698,0
0,1105,27033,3578737698,3578737698,0
0,1105,27034,3578737698,3578737698,0
0,1105,27035,3578737698,3578737698,0
0,1105,27036,3578737698,3578737698,0
0,1105,27037,3578737698,3578737698,0
0,1105,27038,3578737698,3578737698,0
0,1105,27039,3578737698,3578737698,0
0,1105,27040,3578737698,3578737698,0
0,1105,27041,3578737698,3578737698,0
0,1105,27042,3578737698,3578737698,0
0,1105,27043,3578737698,3578737699,1
0,1105,27044,3578737698,3578737699,1
0,1105,27045,3578737698,3578737700,2
0,1105,27046,3578737698,3578737702,4
0,1105,27047,3578737698,3578737702,4
0,1105,27048,3578737698,3578737703,5
0,1105,27049,3578737698,3578737703,5
0,1105,27050,3578737698,3578737705,7
0,1105,27051,3578737698,3578737706,8
0,1105,27052,3578737698,3578737706,8
0,1105,27053,3578737698,3578737707,9
0,1105,27054,3578737698,3578737708,10
0,1105,27055,3578737698,3578737708,10
0,1105,27056,3578737698,3578737708,10
0,1105,27057,3578737698,3578737709,11
0,1105,27058,3578737698,3578737709,11
0,1105,27059,3578737698,3578737710,12
0,1105,27060,3578737698,3578737712,14
0,1105,27061,3578737698,3578737712,14
0,1105,27062,3578737698,3578737714,16
0,1105,27063,3578737698,3578737714,16
0,1105,27064,3578737698,3578737715,17
0,1105,27065,3578737698,3578737715,17
0,1105,27066,3578737698,3578737715,17
0,1105,27067,3578737698,3578737715,17
0,1105,27068,3578737698,3578737716,18
0,1105,27069,3578737698,3578737718,20
0,1105,27070,3578737698,3578737719,21
0,1105,27071,3578737698,3578737720,22
0,1105,27072,3578737698,3578737720,22
0,1105,27073,3578737698,3578737722,24
0,1105,27074,3578737698,3578737722,24
0,1105,27075,3578737698,3578737725,27
0,1105,27076,3578737698,3578737727,29
0,1105,27077,3578737698,3578737728,30
0,1105,27078,3578737698,3578737728,30
0,1105,27079,3578737698,3578737728,30
0,1105,27080,3578737698,3578737729,31
0,1105,27081,3578737698,3578737730,32
0,1105,27082,3578737698,3578737730,32
0,1105,27083,3578737698,3578737730,32
0,1105,27084,3578737698,3578737730,32
0,1105,27085,3578737698,3578737731,33
0,1105,27086,3578737698,3578737733,35
0,1105,27087,3578737698,3578737733,35
0,1105,27088,3578737698,3578737734,36
0,1105,27089,3578737698,3578737736,38
0,1105,27090,3578737698,3578737738,40
0,1105,27091,3578737698,3578737739,41
0,1105,27092,3578737698,3578737740,42
0,1105,27093,3578737698,3578737740,42
0,1105,27094,3578737698,3578737740,42
0,1105,27095,3578737698,3578737742,44
0,1105,27096,3578737698,3578737742,44
0,1105,27097,3578737698,3578737742,44
0,1105,27098,3578737698,3578737742,44
0,1105,27099,3578737698,3578737743,45
0,1105,27100,3578737698,3578737743,45
0,1105,27101,3578737698,3578737743,45
0,1105,27102,3578737698,3578737744,46
0,1105,27103,3578737698,3578737744,46
0,1105,27104,3578737698,3578737745,47
0,1105,27105,3578737698,3578737747,49
0,1105,27106,3578737698,3578737747,49
0,1105,27107,3578737698,3578737747,49
0,1106,27108,3578737759,3578737759,0
0,1106,27109,3578737759,3578737759,0
0,1106,27110,3578737759,3578737759,0
0,1106,27111,3578737759,3578737759,0
0,1106,27112,3578737759,3578737759,0
0,1106,27113,3578737759,3578737759,0
0,1106,27114,3578737759,3578737759,0
0,1106,27115,3578737759,3578737759,0
0,1106,27116,3578737759,3578737759,0
0,1106,27117,3578737759,3578737759,0
0,1106,27118,3578737759,3578737760,1
0,1106,27119,3578737759,3578737761,2
0,1106,27120,3578737759,3578737762,3
0,1106,27121,3578737759,3578737762,3
0,1106,27122,3578737759,3578737763,4
0,1106,27123,3578737759,3578737763,4
0,1106,27124,3578737759,3578737764,5
0,1106,27125,3578737759,3578737765,6
0,1106,27126,3578737759,3578737765,6
0,1106,27127,3578737759,3578737766,7
0,1106,27128,3578737759,3578737767,8
0,1106,27129,3578737759,3578737768,9
0,1106,27130,3578737759,3578737769,10
0,1106,27131,3578737759,3578737769,10
0,1106,27132,3578737759,3578737770,11
0,1106,27133,3578737759,3578737772,13
0,1106,27134,3578737759,3578737773,14
0,1106,27135,3578737759,3578737774,15
0,1106,27136,3578737759,3578737774,15
0,1106,27137,3578737759,3578737776,17
0,1106,27138,3578737759,3578737776,17
0,1106,27139,3578737759,3578737778,19
0,1106,27140,3578737759,3578737778,19
0,1106,27141,3578737759,3578737780,21
0,1106,27142,3578737759,3578737780,21
0,1106,27143,3578737759,3578737781,22
0,1106,27144,3578737759,3578737781,22
0,1106,27145,3578737759,3578737783,24
0,1106,27146,3578737759,3578737784,25
0,1106,27147,3578737759,3578737787,28
0,1106,27148,3578737759,3578737787,28
0,1106,27149,3578737759,3578737788,29
0,1106,27150,3578737759,3578737788,29
0,1106,27151,3578737759,3578737789,30
0,1106,27152,3578737759,3578737791,32
0,1106,27153,3578737759,3578737791,32
0,1106,27154,3578737759,3578737791,32
0,1106,27155,3578737759,3578737792,33
0,1106,27156,3578737759,3578737792,33
0,1106,27157,3578737759,3578737792,33
0,1106,27158,3578737759,3578737793,34
0,1106,27159,3578737759,3578737793,34
0,1106,27160,3578737759,3578737794,35
0,1106,27161,3578737759,3578737795,36
0,1106,27162,3578737759,3578737798,39
0,1106,27163,3578737759,3578737800,41
0,1106,27164,3578737759,3578737801,42
0,1106,27165,3578737759,3578737802,43
0,1106,27166,3578737759,3578737802,43
0,1106,27167,3578737759,3578737803,44
0,1106,27168,3578737759,3578737804,45
0,1106,27169,3578737759,3578737805,46
0,1106,27170,3578737759,3578737805,46
0,1106,27171,3578737759,3578737806,47
0,1106,27172,3578737759,3578737808,49
0,1106,27173,3578737759,3578737808,49
0,1106,27174,3578737759,3578737808,49
0,1107,27175,3578737821,3578737821,0
0,1107,27176,3578737821,3578737821,0
0,1107,27177,3578737821,3578737821,0
0,1107,27178,3578737821,3578737821,0
0,1107,27179,3578737821,3578737821,0
0,1107,27180,3578737821,3578737821,0
0,1107,27181,3578737821,3578737821,0
0,1107,27182,3578737821,3578737821,0
0,1107,27183,3578737821,3578737821,0
0,1107,27184,3578737821,3578737821,0
0,1107,27185,3578737821,3578737821,0
0,1107,27186,3578737821,3578737821,0
0,1107,27187,3578737821,3578737821,0
0,1107,27188,3578737821,3578737821,0
0,1107,27189,3578737821,3578737821,0
0,1107,27190,3578737821,3578737822,1
0,1107,27191,3578737821,3578737822,1
0,1107,27192,3578737821,3578737824,3
0,1107,27193,3578737821,3578737824,3
0,1107,27194,3578737821,3578737826,5
0,1107,27195,3578737821,3578737827,6
0,1107,27196,3578737821,3578737829,8
0,1107,27197,3578737821,3578737829,8
0,1107,27198,3578737821,3578737830,9
0,1107,27199,3578737821,3578737831,10
0,1107,27200,3578737821,3578737833,12
0,1107,27201,3578737821,3578737835,14
0,1107,27202,3578737821,3578737835,14
0,1107,27203,3578737821,3578737837,16
0,1107,27204,3578737821,3578737839,18
0,1107,27205,3578737821,3578737839,18
0,1107,27206,3578737821,3578737839,18
0,1107,27207,3578737821,3578737840,19
0,1107,27208,3578737821,3578737841,20
0,1107,27209,3578737821,3578737842,21
0,1107,27210,3578737821,3578737842,21
0,1107,27211,3578737821,3578737843,22
0,1107,27212,3578737821,3578737843,22
0,1107,27213,3578737821,3578737844,23
0,1107,27214,3578737821,3578737845,24
0,1107,27215,3578737821,3578737845,24
0,1107,27216,3578737821,3578737847,26
0,1107,27217,3578737821,3578737847,26
0,1107,27218,3578737821,3578737849,28
0,1107,27219,3578737821,3578737849,28
0,1107,27220,3578737821,3578737849,28
0,1107,27221,3578737821,3578737853,32
0,1107,27222,3578737821,3578737854,33
0,1107,27223,3578737821,3578737857,36
0,1107,27224,3578737821,3578737857,36
0,1107,27225,3578737821,3578737859,38
0,1107,27226,3578737821,3578737859,38
0,1107,27227,3578737821,3578737859,38
0,1107,27228,3578737821,3578737861,40
0,1107,27229,3578737821,3578737861,40
0,1107,27230,3578737821,3578737862,41
0,1107,27231,3578737821,3578737863,42
0,1107,27232,3578737821,3578737864,43
0,1107,27233,3578737821,3578737865,44
0,1107,27234,3578737821,3578737866,45
0,1107,27235,3578737821,3578737867,46
0,1107,27236,3578737821,3578737869,48
0,1108,27237,3578737882,3578737882,0
0,1108,27238,3578737882,3578737882,0
0,1108,27239,3578737882,3578737882,0
0,1108,27240,3578737882,3578737882,0
0,1108,27241,3578737882,3578737882,0
0,1108,27242,3578737882,3578737882,0
0,1108,27243,3578737882,3578737882,0
0,1108,27244,3578737882,3578737882,0
0,1108,27245,3578737882,3578737882,0
0,1108,27246,3578737882,3578737882,0
0,1108,27247,3578737882,3578737882,0
0,1108,27248,3578737882,3578737882,0
0,1108,27249,3578737882,3578737883,1
0,1108,27250,3578737882,3578737884,2
0,1108,27251,3578737882,3578737884,2
0,1108,27252,3578737882,3578737884,2
0,1108,27253,3578737882,3578737885,3
0,1108,27254,3578737882,3578737887,5
0,1108,27255,3578737882,3578737887,5
0,1108,27256,3578737882,3578737888,6
0,1108,27257,3578737882,3578737888,6
0,1108,27258,3578737882,3578737889,7
0,1108,27259,3578737882,3578737890,8
0,1108,27260,3578737882,3578737891,9
0,1108,27261,3578737882,3578737891,9
0,1108,27262,3578737882,3578737893,11
0,1108,27263,3578737882,3578737894,12
0,1108,27264,3578737882,3578737895,13
0,1108,27265,3578737882,3578737897,15
0,1108,27266,3578737882,3578737898,16
0,1108,27267,3578737882,3578737899,17
0,1108,27268,3578737882,3578737899,17
0,1108,27269,3578737882,3578737899,17
0,1108,27270,3578737882,3578737900,18
0,1108,27271,3578737882,3578737902,20
0,1108,27272,3578737882,3578737902,20
0,1108,27273,3578737882,3578737902,20
0,1108,27274,3578737882,3578737903,21
0,1108,27275,3578737882,3578737905,23
0,1108,27276,3578737882,3578737906,24
0,1108,27277,3578737882,3578737907,25
0,1108,27278,3578737882,3578737907,25
0,1108,27279,3578737882,3578737908,26
0,1108,27280,3578737882,3578737908,26
0,1108,27281,3578737882,3578737908,26
0,1108,27282,3578737882,3578737908,26
0,1108,27283,3578737882,3578737909,27
0,1108,27284,3578737882,3578737910,28
0,1108,27285,3578737882,3578737911,29
0,1108,27286,3578737882,3578737913,31
0,1108,27287,3578737882,3578737913,31
0,1108,27288,3578737882,3578737914,32
0,1108,27289,3578737882,3578737915,33
0,1108,27290,3578737882,3578737915,33
0,1108,27291,3578737882,3578737915,33
0,1108,27292,3578737882,3578737916,34
0,1108,27293,3578737882,3578737916,34
0,1108,27294,3578737882,3578737918,36
0,1108,27295,3578737882,3578737919,37
0,1108,27296,3578737882,3578737920,38
0,1108,27297,3578737882,3578737920,38
0,1108,27298,3578737882,3578737922,40
0,1108,27299,3578737882,3578737923,41
0,1108,27300,3578737882,3578737923,41
0,1108,27301,3578737882,3578737925,43
0,1108,27302,3578737882,3578737925,43
0,1108,27303,3578737882,3578737927,45
0,1108,27304,3578737882,3578737927,45
0,1108,27305,3578737882,3578737928,46
0,1108,27306,3578737882,3578737929,47
0,1108,27307,3578737882,3578737930,48
0,1108,27308,3578737882,3578737930,48
0,1108,27309,3578737882,3578737931,49
0,1108,27310,3578737882,3578737931,49
0,1108,27311,3578737882,3578737931,49
0,1108,27312,3578737882,3578737931,49
0,1109,27313,3578737942,3578737942,0
0,1109,27314,3578737942,3578737942,0
0,1109,27315,3578737942,3578737942,0
0,1109,27316,3578737942,3578737942,0
0,1109,27317,3578737942,3578737942,0
0,1109,27318,3578737942,3578737942,0
0,1109,27319,3578737942,3578737942,0
0,1109,27320,3578737942,3578737942,0
0,1109,27321,3578737942,3578737942,0
0,1109,27322,3578737942,3578737943,1
0,1109,27323,3578737942,3578737943,1
0,1109,27324,3578737942,3578737944,2
0,1109,27325,3578737942,3578737944,2
0,1109,27326,3578737942,3578737944,2
0,1109,27327,3578737942,3578737944,2
0,1109,27328,3578737942,3578737945,3
0,1109,27329,3578737942,3578737945,3
0,1109,27330,3578737942,3578737947,5
0,1109,27331,3578737942,3578737947,5
0,1109,27332,3578737942,3578737948,6
0,1109,27333,3578737942,3578737951,9
0,1109,27334,3578737942,3578737953,11
0,1109,27335,3578737942,3578737955,13
0,1109,27336,3578737942,3578737955,13
0,1109,27337,3578737942,3578737956,14
0,1109,27338,3578737942,3578737956,14
0,1109,27339,3578737942,3578737957,15
0,1109,27340,3578737942,3578737958,16
0,1109,27341,3578737942,3578737958,16
0,1109,27342,3578737942,3578737958,16
0,1109,27343,3578737942,3578737960,18
0,1109,27344,3578737942,3578737961,19
0,1109,27345,3578737942,3578737962,20
0,1109,27346,3578737942,3578737964,22
0,1109,27347,3578737942,3578737964,22
0,1109,27348,3578737942,3578737965,23
0,1109,27349,3578737942,3578737965,23
0,1109,27350,3578737942,3578737965,23
0,1109,27351,3578737942,3578737965,23
0,1109,27352,3578737942,3578737967,25
0,1109,27353,3578737942,3578737968,26
0,1109,27354,3578737942,3578737969,27
0,1109,27355,3578737942,3578737970,28
0,1109,27356,3578737942,3578737972,30
0,1109,27357,3578737942,3578737973,31
0,1109,27358,3578737942,3578737973,31
0,1109,27359,3578737942,3578737974,32
0,1109,27360,3578737942,3578737974,32
0,1109,27361,3578737942,3578737976,34
0,1109,27362,3578737942,3578737976,34
0,1109,27363,3578737942,3578737978,36
0,1109,27364,3578737942,3578737978,36
0,1109,27365,3578737942,3578737978,36
0,1109,27366,3578737942,3578737981,39
0,1109,27367,3578737942,3578737981,39
0,1109,27368,3578737942,3578737982,40
0,1109,27369,3578737942,3578737983,41
0,1109,27370,3578737942,3578737983,41
0,1109,27371,3578737942,3578737985,43
0,1109,27372,3578737942,3578737988,46
0,1109,27373,3578737942,3578737988,46
0,1109,27374,3578737942,3578737988,46
0,1109,27375,3578737942,3578737988,46
0,1109,27376,3578737942,3578737988,46
0,1109,27377,3578737942,3578737991,49
0,1109,27378,3578737942,3578737991,49
0,1110,27379,3578738003,3578738003,0
0,1110,27380,3578738003,3578738003,0
0,1110,27381,3578738003,3578738003,0
0,1110,27382,3578738003,3578738003,0
0,1110,27383,3578738003,3578738003,0
0,1110,27384,3578738003,3578738003,0
0,1110,27385,3578738003,3578738003,0
0,1110,27386,3578738003,3578738003,0
0,1110,27387,3578738003,3578738003,0
0,1110,27388,3578738003,3578738003,0
0,1110,27389,3578738003,3578738003,0
0,1110,27390,3578738003,3578738003,0
0,1110,27391,3578738003,3578738004,1
0,1110,27392,3578738003,3578738004,1
0,1110,27393,3578738003,3578738004,1
0,1110,27394,3578738003,3578738005,2
0,1110,27395,3578738003,3578738007,4
0,1110,27396,3578738003,3578738008,5
0,1110,27397,3578738003,3578738008,5
0,1110,27398,3578738003,3578738009,6
0,1110,27399,3578738003,3578738010,7
0,1110,27400,3578738003,3578738011,8
0,1110,27401,3578738003,3578738013,10
0,1110,27402,3578738003,3578738013,10
0,1110,27403,3578738003,3578738013,10
0,1110,27404,3578738003,3578738014,11
0,1110,27405,3578738003,3578738015,12
0,1110,27406,3578738003,3578738015,12
0,1110,27407,3578738003,3578738015,12
0,1110,27408,3578738003,3578738019,16
0,1110,27409,3578738003,3578738019,16
0,1110,27410,3578738003,3578738019,16
0,1110,27411,3578738003,3578738020,17
0,1110,27412,3578738003,3578738022,19
0,1110,27413,3578738003,3578738023,20
0,1110,27414,3578738003,3578738024,21
0,1110,27415,3578738003,3578738024,21
0,1110,27416,3578738003,3578738025,22
0,1110,27417,3578738003,3578738027,24
0,1110,27418,3578738003,3578738030,27
0,1110,27419,3578738003,3578738030,27
0,1110,27420,3578738003,3578738030,27
0,1110,27421,3578738003,3578738031,28
0,1110,27422,3578738003,3578738033,30
0,1110,27423,3578738003,3578738035,32
0,1110,27424,3578738003,3578738035,32
0,1110,27425,3578738003,3578738037,34
0,1110,27426,3578738003,3578738039,36
0,1110,27427,3578738003,3578738040,37
0,1110,27428,3578738003,3578738041,38
0,1110,27429,3578738003,3578738041,38
0,1110,27430,3578738003,3578738041,38
0,1110,27431,3578738003,3578738042,39
0,1110,27432,3578738003,3578738043,40
0,1110,27433,3578738003,3578738043,40
0,1110,27434,3578738003,3578738045,42
0,1110,27435,3578738003,3578738045,42
0,1110,27436,3578738003,3578738046,43
0,1110,27437,3578738003,3578738046,43
0,1110,27438,3578738003,3578738047,44
0,1110,27439,3578738003,3578738048,45
0,1110,27440,3578738003,3578738049,46
0,1110,27441,3578738003,3578738049,46
0,1110,27442,3578738003,3578738049,46
0,1110,27443,3578738003,3578738053,50
0,1111,27444,3578738062,3578738062,0
0,1111,27445,3578738062,3578738062,0
0,1111,27446,3578738062,3578738062,0
0,1111,27447,3578738062,3578738062,0
0,1111,27448,3578738062,3578738062,0
0,1111,27449,3578738062,3578738062,0
0,1111,27450,3578738062,3578738062,0
0,1111,27451,3578738062,3578738062,0
0,1111,27452,3578738062,3578738063,1
0,1111,27453,3578738062,3578738064,2
0,1111,27454,3578738062,3578738066,4
0,1111,27455,3578738062,3578738066,4
0,1111,27456,3578738062,3578738067,5
0,1111,27457,3578738062,3578738068,6
0,1111,27458,3578738062,3578738070,8
0,1111,27459,3578738062,3578738075,13
0,1111,27460,3578738062,3578738075,13
0,1111,27461,3578738062,3578738076,14
0,1111,27462,3578738062,3578738077,15
0,1111,27463,3578738062,3578738077,15
0,1111,27464,3578738062,3578738078,16
0,1111,27465,3578738062,3578738078,16
0,1111,27466,3578738062,3578738079,17
0,1111,27467,3578738062,3578738080,18
0,1111,27468,3578738062,3578738081,19
0,1111,27469,3578738062,3578738081,19
0,1111,27470,3578738062,3578738082,20
0,1111,27471,3578738062,3578738082,20
0,1111,27472,3578738062,3578738082,20
0,1111,27473,3578738062,3578738083,21
0,1111,27474,3578738062,3578738083,21
0,1111,27475,3578738062,3578738084,22
0,1111,27476,3578738062,3578738085,23
0,1111,27477,3578738062,3578738085,23
0,1111,27478,3578738062,3578738087,25
0,1111,27479,3578738062,3578738088,26
0,1111,27480,3578738062,3578738088,26
0,1111,27481,3578738062,3578738089,27
0,1111,27482,3578738062,3578738090,28
0,1111,27483,3578738062,3578738091,29
0,1111,27484,3578738062,3578738091,29
0,1111,27485,3578738062,3578738093,31
0,1111,27486,3578738062,3578738093,31
0,1111,27487,3578738062,3578738094,32
0,1111,27488,3578738062,3578738096,34
0,1111,27489,3578738062,3578738096,34
0,1111,27490,3578738062,3578738097,35
0,1111,27491,3578738062,3578738098,36
0,1111,27492,3578738062,3578738098,36
0,1111,27493,3578738062,3578738099,37
0,1111,27494,3578738062,3578738099,37
0,1111,27495,3578738062,3578738101,39
0,1111,27496,3578738062,3578738102,40
0,1111,27497,3578738062,3578738102,40
0,1111,27498,3578738062,3578738102,40
0,1111,27499,3578738062,3578738102,40
0,1111,27500,3578738062,3578738103,41
0,1111,27501,3578738062,3578738106,44
0,1111,27502,3578738062,3578738107,45
0,1111,27503,3578738062,3578738107,45
0,1111,27504,3578738062,3578738107,45
0,1111,27505,3578738062,3578738108,46
0,1111,27506,3578738062,3578738108,46
0,1111,27507,3578738062,3578738108,46
0,1111,27508,3578738062,3578738109,47
0,1111,27509,3578738062,3578738109,47
0,1111,27510,3578738062,3578738109,47
0,1111,27511,3578738062,3578738110,48
0,1111,27512,3578738062,3578738112,50
0,1112,27513,3578738127,3578738127,0
0,1112,27514,3578738127,3578738127,0
0,1112,27515,3578738127,3578738127,0
0,1112,27516,3578738127,3578738127,0
0,1112,27517,3578738127,3578738127,0
0,1112,27518,3578738127,3578738127,0
0,1112,27519,3578738127,3578738127,0
0,1112,27520,3578738127,3578738127,0
0,1112,27521,3578738127,3578738127,0
0,1112,27522,3578738127,3578738127,0
0,1112,27523,3578738127,3578738127,0
0,1112,27524,3578738127,3578738127,0
0,1112,27525,3578738127,3578738127,0
0,1112,27526,3578738127,3578738127,0
0,1112,27527,3578738127,3578738127,0
0,1112,27528,3578738127,3578738127,0
0,1112,27529,3578738127,3578738127,0
0,1112,27530,3578738127,3578738128,1
0,1112,27531,3578738127,3578738128,1
0,1112,27532,3578738127,3578738128,1
0,1112,27533,3578738127,3578738129,2
0,1112,27534,3578738127,3578738130,3
0,1112,27535,3578738127,3578738131,4
0,1112,27536,3578738127,3578738131,4
0,1112,27537,3578738127,3578738131,4
0,1112,27538,3578738127,3578738132,5
0,1112,27539,3578738127,3578738132,5
0,1112,27540,3578738127,3578738135,8
0,1112,27541,3578738127,3578738136,9
0,1112,27542,3578738127,3578738138,11
0,1112,27543,3578738127,3578738139,12
0,1112,27544,3578738127,3578738139,12
0,1112,27545,3578738127,3578738140,13
0,1112,27546,3578738127,3578738140,13
0,1112,27547,3578738127,3578738141,14
0,1112,27548,3578738127,3578738142,15
0,1112,27549,3578738127,3578738142,15
0,1112,27550,3578738127,3578738143,16
0,1112,27551,3578738127,3578738143,16
0,1112,27552,3578738127,3578738144,17
0,1112,27553,3578738127,3578738144,17
0,1112,27554,3578738127,3578738144,17
0,1112,27555,3578738127,3578738145,18
0,1112,27556,3578738127,3578738145,18
0,1112,27557,3578738127,3578738146,19
0,1112,27558,3578738127,3578738147,20
0,1112,27559,3578738127,3578738147,20
0,1112,27560,3578738127,3578738148,21
0,1112,27561,3578738127,3578738148,21
0,1112,27562,3578738127,3578738153,26
0,1112,27563,3578738127,3578738153,26
0,1112,27564,3578738127,3578738155,28
0,1112,27565,3578738127,3578738155,28
0,1112,27566,3578738127,3578738156,29
0,1112,27567,3578738127,3578738156,29
0,1112,27568,3578738127,3578738157,30
0,1112,27569,3578738127,3578738158,31
0,1112,27570,3578738127,3578738158,31
0,1112,27571,3578738127,3578738159,32
0,1112,27572,3578738127,3578738159,32
0,1112,27573,3578738127,3578738161,34
0,1112,27574,3578738127,3578738161,34
0,1112,27575,3578738127,3578738161,34
0,1112,27576,3578738127,3578738162,35
0,1112,27577,3578738127,3578738162,35
0,1112,27578,3578738127,3578738164,37
0,1112,27579,3578738127,3578738164,37
0,1112,27580,3578738127,3578738165,38
0,1112,27581,3578738127,3578738165,38
0,1112,27582,3578738127,3578738166,39
0,1112,27583,3578738127,3578738168,41
0,1112,27584,3578738127,3578738169,42
0,1112,27585,3578738127,3578738171,44
0,1112,27586,3578738127,3578738173,46
0,1112,27587,3578738127,3578738173,46
0,1112,27588,3578738127,3578738174,47
0,1112,27589,3578738127,3578738174,47
0,1112,27590,3578738127,3578738174,47
0,1112,27591,3578738127,3578738175,48
0,1112,27592,3578738127,3578738176,49
0,1113,27593,3578738188,3578738188,0
0,1113,27594,3578738188,3578738188,0
0,1113,27595,3578738188,3578738188,0
0,1113,27596,3578738188,3578738188,0
0,1113,27597,3578738188,3578738188,0
0,1113,27598,3578738188,3578738188,0
0,1113,27599,3578738188,3578738188,0
0,1113,27600,3578738188,3578738188,0
0,1113,27601,3578738188,3578738188,0
0,1113,27602,3578738188,3578738188,0
0,1113,27603,3578738188,3578738188,0
0,1113,27604,3578738188,3578738189,1
0,1113,27605,3578738188,3578738189,1
0,1113,27606,3578738188,3578738189,1
0,1113,27607,3578738188,3578738190,2
0,1113,27608,3578738188,3578738190,2
0,1113,27609,3578738188,3578738192,4
0,1113,27610,3578738188,3578738193,5
0,1113,27611,3578738188,3578738194,6
0,1113,27612,3578738188,3578738194,6
0,1113,27613,3578738188,3578738195,7
0,1113,27614,3578738188,3578738196,8
0,1113,27615,3578738188,3578738198,10
0,1113,27616,3578738188,3578738200,12
0,1113,27617,3578738188,3578738201,13
0,1113,27618,3578738188,3578738201,13
0,1113,27619,3578738188,3578738203,15
0,1113,27620,3578738188,3578738204,16
0,1113,27621,3578738188,3578738204,16
0,1113,27622,3578738188,3578738205,17
0,1113,27623,3578738188,3578738205,17
0,1113,27624,3578738188,3578738205,17
0,1113,27625,3578738188,3578738207,19
0,1113,27626,3578738188,3578738207,19
0,1113,27627,3578738188,3578738208,20
0,1113,27628,3578738188,3578738209,21
0,1113,27629,3578738188,3578738210,22
0,1113,27630,3578738188,3578738210,22
0,1113,27631,3578738188,3578738210,22
0,1113,27632,3578738188,3578738212,24
0,1113,27633,3578738188,3578738213,25
0,1113,27634,3578738188,3578738214,26
0,1113,27635,3578738188,3578738215,27
0,1113,27636,3578738188,3578738215,27
0,1113,27637,3578738188,3578738215,27
0,1113,27638,3578738188,3578738215,27
0,1113,27639,3578738188,3578738218,30
0,1113,27640,3578738188,3578738219,31
0,1113,27641,3578738188,3578738219,31
0,1113,27642,3578738188,3578738219,31
0,1113,27643,3578738188,3578738219,31
0,1113,27644,3578738188,3578738223,35
0,1113,27645,3578738188,3578738223,35
0,1113,27646,3578738188,3578738224,36
0,1113,27647,3578738188,3578738225,37
0,1113,27648,3578738188,3578738226,38
0,1113,27649,3578738188,3578738227,39
0,1113,27650,3578738188,3578738229,41
0,1113,27651,3578738188,3578738230,42
0,1113,27652,3578738188,3578738230,42
0,1113,27653,3578738188,3578738231,43
0,1113,27654,3578738188,3578738233,45
0,1113,27655,3578738188,3578738235,47
0,1113,27656,3578738188,3578738236,48
0,1113,27657,3578738188,3578738237,49
0,1114,27658,3578738250,3578738250,0
0,1114,27659,3578738250,3578738250,0
0,1114,27660,3578738250,3578738250,0
0,1114,27661,3578738250,3578738250,0
0,1114,27662,3578738250,3578738250,0
0,1114,27663,3578738250,3578738250,0
0,1114,27664,3578738250,3578738250,0
0,1114,27665,3578738250,3578738250,0
0,1114,27666,3578738250,3578738250,0
0,1114,27667,3578738250,3578738250,0
0,1114,27668,3578738250,3578738250,0
0,1114,27669,3578738250,3578738250,0
0,1114,27670,3578738250,3578738250,0
0,1114,27671,3578738250,3578738250,0
0,1114,27672,3578738250,3578738250,0
0,1114,27673,3578738250,3578738250,0
0,1114,27674,3578738250,3578738250,0
0,1114,27675,3578738250,3578738253,3
0,1114,27676,3578738250,3578738255,5
0,1114,27677,3578738250,3578738255,5
0,1114,27678,3578738250,3578738257,7
0,1114,27679,3578738250,3578738257,7
0,1114,27680,3578738250,3578738258,8
0,1114,27681,3578738250,3578738259,9
0,1114,27682,3578738250,3578738260,10
0,1114,27683,3578738250,3578738261,11
0,1114,27684,3578738250,3578738262,12
0,1114,27685,3578738250,3578738262,12
0,1114,27686,3578738250,3578738264,14
0,1114,27687,3578738250,3578738265,15
0,1114,27688,3578738250,3578738266,16
0,1114,27689,3578738250,3578738266,16
0,1114,27690,3578738250,3578738267,17
0,1114,27691,3578738250,3578738268,18
0,1114,27692,3578738250,3578738270,20
0,1114,27693,3578738250,3578738275,25
0,1114,27694,3578738250,3578738276,26
0,1114,27695,3578738250,3578738276,26
0,1114,27696,3578738250,3578738278,28
0,1114,27697,3578738250,3578738278,28
0,1114,27698,3578738250,3578738279,29
0,1114,27699,3578738250,3578738279,29
0,1114,27700,3578738250,3578738281,31
0,1114,27701,3578738250,3578738281,31
0,1114,27702,3578738250,3578738282,32
0,1114,27703,3578738250,3578738282,32
0,1114,27704,3578738250,3578738283,33
0,1114,27705,3578738250,3578738283,33
0,1114,27706,3578738250,3578738284,34
0,1114,27707,3578738250,3578738284,34
0,1114,27708,3578738250,3578738284,34
0,1114,27709,3578738250,3578738284,34
0,1114,27710,3578738250,3578738285,35
0,1114,27711,3578738250,3578738287,37
0,1114,27712,3578738250,3578738288,38
0,1114,27713,3578738250,3578738288,38
0,1114,27714,3578738250,3578738290,40
0,1114,27715,3578738250,3578738291,41
0,1114,27716,3578738250,3578738291,41
0,1114,27717,3578738250,3578738293,43
0,1114,27718,3578738250,3578738293,43
0,1114,27719,3578738250,3578738294,44
0,1114,27720,3578738250,3578738296,46
0,1114,27721,3578738250,3578738298,48
0,1114,27722,3578738250,3578738298,48
0,1114,27723,3578738250,3578738299,49
0,1114,27724,3578738250,3578738299,49
0,1114,27725,3578738250,3578738300,50
0,1115,27726,3578738309,3578738309,0
0,1115,27727,3578738309,3578738309,0
0,1115,27728,3578738309,3578738309,0
0,1115,27729,3578738309,3578738309,0
0,1115,27730,3578738309,3578738309,0
0,1115,27731,3578738309,3578738309,0
0,1115,27732,3578738309,3578738310,1
0,1115,27733,3578738309,3578738310,1
0,1115,27734,3578738309,3578738310,1
0,1115,27735,3578738309,3578738310,1
0,1115,27736,3578738309,3578738310,1
0,1115,27737,3578738309,3578738310,1
0,1115,27738,3578738309,3578738310,1
0,1115,27739,3578738309,3578738310,1
0,1115,27740,3578738309,3578738310,1
0,1115,27741,3578738309,3578738310,1
0,1115,27742,3578738309,3578738310,1
0,1115,27743,3578738309,3578738310,1
0,1115,27744,3578738309,3578738313,4
0,1115,27745,3578738309,3578738313,4
0,1115,27746,3578738309,3578738314,5
0,1115,27747,3578738309,3578738315,6
0,1115,27748,3578738309,3578738315,6
0,1115,27749,3578738309,3578738316,7
0,1115,27750,3578738309,3578738316,7
0,1115,27751,3578738309,3578738316,7
0,1115,27752,3578738309,3578738317,8
0,1115,27753,3578738309,3578738317,8
0,1115,27754,3578738309,3578738317,8
0,1115,27755,3578738309,3578738318,9
0,1115,27756,3578738309,3578738318,9
0,1115,27757,3578738309,3578738320,11
0,1115,27758,3578738309,3578738320,11
0,1115,27759,3578738309,3578738321,12
0,1115,27760,3578738309,3578738322,13
0,1115,27761,3578738309,3578738323,14
0,1115,27762,3578738309,3578738325,16
0,1115,27763,3578738309,3578738325,16
0,1115,27764,3578738309,3578738328,19
0,1115,27765,3578738309,3578738329,20
0,1115,27766,3578738309,3578738330,21
0,1115,27767,3578738309,3578738330,21
0,1115,27768,3578738309,3578738331,22
0,1115,27769,3578738309,3578738332,23
0,1115,27770,3578738309,3578738332,23
0,1115,27771,3578738309,3578738333,24
0,1115,27772,3578738309,3578738334,25
0,1115,27773,3578738309,3578738335,26
0,1115,27774,3578738309,3578738336,27
0,1115,27775,3578738309,3578738339,30
0,1115,27776,3578738309,3578738339,30
0,1115,27777,3578738309,3578738340,31
0,1115,27778,3578738309,3578738340,31
0,1115,27779,3578738309,3578738341,32
0,1115,27780,3578738309,3578738341,32
0,1115,27781,3578738309,3578738341,32
0,1115,27782,3578738309,3578738341,32
0,1115,27783,3578738309,3578738343,34
0,1115,27784,3578738309,3578738343,34
0,1115,27785,3578738309,3578738343,34
0,1115,27786,3578738309,3578738343,34
0,1115,27787,3578738309,3578738344,35
0,1115,27788,3578738309,3578738345,36
0,1115,27789,3578738309,3578738345,36
0,1115,27790,3578738309,3578738346,37
0,1115,27791,3578738309,3578738346,37
0,1115,27792,3578738309,3578738348,39
0,1115,27793,3578738309,3578738348,39
0,1115,27794,3578738309,3578738348,39
0,1115,27795,3578738309,3578738353,44
0,1115,27796,3578738309,3578738355,46
0,1115,27797,3578738309,3578738356,47
0,1115,27798,3578738309,3578738356,47
0,1115,27799,3578738309,3578738357,48
0,1115,27800,3578738309,3578738357,48
0,1115,27801,3578738309,3578738357,48
0,1115,27802,3578738309,3578738358,49
0,1115,27803,3578738309,3578738359,50
0,1116,27804,3578738372,3578738372,0
0,1116,27805,3578738372,3578738372,0
0,1116,27806,3578738372,3578738372,0
0,1116,27807,3578738372,3578738372,0
0,1116,27808,3578738372,3578738372,0
0,1116,27809,3578738372,3578738372,0
0,1116,27810,3578738372,3578738372,0
0,1116,27811,3578738372,3578738372,0
0,1116,27812,3578738372,3578738372,0
0,1116,27813,3578738372,3578738372,0
0,1116,27814,3578738372,3578738372,0
0,1116,27815,3578738372,3578738372,0
0,1116,27816,3578738372,3578738372,0
0,1116,27817,3578738372,3578738372,0
0,1116,27818,3578738372,3578738372,0
0,1116,27819,3578738372,3578738373,1
0,1116,27820,3578738372,3578738374,2
0,1116,27821,3578738372,3578738374,2
0,1116,27822,3578738372,3578738374,2
0,1116,27823,3578738372,3578738375,3
0,1116,27824,3578738372,3578738375,3
0,1116,27825,3578738372,3578738376,4
0,1116,27826,3578738372,3578738378,6
0,1116,27827,3578738372,3578738379,7
0,1116,27828,3578738372,3578738379,7
0,1116,27829,3578738372,3578738381,9
0,1116,27830,3578738372,3578738382,10
0,1116,27831,3578738372,3578738383,11
0,1116,27832,3578738372,3578738385,13
0,1116,27833,3578738372,3578738386,14
0,1116,27834,3578738372,3578738388,16
0,1116,27835,3578738372,3578738388,16
0,1116,27836,3578738372,3578738388,16
0,1116,27837,3578738372,3578738389,17
0,1116,27838,3578738372,3578738389,17
0,1116,27839,3578738372,3578738389,17
0,1116,27840,3578738372,3578738391,19
0,1116,27841,3578738372,3578738391,19
0,1116,27842,3578738372,3578738393,21
0,1116,27843,3578738372,3578738393,21
0,1116,27844,3578738372,3578738394,22
0,1116,27845,3578738372,3578738394,22
0,1116,27846,3578738372,3578738395,23
0,1116,27847,3578738372,3578738396,24
0,1116,27848,3578738372,3578738398,26
0,1116,27849,3578738372,3578738401,29
0,1116,27850,3578738372,3578738401,29
0,1116,27851,3578738372,3578738401,29
0,1116,27852,3578738372,3578738402,30
0,1116,27853,3578738372,3578738404,32
0,1116,27854,3578738372,3578738405,33
0,1116,27855,3578738372,3578738405,33
0,1116,27856,3578738372,3578738405,33
0,1116,27857,3578738372,3578738406,34
0,1116,27858,3578738372,3578738406,34
0,1116,27859,3578738372,3578738408,36
0,1116,27860,3578738372,3578738408,36
0,1116,27861,3578738372,3578738408,36
0,1116,27862,3578738372,3578738408,36
0,1116,27863,3578738372,3578738409,37
0,1116,27864,3578738372,3578738410,38
0,1116,27865,3578738372,3578738411,39
0,1116,27866,3578738372,3578738413,41
0,1116,27867,3578738372,3578738413,41
0,1116,27868,3578738372,3578738414,42
0,1116,27869,3578738372,3578738415,43
0,1116,27870,3578738372,3578738415,43
0,1116,27871,3578738372,3578738415,43
0,1116,27872,3578738372,3578738415,43
0,1116,27873,3578738372,3578738419,47
0,1116,27874,3578738372,3578738419,47
0,1116,27875,3578738372,3578738420,48
0,1116,27876,3578738372,3578738420,48
0,1117,27877,3578738433,3578738433,0
0,1117,27878,3578738433,3578738433,0
0,1117,27879,3578738433,3578738433,0
0,1117,27880,3578738433,3578738433,0
0,1117,27881,3578738433,3578738433,0
0,1117,27882,3578738433,3578738433,0
0,1117,27883,3578738433,3578738433,0
0,1117,27884,3578738433,3578738433,0
0,1117,27885,3578738433,3578738433,0
0,1117,27886,3578738433,3578738433,0
0,1117,27887,3578738433,3578738434,1
0,1117,27888,3578738433,3578738435,2
0,1117,27889,3578738433,3578738437,4
0,1117,27890,3578738433,3578738439,6
0,1117,27891,3578738433,3578738440,7
0,1117,27892,3578738433,3578738441,8
0,1117,27893,3578738433,3578738441,8
0,1117,27894,3578738433,3578738443,10
0,1117,27895,3578738433,3578738443,10
0,1117,27896,3578738433,3578738443,10
0,1117,27897,3578738433,3578738444,11
0,1117,27898,3578738433,3578738444,11
0,1117,27899,3578738433,3578738444,11
0,1117,27900,3578738433,3578738446,13
0,1117,27901,3578738433,3578738447,14
0,1117,27902,3578738433,3578738447,14
0,1117,27903,3578738433,3578738449,16
0,1117,27904,3578738433,3578738449,16
0,1117,27905,3578738433,3578738450,17
0,1117,27906,3578738433,3578738450,17
0,1117,27907,3578738433,3578738450,17
0,1117,27908,3578738433,3578738453,20
0,1117,27909,3578738433,3578738455,22
0,1117,27910,3578738433,3578738457,24
0,1117,27911,3578738433,3578738457,24
0,1117,27912,3578738433,3578738459,26
0,1117,27913,3578738433,3578738459,26
0,1117,27914,3578738433,3578738459,26
0,1117,27915,3578738433,3578738459,26
0,1117,27916,3578738433,3578738462,29
0,1117,27917,3578738433,3578738462,29
0,1117,27918,3578738433,3578738462,29
0,1117,27919,3578738433,3578738464,31
0,1117,27920,3578738433,3578738464,31
0,1117,27921,3578738433,3578738465,32
0,1117,27922,3578738433,3578738466,33
0,1117,27923,3578738433,3578738467,34
0,1117,27924,3578738433,3578738468,35
0,1117,27925,3578738433,3578738468,35
0,1117,27926,3578738433,3578738470,37
0,1117,27927,3578738433,3578738475,42
0,1117,27928,3578738433,3578738477,44
0,1117,27929,3578738433,3578738477,44
0,1117,27930,3578738433,3578738477,44
0,1117,27931,3578738433,3578738478,45
0,1117,27932,3578738433,3578738478,45
0,1117,27933,3578738433,3578738479,46
0,1117,27934,3578738433,3578738479,46
0,1117,27935,3578738433,3578738480,47
0,1117,27936,3578738433,3578738481,48
0,1117,27937,3578738433,3578738482,49
0,1117,27938,3578738433,3578738482,49
0,1117,27939,3578738433,3578738483,50
0,1118,27940,3578738492,3578738492,0
0,1118,27941,3578738492,3578738492,0
0,1118,27942,3578738492,3578738492,0
0,1118,27943,3578738492,3578738492,0
0,1118,27944,3578738492,3578738492,0
0,1118,27945,3578738492,3578738492,0
0,1118,27946,3578738492,3578738492,0
0,1118,27947,3578738492,3578738492,0
0,1118,27948,3578738492,3578738492,0
0,1118,27949,3578738492,3578738492,0
0,1118,27950,3578738492,3578738492,0
0,1118,27951,3578738492,3578738492,0
0,1118,27952,3578738492,3578738492,0
0,1118,27953,3578738492,3578738493,1
0,1118,27954,3578738492,3578738496,4
0,1118,27955,3578738492,3578738497,5
0,1118,27956,3578738492,3578738497,5
0,1118,27957,3578738492,3578738498,6
0,1118,27958,3578738492,3578738498,6
0,1118,27959,3578738492,3578738499,7
0,1118,27960,3578738492,3578738499,7
0,1118,27961,3578738492,3578738501,9
0,1118,27962,3578738492,3578738501,9
0,1118,27963,3578738492,3578738503,11
0,1118,27964,3578738492,3578738503,11
0,1118,27965,3578738492,3578738504,12
0,1118,27966,3578738492,3578738505,13
0,1118,27967,3578738492,3578738506,14
0,1118,27968,3578738492,3578738506,14
0,1118,27969,3578738492,3578738507,15
0,1118,27970,3578738492,3578738507,15
0,1118,27971,3578738492,3578738507,15
0,1118,27972,3578738492,3578738507,15
0,1118,27973,3578738492,3578738508,16
0,1118,27974,3578738492,3578738508,16
0,1118,27975,3578738492,3578738508,16
0,1118,27976,3578738492,3578738509,17
0,1118,27977,3578738492,3578738512,20
0,1118,27978,3578738492,3578738513,21
0,1118,27979,3578738492,3578738513,21
0,1118,27980,3578738492,3578738513,21
0,1118,27981,3578738492,3578738514,22
0,1118,27982,3578738492,3578738514,22
0,1118,27983,3578738492,3578738515,23
0,1118,27984,3578738492,3578738515,23
0,1118,27985,3578738492,3578738515,23
0,1118,27986,3578738492,3578738516,24
0,1118,27987,3578738492,3578738516,24
0,1118,27988,3578738492,3578738517,25
0,1118,27989,3578738492,3578738519,27
0,1118,27990,3578738492,3578738521,29
0,1118,27991,3578738492,3578738523,31
0,1118,27992,3578738492,3578738523,31
0,1118,27993,3578738492,3578738523,31
0,1118,27994,3578738492,3578738524,32
0,1118,27995,3578738492,3578738525,33
0,1118,27996,3578738492,3578738528,36
0,1118,27997,3578738492,3578738528,36
0,1118,27998,3578738492,3578738529,37
0,1118,27999,3578738492,3578738530,38
0,1118,28000,3578738492,3578738531,39
0,1118,28001,3578738492,3578738531,39
0,1118,28002,3578738492,3578738531,39
0,1118,28003,3578738492,3578738534,42
0,1118,28004,3578738492,3578738536,44
0,1118,28005,3578738492,3578738538,46
0,1118,28006,3578738492,3578738538,46
0,1118,28007,3578738492,3578738539,47
0,1118,28008,3578738492,3578738540,48
0,1118,28009,3578738492,3578738540,48
0,1118,28010,3578738492,3578738540,48
0,1118,28011,3578738492,3578738541,49
0,1119,28012,3578738553,3578738553,0
0,1119,28013,3578738553,3578738553,0
0,1119,28014,3578738553,3578738553,0
0,1119,28015,3578738553,3578738553,0
0,1119,28016,3578738553,3578738553,0
0,1119,28017,3578738553,3578738553,0
0,1119,28018,3578738553,3578738553,0
0,1119,28019,3578738553,3578738553,0
0,1119,28020,3578738553,3578738553,0
0,1119,28021,3578738553,3578738553,0
0,1119,28022,3578738553,3578738553,0
0,1119,28023,3578738553,3578738553,0
0,1119,28024,3578738553,3578738553,0
0,1119,28025,3578738553,3578738553,0
0,1119,28026,3578738553,3578738553,0
0,1119,28027,3578738553,3578738553,0
0,1119,28028,3578738553,3578738554,1
0,1119,28029,3578738553,3578738555,2
0,1119,28030,3578738553,3578738555,2
0,1119,28031,3578738553,3578738556,3
0,1119,28032,3578738553,3578738556,3
0,1119,28033,3578738553,3578738558,5
0,1119,28034,3578738553,3578738558,5
0,1119,28035,3578738553,3578738559,6
0,1119,28036,3578738553,3578738560,7
0,1119,28037,3578738553,3578738560,7
0,1119,28038,3578738553,3578738560,7
0,1119,28039,3578738553,3578738560,7
0,1119,28040,3578738553,3578738562,9
0,1119,28041,3578738553,3578738564,11
0,1119,28042,3578738553,3578738564,11
0,1119,28043,3578738553,3578738565,12
0,1119,28044,3578738553,3578738565,12
0,1119,28045,3578738553,3578738565,12
0,1119,28046,3578738553,3578738567,14
0,1119,28047,3578738553,3578738568,15
0,1119,28048,3578738553,3578738569,16
0,1119,28049,3578738553,3578738570,17
0,1119,28050,3578738553,3578738571,18
0,1119,28051,3578738553,3578738572,19
0,1119,28052,3578738553,3578738572,19
0,1119,28053,3578738553,3578738573,20
0,1119,28054,3578738553,3578738574,21
0,1119,28055,3578738553,3578738574,21
0,1119,28056,3578738553,3578738574,21
0,1119,28057,3578738553,3578738575,22
0,1119,28058,3578738553,3578738577,24
0,1119,28059,3578738553,3578738577,24
0,1119,28060,3578738553,3578738578,25
0,1119,28061,3578738553,3578738580,27
0,1119,28062,3578738553,3578738581,28
0,1119,28063,3578738553,3578738581,28
0,1119,28064,3578738553,3578738581,28
0,1119,28065,3578738553,3578738582,29
0,1119,28066,3578738553,3578738584,31
0,1119,28067,3578738553,3578738585,32
0,1119,28068,3578738553,3578738587,34
0,1119,28069,3578738553,3578738588,35
0,1119,28070,3578738553,3578738588,35
0,1119,28071,3578738553,3578738588,35
0,1119,28072,3578738553,3578738589,36
0,1119,28073,3578738553,3578738590,37
0,1119,28074,3578738553,3578738590,37
0,1119,28075,3578738553,3578738591,38
0,1119,28076,3578738553,3578738592,39
0,1119,28077,3578738553,3578738593,40
0,1119,28078,3578738553,3578738594,41
0,1119,28079,3578738553,3578738594,41
0,1119,28080,3578738553,3578738595,42
0,1119,28081,3578738553,3578738600,47
0,1119,28082,3578738553,3578738600,47
0,1119,28083,3578738553,3578738600,47
0,1119,28084,3578738553,3578738602,49
0,1120,28085,3578738613,3578738613,0
0,1120,28086,3578738613,3578738613,0
0,1120,28087,3578738613,3578738613,0
0,1120,28088,3578738613,3578738613,0
0,1120,28089,3578738613,3578738613,0
0,1120,28090,3578738613,3578738613,0
0,1120,28091,3578738613,3578738613,0
0,1120,28092,3578738613,3578738613,0
0,1120,28093,3578738613,3578738613,0
0,1120,28094,3578738613,3578738613,0
0,1120,28095,3578738613,3578738613,0
0,1120,28096,3578738613,3578738613,0
0,1120,28097,3578738613,3578738613,0
0,1120,28098,3578738613,3578738614,1
0,1120,28099,3578738613,3578738614,1
0,1120,28100,3578738613,3578738615,2
0,1120,28101,3578738613,3578738615,2
0,1120,28102,3578738613,3578738615,2
0,1120,28103,3578738613,3578738617,4
0,1120,28104,3578738613,3578738618,5
0,1120,28105,3578738613,3578738619,6
0,1120,28106,3578738613,3578738620,7
0,1120,28107,3578738613,3578738622,9
0,1120,28108,3578738613,3578738623,10
0,1120,28109,3578738613,3578738623,10
0,1120,28110,3578738613,3578738625,12
0,1120,28111,3578738613,3578738627,14
0,1120,28112,3578738613,3578738628,15
0,1120,28113,3578738613,3578738629,16
0,1120,28114,3578738613,3578738629,16
0,1120,28115,3578738613,3578738631,18
0,1120,28116,3578738613,3578738632,19
0,1120,28117,3578738613,3578738633,20
0,1120,28118,3578738613,3578738634,21
0,1120,28119,3578738613,3578738635,22
0,1120,28120,3578738613,3578738638,25
0,1120,28121,3578738613,3578738639,26
0,1120,28122,3578738613,3578738639,26
0,1120,28123,3578738613,3578738639,26
0,1120,28124,3578738613,3578738642,29
0,1120,28125,3578738613,3578738642,29
0,1120,28126,3578738613,3578738642,29
0,1120,28127,3578738613,3578738643,30
0,1120,28128,3578738613,3578738644,31
0,1120,28129,3578738613,3578738644,31
0,1120,28130,3578738613,3578738645,32
0,1120,28131,3578738613,3578738646,33
0,1120,28132,3578738613,3578738646,33
0,1120,28133,3578738613,3578738647,34
0,1120,28134,3578738613,3578738648,35
0,1120,28135,3578738613,3578738649,36
0,1120,28136,3578738613,3578738649,36
0,1120,28137,3578738613,3578738649,36
0,1120,28138,3578738613,3578738649,36
0,1120,28139,3578738613,3578738652,39
0,1120,28140,3578738613,3578738655,42
0,1120,28141,3578738613,3578738656,43
0,1120,28142,3578738613,3578738658,45
0,1120,28143,3578738613,3578738658,45
0,1120,28144,3578738613,3578738659,46
0,1120,28145,3578738613,3578738660,47
0,1120,28146,3578738613,3578738661,48
0,1120,28147,3578738613,3578738662,49
0,1121,28148,3578738673,3578738673,0
0,1121,28149,3578738673,3578738673,0
0,1121,28150,3578738673,3578738673,0
0,1121,28151,3578738673,3578738673,0
0,1121,28152,3578738673,3578738673,0
0,1121,28153,3578738673,3578738673,0
0,1121,28154,3578738673,3578738673,0
0,1121,28155,3578738673,3578738675,2
0,1121,28156,3578738673,3578738677,4
0,1121,28157,3578738673,3578738677,4
0,1121,28158,3578738673,3578738678,5
0,1121,28159,3578738673,3578738679,6
0,1121,28160,3578738673,3578738679,6
0,1121,28161,3578738673,3578738680,7
0,1121,28162,3578738673,3578738681,8
0,1121,28163,3578738673,3578738681,8
0,1121,28164,3578738673,3578738682,9
0,1121,28165,3578738673,3578738682,9
0,1121,28166,3578738673,3578738682,9
0,1121,28167,3578738673,3578738683,10
0,1121,28168,3578738673,3578738683,10
0,1121,28169,3578738673,3578738683,10
0,1121,28170,3578738673,3578738685,12
0,1121,28171,3578738673,3578738686,13
0,1121,28172,3578738673,3578738687,14
0,1121,28173,3578738673,3578738687,14
0,1121,28174,3578738673,3578738687,14
0,1121,28175,3578738673,3578738687,14
0,1121,28176,3578738673,3578738688,15
0,1121,28177,3578738673,3578738688,15
0,1121,28178,3578738673,3578738688,15
0,1121,28179,3578738673,3578738689,16
0,1121,28180,3578738673,3578738691,18
0,1121,28181,3578738673,3578738691,18
0,1121,28182,3578738673,3578738692,19
0,1121,28183,3578738673,3578738693,20
0,1121,28184,3578738673,3578738693,20
0,1121,28185,3578738673,3578738697,24
0,1121,28186,3578738673,3578738697,24
0,1121,28187,3578738673,3578738697,24
0,1121,28188,3578738673,3578738698,25
0,1121,28189,3578738673,3578738698,25
0,1121,28190,3578738673,3578738699,26
0,1121,28191,3578738673,3578738700,27
0,1121,28192,3578738673,3578738701,28
0,1121,28193,3578738673,3578738703,30
0,1121,28194,3578738673,3578738704,31
0,1121,28195,3578738673,3578738704,31
0,1121,28196,3578738673,3578738704,31
0,1121,28197,3578738673,3578738705,32
0,1121,28198,3578738673,3578738707,34
0,1121,28199,3578738673,3578738707,34
0,1121,28200,3578738673,3578738707,34
0,1121,28201,3578738673,3578738707,34
0,1121,28202,3578738673,3578738707,34
0,1121,28203,3578738673,3578738708,35
0,1121,28204,3578738673,3578738708,35
0,1121,28205,3578738673,3578738710,37
0,1121,28206,3578738673,3578738713,40
0,1121,28207,3578738673,3578738713,40
0,1121,28208,3578738673,3578738714,41
0,1121,28209,3578738673,3578738714,41
0,1121,28210,3578738673,3578738714,41
0,1121,28211,3578738673,3578738715,42
0,1121,28212,3578738673,3578738715,42
0,1121,28213,3578738673,3578738716,43
0,1121,28214,3578738673,3578738716,43
0,1121,28215,3578738673,3578738716,43
0,1121,28216,3578738673,3578738717,44
0,1121,28217,3578738673,3578738720,47
0,1121,28218,3578738673,3578738720,47
0,1121,28219,3578738673,3578738722,49
0,1121,28220,3578738673,3578738723,50
0,1122,28221,3578738735,3578738735,0
0,1122,28222,3578738735,3578738735,0
0,1122,28223,3578738735,3578738735,0
0,1122,28224,3578738735,3578738735,0
0,1122,28225,3578738735,3578738735,0
0,1122,28226,3578738735,3578738735,0
0,1122,28227,3578738735,3578738735,0
0,1122,28228,3578738735,3578738735,0
0,1122,28229,3578738735,3578738735,0
0,1122,28230,3578738735,3578738735,0
0,1122,28231,3578738735,3578738735,0
0,1122,28232,3578738735,3578738735,0
0,1122,28233,3578738735,3578738735,0
0,1122,28234,3578738735,3578738735,0
0,1122,28235,3578738735,3578738736,1
0,1122,28236,3578738735,3578738736,1
0,1122,28237,3578738735,3578738738,3
0,1122,28238,3578738735,3578738739,4
0,1122,28239,3578738735,3578738740,5
0,1122,28240,3578738735,3578738740,5
0,1122,28241,3578738735,3578738740,5
0,1122,28242,3578738735,3578738741,6
0,1122,28243,3578738735,3578738742,7
0,1122,28244,3578738735,3578738742,7
0,1122,28245,3578738735,3578738743,8
0,1122,28246,3578738735,3578738743,8
0,1122,28247,3578738735,3578738743,8
0,1122,28248,3578738735,3578738743,8
0,1122,28249,3578738735,3578738744,9
0,1122,28250,3578738735,3578738745,10
0,1122,28251,3578738735,3578738745,10
0,1122,28252,3578738735,3578738746,11
0,1122,28253,3578738735,3578738747,12
0,1122,28254,3578738735,3578738747,12
0,1122,28255,3578738735,3578738747,12
0,1122,28256,3578738735,3578738748,13
0,1122,28257,3578738735,3578738750,15
0,1122,28258,3578738735,3578738752,17
0,1122,28259,3578738735,3578738754,19
0,1122,28260,3578738735,3578738754,19
0,1122,28261,3578738735,3578738755,20
0,1122,28262,3578738735,3578738755,20
0,1122,28263,3578738735,3578738756,21
0,1122,28264,3578738735,3578738756,21
0,1122,28265,3578738735,3578738758,23
0,1122,28266,3578738735,3578738759,24
0,1122,28267,3578738735,3578738760,25
0,1122,28268,3578738735,3578738760,25
0,1122,28269,3578738735,3578738760,25
0,1122,28270,3578738735,3578738760,25
0,1122,28271,3578738735,3578738763,28
0,1122,28272,3578738735,3578738764,29
0,1122,28273,3578738735,3578738765,30
0,1122,28274,3578738735,3578738765,30
0,1122,28275,3578738735,3578738765,30
0,1122,28276,3578738735,3578738766,31
0,1122,28277,3578738735,3578738766,31
0,1122,28278,3578738735,3578738767,32
0,1122,28279,3578738735,3578738768,33
0,1122,28280,3578738735,3578738769,34
0,1122,28281,3578738735,3578738771,36
0,1122,28282,3578738735,3578738771,36
0,1122,28283,3578738735,3578738773,38
0,1122,28284,3578738735,3578738773,38
0,1122,28285,3578738735,3578738774,39
0,1122,28286,3578738735,3578738774,39
0,1122,28287,3578738735,3578738775,40
0,1122,28288,3578738735,3578738775,40
0,1122,28289,3578738735,3578738776,41
0,1122,28290,3578738735,3578738778,43
0,1122,28291,3578738735,3578738778,43
0,1122,28292,3578738735,3578738779,44
0,1122,28293,3578738735,3578738779,44
0,1122,28294,3578738735,3578738780,45
0,1122,28295,3578738735,3578738781,46
0,1122,28296,3578738735,3578738781,46
0,1122,28297,3578738735,3578738781,46
0,1122,28298,3578738735,3578738784,49
0,1122,28299,3578738735,3578738785,50
0,1123,28300,3578738799,3578738799,0
0,1123,28301,3578738799,3578738799,0
0,1123,28302,3578738799,3578738799,0
0,1123,28303,3578738799,3578738799,0
0,1123,28304,3578738799,3578738799,0
0,1123,28305,3578738799,3578738799,0
0,1123,28306,3578738799,3578738799,0
0,1123,28307,3578738799,3578738799,0
0,1123,28308,3578738799,3578738799,0
0,1123,28309,3578738799,3578738799,0
0,1123,28310,3578738799,3578738799,0
0,1123,28311,3578738799,3578738799,0
0,1123,28312,3578738799,3578738799,0
0,1123,28313,3578738799,3578738799,0
0,1123,28314,3578738799,3578738799,0
0,1123,28315,3578738799,3578738800,1
0,1123,28316,3578738799,3578738800,1
0,1123,28317,3578738799,3578738801,2
0,1123,28318,3578738799,3578738803,4
0,1123,28319,3578738799,3578738804,5
0,1123,28320,3578738799,3578738804,5
0,1123,28321,3578738799,3578738804,5
0,1123,28322,3578738799,3578738805,6
0,1123,28323,3578738799,3578738805,6
0,1123,28324,3578738799,3578738806,7
0,1123,28325,3578738799,3578738806,7
0,1123,28326,3578738799,3578738808,9
0,1123,28327,3578738799,3578738809,10
0,1123,28328,3578738799,3578738810,11
0,1123,28329,3578738799,3578738812,13
0,1123,28330,3578738799,3578738812,13
0,1123,28331,3578738799,3578738813,14
0,1123,28332,3578738799,3578738813,14
0,1123,28333,3578738799,3578738814,15
0,1123,28334,3578738799,3578738814,15
0,1123,28335,3578738799,3578738815,16
0,1123,28336,3578738799,3578738817,18
0,1123,28337,3578738799,3578738818,19
0,1123,28338,3578738799,3578738819,20
0,1123,28339,3578738799,3578738820,21
0,1123,28340,3578738799,3578738823,24
0,1123,28341,3578738799,3578738823,24
0,1123,28342,3578738799,3578738823,24
0,1123,28343,3578738799,3578738825,26
0,1123,28344,3578738799,3578738826,27
0,1123,28345,3578738799,3578738827,28
0,1123,28346,3578738799,3578738828,29
0,1123,28347,3578738799,3578738829,30
0,1123,28348,3578738799,3578738829,30
0,1123,28349,3578738799,3578738831,32
0,1123,28350,3578738799,3578738833,34
0,1123,28351,3578738799,3578738835,36
0,1123,28352,3578738799,3578738836,37
0,1123,28353,3578738799,3578738837,38
0,1123,28354,3578738799,3578738839,40
0,1123,28355,3578738799,3578738839,40
0,1123,28356,3578738799,3578738840,41
0,1123,28357,3578738799,3578738840,41
0,1123,28358,3578738799,3578738843,44
0,1123,28359,3578738799,3578738843,44
0,1123,28360,3578738799,3578738843,44
0,1123,28361,3578738799,3578738844,45
0,1123,28362,3578738799,3578738845,46
0,1123,28363,3578738799,3578738845,46
0,1123,28364,3578738799,3578738846,47
0,1123,28365,3578738799,3578738847,48
0,1123,28366,3578738799,3578738848,49
0,1123,28367,3578738799,3578738848,49
0,1123,28368,3578738799,3578738849,50
0,1124,28369,3578738861,3578738861,0
0,1124,28370,3578738861,3578738861,0
0,1124,28371,3578738861,3578738861,0
0,1124,28372,3578738861,3578738861,0
0,1124,28373,3578738861,3578738861,0
0,1124,28374,3578738861,3578738861,0
0,1124,28375,3578738861,3578738861,0
0,1124,28376,3578738861,3578738861,0
0,1124,28377,3578738861,3578738861,0
0,1124,28378,3578738861,3578738861,0
0,1124,28379,3578738861,3578738861,0
0,1124,28380,3578738861,3578738862,1
0,1124,28381,3578738861,3578738862,1
0,1124,28382,3578738861,3578738864,3
0,1124,28383,3578738861,3578738864,3
0,1124,28384,3578738861,3578738865,4
0,1124,28385,3578738861,3578738866,5
0,1124,28386,3578738861,3578738867,6
0,1124,28387,3578738861,3578738868,7
0,1124,28388,3578738861,3578738869,8
0,1124,28389,3578738861,3578738875,14
0,1124,28390,3578738861,3578738878,17
0,1124,28391,3578738861,3578738878,17
0,1124,28392,3578738861,3578738880,19
0,1124,28393,3578738861,3578738880,19
0,1124,28394,3578738861,3578738881,20
0,1124,28395,3578738861,3578738881,20
0,1124,28396,3578738861,3578738881,20
0,1124,28397,3578738861,3578738882,21
0,1124,28398,3578738861,3578738882,21
0,1124,28399,3578738861,3578738882,21
0,1124,28400,3578738861,3578738882,21
0,1124,28401,3578738861,3578738883,22
0,1124,28402,3578738861,3578738884,23
0,1124,28403,3578738861,3578738886,25
0,1124,28404,3578738861,3578738887,26
0,1124,28405,3578738861,3578738888,27
0,1124,28406,3578738861,3578738888,27
0,1124,28407,3578738861,3578738888,27
0,1124,28408,3578738861,3578738888,27
0,1124,28409,3578738861,3578738888,27
0,1124,28410,3578738861,3578738888,27
0,1124,28411,3578738861,3578738888,27
0,1124,28412,3578738861,3578738889,28
0,1124,28413,3578738861,3578738891,30
0,1124,28414,3578738861,3578738891,30
0,1124,28415,3578738861,3578738892,31
0,1124,28416,3578738861,3578738892,31
0,1124,28417,3578738861,3578738892,31
0,1124,28418,3578738861,3578738898,37
0,1124,28419,3578738861,3578738898,37
0,1124,28420,3578738861,3578738898,37
0,1124,28421,3578738861,3578738898,37
0,1124,28422,3578738861,3578738899,38
0,1124,28423,3578738861,3578738899,38
0,1124,28424,3578738861,3578738899,38
0,1124,28425,3578738861,3578738901,40
0,1124,28426,3578738861,3578738901,40
0,1124,28427,3578738861,3578738903,42
0,1124,28428,3578738861,3578738903,42
0,1124,28429,3578738861,3578738904,43
0,1124,28430,3578738861,3578738904,43
0,1124,28431,3578738861,3578738905,44
0,1124,28432,3578738861,3578738906,45
0,1124,28433,3578738861,3578738907,46
0,1124,28434,3578738861,3578738907,46
0,1124,28435,3578738861,3578738907,46
0,1124,28436,3578738861,3578738907,46
0,1124,28437,3578738861,3578738907,46
0,1124,28438,3578738861,3578738908,47
0,1124,28439,3578738861,3578738908,47
0,1124,28440,3578738861,3578738910,49
0,1125,28441,3578738923,3578738923,0
0,1125,28442,3578738923,3578738923,0
0,1125,28443,3578738923,3578738923,0
0,1125,28444,3578738923,3578738923,0
0,1125,28445,3578738923,3578738923,0
0,1125,28446,3578738923,3578738923,0
0,1125,28447,3578738923,3578738923,0
0,1125,28448,3578738923,3578738923,0
0,1125,28449,3578738923,3578738923,0
0,1125,28450,3578738923,3578738923,0
0,1125,28451,3578738923,3578738923,0
0,1125,28452,3578738923,3578738923,0
0,1125,28453,3578738923,3578738923,0
0,1125,28454,3578738923,3578738923,0
0,1125,28455,3578738923,3578738923,0
0,1125,28456,3578738923,3578738923,0
0,1125,28457,3578738923,3578738923,0
0,1125,28458,3578738923,3578738923,0
0,1125,28459,3578738923,3578738923,0
0,1125,28460,3578738923,3578738924,1
0,1125,28461,3578738923,3578738925,2
0,1125,28462,3578738923,3578738927,4
0,1125,28463,3578738923,3578738928,5
0,1125,28464,3578738923,3578738928,5
0,1125,28465,3578738923,3578738930,7
0,1125,28466,3578738923,3578738930,7
0,1125,28467,3578738923,3578738930,7
0,1125,28468,3578738923,3578738931,8
0,1125,28469,3578738923,3578738931,8
0,1125,28470,3578738923,3578738931,8
0,1125,28471,3578738923,3578738933,10
0,1125,28472,3578738923,3578738935,12
0,1125,28473,3578738923,3578738936,13
0,1125,28474,3578738923,3578738937,14
0,1125,28475,3578738923,3578738939,16
0,1125,28476,3578738923,3578738939,16
0,1125,28477,3578738923,3578738940,17
0,1125,28478,3578738923,3578738940,17
0,1125,28479,3578738923,3578738941,18
0,1125,28480,3578738923,3578738941,18
0,1125,28481,3578738923,3578738941,18
0,1125,28482,3578738923,3578738942,19
0,1125,28483,3578738923,3578738942,19
0,1125,28484,3578738923,3578738942,19
0,1125,28485,3578738923,3578738943,20
0,1125,28486,3578738923,3578738943,20
0,1125,28487,3578738923,3578738943,20
0,1125,28488,3578738923,3578738945,22
0,1125,28489,3578738923,3578738946,23
0,1125,28490,3578738923,3578738947,24
0,1125,28491,3578738923,3578738947,24
0,1125,28492,3578738923,3578738947,24
0,1125,28493,3578738923,3578738948,25
0,1125,28494,3578738923,3578738948,25
0,1125,28495,3578738923,3578738950,27
0,1125,28496,3578738923,3578738952,29
0,1125,28497,3578738923,3578738954,31
0,1125,28498,3578738923,3578738954,31
0,1125,28499,3578738923,3578738955,32
0,1125,28500,3578738923,3578738956,33
0,1125,28501,3578738923,3578738956,33
0,1125,28502,3578738923,3578738957,34
0,1125,28503,3578738923,3578738958,35
0,1125,28504,3578738923,3578738958,35
0,1125,28505,3578738923,3578738960,37
0,1125,28506,3578738923,3578738960,37
0,1125,28507,3578738923,3578738961,38
0,1125,28508,3578738923,3578738961,38
0,1125,28509,3578738923,3578738962,39
0,1125,28510,3578738923,3578738963,40
0,1125,28511,3578738923,3578738964,41
0,1125,28512,3578738923,3578738965,42
0,1125,28513,3578738923,3578738965,42
0,1125,28514,3578738923,3578738965,42
0,1125,28515,3578738923,3578738966,43
0,1125,28516,3578738923,3578738967,44
0,1125,28517,3578738923,3578738967,44
0,1125,28518,3578738923,3578738969,46
0,1125,28519,3578738923,3578738971,48
0,1125,28520,3578738923,3578738972,49
0,1126,28521,3578738986,3578738986,0
0,1126,28522,3578738986,3578738986,0
0,1126,28523,3578738986,3578738986,0
0,1126,28524,3578738986,3578738986,0
0,1126,28525,3578738986,3578738986,0
0,1126,28526,3578738986,3578738986,0
0,1126,28527,3578738986,3578738986,0
0,1126,28528,3578738986,3578738986,0
0,1126,28529,3578738986,3578738986,0
0,1126,28530,3578738986,3578738986,0
0,1126,28531,3578738986,3578738986,0
0,1126,28532,3578738986,3578738986,0
0,1126,28533,3578738986,3578738986,0
0,1126,28534,3578738986,3578738986,0
0,1126,28535,3578738986,3578738986,0
0,1126,28536,3578738986,3578738986,0
0,1126,28537,3578738986,3578738988,2
0,1126,28538,3578738986,3578738988,2
0,1126,28539,3578738986,3578738989,3
0,1126,28540,3578738986,3578738990,4
0,1126,28541,3578738986,3578738990,4
0,1126,28542,3578738986,3578738990,4
0,1126,28543,3578738986,3578738990,4
0,1126,28544,3578738986,3578738991,5
0,1126,28545,3578738986,3578738993,7
0,1126,28546,3578738986,3578738994,8
0,1126,28547,3578738986,3578738994,8
0,1126,28548,3578738986,3578738994,8
0,1126,28549,3578738986,3578738996,10
0,1126,28550,3578738986,3578738997,11
0,1126,28551,3578738986,3578739001,15
0,1126,28552,3578738986,3578739001,15
0,1126,28553,3578738986,3578739001,15
0,1126,28554,3578738986,3578739002,16
0,1126,28555,3578738986,3578739003,17
0,1126,28556,3578738986,3578739004,18
0,1126,28557,3578738986,3578739004,18
0,1126,28558,3578738986,3578739004,18
0,1126,28559,3578738986,3578739005,19
0,1126,28560,3578738986,3578739005,19
0,1126,28561,3578738986,3578739006,20
0,1126,28562,3578738986,3578739006,20
0,1126,28563,3578738986,3578739008,22
0,1126,28564,3578738986,3578739008,22
0,1126,28565,3578738986,3578739009,23
0,1126,28566,3578738986,3578739009,23
0,1126,28567,3578738986,3578739010,24
0,1126,28568,3578738986,3578739012,26
0,1126,28569,3578738986,3578739012,26
0,1126,28570,3578738986,3578739014,28
0,1126,28571,3578738986,3578739014,28
0,1126,28572,3578738986,3578739015,29
0,1126,28573,3578738986,3578739016,30
0,1126,28574,3578738986,3578739018,32
0,1126,28575,3578738986,3578739019,33
0,1126,28576,3578738986,3578739019,33
0,1126,28577,3578738986,3578739020,34
0,1126,28578,3578738986,3578739022,36
0,1126,28579,3578738986,3578739023,37
0,1126,28580,3578738986,3578739023,37
0,1126,28581,3578738986,3578739025,39
0,1126,28582,3578738986,3578739027,41
0,1126,28583,3578738986,3578739029,43
0,1126,28584,3578738986,3578739029,43
0,1126,28585,3578738986,3578739030,44
0,1126,28586,3578738986,3578739031,45
0,1126,28587,3578738986,3578739033,47
0,1126,28588,3578738986,3578739035,49
0,1127,28589,3578739048,3578739048,0
0,1127,28590,3578739048,3578739048,0
0,1127,28591,3578739048,3578739048,0
0,1127,28592,3578739048,3578739048,0
0,1127,28593,3578739048,3578739048,0
0,1127,28594,3578739048,3578739048,0
0,1127,28595,3578739048,3578739048,0
0,1127,28596,3578739048,3578739048,0
0,1127,28597,3578739048,3578739048,0
0,1127,28598,3578739048,3578739048,0
0,1127,28599,3578739048,3578739048,0
0,1127,28600,3578739048,3578739048,0
0,1127,28601,3578739048,3578739048,0
0,1127,28602,3578739048,3578739048,0
0,1127,28603,3578739048,3578739048,0
0,1127,28604,3578739048,3578739048,0
0,1127,28605,3578739048,3578739049,1
0,1127,28606,3578739048,3578739050,2
0,1127,28607,3578739048,3578739053,5
0,1127,28608,3578739048,3578739057,9
0,1127,28609,3578739048,3578739058,10
0,1127,28610,3578739048,3578739059,11
0,1127,28611,3578739048,3578739061,13
0,1127,28612,3578739048,3578739061,13
0,1127,28613,3578739048,3578739062,14
0,1127,28614,3578739048,3578739063,15
0,1127,28615,3578739048,3578739064,16
0,1127,28616,3578739048,3578739065,17
0,1127,28617,3578739048,3578739065,17
0,1127,28618,3578739048,3578739066,18
0,1127,28619,3578739048,3578739067,19
0,1127,28620,3578739048,3578739068,20
0,1127,28621,3578739048,3578739070,22
0,1127,28622,3578739048,3578739077,29
0,1127,28623,3578739048,3578739078,30
0,1127,28624,3578739048,3578739080,32
0,1127,28625,3578739048,3578739080,32
0,1127,28626,3578739048,3578739081,33
0,1127,28627,3578739048,3578739081,33
0,1127,28628,3578739048,3578739081,33
0,1127,28629,3578739048,3578739082,34
0,1127,28630,3578739048,3578739082,34
0,1127,28631,3578739048,3578739082,34
0,1127,28632,3578739048,3578739082,34
0,1127,28633,3578739048,3578739083,35
0,1127,28634,3578739048,3578739085,37
0,1127,28635,3578739048,3578739087,39
0,1127,28636,3578739048,3578739087,39
0,1127,28637,3578739048,3578739087,39
0,1127,28638,3578739048,3578739088,40
0,1127,28639,3578739048,3578739089,41
0,1127,28640,3578739048,3578739089,41
0,1127,28641,3578739048,3578739089,41
0,1127,28642,3578739048,3578739089,41
0,1127,28643,3578739048,3578739091,43
0,1127,28644,3578739048,3578739091,43
0,1127,28645,3578739048,3578739092,44
0,1127,28646,3578739048,3578739092,44
0,1127,28647,3578739048,3578739093,45
0,1127,28648,3578739048,3578739097,49
0,1127,28649,3578739048,3578739098,50
0,1128,28650,3578739114,3578739114,0
0,1128,28651,3578739114,3578739114,0
0,1128,28652,3578739114,3578739114,0
0,1128,28653,3578739114,3578739114,0
0,1128,28654,3578739114,3578739114,0
0,1128,28655,3578739114,3578739114,0
0,1128,28656,3578739114,3578739114,0
0,1128,28657,3578739114,3578739114,0
0,1128,28658,3578739114,3578739114,0
0,1128,28659,3578739114,3578739114,0
0,1128,28660,3578739114,3578739114,0
0,1128,28661,3578739114,3578739114,0
0,1128,28662,3578739114,3578739114,0
0,1128,28663,3578739114,3578739114,0
0,1128,28664,3578739114,3578739114,0
0,1128,28665,3578739114,3578739114,0
0,1128,28666,3578739114,3578739114,0
0,1128,28667,3578739114,3578739114,0
0,1128,28668,3578739114,3578739114,0
0,1128,28669,3578739114,3578739114,0
0,1128,28670,3578739114,3578739114,0
0,1128,28671,3578739114,3578739114,0
0,1128,28672,3578739114,3578739115,1
0,1128,28673,3578739114,3578739115,1
0,1128,28674,3578739114,3578739115,1
0,1128,28675,3578739114,3578739115,1
0,1128,28676,3578739114,3578739116,2
0,1128,28677,3578739114,3578739116,2
0,1128,28678,3578739114,3578739116,2
0,1128,28679,3578739114,3578739117,3
0,1128,28680,3578739114,3578739117,3
0,1128,28681,3578739114,3578739117,3
0,1128,28682,3578739114,3578739118,4
0,1128,28683,3578739114,3578739119,5
0,1128,28684,3578739114,3578739120,6
0,1128,28685,3578739114,3578739121,7
0,1128,28686,3578739114,3578739122,8
0,1128,28687,3578739114,3578739123,9
0,1128,28688,3578739114,3578739123,9
0,1128,28689,3578739114,3578739123,9
0,1128,28690,3578739114,3578739124,10
0,1128,28691,3578739114,3578739125,11
0,1128,28692,3578739114,3578739127,13
0,1128,28693,3578739114,3578739128,14
0,1128,28694,3578739114,3578739128,14
0,1128,28695,3578739114,3578739130,16
0,1128,28696,3578739114,3578739131,17
0,1128,28697,3578739114,3578739131,17
0,1128,28698,3578739114,3578739131,17
0,1128,28699,3578739114,3578739132,18
0,1128,28700,3578739114,3578739134,20
0,1128,28701,3578739114,3578739136,22
0,1128,28702,3578739114,3578739138,24
0,1128,28703,3578739114,3578739139,25
0,1128,28704,3578739114,3578739139,25
0,1128,28705,3578739114,3578739140,26
0,1128,28706,3578739114,3578739140,26
0,1128,28707,3578739114,3578739141,27
0,1128,28708,3578739114,3578739142,28
0,1128,28709,3578739114,3578739142,28
0,1128,28710,3578739114,3578739142,28
0,1128,28711,3578739114,3578739143,29
0,1128,28712,3578739114,3578739143,29
0,1128,28713,3578739114,3578739143,29
0,1128,28714,3578739114,3578739144,30
0,1128,28715,3578739114,3578739144,30
0,1128,28716,3578739114,3578739145,31
0,1128,28717,3578739114,3578739145,31
0,1128,28718,3578739114,3578739147,33
0,1128,28719,3578739114,3578739147,33
0,1128,28720,3578739114,3578739148,34
0,1128,28721,3578739114,3578739149,35
0,1128,28722,3578739114,3578739151,37
0,1128,28723,3578739114,3578739153,39
0,1128,28724,3578739114,3578739154,40
0,1128,28725,3578739114,3578739154,40
0,1128,28726,3578739114,3578739155,41
0,1128,28727,3578739114,3578739155,41
0,1128,28728,3578739114,3578739156,42
0,1128,28729,3578739114,3578739158,44
0,1128,28730,3578739114,3578739158,44
0,1128,28731,3578739114,3578739159,45
0,1128,28732,3578739114,3578739159,45
0,1128,28733,3578739114,3578739160,46
0,1128,28734,3578739114,3578739161,47
0,1128,28735,3578739114,3578739161,47
0,1128,28736,3578739114,3578739162,48
0,1128,28737,3578739114,3578739163,49
0,1128,28738,3578739114,3578739164,50
0,1129,28739,3578739178,3578739178,0
0,1129,28740,3578739178,3578739178,0
0,1129,28741,3578739178,3578739178,0
0,1129,28742,3578739178,3578739178,0
0,1129,28743,3578739178,3578739178,0
0,1129,28744,3578739178,3578739178,0
0,1129,28745,3578739178,3578739178,0
0,1129,28746,3578739178,3578739178,0
0,1129,28747,3578739178,3578739178,0
0,1129,28748,3578739178,3578739178,0
0,1129,28749,3578739178,3578739178,0
0,1129,28750,3578739178,3578739178,0
0,1129,28751,3578739178,3578739178,0
0,1129,28752,3578739178,3578739178,0
0,1129,28753,3578739178,3578739178,0
0,1129,28754,3578739178,3578739179,1
0,1129,28755,3578739178,3578739179,1
0,1129,28756,3578739178,3578739180,2
0,1129,28757,3578739178,3578739181,3
0,1129,28758,3578739178,3578739181,3
0,1129,28759,3578739178,3578739182,4
0,1129,28760,3578739178,3578739182,4
0,1129,28761,3578739178,3578739185,7
0,1129,28762,3578739178,3578739185,7
0,1129,28763,3578739178,3578739188,10
0,1129,28764,3578739178,3578739190,12
0,1129,28765,3578739178,3578739190,12
0,1129,28766,3578739178,3578739190,12
0,1129,28767,3578739178,3578739190,12
0,1129,28768,3578739178,3578739190,12
0,1129,28769,3578739178,3578739192,14
0,1129,28770,3578739178,3578739194,16
0,1129,28771,3578739178,3578739194,16
0,1129,28772,3578739178,3578739195,17
0,1129,28773,3578739178,3578739195,17
0,1129,28774,3578739178,3578739195,17
0,1129,28775,3578739178,3578739198,20
0,1129,28776,3578739178,3578739201,23
0,1129,28777,3578739178,3578739202,24
0,1129,28778,3578739178,3578739203,25
0,1129,28779,3578739178,3578739205,27
0,1129,28780,3578739178,3578739205,27
0,1129,28781,3578739178,3578739205,27
0,1129,28782,3578739178,3578739205,27
0,1129,28783,3578739178,3578739207,29
0,1129,28784,3578739178,3578739209,31
0,1129,28785,3578739178,3578739209,31
0,1129,28786,3578739178,3578739209,31
0,1129,28787,3578739178,3578739209,31
0,1129,28788,3578739178,3578739210,32
0,1129,28789,3578739178,3578739210,32
0,1129,28790,3578739178,3578739211,33
0,1129,28791,3578739178,3578739212,34
0,1129,28792,3578739178,3578739214,36
0,1129,28793,3578739178,3578739214,36
0,1129,28794,3578739178,3578739215,37
0,1129,28795,3578739178,3578739216,38
0,1129,28796,3578739178,3578739218,40
0,1129,28797,3578739178,3578739218,40
0,1129,28798,3578739178,3578739219,41
0,1129,28799,3578739178,3578739219,41
0,1129,28800,3578739178,3578739220,42
0,1129,28801,3578739178,3578739223,45
0,1129,28802,3578739178,3578739223,45
0,1129,28803,3578739178,3578739223,45
0,1129,28804,3578739178,3578739225,47
0,1129,28805,3578739178,3578739226,48
0,1129,28806,3578739178,3578739227,49
0,1130,28807,3578739238,3578739238,0
0,1130,28808,3578739238,3578739238,0
0,1130,28809,3578739238,3578739238,0
0,1130,28810,3578739238,3578739238,0
0,1130,28811,3578739238,3578739238,0
0,1130,28812,3578739238,3578739238,0
0,1130,28813,3578739238,3578739238,0
0,1130,28814,3578739238,3578739238,0
0,1130,28815,3578739238,3578739239,1
0,1130,28816,3578739238,3578739240,2
0,1130,28817,3578739238,3578739242,4
0,1130,28818,3578739238,3578739243,5
0,1130,28819,3578739238,3578739243,5
0,1130,28820,3578739238,3578739244,6
0,1130,28821,3578739238,3578739246,8
0,1130,28822,3578739238,3578739246,8
0,1130,28823,3578739238,3578739247,9
0,1130,28824,3578739238,3578739248,10
0,1130,28825,3578739238,3578739249,11
0,1130,28826,3578739238,3578739249,11
0,1130,28827,3578739238,3578739249,11
0,1130,28828,3578739238,3578739250,12
0,1130,28829,3578739238,3578739250,12
0,1130,28830,3578739238,3578739252,14
0,1130,28831,3578739238,3578739255,17
0,1130,28832,3578739238,3578739256,18
0,1130,28833,3578739238,3578739258,20
0,1130,28834,3578739238,3578739259,21
0,1130,28835,3578739238,3578739261,23
0,1130,28836,3578739238,3578739261,23
0,1130,28837,3578739238,3578739262,24
0,1130,28838,3578739238,3578739263,25
0,1130,28839,3578739238,3578739264,26
0,1130,28840,3578739238,3578739264,26
0,1130,28841,3578739238,3578739265,27
0,1130,28842,3578739238,3578739266,28
0,1130,28843,3578739238,3578739268,30
0,1130,28844,3578739238,3578739268,30
0,1130,28845,3578739238,3578739269,31
0,1130,28846,3578739238,3578739269,31
0,1130,28847,3578739238,3578739275,37
0,1130,28848,3578739238,3578739277,39
0,1130,28849,3578739238,3578739277,39
0,1130,28850,3578739238,3578739280,42
0,1130,28851,3578739238,3578739280,42
0,1130,28852,3578739238,3578739281,43
0,1130,28853,3578739238,3578739281,43
0,1130,28854,3578739238,3578739282,44
0,1130,28855,3578739238,3578739282,44
0,1130,28856,3578739238,3578739282,44
0,1130,28857,3578739238,3578739282,44
0,1130,28858,3578739238,3578739283,45
0,1130,28859,3578739238,3578739283,45
0,1130,28860,3578739238,3578739285,47
0,1130,28861,3578739238,3578739287,49
0,1130,28862,3578739238,3578739287,49
0,1130,28863,3578739238,3578739288,50
0,1131,28864,3578739298,3578739298,0
0,1131,28865,3578739298,3578739298,0
0,1131,28866,3578739298,3578739298,0
0,1131,28867,3578739298,3578739298,0
0,1131,28868,3578739298,3578739298,0
0,1131,28869,3578739298,3578739298,0
0,1131,28870,3578739298,3578739298,0
0,1131,28871,3578739298,3578739298,0
0,1131,28872,3578739298,3578739298,0
0,1131,28873,3578739298,3578739299,1
0,1131,28874,3578739298,3578739299,1
0,1131,28875,3578739298,3578739299,1
0,1131,28876,3578739298,3578739300,2
0,1131,28877,3578739298,3578739300,2
0,1131,28878,3578739298,3578739301,3
0,1131,28879,3578739298,3578739303,5
0,1131,28880,3578739298,3578739303,5
0,1131,28881,3578739298,3578739304,6
0,1131,28882,3578739298,3578739305,7
0,1131,28883,3578739298,3578739306,8
0,1131,28884,3578739298,3578739306,8
0,1131,28885,3578739298,3578739306,8
0,1131,28886,3578739298,3578739307,9
0,1131,28887,3578739298,3578739307,9
0,1131,28888,3578739298,3578739307,9
0,1131,28889,3578739298,3578739308,10
0,1131,28890,3578739298,3578739308,10
0,1131,28891,3578739298,3578739309,11
0,1131,28892,3578739298,3578739309,11
0,1131,28893,3578739298,3578739311,13
0,1131,28894,3578739298,3578739313,15
0,1131,28895,3578739298,3578739313,15
0,1131,28896,3578739298,3578739314,16
0,1131,28897,3578739298,3578739315,17
0,1131,28898,3578739298,3578739316,18
0,1131,28899,3578739298,3578739316,18
0,1131,28900,3578739298,3578739316,18
0,1131,28901,3578739298,3578739316,18
0,1131,28902,3578739298,3578739316,18
0,1131,28903,3578739298,3578739317,19
0,1131,28904,3578739298,3578739317,19
0,1131,28905,3578739298,3578739318,20
0,1131,28906,3578739298,3578739319,21
0,1131,28907,3578739298,3578739320,22
0,1131,28908,3578739298,3578739321,23
0,1131,28909,3578739298,3578739322,24
0,1131,28910,3578739298,3578739322,24
0,1131,28911,3578739298,3578739323,25
0,1131,28912,3578739298,3578739323,25
0,1131,28913,3578739298,3578739324,26
0,1131,28914,3578739298,3578739325,27
0,1131,28915,3578739298,3578739327,29
0,1131,28916,3578739298,3578739328,30
0,1131,28917,3578739298,3578739328,30
0,1131,28918,3578739298,3578739331,33
0,1131,28919,3578739298,3578739331,33
0,1131,28920,3578739298,3578739331,33
0,1131,28921,3578739298,3578739331,33
0,1131,28922,3578739298,3578739331,33
0,1131,28923,3578739298,3578739334,36
0,1131,28924,3578739298,3578739338,40
0,1131,28925,3578739298,3578739339,41
0,1131,28926,3578739298,3578739340,42
0,1131,28927,3578739298,3578739341,43
0,1131,28928,3578739298,3578739341,43
0,1131,28929,3578739298,3578739341,43
0,1131,28930,3578739298,3578739342,44
0,1131,28931,3578739298,3578739342,44
0,1131,28932,3578739298,3578739343,45
0,1131,28933,3578739298,3578739343,45
0,1131,28934,3578739298,3578739343,45
0,1131,28935,3578739298,3578739344,46
0,1131,28936,3578739298,3578739344,46
0,1131,28937,3578739298,3578739344,46
0,1131,28938,3578739298,3578739344,46
0,1131,28939,3578739298,3578739346,48
0,1131,28940,3578739298,3578739347,49
0,1131,28941,3578739298,3578739348,50
0,1132,28942,3578739360,3578739360,0
0,1132,28943,3578739360,3578739360,0
0,1132,28944,3578739360,3578739360,0
0,1132,28945,3578739360,3578739360,0
0,1132,28946,3578739360,3578739360,0
0,1132,28947,3578739360,3578739360,0
0,1132,28948,3578739360,3578739360,0
0,1132,28949,3578739360,3578739360,0
0,1132,28950,3578739360,3578739360,0
0,1132,28951,3578739360,3578739360,0
0,1132,28952,3578739360,3578739360,0
0,1132,28953,3578739360,3578739360,0
0,1132,28954,3578739360,3578739360,0
0,1132,28955,3578739360,3578739360,0
0,1132,28956,3578739360,3578739360,0
0,1132,28957,3578739360,3578739360,0
0,1132,28958,3578739360,3578739361,1
0,1132,28959,3578739360,3578739362,2
0,1132,28960,3578739360,3578739362,2
0,1132,28961,3578739360,3578739364,4
0,1132,28962,3578739360,3578739364,4
0,1132,28963,3578739360,3578739365,5
0,1132,28964,3578739360,3578739366,6
0,1132,28965,3578739360,3578739366,6
0,1132,28966,3578739360,3578739367,7
0,1132,28967,3578739360,3578739368,8
0,1132,28968,3578739360,3578739368,8
0,1132,28969,3578739360,3578739369,9
0,1132,28970,3578739360,3578739371,11
0,1132,28971,3578739360,3578739371,11
0,1132,28972,3578739360,3578739374,14
0,1132,28973,3578739360,3578739374,14
0,1132,28974,3578739360,3578739376,16
0,1132,28975,3578739360,3578739379,19
0,1132,28976,3578739360,3578739379,19
0,1132,28977,3578739360,3578739379,19
0,1132,28978,3578739360,3578739380,20
0,1132,28979,3578739360,3578739381,21
0,1132,28980,3578739360,3578739381,21
0,1132,28981,3578739360,3578739382,22
0,1132,28982,3578739360,3578739382,22
0,1132,28983,3578739360,3578739385,25
0,1132,28984,3578739360,3578739385,25
0,1132,28985,3578739360,3578739388,28
0,1132,28986,3578739360,3578739388,28
0,1132,28987,3578739360,3578739389,29
0,1132,28988,3578739360,3578739390,30
0,1132,28989,3578739360,3578739390,30
0,1132,28990,3578739360,3578739391,31
0,1132,28991,3578739360,3578739391,31
0,1132,28992,3578739360,3578739392,32
0,1132,28993,3578739360,3578739394,34
0,1132,28994,3578739360,3578739394,34
0,1132,28995,3578739360,3578739395,35
0,1132,28996,3578739360,3578739395,35
0,1132,28997,3578739360,3578739397,37
0,1132,28998,3578739360,3578739401,41
0,1132,28999,3578739360,3578739401,41
0,1132,29000,3578739360,3578739402,42
0,1132,29001,3578739360,3578739404,44
0,1132,29002,3578739360,3578739404,44
0,1132,29003,3578739360,3578739405,45
0,1132,29004,3578739360,3578739405,45
0,1132,29005,3578739360,3578739406,46
0,1132,29006,3578739360,3578739406,46
0,1132,29007,3578739360,3578739409,49
0,1132,29008,3578739360,3578739409,49
0,1132,29009,3578739360,3578739409,49
0,1132,29010,3578739360,3578739409,49
0,1132,29011,3578739360,3578739410,50
0,1133,29012,3578739427,3578739427,0
0,1133,29013,3578739427,3578739427,0
0,1133,29014,3578739427,3578739427,0
0,1133,29015,3578739427,3578739427,0
0,1133,29016,3578739427,3578739427,0
0,1133,29017,3578739427,3578739427,0
0,1133,29018,3578739427,3578739427,0
0,1133,29019,3578739427,3578739427,0
0,1133,29020,3578739427,3578739427,0
0,1133,29021,3578739427,3578739427,0
0,1133,29022,3578739427,3578739427,0
0,1133,29023,3578739427,3578739427,0
0,1133,29024,3578739427,3578739427,0
0,1133,29025,3578739427,3578739427,0
0,1133,29026,3578739427,3578739427,0
0,1133,29027,3578739427,3578739427,0
0,1133,29028,3578739427,3578739427,0
0,1133,29029,3578739427,3578739427,0
0,1133,29030,3578739427,3578739427,0
0,1133,29031,3578739427,3578739428,1
0,1133,29032,3578739427,3578739430,3
0,1133,29033,3578739427,3578739430,3
0,1133,29034,3578739427,3578739431,4
0,1133,29035,3578739427,3578739433,6
0,1133,29036,3578739427,3578739435,8
0,1133,29037,3578739427,3578739438,11
0,1133,29038,3578739427,3578739438,11
0,1133,29039,3578739427,3578739439,12
0,1133,29040,3578739427,3578739439,12
0,1133,29041,3578739427,3578739440,13
0,1133,29042,3578739427,3578739441,14
0,1133,29043,3578739427,3578739442,15
0,1133,29044,3578739427,3578739443,16
0,1133,29045,3578739427,3578739443,16
0,1133,29046,3578739427,3578739444,17
0,1133,29047,3578739427,3578739444,17
0,1133,29048,3578739427,3578739447,20
0,1133,29049,3578739427,3578739447,20
0,1133,29050,3578739427,3578739447,20
0,1133,29051,3578739427,3578739448,21
0,1133,29052,3578739427,3578739449,22
0,1133,29053,3578739427,3578739449,22
0,1133,29054,3578739427,3578739450,23
0,1133,29055,3578739427,3578739450,23
0,1133,29056,3578739427,3578739450,23
0,1133,29057,3578739427,3578739451,24
0,1133,29058,3578739427,3578739453,26
0,1133,29059,3578739427,3578739455,28
0,1133,29060,3578739427,3578739456,29
0,1133,29061,3578739427,3578739456,29
0,1133,29062,3578739427,3578739457,30
0,1133,29063,3578739427,3578739457,30
0,1133,29064,3578739427,3578739459,32
0,1133,29065,3578739427,3578739461,34
0,1133,29066,3578739427,3578739462,35
0,1133,29067,3578739427,3578739462,35
0,1133,29068,3578739427,3578739463,36
0,1133,29069,3578739427,3578739464,37
0,1133,29070,3578739427,3578739464,37
0,1133,29071,3578739427,3578739465,38
0,1133,29072,3578739427,3578739466,39
0,1133,29073,3578739427,3578739468,41
0,1133,29074,3578739427,3578739469,42
0,1133,29075,3578739427,3578739469,42
0,1133,29076,3578739427,3578739475,48
0,1133,29077,3578739427,3578739477,50
0,1134,29078,3578739490,3578739490,0
0,1134,29079,3578739490,3578739490,0
0,1134,29080,3578739490,3578739490,0
0,1134,29081,3578739490,3578739490,0
0,1134,29082,3578739490,3578739490,0
0,1134,29083,3578739490,3578739490,0
0,1134,29084,3578739490,3578739490,0
0,1134,29085,3578739490,3578739490,0
0,1134,29086,3578739490,3578739490,0
0,1134,29087,3578739490,3578739490,0
0,1134,29088,3578739490,3578739490,0
0,1134,29089,3578739490,3578739490,0
0,1134,29090,3578739490,3578739490,0
0,1134,29091,3578739490,3578739490,0
0,1134,29092,3578739490,3578739490,0
0,1134,29093,3578739490,3578739490,0
0,1134,29094,3578739490,3578739490,0
0,1134,29095,3578739490,3578739490,0
0,1134,29096,3578739490,3578739490,0
0,1134,29097,3578739490,3578739490,0
0,1134,29098,3578739490,3578739490,0
0,1134,29099,3578739490,3578739490,0
0,1134,29100,3578739490,3578739490,0
0,1134,29101,3578739490,3578739492,2
0,1134,29102,3578739490,3578739493,3
0,1134,29103,3578739490,3578739497,7
0,1134,29104,3578739490,3578739497,7
0,1134,29105,3578739490,3578739498,8
0,1134,29106,3578739490,3578739498,8
0,1134,29107,3578739490,3578739498,8
0,1134,29108,3578739490,3578739499,9
0,1134,29109,3578739490,3578739499,9
0,1134,29110,3578739490,3578739501,11
0,1134,29111,3578739490,3578739502,12
0,1134,29112,3578739490,3578739502,12
0,1134,29113,3578739490,3578739503,13
0,1134,29114,3578739490,3578739505,15
0,1134,29115,3578739490,3578739505,15
0,1134,29116,3578739490,3578739506,16
0,1134,29117,3578739490,3578739506,16
0,1134,29118,3578739490,3578739506,16
0,1134,29119,3578739490,3578739506,16
0,1134,29120,3578739490,3578739507,17
0,1134,29121,3578739490,3578739507,17
0,1134,29122,3578739490,3578739507,17
0,1134,29123,3578739490,3578739508,18
0,1134,29124,3578739490,3578739508,18
0,1134,29125,3578739490,3578739509,19
0,1134,29126,3578739490,3578739510,20
0,1134,29127,3578739490,3578739512,22
0,1134,29128,3578739490,3578739513,23
0,1134,29129,3578739490,3578739513,23
0,1134,29130,3578739490,3578739514,24
0,1134,29131,3578739490,3578739515,25
0,1134,29132,3578739490,3578739515,25
0,1134,29133,3578739490,3578739516,26
0,1134,29134,3578739490,3578739516,26
0,1134,29135,3578739490,3578739516,26
0,1134,29136,3578739490,3578739518,28
0,1134,29137,3578739490,3578739518,28
0,1134,29138,3578739490,3578739521,31
0,1134,29139,3578739490,3578739521,31
0,1134,29140,3578739490,3578739522,32
0,1134,29141,3578739490,3578739522,32
0,1134,29142,3578739490,3578739522,32
0,1134,29143,3578739490,3578739522,32
0,1134,29144,3578739490,3578739523,33
0,1134,29145,3578739490,3578739525,35
0,1134,29146,3578739490,3578739527,37
0,1134,29147,3578739490,3578739527,37
0,1134,29148,3578739490,3578739530,40
0,1134,29149,3578739490,3578739530,40
0,1134,29150,3578739490,3578739530,40
0,1134,29151,3578739490,3578739530,40
0,1134,29152,3578739490,3578739531,41
0,1134,29153,3578739490,3578739532,42
0,1134,29154,3578739490,3578739535,45
0,1134,29155,3578739490,3578739535,45
0,1134,29156,3578739490,3578739537,47
0,1134,29157,3578739490,3578739539,49
0,1134,29158,3578739490,3578739539,49
0,1134,29159,3578739490,3578739540,50
0,1135,29160,3578739551,3578739551,0
0,1135,29161,3578739551,3578739551,0
0,1135,29162,3578739551,3578739551,0
0,1135,29163,3578739551,3578739551,0
0,1135,29164,3578739551,3578739551,0
0,1135,29165,3578739551,3578739551,0
0,1135,29166,3578739551,3578739551,0
0,1135,29167,3578739551,3578739551,0
0,1135,29168,3578739551,3578739551,0
0,1135,29169,3578739551,3578739551,0
0,1135,29170,3578739551,3578739551,0
0,1135,29171,3578739551,3578739551,0
0,1135,29172,3578739551,3578739551,0
0,1135,29173,3578739551,3578739551,0
0,1135,29174,3578739551,3578739551,0
0,1135,29175,3578739551,3578739551,0
0,1135,29176,3578739551,3578739551,0
0,1135,29177,3578739551,3578739551,0
0,1135,29178,3578739551,3578739551,0
0,1135,29179,3578739551,3578739551,0
0,1135,29180,3578739551,3578739553,2
0,1135,29181,3578739551,3578739555,4
0,1135,29182,3578739551,3578739555,4
0,1135,29183,3578739551,3578739555,4
0,1135,29184,3578739551,3578739555,4
0,1135,29185,3578739551,3578739555,4
0,1135,29186,3578739551,3578739557,6
0,1135,29187,3578739551,3578739557,6
0,1135,29188,3578739551,3578739558,7
0,1135,29189,3578739551,3578739560,9
0,1135,29190,3578739551,3578739560,9
0,1135,29191,3578739551,3578739560,9
0,1135,29192,3578739551,3578739560,9
0,1135,29193,3578739551,3578739561,10
0,1135,29194,3578739551,3578739561,10
0,1135,29195,3578739551,3578739562,11
0,1135,29196,3578739551,3578739563,12
0,1135,29197,3578739551,3578739563,12
0,1135,29198,3578739551,3578739564,13
0,1135,29199,3578739551,3578739565,14
0,1135,29200,3578739551,3578739565,14
0,1135,29201,3578739551,3578739566,15
0,1135,29202,3578739551,3578739566,15
0,1135,29203,3578739551,3578739567,16
0,1135,29204,3578739551,3578739568,17
0,1135,29205,3578739551,3578739570,19
0,1135,29206,3578739551,3578739572,21
0,1135,29207,3578739551,3578739573,22
0,1135,29208,3578739551,3578739574,23
0,1135,29209,3578739551,3578739575,24
0,1135,29210,3578739551,3578739576,25
0,1135,29211,3578739551,3578739578,27
0,1135,29212,3578739551,3578739578,27
0,1135,29213,3578739551,3578739579,28
0,1135,29214,3578739551,3578739579,28
0,1135,29215,3578739551,3578739581,30
0,1135,29216,3578739551,3578739581,30
0,1135,29217,3578739551,3578739582,31
0,1135,29218,3578739551,3578739584,33
0,1135,29219,3578739551,3578739585,34
0,1135,29220,3578739551,3578739588,37
0,1135,29221,3578739551,3578739588,37
0,1135,29222,3578739551,3578739589,38
0,1135,29223,3578739551,3578739590,39
0,1135,29224,3578739551,3578739590,39
0,1135,29225,3578739551,3578739590,39
0,1135,29226,3578739551,3578739590,39
0,1135,29227,3578739551,3578739592,41
0,1135,29228,3578739551,3578739594,43
0,1135,29229,3578739551,3578739594,43
0,1135,29230,3578739551,3578739595,44
0,1135,29231,3578739551,3578739596,45
0,1135,29232,3578739551,3578739600,49
0,1136,29233,3578739613,3578739613,0
0,1136,29234,3578739613,3578739613,0
0,1136,29235,3578739613,3578739613,0
0,1136,29236,3578739613,3578739613,0
0,1136,29237,3578739613,3578739613,0
0,1136,29238,3578739613,3578739613,0
0,1136,29239,3578739613,3578739613,0
0,1136,29240,3578739613,3578739613,0
0,1136,29241,3578739613,3578739613,0
0,1136,29242,3578739613,3578739613,0
0,1136,29243,3578739613,3578739613,0
0,1136,29244,3578739613,3578739613,0
0,1136,29245,3578739613,3578739613,0
0,1136,29246,3578739613,3578739613,0
0,1136,29247,3578739613,3578739613,0
0,1136,29248,3578739613,3578739613,0
0,1136,29249,3578739613,3578739614,1
0,1136,29250,3578739613,3578739615,2
0,1136,29251,3578739613,3578739615,2
0,1136,29252,3578739613,3578739615,2
0,1136,29253,3578739613,3578739617,4
0,1136,29254,3578739613,3578739618,5
0,1136,29255,3578739613,3578739618,5
0,1136,29256,3578739613,3578739619,6
0,1136,29257,3578739613,3578739619,6
0,1136,29258,3578739613,3578739621,8
0,1136,29259,3578739613,3578739621,8
0,1136,29260,3578739613,3578739622,9
0,1136,29261,3578739613,3578739623,10
0,1136,29262,3578739613,3578739625,12
0,1136,29263,3578739613,3578739627,14
0,1136,29264,3578739613,3578739629,16
0,1136,29265,3578739613,3578739630,17
0,1136,29266,3578739613,3578739631,18
0,1136,29267,3578739613,3578739633,20
0,1136,29268,3578739613,3578739634,21
0,1136,29269,3578739613,3578739637,24
0,1136,29270,3578739613,3578739638,25
0,1136,29271,3578739613,3578739638,25
0,1136,29272,3578739613,3578739639,26
0,1136,29273,3578739613,3578739639,26
0,1136,29274,3578739613,3578739641,28
0,1136,29275,3578739613,3578739642,29
0,1136,29276,3578739613,3578739642,29
0,1136,29277,3578739613,3578739642,29
0,1136,29278,3578739613,3578739643,30
0,1136,29279,3578739613,3578739643,30
0,1136,29280,3578739613,3578739646,33
0,1136,29281,3578739613,3578739646,33
0,1136,29282,3578739613,3578739646,33
0,1136,29283,3578739613,3578739647,34
0,1136,29284,3578739613,3578739648,35
0,1136,29285,3578739613,3578739648,35
0,1136,29286,3578739613,3578739648,35
0,1136,29287,3578739613,3578739649,36
0,1136,29288,3578739613,3578739649,36
0,1136,29289,3578739613,3578739651,38
0,1136,29290,3578739613,3578739652,39
0,1136,29291,3578739613,3578739656,43
0,1136,29292,3578739613,3578739656,43
0,1136,29293,3578739613,3578739657,44
0,1136,29294,3578739613,3578739657,44
0,1136,29295,3578739613,3578739659,46
0,1136,29296,3578739613,3578739660,47
0,1136,29297,3578739613,3578739661,48
0,1136,29298,3578739613,3578739662,49
0,1136,29299,3578739613,3578739662,49
0,1136,29300,3578739613,3578739663,50
0,1137,29301,3578739674,3578739675,1
0,1137,29302,3578739674,3578739675,1
0,1137,29303,3578739674,3578739675,1
0,1137,29304,3578739674,3578739675,1
0,1137,29305,3578739674,3578739675,1
0,1137,29306,3578739674,3578739675,1
0,1137,29307,3578739674,3578739675,1
0,1137,29308,3578739674,3578739675,1
0,1137,29309,3578739674,3578739677,3
0,1137,29310,3578739674,3578739677,3
0,1137,29311,3578739674,3578739677,3
0,1137,29312,3578739674,3578739680,6
0,1137,29313,3578739674,3578739680,6
0,1137,29314,3578739674,3578739681,7
0,1137,29315,3578739674,3578739681,7
0,1137,29316,3578739674,3578739682,8
0,1137,29317,3578739674,3578739682,8
0,1137,29318,3578739674,3578739683,9
0,1137,29319,3578739674,3578739683,9
0,1137,29320,3578739674,3578739683,9
0,1137,29321,3578739674,3578739683,9
0,1137,29322,3578739674,3578739684,10
0,1137,29323,3578739674,3578739685,11
0,1137,29324,3578739674,3578739686,12
0,1137,29325,3578739674,3578739688,14
0,1137,29326,3578739674,3578739688,14
0,1137,29327,3578739674,3578739688,14
0,1137,29328,3578739674,3578739689,15
0,1137,29329,3578739674,3578739689,15
0,1137,29330,3578739674,3578739690,16
0,1137,29331,3578739674,3578739690,16
0,1137,29332,3578739674,3578739690,16
0,1137,29333,3578739674,3578739694,20
0,1137,29334,3578739674,3578739697,23
0,1137,29335,3578739674,3578739697,23
0,1137,29336,3578739674,3578739698,24
0,1137,29337,3578739674,3578739698,24
0,1137,29338,3578739674,3578739699,25
0,1137,29339,3578739674,3578739699,25
0,1137,29340,3578739674,3578739702,28
0,1137,29341,3578739674,3578739702,28
0,1137,29342,3578739674,3578739702,28
0,1137,29343,3578739674,3578739705,31
0,1137,29344,3578739674,3578739705,31
0,1137,29345,3578739674,3578739706,32
0,1137,29346,3578739674,3578739706,32
0,1137,29347,3578739674,3578739706,32
0,1137,29348,3578739674,3578739706,32
0,1137,29349,3578739674,3578739707,33
0,1137,29350,3578739674,3578739708,34
0,1137,29351,3578739674,3578739708,34
0,1137,29352,3578739674,3578739708,34
0,1137,29353,3578739674,3578739708,34
0,1137,29354,3578739674,3578739710,36
0,1137,29355,3578739674,3578739712,38
0,1137,29356,3578739674,3578739713,39
0,1137,29357,3578739674,3578739714,40
0,1137,29358,3578739674,3578739715,41
0,1137,29359,3578739674,3578739715,41
0,1137,29360,3578739674,3578739715,41
0,1137,29361,3578739674,3578739715,41
0,1137,29362,3578739674,3578739716,42
0,1137,29363,3578739674,3578739717,43
0,1137,29364,3578739674,3578739717,43
0,1137,29365,3578739674,3578739717,43
0,1137,29366,3578739674,3578739717,43
0,1137,29367,3578739674,3578739718,44
0,1137,29368,3578739674,3578739721,47
0,1137,29369,3578739674,3578739722,48
0,1137,29370,3578739674,3578739722,48
0,1137,29371,3578739674,3578739722,48
0,1137,29372,3578739674,3578739723,49
0,1137,29373,3578739674,3578739723,49
0,1138,29374,3578739737,3578739737,0
0,1138,29375,3578739737,3578739737,0
0,1138,29376,3578739737,3578739737,0
0,1138,29377,3578739737,3578739737,0
0,1138,29378,3578739737,3578739737,0
0,1138,29379,3578739737,3578739737,0
0,1138,29380,3578739737,3578739737,0
0,1138,29381,3578739737,3578739737,0
0,1138,29382,3578739737,3578739737,0
0,1138,29383,3578739737,3578739737,0
0,1138,29384,3578739737,3578739737,0
0,1138,29385,3578739737,3578739738,1
0,1138,29386,3578739737,3578739740,3
0,1138,29387,3578739737,3578739740,3
0,1138,29388,3578739737,3578739740,3
0,1138,29389,3578739737,3578739741,4
0,1138,29390,3578739737,3578739742,5
0,1138,29391,3578739737,3578739743,6
0,1138,29392,3578739737,3578739743,6
0,1138,29393,3578739737,3578739743,6
0,1138,29394,3578739737,3578739743,6
0,1138,29395,3578739737,3578739744,7
0,1138,29396,3578739737,3578739744,7
0,1138,29397,3578739737,3578739744,7
0,1138,29398,3578739737,3578739745,8
0,1138,29399,3578739737,3578739746,9
0,1138,29400,3578739737,3578739746,9
0,1138,29401,3578739737,3578739746,9
0,1138,29402,3578739737,3578739747,10
0,1138,29403,3578739737,3578739747,10
0,1138,29404,3578739737,3578739747,10
0,1138,29405,3578739737,3578739750,13
0,1138,29406,3578739737,3578739751,14
0,1138,29407,3578739737,3578739753,16
0,1138,29408,3578739737,3578739755,18
0,1138,29409,3578739737,3578739755,18
0,1138,29410,3578739737,3578739755,18
0,1138,29411,3578739737,3578739756,19
0,1138,29412,3578739737,3578739757,20
0,1138,29413,3578739737,3578739757,20
0,1138,29414,3578739737,3578739757,20
0,1138,29415,3578739737,3578739759,22
0,1138,29416,3578739737,3578739760,23
0,1138,29417,3578739737,3578739760,23
0,1138,29418,3578739737,3578739761,24
0,1138,29419,3578739737,3578739762,25
0,1138,29420,3578739737,3578739764,27
0,1138,29421,3578739737,3578739764,27
0,1138,29422,3578739737,3578739765,28
0,1138,29423,3578739737,3578739765,28
0,1138,29424,3578739737,3578739766,29
0,1138,29425,3578739737,3578739767,30
0,1138,29426,3578739737,3578739767,30
0,1138,29427,3578739737,3578739768,31
0,1138,29428,3578739737,3578739770,33
0,1138,29429,3578739737,3578739770,33
0,1138,29430,3578739737,3578739772,35
0,1138,29431,3578739737,3578739772,35
0,1138,29432,3578739737,3578739772,35
0,1138,29433,3578739737,3578739774,37
0,1138,29434,3578739737,3578739774,37
0,1138,29435,3578739737,3578739774,37
0,1138,29436,3578739737,3578739776,39
0,1138,29437,3578739737,3578739776,39
0,1138,29438,3578739737,3578739778,41
0,1138,29439,3578739737,3578739778,41
0,1138,29440,3578739737,3578739779,42
0,1138,29441,3578739737,3578739779,42
0,1138,29442,3578739737,3578739781,44
0,1138,29443,3578739737,3578739781,44
0,1138,29444,3578739737,3578739781,44
0,1138,29445,3578739737,3578739782,45
0,1138,29446,3578739737,3578739784,47
0,1138,29447,3578739737,3578739785,48
0,1139,29448,3578739799,3578739799,0
0,1139,29449,3578739799,3578739799,0
0,1139,29450,3578739799,3578739799,0
0,1139,29451,3578739799,3578739799,0
0,1139,29452,3578739799,3578739799,0
0,1139,29453,3578739799,3578739799,0
0,1139,29454,3578739799,3578739799,0
0,1139,29455,3578739799,3578739799,0
0,1139,29456,3578739799,3578739799,0
0,1139,29457,3578739799,3578739799,0
0,1139,29458,3578739799,3578739799,0
0,1139,29459,3578739799,3578739799,0
0,1139,29460,3578739799,3578739799,0
0,1139,29461,3578739799,3578739799,0
0,1139,29462,3578739799,3578739799,0
0,1139,29463,3578739799,3578739800,1
0,1139,29464,3578739799,3578739801,2
0,1139,29465,3578739799,3578739802,3
0,1139,29466,3578739799,3578739803,4
0,1139,29467,3578739799,3578739803,4
0,1139,29468,3578739799,3578739804,5
0,1139,29469,3578739799,3578739804,5
0,1139,29470,3578739799,3578739805,6
0,1139,29471,3578739799,3578739805,6
0,1139,29472,3578739799,3578739805,6
0,1139,29473,3578739799,3578739806,7
0,1139,29474,3578739799,3578739806,7
0,1139,29475,3578739799,3578739808,9
0,1139,29476,3578739799,3578739809,10
0,1139,29477,3578739799,3578739809,10
0,1139,29478,3578739799,3578739810,11
0,1139,29479,3578739799,3578739810,11
0,1139,29480,3578739799,3578739810,11
0,1139,29481,3578739799,3578739813,14
0,1139,29482,3578739799,3578739813,14
0,1139,29483,3578739799,3578739814,15
0,1139,29484,3578739799,3578739814,15
0,1139,29485,3578739799,3578739815,16
0,1139,29486,3578739799,3578739815,16
0,1139,29487,3578739799,3578739816,17
0,1139,29488,3578739799,3578739818,19
0,1139,29489,3578739799,3578739818,19
0,1139,29490,3578739799,3578739819,20
0,1139,29491,3578739799,3578739819,20
0,1139,29492,3578739799,3578739819,20
0,1139,29493,3578739799,3578739820,21
0,1139,29494,3578739799,3578739821,22
0,1139,29495,3578739799,3578739822,23
0,1139,29496,3578739799,3578739825,26
0,1139,29497,3578739799,3578739827,28
0,1139,29498,3578739799,3578739829,30
0,1139,29499,3578739799,3578739829,30
0,1139,29500,3578739799,3578739830,31
0,1139,29501,3578739799,3578739831,32
0,1139,29502,3578739799,3578739833,34
0,1139,29503,3578739799,3578739835,36
0,1139,29504,3578739799,3578739836,37
0,1139,29505,3578739799,3578739837,38
0,1139,29506,3578739799,3578739838,39
0,1139,29507,3578739799,3578739839,40
0,1139,29508,3578739799,3578739840,41
0,1139,29509,3578739799,3578739840,41
0,1139,29510,3578739799,3578739840,41
0,1139,29511,3578739799,3578739841,42
0,1139,29512,3578739799,3578739842,43
0,1139,29513,3578739799,3578739843,44
0,1139,29514,3578739799,3578739846,47
0,1139,29515,3578739799,3578739847,48
0,1139,29516,3578739799,3578739847,48
0,1139,29517,3578739799,3578739848,49
0,1139,29518,3578739799,3578739848,49
0,1139,29519,3578739799,3578739849,50
0,1140,29520,3578739861,3578739861,0
0,1140,29521,3578739861,3578739861,0
0,1140,29522,3578739861,3578739861,0
0,1140,29523,3578739861,3578739861,0
0,1140,29524,3578739861,3578739861,0
0,1140,29525,3578739861,3578739861,0
0,1140,29526,3578739861,3578739861,0
0,1140,29527,3578739861,3578739861,0
0,1140,29528,3578739861,3578739861,0
0,1140,29529,3578739861,3578739861,0
0,1140,29530,3578739861,3578739861,0
0,1140,29531,3578739861,3578739862,1
0,1140,29532,3578739861,3578739862,1
0,1140,29533,3578739861,3578739862,1
0,1140,29534,3578739861,3578739863,2
0,1140,29535,3578739861,3578739865,4
0,1140,29536,3578739861,3578739865,4
0,1140,29537,3578739861,3578739866,5
0,1140,29538,3578739861,3578739866,5
0,1140,29539,3578739861,3578739867,6
0,1140,29540,3578739861,3578739868,7
0,1140,29541,3578739861,3578739869,8
0,1140,29542,3578739861,3578739875,14
0,1140,29543,3578739861,3578739876,15
0,1140,29544,3578739861,3578739877,16
0,1140,29545,3578739861,3578739877,16
0,1140,29546,3578739861,3578739878,17
0,1140,29547,3578739861,3578739880,19
0,1140,29548,3578739861,3578739880,19
0,1140,29549,3578739861,3578739881,20
0,1140,29550,3578739861,3578739881,20
0,1140,29551,3578739861,3578739882,21
0,1140,29552,3578739861,3578739882,21
0,1140,29553,3578739861,3578739882,21
0,1140,29554,3578739861,3578739883,22
0,1140,29555,3578739861,3578739883,22
0,1140,29556,3578739861,3578739884,23
0,1140,29557,3578739861,3578739884,23
0,1140,29558,3578739861,3578739885,24
0,1140,29559,3578739861,3578739886,25
0,1140,29560,3578739861,3578739888,27
0,1140,29561,3578739861,3578739888,27
0,1140,29562,3578739861,3578739889,28
0,1140,29563,3578739861,3578739890,29
0,1140,29564,3578739861,3578739890,29
0,1140,29565,3578739861,3578739890,29
0,1140,29566,3578739861,3578739891,30
0,1140,29567,3578739861,3578739891,30
0,1140,29568,3578739861,3578739892,31
0,1140,29569,3578739861,3578739892,31
0,1140,29570,3578739861,3578739893,32
0,1140,29571,3578739861,3578739897,36
0,1140,29572,3578739861,3578739897,36
0,1140,29573,3578739861,3578739898,37
0,1140,29574,3578739861,3578739899,38
0,1140,29575,3578739861,3578739899,38
0,1140,29576,3578739861,3578739899,38
0,1140,29577,3578739861,3578739901,40
0,1140,29578,3578739861,3578739902,41
0,1140,29579,3578739861,3578739902,41
0,1140,29580,3578739861,3578739902,41
0,1140,29581,3578739861,3578739903,42
0,1140,29582,3578739861,3578739904,43
0,1140,29583,3578739861,3578739904,43
0,1140,29584,3578739861,3578739906,45
0,1140,29585,3578739861,3578739906,45
0,1140,29586,3578739861,3578739907,46
0,1140,29587,3578739861,3578739907,46
0,1140,29588,3578739861,3578739907,46
0,1140,29589,3578739861,3578739907,46
0,1140,29590,3578739861,3578739908,47
0,1140,29591,3578739861,3578739909,48
0,1140,29592,3578739861,3578739910,49
0,1140,29593,3578739861,3578739910,49
0,1141,29594,3578739922,3578739922,0
0,1141,29595,3578739922,3578739922,0
0,1141,29596,3578739922,3578739922,0
0,1141,29597,3578739922,3578739922,0
0,1141,29598,3578739922,3578739922,0
0,1141,29599,3578739922,3578739922,0
0,1141,29600,3578739922,3578739922,0
0,1141,29601,3578739922,3578739922,0
0,1141,29602,3578739922,3578739922,0
0,1141,29603,3578739922,3578739922,0
0,1141,29604,3578739922,3578739922,0
0,1141,29605,3578739922,3578739922,0
0,1141,29606,3578739922,3578739922,0
0,1141,29607,3578739922,3578739922,0
0,1141,29608,3578739922,3578739922,0
0,1141,29609,3578739922,3578739922,0
0,1141,29610,3578739922,3578739923,1
0,1141,29611,3578739922,3578739923,1
0,1141,29612,3578739922,3578739923,1
0,1141,29613,3578739922,3578739923,1
0,1141,29614,3578739922,3578739923,1
0,1141,29615,3578739922,3578739927,5
0,1141,29616,3578739922,3578739929,7
0,1141,29617,3578739922,3578739929,7
0,1141,29618,3578739922,3578739930,8
0,1141,29619,3578739922,3578739930,8
0,1141,29620,3578739922,3578739930,8
0,1141,29621,3578739922,3578739931,9
0,1141,29622,3578739922,3578739931,9
0,1141,29623,3578739922,3578739932,10
0,1141,29624,3578739922,3578739932,10
0,1141,29625,3578739922,3578739933,11
0,1141,29626,3578739922,3578739935,13
0,1141,29627,3578739922,3578739937,15
0,1141,29628,3578739922,3578739938,16
0,1141,29629,3578739922,3578739939,17
0,1141,29630,3578739922,3578739939,17
0,1141,29631,3578739922,3578739940,18
0,1141,29632,3578739922,3578739940,18
0,1141,29633,3578739922,3578739941,19
0,1141,29634,3578739922,3578739943,21
0,1141,29635,3578739922,3578739943,21
0,1141,29636,3578739922,3578739943,21
0,1141,29637,3578739922,3578739943,21
0,1141,29638,3578739922,3578739944,22
0,1141,29639,3578739922,3578739944,22
0,1141,29640,3578739922,3578739945,23
0,1141,29641,3578739922,3578739945,23
0,1141,29642,3578739922,3578739946,24
0,1141,29643,3578739922,3578739946,24
0,1141,29644,3578739922,3578739947,25
0,1141,29645,3578739922,3578739947,25
0,1141,29646,3578739922,3578739949,27
0,1141,29647,3578739922,3578739952,30
0,1141,29648,3578739922,3578739952,30
0,1141,29649,3578739922,3578739954,32
0,1141,29650,3578739922,3578739955,33
0,1141,29651,3578739922,3578739955,33
0,1141,29652,3578739922,3578739956,34
0,1141,29653,3578739922,3578739957,35
0,1141,29654,3578739922,3578739957,35
0,1141,29655,3578739922,3578739958,36
0,1141,29656,3578739922,3578739959,37
0,1141,29657,3578739922,3578739960,38
0,1141,29658,3578739922,3578739961,39
0,1141,29659,3578739922,3578739961,39
0,1141,29660,3578739922,3578739962,40
0,1141,29661,3578739922,3578739962,40
0,1141,29662,3578739922,3578739964,42
0,1141,29663,3578739922,3578739964,42
0,1141,29664,3578739922,3578739964,42
0,1141,29665,3578739922,3578739965,43
0,1141,29666,3578739922,3578739966,44
0,1141,29667,3578739922,3578739966,44
0,1141,29668,3578739922,3578739966,44
0,1141,29669,3578739922,3578739967,45
0,1141,29670,3578739922,3578739968,46
0,1141,29671,3578739922,3578739969,47
0,1141,29672,3578739922,3578739970,48
0,1142,29673,3578739984,3578739984,0
0,1142,29674,3578739984,3578739984,0
0,1142,29675,3578739984,3578739984,0
0,1142,29676,3578739984,3578739984,0
0,1142,29677,3578739984,3578739984,0
0,1142,29678,3578739984,3578739984,0
0,1142,29679,3578739984,3578739984,0
0,1142,29680,3578739984,3578739984,0
0,1142,29681,3578739984,3578739984,0
0,1142,29682,3578739984,3578739984,0
0,1142,29683,3578739984,3578739984,0
0,1142,29684,3578739984,3578739984,0
0,1142,29685,3578739984,3578739984,0
0,1142,29686,3578739984,3578739984,0
0,1142,29687,3578739984,3578739984,0
0,1142,29688,3578739984,3578739984,0
0,1142,29689,3578739984,3578739984,0
0,1142,29690,3578739984,3578739985,1
0,1142,29691,3578739984,3578739988,4
0,1142,29692,3578739984,3578739988,4
0,1142,29693,3578739984,3578739989,5
0,1142,29694,3578739984,3578739990,6
0,1142,29695,3578739984,3578739990,6
0,1142,29696,3578739984,3578739992,8
0,1142,29697,3578739984,3578739992,8
0,1142,29698,3578739984,3578739992,8
0,1142,29699,3578739984,3578739993,9
0,1142,29700,3578739984,3578739993,9
0,1142,29701,3578739984,3578739994,10
0,1142,29702,3578739984,3578739995,11
0,1142,29703,3578739984,3578739997,13
0,1142,29704,3578739984,3578739997,13
0,1142,29705,3578739984,3578740000,16
0,1142,29706,3578739984,3578740001,17
0,1142,29707,3578739984,3578740002,18
0,1142,29708,3578739984,3578740003,19
0,1142,29709,3578739984,3578740004,20
0,1142,29710,3578739984,3578740005,21
0,1142,29711,3578739984,3578740005,21
0,1142,29712,3578739984,3578740006,22
0,1142,29713,3578739984,3578740006,22
0,1142,29714,3578739984,3578740006,22
0,1142,29715,3578739984,3578740009,25
0,1142,29716,3578739984,3578740009,25
0,1142,29717,3578739984,3578740010,26
0,1142,29718,3578739984,3578740010,26
0,1142,29719,3578739984,3578740010,26
0,1142,29720,3578739984,3578740011,27
0,1142,29721,3578739984,3578740012,28
0,1142,29722,3578739984,3578740013,29
0,1142,29723,3578739984,3578740014,30
0,1142,29724,3578739984,3578740015,31
0,1142,29725,3578739984,3578740015,31
0,1142,29726,3578739984,3578740015,31
0,1142,29727,3578739984,3578740015,31
0,1142,29728,3578739984,3578740016,32
0,1142,29729,3578739984,3578740018,34
0,1142,29730,3578739984,3578740018,34
0,1142,29731,3578739984,3578740019,35
0,1142,29732,3578739984,3578740019,35
0,1142,29733,3578739984,3578740019,35
0,1142,29734,3578739984,3578740020,36
0,1142,29735,3578739984,3578740021,37
0,1142,29736,3578739984,3578740022,38
0,1142,29737,3578739984,3578740023,39
0,1142,29738,3578739984,3578740025,41
0,1142,29739,3578739984,3578740025,41
0,1142,29740,3578739984,3578740026,42
0,1142,29741,3578739984,3578740027,43
0,1142,29742,3578739984,3578740029,45
0,1142,29743,3578739984,3578740030,46
0,1142,29744,3578739984,3578740031,47
0,1142,29745,3578739984,3578740031,47
0,1142,29746,3578739984,3578740033,49
0,1143,29747,3578740048,3578740048,0
0,1143,29748,3578740048,3578740048,0
0,1143,29749,3578740048,3578740048,0
0,1143,29750,3578740048,3578740048,0
0,1143,29751,3578740048,3578740048,0
0,1143,29752,3578740048,3578740048,0
0,1143,29753,3578740048,3578740048,0
0,1143,29754,3578740048,3578740048,0
0,1143,29755,3578740048,3578740048,0
0,1143,29756,3578740048,3578740048,0
0,1143,29757,3578740048,3578740048,0
0,1143,29758,3578740048,3578740048,0
0,1143,29759,3578740048,3578740048,0
0,1143,29760,3578740048,3578740048,0
0,1143,29761,3578740048,3578740048,0
0,1143,29762,3578740048,3578740048,0
0,1143,29763,3578740048,3578740048,0
0,1143,29764,3578740048,3578740048,0
0,1143,29765,3578740048,3578740049,1
0,1143,29766,3578740048,3578740050,2
0,1143,29767,3578740048,3578740050,2
0,1143,29768,3578740048,3578740051,3
0,1143,29769,3578740048,3578740051,3
0,1143,29770,3578740048,3578740053,5
0,1143,29771,3578740048,3578740056,8
0,1143,29772,3578740048,3578740057,9
0,1143,29773,3578740048,3578740057,9
0,1143,29774,3578740048,3578740057,9
0,1143,29775,3578740048,3578740059,11
0,1143,29776,3578740048,3578740060,12
0,1143,29777,3578740048,3578740062,14
0,1143,29778,3578740048,3578740062,14
0,1143,29779,3578740048,3578740063,15
0,1143,29780,3578740048,3578740063,15
0,1143,29781,3578740048,3578740065,17
0,1143,29782,3578740048,3578740066,18
0,1143,29783,3578740048,3578740066,18
0,1143,29784,3578740048,3578740066,18
0,1143,29785,3578740048,3578740067,19
0,1143,29786,3578740048,3578740068,20
0,1143,29787,3578740048,3578740068,20
0,1143,29788,3578740048,3578740069,21
0,1143,29789,3578740048,3578740075,27
0,1143,29790,3578740048,3578740075,27
0,1143,29791,3578740048,3578740077,29
0,1143,29792,3578740048,3578740078,30
0,1143,29793,3578740048,3578740078,30
0,1143,29794,3578740048,3578740080,32
0,1143,29795,3578740048,3578740081,33
0,1143,29796,3578740048,3578740081,33
0,1143,29797,3578740048,3578740081,33
0,1143,29798,3578740048,3578740082,34
0,1143,29799,3578740048,3578740082,34
0,1143,29800,3578740048,3578740083,35
0,1143,29801,3578740048,3578740083,35
0,1143,29802,3578740048,3578740083,35
0,1143,29803,3578740048,3578740084,36
0,1143,29804,3578740048,3578740084,36
0,1143,29805,3578740048,3578740085,37
0,1143,29806,3578740048,3578740087,39
0,1143,29807,3578740048,3578740087,39
0,1143,29808,3578740048,3578740088,40
0,1143,29809,3578740048,3578740088,40
0,1143,29810,3578740048,3578740088,40
0,1143,29811,3578740048,3578740090,42
0,1143,29812,3578740048,3578740090,42
0,1143,29813,3578740048,3578740090,42
0,1143,29814,3578740048,3578740091,43
0,1143,29815,3578740048,3578740091,43
0,1143,29816,3578740048,3578740092,44
0,1143,29817,3578740048,3578740094,46
0,1143,29818,3578740048,3578740097,49
0,1144,29819,3578740111,3578740111,0
0,1144,29820,3578740111,3578740111,0
0,1144,29821,3578740111,3578740111,0
0,1144,29822,3578740111,3578740111,0
0,1144,29823,3578740111,3578740111,0
0,1144,29824,3578740111,3578740111,0
0,1144,29825,3578740111,3578740111,0
0,1144,29826,3578740111,3578740111,0
0,1144,29827,3578740111,3578740111,0
0,1144,29828,3578740111,3578740111,0
0,1144,29829,3578740111,3578740111,0
0,1144,29830,3578740111,3578740111,0
0,1144,29831,3578740111,3578740111,0
0,1144,29832,3578740111,3578740111,0
0,1144,29833,3578740111,3578740111,0
0,1144,29834,3578740111,3578740111,0
0,1144,29835,3578740111,3578740111,0
0,1144,29836,3578740111,3578740111,0
0,1144,29837,3578740111,3578740111,0
0,1144,29838,3578740111,3578740111,0
0,1144,29839,3578740111,3578740111,0
0,1144,29840,3578740111,3578740114,3
0,1144,29841,3578740111,3578740114,3
0,1144,29842,3578740111,3578740115,4
0,1144,29843,3578740111,3578740116,5
0,1144,29844,3578740111,3578740116,5
0,1144,29845,3578740111,3578740116,5
0,1144,29846,3578740111,3578740116,5
0,1144,29847,3578740111,3578740117,6
0,1144,29848,3578740111,3578740117,6
0,1144,29849,3578740111,3578740117,6
0,1144,29850,3578740111,3578740118,7
0,1144,29851,3578740111,3578740119,8
0,1144,29852,3578740111,3578740119,8
0,1144,29853,3578740111,3578740121,10
0,1144,29854,3578740111,3578740122,11
0,1144,29855,3578740111,3578740122,11
0,1144,29856,3578740111,3578740122,11
0,1144,29857,3578740111,3578740122,11
0,1144,29858,3578740111,3578740123,12
0,1144,29859,3578740111,3578740123,12
0,1144,29860,3578740111,3578740128,17
0,1144,29861,3578740111,3578740129,18
0,1144,29862,3578740111,3578740129,18
0,1144,29863,3578740111,3578740130,19
0,1144,29864,3578740111,3578740130,19
0,1144,29865,3578740111,3578740131,20
0,1144,29866,3578740111,3578740131,20
0,1144,29867,3578740111,3578740132,21
0,1144,29868,3578740111,3578740132,21
0,1144,29869,3578740111,3578740132,21
0,1144,29870,3578740111,3578740136,25
0,1144,29871,3578740111,3578740137,26
0,1144,29872,3578740111,3578740137,26
0,1144,29873,3578740111,3578740139,28
0,1144,29874,3578740111,3578740139,28
0,1144,29875,3578740111,3578740139,28
0,1144,29876,3578740111,3578740139,28
0,1144,29877,3578740111,3578740140,29
0,1144,29878,3578740111,3578740141,30
0,1144,29879,3578740111,3578740142,31
0,1144,29880,3578740111,3578740142,31
0,1144,29881,3578740111,3578740143,32
0,1144,29882,3578740111,3578740143,32
0,1144,29883,3578740111,3578740143,32
0,1144,29884,3578740111,3578740144,33
0,1144,29885,3578740111,3578740144,33
0,1144,29886,3578740111,3578740144,33
0,1144,29887,3578740111,3578740145,34
0,1144,29888,3578740111,3578740146,35
0,1144,29889,3578740111,3578740146,35
0,1144,29890,3578740111,3578740146,35
0,1144,29891,3578740111,3578740147,36
0,1144,29892,3578740111,3578740147,36
0,1144,29893,3578740111,3578740149,38
0,1144,29894,3578740111,3578740152,41
0,1144,29895,3578740111,3578740153,42
0,1144,29896,3578740111,3578740155,44
0,1144,29897,3578740111,3578740155,44
0,1144,29898,3578740111,3578740155,44
0,1144,29899,3578740111,3578740157,46
0,1144,29900,3578740111,3578740157,46
0,1144,29901,3578740111,3578740158,47
0,1144,29902,3578740111,3578740158,47
0,1144,29903,3578740111,3578740159,48
0,1144,29904,3578740111,3578740160,49
0,1145,29905,3578740172,3578740172,0
0,1145,29906,3578740172,3578740172,0
0,1145,29907,3578740172,3578740172,0
0,1145,29908,3578740172,3578740172,0
0,1145,29909,3578740172,3578740172,0
0,1145,29910,3578740172,3578740172,0
0,1145,29911,3578740172,3578740172,0
0,1145,29912,3578740172,3578740172,0
0,1145,29913,3578740172,3578740172,0
0,1145,29914,3578740172,3578740172,0
0,1145,29915,3578740172,3578740172,0
0,1145,29916,3578740172,3578740172,0
0,1145,29917,3578740172,3578740172,0
0,1145,29918,3578740172,3578740172,0
0,1145,29919,3578740172,3578740172,0
0,1145,29920,3578740172,3578740173,1
0,1145,29921,3578740172,3578740174,2
0,1145,29922,3578740172,3578740174,2
0,1145,29923,3578740172,3578740174,2
0,1145,29924,3578740172,3578740175,3
0,1145,29925,3578740172,3578740176,4
0,1145,29926,3578740172,3578740176,4
0,1145,29927,3578740172,3578740177,5
0,1145,29928,3578740172,3578740178,6
0,1145,29929,3578740172,3578740178,6
0,1145,29930,3578740172,3578740179,7
0,1145,29931,3578740172,3578740179,7
0,1145,29932,3578740172,3578740180,8
0,1145,29933,3578740172,3578740181,9
0,1145,29934,3578740172,3578740182,10
0,1145,29935,3578740172,3578740184,12
0,1145,29936,3578740172,3578740185,13
0,1145,29937,3578740172,3578740185,13
0,1145,29938,3578740172,3578740189,17
0,1145,29939,3578740172,3578740189,17
0,1145,29940,3578740172,3578740189,17
0,1145,29941,3578740172,3578740190,18
0,1145,29942,3578740172,3578740190,18
0,1145,29943,3578740172,3578740192,20
0,1145,29944,3578740172,3578740192,20
0,1145,29945,3578740172,3578740193,21
0,1145,29946,3578740172,3578740194,22
0,1145,29947,3578740172,3578740194,22
0,1145,29948,3578740172,3578740194,22
0,1145,29949,3578740172,3578740196,24
0,1145,29950,3578740172,3578740196,24
0,1145,29951,3578740172,3578740198,26
0,1145,29952,3578740172,3578740200,28
0,1145,29953,3578740172,3578740203,31
0,1145,29954,3578740172,3578740203,31
0,1145,29955,3578740172,3578740204,32
0,1145,29956,3578740172,3578740204,32
0,1145,29957,3578740172,3578740205,33
0,1145,29958,3578740172,3578740206,34
0,1145,29959,3578740172,3578740206,34
0,1145,29960,3578740172,3578740206,34
0,1145,29961,3578740172,3578740209,37
0,1145,29962,3578740172,3578740209,37
0,1145,29963,3578740172,3578740210,38
0,1145,29964,3578740172,3578740210,38
0,1145,29965,3578740172,3578740210,38
0,1145,29966,3578740172,3578740211,39
0,1145,29967,3578740172,3578740213,41
0,1145,29968,3578740172,3578740214,42
0,1145,29969,3578740172,3578740214,42
0,1145,29970,3578740172,3578740215,43
0,1145,29971,3578740172,3578740215,43
0,1145,29972,3578740172,3578740215,43
0,1145,29973,3578740172,3578740216,44
0,1145,29974,3578740172,3578740216,44
0,1145,29975,3578740172,3578740219,47
0,1145,29976,3578740172,3578740219,47
0,1145,29977,3578740172,3578740219,47
0,1145,29978,3578740172,3578740219,47
0,1145,29979,3578740172,3578740220,48
0,1145,29980,3578740172,3578740220,48
0,1146,29981,3578740235,3578740236,1
0,1146,29982,3578740235,3578740236,1
0,1146,29983,3578740235,3578740236,1
0,1146,29984,3578740235,3578740236,1
0,1146,29985,3578740235,3578740236,1
0,1146,29986,3578740235,3578740236,1
0,1146,29987,3578740235,3578740236,1
0,1146,29988,3578740235,3578740236,1
0,1146,29989,3578740235,3578740236,1
0,1146,29990,3578740235,3578740238,3
0,1146,29991,3578740235,3578740239,4
0,1146,29992,3578740235,3578740239,4
0,1146,29993,3578740235,3578740240,5
0,1146,29994,3578740235,3578740240,5
0,1146,29995,3578740235,3578740241,6
0,1146,29996,3578740235,3578740242,7
0,1146,29997,3578740235,3578740242,7
0,1146,29998,3578740235,3578740242,7
0,1146,29999,3578740235,3578740243,8
0,1146,30000,3578740235,3578740246,11
0,1146,30001,3578740235,3578740247,12
0,1146,30002,3578740235,3578740247,12
0,1146,30003,3578740235,3578740248,13
0,1146,30004,3578740235,3578740248,13
0,1146,30005,3578740235,3578740249,14
0,1146,30006,3578740235,3578740250,15
0,1146,30007,3578740235,3578740251,16
0,1146,30008,3578740235,3578740251,16
0,1146,30009,3578740235,3578740251,16
0,1146,30010,3578740235,3578740253,18
0,1146,30011,3578740235,3578740255,20
0,1146,30012,3578740235,3578740256,21
0,1146,30013,3578740235,3578740256,21
0,1146,30014,3578740235,3578740256,21
0,1146,30015,3578740235,3578740258,23
0,1146,30016,3578740235,3578740259,24
0,1146,30017,3578740235,3578740260,25
0,1146,30018,3578740235,3578740262,27
0,1146,30019,3578740235,3578740262,27
0,1146,30020,3578740235,3578740263,28
0,1146,30021,3578740235,3578740265,30
0,1146,30022,3578740235,3578740265,30
0,1146,30023,3578740235,3578740266,31
0,1146,30024,3578740235,3578740266,31
0,1146,30025,3578740235,3578740267,32
0,1146,30026,3578740235,3578740267,32
0,1146,30027,3578740235,3578740268,33
0,1146,30028,3578740235,3578740268,33
0,1146,30029,3578740235,3578740269,34
0,1146,30030,3578740235,3578740275,40
0,1146,30031,3578740235,3578740277,42
0,1146,30032,3578740235,3578740278,43
0,1146,30033,3578740235,3578740280,45
0,1146,30034,3578740235,3578740280,45
0,1146,30035,3578740235,3578740281,46
0,1146,30036,3578740235,3578740281,46
0,1146,30037,3578740235,3578740281,46
0,1146,30038,3578740235,3578740282,47
0,1146,30039,3578740235,3578740283,48
0,1146,30040,3578740235,3578740283,48
0,1146,30041,3578740235,3578740283,48
0,1146,30042,3578740235,3578740284,49
0,1146,30043,3578740235,3578740284,49
0,1146,30044,3578740235,3578740284,49
0,1146,30045,3578740235,3578740285,50
0,1147,30046,3578740298,3578740298,0
0,1147,30047,3578740298,3578740298,0
0,1147,30048,3578740298,3578740298,0
0,1147,30049,3578740298,3578740298,0
0,1147,30050,3578740298,3578740298,0
0,1147,30051,3578740298,3578740298,0
0,1147,30052,3578740298,3578740298,0
0,1147,30053,3578740298,3578740298,0
0,1147,30054,3578740298,3578740298,0
0,1147,30055,3578740298,3578740298,0
0,1147,30056,3578740298,3578740298,0
0,1147,30057,3578740298,3578740298,0
0,1147,30058,3578740298,3578740298,0
0,1147,30059,3578740298,3578740298,0
0,1147,30060,3578740298,3578740298,0
0,1147,30061,3578740298,3578740298,0
0,1147,30062,3578740298,3578740298,0
0,1147,30063,3578740298,3578740300,2
0,1147,30064,3578740298,3578740300,2
0,1147,30065,3578740298,3578740301,3
0,1147,30066,3578740298,3578740301,3
0,1147,30067,3578740298,3578740302,4
0,1147,30068,3578740298,3578740302,4
0,1147,30069,3578740298,3578740304,6
0,1147,30070,3578740298,3578740304,6
0,1147,30071,3578740298,3578740304,6
0,1147,30072,3578740298,3578740306,8
0,1147,30073,3578740298,3578740306,8
0,1147,30074,3578740298,3578740306,8
0,1147,30075,3578740298,3578740306,8
0,1147,30076,3578740298,3578740307,9
0,1147,30077,3578740298,3578740307,9
0,1147,30078,3578740298,3578740307,9
0,1147,30079,3578740298,3578740308,10
0,1147,30080,3578740298,3578740309,11
0,1147,30081,3578740298,3578740310,12
0,1147,30082,3578740298,3578740311,13
0,1147,30083,3578740298,3578740313,15
0,1147,30084,3578740298,3578740314,16
0,1147,30085,3578740298,3578740314,16
0,1147,30086,3578740298,3578740314,16
0,1147,30087,3578740298,3578740315,17
0,1147,30088,3578740298,3578740316,18
0,1147,30089,3578740298,3578740316,18
0,1147,30090,3578740298,3578740316,18
0,1147,30091,3578740298,3578740317,19
0,1147,30092,3578740298,3578740317,19
0,1147,30093,3578740298,3578740318,20
0,1147,30094,3578740298,3578740319,21
0,1147,30095,3578740298,3578740319,21
0,1147,30096,3578740298,3578740320,22
0,1147,30097,3578740298,3578740321,23
0,1147,30098,3578740298,3578740322,24
0,1147,30099,3578740298,3578740322,24
0,1147,30100,3578740298,3578740323,25
0,1147,30101,3578740298,3578740323,25
0,1147,30102,3578740298,3578740323,25
0,1147,30103,3578740298,3578740323,25
0,1147,30104,3578740298,3578740328,30
0,1147,30105,3578740298,3578740329,31
0,1147,30106,3578740298,3578740329,31
0,1147,30107,3578740298,3578740330,32
0,1147,30108,3578740298,3578740330,32
0,1147,30109,3578740298,3578740331,33
0,1147,30110,3578740298,3578740331,33
0,1147,30111,3578740298,3578740332,34
0,1147,30112,3578740298,3578740332,34
0,1147,30113,3578740298,3578740333,35
0,1147,30114,3578740298,3578740336,38
0,1147,30115,3578740298,3578740337,39
0,1147,30116,3578740298,3578740337,39
0,1147,30117,3578740298,3578740339,41
0,1147,30118,3578740298,3578740339,41
0,1147,30119,3578740298,3578740340,42
0,1147,30120,3578740298,3578740340,42
0,1147,30121,3578740298,3578740341,43
0,1147,30122,3578740298,3578740342,44
0,1147,30123,3578740298,3578740343,45
0,1147,30124,3578740298,3578740343,45
0,1147,30125,3578740298,3578740343,45
0,1147,30126,3578740298,3578740343,45
0,1147,30127,3578740298,3578740344,46
0,1147,30128,3578740298,3578740345,47
0,1147,30129,3578740298,3578740346,48
0,1147,30130,3578740298,3578740346,48
0,1147,30131,3578740298,3578740346,48
0,1147,30132,3578740298,3578740346,48
0,1147,30133,3578740298,3578740346,48
0,1147,30134,3578740298,3578740346,48
0,1147,30135,3578740298,3578740347,49
0,1147,30136,3578740298,3578740348,50
0,1148,30137,3578740363,3578740363,0
0,1148,30138,3578740363,3578740363,0
0,1148,30139,3578740363,3578740363,0
0,1148,30140,3578740363,3578740363,0
0,1148,30141,3578740363,3578740363,0
0,1148,30142,3578740363,3578740363,0
0,1148,30143,3578740363,3578740363,0
0,1148,30144,3578740363,3578740363,0
0,1148,30145,3578740363,3578740363,0
0,1148,30146,3578740363,3578740363,0
0,1148,30147,3578740363,3578740363,0
0,1148,30148,3578740363,3578740363,0
0,1148,30149,3578740363,3578740363,0
0,1148,30150,3578740363,3578740363,0
0,1148,30151,3578740363,3578740363,0
0,1148,30152,3578740363,3578740363,0
0,1148,30153,3578740363,3578740363,0
0,1148,30154,3578740363,3578740366,3
0,1148,30155,3578740363,3578740366,3
0,1148,30156,3578740363,3578740366,3
0,1148,30157,3578740363,3578740367,4
0,1148,30158,3578740363,3578740368,5
0,1148,30159,3578740363,3578740368,5
0,1148,30160,3578740363,3578740369,6
0,1148,30161,3578740363,3578740369,6
0,1148,30162,3578740363,3578740370,7
0,1148,30163,3578740363,3578740372,9
0,1148,30164,3578740363,3578740374,11
0,1148,30165,3578740363,3578740375,12
0,1148,30166,3578740363,3578740376,13
0,1148,30167,3578740363,3578740376,13
0,1148,30168,3578740363,3578740377,14
0,1148,30169,3578740363,3578740378,15
0,1148,30170,3578740363,3578740379,16
0,1148,30171,3578740363,3578740379,16
0,1148,30172,3578740363,3578740379,16
0,1148,30173,3578740363,3578740380,17
0,1148,30174,3578740363,3578740381,18
0,1148,30175,3578740363,3578740383,20
0,1148,30176,3578740363,3578740383,20
0,1148,30177,3578740363,3578740383,20
0,1148,30178,3578740363,3578740384,21
0,1148,30179,3578740363,3578740385,22
0,1148,30180,3578740363,3578740389,26
0,1148,30181,3578740363,3578740389,26
0,1148,30182,3578740363,3578740390,27
0,1148,30183,3578740363,3578740390,27
0,1148,30184,3578740363,3578740390,27
0,1148,30185,3578740363,3578740392,29
0,1148,30186,3578740363,3578740392,29
0,1148,30187,3578740363,3578740394,31
0,1148,30188,3578740363,3578740394,31
0,1148,30189,3578740363,3578740395,32
0,1148,30190,3578740363,3578740396,33
0,1148,30191,3578740363,3578740399,36
0,1148,30192,3578740363,3578740401,38
0,1148,30193,3578740363,3578740403,40
0,1148,30194,3578740363,3578740404,41
0,1148,30195,3578740363,3578740404,41
0,1148,30196,3578740363,3578740404,41
0,1148,30197,3578740363,3578740405,42
0,1148,30198,3578740363,3578740405,42
0,1148,30199,3578740363,3578740406,43
0,1148,30200,3578740363,3578740406,43
0,1148,30201,3578740363,3578740409,46
0,1148,30202,3578740363,3578740409,46
0,1148,30203,3578740363,3578740409,46
0,1148,30204,3578740363,3578740410,47
0,1148,30205,3578740363,3578740410,47
0,1148,30206,3578740363,3578740411,48
0,1148,30207,3578740363,3578740413,50
0,1149,30208,3578740426,3578740426,0
0,1149,30209,3578740426,3578740426,0
0,1149,30210,3578740426,3578740426,0
0,1149,30211,3578740426,3578740426,0
0,1149,30212,3578740426,3578740426,0
0,1149,30213,3578740426,3578740426,0
0,1149,30214,3578740426,3578740426,0
0,1149,30215,3578740426,3578740426,0
0,1149,30216,3578740426,3578740426,0
0,1149,30217,3578740426,3578740426,0
0,1149,30218,3578740426,3578740426,0
0,1149,30219,3578740426,3578740426,0
0,1149,30220,3578740426,3578740426,0
0,1149,30221,3578740426,3578740426,0
0,1149,30222,3578740426,3578740426,0
0,1149,30223,3578740426,3578740426,0
0,1149,30224,3578740426,3578740427,1
0,1149,30225,3578740426,3578740430,4
0,1149,30226,3578740426,3578740431,5
0,1149,30227,3578740426,3578740432,6
0,1149,30228,3578740426,3578740433,7
0,1149,30229,3578740426,3578740434,8
0,1149,30230,3578740426,3578740439,13
0,1149,30231,3578740426,3578740439,13
0,1149,30232,3578740426,3578740439,13
0,1149,30233,3578740426,3578740439,13
0,1149,30234,3578740426,3578740441,15
0,1149,30235,3578740426,3578740441,15
0,1149,30236,3578740426,3578740441,15
0,1149,30237,3578740426,3578740441,15
0,1149,30238,3578740426,3578740444,18
0,1149,30239,3578740426,3578740444,18
0,1149,30240,3578740426,3578740444,18
0,1149,30241,3578740426,3578740446,20
0,1149,30242,3578740426,3578740448,22
0,1149,30243,3578740426,3578740448,22
0,1149,30244,3578740426,3578740450,24
0,1149,30245,3578740426,3578740450,24
0,1149,30246,3578740426,3578740450,24
0,1149,30247,3578740426,3578740451,25
0,1149,30248,3578740426,3578740452,26
0,1149,30249,3578740426,3578740453,27
0,1149,30250,3578740426,3578740455,29
0,1149,30251,3578740426,3578740457,31
0,1149,30252,3578740426,3578740457,31
0,1149,30253,3578740426,3578740458,32
0,1149,30254,3578740426,3578740459,33
0,1149,30255,3578740426,3578740460,34
0,1149,30256,3578740426,3578740461,35
0,1149,30257,3578740426,3578740463,37
0,1149,30258,3578740426,3578740463,37
0,1149,30259,3578740426,3578740464,38
0,1149,30260,3578740426,3578740466,40
0,1149,30261,3578740426,3578740466,40
0,1149,30262,3578740426,3578740466,40
0,1149,30263,3578740426,3578740468,42
0,1149,30264,3578740426,3578740468,42
0,1149,30265,3578740426,3578740469,43
0,1149,30266,3578740426,3578740469,43
0,1149,30267,3578740426,3578740475,49
0,1150,30268,3578740489,3578740489,0
0,1150,30269,3578740489,3578740489,0
0,1150,30270,3578740489,3578740489,0
0,1150,30271,3578740489,3578740489,0
0,1150,30272,3578740489,3578740489,0
0,1150,30273,3578740489,3578740489,0
0,1150,30274,3578740489,3578740489,0
0,1150,30275,3578740489,3578740489,0
0,1150,30276,3578740489,3578740489,0
0,1150,30277,3578740489,3578740489,0
0,1150,30278,3578740489,3578740489,0
0,1150,30279,3578740489,3578740489,0
0,1150,30280,3578740489,3578740489,0
0,1150,30281,3578740489,3578740489,0
0,1150,30282,3578740489,3578740489,0
0,1150,30283,3578740489,3578740489,0
0,1150,30284,3578740489,3578740489,0
0,1150,30285,3578740489,3578740489,0
0,1150,30286,3578740489,3578740489,0
0,1150,30287,3578740489,3578740489,0
0,1150,30288,3578740489,3578740489,0
0,1150,30289,3578740489,3578740489,0
0,1150,30290,3578740489,3578740489,0
0,1150,30291,3578740489,3578740490,1
0,1150,30292,3578740489,3578740490,1
0,1150,30293,3578740489,3578740490,1
0,1150,30294,3578740489,3578740491,2
0,1150,30295,3578740489,3578740492,3
0,1150,30296,3578740489,3578740492,3
0,1150,30297,3578740489,3578740493,4
0,1150,30298,3578740489,3578740496,7
0,1150,30299,3578740489,3578740497,8
0,1150,30300,3578740489,3578740498,9
0,1150,30301,3578740489,3578740499,10
0,1150,30302,3578740489,3578740501,12
0,1150,30303,3578740489,3578740501,12
0,1150,30304,3578740489,3578740501,12
0,1150,30305,3578740489,3578740502,13
0,1150,30306,3578740489,3578740502,13
0,1150,30307,3578740489,3578740503,14
0,1150,30308,3578740489,3578740503,14
0,1150,30309,3578740489,3578740505,16
0,1150,30310,3578740489,3578740505,16
0,1150,30311,3578740489,3578740506,17
0,1150,30312,3578740489,3578740506,17
0,1150,30313,3578740489,3578740507,18
0,1150,30314,3578740489,3578740507,18
0,1150,30315,3578740489,3578740508,19
0,1150,30316,3578740489,3578740509,20
0,1150,30317,3578740489,3578740509,20
0,1150,30318,3578740489,3578740510,21
0,1150,30319,3578740489,3578740513,24
0,1150,30320,3578740489,3578740513,24
0,1150,30321,3578740489,3578740513,24
0,1150,30322,3578740489,3578740514,25
0,1150,30323,3578740489,3578740514,25
0,1150,30324,3578740489,3578740514,25
0,1150,30325,3578740489,3578740515,26
0,1150,30326,3578740489,3578740515,26
0,1150,30327,3578740489,3578740517,28
0,1150,30328,3578740489,3578740517,28
0,1150,30329,3578740489,3578740517,28
0,1150,30330,3578740489,3578740518,29
0,1150,30331,3578740489,3578740519,30
0,1150,30332,3578740489,3578740520,31
0,1150,30333,3578740489,3578740520,31
0,1150,30334,3578740489,3578740522,33
0,1150,30335,3578740489,3578740522,33
0,1150,30336,3578740489,3578740522,33
0,1150,30337,3578740489,3578740522,33
0,1150,30338,3578740489,3578740523,34
0,1150,30339,3578740489,3578740526,37
0,1150,30340,3578740489,3578740528,39
0,1150,30341,3578740489,3578740528,39
0,1150,30342,3578740489,3578740529,40
0,1150,30343,3578740489,3578740530,41
0,1150,30344,3578740489,3578740530,41
0,1150,30345,3578740489,3578740531,42
0,1150,30346,3578740489,3578740531,42
0,1150,30347,3578740489,3578740532,43
0,1150,30348,3578740489,3578740532,43
0,1150,30349,3578740489,3578740535,46
0,1150,30350,3578740489,3578740536,47
0,1150,30351,3578740489,3578740538,49
0,1150,30352,3578740489,3578740538,49
0,1150,30353,3578740489,3578740539,50
0,1151,30354,3578740554,3578740554,0
0,1151,30355,3578740554,3578740554,0
0,1151,30356,3578740554,3578740554,0
0,1151,30357,3578740554,3578740554,0
0,1151,30358,3578740554,3578740554,0
0,1151,30359,3578740554,3578740554,0
0,1151,30360,3578740554,3578740554,0
0,1151,30361,3578740554,3578740554,0
0,1151,30362,3578740554,3578740554,0
0,1151,30363,3578740554,3578740554,0
0,1151,30364,3578740554,3578740554,0
0,1151,30365,3578740554,3578740554,0
0,1151,30366,3578740554,3578740554,0
0,1151,30367,3578740554,3578740554,0
0,1151,30368,3578740554,3578740554,0
0,1151,30369,3578740554,3578740554,0
0,1151,30370,3578740554,3578740554,0
0,1151,30371,3578740554,3578740554,0
0,1151,30372,3578740554,3578740554,0
0,1151,30373,3578740554,3578740554,0
0,1151,30374,3578740554,3578740554,0
0,1151,30375,3578740554,3578740554,0
0,1151,30376,3578740554,3578740555,1
0,1151,30377,3578740554,3578740557,3
0,1151,30378,3578740554,3578740557,3
0,1151,30379,3578740554,3578740558,4
0,1151,30380,3578740554,3578740559,5
0,1151,30381,3578740554,3578740560,6
0,1151,30382,3578740554,3578740561,7
0,1151,30383,3578740554,3578740561,7
0,1151,30384,3578740554,3578740561,7
0,1151,30385,3578740554,3578740561,7
0,1151,30386,3578740554,3578740563,9
0,1151,30387,3578740554,3578740565,11
0,1151,30388,3578740554,3578740565,11
0,1151,30389,3578740554,3578740566,12
0,1151,30390,3578740554,3578740567,13
0,1151,30391,3578740554,3578740567,13
0,1151,30392,3578740554,3578740568,14
0,1151,30393,3578740554,3578740569,15
0,1151,30394,3578740554,3578740570,16
0,1151,30395,3578740554,3578740571,17
0,1151,30396,3578740554,3578740573,19
0,1151,30397,3578740554,3578740574,20
0,1151,30398,3578740554,3578740575,21
0,1151,30399,3578740554,3578740577,23
0,1151,30400,3578740554,3578740578,24
0,1151,30401,3578740554,3578740578,24
0,1151,30402,3578740554,3578740579,25
0,1151,30403,3578740554,3578740579,25
0,1151,30404,3578740554,3578740580,26
0,1151,30405,3578740554,3578740580,26
0,1151,30406,3578740554,3578740582,28
0,1151,30407,3578740554,3578740583,29
0,1151,30408,3578740554,3578740583,29
0,1151,30409,3578740554,3578740585,31
0,1151,30410,3578740554,3578740588,34
0,1151,30411,3578740554,3578740588,34
0,1151,30412,3578740554,3578740589,35
0,1151,30413,3578740554,3578740589,35
0,1151,30414,3578740554,3578740589,35
0,1151,30415,3578740554,3578740590,36
0,1151,30416,3578740554,3578740590,36
0,1151,30417,3578740554,3578740591,37
0,1151,30418,3578740554,3578740592,38
0,1151,30419,3578740554,3578740593,39
0,1151,30420,3578740554,3578740593,39
0,1151,30421,3578740554,3578740594,40
0,1151,30422,3578740554,3578740595,41
0,1151,30423,3578740554,3578740598,44
0,1151,30424,3578740554,3578740600,46
0,1151,30425,3578740554,3578740600,46
0,1151,30426,3578740554,3578740602,48
0,1151,30427,3578740554,3578740603,49
0,1151,30428,3578740554,3578740603,49
0,1151,30429,3578740554,3578740604,50
0,1152,30430,3578740615,3578740615,0
0,1152,30431,3578740615,3578740615,0
0,1152,30432,3578740615,3578740615,0
0,1152,30433,3578740615,3578740615,0
0,1152,30434,3578740615,3578740615,0
0,1152,30435,3578740615,3578740615,0
0,1152,30436,3578740615,3578740615,0
0,1152,30437,3578740615,3578740615,0
0,1152,30438,3578740615,3578740615,0
0,1152,30439,3578740615,3578740615,0
0,1152,30440,3578740615,3578740615,0
0,1152,30441,3578740615,3578740615,0
0,1152,30442,3578740615,3578740615,0
0,1152,30443,3578740615,3578740615,0
0,1152,30444,3578740615,3578740615,0
0,1152,30445,3578740615,3578740615,0
0,1152,30446,3578740615,3578740615,0
0,1152,30447,3578740615,3578740615,0
0,1152,30448,3578740615,3578740617,2
0,1152,30449,3578740615,3578740619,4
0,1152,30450,3578740615,3578740620,5
0,1152,30451,3578740615,3578740621,6
0,1152,30452,3578740615,3578740621,6
0,1152,30453,3578740615,3578740622,7
0,1152,30454,3578740615,3578740622,7
0,1152,30455,3578740615,3578740625,10
0,1152,30456,3578740615,3578740628,13
0,1152,30457,3578740615,3578740629,14
0,1152,30458,3578740615,3578740629,14
0,1152,30459,3578740615,3578740631,16
0,1152,30460,3578740615,3578740632,17
0,1152,30461,3578740615,3578740633,18
0,1152,30462,3578740615,3578740633,18
0,1152,30463,3578740615,3578740638,23
0,1152,30464,3578740615,3578740638,23
0,1152,30465,3578740615,3578740638,23
0,1152,30466,3578740615,3578740640,25
0,1152,30467,3578740615,3578740640,25
0,1152,30468,3578740615,3578740641,26
0,1152,30469,3578740615,3578740641,26
0,1152,30470,3578740615,3578740641,26
0,1152,30471,3578740615,3578740643,28
0,1152,30472,3578740615,3578740645,30
0,1152,30473,3578740615,3578740647,32
0,1152,30474,3578740615,3578740648,33
0,1152,30475,3578740615,3578740649,34
0,1152,30476,3578740615,3578740649,34
0,1152,30477,3578740615,3578740649,34
0,1152,30478,3578740615,3578740651,36
0,1152,30479,3578740615,3578740652,37
0,1152,30480,3578740615,3578740654,39
0,1152,30481,3578740615,3578740655,40
0,1152,30482,3578740615,3578740657,42
0,1152,30483,3578740615,3578740658,43
0,1152,30484,3578740615,3578740658,43
0,1152,30485,3578740615,3578740659,44
0,1152,30486,3578740615,3578740661,46
0,1152,30487,3578740615,3578740662,47
0,1152,30488,3578740615,3578740662,47
0,1152,30489,3578740615,3578740663,48
0,1152,30490,3578740615,3578740664,49
0,1152,30491,3578740615,3578740665,50
0,1153,30492,3578740677,3578740677,0
0,1153,30493,3578740677,3578740677,0
0,1153,30494,3578740677,3578740677,0
0,1153,30495,3578740677,3578740677,0
0,1153,30496,3578740677,3578740677,0
0,1153,30497,3578740677,3578740677,0
0,1153,30498,3578740677,3578740678,1
0,1153,30499,3578740677,3578740679,2
0,1153,30500,3578740677,3578740680,3
0,1153,30501,3578740677,3578740680,3
0,1153,30502,3578740677,3578740680,3
0,1153,30503,3578740677,3578740681,4
0,1153,30504,3578740677,3578740682,5
0,1153,30505,3578740677,3578740682,5
0,1153,30506,3578740677,3578740683,6
0,1153,30507,3578740677,3578740684,7
0,1153,30508,3578740677,3578740684,7
0,1153,30509,3578740677,3578740685,8
0,1153,30510,3578740677,3578740687,10
0,1153,30511,3578740677,3578740687,10
0,1153,30512,3578740677,3578740687,10
0,1153,30513,3578740677,3578740687,10
0,1153,30514,3578740677,3578740688,11
0,1153,30515,3578740677,3578740689,12
0,1153,30516,3578740677,3578740690,13
0,1153,30517,3578740677,3578740690,13
0,1153,30518,3578740677,3578740690,13
0,1153,30519,3578740677,3578740691,14
0,1153,30520,3578740677,3578740692,15
0,1153,30521,3578740677,3578740692,15
0,1153,30522,3578740677,3578740693,16
0,1153,30523,3578740677,3578740693,16
0,1153,30524,3578740677,3578740693,16
0,1153,30525,3578740677,3578740696,19
0,1153,30526,3578740677,3578740697,20
0,1153,30527,3578740677,3578740697,20
0,1153,30528,3578740677,3578740697,20
0,1153,30529,3578740677,3578740699,22
0,1153,30530,3578740677,3578740699,22
0,1153,30531,3578740677,3578740700,23
0,1153,30532,3578740677,3578740701,24
0,1153,30533,3578740677,3578740701,24
0,1153,30534,3578740677,3578740702,25
0,1153,30535,3578740677,3578740703,26
0,1153,30536,3578740677,3578740703,26
0,1153,30537,3578740677,3578740705,28
0,1153,30538,3578740677,3578740705,28
0,1153,30539,3578740677,3578740706,29
0,1153,30540,3578740677,3578740706,29
0,1153,30541,3578740677,3578740706,29
0,1153,30542,3578740677,3578740707,30
0,1153,30543,3578740677,3578740708,31
0,1153,30544,3578740677,3578740708,31
0,1153,30545,3578740677,3578740709,32
0,1153,30546,3578740677,3578740710,33
0,1153,30547,3578740677,3578740711,34
0,1153,30548,3578740677,3578740713,36
0,1153,30549,3578740677,3578740714,37
0,1153,30550,3578740677,3578740714,37
0,1153,30551,3578740677,3578740714,37
0,1153,30552,3578740677,3578740715,38
0,1153,30553,3578740677,3578740715,38
0,1153,30554,3578740677,3578740715,38
0,1153,30555,3578740677,3578740715,38
0,1153,30556,3578740677,3578740717,40
0,1153,30557,3578740677,3578740717,40
0,1153,30558,3578740677,3578740717,40
0,1153,30559,3578740677,3578740718,41
0,1153,30560,3578740677,3578740720,43
0,1153,30561,3578740677,3578740720,43
0,1153,30562,3578740677,3578740720,43
0,1153,30563,3578740677,3578740722,45
0,1153,30564,3578740677,3578740722,45
0,1153,30565,3578740677,3578740722,45
0,1153,30566,3578740677,3578740723,46
0,1153,30567,3578740677,3578740723,46
0,1154,30568,3578740744,3578740744,0
0,1154,30569,3578740744,3578740744,0
0,1154,30570,3578740744,3578740744,0
0,1154,30571,3578740744,3578740744,0
0,1154,30572,3578740744,3578740744,0
0,1154,30573,3578740744,3578740744,0
0,1154,30574,3578740744,3578740744,0
0,1154,30575,3578740744,3578740744,0
0,1154,30576,3578740744,3578740744,0
0,1154,30577,3578740744,3578740744,0
0,1154,30578,3578740744,3578740744,0
0,1154,30579,3578740744,3578740744,0
0,1154,30580,3578740744,3578740744,0
0,1154,30581,3578740744,3578740744,0
0,1154,30582,3578740744,3578740744,0
0,1154,30583,3578740744,3578740744,0
0,1154,30584,3578740744,3578740744,0
0,1154,30585,3578740744,3578740744,0
0,1154,30586,3578740744,3578740744,0
0,1154,30587,3578740744,3578740744,0
0,1154,30588,3578740744,3578740744,0
0,1154,30589,3578740744,3578740744,0
0,1154,30590,3578740744,3578740744,0
0,1154,30591,3578740744,3578740744,0
0,1154,30592,3578740744,3578740744,0
0,1154,30593,3578740744,3578740744,0
0,1154,30594,3578740744,3578740745,1
0,1154,30595,3578740744,3578740745,1
0,1154,30596,3578740744,3578740745,1
0,1154,30597,3578740744,3578740745,1
0,1154,30598,3578740744,3578740746,2
0,1154,30599,3578740744,3578740746,2
0,1154,30600,3578740744,3578740746,2
0,1154,30601,3578740744,3578740747,3
0,1154,30602,3578740744,3578740747,3
0,1154,30603,3578740744,3578740749,5
0,1154,30604,3578740744,3578740752,8
0,1154,30605,3578740744,3578740753,9
0,1154,30606,3578740744,3578740754,10
0,1154,30607,3578740744,3578740754,10
0,1154,30608,3578740744,3578740755,11
0,1154,30609,3578740744,3578740757,13
0,1154,30610,3578740744,3578740757,13
0,1154,30611,3578740744,3578740757,13
0,1154,30612,3578740744,3578740758,14
0,1154,30613,3578740744,3578740760,16
0,1154,30614,3578740744,3578740761,17
0,1154,30615,3578740744,3578740761,17
0,1154,30616,3578740744,3578740761,17
0,1154,30617,3578740744,3578740761,17
0,1154,30618,3578740744,3578740761,17
0,1154,30619,3578740744,3578740763,19
0,1154,30620,3578740744,3578740764,20
0,1154,30621,3578740744,3578740764,20
0,1154,30622,3578740744,3578740766,22
0,1154,30623,3578740744,3578740766,22
0,1154,30624,3578740744,3578740767,23
0,1154,30625,3578740744,3578740768,24
0,1154,30626,3578740744,3578740768,24
0,1154,30627,3578740744,3578740769,25
0,1154,30628,3578740744,3578740769,25
0,1154,30629,3578740744,3578740770,26
0,1154,30630,3578740744,3578740771,27
0,1154,30631,3578740744,3578740773,29
0,1154,30632,3578740744,3578740774,30
0,1154,30633,3578740744,3578740774,30
0,1154,30634,3578740744,3578740776,32
0,1154,30635,3578740744,3578740776,32
0,1154,30636,3578740744,3578740776,32
0,1154,30637,3578740744,3578740778,34
0,1154,30638,3578740744,3578740779,35
0,1154,30639,3578740744,3578740779,35
0,1154,30640,3578740744,3578740779,35
0,1154,30641,3578740744,3578740780,36
0,1154,30642,3578740744,3578740781,37
0,1154,30643,3578740744,3578740782,38
0,1154,30644,3578740744,3578740782,38
0,1154,30645,3578740744,3578740785,41
0,1154,30646,3578740744,3578740788,44
0,1154,30647,3578740744,3578740788,44
0,1154,30648,3578740744,3578740789,45
0,1154,30649,3578740744,3578740789,45
0,1154,30650,3578740744,3578740789,45
0,1154,30651,3578740744,3578740790,46
0,1154,30652,3578740744,3578740791,47
0,1154,30653,3578740744,3578740792,48
0,1154,30654,3578740744,3578740793,49
0,1154,30655,3578740744,3578740793,49
0,1154,30656,3578740744,3578740794,50
0,1155,30657,3578740805,3578740805,0
0,1155,30658,3578740805,3578740805,0
0,1155,30659,3578740805,3578740805,0
0,1155,30660,3578740805,3578740805,0
0,1155,30661,3578740805,3578740805,0
0,1155,30662,3578740805,3578740806,1
0,1155,30663,3578740805,3578740806,1
0,1155,30664,3578740805,3578740806,1
0,1155,30665,3578740805,3578740806,1
0,1155,30666,3578740805,3578740806,1
0,1155,30667,3578740805,3578740806,1
0,1155,30668,3578740805,3578740809,4
0,1155,30669,3578740805,3578740809,4
0,1155,30670,3578740805,3578740809,4
0,1155,30671,3578740805,3578740810,5
0,1155,30672,3578740805,3578740811,6
0,1155,30673,3578740805,3578740812,7
0,1155,30674,3578740805,3578740813,8
0,1155,30675,3578740805,3578740813,8
0,1155,30676,3578740805,3578740814,9
0,1155,30677,3578740805,3578740815,10
0,1155,30678,3578740805,3578740815,10
0,1155,30679,3578740805,3578740815,10
0,1155,30680,3578740805,3578740816,11
0,1155,30681,3578740805,3578740819,14
0,1155,30682,3578740805,3578740819,14
0,1155,30683,3578740805,3578740819,14
0,1155,30684,3578740805,3578740820,15
0,1155,30685,3578740805,3578740821,16
0,1155,30686,3578740805,3578740821,16
0,1155,30687,3578740805,3578740822,17
0,1155,30688,3578740805,3578740823,18
0,1155,30689,3578740805,3578740825,20
0,1155,30690,3578740805,3578740826,21
0,1155,30691,3578740805,3578740828,23
0,1155,30692,3578740805,3578740829,24
0,1155,30693,3578740805,3578740829,24
0,1155,30694,3578740805,3578740831,26
0,1155,30695,3578740805,3578740832,27
0,1155,30696,3578740805,3578740833,28
0,1155,30697,3578740805,3578740835,30
0,1155,30698,3578740805,3578740836,31
0,1155,30699,3578740805,3578740838,33
0,1155,30700,3578740805,3578740840,35
0,1155,30701,3578740805,3578740840,35
0,1155,30702,3578740805,3578740840,35
0,1155,30703,3578740805,3578740841,36
0,1155,30704,3578740805,3578740841,36
0,1155,30705,3578740805,3578740842,37
0,1155,30706,3578740805,3578740842,37
0,1155,30707,3578740805,3578740844,39
0,1155,30708,3578740805,3578740846,41
0,1155,30709,3578740805,3578740846,41
0,1155,30710,3578740805,3578740847,42
0,1155,30711,3578740805,3578740848,43
0,1155,30712,3578740805,3578740849,44
0,1155,30713,3578740805,3578740850,45
0,1155,30714,3578740805,3578740850,45
0,1155,30715,3578740805,3578740851,46
0,1155,30716,3578740805,3578740851,46
0,1155,30717,3578740805,3578740852,47
0,1155,30718,3578740805,3578740854,49
0,1156,30719,3578740870,3578740870,0
0,1156,30720,3578740870,3578740870,0
0,1156,30721,3578740870,3578740870,0
0,1156,30722,3578740870,3578740870,0
0,1156,30723,3578740870,3578740870,0
0,1156,30724,3578740870,3578740870,0
0,1156,30725,3578740870,3578740870,0
0,1156,30726,3578740870,3578740870,0
0,1156,30727,3578740870,3578740870,0
0,1156,30728,3578740870,3578740870,0
0,1156,30729,3578740870,3578740870,0
0,1156,30730,3578740870,3578740870,0
0,1156,30731,3578740870,3578740870,0
0,1156,30732,3578740870,3578740870,0
0,1156,30733,3578740870,3578740870,0
0,1156,30734,3578740870,3578740875,5
0,1156,30735,3578740870,3578740877,7
0,1156,30736,3578740870,3578740877,7
0,1156,30737,3578740870,3578740879,9
0,1156,30738,3578740870,3578740880,10
0,1156,30739,3578740870,3578740880,10
0,1156,30740,3578740870,3578740881,11
0,1156,30741,3578740870,3578740881,11
0,1156,30742,3578740870,3578740883,13
0,1156,30743,3578740870,3578740883,13
0,1156,30744,3578740870,3578740884,14
0,1156,30745,3578740870,3578740884,14
0,1156,30746,3578740870,3578740886,16
0,1156,30747,3578740870,3578740886,16
0,1156,30748,3578740870,3578740887,17
0,1156,30749,3578740870,3578740888,18
0,1156,30750,3578740870,3578740888,18
0,1156,30751,3578740870,3578740889,19
0,1156,30752,3578740870,3578740890,20
0,1156,30753,3578740870,3578740890,20
0,1156,30754,3578740870,3578740891,21
0,1156,30755,3578740870,3578740891,21
0,1156,30756,3578740870,3578740892,22
0,1156,30757,3578740870,3578740893,23
0,1156,30758,3578740870,3578740893,23
0,1156,30759,3578740870,3578740893,23
0,1156,30760,3578740870,3578740896,26
0,1156,30761,3578740870,3578740897,27
0,1156,30762,3578740870,3578740897,27
0,1156,30763,3578740870,3578740897,27
0,1156,30764,3578740870,3578740898,28
0,1156,30765,3578740870,3578740899,29
0,1156,30766,3578740870,3578740899,29
0,1156,30767,3578740870,3578740901,31
0,1156,30768,3578740870,3578740902,32
0,1156,30769,3578740870,3578740902,32
0,1156,30770,3578740870,3578740903,33
0,1156,30771,3578740870,3578740904,34
0,1156,30772,3578740870,3578740905,35
0,1156,30773,3578740870,3578740906,36
0,1156,30774,3578740870,3578740907,37
0,1156,30775,3578740870,3578740908,38
0,1156,30776,3578740870,3578740908,38
0,1156,30777,3578740870,3578740909,39
0,1156,30778,3578740870,3578740910,40
0,1156,30779,3578740870,3578740912,42
0,1156,30780,3578740870,3578740913,43
0,1156,30781,3578740870,3578740913,43
0,1156,30782,3578740870,3578740913,43
0,1156,30783,3578740870,3578740914,44
0,1156,30784,3578740870,3578740914,44
0,1156,30785,3578740870,3578740914,44
0,1156,30786,3578740870,3578740915,45
0,1156,30787,3578740870,3578740916,46
0,1156,30788,3578740870,3578740916,46
0,1156,30789,3578740870,3578740917,47
0,1156,30790,3578740870,3578740917,47
0,1156,30791,3578740870,3578740918,48
0,1156,30792,3578740870,3578740920,50
0,1157,30793,3578740931,3578740931,0
0,1157,30794,3578740931,3578740931,0
0,1157,30795,3578740931,3578740931,0
0,1157,30796,3578740931,3578740931,0
0,1157,30797,3578740931,3578740931,0
0,1157,30798,3578740931,3578740931,0
0,1157,30799,3578740931,3578740931,0
0,1157,30800,3578740931,3578740931,0
0,1157,30801,3578740931,3578740931,0
0,1157,30802,3578740931,3578740931,0
0,1157,30803,3578740931,3578740931,0
0,1157,30804,3578740931,3578740931,0
0,1157,30805,3578740931,3578740931,0
0,1157,30806,3578740931,3578740931,0
0,1157,30807,3578740931,3578740932,1
0,1157,30808,3578740931,3578740932,1
0,1157,30809,3578740931,3578740932,1
0,1157,30810,3578740931,3578740936,5
0,1157,30811,3578740931,3578740936,5
0,1157,30812,3578740931,3578740939,8
0,1157,30813,3578740931,3578740939,8
0,1157,30814,3578740931,3578740940,9
0,1157,30815,3578740931,3578740940,9
0,1157,30816,3578740931,3578740940,9
0,1157,30817,3578740931,3578740941,10
0,1157,30818,3578740931,3578740941,10
0,1157,30819,3578740931,3578740942,11
0,1157,30820,3578740931,3578740942,11
0,1157,30821,3578740931,3578740943,12
0,1157,30822,3578740931,3578740944,13
0,1157,30823,3578740931,3578740944,13
0,1157,30824,3578740931,3578740945,14
0,1157,30825,3578740931,3578740945,14
0,1157,30826,3578740931,3578740945,14
0,1157,30827,3578740931,3578740945,14
0,1157,30828,3578740931,3578740946,15
0,1157,30829,3578740931,3578740946,15
0,1157,30830,3578740931,3578740946,15
0,1157,30831,3578740931,3578740947,16
0,1157,30832,3578740931,3578740949,18
0,1157,30833,3578740931,3578740949,18
0,1157,30834,3578740931,3578740950,19
0,1157,30835,3578740931,3578740952,21
0,1157,30836,3578740931,3578740953,22
0,1157,30837,3578740931,3578740953,22
0,1157,30838,3578740931,3578740955,24
0,1157,30839,3578740931,3578740956,25
0,1157,30840,3578740931,3578740957,26
0,1157,30841,3578740931,3578740958,27
0,1157,30842,3578740931,3578740959,28
0,1157,30843,3578740931,3578740959,28
0,1157,30844,3578740931,3578740960,29
0,1157,30845,3578740931,3578740961,30
0,1157,30846,3578740931,3578740961,30
0,1157,30847,3578740931,3578740961,30
0,1157,30848,3578740931,3578740961,30
0,1157,30849,3578740931,3578740962,31
0,1157,30850,3578740931,3578740963,32
0,1157,30851,3578740931,3578740964,33
0,1157,30852,3578740931,3578740964,33
0,1157,30853,3578740931,3578740966,35
0,1157,30854,3578740931,3578740967,36
0,1157,30855,3578740931,3578740968,37
0,1157,30856,3578740931,3578740969,38
0,1157,30857,3578740931,3578740969,38
0,1157,30858,3578740931,3578740970,39
0,1157,30859,3578740931,3578740970,39
0,1157,30860,3578740931,3578740972,41
0,1157,30861,3578740931,3578740973,42
0,1157,30862,3578740931,3578740974,43
0,1157,30863,3578740931,3578740974,43
0,1157,30864,3578740931,3578740975,44
0,1157,30865,3578740931,3578740976,45
0,1157,30866,3578740931,3578740977,46
0,1157,30867,3578740931,3578740977,46
0,1157,30868,3578740931,3578740978,47
0,1157,30869,3578740931,3578740978,47
0,1157,30870,3578740931,3578740979,48
0,1157,30871,3578740931,3578740980,49
0,1158,30872,3578740992,3578740992,0
0,1158,30873,3578740992,3578740992,0
0,1158,30874,3578740992,3578740992,0
0,1158,30875,3578740992,3578740992,0
0,1158,30876,3578740992,3578740992,0
0,1158,30877,3578740992,3578740992,0
0,1158,30878,3578740992,3578740992,0
0,1158,30879,3578740992,3578740992,0
0,1158,30880,3578740992,3578740992,0
0,1158,30881,3578740992,3578740992,0
0,1158,30882,3578740992,3578740992,0
0,1158,30883,3578740992,3578740992,0
0,1158,30884,3578740992,3578740993,1
0,1158,30885,3578740992,3578740993,1
0,1158,30886,3578740992,3578740993,1
0,1158,30887,3578740992,3578740994,2
0,1158,30888,3578740992,3578740995,3
0,1158,30889,3578740992,3578740998,6
0,1158,30890,3578740992,3578740999,7
0,1158,30891,3578740992,3578741000,8
0,1158,30892,3578740992,3578741001,9
0,1158,30893,3578740992,3578741002,10
0,1158,30894,3578740992,3578741003,11
0,1158,30895,3578740992,3578741004,12
0,1158,30896,3578740992,3578741004,12
0,1158,30897,3578740992,3578741005,13
0,1158,30898,3578740992,3578741005,13
0,1158,30899,3578740992,3578741006,14
0,1158,30900,3578740992,3578741007,15
0,1158,30901,3578740992,3578741009,17
0,1158,30902,3578740992,3578741009,17
0,1158,30903,3578740992,3578741009,17
0,1158,30904,3578740992,3578741009,17
0,1158,30905,3578740992,3578741010,18
0,1158,30906,3578740992,3578741010,18
0,1158,30907,3578740992,3578741010,18
0,1158,30908,3578740992,3578741011,19
0,1158,30909,3578740992,3578741013,21
0,1158,30910,3578740992,3578741013,21
0,1158,30911,3578740992,3578741014,22
0,1158,30912,3578740992,3578741015,23
0,1158,30913,3578740992,3578741015,23
0,1158,30914,3578740992,3578741015,23
0,1158,30915,3578740992,3578741015,23
0,1158,30916,3578740992,3578741016,24
0,1158,30917,3578740992,3578741018,26
0,1158,30918,3578740992,3578741019,27
0,1158,30919,3578740992,3578741019,27
0,1158,30920,3578740992,3578741019,27
0,1158,30921,3578740992,3578741019,27
0,1158,30922,3578740992,3578741021,29
0,1158,30923,3578740992,3578741023,31
0,1158,30924,3578740992,3578741023,31
0,1158,30925,3578740992,3578741025,33
0,1158,30926,3578740992,3578741025,33
0,1158,30927,3578740992,3578741028,36
0,1158,30928,3578740992,3578741029,37
0,1158,30929,3578740992,3578741029,37
0,1158,30930,3578740992,3578741031,39
0,1158,30931,3578740992,3578741033,41
0,1158,30932,3578740992,3578741036,44
0,1158,30933,3578740992,3578741038,46
0,1158,30934,3578740992,3578741039,47
0,1158,30935,3578740992,3578741039,47
0,1158,30936,3578740992,3578741040,48
0,1158,30937,3578740992,3578741041,49
0,1158,30938,3578740992,3578741041,49
0,1158,30939,3578740992,3578741041,49
0,1158,30940,3578740992,3578741042,50
0,1159,30941,3578741054,3578741054,0
0,1159,30942,3578741054,3578741054,0
0,1159,30943,3578741054,3578741054,0
0,1159,30944,3578741054,3578741054,0
0,1159,30945,3578741054,3578741054,0
0,1159,30946,3578741054,3578741054,0
0,1159,30947,3578741054,3578741054,0
0,1159,30948,3578741054,3578741054,0
0,1159,30949,3578741054,3578741054,0
0,1159,30950,3578741054,3578741054,0
0,1159,30951,3578741054,3578741054,0
0,1159,30952,3578741054,3578741054,0
0,1159,30953,3578741054,3578741054,0
0,1159,30954,3578741054,3578741054,0
0,1159,30955,3578741054,3578741056,2
0,1159,30956,3578741054,3578741056,2
0,1159,30957,3578741054,3578741057,3
0,1159,30958,3578741054,3578741058,4
0,1159,30959,3578741054,3578741059,5
0,1159,30960,3578741054,3578741060,6
0,1159,30961,3578741054,3578741061,7
0,1159,30962,3578741054,3578741062,8
0,1159,30963,3578741054,3578741063,9
0,1159,30964,3578741054,3578741064,10
0,1159,30965,3578741054,3578741064,10
0,1159,30966,3578741054,3578741065,11
0,1159,30967,3578741054,3578741065,11
0,1159,30968,3578741054,3578741066,12
0,1159,30969,3578741054,3578741067,13
0,1159,30970,3578741054,3578741067,13
0,1159,30971,3578741054,3578741068,14
0,1159,30972,3578741054,3578741075,21
0,1159,30973,3578741054,3578741077,23
0,1159,30974,3578741054,3578741077,23
0,1159,30975,3578741054,3578741079,25
0,1159,30976,3578741054,3578741080,26
0,1159,30977,3578741054,3578741080,26
0,1159,30978,3578741054,3578741080,26
0,1159,30979,3578741054,3578741081,27
0,1159,30980,3578741054,3578741081,27
0,1159,30981,3578741054,3578741083,29
0,1159,30982,3578741054,3578741083,29
0,1159,30983,3578741054,3578741083,29
0,1159,30984,3578741054,3578741084,30
0,1159,30985,3578741054,3578741085,31
0,1159,30986,3578741054,3578741086,32
0,1159,30987,3578741054,3578741087,33
0,1159,30988,3578741054,3578741087,33
0,1159,30989,3578741054,3578741087,33
0,1159,30990,3578741054,3578741087,33
0,1159,30991,3578741054,3578741087,33
0,1159,30992,3578741054,3578741088,34
0,1159,30993,3578741054,3578741089,35
0,1159,30994,3578741054,3578741090,36
0,1159,30995,3578741054,3578741090,36
0,1159,30996,3578741054,3578741090,36
0,1159,30997,3578741054,3578741091,37
0,1159,30998,3578741054,3578741091,37
0,1159,30999,3578741054,3578741092,38
0,1159,31000,3578741054,3578741093,39
0,1159,31001,3578741054,3578741093,39
0,1159,31002,3578741054,3578741094,40
0,1159,31003,3578741054,3578741094,40
0,1159,31004,3578741054,3578741096,42
0,1159,31005,3578741054,3578741098,44
0,1159,31006,3578741054,3578741099,45
0,1159,31007,3578741054,3578741099,45
0,1159,31008,3578741054,3578741100,46
0,1159,31009,3578741054,3578741101,47
0,1159,31010,3578741054,3578741101,47
0,1159,31011,3578741054,3578741102,48
0,1159,31012,3578741054,3578741102,48
0,1159,31013,3578741054,3578741103,49
0,1159,31014,3578741054,3578741103,49
0,1160,31015,3578741117,3578741117,0
0,1160,31016,3578741117,3578741117,0
0,1160,31017,3578741117,3578741117,0
0,1160,31018,3578741117,3578741117,0
0,1160,31019,3578741117,3578741117,0
0,1160,31020,3578741117,3578741117,0
0,1160,31021,3578741117,3578741117,0
0,1160,31022,3578741117,3578741117,0
0,1160,31023,3578741117,3578741117,0
0,1160,31024,3578741117,3578741117,0
0,1160,31025,3578741117,3578741117,0
0,1160,31026,3578741117,3578741117,0
0,1160,31027,3578741117,3578741117,0
0,1160,31028,3578741117,3578741117,0
0,1160,31029,3578741117,3578741117,0
0,1160,31030,3578741117,3578741117,0
0,1160,31031,3578741117,3578741117,0
0,1160,31032,3578741117,3578741117,0
0,1160,31033,3578741117,3578741117,0
0,1160,31034,3578741117,3578741117,0
0,1160,31035,3578741117,3578741118,1
0,1160,31036,3578741117,3578741118,1
0,1160,31037,3578741117,3578741118,1
0,1160,31038,3578741117,3578741119,2
0,1160,31039,3578741117,3578741120,3
0,1160,31040,3578741117,3578741120,3
0,1160,31041,3578741117,3578741121,4
0,1160,31042,3578741117,3578741123,6
0,1160,31043,3578741117,3578741124,7
0,1160,31044,3578741117,3578741126,9
0,1160,31045,3578741117,3578741127,10
0,1160,31046,3578741117,3578741127,10
0,1160,31047,3578741117,3578741128,11
0,1160,31048,3578741117,3578741128,11
0,1160,31049,3578741117,3578741129,12
0,1160,31050,3578741117,3578741131,14
0,1160,31051,3578741117,3578741131,14
0,1160,31052,3578741117,3578741131,14
0,1160,31053,3578741117,3578741132,15
0,1160,31054,3578741117,3578741132,15
0,1160,31055,3578741117,3578741132,15
0,1160,31056,3578741117,3578741136,19
0,1160,31057,3578741117,3578741137,20
0,1160,31058,3578741117,3578741138,21
0,1160,31059,3578741117,3578741139,22
0,1160,31060,3578741117,3578741139,22
0,1160,31061,3578741117,3578741139,22
0,1160,31062,3578741117,3578741140,23
0,1160,31063,3578741117,3578741141,24
0,1160,31064,3578741117,3578741141,24
0,1160,31065,3578741117,3578741141,24
0,1160,31066,3578741117,3578741142,25
0,1160,31067,3578741117,3578741143,26
0,1160,31068,3578741117,3578741143,26
0,1160,31069,3578741117,3578741144,27
0,1160,31070,3578741117,3578741144,27
0,1160,31071,3578741117,3578741145,28
0,1160,31072,3578741117,3578741145,28
0,1160,31073,3578741117,3578741145,28
0,1160,31074,3578741117,3578741146,29
0,1160,31075,3578741117,3578741146,29
0,1160,31076,3578741117,3578741147,30
0,1160,31077,3578741117,3578741147,30
0,1160,31078,3578741117,3578741147,30
0,1160,31079,3578741117,3578741147,30
0,1160,31080,3578741117,3578741147,30
0,1160,31081,3578741117,3578741149,32
0,1160,31082,3578741117,3578741151,34
0,1160,31083,3578741117,3578741153,36
0,1160,31084,3578741117,3578741153,36
0,1160,31085,3578741117,3578741153,36
0,1160,31086,3578741117,3578741153,36
0,1160,31087,3578741117,3578741154,37
0,1160,31088,3578741117,3578741155,38
0,1160,31089,3578741117,3578741157,40
0,1160,31090,3578741117,3578741157,40
0,1160,31091,3578741117,3578741158,41
0,1160,31092,3578741117,3578741159,42
0,1160,31093,3578741117,3578741161,44
0,1160,31094,3578741117,3578741161,44
0,1160,31095,3578741117,3578741161,44
0,1160,31096,3578741117,3578741161,44
0,1160,31097,3578741117,3578741161,44
0,1160,31098,3578741117,3578741162,45
0,1160,31099,3578741117,3578741162,45
0,1160,31100,3578741117,3578741163,46
0,1160,31101,3578741117,3578741163,46
0,1160,31102,3578741117,3578741166,49
0,1160,31103,3578741117,3578741166,49
0,1160,31104,3578741117,3578741167,50
0,1161,31105,3578741181,3578741181,0
0,1161,31106,3578741181,3578741181,0
0,1161,31107,3578741181,3578741181,0
0,1161,31108,3578741181,3578741181,0
0,1161,31109,3578741181,3578741181,0
0,1161,31110,3578741181,3578741181,0
0,1161,31111,3578741181,3578741181,0
0,1161,31112,3578741181,3578741181,0
0,1161,31113,3578741181,3578741181,0
0,1161,31114,3578741181,3578741181,0
0,1161,31115,3578741181,3578741181,0
0,1161,31116,3578741181,3578741181,0
0,1161,31117,3578741181,3578741181,0
0,1161,31118,3578741181,3578741181,0
0,1161,31119,3578741181,3578741181,0
0,1161,31120,3578741181,3578741181,0
0,1161,31121,3578741181,3578741181,0
0,1161,31122,3578741181,3578741181,0
0,1161,31123,3578741181,3578741183,2
0,1161,31124,3578741181,3578741184,3
0,1161,31125,3578741181,3578741185,4
0,1161,31126,3578741181,3578741188,7
0,1161,31127,3578741181,3578741189,8
0,1161,31128,3578741181,3578741189,8
0,1161,31129,3578741181,3578741189,8
0,1161,31130,3578741181,3578741190,9
0,1161,31131,3578741181,3578741190,9
0,1161,31132,3578741181,3578741191,10
0,1161,31133,3578741181,3578741191,10
0,1161,31134,3578741181,3578741191,10
0,1161,31135,3578741181,3578741193,12
0,1161,31136,3578741181,3578741193,12
0,1161,31137,3578741181,3578741194,13
0,1161,31138,3578741181,3578741195,14
0,1161,31139,3578741181,3578741198,17
0,1161,31140,3578741181,3578741200,19
0,1161,31141,3578741181,3578741200,19
0,1161,31142,3578741181,3578741201,20
0,1161,31143,3578741181,3578741203,22
0,1161,31144,3578741181,3578741203,22
0,1161,31145,3578741181,3578741204,23
0,1161,31146,3578741181,3578741204,23
0,1161,31147,3578741181,3578741204,23
0,1161,31148,3578741181,3578741205,24
0,1161,31149,3578741181,3578741205,24
0,1161,31150,3578741181,3578741206,25
0,1161,31151,3578741181,3578741206,25
0,1161,31152,3578741181,3578741209,28
0,1161,31153,3578741181,3578741209,28
0,1161,31154,3578741181,3578741209,28
0,1161,31155,3578741181,3578741209,28
0,1161,31156,3578741181,3578741209,28
0,1161,31157,3578741181,3578741209,28
0,1161,31158,3578741181,3578741211,30
0,1161,31159,3578741181,3578741212,31
0,1161,31160,3578741181,3578741212,31
0,1161,31161,3578741181,3578741214,33
0,1161,31162,3578741181,3578741214,33
0,1161,31163,3578741181,3578741215,34
0,1161,31164,3578741181,3578741215,34
0,1161,31165,3578741181,3578741215,34
0,1161,31166,3578741181,3578741216,35
0,1161,31167,3578741181,3578741218,37
0,1161,31168,3578741181,3578741219,38
0,1161,31169,3578741181,3578741219,38
0,1161,31170,3578741181,3578741220,39
0,1161,31171,3578741181,3578741221,40
0,1161,31172,3578741181,3578741222,41
0,1161,31173,3578741181,3578741223,42
0,1161,31174,3578741181,3578741225,44
0,1161,31175,3578741181,3578741225,44
0,1161,31176,3578741181,3578741229,48
0,1161,31177,3578741181,3578741229,48
0,1161,31178,3578741181,3578741231,50
0,1162,31179,3578741242,3578741242,0
0,1162,31180,3578741242,3578741242,0
0,1162,31181,3578741242,3578741242,0
0,1162,31182,3578741242,3578741242,0
0,1162,31183,3578741242,3578741242,0
0,1162,31184,3578741242,3578741242,0
0,1162,31185,3578741242,3578741242,0
0,1162,31186,3578741242,3578741242,0
0,1162,31187,3578741242,3578741242,0
0,1162,31188,3578741242,3578741242,0
0,1162,31189,3578741242,3578741242,0
0,1162,31190,3578741242,3578741244,2
0,1162,31191,3578741242,3578741244,2
0,1162,31192,3578741242,3578741246,4
0,1162,31193,3578741242,3578741247,5
0,1162,31194,3578741242,3578741249,7
0,1162,31195,3578741242,3578741249,7
0,1162,31196,3578741242,3578741249,7
0,1162,31197,3578741242,3578741251,9
0,1162,31198,3578741242,3578741251,9
0,1162,31199,3578741242,3578741251,9
0,1162,31200,3578741242,3578741253,11
0,1162,31201,3578741242,3578741253,11
0,1162,31202,3578741242,3578741256,14
0,1162,31203,3578741242,3578741256,14
0,1162,31204,3578741242,3578741257,15
0,1162,31205,3578741242,3578741257,15
0,1162,31206,3578741242,3578741257,15
0,1162,31207,3578741242,3578741261,19
0,1162,31208,3578741242,3578741261,19
0,1162,31209,3578741242,3578741262,20
0,1162,31210,3578741242,3578741264,22
0,1162,31211,3578741242,3578741264,22
0,1162,31212,3578741242,3578741265,23
0,1162,31213,3578741242,3578741265,23
0,1162,31214,3578741242,3578741265,23
0,1162,31215,3578741242,3578741266,24
0,1162,31216,3578741242,3578741267,25
0,1162,31217,3578741242,3578741267,25
0,1162,31218,3578741242,3578741268,26
0,1162,31219,3578741242,3578741275,33
0,1162,31220,3578741242,3578741277,35
0,1162,31221,3578741242,3578741277,35
0,1162,31222,3578741242,3578741279,37
0,1162,31223,3578741242,3578741279,37
0,1162,31224,3578741242,3578741280,38
0,1162,31225,3578741242,3578741280,38
0,1162,31226,3578741242,3578741281,39
0,1162,31227,3578741242,3578741281,39
0,1162,31228,3578741242,3578741283,41
0,1162,31229,3578741242,3578741283,41
0,1162,31230,3578741242,3578741283,41
0,1162,31231,3578741242,3578741284,42
0,1162,31232,3578741242,3578741285,43
0,1162,31233,3578741242,3578741287,45
0,1162,31234,3578741242,3578741287,45
0,1162,31235,3578741242,3578741287,45
0,1162,31236,3578741242,3578741287,45
0,1162,31237,3578741242,3578741287,45
0,1162,31238,3578741242,3578741288,46
0,1162,31239,3578741242,3578741288,46
0,1162,31240,3578741242,3578741290,48
0,1162,31241,3578741242,3578741290,48
0,1162,31242,3578741242,3578741290,48
0,1162,31243,3578741242,3578741290,48
0,1162,31244,3578741242,3578741292,50
0,1163,31245,3578741302,3578741302,0
0,1163,31246,3578741302,3578741302,0
0,1163,31247,3578741302,3578741302,0
0,1163,31248,3578741302,3578741302,0
0,1163,31249,3578741302,3578741302,0
0,1163,31250,3578741302,3578741302,0
0,1163,31251,3578741302,3578741302,0
0,1163,31252,3578741302,3578741302,0
0,1163,31253,3578741302,3578741302,0
0,1163,31254,3578741302,3578741302,0
0,1163,31255,3578741302,3578741302,0
0,1163,31256,3578741302,3578741302,0
0,1163,31257,3578741302,3578741302,0
0,1163,31258,3578741302,3578741302,0
0,1163,31259,3578741302,3578741303,1
0,1163,31260,3578741302,3578741305,3
0,1163,31261,3578741302,3578741306,4
0,1163,31262,3578741302,3578741306,4
0,1163,31263,3578741302,3578741306,4
0,1163,31264,3578741302,3578741307,5
0,1163,31265,3578741302,3578741308,6
0,1163,31266,3578741302,3578741308,6
0,1163,31267,3578741302,3578741308,6
0,1163,31268,3578741302,3578741308,6
0,1163,31269,3578741302,3578741308,6
0,1163,31270,3578741302,3578741309,7
0,1163,31271,3578741302,3578741310,8
0,1163,31272,3578741302,3578741311,9
0,1163,31273,3578741302,3578741312,10
0,1163,31274,3578741302,3578741314,12
0,1163,31275,3578741302,3578741315,13
0,1163,31276,3578741302,3578741315,13
0,1163,31277,3578741302,3578741315,13
0,1163,31278,3578741302,3578741315,13
0,1163,31279,3578741302,3578741315,13
0,1163,31280,3578741302,3578741316,14
0,1163,31281,3578741302,3578741317,15
0,1163,31282,3578741302,3578741317,15
0,1163,31283,3578741302,3578741318,16
0,1163,31284,3578741302,3578741318,16
0,1163,31285,3578741302,3578741318,16
0,1163,31286,3578741302,3578741319,17
0,1163,31287,3578741302,3578741319,17
0,1163,31288,3578741302,3578741320,18
0,1163,31289,3578741302,3578741320,18
0,1163,31290,3578741302,3578741322,20
0,1163,31291,3578741302,3578741323,21
0,1163,31292,3578741302,3578741325,23
0,1163,31293,3578741302,3578741327,25
0,1163,31294,3578741302,3578741327,25
0,1163,31295,3578741302,3578741328,26
0,1163,31296,3578741302,3578741328,26
0,1163,31297,3578741302,3578741328,26
0,1163,31298,3578741302,3578741330,28
0,1163,31299,3578741302,3578741331,29
0,1163,31300,3578741302,3578741331,29
0,1163,31301,3578741302,3578741332,30
0,1163,31302,3578741302,3578741332,30
0,1163,31303,3578741302,3578741332,30
0,1163,31304,3578741302,3578741332,30
0,1163,31305,3578741302,3578741333,31
0,1163,31306,3578741302,3578741339,37
0,1163,31307,3578741302,3578741339,37
0,1163,31308,3578741302,3578741339,37
0,1163,31309,3578741302,3578741340,38
0,1163,31310,3578741302,3578741340,38
0,1163,31311,3578741302,3578741341,39
0,1163,31312,3578741302,3578741341,39
0,1163,31313,3578741302,3578741343,41
0,1163,31314,3578741302,3578741343,41
0,1163,31315,3578741302,3578741343,41
0,1163,31316,3578741302,3578741344,42
0,1163,31317,3578741302,3578741345,43
0,1163,31318,3578741302,3578741345,43
0,1163,31319,3578741302,3578741345,43
0,1163,31320,3578741302,3578741346,44
0,1163,31321,3578741302,3578741346,44
0,1163,31322,3578741302,3578741346,44
0,1163,31323,3578741302,3578741347,45
0,1163,31324,3578741302,3578741348,46
0,1163,31325,3578741302,3578741349,47
0,1163,31326,3578741302,3578741351,49
0,1164,31327,3578741366,3578741366,0
0,1164,31328,3578741366,3578741366,0
0,1164,31329,3578741366,3578741366,0
0,1164,31330,3578741366,3578741367,1
0,1164,31331,3578741366,3578741367,1
0,1164,31332,3578741366,3578741367,1
0,1164,31333,3578741366,3578741367,1
0,1164,31334,3578741366,3578741367,1
0,1164,31335,3578741366,3578741367,1
0,1164,31336,3578741366,3578741367,1
0,1164,31337,3578741366,3578741367,1
0,1164,31338,3578741366,3578741367,1
0,1164,31339,3578741366,3578741367,1
0,1164,31340,3578741366,3578741367,1
0,1164,31341,3578741366,3578741367,1
0,1164,31342,3578741366,3578741367,1
0,1164,31343,3578741366,3578741367,1
0,1164,31344,3578741366,3578741367,1
0,1164,31345,3578741366,3578741367,1
0,1164,31346,3578741366,3578741367,1
0,1164,31347,3578741366,3578741367,1
0,1164,31348,3578741366,3578741368,2
0,1164,31349,3578741366,3578741368,2
0,1164,31350,3578741366,3578741368,2
0,1164,31351,3578741366,3578741369,3
0,1164,31352,3578741366,3578741369,3
0,1164,31353,3578741366,3578741370,4
0,1164,31354,3578741366,3578741372,6
0,1164,31355,3578741366,3578741373,7
0,1164,31356,3578741366,3578741373,7
0,1164,31357,3578741366,3578741374,8
0,1164,31358,3578741366,3578741376,10
0,1164,31359,3578741366,3578741376,10
0,1164,31360,3578741366,3578741377,11
0,1164,31361,3578741366,3578741377,11
0,1164,31362,3578741366,3578741379,13
0,1164,31363,3578741366,3578741379,13
0,1164,31364,3578741366,3578741379,13
0,1164,31365,3578741366,3578741381,15
0,1164,31366,3578741366,3578741381,15
0,1164,31367,3578741366,3578741381,15
0,1164,31368,3578741366,3578741382,16
0,1164,31369,3578741366,3578741382,16
0,1164,31370,3578741366,3578741384,18
0,1164,31371,3578741366,3578741385,19
0,1164,31372,3578741366,3578741388,22
0,1164,31373,3578741366,3578741388,22
0,1164,31374,3578741366,3578741389,23
0,1164,31375,3578741366,3578741389,23
0,1164,31376,3578741366,3578741389,23
0,1164,31377,3578741366,3578741390,24
0,1164,31378,3578741366,3578741390,24
0,1164,31379,3578741366,3578741390,24
0,1164,31380,3578741366,3578741391,25
0,1164,31381,3578741366,3578741391,25
0,1164,31382,3578741366,3578741391,25
0,1164,31383,3578741366,3578741393,27
0,1164,31384,3578741366,3578741394,28
0,1164,31385,3578741366,3578741394,28
0,1164,31386,3578741366,3578741395,29
0,1164,31387,3578741366,3578741399,33
0,1164,31388,3578741366,3578741400,34
0,1164,31389,3578741366,3578741401,35
0,1164,31390,3578741366,3578741401,35
0,1164,31391,3578741366,3578741402,36
0,1164,31392,3578741366,3578741404,38
0,1164,31393,3578741366,3578741404,38
0,1164,31394,3578741366,3578741405,39
0,1164,31395,3578741366,3578741405,39
0,1164,31396,3578741366,3578741406,40
0,1164,31397,3578741366,3578741406,40
0,1164,31398,3578741366,3578741406,40
0,1164,31399,3578741366,3578741408,42
0,1164,31400,3578741366,3578741409,43
0,1164,31401,3578741366,3578741409,43
0,1164,31402,3578741366,3578741409,43
0,1164,31403,3578741366,3578741409,43
0,1164,31404,3578741366,3578741410,44
0,1164,31405,3578741366,3578741410,44
0,1164,31406,3578741366,3578741411,45
0,1164,31407,3578741366,3578741412,46
0,1164,31408,3578741366,3578741413,47
0,1164,31409,3578741366,3578741414,48
0,1164,31410,3578741366,3578741415,49
0,1164,31411,3578741366,3578741415,49
0,1164,31412,3578741366,3578741415,49
0,1164,31413,3578741366,3578741415,49
0,1164,31414,3578741366,3578741416,50
0,1165,31415,3578741427,3578741427,0
0,1165,31416,3578741427,3578741427,0
0,1165,31417,3578741427,3578741427,0
0,1165,31418,3578741427,3578741427,0
0,1165,31419,3578741427,3578741427,0
0,1165,31420,3578741427,3578741427,0
0,1165,31421,3578741427,3578741427,0
0,1165,31422,3578741427,3578741427,0
0,1165,31423,3578741427,3578741427,0
0,1165,31424,3578741427,3578741429,2
0,1165,31425,3578741427,3578741431,4
0,1165,31426,3578741427,3578741433,6
0,1165,31427,3578741427,3578741433,6
0,1165,31428,3578741427,3578741434,7
0,1165,31429,3578741427,3578741437,10
0,1165,31430,3578741427,3578741438,11
0,1165,31431,3578741427,3578741439,12
0,1165,31432,3578741427,3578741439,12
0,1165,31433,3578741427,3578741440,13
0,1165,31434,3578741427,3578741441,14
0,1165,31435,3578741427,3578741441,14
0,1165,31436,3578741427,3578741442,15
0,1165,31437,3578741427,3578741442,15
0,1165,31438,3578741427,3578741444,17
0,1165,31439,3578741427,3578741444,17
0,1165,31440,3578741427,3578741444,17
0,1165,31441,3578741427,3578741446,19
0,1165,31442,3578741427,3578741448,21
0,1165,31443,3578741427,3578741450,23
0,1165,31444,3578741427,3578741450,23
0,1165,31445,3578741427,3578741450,23
0,1165,31446,3578741427,3578741451,24
0,1165,31447,3578741427,3578741452,25
0,1165,31448,3578741427,3578741452,25
0,1165,31449,3578741427,3578741453,26
0,1165,31450,3578741427,3578741456,29
0,1165,31451,3578741427,3578741457,30
0,1165,31452,3578741427,3578741457,30
0,1165,31453,3578741427,3578741458,31
0,1165,31454,3578741427,3578741459,32
0,1165,31455,3578741427,3578741460,33
0,1165,31456,3578741427,3578741460,33
0,1165,31457,3578741427,3578741461,34
0,1165,31458,3578741427,3578741461,34
0,1165,31459,3578741427,3578741463,36
0,1165,31460,3578741427,3578741464,37
0,1165,31461,3578741427,3578741464,37
0,1165,31462,3578741427,3578741464,37
0,1165,31463,3578741427,3578741465,38
0,1165,31464,3578741427,3578741466,39
0,1165,31465,3578741427,3578741467,40
0,1165,31466,3578741427,3578741468,41
0,1165,31467,3578741427,3578741468,41
0,1165,31468,3578741427,3578741468,41
0,1165,31469,3578741427,3578741475,48
0,1166,31470,3578741489,3578741489,0
0,1166,31471,3578741489,3578741489,0
0,1166,31472,3578741489,3578741489,0
0,1166,31473,3578741489,3578741489,0
0,1166,31474,3578741489,3578741489,0
0,1166,31475,3578741489,3578741489,0
0,1166,31476,3578741489,3578741489,0
0,1166,31477,3578741489,3578741489,0
0,1166,31478,3578741489,3578741489,0
0,1166,31479,3578741489,3578741489,0
0,1166,31480,3578741489,3578741489,0
0,1166,31481,3578741489,3578741489,0
0,1166,31482,3578741489,3578741489,0
0,1166,31483,3578741489,3578741489,0
0,1166,31484,3578741489,3578741489,0
0,1166,31485,3578741489,3578741489,0
0,1166,31486,3578741489,3578741489,0
0,1166,31487,3578741489,3578741489,0
0,1166,31488,3578741489,3578741489,0
0,1166,31489,3578741489,3578741489,0
0,1166,31490,3578741489,3578741489,0
0,1166,31491,3578741489,3578741489,0
0,1166,31492,3578741489,3578741489,0
0,1166,31493,3578741489,3578741491,2
0,1166,31494,3578741489,3578741491,2
0,1166,31495,3578741489,3578741492,3
0,1166,31496,3578741489,3578741492,3
0,1166,31497,3578741489,3578741493,4
0,1166,31498,3578741489,3578741493,4
0,1166,31499,3578741489,3578741496,7
0,1166,31500,3578741489,3578741497,8
0,1166,31501,3578741489,3578741497,8
0,1166,31502,3578741489,3578741498,9
0,1166,31503,3578741489,3578741499,10
0,1166,31504,3578741489,3578741500,11
0,1166,31505,3578741489,3578741500,11
0,1166,31506,3578741489,3578741501,12
0,1166,31507,3578741489,3578741501,12
0,1166,31508,3578741489,3578741502,13
0,1166,31509,3578741489,3578741503,14
0,1166,31510,3578741489,3578741505,16
0,1166,31511,3578741489,3578741505,16
0,1166,31512,3578741489,3578741506,17
0,1166,31513,3578741489,3578741507,18
0,1166,31514,3578741489,3578741507,18
0,1166,31515,3578741489,3578741507,18
0,1166,31516,3578741489,3578741507,18
0,1166,31517,3578741489,3578741508,19
0,1166,31518,3578741489,3578741508,19
0,1166,31519,3578741489,3578741509,20
0,1166,31520,3578741489,3578741510,21
0,1166,31521,3578741489,3578741511,22
0,1166,31522,3578741489,3578741511,22
0,1166,31523,3578741489,3578741513,24
0,1166,31524,3578741489,3578741514,25
0,1166,31525,3578741489,3578741515,26
0,1166,31526,3578741489,3578741515,26
0,1166,31527,3578741489,3578741515,26
0,1166,31528,3578741489,3578741516,27
0,1166,31529,3578741489,3578741517,28
0,1166,31530,3578741489,3578741517,28
0,1166,31531,3578741489,3578741517,28
0,1166,31532,3578741489,3578741518,29
0,1166,31533,3578741489,3578741518,29
0,1166,31534,3578741489,3578741518,29
0,1166,31535,3578741489,3578741518,29
0,1166,31536,3578741489,3578741520,31
0,1166,31537,3578741489,3578741522,33
0,1166,31538,3578741489,3578741522,33
0,1166,31539,3578741489,3578741524,35
0,1166,31540,3578741489,3578741524,35
0,1166,31541,3578741489,3578741527,38
0,1166,31542,3578741489,3578741527,38
0,1166,31543,3578741489,3578741527,38
0,1166,31544,3578741489,3578741527,38
0,1166,31545,3578741489,3578741528,39
0,1166,31546,3578741489,3578741529,40
0,1166,31547,3578741489,3578741530,41
0,1166,31548,3578741489,3578741530,41
0,1166,31549,3578741489,3578741530,41
0,1166,31550,3578741489,3578741531,42
0,1166,31551,3578741489,3578741531,42
0,1166,31552,3578741489,3578741531,42
0,1166,31553,3578741489,3578741533,44
0,1166,31554,3578741489,3578741534,45
0,1166,31555,3578741489,3578741536,47
0,1166,31556,3578741489,3578741538,49
0,1166,31557,3578741489,3578741539,50
0,1167,31558,3578741552,3578741552,0
0,1167,31559,3578741552,3578741552,0
0,1167,31560,3578741552,3578741552,0
0,1167,31561,3578741552,3578741552,0
0,1167,31562,3578741552,3578741552,0
0,1167,31563,3578741552,3578741552,0
0,1167,31564,3578741552,3578741552,0
0,1167,31565,3578741552,3578741552,0
0,1167,31566,3578741552,3578741552,0
0,1167,31567,3578741552,3578741552,0
0,1167,31568,3578741552,3578741552,0
0,1167,31569,3578741552,3578741552,0
0,1167,31570,3578741552,3578741552,0
0,1167,31571,3578741552,3578741552,0
0,1167,31572,3578741552,3578741552,0
0,1167,31573,3578741552,3578741552,0
0,1167,31574,3578741552,3578741552,0
0,1167,31575,3578741552,3578741552,0
0,1167,31576,3578741552,3578741552,0
0,1167,31577,3578741552,3578741552,0
0,1167,31578,3578741552,3578741552,0
0,1167,31579,3578741552,3578741552,0
0,1167,31580,3578741552,3578741555,3
0,1167,31581,3578741552,3578741555,3
0,1167,31582,3578741552,3578741556,4
0,1167,31583,3578741552,3578741557,5
0,1167,31584,3578741552,3578741557,5
0,1167,31585,3578741552,3578741559,7
0,1167,31586,3578741552,3578741560,8
0,1167,31587,3578741552,3578741560,8
0,1167,31588,3578741552,3578741560,8
0,1167,31589,3578741552,3578741560,8
0,1167,31590,3578741552,3578741561,9
0,1167,31591,3578741552,3578741561,9
0,1167,31592,3578741552,3578741561,9
0,1167,31593,3578741552,3578741562,10
0,1167,31594,3578741552,3578741565,13
0,1167,31595,3578741552,3578741565,13
0,1167,31596,3578741552,3578741565,13
0,1167,31597,3578741552,3578741566,14
0,1167,31598,3578741552,3578741568,16
0,1167,31599,3578741552,3578741568,16
0,1167,31600,3578741552,3578741569,17
0,1167,31601,3578741552,3578741569,17
0,1167,31602,3578741552,3578741570,18
0,1167,31603,3578741552,3578741570,18
0,1167,31604,3578741552,3578741571,19
0,1167,31605,3578741552,3578741573,21
0,1167,31606,3578741552,3578741573,21
0,1167,31607,3578741552,3578741574,22
0,1167,31608,3578741552,3578741575,23
0,1167,31609,3578741552,3578741576,24
0,1167,31610,3578741552,3578741576,24
0,1167,31611,3578741552,3578741577,25
0,1167,31612,3578741552,3578741578,26
0,1167,31613,3578741552,3578741578,26
0,1167,31614,3578741552,3578741578,26
0,1167,31615,3578741552,3578741578,26
0,1167,31616,3578741552,3578741579,27
0,1167,31617,3578741552,3578741580,28
0,1167,31618,3578741552,3578741581,29
0,1167,31619,3578741552,3578741582,30
0,1167,31620,3578741552,3578741585,33
0,1167,31621,3578741552,3578741588,36
0,1167,31622,3578741552,3578741588,36
0,1167,31623,3578741552,3578741589,37
0,1167,31624,3578741552,3578741589,37
0,1167,31625,3578741552,3578741590,38
0,1167,31626,3578741552,3578741590,38
0,1167,31627,3578741552,3578741590,38
0,1167,31628,3578741552,3578741590,38
0,1167,31629,3578741552,3578741591,39
0,1167,31630,3578741552,3578741592,40
0,1167,31631,3578741552,3578741593,41
0,1167,31632,3578741552,3578741593,41
0,1167,31633,3578741552,3578741595,43
0,1167,31634,3578741552,3578741597,45
0,1167,31635,3578741552,3578741599,47
0,1167,31636,3578741552,3578741600,48
0,1168,31637,3578741615,3578741615,0
0,1168,31638,3578741615,3578741615,0
0,1168,31639,3578741615,3578741615,0
0,1168,31640,3578741615,3578741615,0
0,1168,31641,3578741615,3578741615,0
0,1168,31642,3578741615,3578741615,0
0,1168,31643,3578741615,3578741615,0
0,1168,31644,3578741615,3578741615,0
0,1168,31645,3578741615,3578741616,1
0,1168,31646,3578741615,3578741616,1
0,1168,31647,3578741615,3578741616,1
0,1168,31648,3578741615,3578741616,1
0,1168,31649,3578741615,3578741616,1
0,1168,31650,3578741615,3578741616,1
0,1168,31651,3578741615,3578741616,1
0,1168,31652,3578741615,3578741616,1
0,1168,31653,3578741615,3578741616,1
0,1168,31654,3578741615,3578741616,1
0,1168,31655,3578741615,3578741616,1
0,1168,31656,3578741615,3578741616,1
0,1168,31657,3578741615,3578741616,1
0,1168,31658,3578741615,3578741616,1
0,1168,31659,3578741615,3578741616,1
0,1168,31660,3578741615,3578741616,1
0,1168,31661,3578741615,3578741616,1
0,1168,31662,3578741615,3578741616,1
0,1168,31663,3578741615,3578741618,3
0,1168,31664,3578741615,3578741618,3
0,1168,31665,3578741615,3578741618,3
0,1168,31666,3578741615,3578741620,5
0,1168,31667,3578741615,3578741620,5
0,1168,31668,3578741615,3578741620,5
0,1168,31669,3578741615,3578741621,6
0,1168,31670,3578741615,3578741622,7
0,1168,31671,3578741615,3578741624,9
0,1168,31672,3578741615,3578741626,11
0,1168,31673,3578741615,3578741628,13
0,1168,31674,3578741615,3578741629,14
0,1168,31675,3578741615,3578741629,14
0,1168,31676,3578741615,3578741631,16
0,1168,31677,3578741615,3578741631,16
0,1168,31678,3578741615,3578741633,18
0,1168,31679,3578741615,3578741636,21
0,1168,31680,3578741615,3578741637,22
0,1168,31681,3578741615,3578741638,23
0,1168,31682,3578741615,3578741638,23
0,1168,31683,3578741615,3578741639,24
0,1168,31684,3578741615,3578741640,25
0,1168,31685,3578741615,3578741640,25
0,1168,31686,3578741615,3578741640,25
0,1168,31687,3578741615,3578741641,26
0,1168,31688,3578741615,3578741642,27
0,1168,31689,3578741615,3578741643,28
0,1168,31690,3578741615,3578741644,29
0,1168,31691,3578741615,3578741645,30
0,1168,31692,3578741615,3578741647,32
0,1168,31693,3578741615,3578741649,34
0,1168,31694,3578741615,3578741649,34
0,1168,31695,3578741615,3578741649,34
0,1168,31696,3578741615,3578741649,34
0,1168,31697,3578741615,3578741651,36
0,1168,31698,3578741615,3578741651,36
0,1168,31699,3578741615,3578741652,37
0,1168,31700,3578741615,3578741655,40
0,1168,31701,3578741615,3578741655,40
0,1168,31702,3578741615,3578741656,41
0,1168,31703,3578741615,3578741657,42
0,1168,31704,3578741615,3578741658,43
0,1168,31705,3578741615,3578741659,44
0,1168,31706,3578741615,3578741660,45
0,1168,31707,3578741615,3578741661,46
0,1168,31708,3578741615,3578741661,46
0,1168,31709,3578741615,3578741663,48
0,1168,31710,3578741615,3578741663,48
0,1168,31711,3578741615,3578741664,49
0,1168,31712,3578741615,3578741664,49
0,1168,31713,3578741615,3578741664,49
0,1168,31714,3578741615,3578741664,49
0,1168,31715,3578741615,3578741665,50
0,1169,31716,3578741677,3578741677,0
0,1169,31717,3578741677,3578741677,0
0,1169,31718,3578741677,3578741677,0
0,1169,31719,3578741677,3578741677,0
0,1169,31720,3578741677,3578741677,0
0,1169,31721,3578741677,3578741678,1
0,1169,31722,3578741677,3578741679,2
0,1169,31723,3578741677,3578741680,3
0,1169,31724,3578741677,3578741682,5
0,1169,31725,3578741677,3578741682,5
0,1169,31726,3578741677,3578741682,5
0,1169,31727,3578741677,3578741683,6
0,1169,31728,3578741677,3578741683,6
0,1169,31729,3578741677,3578741683,6
0,1169,31730,3578741677,3578741683,6
0,1169,31731,3578741677,3578741685,8
0,1169,31732,3578741677,3578741685,8
0,1169,31733,3578741677,3578741686,9
0,1169,31734,3578741677,3578741687,10
0,1169,31735,3578741677,3578741687,10
0,1169,31736,3578741677,3578741687,10
0,1169,31737,3578741677,3578741687,10
0,1169,31738,3578741677,3578741687,10
0,1169,31739,3578741677,3578741689,12
0,1169,31740,3578741677,3578741689,12
0,1169,31741,3578741677,3578741689,12
0,1169,31742,3578741677,3578741690,13
0,1169,31743,3578741677,3578741691,14
0,1169,31744,3578741677,3578741691,14
0,1169,31745,3578741677,3578741692,15
0,1169,31746,3578741677,3578741692,15
0,1169,31747,3578741677,3578741693,16
0,1169,31748,3578741677,3578741693,16
0,1169,31749,3578741677,3578741693,16
0,1169,31750,3578741677,3578741696,19
0,1169,31751,3578741677,3578741697,20
0,1169,31752,3578741677,3578741697,20
0,1169,31753,3578741677,3578741697,20
0,1169,31754,3578741677,3578741698,21
0,1169,31755,3578741677,3578741700,23
0,1169,31756,3578741677,3578741701,24
0,1169,31757,3578741677,3578741701,24
0,1169,31758,3578741677,3578741701,24
0,1169,31759,3578741677,3578741702,25
0,1169,31760,3578741677,3578741703,26
0,1169,31761,3578741677,3578741705,28
0,1169,31762,3578741677,3578741705,28
0,1169,31763,3578741677,3578741706,29
0,1169,31764,3578741677,3578741706,29
0,1169,31765,3578741677,3578741707,30
0,1169,31766,3578741677,3578741707,30
0,1169,31767,3578741677,3578741707,30
0,1169,31768,3578741677,3578741707,30
0,1169,31769,3578741677,3578741708,31
0,1169,31770,3578741677,3578741709,32
0,1169,31771,3578741677,3578741710,33
0,1169,31772,3578741677,3578741711,34
0,1169,31773,3578741677,3578741712,35
0,1169,31774,3578741677,3578741713,36
0,1169,31775,3578741677,3578741713,36
0,1169,31776,3578741677,3578741715,38
0,1169,31777,3578741677,3578741715,38
0,1169,31778,3578741677,3578741715,38
0,1169,31779,3578741677,3578741715,38
0,1169,31780,3578741677,3578741715,38
0,1169,31781,3578741677,3578741715,38
0,1169,31782,3578741677,3578741716,39
0,1169,31783,3578741677,3578741717,40
0,1169,31784,3578741677,3578741717,40
0,1169,31785,3578741677,3578741717,40
0,1169,31786,3578741677,3578741718,41
0,1169,31787,3578741677,3578741718,41
0,1169,31788,3578741677,3578741718,41
0,1169,31789,3578741677,3578741718,41
0,1169,31790,3578741677,3578741720,43
0,1169,31791,3578741677,3578741721,44
0,1169,31792,3578741677,3578741723,46
0,1169,31793,3578741677,3578741724,47
0,1169,31794,3578741677,3578741726,49
0,1169,31795,3578741677,3578741727,50
0,1170,31796,3578741738,3578741738,0
0,1170,31797,3578741738,3578741738,0
0,1170,31798,3578741738,3578741738,0
0,1170,31799,3578741738,3578741738,0
0,1170,31800,3578741738,3578741738,0
0,1170,31801,3578741738,3578741738,0
0,1170,31802,3578741738,3578741738,0
0,1170,31803,3578741738,3578741738,0
0,1170,31804,3578741738,3578741738,0
0,1170,31805,3578741738,3578741738,0
0,1170,31806,3578741738,3578741738,0
0,1170,31807,3578741738,3578741738,0
0,1170,31808,3578741738,3578741738,0
0,1170,31809,3578741738,3578741738,0
0,1170,31810,3578741738,3578741738,0
0,1170,31811,3578741738,3578741739,1
0,1170,31812,3578741738,3578741739,1
0,1170,31813,3578741738,3578741739,1
0,1170,31814,3578741738,3578741740,2
0,1170,31815,3578741738,3578741740,2
0,1170,31816,3578741738,3578741740,2
0,1170,31817,3578741738,3578741740,2
0,1170,31818,3578741738,3578741741,3
0,1170,31819,3578741738,3578741742,4
0,1170,31820,3578741738,3578741742,4
0,1170,31821,3578741738,3578741743,5
0,1170,31822,3578741738,3578741744,6
0,1170,31823,3578741738,3578741744,6
0,1170,31824,3578741738,3578741745,7
0,1170,31825,3578741738,3578741745,7
0,1170,31826,3578741738,3578741746,8
0,1170,31827,3578741738,3578741746,8
0,1170,31828,3578741738,3578741747,9
0,1170,31829,3578741738,3578741748,10
0,1170,31830,3578741738,3578741748,10
0,1170,31831,3578741738,3578741750,12
0,1170,31832,3578741738,3578741752,14
0,1170,31833,3578741738,3578741752,14
0,1170,31834,3578741738,3578741755,17
0,1170,31835,3578741738,3578741756,18
0,1170,31836,3578741738,3578741757,19
0,1170,31837,3578741738,3578741758,20
0,1170,31838,3578741738,3578741759,21
0,1170,31839,3578741738,3578741759,21
0,1170,31840,3578741738,3578741760,22
0,1170,31841,3578741738,3578741760,22
0,1170,31842,3578741738,3578741761,23
0,1170,31843,3578741738,3578741761,23
0,1170,31844,3578741738,3578741761,23
0,1170,31845,3578741738,3578741761,23
0,1170,31846,3578741738,3578741762,24
0,1170,31847,3578741738,3578741765,27
0,1170,31848,3578741738,3578741766,28
0,1170,31849,3578741738,3578741767,29
0,1170,31850,3578741738,3578741767,29
0,1170,31851,3578741738,3578741768,30
0,1170,31852,3578741738,3578741768,30
0,1170,31853,3578741738,3578741769,31
0,1170,31854,3578741738,3578741769,31
0,1170,31855,3578741738,3578741770,32
0,1170,31856,3578741738,3578741771,33
0,1170,31857,3578741738,3578741773,35
0,1170,31858,3578741738,3578741774,36
0,1170,31859,3578741738,3578741776,38
0,1170,31860,3578741738,3578741776,38
0,1170,31861,3578741738,3578741777,39
0,1170,31862,3578741738,3578741778,40
0,1170,31863,3578741738,3578741778,40
0,1170,31864,3578741738,3578741778,40
0,1170,31865,3578741738,3578741779,41
0,1170,31866,3578741738,3578741781,43
0,1170,31867,3578741738,3578741781,43
0,1170,31868,3578741738,3578741782,44
0,1170,31869,3578741738,3578741783,45
0,1170,31870,3578741738,3578741785,47
0,1170,31871,3578741738,3578741787,49
0,1170,31872,3578741738,3578741788,50
0,1171,31873,3578741799,3578741800,1
0,1171,31874,3578741799,3578741800,1
0,1171,31875,3578741799,3578741800,1
0,1171,31876,3578741799,3578741800,1
0,1171,31877,3578741799,3578741800,1
0,1171,31878,3578741799,3578741800,1
0,1171,31879,3578741799,3578741800,1
0,1171,31880,3578741799,3578741800,1
0,1171,31881,3578741799,3578741800,1
0,1171,31882,3578741799,3578741800,1
0,1171,31883,3578741799,3578741800,1
0,1171,31884,3578741799,3578741800,1
0,1171,31885,3578741799,3578741800,1
0,1171,31886,3578741799,3578741800,1
0,1171,31887,3578741799,3578741800,1
0,1171,31888,3578741799,3578741800,1
0,1171,31889,3578741799,3578741801,2
0,1171,31890,3578741799,3578741803,4
0,1171,31891,3578741799,3578741803,4
0,1171,31892,3578741799,3578741803,4
0,1171,31893,3578741799,3578741803,4
0,1171,31894,3578741799,3578741804,5
0,1171,31895,3578741799,3578741805,6
0,1171,31896,3578741799,3578741805,6
0,1171,31897,3578741799,3578741806,7
0,1171,31898,3578741799,3578741806,7
0,1171,31899,3578741799,3578741807,8
0,1171,31900,3578741799,3578741808,9
0,1171,31901,3578741799,3578741808,9
0,1171,31902,3578741799,3578741809,10
0,1171,31903,3578741799,3578741809,10
0,1171,31904,3578741799,3578741809,10
0,1171,31905,3578741799,3578741811,12
0,1171,31906,3578741799,3578741812,13
0,1171,31907,3578741799,3578741813,14
0,1171,31908,3578741799,3578741813,14
0,1171,31909,3578741799,3578741814,15
0,1171,31910,3578741799,3578741814,15
0,1171,31911,3578741799,3578741815,16
0,1171,31912,3578741799,3578741815,16
0,1171,31913,3578741799,3578741815,16
0,1171,31914,3578741799,3578741816,17
0,1171,31915,3578741799,3578741817,18
0,1171,31916,3578741799,3578741818,19
0,1171,31917,3578741799,3578741819,20
0,1171,31918,3578741799,3578741819,20
0,1171,31919,3578741799,3578741819,20
0,1171,31920,3578741799,3578741820,21
0,1171,31921,3578741799,3578741821,22
0,1171,31922,3578741799,3578741821,22
0,1171,31923,3578741799,3578741822,23
0,1171,31924,3578741799,3578741822,23
0,1171,31925,3578741799,3578741824,25
0,1171,31926,3578741799,3578741827,28
0,1171,31927,3578741799,3578741828,29
0,1171,31928,3578741799,3578741828,29
0,1171,31929,3578741799,3578741830,31
0,1171,31930,3578741799,3578741831,32
0,1171,31931,3578741799,3578741832,33
0,1171,31932,3578741799,3578741833,34
0,1171,31933,3578741799,3578741836,37
0,1171,31934,3578741799,3578741838,39
0,1171,31935,3578741799,3578741838,39
0,1171,31936,3578741799,3578741840,41
0,1171,31937,3578741799,3578741840,41
0,1171,31938,3578741799,3578741840,41
0,1171,31939,3578741799,3578741841,42
0,1171,31940,3578741799,3578741841,42
0,1171,31941,3578741799,3578741841,42
0,1171,31942,3578741799,3578741842,43
0,1171,31943,3578741799,3578741843,44
0,1171,31944,3578741799,3578741843,44
0,1171,31945,3578741799,3578741845,46
0,1171,31946,3578741799,3578741846,47
0,1171,31947,3578741799,3578741849,50
0,1172,31948,3578741861,3578741861,0
0,1172,31949,3578741861,3578741861,0
0,1172,31950,3578741861,3578741861,0
0,1172,31951,3578741861,3578741861,0
0,1172,31952,3578741861,3578741861,0
0,1172,31953,3578741861,3578741861,0
0,1172,31954,3578741861,3578741861,0
0,1172,31955,3578741861,3578741861,0
0,1172,31956,3578741861,3578741861,0
0,1172,31957,3578741861,3578741861,0
0,1172,31958,3578741861,3578741861,0
0,1172,31959,3578741861,3578741861,0
0,1172,31960,3578741861,3578741861,0
0,1172,31961,3578741861,3578741863,2
0,1172,31962,3578741861,3578741863,2
0,1172,31963,3578741861,3578741863,2
0,1172,31964,3578741861,3578741864,3
0,1172,31965,3578741861,3578741867,6
0,1172,31966,3578741861,3578741867,6
0,1172,31967,3578741861,3578741868,7
0,1172,31968,3578741861,3578741875,14
0,1172,31969,3578741861,3578741877,16
0,1172,31970,3578741861,3578741879,18
0,1172,31971,3578741861,3578741880,19
0,1172,31972,3578741861,3578741881,20
0,1172,31973,3578741861,3578741881,20
0,1172,31974,3578741861,3578741881,20
0,1172,31975,3578741861,3578741882,21
0,1172,31976,3578741861,3578741882,21
0,1172,31977,3578741861,3578741882,21
0,1172,31978,3578741861,3578741883,22
0,1172,31979,3578741861,3578741883,22
0,1172,31980,3578741861,3578741884,23
0,1172,31981,3578741861,3578741885,24
0,1172,31982,3578741861,3578741886,25
0,1172,31983,3578741861,3578741887,26
0,1172,31984,3578741861,3578741887,26
0,1172,31985,3578741861,3578741887,26
0,1172,31986,3578741861,3578741887,26
0,1172,31987,3578741861,3578741888,27
0,1172,31988,3578741861,3578741888,27
0,1172,31989,3578741861,3578741889,28
0,1172,31990,3578741861,3578741889,28
0,1172,31991,3578741861,3578741889,28
0,1172,31992,3578741861,3578741890,29
0,1172,31993,3578741861,3578741891,30
0,1172,31994,3578741861,3578741891,30
0,1172,31995,3578741861,3578741891,30
0,1172,31996,3578741861,3578741893,32
0,1172,31997,3578741861,3578741893,32
0,1172,31998,3578741861,3578741893,32
0,1172,31999,3578741861,3578741896,35
0,1172,32000,3578741861,3578741897,36
0,1172,32001,3578741861,3578741897,36
0,1172,32002,3578741861,3578741898,37
0,1172,32003,3578741861,3578741898,37
0,1172,32004,3578741861,3578741900,39
0,1172,32005,3578741861,3578741901,40
0,1172,32006,3578741861,3578741901,40
0,1172,32007,3578741861,3578741902,41
0,1172,32008,3578741861,3578741902,41
0,1172,32009,3578741861,3578741903,42
0,1172,32010,3578741861,3578741905,44
0,1172,32011,3578741861,3578741906,45
0,1172,32012,3578741861,3578741907,46
0,1172,32013,3578741861,3578741907,46
0,1172,32014,3578741861,3578741907,46
0,1172,32015,3578741861,3578741908,47
0,1172,32016,3578741861,3578741908,47
0,1172,32017,3578741861,3578741909,48
0,1172,32018,3578741861,3578741910,49
0,1173,32019,3578741924,3578741924,0
0,1173,32020,3578741924,3578741924,0
0,1173,32021,3578741924,3578741924,0
0,1173,32022,3578741924,3578741924,0
0,1173,32023,3578741924,3578741924,0
0,1173,32024,3578741924,3578741924,0
0,1173,32025,3578741924,3578741924,0
0,1173,32026,3578741924,3578741924,0
0,1173,32027,3578741924,3578741924,0
0,1173,32028,3578741924,3578741924,0
0,1173,32029,3578741924,3578741924,0
0,1173,32030,3578741924,3578741924,0
0,1173,32031,3578741924,3578741924,0
0,1173,32032,3578741924,3578741924,0
0,1173,32033,3578741924,3578741924,0
0,1173,32034,3578741924,3578741924,0
0,1173,32035,3578741924,3578741924,0
0,1173,32036,3578741924,3578741924,0
0,1173,32037,3578741924,3578741926,2
0,1173,32038,3578741924,3578741927,3
0,1173,32039,3578741924,3578741928,4
0,1173,32040,3578741924,3578741929,5
0,1173,32041,3578741924,3578741930,6
0,1173,32042,3578741924,3578741931,7
0,1173,32043,3578741924,3578741932,8
0,1173,32044,3578741924,3578741932,8
0,1173,32045,3578741924,3578741932,8
0,1173,32046,3578741924,3578741933,9
0,1173,32047,3578741924,3578741933,9
0,1173,32048,3578741924,3578741933,9
0,1173,32049,3578741924,3578741935,11
0,1173,32050,3578741924,3578741935,11
0,1173,32051,3578741924,3578741936,12
0,1173,32052,3578741924,3578741937,13
0,1173,32053,3578741924,3578741937,13
0,1173,32054,3578741924,3578741939,15
0,1173,32055,3578741924,3578741939,15
0,1173,32056,3578741924,3578741940,16
0,1173,32057,3578741924,3578741940,16
0,1173,32058,3578741924,3578741940,16
0,1173,32059,3578741924,3578741940,16
0,1173,32060,3578741924,3578741942,18
0,1173,32061,3578741924,3578741942,18
0,1173,32062,3578741924,3578741942,18
0,1173,32063,3578741924,3578741943,19
0,1173,32064,3578741924,3578741943,19
0,1173,32065,3578741924,3578741944,20
0,1173,32066,3578741924,3578741945,21
0,1173,32067,3578741924,3578741945,21
0,1173,32068,3578741924,3578741946,22
0,1173,32069,3578741924,3578741946,22
0,1173,32070,3578741924,3578741947,23
0,1173,32071,3578741924,3578741947,23
0,1173,32072,3578741924,3578741947,23
0,1173,32073,3578741924,3578741948,24
0,1173,32074,3578741924,3578741949,25
0,1173,32075,3578741924,3578741950,26
0,1173,32076,3578741924,3578741952,28
0,1173,32077,3578741924,3578741953,29
0,1173,32078,3578741924,3578741956,32
0,1173,32079,3578741924,3578741956,32
0,1173,32080,3578741924,3578741956,32
0,1173,32081,3578741924,3578741958,34
0,1173,32082,3578741924,3578741959,35
0,1173,32083,3578741924,3578741959,35
0,1173,32084,3578741924,3578741960,36
0,1173,32085,3578741924,3578741960,36
0,1173,32086,3578741924,3578741961,37
0,1173,32087,3578741924,3578741961,37
0,1173,32088,3578741924,3578741961,37
0,1173,32089,3578741924,3578741961,37
0,1173,32090,3578741924,3578741962,38
0,1173,32091,3578741924,3578741964,40
0,1173,32092,3578741924,3578741965,41
0,1173,32093,3578741924,3578741966,42
0,1173,32094,3578741924,3578741967,43
0,1173,32095,3578741924,3578741967,43
0,1173,32096,3578741924,3578741968,44
0,1173,32097,3578741924,3578741968,44
0,1173,32098,3578741924,3578741969,45
0,1173,32099,3578741924,3578741969,45
0,1173,32100,3578741924,3578741971,47
0,1173,32101,3578741924,3578741972,48
0,1173,32102,3578741924,3578741973,49
0,1174,32103,3578741987,3578741987,0
0,1174,32104,3578741987,3578741987,0
0,1174,32105,3578741987,3578741987,0
0,1174,32106,3578741987,3578741987,0
0,1174,32107,3578741987,3578741987,0
0,1174,32108,3578741987,3578741987,0
0,1174,32109,3578741987,3578741987,0
0,1174,32110,3578741987,3578741987,0
0,1174,32111,3578741987,3578741987,0
0,1174,32112,3578741987,3578741987,0
0,1174,32113,3578741987,3578741987,0
0,1174,32114,3578741987,3578741988,1
0,1174,32115,3578741987,3578741988,1
0,1174,32116,3578741987,3578741989,2
0,1174,32117,3578741987,3578741989,2
0,1174,32118,3578741987,3578741989,2
0,1174,32119,3578741987,3578741990,3
0,1174,32120,3578741987,3578741990,3
0,1174,32121,3578741987,3578741990,3
0,1174,32122,3578741987,3578741991,4
0,1174,32123,3578741987,3578741991,4
0,1174,32124,3578741987,3578741992,5
0,1174,32125,3578741987,3578741993,6
0,1174,32126,3578741987,3578741994,7
0,1174,32127,3578741987,3578741995,8
0,1174,32128,3578741987,3578741998,11
0,1174,32129,3578741987,3578742000,13
0,1174,32130,3578741987,3578742001,14
0,1174,32131,3578741987,3578742001,14
0,1174,32132,3578741987,3578742003,16
0,1174,32133,3578741987,3578742003,16
0,1174,32134,3578741987,3578742003,16
0,1174,32135,3578741987,3578742003,16
0,1174,32136,3578741987,3578742004,17
0,1174,32137,3578741987,3578742006,19
0,1174,32138,3578741987,3578742006,19
0,1174,32139,3578741987,3578742006,19
0,1174,32140,3578741987,3578742007,20
0,1174,32141,3578741987,3578742008,21
0,1174,32142,3578741987,3578742009,22
0,1174,32143,3578741987,3578742009,22
0,1174,32144,3578741987,3578742009,22
0,1174,32145,3578741987,3578742009,22
0,1174,32146,3578741987,3578742011,24
0,1174,32147,3578741987,3578742011,24
0,1174,32148,3578741987,3578742013,26
0,1174,32149,3578741987,3578742013,26
0,1174,32150,3578741987,3578742014,27
0,1174,32151,3578741987,3578742015,28
0,1174,32152,3578741987,3578742015,28
0,1174,32153,3578741987,3578742015,28
0,1174,32154,3578741987,3578742016,29
0,1174,32155,3578741987,3578742016,29
0,1174,32156,3578741987,3578742018,31
0,1174,32157,3578741987,3578742018,31
0,1174,32158,3578741987,3578742018,31
0,1174,32159,3578741987,3578742020,33
0,1174,32160,3578741987,3578742020,33
0,1174,32161,3578741987,3578742020,33
0,1174,32162,3578741987,3578742021,34
0,1174,32163,3578741987,3578742022,35
0,1174,32164,3578741987,3578742022,35
0,1174,32165,3578741987,3578742023,36
0,1174,32166,3578741987,3578742025,38
0,1174,32167,3578741987,3578742027,40
0,1174,32168,3578741987,3578742027,40
0,1174,32169,3578741987,3578742029,42
0,1174,32170,3578741987,3578742030,43
0,1174,32171,3578741987,3578742031,44
0,1174,32172,3578741987,3578742032,45
0,1174,32173,3578741987,3578742032,45
0,1174,32174,3578741987,3578742036,49
0,1175,32175,3578742051,3578742051,0
0,1175,32176,3578742051,3578742051,0
0,1175,32177,3578742051,3578742051,0
0,1175,32178,3578742051,3578742051,0
0,1175,32179,3578742051,3578742051,0
0,1175,32180,3578742051,3578742051,0
0,1175,32181,3578742051,3578742051,0
0,1175,32182,3578742051,3578742051,0
0,1175,32183,3578742051,3578742051,0
0,1175,32184,3578742051,3578742051,0
0,1175,32185,3578742051,3578742051,0
0,1175,32186,3578742051,3578742051,0
0,1175,32187,3578742051,3578742051,0
0,1175,32188,3578742051,3578742051,0
0,1175,32189,3578742051,3578742051,0
0,1175,32190,3578742051,3578742051,0
0,1175,32191,3578742051,3578742051,0
0,1175,32192,3578742051,3578742051,0
0,1175,32193,3578742051,3578742051,0
0,1175,32194,3578742051,3578742052,1
0,1175,32195,3578742051,3578742052,1
0,1175,32196,3578742051,3578742055,4
0,1175,32197,3578742051,3578742056,5
0,1175,32198,3578742051,3578742057,6
0,1175,32199,3578742051,3578742058,7
0,1175,32200,3578742051,3578742059,8
0,1175,32201,3578742051,3578742061,10
0,1175,32202,3578742051,3578742061,10
0,1175,32203,3578742051,3578742063,12
0,1175,32204,3578742051,3578742064,13
0,1175,32205,3578742051,3578742064,13
0,1175,32206,3578742051,3578742064,13
0,1175,32207,3578742051,3578742066,15
0,1175,32208,3578742051,3578742067,16
0,1175,32209,3578742051,3578742068,17
0,1175,32210,3578742051,3578742073,22
0,1175,32211,3578742051,3578742075,24
0,1175,32212,3578742051,3578742077,26
0,1175,32213,3578742051,3578742078,27
0,1175,32214,3578742051,3578742080,29
0,1175,32215,3578742051,3578742080,29
0,1175,32216,3578742051,3578742081,30
0,1175,32217,3578742051,3578742082,31
0,1175,32218,3578742051,3578742082,31
0,1175,32219,3578742051,3578742082,31
0,1175,32220,3578742051,3578742082,31
0,1175,32221,3578742051,3578742083,32
0,1175,32222,3578742051,3578742083,32
0,1175,32223,3578742051,3578742083,32
0,1175,32224,3578742051,3578742085,34
0,1175,32225,3578742051,3578742085,34
0,1175,32226,3578742051,3578742087,36
0,1175,32227,3578742051,3578742087,36
0,1175,32228,3578742051,3578742087,36
0,1175,32229,3578742051,3578742087,36
0,1175,32230,3578742051,3578742088,37
0,1175,32231,3578742051,3578742088,37
0,1175,32232,3578742051,3578742089,38
0,1175,32233,3578742051,3578742089,38
0,1175,32234,3578742051,3578742089,38
0,1175,32235,3578742051,3578742089,38
0,1175,32236,3578742051,3578742091,40
0,1175,32237,3578742051,3578742091,40
0,1175,32238,3578742051,3578742091,40
0,1175,32239,3578742051,3578742093,42
0,1175,32240,3578742051,3578742093,42
0,1175,32241,3578742051,3578742093,42
0,1175,32242,3578742051,3578742093,42
0,1175,32243,3578742051,3578742096,45
0,1175,32244,3578742051,3578742097,46
0,1175,32245,3578742051,3578742098,47
0,1175,32246,3578742051,3578742098,47
0,1175,32247,3578742051,3578742099,48
0,1175,32248,3578742051,3578742100,49
0,1176,32249,3578742114,3578742114,0
0,1176,32250,3578742114,3578742114,0
0,1176,32251,3578742114,3578742114,0
0,1176,32252,3578742114,3578742114,0
0,1176,32253,3578742114,3578742114,0
0,1176,32254,3578742114,3578742114,0
0,1176,32255,3578742114,3578742114,0
0,1176,32256,3578742114,3578742114,0
0,1176,32257,3578742114,3578742114,0
0,1176,32258,3578742114,3578742114,0
0,1176,32259,3578742114,3578742114,0
0,1176,32260,3578742114,3578742114,0
0,1176,32261,3578742114,3578742114,0
0,1176,32262,3578742114,3578742114,0
0,1176,32263,3578742114,3578742114,0
0,1176,32264,3578742114,3578742114,0
0,1176,32265,3578742114,3578742114,0
0,1176,32266,3578742114,3578742114,0
0,1176,32267,3578742114,3578742114,0
0,1176,32268,3578742114,3578742115,1
0,1176,32269,3578742114,3578742115,1
0,1176,32270,3578742114,3578742115,1
0,1176,32271,3578742114,3578742116,2
0,1176,32272,3578742114,3578742116,2
0,1176,32273,3578742114,3578742117,3
0,1176,32274,3578742114,3578742117,3
0,1176,32275,3578742114,3578742117,3
0,1176,32276,3578742114,3578742119,5
0,1176,32277,3578742114,3578742119,5
0,1176,32278,3578742114,3578742120,6
0,1176,32279,3578742114,3578742120,6
0,1176,32280,3578742114,3578742121,7
0,1176,32281,3578742114,3578742123,9
0,1176,32282,3578742114,3578742124,10
0,1176,32283,3578742114,3578742127,13
0,1176,32284,3578742114,3578742127,13
0,1176,32285,3578742114,3578742128,14
0,1176,32286,3578742114,3578742128,14
0,1176,32287,3578742114,3578742129,15
0,1176,32288,3578742114,3578742130,16
0,1176,32289,3578742114,3578742131,17
0,1176,32290,3578742114,3578742132,18
0,1176,32291,3578742114,3578742132,18
0,1176,32292,3578742114,3578742132,18
0,1176,32293,3578742114,3578742132,18
0,1176,32294,3578742114,3578742133,19
0,1176,32295,3578742114,3578742133,19
0,1176,32296,3578742114,3578742134,20
0,1176,32297,3578742114,3578742135,21
0,1176,32298,3578742114,3578742135,21
0,1176,32299,3578742114,3578742136,22
0,1176,32300,3578742114,3578742137,23
0,1176,32301,3578742114,3578742138,24
0,1176,32302,3578742114,3578742138,24
0,1176,32303,3578742114,3578742140,26
0,1176,32304,3578742114,3578742140,26
0,1176,32305,3578742114,3578742140,26
0,1176,32306,3578742114,3578742141,27
0,1176,32307,3578742114,3578742141,27
0,1176,32308,3578742114,3578742142,28
0,1176,32309,3578742114,3578742143,29
0,1176,32310,3578742114,3578742143,29
0,1176,32311,3578742114,3578742143,29
0,1176,32312,3578742114,3578742143,29
0,1176,32313,3578742114,3578742144,30
0,1176,32314,3578742114,3578742145,31
0,1176,32315,3578742114,3578742145,31
0,1176,32316,3578742114,3578742146,32
0,1176,32317,3578742114,3578742147,33
0,1176,32318,3578742114,3578742147,33
0,1176,32319,3578742114,3578742147,33
0,1176,32320,3578742114,3578742148,34
0,1176,32321,3578742114,3578742149,35
0,1176,32322,3578742114,3578742149,35
0,1176,32323,3578742114,3578742151,37
0,1176,32324,3578742114,3578742152,38
0,1176,32325,3578742114,3578742153,39
0,1176,32326,3578742114,3578742155,41
0,1176,32327,3578742114,3578742156,42
0,1176,32328,3578742114,3578742156,42
0,1176,32329,3578742114,3578742156,42
0,1176,32330,3578742114,3578742158,44
0,1176,32331,3578742114,3578742159,45
0,1176,32332,3578742114,3578742159,45
0,1176,32333,3578742114,3578742160,46
0,1176,32334,3578742114,3578742160,46
0,1176,32335,3578742114,3578742161,47
0,1176,32336,3578742114,3578742161,47
0,1176,32337,3578742114,3578742162,48
0,1176,32338,3578742114,3578742162,48
0,1176,32339,3578742114,3578742162,48
0,1177,32340,3578742176,3578742176,0
0,1177,32341,3578742176,3578742176,0
0,1177,32342,3578742176,3578742176,0
0,1177,32343,3578742176,3578742176,0
0,1177,32344,3578742176,3578742176,0
0,1177,32345,3578742176,3578742176,0
0,1177,32346,3578742176,3578742176,0
0,1177,32347,3578742176,3578742176,0
0,1177,32348,3578742176,3578742176,0
0,1177,32349,3578742176,3578742176,0
0,1177,32350,3578742176,3578742176,0
0,1177,32351,3578742176,3578742176,0
0,1177,32352,3578742176,3578742176,0
0,1177,32353,3578742176,3578742176,0
0,1177,32354,3578742176,3578742176,0
0,1177,32355,3578742176,3578742177,1
0,1177,32356,3578742176,3578742178,2
0,1177,32357,3578742176,3578742178,2
0,1177,32358,3578742176,3578742180,4
0,1177,32359,3578742176,3578742180,4
0,1177,32360,3578742176,3578742181,5
0,1177,32361,3578742176,3578742182,6
0,1177,32362,3578742176,3578742182,6
0,1177,32363,3578742176,3578742184,8
0,1177,32364,3578742176,3578742185,9
0,1177,32365,3578742176,3578742188,12
0,1177,32366,3578742176,3578742188,12
0,1177,32367,3578742176,3578742188,12
0,1177,32368,3578742176,3578742189,13
0,1177,32369,3578742176,3578742189,13
0,1177,32370,3578742176,3578742189,13
0,1177,32371,3578742176,3578742190,14
0,1177,32372,3578742176,3578742190,14
0,1177,32373,3578742176,3578742190,14
0,1177,32374,3578742176,3578742191,15
0,1177,32375,3578742176,3578742191,15
0,1177,32376,3578742176,3578742192,16
0,1177,32377,3578742176,3578742194,18
0,1177,32378,3578742176,3578742194,18
0,1177,32379,3578742176,3578742197,21
0,1177,32380,3578742176,3578742197,21
0,1177,32381,3578742176,3578742201,25
0,1177,32382,3578742176,3578742201,25
0,1177,32383,3578742176,3578742203,27
0,1177,32384,3578742176,3578742203,27
0,1177,32385,3578742176,3578742204,28
0,1177,32386,3578742176,3578742204,28
0,1177,32387,3578742176,3578742206,30
0,1177,32388,3578742176,3578742206,30
0,1177,32389,3578742176,3578742206,30
0,1177,32390,3578742176,3578742207,31
0,1177,32391,3578742176,3578742207,31
0,1177,32392,3578742176,3578742208,32
0,1177,32393,3578742176,3578742208,32
0,1177,32394,3578742176,3578742210,34
0,1177,32395,3578742176,3578742210,34
0,1177,32396,3578742176,3578742212,36
0,1177,32397,3578742176,3578742212,36
0,1177,32398,3578742176,3578742213,37
0,1177,32399,3578742176,3578742214,38
0,1177,32400,3578742176,3578742214,38
0,1177,32401,3578742176,3578742215,39
0,1177,32402,3578742176,3578742215,39
0,1177,32403,3578742176,3578742216,40
0,1177,32404,3578742176,3578742216,40
0,1177,32405,3578742176,3578742216,40
0,1177,32406,3578742176,3578742217,41
0,1177,32407,3578742176,3578742219,43
0,1177,32408,3578742176,3578742219,43
0,1177,32409,3578742176,3578742219,43
0,1177,32410,3578742176,3578742220,44
0,1177,32411,3578742176,3578742221,45
0,1177,32412,3578742176,3578742221,45
0,1177,32413,3578742176,3578742222,46
0,1177,32414,3578742176,3578742225,49
0,1178,32415,3578742240,3578742240,0
0,1178,32416,3578742240,3578742240,0
0,1178,32417,3578742240,3578742240,0
0,1178,32418,3578742240,3578742240,0
0,1178,32419,3578742240,3578742240,0
0,1178,32420,3578742240,3578742240,0
0,1178,32421,3578742240,3578742240,0
0,1178,32422,3578742240,3578742240,0
0,1178,32423,3578742240,3578742240,0
0,1178,32424,3578742240,3578742240,0
0,1178,32425,3578742240,3578742240,0
0,1178,32426,3578742240,3578742240,0
0,1178,32427,3578742240,3578742241,1
0,1178,32428,3578742240,3578742241,1
0,1178,32429,3578742240,3578742241,1
0,1178,32430,3578742240,3578742242,2
0,1178,32431,3578742240,3578742242,2
0,1178,32432,3578742240,3578742243,3
0,1178,32433,3578742240,3578742243,3
0,1178,32434,3578742240,3578742243,3
0,1178,32435,3578742240,3578742245,5
0,1178,32436,3578742240,3578742248,8
0,1178,32437,3578742240,3578742249,9
0,1178,32438,3578742240,3578742250,10
0,1178,32439,3578742240,3578742250,10
0,1178,32440,3578742240,3578742251,11
0,1178,32441,3578742240,3578742251,11
0,1178,32442,3578742240,3578742251,11
0,1178,32443,3578742240,3578742252,12
0,1178,32444,3578742240,3578742253,13
0,1178,32445,3578742240,3578742254,14
0,1178,32446,3578742240,3578742256,16
0,1178,32447,3578742240,3578742257,17
0,1178,32448,3578742240,3578742258,18
0,1178,32449,3578742240,3578742259,19
0,1178,32450,3578742240,3578742260,20
0,1178,32451,3578742240,3578742262,22
0,1178,32452,3578742240,3578742262,22
0,1178,32453,3578742240,3578742263,23
0,1178,32454,3578742240,3578742264,24
0,1178,32455,3578742240,3578742264,24
0,1178,32456,3578742240,3578742264,24
0,1178,32457,3578742240,3578742266,26
0,1178,32458,3578742240,3578742267,27
0,1178,32459,3578742240,3578742268,28
0,1178,32460,3578742240,3578742269,29
0,1178,32461,3578742240,3578742275,35
0,1178,32462,3578742240,3578742277,37
0,1178,32463,3578742240,3578742278,38
0,1178,32464,3578742240,3578742280,40
0,1178,32465,3578742240,3578742280,40
0,1178,32466,3578742240,3578742282,42
0,1178,32467,3578742240,3578742282,42
0,1178,32468,3578742240,3578742282,42
0,1178,32469,3578742240,3578742282,42
0,1178,32470,3578742240,3578742283,43
0,1178,32471,3578742240,3578742283,43
0,1178,32472,3578742240,3578742283,43
0,1178,32473,3578742240,3578742283,43
0,1178,32474,3578742240,3578742285,45
0,1178,32475,3578742240,3578742285,45
0,1178,32476,3578742240,3578742286,46
0,1178,32477,3578742240,3578742287,47
0,1178,32478,3578742240,3578742287,47
0,1178,32479,3578742240,3578742287,47
0,1178,32480,3578742240,3578742288,48
0,1178,32481,3578742240,3578742288,48
0,1178,32482,3578742240,3578742290,50
0,1179,32483,3578742301,3578742301,0
0,1179,32484,3578742301,3578742301,0
0,1179,32485,3578742301,3578742301,0
0,1179,32486,3578742301,3578742301,0
0,1179,32487,3578742301,3578742301,0
0,1179,32488,3578742301,3578742301,0
0,1179,32489,3578742301,3578742301,0
0,1179,32490,3578742301,3578742301,0
0,1179,32491,3578742301,3578742301,0
0,1179,32492,3578742301,3578742301,0
0,1179,32493,3578742301,3578742302,1
0,1179,32494,3578742301,3578742302,1
0,1179,32495,3578742301,3578742302,1
0,1179,32496,3578742301,3578742302,1
0,1179,32497,3578742301,3578742302,1
0,1179,32498,3578742301,3578742303,2
0,1179,32499,3578742301,3578742304,3
0,1179,32500,3578742301,3578742305,4
0,1179,32501,3578742301,3578742306,5
0,1179,32502,3578742301,3578742307,6
0,1179,32503,3578742301,3578742307,6
0,1179,32504,3578742301,3578742307,6
0,1179,32505,3578742301,3578742307,6
0,1179,32506,3578742301,3578742308,7
0,1179,32507,3578742301,3578742309,8
0,1179,32508,3578742301,3578742310,9
0,1179,32509,3578742301,3578742312,11
0,1179,32510,3578742301,3578742312,11
0,1179,32511,3578742301,3578742315,14
0,1179,32512,3578742301,3578742315,14
0,1179,32513,3578742301,3578742315,14
0,1179,32514,3578742301,3578742316,15
0,1179,32515,3578742301,3578742316,15
0,1179,32516,3578742301,3578742316,15
0,1179,32517,3578742301,3578742316,15
0,1179,32518,3578742301,3578742316,15
0,1179,32519,3578742301,3578742316,15
0,1179,32520,3578742301,3578742316,15
0,1179,32521,3578742301,3578742317,16
0,1179,32522,3578742301,3578742318,17
0,1179,32523,3578742301,3578742319,18
0,1179,32524,3578742301,3578742320,19
0,1179,32525,3578742301,3578742320,19
0,1179,32526,3578742301,3578742321,20
0,1179,32527,3578742301,3578742323,22
0,1179,32528,3578742301,3578742324,23
0,1179,32529,3578742301,3578742324,23
0,1179,32530,3578742301,3578742327,26
0,1179,32531,3578742301,3578742327,26
0,1179,32532,3578742301,3578742328,27
0,1179,32533,3578742301,3578742329,28
0,1179,32534,3578742301,3578742329,28
0,1179,32535,3578742301,3578742330,29
0,1179,32536,3578742301,3578742331,30
0,1179,32537,3578742301,3578742331,30
0,1179,32538,3578742301,3578742331,30
0,1179,32539,3578742301,3578742332,31
0,1179,32540,3578742301,3578742333,32
0,1179,32541,3578742301,3578742333,32
0,1179,32542,3578742301,3578742333,32
0,1179,32543,3578742301,3578742333,32
0,1179,32544,3578742301,3578742334,33
0,1179,32545,3578742301,3578742335,34
0,1179,32546,3578742301,3578742335,34
0,1179,32547,3578742301,3578742336,35
0,1179,32548,3578742301,3578742337,36
0,1179,32549,3578742301,3578742338,37
0,1179,32550,3578742301,3578742339,38
0,1179,32551,3578742301,3578742340,39
0,1179,32552,3578742301,3578742340,39
0,1179,32553,3578742301,3578742340,39
0,1179,32554,3578742301,3578742340,39
0,1179,32555,3578742301,3578742341,40
0,1179,32556,3578742301,3578742343,42
0,1179,32557,3578742301,3578742343,42
0,1179,32558,3578742301,3578742343,42
0,1179,32559,3578742301,3578742343,42
0,1179,32560,3578742301,3578742343,42
0,1179,32561,3578742301,3578742343,42
0,1179,32562,3578742301,3578742344,43
0,1179,32563,3578742301,3578742345,44
0,1179,32564,3578742301,3578742345,44
0,1179,32565,3578742301,3578742347,46
0,1179,32566,3578742301,3578742347,46
0,1179,32567,3578742301,3578742348,47
0,1179,32568,3578742301,3578742349,48
0,1179,32569,3578742301,3578742349,48
0,1179,32570,3578742301,3578742351,50
0,1180,32571,3578742364,3578742364,0
0,1180,32572,3578742364,3578742364,0
0,1180,32573,3578742364,3578742364,0
0,1180,32574,3578742364,3578742364,0
0,1180,32575,3578742364,3578742364,0
0,1180,32576,3578742364,3578742364,0
0,1180,32577,3578742364,3578742364,0
0,1180,32578,3578742364,3578742364,0
0,1180,32579,3578742364,3578742364,0
0,1180,32580,3578742364,3578742364,0
0,1180,32581,3578742364,3578742364,0
0,1180,32582,3578742364,3578742364,0
0,1180,32583,3578742364,3578742364,0
0,1180,32584,3578742364,3578742364,0
0,1180,32585,3578742364,3578742364,0
0,1180,32586,3578742364,3578742364,0
0,1180,32587,3578742364,3578742364,0
0,1180,32588,3578742364,3578742364,0
0,1180,32589,3578742364,3578742365,1
0,1180,32590,3578742364,3578742367,3
0,1180,32591,3578742364,3578742367,3
0,1180,32592,3578742364,3578742368,4
0,1180,32593,3578742364,3578742368,4
0,1180,32594,3578742364,3578742369,5
0,1180,32595,3578742364,3578742369,5
0,1180,32596,3578742364,3578742369,5
0,1180,32597,3578742364,3578742369,5
0,1180,32598,3578742364,3578742371,7
0,1180,32599,3578742364,3578742371,7
0,1180,32600,3578742364,3578742374,10
0,1180,32601,3578742364,3578742374,10
0,1180,32602,3578742364,3578742375,11
0,1180,32603,3578742364,3578742376,12
0,1180,32604,3578742364,3578742377,13
0,1180,32605,3578742364,3578742377,13
0,1180,32606,3578742364,3578742378,14
0,1180,32607,3578742364,3578742378,14
0,1180,32608,3578742364,3578742378,14
0,1180,32609,3578742364,3578742380,16
0,1180,32610,3578742364,3578742380,16
0,1180,32611,3578742364,3578742382,18
0,1180,32612,3578742364,3578742382,18
0,1180,32613,3578742364,3578742383,19
0,1180,32614,3578742364,3578742384,20
0,1180,32615,3578742364,3578742384,20
0,1180,32616,3578742364,3578742385,21
0,1180,32617,3578742364,3578742388,24
0,1180,32618,3578742364,3578742388,24
0,1180,32619,3578742364,3578742389,25
0,1180,32620,3578742364,3578742389,25
0,1180,32621,3578742364,3578742389,25
0,1180,32622,3578742364,3578742390,26
0,1180,32623,3578742364,3578742390,26
0,1180,32624,3578742364,3578742390,26
0,1180,32625,3578742364,3578742391,27
0,1180,32626,3578742364,3578742392,28
0,1180,32627,3578742364,3578742394,30
0,1180,32628,3578742364,3578742395,31
0,1180,32629,3578742364,3578742397,33
0,1180,32630,3578742364,3578742397,33
0,1180,32631,3578742364,3578742400,36
0,1180,32632,3578742364,3578742401,37
0,1180,32633,3578742364,3578742403,39
0,1180,32634,3578742364,3578742403,39
0,1180,32635,3578742364,3578742404,40
0,1180,32636,3578742364,3578742404,40
0,1180,32637,3578742364,3578742405,41
0,1180,32638,3578742364,3578742406,42
0,1180,32639,3578742364,3578742406,42
0,1180,32640,3578742364,3578742406,42
0,1180,32641,3578742364,3578742407,43
0,1180,32642,3578742364,3578742408,44
0,1180,32643,3578742364,3578742409,45
0,1180,32644,3578742364,3578742410,46
0,1180,32645,3578742364,3578742411,47
0,1180,32646,3578742364,3578742412,48
0,1180,32647,3578742364,3578742412,48
0,1180,32648,3578742364,3578742413,49
0,1180,32649,3578742364,3578742413,49
0,1181,32650,3578742426,3578742426,0
0,1181,32651,3578742426,3578742426,0
0,1181,32652,3578742426,3578742426,0
0,1181,32653,3578742426,3578742426,0
0,1181,32654,3578742426,3578742426,0
0,1181,32655,3578742426,3578742426,0
0,1181,32656,3578742426,3578742426,0
0,1181,32657,3578742426,3578742426,0
0,1181,32658,3578742426,3578742426,0
0,1181,32659,3578742426,3578742426,0
0,1181,32660,3578742426,3578742426,0
0,1181,32661,3578742426,3578742426,0
0,1181,32662,3578742426,3578742426,0
0,1181,32663,3578742426,3578742426,0
0,1181,32664,3578742426,3578742426,0
0,1181,32665,3578742426,3578742427,1
0,1181,32666,3578742426,3578742428,2
0,1181,32667,3578742426,3578742430,4
0,1181,32668,3578742426,3578742431,5
0,1181,32669,3578742426,3578742433,7
0,1181,32670,3578742426,3578742433,7
0,1181,32671,3578742426,3578742436,10
0,1181,32672,3578742426,3578742436,10
0,1181,32673,3578742426,3578742437,11
0,1181,32674,3578742426,3578742438,12
0,1181,32675,3578742426,3578742440,14
0,1181,32676,3578742426,3578742440,14
0,1181,32677,3578742426,3578742440,14
0,1181,32678,3578742426,3578742441,15
0,1181,32679,3578742426,3578742441,15
0,1181,32680,3578742426,3578742442,16
0,1181,32681,3578742426,3578742443,17
0,1181,32682,3578742426,3578742444,18
0,1181,32683,3578742426,3578742444,18
0,1181,32684,3578742426,3578742445,19
0,1181,32685,3578742426,3578742447,21
0,1181,32686,3578742426,3578742449,23
0,1181,32687,3578742426,3578742450,24
0,1181,32688,3578742426,3578742450,24
0,1181,32689,3578742426,3578742451,25
0,1181,32690,3578742426,3578742451,25
0,1181,32691,3578742426,3578742452,26
0,1181,32692,3578742426,3578742453,27
0,1181,32693,3578742426,3578742455,29
0,1181,32694,3578742426,3578742456,30
0,1181,32695,3578742426,3578742457,31
0,1181,32696,3578742426,3578742459,33
0,1181,32697,3578742426,3578742460,34
0,1181,32698,3578742426,3578742461,35
0,1181,32699,3578742426,3578742462,36
0,1181,32700,3578742426,3578742463,37
0,1181,32701,3578742426,3578742463,37
0,1181,32702,3578742426,3578742463,37
0,1181,32703,3578742426,3578742463,37
0,1181,32704,3578742426,3578742464,38
0,1181,32705,3578742426,3578742464,38
0,1181,32706,3578742426,3578742465,39
0,1181,32707,3578742426,3578742467,41
0,1181,32708,3578742426,3578742467,41
0,1181,32709,3578742426,3578742467,41
0,1181,32710,3578742426,3578742469,43
0,1181,32711,3578742426,3578742475,49
0,1182,32712,3578742490,3578742490,0
0,1182,32713,3578742490,3578742490,0
0,1182,32714,3578742490,3578742490,0
0,1182,32715,3578742490,3578742490,0
0,1182,32716,3578742490,3578742490,0
0,1182,32717,3578742490,3578742490,0
0,1182,32718,3578742490,3578742490,0
0,1182,32719,3578742490,3578742490,0
0,1182,32720,3578742490,3578742490,0
0,1182,32721,3578742490,3578742490,0
0,1182,32722,3578742490,3578742490,0
0,1182,32723,3578742490,3578742490,0
0,1182,32724,3578742490,3578742490,0
0,1182,32725,3578742490,3578742490,0
0,1182,32726,3578742490,3578742490,0
0,1182,32727,3578742490,3578742490,0
0,1182,32728,3578742490,3578742490,0
0,1182,32729,3578742490,3578742490,0
0,1182,32730,3578742490,3578742490,0
0,1182,32731,3578742490,3578742490,0
0,1182,32732,3578742490,3578742490,0
0,1182,32733,3578742490,3578742490,0
0,1182,32734,3578742490,3578742490,0
0,1182,32735,3578742490,3578742490,0
0,1182,32736,3578742490,3578742490,0
0,1182,32737,3578742490,3578742490,0
0,1182,32738,3578742490,3578742490,0
0,1182,32739,3578742490,3578742491,1
0,1182,32740,3578742490,3578742492,2
0,1182,32741,3578742490,3578742492,2
0,1182,32742,3578742490,3578742493,3
0,1182,32743,3578742490,3578742493,3
0,1182,32744,3578742490,3578742495,5
0,1182,32745,3578742490,3578742496,6
0,1182,32746,3578742490,3578742497,7
0,1182,32747,3578742490,3578742499,9
0,1182,32748,3578742490,3578742501,11
0,1182,32749,3578742490,3578742501,11
0,1182,32750,3578742490,3578742501,11
0,1182,32751,3578742490,3578742501,11
0,1182,32752,3578742490,3578742502,12
0,1182,32753,3578742490,3578742503,13
0,1182,32754,3578742490,3578742503,13
0,1182,32755,3578742490,3578742504,14
0,1182,32756,3578742490,3578742506,16
0,1182,32757,3578742490,3578742506,16
0,1182,32758,3578742490,3578742507,17
0,1182,32759,3578742490,3578742507,17
0,1182,32760,3578742490,3578742507,17
0,1182,32761,3578742490,3578742508,18
0,1182,32762,3578742490,3578742509,19
0,1182,32763,3578742490,3578742510,20
0,1182,32764,3578742490,3578742511,21
0,1182,32765,3578742490,3578742514,24
0,1182,32766,3578742490,3578742514,24
0,1182,32767,3578742490,3578742515,25
0,1182,32768,3578742490,3578742515,25
0,1182,32769,3578742490,3578742515,25
0,1182,32770,3578742490,3578742515,25
0,1182,32771,3578742490,3578742515,25
0,1182,32772,3578742490,3578742515,25
0,1182,32773,3578742490,3578742516,26
0,1182,32774,3578742490,3578742516,26
0,1182,32775,3578742490,3578742516,26
0,1182,32776,3578742490,3578742517,27
0,1182,32777,3578742490,3578742518,28
0,1182,32778,3578742490,3578742519,29
0,1182,32779,3578742490,3578742519,29
0,1182,32780,3578742490,3578742520,30
0,1182,32781,3578742490,3578742522,32
0,1182,32782,3578742490,3578742523,33
0,1182,32783,3578742490,3578742523,33
0,1182,32784,3578742490,3578742526,36
0,1182,32785,3578742490,3578742527,37
0,1182,32786,3578742490,3578742527,37
0,1182,32787,3578742490,3578742528,38
0,1182,32788,3578742490,3578742529,39
0,1182,32789,3578742490,3578742530,40
0,1182,32790,3578742490,3578742531,41
0,1182,32791,3578742490,3578742531,41
0,1182,32792,3578742490,3578742531,41
0,1182,32793,3578742490,3578742531,41
0,1182,32794,3578742490,3578742532,42
0,1182,32795,3578742490,3578742533,43
0,1182,32796,3578742490,3578742534,44
0,1182,32797,3578742490,3578742534,44
0,1182,32798,3578742490,3578742534,44
0,1182,32799,3578742490,3578742535,45
0,1182,32800,3578742490,3578742535,45
0,1182,32801,3578742490,3578742536,46
0,1182,32802,3578742490,3578742538,48
0,1182,32803,3578742490,3578742538,48
0,1182,32804,3578742490,3578742538,48
0,1182,32805,3578742490,3578742539,49
0,1182,32806,3578742490,3578742539,49
0,1182,32807,3578742490,3578742540,50
0,1183,32808,3578742552,3578742552,0
0,1183,32809,3578742552,3578742552,0
0,1183,32810,3578742552,3578742552,0
0,1183,32811,3578742552,3578742552,0
0,1183,32812,3578742552,3578742552,0
0,1183,32813,3578742552,3578742552,0
0,1183,32814,3578742552,3578742552,0
0,1183,32815,3578742552,3578742552,0
0,1183,32816,3578742552,3578742552,0
0,1183,32817,3578742552,3578742552,0
0,1183,32818,3578742552,3578742552,0
0,1183,32819,3578742552,3578742552,0
0,1183,32820,3578742552,3578742552,0
0,1183,32821,3578742552,3578742552,0
0,1183,32822,3578742552,3578742552,0
0,1183,32823,3578742552,3578742552,0
0,1183,32824,3578742552,3578742552,0
0,1183,32825,3578742552,3578742555,3
0,1183,32826,3578742552,3578742555,3
0,1183,32827,3578742552,3578742556,4
0,1183,32828,3578742552,3578742556,4
0,1183,32829,3578742552,3578742557,5
0,1183,32830,3578742552,3578742559,7
0,1183,32831,3578742552,3578742559,7
0,1183,32832,3578742552,3578742559,7
0,1183,32833,3578742552,3578742560,8
0,1183,32834,3578742552,3578742560,8
0,1183,32835,3578742552,3578742560,8
0,1183,32836,3578742552,3578742560,8
0,1183,32837,3578742552,3578742561,9
0,1183,32838,3578742552,3578742561,9
0,1183,32839,3578742552,3578742561,9
0,1183,32840,3578742552,3578742564,12
0,1183,32841,3578742552,3578742566,14
0,1183,32842,3578742552,3578742566,14
0,1183,32843,3578742552,3578742567,15
0,1183,32844,3578742552,3578742567,15
0,1183,32845,3578742552,3578742568,16
0,1183,32846,3578742552,3578742568,16
0,1183,32847,3578742552,3578742568,16
0,1183,32848,3578742552,3578742568,16
0,1183,32849,3578742552,3578742568,16
0,1183,32850,3578742552,3578742569,17
0,1183,32851,3578742552,3578742570,18
0,1183,32852,3578742552,3578742570,18
0,1183,32853,3578742552,3578742571,19
0,1183,32854,3578742552,3578742573,21
0,1183,32855,3578742552,3578742573,21
0,1183,32856,3578742552,3578742573,21
0,1183,32857,3578742552,3578742573,21
0,1183,32858,3578742552,3578742575,23
0,1183,32859,3578742552,3578742575,23
0,1183,32860,3578742552,3578742576,24
0,1183,32861,3578742552,3578742577,25
0,1183,32862,3578742552,3578742577,25
0,1183,32863,3578742552,3578742579,27
0,1183,32864,3578742552,3578742579,27
0,1183,32865,3578742552,3578742579,27
0,1183,32866,3578742552,3578742580,28
0,1183,32867,3578742552,3578742580,28
0,1183,32868,3578742552,3578742581,29
0,1183,32869,3578742552,3578742582,30
0,1183,32870,3578742552,3578742583,31
0,1183,32871,3578742552,3578742585,33
0,1183,32872,3578742552,3578742587,35
0,1183,32873,3578742552,3578742588,36
0,1183,32874,3578742552,3578742588,36
0,1183,32875,3578742552,3578742588,36
0,1183,32876,3578742552,3578742588,36
0,1183,32877,3578742552,3578742588,36
0,1183,32878,3578742552,3578742589,37
0,1183,32879,3578742552,3578742589,37
0,1183,32880,3578742552,3578742589,37
0,1183,32881,3578742552,3578742590,38
0,1183,32882,3578742552,3578742590,38
0,1183,32883,3578742552,3578742592,40
0,1183,32884,3578742552,3578742592,40
0,1183,32885,3578742552,3578742594,42
0,1183,32886,3578742552,3578742596,44
0,1183,32887,3578742552,3578742599,47
0,1183,32888,3578742552,3578742602,50
0,1184,32889,3578742617,3578742617,0
0,1184,32890,3578742617,3578742617,0
0,1184,32891,3578742617,3578742617,0
0,1184,32892,3578742617,3578742617,0
0,1184,32893,3578742617,3578742617,0
0,1184,32894,3578742617,3578742617,0
0,1184,32895,3578742617,3578742617,0
0,1184,32896,3578742617,3578742617,0
0,1184,32897,3578742617,3578742617,0
0,1184,32898,3578742617,3578742617,0
0,1184,32899,3578742617,3578742617,0
0,1184,32900,3578742617,3578742617,0
0,1184,32901,3578742617,3578742617,0
0,1184,32902,3578742617,3578742617,0
0,1184,32903,3578742617,3578742617,0
0,1184,32904,3578742617,3578742617,0
0,1184,32905,3578742617,3578742617,0
0,1184,32906,3578742617,3578742617,0
0,1184,32907,3578742617,3578742617,0
0,1184,32908,3578742617,3578742617,0
0,1184,32909,3578742617,3578742617,0
0,1184,32910,3578742617,3578742617,0
0,1184,32911,3578742617,3578742617,0
0,1184,32912,3578742617,3578742617,0
0,1184,32913,3578742617,3578742618,1
0,1184,32914,3578742617,3578742618,1
0,1184,32915,3578742617,3578742618,1
0,1184,32916,3578742617,3578742619,2
0,1184,32917,3578742617,3578742619,2
0,1184,32918,3578742617,3578742621,4
0,1184,32919,3578742617,3578742621,4
0,1184,32920,3578742617,3578742623,6
0,1184,32921,3578742617,3578742624,7
0,1184,32922,3578742617,3578742626,9
0,1184,32923,3578742617,3578742628,11
0,1184,32924,3578742617,3578742630,13
0,1184,32925,3578742617,3578742631,14
0,1184,32926,3578742617,3578742631,14
0,1184,32927,3578742617,3578742633,16
0,1184,32928,3578742617,3578742635,18
0,1184,32929,3578742617,3578742635,18
0,1184,32930,3578742617,3578742637,20
0,1184,32931,3578742617,3578742638,21
0,1184,32932,3578742617,3578742639,22
0,1184,32933,3578742617,3578742640,23
0,1184,32934,3578742617,3578742640,23
0,1184,32935,3578742617,3578742640,23
0,1184,32936,3578742617,3578742640,23
0,1184,32937,3578742617,3578742641,24
0,1184,32938,3578742617,3578742641,24
0,1184,32939,3578742617,3578742643,26
0,1184,32940,3578742617,3578742643,26
0,1184,32941,3578742617,3578742644,27
0,1184,32942,3578742617,3578742644,27
0,1184,32943,3578742617,3578742647,30
0,1184,32944,3578742617,3578742648,31
0,1184,32945,3578742617,3578742649,32
0,1184,32946,3578742617,3578742649,32
0,1184,32947,3578742617,3578742650,33
0,1184,32948,3578742617,3578742650,33
0,1184,32949,3578742617,3578742651,34
0,1184,32950,3578742617,3578742652,35
0,1184,32951,3578742617,3578742653,36
0,1184,32952,3578742617,3578742656,39
0,1184,32953,3578742617,3578742656,39
0,1184,32954,3578742617,3578742657,40
0,1184,32955,3578742617,3578742658,41
0,1184,32956,3578742617,3578742659,42
0,1184,32957,3578742617,3578742660,43
0,1184,32958,3578742617,3578742660,43
0,1184,32959,3578742617,3578742662,45
0,1184,32960,3578742617,3578742662,45
0,1184,32961,3578742617,3578742663,46
0,1184,32962,3578742617,3578742663,46
0,1184,32963,3578742617,3578742663,46
0,1184,32964,3578742617,3578742664,47
0,1184,32965,3578742617,3578742665,48
0,1184,32966,3578742617,3578742666,49
0,1184,32967,3578742617,3578742666,49
0,1184,32968,3578742617,3578742667,50
0,1185,32969,3578742679,3578742679,0
0,1185,32970,3578742679,3578742679,0
0,1185,32971,3578742679,3578742679,0
0,1185,32972,3578742679,3578742679,0
0,1185,32973,3578742679,3578742679,0
0,1185,32974,3578742679,3578742680,1
0,1185,32975,3578742679,3578742681,2
0,1185,32976,3578742679,3578742681,2
0,1185,32977,3578742679,3578742681,2
0,1185,32978,3578742679,3578742682,3
0,1185,32979,3578742679,3578742683,4
0,1185,32980,3578742679,3578742683,4
0,1185,32981,3578742679,3578742683,4
0,1185,32982,3578742679,3578742685,6
0,1185,32983,3578742679,3578742685,6
0,1185,32984,3578742679,3578742686,7
0,1185,32985,3578742679,3578742686,7
0,1185,32986,3578742679,3578742686,7
0,1185,32987,3578742679,3578742686,7
0,1185,32988,3578742679,3578742687,8
0,1185,32989,3578742679,3578742687,8
0,1185,32990,3578742679,3578742688,9
0,1185,32991,3578742679,3578742688,9
0,1185,32992,3578742679,3578742689,10
0,1185,32993,3578742679,3578742689,10
0,1185,32994,3578742679,3578742690,11
0,1185,32995,3578742679,3578742690,11
0,1185,32996,3578742679,3578742690,11
0,1185,32997,3578742679,3578742692,13
0,1185,32998,3578742679,3578742692,13
0,1185,32999,3578742679,3578742693,14
0,1185,33000,3578742679,3578742693,14
0,1185,33001,3578742679,3578742693,14
0,1185,33002,3578742679,3578742694,15
0,1185,33003,3578742679,3578742696,17
0,1185,33004,3578742679,3578742697,18
0,1185,33005,3578742679,3578742699,20
0,1185,33006,3578742679,3578742700,21
0,1185,33007,3578742679,3578742700,21
0,1185,33008,3578742679,3578742701,22
0,1185,33009,3578742679,3578742701,22
0,1185,33010,3578742679,3578742702,23
0,1185,33011,3578742679,3578742703,24
0,1185,33012,3578742679,3578742703,24
0,1185,33013,3578742679,3578742705,26
0,1185,33014,3578742679,3578742706,27
0,1185,33015,3578742679,3578742706,27
0,1185,33016,3578742679,3578742707,28
0,1185,33017,3578742679,3578742707,28
0,1185,33018,3578742679,3578742707,28
0,1185,33019,3578742679,3578742709,30
0,1185,33020,3578742679,3578742709,30
0,1185,33021,3578742679,3578742710,31
0,1185,33022,3578742679,3578742711,32
0,1185,33023,3578742679,3578742711,32
0,1185,33024,3578742679,3578742714,35
0,1185,33025,3578742679,3578742714,35
0,1185,33026,3578742679,3578742715,36
0,1185,33027,3578742679,3578742715,36
0,1185,33028,3578742679,3578742715,36
0,1185,33029,3578742679,3578742715,36
0,1185,33030,3578742679,3578742715,36
0,1185,33031,3578742679,3578742715,36
0,1185,33032,3578742679,3578742716,37
0,1185,33033,3578742679,3578742716,37
0,1185,33034,3578742679,3578742716,37
0,1185,33035,3578742679,3578742717,38
0,1185,33036,3578742679,3578742717,38
0,1185,33037,3578742679,3578742719,40
0,1185,33038,3578742679,3578742720,41
0,1185,33039,3578742679,3578742722,43
0,1185,33040,3578742679,3578742722,43
0,1185,33041,3578742679,3578742723,44
0,1185,33042,3578742679,3578742727,48
0,1185,33043,3578742679,3578742727,48
0,1185,33044,3578742679,3578742727,48
0,1185,33045,3578742679,3578742728,49
0,1185,33046,3578742679,3578742729,50
0,1186,33047,3578742741,3578742741,0
0,1186,33048,3578742741,3578742741,0
0,1186,33049,3578742741,3578742741,0
0,1186,33050,3578742741,3578742741,0
0,1186,33051,3578742741,3578742741,0
0,1186,33052,3578742741,3578742741,0
0,1186,33053,3578742741,3578742741,0
0,1186,33054,3578742741,3578742741,0
0,1186,33055,3578742741,3578742741,0
0,1186,33056,3578742741,3578742741,0
0,1186,33057,3578742741,3578742741,0
0,1186,33058,3578742741,3578742741,0
0,1186,33059,3578742741,3578742741,0
0,1186,33060,3578742741,3578742741,0
0,1186,33061,3578742741,3578742741,0
0,1186,33062,3578742741,3578742741,0
0,1186,33063,3578742741,3578742741,0
0,1186,33064,3578742741,3578742741,0
0,1186,33065,3578742741,3578742741,0
0,1186,33066,3578742741,3578742741,0
0,1186,33067,3578742741,3578742741,0
0,1186,33068,3578742741,3578742742,1
0,1186,33069,3578742741,3578742742,1
0,1186,33070,3578742741,3578742743,2
0,1186,33071,3578742741,3578742743,2
0,1186,33072,3578742741,3578742743,2
0,1186,33073,3578742741,3578742743,2
0,1186,33074,3578742741,3578742744,3
0,1186,33075,3578742741,3578742745,4
0,1186,33076,3578742741,3578742746,5
0,1186,33077,3578742741,3578742746,5
0,1186,33078,3578742741,3578742747,6
0,1186,33079,3578742741,3578742748,7
0,1186,33080,3578742741,3578742748,7
0,1186,33081,3578742741,3578742750,9
0,1186,33082,3578742741,3578742753,12
0,1186,33083,3578742741,3578742755,14
0,1186,33084,3578742741,3578742756,15
0,1186,33085,3578742741,3578742756,15
0,1186,33086,3578742741,3578742757,16
0,1186,33087,3578742741,3578742758,17
0,1186,33088,3578742741,3578742759,18
0,1186,33089,3578742741,3578742759,18
0,1186,33090,3578742741,3578742760,19
0,1186,33091,3578742741,3578742760,19
0,1186,33092,3578742741,3578742760,19
0,1186,33093,3578742741,3578742760,19
0,1186,33094,3578742741,3578742761,20
0,1186,33095,3578742741,3578742762,21
0,1186,33096,3578742741,3578742764,23
0,1186,33097,3578742741,3578742766,25
0,1186,33098,3578742741,3578742767,26
0,1186,33099,3578742741,3578742767,26
0,1186,33100,3578742741,3578742768,27
0,1186,33101,3578742741,3578742768,27
0,1186,33102,3578742741,3578742768,27
0,1186,33103,3578742741,3578742769,28
0,1186,33104,3578742741,3578742769,28
0,1186,33105,3578742741,3578742769,28
0,1186,33106,3578742741,3578742769,28
0,1186,33107,3578742741,3578742770,29
0,1186,33108,3578742741,3578742770,29
0,1186,33109,3578742741,3578742773,32
0,1186,33110,3578742741,3578742773,32
0,1186,33111,3578742741,3578742774,33
0,1186,33112,3578742741,3578742775,34
0,1186,33113,3578742741,3578742776,35
0,1186,33114,3578742741,3578742776,35
0,1186,33115,3578742741,3578742778,37
0,1186,33116,3578742741,3578742778,37
0,1186,33117,3578742741,3578742779,38
0,1186,33118,3578742741,3578742779,38
0,1186,33119,3578742741,3578742779,38
0,1186,33120,3578742741,3578742780,39
0,1186,33121,3578742741,3578742780,39
0,1186,33122,3578742741,3578742782,41
0,1186,33123,3578742741,3578742782,41
0,1186,33124,3578742741,3578742782,41
0,1186,33125,3578742741,3578742785,44
0,1186,33126,3578742741,3578742787,46
0,1186,33127,3578742741,3578742787,46
0,1186,33128,3578742741,3578742788,47
0,1186,33129,3578742741,3578742788,47
0,1186,33130,3578742741,3578742789,48
0,1186,33131,3578742741,3578742789,48
0,1186,33132,3578742741,3578742789,48
0,1186,33133,3578742741,3578742789,48
0,1186,33134,3578742741,3578742790,49
0,1186,33135,3578742741,3578742790,49
0,1187,33136,3578742804,3578742804,0
0,1187,33137,3578742804,3578742804,0
0,1187,33138,3578742804,3578742804,0
0,1187,33139,3578742804,3578742804,0
0,1187,33140,3578742804,3578742804,0
0,1187,33141,3578742804,3578742804,0
0,1187,33142,3578742804,3578742804,0
0,1187,33143,3578742804,3578742804,0
0,1187,33144,3578742804,3578742804,0
0,1187,33145,3578742804,3578742804,0
0,1187,33146,3578742804,3578742804,0
0,1187,33147,3578742804,3578742804,0
0,1187,33148,3578742804,3578742804,0
0,1187,33149,3578742804,3578742805,1
0,1187,33150,3578742804,3578742805,1
0,1187,33151,3578742804,3578742806,2
0,1187,33152,3578742804,3578742806,2
0,1187,33153,3578742804,3578742807,3
0,1187,33154,3578742804,3578742808,4
0,1187,33155,3578742804,3578742808,4
0,1187,33156,3578742804,3578742809,5
0,1187,33157,3578742804,3578742809,5
0,1187,33158,3578742804,3578742810,6
0,1187,33159,3578742804,3578742810,6
0,1187,33160,3578742804,3578742811,7
0,1187,33161,3578742804,3578742812,8
0,1187,33162,3578742804,3578742812,8
0,1187,33163,3578742804,3578742813,9
0,1187,33164,3578742804,3578742813,9
0,1187,33165,3578742804,3578742814,10
0,1187,33166,3578742804,3578742814,10
0,1187,33167,3578742804,3578742814,10
0,1187,33168,3578742804,3578742815,11
0,1187,33169,3578742804,3578742816,12
0,1187,33170,3578742804,3578742818,14
0,1187,33171,3578742804,3578742819,15
0,1187,33172,3578742804,3578742819,15
0,1187,33173,3578742804,3578742820,16
0,1187,33174,3578742804,3578742820,16
0,1187,33175,3578742804,3578742821,17
0,1187,33176,3578742804,3578742822,18
0,1187,33177,3578742804,3578742822,18
0,1187,33178,3578742804,3578742824,20
0,1187,33179,3578742804,3578742824,20
0,1187,33180,3578742804,3578742824,20
0,1187,33181,3578742804,3578742826,22
0,1187,33182,3578742804,3578742827,23
0,1187,33183,3578742804,3578742829,25
0,1187,33184,3578742804,3578742831,27
0,1187,33185,3578742804,3578742832,28
0,1187,33186,3578742804,3578742833,29
0,1187,33187,3578742804,3578742835,31
0,1187,33188,3578742804,3578742835,31
0,1187,33189,3578742804,3578742837,33
0,1187,33190,3578742804,3578742838,34
0,1187,33191,3578742804,3578742839,35
0,1187,33192,3578742804,3578742839,35
0,1187,33193,3578742804,3578742840,36
0,1187,33194,3578742804,3578742840,36
0,1187,33195,3578742804,3578742841,37
0,1187,33196,3578742804,3578742841,37
0,1187,33197,3578742804,3578742841,37
0,1187,33198,3578742804,3578742842,38
0,1187,33199,3578742804,3578742843,39
0,1187,33200,3578742804,3578742843,39
0,1187,33201,3578742804,3578742844,40
0,1187,33202,3578742804,3578742847,43
0,1187,33203,3578742804,3578742848,44
0,1187,33204,3578742804,3578742849,45
0,1187,33205,3578742804,3578742849,45
0,1187,33206,3578742804,3578742850,46
0,1187,33207,3578742804,3578742850,46
0,1187,33208,3578742804,3578742850,46
0,1187,33209,3578742804,3578742851,47
0,1187,33210,3578742804,3578742852,48
0,1188,33211,3578742866,3578742866,0
0,1188,33212,3578742866,3578742866,0
0,1188,33213,3578742866,3578742866,0
0,1188,33214,3578742866,3578742866,0
0,1188,33215,3578742866,3578742866,0
0,1188,33216,3578742866,3578742866,0
0,1188,33217,3578742866,3578742866,0
0,1188,33218,3578742866,3578742866,0
0,1188,33219,3578742866,3578742866,0
0,1188,33220,3578742866,3578742866,0
0,1188,33221,3578742866,3578742866,0
0,1188,33222,3578742866,3578742866,0
0,1188,33223,3578742866,3578742866,0
0,1188,33224,3578742866,3578742866,0
0,1188,33225,3578742866,3578742866,0
0,1188,33226,3578742866,3578742866,0
0,1188,33227,3578742866,3578742867,1
0,1188,33228,3578742866,3578742868,2
0,1188,33229,3578742866,3578742875,9
0,1188,33230,3578742866,3578742877,11
0,1188,33231,3578742866,3578742877,11
0,1188,33232,3578742866,3578742879,13
0,1188,33233,3578742866,3578742880,14
0,1188,33234,3578742866,3578742880,14
0,1188,33235,3578742866,3578742880,14
0,1188,33236,3578742866,3578742881,15
0,1188,33237,3578742866,3578742882,16
0,1188,33238,3578742866,3578742882,16
0,1188,33239,3578742866,3578742882,16
0,1188,33240,3578742866,3578742883,17
0,1188,33241,3578742866,3578742883,17
0,1188,33242,3578742866,3578742883,17
0,1188,33243,3578742866,3578742885,19
0,1188,33244,3578742866,3578742885,19
0,1188,33245,3578742866,3578742886,20
0,1188,33246,3578742866,3578742886,20
0,1188,33247,3578742866,3578742886,20
0,1188,33248,3578742866,3578742887,21
0,1188,33249,3578742866,3578742887,21
0,1188,33250,3578742866,3578742887,21
0,1188,33251,3578742866,3578742887,21
0,1188,33252,3578742866,3578742888,22
0,1188,33253,3578742866,3578742888,22
0,1188,33254,3578742866,3578742889,23
0,1188,33255,3578742866,3578742889,23
0,1188,33256,3578742866,3578742890,24
0,1188,33257,3578742866,3578742890,24
0,1188,33258,3578742866,3578742890,24
0,1188,33259,3578742866,3578742892,26
0,1188,33260,3578742866,3578742892,26
0,1188,33261,3578742866,3578742893,27
0,1188,33262,3578742866,3578742894,28
0,1188,33263,3578742866,3578742895,29
0,1188,33264,3578742866,3578742896,30
0,1188,33265,3578742866,3578742897,31
0,1188,33266,3578742866,3578742898,32
0,1188,33267,3578742866,3578742899,33
0,1188,33268,3578742866,3578742901,35
0,1188,33269,3578742866,3578742901,35
0,1188,33270,3578742866,3578742901,35
0,1188,33271,3578742866,3578742901,35
0,1188,33272,3578742866,3578742902,36
0,1188,33273,3578742866,3578742902,36
0,1188,33274,3578742866,3578742904,38
0,1188,33275,3578742866,3578742904,38
0,1188,33276,3578742866,3578742905,39
0,1188,33277,3578742866,3578742906,40
0,1188,33278,3578742866,3578742906,40
0,1188,33279,3578742866,3578742906,40
0,1188,33280,3578742866,3578742906,40
0,1188,33281,3578742866,3578742907,41
0,1188,33282,3578742866,3578742908,42
0,1188,33283,3578742866,3578742909,43
0,1188,33284,3578742866,3578742910,44
0,1188,33285,3578742866,3578742910,44
0,1188,33286,3578742866,3578742911,45
0,1188,33287,3578742866,3578742912,46
0,1188,33288,3578742866,3578742914,48
0,1188,33289,3578742866,3578742914,48
0,1188,33290,3578742866,3578742914,48
0,1188,33291,3578742866,3578742914,48
0,1188,33292,3578742866,3578742914,48
0,1188,33293,3578742866,3578742915,49
0,1188,33294,3578742866,3578742915,49
0,1188,33295,3578742866,3578742915,49
0,1188,33296,3578742866,3578742916,50
0,1189,33297,3578742928,3578742928,0
0,1189,33298,3578742928,3578742928,0
0,1189,33299,3578742928,3578742928,0
0,1189,33300,3578742928,3578742928,0
0,1189,33301,3578742928,3578742928,0
0,1189,33302,3578742928,3578742928,0
0,1189,33303,3578742928,3578742928,0
0,1189,33304,3578742928,3578742928,0
0,1189,33305,3578742928,3578742928,0
0,1189,33306,3578742928,3578742928,0
0,1189,33307,3578742928,3578742928,0
0,1189,33308,3578742928,3578742928,0
0,1189,33309,3578742928,3578742928,0
0,1189,33310,3578742928,3578742928,0
0,1189,33311,3578742928,3578742928,0
0,1189,33312,3578742928,3578742929,1
0,1189,33313,3578742928,3578742929,1
0,1189,33314,3578742928,3578742931,3
0,1189,33315,3578742928,3578742931,3
0,1189,33316,3578742928,3578742931,3
0,1189,33317,3578742928,3578742931,3
0,1189,33318,3578742928,3578742931,3
0,1189,33319,3578742928,3578742932,4
0,1189,33320,3578742928,3578742932,4
0,1189,33321,3578742928,3578742933,5
0,1189,33322,3578742928,3578742934,6
0,1189,33323,3578742928,3578742935,7
0,1189,33324,3578742928,3578742935,7
0,1189,33325,3578742928,3578742935,7
0,1189,33326,3578742928,3578742936,8
0,1189,33327,3578742928,3578742938,10
0,1189,33328,3578742928,3578742939,11
0,1189,33329,3578742928,3578742939,11
0,1189,33330,3578742928,3578742939,11
0,1189,33331,3578742928,3578742940,12
0,1189,33332,3578742928,3578742940,12
0,1189,33333,3578742928,3578742941,13
0,1189,33334,3578742928,3578742941,13
0,1189,33335,3578742928,3578742942,14
0,1189,33336,3578742928,3578742943,15
0,1189,33337,3578742928,3578742943,15
0,1189,33338,3578742928,3578742943,15
0,1189,33339,3578742928,3578742943,15
0,1189,33340,3578742928,3578742945,17
0,1189,33341,3578742928,3578742946,18
0,1189,33342,3578742928,3578742946,18
0,1189,33343,3578742928,3578742946,18
0,1189,33344,3578742928,3578742946,18
0,1189,33345,3578742928,3578742948,20
0,1189,33346,3578742928,3578742948,20
0,1189,33347,3578742928,3578742948,20
0,1189,33348,3578742928,3578742950,22
0,1189,33349,3578742928,3578742951,23
0,1189,33350,3578742928,3578742952,24
0,1189,33351,3578742928,3578742954,26
0,1189,33352,3578742928,3578742956,28
0,1189,33353,3578742928,3578742957,29
0,1189,33354,3578742928,3578742957,29
0,1189,33355,3578742928,3578742958,30
0,1189,33356,3578742928,3578742959,31
0,1189,33357,3578742928,3578742959,31
0,1189,33358,3578742928,3578742959,31
0,1189,33359,3578742928,3578742960,32
0,1189,33360,3578742928,3578742961,33
0,1189,33361,3578742928,3578742961,33
0,1189,33362,3578742928,3578742961,33
0,1189,33363,3578742928,3578742961,33
0,1189,33364,3578742928,3578742964,36
0,1189,33365,3578742928,3578742966,38
0,1189,33366,3578742928,3578742967,39
0,1189,33367,3578742928,3578742967,39
0,1189,33368,3578742928,3578742968,40
0,1189,33369,3578742928,3578742968,40
0,1189,33370,3578742928,3578742969,41
0,1189,33371,3578742928,3578742969,41
0,1189,33372,3578742928,3578742969,41
0,1189,33373,3578742928,3578742970,42
0,1189,33374,3578742928,3578742970,42
0,1189,33375,3578742928,3578742970,42
0,1189,33376,3578742928,3578742970,42
0,1189,33377,3578742928,3578742974,46
0,1189,33378,3578742928,3578742974,46
0,1189,33379,3578742928,3578742974,46
0,1189,33380,3578742928,3578742975,47
0,1189,33381,3578742928,3578742976,48
0,1189,33382,3578742928,3578742976,48
0,1189,33383,3578742928,3578742978,50
0,1190,33384,3578742990,3578742990,0
0,1190,33385,3578742990,3578742990,0
0,1190,33386,3578742990,3578742990,0
0,1190,33387,3578742990,3578742990,0
0,1190,33388,3578742990,3578742990,0
0,1190,33389,3578742990,3578742990,0
0,1190,33390,3578742990,3578742990,0
0,1190,33391,3578742990,3578742990,0
0,1190,33392,3578742990,3578742990,0
0,1190,33393,3578742990,3578742990,0
0,1190,33394,3578742990,3578742990,0
0,1190,33395,3578742990,3578742990,0
0,1190,33396,3578742990,3578742990,0
0,1190,33397,3578742990,3578742990,0
0,1190,33398,3578742990,3578742990,0
0,1190,33399,3578742990,3578742990,0
0,1190,33400,3578742990,3578742990,0
0,1190,33401,3578742990,3578742990,0
0,1190,33402,3578742990,3578742990,0
0,1190,33403,3578742990,3578742992,2
0,1190,33404,3578742990,3578742992,2
0,1190,33405,3578742990,3578742996,6
0,1190,33406,3578742990,3578742996,6
0,1190,33407,3578742990,3578743000,10
0,1190,33408,3578742990,3578743001,11
0,1190,33409,3578742990,3578743001,11
0,1190,33410,3578742990,3578743002,12
0,1190,33411,3578742990,3578743003,13
0,1190,33412,3578742990,3578743003,13
0,1190,33413,3578742990,3578743005,15
0,1190,33414,3578742990,3578743005,15
0,1190,33415,3578742990,3578743006,16
0,1190,33416,3578742990,3578743006,16
0,1190,33417,3578742990,3578743006,16
0,1190,33418,3578742990,3578743007,17
0,1190,33419,3578742990,3578743007,17
0,1190,33420,3578742990,3578743008,18
0,1190,33421,3578742990,3578743008,18
0,1190,33422,3578742990,3578743009,19
0,1190,33423,3578742990,3578743010,20
0,1190,33424,3578742990,3578743010,20
0,1190,33425,3578742990,3578743012,22
0,1190,33426,3578742990,3578743012,22
0,1190,33427,3578742990,3578743013,23
0,1190,33428,3578742990,3578743014,24
0,1190,33429,3578742990,3578743015,25
0,1190,33430,3578742990,3578743015,25
0,1190,33431,3578742990,3578743015,25
0,1190,33432,3578742990,3578743016,26
0,1190,33433,3578742990,3578743016,26
0,1190,33434,3578742990,3578743016,26
0,1190,33435,3578742990,3578743018,28
0,1190,33436,3578742990,3578743018,28
0,1190,33437,3578742990,3578743019,29
0,1190,33438,3578742990,3578743019,29
0,1190,33439,3578742990,3578743020,30
0,1190,33440,3578742990,3578743020,30
0,1190,33441,3578742990,3578743021,31
0,1190,33442,3578742990,3578743022,32
0,1190,33443,3578742990,3578743023,33
0,1190,33444,3578742990,3578743024,34
0,1190,33445,3578742990,3578743024,34
0,1190,33446,3578742990,3578743025,35
0,1190,33447,3578742990,3578743025,35
0,1190,33448,3578742990,3578743026,36
0,1190,33449,3578742990,3578743027,37
0,1190,33450,3578742990,3578743029,39
0,1190,33451,3578742990,3578743031,41
0,1190,33452,3578742990,3578743032,42
0,1190,33453,3578742990,3578743035,45
0,1190,33454,3578742990,3578743035,45
0,1190,33455,3578742990,3578743037,47
0,1190,33456,3578742990,3578743038,48
0,1190,33457,3578742990,3578743039,49
0,1190,33458,3578742990,3578743039,49
0,1190,33459,3578742990,3578743040,50
0,1191,33460,3578743053,3578743053,0
0,1191,33461,3578743053,3578743053,0
0,1191,33462,3578743053,3578743053,0
0,1191,33463,3578743053,3578743053,0
0,1191,33464,3578743053,3578743053,0
0,1191,33465,3578743053,3578743053,0
0,1191,33466,3578743053,3578743053,0
0,1191,33467,3578743053,3578743053,0
0,1191,33468,3578743053,3578743053,0
0,1191,33469,3578743053,3578743053,0
0,1191,33470,3578743053,3578743053,0
0,1191,33471,3578743053,3578743053,0
0,1191,33472,3578743053,3578743053,0
0,1191,33473,3578743053,3578743053,0
0,1191,33474,3578743053,3578743053,0
0,1191,33475,3578743053,3578743053,0
0,1191,33476,3578743053,3578743053,0
0,1191,33477,3578743053,3578743053,0
0,1191,33478,3578743053,3578743053,0
0,1191,33479,3578743053,3578743054,1
0,1191,33480,3578743053,3578743056,3
0,1191,33481,3578743053,3578743056,3
0,1191,33482,3578743053,3578743057,4
0,1191,33483,3578743053,3578743058,5
0,1191,33484,3578743053,3578743060,7
0,1191,33485,3578743053,3578743061,8
0,1191,33486,3578743053,3578743061,8
0,1191,33487,3578743053,3578743062,9
0,1191,33488,3578743053,3578743063,10
0,1191,33489,3578743053,3578743063,10
0,1191,33490,3578743053,3578743063,10
0,1191,33491,3578743053,3578743064,11
0,1191,33492,3578743053,3578743065,12
0,1191,33493,3578743053,3578743066,13
0,1191,33494,3578743053,3578743066,13
0,1191,33495,3578743053,3578743067,14
0,1191,33496,3578743053,3578743067,14
0,1191,33497,3578743053,3578743075,22
0,1191,33498,3578743053,3578743077,24
0,1191,33499,3578743053,3578743079,26
0,1191,33500,3578743053,3578743079,26
0,1191,33501,3578743053,3578743080,27
0,1191,33502,3578743053,3578743080,27
0,1191,33503,3578743053,3578743081,28
0,1191,33504,3578743053,3578743081,28
0,1191,33505,3578743053,3578743082,29
0,1191,33506,3578743053,3578743082,29
0,1191,33507,3578743053,3578743083,30
0,1191,33508,3578743053,3578743083,30
0,1191,33509,3578743053,3578743084,31
0,1191,33510,3578743053,3578743085,32
0,1191,33511,3578743053,3578743085,32
0,1191,33512,3578743053,3578743086,33
0,1191,33513,3578743053,3578743087,34
0,1191,33514,3578743053,3578743087,34
0,1191,33515,3578743053,3578743087,34
0,1191,33516,3578743053,3578743088,35
0,1191,33517,3578743053,3578743088,35
0,1191,33518,3578743053,3578743088,35
0,1191,33519,3578743053,3578743088,35
0,1191,33520,3578743053,3578743089,36
0,1191,33521,3578743053,3578743090,37
0,1191,33522,3578743053,3578743090,37
0,1191,33523,3578743053,3578743090,37
0,1191,33524,3578743053,3578743091,38
0,1191,33525,3578743053,3578743092,39
0,1191,33526,3578743053,3578743092,39
0,1191,33527,3578743053,3578743093,40
0,1191,33528,3578743053,3578743094,41
0,1191,33529,3578743053,3578743095,42
0,1191,33530,3578743053,3578743097,44
0,1191,33531,3578743053,3578743097,44
0,1191,33532,3578743053,3578743098,45
0,1191,33533,3578743053,3578743099,46
0,1191,33534,3578743053,3578743101,48
0,1191,33535,3578743053,3578743101,48
0,1191,33536,3578743053,3578743101,48
0,1191,33537,3578743053,3578743101,48
0,1191,33538,3578743053,3578743102,49
0,1191,33539,3578743053,3578743102,49
0,1191,33540,3578743053,3578743103,50
0,1192,33541,3578743114,3578743114,0
0,1192,33542,3578743114,3578743114,0
0,1192,33543,3578743114,3578743114,0
0,1192,33544,3578743114,3578743114,0
0,1192,33545,3578743114,3578743114,0
0,1192,33546,3578743114,3578743114,0
0,1192,33547,3578743114,3578743114,0
0,1192,33548,3578743114,3578743114,0
0,1192,33549,3578743114,3578743114,0
0,1192,33550,3578743114,3578743114,0
0,1192,33551,3578743114,3578743114,0
0,1192,33552,3578743114,3578743114,0
0,1192,33553,3578743114,3578743114,0
0,1192,33554,3578743114,3578743114,0
0,1192,33555,3578743114,3578743114,0
0,1192,33556,3578743114,3578743115,1
0,1192,33557,3578743114,3578743115,1
0,1192,33558,3578743114,3578743115,1
0,1192,33559,3578743114,3578743115,1
0,1192,33560,3578743114,3578743115,1
0,1192,33561,3578743114,3578743116,2
0,1192,33562,3578743114,3578743116,2
0,1192,33563,3578743114,3578743116,2
0,1192,33564,3578743114,3578743116,2
0,1192,33565,3578743114,3578743116,2
0,1192,33566,3578743114,3578743118,4
0,1192,33567,3578743114,3578743118,4
0,1192,33568,3578743114,3578743119,5
0,1192,33569,3578743114,3578743119,5
0,1192,33570,3578743114,3578743120,6
0,1192,33571,3578743114,3578743121,7
0,1192,33572,3578743114,3578743122,8
0,1192,33573,3578743114,3578743123,9
0,1192,33574,3578743114,3578743123,9
0,1192,33575,3578743114,3578743127,13
0,1192,33576,3578743114,3578743127,13
0,1192,33577,3578743114,3578743128,14
0,1192,33578,3578743114,3578743129,15
0,1192,33579,3578743114,3578743129,15
0,1192,33580,3578743114,3578743130,16
0,1192,33581,3578743114,3578743131,17
0,1192,33582,3578743114,3578743131,17
0,1192,33583,3578743114,3578743131,17
0,1192,33584,3578743114,3578743132,18
0,1192,33585,3578743114,3578743132,18
0,1192,33586,3578743114,3578743132,18
0,1192,33587,3578743114,3578743134,20
0,1192,33588,3578743114,3578743135,21
0,1192,33589,3578743114,3578743135,21
0,1192,33590,3578743114,3578743135,21
0,1192,33591,3578743114,3578743137,23
0,1192,33592,3578743114,3578743138,24
0,1192,33593,3578743114,3578743139,25
0,1192,33594,3578743114,3578743139,25
0,1192,33595,3578743114,3578743139,25
0,1192,33596,3578743114,3578743140,26
0,1192,33597,3578743114,3578743141,27
0,1192,33598,3578743114,3578743141,27
0,1192,33599,3578743114,3578743141,27
0,1192,33600,3578743114,3578743142,28
0,1192,33601,3578743114,3578743143,29
0,1192,33602,3578743114,3578743143,29
0,1192,33603,3578743114,3578743143,29
0,1192,33604,3578743114,3578743143,29
0,1192,33605,3578743114,3578743144,30
0,1192,33606,3578743114,3578743145,31
0,1192,33607,3578743114,3578743145,31
0,1192,33608,3578743114,3578743147,33
0,1192,33609,3578743114,3578743147,33
0,1192,33610,3578743114,3578743147,33
0,1192,33611,3578743114,3578743148,34
0,1192,33612,3578743114,3578743148,34
0,1192,33613,3578743114,3578743148,34
0,1192,33614,3578743114,3578743151,37
0,1192,33615,3578743114,3578743152,38
0,1192,33616,3578743114,3578743153,39
0,1192,33617,3578743114,3578743155,41
0,1192,33618,3578743114,3578743156,42
0,1192,33619,3578743114,3578743156,42
0,1192,33620,3578743114,3578743156,42
0,1192,33621,3578743114,3578743158,44
0,1192,33622,3578743114,3578743159,45
0,1192,33623,3578743114,3578743159,45
0,1192,33624,3578743114,3578743159,45
0,1192,33625,3578743114,3578743160,46
0,1192,33626,3578743114,3578743160,46
0,1192,33627,3578743114,3578743161,47
0,1192,33628,3578743114,3578743161,47
0,1192,33629,3578743114,3578743161,47
0,1192,33630,3578743114,3578743162,48
0,1193,33631,3578743175,3578743175,0
0,1193,33632,3578743175,3578743175,0
0,1193,33633,3578743175,3578743175,0
0,1193,33634,3578743175,3578743175,0
0,1193,33635,3578743175,3578743175,0
0,1193,33636,3578743175,3578743175,0
0,1193,33637,3578743175,3578743175,0
0,1193,33638,3578743175,3578743175,0
0,1193,33639,3578743175,3578743175,0
0,1193,33640,3578743175,3578743175,0
0,1193,33641,3578743175,3578743175,0
0,1193,33642,3578743175,3578743175,0
0,1193,33643,3578743175,3578743175,0
0,1193,33644,3578743175,3578743175,0
0,1193,33645,3578743175,3578743175,0
0,1193,33646,3578743175,3578743175,0
0,1193,33647,3578743175,3578743176,1
0,1193,33648,3578743175,3578743176,1
0,1193,33649,3578743175,3578743176,1
0,1193,33650,3578743175,3578743178,3
0,1193,33651,3578743175,3578743179,4
0,1193,33652,3578743175,3578743179,4
0,1193,33653,3578743175,3578743179,4
0,1193,33654,3578743175,3578743180,5
0,1193,33655,3578743175,3578743181,6
0,1193,33656,3578743175,3578743181,6
0,1193,33657,3578743175,3578743182,7
0,1193,33658,3578743175,3578743185,10
0,1193,33659,3578743175,3578743185,10
0,1193,33660,3578743175,3578743187,12
0,1193,33661,3578743175,3578743187,12
0,1193,33662,3578743175,3578743188,13
0,1193,33663,3578743175,3578743189,14
0,1193,33664,3578743175,3578743189,14
0,1193,33665,3578743175,3578743189,14
0,1193,33666,3578743175,3578743190,15
0,1193,33667,3578743175,3578743190,15
0,1193,33668,3578743175,3578743190,15
0,1193,33669,3578743175,3578743190,15
0,1193,33670,3578743175,3578743191,16
0,1193,33671,3578743175,3578743193,18
0,1193,33672,3578743175,3578743196,21
0,1193,33673,3578743175,3578743197,22
0,1193,33674,3578743175,3578743197,22
0,1193,33675,3578743175,3578743200,25
0,1193,33676,3578743175,3578743201,26
0,1193,33677,3578743175,3578743201,26
0,1193,33678,3578743175,3578743202,27
0,1193,33679,3578743175,3578743203,28
0,1193,33680,3578743175,3578743204,29
0,1193,33681,3578743175,3578743204,29
0,1193,33682,3578743175,3578743205,30
0,1193,33683,3578743175,3578743206,31
0,1193,33684,3578743175,3578743206,31
0,1193,33685,3578743175,3578743206,31
0,1193,33686,3578743175,3578743206,31
0,1193,33687,3578743175,3578743208,33
0,1193,33688,3578743175,3578743208,33
0,1193,33689,3578743175,3578743209,34
0,1193,33690,3578743175,3578743209,34
0,1193,33691,3578743175,3578743210,35
0,1193,33692,3578743175,3578743210,35
0,1193,33693,3578743175,3578743212,37
0,1193,33694,3578743175,3578743212,37
0,1193,33695,3578743175,3578743213,38
0,1193,33696,3578743175,3578743213,38
0,1193,33697,3578743175,3578743214,39
0,1193,33698,3578743175,3578743215,40
0,1193,33699,3578743175,3578743216,41
0,1193,33700,3578743175,3578743216,41
0,1193,33701,3578743175,3578743216,41
0,1193,33702,3578743175,3578743216,41
0,1193,33703,3578743175,3578743218,43
0,1193,33704,3578743175,3578743218,43
0,1193,33705,3578743175,3578743219,44
0,1193,33706,3578743175,3578743219,44
0,1193,33707,3578743175,3578743219,44
0,1193,33708,3578743175,3578743219,44
0,1193,33709,3578743175,3578743220,45
0,1193,33710,3578743175,3578743221,46
0,1193,33711,3578743175,3578743222,47
0,1193,33712,3578743175,3578743223,48
0,1193,33713,3578743175,3578743225,50
0,1193,33714,3578743175,3578743225,50
0,1194,33715,3578743237,3578743237,0
0,1194,33716,3578743237,3578743237,0
0,1194,33717,3578743237,3578743237,0
0,1194,33718,3578743237,3578743237,0
0,1194,33719,3578743237,3578743237,0
0,1194,33720,3578743237,3578743237,0
0,1194,33721,3578743237,3578743237,0
0,1194,33722,3578743237,3578743237,0
0,1194,33723,3578743237,3578743237,0
0,1194,33724,3578743237,3578743237,0
0,1194,33725,3578743237,3578743237,0
0,1194,33726,3578743237,3578743238,1
0,1194,33727,3578743237,3578743238,1
0,1194,33728,3578743237,3578743239,2
0,1194,33729,3578743237,3578743240,3
0,1194,33730,3578743237,3578743240,3
0,1194,33731,3578743237,3578743240,3
0,1194,33732,3578743237,3578743240,3
0,1194,33733,3578743237,3578743241,4
0,1194,33734,3578743237,3578743242,5
0,1194,33735,3578743237,3578743242,5
0,1194,33736,3578743237,3578743242,5
0,1194,33737,3578743237,3578743244,7
0,1194,33738,3578743237,3578743244,7
0,1194,33739,3578743237,3578743244,7
0,1194,33740,3578743237,3578743248,11
0,1194,33741,3578743237,3578743248,11
0,1194,33742,3578743237,3578743248,11
0,1194,33743,3578743237,3578743249,12
0,1194,33744,3578743237,3578743249,12
0,1194,33745,3578743237,3578743249,12
0,1194,33746,3578743237,3578743250,13
0,1194,33747,3578743237,3578743250,13
0,1194,33748,3578743237,3578743251,14
0,1194,33749,3578743237,3578743253,16
0,1194,33750,3578743237,3578743255,18
0,1194,33751,3578743237,3578743256,19
0,1194,33752,3578743237,3578743256,19
0,1194,33753,3578743237,3578743258,21
0,1194,33754,3578743237,3578743259,22
0,1194,33755,3578743237,3578743260,23
0,1194,33756,3578743237,3578743261,24
0,1194,33757,3578743237,3578743262,25
0,1194,33758,3578743237,3578743262,25
0,1194,33759,3578743237,3578743262,25
0,1194,33760,3578743237,3578743263,26
0,1194,33761,3578743237,3578743264,27
0,1194,33762,3578743237,3578743264,27
0,1194,33763,3578743237,3578743264,27
0,1194,33764,3578743237,3578743264,27
0,1194,33765,3578743237,3578743266,29
0,1194,33766,3578743237,3578743266,29
0,1194,33767,3578743237,3578743268,31
0,1194,33768,3578743237,3578743275,38
0,1194,33769,3578743237,3578743277,40
0,1194,33770,3578743237,3578743277,40
0,1194,33771,3578743237,3578743279,42
0,1194,33772,3578743237,3578743279,42
0,1194,33773,3578743237,3578743279,42
0,1194,33774,3578743237,3578743280,43
0,1194,33775,3578743237,3578743281,44
0,1194,33776,3578743237,3578743281,44
0,1194,33777,3578743237,3578743282,45
0,1194,33778,3578743237,3578743282,45
0,1194,33779,3578743237,3578743283,46
0,1194,33780,3578743237,3578743283,46
0,1194,33781,3578743237,3578743284,47
0,1194,33782,3578743237,3578743285,48
0,1194,33783,3578743237,3578743286,49
0,1194,33784,3578743237,3578743286,49
0,1194,33785,3578743237,3578743287,50
0,1194,33786,3578743237,3578743287,50
0,1195,33787,3578743298,3578743298,0
0,1195,33788,3578743298,3578743298,0
0,1195,33789,3578743298,3578743298,0
0,1195,33790,3578743298,3578743298,0
0,1195,33791,3578743298,3578743298,0
0,1195,33792,3578743298,3578743298,0
0,1195,33793,3578743298,3578743298,0
0,1195,33794,3578743298,3578743298,0
0,1195,33795,3578743298,3578743298,0
0,1195,33796,3578743298,3578743298,0
0,1195,33797,3578743298,3578743298,0
0,1195,33798,3578743298,3578743298,0
0,1195,33799,3578743298,3578743298,0
0,1195,33800,3578743298,3578743298,0
0,1195,33801,3578743298,3578743298,0
0,1195,33802,3578743298,3578743298,0
0,1195,33803,3578743298,3578743298,0
0,1195,33804,3578743298,3578743300,2
0,1195,33805,3578743298,3578743300,2
0,1195,33806,3578743298,3578743301,3
0,1195,33807,3578743298,3578743302,4
0,1195,33808,3578743298,3578743302,4
0,1195,33809,3578743298,3578743302,4
0,1195,33810,3578743298,3578743304,6
0,1195,33811,3578743298,3578743304,6
0,1195,33812,3578743298,3578743304,6
0,1195,33813,3578743298,3578743305,7
0,1195,33814,3578743298,3578743305,7
0,1195,33815,3578743298,3578743306,8
0,1195,33816,3578743298,3578743307,9
0,1195,33817,3578743298,3578743307,9
0,1195,33818,3578743298,3578743307,9
0,1195,33819,3578743298,3578743308,10
0,1195,33820,3578743298,3578743309,11
0,1195,33821,3578743298,3578743309,11
0,1195,33822,3578743298,3578743310,12
0,1195,33823,3578743298,3578743310,12
0,1195,33824,3578743298,3578743310,12
0,1195,33825,3578743298,3578743311,13
0,1195,33826,3578743298,3578743312,14
0,1195,33827,3578743298,3578743314,16
0,1195,33828,3578743298,3578743316,18
0,1195,33829,3578743298,3578743316,18
0,1195,33830,3578743298,3578743316,18
0,1195,33831,3578743298,3578743316,18
0,1195,33832,3578743298,3578743316,18
0,1195,33833,3578743298,3578743316,18
0,1195,33834,3578743298,3578743316,18
0,1195,33835,3578743298,3578743316,18
0,1195,33836,3578743298,3578743316,18
0,1195,33837,3578743298,3578743316,18
0,1195,33838,3578743298,3578743318,20
0,1195,33839,3578743298,3578743318,20
0,1195,33840,3578743298,3578743319,21
0,1195,33841,3578743298,3578743319,21
0,1195,33842,3578743298,3578743320,22
0,1195,33843,3578743298,3578743320,22
0,1195,33844,3578743298,3578743323,25
0,1195,33845,3578743298,3578743323,25
0,1195,33846,3578743298,3578743323,25
0,1195,33847,3578743298,3578743328,30
0,1195,33848,3578743298,3578743328,30
0,1195,33849,3578743298,3578743328,30
0,1195,33850,3578743298,3578743328,30
0,1195,33851,3578743298,3578743329,31
0,1195,33852,3578743298,3578743330,32
0,1195,33853,3578743298,3578743331,33
0,1195,33854,3578743298,3578743331,33
0,1195,33855,3578743298,3578743332,34
0,1195,33856,3578743298,3578743332,34
0,1195,33857,3578743298,3578743332,34
0,1195,33858,3578743298,3578743332,34
0,1195,33859,3578743298,3578743334,36
0,1195,33860,3578743298,3578743335,37
0,1195,33861,3578743298,3578743335,37
0,1195,33862,3578743298,3578743336,38
0,1195,33863,3578743298,3578743336,38
0,1195,33864,3578743298,3578743339,41
0,1195,33865,3578743298,3578743339,41
0,1195,33866,3578743298,3578743340,42
0,1195,33867,3578743298,3578743340,42
0,1195,33868,3578743298,3578743340,42
0,1195,33869,3578743298,3578743341,43
0,1195,33870,3578743298,3578743341,43
0,1195,33871,3578743298,3578743341,43
0,1195,33872,3578743298,3578743342,44
0,1195,33873,3578743298,3578743342,44
0,1195,33874,3578743298,3578743343,45
0,1195,33875,3578743298,3578743343,45
0,1195,33876,3578743298,3578743343,45
0,1195,33877,3578743298,3578743343,45
0,1195,33878,3578743298,3578743345,47
0,1195,33879,3578743298,3578743346,48
0,1195,33880,3578743298,3578743346,48
0,1195,33881,3578743298,3578743347,49
0,1196,33882,3578743361,3578743361,0
0,1196,33883,3578743361,3578743361,0
0,1196,33884,3578743361,3578743361,0
0,1196,33885,3578743361,3578743361,0
0,1196,33886,3578743361,3578743361,0
0,1196,33887,3578743361,3578743361,0
0,1196,33888,3578743361,3578743361,0
0,1196,33889,3578743361,3578743361,0
0,1196,33890,3578743361,3578743361,0
0,1196,33891,3578743361,3578743361,0
0,1196,33892,3578743361,3578743361,0
0,1196,33893,3578743361,3578743361,0
0,1196,33894,3578743361,3578743361,0
0,1196,33895,3578743361,3578743361,0
0,1196,33896,3578743361,3578743361,0
0,1196,33897,3578743361,3578743361,0
0,1196,33898,3578743361,3578743361,0
0,1196,33899,3578743361,3578743361,0
0,1196,33900,3578743361,3578743361,0
0,1196,33901,3578743361,3578743361,0
0,1196,33902,3578743361,3578743362,1
0,1196,33903,3578743361,3578743362,1
0,1196,33904,3578743361,3578743362,1
0,1196,33905,3578743361,3578743364,3
0,1196,33906,3578743361,3578743365,4
0,1196,33907,3578743361,3578743368,7
0,1196,33908,3578743361,3578743368,7
0,1196,33909,3578743361,3578743368,7
0,1196,33910,3578743361,3578743368,7
0,1196,33911,3578743361,3578743369,8
0,1196,33912,3578743361,3578743369,8
0,1196,33913,3578743361,3578743370,9
0,1196,33914,3578743361,3578743370,9
0,1196,33915,3578743361,3578743370,9
0,1196,33916,3578743361,3578743371,10
0,1196,33917,3578743361,3578743372,11
0,1196,33918,3578743361,3578743374,13
0,1196,33919,3578743361,3578743374,13
0,1196,33920,3578743361,3578743374,13
0,1196,33921,3578743361,3578743375,14
0,1196,33922,3578743361,3578743376,15
0,1196,33923,3578743361,3578743376,15
0,1196,33924,3578743361,3578743378,17
0,1196,33925,3578743361,3578743378,17
0,1196,33926,3578743361,3578743379,18
0,1196,33927,3578743361,3578743379,18
0,1196,33928,3578743361,3578743380,19
0,1196,33929,3578743361,3578743380,19
0,1196,33930,3578743361,3578743381,20
0,1196,33931,3578743361,3578743382,21
0,1196,33932,3578743361,3578743385,24
0,1196,33933,3578743361,3578743386,25
0,1196,33934,3578743361,3578743388,27
0,1196,33935,3578743361,3578743388,27
0,1196,33936,3578743361,3578743389,28
0,1196,33937,3578743361,3578743389,28
0,1196,33938,3578743361,3578743389,28
0,1196,33939,3578743361,3578743389,28
0,1196,33940,3578743361,3578743389,28
0,1196,33941,3578743361,3578743390,29
0,1196,33942,3578743361,3578743390,29
0,1196,33943,3578743361,3578743391,30
0,1196,33944,3578743361,3578743391,30
0,1196,33945,3578743361,3578743394,33
0,1196,33946,3578743361,3578743394,33
0,1196,33947,3578743361,3578743396,35
0,1196,33948,3578743361,3578743396,35
0,1196,33949,3578743361,3578743396,35
0,1196,33950,3578743361,3578743400,39
0,1196,33951,3578743361,3578743401,40
0,1196,33952,3578743361,3578743402,41
0,1196,33953,3578743361,3578743403,42
0,1196,33954,3578743361,3578743404,43
0,1196,33955,3578743361,3578743404,43
0,1196,33956,3578743361,3578743405,44
0,1196,33957,3578743361,3578743406,45
0,1196,33958,3578743361,3578743406,45
0,1196,33959,3578743361,3578743406,45
0,1196,33960,3578743361,3578743408,47
0,1196,33961,3578743361,3578743408,47
0,1196,33962,3578743361,3578743408,47
0,1196,33963,3578743361,3578743409,48
0,1196,33964,3578743361,3578743410,49
0,1196,33965,3578743361,3578743410,49
0,1197,33966,3578743424,3578743424,0
0,1197,33967,3578743424,3578743424,0
0,1197,33968,3578743424,3578743424,0
0,1197,33969,3578743424,3578743424,0
0,1197,33970,3578743424,3578743424,0
0,1197,33971,3578743424,3578743424,0
0,1197,33972,3578743424,3578743424,0
0,1197,33973,3578743424,3578743424,0
0,1197,33974,3578743424,3578743424,0
0,1197,33975,3578743424,3578743424,0
0,1197,33976,3578743424,3578743424,0
0,1197,33977,3578743424,3578743424,0
0,1197,33978,3578743424,3578743424,0
0,1197,33979,3578743424,3578743424,0
0,1197,33980,3578743424,3578743424,0
0,1197,33981,3578743424,3578743424,0
0,1197,33982,3578743424,3578743424,0
0,1197,33983,3578743424,3578743424,0
0,1197,33984,3578743424,3578743424,0
0,1197,33985,3578743424,3578743424,0
0,1197,33986,3578743424,3578743425,1
0,1197,33987,3578743424,3578743425,1
0,1197,33988,3578743424,3578743426,2
0,1197,33989,3578743424,3578743427,3
0,1197,33990,3578743424,3578743427,3
0,1197,33991,3578743424,3578743429,5
0,1197,33992,3578743424,3578743430,6
0,1197,33993,3578743424,3578743432,8
0,1197,33994,3578743424,3578743432,8
0,1197,33995,3578743424,3578743433,9
0,1197,33996,3578743424,3578743434,10
0,1197,33997,3578743424,3578743434,10
0,1197,33998,3578743424,3578743435,11
0,1197,33999,3578743424,3578743438,14
0,1197,34000,3578743424,3578743438,14
0,1197,34001,3578743424,3578743438,14
0,1197,34002,3578743424,3578743439,15
0,1197,34003,3578743424,3578743440,16
0,1197,34004,3578743424,3578743440,16
0,1197,34005,3578743424,3578743441,17
0,1197,34006,3578743424,3578743441,17
0,1197,34007,3578743424,3578743441,17
0,1197,34008,3578743424,3578743441,17
0,1197,34009,3578743424,3578743443,19
0,1197,34010,3578743424,3578743444,20
0,1197,34011,3578743424,3578743445,21
0,1197,34012,3578743424,3578743445,21
0,1197,34013,3578743424,3578743447,23
0,1197,34014,3578743424,3578743448,24
0,1197,34015,3578743424,3578743449,25
0,1197,34016,3578743424,3578743449,25
0,1197,34017,3578743424,3578743449,25
0,1197,34018,3578743424,3578743450,26
0,1197,34019,3578743424,3578743450,26
0,1197,34020,3578743424,3578743450,26
0,1197,34021,3578743424,3578743450,26
0,1197,34022,3578743424,3578743451,27
0,1197,34023,3578743424,3578743453,29
0,1197,34024,3578743424,3578743455,31
0,1197,34025,3578743424,3578743456,32
0,1197,34026,3578743424,3578743457,33
0,1197,34027,3578743424,3578743457,33
0,1197,34028,3578743424,3578743458,34
0,1197,34029,3578743424,3578743459,35
0,1197,34030,3578743424,3578743460,36
0,1197,34031,3578743424,3578743461,37
0,1197,34032,3578743424,3578743461,37
0,1197,34033,3578743424,3578743462,38
0,1197,34034,3578743424,3578743463,39
0,1197,34035,3578743424,3578743463,39
0,1197,34036,3578743424,3578743463,39
0,1197,34037,3578743424,3578743463,39
0,1197,34038,3578743424,3578743465,41
0,1197,34039,3578743424,3578743465,41
0,1197,34040,3578743424,3578743465,41
0,1197,34041,3578743424,3578743466,42
0,1197,34042,3578743424,3578743467,43
0,1197,34043,3578743424,3578743467,43
0,1198,34044,3578743486,3578743486,0
0,1198,34045,3578743486,3578743486,0
0,1198,34046,3578743486,3578743486,0
0,1198,34047,3578743486,3578743486,0
0,1198,34048,3578743486,3578743486,0
0,1198,34049,3578743486,3578743486,0
0,1198,34050,3578743486,3578743486,0
0,1198,34051,3578743486,3578743486,0
0,1198,34052,3578743486,3578743486,0
0,1198,34053,3578743486,3578743486,0
0,1198,34054,3578743486,3578743486,0
0,1198,34055,3578743486,3578743486,0
0,1198,34056,3578743486,3578743486,0
0,1198,34057,3578743486,3578743486,0
0,1198,34058,3578743486,3578743486,0
0,1198,34059,3578743486,3578743486,0
0,1198,34060,3578743486,3578743486,0
0,1198,34061,3578743486,3578743486,0
0,1198,34062,3578743486,3578743486,0
0,1198,34063,3578743486,3578743487,1
0,1198,34064,3578743486,3578743487,1
0,1198,34065,3578743486,3578743488,2
0,1198,34066,3578743486,3578743489,3
0,1198,34067,3578743486,3578743489,3
0,1198,34068,3578743486,3578743489,3
0,1198,34069,3578743486,3578743490,4
0,1198,34070,3578743486,3578743491,5
0,1198,34071,3578743486,3578743492,6
0,1198,34072,3578743486,3578743492,6
0,1198,34073,3578743486,3578743493,7
0,1198,34074,3578743486,3578743495,9
0,1198,34075,3578743486,3578743497,11
0,1198,34076,3578743486,3578743497,11
0,1198,34077,3578743486,3578743498,12
0,1198,34078,3578743486,3578743499,13
0,1198,34079,3578743486,3578743499,13
0,1198,34080,3578743486,3578743500,14
0,1198,34081,3578743486,3578743501,15
0,1198,34082,3578743486,3578743501,15
0,1198,34083,3578743486,3578743501,15
0,1198,34084,3578743486,3578743503,17
0,1198,34085,3578743486,3578743503,17
0,1198,34086,3578743486,3578743503,17
0,1198,34087,3578743486,3578743504,18
0,1198,34088,3578743486,3578743504,18
0,1198,34089,3578743486,3578743505,19
0,1198,34090,3578743486,3578743505,19
0,1198,34091,3578743486,3578743506,20
0,1198,34092,3578743486,3578743506,20
0,1198,34093,3578743486,3578743506,20
0,1198,34094,3578743486,3578743506,20
0,1198,34095,3578743486,3578743508,22
0,1198,34096,3578743486,3578743508,22
0,1198,34097,3578743486,3578743508,22
0,1198,34098,3578743486,3578743509,23
0,1198,34099,3578743486,3578743509,23
0,1198,34100,3578743486,3578743510,24
0,1198,34101,3578743486,3578743512,26
0,1198,34102,3578743486,3578743515,29
0,1198,34103,3578743486,3578743515,29
0,1198,34104,3578743486,3578743515,29
0,1198,34105,3578743486,3578743515,29
0,1198,34106,3578743486,3578743515,29
0,1198,34107,3578743486,3578743515,29
0,1198,34108,3578743486,3578743515,29
0,1198,34109,3578743486,3578743515,29
0,1198,34110,3578743486,3578743517,31
0,1198,34111,3578743486,3578743517,31
0,1198,34112,3578743486,3578743518,32
0,1198,34113,3578743486,3578743518,32
0,1198,34114,3578743486,3578743519,33
0,1198,34115,3578743486,3578743520,34
0,1198,34116,3578743486,3578743521,35
0,1198,34117,3578743486,3578743522,36
0,1198,34118,3578743486,3578743527,41
0,1198,34119,3578743486,3578743527,41
0,1198,34120,3578743486,3578743528,42
0,1198,34121,3578743486,3578743528,42
0,1198,34122,3578743486,3578743528,42
0,1198,34123,3578743486,3578743528,42
0,1198,34124,3578743486,3578743529,43
0,1198,34125,3578743486,3578743531,45
0,1198,34126,3578743486,3578743531,45
0,1198,34127,3578743486,3578743532,46
0,1198,34128,3578743486,3578743533,47
0,1198,34129,3578743486,3578743533,47
0,1198,34130,3578743486,3578743534,48
0,1198,34131,3578743486,3578743534,48
0,1198,34132,3578743486,3578743534,48
0,1198,34133,3578743486,3578743535,49
0,1198,34134,3578743486,3578743536,50
0,1199,34135,3578743548,3578743548,0
0,1199,34136,3578743548,3578743548,0
0,1199,34137,3578743548,3578743548,0
0,1199,34138,3578743548,3578743548,0
0,1199,34139,3578743548,3578743548,0
0,1199,34140,3578743548,3578743548,0
0,1199,34141,3578743548,3578743548,0
0,1199,34142,3578743548,3578743548,0
0,1199,34143,3578743548,3578743548,0
0,1199,34144,3578743548,3578743548,0
0,1199,34145,3578743548,3578743548,0
0,1199,34146,3578743548,3578743548,0
0,1199,34147,3578743548,3578743548,0
0,1199,34148,3578743548,3578743548,0
0,1199,34149,3578743548,3578743548,0
0,1199,34150,3578743548,3578743548,0
0,1199,34151,3578743548,3578743548,0
0,1199,34152,3578743548,3578743548,0
0,1199,34153,3578743548,3578743548,0
0,1199,34154,3578743548,3578743548,0
0,1199,34155,3578743548,3578743548,0
0,1199,34156,3578743548,3578743548,0
0,1199,34157,3578743548,3578743550,2
0,1199,34158,3578743548,3578743551,3
0,1199,34159,3578743548,3578743552,4
0,1199,34160,3578743548,3578743554,6
0,1199,34161,3578743548,3578743555,7
0,1199,34162,3578743548,3578743555,7
0,1199,34163,3578743548,3578743555,7
0,1199,34164,3578743548,3578743555,7
0,1199,34165,3578743548,3578743557,9
0,1199,34166,3578743548,3578743558,10
0,1199,34167,3578743548,3578743559,11
0,1199,34168,3578743548,3578743560,12
0,1199,34169,3578743548,3578743560,12
0,1199,34170,3578743548,3578743560,12
0,1199,34171,3578743548,3578743560,12
0,1199,34172,3578743548,3578743560,12
0,1199,34173,3578743548,3578743561,13
0,1199,34174,3578743548,3578743561,13
0,1199,34175,3578743548,3578743561,13
0,1199,34176,3578743548,3578743563,15
0,1199,34177,3578743548,3578743565,17
0,1199,34178,3578743548,3578743567,19
0,1199,34179,3578743548,3578743567,19
0,1199,34180,3578743548,3578743568,20
0,1199,34181,3578743548,3578743568,20
0,1199,34182,3578743548,3578743568,20
0,1199,34183,3578743548,3578743568,20
0,1199,34184,3578743548,3578743569,21
0,1199,34185,3578743548,3578743570,22
0,1199,34186,3578743548,3578743570,22
0,1199,34187,3578743548,3578743570,22
0,1199,34188,3578743548,3578743570,22
0,1199,34189,3578743548,3578743572,24
0,1199,34190,3578743548,3578743572,24
0,1199,34191,3578743548,3578743574,26
0,1199,34192,3578743548,3578743575,27
0,1199,34193,3578743548,3578743575,27
0,1199,34194,3578743548,3578743576,28
0,1199,34195,3578743548,3578743578,30
0,1199,34196,3578743548,3578743578,30
0,1199,34197,3578743548,3578743579,31
0,1199,34198,3578743548,3578743579,31
0,1199,34199,3578743548,3578743580,32
0,1199,34200,3578743548,3578743580,32
0,1199,34201,3578743548,3578743581,33
0,1199,34202,3578743548,3578743582,34
0,1199,34203,3578743548,3578743585,37
0,1199,34204,3578743548,3578743585,37
0,1199,34205,3578743548,3578743586,38
0,1199,34206,3578743548,3578743588,40
0,1199,34207,3578743548,3578743588,40
0,1199,34208,3578743548,3578743588,40
0,1199,34209,3578743548,3578743589,41
0,1199,34210,3578743548,3578743590,42
0,1199,34211,3578743548,3578743590,42
0,1199,34212,3578743548,3578743591,43
0,1199,34213,3578743548,3578743593,45
0,1199,34214,3578743548,3578743594,46
0,1199,34215,3578743548,3578743595,47
0,1199,34216,3578743548,3578743595,47
0,1199,34217,3578743548,3578743595,47
0,1200,34218,3578743610,3578743610,0
0,1200,34219,3578743610,3578743610,0
0,1200,34220,3578743610,3578743610,0
0,1200,34221,3578743610,3578743610,0
0,1200,34222,3578743610,3578743610,0
0,1200,34223,3578743610,3578743610,0
0,1200,34224,3578743610,3578743610,0
0,1200,34225,3578743610,3578743610,0
0,1200,34226,3578743610,3578743610,0
0,1200,34227,3578743610,3578743610,0
0,1200,34228,3578743610,3578743610,0
0,1200,34229,3578743610,3578743610,0
0,1200,34230,3578743610,3578743610,0
0,1200,34231,3578743610,3578743610,0
0,1200,34232,3578743610,3578743610,0
0,1200,34233,3578743610,3578743610,0
0,1200,34234,3578743610,3578743610,0
0,1200,34235,3578743610,3578743612,2
0,1200,34236,3578743610,3578743613,3
0,1200,34237,3578743610,3578743613,3
0,1200,34238,3578743610,3578743613,3
0,1200,34239,3578743610,3578743614,4
0,1200,34240,3578743610,3578743614,4
0,1200,34241,3578743610,3578743614,4
0,1200,34242,3578743610,3578743615,5
0,1200,34243,3578743610,3578743615,5
0,1200,34244,3578743610,3578743615,5
0,1200,34245,3578743610,3578743618,8
0,1200,34246,3578743610,3578743618,8
0,1200,34247,3578743610,3578743618,8
0,1200,34248,3578743610,3578743619,9
0,1200,34249,3578743610,3578743619,9
0,1200,34250,3578743610,3578743619,9
0,1200,34251,3578743610,3578743619,9
0,1200,34252,3578743610,3578743620,10
0,1200,34253,3578743610,3578743622,12
0,1200,34254,3578743610,3578743623,13
0,1200,34255,3578743610,3578743623,13
0,1200,34256,3578743610,3578743624,14
0,1200,34257,3578743610,3578743624,14
0,1200,34258,3578743610,3578743625,15
0,1200,34259,3578743610,3578743625,15
0,1200,34260,3578743610,3578743626,16
0,1200,34261,3578743610,3578743628,18
0,1200,34262,3578743610,3578743629,19
0,1200,34263,3578743610,3578743631,21
0,1200,34264,3578743610,3578743631,21
0,1200,34265,3578743610,3578743633,23
0,1200,34266,3578743610,3578743633,23
0,1200,34267,3578743610,3578743634,24
0,1200,34268,3578743610,3578743635,25
0,1200,34269,3578743610,3578743637,27
0,1200,34270,3578743610,3578743638,28
0,1200,34271,3578743610,3578743638,28
0,1200,34272,3578743610,3578743639,29
0,1200,34273,3578743610,3578743639,29
0,1200,34274,3578743610,3578743639,29
0,1200,34275,3578743610,3578743640,30
0,1200,34276,3578743610,3578743641,31
0,1200,34277,3578743610,3578743641,31
0,1200,34278,3578743610,3578743642,32
0,1200,34279,3578743610,3578743643,33
0,1200,34280,3578743610,3578743643,33
0,1200,34281,3578743610,3578743644,34
0,1200,34282,3578743610,3578743646,36
0,1200,34283,3578743610,3578743648,38
0,1200,34284,3578743610,3578743648,38
0,1200,34285,3578743610,3578743648,38
0,1200,34286,3578743610,3578743648,38
0,1200,34287,3578743610,3578743649,39
0,1200,34288,3578743610,3578743649,39
0,1200,34289,3578743610,3578743649,39
0,1200,34290,3578743610,3578743650,40
0,1200,34291,3578743610,3578743650,40
0,1200,34292,3578743610,3578743652,42
0,1200,34293,3578743610,3578743655,45
0,1200,34294,3578743610,3578743655,45
0,1200,34295,3578743610,3578743657,47
0,1200,34296,3578743610,3578743657,47
0,1200,34297,3578743610,3578743659,49
0,1200,34298,3578743610,3578743659,49
0,1200,34299,3578743610,3578743660,50
0,1201,34300,3578743672,3578743672,0
0,1201,34301,3578743672,3578743672,0
0,1201,34302,3578743672,3578743672,0
0,1201,34303,3578743672,3578743672,0
0,1201,34304,3578743672,3578743672,0
0,1201,34305,3578743672,3578743672,0
0,1201,34306,3578743672,3578743672,0
0,1201,34307,3578743672,3578743672,0
0,1201,34308,3578743672,3578743672,0
0,1201,34309,3578743672,3578743672,0
0,1201,34310,3578743672,3578743672,0
0,1201,34311,3578743672,3578743672,0
0,1201,34312,3578743672,3578743675,3
0,1201,34313,3578743672,3578743677,5
0,1201,34314,3578743672,3578743677,5
0,1201,34315,3578743672,3578743678,6
0,1201,34316,3578743672,3578743679,7
0,1201,34317,3578743672,3578743679,7
0,1201,34318,3578743672,3578743680,8
0,1201,34319,3578743672,3578743680,8
0,1201,34320,3578743672,3578743681,9
0,1201,34321,3578743672,3578743681,9
0,1201,34322,3578743672,3578743682,10
0,1201,34323,3578743672,3578743682,10
0,1201,34324,3578743672,3578743683,11
0,1201,34325,3578743672,3578743684,12
0,1201,34326,3578743672,3578743686,14
0,1201,34327,3578743672,3578743686,14
0,1201,34328,3578743672,3578743686,14
0,1201,34329,3578743672,3578743686,14
0,1201,34330,3578743672,3578743686,14
0,1201,34331,3578743672,3578743687,15
0,1201,34332,3578743672,3578743687,15
0,1201,34333,3578743672,3578743688,16
0,1201,34334,3578743672,3578743688,16
0,1201,34335,3578743672,3578743688,16
0,1201,34336,3578743672,3578743689,17
0,1201,34337,3578743672,3578743689,17
0,1201,34338,3578743672,3578743689,17
0,1201,34339,3578743672,3578743690,18
0,1201,34340,3578743672,3578743691,19
0,1201,34341,3578743672,3578743692,20
0,1201,34342,3578743672,3578743693,21
0,1201,34343,3578743672,3578743693,21
0,1201,34344,3578743672,3578743695,23
0,1201,34345,3578743672,3578743697,25
0,1201,34346,3578743672,3578743697,25
0,1201,34347,3578743672,3578743697,25
0,1201,34348,3578743672,3578743699,27
0,1201,34349,3578743672,3578743699,27
0,1201,34350,3578743672,3578743701,29
0,1201,34351,3578743672,3578743701,29
0,1201,34352,3578743672,3578743701,29
0,1201,34353,3578743672,3578743702,30
0,1201,34354,3578743672,3578743702,30
0,1201,34355,3578743672,3578743702,30
0,1201,34356,3578743672,3578743703,31
0,1201,34357,3578743672,3578743704,32
0,1201,34358,3578743672,3578743704,32
0,1201,34359,3578743672,3578743705,33
0,1201,34360,3578743672,3578743706,34
0,1201,34361,3578743672,3578743706,34
0,1201,34362,3578743672,3578743706,34
0,1201,34363,3578743672,3578743706,34
0,1201,34364,3578743672,3578743707,35
0,1201,34365,3578743672,3578743708,36
0,1201,34366,3578743672,3578743708,36
0,1201,34367,3578743672,3578743709,37
0,1201,34368,3578743672,3578743709,37
0,1201,34369,3578743672,3578743710,38
0,1201,34370,3578743672,3578743710,38
0,1201,34371,3578743672,3578743712,40
0,1201,34372,3578743672,3578743714,42
0,1201,34373,3578743672,3578743714,42
0,1201,34374,3578743672,3578743714,42
0,1201,34375,3578743672,3578743715,43
0,1201,34376,3578743672,3578743715,43
0,1201,34377,3578743672,3578743715,43
0,1201,34378,3578743672,3578743716,44
0,1201,34379,3578743672,3578743716,44
0,1201,34380,3578743672,3578743716,44
0,1201,34381,3578743672,3578743716,44
0,1201,34382,3578743672,3578743717,45
0,1201,34383,3578743672,3578743717,45
0,1201,34384,3578743672,3578743718,46
0,1201,34385,3578743672,3578743718,46
0,1201,34386,3578743672,3578743720,48
0,1201,34387,3578743672,3578743720,48
0,1201,34388,3578743672,3578743722,50
0,1202,34389,3578743733,3578743733,0
0,1202,34390,3578743733,3578743733,0
0,1202,34391,3578743733,3578743733,0
0,1202,34392,3578743733,3578743733,0
0,1202,34393,3578743733,3578743733,0
0,1202,34394,3578743733,3578743733,0
0,1202,34395,3578743733,3578743733,0
0,1202,34396,3578743733,3578743733,0
0,1202,34397,3578743733,3578743733,0
0,1202,34398,3578743733,3578743733,0
0,1202,34399,3578743733,3578743733,0
0,1202,34400,3578743733,3578743733,0
0,1202,34401,3578743733,3578743733,0
0,1202,34402,3578743733,3578743733,0
0,1202,34403,3578743733,3578743733,0
0,1202,34404,3578743733,3578743733,0
0,1202,34405,3578743733,3578743733,0
0,1202,34406,3578743733,3578743734,1
0,1202,34407,3578743733,3578743734,1
0,1202,34408,3578743733,3578743736,3
0,1202,34409,3578743733,3578743738,5
0,1202,34410,3578743733,3578743739,6
0,1202,34411,3578743733,3578743739,6
0,1202,34412,3578743733,3578743739,6
0,1202,34413,3578743733,3578743740,7
0,1202,34414,3578743733,3578743740,7
0,1202,34415,3578743733,3578743741,8
0,1202,34416,3578743733,3578743741,8
0,1202,34417,3578743733,3578743742,9
0,1202,34418,3578743733,3578743743,10
0,1202,34419,3578743733,3578743743,10
0,1202,34420,3578743733,3578743743,10
0,1202,34421,3578743733,3578743743,10
0,1202,34422,3578743733,3578743743,10
0,1202,34423,3578743733,3578743744,11
0,1202,34424,3578743733,3578743745,12
0,1202,34425,3578743733,3578743746,13
0,1202,34426,3578743733,3578743747,14
0,1202,34427,3578743733,3578743747,14
0,1202,34428,3578743733,3578743747,14
0,1202,34429,3578743733,3578743747,14
0,1202,34430,3578743733,3578743747,14
0,1202,34431,3578743733,3578743750,17
0,1202,34432,3578743733,3578743751,18
0,1202,34433,3578743733,3578743753,20
0,1202,34434,3578743733,3578743755,22
0,1202,34435,3578743733,3578743755,22
0,1202,34436,3578743733,3578743755,22
0,1202,34437,3578743733,3578743755,22
0,1202,34438,3578743733,3578743756,23
0,1202,34439,3578743733,3578743757,24
0,1202,34440,3578743733,3578743758,25
0,1202,34441,3578743733,3578743759,26
0,1202,34442,3578743733,3578743760,27
0,1202,34443,3578743733,3578743760,27
0,1202,34444,3578743733,3578743760,27
0,1202,34445,3578743733,3578743760,27
0,1202,34446,3578743733,3578743761,28
0,1202,34447,3578743733,3578743761,28
0,1202,34448,3578743733,3578743761,28
0,1202,34449,3578743733,3578743762,29
0,1202,34450,3578743733,3578743763,30
0,1202,34451,3578743733,3578743765,32
0,1202,34452,3578743733,3578743766,33
0,1202,34453,3578743733,3578743767,34
0,1202,34454,3578743733,3578743767,34
0,1202,34455,3578743733,3578743768,35
0,1202,34456,3578743733,3578743768,35
0,1202,34457,3578743733,3578743768,35
0,1202,34458,3578743733,3578743769,36
0,1202,34459,3578743733,3578743769,36
0,1202,34460,3578743733,3578743770,37
0,1202,34461,3578743733,3578743770,37
0,1202,34462,3578743733,3578743770,37
0,1202,34463,3578743733,3578743770,37
0,1202,34464,3578743733,3578743773,40
0,1202,34465,3578743733,3578743773,40
0,1202,34466,3578743733,3578743773,40
0,1202,34467,3578743733,3578743775,42
0,1202,34468,3578743733,3578743776,43
0,1202,34469,3578743733,3578743776,43
0,1202,34470,3578743733,3578743779,46
0,1202,34471,3578743733,3578743779,46
0,1202,34472,3578743733,3578743779,46
0,1202,34473,3578743733,3578743779,46
0,1202,34474,3578743733,3578743779,46
0,1202,34475,3578743733,3578743780,47
0,1202,34476,3578743733,3578743781,48
0,1202,34477,3578743733,3578743781,48
0,1202,34478,3578743733,3578743782,49
0,1203,34479,3578743795,3578743795,0
0,1203,34480,3578743795,3578743795,0
0,1203,34481,3578743795,3578743795,0
0,1203,34482,3578743795,3578743795,0
0,1203,34483,3578743795,3578743795,0
0,1203,34484,3578743795,3578743795,0
0,1203,34485,3578743795,3578743795,0
0,1203,34486,3578743795,3578743795,0
0,1203,34487,3578743795,3578743795,0
0,1203,34488,3578743795,3578743795,0
0,1203,34489,3578743795,3578743795,0
0,1203,34490,3578743795,3578743795,0
0,1203,34491,3578743795,3578743795,0
0,1203,34492,3578743795,3578743795,0
0,1203,34493,3578743795,3578743795,0
0,1203,34494,3578743795,3578743795,0
0,1203,34495,3578743795,3578743795,0
0,1203,34496,3578743795,3578743799,4
0,1203,34497,3578743795,3578743801,6
0,1203,34498,3578743795,3578743801,6
0,1203,34499,3578743795,3578743803,8
0,1203,34500,3578743795,3578743804,9
0,1203,34501,3578743795,3578743804,9
0,1203,34502,3578743795,3578743804,9
0,1203,34503,3578743795,3578743805,10
0,1203,34504,3578743795,3578743805,10
0,1203,34505,3578743795,3578743805,10
0,1203,34506,3578743795,3578743806,11
0,1203,34507,3578743795,3578743806,11
0,1203,34508,3578743795,3578743807,12
0,1203,34509,3578743795,3578743808,13
0,1203,34510,3578743795,3578743808,13
0,1203,34511,3578743795,3578743808,13
0,1203,34512,3578743795,3578743810,15
0,1203,34513,3578743795,3578743810,15
0,1203,34514,3578743795,3578743811,16
0,1203,34515,3578743795,3578743813,18
0,1203,34516,3578743795,3578743813,18
0,1203,34517,3578743795,3578743813,18
0,1203,34518,3578743795,3578743813,18
0,1203,34519,3578743795,3578743814,19
0,1203,34520,3578743795,3578743815,20
0,1203,34521,3578743795,3578743815,20
0,1203,34522,3578743795,3578743815,20
0,1203,34523,3578743795,3578743815,20
0,1203,34524,3578743795,3578743816,21
0,1203,34525,3578743795,3578743818,23
0,1203,34526,3578743795,3578743818,23
0,1203,34527,3578743795,3578743818,23
0,1203,34528,3578743795,3578743819,24
0,1203,34529,3578743795,3578743819,24
0,1203,34530,3578743795,3578743819,24
0,1203,34531,3578743795,3578743821,26
0,1203,34532,3578743795,3578743822,27
0,1203,34533,3578743795,3578743823,28
0,1203,34534,3578743795,3578743823,28
0,1203,34535,3578743795,3578743823,28
0,1203,34536,3578743795,3578743824,29
0,1203,34537,3578743795,3578743825,30
0,1203,34538,3578743795,3578743825,30
0,1203,34539,3578743795,3578743827,32
0,1203,34540,3578743795,3578743829,34
0,1203,34541,3578743795,3578743829,34
0,1203,34542,3578743795,3578743831,36
0,1203,34543,3578743795,3578743832,37
0,1203,34544,3578743795,3578743833,38
0,1203,34545,3578743795,3578743835,40
0,1203,34546,3578743795,3578743836,41
0,1203,34547,3578743795,3578743837,42
0,1203,34548,3578743795,3578743837,42
0,1203,34549,3578743795,3578743838,43
0,1203,34550,3578743795,3578743839,44
0,1203,34551,3578743795,3578743839,44
0,1203,34552,3578743795,3578743840,45
0,1203,34553,3578743795,3578743840,45
0,1203,34554,3578743795,3578743841,46
0,1203,34555,3578743795,3578743841,46
0,1203,34556,3578743795,3578743841,46
0,1203,34557,3578743795,3578743842,47
0,1203,34558,3578743795,3578743843,48
0,1203,34559,3578743795,3578743844,49
0,1203,34560,3578743795,3578743844,49
0,1204,34561,3578743858,3578743858,0
0,1204,34562,3578743858,3578743858,0
0,1204,34563,3578743858,3578743858,0
0,1204,34564,3578743858,3578743858,0
0,1204,34565,3578743858,3578743858,0
0,1204,34566,3578743858,3578743858,0
0,1204,34567,3578743858,3578743858,0
0,1204,34568,3578743858,3578743858,0
0,1204,34569,3578743858,3578743858,0
0,1204,34570,3578743858,3578743858,0
0,1204,34571,3578743858,3578743858,0
0,1204,34572,3578743858,3578743858,0
0,1204,34573,3578743858,3578743858,0
0,1204,34574,3578743858,3578743858,0
0,1204,34575,3578743858,3578743858,0
0,1204,34576,3578743858,3578743859,1
0,1204,34577,3578743858,3578743860,2
0,1204,34578,3578743858,3578743861,3
0,1204,34579,3578743858,3578743861,3
0,1204,34580,3578743858,3578743862,4
0,1204,34581,3578743858,3578743862,4
0,1204,34582,3578743858,3578743862,4
0,1204,34583,3578743858,3578743863,5
0,1204,34584,3578743858,3578743863,5
0,1204,34585,3578743858,3578743863,5
0,1204,34586,3578743858,3578743864,6
0,1204,34587,3578743858,3578743865,7
0,1204,34588,3578743858,3578743865,7
0,1204,34589,3578743858,3578743866,8
0,1204,34590,3578743858,3578743866,8
0,1204,34591,3578743858,3578743867,9
0,1204,34592,3578743858,3578743875,17
0,1204,34593,3578743858,3578743877,19
0,1204,34594,3578743858,3578743877,19
0,1204,34595,3578743858,3578743878,20
0,1204,34596,3578743858,3578743879,21
0,1204,34597,3578743858,3578743879,21
0,1204,34598,3578743858,3578743879,21
0,1204,34599,3578743858,3578743880,22
0,1204,34600,3578743858,3578743881,23
0,1204,34601,3578743858,3578743882,24
0,1204,34602,3578743858,3578743882,24
0,1204,34603,3578743858,3578743883,25
0,1204,34604,3578743858,3578743885,27
0,1204,34605,3578743858,3578743885,27
0,1204,34606,3578743858,3578743885,27
0,1204,34607,3578743858,3578743886,28
0,1204,34608,3578743858,3578743886,28
0,1204,34609,3578743858,3578743886,28
0,1204,34610,3578743858,3578743886,28
0,1204,34611,3578743858,3578743887,29
0,1204,34612,3578743858,3578743887,29
0,1204,34613,3578743858,3578743887,29
0,1204,34614,3578743858,3578743888,30
0,1204,34615,3578743858,3578743888,30
0,1204,34616,3578743858,3578743889,31
0,1204,34617,3578743858,3578743889,31
0,1204,34618,3578743858,3578743889,31
0,1204,34619,3578743858,3578743890,32
0,1204,34620,3578743858,3578743890,32
0,1204,34621,3578743858,3578743892,34
0,1204,34622,3578743858,3578743892,34
0,1204,34623,3578743858,3578743892,34
0,1204,34624,3578743858,3578743893,35
0,1204,34625,3578743858,3578743895,37
0,1204,34626,3578743858,3578743897,39
0,1204,34627,3578743858,3578743898,40
0,1204,34628,3578743858,3578743899,41
0,1204,34629,3578743858,3578743899,41
0,1204,34630,3578743858,3578743901,43
0,1204,34631,3578743858,3578743901,43
0,1204,34632,3578743858,3578743901,43
0,1204,34633,3578743858,3578743902,44
0,1204,34634,3578743858,3578743902,44
0,1204,34635,3578743858,3578743902,44
0,1204,34636,3578743858,3578743903,45
0,1204,34637,3578743858,3578743903,45
0,1204,34638,3578743858,3578743905,47
0,1204,34639,3578743858,3578743905,47
0,1204,34640,3578743858,3578743906,48
0,1204,34641,3578743858,3578743906,48
0,1204,34642,3578743858,3578743907,49
0,1204,34643,3578743858,3578743907,49
0,1204,34644,3578743858,3578743907,49
0,1205,34645,3578743919,3578743919,0
0,1205,34646,3578743919,3578743919,0
0,1205,34647,3578743919,3578743919,0
0,1205,34648,3578743919,3578743919,0
0,1205,34649,3578743919,3578743919,0
0,1205,34650,3578743919,3578743919,0
0,1205,34651,3578743919,3578743919,0
0,1205,34652,3578743919,3578743919,0
0,1205,34653,3578743919,3578743919,0
0,1205,34654,3578743919,3578743919,0
0,1205,34655,3578743919,3578743919,0
0,1205,34656,3578743919,3578743919,0
0,1205,34657,3578743919,3578743919,0
0,1205,34658,3578743919,3578743919,0
0,1205,34659,3578743919,3578743919,0
0,1205,34660,3578743919,3578743919,0
0,1205,34661,3578743919,3578743919,0
0,1205,34662,3578743919,3578743919,0
0,1205,34663,3578743919,3578743919,0
0,1205,34664,3578743919,3578743919,0
0,1205,34665,3578743919,3578743919,0
0,1205,34666,3578743919,3578743920,1
0,1205,34667,3578743919,3578743922,3
0,1205,34668,3578743919,3578743922,3
0,1205,34669,3578743919,3578743923,4
0,1205,34670,3578743919,3578743928,9
0,1205,34671,3578743919,3578743928,9
0,1205,34672,3578743919,3578743928,9
0,1205,34673,3578743919,3578743928,9
0,1205,34674,3578743919,3578743929,10
0,1205,34675,3578743919,3578743929,10
0,1205,34676,3578743919,3578743930,11
0,1205,34677,3578743919,3578743930,11
0,1205,34678,3578743919,3578743931,12
0,1205,34679,3578743919,3578743931,12
0,1205,34680,3578743919,3578743931,12
0,1205,34681,3578743919,3578743932,13
0,1205,34682,3578743919,3578743933,14
0,1205,34683,3578743919,3578743933,14
0,1205,34684,3578743919,3578743933,14
0,1205,34685,3578743919,3578743933,14
0,1205,34686,3578743919,3578743934,15
0,1205,34687,3578743919,3578743934,15
0,1205,34688,3578743919,3578743936,17
0,1205,34689,3578743919,3578743938,19
0,1205,34690,3578743919,3578743938,19
0,1205,34691,3578743919,3578743939,20
0,1205,34692,3578743919,3578743940,21
0,1205,34693,3578743919,3578743940,21
0,1205,34694,3578743919,3578743941,22
0,1205,34695,3578743919,3578743942,23
0,1205,34696,3578743919,3578743942,23
0,1205,34697,3578743919,3578743943,24
0,1205,34698,3578743919,3578743943,24
0,1205,34699,3578743919,3578743944,25
0,1205,34700,3578743919,3578743944,25
0,1205,34701,3578743919,3578743945,26
0,1205,34702,3578743919,3578743945,26
0,1205,34703,3578743919,3578743946,27
0,1205,34704,3578743919,3578743947,28
0,1205,34705,3578743919,3578743947,28
0,1205,34706,3578743919,3578743947,28
0,1205,34707,3578743919,3578743948,29
0,1205,34708,3578743919,3578743948,29
0,1205,34709,3578743919,3578743950,31
0,1205,34710,3578743919,3578743950,31
0,1205,34711,3578743919,3578743953,34
0,1205,34712,3578743919,3578743955,36
0,1205,34713,3578743919,3578743955,36
0,1205,34714,3578743919,3578743955,36
0,1205,34715,3578743919,3578743956,37
0,1205,34716,3578743919,3578743958,39
0,1205,34717,3578743919,3578743958,39
0,1205,34718,3578743919,3578743958,39
0,1205,34719,3578743919,3578743959,40
0,1205,34720,3578743919,3578743960,41
0,1205,34721,3578743919,3578743961,42
0,1205,34722,3578743919,3578743961,42
0,1205,34723,3578743919,3578743962,43
0,1205,34724,3578743919,3578743962,43
0,1205,34725,3578743919,3578743962,43
0,1205,34726,3578743919,3578743964,45
0,1205,34727,3578743919,3578743964,45
0,1205,34728,3578743919,3578743965,46
0,1205,34729,3578743919,3578743965,46
0,1205,34730,3578743919,3578743967,48
0,1205,34731,3578743919,3578743967,48
0,1205,34732,3578743919,3578743968,49
0,1205,34733,3578743919,3578743968,49
0,1205,34734,3578743919,3578743968,49
0,1205,34735,3578743919,3578743969,50
0,1206,34736,3578743981,3578743981,0
0,1206,34737,3578743981,3578743981,0
0,1206,34738,3578743981,3578743981,0
0,1206,34739,3578743981,3578743981,0
0,1206,34740,3578743981,3578743981,0
0,1206,34741,3578743981,3578743981,0
0,1206,34742,3578743981,3578743981,0
0,1206,34743,3578743981,3578743981,0
0,1206,34744,3578743981,3578743981,0
0,1206,34745,3578743981,3578743981,0
0,1206,34746,3578743981,3578743981,0
0,1206,34747,3578743981,3578743981,0
0,1206,34748,3578743981,3578743981,0
0,1206,34749,3578743981,3578743981,0
0,1206,34750,3578743981,3578743981,0
0,1206,34751,3578743981,3578743981,0
0,1206,34752,3578743981,3578743981,0
0,1206,34753,3578743981,3578743981,0
0,1206,34754,3578743981,3578743981,0
0,1206,34755,3578743981,3578743981,0
0,1206,34756,3578743981,3578743982,1
0,1206,34757,3578743981,3578743985,4
0,1206,34758,3578743981,3578743986,5
0,1206,34759,3578743981,3578743986,5
0,1206,34760,3578743981,3578743987,6
0,1206,34761,3578743981,3578743988,7
0,1206,34762,3578743981,3578743988,7
0,1206,34763,3578743981,3578743988,7
0,1206,34764,3578743981,3578743988,7
0,1206,34765,3578743981,3578743989,8
0,1206,34766,3578743981,3578743990,9
0,1206,34767,3578743981,3578743990,9
0,1206,34768,3578743981,3578743990,9
0,1206,34769,3578743981,3578743991,10
0,1206,34770,3578743981,3578743992,11
0,1206,34771,3578743981,3578743993,12
0,1206,34772,3578743981,3578743993,12
0,1206,34773,3578743981,3578743995,14
0,1206,34774,3578743981,3578743995,14
0,1206,34775,3578743981,3578743995,14
0,1206,34776,3578743981,3578744000,19
0,1206,34777,3578743981,3578744001,20
0,1206,34778,3578743981,3578744001,20
0,1206,34779,3578743981,3578744002,21
0,1206,34780,3578743981,3578744003,22
0,1206,34781,3578743981,3578744004,23
0,1206,34782,3578743981,3578744004,23
0,1206,34783,3578743981,3578744005,24
0,1206,34784,3578743981,3578744005,24
0,1206,34785,3578743981,3578744005,24
0,1206,34786,3578743981,3578744006,25
0,1206,34787,3578743981,3578744006,25
0,1206,34788,3578743981,3578744006,25
0,1206,34789,3578743981,3578744007,26
0,1206,34790,3578743981,3578744008,27
0,1206,34791,3578743981,3578744008,27
0,1206,34792,3578743981,3578744009,28
0,1206,34793,3578743981,3578744009,28
0,1206,34794,3578743981,3578744010,29
0,1206,34795,3578743981,3578744012,31
0,1206,34796,3578743981,3578744012,31
0,1206,34797,3578743981,3578744012,31
0,1206,34798,3578743981,3578744014,33
0,1206,34799,3578743981,3578744015,34
0,1206,34800,3578743981,3578744015,34
0,1206,34801,3578743981,3578744015,34
0,1206,34802,3578743981,3578744015,34
0,1206,34803,3578743981,3578744016,35
0,1206,34804,3578743981,3578744016,35
0,1206,34805,3578743981,3578744017,36
0,1206,34806,3578743981,3578744019,38
0,1206,34807,3578743981,3578744019,38
0,1206,34808,3578743981,3578744019,38
0,1206,34809,3578743981,3578744019,38
0,1206,34810,3578743981,3578744020,39
0,1206,34811,3578743981,3578744022,41
0,1206,34812,3578743981,3578744023,42
0,1206,34813,3578743981,3578744024,43
0,1206,34814,3578743981,3578744024,43
0,1206,34815,3578743981,3578744024,43
0,1206,34816,3578743981,3578744025,44
0,1206,34817,3578743981,3578744025,44
0,1206,34818,3578743981,3578744026,45
0,1206,34819,3578743981,3578744029,48
0,1206,34820,3578743981,3578744030,49
0,1207,34821,3578744043,3578744043,0
0,1207,34822,3578744043,3578744043,0
0,1207,34823,3578744043,3578744043,0
0,1207,34824,3578744043,3578744043,0
0,1207,34825,3578744043,3578744043,0
0,1207,34826,3578744043,3578744043,0
0,1207,34827,3578744043,3578744043,0
0,1207,34828,3578744043,3578744043,0
0,1207,34829,3578744043,3578744043,0
0,1207,34830,3578744043,3578744043,0
0,1207,34831,3578744043,3578744043,0
0,1207,34832,3578744043,3578744043,0
0,1207,34833,3578744043,3578744043,0
0,1207,34834,3578744043,3578744043,0
0,1207,34835,3578744043,3578744043,0
0,1207,34836,3578744043,3578744043,0
0,1207,34837,3578744043,3578744043,0
0,1207,34838,3578744043,3578744045,2
0,1207,34839,3578744043,3578744047,4
0,1207,34840,3578744043,3578744048,5
0,1207,34841,3578744043,3578744049,6
0,1207,34842,3578744043,3578744049,6
0,1207,34843,3578744043,3578744049,6
0,1207,34844,3578744043,3578744049,6
0,1207,34845,3578744043,3578744050,7
0,1207,34846,3578744043,3578744051,8
0,1207,34847,3578744043,3578744052,9
0,1207,34848,3578744043,3578744052,9
0,1207,34849,3578744043,3578744055,12
0,1207,34850,3578744043,3578744057,14
0,1207,34851,3578744043,3578744057,14
0,1207,34852,3578744043,3578744057,14
0,1207,34853,3578744043,3578744059,16
0,1207,34854,3578744043,3578744060,17
0,1207,34855,3578744043,3578744061,18
0,1207,34856,3578744043,3578744062,19
0,1207,34857,3578744043,3578744062,19
0,1207,34858,3578744043,3578744062,19
0,1207,34859,3578744043,3578744062,19
0,1207,34860,3578744043,3578744063,20
0,1207,34861,3578744043,3578744063,20
0,1207,34862,3578744043,3578744063,20
0,1207,34863,3578744043,3578744065,22
0,1207,34864,3578744043,3578744065,22
0,1207,34865,3578744043,3578744065,22
0,1207,34866,3578744043,3578744066,23
0,1207,34867,3578744043,3578744066,23
0,1207,34868,3578744043,3578744067,24
0,1207,34869,3578744043,3578744076,33
0,1207,34870,3578744043,3578744077,34
0,1207,34871,3578744043,3578744078,35
0,1207,34872,3578744043,3578744078,35
0,1207,34873,3578744043,3578744079,36
0,1207,34874,3578744043,3578744080,37
0,1207,34875,3578744043,3578744080,37
0,1207,34876,3578744043,3578744080,37
0,1207,34877,3578744043,3578744081,38
0,1207,34878,3578744043,3578744082,39
0,1207,34879,3578744043,3578744082,39
0,1207,34880,3578744043,3578744082,39
0,1207,34881,3578744043,3578744083,40
0,1207,34882,3578744043,3578744084,41
0,1207,34883,3578744043,3578744085,42
0,1207,34884,3578744043,3578744086,43
0,1207,34885,3578744043,3578744086,43
0,1207,34886,3578744043,3578744087,44
0,1207,34887,3578744043,3578744087,44
0,1207,34888,3578744043,3578744087,44
0,1207,34889,3578744043,3578744087,44
0,1207,34890,3578744043,3578744088,45
0,1207,34891,3578744043,3578744088,45
0,1207,34892,3578744043,3578744088,45
0,1207,34893,3578744043,3578744089,46
0,1207,34894,3578744043,3578744089,46
0,1207,34895,3578744043,3578744089,46
0,1207,34896,3578744043,3578744089,46
0,1207,34897,3578744043,3578744090,47
0,1207,34898,3578744043,3578744092,49
0,1208,34899,3578744106,3578744106,0
0,1208,34900,3578744106,3578744106,0
0,1208,34901,3578744106,3578744106,0
0,1208,34902,3578744106,3578744106,0
0,1208,34903,3578744106,3578744106,0
0,1208,34904,3578744106,3578744106,0
0,1208,34905,3578744106,3578744106,0
0,1208,34906,3578744106,3578744106,0
0,1208,34907,3578744106,3578744106,0
0,1208,34908,3578744106,3578744106,0
0,1208,34909,3578744106,3578744106,0
0,1208,34910,3578744106,3578744106,0
0,1208,34911,3578744106,3578744106,0
0,1208,34912,3578744106,3578744106,0
0,1208,34913,3578744106,3578744106,0
0,1208,34914,3578744106,3578744106,0
0,1208,34915,3578744106,3578744106,0
0,1208,34916,3578744106,3578744106,0
0,1208,34917,3578744106,3578744106,0
0,1208,34918,3578744106,3578744106,0
0,1208,34919,3578744106,3578744107,1
0,1208,34920,3578744106,3578744107,1
0,1208,34921,3578744106,3578744108,2
0,1208,34922,3578744106,3578744108,2
0,1208,34923,3578744106,3578744109,3
0,1208,34924,3578744106,3578744109,3
0,1208,34925,3578744106,3578744110,4
0,1208,34926,3578744106,3578744110,4
0,1208,34927,3578744106,3578744112,6
0,1208,34928,3578744106,3578744114,8
0,1208,34929,3578744106,3578744115,9
0,1208,34930,3578744106,3578744115,9
0,1208,34931,3578744106,3578744115,9
0,1208,34932,3578744106,3578744115,9
0,1208,34933,3578744106,3578744116,10
0,1208,34934,3578744106,3578744116,10
0,1208,34935,3578744106,3578744116,10
0,1208,34936,3578744106,3578744116,10
0,1208,34937,3578744106,3578744116,10
0,1208,34938,3578744106,3578744117,11
0,1208,34939,3578744106,3578744117,11
0,1208,34940,3578744106,3578744118,12
0,1208,34941,3578744106,3578744119,13
0,1208,34942,3578744106,3578744120,14
0,1208,34943,3578744106,3578744120,14
0,1208,34944,3578744106,3578744122,16
0,1208,34945,3578744106,3578744122,16
0,1208,34946,3578744106,3578744122,16
0,1208,34947,3578744106,3578744128,22
0,1208,34948,3578744106,3578744128,22
0,1208,34949,3578744106,3578744128,22
0,1208,34950,3578744106,3578744128,22
0,1208,34951,3578744106,3578744129,23
0,1208,34952,3578744106,3578744129,23
0,1208,34953,3578744106,3578744129,23
0,1208,34954,3578744106,3578744130,24
0,1208,34955,3578744106,3578744130,24
0,1208,34956,3578744106,3578744131,25
0,1208,34957,3578744106,3578744131,25
0,1208,34958,3578744106,3578744132,26
0,1208,34959,3578744106,3578744132,26
0,1208,34960,3578744106,3578744133,27
0,1208,34961,3578744106,3578744133,27
0,1208,34962,3578744106,3578744134,28
0,1208,34963,3578744106,3578744134,28
0,1208,34964,3578744106,3578744134,28
0,1208,34965,3578744106,3578744135,29
0,1208,34966,3578744106,3578744138,32
0,1208,34967,3578744106,3578744139,33
0,1208,34968,3578744106,3578744140,34
0,1208,34969,3578744106,3578744140,34
0,1208,34970,3578744106,3578744140,34
0,1208,34971,3578744106,3578744141,35
0,1208,34972,3578744106,3578744141,35
0,1208,34973,3578744106,3578744142,36
0,1208,34974,3578744106,3578744142,36
0,1208,34975,3578744106,3578744142,36
0,1208,34976,3578744106,3578744144,38
0,1208,34977,3578744106,3578744144,38
0,1208,34978,3578744106,3578744144,38
0,1208,34979,3578744106,3578744145,39
0,1208,34980,3578744106,3578744146,40
0,1208,34981,3578744106,3578744147,41
0,1208,34982,3578744106,3578744147,41
0,1208,34983,3578744106,3578744147,41
0,1208,34984,3578744106,3578744147,41
0,1208,34985,3578744106,3578744148,42
0,1208,34986,3578744106,3578744151,45
0,1208,34987,3578744106,3578744152,46
0,1208,34988,3578744106,3578744153,47
0,1208,34989,3578744106,3578744155,49
0,1208,34990,3578744106,3578744155,49
0,1208,34991,3578744106,3578744155,49
0,1208,34992,3578744106,3578744155,49
0,1208,34993,3578744106,3578744156,50
0,1209,34994,3578744169,3578744169,0
0,1209,34995,3578744169,3578744169,0
0,1209,34996,3578744169,3578744169,0
0,1209,34997,3578744169,3578744169,0
0,1209,34998,3578744169,3578744169,0
0,1209,34999,3578744169,3578744169,0
0,1209,35000,3578744169,3578744169,0
0,1209,35001,3578744169,3578744169,0
0,1209,35002,3578744169,3578744169,0
0,1209,35003,3578744169,3578744169,0
0,1209,35004,3578744169,3578744169,0
0,1209,35005,3578744169,3578744169,0
0,1209,35006,3578744169,3578744169,0
0,1209,35007,3578744169,3578744169,0
0,1209,35008,3578744169,3578744169,0
0,1209,35009,3578744169,3578744169,0
0,1209,35010,3578744169,3578744169,0
0,1209,35011,3578744169,3578744169,0
0,1209,35012,3578744169,3578744169,0
0,1209,35013,3578744169,3578744169,0
0,1209,35014,3578744169,3578744170,1
0,1209,35015,3578744169,3578744170,1
0,1209,35016,3578744169,3578744171,2
0,1209,35017,3578744169,3578744171,2
0,1209,35018,3578744169,3578744173,4
0,1209,35019,3578744169,3578744173,4
0,1209,35020,3578744169,3578744173,4
0,1209,35021,3578744169,3578744174,5
0,1209,35022,3578744169,3578744176,7
0,1209,35023,3578744169,3578744176,7
0,1209,35024,3578744169,3578744176,7
0,1209,35025,3578744169,3578744179,10
0,1209,35026,3578744169,3578744179,10
0,1209,35027,3578744169,3578744180,11
0,1209,35028,3578744169,3578744180,11
0,1209,35029,3578744169,3578744180,11
0,1209,35030,3578744169,3578744181,12
0,1209,35031,3578744169,3578744182,13
0,1209,35032,3578744169,3578744182,13
0,1209,35033,3578744169,3578744185,16
0,1209,35034,3578744169,3578744186,17
0,1209,35035,3578744169,3578744186,17
0,1209,35036,3578744169,3578744187,18
0,1209,35037,3578744169,3578744188,19
0,1209,35038,3578744169,3578744188,19
0,1209,35039,3578744169,3578744189,20
0,1209,35040,3578744169,3578744189,20
0,1209,35041,3578744169,3578744189,20
0,1209,35042,3578744169,3578744190,21
0,1209,35043,3578744169,3578744190,21
0,1209,35044,3578744169,3578744191,22
0,1209,35045,3578744169,3578744191,22
0,1209,35046,3578744169,3578744194,25
0,1209,35047,3578744169,3578744195,26
0,1209,35048,3578744169,3578744195,26
0,1209,35049,3578744169,3578744195,26
0,1209,35050,3578744169,3578744199,30
0,1209,35051,3578744169,3578744201,32
0,1209,35052,3578744169,3578744201,32
0,1209,35053,3578744169,3578744201,32
0,1209,35054,3578744169,3578744204,35
0,1209,35055,3578744169,3578744204,35
0,1209,35056,3578744169,3578744204,35
0,1209,35057,3578744169,3578744205,36
0,1209,35058,3578744169,3578744205,36
0,1209,35059,3578744169,3578744205,36
0,1209,35060,3578744169,3578744206,37
0,1209,35061,3578744169,3578744206,37
0,1209,35062,3578744169,3578744207,38
0,1209,35063,3578744169,3578744207,38
0,1209,35064,3578744169,3578744209,40
0,1209,35065,3578744169,3578744210,41
0,1209,35066,3578744169,3578744210,41
0,1209,35067,3578744169,3578744210,41
0,1209,35068,3578744169,3578744212,43
0,1209,35069,3578744169,3578744212,43
0,1209,35070,3578744169,3578744213,44
0,1209,35071,3578744169,3578744214,45
0,1209,35072,3578744169,3578744215,46
0,1209,35073,3578744169,3578744215,46
0,1209,35074,3578744169,3578744215,46
0,1209,35075,3578744169,3578744216,47
0,1209,35076,3578744169,3578744216,47
0,1209,35077,3578744169,3578744216,47
0,1209,35078,3578744169,3578744218,49
0,1209,35079,3578744169,3578744219,50
0,1210,35080,3578744231,3578744231,0
0,1210,35081,3578744231,3578744231,0
0,1210,35082,3578744231,3578744231,0
0,1210,35083,3578744231,3578744231,0
0,1210,35084,3578744231,3578744231,0
0,1210,35085,3578744231,3578744231,0
0,1210,35086,3578744231,3578744231,0
0,1210,35087,3578744231,3578744231,0
0,1210,35088,3578744231,3578744231,0
0,1210,35089,3578744231,3578744231,0
0,1210,35090,3578744231,3578744231,0
0,1210,35091,3578744231,3578744231,0
0,1210,35092,3578744231,3578744231,0
0,1210,35093,3578744231,3578744231,0
0,1210,35094,3578744231,3578744231,0
0,1210,35095,3578744231,3578744233,2
0,1210,35096,3578744231,3578744233,2
0,1210,35097,3578744231,3578744234,3
0,1210,35098,3578744231,3578744235,4
0,1210,35099,3578744231,3578744236,5
0,1210,35100,3578744231,3578744237,6
0,1210,35101,3578744231,3578744238,7
0,1210,35102,3578744231,3578744238,7
0,1210,35103,3578744231,3578744239,8
0,1210,35104,3578744231,3578744240,9
0,1210,35105,3578744231,3578744241,10
0,1210,35106,3578744231,3578744241,10
0,1210,35107,3578744231,3578744241,10
0,1210,35108,3578744231,3578744241,10
0,1210,35109,3578744231,3578744242,11
0,1210,35110,3578744231,3578744243,12
0,1210,35111,3578744231,3578744245,14
0,1210,35112,3578744231,3578744248,17
0,1210,35113,3578744231,3578744249,18
0,1210,35114,3578744231,3578744249,18
0,1210,35115,3578744231,3578744249,18
0,1210,35116,3578744231,3578744249,18
0,1210,35117,3578744231,3578744250,19
0,1210,35118,3578744231,3578744250,19
0,1210,35119,3578744231,3578744251,20
0,1210,35120,3578744231,3578744251,20
0,1210,35121,3578744231,3578744253,22
0,1210,35122,3578744231,3578744255,24
0,1210,35123,3578744231,3578744257,26
0,1210,35124,3578744231,3578744257,26
0,1210,35125,3578744231,3578744257,26
0,1210,35126,3578744231,3578744258,27
0,1210,35127,3578744231,3578744258,27
0,1210,35128,3578744231,3578744259,28
0,1210,35129,3578744231,3578744259,28
0,1210,35130,3578744231,3578744261,30
0,1210,35131,3578744231,3578744261,30
0,1210,35132,3578744231,3578744262,31
0,1210,35133,3578744231,3578744262,31
0,1210,35134,3578744231,3578744262,31
0,1210,35135,3578744231,3578744263,32
0,1210,35136,3578744231,3578744264,33
0,1210,35137,3578744231,3578744264,33
0,1210,35138,3578744231,3578744264,33
0,1210,35139,3578744231,3578744265,34
0,1210,35140,3578744231,3578744265,34
0,1210,35141,3578744231,3578744267,36
0,1210,35142,3578744231,3578744267,36
0,1210,35143,3578744231,3578744268,37
0,1210,35144,3578744231,3578744276,45
0,1210,35145,3578744231,3578744277,46
0,1210,35146,3578744231,3578744278,47
0,1210,35147,3578744231,3578744278,47
0,1210,35148,3578744231,3578744279,48
0,1210,35149,3578744231,3578744280,49
0,1210,35150,3578744231,3578744280,49
0,1210,35151,3578744231,3578744281,50
0,1211,35152,3578744292,3578744292,0
0,1211,35153,3578744292,3578744292,0
0,1211,35154,3578744292,3578744292,0
0,1211,35155,3578744292,3578744292,0
0,1211,35156,3578744292,3578744292,0
0,1211,35157,3578744292,3578744292,0
0,1211,35158,3578744292,3578744292,0
0,1211,35159,3578744292,3578744292,0
0,1211,35160,3578744292,3578744292,0
0,1211,35161,3578744292,3578744292,0
0,1211,35162,3578744292,3578744292,0
0,1211,35163,3578744292,3578744292,0
0,1211,35164,3578744292,3578744292,0
0,1211,35165,3578744292,3578744292,0
0,1211,35166,3578744292,3578744292,0
0,1211,35167,3578744292,3578744292,0
0,1211,35168,3578744292,3578744292,0
0,1211,35169,3578744292,3578744292,0
0,1211,35170,3578744292,3578744292,0
0,1211,35171,3578744292,3578744293,1
0,1211,35172,3578744292,3578744293,1
0,1211,35173,3578744292,3578744295,3
0,1211,35174,3578744292,3578744298,6
0,1211,35175,3578744292,3578744299,7
0,1211,35176,3578744292,3578744299,7
0,1211,35177,3578744292,3578744301,9
0,1211,35178,3578744292,3578744302,10
0,1211,35179,3578744292,3578744302,10
0,1211,35180,3578744292,3578744302,10
0,1211,35181,3578744292,3578744302,10
0,1211,35182,3578744292,3578744303,11
0,1211,35183,3578744292,3578744304,12
0,1211,35184,3578744292,3578744304,12
0,1211,35185,3578744292,3578744305,13
0,1211,35186,3578744292,3578744305,13
0,1211,35187,3578744292,3578744306,14
0,1211,35188,3578744292,3578744306,14
0,1211,35189,3578744292,3578744307,15
0,1211,35190,3578744292,3578744307,15
0,1211,35191,3578744292,3578744308,16
0,1211,35192,3578744292,3578744308,16
0,1211,35193,3578744292,3578744309,17
0,1211,35194,3578744292,3578744310,18
0,1211,35195,3578744292,3578744310,18
0,1211,35196,3578744292,3578744310,18
0,1211,35197,3578744292,3578744312,20
0,1211,35198,3578744292,3578744315,23
0,1211,35199,3578744292,3578744315,23
0,1211,35200,3578744292,3578744315,23
0,1211,35201,3578744292,3578744315,23
0,1211,35202,3578744292,3578744316,24
0,1211,35203,3578744292,3578744316,24
0,1211,35204,3578744292,3578744316,24
0,1211,35205,3578744292,3578744316,24
0,1211,35206,3578744292,3578744316,24
0,1211,35207,3578744292,3578744317,25
0,1211,35208,3578744292,3578744317,25
0,1211,35209,3578744292,3578744319,27
0,1211,35210,3578744292,3578744319,27
0,1211,35211,3578744292,3578744319,27
0,1211,35212,3578744292,3578744320,28
0,1211,35213,3578744292,3578744322,30
0,1211,35214,3578744292,3578744323,31
0,1211,35215,3578744292,3578744323,31
0,1211,35216,3578744292,3578744328,36
0,1211,35217,3578744292,3578744328,36
0,1211,35218,3578744292,3578744328,36
0,1211,35219,3578744292,3578744328,36
0,1211,35220,3578744292,3578744328,36
0,1211,35221,3578744292,3578744329,37
0,1211,35222,3578744292,3578744329,37
0,1211,35223,3578744292,3578744329,37
0,1211,35224,3578744292,3578744330,38
0,1211,35225,3578744292,3578744331,39
0,1211,35226,3578744292,3578744331,39
0,1211,35227,3578744292,3578744332,40
0,1211,35228,3578744292,3578744332,40
0,1211,35229,3578744292,3578744333,41
0,1211,35230,3578744292,3578744333,41
0,1211,35231,3578744292,3578744333,41
0,1211,35232,3578744292,3578744334,42
0,1211,35233,3578744292,3578744334,42
0,1211,35234,3578744292,3578744335,43
0,1211,35235,3578744292,3578744336,44
0,1211,35236,3578744292,3578744336,44
0,1211,35237,3578744292,3578744338,46
0,1211,35238,3578744292,3578744339,47
0,1211,35239,3578744292,3578744339,47
0,1211,35240,3578744292,3578744340,48
0,1211,35241,3578744292,3578744340,48
0,1211,35242,3578744292,3578744340,48
0,1211,35243,3578744292,3578744341,49
0,1212,35244,3578744354,3578744354,0
0,1212,35245,3578744354,3578744354,0
0,1212,35246,3578744354,3578744354,0
0,1212,35247,3578744354,3578744354,0
0,1212,35248,3578744354,3578744354,0
0,1212,35249,3578744354,3578744354,0
0,1212,35250,3578744354,3578744354,0
0,1212,35251,3578744354,3578744354,0
0,1212,35252,3578744354,3578744354,0
0,1212,35253,3578744354,3578744354,0
0,1212,35254,3578744354,3578744354,0
0,1212,35255,3578744354,3578744354,0
0,1212,35256,3578744354,3578744354,0
0,1212,35257,3578744354,3578744354,0
0,1212,35258,3578744354,3578744354,0
0,1212,35259,3578744354,3578744354,0
0,1212,35260,3578744354,3578744355,1
0,1212,35261,3578744354,3578744355,1
0,1212,35262,3578744354,3578744355,1
0,1212,35263,3578744354,3578744356,2
0,1212,35264,3578744354,3578744356,2
0,1212,35265,3578744354,3578744358,4
0,1212,35266,3578744354,3578744358,4
0,1212,35267,3578744354,3578744358,4
0,1212,35268,3578744354,3578744359,5
0,1212,35269,3578744354,3578744360,6
0,1212,35270,3578744354,3578744360,6
0,1212,35271,3578744354,3578744361,7
0,1212,35272,3578744354,3578744361,7
0,1212,35273,3578744354,3578744361,7
0,1212,35274,3578744354,3578744361,7
0,1212,35275,3578744354,3578744362,8
0,1212,35276,3578744354,3578744364,10
0,1212,35277,3578744354,3578744364,10
0,1212,35278,3578744354,3578744365,11
0,1212,35279,3578744354,3578744366,12
0,1212,35280,3578744354,3578744367,13
0,1212,35281,3578744354,3578744367,13
0,1212,35282,3578744354,3578744367,13
0,1212,35283,3578744354,3578744368,14
0,1212,35284,3578744354,3578744369,15
0,1212,35285,3578744354,3578744370,16
0,1212,35286,3578744354,3578744370,16
0,1212,35287,3578744354,3578744370,16
0,1212,35288,3578744354,3578744371,17
0,1212,35289,3578744354,3578744372,18
0,1212,35290,3578744354,3578744373,19
0,1212,35291,3578744354,3578744373,19
0,1212,35292,3578744354,3578744374,20
0,1212,35293,3578744354,3578744376,22
0,1212,35294,3578744354,3578744376,22
0,1212,35295,3578744354,3578744377,23
0,1212,35296,3578744354,3578744378,24
0,1212,35297,3578744354,3578744379,25
0,1212,35298,3578744354,3578744380,26
0,1212,35299,3578744354,3578744380,26
0,1212,35300,3578744354,3578744380,26
0,1212,35301,3578744354,3578744381,27
0,1212,35302,3578744354,3578744381,27
0,1212,35303,3578744354,3578744382,28
0,1212,35304,3578744354,3578744382,28
0,1212,35305,3578744354,3578744385,31
0,1212,35306,3578744354,3578744385,31
0,1212,35307,3578744354,3578744386,32
0,1212,35308,3578744354,3578744387,33
0,1212,35309,3578744354,3578744388,34
0,1212,35310,3578744354,3578744389,35
0,1212,35311,3578744354,3578744389,35
0,1212,35312,3578744354,3578744389,35
0,1212,35313,3578744354,3578744390,36
0,1212,35314,3578744354,3578744390,36
0,1212,35315,3578744354,3578744390,36
0,1212,35316,3578744354,3578744391,37
0,1212,35317,3578744354,3578744392,38
0,1212,35318,3578744354,3578744393,39
0,1212,35319,3578744354,3578744393,39
0,1212,35320,3578744354,3578744395,41
0,1212,35321,3578744354,3578744395,41
0,1212,35322,3578744354,3578744396,42
0,1212,35323,3578744354,3578744400,46
0,1212,35324,3578744354,3578744401,47
0,1212,35325,3578744354,3578744401,47
0,1212,35326,3578744354,3578744401,47
0,1212,35327,3578744354,3578744404,50
0,1213,35328,3578744415,3578744415,0
0,1213,35329,3578744415,3578744415,0
0,1213,35330,3578744415,3578744415,0
0,1213,35331,3578744415,3578744415,0
0,1213,35332,3578744415,3578744415,0
0,1213,35333,3578744415,3578744415,0
0,1213,35334,3578744415,3578744415,0
0,1213,35335,3578744415,3578744415,0
0,1213,35336,3578744415,3578744415,0
0,1213,35337,3578744415,3578744415,0
0,1213,35338,3578744415,3578744415,0
0,1213,35339,3578744415,3578744415,0
0,1213,35340,3578744415,3578744415,0
0,1213,35341,3578744415,3578744415,0
0,1213,35342,3578744415,3578744415,0
0,1213,35343,3578744415,3578744415,0
0,1213,35344,3578744415,3578744415,0
0,1213,35345,3578744415,3578744415,0
0,1213,35346,3578744415,3578744416,1
0,1213,35347,3578744415,3578744416,1
0,1213,35348,3578744415,3578744416,1
0,1213,35349,3578744415,3578744416,1
0,1213,35350,3578744415,3578744418,3
0,1213,35351,3578744415,3578744418,3
0,1213,35352,3578744415,3578744419,4
0,1213,35353,3578744415,3578744419,4
0,1213,35354,3578744415,3578744419,4
0,1213,35355,3578744415,3578744419,4
0,1213,35356,3578744415,3578744420,5
0,1213,35357,3578744415,3578744422,7
0,1213,35358,3578744415,3578744424,9
0,1213,35359,3578744415,3578744424,9
0,1213,35360,3578744415,3578744425,10
0,1213,35361,3578744415,3578744425,10
0,1213,35362,3578744415,3578744426,11
0,1213,35363,3578744415,3578744427,12
0,1213,35364,3578744415,3578744427,12
0,1213,35365,3578744415,3578744428,13
0,1213,35366,3578744415,3578744430,15
0,1213,35367,3578744415,3578744432,17
0,1213,35368,3578744415,3578744432,17
0,1213,35369,3578744415,3578744433,18
0,1213,35370,3578744415,3578744434,19
0,1213,35371,3578744415,3578744436,21
0,1213,35372,3578744415,3578744437,22
0,1213,35373,3578744415,3578744439,24
0,1213,35374,3578744415,3578744439,24
0,1213,35375,3578744415,3578744439,24
0,1213,35376,3578744415,3578744440,25
0,1213,35377,3578744415,3578744441,26
0,1213,35378,3578744415,3578744442,27
0,1213,35379,3578744415,3578744443,28
0,1213,35380,3578744415,3578744444,29
0,1213,35381,3578744415,3578744445,30
0,1213,35382,3578744415,3578744447,32
0,1213,35383,3578744415,3578744448,33
0,1213,35384,3578744415,3578744448,33
0,1213,35385,3578744415,3578744449,34
0,1213,35386,3578744415,3578744449,34
0,1213,35387,3578744415,3578744450,35
0,1213,35388,3578744415,3578744450,35
0,1213,35389,3578744415,3578744450,35
0,1213,35390,3578744415,3578744451,36
0,1213,35391,3578744415,3578744451,36
0,1213,35392,3578744415,3578744453,38
0,1213,35393,3578744415,3578744454,39
0,1213,35394,3578744415,3578744456,41
0,1213,35395,3578744415,3578744457,42
0,1213,35396,3578744415,3578744458,43
0,1213,35397,3578744415,3578744458,43
0,1213,35398,3578744415,3578744459,44
0,1213,35399,3578744415,3578744460,45
0,1213,35400,3578744415,3578744461,46
0,1213,35401,3578744415,3578744462,47
0,1213,35402,3578744415,3578744462,47
0,1213,35403,3578744415,3578744463,48
0,1213,35404,3578744415,3578744463,48
0,1213,35405,3578744415,3578744463,48
0,1213,35406,3578744415,3578744464,49
0,1213,35407,3578744415,3578744464,49
0,1213,35408,3578744415,3578744465,50
0,1214,35409,3578744476,3578744476,0
0,1214,35410,3578744476,3578744476,0
0,1214,35411,3578744476,3578744476,0
0,1214,35412,3578744476,3578744476,0
0,1214,35413,3578744476,3578744476,0
0,1214,35414,3578744476,3578744477,1
0,1214,35415,3578744476,3578744478,2
0,1214,35416,3578744476,3578744478,2
0,1214,35417,3578744476,3578744478,2
0,1214,35418,3578744476,3578744479,3
0,1214,35419,3578744476,3578744479,3
0,1214,35420,3578744476,3578744480,4
0,1214,35421,3578744476,3578744480,4
0,1214,35422,3578744476,3578744481,5
0,1214,35423,3578744476,3578744483,7
0,1214,35424,3578744476,3578744483,7
0,1214,35425,3578744476,3578744484,8
0,1214,35426,3578744476,3578744484,8
0,1214,35427,3578744476,3578744486,10
0,1214,35428,3578744476,3578744487,11
0,1214,35429,3578744476,3578744487,11
0,1214,35430,3578744476,3578744487,11
0,1214,35431,3578744476,3578744488,12
0,1214,35432,3578744476,3578744488,12
0,1214,35433,3578744476,3578744488,12
0,1214,35434,3578744476,3578744489,13
0,1214,35435,3578744476,3578744489,13
0,1214,35436,3578744476,3578744489,13
0,1214,35437,3578744476,3578744490,14
0,1214,35438,3578744476,3578744491,15
0,1214,35439,3578744476,3578744491,15
0,1214,35440,3578744476,3578744493,17
0,1214,35441,3578744476,3578744497,21
0,1214,35442,3578744476,3578744498,22
0,1214,35443,3578744476,3578744498,22
0,1214,35444,3578744476,3578744498,22
0,1214,35445,3578744476,3578744498,22
0,1214,35446,3578744476,3578744500,24
0,1214,35447,3578744476,3578744501,25
0,1214,35448,3578744476,3578744502,26
0,1214,35449,3578744476,3578744502,26
0,1214,35450,3578744476,3578744502,26
0,1214,35451,3578744476,3578744503,27
0,1214,35452,3578744476,3578744503,27
0,1214,35453,3578744476,3578744504,28
0,1214,35454,3578744476,3578744504,28
0,1214,35455,3578744476,3578744506,30
0,1214,35456,3578744476,3578744506,30
0,1214,35457,3578744476,3578744507,31
0,1214,35458,3578744476,3578744507,31
0,1214,35459,3578744476,3578744507,31
0,1214,35460,3578744476,3578744507,31
0,1214,35461,3578744476,3578744508,32
0,1214,35462,3578744476,3578744509,33
0,1214,35463,3578744476,3578744509,33
0,1214,35464,3578744476,3578744510,34
0,1214,35465,3578744476,3578744510,34
0,1214,35466,3578744476,3578744512,36
0,1214,35467,3578744476,3578744514,38
0,1214,35468,3578744476,3578744514,38
0,1214,35469,3578744476,3578744514,38
0,1214,35470,3578744476,3578744514,38
0,1214,35471,3578744476,3578744515,39
0,1214,35472,3578744476,3578744515,39
0,1214,35473,3578744476,3578744515,39
0,1214,35474,3578744476,3578744515,39
0,1214,35475,3578744476,3578744515,39
0,1214,35476,3578744476,3578744516,40
0,1214,35477,3578744476,3578744516,40
0,1214,35478,3578744476,3578744517,41
0,1214,35479,3578744476,3578744517,41
0,1214,35480,3578744476,3578744518,42
0,1214,35481,3578744476,3578744518,42
0,1214,35482,3578744476,3578744518,42
0,1214,35483,3578744476,3578744518,42
0,1214,35484,3578744476,3578744520,44
0,1214,35485,3578744476,3578744522,46
0,1214,35486,3578744476,3578744522,46
0,1214,35487,3578744476,3578744523,47
0,1215,35488,3578744539,3578744539,0
0,1215,35489,3578744539,3578744539,0
0,1215,35490,3578744539,3578744539,0
0,1215,35491,3578744539,3578744539,0
0,1215,35492,3578744539,3578744539,0
0,1215,35493,3578744539,3578744539,0
0,1215,35494,3578744539,3578744539,0
0,1215,35495,3578744539,3578744539,0
0,1215,35496,3578744539,3578744539,0
0,1215,35497,3578744539,3578744539,0
0,1215,35498,3578744539,3578744539,0
0,1215,35499,3578744539,3578744539,0
0,1215,35500,3578744539,3578744539,0
0,1215,35501,3578744539,3578744539,0
0,1215,35502,3578744539,3578744539,0
0,1215,35503,3578744539,3578744539,0
0,1215,35504,3578744539,3578744539,0
0,1215,35505,3578744539,3578744539,0
0,1215,35506,3578744539,3578744539,0
0,1215,35507,3578744539,3578744539,0
0,1215,35508,3578744539,3578744539,0
0,1215,35509,3578744539,3578744539,0
0,1215,35510,3578744539,3578744539,0
0,1215,35511,3578744539,3578744540,1
0,1215,35512,3578744539,3578744540,1
0,1215,35513,3578744539,3578744540,1
0,1215,35514,3578744539,3578744541,2
0,1215,35515,3578744539,3578744542,3
0,1215,35516,3578744539,3578744542,3
0,1215,35517,3578744539,3578744542,3
0,1215,35518,3578744539,3578744543,4
0,1215,35519,3578744539,3578744544,5
0,1215,35520,3578744539,3578744544,5
0,1215,35521,3578744539,3578744545,6
0,1215,35522,3578744539,3578744545,6
0,1215,35523,3578744539,3578744546,7
0,1215,35524,3578744539,3578744546,7
0,1215,35525,3578744539,3578744546,7
0,1215,35526,3578744539,3578744547,8
0,1215,35527,3578744539,3578744547,8
0,1215,35528,3578744539,3578744549,10
0,1215,35529,3578744539,3578744552,13
0,1215,35530,3578744539,3578744553,14
0,1215,35531,3578744539,3578744554,15
0,1215,35532,3578744539,3578744554,15
0,1215,35533,3578744539,3578744555,16
0,1215,35534,3578744539,3578744555,16
0,1215,35535,3578744539,3578744557,18
0,1215,35536,3578744539,3578744557,18
0,1215,35537,3578744539,3578744557,18
0,1215,35538,3578744539,3578744558,19
0,1215,35539,3578744539,3578744559,20
0,1215,35540,3578744539,3578744560,21
0,1215,35541,3578744539,3578744560,21
0,1215,35542,3578744539,3578744560,21
0,1215,35543,3578744539,3578744560,21
0,1215,35544,3578744539,3578744560,21
0,1215,35545,3578744539,3578744561,22
0,1215,35546,3578744539,3578744562,23
0,1215,35547,3578744539,3578744564,25
0,1215,35548,3578744539,3578744565,26
0,1215,35549,3578744539,3578744566,27
0,1215,35550,3578744539,3578744566,27
0,1215,35551,3578744539,3578744567,28
0,1215,35552,3578744539,3578744567,28
0,1215,35553,3578744539,3578744568,29
0,1215,35554,3578744539,3578744569,30
0,1215,35555,3578744539,3578744569,30
0,1215,35556,3578744539,3578744569,30
0,1215,35557,3578744539,3578744570,31
0,1215,35558,3578744539,3578744571,32
0,1215,35559,3578744539,3578744573,34
0,1215,35560,3578744539,3578744573,34
0,1215,35561,3578744539,3578744573,34
0,1215,35562,3578744539,3578744573,34
0,1215,35563,3578744539,3578744575,36
0,1215,35564,3578744539,3578744576,37
0,1215,35565,3578744539,3578744576,37
0,1215,35566,3578744539,3578744578,39
0,1215,35567,3578744539,3578744579,40
0,1215,35568,3578744539,3578744579,40
0,1215,35569,3578744539,3578744579,40
0,1215,35570,3578744539,3578744579,40
0,1215,35571,3578744539,3578744580,41
0,1215,35572,3578744539,3578744580,41
0,1215,35573,3578744539,3578744581,42
0,1215,35574,3578744539,3578744581,42
0,1215,35575,3578744539,3578744585,46
0,1215,35576,3578744539,3578744585,46
0,1215,35577,3578744539,3578744585,46
0,1215,35578,3578744539,3578744586,47
0,1215,35579,3578744539,3578744587,48
0,1215,35580,3578744539,3578744588,49
0,1215,35581,3578744539,3578744588,49
0,1215,35582,3578744539,3578744589,50
0,1216,35583,3578744600,3578744600,0
0,1216,35584,3578744600,3578744600,0
0,1216,35585,3578744600,3578744600,0
0,1216,35586,3578744600,3578744600,0
0,1216,35587,3578744600,3578744600,0
0,1216,35588,3578744600,3578744600,0
0,1216,35589,3578744600,3578744600,0
0,1216,35590,3578744600,3578744600,0
0,1216,35591,3578744600,3578744600,0
0,1216,35592,3578744600,3578744600,0
0,1216,35593,3578744600,3578744600,0
0,1216,35594,3578744600,3578744600,0
0,1216,35595,3578744600,3578744601,1
0,1216,35596,3578744600,3578744603,3
0,1216,35597,3578744600,3578744604,4
0,1216,35598,3578744600,3578744604,4
0,1216,35599,3578744600,3578744604,4
0,1216,35600,3578744600,3578744604,4
0,1216,35601,3578744600,3578744605,5
0,1216,35602,3578744600,3578744605,5
0,1216,35603,3578744600,3578744607,7
0,1216,35604,3578744600,3578744608,8
0,1216,35605,3578744600,3578744608,8
0,1216,35606,3578744600,3578744609,9
0,1216,35607,3578744600,3578744610,10
0,1216,35608,3578744600,3578744610,10
0,1216,35609,3578744600,3578744610,10
0,1216,35610,3578744600,3578744611,11
0,1216,35611,3578744600,3578744612,12
0,1216,35612,3578744600,3578744613,13
0,1216,35613,3578744600,3578744613,13
0,1216,35614,3578744600,3578744614,14
0,1216,35615,3578744600,3578744614,14
0,1216,35616,3578744600,3578744615,15
0,1216,35617,3578744600,3578744615,15
0,1216,35618,3578744600,3578744615,15
0,1216,35619,3578744600,3578744615,15
0,1216,35620,3578744600,3578744617,17
0,1216,35621,3578744600,3578744618,18
0,1216,35622,3578744600,3578744618,18
0,1216,35623,3578744600,3578744618,18
0,1216,35624,3578744600,3578744618,18
0,1216,35625,3578744600,3578744619,19
0,1216,35626,3578744600,3578744619,19
0,1216,35627,3578744600,3578744619,19
0,1216,35628,3578744600,3578744621,21
0,1216,35629,3578744600,3578744622,22
0,1216,35630,3578744600,3578744622,22
0,1216,35631,3578744600,3578744623,23
0,1216,35632,3578744600,3578744625,25
0,1216,35633,3578744600,3578744625,25
0,1216,35634,3578744600,3578744625,25
0,1216,35635,3578744600,3578744625,25
0,1216,35636,3578744600,3578744627,27
0,1216,35637,3578744600,3578744629,29
0,1216,35638,3578744600,3578744631,31
0,1216,35639,3578744600,3578744631,31
0,1216,35640,3578744600,3578744633,33
0,1216,35641,3578744600,3578744633,33
0,1216,35642,3578744600,3578744634,34
0,1216,35643,3578744600,3578744636,36
0,1216,35644,3578744600,3578744636,36
0,1216,35645,3578744600,3578744638,38
0,1216,35646,3578744600,3578744638,38
0,1216,35647,3578744600,3578744638,38
0,1216,35648,3578744600,3578744638,38
0,1216,35649,3578744600,3578744639,39
0,1216,35650,3578744600,3578744639,39
0,1216,35651,3578744600,3578744640,40
0,1216,35652,3578744600,3578744640,40
0,1216,35653,3578744600,3578744641,41
0,1216,35654,3578744600,3578744642,42
0,1216,35655,3578744600,3578744643,43
0,1216,35656,3578744600,3578744644,44
0,1216,35657,3578744600,3578744647,47
0,1216,35658,3578744600,3578744647,47
0,1216,35659,3578744600,3578744648,48
0,1216,35660,3578744600,3578744648,48
0,1216,35661,3578744600,3578744648,48
0,1216,35662,3578744600,3578744648,48
0,1216,35663,3578744600,3578744648,48
0,1216,35664,3578744600,3578744649,49
0,1216,35665,3578744600,3578744650,50
0,1217,35666,3578744663,3578744663,0
0,1217,35667,3578744663,3578744663,0
0,1217,35668,3578744663,3578744663,0
0,1217,35669,3578744663,3578744663,0
0,1217,35670,3578744663,3578744663,0
0,1217,35671,3578744663,3578744663,0
0,1217,35672,3578744663,3578744663,0
0,1217,35673,3578744663,3578744663,0
0,1217,35674,3578744663,3578744663,0
0,1217,35675,3578744663,3578744663,0
0,1217,35676,3578744663,3578744663,0
0,1217,35677,3578744663,3578744663,0
0,1217,35678,3578744663,3578744663,0
0,1217,35679,3578744663,3578744663,0
0,1217,35680,3578744663,3578744663,0
0,1217,35681,3578744663,3578744663,0
0,1217,35682,3578744663,3578744663,0
0,1217,35683,3578744663,3578744663,0
0,1217,35684,3578744663,3578744664,1
0,1217,35685,3578744663,3578744664,1
0,1217,35686,3578744663,3578744664,1
0,1217,35687,3578744663,3578744666,3
0,1217,35688,3578744663,3578744667,4
0,1217,35689,3578744663,3578744667,4
0,1217,35690,3578744663,3578744676,13
0,1217,35691,3578744663,3578744677,14
0,1217,35692,3578744663,3578744678,15
0,1217,35693,3578744663,3578744679,16
0,1217,35694,3578744663,3578744679,16
0,1217,35695,3578744663,3578744679,16
0,1217,35696,3578744663,3578744680,17
0,1217,35697,3578744663,3578744680,17
0,1217,35698,3578744663,3578744681,18
0,1217,35699,3578744663,3578744681,18
0,1217,35700,3578744663,3578744683,20
0,1217,35701,3578744663,3578744684,21
0,1217,35702,3578744663,3578744684,21
0,1217,35703,3578744663,3578744685,22
0,1217,35704,3578744663,3578744685,22
0,1217,35705,3578744663,3578744687,24
0,1217,35706,3578744663,3578744687,24
0,1217,35707,3578744663,3578744687,24
0,1217,35708,3578744663,3578744687,24
0,1217,35709,3578744663,3578744687,24
0,1217,35710,3578744663,3578744688,25
0,1217,35711,3578744663,3578744688,25
0,1217,35712,3578744663,3578744688,25
0,1217,35713,3578744663,3578744689,26
0,1217,35714,3578744663,3578744690,27
0,1217,35715,3578744663,3578744691,28
0,1217,35716,3578744663,3578744692,29
0,1217,35717,3578744663,3578744692,29
0,1217,35718,3578744663,3578744693,30
0,1217,35719,3578744663,3578744693,30
0,1217,35720,3578744663,3578744697,34
0,1217,35721,3578744663,3578744697,34
0,1217,35722,3578744663,3578744697,34
0,1217,35723,3578744663,3578744698,35
0,1217,35724,3578744663,3578744698,35
0,1217,35725,3578744663,3578744699,36
0,1217,35726,3578744663,3578744701,38
0,1217,35727,3578744663,3578744701,38
0,1217,35728,3578744663,3578744702,39
0,1217,35729,3578744663,3578744702,39
0,1217,35730,3578744663,3578744703,40
0,1217,35731,3578744663,3578744703,40
0,1217,35732,3578744663,3578744703,40
0,1217,35733,3578744663,3578744703,40
0,1217,35734,3578744663,3578744705,42
0,1217,35735,3578744663,3578744706,43
0,1217,35736,3578744663,3578744706,43
0,1217,35737,3578744663,3578744706,43
0,1217,35738,3578744663,3578744706,43
0,1217,35739,3578744663,3578744707,44
0,1217,35740,3578744663,3578744707,44
0,1217,35741,3578744663,3578744709,46
0,1217,35742,3578744663,3578744709,46
0,1217,35743,3578744663,3578744709,46
0,1217,35744,3578744663,3578744710,47
0,1217,35745,3578744663,3578744710,47
0,1217,35746,3578744663,3578744712,49
0,1218,35747,3578744726,3578744726,0
0,1218,35748,3578744726,3578744726,0
0,1218,35749,3578744726,3578744726,0
0,1218,35750,3578744726,3578744726,0
0,1218,35751,3578744726,3578744726,0
0,1218,35752,3578744726,3578744726,0
0,1218,35753,3578744726,3578744726,0
0,1218,35754,3578744726,3578744726,0
0,1218,35755,3578744726,3578744726,0
0,1218,35756,3578744726,3578744726,0
0,1218,35757,3578744726,3578744726,0
0,1218,35758,3578744726,3578744726,0
0,1218,35759,3578744726,3578744726,0
0,1218,35760,3578744726,3578744726,0
0,1218,35761,3578744726,3578744726,0
0,1218,35762,3578744726,3578744726,0
0,1218,35763,3578744726,3578744726,0
0,1218,35764,3578744726,3578744726,0
0,1218,35765,3578744726,3578744726,0
0,1218,35766,3578744726,3578744726,0
0,1218,35767,3578744726,3578744727,1
0,1218,35768,3578744726,3578744727,1
0,1218,35769,3578744726,3578744728,2
0,1218,35770,3578744726,3578744728,2
0,1218,35771,3578744726,3578744729,3
0,1218,35772,3578744726,3578744729,3
0,1218,35773,3578744726,3578744729,3
0,1218,35774,3578744726,3578744729,3
0,1218,35775,3578744726,3578744730,4
0,1218,35776,3578744726,3578744731,5
0,1218,35777,3578744726,3578744731,5
0,1218,35778,3578744726,3578744731,5
0,1218,35779,3578744726,3578744732,6
0,1218,35780,3578744726,3578744732,6
0,1218,35781,3578744726,3578744733,7
0,1218,35782,3578744726,3578744733,7
0,1218,35783,3578744726,3578744734,8
0,1218,35784,3578744726,3578744734,8
0,1218,35785,3578744726,3578744735,9
0,1218,35786,3578744726,3578744736,10
0,1218,35787,3578744726,3578744738,12
0,1218,35788,3578744726,3578744738,12
0,1218,35789,3578744726,3578744739,13
0,1218,35790,3578744726,3578744739,13
0,1218,35791,3578744726,3578744740,14
0,1218,35792,3578744726,3578744740,14
0,1218,35793,3578744726,3578744740,14
0,1218,35794,3578744726,3578744741,15
0,1218,35795,3578744726,3578744742,16
0,1218,35796,3578744726,3578744742,16
0,1218,35797,3578744726,3578744742,16
0,1218,35798,3578744726,3578744743,17
0,1218,35799,3578744726,3578744744,18
0,1218,35800,3578744726,3578744744,18
0,1218,35801,3578744726,3578744745,19
0,1218,35802,3578744726,3578744745,19
0,1218,35803,3578744726,3578744746,20
0,1218,35804,3578744726,3578744746,20
0,1218,35805,3578744726,3578744746,20
0,1218,35806,3578744726,3578744746,20
0,1218,35807,3578744726,3578744747,21
0,1218,35808,3578744726,3578744747,21
0,1218,35809,3578744726,3578744752,26
0,1218,35810,3578744726,3578744754,28
0,1218,35811,3578744726,3578744754,28
0,1218,35812,3578744726,3578744755,29
0,1218,35813,3578744726,3578744757,31
0,1218,35814,3578744726,3578744757,31
0,1218,35815,3578744726,3578744757,31
0,1218,35816,3578744726,3578744757,31
0,1218,35817,3578744726,3578744758,32
0,1218,35818,3578744726,3578744759,33
0,1218,35819,3578744726,3578744760,34
0,1218,35820,3578744726,3578744760,34
0,1218,35821,3578744726,3578744760,34
0,1218,35822,3578744726,3578744760,34
0,1218,35823,3578744726,3578744761,35
0,1218,35824,3578744726,3578744762,36
0,1218,35825,3578744726,3578744764,38
0,1218,35826,3578744726,3578744765,39
0,1218,35827,3578744726,3578744766,40
0,1218,35828,3578744726,3578744767,41
0,1218,35829,3578744726,3578744768,42
0,1218,35830,3578744726,3578744768,42
0,1218,35831,3578744726,3578744768,42
0,1218,35832,3578744726,3578744769,43
0,1218,35833,3578744726,3578744769,43
0,1218,35834,3578744726,3578744769,43
0,1218,35835,3578744726,3578744770,44
0,1218,35836,3578744726,3578744771,45
0,1218,35837,3578744726,3578744773,47
0,1218,35838,3578744726,3578744773,47
0,1218,35839,3578744726,3578744774,48
0,1218,35840,3578744726,3578744775,49
0,1218,35841,3578744726,3578744775,49
0,1219,35842,3578744788,3578744788,0
0,1219,35843,3578744788,3578744788,0
0,1219,35844,3578744788,3578744788,0
0,1219,35845,3578744788,3578744788,0
0,1219,35846,3578744788,3578744788,0
0,1219,35847,3578744788,3578744788,0
0,1219,35848,3578744788,3578744788,0
0,1219,35849,3578744788,3578744788,0
0,1219,35850,3578744788,3578744788,0
0,1219,35851,3578744788,3578744788,0
0,1219,35852,3578744788,3578744788,0
0,1219,35853,3578744788,3578744788,0
0,1219,35854,3578744788,3578744788,0
0,1219,35855,3578744788,3578744788,0
0,1219,35856,3578744788,3578744788,0
0,1219,35857,3578744788,3578744788,0
0,1219,35858,3578744788,3578744789,1
0,1219,35859,3578744788,3578744789,1
0,1219,35860,3578744788,3578744789,1
0,1219,35861,3578744788,3578744790,2
0,1219,35862,3578744788,3578744790,2
0,1219,35863,3578744788,3578744790,2
0,1219,35864,3578744788,3578744791,3
0,1219,35865,3578744788,3578744792,4
0,1219,35866,3578744788,3578744794,6
0,1219,35867,3578744788,3578744795,7
0,1219,35868,3578744788,3578744796,8
0,1219,35869,3578744788,3578744800,12
0,1219,35870,3578744788,3578744800,12
0,1219,35871,3578744788,3578744800,12
0,1219,35872,3578744788,3578744802,14
0,1219,35873,3578744788,3578744803,15
0,1219,35874,3578744788,3578744803,15
0,1219,35875,3578744788,3578744804,16
0,1219,35876,3578744788,3578744804,16
0,1219,35877,3578744788,3578744805,17
0,1219,35878,3578744788,3578744805,17
0,1219,35879,3578744788,3578744805,17
0,1219,35880,3578744788,3578744806,18
0,1219,35881,3578744788,3578744806,18
0,1219,35882,3578744788,3578744807,19
0,1219,35883,3578744788,3578744807,19
0,1219,35884,3578744788,3578744808,20
0,1219,35885,3578744788,3578744809,21
0,1219,35886,3578744788,3578744810,22
0,1219,35887,3578744788,3578744810,22
0,1219,35888,3578744788,3578744810,22
0,1219,35889,3578744788,3578744812,24
0,1219,35890,3578744788,3578744812,24
0,1219,35891,3578744788,3578744813,25
0,1219,35892,3578744788,3578744813,25
0,1219,35893,3578744788,3578744814,26
0,1219,35894,3578744788,3578744815,27
0,1219,35895,3578744788,3578744815,27
0,1219,35896,3578744788,3578744815,27
0,1219,35897,3578744788,3578744815,27
0,1219,35898,3578744788,3578744816,28
0,1219,35899,3578744788,3578744818,30
0,1219,35900,3578744788,3578744818,30
0,1219,35901,3578744788,3578744818,30
0,1219,35902,3578744788,3578744818,30
0,1219,35903,3578744788,3578744818,30
0,1219,35904,3578744788,3578744819,31
0,1219,35905,3578744788,3578744819,31
0,1219,35906,3578744788,3578744819,31
0,1219,35907,3578744788,3578744821,33
0,1219,35908,3578744788,3578744822,34
0,1219,35909,3578744788,3578744822,34
0,1219,35910,3578744788,3578744823,35
0,1219,35911,3578744788,3578744825,37
0,1219,35912,3578744788,3578744825,37
0,1219,35913,3578744788,3578744825,37
0,1219,35914,3578744788,3578744826,38
0,1219,35915,3578744788,3578744827,39
0,1219,35916,3578744788,3578744829,41
0,1219,35917,3578744788,3578744831,43
0,1219,35918,3578744788,3578744832,44
0,1219,35919,3578744788,3578744832,44
0,1219,35920,3578744788,3578744833,45
0,1219,35921,3578744788,3578744835,47
0,1219,35922,3578744788,3578744836,48
0,1219,35923,3578744788,3578744838,50
0,1219,35924,3578744788,3578744838,50
0,1220,35925,3578744852,3578744852,0
0,1220,35926,3578744852,3578744852,0
0,1220,35927,3578744852,3578744852,0
0,1220,35928,3578744852,3578744852,0
0,1220,35929,3578744852,3578744852,0
0,1220,35930,3578744852,3578744852,0
0,1220,35931,3578744852,3578744852,0
0,1220,35932,3578744852,3578744852,0
0,1220,35933,3578744852,3578744852,0
0,1220,35934,3578744852,3578744852,0
0,1220,35935,3578744852,3578744852,0
0,1220,35936,3578744852,3578744852,0
0,1220,35937,3578744852,3578744852,0
0,1220,35938,3578744852,3578744852,0
0,1220,35939,3578744852,3578744852,0
0,1220,35940,3578744852,3578744852,0
0,1220,35941,3578744852,3578744852,0
0,1220,35942,3578744852,3578744852,0
0,1220,35943,3578744852,3578744852,0
0,1220,35944,3578744852,3578744852,0
0,1220,35945,3578744852,3578744854,2
0,1220,35946,3578744852,3578744856,4
0,1220,35947,3578744852,3578744856,4
0,1220,35948,3578744852,3578744857,5
0,1220,35949,3578744852,3578744857,5
0,1220,35950,3578744852,3578744859,7
0,1220,35951,3578744852,3578744859,7
0,1220,35952,3578744852,3578744859,7
0,1220,35953,3578744852,3578744860,8
0,1220,35954,3578744852,3578744861,9
0,1220,35955,3578744852,3578744862,10
0,1220,35956,3578744852,3578744863,11
0,1220,35957,3578744852,3578744863,11
0,1220,35958,3578744852,3578744863,11
0,1220,35959,3578744852,3578744864,12
0,1220,35960,3578744852,3578744865,13
0,1220,35961,3578744852,3578744865,13
0,1220,35962,3578744852,3578744866,14
0,1220,35963,3578744852,3578744867,15
0,1220,35964,3578744852,3578744868,16
0,1220,35965,3578744852,3578744876,24
0,1220,35966,3578744852,3578744878,26
0,1220,35967,3578744852,3578744878,26
0,1220,35968,3578744852,3578744879,27
0,1220,35969,3578744852,3578744879,27
0,1220,35970,3578744852,3578744880,28
0,1220,35971,3578744852,3578744880,28
0,1220,35972,3578744852,3578744880,28
0,1220,35973,3578744852,3578744880,28
0,1220,35974,3578744852,3578744881,29
0,1220,35975,3578744852,3578744883,31
0,1220,35976,3578744852,3578744884,32
0,1220,35977,3578744852,3578744884,32
0,1220,35978,3578744852,3578744884,32
0,1220,35979,3578744852,3578744885,33
0,1220,35980,3578744852,3578744886,34
0,1220,35981,3578744852,3578744886,34
0,1220,35982,3578744852,3578744887,35
0,1220,35983,3578744852,3578744887,35
0,1220,35984,3578744852,3578744887,35
0,1220,35985,3578744852,3578744888,36
0,1220,35986,3578744852,3578744888,36
0,1220,35987,3578744852,3578744889,37
0,1220,35988,3578744852,3578744889,37
0,1220,35989,3578744852,3578744889,37
0,1220,35990,3578744852,3578744889,37
0,1220,35991,3578744852,3578744890,38
0,1220,35992,3578744852,3578744890,38
0,1220,35993,3578744852,3578744892,40
0,1220,35994,3578744852,3578744892,40
0,1220,35995,3578744852,3578744893,41
0,1220,35996,3578744852,3578744893,41
0,1220,35997,3578744852,3578744895,43
0,1220,35998,3578744852,3578744896,44
0,1220,35999,3578744852,3578744897,45
0,1220,36000,3578744852,3578744898,46
0,1220,36001,3578744852,3578744898,46
0,1220,36002,3578744852,3578744899,47
0,1220,36003,3578744852,3578744899,47
0,1220,36004,3578744852,3578744901,49
0,1220,36005,3578744852,3578744901,49
0,1220,36006,3578744852,3578744902,50
0,1221,36007,3578744914,3578744914,0
0,1221,36008,3578744914,3578744914,0
0,1221,36009,3578744914,3578744914,0
0,1221,36010,3578744914,3578744914,0
0,1221,36011,3578744914,3578744914,0
0,1221,36012,3578744914,3578744914,0
0,1221,36013,3578744914,3578744914,0
0,1221,36014,3578744914,3578744914,0
0,1221,36015,3578744914,3578744914,0
0,1221,36016,3578744914,3578744914,0
0,1221,36017,3578744914,3578744914,0
0,1221,36018,3578744914,3578744914,0
0,1221,36019,3578744914,3578744914,0
0,1221,36020,3578744914,3578744914,0
0,1221,36021,3578744914,3578744914,0
0,1221,36022,3578744914,3578744914,0
0,1221,36023,3578744914,3578744914,0
0,1221,36024,3578744914,3578744914,0
0,1221,36025,3578744914,3578744914,0
0,1221,36026,3578744914,3578744915,1
0,1221,36027,3578744914,3578744915,1
0,1221,36028,3578744914,3578744915,1
0,1221,36029,3578744914,3578744915,1
0,1221,36030,3578744914,3578744916,2
0,1221,36031,3578744914,3578744916,2
0,1221,36032,3578744914,3578744916,2
0,1221,36033,3578744914,3578744917,3
0,1221,36034,3578744914,3578744918,4
0,1221,36035,3578744914,3578744918,4
0,1221,36036,3578744914,3578744918,4
0,1221,36037,3578744914,3578744920,6
0,1221,36038,3578744914,3578744920,6
0,1221,36039,3578744914,3578744922,8
0,1221,36040,3578744914,3578744923,9
0,1221,36041,3578744914,3578744923,9
0,1221,36042,3578744914,3578744927,13
0,1221,36043,3578744914,3578744927,13
0,1221,36044,3578744914,3578744928,14
0,1221,36045,3578744914,3578744928,14
0,1221,36046,3578744914,3578744928,14
0,1221,36047,3578744914,3578744929,15
0,1221,36048,3578744914,3578744929,15
0,1221,36049,3578744914,3578744929,15
0,1221,36050,3578744914,3578744929,15
0,1221,36051,3578744914,3578744931,17
0,1221,36052,3578744914,3578744931,17
0,1221,36053,3578744914,3578744931,17
0,1221,36054,3578744914,3578744931,17
0,1221,36055,3578744914,3578744932,18
0,1221,36056,3578744914,3578744933,19
0,1221,36057,3578744914,3578744933,19
0,1221,36058,3578744914,3578744933,19
0,1221,36059,3578744914,3578744934,20
0,1221,36060,3578744914,3578744935,21
0,1221,36061,3578744914,3578744935,21
0,1221,36062,3578744914,3578744935,21
0,1221,36063,3578744914,3578744938,24
0,1221,36064,3578744914,3578744938,24
0,1221,36065,3578744914,3578744939,25
0,1221,36066,3578744914,3578744939,25
0,1221,36067,3578744914,3578744940,26
0,1221,36068,3578744914,3578744940,26
0,1221,36069,3578744914,3578744941,27
0,1221,36070,3578744914,3578744942,28
0,1221,36071,3578744914,3578744942,28
0,1221,36072,3578744914,3578744942,28
0,1221,36073,3578744914,3578744943,29
0,1221,36074,3578744914,3578744943,29
0,1221,36075,3578744914,3578744944,30
0,1221,36076,3578744914,3578744944,30
0,1221,36077,3578744914,3578744945,31
0,1221,36078,3578744914,3578744946,32
0,1221,36079,3578744914,3578744946,32
0,1221,36080,3578744914,3578744946,32
0,1221,36081,3578744914,3578744946,32
0,1221,36082,3578744914,3578744946,32
0,1221,36083,3578744914,3578744948,34
0,1221,36084,3578744914,3578744950,36
0,1221,36085,3578744914,3578744952,38
0,1221,36086,3578744914,3578744954,40
0,1221,36087,3578744914,3578744954,40
0,1221,36088,3578744914,3578744955,41
0,1221,36089,3578744914,3578744957,43
0,1221,36090,3578744914,3578744957,43
0,1221,36091,3578744914,3578744957,43
0,1221,36092,3578744914,3578744958,44
0,1221,36093,3578744914,3578744958,44
0,1221,36094,3578744914,3578744958,44
0,1221,36095,3578744914,3578744960,46
0,1221,36096,3578744914,3578744961,47
0,1221,36097,3578744914,3578744961,47
0,1221,36098,3578744914,3578744961,47
0,1221,36099,3578744914,3578744961,47
0,1221,36100,3578744914,3578744962,48
0,1221,36101,3578744914,3578744963,49
0,1221,36102,3578744914,3578744963,49
0,1221,36103,3578744914,3578744964,50
0,1222,36104,3578744977,3578744977,0
0,1222,36105,3578744977,3578744977,0
0,1222,36106,3578744977,3578744977,0
0,1222,36107,3578744977,3578744977,0
0,1222,36108,3578744977,3578744977,0
0,1222,36109,3578744977,3578744977,0
0,1222,36110,3578744977,3578744977,0
0,1222,36111,3578744977,3578744977,0
0,1222,36112,3578744977,3578744977,0
0,1222,36113,3578744977,3578744977,0
0,1222,36114,3578744977,3578744977,0
0,1222,36115,3578744977,3578744977,0
0,1222,36116,3578744977,3578744977,0
0,1222,36117,3578744977,3578744977,0
0,1222,36118,3578744977,3578744977,0
0,1222,36119,3578744977,3578744977,0
0,1222,36120,3578744977,3578744977,0
0,1222,36121,3578744977,3578744978,1
0,1222,36122,3578744977,3578744979,2
0,1222,36123,3578744977,3578744980,3
0,1222,36124,3578744977,3578744980,3
0,1222,36125,3578744977,3578744980,3
0,1222,36126,3578744977,3578744981,4
0,1222,36127,3578744977,3578744981,4
0,1222,36128,3578744977,3578744981,4
0,1222,36129,3578744977,3578744985,8
0,1222,36130,3578744977,3578744985,8
0,1222,36131,3578744977,3578744986,9
0,1222,36132,3578744977,3578744987,10
0,1222,36133,3578744977,3578744987,10
0,1222,36134,3578744977,3578744987,10
0,1222,36135,3578744977,3578744988,11
0,1222,36136,3578744977,3578744989,12
0,1222,36137,3578744977,3578744989,12
0,1222,36138,3578744977,3578744989,12
0,1222,36139,3578744977,3578744989,12
0,1222,36140,3578744977,3578744990,13
0,1222,36141,3578744977,3578744990,13
0,1222,36142,3578744977,3578744993,16
0,1222,36143,3578744977,3578744994,17
0,1222,36144,3578744977,3578744995,18
0,1222,36145,3578744977,3578744997,20
0,1222,36146,3578744977,3578745000,23
0,1222,36147,3578744977,3578745000,23
0,1222,36148,3578744977,3578745001,24
0,1222,36149,3578744977,3578745001,24
0,1222,36150,3578744977,3578745003,26
0,1222,36151,3578744977,3578745003,26
0,1222,36152,3578744977,3578745004,27
0,1222,36153,3578744977,3578745004,27
0,1222,36154,3578744977,3578745005,28
0,1222,36155,3578744977,3578745005,28
0,1222,36156,3578744977,3578745005,28
0,1222,36157,3578744977,3578745006,29
0,1222,36158,3578744977,3578745006,29
0,1222,36159,3578744977,3578745007,30
0,1222,36160,3578744977,3578745008,31
0,1222,36161,3578744977,3578745008,31
0,1222,36162,3578744977,3578745009,32
0,1222,36163,3578744977,3578745009,32
0,1222,36164,3578744977,3578745010,33
0,1222,36165,3578744977,3578745012,35
0,1222,36166,3578744977,3578745012,35
0,1222,36167,3578744977,3578745013,36
0,1222,36168,3578744977,3578745014,37
0,1222,36169,3578744977,3578745014,37
0,1222,36170,3578744977,3578745015,38
0,1222,36171,3578744977,3578745015,38
0,1222,36172,3578744977,3578745016,39
0,1222,36173,3578744977,3578745016,39
0,1222,36174,3578744977,3578745018,41
0,1222,36175,3578744977,3578745018,41
0,1222,36176,3578744977,3578745018,41
0,1222,36177,3578744977,3578745018,41
0,1222,36178,3578744977,3578745018,41
0,1222,36179,3578744977,3578745019,42
0,1222,36180,3578744977,3578745019,42
0,1222,36181,3578744977,3578745021,44
0,1222,36182,3578744977,3578745023,46
0,1222,36183,3578744977,3578745024,47
0,1222,36184,3578744977,3578745024,47
0,1222,36185,3578744977,3578745025,48
0,1222,36186,3578744977,3578745026,49
0,1222,36187,3578744977,3578745026,49
0,1222,36188,3578744977,3578745026,49
0,1223,36189,3578745039,3578745039,0
0,1223,36190,3578745039,3578745039,0
0,1223,36191,3578745039,3578745039,0
0,1223,36192,3578745039,3578745039,0
0,1223,36193,3578745039,3578745039,0
0,1223,36194,3578745039,3578745039,0
0,1223,36195,3578745039,3578745039,0
0,1223,36196,3578745039,3578745039,0
0,1223,36197,3578745039,3578745039,0
0,1223,36198,3578745039,3578745039,0
0,1223,36199,3578745039,3578745039,0
0,1223,36200,3578745039,3578745039,0
0,1223,36201,3578745039,3578745041,2
0,1223,36202,3578745039,3578745041,2
0,1223,36203,3578745039,3578745041,2
0,1223,36204,3578745039,3578745042,3
0,1223,36205,3578745039,3578745043,4
0,1223,36206,3578745039,3578745044,5
0,1223,36207,3578745039,3578745044,5
0,1223,36208,3578745039,3578745048,9
0,1223,36209,3578745039,3578745048,9
0,1223,36210,3578745039,3578745048,9
0,1223,36211,3578745039,3578745048,9
0,1223,36212,3578745039,3578745049,10
0,1223,36213,3578745039,3578745050,11
0,1223,36214,3578745039,3578745050,11
0,1223,36215,3578745039,3578745050,11
0,1223,36216,3578745039,3578745050,11
0,1223,36217,3578745039,3578745050,11
0,1223,36218,3578745039,3578745052,13
0,1223,36219,3578745039,3578745054,15
0,1223,36220,3578745039,3578745056,17
0,1223,36221,3578745039,3578745056,17
0,1223,36222,3578745039,3578745056,17
0,1223,36223,3578745039,3578745057,18
0,1223,36224,3578745039,3578745058,19
0,1223,36225,3578745039,3578745059,20
0,1223,36226,3578745039,3578745059,20
0,1223,36227,3578745039,3578745060,21
0,1223,36228,3578745039,3578745061,22
0,1223,36229,3578745039,3578745062,23
0,1223,36230,3578745039,3578745063,24
0,1223,36231,3578745039,3578745063,24
0,1223,36232,3578745039,3578745064,25
0,1223,36233,3578745039,3578745065,26
0,1223,36234,3578745039,3578745065,26
0,1223,36235,3578745039,3578745066,27
0,1223,36236,3578745039,3578745067,28
0,1223,36237,3578745039,3578745068,29
0,1223,36238,3578745039,3578745076,37
0,1223,36239,3578745039,3578745078,39
0,1223,36240,3578745039,3578745078,39
0,1223,36241,3578745039,3578745079,40
0,1223,36242,3578745039,3578745079,40
0,1223,36243,3578745039,3578745079,40
0,1223,36244,3578745039,3578745079,40
0,1223,36245,3578745039,3578745080,41
0,1223,36246,3578745039,3578745081,42
0,1223,36247,3578745039,3578745081,42
0,1223,36248,3578745039,3578745083,44
0,1223,36249,3578745039,3578745084,45
0,1223,36250,3578745039,3578745084,45
0,1223,36251,3578745039,3578745084,45
0,1223,36252,3578745039,3578745085,46
0,1223,36253,3578745039,3578745086,47
0,1223,36254,3578745039,3578745087,48
0,1223,36255,3578745039,3578745087,48
0,1223,36256,3578745039,3578745087,48
0,1223,36257,3578745039,3578745087,48
0,1223,36258,3578745039,3578745087,48
0,1223,36259,3578745039,3578745088,49
0,1223,36260,3578745039,3578745088,49
0,1223,36261,3578745039,3578745089,50
0,1224,36262,3578745100,3578745100,0
0,1224,36263,3578745100,3578745100,0
0,1224,36264,3578745100,3578745100,0
0,1224,36265,3578745100,3578745100,0
0,1224,36266,3578745100,3578745100,0
0,1224,36267,3578745100,3578745100,0
0,1224,36268,3578745100,3578745100,0
0,1224,36269,3578745100,3578745100,0
0,1224,36270,3578745100,3578745100,0
0,1224,36271,3578745100,3578745100,0
0,1224,36272,3578745100,3578745100,0
0,1224,36273,3578745100,3578745100,0
0,1224,36274,3578745100,3578745100,0
0,1224,36275,3578745100,3578745100,0
0,1224,36276,3578745100,3578745100,0
0,1224,36277,3578745100,3578745100,0
0,1224,36278,3578745100,3578745101,1
0,1224,36279,3578745100,3578745101,1
0,1224,36280,3578745100,3578745102,2
0,1224,36281,3578745100,3578745103,3
0,1224,36282,3578745100,3578745103,3
0,1224,36283,3578745100,3578745103,3
0,1224,36284,3578745100,3578745104,4
0,1224,36285,3578745100,3578745104,4
0,1224,36286,3578745100,3578745106,6
0,1224,36287,3578745100,3578745106,6
0,1224,36288,3578745100,3578745107,7
0,1224,36289,3578745100,3578745107,7
0,1224,36290,3578745100,3578745107,7
0,1224,36291,3578745100,3578745107,7
0,1224,36292,3578745100,3578745109,9
0,1224,36293,3578745100,3578745109,9
0,1224,36294,3578745100,3578745110,10
0,1224,36295,3578745100,3578745110,10
0,1224,36296,3578745100,3578745110,10
0,1224,36297,3578745100,3578745112,12
0,1224,36298,3578745100,3578745114,14
0,1224,36299,3578745100,3578745114,14
0,1224,36300,3578745100,3578745115,15
0,1224,36301,3578745100,3578745115,15
0,1224,36302,3578745100,3578745115,15
0,1224,36303,3578745100,3578745116,16
0,1224,36304,3578745100,3578745116,16
0,1224,36305,3578745100,3578745116,16
0,1224,36306,3578745100,3578745116,16
0,1224,36307,3578745100,3578745116,16
0,1224,36308,3578745100,3578745117,17
0,1224,36309,3578745100,3578745117,17
0,1224,36310,3578745100,3578745117,17
0,1224,36311,3578745100,3578745118,18
0,1224,36312,3578745100,3578745118,18
0,1224,36313,3578745100,3578745119,19
0,1224,36314,3578745100,3578745119,19
0,1224,36315,3578745100,3578745120,20
0,1224,36316,3578745100,3578745122,22
0,1224,36317,3578745100,3578745123,23
0,1224,36318,3578745100,3578745123,23
0,1224,36319,3578745100,3578745127,27
0,1224,36320,3578745100,3578745128,28
0,1224,36321,3578745100,3578745128,28
0,1224,36322,3578745100,3578745129,29
0,1224,36323,3578745100,3578745129,29
0,1224,36324,3578745100,3578745129,29
0,1224,36325,3578745100,3578745129,29
0,1224,36326,3578745100,3578745130,30
0,1224,36327,3578745100,3578745130,30
0,1224,36328,3578745100,3578745131,31
0,1224,36329,3578745100,3578745131,31
0,1224,36330,3578745100,3578745132,32
0,1224,36331,3578745100,3578745133,33
0,1224,36332,3578745100,3578745133,33
0,1224,36333,3578745100,3578745133,33
0,1224,36334,3578745100,3578745134,34
0,1224,36335,3578745100,3578745136,36
0,1224,36336,3578745100,3578745136,36
0,1224,36337,3578745100,3578745136,36
0,1224,36338,3578745100,3578745138,38
0,1224,36339,3578745100,3578745138,38
0,1224,36340,3578745100,3578745139,39
0,1224,36341,3578745100,3578745139,39
0,1224,36342,3578745100,3578745140,40
0,1224,36343,3578745100,3578745140,40
0,1224,36344,3578745100,3578745141,41
0,1224,36345,3578745100,3578745142,42
0,1224,36346,3578745100,3578745142,42
0,1224,36347,3578745100,3578745142,42
0,1224,36348,3578745100,3578745143,43
0,1224,36349,3578745100,3578745143,43
0,1224,36350,3578745100,3578745143,43
0,1224,36351,3578745100,3578745144,44
0,1224,36352,3578745100,3578745144,44
0,1224,36353,3578745100,3578745145,45
0,1224,36354,3578745100,3578745145,45
0,1224,36355,3578745100,3578745147,47
0,1224,36356,3578745100,3578745147,47
0,1224,36357,3578745100,3578745147,47
0,1224,36358,3578745100,3578745149,49
0,1225,36359,3578745161,3578745161,0
0,1225,36360,3578745161,3578745161,0
0,1225,36361,3578745161,3578745161,0
0,1225,36362,3578745161,3578745161,0
0,1225,36363,3578745161,3578745161,0
0,1225,36364,3578745161,3578745161,0
0,1225,36365,3578745161,3578745161,0
0,1225,36366,3578745161,3578745161,0
0,1225,36367,3578745161,3578745161,0
0,1225,36368,3578745161,3578745161,0
0,1225,36369,3578745161,3578745161,0
0,1225,36370,3578745161,3578745161,0
0,1225,36371,3578745161,3578745161,0
0,1225,36372,3578745161,3578745161,0
0,1225,36373,3578745161,3578745162,1
0,1225,36374,3578745161,3578745162,1
0,1225,36375,3578745161,3578745163,2
0,1225,36376,3578745161,3578745163,2
0,1225,36377,3578745161,3578745165,4
0,1225,36378,3578745161,3578745165,4
0,1225,36379,3578745161,3578745166,5
0,1225,36380,3578745161,3578745166,5
0,1225,36381,3578745161,3578745167,6
0,1225,36382,3578745161,3578745168,7
0,1225,36383,3578745161,3578745168,7
0,1225,36384,3578745161,3578745169,8
0,1225,36385,3578745161,3578745169,8
0,1225,36386,3578745161,3578745170,9
0,1225,36387,3578745161,3578745170,9
0,1225,36388,3578745161,3578745171,10
0,1225,36389,3578745161,3578745171,10
0,1225,36390,3578745161,3578745172,11
0,1225,36391,3578745161,3578745173,12
0,1225,36392,3578745161,3578745174,13
0,1225,36393,3578745161,3578745174,13
0,1225,36394,3578745161,3578745174,13
0,1225,36395,3578745161,3578745176,15
0,1225,36396,3578745161,3578745177,16
0,1225,36397,3578745161,3578745179,18
0,1225,36398,3578745161,3578745179,18
0,1225,36399,3578745161,3578745180,19
0,1225,36400,3578745161,3578745180,19
0,1225,36401,3578745161,3578745180,19
0,1225,36402,3578745161,3578745180,19
0,1225,36403,3578745161,3578745181,20
0,1225,36404,3578745161,3578745181,20
0,1225,36405,3578745161,3578745184,23
0,1225,36406,3578745161,3578745185,24
0,1225,36407,3578745161,3578745186,25
0,1225,36408,3578745161,3578745187,26
0,1225,36409,3578745161,3578745187,26
0,1225,36410,3578745161,3578745188,27
0,1225,36411,3578745161,3578745189,28
0,1225,36412,3578745161,3578745189,28
0,1225,36413,3578745161,3578745189,28
0,1225,36414,3578745161,3578745189,28
0,1225,36415,3578745161,3578745190,29
0,1225,36416,3578745161,3578745190,29
0,1225,36417,3578745161,3578745191,30
0,1225,36418,3578745161,3578745193,32
0,1225,36419,3578745161,3578745193,32
0,1225,36420,3578745161,3578745194,33
0,1225,36421,3578745161,3578745195,34
0,1225,36422,3578745161,3578745196,35
0,1225,36423,3578745161,3578745200,39
0,1225,36424,3578745161,3578745200,39
0,1225,36425,3578745161,3578745201,40
0,1225,36426,3578745161,3578745201,40
0,1225,36427,3578745161,3578745203,42
0,1225,36428,3578745161,3578745203,42
0,1225,36429,3578745161,3578745204,43
0,1225,36430,3578745161,3578745205,44
0,1225,36431,3578745161,3578745205,44
0,1225,36432,3578745161,3578745205,44
0,1225,36433,3578745161,3578745205,44
0,1225,36434,3578745161,3578745206,45
0,1225,36435,3578745161,3578745207,46
0,1225,36436,3578745161,3578745208,47
0,1225,36437,3578745161,3578745208,47
0,1225,36438,3578745161,3578745209,48
0,1225,36439,3578745161,3578745209,48
0,1225,36440,3578745161,3578745210,49
0,1226,36441,3578745222,3578745222,0
0,1226,36442,3578745222,3578745222,0
0,1226,36443,3578745222,3578745222,0
0,1226,36444,3578745222,3578745222,0
0,1226,36445,3578745222,3578745222,0
0,1226,36446,3578745222,3578745222,0
0,1226,36447,3578745222,3578745222,0
0,1226,36448,3578745222,3578745222,0
0,1226,36449,3578745222,3578745222,0
0,1226,36450,3578745222,3578745222,0
0,1226,36451,3578745222,3578745222,0
0,1226,36452,3578745222,3578745222,0
0,1226,36453,3578745222,3578745222,0
0,1226,36454,3578745222,3578745222,0
0,1226,36455,3578745222,3578745222,0
0,1226,36456,3578745222,3578745222,0
0,1226,36457,3578745222,3578745222,0
0,1226,36458,3578745222,3578745222,0
0,1226,36459,3578745222,3578745223,1
0,1226,36460,3578745222,3578745223,1
0,1226,36461,3578745222,3578745224,2
0,1226,36462,3578745222,3578745225,3
0,1226,36463,3578745222,3578745226,4
0,1226,36464,3578745222,3578745226,4
0,1226,36465,3578745222,3578745226,4
0,1226,36466,3578745222,3578745227,5
0,1226,36467,3578745222,3578745230,8
0,1226,36468,3578745222,3578745231,9
0,1226,36469,3578745222,3578745232,10
0,1226,36470,3578745222,3578745234,12
0,1226,36471,3578745222,3578745234,12
0,1226,36472,3578745222,3578745236,14
0,1226,36473,3578745222,3578745236,14
0,1226,36474,3578745222,3578745238,16
0,1226,36475,3578745222,3578745238,16
0,1226,36476,3578745222,3578745238,16
0,1226,36477,3578745222,3578745240,18
0,1226,36478,3578745222,3578745241,19
0,1226,36479,3578745222,3578745243,21
0,1226,36480,3578745222,3578745243,21
0,1226,36481,3578745222,3578745244,22
0,1226,36482,3578745222,3578745247,25
0,1226,36483,3578745222,3578745247,25
0,1226,36484,3578745222,3578745248,26
0,1226,36485,3578745222,3578745249,27
0,1226,36486,3578745222,3578745249,27
0,1226,36487,3578745222,3578745250,28
0,1226,36488,3578745222,3578745250,28
0,1226,36489,3578745222,3578745250,28
0,1226,36490,3578745222,3578745250,28
0,1226,36491,3578745222,3578745253,31
0,1226,36492,3578745222,3578745254,32
0,1226,36493,3578745222,3578745256,34
0,1226,36494,3578745222,3578745257,35
0,1226,36495,3578745222,3578745257,35
0,1226,36496,3578745222,3578745257,35
0,1226,36497,3578745222,3578745259,37
0,1226,36498,3578745222,3578745259,37
0,1226,36499,3578745222,3578745260,38
0,1226,36500,3578745222,3578745261,39
0,1226,36501,3578745222,3578745262,40
0,1226,36502,3578745222,3578745262,40
0,1226,36503,3578745222,3578745262,40
0,1226,36504,3578745222,3578745262,40
0,1226,36505,3578745222,3578745265,43
0,1226,36506,3578745222,3578745266,44
0,1226,36507,3578745222,3578745268,46
0,1226,36508,3578745222,3578745268,46
0,1227,36509,3578745285,3578745285,0
0,1227,36510,3578745285,3578745285,0
0,1227,36511,3578745285,3578745285,0
0,1227,36512,3578745285,3578745285,0
0,1227,36513,3578745285,3578745285,0
0,1227,36514,3578745285,3578745285,0
0,1227,36515,3578745285,3578745285,0
0,1227,36516,3578745285,3578745285,0
0,1227,36517,3578745285,3578745285,0
0,1227,36518,3578745285,3578745285,0
0,1227,36519,3578745285,3578745285,0
0,1227,36520,3578745285,3578745285,0
0,1227,36521,3578745285,3578745287,2
0,1227,36522,3578745285,3578745287,2
0,1227,36523,3578745285,3578745287,2
0,1227,36524,3578745285,3578745287,2
0,1227,36525,3578745285,3578745288,3
0,1227,36526,3578745285,3578745288,3
0,1227,36527,3578745285,3578745289,4
0,1227,36528,3578745285,3578745289,4
0,1227,36529,3578745285,3578745289,4
0,1227,36530,3578745285,3578745290,5
0,1227,36531,3578745285,3578745290,5
0,1227,36532,3578745285,3578745290,5
0,1227,36533,3578745285,3578745291,6
0,1227,36534,3578745285,3578745292,7
0,1227,36535,3578745285,3578745292,7
0,1227,36536,3578745285,3578745293,8
0,1227,36537,3578745285,3578745293,8
0,1227,36538,3578745285,3578745296,11
0,1227,36539,3578745285,3578745297,12
0,1227,36540,3578745285,3578745298,13
0,1227,36541,3578745285,3578745298,13
0,1227,36542,3578745285,3578745299,14
0,1227,36543,3578745285,3578745299,14
0,1227,36544,3578745285,3578745302,17
0,1227,36545,3578745285,3578745302,17
0,1227,36546,3578745285,3578745303,18
0,1227,36547,3578745285,3578745303,18
0,1227,36548,3578745285,3578745303,18
0,1227,36549,3578745285,3578745304,19
0,1227,36550,3578745285,3578745305,20
0,1227,36551,3578745285,3578745305,20
0,1227,36552,3578745285,3578745305,20
0,1227,36553,3578745285,3578745306,21
0,1227,36554,3578745285,3578745306,21
0,1227,36555,3578745285,3578745307,22
0,1227,36556,3578745285,3578745308,23
0,1227,36557,3578745285,3578745308,23
0,1227,36558,3578745285,3578745308,23
0,1227,36559,3578745285,3578745308,23
0,1227,36560,3578745285,3578745308,23
0,1227,36561,3578745285,3578745309,24
0,1227,36562,3578745285,3578745310,25
0,1227,36563,3578745285,3578745312,27
0,1227,36564,3578745285,3578745314,29
0,1227,36565,3578745285,3578745314,29
0,1227,36566,3578745285,3578745315,30
0,1227,36567,3578745285,3578745315,30
0,1227,36568,3578745285,3578745316,31
0,1227,36569,3578745285,3578745316,31
0,1227,36570,3578745285,3578745316,31
0,1227,36571,3578745285,3578745316,31
0,1227,36572,3578745285,3578745316,31
0,1227,36573,3578745285,3578745316,31
0,1227,36574,3578745285,3578745317,32
0,1227,36575,3578745285,3578745317,32
0,1227,36576,3578745285,3578745317,32
0,1227,36577,3578745285,3578745317,32
0,1227,36578,3578745285,3578745319,34
0,1227,36579,3578745285,3578745322,37
0,1227,36580,3578745285,3578745327,42
0,1227,36581,3578745285,3578745328,43
0,1227,36582,3578745285,3578745328,43
0,1227,36583,3578745285,3578745328,43
0,1227,36584,3578745285,3578745328,43
0,1227,36585,3578745285,3578745329,44
0,1227,36586,3578745285,3578745329,44
0,1227,36587,3578745285,3578745330,45
0,1227,36588,3578745285,3578745331,46
0,1227,36589,3578745285,3578745331,46
0,1227,36590,3578745285,3578745331,46
0,1227,36591,3578745285,3578745331,46
0,1227,36592,3578745285,3578745332,47
0,1227,36593,3578745285,3578745333,48
0,1227,36594,3578745285,3578745333,48
0,1227,36595,3578745285,3578745334,49
0,1228,36596,3578745346,3578745346,0
0,1228,36597,3578745346,3578745346,0
0,1228,36598,3578745346,3578745346,0
0,1228,36599,3578745346,3578745346,0
0,1228,36600,3578745346,3578745346,0
0,1228,36601,3578745346,3578745346,0
0,1228,36602,3578745346,3578745346,0
0,1228,36603,3578745346,3578745346,0
0,1228,36604,3578745346,3578745346,0
0,1228,36605,3578745346,3578745346,0
0,1228,36606,3578745346,3578745346,0
0,1228,36607,3578745346,3578745346,0
0,1228,36608,3578745346,3578745346,0
0,1228,36609,3578745346,3578745346,0
0,1228,36610,3578745346,3578745346,0
0,1228,36611,3578745346,3578745346,0
0,1228,36612,3578745346,3578745346,0
0,1228,36613,3578745346,3578745346,0
0,1228,36614,3578745346,3578745347,1
0,1228,36615,3578745346,3578745348,2
0,1228,36616,3578745346,3578745351,5
0,1228,36617,3578745346,3578745352,6
0,1228,36618,3578745346,3578745353,7
0,1228,36619,3578745346,3578745354,8
0,1228,36620,3578745346,3578745355,9
0,1228,36621,3578745346,3578745355,9
0,1228,36622,3578745346,3578745355,9
0,1228,36623,3578745346,3578745357,11
0,1228,36624,3578745346,3578745357,11
0,1228,36625,3578745346,3578745359,13
0,1228,36626,3578745346,3578745359,13
0,1228,36627,3578745346,3578745361,15
0,1228,36628,3578745346,3578745362,16
0,1228,36629,3578745346,3578745362,16
0,1228,36630,3578745346,3578745363,17
0,1228,36631,3578745346,3578745363,17
0,1228,36632,3578745346,3578745364,18
0,1228,36633,3578745346,3578745366,20
0,1228,36634,3578745346,3578745366,20
0,1228,36635,3578745346,3578745367,21
0,1228,36636,3578745346,3578745367,21
0,1228,36637,3578745346,3578745367,21
0,1228,36638,3578745346,3578745369,23
0,1228,36639,3578745346,3578745369,23
0,1228,36640,3578745346,3578745369,23
0,1228,36641,3578745346,3578745369,23
0,1228,36642,3578745346,3578745370,24
0,1228,36643,3578745346,3578745370,24
0,1228,36644,3578745346,3578745371,25
0,1228,36645,3578745346,3578745372,26
0,1228,36646,3578745346,3578745373,27
0,1228,36647,3578745346,3578745373,27
0,1228,36648,3578745346,3578745374,28
0,1228,36649,3578745346,3578745375,29
0,1228,36650,3578745346,3578745377,31
0,1228,36651,3578745346,3578745377,31
0,1228,36652,3578745346,3578745378,32
0,1228,36653,3578745346,3578745379,33
0,1228,36654,3578745346,3578745379,33
0,1228,36655,3578745346,3578745380,34
0,1228,36656,3578745346,3578745381,35
0,1228,36657,3578745346,3578745381,35
0,1228,36658,3578745346,3578745381,35
0,1228,36659,3578745346,3578745382,36
0,1228,36660,3578745346,3578745385,39
0,1228,36661,3578745346,3578745385,39
0,1228,36662,3578745346,3578745386,40
0,1228,36663,3578745346,3578745387,41
0,1228,36664,3578745346,3578745388,42
0,1228,36665,3578745346,3578745388,42
0,1228,36666,3578745346,3578745389,43
0,1228,36667,3578745346,3578745389,43
0,1228,36668,3578745346,3578745389,43
0,1228,36669,3578745346,3578745390,44
0,1228,36670,3578745346,3578745390,44
0,1228,36671,3578745346,3578745390,44
0,1228,36672,3578745346,3578745391,45
0,1228,36673,3578745346,3578745394,48
0,1228,36674,3578745346,3578745394,48
0,1228,36675,3578745346,3578745395,49
0,1228,36676,3578745346,3578745395,49
0,1228,36677,3578745346,3578745396,50
0,1229,36678,3578745407,3578745407,0
0,1229,36679,3578745407,3578745407,0
0,1229,36680,3578745407,3578745407,0
0,1229,36681,3578745407,3578745407,0
0,1229,36682,3578745407,3578745407,0
0,1229,36683,3578745407,3578745407,0
0,1229,36684,3578745407,3578745407,0
0,1229,36685,3578745407,3578745407,0
0,1229,36686,3578745407,3578745407,0
0,1229,36687,3578745407,3578745407,0
0,1229,36688,3578745407,3578745407,0
0,1229,36689,3578745407,3578745407,0
0,1229,36690,3578745407,3578745408,1
0,1229,36691,3578745407,3578745409,2
0,1229,36692,3578745407,3578745409,2
0,1229,36693,3578745407,3578745409,2
0,1229,36694,3578745407,3578745411,4
0,1229,36695,3578745407,3578745411,4
0,1229,36696,3578745407,3578745411,4
0,1229,36697,3578745407,3578745411,4
0,1229,36698,3578745407,3578745413,6
0,1229,36699,3578745407,3578745414,7
0,1229,36700,3578745407,3578745415,8
0,1229,36701,3578745407,3578745415,8
0,1229,36702,3578745407,3578745416,9
0,1229,36703,3578745407,3578745416,9
0,1229,36704,3578745407,3578745416,9
0,1229,36705,3578745407,3578745418,11
0,1229,36706,3578745407,3578745418,11
0,1229,36707,3578745407,3578745419,12
0,1229,36708,3578745407,3578745419,12
0,1229,36709,3578745407,3578745419,12
0,1229,36710,3578745407,3578745419,12
0,1229,36711,3578745407,3578745420,13
0,1229,36712,3578745407,3578745420,13
0,1229,36713,3578745407,3578745422,15
0,1229,36714,3578745407,3578745423,16
0,1229,36715,3578745407,3578745423,16
0,1229,36716,3578745407,3578745425,18
0,1229,36717,3578745407,3578745425,18
0,1229,36718,3578745407,3578745426,19
0,1229,36719,3578745407,3578745426,19
0,1229,36720,3578745407,3578745427,20
0,1229,36721,3578745407,3578745427,20
0,1229,36722,3578745407,3578745430,23
0,1229,36723,3578745407,3578745431,24
0,1229,36724,3578745407,3578745432,25
0,1229,36725,3578745407,3578745433,26
0,1229,36726,3578745407,3578745434,27
0,1229,36727,3578745407,3578745435,28
0,1229,36728,3578745407,3578745436,29
0,1229,36729,3578745407,3578745437,30
0,1229,36730,3578745407,3578745438,31
0,1229,36731,3578745407,3578745438,31
0,1229,36732,3578745407,3578745439,32
0,1229,36733,3578745407,3578745439,32
0,1229,36734,3578745407,3578745439,32
0,1229,36735,3578745407,3578745441,34
0,1229,36736,3578745407,3578745441,34
0,1229,36737,3578745407,3578745444,37
0,1229,36738,3578745407,3578745444,37
0,1229,36739,3578745407,3578745445,38
0,1229,36740,3578745407,3578745447,40
0,1229,36741,3578745407,3578745449,42
0,1229,36742,3578745407,3578745449,42
0,1229,36743,3578745407,3578745449,42
0,1229,36744,3578745407,3578745450,43
0,1229,36745,3578745407,3578745450,43
0,1229,36746,3578745407,3578745450,43
0,1229,36747,3578745407,3578745450,43
0,1229,36748,3578745407,3578745453,46
0,1229,36749,3578745407,3578745455,48
0,1229,36750,3578745407,3578745456,49
0,1229,36751,3578745407,3578745457,50
0,1230,36752,3578745470,3578745470,0
0,1230,36753,3578745470,3578745470,0
0,1230,36754,3578745470,3578745470,0
0,1230,36755,3578745470,3578745470,0
0,1230,36756,3578745470,3578745470,0
0,1230,36757,3578745470,3578745470,0
0,1230,36758,3578745470,3578745470,0
0,1230,36759,3578745470,3578745470,0
0,1230,36760,3578745470,3578745470,0
0,1230,36761,3578745470,3578745470,0
0,1230,36762,3578745470,3578745470,0
0,1230,36763,3578745470,3578745470,0
0,1230,36764,3578745470,3578745470,0
0,1230,36765,3578745470,3578745470,0
0,1230,36766,3578745470,3578745470,0
0,1230,36767,3578745470,3578745476,6
0,1230,36768,3578745470,3578745478,8
0,1230,36769,3578745470,3578745479,9
0,1230,36770,3578745470,3578745479,9
0,1230,36771,3578745470,3578745480,10
0,1230,36772,3578745470,3578745480,10
0,1230,36773,3578745470,3578745481,11
0,1230,36774,3578745470,3578745483,13
0,1230,36775,3578745470,3578745484,14
0,1230,36776,3578745470,3578745484,14
0,1230,36777,3578745470,3578745485,15
0,1230,36778,3578745470,3578745486,16
0,1230,36779,3578745470,3578745487,17
0,1230,36780,3578745470,3578745488,18
0,1230,36781,3578745470,3578745488,18
0,1230,36782,3578745470,3578745488,18
0,1230,36783,3578745470,3578745489,19
0,1230,36784,3578745470,3578745489,19
0,1230,36785,3578745470,3578745489,19
0,1230,36786,3578745470,3578745490,20
0,1230,36787,3578745470,3578745490,20
0,1230,36788,3578745470,3578745490,20
0,1230,36789,3578745470,3578745492,22
0,1230,36790,3578745470,3578745493,23
0,1230,36791,3578745470,3578745493,23
0,1230,36792,3578745470,3578745493,23
0,1230,36793,3578745470,3578745493,23
0,1230,36794,3578745470,3578745496,26
0,1230,36795,3578745470,3578745498,28
0,1230,36796,3578745470,3578745498,28
0,1230,36797,3578745470,3578745498,28
0,1230,36798,3578745470,3578745498,28
0,1230,36799,3578745470,3578745499,29
0,1230,36800,3578745470,3578745502,32
0,1230,36801,3578745470,3578745502,32
0,1230,36802,3578745470,3578745502,32
0,1230,36803,3578745470,3578745503,33
0,1230,36804,3578745470,3578745504,34
0,1230,36805,3578745470,3578745504,34
0,1230,36806,3578745470,3578745505,35
0,1230,36807,3578745470,3578745505,35
0,1230,36808,3578745470,3578745506,36
0,1230,36809,3578745470,3578745506,36
0,1230,36810,3578745470,3578745506,36
0,1230,36811,3578745470,3578745507,37
0,1230,36812,3578745470,3578745507,37
0,1230,36813,3578745470,3578745507,37
0,1230,36814,3578745470,3578745508,38
0,1230,36815,3578745470,3578745508,38
0,1230,36816,3578745470,3578745509,39
0,1230,36817,3578745470,3578745509,39
0,1230,36818,3578745470,3578745510,40
0,1230,36819,3578745470,3578745510,40
0,1230,36820,3578745470,3578745512,42
0,1230,36821,3578745470,3578745514,44
0,1230,36822,3578745470,3578745515,45
0,1230,36823,3578745470,3578745515,45
0,1230,36824,3578745470,3578745515,45
0,1230,36825,3578745470,3578745516,46
0,1230,36826,3578745470,3578745516,46
0,1230,36827,3578745470,3578745516,46
0,1230,36828,3578745470,3578745516,46
0,1230,36829,3578745470,3578745516,46
0,1230,36830,3578745470,3578745517,47
0,1230,36831,3578745470,3578745517,47
0,1230,36832,3578745470,3578745517,47
0,1230,36833,3578745470,3578745518,48
0,1230,36834,3578745470,3578745518,48
0,1230,36835,3578745470,3578745518,48
0,1230,36836,3578745470,3578745519,49
0,1231,36837,3578745534,3578745534,0
0,1231,36838,3578745534,3578745534,0
0,1231,36839,3578745534,3578745534,0
0,1231,36840,3578745534,3578745534,0
0,1231,36841,3578745534,3578745534,0
0,1231,36842,3578745534,3578745534,0
0,1231,36843,3578745534,3578745534,0
0,1231,36844,3578745534,3578745534,0
0,1231,36845,3578745534,3578745534,0
0,1231,36846,3578745534,3578745534,0
0,1231,36847,3578745534,3578745534,0
0,1231,36848,3578745534,3578745534,0
0,1231,36849,3578745534,3578745534,0
0,1231,36850,3578745534,3578745534,0
0,1231,36851,3578745534,3578745534,0
0,1231,36852,3578745534,3578745534,0
0,1231,36853,3578745534,3578745534,0
0,1231,36854,3578745534,3578745534,0
0,1231,36855,3578745534,3578745534,0
0,1231,36856,3578745534,3578745534,0
0,1231,36857,3578745534,3578745534,0
0,1231,36858,3578745534,3578745534,0
0,1231,36859,3578745534,3578745534,0
0,1231,36860,3578745534,3578745534,0
0,1231,36861,3578745534,3578745535,1
0,1231,36862,3578745534,3578745536,2
0,1231,36863,3578745534,3578745537,3
0,1231,36864,3578745534,3578745539,5
0,1231,36865,3578745534,3578745539,5
0,1231,36866,3578745534,3578745539,5
0,1231,36867,3578745534,3578745540,6
0,1231,36868,3578745534,3578745541,7
0,1231,36869,3578745534,3578745541,7
0,1231,36870,3578745534,3578745542,8
0,1231,36871,3578745534,3578745542,8
0,1231,36872,3578745534,3578745542,8
0,1231,36873,3578745534,3578745542,8
0,1231,36874,3578745534,3578745543,9
0,1231,36875,3578745534,3578745544,10
0,1231,36876,3578745534,3578745544,10
0,1231,36877,3578745534,3578745545,11
0,1231,36878,3578745534,3578745545,11
0,1231,36879,3578745534,3578745545,11
0,1231,36880,3578745534,3578745545,11
0,1231,36881,3578745534,3578745547,13
0,1231,36882,3578745534,3578745547,13
0,1231,36883,3578745534,3578745550,16
0,1231,36884,3578745534,3578745552,18
0,1231,36885,3578745534,3578745553,19
0,1231,36886,3578745534,3578745554,20
0,1231,36887,3578745534,3578745554,20
0,1231,36888,3578745534,3578745556,22
0,1231,36889,3578745534,3578745556,22
0,1231,36890,3578745534,3578745557,23
0,1231,36891,3578745534,3578745558,24
0,1231,36892,3578745534,3578745558,24
0,1231,36893,3578745534,3578745558,24
0,1231,36894,3578745534,3578745560,26
0,1231,36895,3578745534,3578745560,26
0,1231,36896,3578745534,3578745560,26
0,1231,36897,3578745534,3578745561,27
0,1231,36898,3578745534,3578745561,27
0,1231,36899,3578745534,3578745562,28
0,1231,36900,3578745534,3578745563,29
0,1231,36901,3578745534,3578745564,30
0,1231,36902,3578745534,3578745564,30
0,1231,36903,3578745534,3578745566,32
0,1231,36904,3578745534,3578745567,33
0,1231,36905,3578745534,3578745567,33
0,1231,36906,3578745534,3578745567,33
0,1231,36907,3578745534,3578745568,34
0,1231,36908,3578745534,3578745568,34
0,1231,36909,3578745534,3578745569,35
0,1231,36910,3578745534,3578745570,36
0,1231,36911,3578745534,3578745570,36
0,1231,36912,3578745534,3578745570,36
0,1231,36913,3578745534,3578745570,36
0,1231,36914,3578745534,3578745573,39
0,1231,36915,3578745534,3578745573,39
0,1231,36916,3578745534,3578745573,39
0,1231,36917,3578745534,3578745574,40
0,1231,36918,3578745534,3578745574,40
0,1231,36919,3578745534,3578745575,41
0,1231,36920,3578745534,3578745576,42
0,1231,36921,3578745534,3578745578,44
0,1231,36922,3578745534,3578745578,44
0,1231,36923,3578745534,3578745578,44
0,1231,36924,3578745534,3578745579,45
0,1231,36925,3578745534,3578745579,45
0,1231,36926,3578745534,3578745579,45
0,1231,36927,3578745534,3578745580,46
0,1231,36928,3578745534,3578745580,46
0,1231,36929,3578745534,3578745584,50
0,1232,36930,3578745597,3578745597,0
0,1232,36931,3578745597,3578745597,0
0,1232,36932,3578745597,3578745597,0
0,1232,36933,3578745597,3578745597,0
0,1232,36934,3578745597,3578745597,0
0,1232,36935,3578745597,3578745597,0
0,1232,36936,3578745597,3578745597,0
0,1232,36937,3578745597,3578745597,0
0,1232,36938,3578745597,3578745597,0
0,1232,36939,3578745597,3578745597,0
0,1232,36940,3578745597,3578745597,0
0,1232,36941,3578745597,3578745597,0
0,1232,36942,3578745597,3578745597,0
0,1232,36943,3578745597,3578745597,0
0,1232,36944,3578745597,3578745597,0
0,1232,36945,3578745597,3578745597,0
0,1232,36946,3578745597,3578745597,0
0,1232,36947,3578745597,3578745599,2
0,1232,36948,3578745597,3578745601,4
0,1232,36949,3578745597,3578745602,5
0,1232,36950,3578745597,3578745603,6
0,1232,36951,3578745597,3578745603,6
0,1232,36952,3578745597,3578745603,6
0,1232,36953,3578745597,3578745604,7
0,1232,36954,3578745597,3578745604,7
0,1232,36955,3578745597,3578745604,7
0,1232,36956,3578745597,3578745605,8
0,1232,36957,3578745597,3578745606,9
0,1232,36958,3578745597,3578745607,10
0,1232,36959,3578745597,3578745608,11
0,1232,36960,3578745597,3578745608,11
0,1232,36961,3578745597,3578745609,12
0,1232,36962,3578745597,3578745610,13
0,1232,36963,3578745597,3578745610,13
0,1232,36964,3578745597,3578745611,14
0,1232,36965,3578745597,3578745612,15
0,1232,36966,3578745597,3578745613,16
0,1232,36967,3578745597,3578745614,17
0,1232,36968,3578745597,3578745614,17
0,1232,36969,3578745597,3578745614,17
0,1232,36970,3578745597,3578745615,18
0,1232,36971,3578745597,3578745616,19
0,1232,36972,3578745597,3578745617,20
0,1232,36973,3578745597,3578745617,20
0,1232,36974,3578745597,3578745617,20
0,1232,36975,3578745597,3578745618,21
0,1232,36976,3578745597,3578745619,22
0,1232,36977,3578745597,3578745619,22
0,1232,36978,3578745597,3578745619,22
0,1232,36979,3578745597,3578745621,24
0,1232,36980,3578745597,3578745622,25
0,1232,36981,3578745597,3578745622,25
0,1232,36982,3578745597,3578745624,27
0,1232,36983,3578745597,3578745624,27
0,1232,36984,3578745597,3578745625,28
0,1232,36985,3578745597,3578745625,28
0,1232,36986,3578745597,3578745626,29
0,1232,36987,3578745597,3578745627,30
0,1232,36988,3578745597,3578745629,32
0,1232,36989,3578745597,3578745631,34
0,1232,36990,3578745597,3578745632,35
0,1232,36991,3578745597,3578745632,35
0,1232,36992,3578745597,3578745633,36
0,1232,36993,3578745597,3578745636,39
0,1232,36994,3578745597,3578745636,39
0,1232,36995,3578745597,3578745637,40
0,1232,36996,3578745597,3578745637,40
0,1232,36997,3578745597,3578745638,41
0,1232,36998,3578745597,3578745638,41
0,1232,36999,3578745597,3578745639,42
0,1232,37000,3578745597,3578745639,42
0,1232,37001,3578745597,3578745639,42
0,1232,37002,3578745597,3578745641,44
0,1232,37003,3578745597,3578745642,45
0,1232,37004,3578745597,3578745643,46
0,1232,37005,3578745597,3578745643,46
0,1232,37006,3578745597,3578745644,47
0,1232,37007,3578745597,3578745647,50
0,1233,37008,3578745658,3578745658,0
0,1233,37009,3578745658,3578745658,0
0,1233,37010,3578745658,3578745658,0
0,1233,37011,3578745658,3578745658,0
0,1233,37012,3578745658,3578745658,0
0,1233,37013,3578745658,3578745658,0
0,1233,37014,3578745658,3578745658,0
0,1233,37015,3578745658,3578745658,0
0,1233,37016,3578745658,3578745658,0
0,1233,37017,3578745658,3578745658,0
0,1233,37018,3578745658,3578745659,1
0,1233,37019,3578745658,3578745659,1
0,1233,37020,3578745658,3578745659,1
0,1233,37021,3578745658,3578745659,1
0,1233,37022,3578745658,3578745660,2
0,1233,37023,3578745658,3578745661,3
0,1233,37024,3578745658,3578745661,3
0,1233,37025,3578745658,3578745662,4
0,1233,37026,3578745658,3578745662,4
0,1233,37027,3578745658,3578745663,5
0,1233,37028,3578745658,3578745663,5
0,1233,37029,3578745658,3578745664,6
0,1233,37030,3578745658,3578745665,7
0,1233,37031,3578745658,3578745665,7
0,1233,37032,3578745658,3578745666,8
0,1233,37033,3578745658,3578745667,9
0,1233,37034,3578745658,3578745676,18
0,1233,37035,3578745658,3578745678,20
0,1233,37036,3578745658,3578745679,21
0,1233,37037,3578745658,3578745679,21
0,1233,37038,3578745658,3578745680,22
0,1233,37039,3578745658,3578745680,22
0,1233,37040,3578745658,3578745681,23
0,1233,37041,3578745658,3578745682,24
0,1233,37042,3578745658,3578745683,25
0,1233,37043,3578745658,3578745684,26
0,1233,37044,3578745658,3578745684,26
0,1233,37045,3578745658,3578745685,27
0,1233,37046,3578745658,3578745685,27
0,1233,37047,3578745658,3578745686,28
0,1233,37048,3578745658,3578745687,29
0,1233,37049,3578745658,3578745687,29
0,1233,37050,3578745658,3578745687,29
0,1233,37051,3578745658,3578745687,29
0,1233,37052,3578745658,3578745688,30
0,1233,37053,3578745658,3578745689,31
0,1233,37054,3578745658,3578745689,31
0,1233,37055,3578745658,3578745690,32
0,1233,37056,3578745658,3578745690,32
0,1233,37057,3578745658,3578745690,32
0,1233,37058,3578745658,3578745691,33
0,1233,37059,3578745658,3578745692,34
0,1233,37060,3578745658,3578745693,35
0,1233,37061,3578745658,3578745693,35
0,1233,37062,3578745658,3578745693,35
0,1233,37063,3578745658,3578745696,38
0,1233,37064,3578745658,3578745698,40
0,1233,37065,3578745658,3578745698,40
0,1233,37066,3578745658,3578745699,41
0,1233,37067,3578745658,3578745702,44
0,1233,37068,3578745658,3578745702,44
0,1233,37069,3578745658,3578745702,44
0,1233,37070,3578745658,3578745702,44
0,1233,37071,3578745658,3578745703,45
0,1233,37072,3578745658,3578745703,45
0,1233,37073,3578745658,3578745704,46
0,1233,37074,3578745658,3578745705,47
0,1233,37075,3578745658,3578745705,47
0,1233,37076,3578745658,3578745706,48
0,1233,37077,3578745658,3578745707,49
0,1233,37078,3578745658,3578745708,50
0,1234,37079,3578745720,3578745720,0
0,1234,37080,3578745720,3578745720,0
0,1234,37081,3578745720,3578745720,0
0,1234,37082,3578745720,3578745720,0
0,1234,37083,3578745720,3578745720,0
0,1234,37084,3578745720,3578745720,0
0,1234,37085,3578745720,3578745720,0
0,1234,37086,3578745720,3578745720,0
0,1234,37087,3578745720,3578745720,0
0,1234,37088,3578745720,3578745720,0
0,1234,37089,3578745720,3578745720,0
0,1234,37090,3578745720,3578745720,0
0,1234,37091,3578745720,3578745720,0
0,1234,37092,3578745720,3578745720,0
0,1234,37093,3578745720,3578745720,0
0,1234,37094,3578745720,3578745720,0
0,1234,37095,3578745720,3578745720,0
0,1234,37096,3578745720,3578745720,0
0,1234,37097,3578745720,3578745720,0
0,1234,37098,3578745720,3578745720,0
0,1234,37099,3578745720,3578745720,0
0,1234,37100,3578745720,3578745720,0
0,1234,37101,3578745720,3578745720,0
0,1234,37102,3578745720,3578745720,0
0,1234,37103,3578745720,3578745720,0
0,1234,37104,3578745720,3578745721,1
0,1234,37105,3578745720,3578745722,2
0,1234,37106,3578745720,3578745723,3
0,1234,37107,3578745720,3578745723,3
0,1234,37108,3578745720,3578745724,4
0,1234,37109,3578745720,3578745725,5
0,1234,37110,3578745720,3578745727,7
0,1234,37111,3578745720,3578745727,7
0,1234,37112,3578745720,3578745728,8
0,1234,37113,3578745720,3578745728,8
0,1234,37114,3578745720,3578745728,8
0,1234,37115,3578745720,3578745729,9
0,1234,37116,3578745720,3578745730,10
0,1234,37117,3578745720,3578745730,10
0,1234,37118,3578745720,3578745730,10
0,1234,37119,3578745720,3578745731,11
0,1234,37120,3578745720,3578745731,11
0,1234,37121,3578745720,3578745731,11
0,1234,37122,3578745720,3578745732,12
0,1234,37123,3578745720,3578745732,12
0,1234,37124,3578745720,3578745733,13
0,1234,37125,3578745720,3578745733,13
0,1234,37126,3578745720,3578745735,15
0,1234,37127,3578745720,3578745735,15
0,1234,37128,3578745720,3578745736,16
0,1234,37129,3578745720,3578745739,19
0,1234,37130,3578745720,3578745739,19
0,1234,37131,3578745720,3578745739,19
0,1234,37132,3578745720,3578745741,21
0,1234,37133,3578745720,3578745741,21
0,1234,37134,3578745720,3578745741,21
0,1234,37135,3578745720,3578745741,21
0,1234,37136,3578745720,3578745741,21
0,1234,37137,3578745720,3578745742,22
0,1234,37138,3578745720,3578745743,23
0,1234,37139,3578745720,3578745743,23
0,1234,37140,3578745720,3578745743,23
0,1234,37141,3578745720,3578745744,24
0,1234,37142,3578745720,3578745744,24
0,1234,37143,3578745720,3578745745,25
0,1234,37144,3578745720,3578745745,25
0,1234,37145,3578745720,3578745747,27
0,1234,37146,3578745720,3578745747,27
0,1234,37147,3578745720,3578745749,29
0,1234,37148,3578745720,3578745750,30
0,1234,37149,3578745720,3578745753,33
0,1234,37150,3578745720,3578745754,34
0,1234,37151,3578745720,3578745754,34
0,1234,37152,3578745720,3578745754,34
0,1234,37153,3578745720,3578745755,35
0,1234,37154,3578745720,3578745756,36
0,1234,37155,3578745720,3578745757,37
0,1234,37156,3578745720,3578745758,38
0,1234,37157,3578745720,3578745758,38
0,1234,37158,3578745720,3578745759,39
0,1234,37159,3578745720,3578745760,40
0,1234,37160,3578745720,3578745760,40
0,1234,37161,3578745720,3578745761,41
0,1234,37162,3578745720,3578745761,41
0,1234,37163,3578745720,3578745761,41
0,1234,37164,3578745720,3578745762,42
0,1234,37165,3578745720,3578745762,42
0,1234,37166,3578745720,3578745762,42
0,1234,37167,3578745720,3578745764,44
0,1234,37168,3578745720,3578745764,44
0,1234,37169,3578745720,3578745764,44
0,1234,37170,3578745720,3578745766,46
0,1234,37171,3578745720,3578745766,46
0,1234,37172,3578745720,3578745767,47
0,1234,37173,3578745720,3578745768,48
0,1234,37174,3578745720,3578745768,48
0,1234,37175,3578745720,3578745768,48
0,1234,37176,3578745720,3578745769,49
0,1235,37177,3578745782,3578745782,0
0,1235,37178,3578745782,3578745782,0
0,1235,37179,3578745782,3578745782,0
0,1235,37180,3578745782,3578745782,0
0,1235,37181,3578745782,3578745782,0
0,1235,37182,3578745782,3578745782,0
0,1235,37183,3578745782,3578745782,0
0,1235,37184,3578745782,3578745782,0
0,1235,37185,3578745782,3578745782,0
0,1235,37186,3578745782,3578745782,0
0,1235,37187,3578745782,3578745782,0
0,1235,37188,3578745782,3578745782,0
0,1235,37189,3578745782,3578745782,0
0,1235,37190,3578745782,3578745782,0
0,1235,37191,3578745782,3578745782,0
0,1235,37192,3578745782,3578745782,0
0,1235,37193,3578745782,3578745782,0
0,1235,37194,3578745782,3578745782,0
0,1235,37195,3578745782,3578745784,2
0,1235,37196,3578745782,3578745785,3
0,1235,37197,3578745782,3578745787,5
0,1235,37198,3578745782,3578745787,5
0,1235,37199,3578745782,3578745788,6
0,1235,37200,3578745782,3578745788,6
0,1235,37201,3578745782,3578745788,6
0,1235,37202,3578745782,3578745788,6
0,1235,37203,3578745782,3578745789,7
0,1235,37204,3578745782,3578745792,10
0,1235,37205,3578745782,3578745792,10
0,1235,37206,3578745782,3578745793,11
0,1235,37207,3578745782,3578745794,12
0,1235,37208,3578745782,3578745795,13
0,1235,37209,3578745782,3578745795,13
0,1235,37210,3578745782,3578745799,17
0,1235,37211,3578745782,3578745800,18
0,1235,37212,3578745782,3578745801,19
0,1235,37213,3578745782,3578745802,20
0,1235,37214,3578745782,3578745803,21
0,1235,37215,3578745782,3578745804,22
0,1235,37216,3578745782,3578745804,22
0,1235,37217,3578745782,3578745804,22
0,1235,37218,3578745782,3578745805,23
0,1235,37219,3578745782,3578745805,23
0,1235,37220,3578745782,3578745806,24
0,1235,37221,3578745782,3578745807,25
0,1235,37222,3578745782,3578745807,25
0,1235,37223,3578745782,3578745808,26
0,1235,37224,3578745782,3578745809,27
0,1235,37225,3578745782,3578745809,27
0,1235,37226,3578745782,3578745810,28
0,1235,37227,3578745782,3578745811,29
0,1235,37228,3578745782,3578745812,30
0,1235,37229,3578745782,3578745812,30
0,1235,37230,3578745782,3578745813,31
0,1235,37231,3578745782,3578745814,32
0,1235,37232,3578745782,3578745815,33
0,1235,37233,3578745782,3578745815,33
0,1235,37234,3578745782,3578745817,35
0,1235,37235,3578745782,3578745817,35
0,1235,37236,3578745782,3578745818,36
0,1235,37237,3578745782,3578745818,36
0,1235,37238,3578745782,3578745819,37
0,1235,37239,3578745782,3578745819,37
0,1235,37240,3578745782,3578745819,37
0,1235,37241,3578745782,3578745821,39
0,1235,37242,3578745782,3578745822,40
0,1235,37243,3578745782,3578745822,40
0,1235,37244,3578745782,3578745824,42
0,1235,37245,3578745782,3578745824,42
0,1235,37246,3578745782,3578745825,43
0,1235,37247,3578745782,3578745827,45
0,1235,37248,3578745782,3578745828,46
0,1235,37249,3578745782,3578745829,47
0,1235,37250,3578745782,3578745831,49
0,1236,37251,3578745843,3578745843,0
0,1236,37252,3578745843,3578745843,0
0,1236,37253,3578745843,3578745843,0
0,1236,37254,3578745843,3578745843,0
0,1236,37255,3578745843,3578745843,0
0,1236,37256,3578745843,3578745843,0
0,1236,37257,3578745843,3578745843,0
0,1236,37258,3578745843,3578745843,0
0,1236,37259,3578745843,3578745843,0
0,1236,37260,3578745843,3578745843,0
0,1236,37261,3578745843,3578745843,0
0,1236,37262,3578745843,3578745843,0
0,1236,37263,3578745843,3578745843,0
0,1236,37264,3578745843,3578745843,0
0,1236,37265,3578745843,3578745843,0
0,1236,37266,3578745843,3578745843,0
0,1236,37267,3578745843,3578745843,0
0,1236,37268,3578745843,3578745844,1
0,1236,37269,3578745843,3578745846,3
0,1236,37270,3578745843,3578745847,4
0,1236,37271,3578745843,3578745847,4
0,1236,37272,3578745843,3578745848,5
0,1236,37273,3578745843,3578745849,6
0,1236,37274,3578745843,3578745849,6
0,1236,37275,3578745843,3578745849,6
0,1236,37276,3578745843,3578745849,6
0,1236,37277,3578745843,3578745850,7
0,1236,37278,3578745843,3578745856,13
0,1236,37279,3578745843,3578745856,13
0,1236,37280,3578745843,3578745857,14
0,1236,37281,3578745843,3578745858,15
0,1236,37282,3578745843,3578745859,16
0,1236,37283,3578745843,3578745859,16
0,1236,37284,3578745843,3578745862,19
0,1236,37285,3578745843,3578745862,19
0,1236,37286,3578745843,3578745862,19
0,1236,37287,3578745843,3578745862,19
0,1236,37288,3578745843,3578745862,19
0,1236,37289,3578745843,3578745863,20
0,1236,37290,3578745843,3578745864,21
0,1236,37291,3578745843,3578745864,21
0,1236,37292,3578745843,3578745865,22
0,1236,37293,3578745843,3578745865,22
0,1236,37294,3578745843,3578745866,23
0,1236,37295,3578745843,3578745868,25
0,1236,37296,3578745843,3578745876,33
0,1236,37297,3578745843,3578745878,35
0,1236,37298,3578745843,3578745879,36
0,1236,37299,3578745843,3578745879,36
0,1236,37300,3578745843,3578745879,36
0,1236,37301,3578745843,3578745879,36
0,1236,37302,3578745843,3578745880,37
0,1236,37303,3578745843,3578745880,37
0,1236,37304,3578745843,3578745881,38
0,1236,37305,3578745843,3578745883,40
0,1236,37306,3578745843,3578745884,41
0,1236,37307,3578745843,3578745884,41
0,1236,37308,3578745843,3578745885,42
0,1236,37309,3578745843,3578745886,43
0,1236,37310,3578745843,3578745887,44
0,1236,37311,3578745843,3578745887,44
0,1236,37312,3578745843,3578745887,44
0,1236,37313,3578745843,3578745887,44
0,1236,37314,3578745843,3578745887,44
0,1236,37315,3578745843,3578745888,45
0,1236,37316,3578745843,3578745889,46
0,1236,37317,3578745843,3578745889,46
0,1236,37318,3578745843,3578745890,47
0,1236,37319,3578745843,3578745890,47
0,1236,37320,3578745843,3578745891,48
0,1236,37321,3578745843,3578745892,49
0,1236,37322,3578745843,3578745893,50
0,1237,37323,3578745905,3578745905,0
0,1237,37324,3578745905,3578745905,0
0,1237,37325,3578745905,3578745905,0
0,1237,37326,3578745905,3578745905,0
0,1237,37327,3578745905,3578745905,0
0,1237,37328,3578745905,3578745905,0
0,1237,37329,3578745905,3578745905,0
0,1237,37330,3578745905,3578745905,0
0,1237,37331,3578745905,3578745905,0
0,1237,37332,3578745905,3578745905,0
0,1237,37333,3578745905,3578745905,0
0,1237,37334,3578745905,3578745905,0
0,1237,37335,3578745905,3578745905,0
0,1237,37336,3578745905,3578745905,0
0,1237,37337,3578745905,3578745905,0
0,1237,37338,3578745905,3578745905,0
0,1237,37339,3578745905,3578745905,0
0,1237,37340,3578745905,3578745906,1
0,1237,37341,3578745905,3578745907,2
0,1237,37342,3578745905,3578745907,2
0,1237,37343,3578745905,3578745907,2
0,1237,37344,3578745905,3578745907,2
0,1237,37345,3578745905,3578745908,3
0,1237,37346,3578745905,3578745908,3
0,1237,37347,3578745905,3578745910,5
0,1237,37348,3578745905,3578745910,5
0,1237,37349,3578745905,3578745910,5
0,1237,37350,3578745905,3578745911,6
0,1237,37351,3578745905,3578745915,10
0,1237,37352,3578745905,3578745915,10
0,1237,37353,3578745905,3578745915,10
0,1237,37354,3578745905,3578745916,11
0,1237,37355,3578745905,3578745916,11
0,1237,37356,3578745905,3578745916,11
0,1237,37357,3578745905,3578745916,11
0,1237,37358,3578745905,3578745917,12
0,1237,37359,3578745905,3578745917,12
0,1237,37360,3578745905,3578745917,12
0,1237,37361,3578745905,3578745918,13
0,1237,37362,3578745905,3578745918,13
0,1237,37363,3578745905,3578745918,13
0,1237,37364,3578745905,3578745918,13
0,1237,37365,3578745905,3578745919,14
0,1237,37366,3578745905,3578745919,14
0,1237,37367,3578745905,3578745921,16
0,1237,37368,3578745905,3578745922,17
0,1237,37369,3578745905,3578745923,18
0,1237,37370,3578745905,3578745924,19
0,1237,37371,3578745905,3578745927,22
0,1237,37372,3578745905,3578745927,22
0,1237,37373,3578745905,3578745928,23
0,1237,37374,3578745905,3578745928,23
0,1237,37375,3578745905,3578745928,23
0,1237,37376,3578745905,3578745929,24
0,1237,37377,3578745905,3578745929,24
0,1237,37378,3578745905,3578745930,25
0,1237,37379,3578745905,3578745930,25
0,1237,37380,3578745905,3578745931,26
0,1237,37381,3578745905,3578745931,26
0,1237,37382,3578745905,3578745932,27
0,1237,37383,3578745905,3578745932,27
0,1237,37384,3578745905,3578745932,27
0,1237,37385,3578745905,3578745933,28
0,1237,37386,3578745905,3578745934,29
0,1237,37387,3578745905,3578745935,30
0,1237,37388,3578745905,3578745935,30
0,1237,37389,3578745905,3578745936,31
0,1237,37390,3578745905,3578745938,33
0,1237,37391,3578745905,3578745939,34
0,1237,37392,3578745905,3578745939,34
0,1237,37393,3578745905,3578745939,34
0,1237,37394,3578745905,3578745940,35
0,1237,37395,3578745905,3578745940,35
0,1237,37396,3578745905,3578745940,35
0,1237,37397,3578745905,3578745941,36
0,1237,37398,3578745905,3578745941,36
0,1237,37399,3578745905,3578745942,37
0,1237,37400,3578745905,3578745942,37
0,1237,37401,3578745905,3578745942,37
0,1237,37402,3578745905,3578745943,38
0,1237,37403,3578745905,3578745943,38
0,1237,37404,3578745905,3578745943,38
0,1237,37405,3578745905,3578745944,39
0,1237,37406,3578745905,3578745945,40
0,1237,37407,3578745905,3578745945,40
0,1237,37408,3578745905,3578745945,40
0,1237,37409,3578745905,3578745945,40
0,1237,37410,3578745905,3578745946,41
0,1237,37411,3578745905,3578745948,43
0,1237,37412,3578745905,3578745950,45
0,1237,37413,3578745905,3578745950,45
0,1237,37414,3578745905,3578745952,47
0,1237,37415,3578745905,3578745954,49
0,1237,37416,3578745905,3578745954,49
0,1237,37417,3578745905,3578745954,49
0,1237,37418,3578745905,3578745955,50
0,1238,37419,3578745968,3578745968,0
0,1238,37420,3578745968,3578745968,0
0,1238,37421,3578745968,3578745968,0
0,1238,37422,3578745968,3578745968,0
0,1238,37423,3578745968,3578745968,0
0,1238,37424,3578745968,3578745968,0
0,1238,37425,3578745968,3578745968,0
0,1238,37426,3578745968,3578745968,0
0,1238,37427,3578745968,3578745968,0
0,1238,37428,3578745968,3578745968,0
0,1238,37429,3578745968,3578745968,0
0,1238,37430,3578745968,3578745968,0
0,1238,37431,3578745968,3578745968,0
0,1238,37432,3578745968,3578745968,0
0,1238,37433,3578745968,3578745968,0
0,1238,37434,3578745968,3578745968,0
0,1238,37435,3578745968,3578745968,0
0,1238,37436,3578745968,3578745968,0
0,1238,37437,3578745968,3578745968,0
0,1238,37438,3578745968,3578745968,0
0,1238,37439,3578745968,3578745968,0
0,1238,37440,3578745968,3578745968,0
0,1238,37441,3578745968,3578745968,0
0,1238,37442,3578745968,3578745969,1
0,1238,37443,3578745968,3578745969,1
0,1238,37444,3578745968,3578745970,2
0,1238,37445,3578745968,3578745970,2
0,1238,37446,3578745968,3578745971,3
0,1238,37447,3578745968,3578745973,5
0,1238,37448,3578745968,3578745974,6
0,1238,37449,3578745968,3578745974,6
0,1238,37450,3578745968,3578745974,6
0,1238,37451,3578745968,3578745975,7
0,1238,37452,3578745968,3578745976,8
0,1238,37453,3578745968,3578745978,10
0,1238,37454,3578745968,3578745978,10
0,1238,37455,3578745968,3578745978,10
0,1238,37456,3578745968,3578745979,11
0,1238,37457,3578745968,3578745979,11
0,1238,37458,3578745968,3578745980,12
0,1238,37459,3578745968,3578745980,12
0,1238,37460,3578745968,3578745980,12
0,1238,37461,3578745968,3578745984,16
0,1238,37462,3578745968,3578745985,17
0,1238,37463,3578745968,3578745986,18
0,1238,37464,3578745968,3578745987,19
0,1238,37465,3578745968,3578745987,19
0,1238,37466,3578745968,3578745988,20
0,1238,37467,3578745968,3578745988,20
0,1238,37468,3578745968,3578745988,20
0,1238,37469,3578745968,3578745989,21
0,1238,37470,3578745968,3578745989,21
0,1238,37471,3578745968,3578745990,22
0,1238,37472,3578745968,3578745992,24
0,1238,37473,3578745968,3578745993,25
0,1238,37474,3578745968,3578745994,26
0,1238,37475,3578745968,3578745994,26
0,1238,37476,3578745968,3578745995,27
0,1238,37477,3578745968,3578745999,31
0,1238,37478,3578745968,3578746001,33
0,1238,37479,3578745968,3578746001,33
0,1238,37480,3578745968,3578746002,34
0,1238,37481,3578745968,3578746002,34
0,1238,37482,3578745968,3578746003,35
0,1238,37483,3578745968,3578746003,35
0,1238,37484,3578745968,3578746004,36
0,1238,37485,3578745968,3578746004,36
0,1238,37486,3578745968,3578746005,37
0,1238,37487,3578745968,3578746005,37
0,1238,37488,3578745968,3578746005,37
0,1238,37489,3578745968,3578746007,39
0,1238,37490,3578745968,3578746007,39
0,1238,37491,3578745968,3578746008,40
0,1238,37492,3578745968,3578746008,40
0,1238,37493,3578745968,3578746009,41
0,1238,37494,3578745968,3578746010,42
0,1238,37495,3578745968,3578746011,43
0,1238,37496,3578745968,3578746011,43
0,1238,37497,3578745968,3578746012,44
0,1238,37498,3578745968,3578746013,45
0,1238,37499,3578745968,3578746014,46
0,1238,37500,3578745968,3578746015,47
0,1238,37501,3578745968,3578746015,47
0,1238,37502,3578745968,3578746015,47
0,1238,37503,3578745968,3578746016,48
0,1238,37504,3578745968,3578746018,50
0,1239,37505,3578746030,3578746030,0
0,1239,37506,3578746030,3578746030,0
0,1239,37507,3578746030,3578746030,0
0,1239,37508,3578746030,3578746030,0
0,1239,37509,3578746030,3578746030,0
0,1239,37510,3578746030,3578746030,0
0,1239,37511,3578746030,3578746030,0
0,1239,37512,3578746030,3578746030,0
0,1239,37513,3578746030,3578746030,0
0,1239,37514,3578746030,3578746030,0
0,1239,37515,3578746030,3578746030,0
0,1239,37516,3578746030,3578746030,0
0,1239,37517,3578746030,3578746030,0
0,1239,37518,3578746030,3578746031,1
0,1239,37519,3578746030,3578746032,2
0,1239,37520,3578746030,3578746033,3
0,1239,37521,3578746030,3578746033,3
0,1239,37522,3578746030,3578746036,6
0,1239,37523,3578746030,3578746036,6
0,1239,37524,3578746030,3578746037,7
0,1239,37525,3578746030,3578746037,7
0,1239,37526,3578746030,3578746037,7
0,1239,37527,3578746030,3578746038,8
0,1239,37528,3578746030,3578746039,9
0,1239,37529,3578746030,3578746040,10
0,1239,37530,3578746030,3578746040,10
0,1239,37531,3578746030,3578746040,10
0,1239,37532,3578746030,3578746041,11
0,1239,37533,3578746030,3578746043,13
0,1239,37534,3578746030,3578746043,13
0,1239,37535,3578746030,3578746043,13
0,1239,37536,3578746030,3578746044,14
0,1239,37537,3578746030,3578746046,16
0,1239,37538,3578746030,3578746047,17
0,1239,37539,3578746030,3578746048,18
0,1239,37540,3578746030,3578746048,18
0,1239,37541,3578746030,3578746049,19
0,1239,37542,3578746030,3578746049,19
0,1239,37543,3578746030,3578746049,19
0,1239,37544,3578746030,3578746049,19
0,1239,37545,3578746030,3578746050,20
0,1239,37546,3578746030,3578746052,22
0,1239,37547,3578746030,3578746057,27
0,1239,37548,3578746030,3578746057,27
0,1239,37549,3578746030,3578746059,29
0,1239,37550,3578746030,3578746059,29
0,1239,37551,3578746030,3578746060,30
0,1239,37552,3578746030,3578746062,32
0,1239,37553,3578746030,3578746062,32
0,1239,37554,3578746030,3578746062,32
0,1239,37555,3578746030,3578746062,32
0,1239,37556,3578746030,3578746063,33
0,1239,37557,3578746030,3578746064,34
0,1239,37558,3578746030,3578746064,34
0,1239,37559,3578746030,3578746065,35
0,1239,37560,3578746030,3578746066,36
0,1239,37561,3578746030,3578746067,37
0,1239,37562,3578746030,3578746069,39
0,1239,37563,3578746030,3578746076,46
0,1239,37564,3578746030,3578746078,48
0,1239,37565,3578746030,3578746079,49
0,1239,37566,3578746030,3578746079,49
0,1239,37567,3578746030,3578746079,49
0,1239,37568,3578746030,3578746080,50
0,1240,37569,3578746092,3578746092,0
0,1240,37570,3578746092,3578746092,0
0,1240,37571,3578746092,3578746092,0
0,1240,37572,3578746092,3578746092,0
0,1240,37573,3578746092,3578746092,0
0,1240,37574,3578746092,3578746092,0
0,1240,37575,3578746092,3578746092,0
0,1240,37576,3578746092,3578746092,0
0,1240,37577,3578746092,3578746092,0
0,1240,37578,3578746092,3578746092,0
0,1240,37579,3578746092,3578746092,0
0,1240,37580,3578746092,3578746092,0
0,1240,37581,3578746092,3578746092,0
0,1240,37582,3578746092,3578746092,0
0,1240,37583,3578746092,3578746092,0
0,1240,37584,3578746092,3578746092,0
0,1240,37585,3578746092,3578746092,0
0,1240,37586,3578746092,3578746092,0
0,1240,37587,3578746092,3578746092,0
0,1240,37588,3578746092,3578746092,0
0,1240,37589,3578746092,3578746092,0
0,1240,37590,3578746092,3578746093,1
0,1240,37591,3578746092,3578746093,1
0,1240,37592,3578746092,3578746093,1
0,1240,37593,3578746092,3578746093,1
0,1240,37594,3578746092,3578746095,3
0,1240,37595,3578746092,3578746096,4
0,1240,37596,3578746092,3578746098,6
0,1240,37597,3578746092,3578746099,7
0,1240,37598,3578746092,3578746099,7
0,1240,37599,3578746092,3578746099,7
0,1240,37600,3578746092,3578746102,10
0,1240,37601,3578746092,3578746102,10
0,1240,37602,3578746092,3578746102,10
0,1240,37603,3578746092,3578746103,11
0,1240,37604,3578746092,3578746103,11
0,1240,37605,3578746092,3578746103,11
0,1240,37606,3578746092,3578746105,13
0,1240,37607,3578746092,3578746105,13
0,1240,37608,3578746092,3578746106,14
0,1240,37609,3578746092,3578746106,14
0,1240,37610,3578746092,3578746106,14
0,1240,37611,3578746092,3578746107,15
0,1240,37612,3578746092,3578746107,15
0,1240,37613,3578746092,3578746108,16
0,1240,37614,3578746092,3578746108,16
0,1240,37615,3578746092,3578746109,17
0,1240,37616,3578746092,3578746110,18
0,1240,37617,3578746092,3578746110,18
0,1240,37618,3578746092,3578746110,18
0,1240,37619,3578746092,3578746110,18
0,1240,37620,3578746092,3578746112,20
0,1240,37621,3578746092,3578746115,23
0,1240,37622,3578746092,3578746115,23
0,1240,37623,3578746092,3578746115,23
0,1240,37624,3578746092,3578746115,23
0,1240,37625,3578746092,3578746116,24
0,1240,37626,3578746092,3578746116,24
0,1240,37627,3578746092,3578746116,24
0,1240,37628,3578746092,3578746117,25
0,1240,37629,3578746092,3578746117,25
0,1240,37630,3578746092,3578746117,25
0,1240,37631,3578746092,3578746117,25
0,1240,37632,3578746092,3578746119,27
0,1240,37633,3578746092,3578746119,27
0,1240,37634,3578746092,3578746119,27
0,1240,37635,3578746092,3578746119,27
0,1240,37636,3578746092,3578746120,28
0,1240,37637,3578746092,3578746121,29
0,1240,37638,3578746092,3578746123,31
0,1240,37639,3578746092,3578746123,31
0,1240,37640,3578746092,3578746123,31
0,1240,37641,3578746092,3578746123,31
0,1240,37642,3578746092,3578746127,35
0,1240,37643,3578746092,3578746127,35
0,1240,37644,3578746092,3578746128,36
0,1240,37645,3578746092,3578746129,37
0,1240,37646,3578746092,3578746129,37
0,1240,37647,3578746092,3578746129,37
0,1240,37648,3578746092,3578746129,37
0,1240,37649,3578746092,3578746130,38
0,1240,37650,3578746092,3578746130,38
0,1240,37651,3578746092,3578746130,38
0,1240,37652,3578746092,3578746131,39
0,1240,37653,3578746092,3578746131,39
0,1240,37654,3578746092,3578746131,39
0,1240,37655,3578746092,3578746132,40
0,1240,37656,3578746092,3578746132,40
0,1240,37657,3578746092,3578746133,41
0,1240,37658,3578746092,3578746134,42
0,1240,37659,3578746092,3578746134,42
0,1240,37660,3578746092,3578746135,43
0,1240,37661,3578746092,3578746135,43
0,1240,37662,3578746092,3578746138,46
0,1240,37663,3578746092,3578746139,47
0,1240,37664,3578746092,3578746139,47
0,1240,37665,3578746092,3578746139,47
0,1240,37666,3578746092,3578746140,48
0,1240,37667,3578746092,3578746140,48
0,1240,37668,3578746092,3578746141,49
0,1240,37669,3578746092,3578746141,49
0,1240,37670,3578746092,3578746141,49
0,1241,37671,3578746154,3578746154,0
0,1241,37672,3578746154,3578746154,0
0,1241,37673,3578746154,3578746154,0
0,1241,37674,3578746154,3578746154,0
0,1241,37675,3578746154,3578746154,0
0,1241,37676,3578746154,3578746154,0
0,1241,37677,3578746154,3578746154,0
0,1241,37678,3578746154,3578746154,0
0,1241,37679,3578746154,3578746154,0
0,1241,37680,3578746154,3578746154,0
0,1241,37681,3578746154,3578746154,0
0,1241,37682,3578746154,3578746154,0
0,1241,37683,3578746154,3578746154,0
0,1241,37684,3578746154,3578746154,0
0,1241,37685,3578746154,3578746154,0
0,1241,37686,3578746154,3578746154,0
0,1241,37687,3578746154,3578746154,0
0,1241,37688,3578746154,3578746154,0
0,1241,37689,3578746154,3578746154,0
0,1241,37690,3578746154,3578746154,0
0,1241,37691,3578746154,3578746155,1
0,1241,37692,3578746154,3578746155,1
0,1241,37693,3578746154,3578746156,2
0,1241,37694,3578746154,3578746156,2
0,1241,37695,3578746154,3578746157,3
0,1241,37696,3578746154,3578746159,5
0,1241,37697,3578746154,3578746159,5
0,1241,37698,3578746154,3578746160,6
0,1241,37699,3578746154,3578746160,6
0,1241,37700,3578746154,3578746160,6
0,1241,37701,3578746154,3578746161,7
0,1241,37702,3578746154,3578746161,7
0,1241,37703,3578746154,3578746162,8
0,1241,37704,3578746154,3578746162,8
0,1241,37705,3578746154,3578746163,9
0,1241,37706,3578746154,3578746164,10
0,1241,37707,3578746154,3578746165,11
0,1241,37708,3578746154,3578746165,11
0,1241,37709,3578746154,3578746166,12
0,1241,37710,3578746154,3578746167,13
0,1241,37711,3578746154,3578746167,13
0,1241,37712,3578746154,3578746168,14
0,1241,37713,3578746154,3578746168,14
0,1241,37714,3578746154,3578746169,15
0,1241,37715,3578746154,3578746170,16
0,1241,37716,3578746154,3578746170,16
0,1241,37717,3578746154,3578746170,16
0,1241,37718,3578746154,3578746171,17
0,1241,37719,3578746154,3578746173,19
0,1241,37720,3578746154,3578746173,19
0,1241,37721,3578746154,3578746174,20
0,1241,37722,3578746154,3578746174,20
0,1241,37723,3578746154,3578746174,20
0,1241,37724,3578746154,3578746176,22
0,1241,37725,3578746154,3578746178,24
0,1241,37726,3578746154,3578746178,24
0,1241,37727,3578746154,3578746179,25
0,1241,37728,3578746154,3578746179,25
0,1241,37729,3578746154,3578746179,25
0,1241,37730,3578746154,3578746180,26
0,1241,37731,3578746154,3578746180,26
0,1241,37732,3578746154,3578746181,27
0,1241,37733,3578746154,3578746184,30
0,1241,37734,3578746154,3578746185,31
0,1241,37735,3578746154,3578746186,32
0,1241,37736,3578746154,3578746187,33
0,1241,37737,3578746154,3578746187,33
0,1241,37738,3578746154,3578746188,34
0,1241,37739,3578746154,3578746188,34
0,1241,37740,3578746154,3578746189,35
0,1241,37741,3578746154,3578746189,35
0,1241,37742,3578746154,3578746190,36
0,1241,37743,3578746154,3578746191,37
0,1241,37744,3578746154,3578746191,37
0,1241,37745,3578746154,3578746192,38
0,1241,37746,3578746154,3578746193,39
0,1241,37747,3578746154,3578746194,40
0,1241,37748,3578746154,3578746195,41
0,1241,37749,3578746154,3578746199,45
0,1241,37750,3578746154,3578746201,47
0,1241,37751,3578746154,3578746201,47
0,1241,37752,3578746154,3578746202,48
0,1241,37753,3578746154,3578746203,49
0,1241,37754,3578746154,3578746203,49
0,1241,37755,3578746154,3578746203,49
0,1242,37756,3578746215,3578746215,0
0,1242,37757,3578746215,3578746215,0
0,1242,37758,3578746215,3578746215,0
0,1242,37759,3578746215,3578746215,0
0,1242,37760,3578746215,3578746215,0
0,1242,37761,3578746215,3578746215,0
0,1242,37762,3578746215,3578746215,0
0,1242,37763,3578746215,3578746215,0
0,1242,37764,3578746215,3578746215,0
0,1242,37765,3578746215,3578746215,0
0,1242,37766,3578746215,3578746215,0
0,1242,37767,3578746215,3578746215,0
0,1242,37768,3578746215,3578746215,0
0,1242,37769,3578746215,3578746215,0
0,1242,37770,3578746215,3578746215,0
0,1242,37771,3578746215,3578746215,0
0,1242,37772,3578746215,3578746215,0
0,1242,37773,3578746215,3578746215,0
0,1242,37774,3578746215,3578746215,0
0,1242,37775,3578746215,3578746215,0
0,1242,37776,3578746215,3578746216,1
0,1242,37777,3578746215,3578746217,2
0,1242,37778,3578746215,3578746218,3
0,1242,37779,3578746215,3578746218,3
0,1242,37780,3578746215,3578746219,4
0,1242,37781,3578746215,3578746221,6
0,1242,37782,3578746215,3578746222,7
0,1242,37783,3578746215,3578746223,8
0,1242,37784,3578746215,3578746224,9
0,1242,37785,3578746215,3578746224,9
0,1242,37786,3578746215,3578746226,11
0,1242,37787,3578746215,3578746228,13
0,1242,37788,3578746215,3578746230,15
0,1242,37789,3578746215,3578746231,16
0,1242,37790,3578746215,3578746233,18
0,1242,37791,3578746215,3578746233,18
0,1242,37792,3578746215,3578746234,19
0,1242,37793,3578746215,3578746235,20
0,1242,37794,3578746215,3578746236,21
0,1242,37795,3578746215,3578746237,22
0,1242,37796,3578746215,3578746237,22
0,1242,37797,3578746215,3578746238,23
0,1242,37798,3578746215,3578746238,23
0,1242,37799,3578746215,3578746238,23
0,1242,37800,3578746215,3578746240,25
0,1242,37801,3578746215,3578746240,25
0,1242,37802,3578746215,3578746240,25
0,1242,37803,3578746215,3578746240,25
0,1242,37804,3578746215,3578746243,28
0,1242,37805,3578746215,3578746243,28
0,1242,37806,3578746215,3578746243,28
0,1242,37807,3578746215,3578746244,29
0,1242,37808,3578746215,3578746246,31
0,1242,37809,3578746215,3578746247,32
0,1242,37810,3578746215,3578746248,33
0,1242,37811,3578746215,3578746248,33
0,1242,37812,3578746215,3578746249,34
0,1242,37813,3578746215,3578746249,34
0,1242,37814,3578746215,3578746249,34
0,1242,37815,3578746215,3578746249,34
0,1242,37816,3578746215,3578746250,35
0,1242,37817,3578746215,3578746253,38
0,1242,37818,3578746215,3578746255,40
0,1242,37819,3578746215,3578746256,41
0,1242,37820,3578746215,3578746256,41
0,1242,37821,3578746215,3578746257,42
0,1242,37822,3578746215,3578746257,42
0,1242,37823,3578746215,3578746259,44
0,1242,37824,3578746215,3578746259,44
0,1242,37825,3578746215,3578746259,44
0,1242,37826,3578746215,3578746261,46
0,1242,37827,3578746215,3578746262,47
0,1242,37828,3578746215,3578746262,47
0,1242,37829,3578746215,3578746262,47
0,1242,37830,3578746215,3578746263,48
0,1242,37831,3578746215,3578746263,48
0,1242,37832,3578746215,3578746264,49
0,1242,37833,3578746215,3578746265,50
0,1243,37834,3578746276,3578746276,0
0,1243,37835,3578746276,3578746276,0
0,1243,37836,3578746276,3578746276,0
0,1243,37837,3578746276,3578746276,0
0,1243,37838,3578746276,3578746276,0
0,1243,37839,3578746276,3578746277,1
0,1243,37840,3578746276,3578746278,2
0,1243,37841,3578746276,3578746279,3
0,1243,37842,3578746276,3578746280,4
0,1243,37843,3578746276,3578746280,4
0,1243,37844,3578746276,3578746280,4
0,1243,37845,3578746276,3578746280,4
0,1243,37846,3578746276,3578746281,5
0,1243,37847,3578746276,3578746281,5
0,1243,37848,3578746276,3578746284,8
0,1243,37849,3578746276,3578746284,8
0,1243,37850,3578746276,3578746284,8
0,1243,37851,3578746276,3578746285,9
0,1243,37852,3578746276,3578746285,9
0,1243,37853,3578746276,3578746285,9
0,1243,37854,3578746276,3578746286,10
0,1243,37855,3578746276,3578746286,10
0,1243,37856,3578746276,3578746287,11
0,1243,37857,3578746276,3578746287,11
0,1243,37858,3578746276,3578746288,12
0,1243,37859,3578746276,3578746288,12
0,1243,37860,3578746276,3578746289,13
0,1243,37861,3578746276,3578746289,13
0,1243,37862,3578746276,3578746289,13
0,1243,37863,3578746276,3578746289,13
0,1243,37864,3578746276,3578746290,14
0,1243,37865,3578746276,3578746290,14
0,1243,37866,3578746276,3578746291,15
0,1243,37867,3578746276,3578746292,16
0,1243,37868,3578746276,3578746292,16
0,1243,37869,3578746276,3578746293,17
0,1243,37870,3578746276,3578746293,17
0,1243,37871,3578746276,3578746294,18
0,1243,37872,3578746276,3578746295,19
0,1243,37873,3578746276,3578746296,20
0,1243,37874,3578746276,3578746298,22
0,1243,37875,3578746276,3578746299,23
0,1243,37876,3578746276,3578746299,23
0,1243,37877,3578746276,3578746302,26
0,1243,37878,3578746276,3578746302,26
0,1243,37879,3578746276,3578746302,26
0,1243,37880,3578746276,3578746303,27
0,1243,37881,3578746276,3578746304,28
0,1243,37882,3578746276,3578746304,28
0,1243,37883,3578746276,3578746305,29
0,1243,37884,3578746276,3578746305,29
0,1243,37885,3578746276,3578746306,30
0,1243,37886,3578746276,3578746306,30
0,1243,37887,3578746276,3578746306,30
0,1243,37888,3578746276,3578746307,31
0,1243,37889,3578746276,3578746307,31
0,1243,37890,3578746276,3578746307,31
0,1243,37891,3578746276,3578746308,32
0,1243,37892,3578746276,3578746308,32
0,1243,37893,3578746276,3578746308,32
0,1243,37894,3578746276,3578746309,33
0,1243,37895,3578746276,3578746310,34
0,1243,37896,3578746276,3578746310,34
0,1243,37897,3578746276,3578746311,35
0,1243,37898,3578746276,3578746311,35
0,1243,37899,3578746276,3578746312,36
0,1243,37900,3578746276,3578746315,39
0,1243,37901,3578746276,3578746315,39
0,1243,37902,3578746276,3578746315,39
0,1243,37903,3578746276,3578746315,39
0,1243,37904,3578746276,3578746316,40
0,1243,37905,3578746276,3578746316,40
0,1243,37906,3578746276,3578746316,40
0,1243,37907,3578746276,3578746316,40
0,1243,37908,3578746276,3578746316,40
0,1243,37909,3578746276,3578746317,41
0,1243,37910,3578746276,3578746318,42
0,1243,37911,3578746276,3578746318,42
0,1243,37912,3578746276,3578746319,43
0,1243,37913,3578746276,3578746319,43
0,1243,37914,3578746276,3578746320,44
0,1243,37915,3578746276,3578746321,45
0,1243,37916,3578746276,3578746323,47
0,1243,37917,3578746276,3578746323,47
0,1243,37918,3578746276,3578746323,47
0,1243,37919,3578746276,3578746325,49
0,1244,37920,3578746339,3578746339,0
0,1244,37921,3578746339,3578746339,0
0,1244,37922,3578746339,3578746339,0
0,1244,37923,3578746339,3578746339,0
0,1244,37924,3578746339,3578746339,0
0,1244,37925,3578746339,3578746339,0
0,1244,37926,3578746339,3578746339,0
0,1244,37927,3578746339,3578746339,0
0,1244,37928,3578746339,3578746339,0
0,1244,37929,3578746339,3578746339,0
0,1244,37930,3578746339,3578746339,0
0,1244,37931,3578746339,3578746339,0
0,1244,37932,3578746339,3578746339,0
0,1244,37933,3578746339,3578746339,0
0,1244,37934,3578746339,3578746339,0
0,1244,37935,3578746339,3578746339,0
0,1244,37936,3578746339,3578746339,0
0,1244,37937,3578746339,3578746339,0
0,1244,37938,3578746339,3578746339,0
0,1244,37939,3578746339,3578746339,0
0,1244,37940,3578746339,3578746339,0
0,1244,37941,3578746339,3578746339,0
0,1244,37942,3578746339,3578746340,1
0,1244,37943,3578746339,3578746340,1
0,1244,37944,3578746339,3578746340,1
0,1244,37945,3578746339,3578746340,1
0,1244,37946,3578746339,3578746341,2
0,1244,37947,3578746339,3578746342,3
0,1244,37948,3578746339,3578746342,3
0,1244,37949,3578746339,3578746343,4
0,1244,37950,3578746339,3578746343,4
0,1244,37951,3578746339,3578746343,4
0,1244,37952,3578746339,3578746344,5
0,1244,37953,3578746339,3578746344,5
0,1244,37954,3578746339,3578746344,5
0,1244,37955,3578746339,3578746345,6
0,1244,37956,3578746339,3578746346,7
0,1244,37957,3578746339,3578746346,7
0,1244,37958,3578746339,3578746346,7
0,1244,37959,3578746339,3578746347,8
0,1244,37960,3578746339,3578746348,9
0,1244,37961,3578746339,3578746348,9
0,1244,37962,3578746339,3578746351,12
0,1244,37963,3578746339,3578746351,12
0,1244,37964,3578746339,3578746353,14
0,1244,37965,3578746339,3578746354,15
0,1244,37966,3578746339,3578746354,15
0,1244,37967,3578746339,3578746355,16
0,1244,37968,3578746339,3578746356,17
0,1244,37969,3578746339,3578746356,17
0,1244,37970,3578746339,3578746356,17
0,1244,37971,3578746339,3578746356,17
0,1244,37972,3578746339,3578746358,19
0,1244,37973,3578746339,3578746359,20
0,1244,37974,3578746339,3578746359,20
0,1244,37975,3578746339,3578746360,21
0,1244,37976,3578746339,3578746361,22
0,1244,37977,3578746339,3578746361,22
0,1244,37978,3578746339,3578746361,22
0,1244,37979,3578746339,3578746361,22
0,1244,37980,3578746339,3578746362,23
0,1244,37981,3578746339,3578746362,23
0,1244,37982,3578746339,3578746363,24
0,1244,37983,3578746339,3578746363,24
0,1244,37984,3578746339,3578746365,26
0,1244,37985,3578746339,3578746366,27
0,1244,37986,3578746339,3578746366,27
0,1244,37987,3578746339,3578746367,28
0,1244,37988,3578746339,3578746368,29
0,1244,37989,3578746339,3578746368,29
0,1244,37990,3578746339,3578746368,29
0,1244,37991,3578746339,3578746369,30
0,1244,37992,3578746339,3578746369,30
0,1244,37993,3578746339,3578746370,31
0,1244,37994,3578746339,3578746370,31
0,1244,37995,3578746339,3578746370,31
0,1244,37996,3578746339,3578746371,32
0,1244,37997,3578746339,3578746373,34
0,1244,37998,3578746339,3578746374,35
0,1244,37999,3578746339,3578746374,35
0,1244,38000,3578746339,3578746374,35
0,1244,38001,3578746339,3578746376,37
0,1244,38002,3578746339,3578746377,38
0,1244,38003,3578746339,3578746378,39
0,1244,38004,3578746339,3578746379,40
0,1244,38005,3578746339,3578746379,40
0,1244,38006,3578746339,3578746379,40
0,1244,38007,3578746339,3578746380,41
0,1244,38008,3578746339,3578746381,42
0,1244,38009,3578746339,3578746381,42
0,1244,38010,3578746339,3578746382,43
0,1244,38011,3578746339,3578746382,43
0,1244,38012,3578746339,3578746384,45
0,1244,38013,3578746339,3578746385,46
0,1244,38014,3578746339,3578746386,47
0,1244,38015,3578746339,3578746387,48
0,1244,38016,3578746339,3578746387,48
0,1244,38017,3578746339,3578746388,49
0,1244,38018,3578746339,3578746389,50
0,1245,38019,3578746402,3578746402,0
0,1245,38020,3578746402,3578746402,0
0,1245,38021,3578746402,3578746402,0
0,1245,38022,3578746402,3578746402,0
0,1245,38023,3578746402,3578746402,0
0,1245,38024,3578746402,3578746402,0
0,1245,38025,3578746402,3578746402,0
0,1245,38026,3578746402,3578746402,0
0,1245,38027,3578746402,3578746402,0
0,1245,38028,3578746402,3578746402,0
0,1245,38029,3578746402,3578746402,0
0,1245,38030,3578746402,3578746402,0
0,1245,38031,3578746402,3578746404,2
0,1245,38032,3578746402,3578746404,2
0,1245,38033,3578746402,3578746404,2
0,1245,38034,3578746402,3578746404,2
0,1245,38035,3578746402,3578746405,3
0,1245,38036,3578746402,3578746405,3
0,1245,38037,3578746402,3578746405,3
0,1245,38038,3578746402,3578746406,4
0,1245,38039,3578746402,3578746407,5
0,1245,38040,3578746402,3578746407,5
0,1245,38041,3578746402,3578746408,6
0,1245,38042,3578746402,3578746409,7
0,1245,38043,3578746402,3578746409,7
0,1245,38044,3578746402,3578746411,9
0,1245,38045,3578746402,3578746411,9
0,1245,38046,3578746402,3578746412,10
0,1245,38047,3578746402,3578746413,11
0,1245,38048,3578746402,3578746414,12
0,1245,38049,3578746402,3578746414,12
0,1245,38050,3578746402,3578746414,12
0,1245,38051,3578746402,3578746415,13
0,1245,38052,3578746402,3578746415,13
0,1245,38053,3578746402,3578746416,14
0,1245,38054,3578746402,3578746416,14
0,1245,38055,3578746402,3578746417,15
0,1245,38056,3578746402,3578746417,15
0,1245,38057,3578746402,3578746418,16
0,1245,38058,3578746402,3578746419,17
0,1245,38059,3578746402,3578746419,17
0,1245,38060,3578746402,3578746419,17
0,1245,38061,3578746402,3578746419,17
0,1245,38062,3578746402,3578746422,20
0,1245,38063,3578746402,3578746422,20
0,1245,38064,3578746402,3578746423,21
0,1245,38065,3578746402,3578746424,22
0,1245,38066,3578746402,3578746424,22
0,1245,38067,3578746402,3578746425,23
0,1245,38068,3578746402,3578746426,24
0,1245,38069,3578746402,3578746427,25
0,1245,38070,3578746402,3578746427,25
0,1245,38071,3578746402,3578746429,27
0,1245,38072,3578746402,3578746431,29
0,1245,38073,3578746402,3578746432,30
0,1245,38074,3578746402,3578746433,31
0,1245,38075,3578746402,3578746434,32
0,1245,38076,3578746402,3578746434,32
0,1245,38077,3578746402,3578746437,35
0,1245,38078,3578746402,3578746437,35
0,1245,38079,3578746402,3578746437,35
0,1245,38080,3578746402,3578746437,35
0,1245,38081,3578746402,3578746437,35
0,1245,38082,3578746402,3578746439,37
0,1245,38083,3578746402,3578746439,37
0,1245,38084,3578746402,3578746440,38
0,1245,38085,3578746402,3578746440,38
0,1245,38086,3578746402,3578746440,38
0,1245,38087,3578746402,3578746441,39
0,1245,38088,3578746402,3578746445,43
0,1245,38089,3578746402,3578746445,43
0,1245,38090,3578746402,3578746446,44
0,1245,38091,3578746402,3578746447,45
0,1245,38092,3578746402,3578746447,45
0,1245,38093,3578746402,3578746448,46
0,1245,38094,3578746402,3578746449,47
0,1245,38095,3578746402,3578746449,47
0,1245,38096,3578746402,3578746449,47
0,1245,38097,3578746402,3578746450,48
0,1245,38098,3578746402,3578746450,48
0,1246,38099,3578746464,3578746464,0
0,1246,38100,3578746464,3578746464,0
0,1246,38101,3578746464,3578746464,0
0,1246,38102,3578746464,3578746464,0
0,1246,38103,3578746464,3578746464,0
0,1246,38104,3578746464,3578746464,0
0,1246,38105,3578746464,3578746464,0
0,1246,38106,3578746464,3578746464,0
0,1246,38107,3578746464,3578746464,0
0,1246,38108,3578746464,3578746464,0
0,1246,38109,3578746464,3578746464,0
0,1246,38110,3578746464,3578746464,0
0,1246,38111,3578746464,3578746464,0
0,1246,38112,3578746464,3578746464,0
0,1246,38113,3578746464,3578746464,0
0,1246,38114,3578746464,3578746465,1
0,1246,38115,3578746464,3578746465,1
0,1246,38116,3578746464,3578746465,1
0,1246,38117,3578746464,3578746466,2
0,1246,38118,3578746464,3578746468,4
0,1246,38119,3578746464,3578746468,4
0,1246,38120,3578746464,3578746477,13
0,1246,38121,3578746464,3578746478,14
0,1246,38122,3578746464,3578746479,15
0,1246,38123,3578746464,3578746480,16
0,1246,38124,3578746464,3578746480,16
0,1246,38125,3578746464,3578746480,16
0,1246,38126,3578746464,3578746480,16
0,1246,38127,3578746464,3578746480,16
0,1246,38128,3578746464,3578746481,17
0,1246,38129,3578746464,3578746484,20
0,1246,38130,3578746464,3578746484,20
0,1246,38131,3578746464,3578746484,20
0,1246,38132,3578746464,3578746484,20
0,1246,38133,3578746464,3578746485,21
0,1246,38134,3578746464,3578746486,22
0,1246,38135,3578746464,3578746487,23
0,1246,38136,3578746464,3578746487,23
0,1246,38137,3578746464,3578746487,23
0,1246,38138,3578746464,3578746487,23
0,1246,38139,3578746464,3578746488,24
0,1246,38140,3578746464,3578746488,24
0,1246,38141,3578746464,3578746488,24
0,1246,38142,3578746464,3578746489,25
0,1246,38143,3578746464,3578746490,26
0,1246,38144,3578746464,3578746490,26
0,1246,38145,3578746464,3578746490,26
0,1246,38146,3578746464,3578746490,26
0,1246,38147,3578746464,3578746490,26
0,1246,38148,3578746464,3578746491,27
0,1246,38149,3578746464,3578746492,28
0,1246,38150,3578746464,3578746492,28
0,1246,38151,3578746464,3578746493,29
0,1246,38152,3578746464,3578746493,29
0,1246,38153,3578746464,3578746494,30
0,1246,38154,3578746464,3578746495,31
0,1246,38155,3578746464,3578746498,34
0,1246,38156,3578746464,3578746499,35
0,1246,38157,3578746464,3578746499,35
0,1246,38158,3578746464,3578746499,35
0,1246,38159,3578746464,3578746502,38
0,1246,38160,3578746464,3578746503,39
0,1246,38161,3578746464,3578746503,39
0,1246,38162,3578746464,3578746503,39
0,1246,38163,3578746464,3578746504,40
0,1246,38164,3578746464,3578746505,41
0,1246,38165,3578746464,3578746506,42
0,1246,38166,3578746464,3578746506,42
0,1246,38167,3578746464,3578746506,42
0,1246,38168,3578746464,3578746507,43
0,1246,38169,3578746464,3578746507,43
0,1246,38170,3578746464,3578746507,43
0,1246,38171,3578746464,3578746507,43
0,1246,38172,3578746464,3578746508,44
0,1246,38173,3578746464,3578746508,44
0,1246,38174,3578746464,3578746508,44
0,1246,38175,3578746464,3578746510,46
0,1246,38176,3578746464,3578746510,46
0,1246,38177,3578746464,3578746510,46
0,1246,38178,3578746464,3578746511,47
0,1246,38179,3578746464,3578746511,47
0,1247,38180,3578746527,3578746527,0
0,1247,38181,3578746527,3578746527,0
0,1247,38182,3578746527,3578746527,0
0,1247,38183,3578746527,3578746527,0
0,1247,38184,3578746527,3578746527,0
0,1247,38185,3578746527,3578746527,0
0,1247,38186,3578746527,3578746527,0
0,1247,38187,3578746527,3578746527,0
0,1247,38188,3578746527,3578746527,0
0,1247,38189,3578746527,3578746527,0
0,1247,38190,3578746527,3578746527,0
0,1247,38191,3578746527,3578746527,0
0,1247,38192,3578746527,3578746527,0
0,1247,38193,3578746527,3578746527,0
0,1247,38194,3578746527,3578746527,0
0,1247,38195,3578746527,3578746527,0
0,1247,38196,3578746527,3578746527,0
0,1247,38197,3578746527,3578746527,0
0,1247,38198,3578746527,3578746527,0
0,1247,38199,3578746527,3578746527,0
0,1247,38200,3578746527,3578746527,0
0,1247,38201,3578746527,3578746527,0
0,1247,38202,3578746527,3578746527,0
0,1247,38203,3578746527,3578746527,0
0,1247,38204,3578746527,3578746528,1
0,1247,38205,3578746527,3578746528,1
0,1247,38206,3578746527,3578746529,2
0,1247,38207,3578746527,3578746529,2
0,1247,38208,3578746527,3578746529,2
0,1247,38209,3578746527,3578746529,2
0,1247,38210,3578746527,3578746530,3
0,1247,38211,3578746527,3578746530,3
0,1247,38212,3578746527,3578746531,4
0,1247,38213,3578746527,3578746532,5
0,1247,38214,3578746527,3578746532,5
0,1247,38215,3578746527,3578746533,6
0,1247,38216,3578746527,3578746533,6
0,1247,38217,3578746527,3578746535,8
0,1247,38218,3578746527,3578746539,12
0,1247,38219,3578746527,3578746539,12
0,1247,38220,3578746527,3578746539,12
0,1247,38221,3578746527,3578746539,12
0,1247,38222,3578746527,3578746539,12
0,1247,38223,3578746527,3578746540,13
0,1247,38224,3578746527,3578746540,13
0,1247,38225,3578746527,3578746541,14
0,1247,38226,3578746527,3578746542,15
0,1247,38227,3578746527,3578746542,15
0,1247,38228,3578746527,3578746542,15
0,1247,38229,3578746527,3578746542,15
0,1247,38230,3578746527,3578746543,16
0,1247,38231,3578746527,3578746543,16
0,1247,38232,3578746527,3578746544,17
0,1247,38233,3578746527,3578746544,17
0,1247,38234,3578746527,3578746545,18
0,1247,38235,3578746527,3578746545,18
0,1247,38236,3578746527,3578746545,18
0,1247,38237,3578746527,3578746545,18
0,1247,38238,3578746527,3578746547,20
0,1247,38239,3578746527,3578746551,24
0,1247,38240,3578746527,3578746553,26
0,1247,38241,3578746527,3578746553,26
0,1247,38242,3578746527,3578746553,26
0,1247,38243,3578746527,3578746554,27
0,1247,38244,3578746527,3578746554,27
0,1247,38245,3578746527,3578746555,28
0,1247,38246,3578746527,3578746555,28
0,1247,38247,3578746527,3578746556,29
0,1247,38248,3578746527,3578746558,31
0,1247,38249,3578746527,3578746558,31
0,1247,38250,3578746527,3578746558,31
0,1247,38251,3578746527,3578746560,33
0,1247,38252,3578746527,3578746560,33
0,1247,38253,3578746527,3578746560,33
0,1247,38254,3578746527,3578746560,33
0,1247,38255,3578746527,3578746560,33
0,1247,38256,3578746527,3578746561,34
0,1247,38257,3578746527,3578746561,34
0,1247,38258,3578746527,3578746562,35
0,1247,38259,3578746527,3578746562,35
0,1247,38260,3578746527,3578746564,37
0,1247,38261,3578746527,3578746565,38
0,1247,38262,3578746527,3578746566,39
0,1247,38263,3578746527,3578746566,39
0,1247,38264,3578746527,3578746567,40
0,1247,38265,3578746527,3578746567,40
0,1247,38266,3578746527,3578746567,40
0,1247,38267,3578746527,3578746567,40
0,1247,38268,3578746527,3578746568,41
0,1247,38269,3578746527,3578746569,42
0,1247,38270,3578746527,3578746570,43
0,1247,38271,3578746527,3578746570,43
0,1247,38272,3578746527,3578746571,44
0,1247,38273,3578746527,3578746572,45
0,1247,38274,3578746527,3578746572,45
0,1247,38275,3578746527,3578746573,46
0,1247,38276,3578746527,3578746573,46
0,1247,38277,3578746527,3578746575,48
0,1247,38278,3578746527,3578746577,50
0,1248,38279,3578746589,3578746589,0
0,1248,38280,3578746589,3578746589,0
0,1248,38281,3578746589,3578746589,0
0,1248,38282,3578746589,3578746589,0
0,1248,38283,3578746589,3578746589,0
0,1248,38284,3578746589,3578746589,0
0,1248,38285,3578746589,3578746589,0
0,1248,38286,3578746589,3578746589,0
0,1248,38287,3578746589,3578746589,0
0,1248,38288,3578746589,3578746589,0
0,1248,38289,3578746589,3578746589,0
0,1248,38290,3578746589,3578746589,0
0,1248,38291,3578746589,3578746589,0
0,1248,38292,3578746589,3578746589,0
0,1248,38293,3578746589,3578746589,0
0,1248,38294,3578746589,3578746589,0
0,1248,38295,3578746589,3578746589,0
0,1248,38296,3578746589,3578746589,0
0,1248,38297,3578746589,3578746589,0
0,1248,38298,3578746589,3578746591,2
0,1248,38299,3578746589,3578746593,4
0,1248,38300,3578746589,3578746593,4
0,1248,38301,3578746589,3578746593,4
0,1248,38302,3578746589,3578746598,9
0,1248,38303,3578746589,3578746600,11
0,1248,38304,3578746589,3578746600,11
0,1248,38305,3578746589,3578746603,14
0,1248,38306,3578746589,3578746603,14
0,1248,38307,3578746589,3578746603,14
0,1248,38308,3578746589,3578746603,14
0,1248,38309,3578746589,3578746604,15
0,1248,38310,3578746589,3578746604,15
0,1248,38311,3578746589,3578746604,15
0,1248,38312,3578746589,3578746605,16
0,1248,38313,3578746589,3578746605,16
0,1248,38314,3578746589,3578746606,17
0,1248,38315,3578746589,3578746607,18
0,1248,38316,3578746589,3578746608,19
0,1248,38317,3578746589,3578746608,19
0,1248,38318,3578746589,3578746609,20
0,1248,38319,3578746589,3578746610,21
0,1248,38320,3578746589,3578746611,22
0,1248,38321,3578746589,3578746612,23
0,1248,38322,3578746589,3578746613,24
0,1248,38323,3578746589,3578746613,24
0,1248,38324,3578746589,3578746614,25
0,1248,38325,3578746589,3578746615,26
0,1248,38326,3578746589,3578746615,26
0,1248,38327,3578746589,3578746615,26
0,1248,38328,3578746589,3578746615,26
0,1248,38329,3578746589,3578746616,27
0,1248,38330,3578746589,3578746616,27
0,1248,38331,3578746589,3578746617,28
0,1248,38332,3578746589,3578746618,29
0,1248,38333,3578746589,3578746618,29
0,1248,38334,3578746589,3578746619,30
0,1248,38335,3578746589,3578746620,31
0,1248,38336,3578746589,3578746621,32
0,1248,38337,3578746589,3578746622,33
0,1248,38338,3578746589,3578746623,34
0,1248,38339,3578746589,3578746623,34
0,1248,38340,3578746589,3578746625,36
0,1248,38341,3578746589,3578746625,36
0,1248,38342,3578746589,3578746627,38
0,1248,38343,3578746589,3578746629,40
0,1248,38344,3578746589,3578746631,42
0,1248,38345,3578746589,3578746631,42
0,1248,38346,3578746589,3578746632,43
0,1248,38347,3578746589,3578746633,44
0,1248,38348,3578746589,3578746633,44
0,1248,38349,3578746589,3578746636,47
0,1248,38350,3578746589,3578746636,47
0,1248,38351,3578746589,3578746636,47
0,1248,38352,3578746589,3578746637,48
0,1248,38353,3578746589,3578746638,49
0,1248,38354,3578746589,3578746638,49
0,1248,38355,3578746589,3578746639,50
0,1249,38356,3578746651,3578746651,0
0,1249,38357,3578746651,3578746651,0
0,1249,38358,3578746651,3578746651,0
0,1249,38359,3578746651,3578746651,0
0,1249,38360,3578746651,3578746651,0
0,1249,38361,3578746651,3578746651,0
0,1249,38362,3578746651,3578746651,0
0,1249,38363,3578746651,3578746651,0
0,1249,38364,3578746651,3578746651,0
0,1249,38365,3578746651,3578746651,0
0,1249,38366,3578746651,3578746651,0
0,1249,38367,3578746651,3578746651,0
0,1249,38368,3578746651,3578746651,0
0,1249,38369,3578746651,3578746651,0
0,1249,38370,3578746651,3578746651,0
0,1249,38371,3578746651,3578746651,0
0,1249,38372,3578746651,3578746651,0
0,1249,38373,3578746651,3578746652,1
0,1249,38374,3578746651,3578746656,5
0,1249,38375,3578746651,3578746656,5
0,1249,38376,3578746651,3578746656,5
0,1249,38377,3578746651,3578746658,7
0,1249,38378,3578746651,3578746658,7
0,1249,38379,3578746651,3578746659,8
0,1249,38380,3578746651,3578746660,9
0,1249,38381,3578746651,3578746661,10
0,1249,38382,3578746651,3578746661,10
0,1249,38383,3578746651,3578746661,10
0,1249,38384,3578746651,3578746662,11
0,1249,38385,3578746651,3578746663,12
0,1249,38386,3578746651,3578746664,13
0,1249,38387,3578746651,3578746664,13
0,1249,38388,3578746651,3578746664,13
0,1249,38389,3578746651,3578746665,14
0,1249,38390,3578746651,3578746665,14
0,1249,38391,3578746651,3578746667,16
0,1249,38392,3578746651,3578746667,16
0,1249,38393,3578746651,3578746677,26
0,1249,38394,3578746651,3578746678,27
0,1249,38395,3578746651,3578746679,28
0,1249,38396,3578746651,3578746679,28
0,1249,38397,3578746651,3578746680,29
0,1249,38398,3578746651,3578746680,29
0,1249,38399,3578746651,3578746680,29
0,1249,38400,3578746651,3578746680,29
0,1249,38401,3578746651,3578746683,32
0,1249,38402,3578746651,3578746684,33
0,1249,38403,3578746651,3578746684,33
0,1249,38404,3578746651,3578746684,33
0,1249,38405,3578746651,3578746685,34
0,1249,38406,3578746651,3578746686,35
0,1249,38407,3578746651,3578746686,35
0,1249,38408,3578746651,3578746687,36
0,1249,38409,3578746651,3578746688,37
0,1249,38410,3578746651,3578746688,37
0,1249,38411,3578746651,3578746689,38
0,1249,38412,3578746651,3578746689,38
0,1249,38413,3578746651,3578746689,38
0,1249,38414,3578746651,3578746690,39
0,1249,38415,3578746651,3578746690,39
0,1249,38416,3578746651,3578746690,39
0,1249,38417,3578746651,3578746691,40
0,1249,38418,3578746651,3578746692,41
0,1249,38419,3578746651,3578746693,42
0,1249,38420,3578746651,3578746693,42
0,1249,38421,3578746651,3578746694,43
0,1249,38422,3578746651,3578746695,44
0,1249,38423,3578746651,3578746696,45
0,1249,38424,3578746651,3578746699,48
0,1249,38425,3578746651,3578746699,48
0,1249,38426,3578746651,3578746699,48
0,1249,38427,3578746651,3578746699,48
0,1250,38428,3578746714,3578746714,0
0,1250,38429,3578746714,3578746714,0
0,1250,38430,3578746714,3578746714,0
0,1250,38431,3578746714,3578746714,0
0,1250,38432,3578746714,3578746714,0
0,1250,38433,3578746714,3578746714,0
0,1250,38434,3578746714,3578746714,0
0,1250,38435,3578746714,3578746714,0
0,1250,38436,3578746714,3578746714,0
0,1250,38437,3578746714,3578746714,0
0,1250,38438,3578746714,3578746714,0
0,1250,38439,3578746714,3578746714,0
0,1250,38440,3578746714,3578746714,0
0,1250,38441,3578746714,3578746714,0
0,1250,38442,3578746714,3578746714,0
0,1250,38443,3578746714,3578746714,0
0,1250,38444,3578746714,3578746714,0
0,1250,38445,3578746714,3578746714,0
0,1250,38446,3578746714,3578746714,0
0,1250,38447,3578746714,3578746714,0
0,1250,38448,3578746714,3578746714,0
0,1250,38449,3578746714,3578746714,0
0,1250,38450,3578746714,3578746714,0
0,1250,38451,3578746714,3578746715,1
0,1250,38452,3578746714,3578746715,1
0,1250,38453,3578746714,3578746716,2
0,1250,38454,3578746714,3578746716,2
0,1250,38455,3578746714,3578746717,3
0,1250,38456,3578746714,3578746717,3
0,1250,38457,3578746714,3578746717,3
0,1250,38458,3578746714,3578746717,3
0,1250,38459,3578746714,3578746719,5
0,1250,38460,3578746714,3578746719,5
0,1250,38461,3578746714,3578746721,7
0,1250,38462,3578746714,3578746723,9
0,1250,38463,3578746714,3578746723,9
0,1250,38464,3578746714,3578746723,9
0,1250,38465,3578746714,3578746726,12
0,1250,38466,3578746714,3578746727,13
0,1250,38467,3578746714,3578746727,13
0,1250,38468,3578746714,3578746727,13
0,1250,38469,3578746714,3578746727,13
0,1250,38470,3578746714,3578746728,14
0,1250,38471,3578746714,3578746728,14
0,1250,38472,3578746714,3578746728,14
0,1250,38473,3578746714,3578746729,15
0,1250,38474,3578746714,3578746729,15
0,1250,38475,3578746714,3578746729,15
0,1250,38476,3578746714,3578746730,16
0,1250,38477,3578746714,3578746731,17
0,1250,38478,3578746714,3578746731,17
0,1250,38479,3578746714,3578746731,17
0,1250,38480,3578746714,3578746731,17
0,1250,38481,3578746714,3578746732,18
0,1250,38482,3578746714,3578746733,19
0,1250,38483,3578746714,3578746733,19
0,1250,38484,3578746714,3578746734,20
0,1250,38485,3578746714,3578746736,22
0,1250,38486,3578746714,3578746738,24
0,1250,38487,3578746714,3578746738,24
0,1250,38488,3578746714,3578746738,24
0,1250,38489,3578746714,3578746739,25
0,1250,38490,3578746714,3578746739,25
0,1250,38491,3578746714,3578746740,26
0,1250,38492,3578746714,3578746740,26
0,1250,38493,3578746714,3578746740,26
0,1250,38494,3578746714,3578746741,27
0,1250,38495,3578746714,3578746742,28
0,1250,38496,3578746714,3578746742,28
0,1250,38497,3578746714,3578746742,28
0,1250,38498,3578746714,3578746743,29
0,1250,38499,3578746714,3578746743,29
0,1250,38500,3578746714,3578746743,29
0,1250,38501,3578746714,3578746744,30
0,1250,38502,3578746714,3578746744,30
0,1250,38503,3578746714,3578746745,31
0,1250,38504,3578746714,3578746745,31
0,1250,38505,3578746714,3578746746,32
0,1250,38506,3578746714,3578746747,33
0,1250,38507,3578746714,3578746747,33
0,1250,38508,3578746714,3578746747,33
0,1250,38509,3578746714,3578746750,36
0,1250,38510,3578746714,3578746750,36
0,1250,38511,3578746714,3578746752,38
0,1250,38512,3578746714,3578746752,38
0,1250,38513,3578746714,3578746753,39
0,1250,38514,3578746714,3578746754,40
0,1250,38515,3578746714,3578746755,41
0,1250,38516,3578746714,3578746755,41
0,1250,38517,3578746714,3578746756,42
0,1250,38518,3578746714,3578746756,42
0,1250,38519,3578746714,3578746757,43
0,1250,38520,3578746714,3578746759,45
0,1250,38521,3578746714,3578746759,45
0,1250,38522,3578746714,3578746760,46
0,1250,38523,3578746714,3578746760,46
0,1250,38524,3578746714,3578746761,47
0,1250,38525,3578746714,3578746761,47
0,1250,38526,3578746714,3578746761,47
0,1250,38527,3578746714,3578746761,47
0,1250,38528,3578746714,3578746762,48
0,1250,38529,3578746714,3578746763,49
0,1251,38530,3578746776,3578746776,0
0,1251,38531,3578746776,3578746776,0
0,1251,38532,3578746776,3578746776,0
0,1251,38533,3578746776,3578746776,0
0,1251,38534,3578746776,3578746776,0
0,1251,38535,3578746776,3578746776,0
0,1251,38536,3578746776,3578746776,0
0,1251,38537,3578746776,3578746776,0
0,1251,38538,3578746776,3578746776,0
0,1251,38539,3578746776,3578746776,0
0,1251,38540,3578746776,3578746776,0
0,1251,38541,3578746776,3578746776,0
0,1251,38542,3578746776,3578746776,0
0,1251,38543,3578746776,3578746776,0
0,1251,38544,3578746776,3578746776,0
0,1251,38545,3578746776,3578746776,0
0,1251,38546,3578746776,3578746776,0
0,1251,38547,3578746776,3578746776,0
0,1251,38548,3578746776,3578746778,2
0,1251,38549,3578746776,3578746778,2
0,1251,38550,3578746776,3578746779,3
0,1251,38551,3578746776,3578746779,3
0,1251,38552,3578746776,3578746779,3
0,1251,38553,3578746776,3578746780,4
0,1251,38554,3578746776,3578746781,5
0,1251,38555,3578746776,3578746783,7
0,1251,38556,3578746776,3578746783,7
0,1251,38557,3578746776,3578746785,9
0,1251,38558,3578746776,3578746786,10
0,1251,38559,3578746776,3578746787,11
0,1251,38560,3578746776,3578746788,12
0,1251,38561,3578746776,3578746788,12
0,1251,38562,3578746776,3578746788,12
0,1251,38563,3578746776,3578746789,13
0,1251,38564,3578746776,3578746789,13
0,1251,38565,3578746776,3578746789,13
0,1251,38566,3578746776,3578746792,16
0,1251,38567,3578746776,3578746793,17
0,1251,38568,3578746776,3578746794,18
0,1251,38569,3578746776,3578746796,20
0,1251,38570,3578746776,3578746798,22
0,1251,38571,3578746776,3578746800,24
0,1251,38572,3578746776,3578746800,24
0,1251,38573,3578746776,3578746802,26
0,1251,38574,3578746776,3578746803,27
0,1251,38575,3578746776,3578746803,27
0,1251,38576,3578746776,3578746804,28
0,1251,38577,3578746776,3578746804,28
0,1251,38578,3578746776,3578746805,29
0,1251,38579,3578746776,3578746805,29
0,1251,38580,3578746776,3578746806,30
0,1251,38581,3578746776,3578746806,30
0,1251,38582,3578746776,3578746807,31
0,1251,38583,3578746776,3578746807,31
0,1251,38584,3578746776,3578746808,32
0,1251,38585,3578746776,3578746808,32
0,1251,38586,3578746776,3578746809,33
0,1251,38587,3578746776,3578746810,34
0,1251,38588,3578746776,3578746811,35
0,1251,38589,3578746776,3578746813,37
0,1251,38590,3578746776,3578746814,38
0,1251,38591,3578746776,3578746814,38
0,1251,38592,3578746776,3578746814,38
0,1251,38593,3578746776,3578746814,38
0,1251,38594,3578746776,3578746815,39
0,1251,38595,3578746776,3578746816,40
0,1251,38596,3578746776,3578746817,41
0,1251,38597,3578746776,3578746817,41
0,1251,38598,3578746776,3578746818,42
0,1251,38599,3578746776,3578746818,42
0,1251,38600,3578746776,3578746818,42
0,1251,38601,3578746776,3578746819,43
0,1251,38602,3578746776,3578746819,43
0,1251,38603,3578746776,3578746819,43
0,1251,38604,3578746776,3578746821,45
0,1251,38605,3578746776,3578746821,45
0,1251,38606,3578746776,3578746822,46
0,1251,38607,3578746776,3578746823,47
0,1251,38608,3578746776,3578746824,48
0,1251,38609,3578746776,3578746824,48
0,1251,38610,3578746776,3578746826,50
0,1252,38611,3578746838,3578746838,0
0,1252,38612,3578746838,3578746838,0
0,1252,38613,3578746838,3578746838,0
0,1252,38614,3578746838,3578746838,0
0,1252,38615,3578746838,3578746838,0
0,1252,38616,3578746838,3578746838,0
0,1252,38617,3578746838,3578746838,0
0,1252,38618,3578746838,3578746838,0
0,1252,38619,3578746838,3578746838,0
0,1252,38620,3578746838,3578746838,0
0,1252,38621,3578746838,3578746838,0
0,1252,38622,3578746838,3578746838,0
0,1252,38623,3578746838,3578746838,0
0,1252,38624,3578746838,3578746839,1
0,1252,38625,3578746838,3578746839,1
0,1252,38626,3578746838,3578746840,2
0,1252,38627,3578746838,3578746840,2
0,1252,38628,3578746838,3578746841,3
0,1252,38629,3578746838,3578746842,4
0,1252,38630,3578746838,3578746843,5
0,1252,38631,3578746838,3578746845,7
0,1252,38632,3578746838,3578746845,7
0,1252,38633,3578746838,3578746847,9
0,1252,38634,3578746838,3578746849,11
0,1252,38635,3578746838,3578746849,11
0,1252,38636,3578746838,3578746849,11
0,1252,38637,3578746838,3578746849,11
0,1252,38638,3578746838,3578746849,11
0,1252,38639,3578746838,3578746852,14
0,1252,38640,3578746838,3578746854,16
0,1252,38641,3578746838,3578746855,17
0,1252,38642,3578746838,3578746857,19
0,1252,38643,3578746838,3578746857,19
0,1252,38644,3578746838,3578746859,21
0,1252,38645,3578746838,3578746859,21
0,1252,38646,3578746838,3578746860,22
0,1252,38647,3578746838,3578746861,23
0,1252,38648,3578746838,3578746862,24
0,1252,38649,3578746838,3578746862,24
0,1252,38650,3578746838,3578746862,24
0,1252,38651,3578746838,3578746863,25
0,1252,38652,3578746838,3578746863,25
0,1252,38653,3578746838,3578746864,26
0,1252,38654,3578746838,3578746865,27
0,1252,38655,3578746838,3578746865,27
0,1252,38656,3578746838,3578746866,28
0,1252,38657,3578746838,3578746867,29
0,1252,38658,3578746838,3578746877,39
0,1252,38659,3578746838,3578746878,40
0,1252,38660,3578746838,3578746879,41
0,1252,38661,3578746838,3578746880,42
0,1252,38662,3578746838,3578746880,42
0,1252,38663,3578746838,3578746880,42
0,1252,38664,3578746838,3578746880,42
0,1252,38665,3578746838,3578746884,46
0,1252,38666,3578746838,3578746884,46
0,1252,38667,3578746838,3578746884,46
0,1252,38668,3578746838,3578746885,47
0,1252,38669,3578746838,3578746886,48
0,1252,38670,3578746838,3578746886,48
0,1252,38671,3578746838,3578746886,48
0,1252,38672,3578746838,3578746887,49
0,1253,38673,3578746899,3578746899,0
0,1253,38674,3578746899,3578746899,0
0,1253,38675,3578746899,3578746899,0
0,1253,38676,3578746899,3578746899,0
0,1253,38677,3578746899,3578746899,0
0,1253,38678,3578746899,3578746899,0
0,1253,38679,3578746899,3578746899,0
0,1253,38680,3578746899,3578746899,0
0,1253,38681,3578746899,3578746899,0
0,1253,38682,3578746899,3578746899,0
0,1253,38683,3578746899,3578746899,0
0,1253,38684,3578746899,3578746899,0
0,1253,38685,3578746899,3578746899,0
0,1253,38686,3578746899,3578746899,0
0,1253,38687,3578746899,3578746899,0
0,1253,38688,3578746899,3578746899,0
0,1253,38689,3578746899,3578746900,1
0,1253,38690,3578746899,3578746902,3
0,1253,38691,3578746899,3578746903,4
0,1253,38692,3578746899,3578746903,4
0,1253,38693,3578746899,3578746903,4
0,1253,38694,3578746899,3578746904,5
0,1253,38695,3578746899,3578746904,5
0,1253,38696,3578746899,3578746906,7
0,1253,38697,3578746899,3578746906,7
0,1253,38698,3578746899,3578746906,7
0,1253,38699,3578746899,3578746907,8
0,1253,38700,3578746899,3578746907,8
0,1253,38701,3578746899,3578746907,8
0,1253,38702,3578746899,3578746908,9
0,1253,38703,3578746899,3578746908,9
0,1253,38704,3578746899,3578746908,9
0,1253,38705,3578746899,3578746909,10
0,1253,38706,3578746899,3578746910,11
0,1253,38707,3578746899,3578746910,11
0,1253,38708,3578746899,3578746911,12
0,1253,38709,3578746899,3578746911,12
0,1253,38710,3578746899,3578746913,14
0,1253,38711,3578746899,3578746915,16
0,1253,38712,3578746899,3578746915,16
0,1253,38713,3578746899,3578746916,17
0,1253,38714,3578746899,3578746916,17
0,1253,38715,3578746899,3578746916,17
0,1253,38716,3578746899,3578746916,17
0,1253,38717,3578746899,3578746917,18
0,1253,38718,3578746899,3578746917,18
0,1253,38719,3578746899,3578746917,18
0,1253,38720,3578746899,3578746917,18
0,1253,38721,3578746899,3578746918,19
0,1253,38722,3578746899,3578746919,20
0,1253,38723,3578746899,3578746919,20
0,1253,38724,3578746899,3578746920,21
0,1253,38725,3578746899,3578746922,23
0,1253,38726,3578746899,3578746923,24
0,1253,38727,3578746899,3578746924,25
0,1253,38728,3578746899,3578746924,25
0,1253,38729,3578746899,3578746926,27
0,1253,38730,3578746899,3578746926,27
0,1253,38731,3578746899,3578746927,28
0,1253,38732,3578746899,3578746927,28
0,1253,38733,3578746899,3578746927,28
0,1253,38734,3578746899,3578746928,29
0,1253,38735,3578746899,3578746928,29
0,1253,38736,3578746899,3578746928,29
0,1253,38737,3578746899,3578746928,29
0,1253,38738,3578746899,3578746929,30
0,1253,38739,3578746899,3578746929,30
0,1253,38740,3578746899,3578746930,31
0,1253,38741,3578746899,3578746930,31
0,1253,38742,3578746899,3578746931,32
0,1253,38743,3578746899,3578746931,32
0,1253,38744,3578746899,3578746931,32
0,1253,38745,3578746899,3578746931,32
0,1253,38746,3578746899,3578746932,33
0,1253,38747,3578746899,3578746933,34
0,1253,38748,3578746899,3578746934,35
0,1253,38749,3578746899,3578746935,36
0,1253,38750,3578746899,3578746936,37
0,1253,38751,3578746899,3578746938,39
0,1253,38752,3578746899,3578746938,39
0,1253,38753,3578746899,3578746939,40
0,1253,38754,3578746899,3578746939,40
0,1253,38755,3578746899,3578746939,40
0,1253,38756,3578746899,3578746939,40
0,1253,38757,3578746899,3578746940,41
0,1253,38758,3578746899,3578746941,42
0,1253,38759,3578746899,3578746942,43
0,1253,38760,3578746899,3578746942,43
0,1253,38761,3578746899,3578746942,43
0,1253,38762,3578746899,3578746942,43
0,1253,38763,3578746899,3578746943,44
0,1253,38764,3578746899,3578746943,44
0,1253,38765,3578746899,3578746944,45
0,1253,38766,3578746899,3578746944,45
0,1253,38767,3578746899,3578746945,46
0,1253,38768,3578746899,3578746945,46
0,1253,38769,3578746899,3578746946,47
0,1253,38770,3578746899,3578746946,47
0,1253,38771,3578746899,3578746947,48
0,1253,38772,3578746899,3578746948,49
0,1254,38773,3578746961,3578746961,0
0,1254,38774,3578746961,3578746961,0
0,1254,38775,3578746961,3578746961,0
0,1254,38776,3578746961,3578746961,0
0,1254,38777,3578746961,3578746961,0
0,1254,38778,3578746961,3578746961,0
0,1254,38779,3578746961,3578746961,0
0,1254,38780,3578746961,3578746961,0
0,1254,38781,3578746961,3578746961,0
0,1254,38782,3578746961,3578746961,0
0,1254,38783,3578746961,3578746961,0
0,1254,38784,3578746961,3578746961,0
0,1254,38785,3578746961,3578746961,0
0,1254,38786,3578746961,3578746961,0
0,1254,38787,3578746961,3578746961,0
0,1254,38788,3578746961,3578746961,0
0,1254,38789,3578746961,3578746961,0
0,1254,38790,3578746961,3578746961,0
0,1254,38791,3578746961,3578746962,1
0,1254,38792,3578746961,3578746963,2
0,1254,38793,3578746961,3578746965,4
0,1254,38794,3578746961,3578746966,5
0,1254,38795,3578746961,3578746966,5
0,1254,38796,3578746961,3578746966,5
0,1254,38797,3578746961,3578746967,6
0,1254,38798,3578746961,3578746968,7
0,1254,38799,3578746961,3578746968,7
0,1254,38800,3578746961,3578746968,7
0,1254,38801,3578746961,3578746970,9
0,1254,38802,3578746961,3578746970,9
0,1254,38803,3578746961,3578746970,9
0,1254,38804,3578746961,3578746970,9
0,1254,38805,3578746961,3578746973,12
0,1254,38806,3578746961,3578746973,12
0,1254,38807,3578746961,3578746973,12
0,1254,38808,3578746961,3578746974,13
0,1254,38809,3578746961,3578746975,14
0,1254,38810,3578746961,3578746976,15
0,1254,38811,3578746961,3578746976,15
0,1254,38812,3578746961,3578746977,16
0,1254,38813,3578746961,3578746978,17
0,1254,38814,3578746961,3578746978,17
0,1254,38815,3578746961,3578746979,18
0,1254,38816,3578746961,3578746980,19
0,1254,38817,3578746961,3578746980,19
0,1254,38818,3578746961,3578746981,20
0,1254,38819,3578746961,3578746983,22
0,1254,38820,3578746961,3578746984,23
0,1254,38821,3578746961,3578746985,24
0,1254,38822,3578746961,3578746987,26
0,1254,38823,3578746961,3578746987,26
0,1254,38824,3578746961,3578746987,26
0,1254,38825,3578746961,3578746988,27
0,1254,38826,3578746961,3578746988,27
0,1254,38827,3578746961,3578746988,27
0,1254,38828,3578746961,3578746988,27
0,1254,38829,3578746961,3578746989,28
0,1254,38830,3578746961,3578746989,28
0,1254,38831,3578746961,3578746989,28
0,1254,38832,3578746961,3578746992,31
0,1254,38833,3578746961,3578746993,32
0,1254,38834,3578746961,3578746994,33
0,1254,38835,3578746961,3578746994,33
0,1254,38836,3578746961,3578746995,34
0,1254,38837,3578746961,3578746998,37
0,1254,38838,3578746961,3578747000,39
0,1254,38839,3578746961,3578747001,40
0,1254,38840,3578746961,3578747002,41
0,1254,38841,3578746961,3578747003,42
0,1254,38842,3578746961,3578747003,42
0,1254,38843,3578746961,3578747003,42
0,1254,38844,3578746961,3578747004,43
0,1254,38845,3578746961,3578747005,44
0,1254,38846,3578746961,3578747005,44
0,1254,38847,3578746961,3578747005,44
0,1254,38848,3578746961,3578747006,45
0,1254,38849,3578746961,3578747006,45
0,1254,38850,3578746961,3578747007,46
0,1254,38851,3578746961,3578747007,46
0,1254,38852,3578746961,3578747007,46
0,1254,38853,3578746961,3578747008,47
0,1254,38854,3578746961,3578747009,48
0,1254,38855,3578746961,3578747010,49
0,1254,38856,3578746961,3578747010,49
0,1255,38857,3578747024,3578747024,0
0,1255,38858,3578747024,3578747024,0
0,1255,38859,3578747024,3578747024,0
0,1255,38860,3578747024,3578747024,0
0,1255,38861,3578747024,3578747024,0
0,1255,38862,3578747024,3578747024,0
0,1255,38863,3578747024,3578747024,0
0,1255,38864,3578747024,3578747024,0
0,1255,38865,3578747024,3578747024,0
0,1255,38866,3578747024,3578747024,0
0,1255,38867,3578747024,3578747024,0
0,1255,38868,3578747024,3578747024,0
0,1255,38869,3578747024,3578747024,0
0,1255,38870,3578747024,3578747024,0
0,1255,38871,3578747024,3578747024,0
0,1255,38872,3578747024,3578747024,0
0,1255,38873,3578747024,3578747024,0
0,1255,38874,3578747024,3578747024,0
0,1255,38875,3578747024,3578747024,0
0,1255,38876,3578747024,3578747024,0
0,1255,38877,3578747024,3578747024,0
0,1255,38878,3578747024,3578747027,3
0,1255,38879,3578747024,3578747029,5
0,1255,38880,3578747024,3578747031,7
0,1255,38881,3578747024,3578747032,8
0,1255,38882,3578747024,3578747032,8
0,1255,38883,3578747024,3578747035,11
0,1255,38884,3578747024,3578747035,11
0,1255,38885,3578747024,3578747036,12
0,1255,38886,3578747024,3578747037,13
0,1255,38887,3578747024,3578747037,13
0,1255,38888,3578747024,3578747038,14
0,1255,38889,3578747024,3578747038,14
0,1255,38890,3578747024,3578747038,14
0,1255,38891,3578747024,3578747038,14
0,1255,38892,3578747024,3578747039,15
0,1255,38893,3578747024,3578747039,15
0,1255,38894,3578747024,3578747040,16
0,1255,38895,3578747024,3578747041,17
0,1255,38896,3578747024,3578747041,17
0,1255,38897,3578747024,3578747043,19
0,1255,38898,3578747024,3578747043,19
0,1255,38899,3578747024,3578747044,20
0,1255,38900,3578747024,3578747045,21
0,1255,38901,3578747024,3578747046,22
0,1255,38902,3578747024,3578747048,24
0,1255,38903,3578747024,3578747049,25
0,1255,38904,3578747024,3578747049,25
0,1255,38905,3578747024,3578747050,26
0,1255,38906,3578747024,3578747050,26
0,1255,38907,3578747024,3578747052,28
0,1255,38908,3578747024,3578747054,30
0,1255,38909,3578747024,3578747056,32
0,1255,38910,3578747024,3578747056,32
0,1255,38911,3578747024,3578747056,32
0,1255,38912,3578747024,3578747057,33
0,1255,38913,3578747024,3578747058,34
0,1255,38914,3578747024,3578747059,35
0,1255,38915,3578747024,3578747060,36
0,1255,38916,3578747024,3578747061,37
0,1255,38917,3578747024,3578747062,38
0,1255,38918,3578747024,3578747062,38
0,1255,38919,3578747024,3578747063,39
0,1255,38920,3578747024,3578747063,39
0,1255,38921,3578747024,3578747063,39
0,1255,38922,3578747024,3578747064,40
0,1255,38923,3578747024,3578747064,40
0,1255,38924,3578747024,3578747065,41
0,1255,38925,3578747024,3578747067,43
0,1255,38926,3578747024,3578747067,43
0,1255,38927,3578747024,3578747068,44
0,1256,38928,3578747086,3578747086,0
0,1256,38929,3578747086,3578747086,0
0,1256,38930,3578747086,3578747086,0
0,1256,38931,3578747086,3578747086,0
0,1256,38932,3578747086,3578747086,0
0,1256,38933,3578747086,3578747086,0
0,1256,38934,3578747086,3578747086,0
0,1256,38935,3578747086,3578747086,0
0,1256,38936,3578747086,3578747086,0
0,1256,38937,3578747086,3578747086,0
0,1256,38938,3578747086,3578747086,0
0,1256,38939,3578747086,3578747086,0
0,1256,38940,3578747086,3578747086,0
0,1256,38941,3578747086,3578747086,0
0,1256,38942,3578747086,3578747087,1
0,1256,38943,3578747086,3578747087,1
0,1256,38944,3578747086,3578747088,2
0,1256,38945,3578747086,3578747088,2
0,1256,38946,3578747086,3578747089,3
0,1256,38947,3578747086,3578747090,4
0,1256,38948,3578747086,3578747090,4
0,1256,38949,3578747086,3578747090,4
0,1256,38950,3578747086,3578747090,4
0,1256,38951,3578747086,3578747090,4
0,1256,38952,3578747086,3578747092,6
0,1256,38953,3578747086,3578747092,6
0,1256,38954,3578747086,3578747093,7
0,1256,38955,3578747086,3578747093,7
0,1256,38956,3578747086,3578747094,8
0,1256,38957,3578747086,3578747095,9
0,1256,38958,3578747086,3578747097,11
0,1256,38959,3578747086,3578747098,12
0,1256,38960,3578747086,3578747099,13
0,1256,38961,3578747086,3578747102,16
0,1256,38962,3578747086,3578747102,16
0,1256,38963,3578747086,3578747103,17
0,1256,38964,3578747086,3578747103,17
0,1256,38965,3578747086,3578747104,18
0,1256,38966,3578747086,3578747104,18
0,1256,38967,3578747086,3578747106,20
0,1256,38968,3578747086,3578747106,20
0,1256,38969,3578747086,3578747106,20
0,1256,38970,3578747086,3578747107,21
0,1256,38971,3578747086,3578747107,21
0,1256,38972,3578747086,3578747108,22
0,1256,38973,3578747086,3578747108,22
0,1256,38974,3578747086,3578747109,23
0,1256,38975,3578747086,3578747109,23
0,1256,38976,3578747086,3578747110,24
0,1256,38977,3578747086,3578747110,24
0,1256,38978,3578747086,3578747111,25
0,1256,38979,3578747086,3578747111,25
0,1256,38980,3578747086,3578747111,25
0,1256,38981,3578747086,3578747113,27
0,1256,38982,3578747086,3578747115,29
0,1256,38983,3578747086,3578747116,30
0,1256,38984,3578747086,3578747116,30
0,1256,38985,3578747086,3578747116,30
0,1256,38986,3578747086,3578747116,30
0,1256,38987,3578747086,3578747116,30
0,1256,38988,3578747086,3578747116,30
0,1256,38989,3578747086,3578747116,30
0,1256,38990,3578747086,3578747117,31
0,1256,38991,3578747086,3578747117,31
0,1256,38992,3578747086,3578747118,32
0,1256,38993,3578747086,3578747118,32
0,1256,38994,3578747086,3578747118,32
0,1256,38995,3578747086,3578747119,33
0,1256,38996,3578747086,3578747119,33
0,1256,38997,3578747086,3578747119,33
0,1256,38998,3578747086,3578747122,36
0,1256,38999,3578747086,3578747124,38
0,1256,39000,3578747086,3578747124,38
0,1256,39001,3578747086,3578747125,39
0,1256,39002,3578747086,3578747127,41
0,1256,39003,3578747086,3578747127,41
0,1256,39004,3578747086,3578747127,41
0,1256,39005,3578747086,3578747127,41
0,1256,39006,3578747086,3578747128,42
0,1256,39007,3578747086,3578747128,42
0,1256,39008,3578747086,3578747128,42
0,1256,39009,3578747086,3578747128,42
0,1256,39010,3578747086,3578747129,43
0,1256,39011,3578747086,3578747129,43
0,1256,39012,3578747086,3578747131,45
0,1256,39013,3578747086,3578747131,45
0,1256,39014,3578747086,3578747131,45
0,1256,39015,3578747086,3578747131,45
0,1256,39016,3578747086,3578747131,45
0,1256,39017,3578747086,3578747131,45
0,1256,39018,3578747086,3578747133,47
0,1256,39019,3578747086,3578747133,47
0,1256,39020,3578747086,3578747133,47
0,1256,39021,3578747086,3578747134,48
0,1256,39022,3578747086,3578747135,49
0,1256,39023,3578747086,3578747135,49
0,1257,39024,3578747148,3578747148,0
0,1257,39025,3578747148,3578747148,0
0,1257,39026,3578747148,3578747148,0
0,1257,39027,3578747148,3578747148,0
0,1257,39028,3578747148,3578747148,0
0,1257,39029,3578747148,3578747148,0
0,1257,39030,3578747148,3578747148,0
0,1257,39031,3578747148,3578747148,0
0,1257,39032,3578747148,3578747148,0
0,1257,39033,3578747148,3578747148,0
0,1257,39034,3578747148,3578747148,0
0,1257,39035,3578747148,3578747148,0
0,1257,39036,3578747148,3578747148,0
0,1257,39037,3578747148,3578747148,0
0,1257,39038,3578747148,3578747148,0
0,1257,39039,3578747148,3578747148,0
0,1257,39040,3578747148,3578747148,0
0,1257,39041,3578747148,3578747148,0
0,1257,39042,3578747148,3578747148,0
0,1257,39043,3578747148,3578747148,0
0,1257,39044,3578747148,3578747151,3
0,1257,39045,3578747148,3578747152,4
0,1257,39046,3578747148,3578747153,5
0,1257,39047,3578747148,3578747153,5
0,1257,39048,3578747148,3578747154,6
0,1257,39049,3578747148,3578747155,7
0,1257,39050,3578747148,3578747155,7
0,1257,39051,3578747148,3578747155,7
0,1257,39052,3578747148,3578747156,8
0,1257,39053,3578747148,3578747158,10
0,1257,39054,3578747148,3578747158,10
0,1257,39055,3578747148,3578747159,11
0,1257,39056,3578747148,3578747160,12
0,1257,39057,3578747148,3578747161,13
0,1257,39058,3578747148,3578747161,13
0,1257,39059,3578747148,3578747161,13
0,1257,39060,3578747148,3578747161,13
0,1257,39061,3578747148,3578747162,14
0,1257,39062,3578747148,3578747163,15
0,1257,39063,3578747148,3578747164,16
0,1257,39064,3578747148,3578747165,17
0,1257,39065,3578747148,3578747165,17
0,1257,39066,3578747148,3578747166,18
0,1257,39067,3578747148,3578747166,18
0,1257,39068,3578747148,3578747167,19
0,1257,39069,3578747148,3578747167,19
0,1257,39070,3578747148,3578747168,20
0,1257,39071,3578747148,3578747168,20
0,1257,39072,3578747148,3578747170,22
0,1257,39073,3578747148,3578747171,23
0,1257,39074,3578747148,3578747171,23
0,1257,39075,3578747148,3578747173,25
0,1257,39076,3578747148,3578747173,25
0,1257,39077,3578747148,3578747174,26
0,1257,39078,3578747148,3578747175,27
0,1257,39079,3578747148,3578747176,28
0,1257,39080,3578747148,3578747177,29
0,1257,39081,3578747148,3578747179,31
0,1257,39082,3578747148,3578747179,31
0,1257,39083,3578747148,3578747179,31
0,1257,39084,3578747148,3578747179,31
0,1257,39085,3578747148,3578747180,32
0,1257,39086,3578747148,3578747182,34
0,1257,39087,3578747148,3578747183,35
0,1257,39088,3578747148,3578747184,36
0,1257,39089,3578747148,3578747185,37
0,1257,39090,3578747148,3578747186,38
0,1257,39091,3578747148,3578747187,39
0,1257,39092,3578747148,3578747188,40
0,1257,39093,3578747148,3578747188,40
0,1257,39094,3578747148,3578747188,40
0,1257,39095,3578747148,3578747188,40
0,1257,39096,3578747148,3578747189,41
0,1257,39097,3578747148,3578747189,41
0,1257,39098,3578747148,3578747189,41
0,1257,39099,3578747148,3578747190,42
0,1257,39100,3578747148,3578747193,45
0,1257,39101,3578747148,3578747193,45
0,1257,39102,3578747148,3578747193,45
0,1257,39103,3578747148,3578747194,46
0,1257,39104,3578747148,3578747198,50
0,1258,39105,3578747210,3578747210,0
0,1258,39106,3578747210,3578747210,0
0,1258,39107,3578747210,3578747210,0
0,1258,39108,3578747210,3578747210,0
0,1258,39109,3578747210,3578747210,0
0,1258,39110,3578747210,3578747210,0
0,1258,39111,3578747210,3578747210,0
0,1258,39112,3578747210,3578747210,0
0,1258,39113,3578747210,3578747210,0
0,1258,39114,3578747210,3578747210,0
0,1258,39115,3578747210,3578747210,0
0,1258,39116,3578747210,3578747210,0
0,1258,39117,3578747210,3578747210,0
0,1258,39118,3578747210,3578747210,0
0,1258,39119,3578747210,3578747210,0
0,1258,39120,3578747210,3578747210,0
0,1258,39121,3578747210,3578747210,0
0,1258,39122,3578747210,3578747210,0
0,1258,39123,3578747210,3578747210,0
0,1258,39124,3578747210,3578747212,2
0,1258,39125,3578747210,3578747214,4
0,1258,39126,3578747210,3578747215,5
0,1258,39127,3578747210,3578747215,5
0,1258,39128,3578747210,3578747215,5
0,1258,39129,3578747210,3578747215,5
0,1258,39130,3578747210,3578747215,5
0,1258,39131,3578747210,3578747216,6
0,1258,39132,3578747210,3578747216,6
0,1258,39133,3578747210,3578747217,7
0,1258,39134,3578747210,3578747218,8
0,1258,39135,3578747210,3578747218,8
0,1258,39136,3578747210,3578747219,9
0,1258,39137,3578747210,3578747220,10
0,1258,39138,3578747210,3578747221,11
0,1258,39139,3578747210,3578747221,11
0,1258,39140,3578747210,3578747221,11
0,1258,39141,3578747210,3578747223,13
0,1258,39142,3578747210,3578747223,13
0,1258,39143,3578747210,3578747224,14
0,1258,39144,3578747210,3578747224,14
0,1258,39145,3578747210,3578747225,15
0,1258,39146,3578747210,3578747228,18
0,1258,39147,3578747210,3578747228,18
0,1258,39148,3578747210,3578747230,20
0,1258,39149,3578747210,3578747231,21
0,1258,39150,3578747210,3578747232,22
0,1258,39151,3578747210,3578747232,22
0,1258,39152,3578747210,3578747232,22
0,1258,39153,3578747210,3578747235,25
0,1258,39154,3578747210,3578747236,26
0,1258,39155,3578747210,3578747236,26
0,1258,39156,3578747210,3578747236,26
0,1258,39157,3578747210,3578747238,28
0,1258,39158,3578747210,3578747238,28
0,1258,39159,3578747210,3578747238,28
0,1258,39160,3578747210,3578747239,29
0,1258,39161,3578747210,3578747239,29
0,1258,39162,3578747210,3578747239,29
0,1258,39163,3578747210,3578747240,30
0,1258,39164,3578747210,3578747240,30
0,1258,39165,3578747210,3578747241,31
0,1258,39166,3578747210,3578747241,31
0,1258,39167,3578747210,3578747242,32
0,1258,39168,3578747210,3578747243,33
0,1258,39169,3578747210,3578747244,34
0,1258,39170,3578747210,3578747245,35
0,1258,39171,3578747210,3578747245,35
0,1258,39172,3578747210,3578747248,38
0,1258,39173,3578747210,3578747248,38
0,1258,39174,3578747210,3578747248,38
0,1258,39175,3578747210,3578747249,39
0,1258,39176,3578747210,3578747249,39
0,1258,39177,3578747210,3578747249,39
0,1258,39178,3578747210,3578747250,40
0,1258,39179,3578747210,3578747256,46
0,1258,39180,3578747210,3578747256,46
0,1258,39181,3578747210,3578747256,46
0,1258,39182,3578747210,3578747257,47
0,1258,39183,3578747210,3578747259,49
0,1258,39184,3578747210,3578747259,49
0,1259,39185,3578747272,3578747272,0
0,1259,39186,3578747272,3578747272,0
0,1259,39187,3578747272,3578747272,0
0,1259,39188,3578747272,3578747272,0
0,1259,39189,3578747272,3578747272,0
0,1259,39190,3578747272,3578747272,0
0,1259,39191,3578747272,3578747272,0
0,1259,39192,3578747272,3578747272,0
0,1259,39193,3578747272,3578747272,0
0,1259,39194,3578747272,3578747272,0
0,1259,39195,3578747272,3578747272,0
0,1259,39196,3578747272,3578747272,0
0,1259,39197,3578747272,3578747272,0
0,1259,39198,3578747272,3578747277,5
0,1259,39199,3578747272,3578747278,6
0,1259,39200,3578747272,3578747279,7
0,1259,39201,3578747272,3578747280,8
0,1259,39202,3578747272,3578747281,9
0,1259,39203,3578747272,3578747282,10
0,1259,39204,3578747272,3578747284,12
0,1259,39205,3578747272,3578747284,12
0,1259,39206,3578747272,3578747285,13
0,1259,39207,3578747272,3578747285,13
0,1259,39208,3578747272,3578747285,13
0,1259,39209,3578747272,3578747286,14
0,1259,39210,3578747272,3578747286,14
0,1259,39211,3578747272,3578747286,14
0,1259,39212,3578747272,3578747288,16
0,1259,39213,3578747272,3578747288,16
0,1259,39214,3578747272,3578747288,16
0,1259,39215,3578747272,3578747289,17
0,1259,39216,3578747272,3578747289,17
0,1259,39217,3578747272,3578747290,18
0,1259,39218,3578747272,3578747290,18
0,1259,39219,3578747272,3578747290,18
0,1259,39220,3578747272,3578747291,19
0,1259,39221,3578747272,3578747291,19
0,1259,39222,3578747272,3578747293,21
0,1259,39223,3578747272,3578747293,21
0,1259,39224,3578747272,3578747293,21
0,1259,39225,3578747272,3578747293,21
0,1259,39226,3578747272,3578747294,22
0,1259,39227,3578747272,3578747295,23
0,1259,39228,3578747272,3578747295,23
0,1259,39229,3578747272,3578747297,25
0,1259,39230,3578747272,3578747298,26
0,1259,39231,3578747272,3578747300,28
0,1259,39232,3578747272,3578747302,30
0,1259,39233,3578747272,3578747302,30
0,1259,39234,3578747272,3578747302,30
0,1259,39235,3578747272,3578747303,31
0,1259,39236,3578747272,3578747303,31
0,1259,39237,3578747272,3578747304,32
0,1259,39238,3578747272,3578747304,32
0,1259,39239,3578747272,3578747306,34
0,1259,39240,3578747272,3578747306,34
0,1259,39241,3578747272,3578747307,35
0,1259,39242,3578747272,3578747307,35
0,1259,39243,3578747272,3578747307,35
0,1259,39244,3578747272,3578747307,35
0,1259,39245,3578747272,3578747307,35
0,1259,39246,3578747272,3578747308,36
0,1259,39247,3578747272,3578747308,36
0,1259,39248,3578747272,3578747308,36
0,1259,39249,3578747272,3578747310,38
0,1259,39250,3578747272,3578747310,38
0,1259,39251,3578747272,3578747310,38
0,1259,39252,3578747272,3578747311,39
0,1259,39253,3578747272,3578747311,39
0,1259,39254,3578747272,3578747311,39
0,1259,39255,3578747272,3578747312,40
0,1259,39256,3578747272,3578747314,42
0,1259,39257,3578747272,3578747315,43
0,1259,39258,3578747272,3578747315,43
0,1259,39259,3578747272,3578747315,43
0,1259,39260,3578747272,3578747316,44
0,1259,39261,3578747272,3578747316,44
0,1259,39262,3578747272,3578747316,44
0,1259,39263,3578747272,3578747317,45
0,1259,39264,3578747272,3578747317,45
0,1259,39265,3578747272,3578747318,46
0,1259,39266,3578747272,3578747319,47
0,1259,39267,3578747272,3578747319,47
0,1259,39268,3578747272,3578747319,47
0,1259,39269,3578747272,3578747319,47
0,1259,39270,3578747272,3578747319,47
0,1259,39271,3578747272,3578747319,47
0,1259,39272,3578747272,3578747320,48
0,1259,39273,3578747272,3578747322,50
0,1260,39274,3578747334,3578747334,0
0,1260,39275,3578747334,3578747334,0
0,1260,39276,3578747334,3578747334,0
0,1260,39277,3578747334,3578747334,0
0,1260,39278,3578747334,3578747334,0
0,1260,39279,3578747334,3578747334,0
0,1260,39280,3578747334,3578747334,0
0,1260,39281,3578747334,3578747334,0
0,1260,39282,3578747334,3578747334,0
0,1260,39283,3578747334,3578747334,0
0,1260,39284,3578747334,3578747334,0
0,1260,39285,3578747334,3578747334,0
0,1260,39286,3578747334,3578747334,0
0,1260,39287,3578747334,3578747334,0
0,1260,39288,3578747334,3578747334,0
0,1260,39289,3578747334,3578747334,0
0,1260,39290,3578747334,3578747334,0
0,1260,39291,3578747334,3578747334,0
0,1260,39292,3578747334,3578747334,0
0,1260,39293,3578747334,3578747334,0
0,1260,39294,3578747334,3578747334,0
0,1260,39295,3578747334,3578747334,0
0,1260,39296,3578747334,3578747334,0
0,1260,39297,3578747334,3578747335,1
0,1260,39298,3578747334,3578747335,1
0,1260,39299,3578747334,3578747339,5
0,1260,39300,3578747334,3578747339,5
0,1260,39301,3578747334,3578747340,6
0,1260,39302,3578747334,3578747340,6
0,1260,39303,3578747334,3578747340,6
0,1260,39304,3578747334,3578747341,7
0,1260,39305,3578747334,3578747342,8
0,1260,39306,3578747334,3578747342,8
0,1260,39307,3578747334,3578747343,9
0,1260,39308,3578747334,3578747343,9
0,1260,39309,3578747334,3578747343,9
0,1260,39310,3578747334,3578747344,10
0,1260,39311,3578747334,3578747344,10
0,1260,39312,3578747334,3578747344,10
0,1260,39313,3578747334,3578747345,11
0,1260,39314,3578747334,3578747346,12
0,1260,39315,3578747334,3578747346,12
0,1260,39316,3578747334,3578747346,12
0,1260,39317,3578747334,3578747347,13
0,1260,39318,3578747334,3578747347,13
0,1260,39319,3578747334,3578747348,14
0,1260,39320,3578747334,3578747351,17
0,1260,39321,3578747334,3578747352,18
0,1260,39322,3578747334,3578747353,19
0,1260,39323,3578747334,3578747353,19
0,1260,39324,3578747334,3578747354,20
0,1260,39325,3578747334,3578747355,21
0,1260,39326,3578747334,3578747355,21
0,1260,39327,3578747334,3578747355,21
0,1260,39328,3578747334,3578747356,22
0,1260,39329,3578747334,3578747358,24
0,1260,39330,3578747334,3578747359,25
0,1260,39331,3578747334,3578747360,26
0,1260,39332,3578747334,3578747361,27
0,1260,39333,3578747334,3578747361,27
0,1260,39334,3578747334,3578747361,27
0,1260,39335,3578747334,3578747362,28
0,1260,39336,3578747334,3578747362,28
0,1260,39337,3578747334,3578747363,29
0,1260,39338,3578747334,3578747365,31
0,1260,39339,3578747334,3578747365,31
0,1260,39340,3578747334,3578747366,32
0,1260,39341,3578747334,3578747366,32
0,1260,39342,3578747334,3578747367,33
0,1260,39343,3578747334,3578747367,33
0,1260,39344,3578747334,3578747367,33
0,1260,39345,3578747334,3578747368,34
0,1260,39346,3578747334,3578747369,35
0,1260,39347,3578747334,3578747370,36
0,1260,39348,3578747334,3578747371,37
0,1260,39349,3578747334,3578747372,38
0,1260,39350,3578747334,3578747372,38
0,1260,39351,3578747334,3578747373,39
0,1260,39352,3578747334,3578747374,40
0,1260,39353,3578747334,3578747374,40
0,1260,39354,3578747334,3578747375,41
0,1260,39355,3578747334,3578747376,42
0,1260,39356,3578747334,3578747377,43
0,1260,39357,3578747334,3578747378,44
0,1260,39358,3578747334,3578747379,45
0,1260,39359,3578747334,3578747379,45
0,1260,39360,3578747334,3578747379,45
0,1260,39361,3578747334,3578747380,46
0,1260,39362,3578747334,3578747380,46
0,1260,39363,3578747334,3578747382,48
0,1260,39364,3578747334,3578747383,49
0,1261,39365,3578747396,3578747396,0
0,1261,39366,3578747396,3578747396,0
0,1261,39367,3578747396,3578747396,0
0,1261,39368,3578747396,3578747396,0
0,1261,39369,3578747396,3578747396,0
0,1261,39370,3578747396,3578747396,0
0,1261,39371,3578747396,3578747396,0
0,1261,39372,3578747396,3578747396,0
0,1261,39373,3578747396,3578747396,0
0,1261,39374,3578747396,3578747396,0
0,1261,39375,3578747396,3578747396,0
0,1261,39376,3578747396,3578747396,0
0,1261,39377,3578747396,3578747396,0
0,1261,39378,3578747396,3578747396,0
0,1261,39379,3578747396,3578747396,0
0,1261,39380,3578747396,3578747396,0
0,1261,39381,3578747396,3578747396,0
0,1261,39382,3578747396,3578747399,3
0,1261,39383,3578747396,3578747401,5
0,1261,39384,3578747396,3578747401,5
0,1261,39385,3578747396,3578747403,7
0,1261,39386,3578747396,3578747403,7
0,1261,39387,3578747396,3578747403,7
0,1261,39388,3578747396,3578747404,8
0,1261,39389,3578747396,3578747404,8
0,1261,39390,3578747396,3578747404,8
0,1261,39391,3578747396,3578747406,10
0,1261,39392,3578747396,3578747406,10
0,1261,39393,3578747396,3578747406,10
0,1261,39394,3578747396,3578747406,10
0,1261,39395,3578747396,3578747407,11
0,1261,39396,3578747396,3578747407,11
0,1261,39397,3578747396,3578747408,12
0,1261,39398,3578747396,3578747408,12
0,1261,39399,3578747396,3578747409,13
0,1261,39400,3578747396,3578747409,13
0,1261,39401,3578747396,3578747410,14
0,1261,39402,3578747396,3578747412,16
0,1261,39403,3578747396,3578747413,17
0,1261,39404,3578747396,3578747414,18
0,1261,39405,3578747396,3578747415,19
0,1261,39406,3578747396,3578747415,19
0,1261,39407,3578747396,3578747415,19
0,1261,39408,3578747396,3578747416,20
0,1261,39409,3578747396,3578747416,20
0,1261,39410,3578747396,3578747416,20
0,1261,39411,3578747396,3578747416,20
0,1261,39412,3578747396,3578747418,22
0,1261,39413,3578747396,3578747419,23
0,1261,39414,3578747396,3578747419,23
0,1261,39415,3578747396,3578747420,24
0,1261,39416,3578747396,3578747421,25
0,1261,39417,3578747396,3578747422,26
0,1261,39418,3578747396,3578747423,27
0,1261,39419,3578747396,3578747423,27
0,1261,39420,3578747396,3578747424,28
0,1261,39421,3578747396,3578747424,28
0,1261,39422,3578747396,3578747425,29
0,1261,39423,3578747396,3578747430,34
0,1261,39424,3578747396,3578747431,35
0,1261,39425,3578747396,3578747431,35
0,1261,39426,3578747396,3578747433,37
0,1261,39427,3578747396,3578747433,37
0,1261,39428,3578747396,3578747436,40
0,1261,39429,3578747396,3578747436,40
0,1261,39430,3578747396,3578747436,40
0,1261,39431,3578747396,3578747437,41
0,1261,39432,3578747396,3578747438,42
0,1261,39433,3578747396,3578747438,42
0,1261,39434,3578747396,3578747439,43
0,1261,39435,3578747396,3578747440,44
0,1261,39436,3578747396,3578747440,44
0,1261,39437,3578747396,3578747440,44
0,1261,39438,3578747396,3578747440,44
0,1261,39439,3578747396,3578747442,46
0,1261,39440,3578747396,3578747442,46
0,1261,39441,3578747396,3578747443,47
0,1261,39442,3578747396,3578747444,48
0,1261,39443,3578747396,3578747445,49
0,1261,39444,3578747396,3578747446,50
0,1262,39445,3578747459,3578747459,0
0,1262,39446,3578747459,3578747459,0
0,1262,39447,3578747459,3578747459,0
0,1262,39448,3578747459,3578747459,0
0,1262,39449,3578747459,3578747459,0
0,1262,39450,3578747459,3578747459,0
0,1262,39451,3578747459,3578747459,0
0,1262,39452,3578747459,3578747459,0
0,1262,39453,3578747459,3578747459,0
0,1262,39454,3578747459,3578747459,0
0,1262,39455,3578747459,3578747459,0
0,1262,39456,3578747459,3578747459,0
0,1262,39457,3578747459,3578747459,0
0,1262,39458,3578747459,3578747459,0
0,1262,39459,3578747459,3578747459,0
0,1262,39460,3578747459,3578747459,0
0,1262,39461,3578747459,3578747460,1
0,1262,39462,3578747459,3578747460,1
0,1262,39463,3578747459,3578747462,3
0,1262,39464,3578747459,3578747463,4
0,1262,39465,3578747459,3578747463,4
0,1262,39466,3578747459,3578747463,4
0,1262,39467,3578747459,3578747464,5
0,1262,39468,3578747459,3578747465,6
0,1262,39469,3578747459,3578747465,6
0,1262,39470,3578747459,3578747466,7
0,1262,39471,3578747459,3578747466,7
0,1262,39472,3578747459,3578747467,8
0,1262,39473,3578747459,3578747467,8
0,1262,39474,3578747459,3578747468,9
0,1262,39475,3578747459,3578747476,17
0,1262,39476,3578747459,3578747478,19
0,1262,39477,3578747459,3578747479,20
0,1262,39478,3578747459,3578747480,21
0,1262,39479,3578747459,3578747480,21
0,1262,39480,3578747459,3578747481,22
0,1262,39481,3578747459,3578747482,23
0,1262,39482,3578747459,3578747484,25
0,1262,39483,3578747459,3578747484,25
0,1262,39484,3578747459,3578747485,26
0,1262,39485,3578747459,3578747485,26
0,1262,39486,3578747459,3578747486,27
0,1262,39487,3578747459,3578747487,28
0,1262,39488,3578747459,3578747487,28
0,1262,39489,3578747459,3578747487,28
0,1262,39490,3578747459,3578747488,29
0,1262,39491,3578747459,3578747488,29
0,1262,39492,3578747459,3578747489,30
0,1262,39493,3578747459,3578747489,30
0,1262,39494,3578747459,3578747490,31
0,1262,39495,3578747459,3578747490,31
0,1262,39496,3578747459,3578747490,31
0,1262,39497,3578747459,3578747491,32
0,1262,39498,3578747459,3578747491,32
0,1262,39499,3578747459,3578747491,32
0,1262,39500,3578747459,3578747492,33
0,1262,39501,3578747459,3578747493,34
0,1262,39502,3578747459,3578747493,34
0,1262,39503,3578747459,3578747494,35
0,1262,39504,3578747459,3578747495,36
0,1262,39505,3578747459,3578747497,38
0,1262,39506,3578747459,3578747498,39
0,1262,39507,3578747459,3578747499,40
0,1262,39508,3578747459,3578747500,41
0,1262,39509,3578747459,3578747502,43
0,1262,39510,3578747459,3578747502,43
0,1262,39511,3578747459,3578747502,43
0,1262,39512,3578747459,3578747503,44
0,1262,39513,3578747459,3578747503,44
0,1262,39514,3578747459,3578747504,45
0,1262,39515,3578747459,3578747504,45
0,1262,39516,3578747459,3578747506,47
0,1262,39517,3578747459,3578747506,47
0,1262,39518,3578747459,3578747507,48
0,1262,39519,3578747459,3578747507,48
0,1262,39520,3578747459,3578747507,48
0,1262,39521,3578747459,3578747507,48
0,1262,39522,3578747459,3578747508,49
0,1262,39523,3578747459,3578747508,49
0,1262,39524,3578747459,3578747509,50
0,1263,39525,3578747523,3578747523,0
0,1263,39526,3578747523,3578747523,0
0,1263,39527,3578747523,3578747523,0
0,1263,39528,3578747523,3578747523,0
0,1263,39529,3578747523,3578747523,0
0,1263,39530,3578747523,3578747523,0
0,1263,39531,3578747523,3578747523,0
0,1263,39532,3578747523,3578747523,0
0,1263,39533,3578747523,3578747523,0
0,1263,39534,3578747523,3578747523,0
0,1263,39535,3578747523,3578747523,0
0,1263,39536,3578747523,3578747523,0
0,1263,39537,3578747523,3578747523,0
0,1263,39538,3578747523,3578747523,0
0,1263,39539,3578747523,3578747523,0
0,1263,39540,3578747523,3578747523,0
0,1263,39541,3578747523,3578747523,0
0,1263,39542,3578747523,3578747523,0
0,1263,39543,3578747523,3578747523,0
0,1263,39544,3578747523,3578747523,0
0,1263,39545,3578747523,3578747523,0
0,1263,39546,3578747523,3578747523,0
0,1263,39547,3578747523,3578747523,0
0,1263,39548,3578747523,3578747523,0
0,1263,39549,3578747523,3578747523,0
0,1263,39550,3578747523,3578747524,1
0,1263,39551,3578747523,3578747524,1
0,1263,39552,3578747523,3578747525,2
0,1263,39553,3578747523,3578747526,3
0,1263,39554,3578747523,3578747526,3
0,1263,39555,3578747523,3578747526,3
0,1263,39556,3578747523,3578747527,4
0,1263,39557,3578747523,3578747527,4
0,1263,39558,3578747523,3578747528,5
0,1263,39559,3578747523,3578747528,5
0,1263,39560,3578747523,3578747528,5
0,1263,39561,3578747523,3578747529,6
0,1263,39562,3578747523,3578747530,7
0,1263,39563,3578747523,3578747530,7
0,1263,39564,3578747523,3578747530,7
0,1263,39565,3578747523,3578747530,7
0,1263,39566,3578747523,3578747530,7
0,1263,39567,3578747523,3578747530,7
0,1263,39568,3578747523,3578747531,8
0,1263,39569,3578747523,3578747532,9
0,1263,39570,3578747523,3578747532,9
0,1263,39571,3578747523,3578747533,10
0,1263,39572,3578747523,3578747533,10
0,1263,39573,3578747523,3578747534,11
0,1263,39574,3578747523,3578747538,15
0,1263,39575,3578747523,3578747539,16
0,1263,39576,3578747523,3578747539,16
0,1263,39577,3578747523,3578747539,16
0,1263,39578,3578747523,3578747540,17
0,1263,39579,3578747523,3578747541,18
0,1263,39580,3578747523,3578747541,18
0,1263,39581,3578747523,3578747542,19
0,1263,39582,3578747523,3578747542,19
0,1263,39583,3578747523,3578747542,19
0,1263,39584,3578747523,3578747542,19
0,1263,39585,3578747523,3578747542,19
0,1263,39586,3578747523,3578747543,20
0,1263,39587,3578747523,3578747544,21
0,1263,39588,3578747523,3578747544,21
0,1263,39589,3578747523,3578747545,22
0,1263,39590,3578747523,3578747545,22
0,1263,39591,3578747523,3578747545,22
0,1263,39592,3578747523,3578747546,23
0,1263,39593,3578747523,3578747547,24
0,1263,39594,3578747523,3578747550,27
0,1263,39595,3578747523,3578747551,28
0,1263,39596,3578747523,3578747552,29
0,1263,39597,3578747523,3578747552,29
0,1263,39598,3578747523,3578747553,30
0,1263,39599,3578747523,3578747554,31
0,1263,39600,3578747523,3578747554,31
0,1263,39601,3578747523,3578747554,31
0,1263,39602,3578747523,3578747557,34
0,1263,39603,3578747523,3578747557,34
0,1263,39604,3578747523,3578747559,36
0,1263,39605,3578747523,3578747560,37
0,1263,39606,3578747523,3578747560,37
0,1263,39607,3578747523,3578747560,37
0,1263,39608,3578747523,3578747560,37
0,1263,39609,3578747523,3578747560,37
0,1263,39610,3578747523,3578747561,38
0,1263,39611,3578747523,3578747562,39
0,1263,39612,3578747523,3578747563,40
0,1263,39613,3578747523,3578747564,41
0,1263,39614,3578747523,3578747564,41
0,1263,39615,3578747523,3578747565,42
0,1263,39616,3578747523,3578747565,42
0,1263,39617,3578747523,3578747566,43
0,1263,39618,3578747523,3578747567,44
0,1263,39619,3578747523,3578747567,44
0,1263,39620,3578747523,3578747567,44
0,1263,39621,3578747523,3578747567,44
0,1263,39622,3578747523,3578747569,46
0,1263,39623,3578747523,3578747569,46
0,1263,39624,3578747523,3578747570,47
0,1263,39625,3578747523,3578747571,48
0,1263,39626,3578747523,3578747571,48
0,1263,39627,3578747523,3578747573,50
0,1264,39628,3578747585,3578747585,0
0,1264,39629,3578747585,3578747585,0
0,1264,39630,3578747585,3578747585,0
0,1264,39631,3578747585,3578747585,0
0,1264,39632,3578747585,3578747585,0
0,1264,39633,3578747585,3578747585,0
0,1264,39634,3578747585,3578747585,0
0,1264,39635,3578747585,3578747585,0
0,1264,39636,3578747585,3578747585,0
0,1264,39637,3578747585,3578747585,0
0,1264,39638,3578747585,3578747585,0
0,1264,39639,3578747585,3578747585,0
0,1264,39640,3578747585,3578747585,0
0,1264,39641,3578747585,3578747585,0
0,1264,39642,3578747585,3578747587,2
0,1264,39643,3578747585,3578747587,2
0,1264,39644,3578747585,3578747587,2
0,1264,39645,3578747585,3578747587,2
0,1264,39646,3578747585,3578747588,3
0,1264,39647,3578747585,3578747588,3
0,1264,39648,3578747585,3578747588,3
0,1264,39649,3578747585,3578747590,5
0,1264,39650,3578747585,3578747592,7
0,1264,39651,3578747585,3578747593,8
0,1264,39652,3578747585,3578747593,8
0,1264,39653,3578747585,3578747593,8
0,1264,39654,3578747585,3578747593,8
0,1264,39655,3578747585,3578747595,10
0,1264,39656,3578747585,3578747598,13
0,1264,39657,3578747585,3578747600,15
0,1264,39658,3578747585,3578747602,17
0,1264,39659,3578747585,3578747603,18
0,1264,39660,3578747585,3578747603,18
0,1264,39661,3578747585,3578747603,18
0,1264,39662,3578747585,3578747604,19
0,1264,39663,3578747585,3578747604,19
0,1264,39664,3578747585,3578747604,19
0,1264,39665,3578747585,3578747604,19
0,1264,39666,3578747585,3578747605,20
0,1264,39667,3578747585,3578747605,20
0,1264,39668,3578747585,3578747606,21
0,1264,39669,3578747585,3578747606,21
0,1264,39670,3578747585,3578747607,22
0,1264,39671,3578747585,3578747608,23
0,1264,39672,3578747585,3578747608,23
0,1264,39673,3578747585,3578747608,23
0,1264,39674,3578747585,3578747610,25
0,1264,39675,3578747585,3578747611,26
0,1264,39676,3578747585,3578747612,27
0,1264,39677,3578747585,3578747614,29
0,1264,39678,3578747585,3578747614,29
0,1264,39679,3578747585,3578747614,29
0,1264,39680,3578747585,3578747615,30
0,1264,39681,3578747585,3578747615,30
0,1264,39682,3578747585,3578747615,30
0,1264,39683,3578747585,3578747615,30
0,1264,39684,3578747585,3578747615,30
0,1264,39685,3578747585,3578747616,31
0,1264,39686,3578747585,3578747617,32
0,1264,39687,3578747585,3578747618,33
0,1264,39688,3578747585,3578747618,33
0,1264,39689,3578747585,3578747618,33
0,1264,39690,3578747585,3578747619,34
0,1264,39691,3578747585,3578747619,34
0,1264,39692,3578747585,3578747622,37
0,1264,39693,3578747585,3578747622,37
0,1264,39694,3578747585,3578747622,37
0,1264,39695,3578747585,3578747623,38
0,1264,39696,3578747585,3578747623,38
0,1264,39697,3578747585,3578747623,38
0,1264,39698,3578747585,3578747625,40
0,1264,39699,3578747585,3578747627,42
0,1264,39700,3578747585,3578747628,43
0,1264,39701,3578747585,3578747629,44
0,1264,39702,3578747585,3578747631,46
0,1264,39703,3578747585,3578747631,46
0,1264,39704,3578747585,3578747633,48
0,1264,39705,3578747585,3578747635,50
0,1265,39706,3578747646,3578747646,0
0,1265,39707,3578747646,3578747646,0
0,1265,39708,3578747646,3578747646,0
0,1265,39709,3578747646,3578747646,0
0,1265,39710,3578747646,3578747646,0
0,1265,39711,3578747646,3578747646,0
0,1265,39712,3578747646,3578747646,0
0,1265,39713,3578747646,3578747646,0
0,1265,39714,3578747646,3578747646,0
0,1265,39715,3578747646,3578747646,0
0,1265,39716,3578747646,3578747646,0
0,1265,39717,3578747646,3578747646,0
0,1265,39718,3578747646,3578747646,0
0,1265,39719,3578747646,3578747646,0
0,1265,39720,3578747646,3578747646,0
0,1265,39721,3578747646,3578747646,0
0,1265,39722,3578747646,3578747646,0
0,1265,39723,3578747646,3578747647,1
0,1265,39724,3578747646,3578747648,2
0,1265,39725,3578747646,3578747648,2
0,1265,39726,3578747646,3578747648,2
0,1265,39727,3578747646,3578747648,2
0,1265,39728,3578747646,3578747649,3
0,1265,39729,3578747646,3578747650,4
0,1265,39730,3578747646,3578747650,4
0,1265,39731,3578747646,3578747653,7
0,1265,39732,3578747646,3578747654,8
0,1265,39733,3578747646,3578747655,9
0,1265,39734,3578747646,3578747655,9
0,1265,39735,3578747646,3578747656,10
0,1265,39736,3578747646,3578747656,10
0,1265,39737,3578747646,3578747657,11
0,1265,39738,3578747646,3578747658,12
0,1265,39739,3578747646,3578747659,13
0,1265,39740,3578747646,3578747659,13
0,1265,39741,3578747646,3578747661,15
0,1265,39742,3578747646,3578747661,15
0,1265,39743,3578747646,3578747661,15
0,1265,39744,3578747646,3578747661,15
0,1265,39745,3578747646,3578747663,17
0,1265,39746,3578747646,3578747663,17
0,1265,39747,3578747646,3578747664,18
0,1265,39748,3578747646,3578747665,19
0,1265,39749,3578747646,3578747665,19
0,1265,39750,3578747646,3578747665,19
0,1265,39751,3578747646,3578747666,20
0,1265,39752,3578747646,3578747666,20
0,1265,39753,3578747646,3578747667,21
0,1265,39754,3578747646,3578747667,21
0,1265,39755,3578747646,3578747677,31
0,1265,39756,3578747646,3578747678,32
0,1265,39757,3578747646,3578747679,33
0,1265,39758,3578747646,3578747680,34
0,1265,39759,3578747646,3578747680,34
0,1265,39760,3578747646,3578747680,34
0,1265,39761,3578747646,3578747681,35
0,1265,39762,3578747646,3578747682,36
0,1265,39763,3578747646,3578747685,39
0,1265,39764,3578747646,3578747685,39
0,1265,39765,3578747646,3578747686,40
0,1265,39766,3578747646,3578747686,40
0,1265,39767,3578747646,3578747686,40
0,1265,39768,3578747646,3578747687,41
0,1265,39769,3578747646,3578747687,41
0,1265,39770,3578747646,3578747688,42
0,1265,39771,3578747646,3578747688,42
0,1265,39772,3578747646,3578747689,43
0,1265,39773,3578747646,3578747689,43
0,1265,39774,3578747646,3578747689,43
0,1265,39775,3578747646,3578747690,44
0,1265,39776,3578747646,3578747690,44
0,1265,39777,3578747646,3578747691,45
0,1265,39778,3578747646,3578747691,45
0,1265,39779,3578747646,3578747691,45
0,1265,39780,3578747646,3578747692,46
0,1265,39781,3578747646,3578747693,47
0,1265,39782,3578747646,3578747693,47
0,1265,39783,3578747646,3578747693,47
0,1265,39784,3578747646,3578747694,48
0,1265,39785,3578747646,3578747695,49
0,1266,39786,3578747710,3578747710,0
0,1266,39787,3578747710,3578747710,0
0,1266,39788,3578747710,3578747710,0
0,1266,39789,3578747710,3578747710,0
0,1266,39790,3578747710,3578747710,0
0,1266,39791,3578747710,3578747710,0
0,1266,39792,3578747710,3578747710,0
0,1266,39793,3578747710,3578747710,0
0,1266,39794,3578747710,3578747710,0
0,1266,39795,3578747710,3578747710,0
0,1266,39796,3578747710,3578747710,0
0,1266,39797,3578747710,3578747710,0
0,1266,39798,3578747710,3578747710,0
0,1266,39799,3578747710,3578747710,0
0,1266,39800,3578747710,3578747710,0
0,1266,39801,3578747710,3578747710,0
0,1266,39802,3578747710,3578747710,0
0,1266,39803,3578747710,3578747710,0
0,1266,39804,3578747710,3578747710,0
0,1266,39805,3578747710,3578747710,0
0,1266,39806,3578747710,3578747710,0
0,1266,39807,3578747710,3578747710,0
0,1266,39808,3578747710,3578747711,1
0,1266,39809,3578747710,3578747711,1
0,1266,39810,3578747710,3578747711,1
0,1266,39811,3578747710,3578747711,1
0,1266,39812,3578747710,3578747712,2
0,1266,39813,3578747710,3578747714,4
0,1266,39814,3578747710,3578747714,4
0,1266,39815,3578747710,3578747714,4
0,1266,39816,3578747710,3578747716,6
0,1266,39817,3578747710,3578747716,6
0,1266,39818,3578747710,3578747716,6
0,1266,39819,3578747710,3578747716,6
0,1266,39820,3578747710,3578747716,6
0,1266,39821,3578747710,3578747717,7
0,1266,39822,3578747710,3578747717,7
0,1266,39823,3578747710,3578747717,7
0,1266,39824,3578747710,3578747719,9
0,1266,39825,3578747710,3578747719,9
0,1266,39826,3578747710,3578747719,9
0,1266,39827,3578747710,3578747719,9
0,1266,39828,3578747710,3578747720,10
0,1266,39829,3578747710,3578747721,11
0,1266,39830,3578747710,3578747722,12
0,1266,39831,3578747710,3578747723,13
0,1266,39832,3578747710,3578747723,13
0,1266,39833,3578747710,3578747724,14
0,1266,39834,3578747710,3578747726,16
0,1266,39835,3578747710,3578747727,17
0,1266,39836,3578747710,3578747727,17
0,1266,39837,3578747710,3578747727,17
0,1266,39838,3578747710,3578747727,17
0,1266,39839,3578747710,3578747728,18
0,1266,39840,3578747710,3578747728,18
0,1266,39841,3578747710,3578747728,18
0,1266,39842,3578747710,3578747730,20
0,1266,39843,3578747710,3578747730,20
0,1266,39844,3578747710,3578747730,20
0,1266,39845,3578747710,3578747730,20
0,1266,39846,3578747710,3578747730,20
0,1266,39847,3578747710,3578747731,21
0,1266,39848,3578747710,3578747731,21
0,1266,39849,3578747710,3578747732,22
0,1266,39850,3578747710,3578747732,22
0,1266,39851,3578747710,3578747732,22
0,1266,39852,3578747710,3578747733,23
0,1266,39853,3578747710,3578747734,24
0,1266,39854,3578747710,3578747736,26
0,1266,39855,3578747710,3578747738,28
0,1266,39856,3578747710,3578747738,28
0,1266,39857,3578747710,3578747739,29
0,1266,39858,3578747710,3578747739,29
0,1266,39859,3578747710,3578747740,30
0,1266,39860,3578747710,3578747740,30
0,1266,39861,3578747710,3578747740,30
0,1266,39862,3578747710,3578747741,31
0,1266,39863,3578747710,3578747741,31
0,1266,39864,3578747710,3578747742,32
0,1266,39865,3578747710,3578747742,32
0,1266,39866,3578747710,3578747742,32
0,1266,39867,3578747710,3578747743,33
0,1266,39868,3578747710,3578747744,34
0,1266,39869,3578747710,3578747745,35
0,1266,39870,3578747710,3578747746,36
0,1266,39871,3578747710,3578747746,36
0,1266,39872,3578747710,3578747746,36
0,1266,39873,3578747710,3578747746,36
0,1266,39874,3578747710,3578747747,37
0,1266,39875,3578747710,3578747750,40
0,1266,39876,3578747710,3578747751,41
0,1266,39877,3578747710,3578747751,41
0,1266,39878,3578747710,3578747753,43
0,1266,39879,3578747710,3578747754,44
0,1266,39880,3578747710,3578747754,44
0,1266,39881,3578747710,3578747755,45
0,1266,39882,3578747710,3578747757,47
0,1266,39883,3578747710,3578747759,49
0,1267,39884,3578747772,3578747772,0
0,1267,39885,3578747772,3578747772,0
0,1267,39886,3578747772,3578747772,0
0,1267,39887,3578747772,3578747772,0
0,1267,39888,3578747772,3578747772,0
0,1267,39889,3578747772,3578747772,0
0,1267,39890,3578747772,3578747772,0
0,1267,39891,3578747772,3578747772,0
0,1267,39892,3578747772,3578747772,0
0,1267,39893,3578747772,3578747772,0
0,1267,39894,3578747772,3578747772,0
0,1267,39895,3578747772,3578747772,0
0,1267,39896,3578747772,3578747772,0
0,1267,39897,3578747772,3578747772,0
0,1267,39898,3578747772,3578747772,0
0,1267,39899,3578747772,3578747772,0
0,1267,39900,3578747772,3578747772,0
0,1267,39901,3578747772,3578747772,0
0,1267,39902,3578747772,3578747772,0
0,1267,39903,3578747772,3578747772,0
0,1267,39904,3578747772,3578747772,0
0,1267,39905,3578747772,3578747773,1
0,1267,39906,3578747772,3578747773,1
0,1267,39907,3578747772,3578747774,2
0,1267,39908,3578747772,3578747774,2
0,1267,39909,3578747772,3578747775,3
0,1267,39910,3578747772,3578747777,5
0,1267,39911,3578747772,3578747777,5
0,1267,39912,3578747772,3578747777,5
0,1267,39913,3578747772,3578747778,6
0,1267,39914,3578747772,3578747778,6
0,1267,39915,3578747772,3578747778,6
0,1267,39916,3578747772,3578747779,7
0,1267,39917,3578747772,3578747781,9
0,1267,39918,3578747772,3578747782,10
0,1267,39919,3578747772,3578747783,11
0,1267,39920,3578747772,3578747785,13
0,1267,39921,3578747772,3578747787,15
0,1267,39922,3578747772,3578747787,15
0,1267,39923,3578747772,3578747787,15
0,1267,39924,3578747772,3578747787,15
0,1267,39925,3578747772,3578747788,16
0,1267,39926,3578747772,3578747788,16
0,1267,39927,3578747772,3578747788,16
0,1267,39928,3578747772,3578747788,16
0,1267,39929,3578747772,3578747791,19
0,1267,39930,3578747772,3578747791,19
0,1267,39931,3578747772,3578747793,21
0,1267,39932,3578747772,3578747793,21
0,1267,39933,3578747772,3578747793,21
0,1267,39934,3578747772,3578747794,22
0,1267,39935,3578747772,3578747795,23
0,1267,39936,3578747772,3578747800,28
0,1267,39937,3578747772,3578747802,30
0,1267,39938,3578747772,3578747803,31
0,1267,39939,3578747772,3578747803,31
0,1267,39940,3578747772,3578747803,31
0,1267,39941,3578747772,3578747804,32
0,1267,39942,3578747772,3578747804,32
0,1267,39943,3578747772,3578747804,32
0,1267,39944,3578747772,3578747804,32
0,1267,39945,3578747772,3578747805,33
0,1267,39946,3578747772,3578747806,34
0,1267,39947,3578747772,3578747806,34
0,1267,39948,3578747772,3578747807,35
0,1267,39949,3578747772,3578747807,35
0,1267,39950,3578747772,3578747807,35
0,1267,39951,3578747772,3578747808,36
0,1267,39952,3578747772,3578747808,36
0,1267,39953,3578747772,3578747809,37
0,1267,39954,3578747772,3578747811,39
0,1267,39955,3578747772,3578747812,40
0,1267,39956,3578747772,3578747814,42
0,1267,39957,3578747772,3578747814,42
0,1267,39958,3578747772,3578747815,43
0,1267,39959,3578747772,3578747815,43
0,1267,39960,3578747772,3578747815,43
0,1267,39961,3578747772,3578747815,43
0,1267,39962,3578747772,3578747815,43
0,1267,39963,3578747772,3578747815,43
0,1267,39964,3578747772,3578747816,44
0,1267,39965,3578747772,3578747818,46
0,1267,39966,3578747772,3578747818,46
0,1267,39967,3578747772,3578747818,46
0,1267,39968,3578747772,3578747819,47
0,1267,39969,3578747772,3578747819,47
0,1267,39970,3578747772,3578747822,50
0,1267,39971,3578747772,3578747822,50
0,1268,39972,3578747834,3578747834,0
0,1268,39973,3578747834,3578747834,0
0,1268,39974,3578747834,3578747834,0
0,1268,39975,3578747834,3578747834,0
0,1268,39976,3578747834,3578747834,0
0,1268,39977,3578747834,3578747834,0
0,1268,39978,3578747834,3578747834,0
0,1268,39979,3578747834,3578747834,0
0,1268,39980,3578747834,3578747834,0
0,1268,39981,3578747834,3578747834,0
0,1268,39982,3578747834,3578747834,0
0,1268,39983,3578747834,3578747834,0
0,1268,39984,3578747834,3578747835,1
0,1268,39985,3578747834,3578747836,2
0,1268,39986,3578747834,3578747836,2
0,1268,39987,3578747834,3578747837,3
0,1268,39988,3578747834,3578747837,3
0,1268,39989,3578747834,3578747838,4
0,1268,39990,3578747834,3578747838,4
0,1268,39991,3578747834,3578747838,4
0,1268,39992,3578747834,3578747838,4
0,1268,39993,3578747834,3578747839,5
0,1268,39994,3578747834,3578747839,5
0,1268,39995,3578747834,3578747841,7
0,1268,39996,3578747834,3578747841,7
0,1268,39997,3578747834,3578747841,7
0,1268,39998,3578747834,3578747843,9
0,1268,39999,3578747834,3578747844,10
0,1268,40000,3578747834,3578747846,12
0,1268,40001,3578747834,3578747847,13
0,1268,40002,3578747834,3578747847,13
0,1268,40003,3578747834,3578747847,13
0,1268,40004,3578747834,3578747848,14
0,1268,40005,3578747834,3578747848,14
0,1268,40006,3578747834,3578747849,15
0,1268,40007,3578747834,3578747849,15
0,1268,40008,3578747834,3578747850,16
0,1268,40009,3578747834,3578747850,16
0,1268,40010,3578747834,3578747850,16
0,1268,40011,3578747834,3578747854,20
0,1268,40012,3578747834,3578747854,20
0,1268,40013,3578747834,3578747855,21
0,1268,40014,3578747834,3578747856,22
0,1268,40015,3578747834,3578747856,22
0,1268,40016,3578747834,3578747857,23
0,1268,40017,3578747834,3578747858,24
0,1268,40018,3578747834,3578747859,25
0,1268,40019,3578747834,3578747859,25
0,1268,40020,3578747834,3578747860,26
0,1268,40021,3578747834,3578747861,27
0,1268,40022,3578747834,3578747862,28
0,1268,40023,3578747834,3578747862,28
0,1268,40024,3578747834,3578747862,28
0,1268,40025,3578747834,3578747863,29
0,1268,40026,3578747834,3578747863,29
0,1268,40027,3578747834,3578747864,30
0,1268,40028,3578747834,3578747864,30
0,1268,40029,3578747834,3578747865,31
0,1268,40030,3578747834,3578747865,31
0,1268,40031,3578747834,3578747866,32
0,1268,40032,3578747834,3578747866,32
0,1268,40033,3578747834,3578747867,33
0,1268,40034,3578747834,3578747867,33
0,1268,40035,3578747834,3578747877,43
0,1268,40036,3578747834,3578747878,44
0,1268,40037,3578747834,3578747879,45
0,1268,40038,3578747834,3578747879,45
0,1268,40039,3578747834,3578747880,46
0,1268,40040,3578747834,3578747881,47
0,1268,40041,3578747834,3578747881,47
0,1268,40042,3578747834,3578747881,47
0,1268,40043,3578747834,3578747882,48
0,1269,40044,3578747896,3578747897,1
0,1269,40045,3578747896,3578747897,1
0,1269,40046,3578747896,3578747897,1
0,1269,40047,3578747896,3578747897,1
0,1269,40048,3578747896,3578747897,1
0,1269,40049,3578747896,3578747897,1
0,1269,40050,3578747896,3578747897,1
0,1269,40051,3578747896,3578747897,1
0,1269,40052,3578747896,3578747897,1
0,1269,40053,3578747896,3578747897,1
0,1269,40054,3578747896,3578747897,1
0,1269,40055,3578747896,3578747897,1
0,1269,40056,3578747896,3578747897,1
0,1269,40057,3578747896,3578747897,1
0,1269,40058,3578747896,3578747897,1
0,1269,40059,3578747896,3578747897,1
0,1269,40060,3578747896,3578747897,1
0,1269,40061,3578747896,3578747897,1
0,1269,40062,3578747896,3578747897,1
0,1269,40063,3578747896,3578747899,3
0,1269,40064,3578747896,3578747900,4
0,1269,40065,3578747896,3578747901,5
0,1269,40066,3578747896,3578747902,6
0,1269,40067,3578747896,3578747903,7
0,1269,40068,3578747896,3578747903,7
0,1269,40069,3578747896,3578747903,7
0,1269,40070,3578747896,3578747904,8
0,1269,40071,3578747896,3578747905,9
0,1269,40072,3578747896,3578747905,9
0,1269,40073,3578747896,3578747905,9
0,1269,40074,3578747896,3578747907,11
0,1269,40075,3578747896,3578747907,11
0,1269,40076,3578747896,3578747907,11
0,1269,40077,3578747896,3578747907,11
0,1269,40078,3578747896,3578747908,12
0,1269,40079,3578747896,3578747908,12
0,1269,40080,3578747896,3578747908,12
0,1269,40081,3578747896,3578747909,13
0,1269,40082,3578747896,3578747910,14
0,1269,40083,3578747896,3578747911,15
0,1269,40084,3578747896,3578747911,15
0,1269,40085,3578747896,3578747911,15
0,1269,40086,3578747896,3578747911,15
0,1269,40087,3578747896,3578747911,15
0,1269,40088,3578747896,3578747914,18
0,1269,40089,3578747896,3578747915,19
0,1269,40090,3578747896,3578747915,19
0,1269,40091,3578747896,3578747915,19
0,1269,40092,3578747896,3578747916,20
0,1269,40093,3578747896,3578747916,20
0,1269,40094,3578747896,3578747916,20
0,1269,40095,3578747896,3578747916,20
0,1269,40096,3578747896,3578747917,21
0,1269,40097,3578747896,3578747917,21
0,1269,40098,3578747896,3578747917,21
0,1269,40099,3578747896,3578747917,21
0,1269,40100,3578747896,3578747918,22
0,1269,40101,3578747896,3578747919,23
0,1269,40102,3578747896,3578747919,23
0,1269,40103,3578747896,3578747919,23
0,1269,40104,3578747896,3578747919,23
0,1269,40105,3578747896,3578747921,25
0,1269,40106,3578747896,3578747921,25
0,1269,40107,3578747896,3578747922,26
0,1269,40108,3578747896,3578747923,27
0,1269,40109,3578747896,3578747924,28
0,1269,40110,3578747896,3578747924,28
0,1269,40111,3578747896,3578747926,30
0,1269,40112,3578747896,3578747927,31
0,1269,40113,3578747896,3578747928,32
0,1269,40114,3578747896,3578747929,33
0,1269,40115,3578747896,3578747929,33
0,1269,40116,3578747896,3578747929,33
0,1269,40117,3578747896,3578747930,34
0,1269,40118,3578747896,3578747930,34
0,1269,40119,3578747896,3578747930,34
0,1269,40120,3578747896,3578747931,35
0,1269,40121,3578747896,3578747931,35
0,1269,40122,3578747896,3578747931,35
0,1269,40123,3578747896,3578747932,36
0,1269,40124,3578747896,3578747932,36
0,1269,40125,3578747896,3578747932,36
0,1269,40126,3578747896,3578747933,37
0,1269,40127,3578747896,3578747935,39
0,1269,40128,3578747896,3578747935,39
0,1269,40129,3578747896,3578747939,43
0,1269,40130,3578747896,3578747939,43
0,1269,40131,3578747896,3578747939,43
0,1269,40132,3578747896,3578747939,43
0,1269,40133,3578747896,3578747940,44
0,1269,40134,3578747896,3578747940,44
0,1269,40135,3578747896,3578747941,45
0,1269,40136,3578747896,3578747941,45
0,1269,40137,3578747896,3578747942,46
0,1269,40138,3578747896,3578747943,47
0,1269,40139,3578747896,3578747943,47
0,1269,40140,3578747896,3578747943,47
0,1269,40141,3578747896,3578747944,48
0,1269,40142,3578747896,3578747945,49
0,1269,40143,3578747896,3578747946,50
0,1270,40144,3578747959,3578747959,0
0,1270,40145,3578747959,3578747959,0
0,1270,40146,3578747959,3578747959,0
0,1270,40147,3578747959,3578747959,0
0,1270,40148,3578747959,3578747959,0
0,1270,40149,3578747959,3578747959,0
0,1270,40150,3578747959,3578747959,0
0,1270,40151,3578747959,3578747959,0
0,1270,40152,3578747959,3578747959,0
0,1270,40153,3578747959,3578747959,0
0,1270,40154,3578747959,3578747959,0
0,1270,40155,3578747959,3578747959,0
0,1270,40156,3578747959,3578747959,0
0,1270,40157,3578747959,3578747959,0
0,1270,40158,3578747959,3578747959,0
0,1270,40159,3578747959,3578747959,0
0,1270,40160,3578747959,3578747960,1
0,1270,40161,3578747959,3578747961,2
0,1270,40162,3578747959,3578747961,2
0,1270,40163,3578747959,3578747962,3
0,1270,40164,3578747959,3578747962,3
0,1270,40165,3578747959,3578747963,4
0,1270,40166,3578747959,3578747963,4
0,1270,40167,3578747959,3578747964,5
0,1270,40168,3578747959,3578747965,6
0,1270,40169,3578747959,3578747965,6
0,1270,40170,3578747959,3578747966,7
0,1270,40171,3578747959,3578747967,8
0,1270,40172,3578747959,3578747967,8
0,1270,40173,3578747959,3578747967,8
0,1270,40174,3578747959,3578747968,9
0,1270,40175,3578747959,3578747969,10
0,1270,40176,3578747959,3578747971,12
0,1270,40177,3578747959,3578747971,12
0,1270,40178,3578747959,3578747972,13
0,1270,40179,3578747959,3578747974,15
0,1270,40180,3578747959,3578747974,15
0,1270,40181,3578747959,3578747974,15
0,1270,40182,3578747959,3578747976,17
0,1270,40183,3578747959,3578747977,18
0,1270,40184,3578747959,3578747978,19
0,1270,40185,3578747959,3578747978,19
0,1270,40186,3578747959,3578747978,19
0,1270,40187,3578747959,3578747979,20
0,1270,40188,3578747959,3578747980,21
0,1270,40189,3578747959,3578747980,21
0,1270,40190,3578747959,3578747981,22
0,1270,40191,3578747959,3578747982,23
0,1270,40192,3578747959,3578747984,25
0,1270,40193,3578747959,3578747985,26
0,1270,40194,3578747959,3578747987,28
0,1270,40195,3578747959,3578747987,28
0,1270,40196,3578747959,3578747987,28
0,1270,40197,3578747959,3578747988,29
0,1270,40198,3578747959,3578747988,29
0,1270,40199,3578747959,3578747988,29
0,1270,40200,3578747959,3578747988,29
0,1270,40201,3578747959,3578747989,30
0,1270,40202,3578747959,3578747991,32
0,1270,40203,3578747959,3578747992,33
0,1270,40204,3578747959,3578747993,34
0,1270,40205,3578747959,3578747993,34
0,1270,40206,3578747959,3578747993,34
0,1270,40207,3578747959,3578747994,35
0,1270,40208,3578747959,3578747996,37
0,1270,40209,3578747959,3578747999,40
0,1270,40210,3578747959,3578748000,41
0,1270,40211,3578747959,3578748001,42
0,1270,40212,3578747959,3578748002,43
0,1270,40213,3578747959,3578748003,44
0,1270,40214,3578747959,3578748003,44
0,1270,40215,3578747959,3578748004,45
0,1270,40216,3578747959,3578748005,46
0,1270,40217,3578747959,3578748005,46
0,1270,40218,3578747959,3578748005,46
0,1270,40219,3578747959,3578748006,47
0,1270,40220,3578747959,3578748006,47
0,1270,40221,3578747959,3578748007,48
0,1270,40222,3578747959,3578748008,49
0,1270,40223,3578747959,3578748008,49
0,1270,40224,3578747959,3578748008,49
0,1270,40225,3578747959,3578748009,50
0,1271,40226,3578748022,3578748022,0
0,1271,40227,3578748022,3578748022,0
0,1271,40228,3578748022,3578748022,0
0,1271,40229,3578748022,3578748022,0
0,1271,40230,3578748022,3578748022,0
0,1271,40231,3578748022,3578748022,0
0,1271,40232,3578748022,3578748022,0
0,1271,40233,3578748022,3578748022,0
0,1271,40234,3578748022,3578748022,0
0,1271,40235,3578748022,3578748022,0
0,1271,40236,3578748022,3578748022,0
0,1271,40237,3578748022,3578748022,0
0,1271,40238,3578748022,3578748022,0
0,1271,40239,3578748022,3578748022,0
0,1271,40240,3578748022,3578748022,0
0,1271,40241,3578748022,3578748022,0
0,1271,40242,3578748022,3578748022,0
0,1271,40243,3578748022,3578748022,0
0,1271,40244,3578748022,3578748023,1
0,1271,40245,3578748022,3578748024,2
0,1271,40246,3578748022,3578748024,2
0,1271,40247,3578748022,3578748025,3
0,1271,40248,3578748022,3578748026,4
0,1271,40249,3578748022,3578748027,5
0,1271,40250,3578748022,3578748028,6
0,1271,40251,3578748022,3578748029,7
0,1271,40252,3578748022,3578748029,7
0,1271,40253,3578748022,3578748031,9
0,1271,40254,3578748022,3578748031,9
0,1271,40255,3578748022,3578748032,10
0,1271,40256,3578748022,3578748033,11
0,1271,40257,3578748022,3578748035,13
0,1271,40258,3578748022,3578748036,14
0,1271,40259,3578748022,3578748036,14
0,1271,40260,3578748022,3578748037,15
0,1271,40261,3578748022,3578748037,15
0,1271,40262,3578748022,3578748038,16
0,1271,40263,3578748022,3578748038,16
0,1271,40264,3578748022,3578748038,16
0,1271,40265,3578748022,3578748038,16
0,1271,40266,3578748022,3578748040,18
0,1271,40267,3578748022,3578748040,18
0,1271,40268,3578748022,3578748040,18
0,1271,40269,3578748022,3578748041,19
0,1271,40270,3578748022,3578748042,20
0,1271,40271,3578748022,3578748043,21
0,1271,40272,3578748022,3578748044,22
0,1271,40273,3578748022,3578748046,24
0,1271,40274,3578748022,3578748047,25
0,1271,40275,3578748022,3578748047,25
0,1271,40276,3578748022,3578748047,25
0,1271,40277,3578748022,3578748048,26
0,1271,40278,3578748022,3578748049,27
0,1271,40279,3578748022,3578748049,27
0,1271,40280,3578748022,3578748049,27
0,1271,40281,3578748022,3578748054,32
0,1271,40282,3578748022,3578748055,33
0,1271,40283,3578748022,3578748056,34
0,1271,40284,3578748022,3578748057,35
0,1271,40285,3578748022,3578748057,35
0,1271,40286,3578748022,3578748059,37
0,1271,40287,3578748022,3578748059,37
0,1271,40288,3578748022,3578748059,37
0,1271,40289,3578748022,3578748061,39
0,1271,40290,3578748022,3578748062,40
0,1271,40291,3578748022,3578748062,40
0,1271,40292,3578748022,3578748063,41
0,1271,40293,3578748022,3578748063,41
0,1271,40294,3578748022,3578748063,41
0,1271,40295,3578748022,3578748064,42
0,1271,40296,3578748022,3578748064,42
0,1271,40297,3578748022,3578748065,43
0,1271,40298,3578748022,3578748066,44
0,1271,40299,3578748022,3578748066,44
0,1271,40300,3578748022,3578748066,44
0,1271,40301,3578748022,3578748066,44
0,1271,40302,3578748022,3578748069,47
0,1272,40303,3578748083,3578748083,0
0,1272,40304,3578748083,3578748083,0
0,1272,40305,3578748083,3578748083,0
0,1272,40306,3578748083,3578748083,0
0,1272,40307,3578748083,3578748083,0
0,1272,40308,3578748083,3578748083,0
0,1272,40309,3578748083,3578748083,0
0,1272,40310,3578748083,3578748083,0
0,1272,40311,3578748083,3578748084,1
0,1272,40312,3578748083,3578748084,1
0,1272,40313,3578748083,3578748085,2
0,1272,40314,3578748083,3578748085,2
0,1272,40315,3578748083,3578748086,3
0,1272,40316,3578748083,3578748086,3
0,1272,40317,3578748083,3578748088,5
0,1272,40318,3578748083,3578748088,5
0,1272,40319,3578748083,3578748088,5
0,1272,40320,3578748083,3578748089,6
0,1272,40321,3578748083,3578748089,6
0,1272,40322,3578748083,3578748090,7
0,1272,40323,3578748083,3578748090,7
0,1272,40324,3578748083,3578748091,8
0,1272,40325,3578748083,3578748091,8
0,1272,40326,3578748083,3578748091,8
0,1272,40327,3578748083,3578748093,10
0,1272,40328,3578748083,3578748093,10
0,1272,40329,3578748083,3578748093,10
0,1272,40330,3578748083,3578748093,10
0,1272,40331,3578748083,3578748094,11
0,1272,40332,3578748083,3578748094,11
0,1272,40333,3578748083,3578748096,13
0,1272,40334,3578748083,3578748097,14
0,1272,40335,3578748083,3578748100,17
0,1272,40336,3578748083,3578748101,18
0,1272,40337,3578748083,3578748102,19
0,1272,40338,3578748083,3578748102,19
0,1272,40339,3578748083,3578748102,19
0,1272,40340,3578748083,3578748103,20
0,1272,40341,3578748083,3578748103,20
0,1272,40342,3578748083,3578748103,20
0,1272,40343,3578748083,3578748105,22
0,1272,40344,3578748083,3578748105,22
0,1272,40345,3578748083,3578748105,22
0,1272,40346,3578748083,3578748106,23
0,1272,40347,3578748083,3578748106,23
0,1272,40348,3578748083,3578748107,24
0,1272,40349,3578748083,3578748107,24
0,1272,40350,3578748083,3578748107,24
0,1272,40351,3578748083,3578748108,25
0,1272,40352,3578748083,3578748108,25
0,1272,40353,3578748083,3578748109,26
0,1272,40354,3578748083,3578748110,27
0,1272,40355,3578748083,3578748110,27
0,1272,40356,3578748083,3578748111,28
0,1272,40357,3578748083,3578748111,28
0,1272,40358,3578748083,3578748111,28
0,1272,40359,3578748083,3578748111,28
0,1272,40360,3578748083,3578748113,30
0,1272,40361,3578748083,3578748114,31
0,1272,40362,3578748083,3578748115,32
0,1272,40363,3578748083,3578748115,32
0,1272,40364,3578748083,3578748116,33
0,1272,40365,3578748083,3578748116,33
0,1272,40366,3578748083,3578748116,33
0,1272,40367,3578748083,3578748117,34
0,1272,40368,3578748083,3578748117,34
0,1272,40369,3578748083,3578748117,34
0,1272,40370,3578748083,3578748117,34
0,1272,40371,3578748083,3578748118,35
0,1272,40372,3578748083,3578748118,35
0,1272,40373,3578748083,3578748119,36
0,1272,40374,3578748083,3578748119,36
0,1272,40375,3578748083,3578748120,37
0,1272,40376,3578748083,3578748121,38
0,1272,40377,3578748083,3578748121,38
0,1272,40378,3578748083,3578748122,39
0,1272,40379,3578748083,3578748123,40
0,1272,40380,3578748083,3578748124,41
0,1272,40381,3578748083,3578748125,42
0,1272,40382,3578748083,3578748126,43
0,1272,40383,3578748083,3578748127,44
0,1272,40384,3578748083,3578748127,44
0,1272,40385,3578748083,3578748127,44
0,1272,40386,3578748083,3578748127,44
0,1272,40387,3578748083,3578748128,45
0,1272,40388,3578748083,3578748129,46
0,1272,40389,3578748083,3578748129,46
0,1272,40390,3578748083,3578748130,47
0,1272,40391,3578748083,3578748130,47
0,1272,40392,3578748083,3578748130,47
0,1272,40393,3578748083,3578748131,48
0,1272,40394,3578748083,3578748131,48
0,1272,40395,3578748083,3578748132,49
0,1272,40396,3578748083,3578748132,49
0,1272,40397,3578748083,3578748132,49
0,1272,40398,3578748083,3578748133,50
0,1273,40399,3578748146,3578748146,0
0,1273,40400,3578748146,3578748146,0
0,1273,40401,3578748146,3578748146,0
0,1273,40402,3578748146,3578748146,0
0,1273,40403,3578748146,3578748146,0
0,1273,40404,3578748146,3578748146,0
0,1273,40405,3578748146,3578748146,0
0,1273,40406,3578748146,3578748146,0
0,1273,40407,3578748146,3578748146,0
0,1273,40408,3578748146,3578748146,0
0,1273,40409,3578748146,3578748146,0
0,1273,40410,3578748146,3578748146,0
0,1273,40411,3578748146,3578748146,0
0,1273,40412,3578748146,3578748146,0
0,1273,40413,3578748146,3578748146,0
0,1273,40414,3578748146,3578748146,0
0,1273,40415,3578748146,3578748146,0
0,1273,40416,3578748146,3578748146,0
0,1273,40417,3578748146,3578748146,0
0,1273,40418,3578748146,3578748146,0
0,1273,40419,3578748146,3578748147,1
0,1273,40420,3578748146,3578748147,1
0,1273,40421,3578748146,3578748147,1
0,1273,40422,3578748146,3578748147,1
0,1273,40423,3578748146,3578748148,2
0,1273,40424,3578748146,3578748151,5
0,1273,40425,3578748146,3578748151,5
0,1273,40426,3578748146,3578748152,6
0,1273,40427,3578748146,3578748153,7
0,1273,40428,3578748146,3578748154,8
0,1273,40429,3578748146,3578748155,9
0,1273,40430,3578748146,3578748155,9
0,1273,40431,3578748146,3578748155,9
0,1273,40432,3578748146,3578748155,9
0,1273,40433,3578748146,3578748157,11
0,1273,40434,3578748146,3578748159,13
0,1273,40435,3578748146,3578748159,13
0,1273,40436,3578748146,3578748160,14
0,1273,40437,3578748146,3578748160,14
0,1273,40438,3578748146,3578748161,15
0,1273,40439,3578748146,3578748161,15
0,1273,40440,3578748146,3578748161,15
0,1273,40441,3578748146,3578748163,17
0,1273,40442,3578748146,3578748163,17
0,1273,40443,3578748146,3578748163,17
0,1273,40444,3578748146,3578748165,19
0,1273,40445,3578748146,3578748166,20
0,1273,40446,3578748146,3578748166,20
0,1273,40447,3578748146,3578748166,20
0,1273,40448,3578748146,3578748167,21
0,1273,40449,3578748146,3578748167,21
0,1273,40450,3578748146,3578748168,22
0,1273,40451,3578748146,3578748169,23
0,1273,40452,3578748146,3578748170,24
0,1273,40453,3578748146,3578748171,25
0,1273,40454,3578748146,3578748173,27
0,1273,40455,3578748146,3578748174,28
0,1273,40456,3578748146,3578748175,29
0,1273,40457,3578748146,3578748176,30
0,1273,40458,3578748146,3578748176,30
0,1273,40459,3578748146,3578748178,32
0,1273,40460,3578748146,3578748179,33
0,1273,40461,3578748146,3578748179,33
0,1273,40462,3578748146,3578748179,33
0,1273,40463,3578748146,3578748179,33
0,1273,40464,3578748146,3578748181,35
0,1273,40465,3578748146,3578748182,36
0,1273,40466,3578748146,3578748183,37
0,1273,40467,3578748146,3578748184,38
0,1273,40468,3578748146,3578748185,39
0,1273,40469,3578748146,3578748187,41
0,1273,40470,3578748146,3578748187,41
0,1273,40471,3578748146,3578748187,41
0,1273,40472,3578748146,3578748187,41
0,1273,40473,3578748146,3578748188,42
0,1273,40474,3578748146,3578748189,43
0,1273,40475,3578748146,3578748190,44
0,1273,40476,3578748146,3578748191,45
0,1273,40477,3578748146,3578748193,47
0,1273,40478,3578748146,3578748193,47
0,1273,40479,3578748146,3578748193,47
0,1273,40480,3578748146,3578748194,48
0,1273,40481,3578748146,3578748195,49
0,1274,40482,3578748208,3578748208,0
0,1274,40483,3578748208,3578748208,0
0,1274,40484,3578748208,3578748208,0
0,1274,40485,3578748208,3578748208,0
0,1274,40486,3578748208,3578748208,0
0,1274,40487,3578748208,3578748208,0
0,1274,40488,3578748208,3578748208,0
0,1274,40489,3578748208,3578748208,0
0,1274,40490,3578748208,3578748208,0
0,1274,40491,3578748208,3578748208,0
0,1274,40492,3578748208,3578748208,0
0,1274,40493,3578748208,3578748208,0
0,1274,40494,3578748208,3578748208,0
0,1274,40495,3578748208,3578748208,0
0,1274,40496,3578748208,3578748208,0
0,1274,40497,3578748208,3578748208,0
0,1274,40498,3578748208,3578748209,1
0,1274,40499,3578748208,3578748209,1
0,1274,40500,3578748208,3578748210,2
0,1274,40501,3578748208,3578748212,4
0,1274,40502,3578748208,3578748212,4
0,1274,40503,3578748208,3578748214,6
0,1274,40504,3578748208,3578748214,6
0,1274,40505,3578748208,3578748214,6
0,1274,40506,3578748208,3578748215,7
0,1274,40507,3578748208,3578748215,7
0,1274,40508,3578748208,3578748215,7
0,1274,40509,3578748208,3578748215,7
0,1274,40510,3578748208,3578748215,7
0,1274,40511,3578748208,3578748217,9
0,1274,40512,3578748208,3578748218,10
0,1274,40513,3578748208,3578748218,10
0,1274,40514,3578748208,3578748219,11
0,1274,40515,3578748208,3578748219,11
0,1274,40516,3578748208,3578748220,12
0,1274,40517,3578748208,3578748220,12
0,1274,40518,3578748208,3578748222,14
0,1274,40519,3578748208,3578748222,14
0,1274,40520,3578748208,3578748223,15
0,1274,40521,3578748208,3578748224,16
0,1274,40522,3578748208,3578748224,16
0,1274,40523,3578748208,3578748225,17
0,1274,40524,3578748208,3578748226,18
0,1274,40525,3578748208,3578748228,20
0,1274,40526,3578748208,3578748228,20
0,1274,40527,3578748208,3578748230,22
0,1274,40528,3578748208,3578748231,23
0,1274,40529,3578748208,3578748232,24
0,1274,40530,3578748208,3578748232,24
0,1274,40531,3578748208,3578748233,25
0,1274,40532,3578748208,3578748236,28
0,1274,40533,3578748208,3578748236,28
0,1274,40534,3578748208,3578748237,29
0,1274,40535,3578748208,3578748237,29
0,1274,40536,3578748208,3578748238,30
0,1274,40537,3578748208,3578748238,30
0,1274,40538,3578748208,3578748238,30
0,1274,40539,3578748208,3578748239,31
0,1274,40540,3578748208,3578748240,32
0,1274,40541,3578748208,3578748240,32
0,1274,40542,3578748208,3578748240,32
0,1274,40543,3578748208,3578748242,34
0,1274,40544,3578748208,3578748242,34
0,1274,40545,3578748208,3578748244,36
0,1274,40546,3578748208,3578748245,37
0,1274,40547,3578748208,3578748246,38
0,1274,40548,3578748208,3578748247,39
0,1274,40549,3578748208,3578748248,40
0,1274,40550,3578748208,3578748248,40
0,1274,40551,3578748208,3578748248,40
0,1274,40552,3578748208,3578748248,40
0,1274,40553,3578748208,3578748248,40
0,1274,40554,3578748208,3578748248,40
0,1274,40555,3578748208,3578748249,41
0,1274,40556,3578748208,3578748250,42
0,1274,40557,3578748208,3578748252,44
0,1274,40558,3578748208,3578748255,47
0,1274,40559,3578748208,3578748256,48
0,1274,40560,3578748208,3578748257,49
0,1274,40561,3578748208,3578748257,49
0,1275,40562,3578748271,3578748271,0
0,1275,40563,3578748271,3578748271,0
0,1275,40564,3578748271,3578748271,0
0,1275,40565,3578748271,3578748271,0
0,1275,40566,3578748271,3578748271,0
0,1275,40567,3578748271,3578748271,0
0,1275,40568,3578748271,3578748271,0
0,1275,40569,3578748271,3578748271,0
0,1275,40570,3578748271,3578748271,0
0,1275,40571,3578748271,3578748271,0
0,1275,40572,3578748271,3578748271,0
0,1275,40573,3578748271,3578748271,0
0,1275,40574,3578748271,3578748271,0
0,1275,40575,3578748271,3578748271,0
0,1275,40576,3578748271,3578748271,0
0,1275,40577,3578748271,3578748271,0
0,1275,40578,3578748271,3578748271,0
0,1275,40579,3578748271,3578748277,6
0,1275,40580,3578748271,3578748280,9
0,1275,40581,3578748271,3578748280,9
0,1275,40582,3578748271,3578748280,9
0,1275,40583,3578748271,3578748280,9
0,1275,40584,3578748271,3578748281,10
0,1275,40585,3578748271,3578748282,11
0,1275,40586,3578748271,3578748284,13
0,1275,40587,3578748271,3578748284,13
0,1275,40588,3578748271,3578748284,13
0,1275,40589,3578748271,3578748285,14
0,1275,40590,3578748271,3578748285,14
0,1275,40591,3578748271,3578748286,15
0,1275,40592,3578748271,3578748286,15
0,1275,40593,3578748271,3578748287,16
0,1275,40594,3578748271,3578748288,17
0,1275,40595,3578748271,3578748288,17
0,1275,40596,3578748271,3578748289,18
0,1275,40597,3578748271,3578748289,18
0,1275,40598,3578748271,3578748290,19
0,1275,40599,3578748271,3578748290,19
0,1275,40600,3578748271,3578748290,19
0,1275,40601,3578748271,3578748290,19
0,1275,40602,3578748271,3578748290,19
0,1275,40603,3578748271,3578748291,20
0,1275,40604,3578748271,3578748292,21
0,1275,40605,3578748271,3578748293,22
0,1275,40606,3578748271,3578748294,23
0,1275,40607,3578748271,3578748294,23
0,1275,40608,3578748271,3578748294,23
0,1275,40609,3578748271,3578748294,23
0,1275,40610,3578748271,3578748294,23
0,1275,40611,3578748271,3578748296,25
0,1275,40612,3578748271,3578748297,26
0,1275,40613,3578748271,3578748299,28
0,1275,40614,3578748271,3578748301,30
0,1275,40615,3578748271,3578748301,30
0,1275,40616,3578748271,3578748302,31
0,1275,40617,3578748271,3578748303,32
0,1275,40618,3578748271,3578748303,32
0,1275,40619,3578748271,3578748303,32
0,1275,40620,3578748271,3578748304,33
0,1275,40621,3578748271,3578748304,33
0,1275,40622,3578748271,3578748305,34
0,1275,40623,3578748271,3578748305,34
0,1275,40624,3578748271,3578748306,35
0,1275,40625,3578748271,3578748307,36
0,1275,40626,3578748271,3578748307,36
0,1275,40627,3578748271,3578748307,36
0,1275,40628,3578748271,3578748308,37
0,1275,40629,3578748271,3578748308,37
0,1275,40630,3578748271,3578748308,37
0,1275,40631,3578748271,3578748309,38
0,1275,40632,3578748271,3578748311,40
0,1275,40633,3578748271,3578748311,40
0,1275,40634,3578748271,3578748311,40
0,1275,40635,3578748271,3578748311,40
0,1275,40636,3578748271,3578748311,40
0,1275,40637,3578748271,3578748312,41
0,1275,40638,3578748271,3578748312,41
0,1275,40639,3578748271,3578748314,43
0,1275,40640,3578748271,3578748315,44
0,1275,40641,3578748271,3578748315,44
0,1275,40642,3578748271,3578748315,44
0,1275,40643,3578748271,3578748316,45
0,1275,40644,3578748271,3578748316,45
0,1275,40645,3578748271,3578748316,45
0,1275,40646,3578748271,3578748316,45
0,1275,40647,3578748271,3578748317,46
0,1275,40648,3578748271,3578748317,46
0,1275,40649,3578748271,3578748317,46
0,1275,40650,3578748271,3578748317,46
0,1275,40651,3578748271,3578748319,48
0,1275,40652,3578748271,3578748319,48
0,1275,40653,3578748271,3578748319,48
0,1275,40654,3578748271,3578748319,48
0,1275,40655,3578748271,3578748320,49
0,1276,40656,3578748334,3578748334,0
0,1276,40657,3578748334,3578748334,0
0,1276,40658,3578748334,3578748334,0
0,1276,40659,3578748334,3578748334,0
0,1276,40660,3578748334,3578748334,0
0,1276,40661,3578748334,3578748334,0
0,1276,40662,3578748334,3578748334,0
0,1276,40663,3578748334,3578748334,0
0,1276,40664,3578748334,3578748334,0
0,1276,40665,3578748334,3578748334,0
0,1276,40666,3578748334,3578748334,0
0,1276,40667,3578748334,3578748334,0
0,1276,40668,3578748334,3578748334,0
0,1276,40669,3578748334,3578748334,0
0,1276,40670,3578748334,3578748334,0
0,1276,40671,3578748334,3578748334,0
0,1276,40672,3578748334,3578748334,0
0,1276,40673,3578748334,3578748334,0
0,1276,40674,3578748334,3578748334,0
0,1276,40675,3578748334,3578748334,0
0,1276,40676,3578748334,3578748334,0
0,1276,40677,3578748334,3578748334,0
0,1276,40678,3578748334,3578748334,0
0,1276,40679,3578748334,3578748334,0
0,1276,40680,3578748334,3578748334,0
0,1276,40681,3578748334,3578748334,0
0,1276,40682,3578748334,3578748336,2
0,1276,40683,3578748334,3578748336,2
0,1276,40684,3578748334,3578748339,5
0,1276,40685,3578748334,3578748339,5
0,1276,40686,3578748334,3578748339,5
0,1276,40687,3578748334,3578748340,6
0,1276,40688,3578748334,3578748340,6
0,1276,40689,3578748334,3578748340,6
0,1276,40690,3578748334,3578748341,7
0,1276,40691,3578748334,3578748341,7
0,1276,40692,3578748334,3578748342,8
0,1276,40693,3578748334,3578748342,8
0,1276,40694,3578748334,3578748343,9
0,1276,40695,3578748334,3578748343,9
0,1276,40696,3578748334,3578748343,9
0,1276,40697,3578748334,3578748343,9
0,1276,40698,3578748334,3578748345,11
0,1276,40699,3578748334,3578748345,11
0,1276,40700,3578748334,3578748346,12
0,1276,40701,3578748334,3578748346,12
0,1276,40702,3578748334,3578748347,13
0,1276,40703,3578748334,3578748347,13
0,1276,40704,3578748334,3578748349,15
0,1276,40705,3578748334,3578748351,17
0,1276,40706,3578748334,3578748352,18
0,1276,40707,3578748334,3578748353,19
0,1276,40708,3578748334,3578748353,19
0,1276,40709,3578748334,3578748354,20
0,1276,40710,3578748334,3578748355,21
0,1276,40711,3578748334,3578748355,21
0,1276,40712,3578748334,3578748356,22
0,1276,40713,3578748334,3578748356,22
0,1276,40714,3578748334,3578748358,24
0,1276,40715,3578748334,3578748359,25
0,1276,40716,3578748334,3578748359,25
0,1276,40717,3578748334,3578748360,26
0,1276,40718,3578748334,3578748360,26
0,1276,40719,3578748334,3578748361,27
0,1276,40720,3578748334,3578748361,27
0,1276,40721,3578748334,3578748361,27
0,1276,40722,3578748334,3578748362,28
0,1276,40723,3578748334,3578748363,29
0,1276,40724,3578748334,3578748363,29
0,1276,40725,3578748334,3578748365,31
0,1276,40726,3578748334,3578748366,32
0,1276,40727,3578748334,3578748366,32
0,1276,40728,3578748334,3578748366,32
0,1276,40729,3578748334,3578748368,34
0,1276,40730,3578748334,3578748369,35
0,1276,40731,3578748334,3578748369,35
0,1276,40732,3578748334,3578748371,37
0,1276,40733,3578748334,3578748374,40
0,1276,40734,3578748334,3578748374,40
0,1276,40735,3578748334,3578748374,40
0,1276,40736,3578748334,3578748376,42
0,1276,40737,3578748334,3578748376,42
0,1276,40738,3578748334,3578748378,44
0,1276,40739,3578748334,3578748379,45
0,1276,40740,3578748334,3578748379,45
0,1276,40741,3578748334,3578748380,46
0,1276,40742,3578748334,3578748380,46
0,1276,40743,3578748334,3578748381,47
0,1276,40744,3578748334,3578748382,48
0,1276,40745,3578748334,3578748384,50
0,1277,40746,3578748396,3578748396,0
0,1277,40747,3578748396,3578748396,0
0,1277,40748,3578748396,3578748396,0
0,1277,40749,3578748396,3578748396,0
0,1277,40750,3578748396,3578748396,0
0,1277,40751,3578748396,3578748396,0
0,1277,40752,3578748396,3578748396,0
0,1277,40753,3578748396,3578748396,0
0,1277,40754,3578748396,3578748396,0
0,1277,40755,3578748396,3578748396,0
0,1277,40756,3578748396,3578748396,0
0,1277,40757,3578748396,3578748396,0
0,1277,40758,3578748396,3578748399,3
0,1277,40759,3578748396,3578748401,5
0,1277,40760,3578748396,3578748401,5
0,1277,40761,3578748396,3578748402,6
0,1277,40762,3578748396,3578748404,8
0,1277,40763,3578748396,3578748405,9
0,1277,40764,3578748396,3578748405,9
0,1277,40765,3578748396,3578748405,9
0,1277,40766,3578748396,3578748406,10
0,1277,40767,3578748396,3578748406,10
0,1277,40768,3578748396,3578748406,10
0,1277,40769,3578748396,3578748407,11
0,1277,40770,3578748396,3578748408,12
0,1277,40771,3578748396,3578748409,13
0,1277,40772,3578748396,3578748409,13
0,1277,40773,3578748396,3578748409,13
0,1277,40774,3578748396,3578748411,15
0,1277,40775,3578748396,3578748412,16
0,1277,40776,3578748396,3578748412,16
0,1277,40777,3578748396,3578748414,18
0,1277,40778,3578748396,3578748414,18
0,1277,40779,3578748396,3578748415,19
0,1277,40780,3578748396,3578748415,19
0,1277,40781,3578748396,3578748415,19
0,1277,40782,3578748396,3578748415,19
0,1277,40783,3578748396,3578748417,21
0,1277,40784,3578748396,3578748417,21
0,1277,40785,3578748396,3578748419,23
0,1277,40786,3578748396,3578748419,23
0,1277,40787,3578748396,3578748419,23
0,1277,40788,3578748396,3578748420,24
0,1277,40789,3578748396,3578748420,24
0,1277,40790,3578748396,3578748420,24
0,1277,40791,3578748396,3578748420,24
0,1277,40792,3578748396,3578748422,26
0,1277,40793,3578748396,3578748422,26
0,1277,40794,3578748396,3578748423,27
0,1277,40795,3578748396,3578748424,28
0,1277,40796,3578748396,3578748425,29
0,1277,40797,3578748396,3578748426,30
0,1277,40798,3578748396,3578748428,32
0,1277,40799,3578748396,3578748428,32
0,1277,40800,3578748396,3578748429,33
0,1277,40801,3578748396,3578748431,35
0,1277,40802,3578748396,3578748432,36
0,1277,40803,3578748396,3578748433,37
0,1277,40804,3578748396,3578748436,40
0,1277,40805,3578748396,3578748436,40
0,1277,40806,3578748396,3578748437,41
0,1277,40807,3578748396,3578748437,41
0,1277,40808,3578748396,3578748438,42
0,1277,40809,3578748396,3578748438,42
0,1277,40810,3578748396,3578748439,43
0,1277,40811,3578748396,3578748440,44
0,1277,40812,3578748396,3578748440,44
0,1277,40813,3578748396,3578748440,44
0,1277,40814,3578748396,3578748441,45
0,1277,40815,3578748396,3578748441,45
0,1277,40816,3578748396,3578748443,47
0,1277,40817,3578748396,3578748444,48
0,1277,40818,3578748396,3578748445,49
0,1277,40819,3578748396,3578748446,50
0,1278,40820,3578748461,3578748461,0
0,1278,40821,3578748461,3578748461,0
0,1278,40822,3578748461,3578748461,0
0,1278,40823,3578748461,3578748461,0
0,1278,40824,3578748461,3578748461,0
0,1278,40825,3578748461,3578748461,0
0,1278,40826,3578748461,3578748461,0
0,1278,40827,3578748461,3578748461,0
0,1278,40828,3578748461,3578748461,0
0,1278,40829,3578748461,3578748461,0
0,1278,40830,3578748461,3578748461,0
0,1278,40831,3578748461,3578748461,0
0,1278,40832,3578748461,3578748461,0
0,1278,40833,3578748461,3578748461,0
0,1278,40834,3578748461,3578748461,0
0,1278,40835,3578748461,3578748461,0
0,1278,40836,3578748461,3578748461,0
0,1278,40837,3578748461,3578748461,0
0,1278,40838,3578748461,3578748461,0
0,1278,40839,3578748461,3578748462,1
0,1278,40840,3578748461,3578748462,1
0,1278,40841,3578748461,3578748463,2
0,1278,40842,3578748461,3578748464,3
0,1278,40843,3578748461,3578748465,4
0,1278,40844,3578748461,3578748465,4
0,1278,40845,3578748461,3578748465,4
0,1278,40846,3578748461,3578748466,5
0,1278,40847,3578748461,3578748466,5
0,1278,40848,3578748461,3578748467,6
0,1278,40849,3578748461,3578748467,6
0,1278,40850,3578748461,3578748467,6
0,1278,40851,3578748461,3578748467,6
0,1278,40852,3578748461,3578748478,17
0,1278,40853,3578748461,3578748480,19
0,1278,40854,3578748461,3578748480,19
0,1278,40855,3578748461,3578748480,19
0,1278,40856,3578748461,3578748480,19
0,1278,40857,3578748461,3578748481,20
0,1278,40858,3578748461,3578748482,21
0,1278,40859,3578748461,3578748484,23
0,1278,40860,3578748461,3578748484,23
0,1278,40861,3578748461,3578748484,23
0,1278,40862,3578748461,3578748485,24
0,1278,40863,3578748461,3578748486,25
0,1278,40864,3578748461,3578748486,25
0,1278,40865,3578748461,3578748488,27
0,1278,40866,3578748461,3578748488,27
0,1278,40867,3578748461,3578748489,28
0,1278,40868,3578748461,3578748489,28
0,1278,40869,3578748461,3578748489,28
0,1278,40870,3578748461,3578748489,28
0,1278,40871,3578748461,3578748490,29
0,1278,40872,3578748461,3578748490,29
0,1278,40873,3578748461,3578748491,30
0,1278,40874,3578748461,3578748491,30
0,1278,40875,3578748461,3578748491,30
0,1278,40876,3578748461,3578748492,31
0,1278,40877,3578748461,3578748493,32
0,1278,40878,3578748461,3578748493,32
0,1278,40879,3578748461,3578748493,32
0,1278,40880,3578748461,3578748494,33
0,1278,40881,3578748461,3578748494,33
0,1278,40882,3578748461,3578748494,33
0,1278,40883,3578748461,3578748496,35
0,1278,40884,3578748461,3578748497,36
0,1278,40885,3578748461,3578748500,39
0,1278,40886,3578748461,3578748501,40
0,1278,40887,3578748461,3578748501,40
0,1278,40888,3578748461,3578748502,41
0,1278,40889,3578748461,3578748503,42
0,1278,40890,3578748461,3578748503,42
0,1278,40891,3578748461,3578748503,42
0,1278,40892,3578748461,3578748504,43
0,1278,40893,3578748461,3578748505,44
0,1278,40894,3578748461,3578748505,44
0,1278,40895,3578748461,3578748505,44
0,1278,40896,3578748461,3578748506,45
0,1278,40897,3578748461,3578748507,46
0,1278,40898,3578748461,3578748507,46
0,1278,40899,3578748461,3578748508,47
0,1278,40900,3578748461,3578748508,47
0,1278,40901,3578748461,3578748508,47
0,1278,40902,3578748461,3578748508,47
0,1278,40903,3578748461,3578748511,50
0,1278,40904,3578748461,3578748511,50
0,1279,40905,3578748524,3578748524,0
0,1279,40906,3578748524,3578748524,0
0,1279,40907,3578748524,3578748524,0
0,1279,40908,3578748524,3578748524,0
0,1279,40909,3578748524,3578748524,0
0,1279,40910,3578748524,3578748524,0
0,1279,40911,3578748524,3578748524,0
0,1279,40912,3578748524,3578748524,0
0,1279,40913,3578748524,3578748524,0
0,1279,40914,3578748524,3578748524,0
0,1279,40915,3578748524,3578748524,0
0,1279,40916,3578748524,3578748524,0
0,1279,40917,3578748524,3578748524,0
0,1279,40918,3578748524,3578748524,0
0,1279,40919,3578748524,3578748524,0
0,1279,40920,3578748524,3578748524,0
0,1279,40921,3578748524,3578748524,0
0,1279,40922,3578748524,3578748524,0
0,1279,40923,3578748524,3578748524,0
0,1279,40924,3578748524,3578748524,0
0,1279,40925,3578748524,3578748524,0
0,1279,40926,3578748524,3578748524,0
0,1279,40927,3578748524,3578748524,0
0,1279,40928,3578748524,3578748524,0
0,1279,40929,3578748524,3578748525,1
0,1279,40930,3578748524,3578748525,1
0,1279,40931,3578748524,3578748525,1
0,1279,40932,3578748524,3578748526,2
0,1279,40933,3578748524,3578748526,2
0,1279,40934,3578748524,3578748527,3
0,1279,40935,3578748524,3578748527,3
0,1279,40936,3578748524,3578748527,3
0,1279,40937,3578748524,3578748529,5
0,1279,40938,3578748524,3578748529,5
0,1279,40939,3578748524,3578748529,5
0,1279,40940,3578748524,3578748529,5
0,1279,40941,3578748524,3578748529,5
0,1279,40942,3578748524,3578748530,6
0,1279,40943,3578748524,3578748530,6
0,1279,40944,3578748524,3578748531,7
0,1279,40945,3578748524,3578748531,7
0,1279,40946,3578748524,3578748531,7
0,1279,40947,3578748524,3578748532,8
0,1279,40948,3578748524,3578748532,8
0,1279,40949,3578748524,3578748535,11
0,1279,40950,3578748524,3578748536,12
0,1279,40951,3578748524,3578748538,14
0,1279,40952,3578748524,3578748538,14
0,1279,40953,3578748524,3578748539,15
0,1279,40954,3578748524,3578748539,15
0,1279,40955,3578748524,3578748539,15
0,1279,40956,3578748524,3578748540,16
0,1279,40957,3578748524,3578748540,16
0,1279,40958,3578748524,3578748540,16
0,1279,40959,3578748524,3578748541,17
0,1279,40960,3578748524,3578748542,18
0,1279,40961,3578748524,3578748542,18
0,1279,40962,3578748524,3578748542,18
0,1279,40963,3578748524,3578748542,18
0,1279,40964,3578748524,3578748542,18
0,1279,40965,3578748524,3578748544,20
0,1279,40966,3578748524,3578748545,21
0,1279,40967,3578748524,3578748545,21
0,1279,40968,3578748524,3578748545,21
0,1279,40969,3578748524,3578748546,22
0,1279,40970,3578748524,3578748546,22
0,1279,40971,3578748524,3578748547,23
0,1279,40972,3578748524,3578748549,25
0,1279,40973,3578748524,3578748551,27
0,1279,40974,3578748524,3578748552,28
0,1279,40975,3578748524,3578748553,29
0,1279,40976,3578748524,3578748553,29
0,1279,40977,3578748524,3578748554,30
0,1279,40978,3578748524,3578748554,30
0,1279,40979,3578748524,3578748554,30
0,1279,40980,3578748524,3578748555,31
0,1279,40981,3578748524,3578748556,32
0,1279,40982,3578748524,3578748557,33
0,1279,40983,3578748524,3578748558,34
0,1279,40984,3578748524,3578748559,35
0,1279,40985,3578748524,3578748560,36
0,1279,40986,3578748524,3578748560,36
0,1279,40987,3578748524,3578748560,36
0,1279,40988,3578748524,3578748560,36
0,1279,40989,3578748524,3578748560,36
0,1279,40990,3578748524,3578748562,38
0,1279,40991,3578748524,3578748562,38
0,1279,40992,3578748524,3578748564,40
0,1279,40993,3578748524,3578748564,40
0,1279,40994,3578748524,3578748565,41
0,1279,40995,3578748524,3578748565,41
0,1279,40996,3578748524,3578748566,42
0,1279,40997,3578748524,3578748567,43
0,1279,40998,3578748524,3578748567,43
0,1279,40999,3578748524,3578748567,43
0,1279,41000,3578748524,3578748569,45
0,1279,41001,3578748524,3578748569,45
0,1279,41002,3578748524,3578748569,45
0,1279,41003,3578748524,3578748571,47
0,1279,41004,3578748524,3578748573,49
0,1279,41005,3578748524,3578748573,49
0,1279,41006,3578748524,3578748573,49
0,1280,41007,3578748587,3578748587,0
0,1280,41008,3578748587,3578748587,0
0,1280,41009,3578748587,3578748587,0
0,1280,41010,3578748587,3578748587,0
0,1280,41011,3578748587,3578748587,0
0,1280,41012,3578748587,3578748587,0
0,1280,41013,3578748587,3578748587,0
0,1280,41014,3578748587,3578748587,0
0,1280,41015,3578748587,3578748587,0
0,1280,41016,3578748587,3578748587,0
0,1280,41017,3578748587,3578748587,0
0,1280,41018,3578748587,3578748587,0
0,1280,41019,3578748587,3578748587,0
0,1280,41020,3578748587,3578748587,0
0,1280,41021,3578748587,3578748587,0
0,1280,41022,3578748587,3578748587,0
0,1280,41023,3578748587,3578748587,0
0,1280,41024,3578748587,3578748587,0
0,1280,41025,3578748587,3578748589,2
0,1280,41026,3578748587,3578748589,2
0,1280,41027,3578748587,3578748591,4
0,1280,41028,3578748587,3578748591,4
0,1280,41029,3578748587,3578748592,5
0,1280,41030,3578748587,3578748593,6
0,1280,41031,3578748587,3578748595,8
0,1280,41032,3578748587,3578748598,11
0,1280,41033,3578748587,3578748600,13
0,1280,41034,3578748587,3578748600,13
0,1280,41035,3578748587,3578748602,15
0,1280,41036,3578748587,3578748602,15
0,1280,41037,3578748587,3578748603,16
0,1280,41038,3578748587,3578748603,16
0,1280,41039,3578748587,3578748603,16
0,1280,41040,3578748587,3578748604,17
0,1280,41041,3578748587,3578748605,18
0,1280,41042,3578748587,3578748605,18
0,1280,41043,3578748587,3578748605,18
0,1280,41044,3578748587,3578748605,18
0,1280,41045,3578748587,3578748606,19
0,1280,41046,3578748587,3578748607,20
0,1280,41047,3578748587,3578748607,20
0,1280,41048,3578748587,3578748607,20
0,1280,41049,3578748587,3578748608,21
0,1280,41050,3578748587,3578748608,21
0,1280,41051,3578748587,3578748609,22
0,1280,41052,3578748587,3578748611,24
0,1280,41053,3578748587,3578748611,24
0,1280,41054,3578748587,3578748613,26
0,1280,41055,3578748587,3578748614,27
0,1280,41056,3578748587,3578748614,27
0,1280,41057,3578748587,3578748614,27
0,1280,41058,3578748587,3578748614,27
0,1280,41059,3578748587,3578748615,28
0,1280,41060,3578748587,3578748615,28
0,1280,41061,3578748587,3578748617,30
0,1280,41062,3578748587,3578748617,30
0,1280,41063,3578748587,3578748617,30
0,1280,41064,3578748587,3578748617,30
0,1280,41065,3578748587,3578748618,31
0,1280,41066,3578748587,3578748619,32
0,1280,41067,3578748587,3578748619,32
0,1280,41068,3578748587,3578748620,33
0,1280,41069,3578748587,3578748620,33
0,1280,41070,3578748587,3578748621,34
0,1280,41071,3578748587,3578748622,35
0,1280,41072,3578748587,3578748622,35
0,1280,41073,3578748587,3578748623,36
0,1280,41074,3578748587,3578748624,37
0,1280,41075,3578748587,3578748626,39
0,1280,41076,3578748587,3578748627,40
0,1280,41077,3578748587,3578748628,41
0,1280,41078,3578748587,3578748629,42
0,1280,41079,3578748587,3578748630,43
0,1280,41080,3578748587,3578748631,44
0,1280,41081,3578748587,3578748632,45
0,1280,41082,3578748587,3578748633,46
0,1280,41083,3578748587,3578748634,47
0,1280,41084,3578748587,3578748634,47
0,1280,41085,3578748587,3578748635,48
0,1280,41086,3578748587,3578748636,49
0,1280,41087,3578748587,3578748637,50
0,1280,41088,3578748587,3578748637,50
0,1281,41089,3578748650,3578748650,0
0,1281,41090,3578748650,3578748650,0
0,1281,41091,3578748650,3578748650,0
0,1281,41092,3578748650,3578748650,0
0,1281,41093,3578748650,3578748650,0
0,1281,41094,3578748650,3578748650,0
0,1281,41095,3578748650,3578748650,0
0,1281,41096,3578748650,3578748650,0
0,1281,41097,3578748650,3578748650,0
0,1281,41098,3578748650,3578748650,0
0,1281,41099,3578748650,3578748650,0
0,1281,41100,3578748650,3578748650,0
0,1281,41101,3578748650,3578748650,0
0,1281,41102,3578748650,3578748650,0
0,1281,41103,3578748650,3578748650,0
0,1281,41104,3578748650,3578748650,0
0,1281,41105,3578748650,3578748650,0
0,1281,41106,3578748650,3578748650,0
0,1281,41107,3578748650,3578748650,0
0,1281,41108,3578748650,3578748650,0
0,1281,41109,3578748650,3578748651,1
0,1281,41110,3578748650,3578748654,4
0,1281,41111,3578748650,3578748654,4
0,1281,41112,3578748650,3578748655,5
0,1281,41113,3578748650,3578748656,6
0,1281,41114,3578748650,3578748656,6
0,1281,41115,3578748650,3578748656,6
0,1281,41116,3578748650,3578748658,8
0,1281,41117,3578748650,3578748659,9
0,1281,41118,3578748650,3578748659,9
0,1281,41119,3578748650,3578748660,10
0,1281,41120,3578748650,3578748661,11
0,1281,41121,3578748650,3578748662,12
0,1281,41122,3578748650,3578748662,12
0,1281,41123,3578748650,3578748664,14
0,1281,41124,3578748650,3578748664,14
0,1281,41125,3578748650,3578748664,14
0,1281,41126,3578748650,3578748664,14
0,1281,41127,3578748650,3578748665,15
0,1281,41128,3578748650,3578748666,16
0,1281,41129,3578748650,3578748666,16
0,1281,41130,3578748650,3578748667,17
0,1281,41131,3578748650,3578748667,17
0,1281,41132,3578748650,3578748679,29
0,1281,41133,3578748650,3578748679,29
0,1281,41134,3578748650,3578748680,30
0,1281,41135,3578748650,3578748681,31
0,1281,41136,3578748650,3578748681,31
0,1281,41137,3578748650,3578748681,31
0,1281,41138,3578748650,3578748683,33
0,1281,41139,3578748650,3578748683,33
0,1281,41140,3578748650,3578748684,34
0,1281,41141,3578748650,3578748685,35
0,1281,41142,3578748650,3578748685,35
0,1281,41143,3578748650,3578748686,36
0,1281,41144,3578748650,3578748686,36
0,1281,41145,3578748650,3578748687,37
0,1281,41146,3578748650,3578748688,38
0,1281,41147,3578748650,3578748688,38
0,1281,41148,3578748650,3578748689,39
0,1281,41149,3578748650,3578748690,40
0,1281,41150,3578748650,3578748690,40
0,1281,41151,3578748650,3578748690,40
0,1281,41152,3578748650,3578748692,42
0,1281,41153,3578748650,3578748692,42
0,1281,41154,3578748650,3578748692,42
0,1281,41155,3578748650,3578748693,43
0,1281,41156,3578748650,3578748693,43
0,1281,41157,3578748650,3578748693,43
0,1281,41158,3578748650,3578748694,44
0,1281,41159,3578748650,3578748694,44
0,1281,41160,3578748650,3578748694,44
0,1281,41161,3578748650,3578748696,46
0,1281,41162,3578748650,3578748697,47
0,1282,41163,3578748712,3578748712,0
0,1282,41164,3578748712,3578748712,0
0,1282,41165,3578748712,3578748712,0
0,1282,41166,3578748712,3578748712,0
0,1282,41167,3578748712,3578748712,0
0,1282,41168,3578748712,3578748712,0
0,1282,41169,3578748712,3578748712,0
0,1282,41170,3578748712,3578748712,0
0,1282,41171,3578748712,3578748712,0
0,1282,41172,3578748712,3578748712,0
0,1282,41173,3578748712,3578748712,0
0,1282,41174,3578748712,3578748712,0
0,1282,41175,3578748712,3578748712,0
0,1282,41176,3578748712,3578748712,0
0,1282,41177,3578748712,3578748712,0
0,1282,41178,3578748712,3578748712,0
0,1282,41179,3578748712,3578748712,0
0,1282,41180,3578748712,3578748712,0
0,1282,41181,3578748712,3578748712,0
0,1282,41182,3578748712,3578748712,0
0,1282,41183,3578748712,3578748712,0
0,1282,41184,3578748712,3578748712,0
0,1282,41185,3578748712,3578748712,0
0,1282,41186,3578748712,3578748712,0
0,1282,41187,3578748712,3578748712,0
0,1282,41188,3578748712,3578748712,0
0,1282,41189,3578748712,3578748713,1
0,1282,41190,3578748712,3578748714,2
0,1282,41191,3578748712,3578748715,3
0,1282,41192,3578748712,3578748715,3
0,1282,41193,3578748712,3578748715,3
0,1282,41194,3578748712,3578748715,3
0,1282,41195,3578748712,3578748716,4
0,1282,41196,3578748712,3578748716,4
0,1282,41197,3578748712,3578748717,5
0,1282,41198,3578748712,3578748717,5
0,1282,41199,3578748712,3578748719,7
0,1282,41200,3578748712,3578748719,7
0,1282,41201,3578748712,3578748720,8
0,1282,41202,3578748712,3578748720,8
0,1282,41203,3578748712,3578748720,8
0,1282,41204,3578748712,3578748722,10
0,1282,41205,3578748712,3578748724,12
0,1282,41206,3578748712,3578748724,12
0,1282,41207,3578748712,3578748725,13
0,1282,41208,3578748712,3578748725,13
0,1282,41209,3578748712,3578748726,14
0,1282,41210,3578748712,3578748727,15
0,1282,41211,3578748712,3578748727,15
0,1282,41212,3578748712,3578748727,15
0,1282,41213,3578748712,3578748727,15
0,1282,41214,3578748712,3578748728,16
0,1282,41215,3578748712,3578748729,17
0,1282,41216,3578748712,3578748729,17
0,1282,41217,3578748712,3578748730,18
0,1282,41218,3578748712,3578748730,18
0,1282,41219,3578748712,3578748730,18
0,1282,41220,3578748712,3578748730,18
0,1282,41221,3578748712,3578748731,19
0,1282,41222,3578748712,3578748731,19
0,1282,41223,3578748712,3578748732,20
0,1282,41224,3578748712,3578748732,20
0,1282,41225,3578748712,3578748735,23
0,1282,41226,3578748712,3578748736,24
0,1282,41227,3578748712,3578748738,26
0,1282,41228,3578748712,3578748738,26
0,1282,41229,3578748712,3578748739,27
0,1282,41230,3578748712,3578748739,27
0,1282,41231,3578748712,3578748739,27
0,1282,41232,3578748712,3578748740,28
0,1282,41233,3578748712,3578748740,28
0,1282,41234,3578748712,3578748741,29
0,1282,41235,3578748712,3578748741,29
0,1282,41236,3578748712,3578748742,30
0,1282,41237,3578748712,3578748742,30
0,1282,41238,3578748712,3578748743,31
0,1282,41239,3578748712,3578748743,31
0,1282,41240,3578748712,3578748743,31
0,1282,41241,3578748712,3578748744,32
0,1282,41242,3578748712,3578748745,33
0,1282,41243,3578748712,3578748746,34
0,1282,41244,3578748712,3578748746,34
0,1282,41245,3578748712,3578748746,34
0,1282,41246,3578748712,3578748746,34
0,1282,41247,3578748712,3578748748,36
0,1282,41248,3578748712,3578748748,36
0,1282,41249,3578748712,3578748749,37
0,1282,41250,3578748712,3578748751,39
0,1282,41251,3578748712,3578748752,40
0,1282,41252,3578748712,3578748753,41
0,1282,41253,3578748712,3578748754,42
0,1282,41254,3578748712,3578748754,42
0,1282,41255,3578748712,3578748754,42
0,1282,41256,3578748712,3578748755,43
0,1282,41257,3578748712,3578748755,43
0,1282,41258,3578748712,3578748756,44
0,1282,41259,3578748712,3578748758,46
0,1282,41260,3578748712,3578748759,47
0,1282,41261,3578748712,3578748759,47
0,1282,41262,3578748712,3578748760,48
0,1282,41263,3578748712,3578748760,48
0,1282,41264,3578748712,3578748760,48
0,1282,41265,3578748712,3578748760,48
0,1282,41266,3578748712,3578748761,49
0,1282,41267,3578748712,3578748761,49
0,1283,41268,3578748775,3578748775,0
0,1283,41269,3578748775,3578748775,0
0,1283,41270,3578748775,3578748775,0
0,1283,41271,3578748775,3578748775,0
0,1283,41272,3578748775,3578748775,0
0,1283,41273,3578748775,3578748775,0
0,1283,41274,3578748775,3578748775,0
0,1283,41275,3578748775,3578748775,0
0,1283,41276,3578748775,3578748775,0
0,1283,41277,3578748775,3578748775,0
0,1283,41278,3578748775,3578748775,0
0,1283,41279,3578748775,3578748775,0
0,1283,41280,3578748775,3578748775,0
0,1283,41281,3578748775,3578748775,0
0,1283,41282,3578748775,3578748775,0
0,1283,41283,3578748775,3578748775,0
0,1283,41284,3578748775,3578748775,0
0,1283,41285,3578748775,3578748776,1
0,1283,41286,3578748775,3578748776,1
0,1283,41287,3578748775,3578748778,3
0,1283,41288,3578748775,3578748779,4
0,1283,41289,3578748775,3578748779,4
0,1283,41290,3578748775,3578748780,5
0,1283,41291,3578748775,3578748781,6
0,1283,41292,3578748775,3578748781,6
0,1283,41293,3578748775,3578748782,7
0,1283,41294,3578748775,3578748786,11
0,1283,41295,3578748775,3578748786,11
0,1283,41296,3578748775,3578748787,12
0,1283,41297,3578748775,3578748787,12
0,1283,41298,3578748775,3578748788,13
0,1283,41299,3578748775,3578748788,13
0,1283,41300,3578748775,3578748788,13
0,1283,41301,3578748775,3578748789,14
0,1283,41302,3578748775,3578748791,16
0,1283,41303,3578748775,3578748792,17
0,1283,41304,3578748775,3578748792,17
0,1283,41305,3578748775,3578748793,18
0,1283,41306,3578748775,3578748794,19
0,1283,41307,3578748775,3578748795,20
0,1283,41308,3578748775,3578748798,23
0,1283,41309,3578748775,3578748800,25
0,1283,41310,3578748775,3578748800,25
0,1283,41311,3578748775,3578748802,27
0,1283,41312,3578748775,3578748803,28
0,1283,41313,3578748775,3578748803,28
0,1283,41314,3578748775,3578748803,28
0,1283,41315,3578748775,3578748804,29
0,1283,41316,3578748775,3578748804,29
0,1283,41317,3578748775,3578748804,29
0,1283,41318,3578748775,3578748805,30
0,1283,41319,3578748775,3578748805,30
0,1283,41320,3578748775,3578748806,31
0,1283,41321,3578748775,3578748806,31
0,1283,41322,3578748775,3578748807,32
0,1283,41323,3578748775,3578748807,32
0,1283,41324,3578748775,3578748808,33
0,1283,41325,3578748775,3578748808,33
0,1283,41326,3578748775,3578748808,33
0,1283,41327,3578748775,3578748812,37
0,1283,41328,3578748775,3578748812,37
0,1283,41329,3578748775,3578748813,38
0,1283,41330,3578748775,3578748814,39
0,1283,41331,3578748775,3578748815,40
0,1283,41332,3578748775,3578748815,40
0,1283,41333,3578748775,3578748815,40
0,1283,41334,3578748775,3578748815,40
0,1283,41335,3578748775,3578748816,41
0,1283,41336,3578748775,3578748817,42
0,1283,41337,3578748775,3578748818,43
0,1283,41338,3578748775,3578748818,43
0,1283,41339,3578748775,3578748818,43
0,1283,41340,3578748775,3578748818,43
0,1283,41341,3578748775,3578748818,43
0,1283,41342,3578748775,3578748819,44
0,1283,41343,3578748775,3578748819,44
0,1283,41344,3578748775,3578748820,45
0,1283,41345,3578748775,3578748821,46
0,1283,41346,3578748775,3578748821,46
0,1283,41347,3578748775,3578748822,47
0,1283,41348,3578748775,3578748822,47
0,1283,41349,3578748775,3578748824,49
0,1284,41350,3578748837,3578748837,0
0,1284,41351,3578748837,3578748837,0
0,1284,41352,3578748837,3578748837,0
0,1284,41353,3578748837,3578748837,0
0,1284,41354,3578748837,3578748837,0
0,1284,41355,3578748837,3578748837,0
0,1284,41356,3578748837,3578748838,1
0,1284,41357,3578748837,3578748838,1
0,1284,41358,3578748837,3578748838,1
0,1284,41359,3578748837,3578748838,1
0,1284,41360,3578748837,3578748838,1
0,1284,41361,3578748837,3578748838,1
0,1284,41362,3578748837,3578748838,1
0,1284,41363,3578748837,3578748838,1
0,1284,41364,3578748837,3578748838,1
0,1284,41365,3578748837,3578748839,2
0,1284,41366,3578748837,3578748839,2
0,1284,41367,3578748837,3578748840,3
0,1284,41368,3578748837,3578748841,4
0,1284,41369,3578748837,3578748841,4
0,1284,41370,3578748837,3578748842,5
0,1284,41371,3578748837,3578748844,7
0,1284,41372,3578748837,3578748845,8
0,1284,41373,3578748837,3578748847,10
0,1284,41374,3578748837,3578748848,11
0,1284,41375,3578748837,3578748848,11
0,1284,41376,3578748837,3578748848,11
0,1284,41377,3578748837,3578748849,12
0,1284,41378,3578748837,3578748849,12
0,1284,41379,3578748837,3578748849,12
0,1284,41380,3578748837,3578748851,14
0,1284,41381,3578748837,3578748853,16
0,1284,41382,3578748837,3578748854,17
0,1284,41383,3578748837,3578748854,17
0,1284,41384,3578748837,3578748856,19
0,1284,41385,3578748837,3578748856,19
0,1284,41386,3578748837,3578748856,19
0,1284,41387,3578748837,3578748857,20
0,1284,41388,3578748837,3578748858,21
0,1284,41389,3578748837,3578748859,22
0,1284,41390,3578748837,3578748859,22
0,1284,41391,3578748837,3578748861,24
0,1284,41392,3578748837,3578748862,25
0,1284,41393,3578748837,3578748862,25
0,1284,41394,3578748837,3578748863,26
0,1284,41395,3578748837,3578748864,27
0,1284,41396,3578748837,3578748864,27
0,1284,41397,3578748837,3578748864,27
0,1284,41398,3578748837,3578748865,28
0,1284,41399,3578748837,3578748865,28
0,1284,41400,3578748837,3578748865,28
0,1284,41401,3578748837,3578748866,29
0,1284,41402,3578748837,3578748867,30
0,1284,41403,3578748837,3578748868,31
0,1284,41404,3578748837,3578748879,42
0,1284,41405,3578748837,3578748879,42
0,1284,41406,3578748837,3578748879,42
0,1284,41407,3578748837,3578748881,44
0,1284,41408,3578748837,3578748881,44
0,1284,41409,3578748837,3578748881,44
0,1284,41410,3578748837,3578748881,44
0,1284,41411,3578748837,3578748883,46
0,1284,41412,3578748837,3578748884,47
0,1284,41413,3578748837,3578748885,48
0,1284,41414,3578748837,3578748885,48
0,1284,41415,3578748837,3578748885,48
0,1284,41416,3578748837,3578748885,48
0,1284,41417,3578748837,3578748886,49
0,1285,41418,3578748899,3578748899,0
0,1285,41419,3578748899,3578748899,0
0,1285,41420,3578748899,3578748899,0
0,1285,41421,3578748899,3578748899,0
0,1285,41422,3578748899,3578748899,0
0,1285,41423,3578748899,3578748899,0
0,1285,41424,3578748899,3578748899,0
0,1285,41425,3578748899,3578748899,0
0,1285,41426,3578748899,3578748899,0
0,1285,41427,3578748899,3578748899,0
0,1285,41428,3578748899,3578748899,0
0,1285,41429,3578748899,3578748899,0
0,1285,41430,3578748899,3578748899,0
0,1285,41431,3578748899,3578748899,0
0,1285,41432,3578748899,3578748899,0
0,1285,41433,3578748899,3578748899,0
0,1285,41434,3578748899,3578748901,2
0,1285,41435,3578748899,3578748902,3
0,1285,41436,3578748899,3578748903,4
0,1285,41437,3578748899,3578748903,4
0,1285,41438,3578748899,3578748903,4
0,1285,41439,3578748899,3578748903,4
0,1285,41440,3578748899,3578748904,5
0,1285,41441,3578748899,3578748905,6
0,1285,41442,3578748899,3578748905,6
0,1285,41443,3578748899,3578748906,7
0,1285,41444,3578748899,3578748906,7
0,1285,41445,3578748899,3578748906,7
0,1285,41446,3578748899,3578748907,8
0,1285,41447,3578748899,3578748908,9
0,1285,41448,3578748899,3578748908,9
0,1285,41449,3578748899,3578748908,9
0,1285,41450,3578748899,3578748909,10
0,1285,41451,3578748899,3578748909,10
0,1285,41452,3578748899,3578748910,11
0,1285,41453,3578748899,3578748911,12
0,1285,41454,3578748899,3578748911,12
0,1285,41455,3578748899,3578748911,12
0,1285,41456,3578748899,3578748911,12
0,1285,41457,3578748899,3578748911,12
0,1285,41458,3578748899,3578748911,12
0,1285,41459,3578748899,3578748912,13
0,1285,41460,3578748899,3578748914,15
0,1285,41461,3578748899,3578748914,15
0,1285,41462,3578748899,3578748914,15
0,1285,41463,3578748899,3578748915,16
0,1285,41464,3578748899,3578748915,16
0,1285,41465,3578748899,3578748916,17
0,1285,41466,3578748899,3578748916,17
0,1285,41467,3578748899,3578748917,18
0,1285,41468,3578748899,3578748917,18
0,1285,41469,3578748899,3578748917,18
0,1285,41470,3578748899,3578748917,18
0,1285,41471,3578748899,3578748918,19
0,1285,41472,3578748899,3578748918,19
0,1285,41473,3578748899,3578748919,20
0,1285,41474,3578748899,3578748919,20
0,1285,41475,3578748899,3578748920,21
0,1285,41476,3578748899,3578748920,21
0,1285,41477,3578748899,3578748922,23
0,1285,41478,3578748899,3578748923,24
0,1285,41479,3578748899,3578748925,26
0,1285,41480,3578748899,3578748926,27
0,1285,41481,3578748899,3578748926,27
0,1285,41482,3578748899,3578748927,28
0,1285,41483,3578748899,3578748927,28
0,1285,41484,3578748899,3578748927,28
0,1285,41485,3578748899,3578748928,29
0,1285,41486,3578748899,3578748928,29
0,1285,41487,3578748899,3578748929,30
0,1285,41488,3578748899,3578748929,30
0,1285,41489,3578748899,3578748929,30
0,1285,41490,3578748899,3578748930,31
0,1285,41491,3578748899,3578748930,31
0,1285,41492,3578748899,3578748930,31
0,1285,41493,3578748899,3578748930,31
0,1285,41494,3578748899,3578748931,32
0,1285,41495,3578748899,3578748931,32
0,1285,41496,3578748899,3578748931,32
0,1285,41497,3578748899,3578748931,32
0,1285,41498,3578748899,3578748931,32
0,1285,41499,3578748899,3578748932,33
0,1285,41500,3578748899,3578748932,33
0,1285,41501,3578748899,3578748935,36
0,1285,41502,3578748899,3578748935,36
0,1285,41503,3578748899,3578748938,39
0,1285,41504,3578748899,3578748939,40
0,1285,41505,3578748899,3578748939,40
0,1285,41506,3578748899,3578748940,41
0,1285,41507,3578748899,3578748940,41
0,1285,41508,3578748899,3578748940,41
0,1285,41509,3578748899,3578748941,42
0,1285,41510,3578748899,3578748942,43
0,1285,41511,3578748899,3578748942,43
0,1285,41512,3578748899,3578748943,44
0,1285,41513,3578748899,3578748943,44
0,1285,41514,3578748899,3578748943,44
0,1285,41515,3578748899,3578748943,44
0,1285,41516,3578748899,3578748945,46
0,1285,41517,3578748899,3578748945,46
0,1285,41518,3578748899,3578748946,47
0,1285,41519,3578748899,3578748946,47
0,1285,41520,3578748899,3578748946,47
0,1285,41521,3578748899,3578748947,48
0,1285,41522,3578748899,3578748947,48
0,1285,41523,3578748899,3578748948,49
0,1286,41524,3578748961,3578748961,0
0,1286,41525,3578748961,3578748961,0
0,1286,41526,3578748961,3578748961,0
0,1286,41527,3578748961,3578748961,0
0,1286,41528,3578748961,3578748961,0
0,1286,41529,3578748961,3578748961,0
0,1286,41530,3578748961,3578748961,0
0,1286,41531,3578748961,3578748961,0
0,1286,41532,3578748961,3578748961,0
0,1286,41533,3578748961,3578748961,0
0,1286,41534,3578748961,3578748961,0
0,1286,41535,3578748961,3578748961,0
0,1286,41536,3578748961,3578748961,0
0,1286,41537,3578748961,3578748961,0
0,1286,41538,3578748961,3578748961,0
0,1286,41539,3578748961,3578748961,0
0,1286,41540,3578748961,3578748961,0
0,1286,41541,3578748961,3578748962,1
0,1286,41542,3578748961,3578748963,2
0,1286,41543,3578748961,3578748964,3
0,1286,41544,3578748961,3578748965,4
0,1286,41545,3578748961,3578748965,4
0,1286,41546,3578748961,3578748965,4
0,1286,41547,3578748961,3578748966,5
0,1286,41548,3578748961,3578748966,5
0,1286,41549,3578748961,3578748966,5
0,1286,41550,3578748961,3578748970,9
0,1286,41551,3578748961,3578748970,9
0,1286,41552,3578748961,3578748971,10
0,1286,41553,3578748961,3578748973,12
0,1286,41554,3578748961,3578748974,13
0,1286,41555,3578748961,3578748974,13
0,1286,41556,3578748961,3578748974,13
0,1286,41557,3578748961,3578748974,13
0,1286,41558,3578748961,3578748976,15
0,1286,41559,3578748961,3578748976,15
0,1286,41560,3578748961,3578748978,17
0,1286,41561,3578748961,3578748978,17
0,1286,41562,3578748961,3578748979,18
0,1286,41563,3578748961,3578748979,18
0,1286,41564,3578748961,3578748979,18
0,1286,41565,3578748961,3578748980,19
0,1286,41566,3578748961,3578748981,20
0,1286,41567,3578748961,3578748985,24
0,1286,41568,3578748961,3578748986,25
0,1286,41569,3578748961,3578748987,26
0,1286,41570,3578748961,3578748987,26
0,1286,41571,3578748961,3578748988,27
0,1286,41572,3578748961,3578748988,27
0,1286,41573,3578748961,3578748988,27
0,1286,41574,3578748961,3578748989,28
0,1286,41575,3578748961,3578748989,28
0,1286,41576,3578748961,3578748991,30
0,1286,41577,3578748961,3578748991,30
0,1286,41578,3578748961,3578748992,31
0,1286,41579,3578748961,3578748993,32
0,1286,41580,3578748961,3578748994,33
0,1286,41581,3578748961,3578748999,38
0,1286,41582,3578748961,3578749000,39
0,1286,41583,3578748961,3578749001,40
0,1286,41584,3578748961,3578749001,40
0,1286,41585,3578748961,3578749003,42
0,1286,41586,3578748961,3578749003,42
0,1286,41587,3578748961,3578749003,42
0,1286,41588,3578748961,3578749004,43
0,1286,41589,3578748961,3578749005,44
0,1286,41590,3578748961,3578749005,44
0,1286,41591,3578748961,3578749005,44
0,1286,41592,3578748961,3578749005,44
0,1286,41593,3578748961,3578749005,44
0,1286,41594,3578748961,3578749006,45
0,1286,41595,3578748961,3578749007,46
0,1286,41596,3578748961,3578749007,46
0,1286,41597,3578748961,3578749008,47
0,1286,41598,3578748961,3578749009,48
0,1286,41599,3578748961,3578749009,48
0,1287,41600,3578749024,3578749024,0
0,1287,41601,3578749024,3578749024,0
0,1287,41602,3578749024,3578749024,0
0,1287,41603,3578749024,3578749024,0
0,1287,41604,3578749024,3578749024,0
0,1287,41605,3578749024,3578749024,0
0,1287,41606,3578749024,3578749024,0
0,1287,41607,3578749024,3578749024,0
0,1287,41608,3578749024,3578749024,0
0,1287,41609,3578749024,3578749024,0
0,1287,41610,3578749024,3578749024,0
0,1287,41611,3578749024,3578749024,0
0,1287,41612,3578749024,3578749024,0
0,1287,41613,3578749024,3578749024,0
0,1287,41614,3578749024,3578749024,0
0,1287,41615,3578749024,3578749024,0
0,1287,41616,3578749024,3578749024,0
0,1287,41617,3578749024,3578749024,0
0,1287,41618,3578749024,3578749024,0
0,1287,41619,3578749024,3578749024,0
0,1287,41620,3578749024,3578749024,0
0,1287,41621,3578749024,3578749024,0
0,1287,41622,3578749024,3578749024,0
0,1287,41623,3578749024,3578749026,2
0,1287,41624,3578749024,3578749028,4
0,1287,41625,3578749024,3578749029,5
0,1287,41626,3578749024,3578749029,5
0,1287,41627,3578749024,3578749030,6
0,1287,41628,3578749024,3578749031,7
0,1287,41629,3578749024,3578749033,9
0,1287,41630,3578749024,3578749033,9
0,1287,41631,3578749024,3578749034,10
0,1287,41632,3578749024,3578749035,11
0,1287,41633,3578749024,3578749035,11
0,1287,41634,3578749024,3578749037,13
0,1287,41635,3578749024,3578749037,13
0,1287,41636,3578749024,3578749037,13
0,1287,41637,3578749024,3578749037,13
0,1287,41638,3578749024,3578749038,14
0,1287,41639,3578749024,3578749038,14
0,1287,41640,3578749024,3578749039,15
0,1287,41641,3578749024,3578749039,15
0,1287,41642,3578749024,3578749039,15
0,1287,41643,3578749024,3578749041,17
0,1287,41644,3578749024,3578749041,17
0,1287,41645,3578749024,3578749042,18
0,1287,41646,3578749024,3578749044,20
0,1287,41647,3578749024,3578749045,21
0,1287,41648,3578749024,3578749048,24
0,1287,41649,3578749024,3578749048,24
0,1287,41650,3578749024,3578749049,25
0,1287,41651,3578749024,3578749050,26
0,1287,41652,3578749024,3578749050,26
0,1287,41653,3578749024,3578749050,26
0,1287,41654,3578749024,3578749051,27
0,1287,41655,3578749024,3578749054,30
0,1287,41656,3578749024,3578749054,30
0,1287,41657,3578749024,3578749054,30
0,1287,41658,3578749024,3578749055,31
0,1287,41659,3578749024,3578749056,32
0,1287,41660,3578749024,3578749056,32
0,1287,41661,3578749024,3578749056,32
0,1287,41662,3578749024,3578749057,33
0,1287,41663,3578749024,3578749058,34
0,1287,41664,3578749024,3578749059,35
0,1287,41665,3578749024,3578749059,35
0,1287,41666,3578749024,3578749061,37
0,1287,41667,3578749024,3578749062,38
0,1287,41668,3578749024,3578749062,38
0,1287,41669,3578749024,3578749063,39
0,1287,41670,3578749024,3578749064,40
0,1287,41671,3578749024,3578749064,40
0,1287,41672,3578749024,3578749064,40
0,1287,41673,3578749024,3578749065,41
0,1287,41674,3578749024,3578749065,41
0,1287,41675,3578749024,3578749066,42
0,1287,41676,3578749024,3578749066,42
0,1287,41677,3578749024,3578749067,43
0,1287,41678,3578749024,3578749068,44
0,1287,41679,3578749024,3578749069,45
0,1288,41680,3578749087,3578749087,0
0,1288,41681,3578749087,3578749087,0
0,1288,41682,3578749087,3578749087,0
0,1288,41683,3578749087,3578749087,0
0,1288,41684,3578749087,3578749087,0
0,1288,41685,3578749087,3578749087,0
0,1288,41686,3578749087,3578749087,0
0,1288,41687,3578749087,3578749087,0
0,1288,41688,3578749087,3578749087,0
0,1288,41689,3578749087,3578749087,0
0,1288,41690,3578749087,3578749087,0
0,1288,41691,3578749087,3578749087,0
0,1288,41692,3578749087,3578749087,0
0,1288,41693,3578749087,3578749087,0
0,1288,41694,3578749087,3578749087,0
0,1288,41695,3578749087,3578749087,0
0,1288,41696,3578749087,3578749088,1
0,1288,41697,3578749087,3578749089,2
0,1288,41698,3578749087,3578749090,3
0,1288,41699,3578749087,3578749090,3
0,1288,41700,3578749087,3578749090,3
0,1288,41701,3578749087,3578749090,3
0,1288,41702,3578749087,3578749091,4
0,1288,41703,3578749087,3578749092,5
0,1288,41704,3578749087,3578749092,5
0,1288,41705,3578749087,3578749093,6
0,1288,41706,3578749087,3578749093,6
0,1288,41707,3578749087,3578749093,6
0,1288,41708,3578749087,3578749094,7
0,1288,41709,3578749087,3578749094,7
0,1288,41710,3578749087,3578749095,8
0,1288,41711,3578749087,3578749096,9
0,1288,41712,3578749087,3578749102,15
0,1288,41713,3578749087,3578749103,16
0,1288,41714,3578749087,3578749103,16
0,1288,41715,3578749087,3578749103,16
0,1288,41716,3578749087,3578749104,17
0,1288,41717,3578749087,3578749104,17
0,1288,41718,3578749087,3578749104,17
0,1288,41719,3578749087,3578749105,18
0,1288,41720,3578749087,3578749105,18
0,1288,41721,3578749087,3578749106,19
0,1288,41722,3578749087,3578749106,19
0,1288,41723,3578749087,3578749107,20
0,1288,41724,3578749087,3578749107,20
0,1288,41725,3578749087,3578749108,21
0,1288,41726,3578749087,3578749108,21
0,1288,41727,3578749087,3578749108,21
0,1288,41728,3578749087,3578749109,22
0,1288,41729,3578749087,3578749109,22
0,1288,41730,3578749087,3578749110,23
0,1288,41731,3578749087,3578749111,24
0,1288,41732,3578749087,3578749111,24
0,1288,41733,3578749087,3578749111,24
0,1288,41734,3578749087,3578749111,24
0,1288,41735,3578749087,3578749112,25
0,1288,41736,3578749087,3578749112,25
0,1288,41737,3578749087,3578749112,25
0,1288,41738,3578749087,3578749114,27
0,1288,41739,3578749087,3578749114,27
0,1288,41740,3578749087,3578749115,28
0,1288,41741,3578749087,3578749115,28
0,1288,41742,3578749087,3578749115,28
0,1288,41743,3578749087,3578749116,29
0,1288,41744,3578749087,3578749116,29
0,1288,41745,3578749087,3578749116,29
0,1288,41746,3578749087,3578749117,30
0,1288,41747,3578749087,3578749117,30
0,1288,41748,3578749087,3578749117,30
0,1288,41749,3578749087,3578749117,30
0,1288,41750,3578749087,3578749117,30
0,1288,41751,3578749087,3578749117,30
0,1288,41752,3578749087,3578749119,32
0,1288,41753,3578749087,3578749119,32
0,1288,41754,3578749087,3578749120,33
0,1288,41755,3578749087,3578749120,33
0,1288,41756,3578749087,3578749120,33
0,1288,41757,3578749087,3578749121,34
0,1288,41758,3578749087,3578749122,35
0,1288,41759,3578749087,3578749124,37
0,1288,41760,3578749087,3578749124,37
0,1288,41761,3578749087,3578749125,38
0,1288,41762,3578749087,3578749125,38
0,1288,41763,3578749087,3578749127,40
0,1288,41764,3578749087,3578749127,40
0,1288,41765,3578749087,3578749127,40
0,1288,41766,3578749087,3578749128,41
0,1288,41767,3578749087,3578749128,41
0,1288,41768,3578749087,3578749128,41
0,1288,41769,3578749087,3578749129,42
0,1288,41770,3578749087,3578749129,42
0,1288,41771,3578749087,3578749129,42
0,1288,41772,3578749087,3578749130,43
0,1288,41773,3578749087,3578749130,43
0,1288,41774,3578749087,3578749130,43
0,1288,41775,3578749087,3578749131,44
0,1288,41776,3578749087,3578749131,44
0,1288,41777,3578749087,3578749131,44
0,1288,41778,3578749087,3578749131,44
0,1288,41779,3578749087,3578749131,44
0,1288,41780,3578749087,3578749132,45
0,1288,41781,3578749087,3578749132,45
0,1288,41782,3578749087,3578749135,48
0,1288,41783,3578749087,3578749135,48
0,1289,41784,3578749150,3578749150,0
0,1289,41785,3578749150,3578749150,0
0,1289,41786,3578749150,3578749150,0
0,1289,41787,3578749150,3578749150,0
0,1289,41788,3578749150,3578749150,0
0,1289,41789,3578749150,3578749150,0
0,1289,41790,3578749150,3578749150,0
0,1289,41791,3578749150,3578749150,0
0,1289,41792,3578749150,3578749150,0
0,1289,41793,3578749150,3578749150,0
0,1289,41794,3578749150,3578749150,0
0,1289,41795,3578749150,3578749150,0
0,1289,41796,3578749150,3578749150,0
0,1289,41797,3578749150,3578749150,0
0,1289,41798,3578749150,3578749150,0
0,1289,41799,3578749150,3578749150,0
0,1289,41800,3578749150,3578749150,0
0,1289,41801,3578749150,3578749150,0
0,1289,41802,3578749150,3578749150,0
0,1289,41803,3578749150,3578749150,0
0,1289,41804,3578749150,3578749150,0
0,1289,41805,3578749150,3578749150,0
0,1289,41806,3578749150,3578749150,0
0,1289,41807,3578749150,3578749151,1
0,1289,41808,3578749150,3578749151,1
0,1289,41809,3578749150,3578749154,4
0,1289,41810,3578749150,3578749154,4
0,1289,41811,3578749150,3578749155,5
0,1289,41812,3578749150,3578749155,5
0,1289,41813,3578749150,3578749156,6
0,1289,41814,3578749150,3578749157,7
0,1289,41815,3578749150,3578749158,8
0,1289,41816,3578749150,3578749159,9
0,1289,41817,3578749150,3578749159,9
0,1289,41818,3578749150,3578749160,10
0,1289,41819,3578749150,3578749161,11
0,1289,41820,3578749150,3578749161,11
0,1289,41821,3578749150,3578749162,12
0,1289,41822,3578749150,3578749162,12
0,1289,41823,3578749150,3578749163,13
0,1289,41824,3578749150,3578749163,13
0,1289,41825,3578749150,3578749165,15
0,1289,41826,3578749150,3578749165,15
0,1289,41827,3578749150,3578749165,15
0,1289,41828,3578749150,3578749166,16
0,1289,41829,3578749150,3578749167,17
0,1289,41830,3578749150,3578749168,18
0,1289,41831,3578749150,3578749168,18
0,1289,41832,3578749150,3578749168,18
0,1289,41833,3578749150,3578749170,20
0,1289,41834,3578749150,3578749170,20
0,1289,41835,3578749150,3578749171,21
0,1289,41836,3578749150,3578749172,22
0,1289,41837,3578749150,3578749174,24
0,1289,41838,3578749150,3578749174,24
0,1289,41839,3578749150,3578749174,24
0,1289,41840,3578749150,3578749174,24
0,1289,41841,3578749150,3578749176,26
0,1289,41842,3578749150,3578749176,26
0,1289,41843,3578749150,3578749178,28
0,1289,41844,3578749150,3578749179,29
0,1289,41845,3578749150,3578749179,29
0,1289,41846,3578749150,3578749180,30
0,1289,41847,3578749150,3578749180,30
0,1289,41848,3578749150,3578749180,30
0,1289,41849,3578749150,3578749182,32
0,1289,41850,3578749150,3578749182,32
0,1289,41851,3578749150,3578749184,34
0,1289,41852,3578749150,3578749186,36
0,1289,41853,3578749150,3578749187,37
0,1289,41854,3578749150,3578749187,37
0,1289,41855,3578749150,3578749187,37
0,1289,41856,3578749150,3578749188,38
0,1289,41857,3578749150,3578749188,38
0,1289,41858,3578749150,3578749192,42
0,1289,41859,3578749150,3578749193,43
0,1289,41860,3578749150,3578749195,45
0,1289,41861,3578749150,3578749199,49
0,1289,41862,3578749150,3578749200,50
0,1290,41863,3578749212,3578749212,0
0,1290,41864,3578749212,3578749212,0
0,1290,41865,3578749212,3578749212,0
0,1290,41866,3578749212,3578749212,0
0,1290,41867,3578749212,3578749212,0
0,1290,41868,3578749212,3578749212,0
0,1290,41869,3578749212,3578749212,0
0,1290,41870,3578749212,3578749212,0
0,1290,41871,3578749212,3578749212,0
0,1290,41872,3578749212,3578749212,0
0,1290,41873,3578749212,3578749212,0
0,1290,41874,3578749212,3578749212,0
0,1290,41875,3578749212,3578749212,0
0,1290,41876,3578749212,3578749212,0
0,1290,41877,3578749212,3578749212,0
0,1290,41878,3578749212,3578749212,0
0,1290,41879,3578749212,3578749213,1
0,1290,41880,3578749212,3578749213,1
0,1290,41881,3578749212,3578749214,2
0,1290,41882,3578749212,3578749214,2
0,1290,41883,3578749212,3578749215,3
0,1290,41884,3578749212,3578749215,3
0,1290,41885,3578749212,3578749215,3
0,1290,41886,3578749212,3578749215,3
0,1290,41887,3578749212,3578749216,4
0,1290,41888,3578749212,3578749217,5
0,1290,41889,3578749212,3578749218,6
0,1290,41890,3578749212,3578749218,6
0,1290,41891,3578749212,3578749219,7
0,1290,41892,3578749212,3578749219,7
0,1290,41893,3578749212,3578749219,7
0,1290,41894,3578749212,3578749220,8
0,1290,41895,3578749212,3578749221,9
0,1290,41896,3578749212,3578749221,9
0,1290,41897,3578749212,3578749221,9
0,1290,41898,3578749212,3578749222,10
0,1290,41899,3578749212,3578749222,10
0,1290,41900,3578749212,3578749223,11
0,1290,41901,3578749212,3578749224,12
0,1290,41902,3578749212,3578749225,13
0,1290,41903,3578749212,3578749228,16
0,1290,41904,3578749212,3578749229,17
0,1290,41905,3578749212,3578749230,18
0,1290,41906,3578749212,3578749230,18
0,1290,41907,3578749212,3578749230,18
0,1290,41908,3578749212,3578749231,19
0,1290,41909,3578749212,3578749232,20
0,1290,41910,3578749212,3578749233,21
0,1290,41911,3578749212,3578749234,22
0,1290,41912,3578749212,3578749235,23
0,1290,41913,3578749212,3578749236,24
0,1290,41914,3578749212,3578749237,25
0,1290,41915,3578749212,3578749237,25
0,1290,41916,3578749212,3578749238,26
0,1290,41917,3578749212,3578749238,26
0,1290,41918,3578749212,3578749238,26
0,1290,41919,3578749212,3578749239,27
0,1290,41920,3578749212,3578749240,28
0,1290,41921,3578749212,3578749240,28
0,1290,41922,3578749212,3578749240,28
0,1290,41923,3578749212,3578749241,29
0,1290,41924,3578749212,3578749242,30
0,1290,41925,3578749212,3578749242,30
0,1290,41926,3578749212,3578749245,33
0,1290,41927,3578749212,3578749245,33
0,1290,41928,3578749212,3578749247,35
0,1290,41929,3578749212,3578749247,35
0,1290,41930,3578749212,3578749247,35
0,1290,41931,3578749212,3578749248,36
0,1290,41932,3578749212,3578749249,37
0,1290,41933,3578749212,3578749249,37
0,1290,41934,3578749212,3578749250,38
0,1290,41935,3578749212,3578749251,39
0,1290,41936,3578749212,3578749251,39
0,1290,41937,3578749212,3578749252,40
0,1290,41938,3578749212,3578749254,42
0,1290,41939,3578749212,3578749254,42
0,1290,41940,3578749212,3578749254,42
0,1290,41941,3578749212,3578749256,44
0,1290,41942,3578749212,3578749256,44
0,1290,41943,3578749212,3578749256,44
0,1290,41944,3578749212,3578749256,44
0,1290,41945,3578749212,3578749257,45
0,1290,41946,3578749212,3578749259,47
0,1290,41947,3578749212,3578749259,47
0,1290,41948,3578749212,3578749259,47
0,1290,41949,3578749212,3578749261,49
0,1291,41950,3578749275,3578749275,0
0,1291,41951,3578749275,3578749275,0
0,1291,41952,3578749275,3578749275,0
0,1291,41953,3578749275,3578749275,0
0,1291,41954,3578749275,3578749275,0
0,1291,41955,3578749275,3578749275,0
0,1291,41956,3578749275,3578749275,0
0,1291,41957,3578749275,3578749275,0
0,1291,41958,3578749275,3578749275,0
0,1291,41959,3578749275,3578749275,0
0,1291,41960,3578749275,3578749275,0
0,1291,41961,3578749275,3578749276,1
0,1291,41962,3578749275,3578749276,1
0,1291,41963,3578749275,3578749276,1
0,1291,41964,3578749275,3578749279,4
0,1291,41965,3578749275,3578749279,4
0,1291,41966,3578749275,3578749279,4
0,1291,41967,3578749275,3578749280,5
0,1291,41968,3578749275,3578749281,6
0,1291,41969,3578749275,3578749281,6
0,1291,41970,3578749275,3578749282,7
0,1291,41971,3578749275,3578749284,9
0,1291,41972,3578749275,3578749285,10
0,1291,41973,3578749275,3578749285,10
0,1291,41974,3578749275,3578749286,11
0,1291,41975,3578749275,3578749286,11
0,1291,41976,3578749275,3578749287,12
0,1291,41977,3578749275,3578749287,12
0,1291,41978,3578749275,3578749287,12
0,1291,41979,3578749275,3578749288,13
0,1291,41980,3578749275,3578749289,14
0,1291,41981,3578749275,3578749290,15
0,1291,41982,3578749275,3578749290,15
0,1291,41983,3578749275,3578749290,15
0,1291,41984,3578749275,3578749290,15
0,1291,41985,3578749275,3578749291,16
0,1291,41986,3578749275,3578749291,16
0,1291,41987,3578749275,3578749292,17
0,1291,41988,3578749275,3578749293,18
0,1291,41989,3578749275,3578749293,18
0,1291,41990,3578749275,3578749293,18
0,1291,41991,3578749275,3578749293,18
0,1291,41992,3578749275,3578749294,19
0,1291,41993,3578749275,3578749294,19
0,1291,41994,3578749275,3578749294,19
0,1291,41995,3578749275,3578749296,21
0,1291,41996,3578749275,3578749297,22
0,1291,41997,3578749275,3578749302,27
0,1291,41998,3578749275,3578749303,28
0,1291,41999,3578749275,3578749303,28
0,1291,42000,3578749275,3578749303,28
0,1291,42001,3578749275,3578749304,29
0,1291,42002,3578749275,3578749304,29
0,1291,42003,3578749275,3578749304,29
0,1291,42004,3578749275,3578749305,30
0,1291,42005,3578749275,3578749305,30
0,1291,42006,3578749275,3578749306,31
0,1291,42007,3578749275,3578749306,31
0,1291,42008,3578749275,3578749307,32
0,1291,42009,3578749275,3578749307,32
0,1291,42010,3578749275,3578749308,33
0,1291,42011,3578749275,3578749309,34
0,1291,42012,3578749275,3578749309,34
0,1291,42013,3578749275,3578749309,34
0,1291,42014,3578749275,3578749309,34
0,1291,42015,3578749275,3578749310,35
0,1291,42016,3578749275,3578749311,36
0,1291,42017,3578749275,3578749311,36
0,1291,42018,3578749275,3578749311,36
0,1291,42019,3578749275,3578749311,36
0,1291,42020,3578749275,3578749312,37
0,1291,42021,3578749275,3578749313,38
0,1291,42022,3578749275,3578749313,38
0,1291,42023,3578749275,3578749313,38
0,1291,42024,3578749275,3578749314,39
0,1291,42025,3578749275,3578749315,40
0,1291,42026,3578749275,3578749315,40
0,1291,42027,3578749275,3578749316,41
0,1291,42028,3578749275,3578749316,41
0,1291,42029,3578749275,3578749316,41
0,1291,42030,3578749275,3578749316,41
0,1291,42031,3578749275,3578749317,42
0,1291,42032,3578749275,3578749317,42
0,1291,42033,3578749275,3578749318,43
0,1291,42034,3578749275,3578749319,44
0,1291,42035,3578749275,3578749319,44
0,1291,42036,3578749275,3578749319,44
0,1291,42037,3578749275,3578749320,45
0,1291,42038,3578749275,3578749320,45
0,1291,42039,3578749275,3578749322,47
0,1291,42040,3578749275,3578749323,48
0,1291,42041,3578749275,3578749323,48
0,1291,42042,3578749275,3578749325,50
0,1292,42043,3578749337,3578749337,0
0,1292,42044,3578749337,3578749337,0
0,1292,42045,3578749337,3578749337,0
0,1292,42046,3578749337,3578749337,0
0,1292,42047,3578749337,3578749337,0
0,1292,42048,3578749337,3578749337,0
0,1292,42049,3578749337,3578749337,0
0,1292,42050,3578749337,3578749337,0
0,1292,42051,3578749337,3578749337,0
0,1292,42052,3578749337,3578749337,0
0,1292,42053,3578749337,3578749337,0
0,1292,42054,3578749337,3578749337,0
0,1292,42055,3578749337,3578749337,0
0,1292,42056,3578749337,3578749337,0
0,1292,42057,3578749337,3578749337,0
0,1292,42058,3578749337,3578749337,0
0,1292,42059,3578749337,3578749337,0
0,1292,42060,3578749337,3578749337,0
0,1292,42061,3578749337,3578749337,0
0,1292,42062,3578749337,3578749337,0
0,1292,42063,3578749337,3578749337,0
0,1292,42064,3578749337,3578749337,0
0,1292,42065,3578749337,3578749338,1
0,1292,42066,3578749337,3578749339,2
0,1292,42067,3578749337,3578749340,3
0,1292,42068,3578749337,3578749340,3
0,1292,42069,3578749337,3578749340,3
0,1292,42070,3578749337,3578749340,3
0,1292,42071,3578749337,3578749341,4
0,1292,42072,3578749337,3578749342,5
0,1292,42073,3578749337,3578749342,5
0,1292,42074,3578749337,3578749343,6
0,1292,42075,3578749337,3578749343,6
0,1292,42076,3578749337,3578749343,6
0,1292,42077,3578749337,3578749343,6
0,1292,42078,3578749337,3578749344,7
0,1292,42079,3578749337,3578749344,7
0,1292,42080,3578749337,3578749345,8
0,1292,42081,3578749337,3578749345,8
0,1292,42082,3578749337,3578749347,10
0,1292,42083,3578749337,3578749347,10
0,1292,42084,3578749337,3578749348,11
0,1292,42085,3578749337,3578749348,11
0,1292,42086,3578749337,3578749348,11
0,1292,42087,3578749337,3578749349,12
0,1292,42088,3578749337,3578749351,14
0,1292,42089,3578749337,3578749352,15
0,1292,42090,3578749337,3578749354,17
0,1292,42091,3578749337,3578749355,18
0,1292,42092,3578749337,3578749355,18
0,1292,42093,3578749337,3578749356,19
0,1292,42094,3578749337,3578749356,19
0,1292,42095,3578749337,3578749356,19
0,1292,42096,3578749337,3578749359,22
0,1292,42097,3578749337,3578749359,22
0,1292,42098,3578749337,3578749359,22
0,1292,42099,3578749337,3578749360,23
0,1292,42100,3578749337,3578749361,24
0,1292,42101,3578749337,3578749361,24
0,1292,42102,3578749337,3578749361,24
0,1292,42103,3578749337,3578749362,25
0,1292,42104,3578749337,3578749363,26
0,1292,42105,3578749337,3578749365,28
0,1292,42106,3578749337,3578749365,28
0,1292,42107,3578749337,3578749365,28
0,1292,42108,3578749337,3578749366,29
0,1292,42109,3578749337,3578749367,30
0,1292,42110,3578749337,3578749367,30
0,1292,42111,3578749337,3578749367,30
0,1292,42112,3578749337,3578749368,31
0,1292,42113,3578749337,3578749369,32
0,1292,42114,3578749337,3578749370,33
0,1292,42115,3578749337,3578749370,33
0,1292,42116,3578749337,3578749371,34
0,1292,42117,3578749337,3578749371,34
0,1292,42118,3578749337,3578749373,36
0,1292,42119,3578749337,3578749373,36
0,1292,42120,3578749337,3578749374,37
0,1292,42121,3578749337,3578749374,37
0,1292,42122,3578749337,3578749374,37
0,1292,42123,3578749337,3578749375,38
0,1292,42124,3578749337,3578749376,39
0,1292,42125,3578749337,3578749377,40
0,1292,42126,3578749337,3578749378,41
0,1292,42127,3578749337,3578749379,42
0,1292,42128,3578749337,3578749380,43
0,1292,42129,3578749337,3578749380,43
0,1292,42130,3578749337,3578749380,43
0,1292,42131,3578749337,3578749381,44
0,1292,42132,3578749337,3578749382,45
0,1292,42133,3578749337,3578749382,45
0,1292,42134,3578749337,3578749384,47
0,1292,42135,3578749337,3578749386,49
0,1292,42136,3578749337,3578749387,50
0,1293,42137,3578749400,3578749400,0
0,1293,42138,3578749400,3578749400,0
0,1293,42139,3578749400,3578749400,0
0,1293,42140,3578749400,3578749400,0
0,1293,42141,3578749400,3578749400,0
0,1293,42142,3578749400,3578749400,0
0,1293,42143,3578749400,3578749400,0
0,1293,42144,3578749400,3578749400,0
0,1293,42145,3578749400,3578749400,0
0,1293,42146,3578749400,3578749401,1
0,1293,42147,3578749400,3578749401,1
0,1293,42148,3578749400,3578749402,2
0,1293,42149,3578749400,3578749404,4
0,1293,42150,3578749400,3578749404,4
0,1293,42151,3578749400,3578749404,4
0,1293,42152,3578749400,3578749404,4
0,1293,42153,3578749400,3578749405,5
0,1293,42154,3578749400,3578749405,5
0,1293,42155,3578749400,3578749406,6
0,1293,42156,3578749400,3578749406,6
0,1293,42157,3578749400,3578749406,6
0,1293,42158,3578749400,3578749406,6
0,1293,42159,3578749400,3578749407,7
0,1293,42160,3578749400,3578749408,8
0,1293,42161,3578749400,3578749408,8
0,1293,42162,3578749400,3578749410,10
0,1293,42163,3578749400,3578749411,11
0,1293,42164,3578749400,3578749413,13
0,1293,42165,3578749400,3578749414,14
0,1293,42166,3578749400,3578749414,14
0,1293,42167,3578749400,3578749414,14
0,1293,42168,3578749400,3578749415,15
0,1293,42169,3578749400,3578749415,15
0,1293,42170,3578749400,3578749416,16
0,1293,42171,3578749400,3578749416,16
0,1293,42172,3578749400,3578749418,18
0,1293,42173,3578749400,3578749419,19
0,1293,42174,3578749400,3578749419,19
0,1293,42175,3578749400,3578749419,19
0,1293,42176,3578749400,3578749419,19
0,1293,42177,3578749400,3578749419,19
0,1293,42178,3578749400,3578749420,20
0,1293,42179,3578749400,3578749421,21
0,1293,42180,3578749400,3578749422,22
0,1293,42181,3578749400,3578749422,22
0,1293,42182,3578749400,3578749422,22
0,1293,42183,3578749400,3578749422,22
0,1293,42184,3578749400,3578749423,23
0,1293,42185,3578749400,3578749425,25
0,1293,42186,3578749400,3578749427,27
0,1293,42187,3578749400,3578749428,28
0,1293,42188,3578749400,3578749428,28
0,1293,42189,3578749400,3578749429,29
0,1293,42190,3578749400,3578749430,30
0,1293,42191,3578749400,3578749430,30
0,1293,42192,3578749400,3578749431,31
0,1293,42193,3578749400,3578749431,31
0,1293,42194,3578749400,3578749433,33
0,1293,42195,3578749400,3578749433,33
0,1293,42196,3578749400,3578749435,35
0,1293,42197,3578749400,3578749435,35
0,1293,42198,3578749400,3578749436,36
0,1293,42199,3578749400,3578749437,37
0,1293,42200,3578749400,3578749437,37
0,1293,42201,3578749400,3578749438,38
0,1293,42202,3578749400,3578749439,39
0,1293,42203,3578749400,3578749440,40
0,1293,42204,3578749400,3578749441,41
0,1293,42205,3578749400,3578749442,42
0,1293,42206,3578749400,3578749442,42
0,1293,42207,3578749400,3578749443,43
0,1293,42208,3578749400,3578749445,45
0,1293,42209,3578749400,3578749445,45
0,1293,42210,3578749400,3578749446,46
0,1293,42211,3578749400,3578749447,47
0,1293,42212,3578749400,3578749447,47
0,1293,42213,3578749400,3578749448,48
0,1293,42214,3578749400,3578749448,48
0,1293,42215,3578749400,3578749449,49
0,1294,42216,3578749463,3578749463,0
0,1294,42217,3578749463,3578749463,0
0,1294,42218,3578749463,3578749463,0
0,1294,42219,3578749463,3578749463,0
0,1294,42220,3578749463,3578749463,0
0,1294,42221,3578749463,3578749463,0
0,1294,42222,3578749463,3578749463,0
0,1294,42223,3578749463,3578749463,0
0,1294,42224,3578749463,3578749463,0
0,1294,42225,3578749463,3578749463,0
0,1294,42226,3578749463,3578749463,0
0,1294,42227,3578749463,3578749463,0
0,1294,42228,3578749463,3578749463,0
0,1294,42229,3578749463,3578749463,0
0,1294,42230,3578749463,3578749463,0
0,1294,42231,3578749463,3578749463,0
0,1294,42232,3578749463,3578749463,0
0,1294,42233,3578749463,3578749463,0
0,1294,42234,3578749463,3578749463,0
0,1294,42235,3578749463,3578749464,1
0,1294,42236,3578749463,3578749465,2
0,1294,42237,3578749463,3578749465,2
0,1294,42238,3578749463,3578749465,2
0,1294,42239,3578749463,3578749465,2
0,1294,42240,3578749463,3578749466,3
0,1294,42241,3578749463,3578749467,4
0,1294,42242,3578749463,3578749467,4
0,1294,42243,3578749463,3578749467,4
0,1294,42244,3578749463,3578749470,7
0,1294,42245,3578749463,3578749479,16
0,1294,42246,3578749463,3578749479,16
0,1294,42247,3578749463,3578749480,17
0,1294,42248,3578749463,3578749480,17
0,1294,42249,3578749463,3578749480,17
0,1294,42250,3578749463,3578749481,18
0,1294,42251,3578749463,3578749481,18
0,1294,42252,3578749463,3578749484,21
0,1294,42253,3578749463,3578749485,22
0,1294,42254,3578749463,3578749485,22
0,1294,42255,3578749463,3578749486,23
0,1294,42256,3578749463,3578749487,24
0,1294,42257,3578749463,3578749487,24
0,1294,42258,3578749463,3578749487,24
0,1294,42259,3578749463,3578749487,24
0,1294,42260,3578749463,3578749489,26
0,1294,42261,3578749463,3578749489,26
0,1294,42262,3578749463,3578749490,27
0,1294,42263,3578749463,3578749490,27
0,1294,42264,3578749463,3578749490,27
0,1294,42265,3578749463,3578749491,28
0,1294,42266,3578749463,3578749491,28
0,1294,42267,3578749463,3578749491,28
0,1294,42268,3578749463,3578749492,29
0,1294,42269,3578749463,3578749493,30
0,1294,42270,3578749463,3578749493,30
0,1294,42271,3578749463,3578749493,30
0,1294,42272,3578749463,3578749494,31
0,1294,42273,3578749463,3578749494,31
0,1294,42274,3578749463,3578749494,31
0,1294,42275,3578749463,3578749494,31
0,1294,42276,3578749463,3578749494,31
0,1294,42277,3578749463,3578749496,33
0,1294,42278,3578749463,3578749498,35
0,1294,42279,3578749463,3578749500,37
0,1294,42280,3578749463,3578749503,40
0,1294,42281,3578749463,3578749503,40
0,1294,42282,3578749463,3578749503,40
0,1294,42283,3578749463,3578749504,41
0,1294,42284,3578749463,3578749504,41
0,1294,42285,3578749463,3578749504,41
0,1294,42286,3578749463,3578749505,42
0,1294,42287,3578749463,3578749505,42
0,1294,42288,3578749463,3578749506,43
0,1294,42289,3578749463,3578749506,43
0,1294,42290,3578749463,3578749507,44
0,1294,42291,3578749463,3578749507,44
0,1294,42292,3578749463,3578749508,45
0,1294,42293,3578749463,3578749508,45
0,1294,42294,3578749463,3578749509,46
0,1294,42295,3578749463,3578749510,47
0,1294,42296,3578749463,3578749510,47
0,1294,42297,3578749463,3578749511,48
0,1294,42298,3578749463,3578749511,48
0,1294,42299,3578749463,3578749511,48
0,1294,42300,3578749463,3578749511,48
0,1294,42301,3578749463,3578749513,50
0,1295,42302,3578749525,3578749525,0
0,1295,42303,3578749525,3578749525,0
0,1295,42304,3578749525,3578749525,0
0,1295,42305,3578749525,3578749525,0
0,1295,42306,3578749525,3578749525,0
0,1295,42307,3578749525,3578749525,0
0,1295,42308,3578749525,3578749525,0
0,1295,42309,3578749525,3578749525,0
0,1295,42310,3578749525,3578749525,0
0,1295,42311,3578749525,3578749525,0
0,1295,42312,3578749525,3578749525,0
0,1295,42313,3578749525,3578749525,0
0,1295,42314,3578749525,3578749525,0
0,1295,42315,3578749525,3578749525,0
0,1295,42316,3578749525,3578749525,0
0,1295,42317,3578749525,3578749525,0
0,1295,42318,3578749525,3578749525,0
0,1295,42319,3578749525,3578749525,0
0,1295,42320,3578749525,3578749525,0
0,1295,42321,3578749525,3578749525,0
0,1295,42322,3578749525,3578749525,0
0,1295,42323,3578749525,3578749525,0
0,1295,42324,3578749525,3578749525,0
0,1295,42325,3578749525,3578749526,1
0,1295,42326,3578749525,3578749526,1
0,1295,42327,3578749525,3578749527,2
0,1295,42328,3578749525,3578749527,2
0,1295,42329,3578749525,3578749527,2
0,1295,42330,3578749525,3578749528,3
0,1295,42331,3578749525,3578749529,4
0,1295,42332,3578749525,3578749529,4
0,1295,42333,3578749525,3578749529,4
0,1295,42334,3578749525,3578749529,4
0,1295,42335,3578749525,3578749529,4
0,1295,42336,3578749525,3578749530,5
0,1295,42337,3578749525,3578749530,5
0,1295,42338,3578749525,3578749530,5
0,1295,42339,3578749525,3578749530,5
0,1295,42340,3578749525,3578749530,5
0,1295,42341,3578749525,3578749532,7
0,1295,42342,3578749525,3578749533,8
0,1295,42343,3578749525,3578749534,9
0,1295,42344,3578749525,3578749535,10
0,1295,42345,3578749525,3578749539,14
0,1295,42346,3578749525,3578749539,14
0,1295,42347,3578749525,3578749539,14
0,1295,42348,3578749525,3578749539,14
0,1295,42349,3578749525,3578749539,14
0,1295,42350,3578749525,3578749540,15
0,1295,42351,3578749525,3578749540,15
0,1295,42352,3578749525,3578749541,16
0,1295,42353,3578749525,3578749542,17
0,1295,42354,3578749525,3578749542,17
0,1295,42355,3578749525,3578749542,17
0,1295,42356,3578749525,3578749542,17
0,1295,42357,3578749525,3578749542,17
0,1295,42358,3578749525,3578749544,19
0,1295,42359,3578749525,3578749544,19
0,1295,42360,3578749525,3578749545,20
0,1295,42361,3578749525,3578749546,21
0,1295,42362,3578749525,3578749546,21
0,1295,42363,3578749525,3578749547,22
0,1295,42364,3578749525,3578749547,22
0,1295,42365,3578749525,3578749547,22
0,1295,42366,3578749525,3578749548,23
0,1295,42367,3578749525,3578749550,25
0,1295,42368,3578749525,3578749550,25
0,1295,42369,3578749525,3578749552,27
0,1295,42370,3578749525,3578749553,28
0,1295,42371,3578749525,3578749554,29
0,1295,42372,3578749525,3578749554,29
0,1295,42373,3578749525,3578749554,29
0,1295,42374,3578749525,3578749555,30
0,1295,42375,3578749525,3578749555,30
0,1295,42376,3578749525,3578749557,32
0,1295,42377,3578749525,3578749558,33
0,1295,42378,3578749525,3578749559,34
0,1295,42379,3578749525,3578749560,35
0,1295,42380,3578749525,3578749560,35
0,1295,42381,3578749525,3578749560,35
0,1295,42382,3578749525,3578749561,36
0,1295,42383,3578749525,3578749561,36
0,1295,42384,3578749525,3578749562,37
0,1295,42385,3578749525,3578749564,39
0,1295,42386,3578749525,3578749565,40
0,1295,42387,3578749525,3578749565,40
0,1295,42388,3578749525,3578749566,41
0,1295,42389,3578749525,3578749566,41
0,1295,42390,3578749525,3578749567,42
0,1295,42391,3578749525,3578749567,42
0,1295,42392,3578749525,3578749567,42
0,1295,42393,3578749525,3578749569,44
0,1295,42394,3578749525,3578749569,44
0,1295,42395,3578749525,3578749569,44
0,1295,42396,3578749525,3578749570,45
0,1295,42397,3578749525,3578749572,47
0,1295,42398,3578749525,3578749572,47
0,1295,42399,3578749525,3578749572,47
0,1295,42400,3578749525,3578749574,49
0,1295,42401,3578749525,3578749574,49
0,1296,42402,3578749588,3578749588,0
0,1296,42403,3578749588,3578749588,0
0,1296,42404,3578749588,3578749588,0
0,1296,42405,3578749588,3578749588,0
0,1296,42406,3578749588,3578749588,0
0,1296,42407,3578749588,3578749588,0
0,1296,42408,3578749588,3578749588,0
0,1296,42409,3578749588,3578749588,0
0,1296,42410,3578749588,3578749588,0
0,1296,42411,3578749588,3578749588,0
0,1296,42412,3578749588,3578749588,0
0,1296,42413,3578749588,3578749588,0
0,1296,42414,3578749588,3578749588,0
0,1296,42415,3578749588,3578749588,0
0,1296,42416,3578749588,3578749588,0
0,1296,42417,3578749588,3578749589,1
0,1296,42418,3578749588,3578749589,1
0,1296,42419,3578749588,3578749591,3
0,1296,42420,3578749588,3578749591,3
0,1296,42421,3578749588,3578749592,4
0,1296,42422,3578749588,3578749593,5
0,1296,42423,3578749588,3578749593,5
0,1296,42424,3578749588,3578749594,6
0,1296,42425,3578749588,3578749595,7
0,1296,42426,3578749588,3578749598,10
0,1296,42427,3578749588,3578749600,12
0,1296,42428,3578749588,3578749600,12
0,1296,42429,3578749588,3578749601,13
0,1296,42430,3578749588,3578749602,14
0,1296,42431,3578749588,3578749603,15
0,1296,42432,3578749588,3578749604,16
0,1296,42433,3578749588,3578749604,16
0,1296,42434,3578749588,3578749604,16
0,1296,42435,3578749588,3578749605,17
0,1296,42436,3578749588,3578749605,17
0,1296,42437,3578749588,3578749606,18
0,1296,42438,3578749588,3578749607,19
0,1296,42439,3578749588,3578749608,20
0,1296,42440,3578749588,3578749608,20
0,1296,42441,3578749588,3578749608,20
0,1296,42442,3578749588,3578749608,20
0,1296,42443,3578749588,3578749611,23
0,1296,42444,3578749588,3578749612,24
0,1296,42445,3578749588,3578749613,25
0,1296,42446,3578749588,3578749613,25
0,1296,42447,3578749588,3578749614,26
0,1296,42448,3578749588,3578749614,26
0,1296,42449,3578749588,3578749614,26
0,1296,42450,3578749588,3578749614,26
0,1296,42451,3578749588,3578749615,27
0,1296,42452,3578749588,3578749616,28
0,1296,42453,3578749588,3578749617,29
0,1296,42454,3578749588,3578749618,30
0,1296,42455,3578749588,3578749618,30
0,1296,42456,3578749588,3578749618,30
0,1296,42457,3578749588,3578749619,31
0,1296,42458,3578749588,3578749620,32
0,1296,42459,3578749588,3578749621,33
0,1296,42460,3578749588,3578749621,33
0,1296,42461,3578749588,3578749621,33
0,1296,42462,3578749588,3578749621,33
0,1296,42463,3578749588,3578749622,34
0,1296,42464,3578749588,3578749623,35
0,1296,42465,3578749588,3578749624,36
0,1296,42466,3578749588,3578749626,38
0,1296,42467,3578749588,3578749627,39
0,1296,42468,3578749588,3578749627,39
0,1296,42469,3578749588,3578749628,40
0,1296,42470,3578749588,3578749629,41
0,1296,42471,3578749588,3578749629,41
0,1296,42472,3578749588,3578749630,42
0,1296,42473,3578749588,3578749631,43
0,1296,42474,3578749588,3578749631,43
0,1296,42475,3578749588,3578749633,45
0,1296,42476,3578749588,3578749634,46
0,1296,42477,3578749588,3578749635,47
0,1296,42478,3578749588,3578749635,47
0,1296,42479,3578749588,3578749636,48
0,1296,42480,3578749588,3578749637,49
0,1296,42481,3578749588,3578749638,50
0,1297,42482,3578749651,3578749651,0
0,1297,42483,3578749651,3578749651,0
0,1297,42484,3578749651,3578749651,0
0,1297,42485,3578749651,3578749651,0
0,1297,42486,3578749651,3578749651,0
0,1297,42487,3578749651,3578749651,0
0,1297,42488,3578749651,3578749651,0
0,1297,42489,3578749651,3578749651,0
0,1297,42490,3578749651,3578749651,0
0,1297,42491,3578749651,3578749651,0
0,1297,42492,3578749651,3578749651,0
0,1297,42493,3578749651,3578749651,0
0,1297,42494,3578749651,3578749651,0
0,1297,42495,3578749651,3578749651,0
0,1297,42496,3578749651,3578749651,0
0,1297,42497,3578749651,3578749651,0
0,1297,42498,3578749651,3578749651,0
0,1297,42499,3578749651,3578749651,0
0,1297,42500,3578749651,3578749651,0
0,1297,42501,3578749651,3578749651,0
0,1297,42502,3578749651,3578749651,0
0,1297,42503,3578749651,3578749653,2
0,1297,42504,3578749651,3578749654,3
0,1297,42505,3578749651,3578749654,3
0,1297,42506,3578749651,3578749655,4
0,1297,42507,3578749651,3578749656,5
0,1297,42508,3578749651,3578749656,5
0,1297,42509,3578749651,3578749656,5
0,1297,42510,3578749651,3578749657,6
0,1297,42511,3578749651,3578749658,7
0,1297,42512,3578749651,3578749658,7
0,1297,42513,3578749651,3578749659,8
0,1297,42514,3578749651,3578749661,10
0,1297,42515,3578749651,3578749661,10
0,1297,42516,3578749651,3578749663,12
0,1297,42517,3578749651,3578749664,13
0,1297,42518,3578749651,3578749664,13
0,1297,42519,3578749651,3578749664,13
0,1297,42520,3578749651,3578749664,13
0,1297,42521,3578749651,3578749665,14
0,1297,42522,3578749651,3578749665,14
0,1297,42523,3578749651,3578749666,15
0,1297,42524,3578749651,3578749667,16
0,1297,42525,3578749651,3578749669,18
0,1297,42526,3578749651,3578749679,28
0,1297,42527,3578749651,3578749679,28
0,1297,42528,3578749651,3578749679,28
0,1297,42529,3578749651,3578749681,30
0,1297,42530,3578749651,3578749681,30
0,1297,42531,3578749651,3578749681,30
0,1297,42532,3578749651,3578749682,31
0,1297,42533,3578749651,3578749685,34
0,1297,42534,3578749651,3578749685,34
0,1297,42535,3578749651,3578749685,34
0,1297,42536,3578749651,3578749686,35
0,1297,42537,3578749651,3578749687,36
0,1297,42538,3578749651,3578749687,36
0,1297,42539,3578749651,3578749687,36
0,1297,42540,3578749651,3578749687,36
0,1297,42541,3578749651,3578749688,37
0,1297,42542,3578749651,3578749689,38
0,1297,42543,3578749651,3578749690,39
0,1297,42544,3578749651,3578749690,39
0,1297,42545,3578749651,3578749690,39
0,1297,42546,3578749651,3578749691,40
0,1297,42547,3578749651,3578749691,40
0,1297,42548,3578749651,3578749691,40
0,1297,42549,3578749651,3578749692,41
0,1297,42550,3578749651,3578749693,42
0,1297,42551,3578749651,3578749693,42
0,1297,42552,3578749651,3578749693,42
0,1297,42553,3578749651,3578749693,42
0,1297,42554,3578749651,3578749694,43
0,1297,42555,3578749651,3578749694,43
0,1297,42556,3578749651,3578749694,43
0,1297,42557,3578749651,3578749694,43
0,1297,42558,3578749651,3578749694,43
0,1297,42559,3578749651,3578749696,45
0,1297,42560,3578749651,3578749698,47
0,1297,42561,3578749651,3578749701,50
0,1298,42562,3578749713,3578749713,0
0,1298,42563,3578749713,3578749713,0
0,1298,42564,3578749713,3578749713,0
0,1298,42565,3578749713,3578749713,0
0,1298,42566,3578749713,3578749713,0
0,1298,42567,3578749713,3578749713,0
0,1298,42568,3578749713,3578749713,0
0,1298,42569,3578749713,3578749713,0
0,1298,42570,3578749713,3578749713,0
0,1298,42571,3578749713,3578749713,0
0,1298,42572,3578749713,3578749713,0
0,1298,42573,3578749713,3578749713,0
0,1298,42574,3578749713,3578749713,0
0,1298,42575,3578749713,3578749713,0
0,1298,42576,3578749713,3578749713,0
0,1298,42577,3578749713,3578749713,0
0,1298,42578,3578749713,3578749713,0
0,1298,42579,3578749713,3578749713,0
0,1298,42580,3578749713,3578749713,0
0,1298,42581,3578749713,3578749713,0
0,1298,42582,3578749713,3578749713,0
0,1298,42583,3578749713,3578749713,0
0,1298,42584,3578749713,3578749713,0
0,1298,42585,3578749713,3578749713,0
0,1298,42586,3578749713,3578749713,0
0,1298,42587,3578749713,3578749713,0
0,1298,42588,3578749713,3578749714,1
0,1298,42589,3578749713,3578749715,2
0,1298,42590,3578749713,3578749715,2
0,1298,42591,3578749713,3578749716,3
0,1298,42592,3578749713,3578749716,3
0,1298,42593,3578749713,3578749716,3
0,1298,42594,3578749713,3578749717,4
0,1298,42595,3578749713,3578749717,4
0,1298,42596,3578749713,3578749718,5
0,1298,42597,3578749713,3578749719,6
0,1298,42598,3578749713,3578749719,6
0,1298,42599,3578749713,3578749720,7
0,1298,42600,3578749713,3578749721,8
0,1298,42601,3578749713,3578749722,9
0,1298,42602,3578749713,3578749722,9
0,1298,42603,3578749713,3578749722,9
0,1298,42604,3578749713,3578749723,10
0,1298,42605,3578749713,3578749724,11
0,1298,42606,3578749713,3578749725,12
0,1298,42607,3578749713,3578749726,13
0,1298,42608,3578749713,3578749727,14
0,1298,42609,3578749713,3578749727,14
0,1298,42610,3578749713,3578749727,14
0,1298,42611,3578749713,3578749727,14
0,1298,42612,3578749713,3578749728,15
0,1298,42613,3578749713,3578749728,15
0,1298,42614,3578749713,3578749729,16
0,1298,42615,3578749713,3578749729,16
0,1298,42616,3578749713,3578749729,16
0,1298,42617,3578749713,3578749730,17
0,1298,42618,3578749713,3578749730,17
0,1298,42619,3578749713,3578749730,17
0,1298,42620,3578749713,3578749731,18
0,1298,42621,3578749713,3578749731,18
0,1298,42622,3578749713,3578749731,18
0,1298,42623,3578749713,3578749732,19
0,1298,42624,3578749713,3578749732,19
0,1298,42625,3578749713,3578749734,21
0,1298,42626,3578749713,3578749735,22
0,1298,42627,3578749713,3578749738,25
0,1298,42628,3578749713,3578749739,26
0,1298,42629,3578749713,3578749739,26
0,1298,42630,3578749713,3578749739,26
0,1298,42631,3578749713,3578749740,27
0,1298,42632,3578749713,3578749740,27
0,1298,42633,3578749713,3578749741,28
0,1298,42634,3578749713,3578749742,29
0,1298,42635,3578749713,3578749742,29
0,1298,42636,3578749713,3578749742,29
0,1298,42637,3578749713,3578749742,29
0,1298,42638,3578749713,3578749743,30
0,1298,42639,3578749713,3578749743,30
0,1298,42640,3578749713,3578749743,30
0,1298,42641,3578749713,3578749744,31
0,1298,42642,3578749713,3578749745,32
0,1298,42643,3578749713,3578749746,33
0,1298,42644,3578749713,3578749746,33
0,1298,42645,3578749713,3578749746,33
0,1298,42646,3578749713,3578749747,34
0,1298,42647,3578749713,3578749747,34
0,1298,42648,3578749713,3578749747,34
0,1298,42649,3578749713,3578749748,35
0,1298,42650,3578749713,3578749750,37
0,1298,42651,3578749713,3578749751,38
0,1298,42652,3578749713,3578749751,38
0,1298,42653,3578749713,3578749753,40
0,1298,42654,3578749713,3578749753,40
0,1298,42655,3578749713,3578749754,41
0,1298,42656,3578749713,3578749754,41
0,1298,42657,3578749713,3578749755,42
0,1298,42658,3578749713,3578749755,42
0,1298,42659,3578749713,3578749756,43
0,1298,42660,3578749713,3578749757,44
0,1298,42661,3578749713,3578749758,45
0,1298,42662,3578749713,3578749759,46
0,1298,42663,3578749713,3578749760,47
0,1298,42664,3578749713,3578749760,47
0,1298,42665,3578749713,3578749761,48
0,1298,42666,3578749713,3578749761,48
0,1299,42667,3578749776,3578749776,0
0,1299,42668,3578749776,3578749776,0
0,1299,42669,3578749776,3578749776,0
0,1299,42670,3578749776,3578749776,0
0,1299,42671,3578749776,3578749776,0
0,1299,42672,3578749776,3578749776,0
0,1299,42673,3578749776,3578749776,0
0,1299,42674,3578749776,3578749776,0
0,1299,42675,3578749776,3578749776,0
0,1299,42676,3578749776,3578749776,0
0,1299,42677,3578749776,3578749776,0
0,1299,42678,3578749776,3578749776,0
0,1299,42679,3578749776,3578749776,0
0,1299,42680,3578749776,3578749776,0
0,1299,42681,3578749776,3578749776,0
0,1299,42682,3578749776,3578749776,0
0,1299,42683,3578749776,3578749776,0
0,1299,42684,3578749776,3578749776,0
0,1299,42685,3578749776,3578749776,0
0,1299,42686,3578749776,3578749778,2
0,1299,42687,3578749776,3578749778,2
0,1299,42688,3578749776,3578749779,3
0,1299,42689,3578749776,3578749779,3
0,1299,42690,3578749776,3578749780,4
0,1299,42691,3578749776,3578749781,5
0,1299,42692,3578749776,3578749782,6
0,1299,42693,3578749776,3578749783,7
0,1299,42694,3578749776,3578749785,9
0,1299,42695,3578749776,3578749785,9
0,1299,42696,3578749776,3578749786,10
0,1299,42697,3578749776,3578749786,10
0,1299,42698,3578749776,3578749787,11
0,1299,42699,3578749776,3578749787,11
0,1299,42700,3578749776,3578749788,12
0,1299,42701,3578749776,3578749788,12
0,1299,42702,3578749776,3578749790,14
0,1299,42703,3578749776,3578749791,15
0,1299,42704,3578749776,3578749792,16
0,1299,42705,3578749776,3578749792,16
0,1299,42706,3578749776,3578749792,16
0,1299,42707,3578749776,3578749793,17
0,1299,42708,3578749776,3578749793,17
0,1299,42709,3578749776,3578749799,23
0,1299,42710,3578749776,3578749800,24
0,1299,42711,3578749776,3578749800,24
0,1299,42712,3578749776,3578749801,25
0,1299,42713,3578749776,3578749803,27
0,1299,42714,3578749776,3578749803,27
0,1299,42715,3578749776,3578749804,28
0,1299,42716,3578749776,3578749804,28
0,1299,42717,3578749776,3578749805,29
0,1299,42718,3578749776,3578749805,29
0,1299,42719,3578749776,3578749805,29
0,1299,42720,3578749776,3578749806,30
0,1299,42721,3578749776,3578749807,31
0,1299,42722,3578749776,3578749807,31
0,1299,42723,3578749776,3578749807,31
0,1299,42724,3578749776,3578749807,31
0,1299,42725,3578749776,3578749808,32
0,1299,42726,3578749776,3578749811,35
0,1299,42727,3578749776,3578749812,36
0,1299,42728,3578749776,3578749812,36
0,1299,42729,3578749776,3578749813,37
0,1299,42730,3578749776,3578749814,38
0,1299,42731,3578749776,3578749814,38
0,1299,42732,3578749776,3578749815,39
0,1299,42733,3578749776,3578749815,39
0,1299,42734,3578749776,3578749815,39
0,1299,42735,3578749776,3578749816,40
0,1299,42736,3578749776,3578749817,41
0,1299,42737,3578749776,3578749818,42
0,1299,42738,3578749776,3578749818,42
0,1299,42739,3578749776,3578749818,42
0,1299,42740,3578749776,3578749818,42
0,1299,42741,3578749776,3578749819,43
0,1299,42742,3578749776,3578749819,43
0,1299,42743,3578749776,3578749821,45
0,1299,42744,3578749776,3578749821,45
0,1299,42745,3578749776,3578749821,45
0,1299,42746,3578749776,3578749821,45
0,1299,42747,3578749776,3578749821,45
0,1299,42748,3578749776,3578749822,46
0,1299,42749,3578749776,3578749823,47
0,1299,42750,3578749776,3578749824,48
0,1299,42751,3578749776,3578749826,50
0,1300,42752,3578749837,3578749838,1
0,1300,42753,3578749837,3578749838,1
0,1300,42754,3578749837,3578749838,1
0,1300,42755,3578749837,3578749838,1
0,1300,42756,3578749837,3578749838,1
0,1300,42757,3578749837,3578749838,1
0,1300,42758,3578749837,3578749838,1
0,1300,42759,3578749837,3578749838,1
0,1300,42760,3578749837,3578749838,1
0,1300,42761,3578749837,3578749838,1
0,1300,42762,3578749837,3578749838,1
0,1300,42763,3578749837,3578749838,1
0,1300,42764,3578749837,3578749838,1
0,1300,42765,3578749837,3578749838,1
0,1300,42766,3578749837,3578749838,1
0,1300,42767,3578749837,3578749838,1
0,1300,42768,3578749837,3578749839,2
0,1300,42769,3578749837,3578749839,2
0,1300,42770,3578749837,3578749840,3
0,1300,42771,3578749837,3578749840,3
0,1300,42772,3578749837,3578749841,4
0,1300,42773,3578749837,3578749841,4
0,1300,42774,3578749837,3578749842,5
0,1300,42775,3578749837,3578749843,6
0,1300,42776,3578749837,3578749844,7
0,1300,42777,3578749837,3578749845,8
0,1300,42778,3578749837,3578749846,9
0,1300,42779,3578749837,3578749847,10
0,1300,42780,3578749837,3578749848,11
0,1300,42781,3578749837,3578749848,11
0,1300,42782,3578749837,3578749849,12
0,1300,42783,3578749837,3578749850,13
0,1300,42784,3578749837,3578749851,14
0,1300,42785,3578749837,3578749851,14
0,1300,42786,3578749837,3578749853,16
0,1300,42787,3578749837,3578749854,17
0,1300,42788,3578749837,3578749854,17
0,1300,42789,3578749837,3578749855,18
0,1300,42790,3578749837,3578749856,19
0,1300,42791,3578749837,3578749856,19
0,1300,42792,3578749837,3578749856,19
0,1300,42793,3578749837,3578749857,20
0,1300,42794,3578749837,3578749858,21
0,1300,42795,3578749837,3578749859,22
0,1300,42796,3578749837,3578749861,24
0,1300,42797,3578749837,3578749862,25
0,1300,42798,3578749837,3578749862,25
0,1300,42799,3578749837,3578749863,26
0,1300,42800,3578749837,3578749863,26
0,1300,42801,3578749837,3578749864,27
0,1300,42802,3578749837,3578749864,27
0,1300,42803,3578749837,3578749864,27
0,1300,42804,3578749837,3578749865,28
0,1300,42805,3578749837,3578749866,29
0,1300,42806,3578749837,3578749866,29
0,1300,42807,3578749837,3578749867,30
0,1300,42808,3578749837,3578749869,32
0,1300,42809,3578749837,3578749879,42
0,1300,42810,3578749837,3578749879,42
0,1300,42811,3578749837,3578749879,42
0,1300,42812,3578749837,3578749880,43
0,1300,42813,3578749837,3578749881,44
0,1300,42814,3578749837,3578749882,45
0,1300,42815,3578749837,3578749884,47
0,1300,42816,3578749837,3578749884,47
0,1300,42817,3578749837,3578749885,48
0,1300,42818,3578749837,3578749886,49
0,1300,42819,3578749837,3578749886,49
0,1300,42820,3578749837,3578749886,49
0,1300,42821,3578749837,3578749887,50
0,1301,42822,3578749898,3578749898,0
0,1301,42823,3578749898,3578749898,0
0,1301,42824,3578749898,3578749898,0
0,1301,42825,3578749898,3578749898,0
0,1301,42826,3578749898,3578749898,0
0,1301,42827,3578749898,3578749898,0
0,1301,42828,3578749898,3578749898,0
0,1301,42829,3578749898,3578749898,0
0,1301,42830,3578749898,3578749898,0
0,1301,42831,3578749898,3578749898,0
0,1301,42832,3578749898,3578749898,0
0,1301,42833,3578749898,3578749898,0
0,1301,42834,3578749898,3578749898,0
0,1301,42835,3578749898,3578749898,0
0,1301,42836,3578749898,3578749898,0
0,1301,42837,3578749898,3578749898,0
0,1301,42838,3578749898,3578749898,0
0,1301,42839,3578749898,3578749898,0
0,1301,42840,3578749898,3578749898,0
0,1301,42841,3578749898,3578749898,0
0,1301,42842,3578749898,3578749898,0
0,1301,42843,3578749898,3578749901,3
0,1301,42844,3578749898,3578749903,5
0,1301,42845,3578749898,3578749903,5
0,1301,42846,3578749898,3578749903,5
0,1301,42847,3578749898,3578749904,6
0,1301,42848,3578749898,3578749904,6
0,1301,42849,3578749898,3578749904,6
0,1301,42850,3578749898,3578749904,6
0,1301,42851,3578749898,3578749905,7
0,1301,42852,3578749898,3578749906,8
0,1301,42853,3578749898,3578749906,8
0,1301,42854,3578749898,3578749907,9
0,1301,42855,3578749898,3578749907,9
0,1301,42856,3578749898,3578749907,9
0,1301,42857,3578749898,3578749908,10
0,1301,42858,3578749898,3578749909,11
0,1301,42859,3578749898,3578749909,11
0,1301,42860,3578749898,3578749909,11
0,1301,42861,3578749898,3578749910,12
0,1301,42862,3578749898,3578749910,12
0,1301,42863,3578749898,3578749911,13
0,1301,42864,3578749898,3578749911,13
0,1301,42865,3578749898,3578749912,14
0,1301,42866,3578749898,3578749913,15
0,1301,42867,3578749898,3578749913,15
0,1301,42868,3578749898,3578749913,15
0,1301,42869,3578749898,3578749914,16
0,1301,42870,3578749898,3578749914,16
0,1301,42871,3578749898,3578749915,17
0,1301,42872,3578749898,3578749916,18
0,1301,42873,3578749898,3578749916,18
0,1301,42874,3578749898,3578749916,18
0,1301,42875,3578749898,3578749916,18
0,1301,42876,3578749898,3578749917,19
0,1301,42877,3578749898,3578749917,19
0,1301,42878,3578749898,3578749917,19
0,1301,42879,3578749898,3578749917,19
0,1301,42880,3578749898,3578749918,20
0,1301,42881,3578749898,3578749918,20
0,1301,42882,3578749898,3578749919,21
0,1301,42883,3578749898,3578749919,21
0,1301,42884,3578749898,3578749921,23
0,1301,42885,3578749898,3578749921,23
0,1301,42886,3578749898,3578749921,23
0,1301,42887,3578749898,3578749922,24
0,1301,42888,3578749898,3578749923,25
0,1301,42889,3578749898,3578749923,25
0,1301,42890,3578749898,3578749924,26
0,1301,42891,3578749898,3578749924,26
0,1301,42892,3578749898,3578749925,27
0,1301,42893,3578749898,3578749927,29
0,1301,42894,3578749898,3578749927,29
0,1301,42895,3578749898,3578749927,29
0,1301,42896,3578749898,3578749928,30
0,1301,42897,3578749898,3578749929,31
0,1301,42898,3578749898,3578749929,31
0,1301,42899,3578749898,3578749929,31
0,1301,42900,3578749898,3578749930,32
0,1301,42901,3578749898,3578749930,32
0,1301,42902,3578749898,3578749930,32
0,1301,42903,3578749898,3578749930,32
0,1301,42904,3578749898,3578749930,32
0,1301,42905,3578749898,3578749930,32
0,1301,42906,3578749898,3578749931,33
0,1301,42907,3578749898,3578749931,33
0,1301,42908,3578749898,3578749932,34
0,1301,42909,3578749898,3578749932,34
0,1301,42910,3578749898,3578749933,35
0,1301,42911,3578749898,3578749935,37
0,1301,42912,3578749898,3578749939,41
0,1301,42913,3578749898,3578749939,41
0,1301,42914,3578749898,3578749940,42
0,1301,42915,3578749898,3578749940,42
0,1301,42916,3578749898,3578749940,42
0,1301,42917,3578749898,3578749940,42
0,1301,42918,3578749898,3578749942,44
0,1301,42919,3578749898,3578749942,44
0,1301,42920,3578749898,3578749943,45
0,1301,42921,3578749898,3578749943,45
0,1301,42922,3578749898,3578749943,45
0,1301,42923,3578749898,3578749943,45
0,1301,42924,3578749898,3578749944,46
0,1301,42925,3578749898,3578749944,46
0,1301,42926,3578749898,3578749944,46
0,1301,42927,3578749898,3578749945,47
0,1301,42928,3578749898,3578749945,47
0,1301,42929,3578749898,3578749946,48
0,1301,42930,3578749898,3578749947,49
0,1301,42931,3578749898,3578749948,50
0,1302,42932,3578749961,3578749961,0
0,1302,42933,3578749961,3578749961,0
0,1302,42934,3578749961,3578749961,0
0,1302,42935,3578749961,3578749961,0
0,1302,42936,3578749961,3578749961,0
0,1302,42937,3578749961,3578749961,0
0,1302,42938,3578749961,3578749961,0
0,1302,42939,3578749961,3578749961,0
0,1302,42940,3578749961,3578749961,0
0,1302,42941,3578749961,3578749961,0
0,1302,42942,3578749961,3578749961,0
0,1302,42943,3578749961,3578749961,0
0,1302,42944,3578749961,3578749961,0
0,1302,42945,3578749961,3578749961,0
0,1302,42946,3578749961,3578749961,0
0,1302,42947,3578749961,3578749961,0
0,1302,42948,3578749961,3578749961,0
0,1302,42949,3578749961,3578749961,0
0,1302,42950,3578749961,3578749961,0
0,1302,42951,3578749961,3578749962,1
0,1302,42952,3578749961,3578749963,2
0,1302,42953,3578749961,3578749963,2
0,1302,42954,3578749961,3578749964,3
0,1302,42955,3578749961,3578749964,3
0,1302,42956,3578749961,3578749964,3
0,1302,42957,3578749961,3578749965,4
0,1302,42958,3578749961,3578749965,4
0,1302,42959,3578749961,3578749966,5
0,1302,42960,3578749961,3578749966,5
0,1302,42961,3578749961,3578749968,7
0,1302,42962,3578749961,3578749968,7
0,1302,42963,3578749961,3578749969,8
0,1302,42964,3578749961,3578749970,9
0,1302,42965,3578749961,3578749971,10
0,1302,42966,3578749961,3578749972,11
0,1302,42967,3578749961,3578749973,12
0,1302,42968,3578749961,3578749974,13
0,1302,42969,3578749961,3578749975,14
0,1302,42970,3578749961,3578749975,14
0,1302,42971,3578749961,3578749976,15
0,1302,42972,3578749961,3578749978,17
0,1302,42973,3578749961,3578749978,17
0,1302,42974,3578749961,3578749979,18
0,1302,42975,3578749961,3578749980,19
0,1302,42976,3578749961,3578749980,19
0,1302,42977,3578749961,3578749981,20
0,1302,42978,3578749961,3578749981,20
0,1302,42979,3578749961,3578749984,23
0,1302,42980,3578749961,3578749985,24
0,1302,42981,3578749961,3578749986,25
0,1302,42982,3578749961,3578749986,25
0,1302,42983,3578749961,3578749987,26
0,1302,42984,3578749961,3578749987,26
0,1302,42985,3578749961,3578749987,26
0,1302,42986,3578749961,3578749988,27
0,1302,42987,3578749961,3578749988,27
0,1302,42988,3578749961,3578749990,29
0,1302,42989,3578749961,3578749991,30
0,1302,42990,3578749961,3578749991,30
0,1302,42991,3578749961,3578749993,32
0,1302,42992,3578749961,3578749993,32
0,1302,42993,3578749961,3578749994,33
0,1302,42994,3578749961,3578749995,34
0,1302,42995,3578749961,3578749999,38
0,1302,42996,3578749961,3578750001,40
0,1302,42997,3578749961,3578750001,40
0,1302,42998,3578749961,3578750003,42
0,1302,42999,3578749961,3578750003,42
0,1302,43000,3578749961,3578750004,43
0,1302,43001,3578749961,3578750005,44
0,1302,43002,3578749961,3578750005,44
0,1302,43003,3578749961,3578750006,45
0,1302,43004,3578749961,3578750007,46
0,1302,43005,3578749961,3578750007,46
0,1302,43006,3578749961,3578750008,47
0,1302,43007,3578749961,3578750008,47
0,1302,43008,3578749961,3578750009,48
0,1302,43009,3578749961,3578750010,49
0,1303,43010,3578750024,3578750024,0
0,1303,43011,3578750024,3578750024,0
0,1303,43012,3578750024,3578750024,0
0,1303,43013,3578750024,3578750024,0
0,1303,43014,3578750024,3578750024,0
0,1303,43015,3578750024,3578750024,0
0,1303,43016,3578750024,3578750024,0
0,1303,43017,3578750024,3578750024,0
0,1303,43018,3578750024,3578750024,0
0,1303,43019,3578750024,3578750024,0
0,1303,43020,3578750024,3578750024,0
0,1303,43021,3578750024,3578750024,0
0,1303,43022,3578750024,3578750024,0
0,1303,43023,3578750024,3578750024,0
0,1303,43024,3578750024,3578750024,0
0,1303,43025,3578750024,3578750024,0
0,1303,43026,3578750024,3578750024,0
0,1303,43027,3578750024,3578750024,0
0,1303,43028,3578750024,3578750024,0
0,1303,43029,3578750024,3578750024,0
0,1303,43030,3578750024,3578750024,0
0,1303,43031,3578750024,3578750024,0
0,1303,43032,3578750024,3578750024,0
0,1303,43033,3578750024,3578750024,0
0,1303,43034,3578750024,3578750026,2
0,1303,43035,3578750024,3578750027,3
0,1303,43036,3578750024,3578750028,4
0,1303,43037,3578750024,3578750029,5
0,1303,43038,3578750024,3578750030,6
0,1303,43039,3578750024,3578750030,6
0,1303,43040,3578750024,3578750031,7
0,1303,43041,3578750024,3578750031,7
0,1303,43042,3578750024,3578750034,10
0,1303,43043,3578750024,3578750034,10
0,1303,43044,3578750024,3578750035,11
0,1303,43045,3578750024,3578750035,11
0,1303,43046,3578750024,3578750036,12
0,1303,43047,3578750024,3578750036,12
0,1303,43048,3578750024,3578750037,13
0,1303,43049,3578750024,3578750038,14
0,1303,43050,3578750024,3578750038,14
0,1303,43051,3578750024,3578750038,14
0,1303,43052,3578750024,3578750038,14
0,1303,43053,3578750024,3578750040,16
0,1303,43054,3578750024,3578750040,16
0,1303,43055,3578750024,3578750040,16
0,1303,43056,3578750024,3578750041,17
0,1303,43057,3578750024,3578750041,17
0,1303,43058,3578750024,3578750042,18
0,1303,43059,3578750024,3578750043,19
0,1303,43060,3578750024,3578750044,20
0,1303,43061,3578750024,3578750045,21
0,1303,43062,3578750024,3578750046,22
0,1303,43063,3578750024,3578750046,22
0,1303,43064,3578750024,3578750047,23
0,1303,43065,3578750024,3578750047,23
0,1303,43066,3578750024,3578750048,24
0,1303,43067,3578750024,3578750048,24
0,1303,43068,3578750024,3578750049,25
0,1303,43069,3578750024,3578750050,26
0,1303,43070,3578750024,3578750050,26
0,1303,43071,3578750024,3578750051,27
0,1303,43072,3578750024,3578750053,29
0,1303,43073,3578750024,3578750054,30
0,1303,43074,3578750024,3578750056,32
0,1303,43075,3578750024,3578750056,32
0,1303,43076,3578750024,3578750057,33
0,1303,43077,3578750024,3578750057,33
0,1303,43078,3578750024,3578750057,33
0,1303,43079,3578750024,3578750058,34
0,1303,43080,3578750024,3578750059,35
0,1303,43081,3578750024,3578750061,37
0,1303,43082,3578750024,3578750061,37
0,1303,43083,3578750024,3578750062,38
0,1303,43084,3578750024,3578750063,39
0,1303,43085,3578750024,3578750064,40
0,1303,43086,3578750024,3578750064,40
0,1303,43087,3578750024,3578750064,40
0,1303,43088,3578750024,3578750064,40
0,1303,43089,3578750024,3578750067,43
0,1303,43090,3578750024,3578750067,43
0,1303,43091,3578750024,3578750067,43
0,1304,43092,3578750087,3578750087,0
0,1304,43093,3578750087,3578750087,0
0,1304,43094,3578750087,3578750087,0
0,1304,43095,3578750087,3578750087,0
0,1304,43096,3578750087,3578750087,0
0,1304,43097,3578750087,3578750087,0
0,1304,43098,3578750087,3578750087,0
0,1304,43099,3578750087,3578750087,0
0,1304,43100,3578750087,3578750087,0
0,1304,43101,3578750087,3578750087,0
0,1304,43102,3578750087,3578750087,0
0,1304,43103,3578750087,3578750087,0
0,1304,43104,3578750087,3578750087,0
0,1304,43105,3578750087,3578750087,0
0,1304,43106,3578750087,3578750089,2
0,1304,43107,3578750087,3578750089,2
0,1304,43108,3578750087,3578750089,2
0,1304,43109,3578750087,3578750090,3
0,1304,43110,3578750087,3578750090,3
0,1304,43111,3578750087,3578750090,3
0,1304,43112,3578750087,3578750091,4
0,1304,43113,3578750087,3578750091,4
0,1304,43114,3578750087,3578750092,5
0,1304,43115,3578750087,3578750093,6
0,1304,43116,3578750087,3578750093,6
0,1304,43117,3578750087,3578750093,6
0,1304,43118,3578750087,3578750093,6
0,1304,43119,3578750087,3578750094,7
0,1304,43120,3578750087,3578750094,7
0,1304,43121,3578750087,3578750094,7
0,1304,43122,3578750087,3578750095,8
0,1304,43123,3578750087,3578750095,8
0,1304,43124,3578750087,3578750099,12
0,1304,43125,3578750087,3578750101,14
0,1304,43126,3578750087,3578750103,16
0,1304,43127,3578750087,3578750103,16
0,1304,43128,3578750087,3578750103,16
0,1304,43129,3578750087,3578750104,17
0,1304,43130,3578750087,3578750104,17
0,1304,43131,3578750087,3578750104,17
0,1304,43132,3578750087,3578750105,18
0,1304,43133,3578750087,3578750106,19
0,1304,43134,3578750087,3578750106,19
0,1304,43135,3578750087,3578750107,20
0,1304,43136,3578750087,3578750107,20
0,1304,43137,3578750087,3578750107,20
0,1304,43138,3578750087,3578750108,21
0,1304,43139,3578750087,3578750109,22
0,1304,43140,3578750087,3578750110,23
0,1304,43141,3578750087,3578750110,23
0,1304,43142,3578750087,3578750111,24
0,1304,43143,3578750087,3578750111,24
0,1304,43144,3578750087,3578750111,24
0,1304,43145,3578750087,3578750112,25
0,1304,43146,3578750087,3578750112,25
0,1304,43147,3578750087,3578750113,26
0,1304,43148,3578750087,3578750114,27
0,1304,43149,3578750087,3578750114,27
0,1304,43150,3578750087,3578750114,27
0,1304,43151,3578750087,3578750114,27
0,1304,43152,3578750087,3578750115,28
0,1304,43153,3578750087,3578750115,28
0,1304,43154,3578750087,3578750115,28
0,1304,43155,3578750087,3578750116,29
0,1304,43156,3578750087,3578750116,29
0,1304,43157,3578750087,3578750116,29
0,1304,43158,3578750087,3578750117,30
0,1304,43159,3578750087,3578750117,30
0,1304,43160,3578750087,3578750117,30
0,1304,43161,3578750087,3578750117,30
0,1304,43162,3578750087,3578750118,31
0,1304,43163,3578750087,3578750118,31
0,1304,43164,3578750087,3578750119,32
0,1304,43165,3578750087,3578750119,32
0,1304,43166,3578750087,3578750121,34
0,1304,43167,3578750087,3578750121,34
0,1304,43168,3578750087,3578750122,35
0,1304,43169,3578750087,3578750122,35
0,1304,43170,3578750087,3578750123,36
0,1304,43171,3578750087,3578750124,37
0,1304,43172,3578750087,3578750124,37
0,1304,43173,3578750087,3578750125,38
0,1304,43174,3578750087,3578750126,39
0,1304,43175,3578750087,3578750127,40
0,1304,43176,3578750087,3578750127,40
0,1304,43177,3578750087,3578750127,40
0,1304,43178,3578750087,3578750128,41
0,1304,43179,3578750087,3578750129,42
0,1304,43180,3578750087,3578750129,42
0,1304,43181,3578750087,3578750129,42
0,1304,43182,3578750087,3578750130,43
0,1304,43183,3578750087,3578750130,43
0,1304,43184,3578750087,3578750130,43
0,1304,43185,3578750087,3578750131,44
0,1304,43186,3578750087,3578750131,44
0,1304,43187,3578750087,3578750131,44
0,1304,43188,3578750087,3578750131,44
0,1304,43189,3578750087,3578750132,45
0,1304,43190,3578750087,3578750132,45
0,1304,43191,3578750087,3578750132,45
0,1304,43192,3578750087,3578750134,47
0,1304,43193,3578750087,3578750135,48
0,1305,43194,3578750150,3578750150,0
0,1305,43195,3578750150,3578750150,0
0,1305,43196,3578750150,3578750150,0
0,1305,43197,3578750150,3578750150,0
0,1305,43198,3578750150,3578750150,0
0,1305,43199,3578750150,3578750150,0
0,1305,43200,3578750150,3578750150,0
0,1305,43201,3578750150,3578750150,0
0,1305,43202,3578750150,3578750150,0
0,1305,43203,3578750150,3578750150,0
0,1305,43204,3578750150,3578750150,0
0,1305,43205,3578750150,3578750150,0
0,1305,43206,3578750150,3578750150,0
0,1305,43207,3578750150,3578750150,0
0,1305,43208,3578750150,3578750150,0
0,1305,43209,3578750150,3578750150,0
0,1305,43210,3578750150,3578750150,0
0,1305,43211,3578750150,3578750150,0
0,1305,43212,3578750150,3578750150,0
0,1305,43213,3578750150,3578750150,0
0,1305,43214,3578750150,3578750151,1
0,1305,43215,3578750150,3578750152,2
0,1305,43216,3578750150,3578750152,2
0,1305,43217,3578750150,3578750153,3
0,1305,43218,3578750150,3578750154,4
0,1305,43219,3578750150,3578750154,4
0,1305,43220,3578750150,3578750155,5
0,1305,43221,3578750150,3578750156,6
0,1305,43222,3578750150,3578750156,6
0,1305,43223,3578750150,3578750156,6
0,1305,43224,3578750150,3578750158,8
0,1305,43225,3578750150,3578750159,9
0,1305,43226,3578750150,3578750159,9
0,1305,43227,3578750150,3578750161,11
0,1305,43228,3578750150,3578750161,11
0,1305,43229,3578750150,3578750161,11
0,1305,43230,3578750150,3578750162,12
0,1305,43231,3578750150,3578750162,12
0,1305,43232,3578750150,3578750162,12
0,1305,43233,3578750150,3578750163,13
0,1305,43234,3578750150,3578750163,13
0,1305,43235,3578750150,3578750163,13
0,1305,43236,3578750150,3578750164,14
0,1305,43237,3578750150,3578750165,15
0,1305,43238,3578750150,3578750166,16
0,1305,43239,3578750150,3578750166,16
0,1305,43240,3578750150,3578750166,16
0,1305,43241,3578750150,3578750167,17
0,1305,43242,3578750150,3578750167,17
0,1305,43243,3578750150,3578750168,18
0,1305,43244,3578750150,3578750169,19
0,1305,43245,3578750150,3578750170,20
0,1305,43246,3578750150,3578750170,20
0,1305,43247,3578750150,3578750172,22
0,1305,43248,3578750150,3578750172,22
0,1305,43249,3578750150,3578750175,25
0,1305,43250,3578750150,3578750175,25
0,1305,43251,3578750150,3578750175,25
0,1305,43252,3578750150,3578750177,27
0,1305,43253,3578750150,3578750177,27
0,1305,43254,3578750150,3578750178,28
0,1305,43255,3578750150,3578750179,29
0,1305,43256,3578750150,3578750179,29
0,1305,43257,3578750150,3578750179,29
0,1305,43258,3578750150,3578750180,30
0,1305,43259,3578750150,3578750181,31
0,1305,43260,3578750150,3578750182,32
0,1305,43261,3578750150,3578750183,33
0,1305,43262,3578750150,3578750184,34
0,1305,43263,3578750150,3578750186,36
0,1305,43264,3578750150,3578750186,36
0,1305,43265,3578750150,3578750186,36
0,1305,43266,3578750150,3578750187,37
0,1305,43267,3578750150,3578750187,37
0,1305,43268,3578750150,3578750188,38
0,1305,43269,3578750150,3578750189,39
0,1305,43270,3578750150,3578750191,41
0,1305,43271,3578750150,3578750191,41
0,1305,43272,3578750150,3578750193,43
0,1305,43273,3578750150,3578750193,43
0,1305,43274,3578750150,3578750194,44
0,1305,43275,3578750150,3578750196,46
0,1305,43276,3578750150,3578750199,49
0,1306,43277,3578750212,3578750212,0
0,1306,43278,3578750212,3578750212,0
0,1306,43279,3578750212,3578750212,0
0,1306,43280,3578750212,3578750213,1
0,1306,43281,3578750212,3578750213,1
0,1306,43282,3578750212,3578750213,1
0,1306,43283,3578750212,3578750213,1
0,1306,43284,3578750212,3578750213,1
0,1306,43285,3578750212,3578750213,1
0,1306,43286,3578750212,3578750213,1
0,1306,43287,3578750212,3578750213,1
0,1306,43288,3578750212,3578750213,1
0,1306,43289,3578750212,3578750213,1
0,1306,43290,3578750212,3578750213,1
0,1306,43291,3578750212,3578750213,1
0,1306,43292,3578750212,3578750213,1
0,1306,43293,3578750212,3578750213,1
0,1306,43294,3578750212,3578750213,1
0,1306,43295,3578750212,3578750213,1
0,1306,43296,3578750212,3578750213,1
0,1306,43297,3578750212,3578750215,3
0,1306,43298,3578750212,3578750215,3
0,1306,43299,3578750212,3578750215,3
0,1306,43300,3578750212,3578750215,3
0,1306,43301,3578750212,3578750215,3
0,1306,43302,3578750212,3578750215,3
0,1306,43303,3578750212,3578750217,5
0,1306,43304,3578750212,3578750217,5
0,1306,43305,3578750212,3578750218,6
0,1306,43306,3578750212,3578750219,7
0,1306,43307,3578750212,3578750219,7
0,1306,43308,3578750212,3578750219,7
0,1306,43309,3578750212,3578750220,8
0,1306,43310,3578750212,3578750220,8
0,1306,43311,3578750212,3578750221,9
0,1306,43312,3578750212,3578750221,9
0,1306,43313,3578750212,3578750221,9
0,1306,43314,3578750212,3578750222,10
0,1306,43315,3578750212,3578750222,10
0,1306,43316,3578750212,3578750222,10
0,1306,43317,3578750212,3578750223,11
0,1306,43318,3578750212,3578750224,12
0,1306,43319,3578750212,3578750225,13
0,1306,43320,3578750212,3578750227,15
0,1306,43321,3578750212,3578750228,16
0,1306,43322,3578750212,3578750229,17
0,1306,43323,3578750212,3578750230,18
0,1306,43324,3578750212,3578750230,18
0,1306,43325,3578750212,3578750231,19
0,1306,43326,3578750212,3578750233,21
0,1306,43327,3578750212,3578750234,22
0,1306,43328,3578750212,3578750235,23
0,1306,43329,3578750212,3578750235,23
0,1306,43330,3578750212,3578750236,24
0,1306,43331,3578750212,3578750236,24
0,1306,43332,3578750212,3578750237,25
0,1306,43333,3578750212,3578750237,25
0,1306,43334,3578750212,3578750238,26
0,1306,43335,3578750212,3578750238,26
0,1306,43336,3578750212,3578750239,27
0,1306,43337,3578750212,3578750240,28
0,1306,43338,3578750212,3578750240,28
0,1306,43339,3578750212,3578750240,28
0,1306,43340,3578750212,3578750241,29
0,1306,43341,3578750212,3578750241,29
0,1306,43342,3578750212,3578750241,29
0,1306,43343,3578750212,3578750242,30
0,1306,43344,3578750212,3578750244,32
0,1306,43345,3578750212,3578750244,32
0,1306,43346,3578750212,3578750245,33
0,1306,43347,3578750212,3578750246,34
0,1306,43348,3578750212,3578750247,35
0,1306,43349,3578750212,3578750247,35
0,1306,43350,3578750212,3578750247,35
0,1306,43351,3578750212,3578750248,36
0,1306,43352,3578750212,3578750249,37
0,1306,43353,3578750212,3578750250,38
0,1306,43354,3578750212,3578750250,38
0,1306,43355,3578750212,3578750250,38
0,1306,43356,3578750212,3578750251,39
0,1306,43357,3578750212,3578750253,41
0,1306,43358,3578750212,3578750254,42
0,1306,43359,3578750212,3578750255,43
0,1306,43360,3578750212,3578750256,44
0,1306,43361,3578750212,3578750256,44
0,1306,43362,3578750212,3578750257,45
0,1306,43363,3578750212,3578750258,46
0,1306,43364,3578750212,3578750259,47
0,1306,43365,3578750212,3578750259,47
0,1306,43366,3578750212,3578750261,49
0,1306,43367,3578750212,3578750262,50
0,1307,43368,3578750274,3578750274,0
0,1307,43369,3578750274,3578750274,0
0,1307,43370,3578750274,3578750274,0
0,1307,43371,3578750274,3578750274,0
0,1307,43372,3578750274,3578750274,0
0,1307,43373,3578750274,3578750274,0
0,1307,43374,3578750274,3578750274,0
0,1307,43375,3578750274,3578750274,0
0,1307,43376,3578750274,3578750274,0
0,1307,43377,3578750274,3578750274,0
0,1307,43378,3578750274,3578750274,0
0,1307,43379,3578750274,3578750280,6
0,1307,43380,3578750274,3578750280,6
0,1307,43381,3578750274,3578750280,6
0,1307,43382,3578750274,3578750281,7
0,1307,43383,3578750274,3578750281,7
0,1307,43384,3578750274,3578750283,9
0,1307,43385,3578750274,3578750285,11
0,1307,43386,3578750274,3578750285,11
0,1307,43387,3578750274,3578750286,12
0,1307,43388,3578750274,3578750286,12
0,1307,43389,3578750274,3578750286,12
0,1307,43390,3578750274,3578750286,12
0,1307,43391,3578750274,3578750287,13
0,1307,43392,3578750274,3578750287,13
0,1307,43393,3578750274,3578750288,14
0,1307,43394,3578750274,3578750289,15
0,1307,43395,3578750274,3578750289,15
0,1307,43396,3578750274,3578750289,15
0,1307,43397,3578750274,3578750290,16
0,1307,43398,3578750274,3578750290,16
0,1307,43399,3578750274,3578750291,17
0,1307,43400,3578750274,3578750291,17
0,1307,43401,3578750274,3578750292,18
0,1307,43402,3578750274,3578750292,18
0,1307,43403,3578750274,3578750292,18
0,1307,43404,3578750274,3578750293,19
0,1307,43405,3578750274,3578750294,20
0,1307,43406,3578750274,3578750294,20
0,1307,43407,3578750274,3578750294,20
0,1307,43408,3578750274,3578750296,22
0,1307,43409,3578750274,3578750296,22
0,1307,43410,3578750274,3578750298,24
0,1307,43411,3578750274,3578750301,27
0,1307,43412,3578750274,3578750303,29
0,1307,43413,3578750274,3578750304,30
0,1307,43414,3578750274,3578750304,30
0,1307,43415,3578750274,3578750304,30
0,1307,43416,3578750274,3578750304,30
0,1307,43417,3578750274,3578750305,31
0,1307,43418,3578750274,3578750305,31
0,1307,43419,3578750274,3578750306,32
0,1307,43420,3578750274,3578750306,32
0,1307,43421,3578750274,3578750307,33
0,1307,43422,3578750274,3578750307,33
0,1307,43423,3578750274,3578750308,34
0,1307,43424,3578750274,3578750309,35
0,1307,43425,3578750274,3578750309,35
0,1307,43426,3578750274,3578750309,35
0,1307,43427,3578750274,3578750309,35
0,1307,43428,3578750274,3578750310,36
0,1307,43429,3578750274,3578750310,36
0,1307,43430,3578750274,3578750310,36
0,1307,43431,3578750274,3578750311,37
0,1307,43432,3578750274,3578750312,38
0,1307,43433,3578750274,3578750313,39
0,1307,43434,3578750274,3578750313,39
0,1307,43435,3578750274,3578750313,39
0,1307,43436,3578750274,3578750313,39
0,1307,43437,3578750274,3578750315,41
0,1307,43438,3578750274,3578750315,41
0,1307,43439,3578750274,3578750315,41
0,1307,43440,3578750274,3578750315,41
0,1307,43441,3578750274,3578750316,42
0,1307,43442,3578750274,3578750316,42
0,1307,43443,3578750274,3578750316,42
0,1307,43444,3578750274,3578750316,42
0,1307,43445,3578750274,3578750316,42
0,1307,43446,3578750274,3578750317,43
0,1307,43447,3578750274,3578750317,43
0,1307,43448,3578750274,3578750317,43
0,1307,43449,3578750274,3578750318,44
0,1307,43450,3578750274,3578750318,44
0,1307,43451,3578750274,3578750319,45
0,1307,43452,3578750274,3578750319,45
0,1307,43453,3578750274,3578750319,45
0,1307,43454,3578750274,3578750321,47
0,1307,43455,3578750274,3578750322,48
0,1307,43456,3578750274,3578750322,48
0,1307,43457,3578750274,3578750323,49
0,1307,43458,3578750274,3578750323,49
0,1307,43459,3578750274,3578750324,50
0,1308,43460,3578750336,3578750336,0
0,1308,43461,3578750336,3578750336,0
0,1308,43462,3578750336,3578750336,0
0,1308,43463,3578750336,3578750336,0
0,1308,43464,3578750336,3578750336,0
0,1308,43465,3578750336,3578750336,0
0,1308,43466,3578750336,3578750336,0
0,1308,43467,3578750336,3578750336,0
0,1308,43468,3578750336,3578750336,0
0,1308,43469,3578750336,3578750336,0
0,1308,43470,3578750336,3578750336,0
0,1308,43471,3578750336,3578750336,0
0,1308,43472,3578750336,3578750336,0
0,1308,43473,3578750336,3578750336,0
0,1308,43474,3578750336,3578750336,0
0,1308,43475,3578750336,3578750336,0
0,1308,43476,3578750336,3578750336,0
0,1308,43477,3578750336,3578750336,0
0,1308,43478,3578750336,3578750336,0
0,1308,43479,3578750336,3578750336,0
0,1308,43480,3578750336,3578750336,0
0,1308,43481,3578750336,3578750336,0
0,1308,43482,3578750336,3578750339,3
0,1308,43483,3578750336,3578750340,4
0,1308,43484,3578750336,3578750340,4
0,1308,43485,3578750336,3578750340,4
0,1308,43486,3578750336,3578750341,5
0,1308,43487,3578750336,3578750341,5
0,1308,43488,3578750336,3578750341,5
0,1308,43489,3578750336,3578750342,6
0,1308,43490,3578750336,3578750342,6
0,1308,43491,3578750336,3578750343,7
0,1308,43492,3578750336,3578750343,7
0,1308,43493,3578750336,3578750344,8
0,1308,43494,3578750336,3578750344,8
0,1308,43495,3578750336,3578750345,9
0,1308,43496,3578750336,3578750346,10
0,1308,43497,3578750336,3578750346,10
0,1308,43498,3578750336,3578750346,10
0,1308,43499,3578750336,3578750347,11
0,1308,43500,3578750336,3578750348,12
0,1308,43501,3578750336,3578750348,12
0,1308,43502,3578750336,3578750348,12
0,1308,43503,3578750336,3578750351,15
0,1308,43504,3578750336,3578750353,17
0,1308,43505,3578750336,3578750353,17
0,1308,43506,3578750336,3578750354,18
0,1308,43507,3578750336,3578750355,19
0,1308,43508,3578750336,3578750355,19
0,1308,43509,3578750336,3578750356,20
0,1308,43510,3578750336,3578750356,20
0,1308,43511,3578750336,3578750356,20
0,1308,43512,3578750336,3578750358,22
0,1308,43513,3578750336,3578750358,22
0,1308,43514,3578750336,3578750359,23
0,1308,43515,3578750336,3578750361,25
0,1308,43516,3578750336,3578750361,25
0,1308,43517,3578750336,3578750362,26
0,1308,43518,3578750336,3578750362,26
0,1308,43519,3578750336,3578750363,27
0,1308,43520,3578750336,3578750363,27
0,1308,43521,3578750336,3578750364,28
0,1308,43522,3578750336,3578750364,28
0,1308,43523,3578750336,3578750365,29
0,1308,43524,3578750336,3578750365,29
0,1308,43525,3578750336,3578750365,29
0,1308,43526,3578750336,3578750366,30
0,1308,43527,3578750336,3578750367,31
0,1308,43528,3578750336,3578750368,32
0,1308,43529,3578750336,3578750369,33
0,1308,43530,3578750336,3578750369,33
0,1308,43531,3578750336,3578750370,34
0,1308,43532,3578750336,3578750372,36
0,1308,43533,3578750336,3578750372,36
0,1308,43534,3578750336,3578750372,36
0,1308,43535,3578750336,3578750374,38
0,1308,43536,3578750336,3578750375,39
0,1308,43537,3578750336,3578750375,39
0,1308,43538,3578750336,3578750376,40
0,1308,43539,3578750336,3578750376,40
0,1308,43540,3578750336,3578750377,41
0,1308,43541,3578750336,3578750378,42
0,1308,43542,3578750336,3578750379,43
0,1308,43543,3578750336,3578750379,43
0,1308,43544,3578750336,3578750380,44
0,1308,43545,3578750336,3578750381,45
0,1308,43546,3578750336,3578750381,45
0,1308,43547,3578750336,3578750384,48
0,1308,43548,3578750336,3578750385,49
0,1308,43549,3578750336,3578750385,49
0,1308,43550,3578750336,3578750386,50
0,1309,43551,3578750398,3578750398,0
0,1309,43552,3578750398,3578750398,0
0,1309,43553,3578750398,3578750398,0
0,1309,43554,3578750398,3578750399,1
0,1309,43555,3578750398,3578750399,1
0,1309,43556,3578750398,3578750399,1
0,1309,43557,3578750398,3578750399,1
0,1309,43558,3578750398,3578750399,1
0,1309,43559,3578750398,3578750399,1
0,1309,43560,3578750398,3578750399,1
0,1309,43561,3578750398,3578750399,1
0,1309,43562,3578750398,3578750399,1
0,1309,43563,3578750398,3578750399,1
0,1309,43564,3578750398,3578750400,2
0,1309,43565,3578750398,3578750401,3
0,1309,43566,3578750398,3578750401,3
0,1309,43567,3578750398,3578750401,3
0,1309,43568,3578750398,3578750403,5
0,1309,43569,3578750398,3578750404,6
0,1309,43570,3578750398,3578750404,6
0,1309,43571,3578750398,3578750404,6
0,1309,43572,3578750398,3578750405,7
0,1309,43573,3578750398,3578750405,7
0,1309,43574,3578750398,3578750406,8
0,1309,43575,3578750398,3578750406,8
0,1309,43576,3578750398,3578750406,8
0,1309,43577,3578750398,3578750406,8
0,1309,43578,3578750398,3578750407,9
0,1309,43579,3578750398,3578750407,9
0,1309,43580,3578750398,3578750409,11
0,1309,43581,3578750398,3578750410,12
0,1309,43582,3578750398,3578750414,16
0,1309,43583,3578750398,3578750414,16
0,1309,43584,3578750398,3578750414,16
0,1309,43585,3578750398,3578750415,17
0,1309,43586,3578750398,3578750415,17
0,1309,43587,3578750398,3578750415,17
0,1309,43588,3578750398,3578750415,17
0,1309,43589,3578750398,3578750415,17
0,1309,43590,3578750398,3578750416,18
0,1309,43591,3578750398,3578750417,19
0,1309,43592,3578750398,3578750418,20
0,1309,43593,3578750398,3578750418,20
0,1309,43594,3578750398,3578750419,21
0,1309,43595,3578750398,3578750419,21
0,1309,43596,3578750398,3578750419,21
0,1309,43597,3578750398,3578750420,22
0,1309,43598,3578750398,3578750420,22
0,1309,43599,3578750398,3578750421,23
0,1309,43600,3578750398,3578750421,23
0,1309,43601,3578750398,3578750421,23
0,1309,43602,3578750398,3578750422,24
0,1309,43603,3578750398,3578750422,24
0,1309,43604,3578750398,3578750423,25
0,1309,43605,3578750398,3578750423,25
0,1309,43606,3578750398,3578750424,26
0,1309,43607,3578750398,3578750426,28
0,1309,43608,3578750398,3578750428,30
0,1309,43609,3578750398,3578750428,30
0,1309,43610,3578750398,3578750429,31
0,1309,43611,3578750398,3578750430,32
0,1309,43612,3578750398,3578750431,33
0,1309,43613,3578750398,3578750431,33
0,1309,43614,3578750398,3578750433,35
0,1309,43615,3578750398,3578750434,36
0,1309,43616,3578750398,3578750435,37
0,1309,43617,3578750398,3578750435,37
0,1309,43618,3578750398,3578750435,37
0,1309,43619,3578750398,3578750435,37
0,1309,43620,3578750398,3578750436,38
0,1309,43621,3578750398,3578750438,40
0,1309,43622,3578750398,3578750438,40
0,1309,43623,3578750398,3578750439,41
0,1309,43624,3578750398,3578750439,41
0,1309,43625,3578750398,3578750440,42
0,1309,43626,3578750398,3578750440,42
0,1309,43627,3578750398,3578750440,42
0,1309,43628,3578750398,3578750441,43
0,1309,43629,3578750398,3578750441,43
0,1309,43630,3578750398,3578750443,45
0,1309,43631,3578750398,3578750443,45
0,1309,43632,3578750398,3578750444,46
0,1309,43633,3578750398,3578750444,46
0,1309,43634,3578750398,3578750445,47
0,1309,43635,3578750398,3578750446,48
0,1309,43636,3578750398,3578750446,48
0,1309,43637,3578750398,3578750447,49
0,1309,43638,3578750398,3578750448,50
0,1310,43639,3578750461,3578750461,0
0,1310,43640,3578750461,3578750461,0
0,1310,43641,3578750461,3578750461,0
0,1310,43642,3578750461,3578750461,0
0,1310,43643,3578750461,3578750461,0
0,1310,43644,3578750461,3578750461,0
0,1310,43645,3578750461,3578750461,0
0,1310,43646,3578750461,3578750461,0
0,1310,43647,3578750461,3578750461,0
0,1310,43648,3578750461,3578750461,0
0,1310,43649,3578750461,3578750461,0
0,1310,43650,3578750461,3578750461,0
0,1310,43651,3578750461,3578750461,0
0,1310,43652,3578750461,3578750461,0
0,1310,43653,3578750461,3578750462,1
0,1310,43654,3578750461,3578750464,3
0,1310,43655,3578750461,3578750466,5
0,1310,43656,3578750461,3578750466,5
0,1310,43657,3578750461,3578750466,5
0,1310,43658,3578750461,3578750466,5
0,1310,43659,3578750461,3578750467,6
0,1310,43660,3578750461,3578750467,6
0,1310,43661,3578750461,3578750467,6
0,1310,43662,3578750461,3578750468,7
0,1310,43663,3578750461,3578750471,10
0,1310,43664,3578750461,3578750480,19
0,1310,43665,3578750461,3578750480,19
0,1310,43666,3578750461,3578750480,19
0,1310,43667,3578750461,3578750481,20
0,1310,43668,3578750461,3578750482,21
0,1310,43669,3578750461,3578750485,24
0,1310,43670,3578750461,3578750486,25
0,1310,43671,3578750461,3578750487,26
0,1310,43672,3578750461,3578750487,26
0,1310,43673,3578750461,3578750487,26
0,1310,43674,3578750461,3578750487,26
0,1310,43675,3578750461,3578750488,27
0,1310,43676,3578750461,3578750489,28
0,1310,43677,3578750461,3578750489,28
0,1310,43678,3578750461,3578750489,28
0,1310,43679,3578750461,3578750489,28
0,1310,43680,3578750461,3578750490,29
0,1310,43681,3578750461,3578750491,30
0,1310,43682,3578750461,3578750491,30
0,1310,43683,3578750461,3578750493,32
0,1310,43684,3578750461,3578750493,32
0,1310,43685,3578750461,3578750493,32
0,1310,43686,3578750461,3578750493,32
0,1310,43687,3578750461,3578750493,32
0,1310,43688,3578750461,3578750494,33
0,1310,43689,3578750461,3578750494,33
0,1310,43690,3578750461,3578750495,34
0,1310,43691,3578750461,3578750496,35
0,1310,43692,3578750461,3578750496,35
0,1310,43693,3578750461,3578750498,37
0,1310,43694,3578750461,3578750501,40
0,1310,43695,3578750461,3578750503,42
0,1310,43696,3578750461,3578750503,42
0,1310,43697,3578750461,3578750504,43
0,1310,43698,3578750461,3578750504,43
0,1310,43699,3578750461,3578750504,43
0,1310,43700,3578750461,3578750504,43
0,1310,43701,3578750461,3578750505,44
0,1310,43702,3578750461,3578750506,45
0,1310,43703,3578750461,3578750506,45
0,1310,43704,3578750461,3578750507,46
0,1310,43705,3578750461,3578750507,46
0,1310,43706,3578750461,3578750507,46
0,1310,43707,3578750461,3578750508,47
0,1310,43708,3578750461,3578750509,48
0,1310,43709,3578750461,3578750509,48
0,1310,43710,3578750461,3578750509,48
0,1310,43711,3578750461,3578750510,49
0,1310,43712,3578750461,3578750510,49
0,1310,43713,3578750461,3578750511,50
0,1311,43714,3578750523,3578750523,0
0,1311,43715,3578750523,3578750523,0
0,1311,43716,3578750523,3578750523,0
0,1311,43717,3578750523,3578750523,0
0,1311,43718,3578750523,3578750523,0
0,1311,43719,3578750523,3578750523,0
0,1311,43720,3578750523,3578750523,0
0,1311,43721,3578750523,3578750523,0
0,1311,43722,3578750523,3578750523,0
0,1311,43723,3578750523,3578750523,0
0,1311,43724,3578750523,3578750523,0
0,1311,43725,3578750523,3578750523,0
0,1311,43726,3578750523,3578750523,0
0,1311,43727,3578750523,3578750523,0
0,1311,43728,3578750523,3578750523,0
0,1311,43729,3578750523,3578750523,0
0,1311,43730,3578750523,3578750523,0
0,1311,43731,3578750523,3578750523,0
0,1311,43732,3578750523,3578750523,0
0,1311,43733,3578750523,3578750523,0
0,1311,43734,3578750523,3578750523,0
0,1311,43735,3578750523,3578750523,0
0,1311,43736,3578750523,3578750523,0
0,1311,43737,3578750523,3578750523,0
0,1311,43738,3578750523,3578750523,0
0,1311,43739,3578750523,3578750523,0
0,1311,43740,3578750523,3578750524,1
0,1311,43741,3578750523,3578750524,1
0,1311,43742,3578750523,3578750524,1
0,1311,43743,3578750523,3578750524,1
0,1311,43744,3578750523,3578750524,1
0,1311,43745,3578750523,3578750525,2
0,1311,43746,3578750523,3578750525,2
0,1311,43747,3578750523,3578750526,3
0,1311,43748,3578750523,3578750527,4
0,1311,43749,3578750523,3578750527,4
0,1311,43750,3578750523,3578750527,4
0,1311,43751,3578750523,3578750528,5
0,1311,43752,3578750523,3578750528,5
0,1311,43753,3578750523,3578750528,5
0,1311,43754,3578750523,3578750529,6
0,1311,43755,3578750523,3578750529,6
0,1311,43756,3578750523,3578750530,7
0,1311,43757,3578750523,3578750530,7
0,1311,43758,3578750523,3578750530,7
0,1311,43759,3578750523,3578750530,7
0,1311,43760,3578750523,3578750531,8
0,1311,43761,3578750523,3578750531,8
0,1311,43762,3578750523,3578750532,9
0,1311,43763,3578750523,3578750533,10
0,1311,43764,3578750523,3578750534,11
0,1311,43765,3578750523,3578750534,11
0,1311,43766,3578750523,3578750535,12
0,1311,43767,3578750523,3578750538,15
0,1311,43768,3578750523,3578750539,16
0,1311,43769,3578750523,3578750539,16
0,1311,43770,3578750523,3578750539,16
0,1311,43771,3578750523,3578750539,16
0,1311,43772,3578750523,3578750540,17
0,1311,43773,3578750523,3578750541,18
0,1311,43774,3578750523,3578750541,18
0,1311,43775,3578750523,3578750542,19
0,1311,43776,3578750523,3578750542,19
0,1311,43777,3578750523,3578750542,19
0,1311,43778,3578750523,3578750542,19
0,1311,43779,3578750523,3578750543,20
0,1311,43780,3578750523,3578750543,20
0,1311,43781,3578750523,3578750544,21
0,1311,43782,3578750523,3578750544,21
0,1311,43783,3578750523,3578750544,21
0,1311,43784,3578750523,3578750545,22
0,1311,43785,3578750523,3578750545,22
0,1311,43786,3578750523,3578750547,24
0,1311,43787,3578750523,3578750547,24
0,1311,43788,3578750523,3578750548,25
0,1311,43789,3578750523,3578750550,27
0,1311,43790,3578750523,3578750552,29
0,1311,43791,3578750523,3578750553,30
0,1311,43792,3578750523,3578750553,30
0,1311,43793,3578750523,3578750554,31
0,1311,43794,3578750523,3578750555,32
0,1311,43795,3578750523,3578750555,32
0,1311,43796,3578750523,3578750556,33
0,1311,43797,3578750523,3578750556,33
0,1311,43798,3578750523,3578750557,34
0,1311,43799,3578750523,3578750558,35
0,1311,43800,3578750523,3578750558,35
0,1311,43801,3578750523,3578750560,37
0,1311,43802,3578750523,3578750560,37
0,1311,43803,3578750523,3578750560,37
0,1311,43804,3578750523,3578750561,38
0,1311,43805,3578750523,3578750561,38
0,1311,43806,3578750523,3578750562,39
0,1311,43807,3578750523,3578750562,39
0,1311,43808,3578750523,3578750563,40
0,1311,43809,3578750523,3578750563,40
0,1311,43810,3578750523,3578750563,40
0,1311,43811,3578750523,3578750564,41
0,1311,43812,3578750523,3578750564,41
0,1311,43813,3578750523,3578750564,41
0,1311,43814,3578750523,3578750565,42
0,1311,43815,3578750523,3578750567,44
0,1311,43816,3578750523,3578750567,44
0,1311,43817,3578750523,3578750567,44
0,1311,43818,3578750523,3578750569,46
0,1311,43819,3578750523,3578750570,47
0,1311,43820,3578750523,3578750570,47
0,1311,43821,3578750523,3578750571,48
0,1311,43822,3578750523,3578750572,49
0,1311,43823,3578750523,3578750572,49
0,1312,43824,3578750584,3578750584,0
0,1312,43825,3578750584,3578750584,0
0,1312,43826,3578750584,3578750584,0
0,1312,43827,3578750584,3578750584,0
0,1312,43828,3578750584,3578750584,0
0,1312,43829,3578750584,3578750584,0
0,1312,43830,3578750584,3578750584,0
0,1312,43831,3578750584,3578750584,0
0,1312,43832,3578750584,3578750584,0
0,1312,43833,3578750584,3578750584,0
0,1312,43834,3578750584,3578750584,0
0,1312,43835,3578750584,3578750584,0
0,1312,43836,3578750584,3578750584,0
0,1312,43837,3578750584,3578750584,0
0,1312,43838,3578750584,3578750584,0
0,1312,43839,3578750584,3578750585,1
0,1312,43840,3578750584,3578750585,1
0,1312,43841,3578750584,3578750586,2
0,1312,43842,3578750584,3578750586,2
0,1312,43843,3578750584,3578750586,2
0,1312,43844,3578750584,3578750587,3
0,1312,43845,3578750584,3578750588,4
0,1312,43846,3578750584,3578750589,5
0,1312,43847,3578750584,3578750589,5
0,1312,43848,3578750584,3578750590,6
0,1312,43849,3578750584,3578750592,8
0,1312,43850,3578750584,3578750592,8
0,1312,43851,3578750584,3578750593,9
0,1312,43852,3578750584,3578750594,10
0,1312,43853,3578750584,3578750594,10
0,1312,43854,3578750584,3578750595,11
0,1312,43855,3578750584,3578750599,15
0,1312,43856,3578750584,3578750600,16
0,1312,43857,3578750584,3578750600,16
0,1312,43858,3578750584,3578750600,16
0,1312,43859,3578750584,3578750603,19
0,1312,43860,3578750584,3578750603,19
0,1312,43861,3578750584,3578750604,20
0,1312,43862,3578750584,3578750604,20
0,1312,43863,3578750584,3578750604,20
0,1312,43864,3578750584,3578750604,20
0,1312,43865,3578750584,3578750605,21
0,1312,43866,3578750584,3578750605,21
0,1312,43867,3578750584,3578750606,22
0,1312,43868,3578750584,3578750606,22
0,1312,43869,3578750584,3578750607,23
0,1312,43870,3578750584,3578750607,23
0,1312,43871,3578750584,3578750607,23
0,1312,43872,3578750584,3578750608,24
0,1312,43873,3578750584,3578750609,25
0,1312,43874,3578750584,3578750614,30
0,1312,43875,3578750584,3578750614,30
0,1312,43876,3578750584,3578750614,30
0,1312,43877,3578750584,3578750614,30
0,1312,43878,3578750584,3578750614,30
0,1312,43879,3578750584,3578750614,30
0,1312,43880,3578750584,3578750614,30
0,1312,43881,3578750584,3578750615,31
0,1312,43882,3578750584,3578750615,31
0,1312,43883,3578750584,3578750616,32
0,1312,43884,3578750584,3578750617,33
0,1312,43885,3578750584,3578750618,34
0,1312,43886,3578750584,3578750618,34
0,1312,43887,3578750584,3578750619,35
0,1312,43888,3578750584,3578750619,35
0,1312,43889,3578750584,3578750619,35
0,1312,43890,3578750584,3578750620,36
0,1312,43891,3578750584,3578750620,36
0,1312,43892,3578750584,3578750621,37
0,1312,43893,3578750584,3578750621,37
0,1312,43894,3578750584,3578750621,37
0,1312,43895,3578750584,3578750622,38
0,1312,43896,3578750584,3578750623,39
0,1312,43897,3578750584,3578750623,39
0,1312,43898,3578750584,3578750625,41
0,1312,43899,3578750584,3578750626,42
0,1312,43900,3578750584,3578750628,44
0,1312,43901,3578750584,3578750628,44
0,1312,43902,3578750584,3578750629,45
0,1312,43903,3578750584,3578750629,45
0,1312,43904,3578750584,3578750629,45
0,1312,43905,3578750584,3578750631,47
0,1312,43906,3578750584,3578750631,47
0,1312,43907,3578750584,3578750633,49
0,1313,43908,3578750646,3578750646,0
0,1313,43909,3578750646,3578750646,0
0,1313,43910,3578750646,3578750646,0
0,1313,43911,3578750646,3578750646,0
0,1313,43912,3578750646,3578750646,0
0,1313,43913,3578750646,3578750646,0
0,1313,43914,3578750646,3578750646,0
0,1313,43915,3578750646,3578750646,0
0,1313,43916,3578750646,3578750646,0
0,1313,43917,3578750646,3578750646,0
0,1313,43918,3578750646,3578750646,0
0,1313,43919,3578750646,3578750646,0
0,1313,43920,3578750646,3578750646,0
0,1313,43921,3578750646,3578750646,0
0,1313,43922,3578750646,3578750646,0
0,1313,43923,3578750646,3578750646,0
0,1313,43924,3578750646,3578750646,0
0,1313,43925,3578750646,3578750646,0
0,1313,43926,3578750646,3578750646,0
0,1313,43927,3578750646,3578750646,0
0,1313,43928,3578750646,3578750646,0
0,1313,43929,3578750646,3578750647,1
0,1313,43930,3578750646,3578750647,1
0,1313,43931,3578750646,3578750649,3
0,1313,43932,3578750646,3578750649,3
0,1313,43933,3578750646,3578750649,3
0,1313,43934,3578750646,3578750649,3
0,1313,43935,3578750646,3578750649,3
0,1313,43936,3578750646,3578750652,6
0,1313,43937,3578750646,3578750654,8
0,1313,43938,3578750646,3578750655,9
0,1313,43939,3578750646,3578750655,9
0,1313,43940,3578750646,3578750655,9
0,1313,43941,3578750646,3578750655,9
0,1313,43942,3578750646,3578750657,11
0,1313,43943,3578750646,3578750658,12
0,1313,43944,3578750646,3578750659,13
0,1313,43945,3578750646,3578750659,13
0,1313,43946,3578750646,3578750661,15
0,1313,43947,3578750646,3578750661,15
0,1313,43948,3578750646,3578750661,15
0,1313,43949,3578750646,3578750663,17
0,1313,43950,3578750646,3578750664,18
0,1313,43951,3578750646,3578750664,18
0,1313,43952,3578750646,3578750665,19
0,1313,43953,3578750646,3578750665,19
0,1313,43954,3578750646,3578750665,19
0,1313,43955,3578750646,3578750665,19
0,1313,43956,3578750646,3578750666,20
0,1313,43957,3578750646,3578750666,20
0,1313,43958,3578750646,3578750667,21
0,1313,43959,3578750646,3578750670,24
0,1313,43960,3578750646,3578750680,34
0,1313,43961,3578750646,3578750680,34
0,1313,43962,3578750646,3578750681,35
0,1313,43963,3578750646,3578750683,37
0,1313,43964,3578750646,3578750685,39
0,1313,43965,3578750646,3578750685,39
0,1313,43966,3578750646,3578750686,40
0,1313,43967,3578750646,3578750687,41
0,1313,43968,3578750646,3578750687,41
0,1313,43969,3578750646,3578750687,41
0,1313,43970,3578750646,3578750689,43
0,1313,43971,3578750646,3578750689,43
0,1313,43972,3578750646,3578750689,43
0,1313,43973,3578750646,3578750690,44
0,1313,43974,3578750646,3578750690,44
0,1313,43975,3578750646,3578750690,44
0,1313,43976,3578750646,3578750691,45
0,1313,43977,3578750646,3578750691,45
0,1313,43978,3578750646,3578750692,46
0,1313,43979,3578750646,3578750693,47
0,1313,43980,3578750646,3578750693,47
0,1313,43981,3578750646,3578750693,47
0,1313,43982,3578750646,3578750694,48
0,1313,43983,3578750646,3578750694,48
0,1313,43984,3578750646,3578750694,48
0,1313,43985,3578750646,3578750695,49
0,1313,43986,3578750646,3578750696,50
0,1314,43987,3578750708,3578750708,0
0,1314,43988,3578750708,3578750708,0
0,1314,43989,3578750708,3578750708,0
0,1314,43990,3578750708,3578750708,0
0,1314,43991,3578750708,3578750708,0
0,1314,43992,3578750708,3578750708,0
0,1314,43993,3578750708,3578750708,0
0,1314,43994,3578750708,3578750708,0
0,1314,43995,3578750708,3578750708,0
0,1314,43996,3578750708,3578750708,0
0,1314,43997,3578750708,3578750708,0
0,1314,43998,3578750708,3578750708,0
0,1314,43999,3578750708,3578750708,0
0,1314,44000,3578750708,3578750708,0
0,1314,44001,3578750708,3578750708,0
0,1314,44002,3578750708,3578750709,1
0,1314,44003,3578750708,3578750709,1
0,1314,44004,3578750708,3578750709,1
0,1314,44005,3578750708,3578750710,2
0,1314,44006,3578750708,3578750711,3
0,1314,44007,3578750708,3578750711,3
0,1314,44008,3578750708,3578750711,3
0,1314,44009,3578750708,3578750711,3
0,1314,44010,3578750708,3578750712,4
0,1314,44011,3578750708,3578750712,4
0,1314,44012,3578750708,3578750713,5
0,1314,44013,3578750708,3578750713,5
0,1314,44014,3578750708,3578750713,5
0,1314,44015,3578750708,3578750714,6
0,1314,44016,3578750708,3578750714,6
0,1314,44017,3578750708,3578750714,6
0,1314,44018,3578750708,3578750714,6
0,1314,44019,3578750708,3578750715,7
0,1314,44020,3578750708,3578750716,8
0,1314,44021,3578750708,3578750716,8
0,1314,44022,3578750708,3578750716,8
0,1314,44023,3578750708,3578750716,8
0,1314,44024,3578750708,3578750716,8
0,1314,44025,3578750708,3578750717,9
0,1314,44026,3578750708,3578750718,10
0,1314,44027,3578750708,3578750718,10
0,1314,44028,3578750708,3578750718,10
0,1314,44029,3578750708,3578750718,10
0,1314,44030,3578750708,3578750719,11
0,1314,44031,3578750708,3578750719,11
0,1314,44032,3578750708,3578750720,12
0,1314,44033,3578750708,3578750720,12
0,1314,44034,3578750708,3578750721,13
0,1314,44035,3578750708,3578750721,13
0,1314,44036,3578750708,3578750722,14
0,1314,44037,3578750708,3578750722,14
0,1314,44038,3578750708,3578750722,14
0,1314,44039,3578750708,3578750723,15
0,1314,44040,3578750708,3578750724,16
0,1314,44041,3578750708,3578750724,16
0,1314,44042,3578750708,3578750725,17
0,1314,44043,3578750708,3578750726,18
0,1314,44044,3578750708,3578750727,19
0,1314,44045,3578750708,3578750727,19
0,1314,44046,3578750708,3578750727,19
0,1314,44047,3578750708,3578750728,20
0,1314,44048,3578750708,3578750728,20
0,1314,44049,3578750708,3578750728,20
0,1314,44050,3578750708,3578750729,21
0,1314,44051,3578750708,3578750729,21
0,1314,44052,3578750708,3578750729,21
0,1314,44053,3578750708,3578750729,21
0,1314,44054,3578750708,3578750729,21
0,1314,44055,3578750708,3578750730,22
0,1314,44056,3578750708,3578750730,22
0,1314,44057,3578750708,3578750730,22
0,1314,44058,3578750708,3578750731,23
0,1314,44059,3578750708,3578750732,24
0,1314,44060,3578750708,3578750732,24
0,1314,44061,3578750708,3578750733,25
0,1314,44062,3578750708,3578750734,26
0,1314,44063,3578750708,3578750735,27
0,1314,44064,3578750708,3578750735,27
0,1314,44065,3578750708,3578750739,31
0,1314,44066,3578750708,3578750739,31
0,1314,44067,3578750708,3578750739,31
0,1314,44068,3578750708,3578750740,32
0,1314,44069,3578750708,3578750740,32
0,1314,44070,3578750708,3578750740,32
0,1314,44071,3578750708,3578750741,33
0,1314,44072,3578750708,3578750741,33
0,1314,44073,3578750708,3578750742,34
0,1314,44074,3578750708,3578750743,35
0,1314,44075,3578750708,3578750743,35
0,1314,44076,3578750708,3578750743,35
0,1314,44077,3578750708,3578750743,35
0,1314,44078,3578750708,3578750743,35
0,1314,44079,3578750708,3578750744,36
0,1314,44080,3578750708,3578750745,37
0,1314,44081,3578750708,3578750746,38
0,1314,44082,3578750708,3578750746,38
0,1314,44083,3578750708,3578750747,39
0,1314,44084,3578750708,3578750747,39
0,1314,44085,3578750708,3578750747,39
0,1314,44086,3578750708,3578750747,39
0,1314,44087,3578750708,3578750751,43
0,1314,44088,3578750708,3578750751,43
0,1314,44089,3578750708,3578750752,44
0,1314,44090,3578750708,3578750755,47
0,1314,44091,3578750708,3578750755,47
0,1314,44092,3578750708,3578750756,48
0,1314,44093,3578750708,3578750758,50
0,1315,44094,3578750770,3578750770,0
0,1315,44095,3578750770,3578750770,0
0,1315,44096,3578750770,3578750770,0
0,1315,44097,3578750770,3578750770,0
0,1315,44098,3578750770,3578750770,0
0,1315,44099,3578750770,3578750770,0
0,1315,44100,3578750770,3578750770,0
0,1315,44101,3578750770,3578750770,0
0,1315,44102,3578750770,3578750770,0
0,1315,44103,3578750770,3578750770,0
0,1315,44104,3578750770,3578750770,0
0,1315,44105,3578750770,3578750770,0
0,1315,44106,3578750770,3578750770,0
0,1315,44107,3578750770,3578750770,0
0,1315,44108,3578750770,3578750770,0
0,1315,44109,3578750770,3578750770,0
0,1315,44110,3578750770,3578750770,0
0,1315,44111,3578750770,3578750770,0
0,1315,44112,3578750770,3578750770,0
0,1315,44113,3578750770,3578750770,0
0,1315,44114,3578750770,3578750770,0
0,1315,44115,3578750770,3578750771,1
0,1315,44116,3578750770,3578750772,2
0,1315,44117,3578750770,3578750773,3
0,1315,44118,3578750770,3578750774,4
0,1315,44119,3578750770,3578750775,5
0,1315,44120,3578750770,3578750776,6
0,1315,44121,3578750770,3578750778,8
0,1315,44122,3578750770,3578750778,8
0,1315,44123,3578750770,3578750779,9
0,1315,44124,3578750770,3578750779,9
0,1315,44125,3578750770,3578750779,9
0,1315,44126,3578750770,3578750780,10
0,1315,44127,3578750770,3578750781,11
0,1315,44128,3578750770,3578750781,11
0,1315,44129,3578750770,3578750783,13
0,1315,44130,3578750770,3578750785,15
0,1315,44131,3578750770,3578750785,15
0,1315,44132,3578750770,3578750785,15
0,1315,44133,3578750770,3578750786,16
0,1315,44134,3578750770,3578750787,17
0,1315,44135,3578750770,3578750787,17
0,1315,44136,3578750770,3578750788,18
0,1315,44137,3578750770,3578750788,18
0,1315,44138,3578750770,3578750790,20
0,1315,44139,3578750770,3578750792,22
0,1315,44140,3578750770,3578750792,22
0,1315,44141,3578750770,3578750793,23
0,1315,44142,3578750770,3578750793,23
0,1315,44143,3578750770,3578750794,24
0,1315,44144,3578750770,3578750794,24
0,1315,44145,3578750770,3578750796,26
0,1315,44146,3578750770,3578750799,29
0,1315,44147,3578750770,3578750800,30
0,1315,44148,3578750770,3578750800,30
0,1315,44149,3578750770,3578750800,30
0,1315,44150,3578750770,3578750803,33
0,1315,44151,3578750770,3578750804,34
0,1315,44152,3578750770,3578750804,34
0,1315,44153,3578750770,3578750804,34
0,1315,44154,3578750770,3578750805,35
0,1315,44155,3578750770,3578750805,35
0,1315,44156,3578750770,3578750805,35
0,1315,44157,3578750770,3578750805,35
0,1315,44158,3578750770,3578750806,36
0,1315,44159,3578750770,3578750807,37
0,1315,44160,3578750770,3578750807,37
0,1315,44161,3578750770,3578750807,37
0,1315,44162,3578750770,3578750808,38
0,1315,44163,3578750770,3578750808,38
0,1315,44164,3578750770,3578750809,39
0,1315,44165,3578750770,3578750814,44
0,1315,44166,3578750770,3578750814,44
0,1315,44167,3578750770,3578750814,44
0,1315,44168,3578750770,3578750814,44
0,1315,44169,3578750770,3578750815,45
0,1315,44170,3578750770,3578750815,45
0,1315,44171,3578750770,3578750815,45
0,1315,44172,3578750770,3578750816,46
0,1315,44173,3578750770,3578750817,47
0,1315,44174,3578750770,3578750817,47
0,1315,44175,3578750770,3578750818,48
0,1315,44176,3578750770,3578750819,49
0,1315,44177,3578750770,3578750819,49
0,1315,44178,3578750770,3578750819,49
0,1315,44179,3578750770,3578750819,49
0,1315,44180,3578750770,3578750820,50
0,1316,44181,3578750832,3578750832,0
0,1316,44182,3578750832,3578750832,0
0,1316,44183,3578750832,3578750832,0
0,1316,44184,3578750832,3578750832,0
0,1316,44185,3578750832,3578750832,0
0,1316,44186,3578750832,3578750832,0
0,1316,44187,3578750832,3578750832,0
0,1316,44188,3578750832,3578750832,0
0,1316,44189,3578750832,3578750832,0
0,1316,44190,3578750832,3578750832,0
0,1316,44191,3578750832,3578750833,1
0,1316,44192,3578750832,3578750833,1
0,1316,44193,3578750832,3578750833,1
0,1316,44194,3578750832,3578750833,1
0,1316,44195,3578750832,3578750833,1
0,1316,44196,3578750832,3578750833,1
0,1316,44197,3578750832,3578750833,1
0,1316,44198,3578750832,3578750834,2
0,1316,44199,3578750832,3578750835,3
0,1316,44200,3578750832,3578750835,3
0,1316,44201,3578750832,3578750838,6
0,1316,44202,3578750832,3578750838,6
0,1316,44203,3578750832,3578750838,6
0,1316,44204,3578750832,3578750839,7
0,1316,44205,3578750832,3578750839,7
0,1316,44206,3578750832,3578750839,7
0,1316,44207,3578750832,3578750839,7
0,1316,44208,3578750832,3578750840,8
0,1316,44209,3578750832,3578750840,8
0,1316,44210,3578750832,3578750840,8
0,1316,44211,3578750832,3578750842,10
0,1316,44212,3578750832,3578750843,11
0,1316,44213,3578750832,3578750843,11
0,1316,44214,3578750832,3578750844,12
0,1316,44215,3578750832,3578750845,13
0,1316,44216,3578750832,3578750845,13
0,1316,44217,3578750832,3578750846,14
0,1316,44218,3578750832,3578750847,15
0,1316,44219,3578750832,3578750847,15
0,1316,44220,3578750832,3578750848,16
0,1316,44221,3578750832,3578750848,16
0,1316,44222,3578750832,3578750848,16
0,1316,44223,3578750832,3578750849,17
0,1316,44224,3578750832,3578750849,17
0,1316,44225,3578750832,3578750850,18
0,1316,44226,3578750832,3578750852,20
0,1316,44227,3578750832,3578750854,22
0,1316,44228,3578750832,3578750856,24
0,1316,44229,3578750832,3578750857,25
0,1316,44230,3578750832,3578750857,25
0,1316,44231,3578750832,3578750858,26
0,1316,44232,3578750832,3578750858,26
0,1316,44233,3578750832,3578750858,26
0,1316,44234,3578750832,3578750858,26
0,1316,44235,3578750832,3578750861,29
0,1316,44236,3578750832,3578750861,29
0,1316,44237,3578750832,3578750862,30
0,1316,44238,3578750832,3578750864,32
0,1316,44239,3578750832,3578750864,32
0,1316,44240,3578750832,3578750864,32
0,1316,44241,3578750832,3578750865,33
0,1316,44242,3578750832,3578750865,33
0,1316,44243,3578750832,3578750865,33
0,1316,44244,3578750832,3578750866,34
0,1316,44245,3578750832,3578750866,34
0,1316,44246,3578750832,3578750867,35
0,1316,44247,3578750832,3578750867,35
0,1316,44248,3578750832,3578750871,39
0,1316,44249,3578750832,3578750879,47
0,1316,44250,3578750832,3578750880,48
0,1316,44251,3578750832,3578750880,48
0,1316,44252,3578750832,3578750881,49
0,1317,44253,3578750896,3578750896,0
0,1317,44254,3578750896,3578750896,0
0,1317,44255,3578750896,3578750896,0
0,1317,44256,3578750896,3578750896,0
0,1317,44257,3578750896,3578750896,0
0,1317,44258,3578750896,3578750896,0
0,1317,44259,3578750896,3578750896,0
0,1317,44260,3578750896,3578750896,0
0,1317,44261,3578750896,3578750896,0
0,1317,44262,3578750896,3578750896,0
0,1317,44263,3578750896,3578750896,0
0,1317,44264,3578750896,3578750896,0
0,1317,44265,3578750896,3578750896,0
0,1317,44266,3578750896,3578750896,0
0,1317,44267,3578750896,3578750896,0
0,1317,44268,3578750896,3578750896,0
0,1317,44269,3578750896,3578750896,0
0,1317,44270,3578750896,3578750896,0
0,1317,44271,3578750896,3578750896,0
0,1317,44272,3578750896,3578750896,0
0,1317,44273,3578750896,3578750896,0
0,1317,44274,3578750896,3578750896,0
0,1317,44275,3578750896,3578750896,0
0,1317,44276,3578750896,3578750896,0
0,1317,44277,3578750896,3578750896,0
0,1317,44278,3578750896,3578750898,2
0,1317,44279,3578750896,3578750902,6
0,1317,44280,3578750896,3578750903,7
0,1317,44281,3578750896,3578750904,8
0,1317,44282,3578750896,3578750904,8
0,1317,44283,3578750896,3578750904,8
0,1317,44284,3578750896,3578750905,9
0,1317,44285,3578750896,3578750906,10
0,1317,44286,3578750896,3578750906,10
0,1317,44287,3578750896,3578750906,10
0,1317,44288,3578750896,3578750907,11
0,1317,44289,3578750896,3578750907,11
0,1317,44290,3578750896,3578750907,11
0,1317,44291,3578750896,3578750908,12
0,1317,44292,3578750896,3578750909,13
0,1317,44293,3578750896,3578750909,13
0,1317,44294,3578750896,3578750910,14
0,1317,44295,3578750896,3578750911,15
0,1317,44296,3578750896,3578750911,15
0,1317,44297,3578750896,3578750912,16
0,1317,44298,3578750896,3578750912,16
0,1317,44299,3578750896,3578750912,16
0,1317,44300,3578750896,3578750913,17
0,1317,44301,3578750896,3578750913,17
0,1317,44302,3578750896,3578750913,17
0,1317,44303,3578750896,3578750913,17
0,1317,44304,3578750896,3578750914,18
0,1317,44305,3578750896,3578750914,18
0,1317,44306,3578750896,3578750914,18
0,1317,44307,3578750896,3578750915,19
0,1317,44308,3578750896,3578750916,20
0,1317,44309,3578750896,3578750916,20
0,1317,44310,3578750896,3578750916,20
0,1317,44311,3578750896,3578750917,21
0,1317,44312,3578750896,3578750917,21
0,1317,44313,3578750896,3578750917,21
0,1317,44314,3578750896,3578750918,22
0,1317,44315,3578750896,3578750918,22
0,1317,44316,3578750896,3578750918,22
0,1317,44317,3578750896,3578750919,23
0,1317,44318,3578750896,3578750919,23
0,1317,44319,3578750896,3578750920,24
0,1317,44320,3578750896,3578750921,25
0,1317,44321,3578750896,3578750921,25
0,1317,44322,3578750896,3578750922,26
0,1317,44323,3578750896,3578750922,26
0,1317,44324,3578750896,3578750924,28
0,1317,44325,3578750896,3578750924,28
0,1317,44326,3578750896,3578750924,28
0,1317,44327,3578750896,3578750924,28
0,1317,44328,3578750896,3578750924,28
0,1317,44329,3578750896,3578750926,30
0,1317,44330,3578750896,3578750927,31
0,1317,44331,3578750896,3578750927,31
0,1317,44332,3578750896,3578750928,32
0,1317,44333,3578750896,3578750928,32
0,1317,44334,3578750896,3578750928,32
0,1317,44335,3578750896,3578750929,33
0,1317,44336,3578750896,3578750929,33
0,1317,44337,3578750896,3578750929,33
0,1317,44338,3578750896,3578750929,33
0,1317,44339,3578750896,3578750930,34
0,1317,44340,3578750896,3578750930,34
0,1317,44341,3578750896,3578750931,35
0,1317,44342,3578750896,3578750931,35
0,1317,44343,3578750896,3578750932,36
0,1317,44344,3578750896,3578750933,37
0,1317,44345,3578750896,3578750933,37
0,1317,44346,3578750896,3578750935,39
0,1317,44347,3578750896,3578750935,39
0,1317,44348,3578750896,3578750935,39
0,1317,44349,3578750896,3578750938,42
0,1317,44350,3578750896,3578750939,43
0,1317,44351,3578750896,3578750939,43
0,1317,44352,3578750896,3578750940,44
0,1317,44353,3578750896,3578750941,45
0,1317,44354,3578750896,3578750941,45
0,1317,44355,3578750896,3578750942,46
0,1317,44356,3578750896,3578750943,47
0,1317,44357,3578750896,3578750943,47
0,1317,44358,3578750896,3578750943,47
0,1317,44359,3578750896,3578750943,47
0,1317,44360,3578750896,3578750944,48
0,1317,44361,3578750896,3578750944,48
0,1317,44362,3578750896,3578750944,48
0,1317,44363,3578750896,3578750945,49
0,1317,44364,3578750896,3578750945,49
0,1317,44365,3578750896,3578750945,49
0,1318,44366,3578750959,3578750959,0
0,1318,44367,3578750959,3578750960,1
0,1318,44368,3578750959,3578750960,1
0,1318,44369,3578750959,3578750960,1
0,1318,44370,3578750959,3578750960,1
0,1318,44371,3578750959,3578750960,1
0,1318,44372,3578750959,3578750960,1
0,1318,44373,3578750959,3578750960,1
0,1318,44374,3578750959,3578750960,1
0,1318,44375,3578750959,3578750960,1
0,1318,44376,3578750959,3578750960,1
0,1318,44377,3578750959,3578750960,1
0,1318,44378,3578750959,3578750960,1
0,1318,44379,3578750959,3578750960,1
0,1318,44380,3578750959,3578750960,1
0,1318,44381,3578750959,3578750960,1
0,1318,44382,3578750959,3578750961,2
0,1318,44383,3578750959,3578750961,2
0,1318,44384,3578750959,3578750961,2
0,1318,44385,3578750959,3578750962,3
0,1318,44386,3578750959,3578750963,4
0,1318,44387,3578750959,3578750963,4
0,1318,44388,3578750959,3578750963,4
0,1318,44389,3578750959,3578750964,5
0,1318,44390,3578750959,3578750964,5
0,1318,44391,3578750959,3578750964,5
0,1318,44392,3578750959,3578750966,7
0,1318,44393,3578750959,3578750967,8
0,1318,44394,3578750959,3578750968,9
0,1318,44395,3578750959,3578750968,9
0,1318,44396,3578750959,3578750969,10
0,1318,44397,3578750959,3578750970,11
0,1318,44398,3578750959,3578750970,11
0,1318,44399,3578750959,3578750971,12
0,1318,44400,3578750959,3578750973,14
0,1318,44401,3578750959,3578750973,14
0,1318,44402,3578750959,3578750974,15
0,1318,44403,3578750959,3578750975,16
0,1318,44404,3578750959,3578750977,18
0,1318,44405,3578750959,3578750977,18
0,1318,44406,3578750959,3578750979,20
0,1318,44407,3578750959,3578750979,20
0,1318,44408,3578750959,3578750979,20
0,1318,44409,3578750959,3578750979,20
0,1318,44410,3578750959,3578750979,20
0,1318,44411,3578750959,3578750980,21
0,1318,44412,3578750959,3578750981,22
0,1318,44413,3578750959,3578750981,22
0,1318,44414,3578750959,3578750984,25
0,1318,44415,3578750959,3578750984,25
0,1318,44416,3578750959,3578750985,26
0,1318,44417,3578750959,3578750985,26
0,1318,44418,3578750959,3578750985,26
0,1318,44419,3578750959,3578750986,27
0,1318,44420,3578750959,3578750987,28
0,1318,44421,3578750959,3578750988,29
0,1318,44422,3578750959,3578750989,30
0,1318,44423,3578750959,3578750990,31
0,1318,44424,3578750959,3578750990,31
0,1318,44425,3578750959,3578750992,33
0,1318,44426,3578750959,3578750993,34
0,1318,44427,3578750959,3578750993,34
0,1318,44428,3578750959,3578750994,35
0,1318,44429,3578750959,3578750994,35
0,1318,44430,3578750959,3578750995,36
0,1318,44431,3578750959,3578750999,40
0,1318,44432,3578750959,3578751000,41
0,1318,44433,3578750959,3578751000,41
0,1318,44434,3578750959,3578751001,42
0,1318,44435,3578750959,3578751003,44
0,1318,44436,3578750959,3578751003,44
0,1318,44437,3578750959,3578751004,45
0,1318,44438,3578750959,3578751004,45
0,1318,44439,3578750959,3578751005,46
0,1318,44440,3578750959,3578751005,46
0,1318,44441,3578750959,3578751005,46
0,1318,44442,3578750959,3578751005,46
0,1318,44443,3578750959,3578751006,47
0,1318,44444,3578750959,3578751007,48
0,1318,44445,3578750959,3578751007,48
0,1318,44446,3578750959,3578751007,48
0,1318,44447,3578750959,3578751008,49
0,1319,44448,3578751021,3578751021,0
0,1319,44449,3578751021,3578751021,0
0,1319,44450,3578751021,3578751021,0
0,1319,44451,3578751021,3578751021,0
0,1319,44452,3578751021,3578751021,0
0,1319,44453,3578751021,3578751021,0
0,1319,44454,3578751021,3578751021,0
0,1319,44455,3578751021,3578751021,0
0,1319,44456,3578751021,3578751021,0
0,1319,44457,3578751021,3578751021,0
0,1319,44458,3578751021,3578751021,0
0,1319,44459,3578751021,3578751021,0
0,1319,44460,3578751021,3578751021,0
0,1319,44461,3578751021,3578751021,0
0,1319,44462,3578751021,3578751021,0
0,1319,44463,3578751021,3578751021,0
0,1319,44464,3578751021,3578751021,0
0,1319,44465,3578751021,3578751021,0
0,1319,44466,3578751021,3578751021,0
0,1319,44467,3578751021,3578751021,0
0,1319,44468,3578751021,3578751021,0
0,1319,44469,3578751021,3578751021,0
0,1319,44470,3578751021,3578751021,0
0,1319,44471,3578751021,3578751022,1
0,1319,44472,3578751021,3578751023,2
0,1319,44473,3578751021,3578751024,3
0,1319,44474,3578751021,3578751024,3
0,1319,44475,3578751021,3578751026,5
0,1319,44476,3578751021,3578751027,6
0,1319,44477,3578751021,3578751027,6
0,1319,44478,3578751021,3578751028,7
0,1319,44479,3578751021,3578751029,8
0,1319,44480,3578751021,3578751030,9
0,1319,44481,3578751021,3578751031,10
0,1319,44482,3578751021,3578751032,11
0,1319,44483,3578751021,3578751034,13
0,1319,44484,3578751021,3578751034,13
0,1319,44485,3578751021,3578751035,14
0,1319,44486,3578751021,3578751035,14
0,1319,44487,3578751021,3578751037,16
0,1319,44488,3578751021,3578751037,16
0,1319,44489,3578751021,3578751038,17
0,1319,44490,3578751021,3578751039,18
0,1319,44491,3578751021,3578751039,18
0,1319,44492,3578751021,3578751040,19
0,1319,44493,3578751021,3578751040,19
0,1319,44494,3578751021,3578751040,19
0,1319,44495,3578751021,3578751041,20
0,1319,44496,3578751021,3578751042,21
0,1319,44497,3578751021,3578751043,22
0,1319,44498,3578751021,3578751044,23
0,1319,44499,3578751021,3578751044,23
0,1319,44500,3578751021,3578751045,24
0,1319,44501,3578751021,3578751046,25
0,1319,44502,3578751021,3578751047,26
0,1319,44503,3578751021,3578751048,27
0,1319,44504,3578751021,3578751048,27
0,1319,44505,3578751021,3578751049,28
0,1319,44506,3578751021,3578751049,28
0,1319,44507,3578751021,3578751050,29
0,1319,44508,3578751021,3578751050,29
0,1319,44509,3578751021,3578751050,29
0,1319,44510,3578751021,3578751051,30
0,1319,44511,3578751021,3578751052,31
0,1319,44512,3578751021,3578751054,33
0,1319,44513,3578751021,3578751055,34
0,1319,44514,3578751021,3578751055,34
0,1319,44515,3578751021,3578751057,36
0,1319,44516,3578751021,3578751057,36
0,1319,44517,3578751021,3578751057,36
0,1319,44518,3578751021,3578751058,37
0,1319,44519,3578751021,3578751059,38
0,1319,44520,3578751021,3578751059,38
0,1319,44521,3578751021,3578751061,40
0,1319,44522,3578751021,3578751062,41
0,1319,44523,3578751021,3578751062,41
0,1319,44524,3578751021,3578751064,43
0,1319,44525,3578751021,3578751064,43
0,1319,44526,3578751021,3578751065,44
0,1319,44527,3578751021,3578751065,44
0,1319,44528,3578751021,3578751065,44
0,1319,44529,3578751021,3578751066,45
0,1319,44530,3578751021,3578751066,45
0,1319,44531,3578751021,3578751066,45
0,1319,44532,3578751021,3578751066,45
0,1319,44533,3578751021,3578751067,46
0,1320,44534,3578751083,3578751083,0
0,1320,44535,3578751083,3578751083,0
0,1320,44536,3578751083,3578751083,0
0,1320,44537,3578751083,3578751083,0
0,1320,44538,3578751083,3578751083,0
0,1320,44539,3578751083,3578751083,0
0,1320,44540,3578751083,3578751083,0
0,1320,44541,3578751083,3578751083,0
0,1320,44542,3578751083,3578751085,2
0,1320,44543,3578751083,3578751086,3
0,1320,44544,3578751083,3578751086,3
0,1320,44545,3578751083,3578751086,3
0,1320,44546,3578751083,3578751087,4
0,1320,44547,3578751083,3578751087,4
0,1320,44548,3578751083,3578751087,4
0,1320,44549,3578751083,3578751088,5
0,1320,44550,3578751083,3578751089,6
0,1320,44551,3578751083,3578751089,6
0,1320,44552,3578751083,3578751089,6
0,1320,44553,3578751083,3578751090,7
0,1320,44554,3578751083,3578751090,7
0,1320,44555,3578751083,3578751090,7
0,1320,44556,3578751083,3578751091,8
0,1320,44557,3578751083,3578751092,9
0,1320,44558,3578751083,3578751093,10
0,1320,44559,3578751083,3578751093,10
0,1320,44560,3578751083,3578751094,11
0,1320,44561,3578751083,3578751094,11
0,1320,44562,3578751083,3578751094,11
0,1320,44563,3578751083,3578751094,11
0,1320,44564,3578751083,3578751094,11
0,1320,44565,3578751083,3578751094,11
0,1320,44566,3578751083,3578751095,12
0,1320,44567,3578751083,3578751096,13
0,1320,44568,3578751083,3578751096,13
0,1320,44569,3578751083,3578751098,15
0,1320,44570,3578751083,3578751102,19
0,1320,44571,3578751083,3578751103,20
0,1320,44572,3578751083,3578751103,20
0,1320,44573,3578751083,3578751104,21
0,1320,44574,3578751083,3578751105,22
0,1320,44575,3578751083,3578751105,22
0,1320,44576,3578751083,3578751106,23
0,1320,44577,3578751083,3578751106,23
0,1320,44578,3578751083,3578751106,23
0,1320,44579,3578751083,3578751107,24
0,1320,44580,3578751083,3578751107,24
0,1320,44581,3578751083,3578751108,25
0,1320,44582,3578751083,3578751109,26
0,1320,44583,3578751083,3578751109,26
0,1320,44584,3578751083,3578751110,27
0,1320,44585,3578751083,3578751111,28
0,1320,44586,3578751083,3578751111,28
0,1320,44587,3578751083,3578751112,29
0,1320,44588,3578751083,3578751112,29
0,1320,44589,3578751083,3578751112,29
0,1320,44590,3578751083,3578751113,30
0,1320,44591,3578751083,3578751114,31
0,1320,44592,3578751083,3578751114,31
0,1320,44593,3578751083,3578751114,31
0,1320,44594,3578751083,3578751114,31
0,1320,44595,3578751083,3578751115,32
0,1320,44596,3578751083,3578751115,32
0,1320,44597,3578751083,3578751116,33
0,1320,44598,3578751083,3578751116,33
0,1320,44599,3578751083,3578751116,33
0,1320,44600,3578751083,3578751117,34
0,1320,44601,3578751083,3578751117,34
0,1320,44602,3578751083,3578751118,35
0,1320,44603,3578751083,3578751118,35
0,1320,44604,3578751083,3578751118,35
0,1320,44605,3578751083,3578751118,35
0,1320,44606,3578751083,3578751119,36
0,1320,44607,3578751083,3578751119,36
0,1320,44608,3578751083,3578751120,37
0,1320,44609,3578751083,3578751120,37
0,1320,44610,3578751083,3578751121,38
0,1320,44611,3578751083,3578751122,39
0,1320,44612,3578751083,3578751122,39
0,1320,44613,3578751083,3578751124,41
0,1320,44614,3578751083,3578751124,41
0,1320,44615,3578751083,3578751124,41
0,1320,44616,3578751083,3578751125,42
0,1320,44617,3578751083,3578751126,43
0,1320,44618,3578751083,3578751127,44
0,1320,44619,3578751083,3578751127,44
0,1320,44620,3578751083,3578751127,44
0,1320,44621,3578751083,3578751128,45
0,1320,44622,3578751083,3578751128,45
0,1320,44623,3578751083,3578751128,45
0,1320,44624,3578751083,3578751128,45
0,1320,44625,3578751083,3578751129,46
0,1320,44626,3578751083,3578751129,46
0,1320,44627,3578751083,3578751129,46
0,1320,44628,3578751083,3578751130,47
0,1320,44629,3578751083,3578751130,47
0,1320,44630,3578751083,3578751130,47
0,1320,44631,3578751083,3578751131,48
0,1320,44632,3578751083,3578751131,48
0,1320,44633,3578751083,3578751131,48
0,1320,44634,3578751083,3578751132,49
0,1320,44635,3578751083,3578751133,50
0,1321,44636,3578751144,3578751144,0
0,1321,44637,3578751144,3578751144,0
0,1321,44638,3578751144,3578751144,0
0,1321,44639,3578751144,3578751144,0
0,1321,44640,3578751144,3578751144,0
0,1321,44641,3578751144,3578751144,0
0,1321,44642,3578751144,3578751144,0
0,1321,44643,3578751144,3578751144,0
0,1321,44644,3578751144,3578751144,0
0,1321,44645,3578751144,3578751144,0
0,1321,44646,3578751144,3578751144,0
0,1321,44647,3578751144,3578751144,0
0,1321,44648,3578751144,3578751144,0
0,1321,44649,3578751144,3578751144,0
0,1321,44650,3578751144,3578751144,0
0,1321,44651,3578751144,3578751144,0
0,1321,44652,3578751144,3578751144,0
0,1321,44653,3578751144,3578751144,0
0,1321,44654,3578751144,3578751145,1
0,1321,44655,3578751144,3578751145,1
0,1321,44656,3578751144,3578751146,2
0,1321,44657,3578751144,3578751146,2
0,1321,44658,3578751144,3578751147,3
0,1321,44659,3578751144,3578751148,4
0,1321,44660,3578751144,3578751148,4
0,1321,44661,3578751144,3578751150,6
0,1321,44662,3578751144,3578751152,8
0,1321,44663,3578751144,3578751153,9
0,1321,44664,3578751144,3578751153,9
0,1321,44665,3578751144,3578751153,9
0,1321,44666,3578751144,3578751155,11
0,1321,44667,3578751144,3578751155,11
0,1321,44668,3578751144,3578751157,13
0,1321,44669,3578751144,3578751159,15
0,1321,44670,3578751144,3578751159,15
0,1321,44671,3578751144,3578751160,16
0,1321,44672,3578751144,3578751161,17
0,1321,44673,3578751144,3578751161,17
0,1321,44674,3578751144,3578751161,17
0,1321,44675,3578751144,3578751161,17
0,1321,44676,3578751144,3578751161,17
0,1321,44677,3578751144,3578751162,18
0,1321,44678,3578751144,3578751164,20
0,1321,44679,3578751144,3578751164,20
0,1321,44680,3578751144,3578751164,20
0,1321,44681,3578751144,3578751165,21
0,1321,44682,3578751144,3578751166,22
0,1321,44683,3578751144,3578751166,22
0,1321,44684,3578751144,3578751167,23
0,1321,44685,3578751144,3578751168,24
0,1321,44686,3578751144,3578751169,25
0,1321,44687,3578751144,3578751170,26
0,1321,44688,3578751144,3578751170,26
0,1321,44689,3578751144,3578751170,26
0,1321,44690,3578751144,3578751172,28
0,1321,44691,3578751144,3578751172,28
0,1321,44692,3578751144,3578751173,29
0,1321,44693,3578751144,3578751174,30
0,1321,44694,3578751144,3578751175,31
0,1321,44695,3578751144,3578751177,33
0,1321,44696,3578751144,3578751179,35
0,1321,44697,3578751144,3578751179,35
0,1321,44698,3578751144,3578751179,35
0,1321,44699,3578751144,3578751179,35
0,1321,44700,3578751144,3578751179,35
0,1321,44701,3578751144,3578751181,37
0,1321,44702,3578751144,3578751181,37
0,1321,44703,3578751144,3578751182,38
0,1321,44704,3578751144,3578751184,40
0,1321,44705,3578751144,3578751185,41
0,1321,44706,3578751144,3578751185,41
0,1321,44707,3578751144,3578751185,41
0,1321,44708,3578751144,3578751186,42
0,1321,44709,3578751144,3578751186,42
0,1321,44710,3578751144,3578751186,42
0,1321,44711,3578751144,3578751188,44
0,1321,44712,3578751144,3578751189,45
0,1321,44713,3578751144,3578751189,45
0,1321,44714,3578751144,3578751192,48
0,1321,44715,3578751144,3578751193,49
0,1321,44716,3578751144,3578751193,49
0,1321,44717,3578751144,3578751194,50
0,1322,44718,3578751208,3578751208,0
0,1322,44719,3578751208,3578751208,0
0,1322,44720,3578751208,3578751208,0
0,1322,44721,3578751208,3578751208,0
0,1322,44722,3578751208,3578751208,0
0,1322,44723,3578751208,3578751208,0
0,1322,44724,3578751208,3578751208,0
0,1322,44725,3578751208,3578751208,0
0,1322,44726,3578751208,3578751208,0
0,1322,44727,3578751208,3578751208,0
0,1322,44728,3578751208,3578751208,0
0,1322,44729,3578751208,3578751208,0
0,1322,44730,3578751208,3578751208,0
0,1322,44731,3578751208,3578751208,0
0,1322,44732,3578751208,3578751208,0
0,1322,44733,3578751208,3578751208,0
0,1322,44734,3578751208,3578751208,0
0,1322,44735,3578751208,3578751208,0
0,1322,44736,3578751208,3578751209,1
0,1322,44737,3578751208,3578751210,2
0,1322,44738,3578751208,3578751214,6
0,1322,44739,3578751208,3578751214,6
0,1322,44740,3578751208,3578751214,6
0,1322,44741,3578751208,3578751214,6
0,1322,44742,3578751208,3578751215,7
0,1322,44743,3578751208,3578751215,7
0,1322,44744,3578751208,3578751216,8
0,1322,44745,3578751208,3578751216,8
0,1322,44746,3578751208,3578751216,8
0,1322,44747,3578751208,3578751216,8
0,1322,44748,3578751208,3578751218,10
0,1322,44749,3578751208,3578751218,10
0,1322,44750,3578751208,3578751219,11
0,1322,44751,3578751208,3578751219,11
0,1322,44752,3578751208,3578751220,12
0,1322,44753,3578751208,3578751221,13
0,1322,44754,3578751208,3578751221,13
0,1322,44755,3578751208,3578751221,13
0,1322,44756,3578751208,3578751222,14
0,1322,44757,3578751208,3578751223,15
0,1322,44758,3578751208,3578751224,16
0,1322,44759,3578751208,3578751224,16
0,1322,44760,3578751208,3578751225,17
0,1322,44761,3578751208,3578751227,19
0,1322,44762,3578751208,3578751227,19
0,1322,44763,3578751208,3578751228,20
0,1322,44764,3578751208,3578751229,21
0,1322,44765,3578751208,3578751230,22
0,1322,44766,3578751208,3578751231,23
0,1322,44767,3578751208,3578751231,23
0,1322,44768,3578751208,3578751233,25
0,1322,44769,3578751208,3578751234,26
0,1322,44770,3578751208,3578751234,26
0,1322,44771,3578751208,3578751235,27
0,1322,44772,3578751208,3578751235,27
0,1322,44773,3578751208,3578751236,28
0,1322,44774,3578751208,3578751237,29
0,1322,44775,3578751208,3578751237,29
0,1322,44776,3578751208,3578751239,31
0,1322,44777,3578751208,3578751239,31
0,1322,44778,3578751208,3578751240,32
0,1322,44779,3578751208,3578751240,32
0,1322,44780,3578751208,3578751241,33
0,1322,44781,3578751208,3578751242,34
0,1322,44782,3578751208,3578751242,34
0,1322,44783,3578751208,3578751243,35
0,1322,44784,3578751208,3578751244,36
0,1322,44785,3578751208,3578751244,36
0,1322,44786,3578751208,3578751244,36
0,1322,44787,3578751208,3578751245,37
0,1322,44788,3578751208,3578751247,39
0,1322,44789,3578751208,3578751248,40
0,1322,44790,3578751208,3578751248,40
0,1322,44791,3578751208,3578751249,41
0,1322,44792,3578751208,3578751250,42
0,1322,44793,3578751208,3578751250,42
0,1322,44794,3578751208,3578751250,42
0,1322,44795,3578751208,3578751252,44
0,1322,44796,3578751208,3578751253,45
0,1322,44797,3578751208,3578751254,46
0,1322,44798,3578751208,3578751255,47
0,1322,44799,3578751208,3578751256,48
0,1322,44800,3578751208,3578751257,49
0,1322,44801,3578751208,3578751257,49
0,1322,44802,3578751208,3578751257,49
0,1322,44803,3578751208,3578751258,50
0,1323,44804,3578751271,3578751272,1
0,1323,44805,3578751271,3578751272,1
0,1323,44806,3578751271,3578751272,1
0,1323,44807,3578751271,3578751272,1
0,1323,44808,3578751271,3578751272,1
0,1323,44809,3578751271,3578751272,1
0,1323,44810,3578751271,3578751272,1
0,1323,44811,3578751271,3578751272,1
0,1323,44812,3578751271,3578751272,1
0,1323,44813,3578751271,3578751272,1
0,1323,44814,3578751271,3578751272,1
0,1323,44815,3578751271,3578751272,1
0,1323,44816,3578751271,3578751272,1
0,1323,44817,3578751271,3578751272,1
0,1323,44818,3578751271,3578751272,1
0,1323,44819,3578751271,3578751279,8
0,1323,44820,3578751271,3578751280,9
0,1323,44821,3578751271,3578751280,9
0,1323,44822,3578751271,3578751280,9
0,1323,44823,3578751271,3578751281,10
0,1323,44824,3578751271,3578751281,10
0,1323,44825,3578751271,3578751284,13
0,1323,44826,3578751271,3578751285,14
0,1323,44827,3578751271,3578751285,14
0,1323,44828,3578751271,3578751286,15
0,1323,44829,3578751271,3578751286,15
0,1323,44830,3578751271,3578751286,15
0,1323,44831,3578751271,3578751287,16
0,1323,44832,3578751271,3578751287,16
0,1323,44833,3578751271,3578751288,17
0,1323,44834,3578751271,3578751289,18
0,1323,44835,3578751271,3578751289,18
0,1323,44836,3578751271,3578751290,19
0,1323,44837,3578751271,3578751290,19
0,1323,44838,3578751271,3578751290,19
0,1323,44839,3578751271,3578751290,19
0,1323,44840,3578751271,3578751290,19
0,1323,44841,3578751271,3578751292,21
0,1323,44842,3578751271,3578751293,22
0,1323,44843,3578751271,3578751293,22
0,1323,44844,3578751271,3578751293,22
0,1323,44845,3578751271,3578751294,23
0,1323,44846,3578751271,3578751294,23
0,1323,44847,3578751271,3578751294,23
0,1323,44848,3578751271,3578751294,23
0,1323,44849,3578751271,3578751295,24
0,1323,44850,3578751271,3578751296,25
0,1323,44851,3578751271,3578751296,25
0,1323,44852,3578751271,3578751296,25
0,1323,44853,3578751271,3578751298,27
0,1323,44854,3578751271,3578751301,30
0,1323,44855,3578751271,3578751303,32
0,1323,44856,3578751271,3578751304,33
0,1323,44857,3578751271,3578751304,33
0,1323,44858,3578751271,3578751305,34
0,1323,44859,3578751271,3578751305,34
0,1323,44860,3578751271,3578751306,35
0,1323,44861,3578751271,3578751306,35
0,1323,44862,3578751271,3578751307,36
0,1323,44863,3578751271,3578751307,36
0,1323,44864,3578751271,3578751307,36
0,1323,44865,3578751271,3578751308,37
0,1323,44866,3578751271,3578751309,38
0,1323,44867,3578751271,3578751309,38
0,1323,44868,3578751271,3578751310,39
0,1323,44869,3578751271,3578751310,39
0,1323,44870,3578751271,3578751311,40
0,1323,44871,3578751271,3578751311,40
0,1323,44872,3578751271,3578751311,40
0,1323,44873,3578751271,3578751312,41
0,1323,44874,3578751271,3578751312,41
0,1323,44875,3578751271,3578751312,41
0,1323,44876,3578751271,3578751313,42
0,1323,44877,3578751271,3578751313,42
0,1323,44878,3578751271,3578751314,43
0,1323,44879,3578751271,3578751314,43
0,1323,44880,3578751271,3578751315,44
0,1323,44881,3578751271,3578751315,44
0,1323,44882,3578751271,3578751315,44
0,1323,44883,3578751271,3578751316,45
0,1323,44884,3578751271,3578751316,45
0,1323,44885,3578751271,3578751316,45
0,1323,44886,3578751271,3578751317,46
0,1323,44887,3578751271,3578751317,46
0,1323,44888,3578751271,3578751317,46
0,1323,44889,3578751271,3578751319,48
0,1323,44890,3578751271,3578751319,48
0,1323,44891,3578751271,3578751319,48
0,1323,44892,3578751271,3578751319,48
0,1323,44893,3578751271,3578751321,50
0,1324,44894,3578751333,3578751333,0
0,1324,44895,3578751333,3578751333,0
0,1324,44896,3578751333,3578751333,0
0,1324,44897,3578751333,3578751333,0
0,1324,44898,3578751333,3578751333,0
0,1324,44899,3578751333,3578751333,0
0,1324,44900,3578751333,3578751333,0
0,1324,44901,3578751333,3578751333,0
0,1324,44902,3578751333,3578751333,0
0,1324,44903,3578751333,3578751333,0
0,1324,44904,3578751333,3578751333,0
0,1324,44905,3578751333,3578751333,0
0,1324,44906,3578751333,3578751333,0
0,1324,44907,3578751333,3578751333,0
0,1324,44908,3578751333,3578751333,0
0,1324,44909,3578751333,3578751333,0
0,1324,44910,3578751333,3578751333,0
0,1324,44911,3578751333,3578751333,0
0,1324,44912,3578751333,3578751333,0
0,1324,44913,3578751333,3578751333,0
0,1324,44914,3578751333,3578751333,0
0,1324,44915,3578751333,3578751333,0
0,1324,44916,3578751333,3578751333,0
0,1324,44917,3578751333,3578751333,0
0,1324,44918,3578751333,3578751333,0
0,1324,44919,3578751333,3578751336,3
0,1324,44920,3578751333,3578751336,3
0,1324,44921,3578751333,3578751336,3
0,1324,44922,3578751333,3578751339,6
0,1324,44923,3578751333,3578751340,7
0,1324,44924,3578751333,3578751340,7
0,1324,44925,3578751333,3578751340,7
0,1324,44926,3578751333,3578751341,8
0,1324,44927,3578751333,3578751341,8
0,1324,44928,3578751333,3578751341,8
0,1324,44929,3578751333,3578751342,9
0,1324,44930,3578751333,3578751342,9
0,1324,44931,3578751333,3578751344,11
0,1324,44932,3578751333,3578751344,11
0,1324,44933,3578751333,3578751344,11
0,1324,44934,3578751333,3578751344,11
0,1324,44935,3578751333,3578751345,12
0,1324,44936,3578751333,3578751345,12
0,1324,44937,3578751333,3578751346,13
0,1324,44938,3578751333,3578751346,13
0,1324,44939,3578751333,3578751347,14
0,1324,44940,3578751333,3578751347,14
0,1324,44941,3578751333,3578751349,16
0,1324,44942,3578751333,3578751349,16
0,1324,44943,3578751333,3578751351,18
0,1324,44944,3578751333,3578751352,19
0,1324,44945,3578751333,3578751353,20
0,1324,44946,3578751333,3578751353,20
0,1324,44947,3578751333,3578751354,21
0,1324,44948,3578751333,3578751355,22
0,1324,44949,3578751333,3578751356,23
0,1324,44950,3578751333,3578751356,23
0,1324,44951,3578751333,3578751357,24
0,1324,44952,3578751333,3578751357,24
0,1324,44953,3578751333,3578751358,25
0,1324,44954,3578751333,3578751359,26
0,1324,44955,3578751333,3578751359,26
0,1324,44956,3578751333,3578751361,28
0,1324,44957,3578751333,3578751361,28
0,1324,44958,3578751333,3578751361,28
0,1324,44959,3578751333,3578751361,28
0,1324,44960,3578751333,3578751362,29
0,1324,44961,3578751333,3578751362,29
0,1324,44962,3578751333,3578751364,31
0,1324,44963,3578751333,3578751365,32
0,1324,44964,3578751333,3578751365,32
0,1324,44965,3578751333,3578751366,33
0,1324,44966,3578751333,3578751366,33
0,1324,44967,3578751333,3578751367,34
0,1324,44968,3578751333,3578751367,34
0,1324,44969,3578751333,3578751369,36
0,1324,44970,3578751333,3578751369,36
0,1324,44971,3578751333,3578751370,37
0,1324,44972,3578751333,3578751370,37
0,1324,44973,3578751333,3578751372,39
0,1324,44974,3578751333,3578751372,39
0,1324,44975,3578751333,3578751373,40
0,1324,44976,3578751333,3578751373,40
0,1324,44977,3578751333,3578751374,41
0,1324,44978,3578751333,3578751375,42
0,1324,44979,3578751333,3578751376,43
0,1324,44980,3578751333,3578751378,45
0,1324,44981,3578751333,3578751378,45
0,1324,44982,3578751333,3578751379,46
0,1324,44983,3578751333,3578751379,46
0,1324,44984,3578751333,3578751380,47
0,1324,44985,3578751333,3578751380,47
0,1324,44986,3578751333,3578751381,48
0,1324,44987,3578751333,3578751382,49
0,1325,44988,3578751396,3578751396,0
0,1325,44989,3578751396,3578751396,0
0,1325,44990,3578751396,3578751396,0
0,1325,44991,3578751396,3578751396,0
0,1325,44992,3578751396,3578751396,0
0,1325,44993,3578751396,3578751396,0
0,1325,44994,3578751396,3578751396,0
0,1325,44995,3578751396,3578751396,0
0,1325,44996,3578751396,3578751396,0
0,1325,44997,3578751396,3578751396,0
0,1325,44998,3578751396,3578751396,0
0,1325,44999,3578751396,3578751396,0
0,1325,45000,3578751396,3578751396,0
0,1325,45001,3578751396,3578751396,0
0,1325,45002,3578751396,3578751396,0
0,1325,45003,3578751396,3578751396,0
0,1325,45004,3578751396,3578751400,4
0,1325,45005,3578751396,3578751400,4
0,1325,45006,3578751396,3578751401,5
0,1325,45007,3578751396,3578751401,5
0,1325,45008,3578751396,3578751403,7
0,1325,45009,3578751396,3578751404,8
0,1325,45010,3578751396,3578751404,8
0,1325,45011,3578751396,3578751404,8
0,1325,45012,3578751396,3578751405,9
0,1325,45013,3578751396,3578751405,9
0,1325,45014,3578751396,3578751405,9
0,1325,45015,3578751396,3578751406,10
0,1325,45016,3578751396,3578751406,10
0,1325,45017,3578751396,3578751407,11
0,1325,45018,3578751396,3578751407,11
0,1325,45019,3578751396,3578751408,12
0,1325,45020,3578751396,3578751408,12
0,1325,45021,3578751396,3578751408,12
0,1325,45022,3578751396,3578751410,14
0,1325,45023,3578751396,3578751411,15
0,1325,45024,3578751396,3578751414,18
0,1325,45025,3578751396,3578751414,18
0,1325,45026,3578751396,3578751415,19
0,1325,45027,3578751396,3578751415,19
0,1325,45028,3578751396,3578751415,19
0,1325,45029,3578751396,3578751415,19
0,1325,45030,3578751396,3578751416,20
0,1325,45031,3578751396,3578751416,20
0,1325,45032,3578751396,3578751416,20
0,1325,45033,3578751396,3578751418,22
0,1325,45034,3578751396,3578751418,22
0,1325,45035,3578751396,3578751419,23
0,1325,45036,3578751396,3578751420,24
0,1325,45037,3578751396,3578751420,24
0,1325,45038,3578751396,3578751420,24
0,1325,45039,3578751396,3578751421,25
0,1325,45040,3578751396,3578751422,26
0,1325,45041,3578751396,3578751422,26
0,1325,45042,3578751396,3578751423,27
0,1325,45043,3578751396,3578751424,28
0,1325,45044,3578751396,3578751427,31
0,1325,45045,3578751396,3578751428,32
0,1325,45046,3578751396,3578751429,33
0,1325,45047,3578751396,3578751430,34
0,1325,45048,3578751396,3578751431,35
0,1325,45049,3578751396,3578751431,35
0,1325,45050,3578751396,3578751433,37
0,1325,45051,3578751396,3578751434,38
0,1325,45052,3578751396,3578751434,38
0,1325,45053,3578751396,3578751435,39
0,1325,45054,3578751396,3578751435,39
0,1325,45055,3578751396,3578751436,40
0,1325,45056,3578751396,3578751436,40
0,1325,45057,3578751396,3578751438,42
0,1325,45058,3578751396,3578751439,43
0,1325,45059,3578751396,3578751440,44
0,1325,45060,3578751396,3578751440,44
0,1325,45061,3578751396,3578751440,44
0,1325,45062,3578751396,3578751440,44
0,1325,45063,3578751396,3578751440,44
0,1325,45064,3578751396,3578751442,46
0,1325,45065,3578751396,3578751442,46
0,1325,45066,3578751396,3578751443,47
0,1325,45067,3578751396,3578751444,48
0,1325,45068,3578751396,3578751445,49
0,1326,45069,3578751458,3578751458,0
0,1326,45070,3578751458,3578751458,0
0,1326,45071,3578751458,3578751458,0
0,1326,45072,3578751458,3578751458,0
0,1326,45073,3578751458,3578751458,0
0,1326,45074,3578751458,3578751458,0
0,1326,45075,3578751458,3578751458,0
0,1326,45076,3578751458,3578751458,0
0,1326,45077,3578751458,3578751458,0
0,1326,45078,3578751458,3578751458,0
0,1326,45079,3578751458,3578751458,0
0,1326,45080,3578751458,3578751458,0
0,1326,45081,3578751458,3578751458,0
0,1326,45082,3578751458,3578751458,0
0,1326,45083,3578751458,3578751458,0
0,1326,45084,3578751458,3578751459,1
0,1326,45085,3578751458,3578751459,1
0,1326,45086,3578751458,3578751462,4
0,1326,45087,3578751458,3578751462,4
0,1326,45088,3578751458,3578751463,5
0,1326,45089,3578751458,3578751464,6
0,1326,45090,3578751458,3578751464,6
0,1326,45091,3578751458,3578751465,7
0,1326,45092,3578751458,3578751465,7
0,1326,45093,3578751458,3578751466,8
0,1326,45094,3578751458,3578751467,9
0,1326,45095,3578751458,3578751467,9
0,1326,45096,3578751458,3578751467,9
0,1326,45097,3578751458,3578751467,9
0,1326,45098,3578751458,3578751468,10
0,1326,45099,3578751458,3578751471,13
0,1326,45100,3578751458,3578751479,21
0,1326,45101,3578751458,3578751479,21
0,1326,45102,3578751458,3578751480,22
0,1326,45103,3578751458,3578751480,22
0,1326,45104,3578751458,3578751481,23
0,1326,45105,3578751458,3578751482,24
0,1326,45106,3578751458,3578751483,25
0,1326,45107,3578751458,3578751485,27
0,1326,45108,3578751458,3578751486,28
0,1326,45109,3578751458,3578751487,29
0,1326,45110,3578751458,3578751487,29
0,1326,45111,3578751458,3578751487,29
0,1326,45112,3578751458,3578751487,29
0,1326,45113,3578751458,3578751487,29
0,1326,45114,3578751458,3578751489,31
0,1326,45115,3578751458,3578751489,31
0,1326,45116,3578751458,3578751489,31
0,1326,45117,3578751458,3578751489,31
0,1326,45118,3578751458,3578751490,32
0,1326,45119,3578751458,3578751490,32
0,1326,45120,3578751458,3578751491,33
0,1326,45121,3578751458,3578751491,33
0,1326,45122,3578751458,3578751492,34
0,1326,45123,3578751458,3578751493,35
0,1326,45124,3578751458,3578751493,35
0,1326,45125,3578751458,3578751494,36
0,1326,45126,3578751458,3578751494,36
0,1326,45127,3578751458,3578751494,36
0,1326,45128,3578751458,3578751494,36
0,1326,45129,3578751458,3578751494,36
0,1326,45130,3578751458,3578751496,38
0,1326,45131,3578751458,3578751496,38
0,1326,45132,3578751458,3578751496,38
0,1326,45133,3578751458,3578751497,39
0,1326,45134,3578751458,3578751498,40
0,1326,45135,3578751458,3578751499,41
0,1326,45136,3578751458,3578751501,43
0,1326,45137,3578751458,3578751503,45
0,1326,45138,3578751458,3578751504,46
0,1326,45139,3578751458,3578751504,46
0,1326,45140,3578751458,3578751504,46
0,1326,45141,3578751458,3578751506,48
0,1326,45142,3578751458,3578751506,48
0,1326,45143,3578751458,3578751506,48
0,1326,45144,3578751458,3578751506,48
0,1326,45145,3578751458,3578751507,49
0,1326,45146,3578751458,3578751508,50
0,1327,45147,3578751521,3578751521,0
0,1327,45148,3578751521,3578751521,0
0,1327,45149,3578751521,3578751521,0
0,1327,45150,3578751521,3578751521,0
0,1327,45151,3578751521,3578751521,0
0,1327,45152,3578751521,3578751521,0
0,1327,45153,3578751521,3578751521,0
0,1327,45154,3578751521,3578751521,0
0,1327,45155,3578751521,3578751521,0
0,1327,45156,3578751521,3578751521,0
0,1327,45157,3578751521,3578751521,0
0,1327,45158,3578751521,3578751521,0
0,1327,45159,3578751521,3578751521,0
0,1327,45160,3578751521,3578751521,0
0,1327,45161,3578751521,3578751521,0
0,1327,45162,3578751521,3578751521,0
0,1327,45163,3578751521,3578751521,0
0,1327,45164,3578751521,3578751521,0
0,1327,45165,3578751521,3578751521,0
0,1327,45166,3578751521,3578751521,0
0,1327,45167,3578751521,3578751521,0
0,1327,45168,3578751521,3578751521,0
0,1327,45169,3578751521,3578751521,0
0,1327,45170,3578751521,3578751521,0
0,1327,45171,3578751521,3578751521,0
0,1327,45172,3578751521,3578751521,0
0,1327,45173,3578751521,3578751521,0
0,1327,45174,3578751521,3578751521,0
0,1327,45175,3578751521,3578751521,0
0,1327,45176,3578751521,3578751521,0
0,1327,45177,3578751521,3578751521,0
0,1327,45178,3578751521,3578751521,0
0,1327,45179,3578751521,3578751521,0
0,1327,45180,3578751521,3578751521,0
0,1327,45181,3578751521,3578751522,1
0,1327,45182,3578751521,3578751522,1
0,1327,45183,3578751521,3578751523,2
0,1327,45184,3578751521,3578751523,2
0,1327,45185,3578751521,3578751524,3
0,1327,45186,3578751521,3578751525,4
0,1327,45187,3578751521,3578751526,5
0,1327,45188,3578751521,3578751526,5
0,1327,45189,3578751521,3578751526,5
0,1327,45190,3578751521,3578751527,6
0,1327,45191,3578751521,3578751527,6
0,1327,45192,3578751521,3578751527,6
0,1327,45193,3578751521,3578751528,7
0,1327,45194,3578751521,3578751528,7
0,1327,45195,3578751521,3578751528,7
0,1327,45196,3578751521,3578751528,7
0,1327,45197,3578751521,3578751529,8
0,1327,45198,3578751521,3578751530,9
0,1327,45199,3578751521,3578751530,9
0,1327,45200,3578751521,3578751530,9
0,1327,45201,3578751521,3578751530,9
0,1327,45202,3578751521,3578751532,11
0,1327,45203,3578751521,3578751533,12
0,1327,45204,3578751521,3578751535,14
0,1327,45205,3578751521,3578751535,14
0,1327,45206,3578751521,3578751535,14
0,1327,45207,3578751521,3578751539,18
0,1327,45208,3578751521,3578751539,18
0,1327,45209,3578751521,3578751540,19
0,1327,45210,3578751521,3578751540,19
0,1327,45211,3578751521,3578751541,20
0,1327,45212,3578751521,3578751541,20
0,1327,45213,3578751521,3578751541,20
0,1327,45214,3578751521,3578751542,21
0,1327,45215,3578751521,3578751542,21
0,1327,45216,3578751521,3578751542,21
0,1327,45217,3578751521,3578751543,22
0,1327,45218,3578751521,3578751543,22
0,1327,45219,3578751521,3578751543,22
0,1327,45220,3578751521,3578751544,23
0,1327,45221,3578751521,3578751544,23
0,1327,45222,3578751521,3578751545,24
0,1327,45223,3578751521,3578751545,24
0,1327,45224,3578751521,3578751545,24
0,1327,45225,3578751521,3578751546,25
0,1327,45226,3578751521,3578751546,25
0,1327,45227,3578751521,3578751547,26
0,1327,45228,3578751521,3578751547,26
0,1327,45229,3578751521,3578751548,27
0,1327,45230,3578751521,3578751551,30
0,1327,45231,3578751521,3578751551,30
0,1327,45232,3578751521,3578751551,30
0,1327,45233,3578751521,3578751551,30
0,1327,45234,3578751521,3578751553,32
0,1327,45235,3578751521,3578751554,33
0,1327,45236,3578751521,3578751555,34
0,1327,45237,3578751521,3578751555,34
0,1327,45238,3578751521,3578751556,35
0,1327,45239,3578751521,3578751557,36
0,1327,45240,3578751521,3578751557,36
0,1327,45241,3578751521,3578751559,38
0,1327,45242,3578751521,3578751559,38
0,1327,45243,3578751521,3578751560,39
0,1327,45244,3578751521,3578751560,39
0,1327,45245,3578751521,3578751561,40
0,1327,45246,3578751521,3578751561,40
0,1327,45247,3578751521,3578751562,41
0,1327,45248,3578751521,3578751563,42
0,1327,45249,3578751521,3578751563,42
0,1327,45250,3578751521,3578751564,43
0,1327,45251,3578751521,3578751564,43
0,1327,45252,3578751521,3578751564,43
0,1327,45253,3578751521,3578751565,44
0,1327,45254,3578751521,3578751566,45
0,1327,45255,3578751521,3578751568,47
0,1327,45256,3578751521,3578751568,47
0,1327,45257,3578751521,3578751569,48
0,1327,45258,3578751521,3578751569,48
0,1327,45259,3578751521,3578751570,49
0,1328,45260,3578751583,3578751583,0
0,1328,45261,3578751583,3578751583,0
0,1328,45262,3578751583,3578751583,0
0,1328,45263,3578751583,3578751583,0
0,1328,45264,3578751583,3578751583,0
0,1328,45265,3578751583,3578751583,0
0,1328,45266,3578751583,3578751583,0
0,1328,45267,3578751583,3578751583,0
0,1328,45268,3578751583,3578751583,0
0,1328,45269,3578751583,3578751583,0
0,1328,45270,3578751583,3578751583,0
0,1328,45271,3578751583,3578751583,0
0,1328,45272,3578751583,3578751583,0
0,1328,45273,3578751583,3578751583,0
0,1328,45274,3578751583,3578751583,0
0,1328,45275,3578751583,3578751584,1
0,1328,45276,3578751583,3578751585,2
0,1328,45277,3578751583,3578751585,2
0,1328,45278,3578751583,3578751585,2
0,1328,45279,3578751583,3578751586,3
0,1328,45280,3578751583,3578751587,4
0,1328,45281,3578751583,3578751589,6
0,1328,45282,3578751583,3578751589,6
0,1328,45283,3578751583,3578751591,8
0,1328,45284,3578751583,3578751591,8
0,1328,45285,3578751583,3578751592,9
0,1328,45286,3578751583,3578751592,9
0,1328,45287,3578751583,3578751593,10
0,1328,45288,3578751583,3578751593,10
0,1328,45289,3578751583,3578751599,16
0,1328,45290,3578751583,3578751600,17
0,1328,45291,3578751583,3578751600,17
0,1328,45292,3578751583,3578751600,17
0,1328,45293,3578751583,3578751603,20
0,1328,45294,3578751583,3578751603,20
0,1328,45295,3578751583,3578751604,21
0,1328,45296,3578751583,3578751604,21
0,1328,45297,3578751583,3578751604,21
0,1328,45298,3578751583,3578751605,22
0,1328,45299,3578751583,3578751605,22
0,1328,45300,3578751583,3578751605,22
0,1328,45301,3578751583,3578751606,23
0,1328,45302,3578751583,3578751606,23
0,1328,45303,3578751583,3578751607,24
0,1328,45304,3578751583,3578751607,24
0,1328,45305,3578751583,3578751607,24
0,1328,45306,3578751583,3578751609,26
0,1328,45307,3578751583,3578751610,27
0,1328,45308,3578751583,3578751613,30
0,1328,45309,3578751583,3578751613,30
0,1328,45310,3578751583,3578751614,31
0,1328,45311,3578751583,3578751614,31
0,1328,45312,3578751583,3578751614,31
0,1328,45313,3578751583,3578751614,31
0,1328,45314,3578751583,3578751615,32
0,1328,45315,3578751583,3578751615,32
0,1328,45316,3578751583,3578751615,32
0,1328,45317,3578751583,3578751615,32
0,1328,45318,3578751583,3578751617,34
0,1328,45319,3578751583,3578751617,34
0,1328,45320,3578751583,3578751617,34
0,1328,45321,3578751583,3578751618,35
0,1328,45322,3578751583,3578751618,35
0,1328,45323,3578751583,3578751618,35
0,1328,45324,3578751583,3578751620,37
0,1328,45325,3578751583,3578751620,37
0,1328,45326,3578751583,3578751621,38
0,1328,45327,3578751583,3578751621,38
0,1328,45328,3578751583,3578751622,39
0,1328,45329,3578751583,3578751622,39
0,1328,45330,3578751583,3578751623,40
0,1328,45331,3578751583,3578751623,40
0,1328,45332,3578751583,3578751626,43
0,1328,45333,3578751583,3578751627,44
0,1328,45334,3578751583,3578751628,45
0,1328,45335,3578751583,3578751629,46
0,1328,45336,3578751583,3578751629,46
0,1328,45337,3578751583,3578751631,48
0,1328,45338,3578751583,3578751632,49
0,1328,45339,3578751583,3578751633,50
0,1329,45340,3578751645,3578751645,0
0,1329,45341,3578751645,3578751645,0
0,1329,45342,3578751645,3578751645,0
0,1329,45343,3578751645,3578751645,0
0,1329,45344,3578751645,3578751645,0
0,1329,45345,3578751645,3578751645,0
0,1329,45346,3578751645,3578751645,0
0,1329,45347,3578751645,3578751645,0
0,1329,45348,3578751645,3578751645,0
0,1329,45349,3578751645,3578751645,0
0,1329,45350,3578751645,3578751645,0
0,1329,45351,3578751645,3578751645,0
0,1329,45352,3578751645,3578751645,0
0,1329,45353,3578751645,3578751645,0
0,1329,45354,3578751645,3578751645,0
0,1329,45355,3578751645,3578751645,0
0,1329,45356,3578751645,3578751645,0
0,1329,45357,3578751645,3578751645,0
0,1329,45358,3578751645,3578751645,0
0,1329,45359,3578751645,3578751645,0
0,1329,45360,3578751645,3578751647,2
0,1329,45361,3578751645,3578751647,2
0,1329,45362,3578751645,3578751647,2
0,1329,45363,3578751645,3578751649,4
0,1329,45364,3578751645,3578751649,4
0,1329,45365,3578751645,3578751649,4
0,1329,45366,3578751645,3578751650,5
0,1329,45367,3578751645,3578751651,6
0,1329,45368,3578751645,3578751652,7
0,1329,45369,3578751645,3578751654,9
0,1329,45370,3578751645,3578751655,10
0,1329,45371,3578751645,3578751656,11
0,1329,45372,3578751645,3578751656,11
0,1329,45373,3578751645,3578751656,11
0,1329,45374,3578751645,3578751657,12
0,1329,45375,3578751645,3578751657,12
0,1329,45376,3578751645,3578751659,14
0,1329,45377,3578751645,3578751661,16
0,1329,45378,3578751645,3578751661,16
0,1329,45379,3578751645,3578751662,17
0,1329,45380,3578751645,3578751664,19
0,1329,45381,3578751645,3578751664,19
0,1329,45382,3578751645,3578751664,19
0,1329,45383,3578751645,3578751664,19
0,1329,45384,3578751645,3578751665,20
0,1329,45385,3578751645,3578751665,20
0,1329,45386,3578751645,3578751666,21
0,1329,45387,3578751645,3578751667,22
0,1329,45388,3578751645,3578751667,22
0,1329,45389,3578751645,3578751667,22
0,1329,45390,3578751645,3578751679,34
0,1329,45391,3578751645,3578751679,34
0,1329,45392,3578751645,3578751680,35
0,1329,45393,3578751645,3578751680,35
0,1329,45394,3578751645,3578751681,36
0,1329,45395,3578751645,3578751682,37
0,1329,45396,3578751645,3578751683,38
0,1329,45397,3578751645,3578751685,40
0,1329,45398,3578751645,3578751686,41
0,1329,45399,3578751645,3578751686,41
0,1329,45400,3578751645,3578751686,41
0,1329,45401,3578751645,3578751687,42
0,1329,45402,3578751645,3578751687,42
0,1329,45403,3578751645,3578751687,42
0,1329,45404,3578751645,3578751688,43
0,1329,45405,3578751645,3578751689,44
0,1329,45406,3578751645,3578751690,45
0,1329,45407,3578751645,3578751690,45
0,1329,45408,3578751645,3578751690,45
0,1329,45409,3578751645,3578751691,46
0,1329,45410,3578751645,3578751691,46
0,1329,45411,3578751645,3578751693,48
0,1329,45412,3578751645,3578751693,48
0,1329,45413,3578751645,3578751694,49
0,1329,45414,3578751645,3578751694,49
0,1329,45415,3578751645,3578751694,49
0,1329,45416,3578751645,3578751694,49
0,1329,45417,3578751645,3578751694,49
0,1329,45418,3578751645,3578751695,50
0,1330,45419,3578751707,3578751707,0
0,1330,45420,3578751707,3578751707,0
0,1330,45421,3578751707,3578751707,0
0,1330,45422,3578751707,3578751707,0
0,1330,45423,3578751707,3578751707,0
0,1330,45424,3578751707,3578751707,0
0,1330,45425,3578751707,3578751707,0
0,1330,45426,3578751707,3578751707,0
0,1330,45427,3578751707,3578751707,0
0,1330,45428,3578751707,3578751707,0
0,1330,45429,3578751707,3578751707,0
0,1330,45430,3578751707,3578751707,0
0,1330,45431,3578751707,3578751707,0
0,1330,45432,3578751707,3578751707,0
0,1330,45433,3578751707,3578751707,0
0,1330,45434,3578751707,3578751708,1
0,1330,45435,3578751707,3578751708,1
0,1330,45436,3578751707,3578751709,2
0,1330,45437,3578751707,3578751710,3
0,1330,45438,3578751707,3578751710,3
0,1330,45439,3578751707,3578751711,4
0,1330,45440,3578751707,3578751711,4
0,1330,45441,3578751707,3578751711,4
0,1330,45442,3578751707,3578751712,5
0,1330,45443,3578751707,3578751712,5
0,1330,45444,3578751707,3578751713,6
0,1330,45445,3578751707,3578751713,6
0,1330,45446,3578751707,3578751713,6
0,1330,45447,3578751707,3578751714,7
0,1330,45448,3578751707,3578751714,7
0,1330,45449,3578751707,3578751714,7
0,1330,45450,3578751707,3578751714,7
0,1330,45451,3578751707,3578751716,9
0,1330,45452,3578751707,3578751716,9
0,1330,45453,3578751707,3578751716,9
0,1330,45454,3578751707,3578751716,9
0,1330,45455,3578751707,3578751717,10
0,1330,45456,3578751707,3578751717,10
0,1330,45457,3578751707,3578751717,10
0,1330,45458,3578751707,3578751717,10
0,1330,45459,3578751707,3578751718,11
0,1330,45460,3578751707,3578751718,11
0,1330,45461,3578751707,3578751719,12
0,1330,45462,3578751707,3578751719,12
0,1330,45463,3578751707,3578751719,12
0,1330,45464,3578751707,3578751719,12
0,1330,45465,3578751707,3578751720,13
0,1330,45466,3578751707,3578751720,13
0,1330,45467,3578751707,3578751721,14
0,1330,45468,3578751707,3578751722,15
0,1330,45469,3578751707,3578751722,15
0,1330,45470,3578751707,3578751723,16
0,1330,45471,3578751707,3578751723,16
0,1330,45472,3578751707,3578751725,18
0,1330,45473,3578751707,3578751725,18
0,1330,45474,3578751707,3578751726,19
0,1330,45475,3578751707,3578751727,20
0,1330,45476,3578751707,3578751727,20
0,1330,45477,3578751707,3578751727,20
0,1330,45478,3578751707,3578751728,21
0,1330,45479,3578751707,3578751728,21
0,1330,45480,3578751707,3578751728,21
0,1330,45481,3578751707,3578751728,21
0,1330,45482,3578751707,3578751730,23
0,1330,45483,3578751707,3578751730,23
0,1330,45484,3578751707,3578751730,23
0,1330,45485,3578751707,3578751730,23
0,1330,45486,3578751707,3578751731,24
0,1330,45487,3578751707,3578751732,25
0,1330,45488,3578751707,3578751733,26
0,1330,45489,3578751707,3578751734,27
0,1330,45490,3578751707,3578751735,28
0,1330,45491,3578751707,3578751736,29
0,1330,45492,3578751707,3578751739,32
0,1330,45493,3578751707,3578751739,32
0,1330,45494,3578751707,3578751739,32
0,1330,45495,3578751707,3578751739,32
0,1330,45496,3578751707,3578751740,33
0,1330,45497,3578751707,3578751740,33
0,1330,45498,3578751707,3578751740,33
0,1330,45499,3578751707,3578751740,33
0,1330,45500,3578751707,3578751741,34
0,1330,45501,3578751707,3578751741,34
0,1330,45502,3578751707,3578751742,35
0,1330,45503,3578751707,3578751743,36
0,1330,45504,3578751707,3578751743,36
0,1330,45505,3578751707,3578751743,36
0,1330,45506,3578751707,3578751743,36
0,1330,45507,3578751707,3578751744,37
0,1330,45508,3578751707,3578751744,37
0,1330,45509,3578751707,3578751745,38
0,1330,45510,3578751707,3578751745,38
0,1330,45511,3578751707,3578751745,38
0,1330,45512,3578751707,3578751746,39
0,1330,45513,3578751707,3578751746,39
0,1330,45514,3578751707,3578751746,39
0,1330,45515,3578751707,3578751747,40
0,1330,45516,3578751707,3578751749,42
0,1330,45517,3578751707,3578751751,44
0,1330,45518,3578751707,3578751751,44
0,1330,45519,3578751707,3578751752,45
0,1330,45520,3578751707,3578751752,45
0,1330,45521,3578751707,3578751752,45
0,1330,45522,3578751707,3578751754,47
0,1330,45523,3578751707,3578751754,47
0,1330,45524,3578751707,3578751755,48
0,1330,45525,3578751707,3578751756,49
0,1330,45526,3578751707,3578751756,49
0,1330,45527,3578751707,3578751757,50
0,1331,45528,3578751770,3578751770,0
0,1331,45529,3578751770,3578751770,0
0,1331,45530,3578751770,3578751770,0
0,1331,45531,3578751770,3578751770,0
0,1331,45532,3578751770,3578751770,0
0,1331,45533,3578751770,3578751770,0
0,1331,45534,3578751770,3578751770,0
0,1331,45535,3578751770,3578751770,0
0,1331,45536,3578751770,3578751770,0
0,1331,45537,3578751770,3578751770,0
0,1331,45538,3578751770,3578751770,0
0,1331,45539,3578751770,3578751770,0
0,1331,45540,3578751770,3578751770,0
0,1331,45541,3578751770,3578751770,0
0,1331,45542,3578751770,3578751770,0
0,1331,45543,3578751770,3578751770,0
0,1331,45544,3578751770,3578751770,0
0,1331,45545,3578751770,3578751770,0
0,1331,45546,3578751770,3578751771,1
0,1331,45547,3578751770,3578751772,2
0,1331,45548,3578751770,3578751773,3
0,1331,45549,3578751770,3578751773,3
0,1331,45550,3578751770,3578751774,4
0,1331,45551,3578751770,3578751775,5
0,1331,45552,3578751770,3578751776,6
0,1331,45553,3578751770,3578751777,7
0,1331,45554,3578751770,3578751778,8
0,1331,45555,3578751770,3578751779,9
0,1331,45556,3578751770,3578751779,9
0,1331,45557,3578751770,3578751779,9
0,1331,45558,3578751770,3578751780,10
0,1331,45559,3578751770,3578751780,10
0,1331,45560,3578751770,3578751781,11
0,1331,45561,3578751770,3578751781,11
0,1331,45562,3578751770,3578751783,13
0,1331,45563,3578751770,3578751784,14
0,1331,45564,3578751770,3578751785,15
0,1331,45565,3578751770,3578751785,15
0,1331,45566,3578751770,3578751786,16
0,1331,45567,3578751770,3578751786,16
0,1331,45568,3578751770,3578751787,17
0,1331,45569,3578751770,3578751788,18
0,1331,45570,3578751770,3578751788,18
0,1331,45571,3578751770,3578751789,19
0,1331,45572,3578751770,3578751791,21
0,1331,45573,3578751770,3578751791,21
0,1331,45574,3578751770,3578751792,22
0,1331,45575,3578751770,3578751793,23
0,1331,45576,3578751770,3578751793,23
0,1331,45577,3578751770,3578751794,24
0,1331,45578,3578751770,3578751795,25
0,1331,45579,3578751770,3578751799,29
0,1331,45580,3578751770,3578751800,30
0,1331,45581,3578751770,3578751800,30
0,1331,45582,3578751770,3578751803,33
0,1331,45583,3578751770,3578751803,33
0,1331,45584,3578751770,3578751803,33
0,1331,45585,3578751770,3578751804,34
0,1331,45586,3578751770,3578751804,34
0,1331,45587,3578751770,3578751805,35
0,1331,45588,3578751770,3578751805,35
0,1331,45589,3578751770,3578751806,36
0,1331,45590,3578751770,3578751806,36
0,1331,45591,3578751770,3578751807,37
0,1331,45592,3578751770,3578751807,37
0,1331,45593,3578751770,3578751807,37
0,1331,45594,3578751770,3578751808,38
0,1331,45595,3578751770,3578751809,39
0,1331,45596,3578751770,3578751809,39
0,1331,45597,3578751770,3578751813,43
0,1331,45598,3578751770,3578751814,44
0,1331,45599,3578751770,3578751814,44
0,1331,45600,3578751770,3578751814,44
0,1331,45601,3578751770,3578751815,45
0,1331,45602,3578751770,3578751815,45
0,1331,45603,3578751770,3578751815,45
0,1331,45604,3578751770,3578751815,45
0,1331,45605,3578751770,3578751816,46
0,1331,45606,3578751770,3578751818,48
0,1331,45607,3578751770,3578751818,48
0,1331,45608,3578751770,3578751818,48
0,1331,45609,3578751770,3578751818,48
0,1331,45610,3578751770,3578751819,49
0,1331,45611,3578751770,3578751819,49
0,1331,45612,3578751770,3578751819,49
0,1331,45613,3578751770,3578751819,49
0,1331,45614,3578751770,3578751820,50
0,1332,45615,3578751833,3578751833,0
0,1332,45616,3578751833,3578751833,0
0,1332,45617,3578751833,3578751833,0
0,1332,45618,3578751833,3578751833,0
0,1332,45619,3578751833,3578751833,0
0,1332,45620,3578751833,3578751833,0
0,1332,45621,3578751833,3578751834,1
0,1332,45622,3578751833,3578751834,1
0,1332,45623,3578751833,3578751834,1
0,1332,45624,3578751833,3578751834,1
0,1332,45625,3578751833,3578751834,1
0,1332,45626,3578751833,3578751834,1
0,1332,45627,3578751833,3578751834,1
0,1332,45628,3578751833,3578751834,1
0,1332,45629,3578751833,3578751834,1
0,1332,45630,3578751833,3578751836,3
0,1332,45631,3578751833,3578751836,3
0,1332,45632,3578751833,3578751836,3
0,1332,45633,3578751833,3578751838,5
0,1332,45634,3578751833,3578751838,5
0,1332,45635,3578751833,3578751839,6
0,1332,45636,3578751833,3578751839,6
0,1332,45637,3578751833,3578751839,6
0,1332,45638,3578751833,3578751840,7
0,1332,45639,3578751833,3578751840,7
0,1332,45640,3578751833,3578751841,8
0,1332,45641,3578751833,3578751841,8
0,1332,45642,3578751833,3578751843,10
0,1332,45643,3578751833,3578751843,10
0,1332,45644,3578751833,3578751844,11
0,1332,45645,3578751833,3578751844,11
0,1332,45646,3578751833,3578751845,12
0,1332,45647,3578751833,3578751847,14
0,1332,45648,3578751833,3578751848,15
0,1332,45649,3578751833,3578751848,15
0,1332,45650,3578751833,3578751849,16
0,1332,45651,3578751833,3578751849,16
0,1332,45652,3578751833,3578751849,16
0,1332,45653,3578751833,3578751849,16
0,1332,45654,3578751833,3578751850,17
0,1332,45655,3578751833,3578751852,19
0,1332,45656,3578751833,3578751853,20
0,1332,45657,3578751833,3578751855,22
0,1332,45658,3578751833,3578751855,22
0,1332,45659,3578751833,3578751856,23
0,1332,45660,3578751833,3578751856,23
0,1332,45661,3578751833,3578751858,25
0,1332,45662,3578751833,3578751858,25
0,1332,45663,3578751833,3578751859,26
0,1332,45664,3578751833,3578751859,26
0,1332,45665,3578751833,3578751861,28
0,1332,45666,3578751833,3578751862,29
0,1332,45667,3578751833,3578751862,29
0,1332,45668,3578751833,3578751864,31
0,1332,45669,3578751833,3578751864,31
0,1332,45670,3578751833,3578751864,31
0,1332,45671,3578751833,3578751864,31
0,1332,45672,3578751833,3578751865,32
0,1332,45673,3578751833,3578751865,32
0,1332,45674,3578751833,3578751866,33
0,1332,45675,3578751833,3578751867,34
0,1332,45676,3578751833,3578751867,34
0,1332,45677,3578751833,3578751867,34
0,1332,45678,3578751833,3578751879,46
0,1332,45679,3578751833,3578751880,47
0,1332,45680,3578751833,3578751880,47
0,1332,45681,3578751833,3578751880,47
0,1332,45682,3578751833,3578751881,48
0,1332,45683,3578751833,3578751883,50
0,1333,45684,3578751895,3578751895,0
0,1333,45685,3578751895,3578751895,0
0,1333,45686,3578751895,3578751895,0
0,1333,45687,3578751895,3578751895,0
0,1333,45688,3578751895,3578751895,0
0,1333,45689,3578751895,3578751895,0
0,1333,45690,3578751895,3578751895,0
0,1333,45691,3578751895,3578751895,0
0,1333,45692,3578751895,3578751895,0
0,1333,45693,3578751895,3578751895,0
0,1333,45694,3578751895,3578751895,0
0,1333,45695,3578751895,3578751895,0
0,1333,45696,3578751895,3578751895,0
0,1333,45697,3578751895,3578751895,0
0,1333,45698,3578751895,3578751895,0
0,1333,45699,3578751895,3578751895,0
0,1333,45700,3578751895,3578751895,0
0,1333,45701,3578751895,3578751895,0
0,1333,45702,3578751895,3578751895,0
0,1333,45703,3578751895,3578751895,0
0,1333,45704,3578751895,3578751895,0
0,1333,45705,3578751895,3578751895,0
0,1333,45706,3578751895,3578751896,1
0,1333,45707,3578751895,3578751896,1
0,1333,45708,3578751895,3578751896,1
0,1333,45709,3578751895,3578751896,1
0,1333,45710,3578751895,3578751899,4
0,1333,45711,3578751895,3578751902,7
0,1333,45712,3578751895,3578751903,8
0,1333,45713,3578751895,3578751904,9
0,1333,45714,3578751895,3578751904,9
0,1333,45715,3578751895,3578751904,9
0,1333,45716,3578751895,3578751906,11
0,1333,45717,3578751895,3578751907,12
0,1333,45718,3578751895,3578751907,12
0,1333,45719,3578751895,3578751908,13
0,1333,45720,3578751895,3578751908,13
0,1333,45721,3578751895,3578751908,13
0,1333,45722,3578751895,3578751908,13
0,1333,45723,3578751895,3578751909,14
0,1333,45724,3578751895,3578751909,14
0,1333,45725,3578751895,3578751910,15
0,1333,45726,3578751895,3578751910,15
0,1333,45727,3578751895,3578751910,15
0,1333,45728,3578751895,3578751910,15
0,1333,45729,3578751895,3578751911,16
0,1333,45730,3578751895,3578751912,17
0,1333,45731,3578751895,3578751912,17
0,1333,45732,3578751895,3578751914,19
0,1333,45733,3578751895,3578751914,19
0,1333,45734,3578751895,3578751914,19
0,1333,45735,3578751895,3578751914,19
0,1333,45736,3578751895,3578751915,20
0,1333,45737,3578751895,3578751916,21
0,1333,45738,3578751895,3578751916,21
0,1333,45739,3578751895,3578751917,22
0,1333,45740,3578751895,3578751917,22
0,1333,45741,3578751895,3578751917,22
0,1333,45742,3578751895,3578751917,22
0,1333,45743,3578751895,3578751918,23
0,1333,45744,3578751895,3578751918,23
0,1333,45745,3578751895,3578751919,24
0,1333,45746,3578751895,3578751919,24
0,1333,45747,3578751895,3578751919,24
0,1333,45748,3578751895,3578751920,25
0,1333,45749,3578751895,3578751921,26
0,1333,45750,3578751895,3578751922,27
0,1333,45751,3578751895,3578751922,27
0,1333,45752,3578751895,3578751922,27
0,1333,45753,3578751895,3578751923,28
0,1333,45754,3578751895,3578751924,29
0,1333,45755,3578751895,3578751924,29
0,1333,45756,3578751895,3578751925,30
0,1333,45757,3578751895,3578751925,30
0,1333,45758,3578751895,3578751926,31
0,1333,45759,3578751895,3578751926,31
0,1333,45760,3578751895,3578751927,32
0,1333,45761,3578751895,3578751927,32
0,1333,45762,3578751895,3578751927,32
0,1333,45763,3578751895,3578751927,32
0,1333,45764,3578751895,3578751928,33
0,1333,45765,3578751895,3578751928,33
0,1333,45766,3578751895,3578751928,33
0,1333,45767,3578751895,3578751929,34
0,1333,45768,3578751895,3578751930,35
0,1333,45769,3578751895,3578751930,35
0,1333,45770,3578751895,3578751931,36
0,1333,45771,3578751895,3578751931,36
0,1333,45772,3578751895,3578751931,36
0,1333,45773,3578751895,3578751932,37
0,1333,45774,3578751895,3578751932,37
0,1333,45775,3578751895,3578751935,40
0,1333,45776,3578751895,3578751935,40
0,1333,45777,3578751895,3578751936,41
0,1333,45778,3578751895,3578751939,44
0,1333,45779,3578751895,3578751940,45
0,1333,45780,3578751895,3578751940,45
0,1333,45781,3578751895,3578751940,45
0,1333,45782,3578751895,3578751941,46
0,1333,45783,3578751895,3578751941,46
0,1333,45784,3578751895,3578751941,46
0,1333,45785,3578751895,3578751941,46
0,1333,45786,3578751895,3578751942,47
0,1333,45787,3578751895,3578751943,48
0,1333,45788,3578751895,3578751943,48
0,1333,45789,3578751895,3578751943,48
0,1333,45790,3578751895,3578751943,48
0,1333,45791,3578751895,3578751944,49
0,1333,45792,3578751895,3578751944,49
0,1333,45793,3578751895,3578751945,50
0,1334,45794,3578751957,3578751957,0
0,1334,45795,3578751957,3578751957,0
0,1334,45796,3578751957,3578751957,0
0,1334,45797,3578751957,3578751957,0
0,1334,45798,3578751957,3578751957,0
0,1334,45799,3578751957,3578751957,0
0,1334,45800,3578751957,3578751957,0
0,1334,45801,3578751957,3578751957,0
0,1334,45802,3578751957,3578751957,0
0,1334,45803,3578751957,3578751957,0
0,1334,45804,3578751957,3578751957,0
0,1334,45805,3578751957,3578751957,0
0,1334,45806,3578751957,3578751957,0
0,1334,45807,3578751957,3578751957,0
0,1334,45808,3578751957,3578751957,0
0,1334,45809,3578751957,3578751957,0
0,1334,45810,3578751957,3578751957,0
0,1334,45811,3578751957,3578751958,1
0,1334,45812,3578751957,3578751959,2
0,1334,45813,3578751957,3578751959,2
0,1334,45814,3578751957,3578751960,3
0,1334,45815,3578751957,3578751961,4
0,1334,45816,3578751957,3578751961,4
0,1334,45817,3578751957,3578751962,5
0,1334,45818,3578751957,3578751963,6
0,1334,45819,3578751957,3578751963,6
0,1334,45820,3578751957,3578751963,6
0,1334,45821,3578751957,3578751964,7
0,1334,45822,3578751957,3578751964,7
0,1334,45823,3578751957,3578751965,8
0,1334,45824,3578751957,3578751965,8
0,1334,45825,3578751957,3578751966,9
0,1334,45826,3578751957,3578751966,9
0,1334,45827,3578751957,3578751966,9
0,1334,45828,3578751957,3578751969,12
0,1334,45829,3578751957,3578751969,12
0,1334,45830,3578751957,3578751969,12
0,1334,45831,3578751957,3578751969,12
0,1334,45832,3578751957,3578751970,13
0,1334,45833,3578751957,3578751971,14
0,1334,45834,3578751957,3578751972,15
0,1334,45835,3578751957,3578751973,16
0,1334,45836,3578751957,3578751973,16
0,1334,45837,3578751957,3578751973,16
0,1334,45838,3578751957,3578751974,17
0,1334,45839,3578751957,3578751978,21
0,1334,45840,3578751957,3578751978,21
0,1334,45841,3578751957,3578751979,22
0,1334,45842,3578751957,3578751979,22
0,1334,45843,3578751957,3578751980,23
0,1334,45844,3578751957,3578751980,23
0,1334,45845,3578751957,3578751981,24
0,1334,45846,3578751957,3578751981,24
0,1334,45847,3578751957,3578751981,24
0,1334,45848,3578751957,3578751984,27
0,1334,45849,3578751957,3578751985,28
0,1334,45850,3578751957,3578751985,28
0,1334,45851,3578751957,3578751986,29
0,1334,45852,3578751957,3578751987,30
0,1334,45853,3578751957,3578751987,30
0,1334,45854,3578751957,3578751988,31
0,1334,45855,3578751957,3578751988,31
0,1334,45856,3578751957,3578751988,31
0,1334,45857,3578751957,3578751991,34
0,1334,45858,3578751957,3578751992,35
0,1334,45859,3578751957,3578751992,35
0,1334,45860,3578751957,3578751993,36
0,1334,45861,3578751957,3578751993,36
0,1334,45862,3578751957,3578751994,37
0,1334,45863,3578751957,3578751996,39
0,1334,45864,3578751957,3578751999,42
0,1334,45865,3578751957,3578752000,43
0,1334,45866,3578751957,3578752001,44
0,1334,45867,3578751957,3578752002,45
0,1334,45868,3578751957,3578752003,46
0,1334,45869,3578751957,3578752004,47
0,1334,45870,3578751957,3578752004,47
0,1334,45871,3578751957,3578752005,48
0,1334,45872,3578751957,3578752005,48
0,1334,45873,3578751957,3578752006,49
0,1334,45874,3578751957,3578752006,49
0,1334,45875,3578751957,3578752007,50
0,1334,45876,3578751957,3578752007,50
0,1335,45877,3578752018,3578752018,0
0,1335,45878,3578752018,3578752018,0
0,1335,45879,3578752018,3578752018,0
0,1335,45880,3578752018,3578752018,0
0,1335,45881,3578752018,3578752018,0
0,1335,45882,3578752018,3578752018,0
0,1335,45883,3578752018,3578752018,0
0,1335,45884,3578752018,3578752018,0
0,1335,45885,3578752018,3578752018,0
0,1335,45886,3578752018,3578752018,0
0,1335,45887,3578752018,3578752018,0
0,1335,45888,3578752018,3578752018,0
0,1335,45889,3578752018,3578752018,0
0,1335,45890,3578752018,3578752018,0
0,1335,45891,3578752018,3578752018,0
0,1335,45892,3578752018,3578752018,0
0,1335,45893,3578752018,3578752018,0
0,1335,45894,3578752018,3578752019,1
0,1335,45895,3578752018,3578752019,1
0,1335,45896,3578752018,3578752020,2
0,1335,45897,3578752018,3578752020,2
0,1335,45898,3578752018,3578752021,3
0,1335,45899,3578752018,3578752022,4
0,1335,45900,3578752018,3578752023,5
0,1335,45901,3578752018,3578752024,6
0,1335,45902,3578752018,3578752024,6
0,1335,45903,3578752018,3578752026,8
0,1335,45904,3578752018,3578752027,9
0,1335,45905,3578752018,3578752028,10
0,1335,45906,3578752018,3578752028,10
0,1335,45907,3578752018,3578752029,11
0,1335,45908,3578752018,3578752030,12
0,1335,45909,3578752018,3578752030,12
0,1335,45910,3578752018,3578752031,13
0,1335,45911,3578752018,3578752031,13
0,1335,45912,3578752018,3578752032,14
0,1335,45913,3578752018,3578752033,15
0,1335,45914,3578752018,3578752034,16
0,1335,45915,3578752018,3578752035,17
0,1335,45916,3578752018,3578752036,18
0,1335,45917,3578752018,3578752036,18
0,1335,45918,3578752018,3578752038,20
0,1335,45919,3578752018,3578752038,20
0,1335,45920,3578752018,3578752039,21
0,1335,45921,3578752018,3578752039,21
0,1335,45922,3578752018,3578752039,21
0,1335,45923,3578752018,3578752039,21
0,1335,45924,3578752018,3578752040,22
0,1335,45925,3578752018,3578752041,23
0,1335,45926,3578752018,3578752041,23
0,1335,45927,3578752018,3578752041,23
0,1335,45928,3578752018,3578752042,24
0,1335,45929,3578752018,3578752043,25
0,1335,45930,3578752018,3578752044,26
0,1335,45931,3578752018,3578752044,26
0,1335,45932,3578752018,3578752044,26
0,1335,45933,3578752018,3578752045,27
0,1335,45934,3578752018,3578752047,29
0,1335,45935,3578752018,3578752047,29
0,1335,45936,3578752018,3578752048,30
0,1335,45937,3578752018,3578752049,31
0,1335,45938,3578752018,3578752049,31
0,1335,45939,3578752018,3578752050,32
0,1335,45940,3578752018,3578752050,32
0,1335,45941,3578752018,3578752050,32
0,1335,45942,3578752018,3578752053,35
0,1335,45943,3578752018,3578752054,36
0,1335,45944,3578752018,3578752055,37
0,1335,45945,3578752018,3578752056,38
0,1335,45946,3578752018,3578752056,38
0,1335,45947,3578752018,3578752056,38
0,1335,45948,3578752018,3578752059,41
0,1335,45949,3578752018,3578752059,41
0,1335,45950,3578752018,3578752061,43
0,1335,45951,3578752018,3578752062,44
0,1335,45952,3578752018,3578752063,45
0,1335,45953,3578752018,3578752063,45
0,1335,45954,3578752018,3578752064,46
0,1335,45955,3578752018,3578752064,46
0,1335,45956,3578752018,3578752064,46
0,1335,45957,3578752018,3578752066,48
0,1335,45958,3578752018,3578752066,48
0,1335,45959,3578752018,3578752067,49
0,1335,45960,3578752018,3578752067,49
0,1335,45961,3578752018,3578752067,49
0,1336,45962,3578752080,3578752080,0
0,1336,45963,3578752080,3578752080,0
0,1336,45964,3578752080,3578752081,1
0,1336,45965,3578752080,3578752081,1
0,1336,45966,3578752080,3578752083,3
0,1336,45967,3578752080,3578752085,5
0,1336,45968,3578752080,3578752086,6
0,1336,45969,3578752080,3578752086,6
0,1336,45970,3578752080,3578752087,7
0,1336,45971,3578752080,3578752087,7
0,1336,45972,3578752080,3578752087,7
0,1336,45973,3578752080,3578752088,8
0,1336,45974,3578752080,3578752088,8
0,1336,45975,3578752080,3578752089,9
0,1336,45976,3578752080,3578752089,9
0,1336,45977,3578752080,3578752090,10
0,1336,45978,3578752080,3578752090,10
0,1336,45979,3578752080,3578752090,10
0,1336,45980,3578752080,3578752090,10
0,1336,45981,3578752080,3578752091,11
0,1336,45982,3578752080,3578752092,12
0,1336,45983,3578752080,3578752093,13
0,1336,45984,3578752080,3578752094,14
0,1336,45985,3578752080,3578752094,14
0,1336,45986,3578752080,3578752094,14
0,1336,45987,3578752080,3578752095,15
0,1336,45988,3578752080,3578752095,15
0,1336,45989,3578752080,3578752095,15
0,1336,45990,3578752080,3578752095,15
0,1336,45991,3578752080,3578752096,16
0,1336,45992,3578752080,3578752096,16
0,1336,45993,3578752080,3578752097,17
0,1336,45994,3578752080,3578752098,18
0,1336,45995,3578752080,3578752099,19
0,1336,45996,3578752080,3578752101,21
0,1336,45997,3578752080,3578752103,23
0,1336,45998,3578752080,3578752104,24
0,1336,45999,3578752080,3578752104,24
0,1336,46000,3578752080,3578752105,25
0,1336,46001,3578752080,3578752107,27
0,1336,46002,3578752080,3578752107,27
0,1336,46003,3578752080,3578752107,27
0,1336,46004,3578752080,3578752108,28
0,1336,46005,3578752080,3578752108,28
0,1336,46006,3578752080,3578752108,28
0,1336,46007,3578752080,3578752108,28
0,1336,46008,3578752080,3578752109,29
0,1336,46009,3578752080,3578752109,29
0,1336,46010,3578752080,3578752109,29
0,1336,46011,3578752080,3578752110,30
0,1336,46012,3578752080,3578752110,30
0,1336,46013,3578752080,3578752111,31
0,1336,46014,3578752080,3578752111,31
0,1336,46015,3578752080,3578752112,32
0,1336,46016,3578752080,3578752112,32
0,1336,46017,3578752080,3578752113,33
0,1336,46018,3578752080,3578752113,33
0,1336,46019,3578752080,3578752113,33
0,1336,46020,3578752080,3578752114,34
0,1336,46021,3578752080,3578752116,36
0,1336,46022,3578752080,3578752116,36
0,1336,46023,3578752080,3578752117,37
0,1336,46024,3578752080,3578752117,37
0,1336,46025,3578752080,3578752117,37
0,1336,46026,3578752080,3578752117,37
0,1336,46027,3578752080,3578752117,37
0,1336,46028,3578752080,3578752117,37
0,1336,46029,3578752080,3578752118,38
0,1336,46030,3578752080,3578752118,38
0,1336,46031,3578752080,3578752119,39
0,1336,46032,3578752080,3578752119,39
0,1336,46033,3578752080,3578752119,39
0,1336,46034,3578752080,3578752119,39
0,1336,46035,3578752080,3578752120,40
0,1336,46036,3578752080,3578752120,40
0,1336,46037,3578752080,3578752121,41
0,1336,46038,3578752080,3578752122,42
0,1336,46039,3578752080,3578752122,42
0,1336,46040,3578752080,3578752122,42
0,1336,46041,3578752080,3578752123,43
0,1336,46042,3578752080,3578752125,45
0,1336,46043,3578752080,3578752125,45
0,1336,46044,3578752080,3578752126,46
0,1336,46045,3578752080,3578752127,47
0,1336,46046,3578752080,3578752127,47
0,1336,46047,3578752080,3578752127,47
0,1336,46048,3578752080,3578752127,47
0,1336,46049,3578752080,3578752127,47
0,1336,46050,3578752080,3578752128,48
0,1336,46051,3578752080,3578752128,48
0,1336,46052,3578752080,3578752128,48
0,1336,46053,3578752080,3578752128,48
0,1336,46054,3578752080,3578752129,49
0,1336,46055,3578752080,3578752130,50
0,1337,46056,3578752142,3578752142,0
0,1337,46057,3578752142,3578752142,0
0,1337,46058,3578752142,3578752142,0
0,1337,46059,3578752142,3578752143,1
0,1337,46060,3578752142,3578752143,1
0,1337,46061,3578752142,3578752143,1
0,1337,46062,3578752142,3578752143,1
0,1337,46063,3578752142,3578752143,1
0,1337,46064,3578752142,3578752143,1
0,1337,46065,3578752142,3578752143,1
0,1337,46066,3578752142,3578752143,1
0,1337,46067,3578752142,3578752143,1
0,1337,46068,3578752142,3578752143,1
0,1337,46069,3578752142,3578752143,1
0,1337,46070,3578752142,3578752143,1
0,1337,46071,3578752142,3578752143,1
0,1337,46072,3578752142,3578752143,1
0,1337,46073,3578752142,3578752143,1
0,1337,46074,3578752142,3578752143,1
0,1337,46075,3578752142,3578752143,1
0,1337,46076,3578752142,3578752143,1
0,1337,46077,3578752142,3578752143,1
0,1337,46078,3578752142,3578752143,1
0,1337,46079,3578752142,3578752143,1
0,1337,46080,3578752142,3578752144,2
0,1337,46081,3578752142,3578752144,2
0,1337,46082,3578752142,3578752145,3
0,1337,46083,3578752142,3578752145,3
0,1337,46084,3578752142,3578752146,4
0,1337,46085,3578752142,3578752146,4
0,1337,46086,3578752142,3578752147,5
0,1337,46087,3578752142,3578752148,6
0,1337,46088,3578752142,3578752149,7
0,1337,46089,3578752142,3578752150,8
0,1337,46090,3578752142,3578752151,9
0,1337,46091,3578752142,3578752152,10
0,1337,46092,3578752142,3578752152,10
0,1337,46093,3578752142,3578752153,11
0,1337,46094,3578752142,3578752153,11
0,1337,46095,3578752142,3578752154,12
0,1337,46096,3578752142,3578752154,12
0,1337,46097,3578752142,3578752155,13
0,1337,46098,3578752142,3578752156,14
0,1337,46099,3578752142,3578752157,15
0,1337,46100,3578752142,3578752159,17
0,1337,46101,3578752142,3578752159,17
0,1337,46102,3578752142,3578752159,17
0,1337,46103,3578752142,3578752160,18
0,1337,46104,3578752142,3578752161,19
0,1337,46105,3578752142,3578752161,19
0,1337,46106,3578752142,3578752161,19
0,1337,46107,3578752142,3578752161,19
0,1337,46108,3578752142,3578752162,20
0,1337,46109,3578752142,3578752163,21
0,1337,46110,3578752142,3578752163,21
0,1337,46111,3578752142,3578752164,22
0,1337,46112,3578752142,3578752164,22
0,1337,46113,3578752142,3578752164,22
0,1337,46114,3578752142,3578752165,23
0,1337,46115,3578752142,3578752165,23
0,1337,46116,3578752142,3578752165,23
0,1337,46117,3578752142,3578752166,24
0,1337,46118,3578752142,3578752168,26
0,1337,46119,3578752142,3578752169,27
0,1337,46120,3578752142,3578752169,27
0,1337,46121,3578752142,3578752170,28
0,1337,46122,3578752142,3578752170,28
0,1337,46123,3578752142,3578752171,29
0,1337,46124,3578752142,3578752172,30
0,1337,46125,3578752142,3578752173,31
0,1337,46126,3578752142,3578752173,31
0,1337,46127,3578752142,3578752174,32
0,1337,46128,3578752142,3578752175,33
0,1337,46129,3578752142,3578752176,34
0,1337,46130,3578752142,3578752178,36
0,1337,46131,3578752142,3578752178,36
0,1337,46132,3578752142,3578752179,37
0,1337,46133,3578752142,3578752179,37
0,1337,46134,3578752142,3578752179,37
0,1337,46135,3578752142,3578752180,38
0,1337,46136,3578752142,3578752181,39
0,1337,46137,3578752142,3578752182,40
0,1337,46138,3578752142,3578752184,42
0,1337,46139,3578752142,3578752184,42
0,1337,46140,3578752142,3578752185,43
0,1337,46141,3578752142,3578752185,43
0,1337,46142,3578752142,3578752186,44
0,1337,46143,3578752142,3578752187,45
0,1337,46144,3578752142,3578752189,47
0,1337,46145,3578752142,3578752189,47
0,1337,46146,3578752142,3578752190,48
0,1337,46147,3578752142,3578752191,49
0,1337,46148,3578752142,3578752192,50
0,1338,46149,3578752205,3578752205,0
0,1338,46150,3578752205,3578752205,0
0,1338,46151,3578752205,3578752205,0
0,1338,46152,3578752205,3578752205,0
0,1338,46153,3578752205,3578752205,0
0,1338,46154,3578752205,3578752205,0
0,1338,46155,3578752205,3578752205,0
0,1338,46156,3578752205,3578752205,0
0,1338,46157,3578752205,3578752205,0
0,1338,46158,3578752205,3578752205,0
0,1338,46159,3578752205,3578752205,0
0,1338,46160,3578752205,3578752205,0
0,1338,46161,3578752205,3578752205,0
0,1338,46162,3578752205,3578752205,0
0,1338,46163,3578752205,3578752206,1
0,1338,46164,3578752205,3578752207,2
0,1338,46165,3578752205,3578752207,2
0,1338,46166,3578752205,3578752207,2
0,1338,46167,3578752205,3578752208,3
0,1338,46168,3578752205,3578752208,3
0,1338,46169,3578752205,3578752209,4
0,1338,46170,3578752205,3578752209,4
0,1338,46171,3578752205,3578752210,5
0,1338,46172,3578752205,3578752213,8
0,1338,46173,3578752205,3578752214,9
0,1338,46174,3578752205,3578752214,9
0,1338,46175,3578752205,3578752215,10
0,1338,46176,3578752205,3578752215,10
0,1338,46177,3578752205,3578752216,11
0,1338,46178,3578752205,3578752216,11
0,1338,46179,3578752205,3578752216,11
0,1338,46180,3578752205,3578752217,12
0,1338,46181,3578752205,3578752218,13
0,1338,46182,3578752205,3578752218,13
0,1338,46183,3578752205,3578752218,13
0,1338,46184,3578752205,3578752219,14
0,1338,46185,3578752205,3578752219,14
0,1338,46186,3578752205,3578752220,15
0,1338,46187,3578752205,3578752220,15
0,1338,46188,3578752205,3578752220,15
0,1338,46189,3578752205,3578752221,16
0,1338,46190,3578752205,3578752222,17
0,1338,46191,3578752205,3578752222,17
0,1338,46192,3578752205,3578752223,18
0,1338,46193,3578752205,3578752224,19
0,1338,46194,3578752205,3578752225,20
0,1338,46195,3578752205,3578752226,21
0,1338,46196,3578752205,3578752228,23
0,1338,46197,3578752205,3578752228,23
0,1338,46198,3578752205,3578752229,24
0,1338,46199,3578752205,3578752229,24
0,1338,46200,3578752205,3578752229,24
0,1338,46201,3578752205,3578752230,25
0,1338,46202,3578752205,3578752231,26
0,1338,46203,3578752205,3578752232,27
0,1338,46204,3578752205,3578752232,27
0,1338,46205,3578752205,3578752234,29
0,1338,46206,3578752205,3578752235,30
0,1338,46207,3578752205,3578752236,31
0,1338,46208,3578752205,3578752237,32
0,1338,46209,3578752205,3578752239,34
0,1338,46210,3578752205,3578752239,34
0,1338,46211,3578752205,3578752239,34
0,1338,46212,3578752205,3578752239,34
0,1338,46213,3578752205,3578752241,36
0,1338,46214,3578752205,3578752242,37
0,1338,46215,3578752205,3578752242,37
0,1338,46216,3578752205,3578752243,38
0,1338,46217,3578752205,3578752243,38
0,1338,46218,3578752205,3578752244,39
0,1338,46219,3578752205,3578752244,39
0,1338,46220,3578752205,3578752244,39
0,1338,46221,3578752205,3578752245,40
0,1338,46222,3578752205,3578752247,42
0,1338,46223,3578752205,3578752248,43
0,1338,46224,3578752205,3578752248,43
0,1338,46225,3578752205,3578752249,44
0,1338,46226,3578752205,3578752250,45
0,1338,46227,3578752205,3578752250,45
0,1338,46228,3578752205,3578752251,46
0,1338,46229,3578752205,3578752253,48
0,1338,46230,3578752205,3578752254,49
0,1338,46231,3578752205,3578752255,50
0,1339,46232,3578752268,3578752268,0
0,1339,46233,3578752268,3578752268,0
0,1339,46234,3578752268,3578752268,0
0,1339,46235,3578752268,3578752268,0
0,1339,46236,3578752268,3578752268,0
0,1339,46237,3578752268,3578752268,0
0,1339,46238,3578752268,3578752268,0
0,1339,46239,3578752268,3578752268,0
0,1339,46240,3578752268,3578752268,0
0,1339,46241,3578752268,3578752268,0
0,1339,46242,3578752268,3578752268,0
0,1339,46243,3578752268,3578752268,0
0,1339,46244,3578752268,3578752268,0
0,1339,46245,3578752268,3578752268,0
0,1339,46246,3578752268,3578752268,0
0,1339,46247,3578752268,3578752268,0
0,1339,46248,3578752268,3578752270,2
0,1339,46249,3578752268,3578752279,11
0,1339,46250,3578752268,3578752280,12
0,1339,46251,3578752268,3578752280,12
0,1339,46252,3578752268,3578752281,13
0,1339,46253,3578752268,3578752281,13
0,1339,46254,3578752268,3578752283,15
0,1339,46255,3578752268,3578752284,16
0,1339,46256,3578752268,3578752285,17
0,1339,46257,3578752268,3578752285,17
0,1339,46258,3578752268,3578752286,18
0,1339,46259,3578752268,3578752286,18
0,1339,46260,3578752268,3578752287,19
0,1339,46261,3578752268,3578752287,19
0,1339,46262,3578752268,3578752287,19
0,1339,46263,3578752268,3578752289,21
0,1339,46264,3578752268,3578752289,21
0,1339,46265,3578752268,3578752289,21
0,1339,46266,3578752268,3578752290,22
0,1339,46267,3578752268,3578752291,23
0,1339,46268,3578752268,3578752291,23
0,1339,46269,3578752268,3578752291,23
0,1339,46270,3578752268,3578752292,24
0,1339,46271,3578752268,3578752293,25
0,1339,46272,3578752268,3578752293,25
0,1339,46273,3578752268,3578752294,26
0,1339,46274,3578752268,3578752294,26
0,1339,46275,3578752268,3578752294,26
0,1339,46276,3578752268,3578752295,27
0,1339,46277,3578752268,3578752296,28
0,1339,46278,3578752268,3578752296,28
0,1339,46279,3578752268,3578752296,28
0,1339,46280,3578752268,3578752296,28
0,1339,46281,3578752268,3578752296,28
0,1339,46282,3578752268,3578752298,30
0,1339,46283,3578752268,3578752298,30
0,1339,46284,3578752268,3578752302,34
0,1339,46285,3578752268,3578752303,35
0,1339,46286,3578752268,3578752304,36
0,1339,46287,3578752268,3578752304,36
0,1339,46288,3578752268,3578752304,36
0,1339,46289,3578752268,3578752306,38
0,1339,46290,3578752268,3578752306,38
0,1339,46291,3578752268,3578752307,39
0,1339,46292,3578752268,3578752308,40
0,1339,46293,3578752268,3578752308,40
0,1339,46294,3578752268,3578752308,40
0,1339,46295,3578752268,3578752308,40
0,1339,46296,3578752268,3578752309,41
0,1339,46297,3578752268,3578752309,41
0,1339,46298,3578752268,3578752309,41
0,1339,46299,3578752268,3578752310,42
0,1339,46300,3578752268,3578752310,42
0,1339,46301,3578752268,3578752311,43
0,1339,46302,3578752268,3578752311,43
0,1339,46303,3578752268,3578752312,44
0,1339,46304,3578752268,3578752312,44
0,1339,46305,3578752268,3578752312,44
0,1339,46306,3578752268,3578752313,45
0,1339,46307,3578752268,3578752313,45
0,1339,46308,3578752268,3578752314,46
0,1339,46309,3578752268,3578752315,47
0,1339,46310,3578752268,3578752315,47
0,1339,46311,3578752268,3578752315,47
0,1339,46312,3578752268,3578752316,48
0,1339,46313,3578752268,3578752316,48
0,1339,46314,3578752268,3578752317,49
0,1339,46315,3578752268,3578752317,49
0,1339,46316,3578752268,3578752317,49
0,1339,46317,3578752268,3578752317,49
0,1339,46318,3578752268,3578752317,49
0,1339,46319,3578752268,3578752318,50
0,1340,46320,3578752330,3578752330,0
0,1340,46321,3578752330,3578752330,0
0,1340,46322,3578752330,3578752330,0
0,1340,46323,3578752330,3578752330,0
0,1340,46324,3578752330,3578752330,0
0,1340,46325,3578752330,3578752330,0
0,1340,46326,3578752330,3578752330,0
0,1340,46327,3578752330,3578752330,0
0,1340,46328,3578752330,3578752330,0
0,1340,46329,3578752330,3578752330,0
0,1340,46330,3578752330,3578752330,0
0,1340,46331,3578752330,3578752330,0
0,1340,46332,3578752330,3578752330,0
0,1340,46333,3578752330,3578752330,0
0,1340,46334,3578752330,3578752330,0
0,1340,46335,3578752330,3578752330,0
0,1340,46336,3578752330,3578752330,0
0,1340,46337,3578752330,3578752330,0
0,1340,46338,3578752330,3578752330,0
0,1340,46339,3578752330,3578752330,0
0,1340,46340,3578752330,3578752330,0
0,1340,46341,3578752330,3578752330,0
0,1340,46342,3578752330,3578752330,0
0,1340,46343,3578752330,3578752330,0
0,1340,46344,3578752330,3578752330,0
0,1340,46345,3578752330,3578752330,0
0,1340,46346,3578752330,3578752330,0
0,1340,46347,3578752330,3578752331,1
0,1340,46348,3578752330,3578752331,1
0,1340,46349,3578752330,3578752332,2
0,1340,46350,3578752330,3578752332,2
0,1340,46351,3578752330,3578752332,2
0,1340,46352,3578752330,3578752332,2
0,1340,46353,3578752330,3578752335,5
0,1340,46354,3578752330,3578752336,6
0,1340,46355,3578752330,3578752337,7
0,1340,46356,3578752330,3578752339,9
0,1340,46357,3578752330,3578752340,10
0,1340,46358,3578752330,3578752340,10
0,1340,46359,3578752330,3578752340,10
0,1340,46360,3578752330,3578752341,11
0,1340,46361,3578752330,3578752341,11
0,1340,46362,3578752330,3578752341,11
0,1340,46363,3578752330,3578752341,11
0,1340,46364,3578752330,3578752342,12
0,1340,46365,3578752330,3578752342,12
0,1340,46366,3578752330,3578752343,13
0,1340,46367,3578752330,3578752343,13
0,1340,46368,3578752330,3578752343,13
0,1340,46369,3578752330,3578752343,13
0,1340,46370,3578752330,3578752344,14
0,1340,46371,3578752330,3578752344,14
0,1340,46372,3578752330,3578752344,14
0,1340,46373,3578752330,3578752345,15
0,1340,46374,3578752330,3578752346,16
0,1340,46375,3578752330,3578752346,16
0,1340,46376,3578752330,3578752346,16
0,1340,46377,3578752330,3578752347,17
0,1340,46378,3578752330,3578752348,18
0,1340,46379,3578752330,3578752348,18
0,1340,46380,3578752330,3578752350,20
0,1340,46381,3578752330,3578752350,20
0,1340,46382,3578752330,3578752351,21
0,1340,46383,3578752330,3578752352,22
0,1340,46384,3578752330,3578752353,23
0,1340,46385,3578752330,3578752353,23
0,1340,46386,3578752330,3578752353,23
0,1340,46387,3578752330,3578752354,24
0,1340,46388,3578752330,3578752355,25
0,1340,46389,3578752330,3578752356,26
0,1340,46390,3578752330,3578752356,26
0,1340,46391,3578752330,3578752357,27
0,1340,46392,3578752330,3578752358,28
0,1340,46393,3578752330,3578752358,28
0,1340,46394,3578752330,3578752359,29
0,1340,46395,3578752330,3578752360,30
0,1340,46396,3578752330,3578752360,30
0,1340,46397,3578752330,3578752361,31
0,1340,46398,3578752330,3578752361,31
0,1340,46399,3578752330,3578752362,32
0,1340,46400,3578752330,3578752363,33
0,1340,46401,3578752330,3578752363,33
0,1340,46402,3578752330,3578752364,34
0,1340,46403,3578752330,3578752364,34
0,1340,46404,3578752330,3578752364,34
0,1340,46405,3578752330,3578752365,35
0,1340,46406,3578752330,3578752365,35
0,1340,46407,3578752330,3578752366,36
0,1340,46408,3578752330,3578752366,36
0,1340,46409,3578752330,3578752368,38
0,1340,46410,3578752330,3578752369,39
0,1340,46411,3578752330,3578752369,39
0,1340,46412,3578752330,3578752370,40
0,1340,46413,3578752330,3578752372,42
0,1340,46414,3578752330,3578752372,42
0,1340,46415,3578752330,3578752373,43
0,1340,46416,3578752330,3578752373,43
0,1340,46417,3578752330,3578752373,43
0,1340,46418,3578752330,3578752376,46
0,1340,46419,3578752330,3578752376,46
0,1340,46420,3578752330,3578752378,48
0,1340,46421,3578752330,3578752379,49
0,1340,46422,3578752330,3578752379,49
0,1340,46423,3578752330,3578752379,49
0,1340,46424,3578752330,3578752380,50
0,1341,46425,3578752393,3578752393,0
0,1341,46426,3578752393,3578752393,0
0,1341,46427,3578752393,3578752393,0
0,1341,46428,3578752393,3578752393,0
0,1341,46429,3578752393,3578752393,0
0,1341,46430,3578752393,3578752393,0
0,1341,46431,3578752393,3578752393,0
0,1341,46432,3578752393,3578752393,0
0,1341,46433,3578752393,3578752393,0
0,1341,46434,3578752393,3578752393,0
0,1341,46435,3578752393,3578752393,0
0,1341,46436,3578752393,3578752393,0
0,1341,46437,3578752393,3578752393,0
0,1341,46438,3578752393,3578752394,1
0,1341,46439,3578752393,3578752394,1
0,1341,46440,3578752393,3578752395,2
0,1341,46441,3578752393,3578752400,7
0,1341,46442,3578752393,3578752400,7
0,1341,46443,3578752393,3578752401,8
0,1341,46444,3578752393,3578752401,8
0,1341,46445,3578752393,3578752403,10
0,1341,46446,3578752393,3578752404,11
0,1341,46447,3578752393,3578752404,11
0,1341,46448,3578752393,3578752404,11
0,1341,46449,3578752393,3578752405,12
0,1341,46450,3578752393,3578752405,12
0,1341,46451,3578752393,3578752406,13
0,1341,46452,3578752393,3578752406,13
0,1341,46453,3578752393,3578752407,14
0,1341,46454,3578752393,3578752407,14
0,1341,46455,3578752393,3578752408,15
0,1341,46456,3578752393,3578752408,15
0,1341,46457,3578752393,3578752409,16
0,1341,46458,3578752393,3578752409,16
0,1341,46459,3578752393,3578752411,18
0,1341,46460,3578752393,3578752413,20
0,1341,46461,3578752393,3578752414,21
0,1341,46462,3578752393,3578752414,21
0,1341,46463,3578752393,3578752415,22
0,1341,46464,3578752393,3578752415,22
0,1341,46465,3578752393,3578752416,23
0,1341,46466,3578752393,3578752416,23
0,1341,46467,3578752393,3578752416,23
0,1341,46468,3578752393,3578752416,23
0,1341,46469,3578752393,3578752418,25
0,1341,46470,3578752393,3578752418,25
0,1341,46471,3578752393,3578752418,25
0,1341,46472,3578752393,3578752419,26
0,1341,46473,3578752393,3578752419,26
0,1341,46474,3578752393,3578752419,26
0,1341,46475,3578752393,3578752420,27
0,1341,46476,3578752393,3578752420,27
0,1341,46477,3578752393,3578752420,27
0,1341,46478,3578752393,3578752422,29
0,1341,46479,3578752393,3578752422,29
0,1341,46480,3578752393,3578752423,30
0,1341,46481,3578752393,3578752423,30
0,1341,46482,3578752393,3578752424,31
0,1341,46483,3578752393,3578752426,33
0,1341,46484,3578752393,3578752427,34
0,1341,46485,3578752393,3578752428,35
0,1341,46486,3578752393,3578752428,35
0,1341,46487,3578752393,3578752428,35
0,1341,46488,3578752393,3578752428,35
0,1341,46489,3578752393,3578752429,36
0,1341,46490,3578752393,3578752429,36
0,1341,46491,3578752393,3578752431,38
0,1341,46492,3578752393,3578752433,40
0,1341,46493,3578752393,3578752434,41
0,1341,46494,3578752393,3578752434,41
0,1341,46495,3578752393,3578752436,43
0,1341,46496,3578752393,3578752436,43
0,1341,46497,3578752393,3578752436,43
0,1341,46498,3578752393,3578752437,44
0,1341,46499,3578752393,3578752439,46
0,1341,46500,3578752393,3578752439,46
0,1341,46501,3578752393,3578752440,47
0,1341,46502,3578752393,3578752440,47
0,1341,46503,3578752393,3578752440,47
0,1341,46504,3578752393,3578752440,47
0,1341,46505,3578752393,3578752441,48
0,1341,46506,3578752393,3578752442,49
0,1341,46507,3578752393,3578752442,49
0,1342,46508,3578752455,3578752455,0
0,1342,46509,3578752455,3578752456,1
0,1342,46510,3578752455,3578752456,1
0,1342,46511,3578752455,3578752456,1
0,1342,46512,3578752455,3578752456,1
0,1342,46513,3578752455,3578752456,1
0,1342,46514,3578752455,3578752456,1
0,1342,46515,3578752455,3578752456,1
0,1342,46516,3578752455,3578752456,1
0,1342,46517,3578752455,3578752456,1
0,1342,46518,3578752455,3578752456,1
0,1342,46519,3578752455,3578752456,1
0,1342,46520,3578752455,3578752456,1
0,1342,46521,3578752455,3578752456,1
0,1342,46522,3578752455,3578752456,1
0,1342,46523,3578752455,3578752456,1
0,1342,46524,3578752455,3578752457,2
0,1342,46525,3578752455,3578752457,2
0,1342,46526,3578752455,3578752457,2
0,1342,46527,3578752455,3578752458,3
0,1342,46528,3578752455,3578752459,4
0,1342,46529,3578752455,3578752461,6
0,1342,46530,3578752455,3578752462,7
0,1342,46531,3578752455,3578752463,8
0,1342,46532,3578752455,3578752464,9
0,1342,46533,3578752455,3578752465,10
0,1342,46534,3578752455,3578752465,10
0,1342,46535,3578752455,3578752465,10
0,1342,46536,3578752455,3578752466,11
0,1342,46537,3578752455,3578752466,11
0,1342,46538,3578752455,3578752467,12
0,1342,46539,3578752455,3578752467,12
0,1342,46540,3578752455,3578752467,12
0,1342,46541,3578752455,3578752468,13
0,1342,46542,3578752455,3578752470,15
0,1342,46543,3578752455,3578752479,24
0,1342,46544,3578752455,3578752480,25
0,1342,46545,3578752455,3578752480,25
0,1342,46546,3578752455,3578752481,26
0,1342,46547,3578752455,3578752484,29
0,1342,46548,3578752455,3578752485,30
0,1342,46549,3578752455,3578752486,31
0,1342,46550,3578752455,3578752486,31
0,1342,46551,3578752455,3578752486,31
0,1342,46552,3578752455,3578752487,32
0,1342,46553,3578752455,3578752487,32
0,1342,46554,3578752455,3578752487,32
0,1342,46555,3578752455,3578752488,33
0,1342,46556,3578752455,3578752489,34
0,1342,46557,3578752455,3578752489,34
0,1342,46558,3578752455,3578752489,34
0,1342,46559,3578752455,3578752490,35
0,1342,46560,3578752455,3578752490,35
0,1342,46561,3578752455,3578752491,36
0,1342,46562,3578752455,3578752491,36
0,1342,46563,3578752455,3578752491,36
0,1342,46564,3578752455,3578752492,37
0,1342,46565,3578752455,3578752493,38
0,1342,46566,3578752455,3578752493,38
0,1342,46567,3578752455,3578752493,38
0,1342,46568,3578752455,3578752494,39
0,1342,46569,3578752455,3578752494,39
0,1342,46570,3578752455,3578752494,39
0,1342,46571,3578752455,3578752495,40
0,1342,46572,3578752455,3578752495,40
0,1342,46573,3578752455,3578752496,41
0,1342,46574,3578752455,3578752496,41
0,1342,46575,3578752455,3578752496,41
0,1342,46576,3578752455,3578752497,42
0,1342,46577,3578752455,3578752498,43
0,1342,46578,3578752455,3578752498,43
0,1342,46579,3578752455,3578752502,47
0,1342,46580,3578752455,3578752504,49
0,1342,46581,3578752455,3578752504,49
0,1342,46582,3578752455,3578752504,49
0,1342,46583,3578752455,3578752504,49
0,1343,46584,3578752518,3578752518,0
0,1343,46585,3578752518,3578752518,0
0,1343,46586,3578752518,3578752518,0
0,1343,46587,3578752518,3578752518,0
0,1343,46588,3578752518,3578752518,0
0,1343,46589,3578752518,3578752518,0
0,1343,46590,3578752518,3578752518,0
0,1343,46591,3578752518,3578752518,0
0,1343,46592,3578752518,3578752518,0
0,1343,46593,3578752518,3578752518,0
0,1343,46594,3578752518,3578752518,0
0,1343,46595,3578752518,3578752518,0
0,1343,46596,3578752518,3578752518,0
0,1343,46597,3578752518,3578752518,0
0,1343,46598,3578752518,3578752518,0
0,1343,46599,3578752518,3578752518,0
0,1343,46600,3578752518,3578752518,0
0,1343,46601,3578752518,3578752518,0
0,1343,46602,3578752518,3578752518,0
0,1343,46603,3578752518,3578752518,0
0,1343,46604,3578752518,3578752518,0
0,1343,46605,3578752518,3578752518,0
0,1343,46606,3578752518,3578752518,0
0,1343,46607,3578752518,3578752518,0
0,1343,46608,3578752518,3578752518,0
0,1343,46609,3578752518,3578752518,0
0,1343,46610,3578752518,3578752518,0
0,1343,46611,3578752518,3578752518,0
0,1343,46612,3578752518,3578752518,0
0,1343,46613,3578752518,3578752518,0
0,1343,46614,3578752518,3578752518,0
0,1343,46615,3578752518,3578752518,0
0,1343,46616,3578752518,3578752518,0
0,1343,46617,3578752518,3578752518,0
0,1343,46618,3578752518,3578752519,1
0,1343,46619,3578752518,3578752519,1
0,1343,46620,3578752518,3578752520,2
0,1343,46621,3578752518,3578752520,2
0,1343,46622,3578752518,3578752521,3
0,1343,46623,3578752518,3578752523,5
0,1343,46624,3578752518,3578752523,5
0,1343,46625,3578752518,3578752523,5
0,1343,46626,3578752518,3578752524,6
0,1343,46627,3578752518,3578752525,7
0,1343,46628,3578752518,3578752526,8
0,1343,46629,3578752518,3578752526,8
0,1343,46630,3578752518,3578752526,8
0,1343,46631,3578752518,3578752527,9
0,1343,46632,3578752518,3578752527,9
0,1343,46633,3578752518,3578752527,9
0,1343,46634,3578752518,3578752527,9
0,1343,46635,3578752518,3578752527,9
0,1343,46636,3578752518,3578752529,11
0,1343,46637,3578752518,3578752529,11
0,1343,46638,3578752518,3578752529,11
0,1343,46639,3578752518,3578752529,11
0,1343,46640,3578752518,3578752530,12
0,1343,46641,3578752518,3578752530,12
0,1343,46642,3578752518,3578752531,13
0,1343,46643,3578752518,3578752532,14
0,1343,46644,3578752518,3578752532,14
0,1343,46645,3578752518,3578752532,14
0,1343,46646,3578752518,3578752534,16
0,1343,46647,3578752518,3578752535,17
0,1343,46648,3578752518,3578752536,18
0,1343,46649,3578752518,3578752539,21
0,1343,46650,3578752518,3578752539,21
0,1343,46651,3578752518,3578752539,21
0,1343,46652,3578752518,3578752539,21
0,1343,46653,3578752518,3578752540,22
0,1343,46654,3578752518,3578752540,22
0,1343,46655,3578752518,3578752541,23
0,1343,46656,3578752518,3578752541,23
0,1343,46657,3578752518,3578752541,23
0,1343,46658,3578752518,3578752542,24
0,1343,46659,3578752518,3578752542,24
0,1343,46660,3578752518,3578752542,24
0,1343,46661,3578752518,3578752542,24
0,1343,46662,3578752518,3578752542,24
0,1343,46663,3578752518,3578752543,25
0,1343,46664,3578752518,3578752543,25
0,1343,46665,3578752518,3578752544,26
0,1343,46666,3578752518,3578752545,27
0,1343,46667,3578752518,3578752545,27
0,1343,46668,3578752518,3578752546,28
0,1343,46669,3578752518,3578752546,28
0,1343,46670,3578752518,3578752547,29
0,1343,46671,3578752518,3578752547,29
0,1343,46672,3578752518,3578752549,31
0,1343,46673,3578752518,3578752549,31
0,1343,46674,3578752518,3578752550,32
0,1343,46675,3578752518,3578752551,33
0,1343,46676,3578752518,3578752552,34
0,1343,46677,3578752518,3578752552,34
0,1343,46678,3578752518,3578752553,35
0,1343,46679,3578752518,3578752553,35
0,1343,46680,3578752518,3578752554,36
0,1343,46681,3578752518,3578752554,36
0,1343,46682,3578752518,3578752555,37
0,1343,46683,3578752518,3578752555,37
0,1343,46684,3578752518,3578752557,39
0,1343,46685,3578752518,3578752558,40
0,1343,46686,3578752518,3578752559,41
0,1343,46687,3578752518,3578752559,41
0,1343,46688,3578752518,3578752560,42
0,1343,46689,3578752518,3578752560,42
0,1343,46690,3578752518,3578752560,42
0,1343,46691,3578752518,3578752561,43
0,1343,46692,3578752518,3578752561,43
0,1343,46693,3578752518,3578752561,43
0,1343,46694,3578752518,3578752562,44
0,1343,46695,3578752518,3578752563,45
0,1343,46696,3578752518,3578752563,45
0,1343,46697,3578752518,3578752563,45
0,1343,46698,3578752518,3578752563,45
0,1343,46699,3578752518,3578752564,46
0,1343,46700,3578752518,3578752565,47
0,1343,46701,3578752518,3578752565,47
0,1343,46702,3578752518,3578752565,47
0,1343,46703,3578752518,3578752567,49
0,1343,46704,3578752518,3578752568,50
0,1344,46705,3578752581,3578752581,0
0,1344,46706,3578752581,3578752581,0
0,1344,46707,3578752581,3578752581,0
0,1344,46708,3578752581,3578752581,0
0,1344,46709,3578752581,3578752581,0
0,1344,46710,3578752581,3578752581,0
0,1344,46711,3578752581,3578752581,0
0,1344,46712,3578752581,3578752581,0
0,1344,46713,3578752581,3578752581,0
0,1344,46714,3578752581,3578752581,0
0,1344,46715,3578752581,3578752581,0
0,1344,46716,3578752581,3578752581,0
0,1344,46717,3578752581,3578752581,0
0,1344,46718,3578752581,3578752581,0
0,1344,46719,3578752581,3578752581,0
0,1344,46720,3578752581,3578752581,0
0,1344,46721,3578752581,3578752582,1
0,1344,46722,3578752581,3578752583,2
0,1344,46723,3578752581,3578752584,3
0,1344,46724,3578752581,3578752585,4
0,1344,46725,3578752581,3578752585,4
0,1344,46726,3578752581,3578752587,6
0,1344,46727,3578752581,3578752588,7
0,1344,46728,3578752581,3578752589,8
0,1344,46729,3578752581,3578752589,8
0,1344,46730,3578752581,3578752590,9
0,1344,46731,3578752581,3578752590,9
0,1344,46732,3578752581,3578752591,10
0,1344,46733,3578752581,3578752592,11
0,1344,46734,3578752581,3578752592,11
0,1344,46735,3578752581,3578752592,11
0,1344,46736,3578752581,3578752593,12
0,1344,46737,3578752581,3578752593,12
0,1344,46738,3578752581,3578752595,14
0,1344,46739,3578752581,3578752598,17
0,1344,46740,3578752581,3578752599,18
0,1344,46741,3578752581,3578752600,19
0,1344,46742,3578752581,3578752600,19
0,1344,46743,3578752581,3578752602,21
0,1344,46744,3578752581,3578752603,22
0,1344,46745,3578752581,3578752603,22
0,1344,46746,3578752581,3578752603,22
0,1344,46747,3578752581,3578752604,23
0,1344,46748,3578752581,3578752605,24
0,1344,46749,3578752581,3578752605,24
0,1344,46750,3578752581,3578752605,24
0,1344,46751,3578752581,3578752606,25
0,1344,46752,3578752581,3578752607,26
0,1344,46753,3578752581,3578752607,26
0,1344,46754,3578752581,3578752608,27
0,1344,46755,3578752581,3578752608,27
0,1344,46756,3578752581,3578752608,27
0,1344,46757,3578752581,3578752610,29
0,1344,46758,3578752581,3578752612,31
0,1344,46759,3578752581,3578752613,32
0,1344,46760,3578752581,3578752614,33
0,1344,46761,3578752581,3578752614,33
0,1344,46762,3578752581,3578752614,33
0,1344,46763,3578752581,3578752614,33
0,1344,46764,3578752581,3578752615,34
0,1344,46765,3578752581,3578752615,34
0,1344,46766,3578752581,3578752615,34
0,1344,46767,3578752581,3578752615,34
0,1344,46768,3578752581,3578752617,36
0,1344,46769,3578752581,3578752617,36
0,1344,46770,3578752581,3578752618,37
0,1344,46771,3578752581,3578752619,38
0,1344,46772,3578752581,3578752619,38
0,1344,46773,3578752581,3578752619,38
0,1344,46774,3578752581,3578752619,38
0,1344,46775,3578752581,3578752621,40
0,1344,46776,3578752581,3578752621,40
0,1344,46777,3578752581,3578752622,41
0,1344,46778,3578752581,3578752623,42
0,1344,46779,3578752581,3578752623,42
0,1344,46780,3578752581,3578752625,44
0,1344,46781,3578752581,3578752625,44
0,1344,46782,3578752581,3578752627,46
0,1344,46783,3578752581,3578752627,46
0,1344,46784,3578752581,3578752627,46
0,1344,46785,3578752581,3578752628,47
0,1344,46786,3578752581,3578752629,48
0,1344,46787,3578752581,3578752629,48
0,1344,46788,3578752581,3578752631,50
0,1345,46789,3578752643,3578752643,0
0,1345,46790,3578752643,3578752643,0
0,1345,46791,3578752643,3578752643,0
0,1345,46792,3578752643,3578752643,0
0,1345,46793,3578752643,3578752643,0
0,1345,46794,3578752643,3578752643,0
0,1345,46795,3578752643,3578752643,0
0,1345,46796,3578752643,3578752643,0
0,1345,46797,3578752643,3578752643,0
0,1345,46798,3578752643,3578752643,0
0,1345,46799,3578752643,3578752643,0
0,1345,46800,3578752643,3578752643,0
0,1345,46801,3578752643,3578752643,0
0,1345,46802,3578752643,3578752643,0
0,1345,46803,3578752643,3578752643,0
0,1345,46804,3578752643,3578752643,0
0,1345,46805,3578752643,3578752643,0
0,1345,46806,3578752643,3578752643,0
0,1345,46807,3578752643,3578752644,1
0,1345,46808,3578752643,3578752645,2
0,1345,46809,3578752643,3578752647,4
0,1345,46810,3578752643,3578752647,4
0,1345,46811,3578752643,3578752647,4
0,1345,46812,3578752643,3578752648,5
0,1345,46813,3578752643,3578752649,6
0,1345,46814,3578752643,3578752649,6
0,1345,46815,3578752643,3578752650,7
0,1345,46816,3578752643,3578752650,7
0,1345,46817,3578752643,3578752652,9
0,1345,46818,3578752643,3578752652,9
0,1345,46819,3578752643,3578752654,11
0,1345,46820,3578752643,3578752654,11
0,1345,46821,3578752643,3578752655,12
0,1345,46822,3578752643,3578752656,13
0,1345,46823,3578752643,3578752656,13
0,1345,46824,3578752643,3578752658,15
0,1345,46825,3578752643,3578752659,16
0,1345,46826,3578752643,3578752659,16
0,1345,46827,3578752643,3578752661,18
0,1345,46828,3578752643,3578752661,18
0,1345,46829,3578752643,3578752662,19
0,1345,46830,3578752643,3578752663,20
0,1345,46831,3578752643,3578752663,20
0,1345,46832,3578752643,3578752664,21
0,1345,46833,3578752643,3578752664,21
0,1345,46834,3578752643,3578752664,21
0,1345,46835,3578752643,3578752666,23
0,1345,46836,3578752643,3578752666,23
0,1345,46837,3578752643,3578752667,24
0,1345,46838,3578752643,3578752667,24
0,1345,46839,3578752643,3578752667,24
0,1345,46840,3578752643,3578752669,26
0,1345,46841,3578752643,3578752679,36
0,1345,46842,3578752643,3578752680,37
0,1345,46843,3578752643,3578752680,37
0,1345,46844,3578752643,3578752680,37
0,1345,46845,3578752643,3578752684,41
0,1345,46846,3578752643,3578752684,41
0,1345,46847,3578752643,3578752685,42
0,1345,46848,3578752643,3578752686,43
0,1345,46849,3578752643,3578752687,44
0,1345,46850,3578752643,3578752687,44
0,1345,46851,3578752643,3578752687,44
0,1345,46852,3578752643,3578752687,44
0,1345,46853,3578752643,3578752688,45
0,1345,46854,3578752643,3578752688,45
0,1345,46855,3578752643,3578752688,45
0,1345,46856,3578752643,3578752689,46
0,1345,46857,3578752643,3578752690,47
0,1345,46858,3578752643,3578752691,48
0,1345,46859,3578752643,3578752691,48
0,1345,46860,3578752643,3578752691,48
0,1345,46861,3578752643,3578752691,48
0,1345,46862,3578752643,3578752691,48
0,1345,46863,3578752643,3578752692,49
0,1345,46864,3578752643,3578752693,50
0,1346,46865,3578752706,3578752706,0
0,1346,46866,3578752706,3578752706,0
0,1346,46867,3578752706,3578752706,0
0,1346,46868,3578752706,3578752706,0
0,1346,46869,3578752706,3578752706,0
0,1346,46870,3578752706,3578752706,0
0,1346,46871,3578752706,3578752706,0
0,1346,46872,3578752706,3578752706,0
0,1346,46873,3578752706,3578752706,0
0,1346,46874,3578752706,3578752706,0
0,1346,46875,3578752706,3578752706,0
0,1346,46876,3578752706,3578752706,0
0,1346,46877,3578752706,3578752706,0
0,1346,46878,3578752706,3578752706,0
0,1346,46879,3578752706,3578752706,0
0,1346,46880,3578752706,3578752706,0
0,1346,46881,3578752706,3578752706,0
0,1346,46882,3578752706,3578752706,0
0,1346,46883,3578752706,3578752706,0
0,1346,46884,3578752706,3578752706,0
0,1346,46885,3578752706,3578752707,1
0,1346,46886,3578752706,3578752707,1
0,1346,46887,3578752706,3578752708,2
0,1346,46888,3578752706,3578752708,2
0,1346,46889,3578752706,3578752709,3
0,1346,46890,3578752706,3578752709,3
0,1346,46891,3578752706,3578752710,4
0,1346,46892,3578752706,3578752710,4
0,1346,46893,3578752706,3578752710,4
0,1346,46894,3578752706,3578752711,5
0,1346,46895,3578752706,3578752711,5
0,1346,46896,3578752706,3578752712,6
0,1346,46897,3578752706,3578752712,6
0,1346,46898,3578752706,3578752713,7
0,1346,46899,3578752706,3578752713,7
0,1346,46900,3578752706,3578752713,7
0,1346,46901,3578752706,3578752713,7
0,1346,46902,3578752706,3578752714,8
0,1346,46903,3578752706,3578752715,9
0,1346,46904,3578752706,3578752716,10
0,1346,46905,3578752706,3578752716,10
0,1346,46906,3578752706,3578752716,10
0,1346,46907,3578752706,3578752716,10
0,1346,46908,3578752706,3578752717,11
0,1346,46909,3578752706,3578752717,11
0,1346,46910,3578752706,3578752717,11
0,1346,46911,3578752706,3578752718,12
0,1346,46912,3578752706,3578752718,12
0,1346,46913,3578752706,3578752718,12
0,1346,46914,3578752706,3578752719,13
0,1346,46915,3578752706,3578752719,13
0,1346,46916,3578752706,3578752720,14
0,1346,46917,3578752706,3578752722,16
0,1346,46918,3578752706,3578752723,17
0,1346,46919,3578752706,3578752723,17
0,1346,46920,3578752706,3578752723,17
0,1346,46921,3578752706,3578752724,18
0,1346,46922,3578752706,3578752726,20
0,1346,46923,3578752706,3578752727,21
0,1346,46924,3578752706,3578752727,21
0,1346,46925,3578752706,3578752727,21
0,1346,46926,3578752706,3578752727,21
0,1346,46927,3578752706,3578752727,21
0,1346,46928,3578752706,3578752728,22
0,1346,46929,3578752706,3578752729,23
0,1346,46930,3578752706,3578752730,24
0,1346,46931,3578752706,3578752730,24
0,1346,46932,3578752706,3578752730,24
0,1346,46933,3578752706,3578752730,24
0,1346,46934,3578752706,3578752730,24
0,1346,46935,3578752706,3578752731,25
0,1346,46936,3578752706,3578752731,25
0,1346,46937,3578752706,3578752731,25
0,1346,46938,3578752706,3578752732,26
0,1346,46939,3578752706,3578752732,26
0,1346,46940,3578752706,3578752735,29
0,1346,46941,3578752706,3578752735,29
0,1346,46942,3578752706,3578752738,32
0,1346,46943,3578752706,3578752740,34
0,1346,46944,3578752706,3578752740,34
0,1346,46945,3578752706,3578752740,34
0,1346,46946,3578752706,3578752740,34
0,1346,46947,3578752706,3578752740,34
0,1346,46948,3578752706,3578752741,35
0,1346,46949,3578752706,3578752742,36
0,1346,46950,3578752706,3578752742,36
0,1346,46951,3578752706,3578752743,37
0,1346,46952,3578752706,3578752743,37
0,1346,46953,3578752706,3578752743,37
0,1346,46954,3578752706,3578752743,37
0,1346,46955,3578752706,3578752743,37
0,1346,46956,3578752706,3578752743,37
0,1346,46957,3578752706,3578752744,38
0,1346,46958,3578752706,3578752745,39
0,1346,46959,3578752706,3578752745,39
0,1346,46960,3578752706,3578752746,40
0,1346,46961,3578752706,3578752746,40
0,1346,46962,3578752706,3578752747,41
0,1346,46963,3578752706,3578752747,41
0,1346,46964,3578752706,3578752748,42
0,1346,46965,3578752706,3578752749,43
0,1346,46966,3578752706,3578752750,44
0,1346,46967,3578752706,3578752750,44
0,1346,46968,3578752706,3578752751,45
0,1346,46969,3578752706,3578752751,45
0,1346,46970,3578752706,3578752752,46
0,1346,46971,3578752706,3578752753,47
0,1346,46972,3578752706,3578752753,47
0,1346,46973,3578752706,3578752754,48
0,1346,46974,3578752706,3578752755,49
0,1346,46975,3578752706,3578752755,49
0,1346,46976,3578752706,3578752756,50
0,1347,46977,3578752768,3578752768,0
0,1347,46978,3578752768,3578752768,0
0,1347,46979,3578752768,3578752768,0
0,1347,46980,3578752768,3578752768,0
0,1347,46981,3578752768,3578752768,0
0,1347,46982,3578752768,3578752768,0
0,1347,46983,3578752768,3578752768,0
0,1347,46984,3578752768,3578752768,0
0,1347,46985,3578752768,3578752768,0
0,1347,46986,3578752768,3578752768,0
0,1347,46987,3578752768,3578752768,0
0,1347,46988,3578752768,3578752768,0
0,1347,46989,3578752768,3578752768,0
0,1347,46990,3578752768,3578752768,0
0,1347,46991,3578752768,3578752768,0
0,1347,46992,3578752768,3578752768,0
0,1347,46993,3578752768,3578752768,0
0,1347,46994,3578752768,3578752768,0
0,1347,46995,3578752768,3578752768,0
0,1347,46996,3578752768,3578752768,0
0,1347,46997,3578752768,3578752769,1
0,1347,46998,3578752768,3578752770,2
0,1347,46999,3578752768,3578752770,2
0,1347,47000,3578752768,3578752770,2
0,1347,47001,3578752768,3578752773,5
0,1347,47002,3578752768,3578752773,5
0,1347,47003,3578752768,3578752773,5
0,1347,47004,3578752768,3578752774,6
0,1347,47005,3578752768,3578752774,6
0,1347,47006,3578752768,3578752775,7
0,1347,47007,3578752768,3578752777,9
0,1347,47008,3578752768,3578752777,9
0,1347,47009,3578752768,3578752778,10
0,1347,47010,3578752768,3578752778,10
0,1347,47011,3578752768,3578752779,11
0,1347,47012,3578752768,3578752779,11
0,1347,47013,3578752768,3578752779,11
0,1347,47014,3578752768,3578752781,13
0,1347,47015,3578752768,3578752781,13
0,1347,47016,3578752768,3578752782,14
0,1347,47017,3578752768,3578752783,15
0,1347,47018,3578752768,3578752784,16
0,1347,47019,3578752768,3578752784,16
0,1347,47020,3578752768,3578752785,17
0,1347,47021,3578752768,3578752785,17
0,1347,47022,3578752768,3578752788,20
0,1347,47023,3578752768,3578752788,20
0,1347,47024,3578752768,3578752788,20
0,1347,47025,3578752768,3578752788,20
0,1347,47026,3578752768,3578752789,21
0,1347,47027,3578752768,3578752791,23
0,1347,47028,3578752768,3578752791,23
0,1347,47029,3578752768,3578752791,23
0,1347,47030,3578752768,3578752792,24
0,1347,47031,3578752768,3578752792,24
0,1347,47032,3578752768,3578752793,25
0,1347,47033,3578752768,3578752793,25
0,1347,47034,3578752768,3578752794,26
0,1347,47035,3578752768,3578752795,27
0,1347,47036,3578752768,3578752799,31
0,1347,47037,3578752768,3578752800,32
0,1347,47038,3578752768,3578752801,33
0,1347,47039,3578752768,3578752801,33
0,1347,47040,3578752768,3578752801,33
0,1347,47041,3578752768,3578752803,35
0,1347,47042,3578752768,3578752803,35
0,1347,47043,3578752768,3578752803,35
0,1347,47044,3578752768,3578752805,37
0,1347,47045,3578752768,3578752805,37
0,1347,47046,3578752768,3578752806,38
0,1347,47047,3578752768,3578752806,38
0,1347,47048,3578752768,3578752806,38
0,1347,47049,3578752768,3578752807,39
0,1347,47050,3578752768,3578752807,39
0,1347,47051,3578752768,3578752808,40
0,1347,47052,3578752768,3578752808,40
0,1347,47053,3578752768,3578752809,41
0,1347,47054,3578752768,3578752810,42
0,1347,47055,3578752768,3578752812,44
0,1347,47056,3578752768,3578752813,45
0,1347,47057,3578752768,3578752814,46
0,1347,47058,3578752768,3578752814,46
0,1347,47059,3578752768,3578752815,47
0,1347,47060,3578752768,3578752815,47
0,1347,47061,3578752768,3578752815,47
0,1347,47062,3578752768,3578752815,47
0,1347,47063,3578752768,3578752816,48
0,1348,47064,3578752831,3578752831,0
0,1348,47065,3578752831,3578752831,0
0,1348,47066,3578752831,3578752831,0
0,1348,47067,3578752831,3578752831,0
0,1348,47068,3578752831,3578752831,0
0,1348,47069,3578752831,3578752831,0
0,1348,47070,3578752831,3578752831,0
0,1348,47071,3578752831,3578752831,0
0,1348,47072,3578752831,3578752831,0
0,1348,47073,3578752831,3578752831,0
0,1348,47074,3578752831,3578752831,0
0,1348,47075,3578752831,3578752831,0
0,1348,47076,3578752831,3578752831,0
0,1348,47077,3578752831,3578752831,0
0,1348,47078,3578752831,3578752831,0
0,1348,47079,3578752831,3578752831,0
0,1348,47080,3578752831,3578752831,0
0,1348,47081,3578752831,3578752831,0
0,1348,47082,3578752831,3578752831,0
0,1348,47083,3578752831,3578752831,0
0,1348,47084,3578752831,3578752832,1
0,1348,47085,3578752831,3578752832,1
0,1348,47086,3578752831,3578752833,2
0,1348,47087,3578752831,3578752834,3
0,1348,47088,3578752831,3578752836,5
0,1348,47089,3578752831,3578752836,5
0,1348,47090,3578752831,3578752836,5
0,1348,47091,3578752831,3578752837,6
0,1348,47092,3578752831,3578752838,7
0,1348,47093,3578752831,3578752838,7
0,1348,47094,3578752831,3578752839,8
0,1348,47095,3578752831,3578752839,8
0,1348,47096,3578752831,3578752840,9
0,1348,47097,3578752831,3578752840,9
0,1348,47098,3578752831,3578752840,9
0,1348,47099,3578752831,3578752842,11
0,1348,47100,3578752831,3578752843,12
0,1348,47101,3578752831,3578752844,13
0,1348,47102,3578752831,3578752844,13
0,1348,47103,3578752831,3578752845,14
0,1348,47104,3578752831,3578752847,16
0,1348,47105,3578752831,3578752847,16
0,1348,47106,3578752831,3578752848,17
0,1348,47107,3578752831,3578752848,17
0,1348,47108,3578752831,3578752849,18
0,1348,47109,3578752831,3578752850,19
0,1348,47110,3578752831,3578752850,19
0,1348,47111,3578752831,3578752852,21
0,1348,47112,3578752831,3578752852,21
0,1348,47113,3578752831,3578752854,23
0,1348,47114,3578752831,3578752854,23
0,1348,47115,3578752831,3578752854,23
0,1348,47116,3578752831,3578752856,25
0,1348,47117,3578752831,3578752856,25
0,1348,47118,3578752831,3578752857,26
0,1348,47119,3578752831,3578752858,27
0,1348,47120,3578752831,3578752858,27
0,1348,47121,3578752831,3578752859,28
0,1348,47122,3578752831,3578752861,30
0,1348,47123,3578752831,3578752861,30
0,1348,47124,3578752831,3578752862,31
0,1348,47125,3578752831,3578752863,32
0,1348,47126,3578752831,3578752864,33
0,1348,47127,3578752831,3578752864,33
0,1348,47128,3578752831,3578752864,33
0,1348,47129,3578752831,3578752865,34
0,1348,47130,3578752831,3578752866,35
0,1348,47131,3578752831,3578752866,35
0,1348,47132,3578752831,3578752867,36
0,1348,47133,3578752831,3578752867,36
0,1348,47134,3578752831,3578752867,36
0,1348,47135,3578752831,3578752880,49
0,1348,47136,3578752831,3578752880,49
0,1348,47137,3578752831,3578752881,50
0,1349,47138,3578752894,3578752894,0
0,1349,47139,3578752894,3578752894,0
0,1349,47140,3578752894,3578752894,0
0,1349,47141,3578752894,3578752894,0
0,1349,47142,3578752894,3578752894,0
0,1349,47143,3578752894,3578752894,0
0,1349,47144,3578752894,3578752894,0
0,1349,47145,3578752894,3578752894,0
0,1349,47146,3578752894,3578752894,0
0,1349,47147,3578752894,3578752894,0
0,1349,47148,3578752894,3578752894,0
0,1349,47149,3578752894,3578752894,0
0,1349,47150,3578752894,3578752894,0
0,1349,47151,3578752894,3578752894,0
0,1349,47152,3578752894,3578752894,0
0,1349,47153,3578752894,3578752894,0
0,1349,47154,3578752894,3578752894,0
0,1349,47155,3578752894,3578752894,0
0,1349,47156,3578752894,3578752894,0
0,1349,47157,3578752894,3578752894,0
0,1349,47158,3578752894,3578752894,0
0,1349,47159,3578752894,3578752895,1
0,1349,47160,3578752894,3578752895,1
0,1349,47161,3578752894,3578752895,1
0,1349,47162,3578752894,3578752896,2
0,1349,47163,3578752894,3578752896,2
0,1349,47164,3578752894,3578752896,2
0,1349,47165,3578752894,3578752897,3
0,1349,47166,3578752894,3578752897,3
0,1349,47167,3578752894,3578752898,4
0,1349,47168,3578752894,3578752899,5
0,1349,47169,3578752894,3578752901,7
0,1349,47170,3578752894,3578752904,10
0,1349,47171,3578752894,3578752904,10
0,1349,47172,3578752894,3578752905,11
0,1349,47173,3578752894,3578752906,12
0,1349,47174,3578752894,3578752906,12
0,1349,47175,3578752894,3578752907,13
0,1349,47176,3578752894,3578752908,14
0,1349,47177,3578752894,3578752909,15
0,1349,47178,3578752894,3578752909,15
0,1349,47179,3578752894,3578752909,15
0,1349,47180,3578752894,3578752909,15
0,1349,47181,3578752894,3578752910,16
0,1349,47182,3578752894,3578752911,17
0,1349,47183,3578752894,3578752911,17
0,1349,47184,3578752894,3578752911,17
0,1349,47185,3578752894,3578752912,18
0,1349,47186,3578752894,3578752912,18
0,1349,47187,3578752894,3578752912,18
0,1349,47188,3578752894,3578752913,19
0,1349,47189,3578752894,3578752913,19
0,1349,47190,3578752894,3578752913,19
0,1349,47191,3578752894,3578752914,20
0,1349,47192,3578752894,3578752914,20
0,1349,47193,3578752894,3578752915,21
0,1349,47194,3578752894,3578752916,22
0,1349,47195,3578752894,3578752916,22
0,1349,47196,3578752894,3578752917,23
0,1349,47197,3578752894,3578752918,24
0,1349,47198,3578752894,3578752918,24
0,1349,47199,3578752894,3578752918,24
0,1349,47200,3578752894,3578752918,24
0,1349,47201,3578752894,3578752919,25
0,1349,47202,3578752894,3578752919,25
0,1349,47203,3578752894,3578752919,25
0,1349,47204,3578752894,3578752919,25
0,1349,47205,3578752894,3578752920,26
0,1349,47206,3578752894,3578752920,26
0,1349,47207,3578752894,3578752921,27
0,1349,47208,3578752894,3578752922,28
0,1349,47209,3578752894,3578752922,28
0,1349,47210,3578752894,3578752923,29
0,1349,47211,3578752894,3578752923,29
0,1349,47212,3578752894,3578752925,31
0,1349,47213,3578752894,3578752926,32
0,1349,47214,3578752894,3578752926,32
0,1349,47215,3578752894,3578752926,32
0,1349,47216,3578752894,3578752926,32
0,1349,47217,3578752894,3578752927,33
0,1349,47218,3578752894,3578752927,33
0,1349,47219,3578752894,3578752928,34
0,1349,47220,3578752894,3578752928,34
0,1349,47221,3578752894,3578752929,35
0,1349,47222,3578752894,3578752929,35
0,1349,47223,3578752894,3578752930,36
0,1349,47224,3578752894,3578752930,36
0,1349,47225,3578752894,3578752931,37
0,1349,47226,3578752894,3578752931,37
0,1349,47227,3578752894,3578752931,37
0,1349,47228,3578752894,3578752932,38
0,1349,47229,3578752894,3578752932,38
0,1349,47230,3578752894,3578752933,39
0,1349,47231,3578752894,3578752933,39
0,1349,47232,3578752894,3578752934,40
0,1349,47233,3578752894,3578752936,42
0,1349,47234,3578752894,3578752939,45
0,1349,47235,3578752894,3578752940,46
0,1349,47236,3578752894,3578752940,46
0,1349,47237,3578752894,3578752941,47
0,1349,47238,3578752894,3578752941,47
0,1349,47239,3578752894,3578752941,47
0,1349,47240,3578752894,3578752941,47
0,1349,47241,3578752894,3578752942,48
0,1349,47242,3578752894,3578752942,48
0,1349,47243,3578752894,3578752943,49
0,1349,47244,3578752894,3578752943,49
0,1349,47245,3578752894,3578752943,49
0,1349,47246,3578752894,3578752944,50
0,1350,47247,3578752956,3578752956,0
0,1350,47248,3578752956,3578752956,0
0,1350,47249,3578752956,3578752956,0
0,1350,47250,3578752956,3578752956,0
0,1350,47251,3578752956,3578752956,0
0,1350,47252,3578752956,3578752956,0
0,1350,47253,3578752956,3578752956,0
0,1350,47254,3578752956,3578752956,0
0,1350,47255,3578752956,3578752956,0
0,1350,47256,3578752956,3578752956,0
0,1350,47257,3578752956,3578752956,0
0,1350,47258,3578752956,3578752956,0
0,1350,47259,3578752956,3578752956,0
0,1350,47260,3578752956,3578752956,0
0,1350,47261,3578752956,3578752956,0
0,1350,47262,3578752956,3578752956,0
0,1350,47263,3578752956,3578752956,0
0,1350,47264,3578752956,3578752958,2
0,1350,47265,3578752956,3578752959,3
0,1350,47266,3578752956,3578752959,3
0,1350,47267,3578752956,3578752960,4
0,1350,47268,3578752956,3578752961,5
0,1350,47269,3578752956,3578752961,5
0,1350,47270,3578752956,3578752962,6
0,1350,47271,3578752956,3578752962,6
0,1350,47272,3578752956,3578752962,6
0,1350,47273,3578752956,3578752963,7
0,1350,47274,3578752956,3578752963,7
0,1350,47275,3578752956,3578752963,7
0,1350,47276,3578752956,3578752964,8
0,1350,47277,3578752956,3578752965,9
0,1350,47278,3578752956,3578752965,9
0,1350,47279,3578752956,3578752965,9
0,1350,47280,3578752956,3578752967,11
0,1350,47281,3578752956,3578752967,11
0,1350,47282,3578752956,3578752968,12
0,1350,47283,3578752956,3578752969,13
0,1350,47284,3578752956,3578752970,14
0,1350,47285,3578752956,3578752971,15
0,1350,47286,3578752956,3578752971,15
0,1350,47287,3578752956,3578752973,17
0,1350,47288,3578752956,3578752973,17
0,1350,47289,3578752956,3578752973,17
0,1350,47290,3578752956,3578752973,17
0,1350,47291,3578752956,3578752974,18
0,1350,47292,3578752956,3578752976,20
0,1350,47293,3578752956,3578752977,21
0,1350,47294,3578752956,3578752978,22
0,1350,47295,3578752956,3578752978,22
0,1350,47296,3578752956,3578752979,23
0,1350,47297,3578752956,3578752981,25
0,1350,47298,3578752956,3578752981,25
0,1350,47299,3578752956,3578752983,27
0,1350,47300,3578752956,3578752984,28
0,1350,47301,3578752956,3578752984,28
0,1350,47302,3578752956,3578752984,28
0,1350,47303,3578752956,3578752985,29
0,1350,47304,3578752956,3578752987,31
0,1350,47305,3578752956,3578752988,32
0,1350,47306,3578752956,3578752989,33
0,1350,47307,3578752956,3578752989,33
0,1350,47308,3578752956,3578752989,33
0,1350,47309,3578752956,3578752991,35
0,1350,47310,3578752956,3578752991,35
0,1350,47311,3578752956,3578752992,36
0,1350,47312,3578752956,3578752992,36
0,1350,47313,3578752956,3578752992,36
0,1350,47314,3578752956,3578752993,37
0,1350,47315,3578752956,3578752995,39
0,1350,47316,3578752956,3578752999,43
0,1350,47317,3578752956,3578753000,44
0,1350,47318,3578752956,3578753001,45
0,1350,47319,3578752956,3578753001,45
0,1350,47320,3578752956,3578753002,46
0,1350,47321,3578752956,3578753003,47
0,1350,47322,3578752956,3578753003,47
0,1350,47323,3578752956,3578753004,48
0,1350,47324,3578752956,3578753005,49
0,1350,47325,3578752956,3578753005,49
0,1350,47326,3578752956,3578753005,49
0,1350,47327,3578752956,3578753006,50
0,1351,47328,3578753018,3578753018,0
0,1351,47329,3578753018,3578753018,0
0,1351,47330,3578753018,3578753018,0
0,1351,47331,3578753018,3578753018,0
0,1351,47332,3578753018,3578753018,0
0,1351,47333,3578753018,3578753018,0
0,1351,47334,3578753018,3578753018,0
0,1351,47335,3578753018,3578753018,0
0,1351,47336,3578753018,3578753018,0
0,1351,47337,3578753018,3578753018,0
0,1351,47338,3578753018,3578753018,0
0,1351,47339,3578753018,3578753018,0
0,1351,47340,3578753018,3578753018,0
0,1351,47341,3578753018,3578753018,0
0,1351,47342,3578753018,3578753018,0
0,1351,47343,3578753018,3578753018,0
0,1351,47344,3578753018,3578753018,0
0,1351,47345,3578753018,3578753018,0
0,1351,47346,3578753018,3578753018,0
0,1351,47347,3578753018,3578753019,1
0,1351,47348,3578753018,3578753020,2
0,1351,47349,3578753018,3578753021,3
0,1351,47350,3578753018,3578753021,3
0,1351,47351,3578753018,3578753021,3
0,1351,47352,3578753018,3578753024,6
0,1351,47353,3578753018,3578753025,7
0,1351,47354,3578753018,3578753025,7
0,1351,47355,3578753018,3578753026,8
0,1351,47356,3578753018,3578753027,9
0,1351,47357,3578753018,3578753028,10
0,1351,47358,3578753018,3578753028,10
0,1351,47359,3578753018,3578753029,11
0,1351,47360,3578753018,3578753029,11
0,1351,47361,3578753018,3578753032,14
0,1351,47362,3578753018,3578753032,14
0,1351,47363,3578753018,3578753033,15
0,1351,47364,3578753018,3578753034,16
0,1351,47365,3578753018,3578753035,17
0,1351,47366,3578753018,3578753035,17
0,1351,47367,3578753018,3578753036,18
0,1351,47368,3578753018,3578753036,18
0,1351,47369,3578753018,3578753038,20
0,1351,47370,3578753018,3578753038,20
0,1351,47371,3578753018,3578753038,20
0,1351,47372,3578753018,3578753039,21
0,1351,47373,3578753018,3578753039,21
0,1351,47374,3578753018,3578753040,22
0,1351,47375,3578753018,3578753040,22
0,1351,47376,3578753018,3578753040,22
0,1351,47377,3578753018,3578753040,22
0,1351,47378,3578753018,3578753043,25
0,1351,47379,3578753018,3578753043,25
0,1351,47380,3578753018,3578753043,25
0,1351,47381,3578753018,3578753044,26
0,1351,47382,3578753018,3578753044,26
0,1351,47383,3578753018,3578753045,27
0,1351,47384,3578753018,3578753047,29
0,1351,47385,3578753018,3578753048,30
0,1351,47386,3578753018,3578753048,30
0,1351,47387,3578753018,3578753049,31
0,1351,47388,3578753018,3578753049,31
0,1351,47389,3578753018,3578753050,32
0,1351,47390,3578753018,3578753050,32
0,1351,47391,3578753018,3578753052,34
0,1351,47392,3578753018,3578753052,34
0,1351,47393,3578753018,3578753053,35
0,1351,47394,3578753018,3578753054,36
0,1351,47395,3578753018,3578753055,37
0,1351,47396,3578753018,3578753055,37
0,1351,47397,3578753018,3578753057,39
0,1351,47398,3578753018,3578753057,39
0,1351,47399,3578753018,3578753058,40
0,1351,47400,3578753018,3578753058,40
0,1351,47401,3578753018,3578753059,41
0,1351,47402,3578753018,3578753059,41
0,1351,47403,3578753018,3578753061,43
0,1351,47404,3578753018,3578753062,44
0,1351,47405,3578753018,3578753062,44
0,1351,47406,3578753018,3578753063,45
0,1351,47407,3578753018,3578753064,46
0,1351,47408,3578753018,3578753064,46
0,1351,47409,3578753018,3578753065,47
0,1351,47410,3578753018,3578753065,47
0,1351,47411,3578753018,3578753066,48
0,1351,47412,3578753018,3578753066,48
0,1351,47413,3578753018,3578753066,48
0,1351,47414,3578753018,3578753067,49
0,1351,47415,3578753018,3578753067,49
0,1352,47416,3578753080,3578753080,0
0,1352,47417,3578753080,3578753080,0
0,1352,47418,3578753080,3578753080,0
0,1352,47419,3578753080,3578753080,0
0,1352,47420,3578753080,3578753080,0
0,1352,47421,3578753080,3578753081,1
0,1352,47422,3578753080,3578753084,4
0,1352,47423,3578753080,3578753085,5
0,1352,47424,3578753080,3578753087,7
0,1352,47425,3578753080,3578753087,7
0,1352,47426,3578753080,3578753087,7
0,1352,47427,3578753080,3578753087,7
0,1352,47428,3578753080,3578753087,7
0,1352,47429,3578753080,3578753088,8
0,1352,47430,3578753080,3578753088,8
0,1352,47431,3578753080,3578753089,9
0,1352,47432,3578753080,3578753089,9
0,1352,47433,3578753080,3578753090,10
0,1352,47434,3578753080,3578753090,10
0,1352,47435,3578753080,3578753091,11
0,1352,47436,3578753080,3578753091,11
0,1352,47437,3578753080,3578753091,11
0,1352,47438,3578753080,3578753093,13
0,1352,47439,3578753080,3578753093,13
0,1352,47440,3578753080,3578753093,13
0,1352,47441,3578753080,3578753093,13
0,1352,47442,3578753080,3578753094,14
0,1352,47443,3578753080,3578753095,15
0,1352,47444,3578753080,3578753095,15
0,1352,47445,3578753080,3578753096,16
0,1352,47446,3578753080,3578753096,16
0,1352,47447,3578753080,3578753096,16
0,1352,47448,3578753080,3578753096,16
0,1352,47449,3578753080,3578753097,17
0,1352,47450,3578753080,3578753097,17
0,1352,47451,3578753080,3578753097,17
0,1352,47452,3578753080,3578753098,18
0,1352,47453,3578753080,3578753099,19
0,1352,47454,3578753080,3578753101,21
0,1352,47455,3578753080,3578753104,24
0,1352,47456,3578753080,3578753104,24
0,1352,47457,3578753080,3578753105,25
0,1352,47458,3578753080,3578753105,25
0,1352,47459,3578753080,3578753106,26
0,1352,47460,3578753080,3578753107,27
0,1352,47461,3578753080,3578753108,28
0,1352,47462,3578753080,3578753108,28
0,1352,47463,3578753080,3578753109,29
0,1352,47464,3578753080,3578753109,29
0,1352,47465,3578753080,3578753109,29
0,1352,47466,3578753080,3578753110,30
0,1352,47467,3578753080,3578753110,30
0,1352,47468,3578753080,3578753110,30
0,1352,47469,3578753080,3578753110,30
0,1352,47470,3578753080,3578753110,30
0,1352,47471,3578753080,3578753111,31
0,1352,47472,3578753080,3578753112,32
0,1352,47473,3578753080,3578753112,32
0,1352,47474,3578753080,3578753112,32
0,1352,47475,3578753080,3578753113,33
0,1352,47476,3578753080,3578753113,33
0,1352,47477,3578753080,3578753114,34
0,1352,47478,3578753080,3578753114,34
0,1352,47479,3578753080,3578753116,36
0,1352,47480,3578753080,3578753116,36
0,1352,47481,3578753080,3578753116,36
0,1352,47482,3578753080,3578753116,36
0,1352,47483,3578753080,3578753117,37
0,1352,47484,3578753080,3578753117,37
0,1352,47485,3578753080,3578753118,38
0,1352,47486,3578753080,3578753118,38
0,1352,47487,3578753080,3578753118,38
0,1352,47488,3578753080,3578753119,39
0,1352,47489,3578753080,3578753119,39
0,1352,47490,3578753080,3578753119,39
0,1352,47491,3578753080,3578753119,39
0,1352,47492,3578753080,3578753119,39
0,1352,47493,3578753080,3578753120,40
0,1352,47494,3578753080,3578753120,40
0,1352,47495,3578753080,3578753122,42
0,1352,47496,3578753080,3578753122,42
0,1352,47497,3578753080,3578753123,43
0,1352,47498,3578753080,3578753123,43
0,1352,47499,3578753080,3578753124,44
0,1352,47500,3578753080,3578753126,46
0,1352,47501,3578753080,3578753126,46
0,1352,47502,3578753080,3578753127,47
0,1352,47503,3578753080,3578753127,47
0,1352,47504,3578753080,3578753127,47
0,1352,47505,3578753080,3578753127,47
0,1352,47506,3578753080,3578753127,47
0,1352,47507,3578753080,3578753128,48
0,1352,47508,3578753080,3578753128,48
0,1352,47509,3578753080,3578753129,49
0,1352,47510,3578753080,3578753130,50
0,1353,47511,3578753142,3578753142,0
0,1353,47512,3578753142,3578753142,0
0,1353,47513,3578753142,3578753142,0
0,1353,47514,3578753142,3578753142,0
0,1353,47515,3578753142,3578753142,0
0,1353,47516,3578753142,3578753142,0
0,1353,47517,3578753142,3578753142,0
0,1353,47518,3578753142,3578753142,0
0,1353,47519,3578753142,3578753142,0
0,1353,47520,3578753142,3578753142,0
0,1353,47521,3578753142,3578753142,0
0,1353,47522,3578753142,3578753142,0
0,1353,47523,3578753142,3578753142,0
0,1353,47524,3578753142,3578753142,0
0,1353,47525,3578753142,3578753142,0
0,1353,47526,3578753142,3578753142,0
0,1353,47527,3578753142,3578753142,0
0,1353,47528,3578753142,3578753142,0
0,1353,47529,3578753142,3578753142,0
0,1353,47530,3578753142,3578753142,0
0,1353,47531,3578753142,3578753142,0
0,1353,47532,3578753142,3578753143,1
0,1353,47533,3578753142,3578753143,1
0,1353,47534,3578753142,3578753143,1
0,1353,47535,3578753142,3578753143,1
0,1353,47536,3578753142,3578753144,2
0,1353,47537,3578753142,3578753145,3
0,1353,47538,3578753142,3578753145,3
0,1353,47539,3578753142,3578753147,5
0,1353,47540,3578753142,3578753147,5
0,1353,47541,3578753142,3578753149,7
0,1353,47542,3578753142,3578753149,7
0,1353,47543,3578753142,3578753149,7
0,1353,47544,3578753142,3578753151,9
0,1353,47545,3578753142,3578753153,11
0,1353,47546,3578753142,3578753153,11
0,1353,47547,3578753142,3578753155,13
0,1353,47548,3578753142,3578753155,13
0,1353,47549,3578753142,3578753155,13
0,1353,47550,3578753142,3578753156,14
0,1353,47551,3578753142,3578753157,15
0,1353,47552,3578753142,3578753159,17
0,1353,47553,3578753142,3578753159,17
0,1353,47554,3578753142,3578753160,18
0,1353,47555,3578753142,3578753162,20
0,1353,47556,3578753142,3578753162,20
0,1353,47557,3578753142,3578753162,20
0,1353,47558,3578753142,3578753163,21
0,1353,47559,3578753142,3578753163,21
0,1353,47560,3578753142,3578753163,21
0,1353,47561,3578753142,3578753164,22
0,1353,47562,3578753142,3578753164,22
0,1353,47563,3578753142,3578753165,23
0,1353,47564,3578753142,3578753165,23
0,1353,47565,3578753142,3578753165,23
0,1353,47566,3578753142,3578753167,25
0,1353,47567,3578753142,3578753168,26
0,1353,47568,3578753142,3578753168,26
0,1353,47569,3578753142,3578753168,26
0,1353,47570,3578753142,3578753169,27
0,1353,47571,3578753142,3578753170,28
0,1353,47572,3578753142,3578753171,29
0,1353,47573,3578753142,3578753171,29
0,1353,47574,3578753142,3578753172,30
0,1353,47575,3578753142,3578753172,30
0,1353,47576,3578753142,3578753173,31
0,1353,47577,3578753142,3578753174,32
0,1353,47578,3578753142,3578753175,33
0,1353,47579,3578753142,3578753176,34
0,1353,47580,3578753142,3578753176,34
0,1353,47581,3578753142,3578753177,35
0,1353,47582,3578753142,3578753178,36
0,1353,47583,3578753142,3578753178,36
0,1353,47584,3578753142,3578753179,37
0,1353,47585,3578753142,3578753179,37
0,1353,47586,3578753142,3578753181,39
0,1353,47587,3578753142,3578753184,42
0,1353,47588,3578753142,3578753184,42
0,1353,47589,3578753142,3578753184,42
0,1353,47590,3578753142,3578753184,42
0,1353,47591,3578753142,3578753186,44
0,1353,47592,3578753142,3578753187,45
0,1353,47593,3578753142,3578753187,45
0,1353,47594,3578753142,3578753188,46
0,1353,47595,3578753142,3578753189,47
0,1353,47596,3578753142,3578753189,47
0,1353,47597,3578753142,3578753191,49
0,1353,47598,3578753142,3578753191,49
0,1353,47599,3578753142,3578753191,49
0,1353,47600,3578753142,3578753192,50
0,1354,47601,3578753204,3578753204,0
0,1354,47602,3578753204,3578753204,0
0,1354,47603,3578753204,3578753204,0
0,1354,47604,3578753204,3578753204,0
0,1354,47605,3578753204,3578753204,0
0,1354,47606,3578753204,3578753204,0
0,1354,47607,3578753204,3578753204,0
0,1354,47608,3578753204,3578753204,0
0,1354,47609,3578753204,3578753204,0
0,1354,47610,3578753204,3578753204,0
0,1354,47611,3578753204,3578753204,0
0,1354,47612,3578753204,3578753205,1
0,1354,47613,3578753204,3578753205,1
0,1354,47614,3578753204,3578753205,1
0,1354,47615,3578753204,3578753206,2
0,1354,47616,3578753204,3578753207,3
0,1354,47617,3578753204,3578753207,3
0,1354,47618,3578753204,3578753207,3
0,1354,47619,3578753204,3578753208,4
0,1354,47620,3578753204,3578753208,4
0,1354,47621,3578753204,3578753209,5
0,1354,47622,3578753204,3578753210,6
0,1354,47623,3578753204,3578753210,6
0,1354,47624,3578753204,3578753212,8
0,1354,47625,3578753204,3578753214,10
0,1354,47626,3578753204,3578753215,11
0,1354,47627,3578753204,3578753215,11
0,1354,47628,3578753204,3578753215,11
0,1354,47629,3578753204,3578753215,11
0,1354,47630,3578753204,3578753216,12
0,1354,47631,3578753204,3578753218,14
0,1354,47632,3578753204,3578753218,14
0,1354,47633,3578753204,3578753219,15
0,1354,47634,3578753204,3578753219,15
0,1354,47635,3578753204,3578753219,15
0,1354,47636,3578753204,3578753219,15
0,1354,47637,3578753204,3578753219,15
0,1354,47638,3578753204,3578753220,16
0,1354,47639,3578753204,3578753221,17
0,1354,47640,3578753204,3578753222,18
0,1354,47641,3578753204,3578753224,20
0,1354,47642,3578753204,3578753225,21
0,1354,47643,3578753204,3578753225,21
0,1354,47644,3578753204,3578753225,21
0,1354,47645,3578753204,3578753227,23
0,1354,47646,3578753204,3578753227,23
0,1354,47647,3578753204,3578753229,25
0,1354,47648,3578753204,3578753229,25
0,1354,47649,3578753204,3578753230,26
0,1354,47650,3578753204,3578753230,26
0,1354,47651,3578753204,3578753232,28
0,1354,47652,3578753204,3578753233,29
0,1354,47653,3578753204,3578753233,29
0,1354,47654,3578753204,3578753233,29
0,1354,47655,3578753204,3578753235,31
0,1354,47656,3578753204,3578753235,31
0,1354,47657,3578753204,3578753236,32
0,1354,47658,3578753204,3578753237,33
0,1354,47659,3578753204,3578753238,34
0,1354,47660,3578753204,3578753238,34
0,1354,47661,3578753204,3578753239,35
0,1354,47662,3578753204,3578753239,35
0,1354,47663,3578753204,3578753239,35
0,1354,47664,3578753204,3578753240,36
0,1354,47665,3578753204,3578753240,36
0,1354,47666,3578753204,3578753240,36
0,1354,47667,3578753204,3578753241,37
0,1354,47668,3578753204,3578753242,38
0,1354,47669,3578753204,3578753243,39
0,1354,47670,3578753204,3578753244,40
0,1354,47671,3578753204,3578753244,40
0,1354,47672,3578753204,3578753244,40
0,1354,47673,3578753204,3578753245,41
0,1354,47674,3578753204,3578753245,41
0,1354,47675,3578753204,3578753247,43
0,1354,47676,3578753204,3578753247,43
0,1354,47677,3578753204,3578753248,44
0,1354,47678,3578753204,3578753248,44
0,1354,47679,3578753204,3578753250,46
0,1354,47680,3578753204,3578753250,46
0,1354,47681,3578753204,3578753250,46
0,1354,47682,3578753204,3578753250,46
0,1354,47683,3578753204,3578753252,48
0,1354,47684,3578753204,3578753253,49
0,1354,47685,3578753204,3578753254,50
0,1355,47686,3578753266,3578753266,0
0,1355,47687,3578753266,3578753266,0
0,1355,47688,3578753266,3578753267,1
0,1355,47689,3578753266,3578753267,1
0,1355,47690,3578753266,3578753267,1
0,1355,47691,3578753266,3578753267,1
0,1355,47692,3578753266,3578753267,1
0,1355,47693,3578753266,3578753267,1
0,1355,47694,3578753266,3578753267,1
0,1355,47695,3578753266,3578753267,1
0,1355,47696,3578753266,3578753267,1
0,1355,47697,3578753266,3578753267,1
0,1355,47698,3578753266,3578753267,1
0,1355,47699,3578753266,3578753267,1
0,1355,47700,3578753266,3578753267,1
0,1355,47701,3578753266,3578753267,1
0,1355,47702,3578753266,3578753267,1
0,1355,47703,3578753266,3578753267,1
0,1355,47704,3578753266,3578753267,1
0,1355,47705,3578753266,3578753268,2
0,1355,47706,3578753266,3578753280,14
0,1355,47707,3578753266,3578753281,15
0,1355,47708,3578753266,3578753281,15
0,1355,47709,3578753266,3578753282,16
0,1355,47710,3578753266,3578753284,18
0,1355,47711,3578753266,3578753285,19
0,1355,47712,3578753266,3578753286,20
0,1355,47713,3578753266,3578753287,21
0,1355,47714,3578753266,3578753287,21
0,1355,47715,3578753266,3578753287,21
0,1355,47716,3578753266,3578753287,21
0,1355,47717,3578753266,3578753289,23
0,1355,47718,3578753266,3578753289,23
0,1355,47719,3578753266,3578753289,23
0,1355,47720,3578753266,3578753290,24
0,1355,47721,3578753266,3578753290,24
0,1355,47722,3578753266,3578753290,24
0,1355,47723,3578753266,3578753291,25
0,1355,47724,3578753266,3578753291,25
0,1355,47725,3578753266,3578753291,25
0,1355,47726,3578753266,3578753291,25
0,1355,47727,3578753266,3578753293,27
0,1355,47728,3578753266,3578753293,27
0,1355,47729,3578753266,3578753293,27
0,1355,47730,3578753266,3578753294,28
0,1355,47731,3578753266,3578753295,29
0,1355,47732,3578753266,3578753295,29
0,1355,47733,3578753266,3578753296,30
0,1355,47734,3578753266,3578753296,30
0,1355,47735,3578753266,3578753296,30
0,1355,47736,3578753266,3578753296,30
0,1355,47737,3578753266,3578753297,31
0,1355,47738,3578753266,3578753297,31
0,1355,47739,3578753266,3578753298,32
0,1355,47740,3578753266,3578753299,33
0,1355,47741,3578753266,3578753300,34
0,1355,47742,3578753266,3578753301,35
0,1355,47743,3578753266,3578753304,38
0,1355,47744,3578753266,3578753305,39
0,1355,47745,3578753266,3578753305,39
0,1355,47746,3578753266,3578753305,39
0,1355,47747,3578753266,3578753306,40
0,1355,47748,3578753266,3578753307,41
0,1355,47749,3578753266,3578753308,42
0,1355,47750,3578753266,3578753308,42
0,1355,47751,3578753266,3578753308,42
0,1355,47752,3578753266,3578753309,43
0,1355,47753,3578753266,3578753309,43
0,1355,47754,3578753266,3578753309,43
0,1355,47755,3578753266,3578753310,44
0,1355,47756,3578753266,3578753311,45
0,1355,47757,3578753266,3578753311,45
0,1355,47758,3578753266,3578753311,45
0,1355,47759,3578753266,3578753311,45
0,1355,47760,3578753266,3578753312,46
0,1355,47761,3578753266,3578753312,46
0,1355,47762,3578753266,3578753312,46
0,1355,47763,3578753266,3578753313,47
0,1355,47764,3578753266,3578753313,47
0,1355,47765,3578753266,3578753315,49
0,1355,47766,3578753266,3578753315,49
0,1355,47767,3578753266,3578753315,49
0,1355,47768,3578753266,3578753316,50
0,1356,47769,3578753330,3578753330,0
0,1356,47770,3578753330,3578753330,0
0,1356,47771,3578753330,3578753330,0
0,1356,47772,3578753330,3578753330,0
0,1356,47773,3578753330,3578753330,0
0,1356,47774,3578753330,3578753330,0
0,1356,47775,3578753330,3578753330,0
0,1356,47776,3578753330,3578753330,0
0,1356,47777,3578753330,3578753330,0
0,1356,47778,3578753330,3578753330,0
0,1356,47779,3578753330,3578753330,0
0,1356,47780,3578753330,3578753330,0
0,1356,47781,3578753330,3578753330,0
0,1356,47782,3578753330,3578753330,0
0,1356,47783,3578753330,3578753330,0
0,1356,47784,3578753330,3578753330,0
0,1356,47785,3578753330,3578753330,0
0,1356,47786,3578753330,3578753330,0
0,1356,47787,3578753330,3578753330,0
0,1356,47788,3578753330,3578753330,0
0,1356,47789,3578753330,3578753330,0
0,1356,47790,3578753330,3578753330,0
0,1356,47791,3578753330,3578753330,0
0,1356,47792,3578753330,3578753330,0
0,1356,47793,3578753330,3578753330,0
0,1356,47794,3578753330,3578753330,0
0,1356,47795,3578753330,3578753330,0
0,1356,47796,3578753330,3578753330,0
0,1356,47797,3578753330,3578753330,0
0,1356,47798,3578753330,3578753330,0
0,1356,47799,3578753330,3578753330,0
0,1356,47800,3578753330,3578753330,0
0,1356,47801,3578753330,3578753331,1
0,1356,47802,3578753330,3578753331,1
0,1356,47803,3578753330,3578753331,1
0,1356,47804,3578753330,3578753332,2
0,1356,47805,3578753330,3578753332,2
0,1356,47806,3578753330,3578753333,3
0,1356,47807,3578753330,3578753333,3
0,1356,47808,3578753330,3578753334,4
0,1356,47809,3578753330,3578753335,5
0,1356,47810,3578753330,3578753338,8
0,1356,47811,3578753330,3578753340,10
0,1356,47812,3578753330,3578753340,10
0,1356,47813,3578753330,3578753340,10
0,1356,47814,3578753330,3578753341,11
0,1356,47815,3578753330,3578753341,11
0,1356,47816,3578753330,3578753341,11
0,1356,47817,3578753330,3578753341,11
0,1356,47818,3578753330,3578753341,11
0,1356,47819,3578753330,3578753342,12
0,1356,47820,3578753330,3578753343,13
0,1356,47821,3578753330,3578753343,13
0,1356,47822,3578753330,3578753343,13
0,1356,47823,3578753330,3578753344,14
0,1356,47824,3578753330,3578753344,14
0,1356,47825,3578753330,3578753344,14
0,1356,47826,3578753330,3578753344,14
0,1356,47827,3578753330,3578753346,16
0,1356,47828,3578753330,3578753346,16
0,1356,47829,3578753330,3578753347,17
0,1356,47830,3578753330,3578753348,18
0,1356,47831,3578753330,3578753350,20
0,1356,47832,3578753330,3578753350,20
0,1356,47833,3578753330,3578753351,21
0,1356,47834,3578753330,3578753353,23
0,1356,47835,3578753330,3578753353,23
0,1356,47836,3578753330,3578753353,23
0,1356,47837,3578753330,3578753353,23
0,1356,47838,3578753330,3578753355,25
0,1356,47839,3578753330,3578753355,25
0,1356,47840,3578753330,3578753356,26
0,1356,47841,3578753330,3578753356,26
0,1356,47842,3578753330,3578753358,28
0,1356,47843,3578753330,3578753358,28
0,1356,47844,3578753330,3578753359,29
0,1356,47845,3578753330,3578753360,30
0,1356,47846,3578753330,3578753361,31
0,1356,47847,3578753330,3578753361,31
0,1356,47848,3578753330,3578753361,31
0,1356,47849,3578753330,3578753362,32
0,1356,47850,3578753330,3578753362,32
0,1356,47851,3578753330,3578753362,32
0,1356,47852,3578753330,3578753363,33
0,1356,47853,3578753330,3578753363,33
0,1356,47854,3578753330,3578753364,34
0,1356,47855,3578753330,3578753364,34
0,1356,47856,3578753330,3578753365,35
0,1356,47857,3578753330,3578753366,36
0,1356,47858,3578753330,3578753366,36
0,1356,47859,3578753330,3578753367,37
0,1356,47860,3578753330,3578753368,38
0,1356,47861,3578753330,3578753369,39
0,1356,47862,3578753330,3578753370,40
0,1356,47863,3578753330,3578753371,41
0,1356,47864,3578753330,3578753371,41
0,1356,47865,3578753330,3578753372,42
0,1356,47866,3578753330,3578753373,43
0,1356,47867,3578753330,3578753374,44
0,1356,47868,3578753330,3578753374,44
0,1356,47869,3578753330,3578753375,45
0,1356,47870,3578753330,3578753377,47
0,1356,47871,3578753330,3578753377,47
0,1356,47872,3578753330,3578753377,47
0,1356,47873,3578753330,3578753378,48
0,1356,47874,3578753330,3578753379,49
0,1356,47875,3578753330,3578753379,49
0,1356,47876,3578753330,3578753379,49
0,1357,47877,3578753393,3578753393,0
0,1357,47878,3578753393,3578753393,0
0,1357,47879,3578753393,3578753393,0
0,1357,47880,3578753393,3578753393,0
0,1357,47881,3578753393,3578753393,0
0,1357,47882,3578753393,3578753393,0
0,1357,47883,3578753393,3578753393,0
0,1357,47884,3578753393,3578753393,0
0,1357,47885,3578753393,3578753393,0
0,1357,47886,3578753393,3578753393,0
0,1357,47887,3578753393,3578753393,0
0,1357,47888,3578753393,3578753393,0
0,1357,47889,3578753393,3578753393,0
0,1357,47890,3578753393,3578753393,0
0,1357,47891,3578753393,3578753393,0
0,1357,47892,3578753393,3578753393,0
0,1357,47893,3578753393,3578753393,0
0,1357,47894,3578753393,3578753394,1
0,1357,47895,3578753393,3578753394,1
0,1357,47896,3578753393,3578753395,2
0,1357,47897,3578753393,3578753398,5
0,1357,47898,3578753393,3578753401,8
0,1357,47899,3578753393,3578753401,8
0,1357,47900,3578753393,3578753401,8
0,1357,47901,3578753393,3578753402,9
0,1357,47902,3578753393,3578753402,9
0,1357,47903,3578753393,3578753404,11
0,1357,47904,3578753393,3578753404,11
0,1357,47905,3578753393,3578753405,12
0,1357,47906,3578753393,3578753406,13
0,1357,47907,3578753393,3578753406,13
0,1357,47908,3578753393,3578753407,14
0,1357,47909,3578753393,3578753407,14
0,1357,47910,3578753393,3578753407,14
0,1357,47911,3578753393,3578753408,15
0,1357,47912,3578753393,3578753408,15
0,1357,47913,3578753393,3578753409,16
0,1357,47914,3578753393,3578753410,17
0,1357,47915,3578753393,3578753411,18
0,1357,47916,3578753393,3578753412,19
0,1357,47917,3578753393,3578753414,21
0,1357,47918,3578753393,3578753415,22
0,1357,47919,3578753393,3578753415,22
0,1357,47920,3578753393,3578753415,22
0,1357,47921,3578753393,3578753415,22
0,1357,47922,3578753393,3578753415,22
0,1357,47923,3578753393,3578753415,22
0,1357,47924,3578753393,3578753416,23
0,1357,47925,3578753393,3578753418,25
0,1357,47926,3578753393,3578753419,26
0,1357,47927,3578753393,3578753419,26
0,1357,47928,3578753393,3578753419,26
0,1357,47929,3578753393,3578753419,26
0,1357,47930,3578753393,3578753420,27
0,1357,47931,3578753393,3578753420,27
0,1357,47932,3578753393,3578753422,29
0,1357,47933,3578753393,3578753422,29
0,1357,47934,3578753393,3578753424,31
0,1357,47935,3578753393,3578753425,32
0,1357,47936,3578753393,3578753425,32
0,1357,47937,3578753393,3578753426,33
0,1357,47938,3578753393,3578753427,34
0,1357,47939,3578753393,3578753428,35
0,1357,47940,3578753393,3578753429,36
0,1357,47941,3578753393,3578753429,36
0,1357,47942,3578753393,3578753430,37
0,1357,47943,3578753393,3578753430,37
0,1357,47944,3578753393,3578753431,38
0,1357,47945,3578753393,3578753432,39
0,1357,47946,3578753393,3578753432,39
0,1357,47947,3578753393,3578753433,40
0,1357,47948,3578753393,3578753433,40
0,1357,47949,3578753393,3578753434,41
0,1357,47950,3578753393,3578753436,43
0,1357,47951,3578753393,3578753437,44
0,1357,47952,3578753393,3578753437,44
0,1357,47953,3578753393,3578753438,45
0,1357,47954,3578753393,3578753439,46
0,1357,47955,3578753393,3578753439,46
0,1357,47956,3578753393,3578753439,46
0,1357,47957,3578753393,3578753440,47
0,1357,47958,3578753393,3578753440,47
0,1357,47959,3578753393,3578753441,48
0,1357,47960,3578753393,3578753442,49
0,1358,47961,3578753455,3578753455,0
0,1358,47962,3578753455,3578753455,0
0,1358,47963,3578753455,3578753455,0
0,1358,47964,3578753455,3578753455,0
0,1358,47965,3578753455,3578753455,0
0,1358,47966,3578753455,3578753455,0
0,1358,47967,3578753455,3578753455,0
0,1358,47968,3578753455,3578753455,0
0,1358,47969,3578753455,3578753455,0
0,1358,47970,3578753455,3578753455,0
0,1358,47971,3578753455,3578753455,0
0,1358,47972,3578753455,3578753455,0
0,1358,47973,3578753455,3578753455,0
0,1358,47974,3578753455,3578753455,0
0,1358,47975,3578753455,3578753455,0
0,1358,47976,3578753455,3578753455,0
0,1358,47977,3578753455,3578753455,0
0,1358,47978,3578753455,3578753455,0
0,1358,47979,3578753455,3578753456,1
0,1358,47980,3578753455,3578753457,2
0,1358,47981,3578753455,3578753457,2
0,1358,47982,3578753455,3578753459,4
0,1358,47983,3578753455,3578753459,4
0,1358,47984,3578753455,3578753462,7
0,1358,47985,3578753455,3578753462,7
0,1358,47986,3578753455,3578753462,7
0,1358,47987,3578753455,3578753464,9
0,1358,47988,3578753455,3578753464,9
0,1358,47989,3578753455,3578753464,9
0,1358,47990,3578753455,3578753465,10
0,1358,47991,3578753455,3578753465,10
0,1358,47992,3578753455,3578753466,11
0,1358,47993,3578753455,3578753467,12
0,1358,47994,3578753455,3578753467,12
0,1358,47995,3578753455,3578753467,12
0,1358,47996,3578753455,3578753468,13
0,1358,47997,3578753455,3578753468,13
0,1358,47998,3578753455,3578753470,15
0,1358,47999,3578753455,3578753480,25
0,1358,48000,3578753455,3578753480,25
0,1358,48001,3578753455,3578753481,26
0,1358,48002,3578753455,3578753481,26
0,1358,48003,3578753455,3578753483,28
0,1358,48004,3578753455,3578753485,30
0,1358,48005,3578753455,3578753486,31
0,1358,48006,3578753455,3578753486,31
0,1358,48007,3578753455,3578753486,31
0,1358,48008,3578753455,3578753487,32
0,1358,48009,3578753455,3578753487,32
0,1358,48010,3578753455,3578753487,32
0,1358,48011,3578753455,3578753488,33
0,1358,48012,3578753455,3578753489,34
0,1358,48013,3578753455,3578753489,34
0,1358,48014,3578753455,3578753490,35
0,1358,48015,3578753455,3578753490,35
0,1358,48016,3578753455,3578753490,35
0,1358,48017,3578753455,3578753490,35
0,1358,48018,3578753455,3578753491,36
0,1358,48019,3578753455,3578753491,36
0,1358,48020,3578753455,3578753491,36
0,1358,48021,3578753455,3578753493,38
0,1358,48022,3578753455,3578753493,38
0,1358,48023,3578753455,3578753495,40
0,1358,48024,3578753455,3578753495,40
0,1358,48025,3578753455,3578753495,40
0,1358,48026,3578753455,3578753496,41
0,1358,48027,3578753455,3578753496,41
0,1358,48028,3578753455,3578753496,41
0,1358,48029,3578753455,3578753496,41
0,1358,48030,3578753455,3578753498,43
0,1358,48031,3578753455,3578753498,43
0,1358,48032,3578753455,3578753498,43
0,1358,48033,3578753455,3578753499,44
0,1358,48034,3578753455,3578753501,46
0,1358,48035,3578753455,3578753502,47
0,1358,48036,3578753455,3578753504,49
0,1358,48037,3578753455,3578753504,49
0,1358,48038,3578753455,3578753505,50
0,1359,48039,3578753517,3578753517,0
0,1359,48040,3578753517,3578753517,0
0,1359,48041,3578753517,3578753517,0
0,1359,48042,3578753517,3578753517,0
0,1359,48043,3578753517,3578753517,0
0,1359,48044,3578753517,3578753517,0
0,1359,48045,3578753517,3578753517,0
0,1359,48046,3578753517,3578753517,0
0,1359,48047,3578753517,3578753517,0
0,1359,48048,3578753517,3578753517,0
0,1359,48049,3578753517,3578753517,0
0,1359,48050,3578753517,3578753517,0
0,1359,48051,3578753517,3578753517,0
0,1359,48052,3578753517,3578753517,0
0,1359,48053,3578753517,3578753517,0
0,1359,48054,3578753517,3578753517,0
0,1359,48055,3578753517,3578753517,0
0,1359,48056,3578753517,3578753517,0
0,1359,48057,3578753517,3578753517,0
0,1359,48058,3578753517,3578753517,0
0,1359,48059,3578753517,3578753517,0
0,1359,48060,3578753517,3578753517,0
0,1359,48061,3578753517,3578753517,0
0,1359,48062,3578753517,3578753517,0
0,1359,48063,3578753517,3578753517,0
0,1359,48064,3578753517,3578753517,0
0,1359,48065,3578753517,3578753517,0
0,1359,48066,3578753517,3578753517,0
0,1359,48067,3578753517,3578753517,0
0,1359,48068,3578753517,3578753517,0
0,1359,48069,3578753517,3578753517,0
0,1359,48070,3578753517,3578753518,1
0,1359,48071,3578753517,3578753518,1
0,1359,48072,3578753517,3578753519,2
0,1359,48073,3578753517,3578753519,2
0,1359,48074,3578753517,3578753519,2
0,1359,48075,3578753517,3578753521,4
0,1359,48076,3578753517,3578753522,5
0,1359,48077,3578753517,3578753523,6
0,1359,48078,3578753517,3578753524,7
0,1359,48079,3578753517,3578753525,8
0,1359,48080,3578753517,3578753526,9
0,1359,48081,3578753517,3578753526,9
0,1359,48082,3578753517,3578753527,10
0,1359,48083,3578753517,3578753527,10
0,1359,48084,3578753517,3578753527,10
0,1359,48085,3578753517,3578753527,10
0,1359,48086,3578753517,3578753528,11
0,1359,48087,3578753517,3578753529,12
0,1359,48088,3578753517,3578753529,12
0,1359,48089,3578753517,3578753530,13
0,1359,48090,3578753517,3578753530,13
0,1359,48091,3578753517,3578753530,13
0,1359,48092,3578753517,3578753532,15
0,1359,48093,3578753517,3578753532,15
0,1359,48094,3578753517,3578753532,15
0,1359,48095,3578753517,3578753532,15
0,1359,48096,3578753517,3578753533,16
0,1359,48097,3578753517,3578753534,17
0,1359,48098,3578753517,3578753536,19
0,1359,48099,3578753517,3578753539,22
0,1359,48100,3578753517,3578753539,22
0,1359,48101,3578753517,3578753539,22
0,1359,48102,3578753517,3578753539,22
0,1359,48103,3578753517,3578753540,23
0,1359,48104,3578753517,3578753540,23
0,1359,48105,3578753517,3578753540,23
0,1359,48106,3578753517,3578753541,24
0,1359,48107,3578753517,3578753541,24
0,1359,48108,3578753517,3578753541,24
0,1359,48109,3578753517,3578753542,25
0,1359,48110,3578753517,3578753542,25
0,1359,48111,3578753517,3578753542,25
0,1359,48112,3578753517,3578753543,26
0,1359,48113,3578753517,3578753544,27
0,1359,48114,3578753517,3578753544,27
0,1359,48115,3578753517,3578753545,28
0,1359,48116,3578753517,3578753545,28
0,1359,48117,3578753517,3578753545,28
0,1359,48118,3578753517,3578753545,28
0,1359,48119,3578753517,3578753547,30
0,1359,48120,3578753517,3578753548,31
0,1359,48121,3578753517,3578753549,32
0,1359,48122,3578753517,3578753550,33
0,1359,48123,3578753517,3578753550,33
0,1359,48124,3578753517,3578753551,34
0,1359,48125,3578753517,3578753552,35
0,1359,48126,3578753517,3578753552,35
0,1359,48127,3578753517,3578753553,36
0,1359,48128,3578753517,3578753553,36
0,1359,48129,3578753517,3578753554,37
0,1359,48130,3578753517,3578753555,38
0,1359,48131,3578753517,3578753555,38
0,1359,48132,3578753517,3578753555,38
0,1359,48133,3578753517,3578753557,40
0,1359,48134,3578753517,3578753558,41
0,1359,48135,3578753517,3578753558,41
0,1359,48136,3578753517,3578753559,42
0,1359,48137,3578753517,3578753559,42
0,1359,48138,3578753517,3578753560,43
0,1359,48139,3578753517,3578753560,43
0,1359,48140,3578753517,3578753561,44
0,1359,48141,3578753517,3578753561,44
0,1359,48142,3578753517,3578753561,44
0,1359,48143,3578753517,3578753562,45
0,1359,48144,3578753517,3578753564,47
0,1359,48145,3578753517,3578753564,47
0,1359,48146,3578753517,3578753564,47
0,1359,48147,3578753517,3578753564,47
0,1359,48148,3578753517,3578753564,47
0,1359,48149,3578753517,3578753566,49
0,1359,48150,3578753517,3578753566,49
0,1360,48151,3578753580,3578753580,0
0,1360,48152,3578753580,3578753580,0
0,1360,48153,3578753580,3578753580,0
0,1360,48154,3578753580,3578753580,0
0,1360,48155,3578753580,3578753580,0
0,1360,48156,3578753580,3578753580,0
0,1360,48157,3578753580,3578753580,0
0,1360,48158,3578753580,3578753580,0
0,1360,48159,3578753580,3578753580,0
0,1360,48160,3578753580,3578753580,0
0,1360,48161,3578753580,3578753580,0
0,1360,48162,3578753580,3578753580,0
0,1360,48163,3578753580,3578753580,0
0,1360,48164,3578753580,3578753580,0
0,1360,48165,3578753580,3578753580,0
0,1360,48166,3578753580,3578753580,0
0,1360,48167,3578753580,3578753580,0
0,1360,48168,3578753580,3578753580,0
0,1360,48169,3578753580,3578753581,1
0,1360,48170,3578753580,3578753582,2
0,1360,48171,3578753580,3578753583,3
0,1360,48172,3578753580,3578753583,3
0,1360,48173,3578753580,3578753583,3
0,1360,48174,3578753580,3578753584,4
0,1360,48175,3578753580,3578753585,5
0,1360,48176,3578753580,3578753585,5
0,1360,48177,3578753580,3578753586,6
0,1360,48178,3578753580,3578753588,8
0,1360,48179,3578753580,3578753588,8
0,1360,48180,3578753580,3578753588,8
0,1360,48181,3578753580,3578753588,8
0,1360,48182,3578753580,3578753589,9
0,1360,48183,3578753580,3578753589,9
0,1360,48184,3578753580,3578753590,10
0,1360,48185,3578753580,3578753592,12
0,1360,48186,3578753580,3578753593,13
0,1360,48187,3578753580,3578753593,13
0,1360,48188,3578753580,3578753594,14
0,1360,48189,3578753580,3578753598,18
0,1360,48190,3578753580,3578753600,20
0,1360,48191,3578753580,3578753600,20
0,1360,48192,3578753580,3578753601,21
0,1360,48193,3578753580,3578753601,21
0,1360,48194,3578753580,3578753602,22
0,1360,48195,3578753580,3578753603,23
0,1360,48196,3578753580,3578753604,24
0,1360,48197,3578753580,3578753604,24
0,1360,48198,3578753580,3578753605,25
0,1360,48199,3578753580,3578753606,26
0,1360,48200,3578753580,3578753606,26
0,1360,48201,3578753580,3578753606,26
0,1360,48202,3578753580,3578753606,26
0,1360,48203,3578753580,3578753607,27
0,1360,48204,3578753580,3578753608,28
0,1360,48205,3578753580,3578753608,28
0,1360,48206,3578753580,3578753609,29
0,1360,48207,3578753580,3578753610,30
0,1360,48208,3578753580,3578753611,31
0,1360,48209,3578753580,3578753613,33
0,1360,48210,3578753580,3578753614,34
0,1360,48211,3578753580,3578753614,34
0,1360,48212,3578753580,3578753614,34
0,1360,48213,3578753580,3578753614,34
0,1360,48214,3578753580,3578753614,34
0,1360,48215,3578753580,3578753614,34
0,1360,48216,3578753580,3578753615,35
0,1360,48217,3578753580,3578753615,35
0,1360,48218,3578753580,3578753617,37
0,1360,48219,3578753580,3578753618,38
0,1360,48220,3578753580,3578753618,38
0,1360,48221,3578753580,3578753618,38
0,1360,48222,3578753580,3578753619,39
0,1360,48223,3578753580,3578753621,41
0,1360,48224,3578753580,3578753621,41
0,1360,48225,3578753580,3578753621,41
0,1360,48226,3578753580,3578753621,41
0,1360,48227,3578753580,3578753624,44
0,1360,48228,3578753580,3578753624,44
0,1360,48229,3578753580,3578753624,44
0,1360,48230,3578753580,3578753624,44
0,1360,48231,3578753580,3578753626,46
0,1360,48232,3578753580,3578753627,47
0,1360,48233,3578753580,3578753627,47
0,1360,48234,3578753580,3578753628,48
0,1360,48235,3578753580,3578753628,48
0,1360,48236,3578753580,3578753629,49
0,1360,48237,3578753580,3578753629,49
0,1361,48238,3578753643,3578753643,0
0,1361,48239,3578753643,3578753643,0
0,1361,48240,3578753643,3578753643,0
0,1361,48241,3578753643,3578753643,0
0,1361,48242,3578753643,3578753643,0
0,1361,48243,3578753643,3578753643,0
0,1361,48244,3578753643,3578753643,0
0,1361,48245,3578753643,3578753643,0
0,1361,48246,3578753643,3578753643,0
0,1361,48247,3578753643,3578753643,0
0,1361,48248,3578753643,3578753643,0
0,1361,48249,3578753643,3578753643,0
0,1361,48250,3578753643,3578753643,0
0,1361,48251,3578753643,3578753643,0
0,1361,48252,3578753643,3578753643,0
0,1361,48253,3578753643,3578753643,0
0,1361,48254,3578753643,3578753643,0
0,1361,48255,3578753643,3578753643,0
0,1361,48256,3578753643,3578753643,0
0,1361,48257,3578753643,3578753643,0
0,1361,48258,3578753643,3578753643,0
0,1361,48259,3578753643,3578753643,0
0,1361,48260,3578753643,3578753643,0
0,1361,48261,3578753643,3578753646,3
0,1361,48262,3578753643,3578753647,4
0,1361,48263,3578753643,3578753647,4
0,1361,48264,3578753643,3578753647,4
0,1361,48265,3578753643,3578753648,5
0,1361,48266,3578753643,3578753649,6
0,1361,48267,3578753643,3578753649,6
0,1361,48268,3578753643,3578753649,6
0,1361,48269,3578753643,3578753649,6
0,1361,48270,3578753643,3578753652,9
0,1361,48271,3578753643,3578753652,9
0,1361,48272,3578753643,3578753654,11
0,1361,48273,3578753643,3578753654,11
0,1361,48274,3578753643,3578753655,12
0,1361,48275,3578753643,3578753656,13
0,1361,48276,3578753643,3578753656,13
0,1361,48277,3578753643,3578753658,15
0,1361,48278,3578753643,3578753658,15
0,1361,48279,3578753643,3578753661,18
0,1361,48280,3578753643,3578753661,18
0,1361,48281,3578753643,3578753662,19
0,1361,48282,3578753643,3578753663,20
0,1361,48283,3578753643,3578753663,20
0,1361,48284,3578753643,3578753664,21
0,1361,48285,3578753643,3578753664,21
0,1361,48286,3578753643,3578753664,21
0,1361,48287,3578753643,3578753665,22
0,1361,48288,3578753643,3578753666,23
0,1361,48289,3578753643,3578753666,23
0,1361,48290,3578753643,3578753666,23
0,1361,48291,3578753643,3578753667,24
0,1361,48292,3578753643,3578753667,24
0,1361,48293,3578753643,3578753680,37
0,1361,48294,3578753643,3578753681,38
0,1361,48295,3578753643,3578753681,38
0,1361,48296,3578753643,3578753681,38
0,1361,48297,3578753643,3578753684,41
0,1361,48298,3578753643,3578753684,41
0,1361,48299,3578753643,3578753685,42
0,1361,48300,3578753643,3578753686,43
0,1361,48301,3578753643,3578753687,44
0,1361,48302,3578753643,3578753687,44
0,1361,48303,3578753643,3578753687,44
0,1361,48304,3578753643,3578753687,44
0,1361,48305,3578753643,3578753687,44
0,1361,48306,3578753643,3578753688,45
0,1361,48307,3578753643,3578753688,45
0,1361,48308,3578753643,3578753689,46
0,1361,48309,3578753643,3578753690,47
0,1361,48310,3578753643,3578753691,48
0,1361,48311,3578753643,3578753691,48
0,1361,48312,3578753643,3578753691,48
0,1361,48313,3578753643,3578753691,48
0,1361,48314,3578753643,3578753691,48
0,1361,48315,3578753643,3578753691,48
0,1362,48316,3578753706,3578753706,0
0,1362,48317,3578753706,3578753706,0
0,1362,48318,3578753706,3578753706,0
0,1362,48319,3578753706,3578753706,0
0,1362,48320,3578753706,3578753706,0
0,1362,48321,3578753706,3578753706,0
0,1362,48322,3578753706,3578753706,0
0,1362,48323,3578753706,3578753706,0
0,1362,48324,3578753706,3578753706,0
0,1362,48325,3578753706,3578753706,0
0,1362,48326,3578753706,3578753706,0
0,1362,48327,3578753706,3578753706,0
0,1362,48328,3578753706,3578753706,0
0,1362,48329,3578753706,3578753706,0
0,1362,48330,3578753706,3578753706,0
0,1362,48331,3578753706,3578753706,0
0,1362,48332,3578753706,3578753706,0
0,1362,48333,3578753706,3578753706,0
0,1362,48334,3578753706,3578753706,0
0,1362,48335,3578753706,3578753706,0
0,1362,48336,3578753706,3578753706,0
0,1362,48337,3578753706,3578753707,1
0,1362,48338,3578753706,3578753707,1
0,1362,48339,3578753706,3578753708,2
0,1362,48340,3578753706,3578753708,2
0,1362,48341,3578753706,3578753708,2
0,1362,48342,3578753706,3578753709,3
0,1362,48343,3578753706,3578753709,3
0,1362,48344,3578753706,3578753710,4
0,1362,48345,3578753706,3578753710,4
0,1362,48346,3578753706,3578753710,4
0,1362,48347,3578753706,3578753710,4
0,1362,48348,3578753706,3578753711,5
0,1362,48349,3578753706,3578753711,5
0,1362,48350,3578753706,3578753712,6
0,1362,48351,3578753706,3578753712,6
0,1362,48352,3578753706,3578753712,6
0,1362,48353,3578753706,3578753712,6
0,1362,48354,3578753706,3578753713,7
0,1362,48355,3578753706,3578753714,8
0,1362,48356,3578753706,3578753714,8
0,1362,48357,3578753706,3578753715,9
0,1362,48358,3578753706,3578753715,9
0,1362,48359,3578753706,3578753715,9
0,1362,48360,3578753706,3578753716,10
0,1362,48361,3578753706,3578753716,10
0,1362,48362,3578753706,3578753716,10
0,1362,48363,3578753706,3578753716,10
0,1362,48364,3578753706,3578753717,11
0,1362,48365,3578753706,3578753717,11
0,1362,48366,3578753706,3578753717,11
0,1362,48367,3578753706,3578753717,11
0,1362,48368,3578753706,3578753718,12
0,1362,48369,3578753706,3578753718,12
0,1362,48370,3578753706,3578753718,12
0,1362,48371,3578753706,3578753719,13
0,1362,48372,3578753706,3578753719,13
0,1362,48373,3578753706,3578753720,14
0,1362,48374,3578753706,3578753720,14
0,1362,48375,3578753706,3578753721,15
0,1362,48376,3578753706,3578753723,17
0,1362,48377,3578753706,3578753723,17
0,1362,48378,3578753706,3578753724,18
0,1362,48379,3578753706,3578753724,18
0,1362,48380,3578753706,3578753726,20
0,1362,48381,3578753706,3578753726,20
0,1362,48382,3578753706,3578753726,20
0,1362,48383,3578753706,3578753727,21
0,1362,48384,3578753706,3578753727,21
0,1362,48385,3578753706,3578753727,21
0,1362,48386,3578753706,3578753728,22
0,1362,48387,3578753706,3578753728,22
0,1362,48388,3578753706,3578753728,22
0,1362,48389,3578753706,3578753729,23
0,1362,48390,3578753706,3578753729,23
0,1362,48391,3578753706,3578753730,24
0,1362,48392,3578753706,3578753730,24
0,1362,48393,3578753706,3578753730,24
0,1362,48394,3578753706,3578753731,25
0,1362,48395,3578753706,3578753732,26
0,1362,48396,3578753706,3578753732,26
0,1362,48397,3578753706,3578753732,26
0,1362,48398,3578753706,3578753733,27
0,1362,48399,3578753706,3578753734,28
0,1362,48400,3578753706,3578753736,30
0,1362,48401,3578753706,3578753739,33
0,1362,48402,3578753706,3578753739,33
0,1362,48403,3578753706,3578753739,33
0,1362,48404,3578753706,3578753739,33
0,1362,48405,3578753706,3578753740,34
0,1362,48406,3578753706,3578753740,34
0,1362,48407,3578753706,3578753741,35
0,1362,48408,3578753706,3578753741,35
0,1362,48409,3578753706,3578753741,35
0,1362,48410,3578753706,3578753742,36
0,1362,48411,3578753706,3578753742,36
0,1362,48412,3578753706,3578753742,36
0,1362,48413,3578753706,3578753743,37
0,1362,48414,3578753706,3578753743,37
0,1362,48415,3578753706,3578753743,37
0,1362,48416,3578753706,3578753744,38
0,1362,48417,3578753706,3578753746,40
0,1362,48418,3578753706,3578753746,40
0,1362,48419,3578753706,3578753746,40
0,1362,48420,3578753706,3578753746,40
0,1362,48421,3578753706,3578753746,40
0,1362,48422,3578753706,3578753747,41
0,1362,48423,3578753706,3578753748,42
0,1362,48424,3578753706,3578753749,43
0,1362,48425,3578753706,3578753750,44
0,1362,48426,3578753706,3578753751,45
0,1362,48427,3578753706,3578753751,45
0,1362,48428,3578753706,3578753752,46
0,1362,48429,3578753706,3578753753,47
0,1362,48430,3578753706,3578753753,47
0,1362,48431,3578753706,3578753753,47
0,1362,48432,3578753706,3578753755,49
0,1362,48433,3578753706,3578753755,49
0,1362,48434,3578753706,3578753755,49
0,1362,48435,3578753706,3578753756,50
0,1363,48436,3578753769,3578753769,0
0,1363,48437,3578753769,3578753769,0
0,1363,48438,3578753769,3578753769,0
0,1363,48439,3578753769,3578753769,0
0,1363,48440,3578753769,3578753769,0
0,1363,48441,3578753769,3578753769,0
0,1363,48442,3578753769,3578753769,0
0,1363,48443,3578753769,3578753769,0
0,1363,48444,3578753769,3578753769,0
0,1363,48445,3578753769,3578753769,0
0,1363,48446,3578753769,3578753769,0
0,1363,48447,3578753769,3578753769,0
0,1363,48448,3578753769,3578753769,0
0,1363,48449,3578753769,3578753769,0
0,1363,48450,3578753769,3578753769,0
0,1363,48451,3578753769,3578753769,0
0,1363,48452,3578753769,3578753769,0
0,1363,48453,3578753769,3578753769,0
0,1363,48454,3578753769,3578753769,0
0,1363,48455,3578753769,3578753769,0
0,1363,48456,3578753769,3578753769,0
0,1363,48457,3578753769,3578753769,0
0,1363,48458,3578753769,3578753770,1
0,1363,48459,3578753769,3578753771,2
0,1363,48460,3578753769,3578753772,3
0,1363,48461,3578753769,3578753773,4
0,1363,48462,3578753769,3578753773,4
0,1363,48463,3578753769,3578753773,4
0,1363,48464,3578753769,3578753774,5
0,1363,48465,3578753769,3578753776,7
0,1363,48466,3578753769,3578753776,7
0,1363,48467,3578753769,3578753778,9
0,1363,48468,3578753769,3578753778,9
0,1363,48469,3578753769,3578753779,10
0,1363,48470,3578753769,3578753779,10
0,1363,48471,3578753769,3578753780,11
0,1363,48472,3578753769,3578753781,12
0,1363,48473,3578753769,3578753782,13
0,1363,48474,3578753769,3578753783,14
0,1363,48475,3578753769,3578753783,14
0,1363,48476,3578753769,3578753783,14
0,1363,48477,3578753769,3578753784,15
0,1363,48478,3578753769,3578753785,16
0,1363,48479,3578753769,3578753786,17
0,1363,48480,3578753769,3578753786,17
0,1363,48481,3578753769,3578753788,19
0,1363,48482,3578753769,3578753788,19
0,1363,48483,3578753769,3578753788,19
0,1363,48484,3578753769,3578753788,19
0,1363,48485,3578753769,3578753789,20
0,1363,48486,3578753769,3578753789,20
0,1363,48487,3578753769,3578753790,21
0,1363,48488,3578753769,3578753791,22
0,1363,48489,3578753769,3578753792,23
0,1363,48490,3578753769,3578753793,24
0,1363,48491,3578753769,3578753793,24
0,1363,48492,3578753769,3578753793,24
0,1363,48493,3578753769,3578753794,25
0,1363,48494,3578753769,3578753796,27
0,1363,48495,3578753769,3578753798,29
0,1363,48496,3578753769,3578753799,30
0,1363,48497,3578753769,3578753800,31
0,1363,48498,3578753769,3578753801,32
0,1363,48499,3578753769,3578753801,32
0,1363,48500,3578753769,3578753802,33
0,1363,48501,3578753769,3578753803,34
0,1363,48502,3578753769,3578753803,34
0,1363,48503,3578753769,3578753804,35
0,1363,48504,3578753769,3578753805,36
0,1363,48505,3578753769,3578753805,36
0,1363,48506,3578753769,3578753806,37
0,1363,48507,3578753769,3578753806,37
0,1363,48508,3578753769,3578753806,37
0,1363,48509,3578753769,3578753807,38
0,1363,48510,3578753769,3578753807,38
0,1363,48511,3578753769,3578753808,39
0,1363,48512,3578753769,3578753809,40
0,1363,48513,3578753769,3578753809,40
0,1363,48514,3578753769,3578753811,42
0,1363,48515,3578753769,3578753812,43
0,1363,48516,3578753769,3578753813,44
0,1363,48517,3578753769,3578753814,45
0,1363,48518,3578753769,3578753814,45
0,1363,48519,3578753769,3578753814,45
0,1363,48520,3578753769,3578753814,45
0,1363,48521,3578753769,3578753815,46
0,1363,48522,3578753769,3578753815,46
0,1363,48523,3578753769,3578753815,46
0,1363,48524,3578753769,3578753815,46
0,1363,48525,3578753769,3578753818,49
0,1363,48526,3578753769,3578753819,50
0,1364,48527,3578753832,3578753832,0
0,1364,48528,3578753832,3578753832,0
0,1364,48529,3578753832,3578753832,0
0,1364,48530,3578753832,3578753832,0
0,1364,48531,3578753832,3578753832,0
0,1364,48532,3578753832,3578753832,0
0,1364,48533,3578753832,3578753832,0
0,1364,48534,3578753832,3578753832,0
0,1364,48535,3578753832,3578753832,0
0,1364,48536,3578753832,3578753832,0
0,1364,48537,3578753832,3578753832,0
0,1364,48538,3578753832,3578753832,0
0,1364,48539,3578753832,3578753832,0
0,1364,48540,3578753832,3578753832,0
0,1364,48541,3578753832,3578753832,0
0,1364,48542,3578753832,3578753832,0
0,1364,48543,3578753832,3578753832,0
0,1364,48544,3578753832,3578753832,0
0,1364,48545,3578753832,3578753832,0
0,1364,48546,3578753832,3578753832,0
0,1364,48547,3578753832,3578753833,1
0,1364,48548,3578753832,3578753834,2
0,1364,48549,3578753832,3578753835,3
0,1364,48550,3578753832,3578753836,4
0,1364,48551,3578753832,3578753836,4
0,1364,48552,3578753832,3578753836,4
0,1364,48553,3578753832,3578753838,6
0,1364,48554,3578753832,3578753838,6
0,1364,48555,3578753832,3578753838,6
0,1364,48556,3578753832,3578753839,7
0,1364,48557,3578753832,3578753839,7
0,1364,48558,3578753832,3578753840,8
0,1364,48559,3578753832,3578753840,8
0,1364,48560,3578753832,3578753841,9
0,1364,48561,3578753832,3578753842,10
0,1364,48562,3578753832,3578753842,10
0,1364,48563,3578753832,3578753843,11
0,1364,48564,3578753832,3578753843,11
0,1364,48565,3578753832,3578753844,12
0,1364,48566,3578753832,3578753846,14
0,1364,48567,3578753832,3578753847,15
0,1364,48568,3578753832,3578753848,16
0,1364,48569,3578753832,3578753848,16
0,1364,48570,3578753832,3578753849,17
0,1364,48571,3578753832,3578753849,17
0,1364,48572,3578753832,3578753849,17
0,1364,48573,3578753832,3578753849,17
0,1364,48574,3578753832,3578753852,20
0,1364,48575,3578753832,3578753852,20
0,1364,48576,3578753832,3578753853,21
0,1364,48577,3578753832,3578753854,22
0,1364,48578,3578753832,3578753856,24
0,1364,48579,3578753832,3578753856,24
0,1364,48580,3578753832,3578753858,26
0,1364,48581,3578753832,3578753858,26
0,1364,48582,3578753832,3578753858,26
0,1364,48583,3578753832,3578753859,27
0,1364,48584,3578753832,3578753860,28
0,1364,48585,3578753832,3578753862,30
0,1364,48586,3578753832,3578753862,30
0,1364,48587,3578753832,3578753863,31
0,1364,48588,3578753832,3578753864,32
0,1364,48589,3578753832,3578753864,32
0,1364,48590,3578753832,3578753865,33
0,1364,48591,3578753832,3578753865,33
0,1364,48592,3578753832,3578753866,34
0,1364,48593,3578753832,3578753866,34
0,1364,48594,3578753832,3578753866,34
0,1364,48595,3578753832,3578753867,35
0,1364,48596,3578753832,3578753868,36
0,1364,48597,3578753832,3578753880,48
0,1364,48598,3578753832,3578753881,49
0,1364,48599,3578753832,3578753881,49
0,1364,48600,3578753832,3578753882,50
0,1365,48601,3578753893,3578753893,0
0,1365,48602,3578753893,3578753893,0
0,1365,48603,3578753893,3578753893,0
0,1365,48604,3578753893,3578753893,0
0,1365,48605,3578753893,3578753893,0
0,1365,48606,3578753893,3578753893,0
0,1365,48607,3578753893,3578753893,0
0,1365,48608,3578753893,3578753893,0
0,1365,48609,3578753893,3578753893,0
0,1365,48610,3578753893,3578753893,0
0,1365,48611,3578753893,3578753893,0
0,1365,48612,3578753893,3578753893,0
0,1365,48613,3578753893,3578753893,0
0,1365,48614,3578753893,3578753893,0
0,1365,48615,3578753893,3578753893,0
0,1365,48616,3578753893,3578753893,0
0,1365,48617,3578753893,3578753893,0
0,1365,48618,3578753893,3578753893,0
0,1365,48619,3578753893,3578753893,0
0,1365,48620,3578753893,3578753894,1
0,1365,48621,3578753893,3578753894,1
0,1365,48622,3578753893,3578753895,2
0,1365,48623,3578753893,3578753896,3
0,1365,48624,3578753893,3578753896,3
0,1365,48625,3578753893,3578753897,4
0,1365,48626,3578753893,3578753897,4
0,1365,48627,3578753893,3578753897,4
0,1365,48628,3578753893,3578753898,5
0,1365,48629,3578753893,3578753899,6
0,1365,48630,3578753893,3578753900,7
0,1365,48631,3578753893,3578753900,7
0,1365,48632,3578753893,3578753904,11
0,1365,48633,3578753893,3578753904,11
0,1365,48634,3578753893,3578753905,12
0,1365,48635,3578753893,3578753905,12
0,1365,48636,3578753893,3578753907,14
0,1365,48637,3578753893,3578753907,14
0,1365,48638,3578753893,3578753907,14
0,1365,48639,3578753893,3578753908,15
0,1365,48640,3578753893,3578753908,15
0,1365,48641,3578753893,3578753908,15
0,1365,48642,3578753893,3578753909,16
0,1365,48643,3578753893,3578753909,16
0,1365,48644,3578753893,3578753909,16
0,1365,48645,3578753893,3578753910,17
0,1365,48646,3578753893,3578753910,17
0,1365,48647,3578753893,3578753911,18
0,1365,48648,3578753893,3578753911,18
0,1365,48649,3578753893,3578753911,18
0,1365,48650,3578753893,3578753911,18
0,1365,48651,3578753893,3578753911,18
0,1365,48652,3578753893,3578753912,19
0,1365,48653,3578753893,3578753912,19
0,1365,48654,3578753893,3578753912,19
0,1365,48655,3578753893,3578753913,20
0,1365,48656,3578753893,3578753913,20
0,1365,48657,3578753893,3578753914,21
0,1365,48658,3578753893,3578753914,21
0,1365,48659,3578753893,3578753915,22
0,1365,48660,3578753893,3578753915,22
0,1365,48661,3578753893,3578753916,23
0,1365,48662,3578753893,3578753916,23
0,1365,48663,3578753893,3578753917,24
0,1365,48664,3578753893,3578753917,24
0,1365,48665,3578753893,3578753917,24
0,1365,48666,3578753893,3578753917,24
0,1365,48667,3578753893,3578753917,24
0,1365,48668,3578753893,3578753918,25
0,1365,48669,3578753893,3578753918,25
0,1365,48670,3578753893,3578753919,26
0,1365,48671,3578753893,3578753919,26
0,1365,48672,3578753893,3578753919,26
0,1365,48673,3578753893,3578753920,27
0,1365,48674,3578753893,3578753920,27
0,1365,48675,3578753893,3578753922,29
0,1365,48676,3578753893,3578753923,30
0,1365,48677,3578753893,3578753923,30
0,1365,48678,3578753893,3578753924,31
0,1365,48679,3578753893,3578753925,32
0,1365,48680,3578753893,3578753926,33
0,1365,48681,3578753893,3578753926,33
0,1365,48682,3578753893,3578753926,33
0,1365,48683,3578753893,3578753927,34
0,1365,48684,3578753893,3578753927,34
0,1365,48685,3578753893,3578753927,34
0,1365,48686,3578753893,3578753928,35
0,1365,48687,3578753893,3578753928,35
0,1365,48688,3578753893,3578753929,36
0,1365,48689,3578753893,3578753929,36
0,1365,48690,3578753893,3578753929,36
0,1365,48691,3578753893,3578753929,36
0,1365,48692,3578753893,3578753930,37
0,1365,48693,3578753893,3578753931,38
0,1365,48694,3578753893,3578753931,38
0,1365,48695,3578753893,3578753931,38
0,1365,48696,3578753893,3578753932,39
0,1365,48697,3578753893,3578753932,39
0,1365,48698,3578753893,3578753932,39
0,1365,48699,3578753893,3578753932,39
0,1365,48700,3578753893,3578753933,40
0,1365,48701,3578753893,3578753936,43
0,1365,48702,3578753893,3578753936,43
0,1365,48703,3578753893,3578753939,46
0,1365,48704,3578753893,3578753939,46
0,1365,48705,3578753893,3578753939,46
0,1365,48706,3578753893,3578753940,47
0,1365,48707,3578753893,3578753940,47
0,1365,48708,3578753893,3578753941,48
0,1365,48709,3578753893,3578753941,48
0,1365,48710,3578753893,3578753941,48
0,1365,48711,3578753893,3578753941,48
0,1365,48712,3578753893,3578753942,49
0,1365,48713,3578753893,3578753942,49
0,1365,48714,3578753893,3578753942,49
0,1365,48715,3578753893,3578753943,50
0,1366,48716,3578754072,3578754072,0
0,1366,48717,3578754072,3578754072,0
0,1366,48718,3578754072,3578754072,0
0,1366,48719,3578754072,3578754072,0
0,1366,48720,3578754072,3578754072,0
0,1366,48721,3578754072,3578754072,0
0,1366,48722,3578754072,3578754072,0
0,1366,48723,3578754072,3578754072,0
0,1366,48724,3578754072,3578754072,0
0,1366,48725,3578754072,3578754072,0
0,1366,48726,3578754072,3578754072,0
0,1366,48727,3578754072,3578754072,0
0,1366,48728,3578754072,3578754072,0
0,1366,48729,3578754072,3578754072,0
0,1366,48730,3578754072,3578754072,0
0,1366,48731,3578754072,3578754072,0
0,1366,48732,3578754072,3578754072,0
0,1366,48733,3578754072,3578754072,0
0,1366,48734,3578754072,3578754072,0
0,1366,48735,3578754072,3578754072,0
0,1366,48736,3578754072,3578754072,0
0,1366,48737,3578754072,3578754072,0
0,1366,48738,3578754072,3578754072,0
0,1366,48739,3578754072,3578754072,0
0,1366,48740,3578754072,3578754072,0
0,1366,48741,3578754072,3578754072,0
0,1366,48742,3578754072,3578754072,0
0,1366,48743,3578754072,3578754072,0
0,1366,48744,3578754072,3578754072,0
0,1366,48745,3578754072,3578754072,0
0,1366,48746,3578754072,3578754072,0
0,1366,48747,3578754072,3578754072,0
0,1366,48748,3578754072,3578754072,0
0,1366,48749,3578754072,3578754072,0
0,1366,48750,3578754072,3578754072,0
0,1366,48751,3578754072,3578754072,0
0,1366,48752,3578754072,3578754072,0
0,1366,48753,3578754072,3578754072,0
0,1366,48754,3578754072,3578754072,0
0,1366,48755,3578754072,3578754072,0
0,1366,48756,3578754072,3578754072,0
0,1366,48757,3578754072,3578754072,0
0,1366,48758,3578754072,3578754072,0
0,1366,48759,3578754072,3578754072,0
0,1366,48760,3578754072,3578754072,0
0,1366,48761,3578754072,3578754072,0
0,1366,48762,3578754072,3578754072,0
0,1366,48763,3578754072,3578754072,0
0,1366,48764,3578754072,3578754072,0
0,1366,48765,3578754072,3578754072,0
0,1366,48766,3578754072,3578754072,0
0,1366,48767,3578754072,3578754072,0
0,1366,48768,3578754072,3578754072,0
0,1366,48769,3578754072,3578754072,0
0,1366,48770,3578754072,3578754072,0
0,1366,48771,3578754072,3578754072,0
0,1366,48772,3578754072,3578754072,0
0,1366,48773,3578754072,3578754072,0
0,1366,48774,3578754072,3578754072,0
0,1366,48775,3578754072,3578754072,0
0,1366,48776,3578754072,3578754072,0
0,1366,48777,3578754072,3578754072,0
0,1366,48778,3578754072,3578754072,0
0,1366,48779,3578754072,3578754072,0
0,1366,48780,3578754072,3578754072,0
0,1366,48781,3578754072,3578754072,0
0,1366,48782,3578754072,3578754072,0
0,1366,48783,3578754072,3578754072,0
0,1366,48784,3578754072,3578754072,0
0,1366,48785,3578754072,3578754072,0
0,1366,48786,3578754072,3578754072,0
0,1366,48787,3578754072,3578754072,0
0,1366,48788,3578754072,3578754072,0
0,1366,48789,3578754072,3578754073,1
0,1366,48790,3578754072,3578754073,1
0,1366,48791,3578754072,3578754073,1
0,1366,48792,3578754072,3578754073,1
0,1366,48793,3578754072,3578754073,1
0,1366,48794,3578754072,3578754073,1
0,1366,48795,3578754072,3578754073,1
0,1366,48796,3578754072,3578754073,1
0,1366,48797,3578754072,3578754073,1
0,1366,48798,3578754072,3578754073,1
0,1366,48799,3578754072,3578754073,1
0,1366,48800,3578754072,3578754073,1
0,1366,48801,3578754072,3578754073,1
0,1366,48802,3578754072,3578754073,1
0,1366,48803,3578754072,3578754073,1
0,1366,48804,3578754072,3578754073,1
0,1366,48805,3578754072,3578754073,1
0,1366,48806,3578754072,3578754073,1
0,1366,48807,3578754072,3578754073,1
0,1366,48808,3578754072,3578754073,1
0,1366,48809,3578754072,3578754073,1
0,1366,48810,3578754072,3578754073,1
0,1366,48811,3578754072,3578754073,1
0,1366,48812,3578754072,3578754073,1
0,1366,48813,3578754072,3578754073,1
0,1366,48814,3578754072,3578754073,1
0,1366,48815,3578754072,3578754073,1
0,1366,48816,3578754072,3578754073,1
0,1366,48817,3578754072,3578754073,1
0,1366,48818,3578754072,3578754073,1
0,1366,48819,3578754072,3578754073,1
0,1366,48820,3578754072,3578754073,1
0,1366,48821,3578754072,3578754073,1
0,1366,48822,3578754072,3578754073,1
0,1366,48823,3578754072,3578754073,1
0,1366,48824,3578754072,3578754073,1
0,1366,48825,3578754072,3578754073,1
0,1366,48826,3578754072,3578754073,1
0,1366,48827,3578754072,3578754073,1
0,1366,48828,3578754072,3578754073,1
0,1366,48829,3578754072,3578754073,1
0,1366,48830,3578754072,3578754073,1
0,1366,48831,3578754072,3578754073,1
0,1366,48832,3578754072,3578754073,1
0,1366,48833,3578754072,3578754073,1
0,1366,48834,3578754072,3578754073,1
0,1366,48835,3578754072,3578754073,1
0,1366,48836,3578754072,3578754073,1
0,1366,48837,3578754072,3578754073,1
0,1366,48838,3578754072,3578754073,1
0,1366,48839,3578754072,3578754073,1
0,1366,48840,3578754072,3578754073,1
0,1366,48841,3578754072,3578754073,1
0,1366,48842,3578754072,3578754073,1
0,1366,48843,3578754072,3578754073,1
0,1366,48844,3578754072,3578754073,1
0,1366,48845,3578754072,3578754073,1
0,1366,48846,3578754072,3578754073,1
0,1366,48847,3578754072,3578754073,1
0,1366,48848,3578754072,3578754073,1
0,1366,48849,3578754072,3578754073,1
0,1366,48850,3578754072,3578754073,1
0,1366,48851,3578754072,3578754073,1
0,1366,48852,3578754072,3578754073,1
0,1366,48853,3578754072,3578754073,1
0,1366,48854,3578754072,3578754073,1
0,1366,48855,3578754072,3578754073,1
0,1366,48856,3578754072,3578754073,1
0,1366,48857,3578754072,3578754073,1
0,1366,48858,3578754072,3578754073,1
0,1366,48859,3578754072,3578754073,1
0,1366,48860,3578754072,3578754073,1
0,1366,48861,3578754072,3578754073,1
0,1366,48862,3578754072,3578754073,1
0,1366,48863,3578754072,3578754073,1
0,1366,48864,3578754072,3578754073,1
0,1366,48865,3578754072,3578754073,1
0,1366,48866,3578754072,3578754073,1
0,1366,48867,3578754072,3578754073,1
0,1366,48868,3578754072,3578754073,1
0,1366,48869,3578754072,3578754073,1
0,1366,48870,3578754072,3578754073,1
0,1366,48871,3578754072,3578754073,1
0,1366,48872,3578754072,3578754073,1
0,1366,48873,3578754072,3578754073,1
0,1366,48874,3578754072,3578754073,1
0,1366,48875,3578754072,3578754073,1
0,1366,48876,3578754072,3578754114,42
0,1366,48877,3578754072,3578754114,42
0,1366,48878,3578754072,3578754114,42
0,1366,48879,3578754072,3578754114,42
0,1366,48880,3578754072,3578754114,42
0,1366,48881,3578754072,3578754114,42
0,1366,48882,3578754072,3578754114,42
0,1366,48883,3578754072,3578754114,42
0,1366,48884,3578754072,3578754114,42
0,1366,48885,3578754072,3578754114,42
0,1366,48886,3578754072,3578754114,42
0,1366,48887,3578754072,3578754114,42
0,1366,48888,3578754072,3578754114,42
0,1366,48889,3578754072,3578754114,42
0,1366,48890,3578754072,3578754114,42
0,1366,48891,3578754072,3578754114,42
0,1366,48892,3578754072,3578754114,42
0,1366,48893,3578754072,3578754114,42
0,1366,48894,3578754072,3578754114,42
0,1366,48895,3578754072,3578754114,42
0,1366,48896,3578754072,3578754114,42
0,1366,48897,3578754072,3578754114,42
0,1366,48898,3578754072,3578754114,42
0,1366,48899,3578754072,3578754114,42
0,1366,48900,3578754072,3578754114,42
0,1366,48901,3578754072,3578754114,42
0,1366,48902,3578754072,3578754114,42
0,1366,48903,3578754072,3578754114,42
0,1366,48904,3578754072,3578754114,42
0,1366,48905,3578754072,3578754114,42
0,1366,48906,3578754072,3578754114,42
0,1366,48907,3578754072,3578754114,42
0,1366,48908,3578754072,3578754114,42
0,1366,48909,3578754072,3578754114,42
0,1366,48910,3578754072,3578754114,42
0,1366,48911,3578754072,3578754114,42
0,1366,48912,3578754072,3578754114,42
0,1366,48913,3578754072,3578754114,42
0,1366,48914,3578754072,3578754114,42
0,1366,48915,3578754072,3578754114,42
0,1366,48916,3578754072,3578754114,42
0,1366,48917,3578754072,3578754114,42
0,1366,48918,3578754072,3578754114,42
0,1366,48919,3578754072,3578754114,42
0,1366,48920,3578754072,3578754114,42
0,1366,48921,3578754072,3578754114,42
0,1366,48922,3578754072,3578754114,42
0,1366,48923,3578754072,3578754114,42
0,1366,48924,3578754072,3578754114,42
0,1366,48925,3578754072,3578754114,42
0,1366,48926,3578754072,3578754114,42
0,1366,48927,3578754072,3578754114,42
0,1366,48928,3578754072,3578754114,42
0,1366,48929,3578754072,3578754114,42
0,1366,48930,3578754072,3578754114,42
0,1366,48931,3578754072,3578754114,42
0,1366,48932,3578754072,3578754114,42
0,1366,48933,3578754072,3578754114,42
0,1366,48934,3578754072,3578754114,42
0,1366,48935,3578754072,3578754114,42
0,1366,48936,3578754072,3578754114,42
0,1366,48937,3578754072,3578754114,42
0,1366,48938,3578754072,3578754114,42
0,1366,48939,3578754072,3578754114,42
0,1366,48940,3578754072,3578754114,42
0,1366,48941,3578754072,3578754114,42
0,1366,48942,3578754072,3578754114,42
0,1366,48943,3578754072,3578754114,42
0,1366,48944,3578754072,3578754114,42
0,1366,48945,3578754072,3578754114,42
0,1366,48946,3578754072,3578754114,42
0,1366,48947,3578754072,3578754114,42
0,1366,48948,3578754072,3578754114,42
0,1366,48949,3578754072,3578754114,42
0,1366,48950,3578754072,3578754114,42
0,1366,48951,3578754072,3578754114,42
0,1366,48952,3578754072,3578754114,42
0,1366,48953,3578754072,3578754114,42
0,1366,48954,3578754072,3578754114,42
0,1366,48955,3578754072,3578754114,42
0,1366,48956,3578754072,3578754114,42
0,1366,48957,3578754072,3578754114,42
0,1366,48958,3578754072,3578754115,43
0,1366,48959,3578754072,3578754115,43
0,1366,48960,3578754072,3578754115,43
0,1366,48961,3578754072,3578754116,44
0,1366,48962,3578754072,3578754116,44
0,1366,48963,3578754072,3578754116,44
0,1366,48964,3578754072,3578754117,45
0,1366,48965,3578754072,3578754117,45
0,1366,48966,3578754072,3578754117,45
0,1366,48967,3578754072,3578754118,46
0,1366,48968,3578754072,3578754118,46
0,1366,48969,3578754072,3578754118,46
0,1366,48970,3578754072,3578754119,47
0,1366,48971,3578754072,3578754119,47
0,1366,48972,3578754072,3578754119,47
0,1366,48973,3578754072,3578754120,48
0,1366,48974,3578754072,3578754120,48
0,1366,48975,3578754072,3578754120,48
0,1366,48976,3578754072,3578754120,48
0,1366,48977,3578754072,3578754122,50
0,1367,48978,3578754147,3578754147,0
0,1367,48979,3578754147,3578754147,0
0,1367,48980,3578754147,3578754147,0
0,1367,48981,3578754147,3578754147,0
0,1367,48982,3578754147,3578754147,0
0,1367,48983,3578754147,3578754147,0
0,1367,48984,3578754147,3578754147,0
0,1367,48985,3578754147,3578754147,0
0,1367,48986,3578754147,3578754147,0
0,1367,48987,3578754147,3578754147,0
0,1367,48988,3578754147,3578754147,0
0,1367,48989,3578754147,3578754147,0
0,1367,48990,3578754147,3578754147,0
0,1367,48991,3578754147,3578754147,0
0,1367,48992,3578754147,3578754147,0
0,1367,48993,3578754147,3578754147,0
0,1367,48994,3578754147,3578754147,0
0,1367,48995,3578754147,3578754147,0
0,1367,48996,3578754147,3578754147,0
0,1367,48997,3578754147,3578754147,0
0,1367,48998,3578754147,3578754147,0
0,1367,48999,3578754147,3578754147,0
0,1367,49000,3578754147,3578754147,0
0,1367,49001,3578754147,3578754147,0
0,1367,49002,3578754147,3578754147,0
0,1367,49003,3578754147,3578754147,0
0,1367,49004,3578754147,3578754147,0
0,1367,49005,3578754147,3578754147,0
0,1367,49006,3578754147,3578754147,0
0,1367,49007,3578754147,3578754147,0
0,1367,49008,3578754147,3578754147,0
0,1367,49009,3578754147,3578754147,0
0,1367,49010,3578754147,3578754147,0
0,1367,49011,3578754147,3578754147,0
0,1367,49012,3578754147,3578754147,0
0,1367,49013,3578754147,3578754147,0
0,1367,49014,3578754147,3578754147,0
0,1367,49015,3578754147,3578754147,0
0,1367,49016,3578754147,3578754147,0
0,1367,49017,3578754147,3578754147,0
0,1367,49018,3578754147,3578754147,0
0,1367,49019,3578754147,3578754147,0
0,1367,49020,3578754147,3578754147,0
0,1367,49021,3578754147,3578754147,0
0,1367,49022,3578754147,3578754147,0
0,1367,49023,3578754147,3578754147,0
0,1367,49024,3578754147,3578754147,0
0,1367,49025,3578754147,3578754148,1
0,1367,49026,3578754147,3578754148,1
0,1367,49027,3578754147,3578754149,2
0,1367,49028,3578754147,3578754150,3
0,1367,49029,3578754147,3578754151,4
0,1367,49030,3578754147,3578754152,5
0,1367,49031,3578754147,3578754152,5
0,1367,49032,3578754147,3578754153,6
0,1367,49033,3578754147,3578754153,6
0,1367,49034,3578754147,3578754153,6
0,1367,49035,3578754147,3578754154,7
0,1367,49036,3578754147,3578754155,8
0,1367,49037,3578754147,3578754155,8
0,1367,49038,3578754147,3578754155,8
0,1367,49039,3578754147,3578754156,9
0,1367,49040,3578754147,3578754156,9
0,1367,49041,3578754147,3578754156,9
0,1367,49042,3578754147,3578754158,11
0,1367,49043,3578754147,3578754158,11
0,1367,49044,3578754147,3578754159,12
0,1367,49045,3578754147,3578754160,13
0,1367,49046,3578754147,3578754161,14
0,1367,49047,3578754147,3578754162,15
0,1367,49048,3578754147,3578754162,15
0,1367,49049,3578754147,3578754162,15
0,1367,49050,3578754147,3578754162,15
0,1367,49051,3578754147,3578754163,16
0,1367,49052,3578754147,3578754164,17
0,1367,49053,3578754147,3578754164,17
0,1367,49054,3578754147,3578754165,18
0,1367,49055,3578754147,3578754166,19
0,1367,49056,3578754147,3578754166,19
0,1367,49057,3578754147,3578754166,19
0,1367,49058,3578754147,3578754167,20
0,1367,49059,3578754147,3578754168,21
0,1367,49060,3578754147,3578754168,21
0,1367,49061,3578754147,3578754169,22
0,1367,49062,3578754147,3578754170,23
0,1367,49063,3578754147,3578754170,23
0,1367,49064,3578754147,3578754172,25
0,1367,49065,3578754147,3578754173,26
0,1367,49066,3578754147,3578754173,26
0,1367,49067,3578754147,3578754173,26
0,1367,49068,3578754147,3578754174,27
0,1367,49069,3578754147,3578754174,27
0,1367,49070,3578754147,3578754175,28
0,1367,49071,3578754147,3578754176,29
0,1367,49072,3578754147,3578754177,30
0,1367,49073,3578754147,3578754179,32
0,1367,49074,3578754147,3578754179,32
0,1367,49075,3578754147,3578754179,32
0,1367,49076,3578754147,3578754179,32
0,1367,49077,3578754147,3578754181,34
0,1367,49078,3578754147,3578754182,35
0,1367,49079,3578754147,3578754183,36
0,1367,49080,3578754147,3578754184,37
0,1367,49081,3578754147,3578754184,37
0,1367,49082,3578754147,3578754185,38
0,1367,49083,3578754147,3578754186,39
0,1367,49084,3578754147,3578754186,39
0,1367,49085,3578754147,3578754187,40
0,1367,49086,3578754147,3578754188,41
0,1367,49087,3578754147,3578754188,41
0,1367,49088,3578754147,3578754190,43
0,1367,49089,3578754147,3578754190,43
0,1367,49090,3578754147,3578754190,43
0,1367,49091,3578754147,3578754191,44
0,1367,49092,3578754147,3578754191,44
0,1367,49093,3578754147,3578754192,45
0,1367,49094,3578754147,3578754193,46
0,1367,49095,3578754147,3578754194,47
0,1367,49096,3578754147,3578754194,47
0,1367,49097,3578754147,3578754196,49
0,1368,49098,3578754210,3578754210,0
0,1368,49099,3578754210,3578754210,0
0,1368,49100,3578754210,3578754210,0
0,1368,49101,3578754210,3578754210,0
0,1368,49102,3578754210,3578754210,0
0,1368,49103,3578754210,3578754210,0
0,1368,49104,3578754210,3578754210,0
0,1368,49105,3578754210,3578754210,0
0,1368,49106,3578754210,3578754210,0
0,1368,49107,3578754210,3578754210,0
0,1368,49108,3578754210,3578754210,0
0,1368,49109,3578754210,3578754210,0
0,1368,49110,3578754210,3578754210,0
0,1368,49111,3578754210,3578754210,0
0,1368,49112,3578754210,3578754210,0
0,1368,49113,3578754210,3578754210,0
0,1368,49114,3578754210,3578754210,0
0,1368,49115,3578754210,3578754210,0
0,1368,49116,3578754210,3578754210,0
0,1368,49117,3578754210,3578754212,2
0,1368,49118,3578754210,3578754213,3
0,1368,49119,3578754210,3578754214,4
0,1368,49120,3578754210,3578754214,4
0,1368,49121,3578754210,3578754214,4
0,1368,49122,3578754210,3578754215,5
0,1368,49123,3578754210,3578754215,5
0,1368,49124,3578754210,3578754215,5
0,1368,49125,3578754210,3578754215,5
0,1368,49126,3578754210,3578754216,6
0,1368,49127,3578754210,3578754218,8
0,1368,49128,3578754210,3578754218,8
0,1368,49129,3578754210,3578754219,9
0,1368,49130,3578754210,3578754219,9
0,1368,49131,3578754210,3578754219,9
0,1368,49132,3578754210,3578754219,9
0,1368,49133,3578754210,3578754221,11
0,1368,49134,3578754210,3578754222,12
0,1368,49135,3578754210,3578754222,12
0,1368,49136,3578754210,3578754223,13
0,1368,49137,3578754210,3578754224,14
0,1368,49138,3578754210,3578754224,14
0,1368,49139,3578754210,3578754224,14
0,1368,49140,3578754210,3578754224,14
0,1368,49141,3578754210,3578754225,15
0,1368,49142,3578754210,3578754228,18
0,1368,49143,3578754210,3578754228,18
0,1368,49144,3578754210,3578754229,19
0,1368,49145,3578754210,3578754230,20
0,1368,49146,3578754210,3578754230,20
0,1368,49147,3578754210,3578754231,21
0,1368,49148,3578754210,3578754233,23
0,1368,49149,3578754210,3578754233,23
0,1368,49150,3578754210,3578754234,24
0,1368,49151,3578754210,3578754235,25
0,1368,49152,3578754210,3578754236,26
0,1368,49153,3578754210,3578754236,26
0,1368,49154,3578754210,3578754237,27
0,1368,49155,3578754210,3578754237,27
0,1368,49156,3578754210,3578754237,27
0,1368,49157,3578754210,3578754237,27
0,1368,49158,3578754210,3578754240,30
0,1368,49159,3578754210,3578754240,30
0,1368,49160,3578754210,3578754240,30
0,1368,49161,3578754210,3578754242,32
0,1368,49162,3578754210,3578754242,32
0,1368,49163,3578754210,3578754243,33
0,1368,49164,3578754210,3578754243,33
0,1368,49165,3578754210,3578754243,33
0,1368,49166,3578754210,3578754247,37
0,1368,49167,3578754210,3578754248,38
0,1368,49168,3578754210,3578754248,38
0,1368,49169,3578754210,3578754249,39
0,1368,49170,3578754210,3578754249,39
0,1368,49171,3578754210,3578754249,39
0,1368,49172,3578754210,3578754249,39
0,1368,49173,3578754210,3578754251,41
0,1368,49174,3578754210,3578754252,42
0,1368,49175,3578754210,3578754253,43
0,1368,49176,3578754210,3578754255,45
0,1368,49177,3578754210,3578754256,46
0,1368,49178,3578754210,3578754257,47
0,1368,49179,3578754210,3578754257,47
0,1368,49180,3578754210,3578754257,47
0,1368,49181,3578754210,3578754258,48
0,1368,49182,3578754210,3578754259,49
0,1368,49183,3578754210,3578754259,49
0,1369,49184,3578754274,3578754274,0
0,1369,49185,3578754274,3578754274,0
0,1369,49186,3578754274,3578754274,0
0,1369,49187,3578754274,3578754274,0
0,1369,49188,3578754274,3578754274,0
0,1369,49189,3578754274,3578754274,0
0,1369,49190,3578754274,3578754274,0
0,1369,49191,3578754274,3578754274,0
0,1369,49192,3578754274,3578754274,0
0,1369,49193,3578754274,3578754274,0
0,1369,49194,3578754274,3578754274,0
0,1369,49195,3578754274,3578754274,0
0,1369,49196,3578754274,3578754280,6
0,1369,49197,3578754274,3578754280,6
0,1369,49198,3578754274,3578754281,7
0,1369,49199,3578754274,3578754281,7
0,1369,49200,3578754274,3578754282,8
0,1369,49201,3578754274,3578754283,9
0,1369,49202,3578754274,3578754284,10
0,1369,49203,3578754274,3578754284,10
0,1369,49204,3578754274,3578754287,13
0,1369,49205,3578754274,3578754287,13
0,1369,49206,3578754274,3578754287,13
0,1369,49207,3578754274,3578754288,14
0,1369,49208,3578754274,3578754288,14
0,1369,49209,3578754274,3578754288,14
0,1369,49210,3578754274,3578754289,15
0,1369,49211,3578754274,3578754290,16
0,1369,49212,3578754274,3578754290,16
0,1369,49213,3578754274,3578754291,17
0,1369,49214,3578754274,3578754291,17
0,1369,49215,3578754274,3578754291,17
0,1369,49216,3578754274,3578754292,18
0,1369,49217,3578754274,3578754292,18
0,1369,49218,3578754274,3578754292,18
0,1369,49219,3578754274,3578754293,19
0,1369,49220,3578754274,3578754293,19
0,1369,49221,3578754274,3578754294,20
0,1369,49222,3578754274,3578754294,20
0,1369,49223,3578754274,3578754295,21
0,1369,49224,3578754274,3578754295,21
0,1369,49225,3578754274,3578754296,22
0,1369,49226,3578754274,3578754296,22
0,1369,49227,3578754274,3578754297,23
0,1369,49228,3578754274,3578754297,23
0,1369,49229,3578754274,3578754298,24
0,1369,49230,3578754274,3578754298,24
0,1369,49231,3578754274,3578754300,26
0,1369,49232,3578754274,3578754301,27
0,1369,49233,3578754274,3578754304,30
0,1369,49234,3578754274,3578754304,30
0,1369,49235,3578754274,3578754305,31
0,1369,49236,3578754274,3578754305,31
0,1369,49237,3578754274,3578754305,31
0,1369,49238,3578754274,3578754306,32
0,1369,49239,3578754274,3578754307,33
0,1369,49240,3578754274,3578754308,34
0,1369,49241,3578754274,3578754308,34
0,1369,49242,3578754274,3578754308,34
0,1369,49243,3578754274,3578754308,34
0,1369,49244,3578754274,3578754309,35
0,1369,49245,3578754274,3578754309,35
0,1369,49246,3578754274,3578754310,36
0,1369,49247,3578754274,3578754310,36
0,1369,49248,3578754274,3578754310,36
0,1369,49249,3578754274,3578754311,37
0,1369,49250,3578754274,3578754311,37
0,1369,49251,3578754274,3578754311,37
0,1369,49252,3578754274,3578754312,38
0,1369,49253,3578754274,3578754312,38
0,1369,49254,3578754274,3578754312,38
0,1369,49255,3578754274,3578754312,38
0,1369,49256,3578754274,3578754313,39
0,1369,49257,3578754274,3578754313,39
0,1369,49258,3578754274,3578754314,40
0,1369,49259,3578754274,3578754315,41
0,1369,49260,3578754274,3578754315,41
0,1369,49261,3578754274,3578754315,41
0,1369,49262,3578754274,3578754315,41
0,1369,49263,3578754274,3578754315,41
0,1369,49264,3578754274,3578754316,42
0,1369,49265,3578754274,3578754317,43
0,1369,49266,3578754274,3578754317,43
0,1369,49267,3578754274,3578754318,44
0,1369,49268,3578754274,3578754319,45
0,1369,49269,3578754274,3578754319,45
0,1369,49270,3578754274,3578754319,45
0,1369,49271,3578754274,3578754319,45
0,1369,49272,3578754274,3578754319,45
0,1369,49273,3578754274,3578754320,46
0,1369,49274,3578754274,3578754322,48
0,1369,49275,3578754274,3578754323,49
0,1369,49276,3578754274,3578754324,50
0,1370,49277,3578754338,3578754338,0
0,1370,49278,3578754338,3578754338,0
0,1370,49279,3578754338,3578754338,0
0,1370,49280,3578754338,3578754338,0
0,1370,49281,3578754338,3578754338,0
0,1370,49282,3578754338,3578754338,0
0,1370,49283,3578754338,3578754338,0
0,1370,49284,3578754338,3578754338,0
0,1370,49285,3578754338,3578754338,0
0,1370,49286,3578754338,3578754338,0
0,1370,49287,3578754338,3578754338,0
0,1370,49288,3578754338,3578754338,0
0,1370,49289,3578754338,3578754338,0
0,1370,49290,3578754338,3578754338,0
0,1370,49291,3578754338,3578754338,0
0,1370,49292,3578754338,3578754338,0
0,1370,49293,3578754338,3578754338,0
0,1370,49294,3578754338,3578754338,0
0,1370,49295,3578754338,3578754338,0
0,1370,49296,3578754338,3578754338,0
0,1370,49297,3578754338,3578754338,0
0,1370,49298,3578754338,3578754338,0
0,1370,49299,3578754338,3578754338,0
0,1370,49300,3578754338,3578754338,0
0,1370,49301,3578754338,3578754338,0
0,1370,49302,3578754338,3578754340,2
0,1370,49303,3578754338,3578754341,3
0,1370,49304,3578754338,3578754341,3
0,1370,49305,3578754338,3578754341,3
0,1370,49306,3578754338,3578754341,3
0,1370,49307,3578754338,3578754341,3
0,1370,49308,3578754338,3578754342,4
0,1370,49309,3578754338,3578754343,5
0,1370,49310,3578754338,3578754343,5
0,1370,49311,3578754338,3578754343,5
0,1370,49312,3578754338,3578754343,5
0,1370,49313,3578754338,3578754343,5
0,1370,49314,3578754338,3578754344,6
0,1370,49315,3578754338,3578754344,6
0,1370,49316,3578754338,3578754345,7
0,1370,49317,3578754338,3578754346,8
0,1370,49318,3578754338,3578754347,9
0,1370,49319,3578754338,3578754348,10
0,1370,49320,3578754338,3578754348,10
0,1370,49321,3578754338,3578754348,10
0,1370,49322,3578754338,3578754350,12
0,1370,49323,3578754338,3578754351,13
0,1370,49324,3578754338,3578754351,13
0,1370,49325,3578754338,3578754352,14
0,1370,49326,3578754338,3578754352,14
0,1370,49327,3578754338,3578754352,14
0,1370,49328,3578754338,3578754352,14
0,1370,49329,3578754338,3578754353,15
0,1370,49330,3578754338,3578754355,17
0,1370,49331,3578754338,3578754355,17
0,1370,49332,3578754338,3578754355,17
0,1370,49333,3578754338,3578754356,18
0,1370,49334,3578754338,3578754357,19
0,1370,49335,3578754338,3578754357,19
0,1370,49336,3578754338,3578754358,20
0,1370,49337,3578754338,3578754358,20
0,1370,49338,3578754338,3578754360,22
0,1370,49339,3578754338,3578754361,23
0,1370,49340,3578754338,3578754361,23
0,1370,49341,3578754338,3578754362,24
0,1370,49342,3578754338,3578754362,24
0,1370,49343,3578754338,3578754362,24
0,1370,49344,3578754338,3578754363,25
0,1370,49345,3578754338,3578754364,26
0,1370,49346,3578754338,3578754364,26
0,1370,49347,3578754338,3578754365,27
0,1370,49348,3578754338,3578754365,27
0,1370,49349,3578754338,3578754366,28
0,1370,49350,3578754338,3578754366,28
0,1370,49351,3578754338,3578754366,28
0,1370,49352,3578754338,3578754368,30
0,1370,49353,3578754338,3578754368,30
0,1370,49354,3578754338,3578754369,31
0,1370,49355,3578754338,3578754369,31
0,1370,49356,3578754338,3578754370,32
0,1370,49357,3578754338,3578754371,33
0,1370,49358,3578754338,3578754372,34
0,1370,49359,3578754338,3578754373,35
0,1370,49360,3578754338,3578754374,36
0,1370,49361,3578754338,3578754374,36
0,1370,49362,3578754338,3578754374,36
0,1370,49363,3578754338,3578754374,36
0,1370,49364,3578754338,3578754375,37
0,1370,49365,3578754338,3578754376,38
0,1370,49366,3578754338,3578754376,38
0,1370,49367,3578754338,3578754378,40
0,1370,49368,3578754338,3578754379,41
0,1370,49369,3578754338,3578754379,41
0,1370,49370,3578754338,3578754379,41
0,1370,49371,3578754338,3578754382,44
0,1370,49372,3578754338,3578754382,44
0,1370,49373,3578754338,3578754383,45
0,1370,49374,3578754338,3578754383,45
0,1370,49375,3578754338,3578754384,46
0,1370,49376,3578754338,3578754384,46
0,1370,49377,3578754338,3578754386,48
0,1370,49378,3578754338,3578754387,49
0,1371,49379,3578754401,3578754401,0
0,1371,49380,3578754401,3578754401,0
0,1371,49381,3578754401,3578754401,0
0,1371,49382,3578754401,3578754401,0
0,1371,49383,3578754401,3578754401,0
0,1371,49384,3578754401,3578754401,0
0,1371,49385,3578754401,3578754401,0
0,1371,49386,3578754401,3578754401,0
0,1371,49387,3578754401,3578754401,0
0,1371,49388,3578754401,3578754401,0
0,1371,49389,3578754401,3578754401,0
0,1371,49390,3578754401,3578754401,0
0,1371,49391,3578754401,3578754401,0
0,1371,49392,3578754401,3578754401,0
0,1371,49393,3578754401,3578754401,0
0,1371,49394,3578754401,3578754401,0
0,1371,49395,3578754401,3578754401,0
0,1371,49396,3578754401,3578754401,0
0,1371,49397,3578754401,3578754401,0
0,1371,49398,3578754401,3578754402,1
0,1371,49399,3578754401,3578754402,1
0,1371,49400,3578754401,3578754402,1
0,1371,49401,3578754401,3578754404,3
0,1371,49402,3578754401,3578754405,4
0,1371,49403,3578754401,3578754405,4
0,1371,49404,3578754401,3578754405,4
0,1371,49405,3578754401,3578754405,4
0,1371,49406,3578754401,3578754405,4
0,1371,49407,3578754401,3578754407,6
0,1371,49408,3578754401,3578754407,6
0,1371,49409,3578754401,3578754409,8
0,1371,49410,3578754401,3578754409,8
0,1371,49411,3578754401,3578754410,9
0,1371,49412,3578754401,3578754412,11
0,1371,49413,3578754401,3578754413,12
0,1371,49414,3578754401,3578754414,13
0,1371,49415,3578754401,3578754414,13
0,1371,49416,3578754401,3578754415,14
0,1371,49417,3578754401,3578754415,14
0,1371,49418,3578754401,3578754415,14
0,1371,49419,3578754401,3578754415,14
0,1371,49420,3578754401,3578754415,14
0,1371,49421,3578754401,3578754416,15
0,1371,49422,3578754401,3578754416,15
0,1371,49423,3578754401,3578754418,17
0,1371,49424,3578754401,3578754418,17
0,1371,49425,3578754401,3578754419,18
0,1371,49426,3578754401,3578754419,18
0,1371,49427,3578754401,3578754419,18
0,1371,49428,3578754401,3578754420,19
0,1371,49429,3578754401,3578754421,20
0,1371,49430,3578754401,3578754421,20
0,1371,49431,3578754401,3578754423,22
0,1371,49432,3578754401,3578754423,22
0,1371,49433,3578754401,3578754424,23
0,1371,49434,3578754401,3578754424,23
0,1371,49435,3578754401,3578754424,23
0,1371,49436,3578754401,3578754426,25
0,1371,49437,3578754401,3578754428,27
0,1371,49438,3578754401,3578754428,27
0,1371,49439,3578754401,3578754430,29
0,1371,49440,3578754401,3578754430,29
0,1371,49441,3578754401,3578754431,30
0,1371,49442,3578754401,3578754432,31
0,1371,49443,3578754401,3578754433,32
0,1371,49444,3578754401,3578754434,33
0,1371,49445,3578754401,3578754435,34
0,1371,49446,3578754401,3578754436,35
0,1371,49447,3578754401,3578754436,35
0,1371,49448,3578754401,3578754437,36
0,1371,49449,3578754401,3578754437,36
0,1371,49450,3578754401,3578754438,37
0,1371,49451,3578754401,3578754439,38
0,1371,49452,3578754401,3578754439,38
0,1371,49453,3578754401,3578754440,39
0,1371,49454,3578754401,3578754440,39
0,1371,49455,3578754401,3578754440,39
0,1371,49456,3578754401,3578754440,39
0,1371,49457,3578754401,3578754441,40
0,1371,49458,3578754401,3578754442,41
0,1371,49459,3578754401,3578754444,43
0,1371,49460,3578754401,3578754444,43
0,1371,49461,3578754401,3578754444,43
0,1371,49462,3578754401,3578754445,44
0,1371,49463,3578754401,3578754447,46
0,1371,49464,3578754401,3578754447,46
0,1371,49465,3578754401,3578754448,47
0,1371,49466,3578754401,3578754449,48
0,1371,49467,3578754401,3578754449,48
0,1371,49468,3578754401,3578754450,49
0,1372,49469,3578754464,3578754464,0
0,1372,49470,3578754464,3578754464,0
0,1372,49471,3578754464,3578754464,0
0,1372,49472,3578754464,3578754464,0
0,1372,49473,3578754464,3578754464,0
0,1372,49474,3578754464,3578754464,0
0,1372,49475,3578754464,3578754464,0
0,1372,49476,3578754464,3578754464,0
0,1372,49477,3578754464,3578754464,0
0,1372,49478,3578754464,3578754464,0
0,1372,49479,3578754464,3578754464,0
0,1372,49480,3578754464,3578754464,0
0,1372,49481,3578754464,3578754464,0
0,1372,49482,3578754464,3578754464,0
0,1372,49483,3578754464,3578754464,0
0,1372,49484,3578754464,3578754464,0
0,1372,49485,3578754464,3578754465,1
0,1372,49486,3578754464,3578754465,1
0,1372,49487,3578754464,3578754467,3
0,1372,49488,3578754464,3578754468,4
0,1372,49489,3578754464,3578754468,4
0,1372,49490,3578754464,3578754468,4
0,1372,49491,3578754464,3578754480,16
0,1372,49492,3578754464,3578754480,16
0,1372,49493,3578754464,3578754480,16
0,1372,49494,3578754464,3578754481,17
0,1372,49495,3578754464,3578754481,17
0,1372,49496,3578754464,3578754484,20
0,1372,49497,3578754464,3578754485,21
0,1372,49498,3578754464,3578754485,21
0,1372,49499,3578754464,3578754486,22
0,1372,49500,3578754464,3578754487,23
0,1372,49501,3578754464,3578754487,23
0,1372,49502,3578754464,3578754488,24
0,1372,49503,3578754464,3578754488,24
0,1372,49504,3578754464,3578754488,24
0,1372,49505,3578754464,3578754489,25
0,1372,49506,3578754464,3578754489,25
0,1372,49507,3578754464,3578754491,27
0,1372,49508,3578754464,3578754491,27
0,1372,49509,3578754464,3578754491,27
0,1372,49510,3578754464,3578754492,28
0,1372,49511,3578754464,3578754492,28
0,1372,49512,3578754464,3578754493,29
0,1372,49513,3578754464,3578754494,30
0,1372,49514,3578754464,3578754495,31
0,1372,49515,3578754464,3578754495,31
0,1372,49516,3578754464,3578754496,32
0,1372,49517,3578754464,3578754496,32
0,1372,49518,3578754464,3578754497,33
0,1372,49519,3578754464,3578754498,34
0,1372,49520,3578754464,3578754498,34
0,1372,49521,3578754464,3578754499,35
0,1372,49522,3578754464,3578754500,36
0,1372,49523,3578754464,3578754501,37
0,1372,49524,3578754464,3578754504,40
0,1372,49525,3578754464,3578754505,41
0,1372,49526,3578754464,3578754505,41
0,1372,49527,3578754464,3578754506,42
0,1372,49528,3578754464,3578754508,44
0,1372,49529,3578754464,3578754508,44
0,1372,49530,3578754464,3578754508,44
0,1372,49531,3578754464,3578754508,44
0,1372,49532,3578754464,3578754509,45
0,1372,49533,3578754464,3578754509,45
0,1372,49534,3578754464,3578754510,46
0,1372,49535,3578754464,3578754510,46
0,1372,49536,3578754464,3578754510,46
0,1372,49537,3578754464,3578754511,47
0,1372,49538,3578754464,3578754511,47
0,1372,49539,3578754464,3578754511,47
0,1372,49540,3578754464,3578754512,48
0,1372,49541,3578754464,3578754512,48
0,1372,49542,3578754464,3578754512,48
0,1372,49543,3578754464,3578754512,48
0,1372,49544,3578754464,3578754513,49
0,1372,49545,3578754464,3578754513,49
0,1373,49546,3578754528,3578754528,0
0,1373,49547,3578754528,3578754528,0
0,1373,49548,3578754528,3578754528,0
0,1373,49549,3578754528,3578754528,0
0,1373,49550,3578754528,3578754528,0
0,1373,49551,3578754528,3578754528,0
0,1373,49552,3578754528,3578754528,0
0,1373,49553,3578754528,3578754528,0
0,1373,49554,3578754528,3578754528,0
0,1373,49555,3578754528,3578754528,0
0,1373,49556,3578754528,3578754528,0
0,1373,49557,3578754528,3578754528,0
0,1373,49558,3578754528,3578754528,0
0,1373,49559,3578754528,3578754528,0
0,1373,49560,3578754528,3578754528,0
0,1373,49561,3578754528,3578754528,0
0,1373,49562,3578754528,3578754528,0
0,1373,49563,3578754528,3578754528,0
0,1373,49564,3578754528,3578754528,0
0,1373,49565,3578754528,3578754528,0
0,1373,49566,3578754528,3578754528,0
0,1373,49567,3578754528,3578754528,0
0,1373,49568,3578754528,3578754528,0
0,1373,49569,3578754528,3578754528,0
0,1373,49570,3578754528,3578754528,0
0,1373,49571,3578754528,3578754528,0
0,1373,49572,3578754528,3578754528,0
0,1373,49573,3578754528,3578754528,0
0,1373,49574,3578754528,3578754528,0
0,1373,49575,3578754528,3578754528,0
0,1373,49576,3578754528,3578754529,1
0,1373,49577,3578754528,3578754529,1
0,1373,49578,3578754528,3578754529,1
0,1373,49579,3578754528,3578754530,2
0,1373,49580,3578754528,3578754530,2
0,1373,49581,3578754528,3578754531,3
0,1373,49582,3578754528,3578754531,3
0,1373,49583,3578754528,3578754531,3
0,1373,49584,3578754528,3578754531,3
0,1373,49585,3578754528,3578754533,5
0,1373,49586,3578754528,3578754534,6
0,1373,49587,3578754528,3578754535,7
0,1373,49588,3578754528,3578754535,7
0,1373,49589,3578754528,3578754539,11
0,1373,49590,3578754528,3578754539,11
0,1373,49591,3578754528,3578754539,11
0,1373,49592,3578754528,3578754539,11
0,1373,49593,3578754528,3578754540,12
0,1373,49594,3578754528,3578754540,12
0,1373,49595,3578754528,3578754540,12
0,1373,49596,3578754528,3578754541,13
0,1373,49597,3578754528,3578754541,13
0,1373,49598,3578754528,3578754541,13
0,1373,49599,3578754528,3578754542,14
0,1373,49600,3578754528,3578754542,14
0,1373,49601,3578754528,3578754542,14
0,1373,49602,3578754528,3578754542,14
0,1373,49603,3578754528,3578754543,15
0,1373,49604,3578754528,3578754543,15
0,1373,49605,3578754528,3578754544,16
0,1373,49606,3578754528,3578754544,16
0,1373,49607,3578754528,3578754544,16
0,1373,49608,3578754528,3578754546,18
0,1373,49609,3578754528,3578754547,19
0,1373,49610,3578754528,3578754547,19
0,1373,49611,3578754528,3578754550,22
0,1373,49612,3578754528,3578754550,22
0,1373,49613,3578754528,3578754551,23
0,1373,49614,3578754528,3578754551,23
0,1373,49615,3578754528,3578754552,24
0,1373,49616,3578754528,3578754552,24
0,1373,49617,3578754528,3578754553,25
0,1373,49618,3578754528,3578754554,26
0,1373,49619,3578754528,3578754554,26
0,1373,49620,3578754528,3578754554,26
0,1373,49621,3578754528,3578754555,27
0,1373,49622,3578754528,3578754555,27
0,1373,49623,3578754528,3578754556,28
0,1373,49624,3578754528,3578754558,30
0,1373,49625,3578754528,3578754558,30
0,1373,49626,3578754528,3578754560,32
0,1373,49627,3578754528,3578754560,32
0,1373,49628,3578754528,3578754561,33
0,1373,49629,3578754528,3578754561,33
0,1373,49630,3578754528,3578754561,33
0,1373,49631,3578754528,3578754562,34
0,1373,49632,3578754528,3578754562,34
0,1373,49633,3578754528,3578754563,35
0,1373,49634,3578754528,3578754563,35
0,1373,49635,3578754528,3578754564,36
0,1373,49636,3578754528,3578754564,36
0,1373,49637,3578754528,3578754565,37
0,1373,49638,3578754528,3578754565,37
0,1373,49639,3578754528,3578754565,37
0,1373,49640,3578754528,3578754567,39
0,1373,49641,3578754528,3578754567,39
0,1373,49642,3578754528,3578754568,40
0,1373,49643,3578754528,3578754569,41
0,1373,49644,3578754528,3578754569,41
0,1373,49645,3578754528,3578754572,44
0,1373,49646,3578754528,3578754572,44
0,1373,49647,3578754528,3578754573,45
0,1373,49648,3578754528,3578754573,45
0,1373,49649,3578754528,3578754573,45
0,1373,49650,3578754528,3578754574,46
0,1373,49651,3578754528,3578754575,47
0,1373,49652,3578754528,3578754575,47
0,1373,49653,3578754528,3578754576,48
0,1373,49654,3578754528,3578754576,48
0,1373,49655,3578754528,3578754578,50
0,1374,49656,3578754592,3578754592,0
0,1374,49657,3578754592,3578754592,0
0,1374,49658,3578754592,3578754592,0
0,1374,49659,3578754592,3578754592,0
0,1374,49660,3578754592,3578754592,0
0,1374,49661,3578754592,3578754592,0
0,1374,49662,3578754592,3578754592,0
0,1374,49663,3578754592,3578754592,0
0,1374,49664,3578754592,3578754592,0
0,1374,49665,3578754592,3578754592,0
0,1374,49666,3578754592,3578754592,0
0,1374,49667,3578754592,3578754592,0
0,1374,49668,3578754592,3578754592,0
0,1374,49669,3578754592,3578754592,0
0,1374,49670,3578754592,3578754592,0
0,1374,49671,3578754592,3578754593,1
0,1374,49672,3578754592,3578754594,2
0,1374,49673,3578754592,3578754595,3
0,1374,49674,3578754592,3578754596,4
0,1374,49675,3578754592,3578754597,5
0,1374,49676,3578754592,3578754599,7
0,1374,49677,3578754592,3578754600,8
0,1374,49678,3578754592,3578754601,9
0,1374,49679,3578754592,3578754601,9
0,1374,49680,3578754592,3578754603,11
0,1374,49681,3578754592,3578754603,11
0,1374,49682,3578754592,3578754603,11
0,1374,49683,3578754592,3578754603,11
0,1374,49684,3578754592,3578754604,12
0,1374,49685,3578754592,3578754604,12
0,1374,49686,3578754592,3578754605,13
0,1374,49687,3578754592,3578754606,14
0,1374,49688,3578754592,3578754607,15
0,1374,49689,3578754592,3578754608,16
0,1374,49690,3578754592,3578754608,16
0,1374,49691,3578754592,3578754609,17
0,1374,49692,3578754592,3578754609,17
0,1374,49693,3578754592,3578754611,19
0,1374,49694,3578754592,3578754612,20
0,1374,49695,3578754592,3578754613,21
0,1374,49696,3578754592,3578754614,22
0,1374,49697,3578754592,3578754614,22
0,1374,49698,3578754592,3578754614,22
0,1374,49699,3578754592,3578754614,22
0,1374,49700,3578754592,3578754615,23
0,1374,49701,3578754592,3578754615,23
0,1374,49702,3578754592,3578754615,23
0,1374,49703,3578754592,3578754618,26
0,1374,49704,3578754592,3578754618,26
0,1374,49705,3578754592,3578754618,26
0,1374,49706,3578754592,3578754619,27
0,1374,49707,3578754592,3578754619,27
0,1374,49708,3578754592,3578754620,28
0,1374,49709,3578754592,3578754621,29
0,1374,49710,3578754592,3578754621,29
0,1374,49711,3578754592,3578754622,30
0,1374,49712,3578754592,3578754622,30
0,1374,49713,3578754592,3578754623,31
0,1374,49714,3578754592,3578754624,32
0,1374,49715,3578754592,3578754624,32
0,1374,49716,3578754592,3578754625,33
0,1374,49717,3578754592,3578754626,34
0,1374,49718,3578754592,3578754627,35
0,1374,49719,3578754592,3578754627,35
0,1374,49720,3578754592,3578754628,36
0,1374,49721,3578754592,3578754628,36
0,1374,49722,3578754592,3578754629,37
0,1374,49723,3578754592,3578754630,38
0,1374,49724,3578754592,3578754631,39
0,1374,49725,3578754592,3578754632,40
0,1374,49726,3578754592,3578754633,41
0,1374,49727,3578754592,3578754634,42
0,1374,49728,3578754592,3578754635,43
0,1374,49729,3578754592,3578754635,43
0,1374,49730,3578754592,3578754636,44
0,1374,49731,3578754592,3578754636,44
0,1374,49732,3578754592,3578754637,45
0,1374,49733,3578754592,3578754637,45
0,1374,49734,3578754592,3578754638,46
0,1374,49735,3578754592,3578754639,47
0,1374,49736,3578754592,3578754639,47
0,1374,49737,3578754592,3578754640,48
0,1374,49738,3578754592,3578754640,48
0,1374,49739,3578754592,3578754641,49
0,1374,49740,3578754592,3578754641,49
0,1374,49741,3578754592,3578754642,50
0,1375,49742,3578754655,3578754655,0
0,1375,49743,3578754655,3578754655,0
0,1375,49744,3578754655,3578754655,0
0,1375,49745,3578754655,3578754655,0
0,1375,49746,3578754655,3578754655,0
0,1375,49747,3578754655,3578754655,0
0,1375,49748,3578754655,3578754655,0
0,1375,49749,3578754655,3578754655,0
0,1375,49750,3578754655,3578754655,0
0,1375,49751,3578754655,3578754655,0
0,1375,49752,3578754655,3578754655,0
0,1375,49753,3578754655,3578754655,0
0,1375,49754,3578754655,3578754655,0
0,1375,49755,3578754655,3578754655,0
0,1375,49756,3578754655,3578754655,0
0,1375,49757,3578754655,3578754655,0
0,1375,49758,3578754655,3578754656,1
0,1375,49759,3578754655,3578754656,1
0,1375,49760,3578754655,3578754657,2
0,1375,49761,3578754655,3578754658,3
0,1375,49762,3578754655,3578754659,4
0,1375,49763,3578754655,3578754661,6
0,1375,49764,3578754655,3578754661,6
0,1375,49765,3578754655,3578754661,6
0,1375,49766,3578754655,3578754663,8
0,1375,49767,3578754655,3578754664,9
0,1375,49768,3578754655,3578754664,9
0,1375,49769,3578754655,3578754664,9
0,1375,49770,3578754655,3578754666,11
0,1375,49771,3578754655,3578754666,11
0,1375,49772,3578754655,3578754667,12
0,1375,49773,3578754655,3578754667,12
0,1375,49774,3578754655,3578754669,14
0,1375,49775,3578754655,3578754680,25
0,1375,49776,3578754655,3578754680,25
0,1375,49777,3578754655,3578754682,27
0,1375,49778,3578754655,3578754684,29
0,1375,49779,3578754655,3578754685,30
0,1375,49780,3578754655,3578754685,30
0,1375,49781,3578754655,3578754686,31
0,1375,49782,3578754655,3578754687,32
0,1375,49783,3578754655,3578754688,33
0,1375,49784,3578754655,3578754688,33
0,1375,49785,3578754655,3578754689,34
0,1375,49786,3578754655,3578754689,34
0,1375,49787,3578754655,3578754689,34
0,1375,49788,3578754655,3578754689,34
0,1375,49789,3578754655,3578754691,36
0,1375,49790,3578754655,3578754691,36
0,1375,49791,3578754655,3578754691,36
0,1375,49792,3578754655,3578754691,36
0,1375,49793,3578754655,3578754692,37
0,1375,49794,3578754655,3578754692,37
0,1375,49795,3578754655,3578754692,37
0,1375,49796,3578754655,3578754693,38
0,1375,49797,3578754655,3578754693,38
0,1375,49798,3578754655,3578754693,38
0,1375,49799,3578754655,3578754694,39
0,1375,49800,3578754655,3578754694,39
0,1375,49801,3578754655,3578754695,40
0,1375,49802,3578754655,3578754696,41
0,1375,49803,3578754655,3578754696,41
0,1375,49804,3578754655,3578754696,41
0,1375,49805,3578754655,3578754697,42
0,1375,49806,3578754655,3578754697,42
0,1375,49807,3578754655,3578754698,43
0,1375,49808,3578754655,3578754698,43
0,1375,49809,3578754655,3578754698,43
0,1375,49810,3578754655,3578754703,48
0,1375,49811,3578754655,3578754705,50
0,1376,49812,3578754717,3578754717,0
0,1376,49813,3578754717,3578754717,0
0,1376,49814,3578754717,3578754717,0
0,1376,49815,3578754717,3578754717,0
0,1376,49816,3578754717,3578754717,0
0,1376,49817,3578754717,3578754717,0
0,1376,49818,3578754717,3578754717,0
0,1376,49819,3578754717,3578754717,0
0,1376,49820,3578754717,3578754717,0
0,1376,49821,3578754717,3578754717,0
0,1376,49822,3578754717,3578754717,0
0,1376,49823,3578754717,3578754717,0
0,1376,49824,3578754717,3578754717,0
0,1376,49825,3578754717,3578754717,0
0,1376,49826,3578754717,3578754717,0
0,1376,49827,3578754717,3578754717,0
0,1376,49828,3578754717,3578754717,0
0,1376,49829,3578754717,3578754717,0
0,1376,49830,3578754717,3578754717,0
0,1376,49831,3578754717,3578754717,0
0,1376,49832,3578754717,3578754717,0
0,1376,49833,3578754717,3578754717,0
0,1376,49834,3578754717,3578754717,0
0,1376,49835,3578754717,3578754717,0
0,1376,49836,3578754717,3578754717,0
0,1376,49837,3578754717,3578754717,0
0,1376,49838,3578754717,3578754717,0
0,1376,49839,3578754717,3578754717,0
0,1376,49840,3578754717,3578754718,1
0,1376,49841,3578754717,3578754718,1
0,1376,49842,3578754717,3578754719,2
0,1376,49843,3578754717,3578754719,2
0,1376,49844,3578754717,3578754719,2
0,1376,49845,3578754717,3578754719,2
0,1376,49846,3578754717,3578754719,2
0,1376,49847,3578754717,3578754719,2
0,1376,49848,3578754717,3578754720,3
0,1376,49849,3578754717,3578754720,3
0,1376,49850,3578754717,3578754721,4
0,1376,49851,3578754717,3578754721,4
0,1376,49852,3578754717,3578754723,6
0,1376,49853,3578754717,3578754724,7
0,1376,49854,3578754717,3578754725,8
0,1376,49855,3578754717,3578754726,9
0,1376,49856,3578754717,3578754726,9
0,1376,49857,3578754717,3578754727,10
0,1376,49858,3578754717,3578754727,10
0,1376,49859,3578754717,3578754728,11
0,1376,49860,3578754717,3578754728,11
0,1376,49861,3578754717,3578754728,11
0,1376,49862,3578754717,3578754728,11
0,1376,49863,3578754717,3578754728,11
0,1376,49864,3578754717,3578754729,12
0,1376,49865,3578754717,3578754730,13
0,1376,49866,3578754717,3578754730,13
0,1376,49867,3578754717,3578754730,13
0,1376,49868,3578754717,3578754730,13
0,1376,49869,3578754717,3578754731,14
0,1376,49870,3578754717,3578754731,14
0,1376,49871,3578754717,3578754731,14
0,1376,49872,3578754717,3578754732,15
0,1376,49873,3578754717,3578754733,16
0,1376,49874,3578754717,3578754733,16
0,1376,49875,3578754717,3578754734,17
0,1376,49876,3578754717,3578754736,19
0,1376,49877,3578754717,3578754738,21
0,1376,49878,3578754717,3578754739,22
0,1376,49879,3578754717,3578754739,22
0,1376,49880,3578754717,3578754739,22
0,1376,49881,3578754717,3578754740,23
0,1376,49882,3578754717,3578754740,23
0,1376,49883,3578754717,3578754740,23
0,1376,49884,3578754717,3578754742,25
0,1376,49885,3578754717,3578754742,25
0,1376,49886,3578754717,3578754742,25
0,1376,49887,3578754717,3578754743,26
0,1376,49888,3578754717,3578754743,26
0,1376,49889,3578754717,3578754743,26
0,1376,49890,3578754717,3578754743,26
0,1376,49891,3578754717,3578754744,27
0,1376,49892,3578754717,3578754745,28
0,1376,49893,3578754717,3578754746,29
0,1376,49894,3578754717,3578754746,29
0,1376,49895,3578754717,3578754747,30
0,1376,49896,3578754717,3578754747,30
0,1376,49897,3578754717,3578754748,31
0,1376,49898,3578754717,3578754749,32
0,1376,49899,3578754717,3578754750,33
0,1376,49900,3578754717,3578754750,33
0,1376,49901,3578754717,3578754752,35
0,1376,49902,3578754717,3578754752,35
0,1376,49903,3578754717,3578754752,35
0,1376,49904,3578754717,3578754752,35
0,1376,49905,3578754717,3578754753,36
0,1376,49906,3578754717,3578754754,37
0,1376,49907,3578754717,3578754755,38
0,1376,49908,3578754717,3578754755,38
0,1376,49909,3578754717,3578754755,38
0,1376,49910,3578754717,3578754756,39
0,1376,49911,3578754717,3578754756,39
0,1376,49912,3578754717,3578754758,41
0,1376,49913,3578754717,3578754758,41
0,1376,49914,3578754717,3578754759,42
0,1376,49915,3578754717,3578754760,43
0,1376,49916,3578754717,3578754760,43
0,1376,49917,3578754717,3578754760,43
0,1376,49918,3578754717,3578754761,44
0,1376,49919,3578754717,3578754761,44
0,1376,49920,3578754717,3578754762,45
0,1376,49921,3578754717,3578754762,45
0,1376,49922,3578754717,3578754762,45
0,1376,49923,3578754717,3578754763,46
0,1376,49924,3578754717,3578754763,46
0,1376,49925,3578754717,3578754763,46
0,1376,49926,3578754717,3578754763,46
0,1376,49927,3578754717,3578754764,47
0,1376,49928,3578754717,3578754765,48
0,1376,49929,3578754717,3578754765,48
0,1377,49930,3578754780,3578754780,0
0,1377,49931,3578754780,3578754780,0
0,1377,49932,3578754780,3578754780,0
0,1377,49933,3578754780,3578754780,0
0,1377,49934,3578754780,3578754780,0
0,1377,49935,3578754780,3578754780,0
0,1377,49936,3578754780,3578754780,0
0,1377,49937,3578754780,3578754780,0
0,1377,49938,3578754780,3578754780,0
0,1377,49939,3578754780,3578754780,0
0,1377,49940,3578754780,3578754780,0
0,1377,49941,3578754780,3578754780,0
0,1377,49942,3578754780,3578754780,0
0,1377,49943,3578754780,3578754780,0
0,1377,49944,3578754780,3578754780,0
0,1377,49945,3578754780,3578754780,0
0,1377,49946,3578754780,3578754780,0
0,1377,49947,3578754780,3578754780,0
0,1377,49948,3578754780,3578754780,0
0,1377,49949,3578754780,3578754780,0
0,1377,49950,3578754780,3578754780,0
0,1377,49951,3578754780,3578754781,1
0,1377,49952,3578754780,3578754783,3
0,1377,49953,3578754780,3578754785,5
0,1377,49954,3578754780,3578754787,7
0,1377,49955,3578754780,3578754787,7
0,1377,49956,3578754780,3578754787,7
0,1377,49957,3578754780,3578754788,8
0,1377,49958,3578754780,3578754789,9
0,1377,49959,3578754780,3578754791,11
0,1377,49960,3578754780,3578754792,12
0,1377,49961,3578754780,3578754793,13
0,1377,49962,3578754780,3578754793,13
0,1377,49963,3578754780,3578754793,13
0,1377,49964,3578754780,3578754794,14
0,1377,49965,3578754780,3578754794,14
0,1377,49966,3578754780,3578754795,15
0,1377,49967,3578754780,3578754796,16
0,1377,49968,3578754780,3578754800,20
0,1377,49969,3578754780,3578754800,20
0,1377,49970,3578754780,3578754801,21
0,1377,49971,3578754780,3578754801,21
0,1377,49972,3578754780,3578754802,22
0,1377,49973,3578754780,3578754803,23
0,1377,49974,3578754780,3578754803,23
0,1377,49975,3578754780,3578754803,23
0,1377,49976,3578754780,3578754804,24
0,1377,49977,3578754780,3578754805,25
0,1377,49978,3578754780,3578754805,25
0,1377,49979,3578754780,3578754807,27
0,1377,49980,3578754780,3578754807,27
0,1377,49981,3578754780,3578754808,28
0,1377,49982,3578754780,3578754809,29
0,1377,49983,3578754780,3578754809,29
0,1377,49984,3578754780,3578754809,29
0,1377,49985,3578754780,3578754811,31
0,1377,49986,3578754780,3578754812,32
0,1377,49987,3578754780,3578754813,33
0,1377,49988,3578754780,3578754814,34
0,1377,49989,3578754780,3578754814,34
0,1377,49990,3578754780,3578754815,35
0,1377,49991,3578754780,3578754815,35
0,1377,49992,3578754780,3578754816,36
0,1377,49993,3578754780,3578754818,38
0,1377,49994,3578754780,3578754818,38
0,1377,49995,3578754780,3578754818,38
0,1377,49996,3578754780,3578754818,38
0,1377,49997,3578754780,3578754819,39
0,1377,49998,3578754780,3578754820,40
0,1377,49999,3578754780,3578754820,40
0,1377,50000,3578754780,3578754821,41
0,1377,50001,3578754780,3578754821,41
0,1377,50002,3578754780,3578754822,42
0,1377,50003,3578754780,3578754822,42
0,1377,50004,3578754780,3578754824,44
0,1377,50005,3578754780,3578754824,44
0,1377,50006,3578754780,3578754825,45
0,1377,50007,3578754780,3578754826,46
0,1377,50008,3578754780,3578754826,46
0,1377,50009,3578754780,3578754828,48
0,1377,50010,3578754780,3578754828,48
0,1377,50011,3578754780,3578754829,49
0,1377,50012,3578754780,3578754829,49
0,1377,50013,3578754780,3578754829,49
0,1378,50014,3578754842,3578754842,0
0,1378,50015,3578754842,3578754842,0
0,1378,50016,3578754842,3578754842,0
0,1378,50017,3578754842,3578754842,0
0,1378,50018,3578754842,3578754842,0
0,1378,50019,3578754842,3578754843,1
0,1378,50020,3578754842,3578754843,1
0,1378,50021,3578754842,3578754843,1
0,1378,50022,3578754842,3578754843,1
0,1378,50023,3578754842,3578754843,1
0,1378,50024,3578754842,3578754843,1
0,1378,50025,3578754842,3578754843,1
0,1378,50026,3578754842,3578754843,1
0,1378,50027,3578754842,3578754843,1
0,1378,50028,3578754842,3578754843,1
0,1378,50029,3578754842,3578754843,1
0,1378,50030,3578754842,3578754843,1
0,1378,50031,3578754842,3578754843,1
0,1378,50032,3578754842,3578754843,1
0,1378,50033,3578754842,3578754844,2
0,1378,50034,3578754842,3578754844,2
0,1378,50035,3578754842,3578754847,5
0,1378,50036,3578754842,3578754848,6
0,1378,50037,3578754842,3578754848,6
0,1378,50038,3578754842,3578754849,7
0,1378,50039,3578754842,3578754849,7
0,1378,50040,3578754842,3578754851,9
0,1378,50041,3578754842,3578754851,9
0,1378,50042,3578754842,3578754852,10
0,1378,50043,3578754842,3578754852,10
0,1378,50044,3578754842,3578754854,12
0,1378,50045,3578754842,3578754855,13
0,1378,50046,3578754842,3578754855,13
0,1378,50047,3578754842,3578754856,14
0,1378,50048,3578754842,3578754856,14
0,1378,50049,3578754842,3578754859,17
0,1378,50050,3578754842,3578754861,19
0,1378,50051,3578754842,3578754862,20
0,1378,50052,3578754842,3578754862,20
0,1378,50053,3578754842,3578754863,21
0,1378,50054,3578754842,3578754864,22
0,1378,50055,3578754842,3578754864,22
0,1378,50056,3578754842,3578754865,23
0,1378,50057,3578754842,3578754865,23
0,1378,50058,3578754842,3578754866,24
0,1378,50059,3578754842,3578754866,24
0,1378,50060,3578754842,3578754866,24
0,1378,50061,3578754842,3578754867,25
0,1378,50062,3578754842,3578754880,38
0,1378,50063,3578754842,3578754880,38
0,1378,50064,3578754842,3578754881,39
0,1378,50065,3578754842,3578754881,39
0,1378,50066,3578754842,3578754885,43
0,1378,50067,3578754842,3578754885,43
0,1378,50068,3578754842,3578754885,43
0,1378,50069,3578754842,3578754886,44
0,1378,50070,3578754842,3578754887,45
0,1378,50071,3578754842,3578754888,46
0,1378,50072,3578754842,3578754889,47
0,1378,50073,3578754842,3578754889,47
0,1378,50074,3578754842,3578754889,47
0,1378,50075,3578754842,3578754891,49
0,1378,50076,3578754842,3578754891,49
0,1378,50077,3578754842,3578754891,49
0,1378,50078,3578754842,3578754891,49
0,1378,50079,3578754842,3578754891,49
0,1378,50080,3578754842,3578754892,50
0,1379,50081,3578754903,3578754904,1
0,1379,50082,3578754903,3578754904,1
0,1379,50083,3578754903,3578754904,1
0,1379,50084,3578754903,3578754904,1
0,1379,50085,3578754903,3578754904,1
0,1379,50086,3578754903,3578754904,1
0,1379,50087,3578754903,3578754904,1
0,1379,50088,3578754903,3578754904,1
0,1379,50089,3578754903,3578754904,1
0,1379,50090,3578754903,3578754904,1
0,1379,50091,3578754903,3578754904,1
0,1379,50092,3578754903,3578754904,1
0,1379,50093,3578754903,3578754904,1
0,1379,50094,3578754903,3578754904,1
0,1379,50095,3578754903,3578754904,1
0,1379,50096,3578754903,3578754904,1
0,1379,50097,3578754903,3578754905,2
0,1379,50098,3578754903,3578754905,2
0,1379,50099,3578754903,3578754907,4
0,1379,50100,3578754903,3578754908,5
0,1379,50101,3578754903,3578754908,5
0,1379,50102,3578754903,3578754908,5
0,1379,50103,3578754903,3578754909,6
0,1379,50104,3578754903,3578754909,6
0,1379,50105,3578754903,3578754909,6
0,1379,50106,3578754903,3578754910,7
0,1379,50107,3578754903,3578754910,7
0,1379,50108,3578754903,3578754910,7
0,1379,50109,3578754903,3578754911,8
0,1379,50110,3578754903,3578754911,8
0,1379,50111,3578754903,3578754911,8
0,1379,50112,3578754903,3578754911,8
0,1379,50113,3578754903,3578754913,10
0,1379,50114,3578754903,3578754913,10
0,1379,50115,3578754903,3578754913,10
0,1379,50116,3578754903,3578754915,12
0,1379,50117,3578754903,3578754915,12
0,1379,50118,3578754903,3578754915,12
0,1379,50119,3578754903,3578754915,12
0,1379,50120,3578754903,3578754915,12
0,1379,50121,3578754903,3578754915,12
0,1379,50122,3578754903,3578754916,13
0,1379,50123,3578754903,3578754917,14
0,1379,50124,3578754903,3578754917,14
0,1379,50125,3578754903,3578754918,15
0,1379,50126,3578754903,3578754918,15
0,1379,50127,3578754903,3578754918,15
0,1379,50128,3578754903,3578754918,15
0,1379,50129,3578754903,3578754919,16
0,1379,50130,3578754903,3578754919,16
0,1379,50131,3578754903,3578754919,16
0,1379,50132,3578754903,3578754919,16
0,1379,50133,3578754903,3578754920,17
0,1379,50134,3578754903,3578754920,17
0,1379,50135,3578754903,3578754921,18
0,1379,50136,3578754903,3578754921,18
0,1379,50137,3578754903,3578754921,18
0,1379,50138,3578754903,3578754922,19
0,1379,50139,3578754903,3578754923,20
0,1379,50140,3578754903,3578754923,20
0,1379,50141,3578754903,3578754925,22
0,1379,50142,3578754903,3578754926,23
0,1379,50143,3578754903,3578754926,23
0,1379,50144,3578754903,3578754926,23
0,1379,50145,3578754903,3578754926,23
0,1379,50146,3578754903,3578754927,24
0,1379,50147,3578754903,3578754927,24
0,1379,50148,3578754903,3578754928,25
0,1379,50149,3578754903,3578754928,25
0,1379,50150,3578754903,3578754928,25
0,1379,50151,3578754903,3578754929,26
0,1379,50152,3578754903,3578754930,27
0,1379,50153,3578754903,3578754930,27
0,1379,50154,3578754903,3578754931,28
0,1379,50155,3578754903,3578754931,28
0,1379,50156,3578754903,3578754931,28
0,1379,50157,3578754903,3578754932,29
0,1379,50158,3578754903,3578754932,29
0,1379,50159,3578754903,3578754932,29
0,1379,50160,3578754903,3578754933,30
0,1379,50161,3578754903,3578754933,30
0,1379,50162,3578754903,3578754934,31
0,1379,50163,3578754903,3578754936,33
0,1379,50164,3578754903,3578754939,36
0,1379,50165,3578754903,3578754939,36
0,1379,50166,3578754903,3578754939,36
0,1379,50167,3578754903,3578754940,37
0,1379,50168,3578754903,3578754940,37
0,1379,50169,3578754903,3578754940,37
0,1379,50170,3578754903,3578754940,37
0,1379,50171,3578754903,3578754941,38
0,1379,50172,3578754903,3578754941,38
0,1379,50173,3578754903,3578754942,39
0,1379,50174,3578754903,3578754942,39
0,1379,50175,3578754903,3578754943,40
0,1379,50176,3578754903,3578754943,40
0,1379,50177,3578754903,3578754943,40
0,1379,50178,3578754903,3578754944,41
0,1379,50179,3578754903,3578754944,41
0,1379,50180,3578754903,3578754945,42
0,1379,50181,3578754903,3578754945,42
0,1379,50182,3578754903,3578754946,43
0,1379,50183,3578754903,3578754946,43
0,1379,50184,3578754903,3578754947,44
0,1379,50185,3578754903,3578754948,45
0,1379,50186,3578754903,3578754950,47
0,1379,50187,3578754903,3578754950,47
0,1379,50188,3578754903,3578754951,48
0,1379,50189,3578754903,3578754952,49
0,1379,50190,3578754903,3578754952,49
0,1379,50191,3578754903,3578754952,49
0,1379,50192,3578754903,3578754953,50
0,1380,50193,3578754965,3578754965,0
0,1380,50194,3578754965,3578754965,0
0,1380,50195,3578754965,3578754965,0
0,1380,50196,3578754965,3578754965,0
0,1380,50197,3578754965,3578754965,0
0,1380,50198,3578754965,3578754965,0
0,1380,50199,3578754965,3578754965,0
0,1380,50200,3578754965,3578754965,0
0,1380,50201,3578754965,3578754965,0
0,1380,50202,3578754965,3578754965,0
0,1380,50203,3578754965,3578754965,0
0,1380,50204,3578754965,3578754965,0
0,1380,50205,3578754965,3578754965,0
0,1380,50206,3578754965,3578754965,0
0,1380,50207,3578754965,3578754965,0
0,1380,50208,3578754965,3578754965,0
0,1380,50209,3578754965,3578754965,0
0,1380,50210,3578754965,3578754965,0
0,1380,50211,3578754965,3578754965,0
0,1380,50212,3578754965,3578754965,0
0,1380,50213,3578754965,3578754965,0
0,1380,50214,3578754965,3578754965,0
0,1380,50215,3578754965,3578754965,0
0,1380,50216,3578754965,3578754965,0
0,1380,50217,3578754965,3578754965,0
0,1380,50218,3578754965,3578754966,1
0,1380,50219,3578754965,3578754968,3
0,1380,50220,3578754965,3578754968,3
0,1380,50221,3578754965,3578754969,4
0,1380,50222,3578754965,3578754970,5
0,1380,50223,3578754965,3578754970,5
0,1380,50224,3578754965,3578754973,8
0,1380,50225,3578754965,3578754973,8
0,1380,50226,3578754965,3578754974,9
0,1380,50227,3578754965,3578754974,9
0,1380,50228,3578754965,3578754974,9
0,1380,50229,3578754965,3578754975,10
0,1380,50230,3578754965,3578754976,11
0,1380,50231,3578754965,3578754977,12
0,1380,50232,3578754965,3578754978,13
0,1380,50233,3578754965,3578754978,13
0,1380,50234,3578754965,3578754979,14
0,1380,50235,3578754965,3578754979,14
0,1380,50236,3578754965,3578754980,15
0,1380,50237,3578754965,3578754981,16
0,1380,50238,3578754965,3578754981,16
0,1380,50239,3578754965,3578754983,18
0,1380,50240,3578754965,3578754986,21
0,1380,50241,3578754965,3578754987,22
0,1380,50242,3578754965,3578754987,22
0,1380,50243,3578754965,3578754988,23
0,1380,50244,3578754965,3578754988,23
0,1380,50245,3578754965,3578754988,23
0,1380,50246,3578754965,3578754989,24
0,1380,50247,3578754965,3578754991,26
0,1380,50248,3578754965,3578754992,27
0,1380,50249,3578754965,3578754992,27
0,1380,50250,3578754965,3578754993,28
0,1380,50251,3578754965,3578754993,28
0,1380,50252,3578754965,3578754993,28
0,1380,50253,3578754965,3578754994,29
0,1380,50254,3578754965,3578754994,29
0,1380,50255,3578754965,3578754995,30
0,1380,50256,3578754965,3578754996,31
0,1380,50257,3578754965,3578754999,34
0,1380,50258,3578754965,3578754999,34
0,1380,50259,3578754965,3578755001,36
0,1380,50260,3578754965,3578755001,36
0,1380,50261,3578754965,3578755002,37
0,1380,50262,3578754965,3578755003,38
0,1380,50263,3578754965,3578755004,39
0,1380,50264,3578754965,3578755004,39
0,1380,50265,3578754965,3578755005,40
0,1380,50266,3578754965,3578755006,41
0,1380,50267,3578754965,3578755006,41
0,1380,50268,3578754965,3578755006,41
0,1380,50269,3578754965,3578755006,41
0,1380,50270,3578754965,3578755007,42
0,1380,50271,3578754965,3578755008,43
0,1380,50272,3578754965,3578755009,44
0,1380,50273,3578754965,3578755010,45
0,1380,50274,3578754965,3578755010,45
0,1380,50275,3578754965,3578755010,45
0,1380,50276,3578754965,3578755012,47
0,1380,50277,3578754965,3578755012,47
0,1380,50278,3578754965,3578755013,48
0,1380,50279,3578754965,3578755014,49
0,1380,50280,3578754965,3578755015,50
0,1381,50281,3578755028,3578755028,0
0,1381,50282,3578755028,3578755028,0
0,1381,50283,3578755028,3578755028,0
0,1381,50284,3578755028,3578755028,0
0,1381,50285,3578755028,3578755028,0
0,1381,50286,3578755028,3578755028,0
0,1381,50287,3578755028,3578755028,0
0,1381,50288,3578755028,3578755028,0
0,1381,50289,3578755028,3578755028,0
0,1381,50290,3578755028,3578755028,0
0,1381,50291,3578755028,3578755028,0
0,1381,50292,3578755028,3578755028,0
0,1381,50293,3578755028,3578755028,0
0,1381,50294,3578755028,3578755028,0
0,1381,50295,3578755028,3578755028,0
0,1381,50296,3578755028,3578755028,0
0,1381,50297,3578755028,3578755028,0
0,1381,50298,3578755028,3578755028,0
0,1381,50299,3578755028,3578755028,0
0,1381,50300,3578755028,3578755028,0
0,1381,50301,3578755028,3578755029,1
0,1381,50302,3578755028,3578755030,2
0,1381,50303,3578755028,3578755030,2
0,1381,50304,3578755028,3578755031,3
0,1381,50305,3578755028,3578755032,4
0,1381,50306,3578755028,3578755032,4
0,1381,50307,3578755028,3578755033,5
0,1381,50308,3578755028,3578755034,6
0,1381,50309,3578755028,3578755035,7
0,1381,50310,3578755028,3578755036,8
0,1381,50311,3578755028,3578755036,8
0,1381,50312,3578755028,3578755037,9
0,1381,50313,3578755028,3578755038,10
0,1381,50314,3578755028,3578755038,10
0,1381,50315,3578755028,3578755039,11
0,1381,50316,3578755028,3578755039,11
0,1381,50317,3578755028,3578755040,12
0,1381,50318,3578755028,3578755040,12
0,1381,50319,3578755028,3578755040,12
0,1381,50320,3578755028,3578755042,14
0,1381,50321,3578755028,3578755042,14
0,1381,50322,3578755028,3578755043,15
0,1381,50323,3578755028,3578755043,15
0,1381,50324,3578755028,3578755047,19
0,1381,50325,3578755028,3578755048,20
0,1381,50326,3578755028,3578755048,20
0,1381,50327,3578755028,3578755049,21
0,1381,50328,3578755028,3578755049,21
0,1381,50329,3578755028,3578755049,21
0,1381,50330,3578755028,3578755050,22
0,1381,50331,3578755028,3578755051,23
0,1381,50332,3578755028,3578755052,24
0,1381,50333,3578755028,3578755052,24
0,1381,50334,3578755028,3578755054,26
0,1381,50335,3578755028,3578755055,27
0,1381,50336,3578755028,3578755055,27
0,1381,50337,3578755028,3578755056,28
0,1381,50338,3578755028,3578755056,28
0,1381,50339,3578755028,3578755058,30
0,1381,50340,3578755028,3578755058,30
0,1381,50341,3578755028,3578755059,31
0,1381,50342,3578755028,3578755061,33
0,1381,50343,3578755028,3578755061,33
0,1381,50344,3578755028,3578755062,34
0,1381,50345,3578755028,3578755064,36
0,1381,50346,3578755028,3578755064,36
0,1381,50347,3578755028,3578755064,36
0,1381,50348,3578755028,3578755065,37
0,1381,50349,3578755028,3578755066,38
0,1381,50350,3578755028,3578755066,38
0,1381,50351,3578755028,3578755067,39
0,1381,50352,3578755028,3578755067,39
0,1381,50353,3578755028,3578755068,40
0,1381,50354,3578755028,3578755070,42
0,1382,50355,3578755091,3578755091,0
0,1382,50356,3578755091,3578755091,0
0,1382,50357,3578755091,3578755091,0
0,1382,50358,3578755091,3578755091,0
0,1382,50359,3578755091,3578755091,0
0,1382,50360,3578755091,3578755091,0
0,1382,50361,3578755091,3578755091,0
0,1382,50362,3578755091,3578755091,0
0,1382,50363,3578755091,3578755091,0
0,1382,50364,3578755091,3578755091,0
0,1382,50365,3578755091,3578755091,0
0,1382,50366,3578755091,3578755091,0
0,1382,50367,3578755091,3578755091,0
0,1382,50368,3578755091,3578755091,0
0,1382,50369,3578755091,3578755091,0
0,1382,50370,3578755091,3578755092,1
0,1382,50371,3578755091,3578755092,1
0,1382,50372,3578755091,3578755093,2
0,1382,50373,3578755091,3578755093,2
0,1382,50374,3578755091,3578755094,3
0,1382,50375,3578755091,3578755094,3
0,1382,50376,3578755091,3578755095,4
0,1382,50377,3578755091,3578755096,5
0,1382,50378,3578755091,3578755096,5
0,1382,50379,3578755091,3578755098,7
0,1382,50380,3578755091,3578755098,7
0,1382,50381,3578755091,3578755098,7
0,1382,50382,3578755091,3578755099,8
0,1382,50383,3578755091,3578755101,10
0,1382,50384,3578755091,3578755101,10
0,1382,50385,3578755091,3578755104,13
0,1382,50386,3578755091,3578755104,13
0,1382,50387,3578755091,3578755105,14
0,1382,50388,3578755091,3578755105,14
0,1382,50389,3578755091,3578755106,15
0,1382,50390,3578755091,3578755108,17
0,1382,50391,3578755091,3578755108,17
0,1382,50392,3578755091,3578755108,17
0,1382,50393,3578755091,3578755109,18
0,1382,50394,3578755091,3578755109,18
0,1382,50395,3578755091,3578755109,18
0,1382,50396,3578755091,3578755109,18
0,1382,50397,3578755091,3578755110,19
0,1382,50398,3578755091,3578755110,19
0,1382,50399,3578755091,3578755110,19
0,1382,50400,3578755091,3578755111,20
0,1382,50401,3578755091,3578755111,20
0,1382,50402,3578755091,3578755111,20
0,1382,50403,3578755091,3578755112,21
0,1382,50404,3578755091,3578755113,22
0,1382,50405,3578755091,3578755113,22
0,1382,50406,3578755091,3578755113,22
0,1382,50407,3578755091,3578755113,22
0,1382,50408,3578755091,3578755113,22
0,1382,50409,3578755091,3578755115,24
0,1382,50410,3578755091,3578755115,24
0,1382,50411,3578755091,3578755115,24
0,1382,50412,3578755091,3578755115,24
0,1382,50413,3578755091,3578755116,25
0,1382,50414,3578755091,3578755116,25
0,1382,50415,3578755091,3578755117,26
0,1382,50416,3578755091,3578755117,26
0,1382,50417,3578755091,3578755117,26
0,1382,50418,3578755091,3578755117,26
0,1382,50419,3578755091,3578755118,27
0,1382,50420,3578755091,3578755119,28
0,1382,50421,3578755091,3578755119,28
0,1382,50422,3578755091,3578755119,28
0,1382,50423,3578755091,3578755119,28
0,1382,50424,3578755091,3578755119,28
0,1382,50425,3578755091,3578755120,29
0,1382,50426,3578755091,3578755121,30
0,1382,50427,3578755091,3578755121,30
0,1382,50428,3578755091,3578755122,31
0,1382,50429,3578755091,3578755123,32
0,1382,50430,3578755091,3578755123,32
0,1382,50431,3578755091,3578755123,32
0,1382,50432,3578755091,3578755125,34
0,1382,50433,3578755091,3578755126,35
0,1382,50434,3578755091,3578755126,35
0,1382,50435,3578755091,3578755127,36
0,1382,50436,3578755091,3578755128,37
0,1382,50437,3578755091,3578755128,37
0,1382,50438,3578755091,3578755129,38
0,1382,50439,3578755091,3578755129,38
0,1382,50440,3578755091,3578755130,39
0,1382,50441,3578755091,3578755130,39
0,1382,50442,3578755091,3578755131,40
0,1382,50443,3578755091,3578755131,40
0,1382,50444,3578755091,3578755131,40
0,1382,50445,3578755091,3578755131,40
0,1382,50446,3578755091,3578755131,40
0,1382,50447,3578755091,3578755132,41
0,1382,50448,3578755091,3578755132,41
0,1382,50449,3578755091,3578755133,42
0,1382,50450,3578755091,3578755134,43
0,1382,50451,3578755091,3578755134,43
0,1382,50452,3578755091,3578755134,43
0,1382,50453,3578755091,3578755136,45
0,1382,50454,3578755091,3578755139,48
0,1382,50455,3578755091,3578755139,48
0,1382,50456,3578755091,3578755140,49
0,1382,50457,3578755091,3578755141,50
0,1383,50458,3578755154,3578755154,0
0,1383,50459,3578755154,3578755154,0
0,1383,50460,3578755154,3578755154,0
0,1383,50461,3578755154,3578755154,0
0,1383,50462,3578755154,3578755154,0
0,1383,50463,3578755154,3578755154,0
0,1383,50464,3578755154,3578755154,0
0,1383,50465,3578755154,3578755154,0
0,1383,50466,3578755154,3578755154,0
0,1383,50467,3578755154,3578755154,0
0,1383,50468,3578755154,3578755154,0
0,1383,50469,3578755154,3578755154,0
0,1383,50470,3578755154,3578755154,0
0,1383,50471,3578755154,3578755154,0
0,1383,50472,3578755154,3578755154,0
0,1383,50473,3578755154,3578755154,0
0,1383,50474,3578755154,3578755154,0
0,1383,50475,3578755154,3578755154,0
0,1383,50476,3578755154,3578755154,0
0,1383,50477,3578755154,3578755154,0
0,1383,50478,3578755154,3578755154,0
0,1383,50479,3578755154,3578755154,0
0,1383,50480,3578755154,3578755154,0
0,1383,50481,3578755154,3578755154,0
0,1383,50482,3578755154,3578755154,0
0,1383,50483,3578755154,3578755154,0
0,1383,50484,3578755154,3578755154,0
0,1383,50485,3578755154,3578755155,1
0,1383,50486,3578755154,3578755155,1
0,1383,50487,3578755154,3578755155,1
0,1383,50488,3578755154,3578755155,1
0,1383,50489,3578755154,3578755157,3
0,1383,50490,3578755154,3578755158,4
0,1383,50491,3578755154,3578755159,5
0,1383,50492,3578755154,3578755160,6
0,1383,50493,3578755154,3578755161,7
0,1383,50494,3578755154,3578755162,8
0,1383,50495,3578755154,3578755162,8
0,1383,50496,3578755154,3578755162,8
0,1383,50497,3578755154,3578755163,9
0,1383,50498,3578755154,3578755163,9
0,1383,50499,3578755154,3578755163,9
0,1383,50500,3578755154,3578755164,10
0,1383,50501,3578755154,3578755165,11
0,1383,50502,3578755154,3578755165,11
0,1383,50503,3578755154,3578755165,11
0,1383,50504,3578755154,3578755166,12
0,1383,50505,3578755154,3578755167,13
0,1383,50506,3578755154,3578755168,14
0,1383,50507,3578755154,3578755169,15
0,1383,50508,3578755154,3578755170,16
0,1383,50509,3578755154,3578755170,16
0,1383,50510,3578755154,3578755173,19
0,1383,50511,3578755154,3578755174,20
0,1383,50512,3578755154,3578755174,20
0,1383,50513,3578755154,3578755175,21
0,1383,50514,3578755154,3578755176,22
0,1383,50515,3578755154,3578755177,23
0,1383,50516,3578755154,3578755179,25
0,1383,50517,3578755154,3578755180,26
0,1383,50518,3578755154,3578755180,26
0,1383,50519,3578755154,3578755181,27
0,1383,50520,3578755154,3578755181,27
0,1383,50521,3578755154,3578755183,29
0,1383,50522,3578755154,3578755184,30
0,1383,50523,3578755154,3578755185,31
0,1383,50524,3578755154,3578755186,32
0,1383,50525,3578755154,3578755187,33
0,1383,50526,3578755154,3578755187,33
0,1383,50527,3578755154,3578755188,34
0,1383,50528,3578755154,3578755189,35
0,1383,50529,3578755154,3578755189,35
0,1383,50530,3578755154,3578755189,35
0,1383,50531,3578755154,3578755191,37
0,1383,50532,3578755154,3578755192,38
0,1383,50533,3578755154,3578755193,39
0,1383,50534,3578755154,3578755193,39
0,1383,50535,3578755154,3578755193,39
0,1383,50536,3578755154,3578755194,40
0,1383,50537,3578755154,3578755194,40
0,1383,50538,3578755154,3578755195,41
0,1383,50539,3578755154,3578755195,41
0,1383,50540,3578755154,3578755198,44
0,1383,50541,3578755154,3578755199,45
0,1383,50542,3578755154,3578755200,46
0,1383,50543,3578755154,3578755201,47
0,1383,50544,3578755154,3578755201,47
0,1383,50545,3578755154,3578755202,48
0,1383,50546,3578755154,3578755203,49
0,1383,50547,3578755154,3578755204,50
0,1384,50548,3578755216,3578755216,0
0,1384,50549,3578755216,3578755216,0
0,1384,50550,3578755216,3578755216,0
0,1384,50551,3578755216,3578755216,0
0,1384,50552,3578755216,3578755216,0
0,1384,50553,3578755216,3578755216,0
0,1384,50554,3578755216,3578755216,0
0,1384,50555,3578755216,3578755216,0
0,1384,50556,3578755216,3578755216,0
0,1384,50557,3578755216,3578755216,0
0,1384,50558,3578755216,3578755216,0
0,1384,50559,3578755216,3578755216,0
0,1384,50560,3578755216,3578755216,0
0,1384,50561,3578755216,3578755216,0
0,1384,50562,3578755216,3578755216,0
0,1384,50563,3578755216,3578755216,0
0,1384,50564,3578755216,3578755216,0
0,1384,50565,3578755216,3578755217,1
0,1384,50566,3578755216,3578755217,1
0,1384,50567,3578755216,3578755217,1
0,1384,50568,3578755216,3578755217,1
0,1384,50569,3578755216,3578755217,1
0,1384,50570,3578755216,3578755218,2
0,1384,50571,3578755216,3578755218,2
0,1384,50572,3578755216,3578755218,2
0,1384,50573,3578755216,3578755219,3
0,1384,50574,3578755216,3578755219,3
0,1384,50575,3578755216,3578755220,4
0,1384,50576,3578755216,3578755221,5
0,1384,50577,3578755216,3578755222,6
0,1384,50578,3578755216,3578755223,7
0,1384,50579,3578755216,3578755223,7
0,1384,50580,3578755216,3578755224,8
0,1384,50581,3578755216,3578755224,8
0,1384,50582,3578755216,3578755224,8
0,1384,50583,3578755216,3578755225,9
0,1384,50584,3578755216,3578755227,11
0,1384,50585,3578755216,3578755228,12
0,1384,50586,3578755216,3578755228,12
0,1384,50587,3578755216,3578755229,13
0,1384,50588,3578755216,3578755230,14
0,1384,50589,3578755216,3578755230,14
0,1384,50590,3578755216,3578755230,14
0,1384,50591,3578755216,3578755231,15
0,1384,50592,3578755216,3578755232,16
0,1384,50593,3578755216,3578755232,16
0,1384,50594,3578755216,3578755232,16
0,1384,50595,3578755216,3578755234,18
0,1384,50596,3578755216,3578755235,19
0,1384,50597,3578755216,3578755237,21
0,1384,50598,3578755216,3578755237,21
0,1384,50599,3578755216,3578755237,21
0,1384,50600,3578755216,3578755238,22
0,1384,50601,3578755216,3578755238,22
0,1384,50602,3578755216,3578755239,23
0,1384,50603,3578755216,3578755239,23
0,1384,50604,3578755216,3578755239,23
0,1384,50605,3578755216,3578755240,24
0,1384,50606,3578755216,3578755240,24
0,1384,50607,3578755216,3578755240,24
0,1384,50608,3578755216,3578755242,26
0,1384,50609,3578755216,3578755242,26
0,1384,50610,3578755216,3578755243,27
0,1384,50611,3578755216,3578755243,27
0,1384,50612,3578755216,3578755243,27
0,1384,50613,3578755216,3578755245,29
0,1384,50614,3578755216,3578755246,30
0,1384,50615,3578755216,3578755247,31
0,1384,50616,3578755216,3578755247,31
0,1384,50617,3578755216,3578755248,32
0,1384,50618,3578755216,3578755249,33
0,1384,50619,3578755216,3578755249,33
0,1384,50620,3578755216,3578755250,34
0,1384,50621,3578755216,3578755250,34
0,1384,50622,3578755216,3578755251,35
0,1384,50623,3578755216,3578755252,36
0,1384,50624,3578755216,3578755252,36
0,1384,50625,3578755216,3578755253,37
0,1384,50626,3578755216,3578755254,38
0,1384,50627,3578755216,3578755255,39
0,1384,50628,3578755216,3578755255,39
0,1384,50629,3578755216,3578755256,40
0,1384,50630,3578755216,3578755256,40
0,1384,50631,3578755216,3578755257,41
0,1384,50632,3578755216,3578755258,42
0,1384,50633,3578755216,3578755259,43
0,1384,50634,3578755216,3578755261,45
0,1384,50635,3578755216,3578755262,46
0,1384,50636,3578755216,3578755262,46
0,1384,50637,3578755216,3578755263,47
0,1384,50638,3578755216,3578755264,48
0,1384,50639,3578755216,3578755265,49
0,1384,50640,3578755216,3578755265,49
0,1384,50641,3578755216,3578755265,49
0,1385,50642,3578755279,3578755279,0
0,1385,50643,3578755279,3578755279,0
0,1385,50644,3578755279,3578755279,0
0,1385,50645,3578755279,3578755279,0
0,1385,50646,3578755279,3578755279,0
0,1385,50647,3578755279,3578755280,1
0,1385,50648,3578755279,3578755281,2
0,1385,50649,3578755279,3578755281,2
0,1385,50650,3578755279,3578755282,3
0,1385,50651,3578755279,3578755285,6
0,1385,50652,3578755279,3578755286,7
0,1385,50653,3578755279,3578755286,7
0,1385,50654,3578755279,3578755286,7
0,1385,50655,3578755279,3578755287,8
0,1385,50656,3578755279,3578755287,8
0,1385,50657,3578755279,3578755287,8
0,1385,50658,3578755279,3578755289,10
0,1385,50659,3578755279,3578755289,10
0,1385,50660,3578755279,3578755289,10
0,1385,50661,3578755279,3578755291,12
0,1385,50662,3578755279,3578755291,12
0,1385,50663,3578755279,3578755291,12
0,1385,50664,3578755279,3578755292,13
0,1385,50665,3578755279,3578755292,13
0,1385,50666,3578755279,3578755292,13
0,1385,50667,3578755279,3578755293,14
0,1385,50668,3578755279,3578755294,15
0,1385,50669,3578755279,3578755295,16
0,1385,50670,3578755279,3578755295,16
0,1385,50671,3578755279,3578755297,18
0,1385,50672,3578755279,3578755297,18
0,1385,50673,3578755279,3578755298,19
0,1385,50674,3578755279,3578755300,21
0,1385,50675,3578755279,3578755301,22
0,1385,50676,3578755279,3578755301,22
0,1385,50677,3578755279,3578755304,25
0,1385,50678,3578755279,3578755305,26
0,1385,50679,3578755279,3578755305,26
0,1385,50680,3578755279,3578755305,26
0,1385,50681,3578755279,3578755306,27
0,1385,50682,3578755279,3578755307,28
0,1385,50683,3578755279,3578755308,29
0,1385,50684,3578755279,3578755308,29
0,1385,50685,3578755279,3578755308,29
0,1385,50686,3578755279,3578755308,29
0,1385,50687,3578755279,3578755309,30
0,1385,50688,3578755279,3578755309,30
0,1385,50689,3578755279,3578755310,31
0,1385,50690,3578755279,3578755310,31
0,1385,50691,3578755279,3578755310,31
0,1385,50692,3578755279,3578755311,32
0,1385,50693,3578755279,3578755311,32
0,1385,50694,3578755279,3578755311,32
0,1385,50695,3578755279,3578755311,32
0,1385,50696,3578755279,3578755312,33
0,1385,50697,3578755279,3578755312,33
0,1385,50698,3578755279,3578755313,34
0,1385,50699,3578755279,3578755313,34
0,1385,50700,3578755279,3578755313,34
0,1385,50701,3578755279,3578755313,34
0,1385,50702,3578755279,3578755314,35
0,1385,50703,3578755279,3578755314,35
0,1385,50704,3578755279,3578755315,36
0,1385,50705,3578755279,3578755315,36
0,1385,50706,3578755279,3578755315,36
0,1385,50707,3578755279,3578755315,36
0,1385,50708,3578755279,3578755316,37
0,1385,50709,3578755279,3578755316,37
0,1385,50710,3578755279,3578755316,37
0,1385,50711,3578755279,3578755317,38
0,1385,50712,3578755279,3578755317,38
0,1385,50713,3578755279,3578755318,39
0,1385,50714,3578755279,3578755318,39
0,1385,50715,3578755279,3578755318,39
0,1385,50716,3578755279,3578755318,39
0,1385,50717,3578755279,3578755319,40
0,1385,50718,3578755279,3578755319,40
0,1385,50719,3578755279,3578755319,40
0,1385,50720,3578755279,3578755320,41
0,1385,50721,3578755279,3578755321,42
0,1385,50722,3578755279,3578755321,42
0,1385,50723,3578755279,3578755322,43
0,1385,50724,3578755279,3578755322,43
0,1385,50725,3578755279,3578755323,44
0,1385,50726,3578755279,3578755324,45
0,1385,50727,3578755279,3578755324,45
0,1385,50728,3578755279,3578755325,46
0,1385,50729,3578755279,3578755326,47
0,1385,50730,3578755279,3578755326,47
0,1385,50731,3578755279,3578755326,47
0,1385,50732,3578755279,3578755327,48
0,1385,50733,3578755279,3578755327,48
0,1385,50734,3578755279,3578755327,48
0,1385,50735,3578755279,3578755328,49
0,1385,50736,3578755279,3578755329,50
0,1386,50737,3578755342,3578755342,0
0,1386,50738,3578755342,3578755342,0
0,1386,50739,3578755342,3578755342,0
0,1386,50740,3578755342,3578755342,0
0,1386,50741,3578755342,3578755342,0
0,1386,50742,3578755342,3578755342,0
0,1386,50743,3578755342,3578755342,0
0,1386,50744,3578755342,3578755342,0
0,1386,50745,3578755342,3578755342,0
0,1386,50746,3578755342,3578755342,0
0,1386,50747,3578755342,3578755342,0
0,1386,50748,3578755342,3578755342,0
0,1386,50749,3578755342,3578755342,0
0,1386,50750,3578755342,3578755342,0
0,1386,50751,3578755342,3578755342,0
0,1386,50752,3578755342,3578755342,0
0,1386,50753,3578755342,3578755342,0
0,1386,50754,3578755342,3578755342,0
0,1386,50755,3578755342,3578755342,0
0,1386,50756,3578755342,3578755342,0
0,1386,50757,3578755342,3578755342,0
0,1386,50758,3578755342,3578755342,0
0,1386,50759,3578755342,3578755342,0
0,1386,50760,3578755342,3578755342,0
0,1386,50761,3578755342,3578755342,0
0,1386,50762,3578755342,3578755342,0
0,1386,50763,3578755342,3578755343,1
0,1386,50764,3578755342,3578755343,1
0,1386,50765,3578755342,3578755343,1
0,1386,50766,3578755342,3578755343,1
0,1386,50767,3578755342,3578755343,1
0,1386,50768,3578755342,3578755345,3
0,1386,50769,3578755342,3578755345,3
0,1386,50770,3578755342,3578755345,3
0,1386,50771,3578755342,3578755347,5
0,1386,50772,3578755342,3578755348,6
0,1386,50773,3578755342,3578755348,6
0,1386,50774,3578755342,3578755348,6
0,1386,50775,3578755342,3578755350,8
0,1386,50776,3578755342,3578755351,9
0,1386,50777,3578755342,3578755352,10
0,1386,50778,3578755342,3578755352,10
0,1386,50779,3578755342,3578755353,11
0,1386,50780,3578755342,3578755353,11
0,1386,50781,3578755342,3578755353,11
0,1386,50782,3578755342,3578755353,11
0,1386,50783,3578755342,3578755355,13
0,1386,50784,3578755342,3578755355,13
0,1386,50785,3578755342,3578755356,14
0,1386,50786,3578755342,3578755356,14
0,1386,50787,3578755342,3578755356,14
0,1386,50788,3578755342,3578755358,16
0,1386,50789,3578755342,3578755358,16
0,1386,50790,3578755342,3578755359,17
0,1386,50791,3578755342,3578755360,18
0,1386,50792,3578755342,3578755360,18
0,1386,50793,3578755342,3578755361,19
0,1386,50794,3578755342,3578755361,19
0,1386,50795,3578755342,3578755362,20
0,1386,50796,3578755342,3578755362,20
0,1386,50797,3578755342,3578755362,20
0,1386,50798,3578755342,3578755363,21
0,1386,50799,3578755342,3578755363,21
0,1386,50800,3578755342,3578755363,21
0,1386,50801,3578755342,3578755364,22
0,1386,50802,3578755342,3578755364,22
0,1386,50803,3578755342,3578755365,23
0,1386,50804,3578755342,3578755365,23
0,1386,50805,3578755342,3578755365,23
0,1386,50806,3578755342,3578755365,23
0,1386,50807,3578755342,3578755367,25
0,1386,50808,3578755342,3578755369,27
0,1386,50809,3578755342,3578755369,27
0,1386,50810,3578755342,3578755370,28
0,1386,50811,3578755342,3578755371,29
0,1386,50812,3578755342,3578755373,31
0,1386,50813,3578755342,3578755373,31
0,1386,50814,3578755342,3578755374,32
0,1386,50815,3578755342,3578755375,33
0,1386,50816,3578755342,3578755376,34
0,1386,50817,3578755342,3578755378,36
0,1386,50818,3578755342,3578755379,37
0,1386,50819,3578755342,3578755379,37
0,1386,50820,3578755342,3578755379,37
0,1386,50821,3578755342,3578755381,39
0,1386,50822,3578755342,3578755381,39
0,1386,50823,3578755342,3578755382,40
0,1386,50824,3578755342,3578755383,41
0,1386,50825,3578755342,3578755384,42
0,1386,50826,3578755342,3578755384,42
0,1386,50827,3578755342,3578755384,42
0,1386,50828,3578755342,3578755387,45
0,1386,50829,3578755342,3578755387,45
0,1386,50830,3578755342,3578755387,45
0,1386,50831,3578755342,3578755388,46
0,1386,50832,3578755342,3578755389,47
0,1386,50833,3578755342,3578755389,47
0,1386,50834,3578755342,3578755390,48
0,1386,50835,3578755342,3578755391,49
0,1386,50836,3578755342,3578755392,50
0,1387,50837,3578755404,3578755404,0
0,1387,50838,3578755404,3578755404,0
0,1387,50839,3578755404,3578755404,0
0,1387,50840,3578755404,3578755404,0
0,1387,50841,3578755404,3578755404,0
0,1387,50842,3578755404,3578755404,0
0,1387,50843,3578755404,3578755404,0
0,1387,50844,3578755404,3578755404,0
0,1387,50845,3578755404,3578755404,0
0,1387,50846,3578755404,3578755404,0
0,1387,50847,3578755404,3578755404,0
0,1387,50848,3578755404,3578755404,0
0,1387,50849,3578755404,3578755404,0
0,1387,50850,3578755404,3578755404,0
0,1387,50851,3578755404,3578755404,0
0,1387,50852,3578755404,3578755405,1
0,1387,50853,3578755404,3578755406,2
0,1387,50854,3578755404,3578755406,2
0,1387,50855,3578755404,3578755407,3
0,1387,50856,3578755404,3578755407,3
0,1387,50857,3578755404,3578755409,5
0,1387,50858,3578755404,3578755410,6
0,1387,50859,3578755404,3578755410,6
0,1387,50860,3578755404,3578755411,7
0,1387,50861,3578755404,3578755412,8
0,1387,50862,3578755404,3578755413,9
0,1387,50863,3578755404,3578755414,10
0,1387,50864,3578755404,3578755414,10
0,1387,50865,3578755404,3578755414,10
0,1387,50866,3578755404,3578755414,10
0,1387,50867,3578755404,3578755415,11
0,1387,50868,3578755404,3578755415,11
0,1387,50869,3578755404,3578755416,12
0,1387,50870,3578755404,3578755416,12
0,1387,50871,3578755404,3578755416,12
0,1387,50872,3578755404,3578755418,14
0,1387,50873,3578755404,3578755418,14
0,1387,50874,3578755404,3578755418,14
0,1387,50875,3578755404,3578755419,15
0,1387,50876,3578755404,3578755419,15
0,1387,50877,3578755404,3578755420,16
0,1387,50878,3578755404,3578755422,18
0,1387,50879,3578755404,3578755422,18
0,1387,50880,3578755404,3578755422,18
0,1387,50881,3578755404,3578755423,19
0,1387,50882,3578755404,3578755424,20
0,1387,50883,3578755404,3578755424,20
0,1387,50884,3578755404,3578755424,20
0,1387,50885,3578755404,3578755424,20
0,1387,50886,3578755404,3578755427,23
0,1387,50887,3578755404,3578755427,23
0,1387,50888,3578755404,3578755428,24
0,1387,50889,3578755404,3578755428,24
0,1387,50890,3578755404,3578755429,25
0,1387,50891,3578755404,3578755430,26
0,1387,50892,3578755404,3578755430,26
0,1387,50893,3578755404,3578755430,26
0,1387,50894,3578755404,3578755431,27
0,1387,50895,3578755404,3578755431,27
0,1387,50896,3578755404,3578755432,28
0,1387,50897,3578755404,3578755433,29
0,1387,50898,3578755404,3578755433,29
0,1387,50899,3578755404,3578755435,31
0,1387,50900,3578755404,3578755435,31
0,1387,50901,3578755404,3578755435,31
0,1387,50902,3578755404,3578755437,33
0,1387,50903,3578755404,3578755437,33
0,1387,50904,3578755404,3578755438,34
0,1387,50905,3578755404,3578755439,35
0,1387,50906,3578755404,3578755439,35
0,1387,50907,3578755404,3578755439,35
0,1387,50908,3578755404,3578755439,35
0,1387,50909,3578755404,3578755440,36
0,1387,50910,3578755404,3578755440,36
0,1387,50911,3578755404,3578755442,38
0,1387,50912,3578755404,3578755443,39
0,1387,50913,3578755404,3578755443,39
0,1387,50914,3578755404,3578755444,40
0,1387,50915,3578755404,3578755444,40
0,1387,50916,3578755404,3578755444,40
0,1387,50917,3578755404,3578755446,42
0,1387,50918,3578755404,3578755447,43
0,1387,50919,3578755404,3578755448,44
0,1387,50920,3578755404,3578755448,44
0,1387,50921,3578755404,3578755450,46
0,1387,50922,3578755404,3578755450,46
0,1387,50923,3578755404,3578755450,46
0,1387,50924,3578755404,3578755450,46
0,1387,50925,3578755404,3578755450,46
0,1387,50926,3578755404,3578755452,48
0,1387,50927,3578755404,3578755452,48
0,1387,50928,3578755404,3578755453,49
0,1388,50929,3578755468,3578755468,0
0,1388,50930,3578755468,3578755468,0
0,1388,50931,3578755468,3578755468,0
0,1388,50932,3578755468,3578755468,0
0,1388,50933,3578755468,3578755468,0
0,1388,50934,3578755468,3578755468,0
0,1388,50935,3578755468,3578755468,0
0,1388,50936,3578755468,3578755468,0
0,1388,50937,3578755468,3578755468,0
0,1388,50938,3578755468,3578755468,0
0,1388,50939,3578755468,3578755468,0
0,1388,50940,3578755468,3578755468,0
0,1388,50941,3578755468,3578755468,0
0,1388,50942,3578755468,3578755468,0
0,1388,50943,3578755468,3578755468,0
0,1388,50944,3578755468,3578755468,0
0,1388,50945,3578755468,3578755468,0
0,1388,50946,3578755468,3578755468,0
0,1388,50947,3578755468,3578755468,0
0,1388,50948,3578755468,3578755469,1
0,1388,50949,3578755468,3578755470,2
0,1388,50950,3578755468,3578755480,12
0,1388,50951,3578755468,3578755481,13
0,1388,50952,3578755468,3578755482,14
0,1388,50953,3578755468,3578755482,14
0,1388,50954,3578755468,3578755482,14
0,1388,50955,3578755468,3578755484,16
0,1388,50956,3578755468,3578755486,18
0,1388,50957,3578755468,3578755486,18
0,1388,50958,3578755468,3578755487,19
0,1388,50959,3578755468,3578755487,19
0,1388,50960,3578755468,3578755487,19
0,1388,50961,3578755468,3578755489,21
0,1388,50962,3578755468,3578755489,21
0,1388,50963,3578755468,3578755489,21
0,1388,50964,3578755468,3578755490,22
0,1388,50965,3578755468,3578755490,22
0,1388,50966,3578755468,3578755491,23
0,1388,50967,3578755468,3578755491,23
0,1388,50968,3578755468,3578755492,24
0,1388,50969,3578755468,3578755492,24
0,1388,50970,3578755468,3578755492,24
0,1388,50971,3578755468,3578755493,25
0,1388,50972,3578755468,3578755493,25
0,1388,50973,3578755468,3578755493,25
0,1388,50974,3578755468,3578755494,26
0,1388,50975,3578755468,3578755495,27
0,1388,50976,3578755468,3578755495,27
0,1388,50977,3578755468,3578755495,27
0,1388,50978,3578755468,3578755496,28
0,1388,50979,3578755468,3578755496,28
0,1388,50980,3578755468,3578755497,29
0,1388,50981,3578755468,3578755499,31
0,1388,50982,3578755468,3578755499,31
0,1388,50983,3578755468,3578755499,31
0,1388,50984,3578755468,3578755499,31
0,1388,50985,3578755468,3578755501,33
0,1388,50986,3578755468,3578755501,33
0,1388,50987,3578755468,3578755503,35
0,1388,50988,3578755468,3578755504,36
0,1388,50989,3578755468,3578755504,36
0,1388,50990,3578755468,3578755505,37
0,1388,50991,3578755468,3578755506,38
0,1388,50992,3578755468,3578755508,40
0,1388,50993,3578755468,3578755508,40
0,1388,50994,3578755468,3578755508,40
0,1388,50995,3578755468,3578755509,41
0,1388,50996,3578755468,3578755509,41
0,1388,50997,3578755468,3578755509,41
0,1388,50998,3578755468,3578755510,42
0,1388,50999,3578755468,3578755510,42
0,1388,51000,3578755468,3578755510,42
0,1388,51001,3578755468,3578755511,43
0,1388,51002,3578755468,3578755511,43
0,1388,51003,3578755468,3578755511,43
0,1388,51004,3578755468,3578755511,43
0,1388,51005,3578755468,3578755512,44
0,1388,51006,3578755468,3578755513,45
0,1388,51007,3578755468,3578755513,45
0,1388,51008,3578755468,3578755513,45
0,1388,51009,3578755468,3578755513,45
0,1388,51010,3578755468,3578755513,45
0,1388,51011,3578755468,3578755513,45
0,1388,51012,3578755468,3578755515,47
0,1388,51013,3578755468,3578755515,47
0,1388,51014,3578755468,3578755516,48
0,1388,51015,3578755468,3578755516,48
0,1388,51016,3578755468,3578755517,49
0,1388,51017,3578755468,3578755517,49
0,1388,51018,3578755468,3578755517,49
0,1388,51019,3578755468,3578755518,50
0,1389,51020,3578755532,3578755532,0
0,1389,51021,3578755532,3578755532,0
0,1389,51022,3578755532,3578755532,0
0,1389,51023,3578755532,3578755532,0
0,1389,51024,3578755532,3578755532,0
0,1389,51025,3578755532,3578755532,0
0,1389,51026,3578755532,3578755532,0
0,1389,51027,3578755532,3578755532,0
0,1389,51028,3578755532,3578755532,0
0,1389,51029,3578755532,3578755532,0
0,1389,51030,3578755532,3578755532,0
0,1389,51031,3578755532,3578755532,0
0,1389,51032,3578755532,3578755532,0
0,1389,51033,3578755532,3578755532,0
0,1389,51034,3578755532,3578755532,0
0,1389,51035,3578755532,3578755532,0
0,1389,51036,3578755532,3578755532,0
0,1389,51037,3578755532,3578755532,0
0,1389,51038,3578755532,3578755532,0
0,1389,51039,3578755532,3578755532,0
0,1389,51040,3578755532,3578755532,0
0,1389,51041,3578755532,3578755532,0
0,1389,51042,3578755532,3578755532,0
0,1389,51043,3578755532,3578755532,0
0,1389,51044,3578755532,3578755532,0
0,1389,51045,3578755532,3578755532,0
0,1389,51046,3578755532,3578755532,0
0,1389,51047,3578755532,3578755532,0
0,1389,51048,3578755532,3578755532,0
0,1389,51049,3578755532,3578755532,0
0,1389,51050,3578755532,3578755532,0
0,1389,51051,3578755532,3578755533,1
0,1389,51052,3578755532,3578755533,1
0,1389,51053,3578755532,3578755533,1
0,1389,51054,3578755532,3578755534,2
0,1389,51055,3578755532,3578755534,2
0,1389,51056,3578755532,3578755535,3
0,1389,51057,3578755532,3578755538,6
0,1389,51058,3578755532,3578755538,6
0,1389,51059,3578755532,3578755539,7
0,1389,51060,3578755532,3578755539,7
0,1389,51061,3578755532,3578755540,8
0,1389,51062,3578755532,3578755540,8
0,1389,51063,3578755532,3578755542,10
0,1389,51064,3578755532,3578755542,10
0,1389,51065,3578755532,3578755542,10
0,1389,51066,3578755532,3578755542,10
0,1389,51067,3578755532,3578755543,11
0,1389,51068,3578755532,3578755543,11
0,1389,51069,3578755532,3578755544,12
0,1389,51070,3578755532,3578755544,12
0,1389,51071,3578755532,3578755545,13
0,1389,51072,3578755532,3578755546,14
0,1389,51073,3578755532,3578755547,15
0,1389,51074,3578755532,3578755547,15
0,1389,51075,3578755532,3578755549,17
0,1389,51076,3578755532,3578755550,18
0,1389,51077,3578755532,3578755551,19
0,1389,51078,3578755532,3578755552,20
0,1389,51079,3578755532,3578755552,20
0,1389,51080,3578755532,3578755552,20
0,1389,51081,3578755532,3578755552,20
0,1389,51082,3578755532,3578755552,20
0,1389,51083,3578755532,3578755554,22
0,1389,51084,3578755532,3578755554,22
0,1389,51085,3578755532,3578755555,23
0,1389,51086,3578755532,3578755555,23
0,1389,51087,3578755532,3578755556,24
0,1389,51088,3578755532,3578755556,24
0,1389,51089,3578755532,3578755557,25
0,1389,51090,3578755532,3578755558,26
0,1389,51091,3578755532,3578755558,26
0,1389,51092,3578755532,3578755559,27
0,1389,51093,3578755532,3578755560,28
0,1389,51094,3578755532,3578755560,28
0,1389,51095,3578755532,3578755561,29
0,1389,51096,3578755532,3578755561,29
0,1389,51097,3578755532,3578755561,29
0,1389,51098,3578755532,3578755561,29
0,1389,51099,3578755532,3578755561,29
0,1389,51100,3578755532,3578755562,30
0,1389,51101,3578755532,3578755563,31
0,1389,51102,3578755532,3578755563,31
0,1389,51103,3578755532,3578755564,32
0,1389,51104,3578755532,3578755564,32
0,1389,51105,3578755532,3578755565,33
0,1389,51106,3578755532,3578755565,33
0,1389,51107,3578755532,3578755570,38
0,1389,51108,3578755532,3578755570,38
0,1389,51109,3578755532,3578755572,40
0,1389,51110,3578755532,3578755572,40
0,1389,51111,3578755532,3578755573,41
0,1389,51112,3578755532,3578755573,41
0,1389,51113,3578755532,3578755574,42
0,1389,51114,3578755532,3578755575,43
0,1389,51115,3578755532,3578755575,43
0,1389,51116,3578755532,3578755576,44
0,1389,51117,3578755532,3578755577,45
0,1389,51118,3578755532,3578755578,46
0,1389,51119,3578755532,3578755579,47
0,1389,51120,3578755532,3578755579,47
0,1389,51121,3578755532,3578755580,48
0,1389,51122,3578755532,3578755582,50
0,1390,51123,3578755596,3578755596,0
0,1390,51124,3578755596,3578755596,0
0,1390,51125,3578755596,3578755596,0
0,1390,51126,3578755596,3578755596,0
0,1390,51127,3578755596,3578755596,0
0,1390,51128,3578755596,3578755596,0
0,1390,51129,3578755596,3578755596,0
0,1390,51130,3578755596,3578755596,0
0,1390,51131,3578755596,3578755597,1
0,1390,51132,3578755596,3578755597,1
0,1390,51133,3578755596,3578755597,1
0,1390,51134,3578755596,3578755597,1
0,1390,51135,3578755596,3578755597,1
0,1390,51136,3578755596,3578755597,1
0,1390,51137,3578755596,3578755597,1
0,1390,51138,3578755596,3578755597,1
0,1390,51139,3578755596,3578755597,1
0,1390,51140,3578755596,3578755597,1
0,1390,51141,3578755596,3578755597,1
0,1390,51142,3578755596,3578755598,2
0,1390,51143,3578755596,3578755599,3
0,1390,51144,3578755596,3578755600,4
0,1390,51145,3578755596,3578755600,4
0,1390,51146,3578755596,3578755600,4
0,1390,51147,3578755596,3578755602,6
0,1390,51148,3578755596,3578755603,7
0,1390,51149,3578755596,3578755603,7
0,1390,51150,3578755596,3578755604,8
0,1390,51151,3578755596,3578755604,8
0,1390,51152,3578755596,3578755605,9
0,1390,51153,3578755596,3578755606,10
0,1390,51154,3578755596,3578755607,11
0,1390,51155,3578755596,3578755608,12
0,1390,51156,3578755596,3578755608,12
0,1390,51157,3578755596,3578755610,14
0,1390,51158,3578755596,3578755610,14
0,1390,51159,3578755596,3578755613,17
0,1390,51160,3578755596,3578755613,17
0,1390,51161,3578755596,3578755613,17
0,1390,51162,3578755596,3578755614,18
0,1390,51163,3578755596,3578755614,18
0,1390,51164,3578755596,3578755615,19
0,1390,51165,3578755596,3578755615,19
0,1390,51166,3578755596,3578755615,19
0,1390,51167,3578755596,3578755617,21
0,1390,51168,3578755596,3578755617,21
0,1390,51169,3578755596,3578755618,22
0,1390,51170,3578755596,3578755618,22
0,1390,51171,3578755596,3578755620,24
0,1390,51172,3578755596,3578755621,25
0,1390,51173,3578755596,3578755621,25
0,1390,51174,3578755596,3578755621,25
0,1390,51175,3578755596,3578755622,26
0,1390,51176,3578755596,3578755623,27
0,1390,51177,3578755596,3578755623,27
0,1390,51178,3578755596,3578755624,28
0,1390,51179,3578755596,3578755626,30
0,1390,51180,3578755596,3578755626,30
0,1390,51181,3578755596,3578755627,31
0,1390,51182,3578755596,3578755627,31
0,1390,51183,3578755596,3578755628,32
0,1390,51184,3578755596,3578755629,33
0,1390,51185,3578755596,3578755629,33
0,1390,51186,3578755596,3578755630,34
0,1390,51187,3578755596,3578755631,35
0,1390,51188,3578755596,3578755631,35
0,1390,51189,3578755596,3578755632,36
0,1390,51190,3578755596,3578755633,37
0,1390,51191,3578755596,3578755633,37
0,1390,51192,3578755596,3578755633,37
0,1390,51193,3578755596,3578755635,39
0,1390,51194,3578755596,3578755636,40
0,1390,51195,3578755596,3578755636,40
0,1390,51196,3578755596,3578755638,42
0,1390,51197,3578755596,3578755638,42
0,1390,51198,3578755596,3578755638,42
0,1390,51199,3578755596,3578755638,42
0,1390,51200,3578755596,3578755638,42
0,1390,51201,3578755596,3578755639,43
0,1390,51202,3578755596,3578755639,43
0,1390,51203,3578755596,3578755639,43
0,1390,51204,3578755596,3578755640,44
0,1390,51205,3578755596,3578755642,46
0,1390,51206,3578755596,3578755642,46
0,1390,51207,3578755596,3578755643,47
0,1390,51208,3578755596,3578755643,47
0,1390,51209,3578755596,3578755643,47
0,1390,51210,3578755596,3578755644,48
0,1390,51211,3578755596,3578755645,49
0,1391,51212,3578755659,3578755659,0
0,1391,51213,3578755659,3578755659,0
0,1391,51214,3578755659,3578755659,0
0,1391,51215,3578755659,3578755659,0
0,1391,51216,3578755659,3578755659,0
0,1391,51217,3578755659,3578755659,0
0,1391,51218,3578755659,3578755659,0
0,1391,51219,3578755659,3578755659,0
0,1391,51220,3578755659,3578755659,0
0,1391,51221,3578755659,3578755659,0
0,1391,51222,3578755659,3578755659,0
0,1391,51223,3578755659,3578755659,0
0,1391,51224,3578755659,3578755659,0
0,1391,51225,3578755659,3578755659,0
0,1391,51226,3578755659,3578755659,0
0,1391,51227,3578755659,3578755659,0
0,1391,51228,3578755659,3578755659,0
0,1391,51229,3578755659,3578755661,2
0,1391,51230,3578755659,3578755661,2
0,1391,51231,3578755659,3578755661,2
0,1391,51232,3578755659,3578755663,4
0,1391,51233,3578755659,3578755663,4
0,1391,51234,3578755659,3578755664,5
0,1391,51235,3578755659,3578755665,6
0,1391,51236,3578755659,3578755665,6
0,1391,51237,3578755659,3578755666,7
0,1391,51238,3578755659,3578755666,7
0,1391,51239,3578755659,3578755666,7
0,1391,51240,3578755659,3578755667,8
0,1391,51241,3578755659,3578755668,9
0,1391,51242,3578755659,3578755669,10
0,1391,51243,3578755659,3578755680,21
0,1391,51244,3578755659,3578755681,22
0,1391,51245,3578755659,3578755681,22
0,1391,51246,3578755659,3578755682,23
0,1391,51247,3578755659,3578755682,23
0,1391,51248,3578755659,3578755684,25
0,1391,51249,3578755659,3578755687,28
0,1391,51250,3578755659,3578755687,28
0,1391,51251,3578755659,3578755687,28
0,1391,51252,3578755659,3578755687,28
0,1391,51253,3578755659,3578755689,30
0,1391,51254,3578755659,3578755689,30
0,1391,51255,3578755659,3578755689,30
0,1391,51256,3578755659,3578755690,31
0,1391,51257,3578755659,3578755691,32
0,1391,51258,3578755659,3578755692,33
0,1391,51259,3578755659,3578755692,33
0,1391,51260,3578755659,3578755693,34
0,1391,51261,3578755659,3578755693,34
0,1391,51262,3578755659,3578755693,34
0,1391,51263,3578755659,3578755693,34
0,1391,51264,3578755659,3578755695,36
0,1391,51265,3578755659,3578755695,36
0,1391,51266,3578755659,3578755695,36
0,1391,51267,3578755659,3578755695,36
0,1391,51268,3578755659,3578755696,37
0,1391,51269,3578755659,3578755697,38
0,1391,51270,3578755659,3578755697,38
0,1391,51271,3578755659,3578755697,38
0,1391,51272,3578755659,3578755698,39
0,1391,51273,3578755659,3578755699,40
0,1391,51274,3578755659,3578755699,40
0,1391,51275,3578755659,3578755700,41
0,1391,51276,3578755659,3578755701,42
0,1391,51277,3578755659,3578755701,42
0,1391,51278,3578755659,3578755703,44
0,1391,51279,3578755659,3578755704,45
0,1391,51280,3578755659,3578755705,46
0,1391,51281,3578755659,3578755705,46
0,1391,51282,3578755659,3578755706,47
0,1391,51283,3578755659,3578755707,48
0,1391,51284,3578755659,3578755708,49
0,1391,51285,3578755659,3578755708,49
0,1391,51286,3578755659,3578755709,50
0,1392,51287,3578755723,3578755723,0
0,1392,51288,3578755723,3578755723,0
0,1392,51289,3578755723,3578755723,0
0,1392,51290,3578755723,3578755724,1
0,1392,51291,3578755723,3578755724,1
0,1392,51292,3578755723,3578755724,1
0,1392,51293,3578755723,3578755724,1
0,1392,51294,3578755723,3578755724,1
0,1392,51295,3578755723,3578755724,1
0,1392,51296,3578755723,3578755724,1
0,1392,51297,3578755723,3578755724,1
0,1392,51298,3578755723,3578755724,1
0,1392,51299,3578755723,3578755724,1
0,1392,51300,3578755723,3578755724,1
0,1392,51301,3578755723,3578755724,1
0,1392,51302,3578755723,3578755724,1
0,1392,51303,3578755723,3578755724,1
0,1392,51304,3578755723,3578755724,1
0,1392,51305,3578755723,3578755724,1
0,1392,51306,3578755723,3578755724,1
0,1392,51307,3578755723,3578755724,1
0,1392,51308,3578755723,3578755724,1
0,1392,51309,3578755723,3578755724,1
0,1392,51310,3578755723,3578755724,1
0,1392,51311,3578755723,3578755724,1
0,1392,51312,3578755723,3578755724,1
0,1392,51313,3578755723,3578755724,1
0,1392,51314,3578755723,3578755724,1
0,1392,51315,3578755723,3578755724,1
0,1392,51316,3578755723,3578755724,1
0,1392,51317,3578755723,3578755724,1
0,1392,51318,3578755723,3578755724,1
0,1392,51319,3578755723,3578755724,1
0,1392,51320,3578755723,3578755724,1
0,1392,51321,3578755723,3578755724,1
0,1392,51322,3578755723,3578755724,1
0,1392,51323,3578755723,3578755724,1
0,1392,51324,3578755723,3578755724,1
0,1392,51325,3578755723,3578755724,1
0,1392,51326,3578755723,3578755724,1
0,1392,51327,3578755723,3578755725,2
0,1392,51328,3578755723,3578755725,2
0,1392,51329,3578755723,3578755725,2
0,1392,51330,3578755723,3578755725,2
0,1392,51331,3578755723,3578755726,3
0,1392,51332,3578755723,3578755727,4
0,1392,51333,3578755723,3578755727,4
0,1392,51334,3578755723,3578755728,5
0,1392,51335,3578755723,3578755728,5
0,1392,51336,3578755723,3578755728,5
0,1392,51337,3578755723,3578755728,5
0,1392,51338,3578755723,3578755729,6
0,1392,51339,3578755723,3578755729,6
0,1392,51340,3578755723,3578755729,6
0,1392,51341,3578755723,3578755730,7
0,1392,51342,3578755723,3578755730,7
0,1392,51343,3578755723,3578755731,8
0,1392,51344,3578755723,3578755731,8
0,1392,51345,3578755723,3578755731,8
0,1392,51346,3578755723,3578755731,8
0,1392,51347,3578755723,3578755733,10
0,1392,51348,3578755723,3578755733,10
0,1392,51349,3578755723,3578755733,10
0,1392,51350,3578755723,3578755734,11
0,1392,51351,3578755723,3578755734,11
0,1392,51352,3578755723,3578755734,11
0,1392,51353,3578755723,3578755735,12
0,1392,51354,3578755723,3578755738,15
0,1392,51355,3578755723,3578755739,16
0,1392,51356,3578755723,3578755739,16
0,1392,51357,3578755723,3578755740,17
0,1392,51358,3578755723,3578755740,17
0,1392,51359,3578755723,3578755740,17
0,1392,51360,3578755723,3578755740,17
0,1392,51361,3578755723,3578755741,18
0,1392,51362,3578755723,3578755741,18
0,1392,51363,3578755723,3578755742,19
0,1392,51364,3578755723,3578755742,19
0,1392,51365,3578755723,3578755742,19
0,1392,51366,3578755723,3578755743,20
0,1392,51367,3578755723,3578755744,21
0,1392,51368,3578755723,3578755744,21
0,1392,51369,3578755723,3578755744,21
0,1392,51370,3578755723,3578755746,23
0,1392,51371,3578755723,3578755746,23
0,1392,51372,3578755723,3578755746,23
0,1392,51373,3578755723,3578755747,24
0,1392,51374,3578755723,3578755747,24
0,1392,51375,3578755723,3578755749,26
0,1392,51376,3578755723,3578755749,26
0,1392,51377,3578755723,3578755752,29
0,1392,51378,3578755723,3578755752,29
0,1392,51379,3578755723,3578755753,30
0,1392,51380,3578755723,3578755753,30
0,1392,51381,3578755723,3578755753,30
0,1392,51382,3578755723,3578755753,30
0,1392,51383,3578755723,3578755754,31
0,1392,51384,3578755723,3578755755,32
0,1392,51385,3578755723,3578755755,32
0,1392,51386,3578755723,3578755755,32
0,1392,51387,3578755723,3578755755,32
0,1392,51388,3578755723,3578755757,34
0,1392,51389,3578755723,3578755757,34
0,1392,51390,3578755723,3578755758,35
0,1392,51391,3578755723,3578755758,35
0,1392,51392,3578755723,3578755760,37
0,1392,51393,3578755723,3578755760,37
0,1392,51394,3578755723,3578755760,37
0,1392,51395,3578755723,3578755760,37
0,1392,51396,3578755723,3578755761,38
0,1392,51397,3578755723,3578755761,38
0,1392,51398,3578755723,3578755761,38
0,1392,51399,3578755723,3578755762,39
0,1392,51400,3578755723,3578755763,40
0,1392,51401,3578755723,3578755763,40
0,1392,51402,3578755723,3578755764,41
0,1392,51403,3578755723,3578755764,41
0,1392,51404,3578755723,3578755764,41
0,1392,51405,3578755723,3578755764,41
0,1392,51406,3578755723,3578755765,42
0,1392,51407,3578755723,3578755767,44
0,1392,51408,3578755723,3578755768,45
0,1392,51409,3578755723,3578755768,45
0,1392,51410,3578755723,3578755769,46
0,1392,51411,3578755723,3578755770,47
0,1392,51412,3578755723,3578755772,49
0,1392,51413,3578755723,3578755773,50
0,1393,51414,3578755785,3578755785,0
0,1393,51415,3578755785,3578755785,0
0,1393,51416,3578755785,3578755785,0
0,1393,51417,3578755785,3578755785,0
0,1393,51418,3578755785,3578755785,0
0,1393,51419,3578755785,3578755785,0
0,1393,51420,3578755785,3578755785,0
0,1393,51421,3578755785,3578755785,0
0,1393,51422,3578755785,3578755785,0
0,1393,51423,3578755785,3578755785,0
0,1393,51424,3578755785,3578755785,0
0,1393,51425,3578755785,3578755785,0
0,1393,51426,3578755785,3578755785,0
0,1393,51427,3578755785,3578755785,0
0,1393,51428,3578755785,3578755785,0
0,1393,51429,3578755785,3578755785,0
0,1393,51430,3578755785,3578755786,1
0,1393,51431,3578755785,3578755787,2
0,1393,51432,3578755785,3578755788,3
0,1393,51433,3578755785,3578755788,3
0,1393,51434,3578755785,3578755789,4
0,1393,51435,3578755785,3578755789,4
0,1393,51436,3578755785,3578755791,6
0,1393,51437,3578755785,3578755791,6
0,1393,51438,3578755785,3578755792,7
0,1393,51439,3578755785,3578755793,8
0,1393,51440,3578755785,3578755793,8
0,1393,51441,3578755785,3578755794,9
0,1393,51442,3578755785,3578755794,9
0,1393,51443,3578755785,3578755795,10
0,1393,51444,3578755785,3578755795,10
0,1393,51445,3578755785,3578755796,11
0,1393,51446,3578755785,3578755798,13
0,1393,51447,3578755785,3578755799,14
0,1393,51448,3578755785,3578755800,15
0,1393,51449,3578755785,3578755800,15
0,1393,51450,3578755785,3578755800,15
0,1393,51451,3578755785,3578755803,18
0,1393,51452,3578755785,3578755803,18
0,1393,51453,3578755785,3578755803,18
0,1393,51454,3578755785,3578755805,20
0,1393,51455,3578755785,3578755805,20
0,1393,51456,3578755785,3578755805,20
0,1393,51457,3578755785,3578755808,23
0,1393,51458,3578755785,3578755808,23
0,1393,51459,3578755785,3578755808,23
0,1393,51460,3578755785,3578755809,24
0,1393,51461,3578755785,3578755810,25
0,1393,51462,3578755785,3578755812,27
0,1393,51463,3578755785,3578755812,27
0,1393,51464,3578755785,3578755813,28
0,1393,51465,3578755785,3578755814,29
0,1393,51466,3578755785,3578755814,29
0,1393,51467,3578755785,3578755815,30
0,1393,51468,3578755785,3578755815,30
0,1393,51469,3578755785,3578755815,30
0,1393,51470,3578755785,3578755816,31
0,1393,51471,3578755785,3578755817,32
0,1393,51472,3578755785,3578755817,32
0,1393,51473,3578755785,3578755818,33
0,1393,51474,3578755785,3578755819,34
0,1393,51475,3578755785,3578755819,34
0,1393,51476,3578755785,3578755820,35
0,1393,51477,3578755785,3578755821,36
0,1393,51478,3578755785,3578755821,36
0,1393,51479,3578755785,3578755821,36
0,1393,51480,3578755785,3578755822,37
0,1393,51481,3578755785,3578755823,38
0,1393,51482,3578755785,3578755824,39
0,1393,51483,3578755785,3578755825,40
0,1393,51484,3578755785,3578755826,41
0,1393,51485,3578755785,3578755827,42
0,1393,51486,3578755785,3578755827,42
0,1393,51487,3578755785,3578755829,44
0,1393,51488,3578755785,3578755829,44
0,1393,51489,3578755785,3578755831,46
0,1393,51490,3578755785,3578755831,46
0,1393,51491,3578755785,3578755831,46
0,1393,51492,3578755785,3578755832,47
0,1393,51493,3578755785,3578755833,48
0,1393,51494,3578755785,3578755834,49
0,1393,51495,3578755785,3578755835,50
0,1394,51496,3578755847,3578755847,0
0,1394,51497,3578755847,3578755847,0
0,1394,51498,3578755847,3578755847,0
0,1394,51499,3578755847,3578755847,0
0,1394,51500,3578755847,3578755847,0
0,1394,51501,3578755847,3578755847,0
0,1394,51502,3578755847,3578755847,0
0,1394,51503,3578755847,3578755847,0
0,1394,51504,3578755847,3578755847,0
0,1394,51505,3578755847,3578755847,0
0,1394,51506,3578755847,3578755847,0
0,1394,51507,3578755847,3578755847,0
0,1394,51508,3578755847,3578755847,0
0,1394,51509,3578755847,3578755847,0
0,1394,51510,3578755847,3578755847,0
0,1394,51511,3578755847,3578755847,0
0,1394,51512,3578755847,3578755847,0
0,1394,51513,3578755847,3578755847,0
0,1394,51514,3578755847,3578755847,0
0,1394,51515,3578755847,3578755848,1
0,1394,51516,3578755847,3578755849,2
0,1394,51517,3578755847,3578755849,2
0,1394,51518,3578755847,3578755850,3
0,1394,51519,3578755847,3578755850,3
0,1394,51520,3578755847,3578755851,4
0,1394,51521,3578755847,3578755852,5
0,1394,51522,3578755847,3578755854,7
0,1394,51523,3578755847,3578755854,7
0,1394,51524,3578755847,3578755856,9
0,1394,51525,3578755847,3578755856,9
0,1394,51526,3578755847,3578755856,9
0,1394,51527,3578755847,3578755858,11
0,1394,51528,3578755847,3578755858,11
0,1394,51529,3578755847,3578755858,11
0,1394,51530,3578755847,3578755859,12
0,1394,51531,3578755847,3578755861,14
0,1394,51532,3578755847,3578755861,14
0,1394,51533,3578755847,3578755862,15
0,1394,51534,3578755847,3578755863,16
0,1394,51535,3578755847,3578755863,16
0,1394,51536,3578755847,3578755864,17
0,1394,51537,3578755847,3578755864,17
0,1394,51538,3578755847,3578755865,18
0,1394,51539,3578755847,3578755865,18
0,1394,51540,3578755847,3578755866,19
0,1394,51541,3578755847,3578755866,19
0,1394,51542,3578755847,3578755866,19
0,1394,51543,3578755847,3578755868,21
0,1394,51544,3578755847,3578755868,21
0,1394,51545,3578755847,3578755880,33
0,1394,51546,3578755847,3578755882,35
0,1394,51547,3578755847,3578755882,35
0,1394,51548,3578755847,3578755883,36
0,1394,51549,3578755847,3578755884,37
0,1394,51550,3578755847,3578755886,39
0,1394,51551,3578755847,3578755887,40
0,1394,51552,3578755847,3578755887,40
0,1394,51553,3578755847,3578755887,40
0,1394,51554,3578755847,3578755889,42
0,1394,51555,3578755847,3578755889,42
0,1394,51556,3578755847,3578755889,42
0,1394,51557,3578755847,3578755890,43
0,1394,51558,3578755847,3578755891,44
0,1394,51559,3578755847,3578755891,44
0,1394,51560,3578755847,3578755892,45
0,1394,51561,3578755847,3578755892,45
0,1394,51562,3578755847,3578755893,46
0,1394,51563,3578755847,3578755893,46
0,1394,51564,3578755847,3578755893,46
0,1394,51565,3578755847,3578755894,47
0,1394,51566,3578755847,3578755894,47
0,1394,51567,3578755847,3578755895,48
0,1394,51568,3578755847,3578755895,48
0,1394,51569,3578755847,3578755896,49
0,1394,51570,3578755847,3578755896,49
0,1394,51571,3578755847,3578755897,50
0,1395,51572,3578755908,3578755908,0
0,1395,51573,3578755908,3578755908,0
0,1395,51574,3578755908,3578755908,0
0,1395,51575,3578755908,3578755908,0
0,1395,51576,3578755908,3578755908,0
0,1395,51577,3578755908,3578755908,0
0,1395,51578,3578755908,3578755908,0
0,1395,51579,3578755908,3578755908,0
0,1395,51580,3578755908,3578755908,0
0,1395,51581,3578755908,3578755908,0
0,1395,51582,3578755908,3578755908,0
0,1395,51583,3578755908,3578755908,0
0,1395,51584,3578755908,3578755908,0
0,1395,51585,3578755908,3578755908,0
0,1395,51586,3578755908,3578755908,0
0,1395,51587,3578755908,3578755909,1
0,1395,51588,3578755908,3578755909,1
0,1395,51589,3578755908,3578755909,1
0,1395,51590,3578755908,3578755910,2
0,1395,51591,3578755908,3578755910,2
0,1395,51592,3578755908,3578755910,2
0,1395,51593,3578755908,3578755910,2
0,1395,51594,3578755908,3578755911,3
0,1395,51595,3578755908,3578755911,3
0,1395,51596,3578755908,3578755911,3
0,1395,51597,3578755908,3578755912,4
0,1395,51598,3578755908,3578755912,4
0,1395,51599,3578755908,3578755913,5
0,1395,51600,3578755908,3578755913,5
0,1395,51601,3578755908,3578755913,5
0,1395,51602,3578755908,3578755914,6
0,1395,51603,3578755908,3578755915,7
0,1395,51604,3578755908,3578755915,7
0,1395,51605,3578755908,3578755915,7
0,1395,51606,3578755908,3578755915,7
0,1395,51607,3578755908,3578755916,8
0,1395,51608,3578755908,3578755916,8
0,1395,51609,3578755908,3578755916,8
0,1395,51610,3578755908,3578755917,9
0,1395,51611,3578755908,3578755917,9
0,1395,51612,3578755908,3578755918,10
0,1395,51613,3578755908,3578755919,11
0,1395,51614,3578755908,3578755919,11
0,1395,51615,3578755908,3578755919,11
0,1395,51616,3578755908,3578755919,11
0,1395,51617,3578755908,3578755919,11
0,1395,51618,3578755908,3578755919,11
0,1395,51619,3578755908,3578755919,11
0,1395,51620,3578755908,3578755920,12
0,1395,51621,3578755908,3578755922,14
0,1395,51622,3578755908,3578755922,14
0,1395,51623,3578755908,3578755923,15
0,1395,51624,3578755908,3578755923,15
0,1395,51625,3578755908,3578755923,15
0,1395,51626,3578755908,3578755923,15
0,1395,51627,3578755908,3578755924,16
0,1395,51628,3578755908,3578755925,17
0,1395,51629,3578755908,3578755925,17
0,1395,51630,3578755908,3578755926,18
0,1395,51631,3578755908,3578755926,18
0,1395,51632,3578755908,3578755926,18
0,1395,51633,3578755908,3578755927,19
0,1395,51634,3578755908,3578755928,20
0,1395,51635,3578755908,3578755929,21
0,1395,51636,3578755908,3578755929,21
0,1395,51637,3578755908,3578755929,21
0,1395,51638,3578755908,3578755929,21
0,1395,51639,3578755908,3578755929,21
0,1395,51640,3578755908,3578755930,22
0,1395,51641,3578755908,3578755930,22
0,1395,51642,3578755908,3578755930,22
0,1395,51643,3578755908,3578755931,23
0,1395,51644,3578755908,3578755931,23
0,1395,51645,3578755908,3578755933,25
0,1395,51646,3578755908,3578755933,25
0,1395,51647,3578755908,3578755934,26
0,1395,51648,3578755908,3578755934,26
0,1395,51649,3578755908,3578755934,26
0,1395,51650,3578755908,3578755936,28
0,1395,51651,3578755908,3578755936,28
0,1395,51652,3578755908,3578755939,31
0,1395,51653,3578755908,3578755939,31
0,1395,51654,3578755908,3578755939,31
0,1395,51655,3578755908,3578755939,31
0,1395,51656,3578755908,3578755939,31
0,1395,51657,3578755908,3578755940,32
0,1395,51658,3578755908,3578755940,32
0,1395,51659,3578755908,3578755941,33
0,1395,51660,3578755908,3578755941,33
0,1395,51661,3578755908,3578755942,34
0,1395,51662,3578755908,3578755942,34
0,1395,51663,3578755908,3578755942,34
0,1395,51664,3578755908,3578755943,35
0,1395,51665,3578755908,3578755943,35
0,1395,51666,3578755908,3578755943,35
0,1395,51667,3578755908,3578755943,35
0,1395,51668,3578755908,3578755944,36
0,1395,51669,3578755908,3578755944,36
0,1395,51670,3578755908,3578755945,37
0,1395,51671,3578755908,3578755945,37
0,1395,51672,3578755908,3578755945,37
0,1395,51673,3578755908,3578755946,38
0,1395,51674,3578755908,3578755947,39
0,1395,51675,3578755908,3578755947,39
0,1395,51676,3578755908,3578755948,40
0,1395,51677,3578755908,3578755949,41
0,1395,51678,3578755908,3578755952,44
0,1395,51679,3578755908,3578755952,44
0,1395,51680,3578755908,3578755953,45
0,1395,51681,3578755908,3578755953,45
0,1395,51682,3578755908,3578755953,45
0,1395,51683,3578755908,3578755953,45
0,1395,51684,3578755908,3578755953,45
0,1395,51685,3578755908,3578755954,46
0,1395,51686,3578755908,3578755955,47
0,1395,51687,3578755908,3578755955,47
0,1395,51688,3578755908,3578755956,48
0,1395,51689,3578755908,3578755956,48
0,1395,51690,3578755908,3578755956,48
0,1395,51691,3578755908,3578755958,50
0,1396,51692,3578755971,3578755971,0
0,1396,51693,3578755971,3578755971,0
0,1396,51694,3578755971,3578755971,0
0,1396,51695,3578755971,3578755971,0
0,1396,51696,3578755971,3578755971,0
0,1396,51697,3578755971,3578755971,0
0,1396,51698,3578755971,3578755971,0
0,1396,51699,3578755971,3578755971,0
0,1396,51700,3578755971,3578755971,0
0,1396,51701,3578755971,3578755971,0
0,1396,51702,3578755971,3578755971,0
0,1396,51703,3578755971,3578755971,0
0,1396,51704,3578755971,3578755971,0
0,1396,51705,3578755971,3578755971,0
0,1396,51706,3578755971,3578755971,0
0,1396,51707,3578755971,3578755971,0
0,1396,51708,3578755971,3578755971,0
0,1396,51709,3578755971,3578755971,0
0,1396,51710,3578755971,3578755971,0
0,1396,51711,3578755971,3578755971,0
0,1396,51712,3578755971,3578755973,2
0,1396,51713,3578755971,3578755974,3
0,1396,51714,3578755971,3578755974,3
0,1396,51715,3578755971,3578755975,4
0,1396,51716,3578755971,3578755975,4
0,1396,51717,3578755971,3578755975,4
0,1396,51718,3578755971,3578755976,5
0,1396,51719,3578755971,3578755976,5
0,1396,51720,3578755971,3578755978,7
0,1396,51721,3578755971,3578755978,7
0,1396,51722,3578755971,3578755979,8
0,1396,51723,3578755971,3578755980,9
0,1396,51724,3578755971,3578755981,10
0,1396,51725,3578755971,3578755982,11
0,1396,51726,3578755971,3578755983,12
0,1396,51727,3578755971,3578755984,13
0,1396,51728,3578755971,3578755985,14
0,1396,51729,3578755971,3578755985,14
0,1396,51730,3578755971,3578755987,16
0,1396,51731,3578755971,3578755987,16
0,1396,51732,3578755971,3578755989,18
0,1396,51733,3578755971,3578755989,18
0,1396,51734,3578755971,3578755990,19
0,1396,51735,3578755971,3578755990,19
0,1396,51736,3578755971,3578755991,20
0,1396,51737,3578755971,3578755991,20
0,1396,51738,3578755971,3578755992,21
0,1396,51739,3578755971,3578755993,22
0,1396,51740,3578755971,3578755993,22
0,1396,51741,3578755971,3578755994,23
0,1396,51742,3578755971,3578755995,24
0,1396,51743,3578755971,3578755995,24
0,1396,51744,3578755971,3578755996,25
0,1396,51745,3578755971,3578755998,27
0,1396,51746,3578755971,3578755998,27
0,1396,51747,3578755971,3578755999,28
0,1396,51748,3578755971,3578756000,29
0,1396,51749,3578755971,3578756000,29
0,1396,51750,3578755971,3578756001,30
0,1396,51751,3578755971,3578756003,32
0,1396,51752,3578755971,3578756003,32
0,1396,51753,3578755971,3578756003,32
0,1396,51754,3578755971,3578756004,33
0,1396,51755,3578755971,3578756004,33
0,1396,51756,3578755971,3578756006,35
0,1396,51757,3578755971,3578756006,35
0,1396,51758,3578755971,3578756006,35
0,1396,51759,3578755971,3578756008,37
0,1396,51760,3578755971,3578756008,37
0,1396,51761,3578755971,3578756009,38
0,1396,51762,3578755971,3578756010,39
0,1396,51763,3578755971,3578756011,40
0,1396,51764,3578755971,3578756012,41
0,1396,51765,3578755971,3578756012,41
0,1396,51766,3578755971,3578756014,43
0,1396,51767,3578755971,3578756014,43
0,1396,51768,3578755971,3578756015,44
0,1396,51769,3578755971,3578756015,44
0,1396,51770,3578755971,3578756015,44
0,1396,51771,3578755971,3578756016,45
0,1396,51772,3578755971,3578756018,47
0,1396,51773,3578755971,3578756018,47
0,1396,51774,3578755971,3578756018,47
0,1396,51775,3578755971,3578756019,48
0,1396,51776,3578755971,3578756020,49
0,1396,51777,3578755971,3578756020,49
0,1396,51778,3578755971,3578756020,49
0,1396,51779,3578755971,3578756021,50
0,1397,51780,3578756035,3578756035,0
0,1397,51781,3578756035,3578756035,0
0,1397,51782,3578756035,3578756035,0
0,1397,51783,3578756035,3578756035,0
0,1397,51784,3578756035,3578756035,0
0,1397,51785,3578756035,3578756035,0
0,1397,51786,3578756035,3578756035,0
0,1397,51787,3578756035,3578756035,0
0,1397,51788,3578756035,3578756035,0
0,1397,51789,3578756035,3578756035,0
0,1397,51790,3578756035,3578756035,0
0,1397,51791,3578756035,3578756035,0
0,1397,51792,3578756035,3578756035,0
0,1397,51793,3578756035,3578756035,0
0,1397,51794,3578756035,3578756035,0
0,1397,51795,3578756035,3578756035,0
0,1397,51796,3578756035,3578756035,0
0,1397,51797,3578756035,3578756035,0
0,1397,51798,3578756035,3578756035,0
0,1397,51799,3578756035,3578756036,1
0,1397,51800,3578756035,3578756036,1
0,1397,51801,3578756035,3578756037,2
0,1397,51802,3578756035,3578756038,3
0,1397,51803,3578756035,3578756038,3
0,1397,51804,3578756035,3578756039,4
0,1397,51805,3578756035,3578756039,4
0,1397,51806,3578756035,3578756041,6
0,1397,51807,3578756035,3578756041,6
0,1397,51808,3578756035,3578756042,7
0,1397,51809,3578756035,3578756043,8
0,1397,51810,3578756035,3578756043,8
0,1397,51811,3578756035,3578756043,8
0,1397,51812,3578756035,3578756044,9
0,1397,51813,3578756035,3578756046,11
0,1397,51814,3578756035,3578756048,13
0,1397,51815,3578756035,3578756048,13
0,1397,51816,3578756035,3578756048,13
0,1397,51817,3578756035,3578756049,14
0,1397,51818,3578756035,3578756049,14
0,1397,51819,3578756035,3578756050,15
0,1397,51820,3578756035,3578756051,16
0,1397,51821,3578756035,3578756052,17
0,1397,51822,3578756035,3578756052,17
0,1397,51823,3578756035,3578756054,19
0,1397,51824,3578756035,3578756054,19
0,1397,51825,3578756035,3578756056,21
0,1397,51826,3578756035,3578756056,21
0,1397,51827,3578756035,3578756057,22
0,1397,51828,3578756035,3578756058,23
0,1397,51829,3578756035,3578756058,23
0,1397,51830,3578756035,3578756058,23
0,1397,51831,3578756035,3578756059,24
0,1397,51832,3578756035,3578756061,26
0,1397,51833,3578756035,3578756061,26
0,1397,51834,3578756035,3578756064,29
0,1397,51835,3578756035,3578756064,29
0,1397,51836,3578756035,3578756064,29
0,1397,51837,3578756035,3578756065,30
0,1397,51838,3578756035,3578756066,31
0,1397,51839,3578756035,3578756066,31
0,1397,51840,3578756035,3578756067,32
0,1397,51841,3578756035,3578756068,33
0,1397,51842,3578756035,3578756069,34
0,1397,51843,3578756035,3578756081,46
0,1397,51844,3578756035,3578756082,47
0,1397,51845,3578756035,3578756083,48
0,1397,51846,3578756035,3578756085,50
0,1398,51847,3578756100,3578756100,0
0,1398,51848,3578756100,3578756100,0
0,1398,51849,3578756100,3578756100,0
0,1398,51850,3578756100,3578756100,0
0,1398,51851,3578756100,3578756100,0
0,1398,51852,3578756100,3578756100,0
0,1398,51853,3578756100,3578756100,0
0,1398,51854,3578756100,3578756100,0
0,1398,51855,3578756100,3578756100,0
0,1398,51856,3578756100,3578756100,0
0,1398,51857,3578756100,3578756100,0
0,1398,51858,3578756100,3578756100,0
0,1398,51859,3578756100,3578756100,0
0,1398,51860,3578756100,3578756100,0
0,1398,51861,3578756100,3578756100,0
0,1398,51862,3578756100,3578756100,0
0,1398,51863,3578756100,3578756100,0
0,1398,51864,3578756100,3578756100,0
0,1398,51865,3578756100,3578756100,0
0,1398,51866,3578756100,3578756100,0
0,1398,51867,3578756100,3578756100,0
0,1398,51868,3578756100,3578756100,0
0,1398,51869,3578756100,3578756100,0
0,1398,51870,3578756100,3578756100,0
0,1398,51871,3578756100,3578756100,0
0,1398,51872,3578756100,3578756101,1
0,1398,51873,3578756100,3578756101,1
0,1398,51874,3578756100,3578756101,1
0,1398,51875,3578756100,3578756104,4
0,1398,51876,3578756100,3578756105,5
0,1398,51877,3578756100,3578756105,5
0,1398,51878,3578756100,3578756105,5
0,1398,51879,3578756100,3578756106,6
0,1398,51880,3578756100,3578756108,8
0,1398,51881,3578756100,3578756108,8
0,1398,51882,3578756100,3578756108,8
0,1398,51883,3578756100,3578756109,9
0,1398,51884,3578756100,3578756109,9
0,1398,51885,3578756100,3578756109,9
0,1398,51886,3578756100,3578756109,9
0,1398,51887,3578756100,3578756110,10
0,1398,51888,3578756100,3578756110,10
0,1398,51889,3578756100,3578756111,11
0,1398,51890,3578756100,3578756112,12
0,1398,51891,3578756100,3578756113,13
0,1398,51892,3578756100,3578756113,13
0,1398,51893,3578756100,3578756113,13
0,1398,51894,3578756100,3578756114,14
0,1398,51895,3578756100,3578756114,14
0,1398,51896,3578756100,3578756115,15
0,1398,51897,3578756100,3578756115,15
0,1398,51898,3578756100,3578756115,15
0,1398,51899,3578756100,3578756115,15
0,1398,51900,3578756100,3578756116,16
0,1398,51901,3578756100,3578756116,16
0,1398,51902,3578756100,3578756116,16
0,1398,51903,3578756100,3578756118,18
0,1398,51904,3578756100,3578756118,18
0,1398,51905,3578756100,3578756118,18
0,1398,51906,3578756100,3578756119,19
0,1398,51907,3578756100,3578756119,19
0,1398,51908,3578756100,3578756119,19
0,1398,51909,3578756100,3578756119,19
0,1398,51910,3578756100,3578756119,19
0,1398,51911,3578756100,3578756119,19
0,1398,51912,3578756100,3578756119,19
0,1398,51913,3578756100,3578756119,19
0,1398,51914,3578756100,3578756120,20
0,1398,51915,3578756100,3578756122,22
0,1398,51916,3578756100,3578756122,22
0,1398,51917,3578756100,3578756123,23
0,1398,51918,3578756100,3578756123,23
0,1398,51919,3578756100,3578756123,23
0,1398,51920,3578756100,3578756123,23
0,1398,51921,3578756100,3578756124,24
0,1398,51922,3578756100,3578756124,24
0,1398,51923,3578756100,3578756124,24
0,1398,51924,3578756100,3578756125,25
0,1398,51925,3578756100,3578756125,25
0,1398,51926,3578756100,3578756126,26
0,1398,51927,3578756100,3578756127,27
0,1398,51928,3578756100,3578756127,27
0,1398,51929,3578756100,3578756127,27
0,1398,51930,3578756100,3578756128,28
0,1398,51931,3578756100,3578756128,28
0,1398,51932,3578756100,3578756129,29
0,1398,51933,3578756100,3578756129,29
0,1398,51934,3578756100,3578756129,29
0,1398,51935,3578756100,3578756129,29
0,1398,51936,3578756100,3578756131,31
0,1398,51937,3578756100,3578756131,31
0,1398,51938,3578756100,3578756131,31
0,1398,51939,3578756100,3578756131,31
0,1398,51940,3578756100,3578756131,31
0,1398,51941,3578756100,3578756132,32
0,1398,51942,3578756100,3578756133,33
0,1398,51943,3578756100,3578756133,33
0,1398,51944,3578756100,3578756134,34
0,1398,51945,3578756100,3578756134,34
0,1398,51946,3578756100,3578756134,34
0,1398,51947,3578756100,3578756136,36
0,1398,51948,3578756100,3578756136,36
0,1398,51949,3578756100,3578756138,38
0,1398,51950,3578756100,3578756139,39
0,1398,51951,3578756100,3578756140,40
0,1398,51952,3578756100,3578756141,41
0,1398,51953,3578756100,3578756141,41
0,1398,51954,3578756100,3578756141,41
0,1398,51955,3578756100,3578756141,41
0,1398,51956,3578756100,3578756142,42
0,1398,51957,3578756100,3578756142,42
0,1398,51958,3578756100,3578756143,43
0,1398,51959,3578756100,3578756143,43
0,1398,51960,3578756100,3578756143,43
0,1398,51961,3578756100,3578756143,43
0,1398,51962,3578756100,3578756144,44
0,1398,51963,3578756100,3578756144,44
0,1398,51964,3578756100,3578756144,44
0,1398,51965,3578756100,3578756145,45
0,1398,51966,3578756100,3578756146,46
0,1398,51967,3578756100,3578756147,47
0,1398,51968,3578756100,3578756147,47
0,1398,51969,3578756100,3578756147,47
0,1398,51970,3578756100,3578756148,48
0,1398,51971,3578756100,3578756150,50
0,1399,51972,3578756163,3578756163,0
0,1399,51973,3578756163,3578756163,0
0,1399,51974,3578756163,3578756163,0
0,1399,51975,3578756163,3578756163,0
0,1399,51976,3578756163,3578756163,0
0,1399,51977,3578756163,3578756163,0
0,1399,51978,3578756163,3578756163,0
0,1399,51979,3578756163,3578756163,0
0,1399,51980,3578756163,3578756163,0
0,1399,51981,3578756163,3578756163,0
0,1399,51982,3578756163,3578756163,0
0,1399,51983,3578756163,3578756163,0
0,1399,51984,3578756163,3578756163,0
0,1399,51985,3578756163,3578756163,0
0,1399,51986,3578756163,3578756163,0
0,1399,51987,3578756163,3578756163,0
0,1399,51988,3578756163,3578756163,0
0,1399,51989,3578756163,3578756164,1
0,1399,51990,3578756163,3578756164,1
0,1399,51991,3578756163,3578756164,1
0,1399,51992,3578756163,3578756164,1
0,1399,51993,3578756163,3578756164,1
0,1399,51994,3578756163,3578756164,1
0,1399,51995,3578756163,3578756164,1
0,1399,51996,3578756163,3578756164,1
0,1399,51997,3578756163,3578756164,1
0,1399,51998,3578756163,3578756164,1
0,1399,51999,3578756163,3578756164,1
0,1399,52000,3578756163,3578756165,2
0,1399,52001,3578756163,3578756165,2
0,1399,52002,3578756163,3578756166,3
0,1399,52003,3578756163,3578756166,3
0,1399,52004,3578756163,3578756167,4
0,1399,52005,3578756163,3578756168,5
0,1399,52006,3578756163,3578756170,7
0,1399,52007,3578756163,3578756171,8
0,1399,52008,3578756163,3578756172,9
0,1399,52009,3578756163,3578756174,11
0,1399,52010,3578756163,3578756174,11
0,1399,52011,3578756163,3578756175,12
0,1399,52012,3578756163,3578756175,12
0,1399,52013,3578756163,3578756175,12
0,1399,52014,3578756163,3578756177,14
0,1399,52015,3578756163,3578756177,14
0,1399,52016,3578756163,3578756179,16
0,1399,52017,3578756163,3578756179,16
0,1399,52018,3578756163,3578756180,17
0,1399,52019,3578756163,3578756180,17
0,1399,52020,3578756163,3578756181,18
0,1399,52021,3578756163,3578756182,19
0,1399,52022,3578756163,3578756182,19
0,1399,52023,3578756163,3578756183,20
0,1399,52024,3578756163,3578756184,21
0,1399,52025,3578756163,3578756184,21
0,1399,52026,3578756163,3578756185,22
0,1399,52027,3578756163,3578756186,23
0,1399,52028,3578756163,3578756187,24
0,1399,52029,3578756163,3578756187,24
0,1399,52030,3578756163,3578756188,25
0,1399,52031,3578756163,3578756190,27
0,1399,52032,3578756163,3578756190,27
0,1399,52033,3578756163,3578756190,27
0,1399,52034,3578756163,3578756191,28
0,1399,52035,3578756163,3578756192,29
0,1399,52036,3578756163,3578756192,29
0,1399,52037,3578756163,3578756192,29
0,1399,52038,3578756163,3578756193,30
0,1399,52039,3578756163,3578756193,30
0,1399,52040,3578756163,3578756194,31
0,1399,52041,3578756163,3578756194,31
0,1399,52042,3578756163,3578756195,32
0,1399,52043,3578756163,3578756199,36
0,1399,52044,3578756163,3578756199,36
0,1399,52045,3578756163,3578756199,36
0,1399,52046,3578756163,3578756200,37
0,1399,52047,3578756163,3578756200,37
0,1399,52048,3578756163,3578756201,38
0,1399,52049,3578756163,3578756202,39
0,1399,52050,3578756163,3578756204,41
0,1399,52051,3578756163,3578756204,41
0,1399,52052,3578756163,3578756205,42
0,1399,52053,3578756163,3578756205,42
0,1399,52054,3578756163,3578756206,43
0,1399,52055,3578756163,3578756206,43
0,1399,52056,3578756163,3578756208,45
0,1399,52057,3578756163,3578756208,45
0,1399,52058,3578756163,3578756209,46
0,1399,52059,3578756163,3578756210,47
0,1399,52060,3578756163,3578756211,48
0,1399,52061,3578756163,3578756212,49
0,1399,52062,3578756163,3578756213,50
0,1400,52063,3578756226,3578756226,0
0,1400,52064,3578756226,3578756226,0
0,1400,52065,3578756226,3578756226,0
0,1400,52066,3578756226,3578756226,0
0,1400,52067,3578756226,3578756226,0
0,1400,52068,3578756226,3578756226,0
0,1400,52069,3578756226,3578756226,0
0,1400,52070,3578756226,3578756226,0
0,1400,52071,3578756226,3578756226,0
0,1400,52072,3578756226,3578756226,0
0,1400,52073,3578756226,3578756226,0
0,1400,52074,3578756226,3578756226,0
0,1400,52075,3578756226,3578756226,0
0,1400,52076,3578756226,3578756226,0
0,1400,52077,3578756226,3578756226,0
0,1400,52078,3578756226,3578756226,0
0,1400,52079,3578756226,3578756226,0
0,1400,52080,3578756226,3578756226,0
0,1400,52081,3578756226,3578756226,0
0,1400,52082,3578756226,3578756226,0
0,1400,52083,3578756226,3578756226,0
0,1400,52084,3578756226,3578756226,0
0,1400,52085,3578756226,3578756226,0
0,1400,52086,3578756226,3578756227,1
0,1400,52087,3578756226,3578756228,2
0,1400,52088,3578756226,3578756229,3
0,1400,52089,3578756226,3578756230,4
0,1400,52090,3578756226,3578756231,5
0,1400,52091,3578756226,3578756231,5
0,1400,52092,3578756226,3578756231,5
0,1400,52093,3578756226,3578756231,5
0,1400,52094,3578756226,3578756232,6
0,1400,52095,3578756226,3578756233,7
0,1400,52096,3578756226,3578756234,8
0,1400,52097,3578756226,3578756235,9
0,1400,52098,3578756226,3578756236,10
0,1400,52099,3578756226,3578756236,10
0,1400,52100,3578756226,3578756237,11
0,1400,52101,3578756226,3578756238,12
0,1400,52102,3578756226,3578756238,12
0,1400,52103,3578756226,3578756238,12
0,1400,52104,3578756226,3578756239,13
0,1400,52105,3578756226,3578756239,13
0,1400,52106,3578756226,3578756240,14
0,1400,52107,3578756226,3578756240,14
0,1400,52108,3578756226,3578756242,16
0,1400,52109,3578756226,3578756243,17
0,1400,52110,3578756226,3578756243,17
0,1400,52111,3578756226,3578756243,17
0,1400,52112,3578756226,3578756244,18
0,1400,52113,3578756226,3578756244,18
0,1400,52114,3578756226,3578756244,18
0,1400,52115,3578756226,3578756247,21
0,1400,52116,3578756226,3578756248,22
0,1400,52117,3578756226,3578756248,22
0,1400,52118,3578756226,3578756249,23
0,1400,52119,3578756226,3578756249,23
0,1400,52120,3578756226,3578756250,24
0,1400,52121,3578756226,3578756250,24
0,1400,52122,3578756226,3578756251,25
0,1400,52123,3578756226,3578756252,26
0,1400,52124,3578756226,3578756253,27
0,1400,52125,3578756226,3578756254,28
0,1400,52126,3578756226,3578756255,29
0,1400,52127,3578756226,3578756256,30
0,1400,52128,3578756226,3578756256,30
0,1400,52129,3578756226,3578756256,30
0,1400,52130,3578756226,3578756257,31
0,1400,52131,3578756226,3578756259,33
0,1400,52132,3578756226,3578756259,33
0,1400,52133,3578756226,3578756259,33
0,1400,52134,3578756226,3578756259,33
0,1400,52135,3578756226,3578756261,35
0,1400,52136,3578756226,3578756262,36
0,1400,52137,3578756226,3578756262,36
0,1400,52138,3578756226,3578756263,37
0,1400,52139,3578756226,3578756264,38
0,1400,52140,3578756226,3578756264,38
0,1400,52141,3578756226,3578756265,39
0,1400,52142,3578756226,3578756266,40
0,1400,52143,3578756226,3578756267,41
0,1400,52144,3578756226,3578756268,42
0,1400,52145,3578756226,3578756268,42
0,1401,52146,3578756289,3578756289,0
0,1401,52147,3578756289,3578756289,0
0,1401,52148,3578756289,3578756289,0
0,1401,52149,3578756289,3578756289,0
0,1401,52150,3578756289,3578756289,0
0,1401,52151,3578756289,3578756289,0
0,1401,52152,3578756289,3578756289,0
0,1401,52153,3578756289,3578756289,0
0,1401,52154,3578756289,3578756289,0
0,1401,52155,3578756289,3578756289,0
0,1401,52156,3578756289,3578756289,0
0,1401,52157,3578756289,3578756289,0
0,1401,52158,3578756289,3578756290,1
0,1401,52159,3578756289,3578756291,2
0,1401,52160,3578756289,3578756291,2
0,1401,52161,3578756289,3578756291,2
0,1401,52162,3578756289,3578756291,2
0,1401,52163,3578756289,3578756292,3
0,1401,52164,3578756289,3578756292,3
0,1401,52165,3578756289,3578756293,4
0,1401,52166,3578756289,3578756293,4
0,1401,52167,3578756289,3578756294,5
0,1401,52168,3578756289,3578756294,5
0,1401,52169,3578756289,3578756295,6
0,1401,52170,3578756289,3578756296,7
0,1401,52171,3578756289,3578756296,7
0,1401,52172,3578756289,3578756296,7
0,1401,52173,3578756289,3578756296,7
0,1401,52174,3578756289,3578756297,8
0,1401,52175,3578756289,3578756298,9
0,1401,52176,3578756289,3578756298,9
0,1401,52177,3578756289,3578756300,11
0,1401,52178,3578756289,3578756300,11
0,1401,52179,3578756289,3578756300,11
0,1401,52180,3578756289,3578756301,12
0,1401,52181,3578756289,3578756301,12
0,1401,52182,3578756289,3578756304,15
0,1401,52183,3578756289,3578756304,15
0,1401,52184,3578756289,3578756305,16
0,1401,52185,3578756289,3578756306,17
0,1401,52186,3578756289,3578756306,17
0,1401,52187,3578756289,3578756307,18
0,1401,52188,3578756289,3578756308,19
0,1401,52189,3578756289,3578756308,19
0,1401,52190,3578756289,3578756308,19
0,1401,52191,3578756289,3578756309,20
0,1401,52192,3578756289,3578756309,20
0,1401,52193,3578756289,3578756309,20
0,1401,52194,3578756289,3578756310,21
0,1401,52195,3578756289,3578756310,21
0,1401,52196,3578756289,3578756310,21
0,1401,52197,3578756289,3578756311,22
0,1401,52198,3578756289,3578756311,22
0,1401,52199,3578756289,3578756311,22
0,1401,52200,3578756289,3578756312,23
0,1401,52201,3578756289,3578756312,23
0,1401,52202,3578756289,3578756313,24
0,1401,52203,3578756289,3578756313,24
0,1401,52204,3578756289,3578756314,25
0,1401,52205,3578756289,3578756314,25
0,1401,52206,3578756289,3578756315,26
0,1401,52207,3578756289,3578756315,26
0,1401,52208,3578756289,3578756315,26
0,1401,52209,3578756289,3578756315,26
0,1401,52210,3578756289,3578756316,27
0,1401,52211,3578756289,3578756316,27
0,1401,52212,3578756289,3578756316,27
0,1401,52213,3578756289,3578756316,27
0,1401,52214,3578756289,3578756317,28
0,1401,52215,3578756289,3578756318,29
0,1401,52216,3578756289,3578756318,29
0,1401,52217,3578756289,3578756318,29
0,1401,52218,3578756289,3578756319,30
0,1401,52219,3578756289,3578756319,30
0,1401,52220,3578756289,3578756319,30
0,1401,52221,3578756289,3578756319,30
0,1401,52222,3578756289,3578756319,30
0,1401,52223,3578756289,3578756319,30
0,1401,52224,3578756289,3578756319,30
0,1401,52225,3578756289,3578756319,30
0,1401,52226,3578756289,3578756320,31
0,1401,52227,3578756289,3578756322,33
0,1401,52228,3578756289,3578756322,33
0,1401,52229,3578756289,3578756323,34
0,1401,52230,3578756289,3578756323,34
0,1401,52231,3578756289,3578756323,34
0,1401,52232,3578756289,3578756323,34
0,1401,52233,3578756289,3578756324,35
0,1401,52234,3578756289,3578756324,35
0,1401,52235,3578756289,3578756325,36
0,1401,52236,3578756289,3578756326,37
0,1401,52237,3578756289,3578756327,38
0,1401,52238,3578756289,3578756327,38
0,1401,52239,3578756289,3578756329,40
0,1401,52240,3578756289,3578756329,40
0,1401,52241,3578756289,3578756329,40
0,1401,52242,3578756289,3578756329,40
0,1401,52243,3578756289,3578756330,41
0,1401,52244,3578756289,3578756330,41
0,1401,52245,3578756289,3578756330,41
0,1401,52246,3578756289,3578756331,42
0,1401,52247,3578756289,3578756331,42
0,1401,52248,3578756289,3578756331,42
0,1401,52249,3578756289,3578756331,42
0,1401,52250,3578756289,3578756332,43
0,1401,52251,3578756289,3578756333,44
0,1401,52252,3578756289,3578756333,44
0,1401,52253,3578756289,3578756333,44
0,1401,52254,3578756289,3578756333,44
0,1401,52255,3578756289,3578756334,45
0,1401,52256,3578756289,3578756335,46
0,1401,52257,3578756289,3578756336,47
0,1402,52258,3578756350,3578756350,0
0,1402,52259,3578756350,3578756350,0
0,1402,52260,3578756350,3578756350,0
0,1402,52261,3578756350,3578756350,0
0,1402,52262,3578756350,3578756350,0
0,1402,52263,3578756350,3578756350,0
0,1402,52264,3578756350,3578756350,0
0,1402,52265,3578756350,3578756350,0
0,1402,52266,3578756350,3578756350,0
0,1402,52267,3578756350,3578756350,0
0,1402,52268,3578756350,3578756350,0
0,1402,52269,3578756350,3578756350,0
0,1402,52270,3578756350,3578756350,0
0,1402,52271,3578756350,3578756350,0
0,1402,52272,3578756350,3578756350,0
0,1402,52273,3578756350,3578756350,0
0,1402,52274,3578756350,3578756350,0
0,1402,52275,3578756350,3578756351,1
0,1402,52276,3578756350,3578756351,1
0,1402,52277,3578756350,3578756351,1
0,1402,52278,3578756350,3578756351,1
0,1402,52279,3578756350,3578756351,1
0,1402,52280,3578756350,3578756351,1
0,1402,52281,3578756350,3578756351,1
0,1402,52282,3578756350,3578756351,1
0,1402,52283,3578756350,3578756351,1
0,1402,52284,3578756350,3578756352,2
0,1402,52285,3578756350,3578756353,3
0,1402,52286,3578756350,3578756353,3
0,1402,52287,3578756350,3578756353,3
0,1402,52288,3578756350,3578756353,3
0,1402,52289,3578756350,3578756354,4
0,1402,52290,3578756350,3578756355,5
0,1402,52291,3578756350,3578756355,5
0,1402,52292,3578756350,3578756356,6
0,1402,52293,3578756350,3578756356,6
0,1402,52294,3578756350,3578756358,8
0,1402,52295,3578756350,3578756358,8
0,1402,52296,3578756350,3578756359,9
0,1402,52297,3578756350,3578756359,9
0,1402,52298,3578756350,3578756360,10
0,1402,52299,3578756350,3578756360,10
0,1402,52300,3578756350,3578756361,11
0,1402,52301,3578756350,3578756361,11
0,1402,52302,3578756350,3578756361,11
0,1402,52303,3578756350,3578756362,12
0,1402,52304,3578756350,3578756362,12
0,1402,52305,3578756350,3578756362,12
0,1402,52306,3578756350,3578756363,13
0,1402,52307,3578756350,3578756363,13
0,1402,52308,3578756350,3578756364,14
0,1402,52309,3578756350,3578756364,14
0,1402,52310,3578756350,3578756365,15
0,1402,52311,3578756350,3578756365,15
0,1402,52312,3578756350,3578756366,16
0,1402,52313,3578756350,3578756366,16
0,1402,52314,3578756350,3578756368,18
0,1402,52315,3578756350,3578756369,19
0,1402,52316,3578756350,3578756369,19
0,1402,52317,3578756350,3578756370,20
0,1402,52318,3578756350,3578756370,20
0,1402,52319,3578756350,3578756372,22
0,1402,52320,3578756350,3578756373,23
0,1402,52321,3578756350,3578756374,24
0,1402,52322,3578756350,3578756374,24
0,1402,52323,3578756350,3578756374,24
0,1402,52324,3578756350,3578756376,26
0,1402,52325,3578756350,3578756377,27
0,1402,52326,3578756350,3578756379,29
0,1402,52327,3578756350,3578756379,29
0,1402,52328,3578756350,3578756379,29
0,1402,52329,3578756350,3578756380,30
0,1402,52330,3578756350,3578756381,31
0,1402,52331,3578756350,3578756381,31
0,1402,52332,3578756350,3578756382,32
0,1402,52333,3578756350,3578756383,33
0,1402,52334,3578756350,3578756383,33
0,1402,52335,3578756350,3578756384,34
0,1402,52336,3578756350,3578756385,35
0,1402,52337,3578756350,3578756386,36
0,1402,52338,3578756350,3578756387,37
0,1402,52339,3578756350,3578756387,37
0,1402,52340,3578756350,3578756387,37
0,1402,52341,3578756350,3578756390,40
0,1402,52342,3578756350,3578756390,40
0,1402,52343,3578756350,3578756391,41
0,1402,52344,3578756350,3578756391,41
0,1402,52345,3578756350,3578756392,42
0,1402,52346,3578756350,3578756392,42
0,1402,52347,3578756350,3578756392,42
0,1402,52348,3578756350,3578756393,43
0,1402,52349,3578756350,3578756393,43
0,1402,52350,3578756350,3578756395,45
0,1402,52351,3578756350,3578756395,45
0,1402,52352,3578756350,3578756395,45
0,1402,52353,3578756350,3578756398,48
0,1402,52354,3578756350,3578756399,49
0,1403,52355,3578756413,3578756413,0
0,1403,52356,3578756413,3578756413,0
0,1403,52357,3578756413,3578756413,0
0,1403,52358,3578756413,3578756413,0
0,1403,52359,3578756413,3578756413,0
0,1403,52360,3578756413,3578756413,0
0,1403,52361,3578756413,3578756413,0
0,1403,52362,3578756413,3578756413,0
0,1403,52363,3578756413,3578756413,0
0,1403,52364,3578756413,3578756413,0
0,1403,52365,3578756413,3578756413,0
0,1403,52366,3578756413,3578756413,0
0,1403,52367,3578756413,3578756413,0
0,1403,52368,3578756413,3578756413,0
0,1403,52369,3578756413,3578756413,0
0,1403,52370,3578756413,3578756413,0
0,1403,52371,3578756413,3578756413,0
0,1403,52372,3578756413,3578756413,0
0,1403,52373,3578756413,3578756413,0
0,1403,52374,3578756413,3578756414,1
0,1403,52375,3578756413,3578756415,2
0,1403,52376,3578756413,3578756415,2
0,1403,52377,3578756413,3578756415,2
0,1403,52378,3578756413,3578756415,2
0,1403,52379,3578756413,3578756415,2
0,1403,52380,3578756413,3578756416,3
0,1403,52381,3578756413,3578756416,3
0,1403,52382,3578756413,3578756417,4
0,1403,52383,3578756413,3578756418,5
0,1403,52384,3578756413,3578756418,5
0,1403,52385,3578756413,3578756419,6
0,1403,52386,3578756413,3578756419,6
0,1403,52387,3578756413,3578756420,7
0,1403,52388,3578756413,3578756420,7
0,1403,52389,3578756413,3578756421,8
0,1403,52390,3578756413,3578756422,9
0,1403,52391,3578756413,3578756422,9
0,1403,52392,3578756413,3578756423,10
0,1403,52393,3578756413,3578756424,11
0,1403,52394,3578756413,3578756424,11
0,1403,52395,3578756413,3578756424,11
0,1403,52396,3578756413,3578756427,14
0,1403,52397,3578756413,3578756428,15
0,1403,52398,3578756413,3578756428,15
0,1403,52399,3578756413,3578756429,16
0,1403,52400,3578756413,3578756431,18
0,1403,52401,3578756413,3578756431,18
0,1403,52402,3578756413,3578756431,18
0,1403,52403,3578756413,3578756433,20
0,1403,52404,3578756413,3578756433,20
0,1403,52405,3578756413,3578756435,22
0,1403,52406,3578756413,3578756435,22
0,1403,52407,3578756413,3578756436,23
0,1403,52408,3578756413,3578756436,23
0,1403,52409,3578756413,3578756437,24
0,1403,52410,3578756413,3578756438,25
0,1403,52411,3578756413,3578756438,25
0,1403,52412,3578756413,3578756439,26
0,1403,52413,3578756413,3578756439,26
0,1403,52414,3578756413,3578756440,27
0,1403,52415,3578756413,3578756440,27
0,1403,52416,3578756413,3578756440,27
0,1403,52417,3578756413,3578756440,27
0,1403,52418,3578756413,3578756441,28
0,1403,52419,3578756413,3578756441,28
0,1403,52420,3578756413,3578756443,30
0,1403,52421,3578756413,3578756443,30
0,1403,52422,3578756413,3578756444,31
0,1403,52423,3578756413,3578756444,31
0,1403,52424,3578756413,3578756444,31
0,1403,52425,3578756413,3578756444,31
0,1403,52426,3578756413,3578756445,32
0,1403,52427,3578756413,3578756446,33
0,1403,52428,3578756413,3578756447,34
0,1403,52429,3578756413,3578756448,35
0,1403,52430,3578756413,3578756449,36
0,1403,52431,3578756413,3578756449,36
0,1403,52432,3578756413,3578756449,36
0,1403,52433,3578756413,3578756450,37
0,1403,52434,3578756413,3578756451,38
0,1403,52435,3578756413,3578756452,39
0,1403,52436,3578756413,3578756453,40
0,1403,52437,3578756413,3578756455,42
0,1403,52438,3578756413,3578756456,43
0,1403,52439,3578756413,3578756457,44
0,1403,52440,3578756413,3578756457,44
0,1403,52441,3578756413,3578756457,44
0,1403,52442,3578756413,3578756458,45
0,1403,52443,3578756413,3578756458,45
0,1403,52444,3578756413,3578756459,46
0,1403,52445,3578756413,3578756459,46
0,1403,52446,3578756413,3578756461,48
0,1403,52447,3578756413,3578756461,48
0,1403,52448,3578756413,3578756462,49
0,1404,52449,3578756475,3578756475,0
0,1404,52450,3578756475,3578756475,0
0,1404,52451,3578756475,3578756475,0
0,1404,52452,3578756475,3578756475,0
0,1404,52453,3578756475,3578756475,0
0,1404,52454,3578756475,3578756476,1
0,1404,52455,3578756475,3578756476,1
0,1404,52456,3578756475,3578756476,1
0,1404,52457,3578756475,3578756476,1
0,1404,52458,3578756475,3578756476,1
0,1404,52459,3578756475,3578756480,5
0,1404,52460,3578756475,3578756481,6
0,1404,52461,3578756475,3578756482,7
0,1404,52462,3578756475,3578756483,8
0,1404,52463,3578756475,3578756484,9
0,1404,52464,3578756475,3578756487,12
0,1404,52465,3578756475,3578756487,12
0,1404,52466,3578756475,3578756487,12
0,1404,52467,3578756475,3578756488,13
0,1404,52468,3578756475,3578756488,13
0,1404,52469,3578756475,3578756489,14
0,1404,52470,3578756475,3578756490,15
0,1404,52471,3578756475,3578756490,15
0,1404,52472,3578756475,3578756491,16
0,1404,52473,3578756475,3578756491,16
0,1404,52474,3578756475,3578756491,16
0,1404,52475,3578756475,3578756492,17
0,1404,52476,3578756475,3578756492,17
0,1404,52477,3578756475,3578756492,17
0,1404,52478,3578756475,3578756493,18
0,1404,52479,3578756475,3578756494,19
0,1404,52480,3578756475,3578756494,19
0,1404,52481,3578756475,3578756494,19
0,1404,52482,3578756475,3578756496,21
0,1404,52483,3578756475,3578756496,21
0,1404,52484,3578756475,3578756496,21
0,1404,52485,3578756475,3578756496,21
0,1404,52486,3578756475,3578756497,22
0,1404,52487,3578756475,3578756498,23
0,1404,52488,3578756475,3578756498,23
0,1404,52489,3578756475,3578756498,23
0,1404,52490,3578756475,3578756499,24
0,1404,52491,3578756475,3578756500,25
0,1404,52492,3578756475,3578756500,25
0,1404,52493,3578756475,3578756500,25
0,1404,52494,3578756475,3578756501,26
0,1404,52495,3578756475,3578756503,28
0,1404,52496,3578756475,3578756505,30
0,1404,52497,3578756475,3578756505,30
0,1404,52498,3578756475,3578756506,31
0,1404,52499,3578756475,3578756507,32
0,1404,52500,3578756475,3578756507,32
0,1404,52501,3578756475,3578756508,33
0,1404,52502,3578756475,3578756508,33
0,1404,52503,3578756475,3578756508,33
0,1404,52504,3578756475,3578756508,33
0,1404,52505,3578756475,3578756509,34
0,1404,52506,3578756475,3578756510,35
0,1404,52507,3578756475,3578756510,35
0,1404,52508,3578756475,3578756510,35
0,1404,52509,3578756475,3578756510,35
0,1404,52510,3578756475,3578756511,36
0,1404,52511,3578756475,3578756512,37
0,1404,52512,3578756475,3578756513,38
0,1404,52513,3578756475,3578756514,39
0,1404,52514,3578756475,3578756514,39
0,1404,52515,3578756475,3578756514,39
0,1404,52516,3578756475,3578756515,40
0,1404,52517,3578756475,3578756515,40
0,1404,52518,3578756475,3578756515,40
0,1404,52519,3578756475,3578756516,41
0,1404,52520,3578756475,3578756516,41
0,1404,52521,3578756475,3578756516,41
0,1404,52522,3578756475,3578756516,41
0,1404,52523,3578756475,3578756517,42
0,1404,52524,3578756475,3578756517,42
0,1404,52525,3578756475,3578756517,42
0,1404,52526,3578756475,3578756517,42
0,1404,52527,3578756475,3578756517,42
0,1404,52528,3578756475,3578756518,43
0,1404,52529,3578756475,3578756518,43
0,1404,52530,3578756475,3578756518,43
0,1404,52531,3578756475,3578756519,44
0,1404,52532,3578756475,3578756519,44
0,1404,52533,3578756475,3578756519,44
0,1404,52534,3578756475,3578756519,44
0,1404,52535,3578756475,3578756520,45
0,1404,52536,3578756475,3578756521,46
0,1404,52537,3578756475,3578756522,47
0,1404,52538,3578756475,3578756522,47
0,1404,52539,3578756475,3578756523,48
0,1404,52540,3578756475,3578756523,48
0,1404,52541,3578756475,3578756523,48
0,1404,52542,3578756475,3578756523,48
0,1404,52543,3578756475,3578756523,48
0,1404,52544,3578756475,3578756524,49
0,1404,52545,3578756475,3578756525,50
0,1405,52546,3578756539,3578756539,0
0,1405,52547,3578756539,3578756539,0
0,1405,52548,3578756539,3578756539,0
0,1405,52549,3578756539,3578756539,0
0,1405,52550,3578756539,3578756539,0
0,1405,52551,3578756539,3578756539,0
0,1405,52552,3578756539,3578756539,0
0,1405,52553,3578756539,3578756539,0
0,1405,52554,3578756539,3578756539,0
0,1405,52555,3578756539,3578756539,0
0,1405,52556,3578756539,3578756539,0
0,1405,52557,3578756539,3578756539,0
0,1405,52558,3578756539,3578756539,0
0,1405,52559,3578756539,3578756539,0
0,1405,52560,3578756539,3578756539,0
0,1405,52561,3578756539,3578756539,0
0,1405,52562,3578756539,3578756539,0
0,1405,52563,3578756539,3578756539,0
0,1405,52564,3578756539,3578756539,0
0,1405,52565,3578756539,3578756539,0
0,1405,52566,3578756539,3578756539,0
0,1405,52567,3578756539,3578756539,0
0,1405,52568,3578756539,3578756539,0
0,1405,52569,3578756539,3578756539,0
0,1405,52570,3578756539,3578756539,0
0,1405,52571,3578756539,3578756539,0
0,1405,52572,3578756539,3578756539,0
0,1405,52573,3578756539,3578756539,0
0,1405,52574,3578756539,3578756539,0
0,1405,52575,3578756539,3578756540,1
0,1405,52576,3578756539,3578756540,1
0,1405,52577,3578756539,3578756540,1
0,1405,52578,3578756539,3578756541,2
0,1405,52579,3578756539,3578756542,3
0,1405,52580,3578756539,3578756542,3
0,1405,52581,3578756539,3578756542,3
0,1405,52582,3578756539,3578756543,4
0,1405,52583,3578756539,3578756543,4
0,1405,52584,3578756539,3578756544,5
0,1405,52585,3578756539,3578756545,6
0,1405,52586,3578756539,3578756545,6
0,1405,52587,3578756539,3578756545,6
0,1405,52588,3578756539,3578756546,7
0,1405,52589,3578756539,3578756546,7
0,1405,52590,3578756539,3578756547,8
0,1405,52591,3578756539,3578756547,8
0,1405,52592,3578756539,3578756548,9
0,1405,52593,3578756539,3578756550,11
0,1405,52594,3578756539,3578756551,12
0,1405,52595,3578756539,3578756551,12
0,1405,52596,3578756539,3578756552,13
0,1405,52597,3578756539,3578756553,14
0,1405,52598,3578756539,3578756553,14
0,1405,52599,3578756539,3578756553,14
0,1405,52600,3578756539,3578756554,15
0,1405,52601,3578756539,3578756554,15
0,1405,52602,3578756539,3578756554,15
0,1405,52603,3578756539,3578756555,16
0,1405,52604,3578756539,3578756555,16
0,1405,52605,3578756539,3578756557,18
0,1405,52606,3578756539,3578756558,19
0,1405,52607,3578756539,3578756558,19
0,1405,52608,3578756539,3578756559,20
0,1405,52609,3578756539,3578756560,21
0,1405,52610,3578756539,3578756560,21
0,1405,52611,3578756539,3578756560,21
0,1405,52612,3578756539,3578756561,22
0,1405,52613,3578756539,3578756561,22
0,1405,52614,3578756539,3578756561,22
0,1405,52615,3578756539,3578756562,23
0,1405,52616,3578756539,3578756563,24
0,1405,52617,3578756539,3578756563,24
0,1405,52618,3578756539,3578756564,25
0,1405,52619,3578756539,3578756564,25
0,1405,52620,3578756539,3578756565,26
0,1405,52621,3578756539,3578756565,26
0,1405,52622,3578756539,3578756567,28
0,1405,52623,3578756539,3578756567,28
0,1405,52624,3578756539,3578756568,29
0,1405,52625,3578756539,3578756569,30
0,1405,52626,3578756539,3578756569,30
0,1405,52627,3578756539,3578756570,31
0,1405,52628,3578756539,3578756572,33
0,1405,52629,3578756539,3578756572,33
0,1405,52630,3578756539,3578756573,34
0,1405,52631,3578756539,3578756574,35
0,1405,52632,3578756539,3578756575,36
0,1405,52633,3578756539,3578756576,37
0,1405,52634,3578756539,3578756577,38
0,1405,52635,3578756539,3578756578,39
0,1405,52636,3578756539,3578756579,40
0,1405,52637,3578756539,3578756579,40
0,1405,52638,3578756539,3578756581,42
0,1405,52639,3578756539,3578756581,42
0,1405,52640,3578756539,3578756581,42
0,1405,52641,3578756539,3578756581,42
0,1405,52642,3578756539,3578756582,43
0,1405,52643,3578756539,3578756583,44
0,1405,52644,3578756539,3578756585,46
0,1405,52645,3578756539,3578756586,47
0,1405,52646,3578756539,3578756586,47
0,1405,52647,3578756539,3578756587,48
0,1405,52648,3578756539,3578756588,49
0,1405,52649,3578756539,3578756589,50
0,1406,52650,3578756601,3578756601,0
0,1406,52651,3578756601,3578756601,0
0,1406,52652,3578756601,3578756601,0
0,1406,52653,3578756601,3578756601,0
0,1406,52654,3578756601,3578756601,0
0,1406,52655,3578756601,3578756601,0
0,1406,52656,3578756601,3578756601,0
0,1406,52657,3578756601,3578756601,0
0,1406,52658,3578756601,3578756601,0
0,1406,52659,3578756601,3578756601,0
0,1406,52660,3578756601,3578756601,0
0,1406,52661,3578756601,3578756601,0
0,1406,52662,3578756601,3578756601,0
0,1406,52663,3578756601,3578756602,1
0,1406,52664,3578756601,3578756602,1
0,1406,52665,3578756601,3578756603,2
0,1406,52666,3578756601,3578756604,3
0,1406,52667,3578756601,3578756604,3
0,1406,52668,3578756601,3578756604,3
0,1406,52669,3578756601,3578756605,4
0,1406,52670,3578756601,3578756605,4
0,1406,52671,3578756601,3578756606,5
0,1406,52672,3578756601,3578756606,5
0,1406,52673,3578756601,3578756608,7
0,1406,52674,3578756601,3578756609,8
0,1406,52675,3578756601,3578756609,8
0,1406,52676,3578756601,3578756610,9
0,1406,52677,3578756601,3578756611,10
0,1406,52678,3578756601,3578756611,10
0,1406,52679,3578756601,3578756612,11
0,1406,52680,3578756601,3578756613,12
0,1406,52681,3578756601,3578756614,13
0,1406,52682,3578756601,3578756614,13
0,1406,52683,3578756601,3578756614,13
0,1406,52684,3578756601,3578756614,13
0,1406,52685,3578756601,3578756617,16
0,1406,52686,3578756601,3578756618,17
0,1406,52687,3578756601,3578756618,17
0,1406,52688,3578756601,3578756618,17
0,1406,52689,3578756601,3578756618,17
0,1406,52690,3578756601,3578756619,18
0,1406,52691,3578756601,3578756620,19
0,1406,52692,3578756601,3578756621,20
0,1406,52693,3578756601,3578756621,20
0,1406,52694,3578756601,3578756622,21
0,1406,52695,3578756601,3578756623,22
0,1406,52696,3578756601,3578756623,22
0,1406,52697,3578756601,3578756624,23
0,1406,52698,3578756601,3578756624,23
0,1406,52699,3578756601,3578756625,24
0,1406,52700,3578756601,3578756627,26
0,1406,52701,3578756601,3578756627,26
0,1406,52702,3578756601,3578756628,27
0,1406,52703,3578756601,3578756629,28
0,1406,52704,3578756601,3578756630,29
0,1406,52705,3578756601,3578756630,29
0,1406,52706,3578756601,3578756631,30
0,1406,52707,3578756601,3578756632,31
0,1406,52708,3578756601,3578756632,31
0,1406,52709,3578756601,3578756633,32
0,1406,52710,3578756601,3578756633,32
0,1406,52711,3578756601,3578756634,33
0,1406,52712,3578756601,3578756635,34
0,1406,52713,3578756601,3578756636,35
0,1406,52714,3578756601,3578756636,35
0,1406,52715,3578756601,3578756637,36
0,1406,52716,3578756601,3578756637,36
0,1406,52717,3578756601,3578756638,37
0,1406,52718,3578756601,3578756639,38
0,1406,52719,3578756601,3578756639,38
0,1406,52720,3578756601,3578756639,38
0,1406,52721,3578756601,3578756640,39
0,1406,52722,3578756601,3578756640,39
0,1406,52723,3578756601,3578756641,40
0,1406,52724,3578756601,3578756642,41
0,1406,52725,3578756601,3578756642,41
0,1406,52726,3578756601,3578756643,42
0,1406,52727,3578756601,3578756643,42
0,1406,52728,3578756601,3578756643,42
0,1406,52729,3578756601,3578756643,42
0,1406,52730,3578756601,3578756644,43
0,1406,52731,3578756601,3578756645,44
0,1406,52732,3578756601,3578756648,47
0,1406,52733,3578756601,3578756648,47
0,1406,52734,3578756601,3578756648,47
0,1406,52735,3578756601,3578756649,48
0,1406,52736,3578756601,3578756649,48
0,1406,52737,3578756601,3578756649,48
0,1406,52738,3578756601,3578756650,49
0,1406,52739,3578756601,3578756651,50
0,1407,52740,3578756663,3578756663,0
0,1407,52741,3578756663,3578756663,0
0,1407,52742,3578756663,3578756663,0
0,1407,52743,3578756663,3578756663,0
0,1407,52744,3578756663,3578756663,0
0,1407,52745,3578756663,3578756663,0
0,1407,52746,3578756663,3578756663,0
0,1407,52747,3578756663,3578756663,0
0,1407,52748,3578756663,3578756663,0
0,1407,52749,3578756663,3578756663,0
0,1407,52750,3578756663,3578756663,0
0,1407,52751,3578756663,3578756663,0
0,1407,52752,3578756663,3578756663,0
0,1407,52753,3578756663,3578756663,0
0,1407,52754,3578756663,3578756663,0
0,1407,52755,3578756663,3578756664,1
0,1407,52756,3578756663,3578756664,1
0,1407,52757,3578756663,3578756664,1
0,1407,52758,3578756663,3578756665,2
0,1407,52759,3578756663,3578756666,3
0,1407,52760,3578756663,3578756667,4
0,1407,52761,3578756663,3578756667,4
0,1407,52762,3578756663,3578756667,4
0,1407,52763,3578756663,3578756667,4
0,1407,52764,3578756663,3578756670,7
0,1407,52765,3578756663,3578756681,18
0,1407,52766,3578756663,3578756681,18
0,1407,52767,3578756663,3578756684,21
0,1407,52768,3578756663,3578756684,21
0,1407,52769,3578756663,3578756687,24
0,1407,52770,3578756663,3578756687,24
0,1407,52771,3578756663,3578756688,25
0,1407,52772,3578756663,3578756688,25
0,1407,52773,3578756663,3578756688,25
0,1407,52774,3578756663,3578756688,25
0,1407,52775,3578756663,3578756689,26
0,1407,52776,3578756663,3578756690,27
0,1407,52777,3578756663,3578756690,27
0,1407,52778,3578756663,3578756691,28
0,1407,52779,3578756663,3578756691,28
0,1407,52780,3578756663,3578756691,28
0,1407,52781,3578756663,3578756692,29
0,1407,52782,3578756663,3578756693,30
0,1407,52783,3578756663,3578756694,31
0,1407,52784,3578756663,3578756694,31
0,1407,52785,3578756663,3578756695,32
0,1407,52786,3578756663,3578756696,33
0,1407,52787,3578756663,3578756696,33
0,1407,52788,3578756663,3578756696,33
0,1407,52789,3578756663,3578756697,34
0,1407,52790,3578756663,3578756697,34
0,1407,52791,3578756663,3578756698,35
0,1407,52792,3578756663,3578756698,35
0,1407,52793,3578756663,3578756700,37
0,1407,52794,3578756663,3578756700,37
0,1407,52795,3578756663,3578756700,37
0,1407,52796,3578756663,3578756701,38
0,1407,52797,3578756663,3578756703,40
0,1407,52798,3578756663,3578756704,41
0,1407,52799,3578756663,3578756705,42
0,1407,52800,3578756663,3578756706,43
0,1407,52801,3578756663,3578756706,43
0,1407,52802,3578756663,3578756707,44
0,1407,52803,3578756663,3578756708,45
0,1407,52804,3578756663,3578756708,45
0,1407,52805,3578756663,3578756709,46
0,1407,52806,3578756663,3578756709,46
0,1407,52807,3578756663,3578756709,46
0,1407,52808,3578756663,3578756709,46
0,1407,52809,3578756663,3578756710,47
0,1407,52810,3578756663,3578756710,47
0,1407,52811,3578756663,3578756710,47
0,1407,52812,3578756663,3578756710,47
0,1407,52813,3578756663,3578756711,48
0,1407,52814,3578756663,3578756711,48
0,1407,52815,3578756663,3578756712,49
0,1407,52816,3578756663,3578756713,50
0,1408,52817,3578756726,3578756726,0
0,1408,52818,3578756726,3578756726,0
0,1408,52819,3578756726,3578756726,0
0,1408,52820,3578756726,3578756726,0
0,1408,52821,3578756726,3578756726,0
0,1408,52822,3578756726,3578756726,0
0,1408,52823,3578756726,3578756726,0
0,1408,52824,3578756726,3578756726,0
0,1408,52825,3578756726,3578756726,0
0,1408,52826,3578756726,3578756726,0
0,1408,52827,3578756726,3578756726,0
0,1408,52828,3578756726,3578756726,0
0,1408,52829,3578756726,3578756726,0
0,1408,52830,3578756726,3578756726,0
0,1408,52831,3578756726,3578756726,0
0,1408,52832,3578756726,3578756726,0
0,1408,52833,3578756726,3578756726,0
0,1408,52834,3578756726,3578756726,0
0,1408,52835,3578756726,3578756726,0
0,1408,52836,3578756726,3578756726,0
0,1408,52837,3578756726,3578756726,0
0,1408,52838,3578756726,3578756726,0
0,1408,52839,3578756726,3578756726,0
0,1408,52840,3578756726,3578756726,0
0,1408,52841,3578756726,3578756726,0
0,1408,52842,3578756726,3578756726,0
0,1408,52843,3578756726,3578756726,0
0,1408,52844,3578756726,3578756726,0
0,1408,52845,3578756726,3578756726,0
0,1408,52846,3578756726,3578756726,0
0,1408,52847,3578756726,3578756726,0
0,1408,52848,3578756726,3578756726,0
0,1408,52849,3578756726,3578756726,0
0,1408,52850,3578756726,3578756726,0
0,1408,52851,3578756726,3578756726,0
0,1408,52852,3578756726,3578756726,0
0,1408,52853,3578756726,3578756728,2
0,1408,52854,3578756726,3578756728,2
0,1408,52855,3578756726,3578756728,2
0,1408,52856,3578756726,3578756728,2
0,1408,52857,3578756726,3578756730,4
0,1408,52858,3578756726,3578756730,4
0,1408,52859,3578756726,3578756730,4
0,1408,52860,3578756726,3578756730,4
0,1408,52861,3578756726,3578756731,5
0,1408,52862,3578756726,3578756731,5
0,1408,52863,3578756726,3578756731,5
0,1408,52864,3578756726,3578756731,5
0,1408,52865,3578756726,3578756731,5
0,1408,52866,3578756726,3578756731,5
0,1408,52867,3578756726,3578756732,6
0,1408,52868,3578756726,3578756732,6
0,1408,52869,3578756726,3578756733,7
0,1408,52870,3578756726,3578756733,7
0,1408,52871,3578756726,3578756735,9
0,1408,52872,3578756726,3578756735,9
0,1408,52873,3578756726,3578756738,12
0,1408,52874,3578756726,3578756739,13
0,1408,52875,3578756726,3578756739,13
0,1408,52876,3578756726,3578756740,14
0,1408,52877,3578756726,3578756740,14
0,1408,52878,3578756726,3578756740,14
0,1408,52879,3578756726,3578756740,14
0,1408,52880,3578756726,3578756740,14
0,1408,52881,3578756726,3578756740,14
0,1408,52882,3578756726,3578756741,15
0,1408,52883,3578756726,3578756742,16
0,1408,52884,3578756726,3578756743,17
0,1408,52885,3578756726,3578756743,17
0,1408,52886,3578756726,3578756743,17
0,1408,52887,3578756726,3578756743,17
0,1408,52888,3578756726,3578756744,18
0,1408,52889,3578756726,3578756744,18
0,1408,52890,3578756726,3578756746,20
0,1408,52891,3578756726,3578756746,20
0,1408,52892,3578756726,3578756746,20
0,1408,52893,3578756726,3578756748,22
0,1408,52894,3578756726,3578756748,22
0,1408,52895,3578756726,3578756750,24
0,1408,52896,3578756726,3578756751,25
0,1408,52897,3578756726,3578756752,26
0,1408,52898,3578756726,3578756752,26
0,1408,52899,3578756726,3578756753,27
0,1408,52900,3578756726,3578756753,27
0,1408,52901,3578756726,3578756753,27
0,1408,52902,3578756726,3578756754,28
0,1408,52903,3578756726,3578756755,29
0,1408,52904,3578756726,3578756755,29
0,1408,52905,3578756726,3578756757,31
0,1408,52906,3578756726,3578756758,32
0,1408,52907,3578756726,3578756759,33
0,1408,52908,3578756726,3578756759,33
0,1408,52909,3578756726,3578756760,34
0,1408,52910,3578756726,3578756760,34
0,1408,52911,3578756726,3578756761,35
0,1408,52912,3578756726,3578756761,35
0,1408,52913,3578756726,3578756761,35
0,1408,52914,3578756726,3578756761,35
0,1408,52915,3578756726,3578756762,36
0,1408,52916,3578756726,3578756762,36
0,1408,52917,3578756726,3578756762,36
0,1408,52918,3578756726,3578756763,37
0,1408,52919,3578756726,3578756764,38
0,1408,52920,3578756726,3578756764,38
0,1408,52921,3578756726,3578756765,39
0,1408,52922,3578756726,3578756765,39
0,1408,52923,3578756726,3578756767,41
0,1408,52924,3578756726,3578756767,41
0,1408,52925,3578756726,3578756768,42
0,1408,52926,3578756726,3578756769,43
0,1408,52927,3578756726,3578756769,43
0,1408,52928,3578756726,3578756771,45
0,1408,52929,3578756726,3578756772,46
0,1408,52930,3578756726,3578756773,47
0,1408,52931,3578756726,3578756773,47
0,1408,52932,3578756726,3578756774,48
0,1409,52933,3578756790,3578756790,0
0,1409,52934,3578756790,3578756790,0
0,1409,52935,3578756790,3578756790,0
0,1409,52936,3578756790,3578756790,0
0,1409,52937,3578756790,3578756790,0
0,1409,52938,3578756790,3578756790,0
0,1409,52939,3578756790,3578756790,0
0,1409,52940,3578756790,3578756790,0
0,1409,52941,3578756790,3578756790,0
0,1409,52942,3578756790,3578756790,0
0,1409,52943,3578756790,3578756790,0
0,1409,52944,3578756790,3578756790,0
0,1409,52945,3578756790,3578756790,0
0,1409,52946,3578756790,3578756790,0
0,1409,52947,3578756790,3578756790,0
0,1409,52948,3578756790,3578756790,0
0,1409,52949,3578756790,3578756791,1
0,1409,52950,3578756790,3578756793,3
0,1409,52951,3578756790,3578756793,3
0,1409,52952,3578756790,3578756794,4
0,1409,52953,3578756790,3578756794,4
0,1409,52954,3578756790,3578756795,5
0,1409,52955,3578756790,3578756797,7
0,1409,52956,3578756790,3578756798,8
0,1409,52957,3578756790,3578756798,8
0,1409,52958,3578756790,3578756799,9
0,1409,52959,3578756790,3578756800,10
0,1409,52960,3578756790,3578756800,10
0,1409,52961,3578756790,3578756802,12
0,1409,52962,3578756790,3578756803,13
0,1409,52963,3578756790,3578756804,14
0,1409,52964,3578756790,3578756804,14
0,1409,52965,3578756790,3578756804,14
0,1409,52966,3578756790,3578756804,14
0,1409,52967,3578756790,3578756805,15
0,1409,52968,3578756790,3578756806,16
0,1409,52969,3578756790,3578756808,18
0,1409,52970,3578756790,3578756809,19
0,1409,52971,3578756790,3578756809,19
0,1409,52972,3578756790,3578756809,19
0,1409,52973,3578756790,3578756810,20
0,1409,52974,3578756790,3578756812,22
0,1409,52975,3578756790,3578756813,23
0,1409,52976,3578756790,3578756813,23
0,1409,52977,3578756790,3578756814,24
0,1409,52978,3578756790,3578756815,25
0,1409,52979,3578756790,3578756815,25
0,1409,52980,3578756790,3578756815,25
0,1409,52981,3578756790,3578756815,25
0,1409,52982,3578756790,3578756816,26
0,1409,52983,3578756790,3578756816,26
0,1409,52984,3578756790,3578756817,27
0,1409,52985,3578756790,3578756818,28
0,1409,52986,3578756790,3578756818,28
0,1409,52987,3578756790,3578756818,28
0,1409,52988,3578756790,3578756819,29
0,1409,52989,3578756790,3578756820,30
0,1409,52990,3578756790,3578756821,31
0,1409,52991,3578756790,3578756822,32
0,1409,52992,3578756790,3578756823,33
0,1409,52993,3578756790,3578756823,33
0,1409,52994,3578756790,3578756824,34
0,1409,52995,3578756790,3578756824,34
0,1409,52996,3578756790,3578756825,35
0,1409,52997,3578756790,3578756827,37
0,1409,52998,3578756790,3578756828,38
0,1409,52999,3578756790,3578756829,39
0,1409,53000,3578756790,3578756829,39
0,1409,53001,3578756790,3578756829,39
0,1409,53002,3578756790,3578756829,39
0,1409,53003,3578756790,3578756831,41
0,1409,53004,3578756790,3578756832,42
0,1409,53005,3578756790,3578756833,43
0,1409,53006,3578756790,3578756835,45
0,1409,53007,3578756790,3578756835,45
0,1409,53008,3578756790,3578756836,46
0,1409,53009,3578756790,3578756836,46
0,1409,53010,3578756790,3578756836,46
0,1409,53011,3578756790,3578756839,49
0,1409,53012,3578756790,3578756840,50
0,1409,53013,3578756790,3578756840,50
0,1410,53014,3578756853,3578756853,0
0,1410,53015,3578756853,3578756853,0
0,1410,53016,3578756853,3578756853,0
0,1410,53017,3578756853,3578756853,0
0,1410,53018,3578756853,3578756853,0
0,1410,53019,3578756853,3578756853,0
0,1410,53020,3578756853,3578756853,0
0,1410,53021,3578756853,3578756853,0
0,1410,53022,3578756853,3578756853,0
0,1410,53023,3578756853,3578756853,0
0,1410,53024,3578756853,3578756853,0
0,1410,53025,3578756853,3578756853,0
0,1410,53026,3578756853,3578756853,0
0,1410,53027,3578756853,3578756853,0
0,1410,53028,3578756853,3578756853,0
0,1410,53029,3578756853,3578756853,0
0,1410,53030,3578756853,3578756853,0
0,1410,53031,3578756853,3578756855,2
0,1410,53032,3578756853,3578756855,2
0,1410,53033,3578756853,3578756856,3
0,1410,53034,3578756853,3578756856,3
0,1410,53035,3578756853,3578756857,4
0,1410,53036,3578756853,3578756858,5
0,1410,53037,3578756853,3578756859,6
0,1410,53038,3578756853,3578756859,6
0,1410,53039,3578756853,3578756861,8
0,1410,53040,3578756853,3578756862,9
0,1410,53041,3578756853,3578756862,9
0,1410,53042,3578756853,3578756864,11
0,1410,53043,3578756853,3578756864,11
0,1410,53044,3578756853,3578756864,11
0,1410,53045,3578756853,3578756865,12
0,1410,53046,3578756853,3578756866,13
0,1410,53047,3578756853,3578756866,13
0,1410,53048,3578756853,3578756866,13
0,1410,53049,3578756853,3578756866,13
0,1410,53050,3578756853,3578756867,14
0,1410,53051,3578756853,3578756881,28
0,1410,53052,3578756853,3578756881,28
0,1410,53053,3578756853,3578756881,28
0,1410,53054,3578756853,3578756882,29
0,1410,53055,3578756853,3578756883,30
0,1410,53056,3578756853,3578756884,31
0,1410,53057,3578756853,3578756887,34
0,1410,53058,3578756853,3578756887,34
0,1410,53059,3578756853,3578756888,35
0,1410,53060,3578756853,3578756889,36
0,1410,53061,3578756853,3578756889,36
0,1410,53062,3578756853,3578756889,36
0,1410,53063,3578756853,3578756890,37
0,1410,53064,3578756853,3578756890,37
0,1410,53065,3578756853,3578756890,37
0,1410,53066,3578756853,3578756891,38
0,1410,53067,3578756853,3578756891,38
0,1410,53068,3578756853,3578756891,38
0,1410,53069,3578756853,3578756892,39
0,1410,53070,3578756853,3578756893,40
0,1410,53071,3578756853,3578756894,41
0,1410,53072,3578756853,3578756894,41
0,1410,53073,3578756853,3578756895,42
0,1410,53074,3578756853,3578756896,43
0,1410,53075,3578756853,3578756896,43
0,1410,53076,3578756853,3578756897,44
0,1410,53077,3578756853,3578756897,44
0,1410,53078,3578756853,3578756898,45
0,1410,53079,3578756853,3578756898,45
0,1410,53080,3578756853,3578756900,47
0,1410,53081,3578756853,3578756900,47
0,1410,53082,3578756853,3578756901,48
0,1410,53083,3578756853,3578756901,48
0,1411,53084,3578756916,3578756916,0
0,1411,53085,3578756916,3578756916,0
0,1411,53086,3578756916,3578756916,0
0,1411,53087,3578756916,3578756916,0
0,1411,53088,3578756916,3578756916,0
0,1411,53089,3578756916,3578756916,0
0,1411,53090,3578756916,3578756916,0
0,1411,53091,3578756916,3578756916,0
0,1411,53092,3578756916,3578756916,0
0,1411,53093,3578756916,3578756916,0
0,1411,53094,3578756916,3578756916,0
0,1411,53095,3578756916,3578756916,0
0,1411,53096,3578756916,3578756916,0
0,1411,53097,3578756916,3578756916,0
0,1411,53098,3578756916,3578756916,0
0,1411,53099,3578756916,3578756916,0
0,1411,53100,3578756916,3578756916,0
0,1411,53101,3578756916,3578756916,0
0,1411,53102,3578756916,3578756916,0
0,1411,53103,3578756916,3578756916,0
0,1411,53104,3578756916,3578756916,0
0,1411,53105,3578756916,3578756916,0
0,1411,53106,3578756916,3578756916,0
0,1411,53107,3578756916,3578756916,0
0,1411,53108,3578756916,3578756916,0
0,1411,53109,3578756916,3578756916,0
0,1411,53110,3578756916,3578756916,0
0,1411,53111,3578756916,3578756916,0
0,1411,53112,3578756916,3578756917,1
0,1411,53113,3578756916,3578756917,1
0,1411,53114,3578756916,3578756917,1
0,1411,53115,3578756916,3578756917,1
0,1411,53116,3578756916,3578756917,1
0,1411,53117,3578756916,3578756917,1
0,1411,53118,3578756916,3578756918,2
0,1411,53119,3578756916,3578756918,2
0,1411,53120,3578756916,3578756919,3
0,1411,53121,3578756916,3578756919,3
0,1411,53122,3578756916,3578756919,3
0,1411,53123,3578756916,3578756919,3
0,1411,53124,3578756916,3578756919,3
0,1411,53125,3578756916,3578756919,3
0,1411,53126,3578756916,3578756919,3
0,1411,53127,3578756916,3578756919,3
0,1411,53128,3578756916,3578756921,5
0,1411,53129,3578756916,3578756922,6
0,1411,53130,3578756916,3578756922,6
0,1411,53131,3578756916,3578756923,7
0,1411,53132,3578756916,3578756923,7
0,1411,53133,3578756916,3578756923,7
0,1411,53134,3578756916,3578756924,8
0,1411,53135,3578756916,3578756924,8
0,1411,53136,3578756916,3578756924,8
0,1411,53137,3578756916,3578756926,10
0,1411,53138,3578756916,3578756926,10
0,1411,53139,3578756916,3578756926,10
0,1411,53140,3578756916,3578756927,11
0,1411,53141,3578756916,3578756928,12
0,1411,53142,3578756916,3578756928,12
0,1411,53143,3578756916,3578756928,12
0,1411,53144,3578756916,3578756930,14
0,1411,53145,3578756916,3578756930,14
0,1411,53146,3578756916,3578756930,14
0,1411,53147,3578756916,3578756931,15
0,1411,53148,3578756916,3578756931,15
0,1411,53149,3578756916,3578756931,15
0,1411,53150,3578756916,3578756931,15
0,1411,53151,3578756916,3578756931,15
0,1411,53152,3578756916,3578756931,15
0,1411,53153,3578756916,3578756931,15
0,1411,53154,3578756916,3578756931,15
0,1411,53155,3578756916,3578756932,16
0,1411,53156,3578756916,3578756932,16
0,1411,53157,3578756916,3578756933,17
0,1411,53158,3578756916,3578756933,17
0,1411,53159,3578756916,3578756934,18
0,1411,53160,3578756916,3578756934,18
0,1411,53161,3578756916,3578756936,20
0,1411,53162,3578756916,3578756938,22
0,1411,53163,3578756916,3578756939,23
0,1411,53164,3578756916,3578756940,24
0,1411,53165,3578756916,3578756940,24
0,1411,53166,3578756916,3578756940,24
0,1411,53167,3578756916,3578756941,25
0,1411,53168,3578756916,3578756941,25
0,1411,53169,3578756916,3578756941,25
0,1411,53170,3578756916,3578756942,26
0,1411,53171,3578756916,3578756943,27
0,1411,53172,3578756916,3578756943,27
0,1411,53173,3578756916,3578756943,27
0,1411,53174,3578756916,3578756945,29
0,1411,53175,3578756916,3578756946,30
0,1411,53176,3578756916,3578756947,31
0,1411,53177,3578756916,3578756947,31
0,1411,53178,3578756916,3578756948,32
0,1411,53179,3578756916,3578756948,32
0,1411,53180,3578756916,3578756950,34
0,1411,53181,3578756916,3578756950,34
0,1411,53182,3578756916,3578756951,35
0,1411,53183,3578756916,3578756952,36
0,1411,53184,3578756916,3578756952,36
0,1411,53185,3578756916,3578756952,36
0,1411,53186,3578756916,3578756953,37
0,1411,53187,3578756916,3578756953,37
0,1411,53188,3578756916,3578756954,38
0,1411,53189,3578756916,3578756955,39
0,1411,53190,3578756916,3578756957,41
0,1411,53191,3578756916,3578756959,43
0,1411,53192,3578756916,3578756959,43
0,1411,53193,3578756916,3578756959,43
0,1411,53194,3578756916,3578756960,44
0,1411,53195,3578756916,3578756960,44
0,1411,53196,3578756916,3578756961,45
0,1411,53197,3578756916,3578756961,45
0,1411,53198,3578756916,3578756961,45
0,1411,53199,3578756916,3578756962,46
0,1411,53200,3578756916,3578756962,46
0,1411,53201,3578756916,3578756962,46
0,1411,53202,3578756916,3578756962,46
0,1411,53203,3578756916,3578756965,49
0,1411,53204,3578756916,3578756965,49
0,1412,53205,3578756979,3578756979,0
0,1412,53206,3578756979,3578756979,0
0,1412,53207,3578756979,3578756979,0
0,1412,53208,3578756979,3578756979,0
0,1412,53209,3578756979,3578756979,0
0,1412,53210,3578756979,3578756979,0
0,1412,53211,3578756979,3578756979,0
0,1412,53212,3578756979,3578756979,0
0,1412,53213,3578756979,3578756979,0
0,1412,53214,3578756979,3578756979,0
0,1412,53215,3578756979,3578756979,0
0,1412,53216,3578756979,3578756979,0
0,1412,53217,3578756979,3578756979,0
0,1412,53218,3578756979,3578756979,0
0,1412,53219,3578756979,3578756979,0
0,1412,53220,3578756979,3578756979,0
0,1412,53221,3578756979,3578756979,0
0,1412,53222,3578756979,3578756979,0
0,1412,53223,3578756979,3578756980,1
0,1412,53224,3578756979,3578756981,2
0,1412,53225,3578756979,3578756981,2
0,1412,53226,3578756979,3578756981,2
0,1412,53227,3578756979,3578756984,5
0,1412,53228,3578756979,3578756984,5
0,1412,53229,3578756979,3578756985,6
0,1412,53230,3578756979,3578756986,7
0,1412,53231,3578756979,3578756987,8
0,1412,53232,3578756979,3578756989,10
0,1412,53233,3578756979,3578756991,12
0,1412,53234,3578756979,3578756991,12
0,1412,53235,3578756979,3578756991,12
0,1412,53236,3578756979,3578756993,14
0,1412,53237,3578756979,3578756993,14
0,1412,53238,3578756979,3578756994,15
0,1412,53239,3578756979,3578756995,16
0,1412,53240,3578756979,3578756996,17
0,1412,53241,3578756979,3578756997,18
0,1412,53242,3578756979,3578756998,19
0,1412,53243,3578756979,3578756998,19
0,1412,53244,3578756979,3578756998,19
0,1412,53245,3578756979,3578756999,20
0,1412,53246,3578756979,3578757000,21
0,1412,53247,3578756979,3578757001,22
0,1412,53248,3578756979,3578757002,23
0,1412,53249,3578756979,3578757003,24
0,1412,53250,3578756979,3578757004,25
0,1412,53251,3578756979,3578757004,25
0,1412,53252,3578756979,3578757005,26
0,1412,53253,3578756979,3578757005,26
0,1412,53254,3578756979,3578757006,27
0,1412,53255,3578756979,3578757008,29
0,1412,53256,3578756979,3578757009,30
0,1412,53257,3578756979,3578757009,30
0,1412,53258,3578756979,3578757010,31
0,1412,53259,3578756979,3578757010,31
0,1412,53260,3578756979,3578757012,33
0,1412,53261,3578756979,3578757012,33
0,1412,53262,3578756979,3578757013,34
0,1412,53263,3578756979,3578757013,34
0,1412,53264,3578756979,3578757014,35
0,1412,53265,3578756979,3578757014,35
0,1412,53266,3578756979,3578757015,36
0,1412,53267,3578756979,3578757016,37
0,1412,53268,3578756979,3578757016,37
0,1412,53269,3578756979,3578757017,38
0,1412,53270,3578756979,3578757017,38
0,1412,53271,3578756979,3578757018,39
0,1412,53272,3578756979,3578757018,39
0,1412,53273,3578756979,3578757018,39
0,1412,53274,3578756979,3578757019,40
0,1412,53275,3578756979,3578757020,41
0,1412,53276,3578756979,3578757021,42
0,1412,53277,3578756979,3578757022,43
0,1412,53278,3578756979,3578757023,44
0,1412,53279,3578756979,3578757024,45
0,1412,53280,3578756979,3578757025,46
0,1412,53281,3578756979,3578757026,47
0,1412,53282,3578756979,3578757027,48
0,1412,53283,3578756979,3578757027,48
0,1412,53284,3578756979,3578757028,49
0,1412,53285,3578756979,3578757028,49
0,1412,53286,3578756979,3578757028,49
0,1413,53287,3578757043,3578757043,0
0,1413,53288,3578757043,3578757043,0
0,1413,53289,3578757043,3578757043,0
0,1413,53290,3578757043,3578757043,0
0,1413,53291,3578757043,3578757043,0
0,1413,53292,3578757043,3578757043,0
0,1413,53293,3578757043,3578757043,0
0,1413,53294,3578757043,3578757043,0
0,1413,53295,3578757043,3578757043,0
0,1413,53296,3578757043,3578757043,0
0,1413,53297,3578757043,3578757043,0
0,1413,53298,3578757043,3578757043,0
0,1413,53299,3578757043,3578757043,0
0,1413,53300,3578757043,3578757043,0
0,1413,53301,3578757043,3578757043,0
0,1413,53302,3578757043,3578757043,0
0,1413,53303,3578757043,3578757043,0
0,1413,53304,3578757043,3578757043,0
0,1413,53305,3578757043,3578757043,0
0,1413,53306,3578757043,3578757043,0
0,1413,53307,3578757043,3578757044,1
0,1413,53308,3578757043,3578757044,1
0,1413,53309,3578757043,3578757045,2
0,1413,53310,3578757043,3578757046,3
0,1413,53311,3578757043,3578757048,5
0,1413,53312,3578757043,3578757048,5
0,1413,53313,3578757043,3578757049,6
0,1413,53314,3578757043,3578757049,6
0,1413,53315,3578757043,3578757050,7
0,1413,53316,3578757043,3578757050,7
0,1413,53317,3578757043,3578757050,7
0,1413,53318,3578757043,3578757051,8
0,1413,53319,3578757043,3578757052,9
0,1413,53320,3578757043,3578757054,11
0,1413,53321,3578757043,3578757056,13
0,1413,53322,3578757043,3578757056,13
0,1413,53323,3578757043,3578757056,13
0,1413,53324,3578757043,3578757056,13
0,1413,53325,3578757043,3578757057,14
0,1413,53326,3578757043,3578757058,15
0,1413,53327,3578757043,3578757058,15
0,1413,53328,3578757043,3578757059,16
0,1413,53329,3578757043,3578757061,18
0,1413,53330,3578757043,3578757062,19
0,1413,53331,3578757043,3578757062,19
0,1413,53332,3578757043,3578757064,21
0,1413,53333,3578757043,3578757064,21
0,1413,53334,3578757043,3578757065,22
0,1413,53335,3578757043,3578757066,23
0,1413,53336,3578757043,3578757066,23
0,1413,53337,3578757043,3578757066,23
0,1413,53338,3578757043,3578757067,24
0,1413,53339,3578757043,3578757070,27
0,1413,53340,3578757043,3578757081,38
0,1413,53341,3578757043,3578757081,38
0,1413,53342,3578757043,3578757082,39
0,1413,53343,3578757043,3578757082,39
0,1413,53344,3578757043,3578757084,41
0,1413,53345,3578757043,3578757084,41
0,1413,53346,3578757043,3578757086,43
0,1413,53347,3578757043,3578757087,44
0,1413,53348,3578757043,3578757087,44
0,1413,53349,3578757043,3578757088,45
0,1413,53350,3578757043,3578757088,45
0,1413,53351,3578757043,3578757089,46
0,1413,53352,3578757043,3578757089,46
0,1413,53353,3578757043,3578757089,46
0,1413,53354,3578757043,3578757090,47
0,1413,53355,3578757043,3578757090,47
0,1413,53356,3578757043,3578757091,48
0,1413,53357,3578757043,3578757091,48
0,1413,53358,3578757043,3578757091,48
0,1413,53359,3578757043,3578757092,49
0,1414,53360,3578757104,3578757104,0
0,1414,53361,3578757104,3578757104,0
0,1414,53362,3578757104,3578757104,0
0,1414,53363,3578757104,3578757104,0
0,1414,53364,3578757104,3578757104,0
0,1414,53365,3578757104,3578757104,0
0,1414,53366,3578757104,3578757104,0
0,1414,53367,3578757104,3578757104,0
0,1414,53368,3578757104,3578757104,0
0,1414,53369,3578757104,3578757104,0
0,1414,53370,3578757104,3578757104,0
0,1414,53371,3578757104,3578757104,0
0,1414,53372,3578757104,3578757104,0
0,1414,53373,3578757104,3578757104,0
0,1414,53374,3578757104,3578757104,0
0,1414,53375,3578757104,3578757106,2
0,1414,53376,3578757104,3578757107,3
0,1414,53377,3578757104,3578757107,3
0,1414,53378,3578757104,3578757107,3
0,1414,53379,3578757104,3578757108,4
0,1414,53380,3578757104,3578757109,5
0,1414,53381,3578757104,3578757110,6
0,1414,53382,3578757104,3578757110,6
0,1414,53383,3578757104,3578757110,6
0,1414,53384,3578757104,3578757110,6
0,1414,53385,3578757104,3578757110,6
0,1414,53386,3578757104,3578757112,8
0,1414,53387,3578757104,3578757112,8
0,1414,53388,3578757104,3578757112,8
0,1414,53389,3578757104,3578757113,9
0,1414,53390,3578757104,3578757113,9
0,1414,53391,3578757104,3578757114,10
0,1414,53392,3578757104,3578757115,11
0,1414,53393,3578757104,3578757115,11
0,1414,53394,3578757104,3578757116,12
0,1414,53395,3578757104,3578757116,12
0,1414,53396,3578757104,3578757116,12
0,1414,53397,3578757104,3578757117,13
0,1414,53398,3578757104,3578757117,13
0,1414,53399,3578757104,3578757117,13
0,1414,53400,3578757104,3578757117,13
0,1414,53401,3578757104,3578757118,14
0,1414,53402,3578757104,3578757118,14
0,1414,53403,3578757104,3578757118,14
0,1414,53404,3578757104,3578757118,14
0,1414,53405,3578757104,3578757118,14
0,1414,53406,3578757104,3578757119,15
0,1414,53407,3578757104,3578757119,15
0,1414,53408,3578757104,3578757119,15
0,1414,53409,3578757104,3578757119,15
0,1414,53410,3578757104,3578757120,16
0,1414,53411,3578757104,3578757120,16
0,1414,53412,3578757104,3578757120,16
0,1414,53413,3578757104,3578757121,17
0,1414,53414,3578757104,3578757122,18
0,1414,53415,3578757104,3578757123,19
0,1414,53416,3578757104,3578757123,19
0,1414,53417,3578757104,3578757123,19
0,1414,53418,3578757104,3578757124,20
0,1414,53419,3578757104,3578757124,20
0,1414,53420,3578757104,3578757125,21
0,1414,53421,3578757104,3578757125,21
0,1414,53422,3578757104,3578757125,21
0,1414,53423,3578757104,3578757126,22
0,1414,53424,3578757104,3578757127,23
0,1414,53425,3578757104,3578757127,23
0,1414,53426,3578757104,3578757127,23
0,1414,53427,3578757104,3578757128,24
0,1414,53428,3578757104,3578757128,24
0,1414,53429,3578757104,3578757128,24
0,1414,53430,3578757104,3578757130,26
0,1414,53431,3578757104,3578757130,26
0,1414,53432,3578757104,3578757130,26
0,1414,53433,3578757104,3578757130,26
0,1414,53434,3578757104,3578757131,27
0,1414,53435,3578757104,3578757131,27
0,1414,53436,3578757104,3578757131,27
0,1414,53437,3578757104,3578757131,27
0,1414,53438,3578757104,3578757132,28
0,1414,53439,3578757104,3578757132,28
0,1414,53440,3578757104,3578757132,28
0,1414,53441,3578757104,3578757132,28
0,1414,53442,3578757104,3578757133,29
0,1414,53443,3578757104,3578757133,29
0,1414,53444,3578757104,3578757134,30
0,1414,53445,3578757104,3578757134,30
0,1414,53446,3578757104,3578757135,31
0,1414,53447,3578757104,3578757136,32
0,1414,53448,3578757104,3578757139,35
0,1414,53449,3578757104,3578757139,35
0,1414,53450,3578757104,3578757139,35
0,1414,53451,3578757104,3578757140,36
0,1414,53452,3578757104,3578757140,36
0,1414,53453,3578757104,3578757140,36
0,1414,53454,3578757104,3578757140,36
0,1414,53455,3578757104,3578757141,37
0,1414,53456,3578757104,3578757142,38
0,1414,53457,3578757104,3578757142,38
0,1414,53458,3578757104,3578757142,38
0,1414,53459,3578757104,3578757143,39
0,1414,53460,3578757104,3578757143,39
0,1414,53461,3578757104,3578757144,40
0,1414,53462,3578757104,3578757144,40
0,1414,53463,3578757104,3578757145,41
0,1414,53464,3578757104,3578757147,43
0,1414,53465,3578757104,3578757147,43
0,1414,53466,3578757104,3578757148,44
0,1414,53467,3578757104,3578757148,44
0,1414,53468,3578757104,3578757150,46
0,1414,53469,3578757104,3578757151,47
0,1414,53470,3578757104,3578757152,48
0,1414,53471,3578757104,3578757153,49
0,1414,53472,3578757104,3578757153,49
0,1414,53473,3578757104,3578757153,49
0,1414,53474,3578757104,3578757154,50
0,1415,53475,3578757168,3578757168,0
0,1415,53476,3578757168,3578757168,0
0,1415,53477,3578757168,3578757168,0
0,1415,53478,3578757168,3578757168,0
0,1415,53479,3578757168,3578757168,0
0,1415,53480,3578757168,3578757168,0
0,1415,53481,3578757168,3578757168,0
0,1415,53482,3578757168,3578757168,0
0,1415,53483,3578757168,3578757168,0
0,1415,53484,3578757168,3578757168,0
0,1415,53485,3578757168,3578757168,0
0,1415,53486,3578757168,3578757168,0
0,1415,53487,3578757168,3578757168,0
0,1415,53488,3578757168,3578757168,0
0,1415,53489,3578757168,3578757168,0
0,1415,53490,3578757168,3578757168,0
0,1415,53491,3578757168,3578757168,0
0,1415,53492,3578757168,3578757168,0
0,1415,53493,3578757168,3578757168,0
0,1415,53494,3578757168,3578757168,0
0,1415,53495,3578757168,3578757168,0
0,1415,53496,3578757168,3578757168,0
0,1415,53497,3578757168,3578757168,0
0,1415,53498,3578757168,3578757170,2
0,1415,53499,3578757168,3578757171,3
0,1415,53500,3578757168,3578757171,3
0,1415,53501,3578757168,3578757173,5
0,1415,53502,3578757168,3578757173,5
0,1415,53503,3578757168,3578757174,6
0,1415,53504,3578757168,3578757174,6
0,1415,53505,3578757168,3578757174,6
0,1415,53506,3578757168,3578757175,7
0,1415,53507,3578757168,3578757176,8
0,1415,53508,3578757168,3578757178,10
0,1415,53509,3578757168,3578757179,11
0,1415,53510,3578757168,3578757179,11
0,1415,53511,3578757168,3578757179,11
0,1415,53512,3578757168,3578757181,13
0,1415,53513,3578757168,3578757182,14
0,1415,53514,3578757168,3578757183,15
0,1415,53515,3578757168,3578757184,16
0,1415,53516,3578757168,3578757184,16
0,1415,53517,3578757168,3578757185,17
0,1415,53518,3578757168,3578757186,18
0,1415,53519,3578757168,3578757187,19
0,1415,53520,3578757168,3578757187,19
0,1415,53521,3578757168,3578757189,21
0,1415,53522,3578757168,3578757191,23
0,1415,53523,3578757168,3578757191,23
0,1415,53524,3578757168,3578757192,24
0,1415,53525,3578757168,3578757193,25
0,1415,53526,3578757168,3578757194,26
0,1415,53527,3578757168,3578757195,27
0,1415,53528,3578757168,3578757197,29
0,1415,53529,3578757168,3578757197,29
0,1415,53530,3578757168,3578757198,30
0,1415,53531,3578757168,3578757199,31
0,1415,53532,3578757168,3578757199,31
0,1415,53533,3578757168,3578757200,32
0,1415,53534,3578757168,3578757201,33
0,1415,53535,3578757168,3578757202,34
0,1415,53536,3578757168,3578757203,35
0,1415,53537,3578757168,3578757204,36
0,1415,53538,3578757168,3578757205,37
0,1415,53539,3578757168,3578757205,37
0,1415,53540,3578757168,3578757205,37
0,1415,53541,3578757168,3578757206,38
0,1415,53542,3578757168,3578757209,41
0,1415,53543,3578757168,3578757209,41
0,1415,53544,3578757168,3578757210,42
0,1415,53545,3578757168,3578757210,42
0,1415,53546,3578757168,3578757212,44
0,1415,53547,3578757168,3578757213,45
0,1415,53548,3578757168,3578757213,45
0,1415,53549,3578757168,3578757213,45
0,1415,53550,3578757168,3578757214,46
0,1415,53551,3578757168,3578757215,47
0,1415,53552,3578757168,3578757215,47
0,1415,53553,3578757168,3578757215,47
0,1415,53554,3578757168,3578757215,47
0,1415,53555,3578757168,3578757215,47
0,1415,53556,3578757168,3578757217,49
0,1415,53557,3578757168,3578757217,49
0,1415,53558,3578757168,3578757218,50
0,1416,53559,3578757231,3578757231,0
0,1416,53560,3578757231,3578757231,0
0,1416,53561,3578757231,3578757231,0
0,1416,53562,3578757231,3578757231,0
0,1416,53563,3578757231,3578757231,0
0,1416,53564,3578757231,3578757231,0
0,1416,53565,3578757231,3578757231,0
0,1416,53566,3578757231,3578757231,0
0,1416,53567,3578757231,3578757231,0
0,1416,53568,3578757231,3578757231,0
0,1416,53569,3578757231,3578757231,0
0,1416,53570,3578757231,3578757231,0
0,1416,53571,3578757231,3578757231,0
0,1416,53572,3578757231,3578757231,0
0,1416,53573,3578757231,3578757231,0
0,1416,53574,3578757231,3578757231,0
0,1416,53575,3578757231,3578757231,0
0,1416,53576,3578757231,3578757231,0
0,1416,53577,3578757231,3578757231,0
0,1416,53578,3578757231,3578757231,0
0,1416,53579,3578757231,3578757231,0
0,1416,53580,3578757231,3578757233,2
0,1416,53581,3578757231,3578757233,2
0,1416,53582,3578757231,3578757234,3
0,1416,53583,3578757231,3578757236,5
0,1416,53584,3578757231,3578757237,6
0,1416,53585,3578757231,3578757238,7
0,1416,53586,3578757231,3578757238,7
0,1416,53587,3578757231,3578757238,7
0,1416,53588,3578757231,3578757239,8
0,1416,53589,3578757231,3578757239,8
0,1416,53590,3578757231,3578757239,8
0,1416,53591,3578757231,3578757241,10
0,1416,53592,3578757231,3578757241,10
0,1416,53593,3578757231,3578757241,10
0,1416,53594,3578757231,3578757242,11
0,1416,53595,3578757231,3578757243,12
0,1416,53596,3578757231,3578757243,12
0,1416,53597,3578757231,3578757244,13
0,1416,53598,3578757231,3578757244,13
0,1416,53599,3578757231,3578757245,14
0,1416,53600,3578757231,3578757245,14
0,1416,53601,3578757231,3578757248,17
0,1416,53602,3578757231,3578757248,17
0,1416,53603,3578757231,3578757249,18
0,1416,53604,3578757231,3578757249,18
0,1416,53605,3578757231,3578757249,18
0,1416,53606,3578757231,3578757250,19
0,1416,53607,3578757231,3578757250,19
0,1416,53608,3578757231,3578757251,20
0,1416,53609,3578757231,3578757253,22
0,1416,53610,3578757231,3578757254,23
0,1416,53611,3578757231,3578757256,25
0,1416,53612,3578757231,3578757256,25
0,1416,53613,3578757231,3578757256,25
0,1416,53614,3578757231,3578757257,26
0,1416,53615,3578757231,3578757259,28
0,1416,53616,3578757231,3578757260,29
0,1416,53617,3578757231,3578757262,31
0,1416,53618,3578757231,3578757262,31
0,1416,53619,3578757231,3578757265,34
0,1416,53620,3578757231,3578757265,34
0,1416,53621,3578757231,3578757267,36
0,1416,53622,3578757231,3578757267,36
0,1416,53623,3578757231,3578757267,36
0,1416,53624,3578757231,3578757267,36
0,1416,53625,3578757231,3578757268,37
0,1416,53626,3578757231,3578757270,39
0,1416,53627,3578757231,3578757281,50
0,1417,53628,3578757294,3578757294,0
0,1417,53629,3578757294,3578757294,0
0,1417,53630,3578757294,3578757294,0
0,1417,53631,3578757294,3578757294,0
0,1417,53632,3578757294,3578757294,0
0,1417,53633,3578757294,3578757294,0
0,1417,53634,3578757294,3578757294,0
0,1417,53635,3578757294,3578757294,0
0,1417,53636,3578757294,3578757294,0
0,1417,53637,3578757294,3578757294,0
0,1417,53638,3578757294,3578757294,0
0,1417,53639,3578757294,3578757294,0
0,1417,53640,3578757294,3578757294,0
0,1417,53641,3578757294,3578757294,0
0,1417,53642,3578757294,3578757294,0
0,1417,53643,3578757294,3578757294,0
0,1417,53644,3578757294,3578757294,0
0,1417,53645,3578757294,3578757294,0
0,1417,53646,3578757294,3578757294,0
0,1417,53647,3578757294,3578757294,0
0,1417,53648,3578757294,3578757294,0
0,1417,53649,3578757294,3578757295,1
0,1417,53650,3578757294,3578757296,2
0,1417,53651,3578757294,3578757296,2
0,1417,53652,3578757294,3578757296,2
0,1417,53653,3578757294,3578757298,4
0,1417,53654,3578757294,3578757298,4
0,1417,53655,3578757294,3578757298,4
0,1417,53656,3578757294,3578757299,5
0,1417,53657,3578757294,3578757299,5
0,1417,53658,3578757294,3578757300,6
0,1417,53659,3578757294,3578757300,6
0,1417,53660,3578757294,3578757300,6
0,1417,53661,3578757294,3578757301,7
0,1417,53662,3578757294,3578757304,10
0,1417,53663,3578757294,3578757305,11
0,1417,53664,3578757294,3578757305,11
0,1417,53665,3578757294,3578757306,12
0,1417,53666,3578757294,3578757307,13
0,1417,53667,3578757294,3578757307,13
0,1417,53668,3578757294,3578757308,14
0,1417,53669,3578757294,3578757308,14
0,1417,53670,3578757294,3578757308,14
0,1417,53671,3578757294,3578757309,15
0,1417,53672,3578757294,3578757309,15
0,1417,53673,3578757294,3578757309,15
0,1417,53674,3578757294,3578757310,16
0,1417,53675,3578757294,3578757310,16
0,1417,53676,3578757294,3578757310,16
0,1417,53677,3578757294,3578757310,16
0,1417,53678,3578757294,3578757311,17
0,1417,53679,3578757294,3578757311,17
0,1417,53680,3578757294,3578757312,18
0,1417,53681,3578757294,3578757313,19
0,1417,53682,3578757294,3578757313,19
0,1417,53683,3578757294,3578757314,20
0,1417,53684,3578757294,3578757314,20
0,1417,53685,3578757294,3578757314,20
0,1417,53686,3578757294,3578757315,21
0,1417,53687,3578757294,3578757316,22
0,1417,53688,3578757294,3578757316,22
0,1417,53689,3578757294,3578757316,22
0,1417,53690,3578757294,3578757317,23
0,1417,53691,3578757294,3578757317,23
0,1417,53692,3578757294,3578757317,23
0,1417,53693,3578757294,3578757318,24
0,1417,53694,3578757294,3578757318,24
0,1417,53695,3578757294,3578757318,24
0,1417,53696,3578757294,3578757318,24
0,1417,53697,3578757294,3578757318,24
0,1417,53698,3578757294,3578757319,25
0,1417,53699,3578757294,3578757319,25
0,1417,53700,3578757294,3578757319,25
0,1417,53701,3578757294,3578757319,25
0,1417,53702,3578757294,3578757319,25
0,1417,53703,3578757294,3578757320,26
0,1417,53704,3578757294,3578757320,26
0,1417,53705,3578757294,3578757322,28
0,1417,53706,3578757294,3578757323,29
0,1417,53707,3578757294,3578757323,29
0,1417,53708,3578757294,3578757323,29
0,1417,53709,3578757294,3578757323,29
0,1417,53710,3578757294,3578757324,30
0,1417,53711,3578757294,3578757325,31
0,1417,53712,3578757294,3578757325,31
0,1417,53713,3578757294,3578757325,31
0,1417,53714,3578757294,3578757326,32
0,1417,53715,3578757294,3578757327,33
0,1417,53716,3578757294,3578757327,33
0,1417,53717,3578757294,3578757328,34
0,1417,53718,3578757294,3578757328,34
0,1417,53719,3578757294,3578757328,34
0,1417,53720,3578757294,3578757328,34
0,1417,53721,3578757294,3578757328,34
0,1417,53722,3578757294,3578757329,35
0,1417,53723,3578757294,3578757330,36
0,1417,53724,3578757294,3578757330,36
0,1417,53725,3578757294,3578757330,36
0,1417,53726,3578757294,3578757330,36
0,1417,53727,3578757294,3578757330,36
0,1417,53728,3578757294,3578757331,37
0,1417,53729,3578757294,3578757331,37
0,1417,53730,3578757294,3578757331,37
0,1417,53731,3578757294,3578757331,37
0,1417,53732,3578757294,3578757332,38
0,1417,53733,3578757294,3578757332,38
0,1417,53734,3578757294,3578757333,39
0,1417,53735,3578757294,3578757333,39
0,1417,53736,3578757294,3578757333,39
0,1417,53737,3578757294,3578757335,41
0,1417,53738,3578757294,3578757335,41
0,1417,53739,3578757294,3578757335,41
0,1417,53740,3578757294,3578757336,42
0,1417,53741,3578757294,3578757339,45
0,1417,53742,3578757294,3578757339,45
0,1417,53743,3578757294,3578757340,46
0,1417,53744,3578757294,3578757340,46
0,1417,53745,3578757294,3578757341,47
0,1417,53746,3578757294,3578757341,47
0,1417,53747,3578757294,3578757341,47
0,1417,53748,3578757294,3578757343,49
0,1417,53749,3578757294,3578757343,49
0,1417,53750,3578757294,3578757343,49
0,1417,53751,3578757294,3578757343,49
0,1417,53752,3578757294,3578757344,50
0,1418,53753,3578757357,3578757357,0
0,1418,53754,3578757357,3578757357,0
0,1418,53755,3578757357,3578757357,0
0,1418,53756,3578757357,3578757357,0
0,1418,53757,3578757357,3578757357,0
0,1418,53758,3578757357,3578757357,0
0,1418,53759,3578757357,3578757357,0
0,1418,53760,3578757357,3578757357,0
0,1418,53761,3578757357,3578757357,0
0,1418,53762,3578757357,3578757357,0
0,1418,53763,3578757357,3578757357,0
0,1418,53764,3578757357,3578757357,0
0,1418,53765,3578757357,3578757357,0
0,1418,53766,3578757357,3578757357,0
0,1418,53767,3578757357,3578757357,0
0,1418,53768,3578757357,3578757357,0
0,1418,53769,3578757357,3578757358,1
0,1418,53770,3578757357,3578757358,1
0,1418,53771,3578757357,3578757359,2
0,1418,53772,3578757357,3578757359,2
0,1418,53773,3578757357,3578757360,3
0,1418,53774,3578757357,3578757360,3
0,1418,53775,3578757357,3578757361,4
0,1418,53776,3578757357,3578757362,5
0,1418,53777,3578757357,3578757362,5
0,1418,53778,3578757357,3578757362,5
0,1418,53779,3578757357,3578757362,5
0,1418,53780,3578757357,3578757363,6
0,1418,53781,3578757357,3578757364,7
0,1418,53782,3578757357,3578757365,8
0,1418,53783,3578757357,3578757366,9
0,1418,53784,3578757357,3578757366,9
0,1418,53785,3578757357,3578757368,11
0,1418,53786,3578757357,3578757369,12
0,1418,53787,3578757357,3578757371,14
0,1418,53788,3578757357,3578757371,14
0,1418,53789,3578757357,3578757373,16
0,1418,53790,3578757357,3578757373,16
0,1418,53791,3578757357,3578757373,16
0,1418,53792,3578757357,3578757374,17
0,1418,53793,3578757357,3578757374,17
0,1418,53794,3578757357,3578757375,18
0,1418,53795,3578757357,3578757376,19
0,1418,53796,3578757357,3578757378,21
0,1418,53797,3578757357,3578757378,21
0,1418,53798,3578757357,3578757379,22
0,1418,53799,3578757357,3578757379,22
0,1418,53800,3578757357,3578757381,24
0,1418,53801,3578757357,3578757381,24
0,1418,53802,3578757357,3578757381,24
0,1418,53803,3578757357,3578757382,25
0,1418,53804,3578757357,3578757384,27
0,1418,53805,3578757357,3578757385,28
0,1418,53806,3578757357,3578757385,28
0,1418,53807,3578757357,3578757387,30
0,1418,53808,3578757357,3578757387,30
0,1418,53809,3578757357,3578757389,32
0,1418,53810,3578757357,3578757389,32
0,1418,53811,3578757357,3578757390,33
0,1418,53812,3578757357,3578757391,34
0,1418,53813,3578757357,3578757391,34
0,1418,53814,3578757357,3578757391,34
0,1418,53815,3578757357,3578757393,36
0,1418,53816,3578757357,3578757393,36
0,1418,53817,3578757357,3578757394,37
0,1418,53818,3578757357,3578757395,38
0,1418,53819,3578757357,3578757397,40
0,1418,53820,3578757357,3578757398,41
0,1418,53821,3578757357,3578757398,41
0,1418,53822,3578757357,3578757399,42
0,1418,53823,3578757357,3578757401,44
0,1418,53824,3578757357,3578757401,44
0,1418,53825,3578757357,3578757402,45
0,1418,53826,3578757357,3578757404,47
0,1418,53827,3578757357,3578757404,47
0,1418,53828,3578757357,3578757405,48
0,1418,53829,3578757357,3578757406,49
0,1418,53830,3578757357,3578757406,49
0,1418,53831,3578757357,3578757406,49
0,1418,53832,3578757357,3578757406,49
0,1419,53833,3578757422,3578757422,0
0,1419,53834,3578757422,3578757422,0
0,1419,53835,3578757422,3578757422,0
0,1419,53836,3578757422,3578757422,0
0,1419,53837,3578757422,3578757422,0
0,1419,53838,3578757422,3578757422,0
0,1419,53839,3578757422,3578757422,0
0,1419,53840,3578757422,3578757422,0
0,1419,53841,3578757422,3578757422,0
0,1419,53842,3578757422,3578757422,0
0,1419,53843,3578757422,3578757422,0
0,1419,53844,3578757422,3578757422,0
0,1419,53845,3578757422,3578757422,0
0,1419,53846,3578757422,3578757422,0
0,1419,53847,3578757422,3578757422,0
0,1419,53848,3578757422,3578757422,0
0,1419,53849,3578757422,3578757422,0
0,1419,53850,3578757422,3578757422,0
0,1419,53851,3578757422,3578757422,0
0,1419,53852,3578757422,3578757422,0
0,1419,53853,3578757422,3578757422,0
0,1419,53854,3578757422,3578757423,1
0,1419,53855,3578757422,3578757424,2
0,1419,53856,3578757422,3578757425,3
0,1419,53857,3578757422,3578757426,4
0,1419,53858,3578757422,3578757427,5
0,1419,53859,3578757422,3578757428,6
0,1419,53860,3578757422,3578757428,6
0,1419,53861,3578757422,3578757428,6
0,1419,53862,3578757422,3578757429,7
0,1419,53863,3578757422,3578757430,8
0,1419,53864,3578757422,3578757430,8
0,1419,53865,3578757422,3578757431,9
0,1419,53866,3578757422,3578757431,9
0,1419,53867,3578757422,3578757431,9
0,1419,53868,3578757422,3578757432,10
0,1419,53869,3578757422,3578757433,11
0,1419,53870,3578757422,3578757433,11
0,1419,53871,3578757422,3578757434,12
0,1419,53872,3578757422,3578757435,13
0,1419,53873,3578757422,3578757437,15
0,1419,53874,3578757422,3578757437,15
0,1419,53875,3578757422,3578757439,17
0,1419,53876,3578757422,3578757439,17
0,1419,53877,3578757422,3578757440,18
0,1419,53878,3578757422,3578757440,18
0,1419,53879,3578757422,3578757441,19
0,1419,53880,3578757422,3578757441,19
0,1419,53881,3578757422,3578757442,20
0,1419,53882,3578757422,3578757442,20
0,1419,53883,3578757422,3578757443,21
0,1419,53884,3578757422,3578757444,22
0,1419,53885,3578757422,3578757444,22
0,1419,53886,3578757422,3578757444,22
0,1419,53887,3578757422,3578757445,23
0,1419,53888,3578757422,3578757446,24
0,1419,53889,3578757422,3578757448,26
0,1419,53890,3578757422,3578757448,26
0,1419,53891,3578757422,3578757449,27
0,1419,53892,3578757422,3578757449,27
0,1419,53893,3578757422,3578757449,27
0,1419,53894,3578757422,3578757450,28
0,1419,53895,3578757422,3578757450,28
0,1419,53896,3578757422,3578757450,28
0,1419,53897,3578757422,3578757450,28
0,1419,53898,3578757422,3578757451,29
0,1419,53899,3578757422,3578757453,31
0,1419,53900,3578757422,3578757457,35
0,1419,53901,3578757422,3578757457,35
0,1419,53902,3578757422,3578757458,36
0,1419,53903,3578757422,3578757458,36
0,1419,53904,3578757422,3578757459,37
0,1419,53905,3578757422,3578757460,38
0,1419,53906,3578757422,3578757461,39
0,1419,53907,3578757422,3578757461,39
0,1419,53908,3578757422,3578757462,40
0,1419,53909,3578757422,3578757464,42
0,1419,53910,3578757422,3578757465,43
0,1419,53911,3578757422,3578757465,43
0,1419,53912,3578757422,3578757465,43
0,1419,53913,3578757422,3578757466,44
0,1419,53914,3578757422,3578757467,45
0,1419,53915,3578757422,3578757467,45
0,1419,53916,3578757422,3578757467,45
0,1419,53917,3578757422,3578757468,46
0,1419,53918,3578757422,3578757469,47
0,1419,53919,3578757422,3578757470,48
0,1420,53920,3578757487,3578757487,0
0,1420,53921,3578757487,3578757487,0
0,1420,53922,3578757487,3578757487,0
0,1420,53923,3578757487,3578757487,0
0,1420,53924,3578757487,3578757487,0
0,1420,53925,3578757487,3578757487,0
0,1420,53926,3578757487,3578757488,1
0,1420,53927,3578757487,3578757488,1
0,1420,53928,3578757487,3578757488,1
0,1420,53929,3578757487,3578757489,2
0,1420,53930,3578757487,3578757489,2
0,1420,53931,3578757487,3578757490,3
0,1420,53932,3578757487,3578757490,3
0,1420,53933,3578757487,3578757491,4
0,1420,53934,3578757487,3578757491,4
0,1420,53935,3578757487,3578757491,4
0,1420,53936,3578757487,3578757494,7
0,1420,53937,3578757487,3578757494,7
0,1420,53938,3578757487,3578757494,7
0,1420,53939,3578757487,3578757494,7
0,1420,53940,3578757487,3578757495,8
0,1420,53941,3578757487,3578757496,9
0,1420,53942,3578757487,3578757497,10
0,1420,53943,3578757487,3578757497,10
0,1420,53944,3578757487,3578757499,12
0,1420,53945,3578757487,3578757499,12
0,1420,53946,3578757487,3578757499,12
0,1420,53947,3578757487,3578757500,13
0,1420,53948,3578757487,3578757501,14
0,1420,53949,3578757487,3578757503,16
0,1420,53950,3578757487,3578757504,17
0,1420,53951,3578757487,3578757505,18
0,1420,53952,3578757487,3578757506,19
0,1420,53953,3578757487,3578757507,20
0,1420,53954,3578757487,3578757507,20
0,1420,53955,3578757487,3578757507,20
0,1420,53956,3578757487,3578757507,20
0,1420,53957,3578757487,3578757508,21
0,1420,53958,3578757487,3578757508,21
0,1420,53959,3578757487,3578757508,21
0,1420,53960,3578757487,3578757509,22
0,1420,53961,3578757487,3578757509,22
0,1420,53962,3578757487,3578757509,22
0,1420,53963,3578757487,3578757509,22
0,1420,53964,3578757487,3578757511,24
0,1420,53965,3578757487,3578757511,24
0,1420,53966,3578757487,3578757512,25
0,1420,53967,3578757487,3578757512,25
0,1420,53968,3578757487,3578757512,25
0,1420,53969,3578757487,3578757513,26
0,1420,53970,3578757487,3578757514,27
0,1420,53971,3578757487,3578757514,27
0,1420,53972,3578757487,3578757514,27
0,1420,53973,3578757487,3578757515,28
0,1420,53974,3578757487,3578757515,28
0,1420,53975,3578757487,3578757515,28
0,1420,53976,3578757487,3578757516,29
0,1420,53977,3578757487,3578757516,29
0,1420,53978,3578757487,3578757516,29
0,1420,53979,3578757487,3578757517,30
0,1420,53980,3578757487,3578757517,30
0,1420,53981,3578757487,3578757517,30
0,1420,53982,3578757487,3578757517,30
0,1420,53983,3578757487,3578757517,30
0,1420,53984,3578757487,3578757517,30
0,1420,53985,3578757487,3578757518,31
0,1420,53986,3578757487,3578757518,31
0,1420,53987,3578757487,3578757518,31
0,1420,53988,3578757487,3578757518,31
0,1420,53989,3578757487,3578757518,31
0,1420,53990,3578757487,3578757519,32
0,1420,53991,3578757487,3578757520,33
0,1420,53992,3578757487,3578757522,35
0,1420,53993,3578757487,3578757522,35
0,1420,53994,3578757487,3578757522,35
0,1420,53995,3578757487,3578757522,35
0,1420,53996,3578757487,3578757523,36
0,1420,53997,3578757487,3578757523,36
0,1420,53998,3578757487,3578757524,37
0,1420,53999,3578757487,3578757524,37
0,1420,54000,3578757487,3578757524,37
0,1420,54001,3578757487,3578757525,38
0,1420,54002,3578757487,3578757525,38
0,1420,54003,3578757487,3578757525,38
0,1420,54004,3578757487,3578757525,38
0,1420,54005,3578757487,3578757526,39
0,1420,54006,3578757487,3578757526,39
0,1420,54007,3578757487,3578757527,40
0,1420,54008,3578757487,3578757527,40
0,1420,54009,3578757487,3578757528,41
0,1420,54010,3578757487,3578757529,42
0,1420,54011,3578757487,3578757529,42
0,1420,54012,3578757487,3578757529,42
0,1420,54013,3578757487,3578757529,42
0,1420,54014,3578757487,3578757529,42
0,1420,54015,3578757487,3578757530,43
0,1420,54016,3578757487,3578757530,43
0,1420,54017,3578757487,3578757531,44
0,1420,54018,3578757487,3578757531,44
0,1420,54019,3578757487,3578757532,45
0,1420,54020,3578757487,3578757532,45
0,1420,54021,3578757487,3578757532,45
0,1420,54022,3578757487,3578757533,46
0,1420,54023,3578757487,3578757533,46
0,1420,54024,3578757487,3578757534,47
0,1420,54025,3578757487,3578757534,47
0,1420,54026,3578757487,3578757535,48
0,1421,54027,3578757551,3578757551,0
0,1421,54028,3578757551,3578757551,0
0,1421,54029,3578757551,3578757551,0
0,1421,54030,3578757551,3578757551,0
0,1421,54031,3578757551,3578757551,0
0,1421,54032,3578757551,3578757551,0
0,1421,54033,3578757551,3578757551,0
0,1421,54034,3578757551,3578757551,0
0,1421,54035,3578757551,3578757551,0
0,1421,54036,3578757551,3578757551,0
0,1421,54037,3578757551,3578757551,0
0,1421,54038,3578757551,3578757551,0
0,1421,54039,3578757551,3578757551,0
0,1421,54040,3578757551,3578757551,0
0,1421,54041,3578757551,3578757551,0
0,1421,54042,3578757551,3578757551,0
0,1421,54043,3578757551,3578757551,0
0,1421,54044,3578757551,3578757551,0
0,1421,54045,3578757551,3578757551,0
0,1421,54046,3578757551,3578757551,0
0,1421,54047,3578757551,3578757551,0
0,1421,54048,3578757551,3578757551,0
0,1421,54049,3578757551,3578757551,0
0,1421,54050,3578757551,3578757551,0
0,1421,54051,3578757551,3578757552,1
0,1421,54052,3578757551,3578757552,1
0,1421,54053,3578757551,3578757552,1
0,1421,54054,3578757551,3578757552,1
0,1421,54055,3578757551,3578757553,2
0,1421,54056,3578757551,3578757553,2
0,1421,54057,3578757551,3578757554,3
0,1421,54058,3578757551,3578757554,3
0,1421,54059,3578757551,3578757555,4
0,1421,54060,3578757551,3578757556,5
0,1421,54061,3578757551,3578757557,6
0,1421,54062,3578757551,3578757558,7
0,1421,54063,3578757551,3578757558,7
0,1421,54064,3578757551,3578757559,8
0,1421,54065,3578757551,3578757560,9
0,1421,54066,3578757551,3578757561,10
0,1421,54067,3578757551,3578757561,10
0,1421,54068,3578757551,3578757561,10
0,1421,54069,3578757551,3578757561,10
0,1421,54070,3578757551,3578757561,10
0,1421,54071,3578757551,3578757562,11
0,1421,54072,3578757551,3578757562,11
0,1421,54073,3578757551,3578757563,12
0,1421,54074,3578757551,3578757564,13
0,1421,54075,3578757551,3578757565,14
0,1421,54076,3578757551,3578757565,14
0,1421,54077,3578757551,3578757565,14
0,1421,54078,3578757551,3578757566,15
0,1421,54079,3578757551,3578757568,17
0,1421,54080,3578757551,3578757570,19
0,1421,54081,3578757551,3578757570,19
0,1421,54082,3578757551,3578757570,19
0,1421,54083,3578757551,3578757573,22
0,1421,54084,3578757551,3578757574,23
0,1421,54085,3578757551,3578757574,23
0,1421,54086,3578757551,3578757574,23
0,1421,54087,3578757551,3578757575,24
0,1421,54088,3578757551,3578757578,27
0,1421,54089,3578757551,3578757580,29
0,1421,54090,3578757551,3578757580,29
0,1421,54091,3578757551,3578757581,30
0,1421,54092,3578757551,3578757581,30
0,1421,54093,3578757551,3578757581,30
0,1421,54094,3578757551,3578757583,32
0,1421,54095,3578757551,3578757585,34
0,1421,54096,3578757551,3578757585,34
0,1421,54097,3578757551,3578757586,35
0,1421,54098,3578757551,3578757588,37
0,1421,54099,3578757551,3578757589,38
0,1421,54100,3578757551,3578757589,38
0,1421,54101,3578757551,3578757589,38
0,1421,54102,3578757551,3578757590,39
0,1421,54103,3578757551,3578757590,39
0,1421,54104,3578757551,3578757590,39
0,1421,54105,3578757551,3578757593,42
0,1421,54106,3578757551,3578757593,42
0,1421,54107,3578757551,3578757595,44
0,1421,54108,3578757551,3578757596,45
0,1421,54109,3578757551,3578757596,45
0,1421,54110,3578757551,3578757597,46
0,1421,54111,3578757551,3578757598,47
0,1421,54112,3578757551,3578757599,48
0,1421,54113,3578757551,3578757600,49
0,1421,54114,3578757551,3578757600,49
0,1421,54115,3578757551,3578757601,50
0,1422,54116,3578757615,3578757615,0
0,1422,54117,3578757615,3578757615,0
0,1422,54118,3578757615,3578757615,0
0,1422,54119,3578757615,3578757615,0
0,1422,54120,3578757615,3578757616,1
0,1422,54121,3578757615,3578757616,1
0,1422,54122,3578757615,3578757616,1
0,1422,54123,3578757615,3578757616,1
0,1422,54124,3578757615,3578757616,1
0,1422,54125,3578757615,3578757616,1
0,1422,54126,3578757615,3578757616,1
0,1422,54127,3578757615,3578757616,1
0,1422,54128,3578757615,3578757616,1
0,1422,54129,3578757615,3578757616,1
0,1422,54130,3578757615,3578757616,1
0,1422,54131,3578757615,3578757616,1
0,1422,54132,3578757615,3578757616,1
0,1422,54133,3578757615,3578757616,1
0,1422,54134,3578757615,3578757616,1
0,1422,54135,3578757615,3578757616,1
0,1422,54136,3578757615,3578757616,1
0,1422,54137,3578757615,3578757616,1
0,1422,54138,3578757615,3578757616,1
0,1422,54139,3578757615,3578757618,3
0,1422,54140,3578757615,3578757618,3
0,1422,54141,3578757615,3578757620,5
0,1422,54142,3578757615,3578757621,6
0,1422,54143,3578757615,3578757622,7
0,1422,54144,3578757615,3578757623,8
0,1422,54145,3578757615,3578757623,8
0,1422,54146,3578757615,3578757624,9
0,1422,54147,3578757615,3578757624,9
0,1422,54148,3578757615,3578757624,9
0,1422,54149,3578757615,3578757626,11
0,1422,54150,3578757615,3578757627,12
0,1422,54151,3578757615,3578757628,13
0,1422,54152,3578757615,3578757629,14
0,1422,54153,3578757615,3578757629,14
0,1422,54154,3578757615,3578757630,15
0,1422,54155,3578757615,3578757630,15
0,1422,54156,3578757615,3578757632,17
0,1422,54157,3578757615,3578757632,17
0,1422,54158,3578757615,3578757633,18
0,1422,54159,3578757615,3578757633,18
0,1422,54160,3578757615,3578757634,19
0,1422,54161,3578757615,3578757636,21
0,1422,54162,3578757615,3578757636,21
0,1422,54163,3578757615,3578757637,22
0,1422,54164,3578757615,3578757637,22
0,1422,54165,3578757615,3578757638,23
0,1422,54166,3578757615,3578757638,23
0,1422,54167,3578757615,3578757639,24
0,1422,54168,3578757615,3578757639,24
0,1422,54169,3578757615,3578757640,25
0,1422,54170,3578757615,3578757640,25
0,1422,54171,3578757615,3578757640,25
0,1422,54172,3578757615,3578757641,26
0,1422,54173,3578757615,3578757643,28
0,1422,54174,3578757615,3578757643,28
0,1422,54175,3578757615,3578757643,28
0,1422,54176,3578757615,3578757643,28
0,1422,54177,3578757615,3578757643,28
0,1422,54178,3578757615,3578757643,28
0,1422,54179,3578757615,3578757647,32
0,1422,54180,3578757615,3578757647,32
0,1422,54181,3578757615,3578757647,32
0,1422,54182,3578757615,3578757647,32
0,1422,54183,3578757615,3578757648,33
0,1422,54184,3578757615,3578757649,34
0,1422,54185,3578757615,3578757649,34
0,1422,54186,3578757615,3578757649,34
0,1422,54187,3578757615,3578757651,36
0,1422,54188,3578757615,3578757651,36
0,1422,54189,3578757615,3578757652,37
0,1422,54190,3578757615,3578757654,39
0,1422,54191,3578757615,3578757655,40
0,1422,54192,3578757615,3578757656,41
0,1422,54193,3578757615,3578757657,42
0,1422,54194,3578757615,3578757659,44
0,1422,54195,3578757615,3578757659,44
0,1422,54196,3578757615,3578757660,45
0,1422,54197,3578757615,3578757661,46
0,1422,54198,3578757615,3578757661,46
0,1422,54199,3578757615,3578757663,48
0,1422,54200,3578757615,3578757664,49
0,1422,54201,3578757615,3578757664,49
0,1422,54202,3578757615,3578757665,50
0,1423,54203,3578757679,3578757679,0
0,1423,54204,3578757679,3578757679,0
0,1423,54205,3578757679,3578757679,0
0,1423,54206,3578757679,3578757679,0
0,1423,54207,3578757679,3578757679,0
0,1423,54208,3578757679,3578757679,0
0,1423,54209,3578757679,3578757679,0
0,1423,54210,3578757679,3578757679,0
0,1423,54211,3578757679,3578757681,2
0,1423,54212,3578757679,3578757682,3
0,1423,54213,3578757679,3578757684,5
0,1423,54214,3578757679,3578757684,5
0,1423,54215,3578757679,3578757685,6
0,1423,54216,3578757679,3578757687,8
0,1423,54217,3578757679,3578757687,8
0,1423,54218,3578757679,3578757687,8
0,1423,54219,3578757679,3578757688,9
0,1423,54220,3578757679,3578757689,10
0,1423,54221,3578757679,3578757689,10
0,1423,54222,3578757679,3578757689,10
0,1423,54223,3578757679,3578757690,11
0,1423,54224,3578757679,3578757690,11
0,1423,54225,3578757679,3578757690,11
0,1423,54226,3578757679,3578757691,12
0,1423,54227,3578757679,3578757691,12
0,1423,54228,3578757679,3578757694,15
0,1423,54229,3578757679,3578757694,15
0,1423,54230,3578757679,3578757694,15
0,1423,54231,3578757679,3578757694,15
0,1423,54232,3578757679,3578757695,16
0,1423,54233,3578757679,3578757695,16
0,1423,54234,3578757679,3578757697,18
0,1423,54235,3578757679,3578757698,19
0,1423,54236,3578757679,3578757699,20
0,1423,54237,3578757679,3578757699,20
0,1423,54238,3578757679,3578757699,20
0,1423,54239,3578757679,3578757699,20
0,1423,54240,3578757679,3578757699,20
0,1423,54241,3578757679,3578757700,21
0,1423,54242,3578757679,3578757703,24
0,1423,54243,3578757679,3578757704,25
0,1423,54244,3578757679,3578757705,26
0,1423,54245,3578757679,3578757706,27
0,1423,54246,3578757679,3578757707,28
0,1423,54247,3578757679,3578757707,28
0,1423,54248,3578757679,3578757707,28
0,1423,54249,3578757679,3578757707,28
0,1423,54250,3578757679,3578757708,29
0,1423,54251,3578757679,3578757708,29
0,1423,54252,3578757679,3578757709,30
0,1423,54253,3578757679,3578757709,30
0,1423,54254,3578757679,3578757709,30
0,1423,54255,3578757679,3578757709,30
0,1423,54256,3578757679,3578757712,33
0,1423,54257,3578757679,3578757712,33
0,1423,54258,3578757679,3578757713,34
0,1423,54259,3578757679,3578757713,34
0,1423,54260,3578757679,3578757713,34
0,1423,54261,3578757679,3578757715,36
0,1423,54262,3578757679,3578757715,36
0,1423,54263,3578757679,3578757715,36
0,1423,54264,3578757679,3578757715,36
0,1423,54265,3578757679,3578757715,36
0,1423,54266,3578757679,3578757716,37
0,1423,54267,3578757679,3578757716,37
0,1423,54268,3578757679,3578757717,38
0,1423,54269,3578757679,3578757717,38
0,1423,54270,3578757679,3578757717,38
0,1423,54271,3578757679,3578757717,38
0,1423,54272,3578757679,3578757717,38
0,1423,54273,3578757679,3578757717,38
0,1423,54274,3578757679,3578757718,39
0,1423,54275,3578757679,3578757718,39
0,1423,54276,3578757679,3578757718,39
0,1423,54277,3578757679,3578757719,40
0,1423,54278,3578757679,3578757720,41
0,1423,54279,3578757679,3578757722,43
0,1423,54280,3578757679,3578757722,43
0,1423,54281,3578757679,3578757722,43
0,1423,54282,3578757679,3578757722,43
0,1423,54283,3578757679,3578757723,44
0,1423,54284,3578757679,3578757723,44
0,1423,54285,3578757679,3578757724,45
0,1423,54286,3578757679,3578757725,46
0,1423,54287,3578757679,3578757725,46
0,1423,54288,3578757679,3578757725,46
0,1423,54289,3578757679,3578757725,46
0,1423,54290,3578757679,3578757726,47
0,1423,54291,3578757679,3578757727,48
0,1423,54292,3578757679,3578757727,48
0,1423,54293,3578757679,3578757727,48
0,1423,54294,3578757679,3578757727,48
0,1423,54295,3578757679,3578757727,48
0,1423,54296,3578757679,3578757728,49
0,1423,54297,3578757679,3578757728,49
0,1423,54298,3578757679,3578757729,50
0,1424,54299,3578757743,3578757743,0
0,1424,54300,3578757743,3578757743,0
0,1424,54301,3578757743,3578757743,0
0,1424,54302,3578757743,3578757743,0
0,1424,54303,3578757743,3578757743,0
0,1424,54304,3578757743,3578757743,0
0,1424,54305,3578757743,3578757743,0
0,1424,54306,3578757743,3578757743,0
0,1424,54307,3578757743,3578757743,0
0,1424,54308,3578757743,3578757743,0
0,1424,54309,3578757743,3578757743,0
0,1424,54310,3578757743,3578757743,0
0,1424,54311,3578757743,3578757743,0
0,1424,54312,3578757743,3578757743,0
0,1424,54313,3578757743,3578757743,0
0,1424,54314,3578757743,3578757743,0
0,1424,54315,3578757743,3578757743,0
0,1424,54316,3578757743,3578757743,0
0,1424,54317,3578757743,3578757743,0
0,1424,54318,3578757743,3578757743,0
0,1424,54319,3578757743,3578757743,0
0,1424,54320,3578757743,3578757743,0
0,1424,54321,3578757743,3578757743,0
0,1424,54322,3578757743,3578757743,0
0,1424,54323,3578757743,3578757743,0
0,1424,54324,3578757743,3578757743,0
0,1424,54325,3578757743,3578757743,0
0,1424,54326,3578757743,3578757743,0
0,1424,54327,3578757743,3578757743,0
0,1424,54328,3578757743,3578757743,0
0,1424,54329,3578757743,3578757743,0
0,1424,54330,3578757743,3578757743,0
0,1424,54331,3578757743,3578757744,1
0,1424,54332,3578757743,3578757744,1
0,1424,54333,3578757743,3578757745,2
0,1424,54334,3578757743,3578757746,3
0,1424,54335,3578757743,3578757746,3
0,1424,54336,3578757743,3578757747,4
0,1424,54337,3578757743,3578757747,4
0,1424,54338,3578757743,3578757748,5
0,1424,54339,3578757743,3578757750,7
0,1424,54340,3578757743,3578757750,7
0,1424,54341,3578757743,3578757751,8
0,1424,54342,3578757743,3578757752,9
0,1424,54343,3578757743,3578757753,10
0,1424,54344,3578757743,3578757753,10
0,1424,54345,3578757743,3578757753,10
0,1424,54346,3578757743,3578757754,11
0,1424,54347,3578757743,3578757754,11
0,1424,54348,3578757743,3578757754,11
0,1424,54349,3578757743,3578757755,12
0,1424,54350,3578757743,3578757756,13
0,1424,54351,3578757743,3578757757,14
0,1424,54352,3578757743,3578757758,15
0,1424,54353,3578757743,3578757758,15
0,1424,54354,3578757743,3578757759,16
0,1424,54355,3578757743,3578757760,17
0,1424,54356,3578757743,3578757760,17
0,1424,54357,3578757743,3578757760,17
0,1424,54358,3578757743,3578757761,18
0,1424,54359,3578757743,3578757761,18
0,1424,54360,3578757743,3578757762,19
0,1424,54361,3578757743,3578757762,19
0,1424,54362,3578757743,3578757762,19
0,1424,54363,3578757743,3578757763,20
0,1424,54364,3578757743,3578757764,21
0,1424,54365,3578757743,3578757764,21
0,1424,54366,3578757743,3578757764,21
0,1424,54367,3578757743,3578757765,22
0,1424,54368,3578757743,3578757766,23
0,1424,54369,3578757743,3578757767,24
0,1424,54370,3578757743,3578757768,25
0,1424,54371,3578757743,3578757769,26
0,1424,54372,3578757743,3578757770,27
0,1424,54373,3578757743,3578757770,27
0,1424,54374,3578757743,3578757773,30
0,1424,54375,3578757743,3578757773,30
0,1424,54376,3578757743,3578757774,31
0,1424,54377,3578757743,3578757774,31
0,1424,54378,3578757743,3578757775,32
0,1424,54379,3578757743,3578757777,34
0,1424,54380,3578757743,3578757778,35
0,1424,54381,3578757743,3578757779,36
0,1424,54382,3578757743,3578757779,36
0,1424,54383,3578757743,3578757780,37
0,1424,54384,3578757743,3578757781,38
0,1424,54385,3578757743,3578757781,38
0,1424,54386,3578757743,3578757781,38
0,1424,54387,3578757743,3578757781,38
0,1424,54388,3578757743,3578757783,40
0,1424,54389,3578757743,3578757784,41
0,1424,54390,3578757743,3578757785,42
0,1424,54391,3578757743,3578757785,42
0,1424,54392,3578757743,3578757786,43
0,1424,54393,3578757743,3578757788,45
0,1424,54394,3578757743,3578757789,46
0,1424,54395,3578757743,3578757790,47
0,1424,54396,3578757743,3578757791,48
0,1424,54397,3578757743,3578757792,49
0,1424,54398,3578757743,3578757793,50
0,1424,54399,3578757743,3578757793,50
0,1425,54400,3578757805,3578757805,0
0,1425,54401,3578757805,3578757805,0
0,1425,54402,3578757805,3578757805,0
0,1425,54403,3578757805,3578757805,0
0,1425,54404,3578757805,3578757805,0
0,1425,54405,3578757805,3578757805,0
0,1425,54406,3578757805,3578757805,0
0,1425,54407,3578757805,3578757805,0
0,1425,54408,3578757805,3578757805,0
0,1425,54409,3578757805,3578757805,0
0,1425,54410,3578757805,3578757805,0
0,1425,54411,3578757805,3578757805,0
0,1425,54412,3578757805,3578757805,0
0,1425,54413,3578757805,3578757805,0
0,1425,54414,3578757805,3578757805,0
0,1425,54415,3578757805,3578757805,0
0,1425,54416,3578757805,3578757805,0
0,1425,54417,3578757805,3578757805,0
0,1425,54418,3578757805,3578757808,3
0,1425,54419,3578757805,3578757808,3
0,1425,54420,3578757805,3578757809,4
0,1425,54421,3578757805,3578757811,6
0,1425,54422,3578757805,3578757811,6
0,1425,54423,3578757805,3578757811,6
0,1425,54424,3578757805,3578757812,7
0,1425,54425,3578757805,3578757812,7
0,1425,54426,3578757805,3578757813,8
0,1425,54427,3578757805,3578757814,9
0,1425,54428,3578757805,3578757814,9
0,1425,54429,3578757805,3578757815,10
0,1425,54430,3578757805,3578757815,10
0,1425,54431,3578757805,3578757815,10
0,1425,54432,3578757805,3578757815,10
0,1425,54433,3578757805,3578757816,11
0,1425,54434,3578757805,3578757817,12
0,1425,54435,3578757805,3578757818,13
0,1425,54436,3578757805,3578757818,13
0,1425,54437,3578757805,3578757819,14
0,1425,54438,3578757805,3578757819,14
0,1425,54439,3578757805,3578757820,15
0,1425,54440,3578757805,3578757822,17
0,1425,54441,3578757805,3578757823,18
0,1425,54442,3578757805,3578757824,19
0,1425,54443,3578757805,3578757824,19
0,1425,54444,3578757805,3578757824,19
0,1425,54445,3578757805,3578757828,23
0,1425,54446,3578757805,3578757828,23
0,1425,54447,3578757805,3578757829,24
0,1425,54448,3578757805,3578757829,24
0,1425,54449,3578757805,3578757829,24
0,1425,54450,3578757805,3578757830,25
0,1425,54451,3578757805,3578757830,25
0,1425,54452,3578757805,3578757831,26
0,1425,54453,3578757805,3578757831,26
0,1425,54454,3578757805,3578757832,27
0,1425,54455,3578757805,3578757833,28
0,1425,54456,3578757805,3578757834,29
0,1425,54457,3578757805,3578757834,29
0,1425,54458,3578757805,3578757836,31
0,1425,54459,3578757805,3578757837,32
0,1425,54460,3578757805,3578757837,32
0,1425,54461,3578757805,3578757838,33
0,1425,54462,3578757805,3578757839,34
0,1425,54463,3578757805,3578757839,34
0,1425,54464,3578757805,3578757839,34
0,1425,54465,3578757805,3578757840,35
0,1425,54466,3578757805,3578757840,35
0,1425,54467,3578757805,3578757842,37
0,1425,54468,3578757805,3578757843,38
0,1425,54469,3578757805,3578757843,38
0,1425,54470,3578757805,3578757844,39
0,1425,54471,3578757805,3578757845,40
0,1425,54472,3578757805,3578757846,41
0,1425,54473,3578757805,3578757847,42
0,1425,54474,3578757805,3578757847,42
0,1425,54475,3578757805,3578757847,42
0,1425,54476,3578757805,3578757848,43
0,1425,54477,3578757805,3578757848,43
0,1425,54478,3578757805,3578757849,44
0,1425,54479,3578757805,3578757849,44
0,1425,54480,3578757805,3578757849,44
0,1425,54481,3578757805,3578757850,45
0,1425,54482,3578757805,3578757850,45
0,1425,54483,3578757805,3578757850,45
0,1425,54484,3578757805,3578757852,47
0,1425,54485,3578757805,3578757852,47
0,1426,54486,3578757868,3578757868,0
0,1426,54487,3578757868,3578757868,0
0,1426,54488,3578757868,3578757868,0
0,1426,54489,3578757868,3578757868,0
0,1426,54490,3578757868,3578757868,0
0,1426,54491,3578757868,3578757868,0
0,1426,54492,3578757868,3578757868,0
0,1426,54493,3578757868,3578757868,0
0,1426,54494,3578757868,3578757868,0
0,1426,54495,3578757868,3578757868,0
0,1426,54496,3578757868,3578757868,0
0,1426,54497,3578757868,3578757868,0
0,1426,54498,3578757868,3578757868,0
0,1426,54499,3578757868,3578757868,0
0,1426,54500,3578757868,3578757868,0
0,1426,54501,3578757868,3578757868,0
0,1426,54502,3578757868,3578757868,0
0,1426,54503,3578757868,3578757880,12
0,1426,54504,3578757868,3578757881,13
0,1426,54505,3578757868,3578757882,14
0,1426,54506,3578757868,3578757884,16
0,1426,54507,3578757868,3578757884,16
0,1426,54508,3578757868,3578757885,17
0,1426,54509,3578757868,3578757887,19
0,1426,54510,3578757868,3578757887,19
0,1426,54511,3578757868,3578757888,20
0,1426,54512,3578757868,3578757889,21
0,1426,54513,3578757868,3578757889,21
0,1426,54514,3578757868,3578757890,22
0,1426,54515,3578757868,3578757890,22
0,1426,54516,3578757868,3578757890,22
0,1426,54517,3578757868,3578757891,23
0,1426,54518,3578757868,3578757891,23
0,1426,54519,3578757868,3578757891,23
0,1426,54520,3578757868,3578757894,26
0,1426,54521,3578757868,3578757894,26
0,1426,54522,3578757868,3578757894,26
0,1426,54523,3578757868,3578757894,26
0,1426,54524,3578757868,3578757895,27
0,1426,54525,3578757868,3578757896,28
0,1426,54526,3578757868,3578757897,29
0,1426,54527,3578757868,3578757898,30
0,1426,54528,3578757868,3578757899,31
0,1426,54529,3578757868,3578757899,31
0,1426,54530,3578757868,3578757899,31
0,1426,54531,3578757868,3578757900,32
0,1426,54532,3578757868,3578757900,32
0,1426,54533,3578757868,3578757901,33
0,1426,54534,3578757868,3578757903,35
0,1426,54535,3578757868,3578757904,36
0,1426,54536,3578757868,3578757905,37
0,1426,54537,3578757868,3578757906,38
0,1426,54538,3578757868,3578757907,39
0,1426,54539,3578757868,3578757907,39
0,1426,54540,3578757868,3578757907,39
0,1426,54541,3578757868,3578757907,39
0,1426,54542,3578757868,3578757908,40
0,1426,54543,3578757868,3578757908,40
0,1426,54544,3578757868,3578757908,40
0,1426,54545,3578757868,3578757908,40
0,1426,54546,3578757868,3578757909,41
0,1426,54547,3578757868,3578757909,41
0,1426,54548,3578757868,3578757911,43
0,1426,54549,3578757868,3578757911,43
0,1426,54550,3578757868,3578757912,44
0,1426,54551,3578757868,3578757912,44
0,1426,54552,3578757868,3578757913,45
0,1426,54553,3578757868,3578757914,46
0,1426,54554,3578757868,3578757915,47
0,1426,54555,3578757868,3578757915,47
0,1426,54556,3578757868,3578757915,47
0,1426,54557,3578757868,3578757915,47
0,1426,54558,3578757868,3578757916,48
0,1426,54559,3578757868,3578757917,49
0,1426,54560,3578757868,3578757917,49
0,1426,54561,3578757868,3578757917,49
0,1426,54562,3578757868,3578757917,49
0,1426,54563,3578757868,3578757917,49
0,1426,54564,3578757868,3578757917,49
0,1426,54565,3578757868,3578757917,49
0,1426,54566,3578757868,3578757918,50
0,1427,54567,3578757931,3578757931,0
0,1427,54568,3578757931,3578757931,0
0,1427,54569,3578757931,3578757931,0
0,1427,54570,3578757931,3578757931,0
0,1427,54571,3578757931,3578757931,0
0,1427,54572,3578757931,3578757931,0
0,1427,54573,3578757931,3578757931,0
0,1427,54574,3578757931,3578757931,0
0,1427,54575,3578757931,3578757931,0
0,1427,54576,3578757931,3578757931,0
0,1427,54577,3578757931,3578757931,0
0,1427,54578,3578757931,3578757931,0
0,1427,54579,3578757931,3578757931,0
0,1427,54580,3578757931,3578757931,0
0,1427,54581,3578757931,3578757931,0
0,1427,54582,3578757931,3578757931,0
0,1427,54583,3578757931,3578757931,0
0,1427,54584,3578757931,3578757931,0
0,1427,54585,3578757931,3578757931,0
0,1427,54586,3578757931,3578757931,0
0,1427,54587,3578757931,3578757931,0
0,1427,54588,3578757931,3578757931,0
0,1427,54589,3578757931,3578757931,0
0,1427,54590,3578757931,3578757931,0
0,1427,54591,3578757931,3578757931,0
0,1427,54592,3578757931,3578757931,0
0,1427,54593,3578757931,3578757931,0
0,1427,54594,3578757931,3578757931,0
0,1427,54595,3578757931,3578757932,1
0,1427,54596,3578757931,3578757932,1
0,1427,54597,3578757931,3578757932,1
0,1427,54598,3578757931,3578757932,1
0,1427,54599,3578757931,3578757932,1
0,1427,54600,3578757931,3578757933,2
0,1427,54601,3578757931,3578757934,3
0,1427,54602,3578757931,3578757934,3
0,1427,54603,3578757931,3578757934,3
0,1427,54604,3578757931,3578757935,4
0,1427,54605,3578757931,3578757938,7
0,1427,54606,3578757931,3578757939,8
0,1427,54607,3578757931,3578757939,8
0,1427,54608,3578757931,3578757940,9
0,1427,54609,3578757931,3578757940,9
0,1427,54610,3578757931,3578757940,9
0,1427,54611,3578757931,3578757941,10
0,1427,54612,3578757931,3578757942,11
0,1427,54613,3578757931,3578757942,11
0,1427,54614,3578757931,3578757942,11
0,1427,54615,3578757931,3578757943,12
0,1427,54616,3578757931,3578757943,12
0,1427,54617,3578757931,3578757944,13
0,1427,54618,3578757931,3578757945,14
0,1427,54619,3578757931,3578757945,14
0,1427,54620,3578757931,3578757946,15
0,1427,54621,3578757931,3578757946,15
0,1427,54622,3578757931,3578757946,15
0,1427,54623,3578757931,3578757948,17
0,1427,54624,3578757931,3578757948,17
0,1427,54625,3578757931,3578757949,18
0,1427,54626,3578757931,3578757949,18
0,1427,54627,3578757931,3578757950,19
0,1427,54628,3578757931,3578757951,20
0,1427,54629,3578757931,3578757952,21
0,1427,54630,3578757931,3578757953,22
0,1427,54631,3578757931,3578757953,22
0,1427,54632,3578757931,3578757953,22
0,1427,54633,3578757931,3578757954,23
0,1427,54634,3578757931,3578757954,23
0,1427,54635,3578757931,3578757955,24
0,1427,54636,3578757931,3578757955,24
0,1427,54637,3578757931,3578757955,24
0,1427,54638,3578757931,3578757955,24
0,1427,54639,3578757931,3578757956,25
0,1427,54640,3578757931,3578757958,27
0,1427,54641,3578757931,3578757958,27
0,1427,54642,3578757931,3578757959,28
0,1427,54643,3578757931,3578757959,28
0,1427,54644,3578757931,3578757960,29
0,1427,54645,3578757931,3578757960,29
0,1427,54646,3578757931,3578757961,30
0,1427,54647,3578757931,3578757961,30
0,1427,54648,3578757931,3578757961,30
0,1427,54649,3578757931,3578757962,31
0,1427,54650,3578757931,3578757962,31
0,1427,54651,3578757931,3578757962,31
0,1427,54652,3578757931,3578757964,33
0,1427,54653,3578757931,3578757964,33
0,1427,54654,3578757931,3578757966,35
0,1427,54655,3578757931,3578757966,35
0,1427,54656,3578757931,3578757967,36
0,1427,54657,3578757931,3578757967,36
0,1427,54658,3578757931,3578757968,37
0,1427,54659,3578757931,3578757969,38
0,1427,54660,3578757931,3578757970,39
0,1427,54661,3578757931,3578757970,39
0,1427,54662,3578757931,3578757971,40
0,1427,54663,3578757931,3578757972,41
0,1427,54664,3578757931,3578757973,42
0,1427,54665,3578757931,3578757973,42
0,1427,54666,3578757931,3578757974,43
0,1427,54667,3578757931,3578757976,45
0,1427,54668,3578757931,3578757978,47
0,1427,54669,3578757931,3578757979,48
0,1427,54670,3578757931,3578757979,48
0,1427,54671,3578757931,3578757979,48
0,1427,54672,3578757931,3578757980,49
0,1427,54673,3578757931,3578757980,49
0,1427,54674,3578757931,3578757981,50
0,1428,54675,3578757995,3578757995,0
0,1428,54676,3578757995,3578757995,0
0,1428,54677,3578757995,3578757995,0
0,1428,54678,3578757995,3578757995,0
0,1428,54679,3578757995,3578757995,0
0,1428,54680,3578757995,3578757995,0
0,1428,54681,3578757995,3578757995,0
0,1428,54682,3578757995,3578757995,0
0,1428,54683,3578757995,3578757995,0
0,1428,54684,3578757995,3578757995,0
0,1428,54685,3578757995,3578757995,0
0,1428,54686,3578757995,3578757995,0
0,1428,54687,3578757995,3578757995,0
0,1428,54688,3578757995,3578757995,0
0,1428,54689,3578757995,3578757995,0
0,1428,54690,3578757995,3578757996,1
0,1428,54691,3578757995,3578757997,2
0,1428,54692,3578757995,3578757998,3
0,1428,54693,3578757995,3578757998,3
0,1428,54694,3578757995,3578757999,4
0,1428,54695,3578757995,3578758000,5
0,1428,54696,3578757995,3578758001,6
0,1428,54697,3578757995,3578758001,6
0,1428,54698,3578757995,3578758002,7
0,1428,54699,3578757995,3578758004,9
0,1428,54700,3578757995,3578758004,9
0,1428,54701,3578757995,3578758004,9
0,1428,54702,3578757995,3578758005,10
0,1428,54703,3578757995,3578758006,11
0,1428,54704,3578757995,3578758008,13
0,1428,54705,3578757995,3578758008,13
0,1428,54706,3578757995,3578758009,14
0,1428,54707,3578757995,3578758011,16
0,1428,54708,3578757995,3578758011,16
0,1428,54709,3578757995,3578758013,18
0,1428,54710,3578757995,3578758013,18
0,1428,54711,3578757995,3578758014,19
0,1428,54712,3578757995,3578758014,19
0,1428,54713,3578757995,3578758015,20
0,1428,54714,3578757995,3578758015,20
0,1428,54715,3578757995,3578758015,20
0,1428,54716,3578757995,3578758016,21
0,1428,54717,3578757995,3578758016,21
0,1428,54718,3578757995,3578758017,22
0,1428,54719,3578757995,3578758018,23
0,1428,54720,3578757995,3578758018,23
0,1428,54721,3578757995,3578758019,24
0,1428,54722,3578757995,3578758020,25
0,1428,54723,3578757995,3578758020,25
0,1428,54724,3578757995,3578758022,27
0,1428,54725,3578757995,3578758023,28
0,1428,54726,3578757995,3578758023,28
0,1428,54727,3578757995,3578758024,29
0,1428,54728,3578757995,3578758024,29
0,1428,54729,3578757995,3578758028,33
0,1428,54730,3578757995,3578758028,33
0,1428,54731,3578757995,3578758028,33
0,1428,54732,3578757995,3578758029,34
0,1428,54733,3578757995,3578758030,35
0,1428,54734,3578757995,3578758031,36
0,1428,54735,3578757995,3578758031,36
0,1428,54736,3578757995,3578758032,37
0,1428,54737,3578757995,3578758032,37
0,1428,54738,3578757995,3578758033,38
0,1428,54739,3578757995,3578758034,39
0,1428,54740,3578757995,3578758036,41
0,1428,54741,3578757995,3578758037,42
0,1428,54742,3578757995,3578758037,42
0,1428,54743,3578757995,3578758038,43
0,1428,54744,3578757995,3578758038,43
0,1428,54745,3578757995,3578758039,44
0,1428,54746,3578757995,3578758039,44
0,1428,54747,3578757995,3578758039,44
0,1428,54748,3578757995,3578758039,44
0,1428,54749,3578757995,3578758041,46
0,1428,54750,3578757995,3578758041,46
0,1428,54751,3578757995,3578758042,47
0,1428,54752,3578757995,3578758043,48
0,1428,54753,3578757995,3578758043,48
0,1428,54754,3578757995,3578758043,48
0,1428,54755,3578757995,3578758044,49
0,1428,54756,3578757995,3578758044,49
0,1428,54757,3578757995,3578758044,49
0,1428,54758,3578757995,3578758045,50
0,1429,54759,3578758059,3578758059,0
0,1429,54760,3578758059,3578758059,0
0,1429,54761,3578758059,3578758059,0
0,1429,54762,3578758059,3578758059,0
0,1429,54763,3578758059,3578758059,0
0,1429,54764,3578758059,3578758059,0
0,1429,54765,3578758059,3578758059,0
0,1429,54766,3578758059,3578758059,0
0,1429,54767,3578758059,3578758059,0
0,1429,54768,3578758059,3578758059,0
0,1429,54769,3578758059,3578758059,0
0,1429,54770,3578758059,3578758059,0
0,1429,54771,3578758059,3578758059,0
0,1429,54772,3578758059,3578758059,0
0,1429,54773,3578758059,3578758059,0
0,1429,54774,3578758059,3578758059,0
0,1429,54775,3578758059,3578758059,0
0,1429,54776,3578758059,3578758059,0
0,1429,54777,3578758059,3578758059,0
0,1429,54778,3578758059,3578758059,0
0,1429,54779,3578758059,3578758059,0
0,1429,54780,3578758059,3578758060,1
0,1429,54781,3578758059,3578758062,3
0,1429,54782,3578758059,3578758063,4
0,1429,54783,3578758059,3578758064,5
0,1429,54784,3578758059,3578758064,5
0,1429,54785,3578758059,3578758065,6
0,1429,54786,3578758059,3578758066,7
0,1429,54787,3578758059,3578758066,7
0,1429,54788,3578758059,3578758067,8
0,1429,54789,3578758059,3578758068,9
0,1429,54790,3578758059,3578758079,20
0,1429,54791,3578758059,3578758081,22
0,1429,54792,3578758059,3578758081,22
0,1429,54793,3578758059,3578758085,26
0,1429,54794,3578758059,3578758085,26
0,1429,54795,3578758059,3578758087,28
0,1429,54796,3578758059,3578758087,28
0,1429,54797,3578758059,3578758087,28
0,1429,54798,3578758059,3578758088,29
0,1429,54799,3578758059,3578758089,30
0,1429,54800,3578758059,3578758089,30
0,1429,54801,3578758059,3578758089,30
0,1429,54802,3578758059,3578758090,31
0,1429,54803,3578758059,3578758090,31
0,1429,54804,3578758059,3578758090,31
0,1429,54805,3578758059,3578758090,31
0,1429,54806,3578758059,3578758092,33
0,1429,54807,3578758059,3578758092,33
0,1429,54808,3578758059,3578758093,34
0,1429,54809,3578758059,3578758094,35
0,1429,54810,3578758059,3578758094,35
0,1429,54811,3578758059,3578758094,35
0,1429,54812,3578758059,3578758095,36
0,1429,54813,3578758059,3578758095,36
0,1429,54814,3578758059,3578758096,37
0,1429,54815,3578758059,3578758097,38
0,1429,54816,3578758059,3578758097,38
0,1429,54817,3578758059,3578758098,39
0,1429,54818,3578758059,3578758099,40
0,1429,54819,3578758059,3578758099,40
0,1429,54820,3578758059,3578758099,40
0,1429,54821,3578758059,3578758099,40
0,1429,54822,3578758059,3578758100,41
0,1429,54823,3578758059,3578758100,41
0,1429,54824,3578758059,3578758100,41
0,1429,54825,3578758059,3578758104,45
0,1429,54826,3578758059,3578758104,45
0,1429,54827,3578758059,3578758104,45
0,1429,54828,3578758059,3578758106,47
0,1429,54829,3578758059,3578758106,47
0,1429,54830,3578758059,3578758107,48
0,1429,54831,3578758059,3578758107,48
0,1429,54832,3578758059,3578758107,48
0,1429,54833,3578758059,3578758107,48
0,1429,54834,3578758059,3578758108,49
0,1429,54835,3578758059,3578758108,49
0,1429,54836,3578758059,3578758109,50
0,1430,54837,3578758123,3578758123,0
0,1430,54838,3578758123,3578758123,0
0,1430,54839,3578758123,3578758123,0
0,1430,54840,3578758123,3578758123,0
0,1430,54841,3578758123,3578758123,0
0,1430,54842,3578758123,3578758123,0
0,1430,54843,3578758123,3578758123,0
0,1430,54844,3578758123,3578758123,0
0,1430,54845,3578758123,3578758123,0
0,1430,54846,3578758123,3578758123,0
0,1430,54847,3578758123,3578758123,0
0,1430,54848,3578758123,3578758123,0
0,1430,54849,3578758123,3578758123,0
0,1430,54850,3578758123,3578758123,0
0,1430,54851,3578758123,3578758123,0
0,1430,54852,3578758123,3578758123,0
0,1430,54853,3578758123,3578758123,0
0,1430,54854,3578758123,3578758123,0
0,1430,54855,3578758123,3578758123,0
0,1430,54856,3578758123,3578758123,0
0,1430,54857,3578758123,3578758123,0
0,1430,54858,3578758123,3578758123,0
0,1430,54859,3578758123,3578758123,0
0,1430,54860,3578758123,3578758123,0
0,1430,54861,3578758123,3578758123,0
0,1430,54862,3578758123,3578758123,0
0,1430,54863,3578758123,3578758123,0
0,1430,54864,3578758123,3578758123,0
0,1430,54865,3578758123,3578758123,0
0,1430,54866,3578758123,3578758123,0
0,1430,54867,3578758123,3578758124,1
0,1430,54868,3578758123,3578758124,1
0,1430,54869,3578758123,3578758125,2
0,1430,54870,3578758123,3578758125,2
0,1430,54871,3578758123,3578758126,3
0,1430,54872,3578758123,3578758127,4
0,1430,54873,3578758123,3578758127,4
0,1430,54874,3578758123,3578758127,4
0,1430,54875,3578758123,3578758127,4
0,1430,54876,3578758123,3578758127,4
0,1430,54877,3578758123,3578758128,5
0,1430,54878,3578758123,3578758128,5
0,1430,54879,3578758123,3578758128,5
0,1430,54880,3578758123,3578758128,5
0,1430,54881,3578758123,3578758128,5
0,1430,54882,3578758123,3578758129,6
0,1430,54883,3578758123,3578758130,7
0,1430,54884,3578758123,3578758130,7
0,1430,54885,3578758123,3578758131,8
0,1430,54886,3578758123,3578758131,8
0,1430,54887,3578758123,3578758131,8
0,1430,54888,3578758123,3578758132,9
0,1430,54889,3578758123,3578758132,9
0,1430,54890,3578758123,3578758133,10
0,1430,54891,3578758123,3578758133,10
0,1430,54892,3578758123,3578758134,11
0,1430,54893,3578758123,3578758134,11
0,1430,54894,3578758123,3578758135,12
0,1430,54895,3578758123,3578758138,15
0,1430,54896,3578758123,3578758139,16
0,1430,54897,3578758123,3578758140,17
0,1430,54898,3578758123,3578758140,17
0,1430,54899,3578758123,3578758140,17
0,1430,54900,3578758123,3578758140,17
0,1430,54901,3578758123,3578758141,18
0,1430,54902,3578758123,3578758142,19
0,1430,54903,3578758123,3578758142,19
0,1430,54904,3578758123,3578758143,20
0,1430,54905,3578758123,3578758143,20
0,1430,54906,3578758123,3578758143,20
0,1430,54907,3578758123,3578758144,21
0,1430,54908,3578758123,3578758144,21
0,1430,54909,3578758123,3578758145,22
0,1430,54910,3578758123,3578758145,22
0,1430,54911,3578758123,3578758146,23
0,1430,54912,3578758123,3578758147,24
0,1430,54913,3578758123,3578758148,25
0,1430,54914,3578758123,3578758148,25
0,1430,54915,3578758123,3578758149,26
0,1430,54916,3578758123,3578758149,26
0,1430,54917,3578758123,3578758151,28
0,1430,54918,3578758123,3578758151,28
0,1430,54919,3578758123,3578758153,30
0,1430,54920,3578758123,3578758153,30
0,1430,54921,3578758123,3578758153,30
0,1430,54922,3578758123,3578758154,31
0,1430,54923,3578758123,3578758154,31
0,1430,54924,3578758123,3578758155,32
0,1430,54925,3578758123,3578758155,32
0,1430,54926,3578758123,3578758156,33
0,1430,54927,3578758123,3578758156,33
0,1430,54928,3578758123,3578758156,33
0,1430,54929,3578758123,3578758158,35
0,1430,54930,3578758123,3578758158,35
0,1430,54931,3578758123,3578758158,35
0,1430,54932,3578758123,3578758159,36
0,1430,54933,3578758123,3578758159,36
0,1430,54934,3578758123,3578758160,37
0,1430,54935,3578758123,3578758160,37
0,1430,54936,3578758123,3578758160,37
0,1430,54937,3578758123,3578758161,38
0,1430,54938,3578758123,3578758161,38
0,1430,54939,3578758123,3578758162,39
0,1430,54940,3578758123,3578758162,39
0,1430,54941,3578758123,3578758162,39
0,1430,54942,3578758123,3578758162,39
0,1430,54943,3578758123,3578758165,42
0,1430,54944,3578758123,3578758165,42
0,1430,54945,3578758123,3578758166,43
0,1430,54946,3578758123,3578758166,43
0,1430,54947,3578758123,3578758168,45
0,1430,54948,3578758123,3578758168,45
0,1430,54949,3578758123,3578758169,46
0,1430,54950,3578758123,3578758170,47
0,1430,54951,3578758123,3578758171,48
0,1430,54952,3578758123,3578758173,50
0,1431,54953,3578758185,3578758185,0
0,1431,54954,3578758185,3578758185,0
0,1431,54955,3578758185,3578758185,0
0,1431,54956,3578758185,3578758185,0
0,1431,54957,3578758185,3578758185,0
0,1431,54958,3578758185,3578758185,0
0,1431,54959,3578758185,3578758185,0
0,1431,54960,3578758185,3578758185,0
0,1431,54961,3578758185,3578758185,0
0,1431,54962,3578758185,3578758185,0
0,1431,54963,3578758185,3578758185,0
0,1431,54964,3578758185,3578758185,0
0,1431,54965,3578758185,3578758185,0
0,1431,54966,3578758185,3578758185,0
0,1431,54967,3578758185,3578758185,0
0,1431,54968,3578758185,3578758187,2
0,1431,54969,3578758185,3578758187,2
0,1431,54970,3578758185,3578758188,3
0,1431,54971,3578758185,3578758188,3
0,1431,54972,3578758185,3578758190,5
0,1431,54973,3578758185,3578758190,5
0,1431,54974,3578758185,3578758190,5
0,1431,54975,3578758185,3578758190,5
0,1431,54976,3578758185,3578758191,6
0,1431,54977,3578758185,3578758192,7
0,1431,54978,3578758185,3578758193,8
0,1431,54979,3578758185,3578758194,9
0,1431,54980,3578758185,3578758194,9
0,1431,54981,3578758185,3578758196,11
0,1431,54982,3578758185,3578758197,12
0,1431,54983,3578758185,3578758197,12
0,1431,54984,3578758185,3578758199,14
0,1431,54985,3578758185,3578758199,14
0,1431,54986,3578758185,3578758199,14
0,1431,54987,3578758185,3578758201,16
0,1431,54988,3578758185,3578758201,16
0,1431,54989,3578758185,3578758202,17
0,1431,54990,3578758185,3578758203,18
0,1431,54991,3578758185,3578758204,19
0,1431,54992,3578758185,3578758205,20
0,1431,54993,3578758185,3578758205,20
0,1431,54994,3578758185,3578758205,20
0,1431,54995,3578758185,3578758206,21
0,1431,54996,3578758185,3578758208,23
0,1431,54997,3578758185,3578758208,23
0,1431,54998,3578758185,3578758209,24
0,1431,54999,3578758185,3578758211,26
0,1431,55000,3578758185,3578758212,27
0,1431,55001,3578758185,3578758212,27
0,1431,55002,3578758185,3578758213,28
0,1431,55003,3578758185,3578758214,29
0,1431,55004,3578758185,3578758214,29
0,1431,55005,3578758185,3578758215,30
0,1431,55006,3578758185,3578758215,30
0,1431,55007,3578758185,3578758216,31
0,1431,55008,3578758185,3578758216,31
0,1431,55009,3578758185,3578758216,31
0,1431,55010,3578758185,3578758217,32
0,1431,55011,3578758185,3578758218,33
0,1431,55012,3578758185,3578758218,33
0,1431,55013,3578758185,3578758219,34
0,1431,55014,3578758185,3578758221,36
0,1431,55015,3578758185,3578758221,36
0,1431,55016,3578758185,3578758222,37
0,1431,55017,3578758185,3578758224,39
0,1431,55018,3578758185,3578758224,39
0,1431,55019,3578758185,3578758224,39
0,1431,55020,3578758185,3578758224,39
0,1431,55021,3578758185,3578758225,40
0,1431,55022,3578758185,3578758227,42
0,1431,55023,3578758185,3578758228,43
0,1431,55024,3578758185,3578758229,44
0,1431,55025,3578758185,3578758230,45
0,1431,55026,3578758185,3578758230,45
0,1431,55027,3578758185,3578758230,45
0,1431,55028,3578758185,3578758230,45
0,1431,55029,3578758185,3578758231,46
0,1431,55030,3578758185,3578758231,46
0,1431,55031,3578758185,3578758232,47
0,1431,55032,3578758185,3578758232,47
0,1431,55033,3578758185,3578758232,47
0,1431,55034,3578758185,3578758234,49
0,1431,55035,3578758185,3578758234,49
0,1432,55036,3578758248,3578758248,0
0,1432,55037,3578758248,3578758248,0
0,1432,55038,3578758248,3578758248,0
0,1432,55039,3578758248,3578758248,0
0,1432,55040,3578758248,3578758248,0
0,1432,55041,3578758248,3578758248,0
0,1432,55042,3578758248,3578758248,0
0,1432,55043,3578758248,3578758248,0
0,1432,55044,3578758248,3578758248,0
0,1432,55045,3578758248,3578758248,0
0,1432,55046,3578758248,3578758248,0
0,1432,55047,3578758248,3578758248,0
0,1432,55048,3578758248,3578758248,0
0,1432,55049,3578758248,3578758248,0
0,1432,55050,3578758248,3578758248,0
0,1432,55051,3578758248,3578758248,0
0,1432,55052,3578758248,3578758249,1
0,1432,55053,3578758248,3578758249,1
0,1432,55054,3578758248,3578758249,1
0,1432,55055,3578758248,3578758249,1
0,1432,55056,3578758248,3578758249,1
0,1432,55057,3578758248,3578758250,2
0,1432,55058,3578758248,3578758250,2
0,1432,55059,3578758248,3578758250,2
0,1432,55060,3578758248,3578758251,3
0,1432,55061,3578758248,3578758252,4
0,1432,55062,3578758248,3578758253,5
0,1432,55063,3578758248,3578758256,8
0,1432,55064,3578758248,3578758256,8
0,1432,55065,3578758248,3578758256,8
0,1432,55066,3578758248,3578758257,9
0,1432,55067,3578758248,3578758257,9
0,1432,55068,3578758248,3578758258,10
0,1432,55069,3578758248,3578758258,10
0,1432,55070,3578758248,3578758260,12
0,1432,55071,3578758248,3578758261,13
0,1432,55072,3578758248,3578758261,13
0,1432,55073,3578758248,3578758263,15
0,1432,55074,3578758248,3578758263,15
0,1432,55075,3578758248,3578758265,17
0,1432,55076,3578758248,3578758266,18
0,1432,55077,3578758248,3578758267,19
0,1432,55078,3578758248,3578758267,19
0,1432,55079,3578758248,3578758267,19
0,1432,55080,3578758248,3578758267,19
0,1432,55081,3578758248,3578758268,20
0,1432,55082,3578758248,3578758268,20
0,1432,55083,3578758248,3578758270,22
0,1432,55084,3578758248,3578758280,32
0,1432,55085,3578758248,3578758281,33
0,1432,55086,3578758248,3578758281,33
0,1432,55087,3578758248,3578758285,37
0,1432,55088,3578758248,3578758285,37
0,1432,55089,3578758248,3578758285,37
0,1432,55090,3578758248,3578758287,39
0,1432,55091,3578758248,3578758287,39
0,1432,55092,3578758248,3578758288,40
0,1432,55093,3578758248,3578758288,40
0,1432,55094,3578758248,3578758289,41
0,1432,55095,3578758248,3578758289,41
0,1432,55096,3578758248,3578758289,41
0,1432,55097,3578758248,3578758289,41
0,1432,55098,3578758248,3578758290,42
0,1432,55099,3578758248,3578758290,42
0,1432,55100,3578758248,3578758290,42
0,1432,55101,3578758248,3578758290,42
0,1432,55102,3578758248,3578758291,43
0,1432,55103,3578758248,3578758292,44
0,1432,55104,3578758248,3578758293,45
0,1432,55105,3578758248,3578758294,46
0,1432,55106,3578758248,3578758294,46
0,1432,55107,3578758248,3578758294,46
0,1432,55108,3578758248,3578758295,47
0,1432,55109,3578758248,3578758296,48
0,1432,55110,3578758248,3578758297,49
0,1432,55111,3578758248,3578758297,49
0,1432,55112,3578758248,3578758298,50
0,1433,55113,3578758311,3578758311,0
0,1433,55114,3578758311,3578758311,0
0,1433,55115,3578758311,3578758311,0
0,1433,55116,3578758311,3578758311,0
0,1433,55117,3578758311,3578758311,0
0,1433,55118,3578758311,3578758311,0
0,1433,55119,3578758311,3578758311,0
0,1433,55120,3578758311,3578758311,0
0,1433,55121,3578758311,3578758311,0
0,1433,55122,3578758311,3578758311,0
0,1433,55123,3578758311,3578758311,0
0,1433,55124,3578758311,3578758311,0
0,1433,55125,3578758311,3578758311,0
0,1433,55126,3578758311,3578758311,0
0,1433,55127,3578758311,3578758311,0
0,1433,55128,3578758311,3578758311,0
0,1433,55129,3578758311,3578758311,0
0,1433,55130,3578758311,3578758311,0
0,1433,55131,3578758311,3578758311,0
0,1433,55132,3578758311,3578758311,0
0,1433,55133,3578758311,3578758311,0
0,1433,55134,3578758311,3578758311,0
0,1433,55135,3578758311,3578758311,0
0,1433,55136,3578758311,3578758311,0
0,1433,55137,3578758311,3578758311,0
0,1433,55138,3578758311,3578758312,1
0,1433,55139,3578758311,3578758313,2
0,1433,55140,3578758311,3578758314,3
0,1433,55141,3578758311,3578758315,4
0,1433,55142,3578758311,3578758315,4
0,1433,55143,3578758311,3578758315,4
0,1433,55144,3578758311,3578758316,5
0,1433,55145,3578758311,3578758316,5
0,1433,55146,3578758311,3578758316,5
0,1433,55147,3578758311,3578758317,6
0,1433,55148,3578758311,3578758317,6
0,1433,55149,3578758311,3578758317,6
0,1433,55150,3578758311,3578758317,6
0,1433,55151,3578758311,3578758317,6
0,1433,55152,3578758311,3578758317,6
0,1433,55153,3578758311,3578758317,6
0,1433,55154,3578758311,3578758318,7
0,1433,55155,3578758311,3578758318,7
0,1433,55156,3578758311,3578758319,8
0,1433,55157,3578758311,3578758319,8
0,1433,55158,3578758311,3578758320,9
0,1433,55159,3578758311,3578758320,9
0,1433,55160,3578758311,3578758321,10
0,1433,55161,3578758311,3578758322,11
0,1433,55162,3578758311,3578758322,11
0,1433,55163,3578758311,3578758324,13
0,1433,55164,3578758311,3578758324,13
0,1433,55165,3578758311,3578758324,13
0,1433,55166,3578758311,3578758325,14
0,1433,55167,3578758311,3578758326,15
0,1433,55168,3578758311,3578758326,15
0,1433,55169,3578758311,3578758326,15
0,1433,55170,3578758311,3578758327,16
0,1433,55171,3578758311,3578758327,16
0,1433,55172,3578758311,3578758327,16
0,1433,55173,3578758311,3578758327,16
0,1433,55174,3578758311,3578758328,17
0,1433,55175,3578758311,3578758328,17
0,1433,55176,3578758311,3578758328,17
0,1433,55177,3578758311,3578758328,17
0,1433,55178,3578758311,3578758329,18
0,1433,55179,3578758311,3578758331,20
0,1433,55180,3578758311,3578758331,20
0,1433,55181,3578758311,3578758331,20
0,1433,55182,3578758311,3578758332,21
0,1433,55183,3578758311,3578758332,21
0,1433,55184,3578758311,3578758333,22
0,1433,55185,3578758311,3578758333,22
0,1433,55186,3578758311,3578758334,23
0,1433,55187,3578758311,3578758334,23
0,1433,55188,3578758311,3578758335,24
0,1433,55189,3578758311,3578758336,25
0,1433,55190,3578758311,3578758338,27
0,1433,55191,3578758311,3578758339,28
0,1433,55192,3578758311,3578758340,29
0,1433,55193,3578758311,3578758340,29
0,1433,55194,3578758311,3578758340,29
0,1433,55195,3578758311,3578758340,29
0,1433,55196,3578758311,3578758341,30
0,1433,55197,3578758311,3578758341,30
0,1433,55198,3578758311,3578758342,31
0,1433,55199,3578758311,3578758342,31
0,1433,55200,3578758311,3578758343,32
0,1433,55201,3578758311,3578758343,32
0,1433,55202,3578758311,3578758344,33
0,1433,55203,3578758311,3578758346,35
0,1433,55204,3578758311,3578758346,35
0,1433,55205,3578758311,3578758347,36
0,1433,55206,3578758311,3578758347,36
0,1433,55207,3578758311,3578758348,37
0,1433,55208,3578758311,3578758348,37
0,1433,55209,3578758311,3578758349,38
0,1433,55210,3578758311,3578758350,39
0,1433,55211,3578758311,3578758352,41
0,1433,55212,3578758311,3578758352,41
0,1433,55213,3578758311,3578758353,42
0,1433,55214,3578758311,3578758353,42
0,1433,55215,3578758311,3578758353,42
0,1433,55216,3578758311,3578758354,43
0,1433,55217,3578758311,3578758355,44
0,1433,55218,3578758311,3578758355,44
0,1433,55219,3578758311,3578758356,45
0,1433,55220,3578758311,3578758356,45
0,1433,55221,3578758311,3578758357,46
0,1433,55222,3578758311,3578758358,47
0,1433,55223,3578758311,3578758359,48
0,1433,55224,3578758311,3578758359,48
0,1433,55225,3578758311,3578758360,49
0,1433,55226,3578758311,3578758360,49
0,1433,55227,3578758311,3578758361,50
0,1434,55228,3578758375,3578758375,0
0,1434,55229,3578758375,3578758375,0
0,1434,55230,3578758375,3578758375,0
0,1434,55231,3578758375,3578758375,0
0,1434,55232,3578758375,3578758375,0
0,1434,55233,3578758375,3578758375,0
0,1434,55234,3578758375,3578758375,0
0,1434,55235,3578758375,3578758375,0
0,1434,55236,3578758375,3578758375,0
0,1434,55237,3578758375,3578758375,0
0,1434,55238,3578758375,3578758375,0
0,1434,55239,3578758375,3578758375,0
0,1434,55240,3578758375,3578758375,0
0,1434,55241,3578758375,3578758375,0
0,1434,55242,3578758375,3578758375,0
0,1434,55243,3578758375,3578758375,0
0,1434,55244,3578758375,3578758375,0
0,1434,55245,3578758375,3578758375,0
0,1434,55246,3578758375,3578758375,0
0,1434,55247,3578758375,3578758375,0
0,1434,55248,3578758375,3578758375,0
0,1434,55249,3578758375,3578758375,0
0,1434,55250,3578758375,3578758376,1
0,1434,55251,3578758375,3578758376,1
0,1434,55252,3578758375,3578758378,3
0,1434,55253,3578758375,3578758378,3
0,1434,55254,3578758375,3578758379,4
0,1434,55255,3578758375,3578758379,4
0,1434,55256,3578758375,3578758380,5
0,1434,55257,3578758375,3578758381,6
0,1434,55258,3578758375,3578758381,6
0,1434,55259,3578758375,3578758382,7
0,1434,55260,3578758375,3578758382,7
0,1434,55261,3578758375,3578758383,8
0,1434,55262,3578758375,3578758386,11
0,1434,55263,3578758375,3578758387,12
0,1434,55264,3578758375,3578758388,13
0,1434,55265,3578758375,3578758390,15
0,1434,55266,3578758375,3578758390,15
0,1434,55267,3578758375,3578758391,16
0,1434,55268,3578758375,3578758393,18
0,1434,55269,3578758375,3578758393,18
0,1434,55270,3578758375,3578758394,19
0,1434,55271,3578758375,3578758394,19
0,1434,55272,3578758375,3578758396,21
0,1434,55273,3578758375,3578758396,21
0,1434,55274,3578758375,3578758397,22
0,1434,55275,3578758375,3578758397,22
0,1434,55276,3578758375,3578758399,24
0,1434,55277,3578758375,3578758399,24
0,1434,55278,3578758375,3578758400,25
0,1434,55279,3578758375,3578758401,26
0,1434,55280,3578758375,3578758401,26
0,1434,55281,3578758375,3578758402,27
0,1434,55282,3578758375,3578758403,28
0,1434,55283,3578758375,3578758405,30
0,1434,55284,3578758375,3578758405,30
0,1434,55285,3578758375,3578758405,30
0,1434,55286,3578758375,3578758405,30
0,1434,55287,3578758375,3578758406,31
0,1434,55288,3578758375,3578758408,33
0,1434,55289,3578758375,3578758408,33
0,1434,55290,3578758375,3578758409,34
0,1434,55291,3578758375,3578758411,36
0,1434,55292,3578758375,3578758412,37
0,1434,55293,3578758375,3578758412,37
0,1434,55294,3578758375,3578758414,39
0,1434,55295,3578758375,3578758414,39
0,1434,55296,3578758375,3578758415,40
0,1434,55297,3578758375,3578758415,40
0,1434,55298,3578758375,3578758415,40
0,1434,55299,3578758375,3578758415,40
0,1434,55300,3578758375,3578758416,41
0,1434,55301,3578758375,3578758416,41
0,1434,55302,3578758375,3578758417,42
0,1434,55303,3578758375,3578758418,43
0,1434,55304,3578758375,3578758419,44
0,1434,55305,3578758375,3578758419,44
0,1434,55306,3578758375,3578758419,44
0,1434,55307,3578758375,3578758421,46
0,1434,55308,3578758375,3578758422,47
0,1434,55309,3578758375,3578758423,48
0,1434,55310,3578758375,3578758423,48
0,1434,55311,3578758375,3578758424,49
0,1434,55312,3578758375,3578758424,49
0,1434,55313,3578758375,3578758425,50
0,1435,55314,3578758437,3578758437,0
0,1435,55315,3578758437,3578758437,0
0,1435,55316,3578758437,3578758437,0
0,1435,55317,3578758437,3578758437,0
0,1435,55318,3578758437,3578758437,0
0,1435,55319,3578758437,3578758437,0
0,1435,55320,3578758437,3578758437,0
0,1435,55321,3578758437,3578758437,0
0,1435,55322,3578758437,3578758437,0
0,1435,55323,3578758437,3578758437,0
0,1435,55324,3578758437,3578758437,0
0,1435,55325,3578758437,3578758437,0
0,1435,55326,3578758437,3578758437,0
0,1435,55327,3578758437,3578758437,0
0,1435,55328,3578758437,3578758437,0
0,1435,55329,3578758437,3578758438,1
0,1435,55330,3578758437,3578758438,1
0,1435,55331,3578758437,3578758438,1
0,1435,55332,3578758437,3578758439,2
0,1435,55333,3578758437,3578758440,3
0,1435,55334,3578758437,3578758440,3
0,1435,55335,3578758437,3578758440,3
0,1435,55336,3578758437,3578758441,4
0,1435,55337,3578758437,3578758442,5
0,1435,55338,3578758437,3578758443,6
0,1435,55339,3578758437,3578758444,7
0,1435,55340,3578758437,3578758444,7
0,1435,55341,3578758437,3578758444,7
0,1435,55342,3578758437,3578758444,7
0,1435,55343,3578758437,3578758445,8
0,1435,55344,3578758437,3578758447,10
0,1435,55345,3578758437,3578758447,10
0,1435,55346,3578758437,3578758447,10
0,1435,55347,3578758437,3578758448,11
0,1435,55348,3578758437,3578758448,11
0,1435,55349,3578758437,3578758449,12
0,1435,55350,3578758437,3578758450,13
0,1435,55351,3578758437,3578758450,13
0,1435,55352,3578758437,3578758451,14
0,1435,55353,3578758437,3578758452,15
0,1435,55354,3578758437,3578758453,16
0,1435,55355,3578758437,3578758456,19
0,1435,55356,3578758437,3578758456,19
0,1435,55357,3578758437,3578758457,20
0,1435,55358,3578758437,3578758457,20
0,1435,55359,3578758437,3578758457,20
0,1435,55360,3578758437,3578758457,20
0,1435,55361,3578758437,3578758458,21
0,1435,55362,3578758437,3578758461,24
0,1435,55363,3578758437,3578758461,24
0,1435,55364,3578758437,3578758462,25
0,1435,55365,3578758437,3578758463,26
0,1435,55366,3578758437,3578758463,26
0,1435,55367,3578758437,3578758465,28
0,1435,55368,3578758437,3578758465,28
0,1435,55369,3578758437,3578758465,28
0,1435,55370,3578758437,3578758466,29
0,1435,55371,3578758437,3578758467,30
0,1435,55372,3578758437,3578758467,30
0,1435,55373,3578758437,3578758467,30
0,1435,55374,3578758437,3578758468,31
0,1435,55375,3578758437,3578758480,43
0,1435,55376,3578758437,3578758481,44
0,1435,55377,3578758437,3578758481,44
0,1435,55378,3578758437,3578758482,45
0,1435,55379,3578758437,3578758484,47
0,1435,55380,3578758437,3578758485,48
0,1436,55381,3578758500,3578758500,0
0,1436,55382,3578758500,3578758500,0
0,1436,55383,3578758500,3578758500,0
0,1436,55384,3578758500,3578758500,0
0,1436,55385,3578758500,3578758500,0
0,1436,55386,3578758500,3578758500,0
0,1436,55387,3578758500,3578758500,0
0,1436,55388,3578758500,3578758500,0
0,1436,55389,3578758500,3578758500,0
0,1436,55390,3578758500,3578758500,0
0,1436,55391,3578758500,3578758500,0
0,1436,55392,3578758500,3578758500,0
0,1436,55393,3578758500,3578758500,0
0,1436,55394,3578758500,3578758500,0
0,1436,55395,3578758500,3578758500,0
0,1436,55396,3578758500,3578758500,0
0,1436,55397,3578758500,3578758500,0
0,1436,55398,3578758500,3578758500,0
0,1436,55399,3578758500,3578758500,0
0,1436,55400,3578758500,3578758500,0
0,1436,55401,3578758500,3578758500,0
0,1436,55402,3578758500,3578758500,0
0,1436,55403,3578758500,3578758500,0
0,1436,55404,3578758500,3578758500,0
0,1436,55405,3578758500,3578758500,0
0,1436,55406,3578758500,3578758500,0
0,1436,55407,3578758500,3578758500,0
0,1436,55408,3578758500,3578758500,0
0,1436,55409,3578758500,3578758500,0
0,1436,55410,3578758500,3578758502,2
0,1436,55411,3578758500,3578758504,4
0,1436,55412,3578758500,3578758504,4
0,1436,55413,3578758500,3578758505,5
0,1436,55414,3578758500,3578758506,6
0,1436,55415,3578758500,3578758506,6
0,1436,55416,3578758500,3578758507,7
0,1436,55417,3578758500,3578758507,7
0,1436,55418,3578758500,3578758508,8
0,1436,55419,3578758500,3578758508,8
0,1436,55420,3578758500,3578758508,8
0,1436,55421,3578758500,3578758508,8
0,1436,55422,3578758500,3578758508,8
0,1436,55423,3578758500,3578758508,8
0,1436,55424,3578758500,3578758509,9
0,1436,55425,3578758500,3578758510,10
0,1436,55426,3578758500,3578758510,10
0,1436,55427,3578758500,3578758510,10
0,1436,55428,3578758500,3578758511,11
0,1436,55429,3578758500,3578758512,12
0,1436,55430,3578758500,3578758512,12
0,1436,55431,3578758500,3578758512,12
0,1436,55432,3578758500,3578758514,14
0,1436,55433,3578758500,3578758514,14
0,1436,55434,3578758500,3578758514,14
0,1436,55435,3578758500,3578758514,14
0,1436,55436,3578758500,3578758515,15
0,1436,55437,3578758500,3578758515,15
0,1436,55438,3578758500,3578758516,16
0,1436,55439,3578758500,3578758516,16
0,1436,55440,3578758500,3578758516,16
0,1436,55441,3578758500,3578758516,16
0,1436,55442,3578758500,3578758516,16
0,1436,55443,3578758500,3578758516,16
0,1436,55444,3578758500,3578758517,17
0,1436,55445,3578758500,3578758517,17
0,1436,55446,3578758500,3578758517,17
0,1436,55447,3578758500,3578758517,17
0,1436,55448,3578758500,3578758518,18
0,1436,55449,3578758500,3578758518,18
0,1436,55450,3578758500,3578758519,19
0,1436,55451,3578758500,3578758520,20
0,1436,55452,3578758500,3578758520,20
0,1436,55453,3578758500,3578758521,21
0,1436,55454,3578758500,3578758522,22
0,1436,55455,3578758500,3578758523,23
0,1436,55456,3578758500,3578758523,23
0,1436,55457,3578758500,3578758523,23
0,1436,55458,3578758500,3578758524,24
0,1436,55459,3578758500,3578758524,24
0,1436,55460,3578758500,3578758526,26
0,1436,55461,3578758500,3578758526,26
0,1436,55462,3578758500,3578758526,26
0,1436,55463,3578758500,3578758526,26
0,1436,55464,3578758500,3578758527,27
0,1436,55465,3578758500,3578758527,27
0,1436,55466,3578758500,3578758527,27
0,1436,55467,3578758500,3578758528,28
0,1436,55468,3578758500,3578758529,29
0,1436,55469,3578758500,3578758530,30
0,1436,55470,3578758500,3578758530,30
0,1436,55471,3578758500,3578758530,30
0,1436,55472,3578758500,3578758531,31
0,1436,55473,3578758500,3578758531,31
0,1436,55474,3578758500,3578758531,31
0,1436,55475,3578758500,3578758532,32
0,1436,55476,3578758500,3578758532,32
0,1436,55477,3578758500,3578758532,32
0,1436,55478,3578758500,3578758533,33
0,1436,55479,3578758500,3578758533,33
0,1436,55480,3578758500,3578758534,34
0,1436,55481,3578758500,3578758535,35
0,1436,55482,3578758500,3578758535,35
0,1436,55483,3578758500,3578758537,37
0,1436,55484,3578758500,3578758539,39
0,1436,55485,3578758500,3578758539,39
0,1436,55486,3578758500,3578758539,39
0,1436,55487,3578758500,3578758540,40
0,1436,55488,3578758500,3578758540,40
0,1436,55489,3578758500,3578758541,41
0,1436,55490,3578758500,3578758542,42
0,1436,55491,3578758500,3578758542,42
0,1436,55492,3578758500,3578758542,42
0,1436,55493,3578758500,3578758542,42
0,1436,55494,3578758500,3578758543,43
0,1436,55495,3578758500,3578758544,44
0,1436,55496,3578758500,3578758544,44
0,1436,55497,3578758500,3578758545,45
0,1436,55498,3578758500,3578758545,45
0,1436,55499,3578758500,3578758545,45
0,1436,55500,3578758500,3578758546,46
0,1436,55501,3578758500,3578758547,47
0,1436,55502,3578758500,3578758547,47
0,1436,55503,3578758500,3578758549,49
0,1436,55504,3578758500,3578758549,49
0,1437,55505,3578758565,3578758565,0
0,1437,55506,3578758565,3578758565,0
0,1437,55507,3578758565,3578758565,0
0,1437,55508,3578758565,3578758565,0
0,1437,55509,3578758565,3578758565,0
0,1437,55510,3578758565,3578758565,0
0,1437,55511,3578758565,3578758565,0
0,1437,55512,3578758565,3578758565,0
0,1437,55513,3578758565,3578758565,0
0,1437,55514,3578758565,3578758565,0
0,1437,55515,3578758565,3578758565,0
0,1437,55516,3578758565,3578758565,0
0,1437,55517,3578758565,3578758565,0
0,1437,55518,3578758565,3578758565,0
0,1437,55519,3578758565,3578758565,0
0,1437,55520,3578758565,3578758565,0
0,1437,55521,3578758565,3578758565,0
0,1437,55522,3578758565,3578758565,0
0,1437,55523,3578758565,3578758565,0
0,1437,55524,3578758565,3578758565,0
0,1437,55525,3578758565,3578758565,0
0,1437,55526,3578758565,3578758565,0
0,1437,55527,3578758565,3578758565,0
0,1437,55528,3578758565,3578758565,0
0,1437,55529,3578758565,3578758565,0
0,1437,55530,3578758565,3578758565,0
0,1437,55531,3578758565,3578758565,0
0,1437,55532,3578758565,3578758565,0
0,1437,55533,3578758565,3578758566,1
0,1437,55534,3578758565,3578758568,3
0,1437,55535,3578758565,3578758569,4
0,1437,55536,3578758565,3578758569,4
0,1437,55537,3578758565,3578758570,5
0,1437,55538,3578758565,3578758570,5
0,1437,55539,3578758565,3578758571,6
0,1437,55540,3578758565,3578758572,7
0,1437,55541,3578758565,3578758573,8
0,1437,55542,3578758565,3578758573,8
0,1437,55543,3578758565,3578758573,8
0,1437,55544,3578758565,3578758575,10
0,1437,55545,3578758565,3578758576,11
0,1437,55546,3578758565,3578758577,12
0,1437,55547,3578758565,3578758577,12
0,1437,55548,3578758565,3578758579,14
0,1437,55549,3578758565,3578758579,14
0,1437,55550,3578758565,3578758580,15
0,1437,55551,3578758565,3578758580,15
0,1437,55552,3578758565,3578758580,15
0,1437,55553,3578758565,3578758581,16
0,1437,55554,3578758565,3578758581,16
0,1437,55555,3578758565,3578758582,17
0,1437,55556,3578758565,3578758584,19
0,1437,55557,3578758565,3578758584,19
0,1437,55558,3578758565,3578758585,20
0,1437,55559,3578758565,3578758587,22
0,1437,55560,3578758565,3578758587,22
0,1437,55561,3578758565,3578758587,22
0,1437,55562,3578758565,3578758589,24
0,1437,55563,3578758565,3578758589,24
0,1437,55564,3578758565,3578758590,25
0,1437,55565,3578758565,3578758590,25
0,1437,55566,3578758565,3578758593,28
0,1437,55567,3578758565,3578758593,28
0,1437,55568,3578758565,3578758594,29
0,1437,55569,3578758565,3578758595,30
0,1437,55570,3578758565,3578758596,31
0,1437,55571,3578758565,3578758596,31
0,1437,55572,3578758565,3578758596,31
0,1437,55573,3578758565,3578758597,32
0,1437,55574,3578758565,3578758598,33
0,1437,55575,3578758565,3578758599,34
0,1437,55576,3578758565,3578758600,35
0,1437,55577,3578758565,3578758601,36
0,1437,55578,3578758565,3578758602,37
0,1437,55579,3578758565,3578758603,38
0,1437,55580,3578758565,3578758603,38
0,1437,55581,3578758565,3578758604,39
0,1437,55582,3578758565,3578758605,40
0,1437,55583,3578758565,3578758605,40
0,1437,55584,3578758565,3578758605,40
0,1437,55585,3578758565,3578758605,40
0,1437,55586,3578758565,3578758606,41
0,1437,55587,3578758565,3578758607,42
0,1437,55588,3578758565,3578758607,42
0,1437,55589,3578758565,3578758608,43
0,1437,55590,3578758565,3578758611,46
0,1437,55591,3578758565,3578758611,46
0,1437,55592,3578758565,3578758611,46
0,1437,55593,3578758565,3578758611,46
0,1437,55594,3578758565,3578758612,47
0,1437,55595,3578758565,3578758612,47
0,1437,55596,3578758565,3578758612,47
0,1437,55597,3578758565,3578758613,48
0,1437,55598,3578758565,3578758614,49
0,1437,55599,3578758565,3578758614,49
0,1437,55600,3578758565,3578758615,50
0,1438,55601,3578758629,3578758629,0
0,1438,55602,3578758629,3578758629,0
0,1438,55603,3578758629,3578758629,0
0,1438,55604,3578758629,3578758629,0
0,1438,55605,3578758629,3578758629,0
0,1438,55606,3578758629,3578758629,0
0,1438,55607,3578758629,3578758629,0
0,1438,55608,3578758629,3578758629,0
0,1438,55609,3578758629,3578758629,0
0,1438,55610,3578758629,3578758629,0
0,1438,55611,3578758629,3578758629,0
0,1438,55612,3578758629,3578758629,0
0,1438,55613,3578758629,3578758629,0
0,1438,55614,3578758629,3578758629,0
0,1438,55615,3578758629,3578758629,0
0,1438,55616,3578758629,3578758629,0
0,1438,55617,3578758629,3578758629,0
0,1438,55618,3578758629,3578758629,0
0,1438,55619,3578758629,3578758629,0
0,1438,55620,3578758629,3578758630,1
0,1438,55621,3578758629,3578758630,1
0,1438,55622,3578758629,3578758631,2
0,1438,55623,3578758629,3578758632,3
0,1438,55624,3578758629,3578758632,3
0,1438,55625,3578758629,3578758633,4
0,1438,55626,3578758629,3578758633,4
0,1438,55627,3578758629,3578758634,5
0,1438,55628,3578758629,3578758636,7
0,1438,55629,3578758629,3578758637,8
0,1438,55630,3578758629,3578758638,9
0,1438,55631,3578758629,3578758638,9
0,1438,55632,3578758629,3578758640,11
0,1438,55633,3578758629,3578758640,11
0,1438,55634,3578758629,3578758641,12
0,1438,55635,3578758629,3578758641,12
0,1438,55636,3578758629,3578758641,12
0,1438,55637,3578758629,3578758642,13
0,1438,55638,3578758629,3578758643,14
0,1438,55639,3578758629,3578758643,14
0,1438,55640,3578758629,3578758643,14
0,1438,55641,3578758629,3578758644,15
0,1438,55642,3578758629,3578758645,16
0,1438,55643,3578758629,3578758647,18
0,1438,55644,3578758629,3578758647,18
0,1438,55645,3578758629,3578758647,18
0,1438,55646,3578758629,3578758648,19
0,1438,55647,3578758629,3578758649,20
0,1438,55648,3578758629,3578758649,20
0,1438,55649,3578758629,3578758649,20
0,1438,55650,3578758629,3578758649,20
0,1438,55651,3578758629,3578758651,22
0,1438,55652,3578758629,3578758651,22
0,1438,55653,3578758629,3578758652,23
0,1438,55654,3578758629,3578758655,26
0,1438,55655,3578758629,3578758656,27
0,1438,55656,3578758629,3578758656,27
0,1438,55657,3578758629,3578758656,27
0,1438,55658,3578758629,3578758658,29
0,1438,55659,3578758629,3578758658,29
0,1438,55660,3578758629,3578758659,30
0,1438,55661,3578758629,3578758660,31
0,1438,55662,3578758629,3578758660,31
0,1438,55663,3578758629,3578758661,32
0,1438,55664,3578758629,3578758662,33
0,1438,55665,3578758629,3578758663,34
0,1438,55666,3578758629,3578758663,34
0,1438,55667,3578758629,3578758663,34
0,1438,55668,3578758629,3578758664,35
0,1438,55669,3578758629,3578758664,35
0,1438,55670,3578758629,3578758665,36
0,1438,55671,3578758629,3578758665,36
0,1438,55672,3578758629,3578758666,37
0,1438,55673,3578758629,3578758666,37
0,1438,55674,3578758629,3578758667,38
0,1438,55675,3578758629,3578758668,39
0,1438,55676,3578758629,3578758669,40
0,1439,55677,3578758693,3578758693,0
0,1439,55678,3578758693,3578758693,0
0,1439,55679,3578758693,3578758693,0
0,1439,55680,3578758693,3578758693,0
0,1439,55681,3578758693,3578758693,0
0,1439,55682,3578758693,3578758693,0
0,1439,55683,3578758693,3578758693,0
0,1439,55684,3578758693,3578758693,0
0,1439,55685,3578758693,3578758693,0
0,1439,55686,3578758693,3578758693,0
0,1439,55687,3578758693,3578758693,0
0,1439,55688,3578758693,3578758693,0
0,1439,55689,3578758693,3578758693,0
0,1439,55690,3578758693,3578758693,0
0,1439,55691,3578758693,3578758693,0
0,1439,55692,3578758693,3578758693,0
0,1439,55693,3578758693,3578758693,0
0,1439,55694,3578758693,3578758693,0
0,1439,55695,3578758693,3578758693,0
0,1439,55696,3578758693,3578758693,0
0,1439,55697,3578758693,3578758693,0
0,1439,55698,3578758693,3578758693,0
0,1439,55699,3578758693,3578758693,0
0,1439,55700,3578758693,3578758693,0
0,1439,55701,3578758693,3578758694,1
0,1439,55702,3578758693,3578758694,1
0,1439,55703,3578758693,3578758694,1
0,1439,55704,3578758693,3578758695,2
0,1439,55705,3578758693,3578758696,3
0,1439,55706,3578758693,3578758697,4
0,1439,55707,3578758693,3578758698,5
0,1439,55708,3578758693,3578758698,5
0,1439,55709,3578758693,3578758699,6
0,1439,55710,3578758693,3578758699,6
0,1439,55711,3578758693,3578758699,6
0,1439,55712,3578758693,3578758699,6
0,1439,55713,3578758693,3578758703,10
0,1439,55714,3578758693,3578758704,11
0,1439,55715,3578758693,3578758705,12
0,1439,55716,3578758693,3578758706,13
0,1439,55717,3578758693,3578758706,13
0,1439,55718,3578758693,3578758706,13
0,1439,55719,3578758693,3578758707,14
0,1439,55720,3578758693,3578758707,14
0,1439,55721,3578758693,3578758708,15
0,1439,55722,3578758693,3578758708,15
0,1439,55723,3578758693,3578758709,16
0,1439,55724,3578758693,3578758709,16
0,1439,55725,3578758693,3578758709,16
0,1439,55726,3578758693,3578758709,16
0,1439,55727,3578758693,3578758709,16
0,1439,55728,3578758693,3578758710,17
0,1439,55729,3578758693,3578758711,18
0,1439,55730,3578758693,3578758711,18
0,1439,55731,3578758693,3578758711,18
0,1439,55732,3578758693,3578758713,20
0,1439,55733,3578758693,3578758713,20
0,1439,55734,3578758693,3578758714,21
0,1439,55735,3578758693,3578758714,21
0,1439,55736,3578758693,3578758715,22
0,1439,55737,3578758693,3578758715,22
0,1439,55738,3578758693,3578758715,22
0,1439,55739,3578758693,3578758716,23
0,1439,55740,3578758693,3578758716,23
0,1439,55741,3578758693,3578758716,23
0,1439,55742,3578758693,3578758716,23
0,1439,55743,3578758693,3578758717,24
0,1439,55744,3578758693,3578758717,24
0,1439,55745,3578758693,3578758717,24
0,1439,55746,3578758693,3578758717,24
0,1439,55747,3578758693,3578758717,24
0,1439,55748,3578758693,3578758717,24
0,1439,55749,3578758693,3578758717,24
0,1439,55750,3578758693,3578758717,24
0,1439,55751,3578758693,3578758718,25
0,1439,55752,3578758693,3578758718,25
0,1439,55753,3578758693,3578758719,26
0,1439,55754,3578758693,3578758720,27
0,1439,55755,3578758693,3578758722,29
0,1439,55756,3578758693,3578758723,30
0,1439,55757,3578758693,3578758723,30
0,1439,55758,3578758693,3578758724,31
0,1439,55759,3578758693,3578758724,31
0,1439,55760,3578758693,3578758725,32
0,1439,55761,3578758693,3578758725,32
0,1439,55762,3578758693,3578758726,33
0,1439,55763,3578758693,3578758726,33
0,1439,55764,3578758693,3578758726,33
0,1439,55765,3578758693,3578758727,34
0,1439,55766,3578758693,3578758727,34
0,1439,55767,3578758693,3578758727,34
0,1439,55768,3578758693,3578758727,34
0,1439,55769,3578758693,3578758728,35
0,1439,55770,3578758693,3578758728,35
0,1439,55771,3578758693,3578758728,35
0,1439,55772,3578758693,3578758729,36
0,1439,55773,3578758693,3578758730,37
0,1439,55774,3578758693,3578758731,38
0,1439,55775,3578758693,3578758731,38
0,1439,55776,3578758693,3578758731,38
0,1439,55777,3578758693,3578758731,38
0,1439,55778,3578758693,3578758731,38
0,1439,55779,3578758693,3578758732,39
0,1439,55780,3578758693,3578758732,39
0,1439,55781,3578758693,3578758732,39
0,1439,55782,3578758693,3578758733,40
0,1439,55783,3578758693,3578758734,41
0,1439,55784,3578758693,3578758734,41
0,1439,55785,3578758693,3578758736,43
0,1439,55786,3578758693,3578758737,44
0,1439,55787,3578758693,3578758739,46
0,1439,55788,3578758693,3578758739,46
0,1439,55789,3578758693,3578758739,46
0,1439,55790,3578758693,3578758740,47
0,1439,55791,3578758693,3578758740,47
0,1439,55792,3578758693,3578758740,47
0,1439,55793,3578758693,3578758741,48
0,1439,55794,3578758693,3578758741,48
0,1439,55795,3578758693,3578758742,49
0,1439,55796,3578758693,3578758743,50
0,1440,55797,3578758758,3578758758,0
0,1440,55798,3578758758,3578758758,0
0,1440,55799,3578758758,3578758758,0
0,1440,55800,3578758758,3578758758,0
0,1440,55801,3578758758,3578758758,0
0,1440,55802,3578758758,3578758758,0
0,1440,55803,3578758758,3578758758,0
0,1440,55804,3578758758,3578758758,0
0,1440,55805,3578758758,3578758758,0
0,1440,55806,3578758758,3578758758,0
0,1440,55807,3578758758,3578758758,0
0,1440,55808,3578758758,3578758758,0
0,1440,55809,3578758758,3578758758,0
0,1440,55810,3578758758,3578758759,1
0,1440,55811,3578758758,3578758759,1
0,1440,55812,3578758758,3578758759,1
0,1440,55813,3578758758,3578758759,1
0,1440,55814,3578758758,3578758759,1
0,1440,55815,3578758758,3578758759,1
0,1440,55816,3578758758,3578758759,1
0,1440,55817,3578758758,3578758759,1
0,1440,55818,3578758758,3578758759,1
0,1440,55819,3578758758,3578758759,1
0,1440,55820,3578758758,3578758759,1
0,1440,55821,3578758758,3578758759,1
0,1440,55822,3578758758,3578758759,1
0,1440,55823,3578758758,3578758760,2
0,1440,55824,3578758758,3578758760,2
0,1440,55825,3578758758,3578758760,2
0,1440,55826,3578758758,3578758761,3
0,1440,55827,3578758758,3578758761,3
0,1440,55828,3578758758,3578758761,3
0,1440,55829,3578758758,3578758761,3
0,1440,55830,3578758758,3578758762,4
0,1440,55831,3578758758,3578758762,4
0,1440,55832,3578758758,3578758762,4
0,1440,55833,3578758758,3578758762,4
0,1440,55834,3578758758,3578758764,6
0,1440,55835,3578758758,3578758764,6
0,1440,55836,3578758758,3578758764,6
0,1440,55837,3578758758,3578758765,7
0,1440,55838,3578758758,3578758766,8
0,1440,55839,3578758758,3578758767,9
0,1440,55840,3578758758,3578758767,9
0,1440,55841,3578758758,3578758768,10
0,1440,55842,3578758758,3578758769,11
0,1440,55843,3578758758,3578758770,12
0,1440,55844,3578758758,3578758770,12
0,1440,55845,3578758758,3578758771,13
0,1440,55846,3578758758,3578758772,14
0,1440,55847,3578758758,3578758773,15
0,1440,55848,3578758758,3578758773,15
0,1440,55849,3578758758,3578758773,15
0,1440,55850,3578758758,3578758773,15
0,1440,55851,3578758758,3578758774,16
0,1440,55852,3578758758,3578758776,18
0,1440,55853,3578758758,3578758776,18
0,1440,55854,3578758758,3578758776,18
0,1440,55855,3578758758,3578758778,20
0,1440,55856,3578758758,3578758778,20
0,1440,55857,3578758758,3578758779,21
0,1440,55858,3578758758,3578758780,22
0,1440,55859,3578758758,3578758780,22
0,1440,55860,3578758758,3578758780,22
0,1440,55861,3578758758,3578758781,23
0,1440,55862,3578758758,3578758781,23
0,1440,55863,3578758758,3578758783,25
0,1440,55864,3578758758,3578758784,26
0,1440,55865,3578758758,3578758785,27
0,1440,55866,3578758758,3578758786,28
0,1440,55867,3578758758,3578758788,30
0,1440,55868,3578758758,3578758788,30
0,1440,55869,3578758758,3578758789,31
0,1440,55870,3578758758,3578758790,32
0,1440,55871,3578758758,3578758791,33
0,1440,55872,3578758758,3578758793,35
0,1440,55873,3578758758,3578758793,35
0,1440,55874,3578758758,3578758793,35
0,1440,55875,3578758758,3578758793,35
0,1440,55876,3578758758,3578758794,36
0,1440,55877,3578758758,3578758796,38
0,1440,55878,3578758758,3578758796,38
0,1440,55879,3578758758,3578758797,39
0,1440,55880,3578758758,3578758797,39
0,1440,55881,3578758758,3578758798,40
0,1440,55882,3578758758,3578758799,41
0,1440,55883,3578758758,3578758799,41
0,1440,55884,3578758758,3578758800,42
0,1440,55885,3578758758,3578758800,42
0,1440,55886,3578758758,3578758802,44
0,1440,55887,3578758758,3578758803,45
0,1440,55888,3578758758,3578758804,46
0,1440,55889,3578758758,3578758804,46
0,1440,55890,3578758758,3578758804,46
0,1440,55891,3578758758,3578758804,46
0,1440,55892,3578758758,3578758805,47
0,1440,55893,3578758758,3578758805,47
0,1440,55894,3578758758,3578758806,48
0,1440,55895,3578758758,3578758807,49
0,1440,55896,3578758758,3578758808,50
0,1441,55897,3578758821,3578758821,0
0,1441,55898,3578758821,3578758821,0
0,1441,55899,3578758821,3578758821,0
0,1441,55900,3578758821,3578758821,0
0,1441,55901,3578758821,3578758821,0
0,1441,55902,3578758821,3578758821,0
0,1441,55903,3578758821,3578758821,0
0,1441,55904,3578758821,3578758821,0
0,1441,55905,3578758821,3578758821,0
0,1441,55906,3578758821,3578758821,0
0,1441,55907,3578758821,3578758821,0
0,1441,55908,3578758821,3578758821,0
0,1441,55909,3578758821,3578758821,0
0,1441,55910,3578758821,3578758821,0
0,1441,55911,3578758821,3578758821,0
0,1441,55912,3578758821,3578758821,0
0,1441,55913,3578758821,3578758821,0
0,1441,55914,3578758821,3578758821,0
0,1441,55915,3578758821,3578758821,0
0,1441,55916,3578758821,3578758822,1
0,1441,55917,3578758821,3578758822,1
0,1441,55918,3578758821,3578758824,3
0,1441,55919,3578758821,3578758824,3
0,1441,55920,3578758821,3578758825,4
0,1441,55921,3578758821,3578758827,6
0,1441,55922,3578758821,3578758827,6
0,1441,55923,3578758821,3578758828,7
0,1441,55924,3578758821,3578758829,8
0,1441,55925,3578758821,3578758829,8
0,1441,55926,3578758821,3578758829,8
0,1441,55927,3578758821,3578758830,9
0,1441,55928,3578758821,3578758830,9
0,1441,55929,3578758821,3578758831,10
0,1441,55930,3578758821,3578758831,10
0,1441,55931,3578758821,3578758831,10
0,1441,55932,3578758821,3578758831,10
0,1441,55933,3578758821,3578758833,12
0,1441,55934,3578758821,3578758833,12
0,1441,55935,3578758821,3578758834,13
0,1441,55936,3578758821,3578758837,16
0,1441,55937,3578758821,3578758837,16
0,1441,55938,3578758821,3578758838,17
0,1441,55939,3578758821,3578758838,17
0,1441,55940,3578758821,3578758839,18
0,1441,55941,3578758821,3578758839,18
0,1441,55942,3578758821,3578758839,18
0,1441,55943,3578758821,3578758840,19
0,1441,55944,3578758821,3578758841,20
0,1441,55945,3578758821,3578758841,20
0,1441,55946,3578758821,3578758841,20
0,1441,55947,3578758821,3578758841,20
0,1441,55948,3578758821,3578758842,21
0,1441,55949,3578758821,3578758843,22
0,1441,55950,3578758821,3578758843,22
0,1441,55951,3578758821,3578758843,22
0,1441,55952,3578758821,3578758844,23
0,1441,55953,3578758821,3578758846,25
0,1441,55954,3578758821,3578758847,26
0,1441,55955,3578758821,3578758848,27
0,1441,55956,3578758821,3578758849,28
0,1441,55957,3578758821,3578758849,28
0,1441,55958,3578758821,3578758849,28
0,1441,55959,3578758821,3578758849,28
0,1441,55960,3578758821,3578758850,29
0,1441,55961,3578758821,3578758850,29
0,1441,55962,3578758821,3578758852,31
0,1441,55963,3578758821,3578758852,31
0,1441,55964,3578758821,3578758855,34
0,1441,55965,3578758821,3578758856,35
0,1441,55966,3578758821,3578758856,35
0,1441,55967,3578758821,3578758856,35
0,1441,55968,3578758821,3578758856,35
0,1441,55969,3578758821,3578758857,36
0,1441,55970,3578758821,3578758858,37
0,1441,55971,3578758821,3578758858,37
0,1441,55972,3578758821,3578758859,38
0,1441,55973,3578758821,3578758859,38
0,1441,55974,3578758821,3578758859,38
0,1441,55975,3578758821,3578758862,41
0,1441,55976,3578758821,3578758862,41
0,1441,55977,3578758821,3578758862,41
0,1441,55978,3578758821,3578758863,42
0,1441,55979,3578758821,3578758863,42
0,1441,55980,3578758821,3578758863,42
0,1441,55981,3578758821,3578758865,44
0,1441,55982,3578758821,3578758865,44
0,1441,55983,3578758821,3578758866,45
0,1441,55984,3578758821,3578758866,45
0,1441,55985,3578758821,3578758866,45
0,1441,55986,3578758821,3578758867,46
0,1441,55987,3578758821,3578758867,46
0,1441,55988,3578758821,3578758869,48
0,1442,55989,3578758885,3578758885,0
0,1442,55990,3578758885,3578758885,0
0,1442,55991,3578758885,3578758885,0
0,1442,55992,3578758885,3578758887,2
0,1442,55993,3578758885,3578758888,3
0,1442,55994,3578758885,3578758889,4
0,1442,55995,3578758885,3578758889,4
0,1442,55996,3578758885,3578758890,5
0,1442,55997,3578758885,3578758890,5
0,1442,55998,3578758885,3578758890,5
0,1442,55999,3578758885,3578758890,5
0,1442,56000,3578758885,3578758890,5
0,1442,56001,3578758885,3578758891,6
0,1442,56002,3578758885,3578758891,6
0,1442,56003,3578758885,3578758892,7
0,1442,56004,3578758885,3578758893,8
0,1442,56005,3578758885,3578758894,9
0,1442,56006,3578758885,3578758894,9
0,1442,56007,3578758885,3578758894,9
0,1442,56008,3578758885,3578758895,10
0,1442,56009,3578758885,3578758896,11
0,1442,56010,3578758885,3578758897,12
0,1442,56011,3578758885,3578758898,13
0,1442,56012,3578758885,3578758898,13
0,1442,56013,3578758885,3578758899,14
0,1442,56014,3578758885,3578758899,14
0,1442,56015,3578758885,3578758899,14
0,1442,56016,3578758885,3578758899,14
0,1442,56017,3578758885,3578758899,14
0,1442,56018,3578758885,3578758903,18
0,1442,56019,3578758885,3578758904,19
0,1442,56020,3578758885,3578758905,20
0,1442,56021,3578758885,3578758906,21
0,1442,56022,3578758885,3578758907,22
0,1442,56023,3578758885,3578758907,22
0,1442,56024,3578758885,3578758908,23
0,1442,56025,3578758885,3578758908,23
0,1442,56026,3578758885,3578758908,23
0,1442,56027,3578758885,3578758908,23
0,1442,56028,3578758885,3578758908,23
0,1442,56029,3578758885,3578758908,23
0,1442,56030,3578758885,3578758909,24
0,1442,56031,3578758885,3578758911,26
0,1442,56032,3578758885,3578758911,26
0,1442,56033,3578758885,3578758911,26
0,1442,56034,3578758885,3578758911,26
0,1442,56035,3578758885,3578758912,27
0,1442,56036,3578758885,3578758913,28
0,1442,56037,3578758885,3578758915,30
0,1442,56038,3578758885,3578758915,30
0,1442,56039,3578758885,3578758915,30
0,1442,56040,3578758885,3578758916,31
0,1442,56041,3578758885,3578758916,31
0,1442,56042,3578758885,3578758916,31
0,1442,56043,3578758885,3578758917,32
0,1442,56044,3578758885,3578758917,32
0,1442,56045,3578758885,3578758917,32
0,1442,56046,3578758885,3578758917,32
0,1442,56047,3578758885,3578758917,32
0,1442,56048,3578758885,3578758917,32
0,1442,56049,3578758885,3578758917,32
0,1442,56050,3578758885,3578758917,32
0,1442,56051,3578758885,3578758918,33
0,1442,56052,3578758885,3578758918,33
0,1442,56053,3578758885,3578758918,33
0,1442,56054,3578758885,3578758920,35
0,1442,56055,3578758885,3578758920,35
0,1442,56056,3578758885,3578758921,36
0,1442,56057,3578758885,3578758922,37
0,1442,56058,3578758885,3578758923,38
0,1442,56059,3578758885,3578758923,38
0,1442,56060,3578758885,3578758924,39
0,1442,56061,3578758885,3578758925,40
0,1442,56062,3578758885,3578758925,40
0,1442,56063,3578758885,3578758925,40
0,1442,56064,3578758885,3578758926,41
0,1442,56065,3578758885,3578758926,41
0,1442,56066,3578758885,3578758927,42
0,1442,56067,3578758885,3578758927,42
0,1442,56068,3578758885,3578758927,42
0,1442,56069,3578758885,3578758927,42
0,1442,56070,3578758885,3578758927,42
0,1442,56071,3578758885,3578758928,43
0,1442,56072,3578758885,3578758928,43
0,1442,56073,3578758885,3578758928,43
0,1442,56074,3578758885,3578758928,43
0,1442,56075,3578758885,3578758928,43
0,1442,56076,3578758885,3578758929,44
0,1442,56077,3578758885,3578758929,44
0,1442,56078,3578758885,3578758929,44
0,1442,56079,3578758885,3578758929,44
0,1442,56080,3578758885,3578758930,45
0,1442,56081,3578758885,3578758930,45
0,1442,56082,3578758885,3578758931,46
0,1442,56083,3578758885,3578758931,46
0,1442,56084,3578758885,3578758931,46
0,1442,56085,3578758885,3578758931,46
0,1442,56086,3578758885,3578758932,47
0,1442,56087,3578758885,3578758932,47
0,1442,56088,3578758885,3578758932,47
0,1442,56089,3578758885,3578758932,47
0,1442,56090,3578758885,3578758935,50
0,1443,56091,3578758948,3578758948,0
0,1443,56092,3578758948,3578758948,0
0,1443,56093,3578758948,3578758948,0
0,1443,56094,3578758948,3578758948,0
0,1443,56095,3578758948,3578758948,0
0,1443,56096,3578758948,3578758948,0
0,1443,56097,3578758948,3578758948,0
0,1443,56098,3578758948,3578758948,0
0,1443,56099,3578758948,3578758948,0
0,1443,56100,3578758948,3578758948,0
0,1443,56101,3578758948,3578758948,0
0,1443,56102,3578758948,3578758948,0
0,1443,56103,3578758948,3578758948,0
0,1443,56104,3578758948,3578758948,0
0,1443,56105,3578758948,3578758948,0
0,1443,56106,3578758948,3578758948,0
0,1443,56107,3578758948,3578758948,0
0,1443,56108,3578758948,3578758948,0
0,1443,56109,3578758948,3578758948,0
0,1443,56110,3578758948,3578758948,0
0,1443,56111,3578758948,3578758948,0
0,1443,56112,3578758948,3578758948,0
0,1443,56113,3578758948,3578758948,0
0,1443,56114,3578758948,3578758949,1
0,1443,56115,3578758948,3578758950,2
0,1443,56116,3578758948,3578758951,3
0,1443,56117,3578758948,3578758951,3
0,1443,56118,3578758948,3578758951,3
0,1443,56119,3578758948,3578758952,4
0,1443,56120,3578758948,3578758952,4
0,1443,56121,3578758948,3578758952,4
0,1443,56122,3578758948,3578758953,5
0,1443,56123,3578758948,3578758953,5
0,1443,56124,3578758948,3578758954,6
0,1443,56125,3578758948,3578758955,7
0,1443,56126,3578758948,3578758955,7
0,1443,56127,3578758948,3578758956,8
0,1443,56128,3578758948,3578758956,8
0,1443,56129,3578758948,3578758958,10
0,1443,56130,3578758948,3578758959,11
0,1443,56131,3578758948,3578758959,11
0,1443,56132,3578758948,3578758959,11
0,1443,56133,3578758948,3578758960,12
0,1443,56134,3578758948,3578758961,13
0,1443,56135,3578758948,3578758961,13
0,1443,56136,3578758948,3578758961,13
0,1443,56137,3578758948,3578758961,13
0,1443,56138,3578758948,3578758962,14
0,1443,56139,3578758948,3578758962,14
0,1443,56140,3578758948,3578758962,14
0,1443,56141,3578758948,3578758963,15
0,1443,56142,3578758948,3578758963,15
0,1443,56143,3578758948,3578758964,16
0,1443,56144,3578758948,3578758965,17
0,1443,56145,3578758948,3578758965,17
0,1443,56146,3578758948,3578758965,17
0,1443,56147,3578758948,3578758966,18
0,1443,56148,3578758948,3578758966,18
0,1443,56149,3578758948,3578758968,20
0,1443,56150,3578758948,3578758968,20
0,1443,56151,3578758948,3578758969,21
0,1443,56152,3578758948,3578758970,22
0,1443,56153,3578758948,3578758970,22
0,1443,56154,3578758948,3578758970,22
0,1443,56155,3578758948,3578758972,24
0,1443,56156,3578758948,3578758973,25
0,1443,56157,3578758948,3578758974,26
0,1443,56158,3578758948,3578758974,26
0,1443,56159,3578758948,3578758976,28
0,1443,56160,3578758948,3578758976,28
0,1443,56161,3578758948,3578758978,30
0,1443,56162,3578758948,3578758979,31
0,1443,56163,3578758948,3578758979,31
0,1443,56164,3578758948,3578758979,31
0,1443,56165,3578758948,3578758981,33
0,1443,56166,3578758948,3578758981,33
0,1443,56167,3578758948,3578758982,34
0,1443,56168,3578758948,3578758983,35
0,1443,56169,3578758948,3578758985,37
0,1443,56170,3578758948,3578758987,39
0,1443,56171,3578758948,3578758988,40
0,1443,56172,3578758948,3578758988,40
0,1443,56173,3578758948,3578758989,41
0,1443,56174,3578758948,3578758990,42
0,1443,56175,3578758948,3578758991,43
0,1443,56176,3578758948,3578758991,43
0,1443,56177,3578758948,3578758993,45
0,1443,56178,3578758948,3578758994,46
0,1443,56179,3578758948,3578758994,46
0,1443,56180,3578758948,3578758996,48
0,1443,56181,3578758948,3578758997,49
0,1443,56182,3578758948,3578758997,49
0,1443,56183,3578758948,3578758997,49
0,1443,56184,3578758948,3578758998,50
0,1444,56185,3578759012,3578759012,0
0,1444,56186,3578759012,3578759012,0
0,1444,56187,3578759012,3578759012,0
0,1444,56188,3578759012,3578759012,0
0,1444,56189,3578759012,3578759012,0
0,1444,56190,3578759012,3578759012,0
0,1444,56191,3578759012,3578759012,0
0,1444,56192,3578759012,3578759012,0
0,1444,56193,3578759012,3578759012,0
0,1444,56194,3578759012,3578759012,0
0,1444,56195,3578759012,3578759012,0
0,1444,56196,3578759012,3578759012,0
0,1444,56197,3578759012,3578759012,0
0,1444,56198,3578759012,3578759012,0
0,1444,56199,3578759012,3578759012,0
0,1444,56200,3578759012,3578759012,0
0,1444,56201,3578759012,3578759012,0
0,1444,56202,3578759012,3578759012,0
0,1444,56203,3578759012,3578759013,1
0,1444,56204,3578759012,3578759013,1
0,1444,56205,3578759012,3578759013,1
0,1444,56206,3578759012,3578759013,1
0,1444,56207,3578759012,3578759014,2
0,1444,56208,3578759012,3578759015,3
0,1444,56209,3578759012,3578759015,3
0,1444,56210,3578759012,3578759015,3
0,1444,56211,3578759012,3578759016,4
0,1444,56212,3578759012,3578759016,4
0,1444,56213,3578759012,3578759018,6
0,1444,56214,3578759012,3578759018,6
0,1444,56215,3578759012,3578759018,6
0,1444,56216,3578759012,3578759019,7
0,1444,56217,3578759012,3578759019,7
0,1444,56218,3578759012,3578759020,8
0,1444,56219,3578759012,3578759021,9
0,1444,56220,3578759012,3578759022,10
0,1444,56221,3578759012,3578759023,11
0,1444,56222,3578759012,3578759024,12
0,1444,56223,3578759012,3578759024,12
0,1444,56224,3578759012,3578759026,14
0,1444,56225,3578759012,3578759028,16
0,1444,56226,3578759012,3578759028,16
0,1444,56227,3578759012,3578759028,16
0,1444,56228,3578759012,3578759029,17
0,1444,56229,3578759012,3578759029,17
0,1444,56230,3578759012,3578759029,17
0,1444,56231,3578759012,3578759030,18
0,1444,56232,3578759012,3578759031,19
0,1444,56233,3578759012,3578759031,19
0,1444,56234,3578759012,3578759031,19
0,1444,56235,3578759012,3578759031,19
0,1444,56236,3578759012,3578759032,20
0,1444,56237,3578759012,3578759033,21
0,1444,56238,3578759012,3578759033,21
0,1444,56239,3578759012,3578759037,25
0,1444,56240,3578759012,3578759037,25
0,1444,56241,3578759012,3578759037,25
0,1444,56242,3578759012,3578759038,26
0,1444,56243,3578759012,3578759039,27
0,1444,56244,3578759012,3578759039,27
0,1444,56245,3578759012,3578759040,28
0,1444,56246,3578759012,3578759040,28
0,1444,56247,3578759012,3578759040,28
0,1444,56248,3578759012,3578759040,28
0,1444,56249,3578759012,3578759042,30
0,1444,56250,3578759012,3578759043,31
0,1444,56251,3578759012,3578759043,31
0,1444,56252,3578759012,3578759043,31
0,1444,56253,3578759012,3578759044,32
0,1444,56254,3578759012,3578759045,33
0,1444,56255,3578759012,3578759047,35
0,1444,56256,3578759012,3578759047,35
0,1444,56257,3578759012,3578759047,35
0,1444,56258,3578759012,3578759048,36
0,1444,56259,3578759012,3578759048,36
0,1444,56260,3578759012,3578759049,37
0,1444,56261,3578759012,3578759049,37
0,1444,56262,3578759012,3578759049,37
0,1444,56263,3578759012,3578759049,37
0,1444,56264,3578759012,3578759050,38
0,1444,56265,3578759012,3578759050,38
0,1444,56266,3578759012,3578759051,39
0,1444,56267,3578759012,3578759051,39
0,1444,56268,3578759012,3578759056,44
0,1444,56269,3578759012,3578759056,44
0,1444,56270,3578759012,3578759057,45
0,1444,56271,3578759012,3578759057,45
0,1444,56272,3578759012,3578759057,45
0,1444,56273,3578759012,3578759058,46
0,1444,56274,3578759012,3578759058,46
0,1444,56275,3578759012,3578759059,47
0,1444,56276,3578759012,3578759062,50
0,1445,56277,3578759074,3578759074,0
0,1445,56278,3578759074,3578759074,0
0,1445,56279,3578759074,3578759074,0
0,1445,56280,3578759074,3578759074,0
0,1445,56281,3578759074,3578759074,0
0,1445,56282,3578759074,3578759074,0
0,1445,56283,3578759074,3578759074,0
0,1445,56284,3578759074,3578759074,0
0,1445,56285,3578759074,3578759074,0
0,1445,56286,3578759074,3578759074,0
0,1445,56287,3578759074,3578759081,7
0,1445,56288,3578759074,3578759081,7
0,1445,56289,3578759074,3578759082,8
0,1445,56290,3578759074,3578759084,10
0,1445,56291,3578759074,3578759085,11
0,1445,56292,3578759074,3578759087,13
0,1445,56293,3578759074,3578759089,15
0,1445,56294,3578759074,3578759090,16
0,1445,56295,3578759074,3578759090,16
0,1445,56296,3578759074,3578759090,16
0,1445,56297,3578759074,3578759090,16
0,1445,56298,3578759074,3578759090,16
0,1445,56299,3578759074,3578759090,16
0,1445,56300,3578759074,3578759091,17
0,1445,56301,3578759074,3578759092,18
0,1445,56302,3578759074,3578759092,18
0,1445,56303,3578759074,3578759093,19
0,1445,56304,3578759074,3578759094,20
0,1445,56305,3578759074,3578759094,20
0,1445,56306,3578759074,3578759094,20
0,1445,56307,3578759074,3578759095,21
0,1445,56308,3578759074,3578759096,22
0,1445,56309,3578759074,3578759096,22
0,1445,56310,3578759074,3578759098,24
0,1445,56311,3578759074,3578759099,25
0,1445,56312,3578759074,3578759099,25
0,1445,56313,3578759074,3578759099,25
0,1445,56314,3578759074,3578759100,26
0,1445,56315,3578759074,3578759103,29
0,1445,56316,3578759074,3578759105,31
0,1445,56317,3578759074,3578759105,31
0,1445,56318,3578759074,3578759106,32
0,1445,56319,3578759074,3578759107,33
0,1445,56320,3578759074,3578759107,33
0,1445,56321,3578759074,3578759107,33
0,1445,56322,3578759074,3578759108,34
0,1445,56323,3578759074,3578759108,34
0,1445,56324,3578759074,3578759108,34
0,1445,56325,3578759074,3578759108,34
0,1445,56326,3578759074,3578759109,35
0,1445,56327,3578759074,3578759109,35
0,1445,56328,3578759074,3578759110,36
0,1445,56329,3578759074,3578759110,36
0,1445,56330,3578759074,3578759111,37
0,1445,56331,3578759074,3578759111,37
0,1445,56332,3578759074,3578759111,37
0,1445,56333,3578759074,3578759112,38
0,1445,56334,3578759074,3578759113,39
0,1445,56335,3578759074,3578759114,40
0,1445,56336,3578759074,3578759115,41
0,1445,56337,3578759074,3578759115,41
0,1445,56338,3578759074,3578759115,41
0,1445,56339,3578759074,3578759116,42
0,1445,56340,3578759074,3578759116,42
0,1445,56341,3578759074,3578759116,42
0,1445,56342,3578759074,3578759116,42
0,1445,56343,3578759074,3578759117,43
0,1445,56344,3578759074,3578759117,43
0,1445,56345,3578759074,3578759117,43
0,1445,56346,3578759074,3578759117,43
0,1445,56347,3578759074,3578759118,44
0,1445,56348,3578759074,3578759118,44
0,1445,56349,3578759074,3578759118,44
0,1445,56350,3578759074,3578759119,45
0,1445,56351,3578759074,3578759121,47
0,1445,56352,3578759074,3578759121,47
0,1445,56353,3578759074,3578759122,48
0,1445,56354,3578759074,3578759123,49
0,1445,56355,3578759074,3578759123,49
0,1445,56356,3578759074,3578759124,50
0,1446,56357,3578759137,3578759137,0
0,1446,56358,3578759137,3578759137,0
0,1446,56359,3578759137,3578759137,0
0,1446,56360,3578759137,3578759137,0
0,1446,56361,3578759137,3578759137,0
0,1446,56362,3578759137,3578759137,0
0,1446,56363,3578759137,3578759137,0
0,1446,56364,3578759137,3578759137,0
0,1446,56365,3578759137,3578759137,0
0,1446,56366,3578759137,3578759137,0
0,1446,56367,3578759137,3578759137,0
0,1446,56368,3578759137,3578759137,0
0,1446,56369,3578759137,3578759137,0
0,1446,56370,3578759137,3578759137,0
0,1446,56371,3578759137,3578759137,0
0,1446,56372,3578759137,3578759137,0
0,1446,56373,3578759137,3578759137,0
0,1446,56374,3578759137,3578759137,0
0,1446,56375,3578759137,3578759137,0
0,1446,56376,3578759137,3578759137,0
0,1446,56377,3578759137,3578759137,0
0,1446,56378,3578759137,3578759137,0
0,1446,56379,3578759137,3578759137,0
0,1446,56380,3578759137,3578759137,0
0,1446,56381,3578759137,3578759137,0
0,1446,56382,3578759137,3578759137,0
0,1446,56383,3578759137,3578759137,0
0,1446,56384,3578759137,3578759137,0
0,1446,56385,3578759137,3578759137,0
0,1446,56386,3578759137,3578759137,0
0,1446,56387,3578759137,3578759139,2
0,1446,56388,3578759137,3578759139,2
0,1446,56389,3578759137,3578759140,3
0,1446,56390,3578759137,3578759140,3
0,1446,56391,3578759137,3578759140,3
0,1446,56392,3578759137,3578759140,3
0,1446,56393,3578759137,3578759141,4
0,1446,56394,3578759137,3578759142,5
0,1446,56395,3578759137,3578759142,5
0,1446,56396,3578759137,3578759142,5
0,1446,56397,3578759137,3578759143,6
0,1446,56398,3578759137,3578759143,6
0,1446,56399,3578759137,3578759145,8
0,1446,56400,3578759137,3578759146,9
0,1446,56401,3578759137,3578759147,10
0,1446,56402,3578759137,3578759147,10
0,1446,56403,3578759137,3578759148,11
0,1446,56404,3578759137,3578759148,11
0,1446,56405,3578759137,3578759149,12
0,1446,56406,3578759137,3578759150,13
0,1446,56407,3578759137,3578759151,14
0,1446,56408,3578759137,3578759151,14
0,1446,56409,3578759137,3578759152,15
0,1446,56410,3578759137,3578759152,15
0,1446,56411,3578759137,3578759153,16
0,1446,56412,3578759137,3578759153,16
0,1446,56413,3578759137,3578759154,17
0,1446,56414,3578759137,3578759154,17
0,1446,56415,3578759137,3578759154,17
0,1446,56416,3578759137,3578759155,18
0,1446,56417,3578759137,3578759156,19
0,1446,56418,3578759137,3578759156,19
0,1446,56419,3578759137,3578759157,20
0,1446,56420,3578759137,3578759157,20
0,1446,56421,3578759137,3578759157,20
0,1446,56422,3578759137,3578759159,22
0,1446,56423,3578759137,3578759159,22
0,1446,56424,3578759137,3578759159,22
0,1446,56425,3578759137,3578759160,23
0,1446,56426,3578759137,3578759161,24
0,1446,56427,3578759137,3578759161,24
0,1446,56428,3578759137,3578759161,24
0,1446,56429,3578759137,3578759161,24
0,1446,56430,3578759137,3578759162,25
0,1446,56431,3578759137,3578759162,25
0,1446,56432,3578759137,3578759162,25
0,1446,56433,3578759137,3578759162,25
0,1446,56434,3578759137,3578759162,25
0,1446,56435,3578759137,3578759163,26
0,1446,56436,3578759137,3578759164,27
0,1446,56437,3578759137,3578759165,28
0,1446,56438,3578759137,3578759166,29
0,1446,56439,3578759137,3578759166,29
0,1446,56440,3578759137,3578759166,29
0,1446,56441,3578759137,3578759168,31
0,1446,56442,3578759137,3578759168,31
0,1446,56443,3578759137,3578759169,32
0,1446,56444,3578759137,3578759170,33
0,1446,56445,3578759137,3578759171,34
0,1446,56446,3578759137,3578759171,34
0,1446,56447,3578759137,3578759172,35
0,1446,56448,3578759137,3578759172,35
0,1446,56449,3578759137,3578759173,36
0,1446,56450,3578759137,3578759174,37
0,1446,56451,3578759137,3578759174,37
0,1446,56452,3578759137,3578759174,37
0,1446,56453,3578759137,3578759176,39
0,1446,56454,3578759137,3578759176,39
0,1446,56455,3578759137,3578759176,39
0,1446,56456,3578759137,3578759178,41
0,1446,56457,3578759137,3578759179,42
0,1446,56458,3578759137,3578759180,43
0,1446,56459,3578759137,3578759180,43
0,1446,56460,3578759137,3578759181,44
0,1446,56461,3578759137,3578759181,44
0,1446,56462,3578759137,3578759181,44
0,1446,56463,3578759137,3578759183,46
0,1446,56464,3578759137,3578759184,47
0,1446,56465,3578759137,3578759185,48
0,1446,56466,3578759137,3578759187,50
0,1447,56467,3578759199,3578759199,0
0,1447,56468,3578759199,3578759199,0
0,1447,56469,3578759199,3578759199,0
0,1447,56470,3578759199,3578759199,0
0,1447,56471,3578759199,3578759199,0
0,1447,56472,3578759199,3578759199,0
0,1447,56473,3578759199,3578759199,0
0,1447,56474,3578759199,3578759199,0
0,1447,56475,3578759199,3578759199,0
0,1447,56476,3578759199,3578759199,0
0,1447,56477,3578759199,3578759199,0
0,1447,56478,3578759199,3578759199,0
0,1447,56479,3578759199,3578759199,0
0,1447,56480,3578759199,3578759199,0
0,1447,56481,3578759199,3578759199,0
0,1447,56482,3578759199,3578759200,1
0,1447,56483,3578759199,3578759201,2
0,1447,56484,3578759199,3578759202,3
0,1447,56485,3578759199,3578759203,4
0,1447,56486,3578759199,3578759203,4
0,1447,56487,3578759199,3578759205,6
0,1447,56488,3578759199,3578759205,6
0,1447,56489,3578759199,3578759205,6
0,1447,56490,3578759199,3578759206,7
0,1447,56491,3578759199,3578759206,7
0,1447,56492,3578759199,3578759207,8
0,1447,56493,3578759199,3578759209,10
0,1447,56494,3578759199,3578759210,11
0,1447,56495,3578759199,3578759211,12
0,1447,56496,3578759199,3578759212,13
0,1447,56497,3578759199,3578759212,13
0,1447,56498,3578759199,3578759213,14
0,1447,56499,3578759199,3578759214,15
0,1447,56500,3578759199,3578759214,15
0,1447,56501,3578759199,3578759215,16
0,1447,56502,3578759199,3578759215,16
0,1447,56503,3578759199,3578759216,17
0,1447,56504,3578759199,3578759216,17
0,1447,56505,3578759199,3578759217,18
0,1447,56506,3578759199,3578759218,19
0,1447,56507,3578759199,3578759218,19
0,1447,56508,3578759199,3578759218,19
0,1447,56509,3578759199,3578759218,19
0,1447,56510,3578759199,3578759218,19
0,1447,56511,3578759199,3578759219,20
0,1447,56512,3578759199,3578759220,21
0,1447,56513,3578759199,3578759221,22
0,1447,56514,3578759199,3578759221,22
0,1447,56515,3578759199,3578759224,25
0,1447,56516,3578759199,3578759225,26
0,1447,56517,3578759199,3578759225,26
0,1447,56518,3578759199,3578759227,28
0,1447,56519,3578759199,3578759228,29
0,1447,56520,3578759199,3578759229,30
0,1447,56521,3578759199,3578759229,30
0,1447,56522,3578759199,3578759230,31
0,1447,56523,3578759199,3578759231,32
0,1447,56524,3578759199,3578759232,33
0,1447,56525,3578759199,3578759232,33
0,1447,56526,3578759199,3578759233,34
0,1447,56527,3578759199,3578759233,34
0,1447,56528,3578759199,3578759234,35
0,1447,56529,3578759199,3578759234,35
0,1447,56530,3578759199,3578759237,38
0,1447,56531,3578759199,3578759237,38
0,1447,56532,3578759199,3578759237,38
0,1447,56533,3578759199,3578759237,38
0,1447,56534,3578759199,3578759238,39
0,1447,56535,3578759199,3578759239,40
0,1447,56536,3578759199,3578759239,40
0,1447,56537,3578759199,3578759239,40
0,1447,56538,3578759199,3578759239,40
0,1447,56539,3578759199,3578759239,40
0,1447,56540,3578759199,3578759240,41
0,1447,56541,3578759199,3578759241,42
0,1447,56542,3578759199,3578759241,42
0,1447,56543,3578759199,3578759242,43
0,1447,56544,3578759199,3578759242,43
0,1447,56545,3578759199,3578759243,44
0,1447,56546,3578759199,3578759243,44
0,1447,56547,3578759199,3578759243,44
0,1447,56548,3578759199,3578759243,44
0,1447,56549,3578759199,3578759243,44
0,1447,56550,3578759199,3578759246,47
0,1447,56551,3578759199,3578759247,48
0,1447,56552,3578759199,3578759248,49
0,1447,56553,3578759199,3578759248,49
0,1447,56554,3578759199,3578759248,49
0,1447,56555,3578759199,3578759249,50
0,1448,56556,3578759262,3578759262,0
0,1448,56557,3578759262,3578759262,0
0,1448,56558,3578759262,3578759262,0
0,1448,56559,3578759262,3578759262,0
0,1448,56560,3578759262,3578759262,0
0,1448,56561,3578759262,3578759262,0
0,1448,56562,3578759262,3578759262,0
0,1448,56563,3578759262,3578759262,0
0,1448,56564,3578759262,3578759262,0
0,1448,56565,3578759262,3578759262,0
0,1448,56566,3578759262,3578759262,0
0,1448,56567,3578759262,3578759262,0
0,1448,56568,3578759262,3578759262,0
0,1448,56569,3578759262,3578759262,0
0,1448,56570,3578759262,3578759263,1
0,1448,56571,3578759262,3578759263,1
0,1448,56572,3578759262,3578759263,1
0,1448,56573,3578759262,3578759263,1
0,1448,56574,3578759262,3578759264,2
0,1448,56575,3578759262,3578759264,2
0,1448,56576,3578759262,3578759266,4
0,1448,56577,3578759262,3578759266,4
0,1448,56578,3578759262,3578759266,4
0,1448,56579,3578759262,3578759267,5
0,1448,56580,3578759262,3578759267,5
0,1448,56581,3578759262,3578759267,5
0,1448,56582,3578759262,3578759269,7
0,1448,56583,3578759262,3578759281,19
0,1448,56584,3578759262,3578759281,19
0,1448,56585,3578759262,3578759285,23
0,1448,56586,3578759262,3578759287,25
0,1448,56587,3578759262,3578759289,27
0,1448,56588,3578759262,3578759289,27
0,1448,56589,3578759262,3578759290,28
0,1448,56590,3578759262,3578759290,28
0,1448,56591,3578759262,3578759290,28
0,1448,56592,3578759262,3578759290,28
0,1448,56593,3578759262,3578759291,29
0,1448,56594,3578759262,3578759291,29
0,1448,56595,3578759262,3578759291,29
0,1448,56596,3578759262,3578759291,29
0,1448,56597,3578759262,3578759292,30
0,1448,56598,3578759262,3578759293,31
0,1448,56599,3578759262,3578759294,32
0,1448,56600,3578759262,3578759294,32
0,1448,56601,3578759262,3578759294,32
0,1448,56602,3578759262,3578759294,32
0,1448,56603,3578759262,3578759296,34
0,1448,56604,3578759262,3578759297,35
0,1448,56605,3578759262,3578759298,36
0,1448,56606,3578759262,3578759299,37
0,1448,56607,3578759262,3578759299,37
0,1448,56608,3578759262,3578759299,37
0,1448,56609,3578759262,3578759299,37
0,1448,56610,3578759262,3578759303,41
0,1448,56611,3578759262,3578759305,43
0,1448,56612,3578759262,3578759305,43
0,1448,56613,3578759262,3578759307,45
0,1448,56614,3578759262,3578759307,45
0,1448,56615,3578759262,3578759307,45
0,1448,56616,3578759262,3578759307,45
0,1448,56617,3578759262,3578759307,45
0,1448,56618,3578759262,3578759307,45
0,1448,56619,3578759262,3578759308,46
0,1448,56620,3578759262,3578759308,46
0,1448,56621,3578759262,3578759308,46
0,1448,56622,3578759262,3578759309,47
0,1448,56623,3578759262,3578759310,48
0,1448,56624,3578759262,3578759311,49
0,1448,56625,3578759262,3578759311,49
0,1448,56626,3578759262,3578759311,49
0,1448,56627,3578759262,3578759311,49
0,1448,56628,3578759262,3578759311,49
0,1448,56629,3578759262,3578759312,50
0,1449,56630,3578759326,3578759326,0
0,1449,56631,3578759326,3578759326,0
0,1449,56632,3578759326,3578759326,0
0,1449,56633,3578759326,3578759326,0
0,1449,56634,3578759326,3578759326,0
0,1449,56635,3578759326,3578759326,0
0,1449,56636,3578759326,3578759326,0
0,1449,56637,3578759326,3578759326,0
0,1449,56638,3578759326,3578759326,0
0,1449,56639,3578759326,3578759326,0
0,1449,56640,3578759326,3578759326,0
0,1449,56641,3578759326,3578759326,0
0,1449,56642,3578759326,3578759326,0
0,1449,56643,3578759326,3578759326,0
0,1449,56644,3578759326,3578759326,0
0,1449,56645,3578759326,3578759326,0
0,1449,56646,3578759326,3578759326,0
0,1449,56647,3578759326,3578759326,0
0,1449,56648,3578759326,3578759326,0
0,1449,56649,3578759326,3578759326,0
0,1449,56650,3578759326,3578759326,0
0,1449,56651,3578759326,3578759326,0
0,1449,56652,3578759326,3578759326,0
0,1449,56653,3578759326,3578759326,0
0,1449,56654,3578759326,3578759326,0
0,1449,56655,3578759326,3578759326,0
0,1449,56656,3578759326,3578759327,1
0,1449,56657,3578759326,3578759327,1
0,1449,56658,3578759326,3578759327,1
0,1449,56659,3578759326,3578759327,1
0,1449,56660,3578759326,3578759327,1
0,1449,56661,3578759326,3578759327,1
0,1449,56662,3578759326,3578759328,2
0,1449,56663,3578759326,3578759328,2
0,1449,56664,3578759326,3578759329,3
0,1449,56665,3578759326,3578759329,3
0,1449,56666,3578759326,3578759330,4
0,1449,56667,3578759326,3578759330,4
0,1449,56668,3578759326,3578759331,5
0,1449,56669,3578759326,3578759331,5
0,1449,56670,3578759326,3578759331,5
0,1449,56671,3578759326,3578759332,6
0,1449,56672,3578759326,3578759332,6
0,1449,56673,3578759326,3578759332,6
0,1449,56674,3578759326,3578759332,6
0,1449,56675,3578759326,3578759334,8
0,1449,56676,3578759326,3578759335,9
0,1449,56677,3578759326,3578759335,9
0,1449,56678,3578759326,3578759336,10
0,1449,56679,3578759326,3578759336,10
0,1449,56680,3578759326,3578759339,13
0,1449,56681,3578759326,3578759339,13
0,1449,56682,3578759326,3578759340,14
0,1449,56683,3578759326,3578759340,14
0,1449,56684,3578759326,3578759340,14
0,1449,56685,3578759326,3578759341,15
0,1449,56686,3578759326,3578759341,15
0,1449,56687,3578759326,3578759343,17
0,1449,56688,3578759326,3578759343,17
0,1449,56689,3578759326,3578759343,17
0,1449,56690,3578759326,3578759343,17
0,1449,56691,3578759326,3578759343,17
0,1449,56692,3578759326,3578759344,18
0,1449,56693,3578759326,3578759344,18
0,1449,56694,3578759326,3578759345,19
0,1449,56695,3578759326,3578759346,20
0,1449,56696,3578759326,3578759348,22
0,1449,56697,3578759326,3578759348,22
0,1449,56698,3578759326,3578759348,22
0,1449,56699,3578759326,3578759349,23
0,1449,56700,3578759326,3578759350,24
0,1449,56701,3578759326,3578759351,25
0,1449,56702,3578759326,3578759351,25
0,1449,56703,3578759326,3578759353,27
0,1449,56704,3578759326,3578759353,27
0,1449,56705,3578759326,3578759354,28
0,1449,56706,3578759326,3578759354,28
0,1449,56707,3578759326,3578759355,29
0,1449,56708,3578759326,3578759356,30
0,1449,56709,3578759326,3578759357,31
0,1449,56710,3578759326,3578759357,31
0,1449,56711,3578759326,3578759358,32
0,1449,56712,3578759326,3578759360,34
0,1449,56713,3578759326,3578759360,34
0,1449,56714,3578759326,3578759361,35
0,1449,56715,3578759326,3578759361,35
0,1449,56716,3578759326,3578759361,35
0,1449,56717,3578759326,3578759361,35
0,1449,56718,3578759326,3578759361,35
0,1449,56719,3578759326,3578759361,35
0,1449,56720,3578759326,3578759362,36
0,1449,56721,3578759326,3578759362,36
0,1449,56722,3578759326,3578759363,37
0,1449,56723,3578759326,3578759364,38
0,1449,56724,3578759326,3578759365,39
0,1449,56725,3578759326,3578759365,39
0,1449,56726,3578759326,3578759365,39
0,1449,56727,3578759326,3578759365,39
0,1449,56728,3578759326,3578759367,41
0,1449,56729,3578759326,3578759367,41
0,1449,56730,3578759326,3578759369,43
0,1449,56731,3578759326,3578759370,44
0,1449,56732,3578759326,3578759370,44
0,1449,56733,3578759326,3578759371,45
0,1449,56734,3578759326,3578759372,46
0,1449,56735,3578759326,3578759372,46
0,1449,56736,3578759326,3578759373,47
0,1449,56737,3578759326,3578759374,48
0,1449,56738,3578759326,3578759374,48
0,1449,56739,3578759326,3578759374,48
0,1449,56740,3578759326,3578759375,49
0,1449,56741,3578759326,3578759376,50
0,1449,56742,3578759326,3578759376,50
0,1450,56743,3578759389,3578759389,0
0,1450,56744,3578759389,3578759389,0
0,1450,56745,3578759389,3578759389,0
0,1450,56746,3578759389,3578759389,0
0,1450,56747,3578759389,3578759389,0
0,1450,56748,3578759389,3578759389,0
0,1450,56749,3578759389,3578759389,0
0,1450,56750,3578759389,3578759389,0
0,1450,56751,3578759389,3578759389,0
0,1450,56752,3578759389,3578759389,0
0,1450,56753,3578759389,3578759389,0
0,1450,56754,3578759389,3578759389,0
0,1450,56755,3578759389,3578759389,0
0,1450,56756,3578759389,3578759389,0
0,1450,56757,3578759389,3578759391,2
0,1450,56758,3578759389,3578759391,2
0,1450,56759,3578759389,3578759391,2
0,1450,56760,3578759389,3578759393,4
0,1450,56761,3578759389,3578759394,5
0,1450,56762,3578759389,3578759396,7
0,1450,56763,3578759389,3578759397,8
0,1450,56764,3578759389,3578759397,8
0,1450,56765,3578759389,3578759397,8
0,1450,56766,3578759389,3578759398,9
0,1450,56767,3578759389,3578759399,10
0,1450,56768,3578759389,3578759401,12
0,1450,56769,3578759389,3578759401,12
0,1450,56770,3578759389,3578759402,13
0,1450,56771,3578759389,3578759402,13
0,1450,56772,3578759389,3578759404,15
0,1450,56773,3578759389,3578759405,16
0,1450,56774,3578759389,3578759405,16
0,1450,56775,3578759389,3578759406,17
0,1450,56776,3578759389,3578759406,17
0,1450,56777,3578759389,3578759406,17
0,1450,56778,3578759389,3578759407,18
0,1450,56779,3578759389,3578759408,19
0,1450,56780,3578759389,3578759409,20
0,1450,56781,3578759389,3578759411,22
0,1450,56782,3578759389,3578759413,24
0,1450,56783,3578759389,3578759413,24
0,1450,56784,3578759389,3578759413,24
0,1450,56785,3578759389,3578759415,26
0,1450,56786,3578759389,3578759415,26
0,1450,56787,3578759389,3578759415,26
0,1450,56788,3578759389,3578759416,27
0,1450,56789,3578759389,3578759416,27
0,1450,56790,3578759389,3578759416,27
0,1450,56791,3578759389,3578759417,28
0,1450,56792,3578759389,3578759418,29
0,1450,56793,3578759389,3578759419,30
0,1450,56794,3578759389,3578759419,30
0,1450,56795,3578759389,3578759420,31
0,1450,56796,3578759389,3578759420,31
0,1450,56797,3578759389,3578759420,31
0,1450,56798,3578759389,3578759421,32
0,1450,56799,3578759389,3578759421,32
0,1450,56800,3578759389,3578759421,32
0,1450,56801,3578759389,3578759423,34
0,1450,56802,3578759389,3578759424,35
0,1450,56803,3578759389,3578759425,36
0,1450,56804,3578759389,3578759425,36
0,1450,56805,3578759389,3578759427,38
0,1450,56806,3578759389,3578759429,40
0,1450,56807,3578759389,3578759429,40
0,1450,56808,3578759389,3578759430,41
0,1450,56809,3578759389,3578759430,41
0,1450,56810,3578759389,3578759431,42
0,1450,56811,3578759389,3578759431,42
0,1450,56812,3578759389,3578759432,43
0,1450,56813,3578759389,3578759432,43
0,1450,56814,3578759389,3578759433,44
0,1450,56815,3578759389,3578759433,44
0,1450,56816,3578759389,3578759433,44
0,1450,56817,3578759389,3578759434,45
0,1450,56818,3578759389,3578759435,46
0,1450,56819,3578759389,3578759436,47
0,1450,56820,3578759389,3578759437,48
0,1450,56821,3578759389,3578759438,49
0,1450,56822,3578759389,3578759439,50
0,1451,56823,3578759452,3578759452,0
0,1451,56824,3578759452,3578759452,0
0,1451,56825,3578759452,3578759452,0
0,1451,56826,3578759452,3578759452,0
0,1451,56827,3578759452,3578759452,0
0,1451,56828,3578759452,3578759452,0
0,1451,56829,3578759452,3578759452,0
0,1451,56830,3578759452,3578759452,0
0,1451,56831,3578759452,3578759452,0
0,1451,56832,3578759452,3578759452,0
0,1451,56833,3578759452,3578759452,0
0,1451,56834,3578759452,3578759452,0
0,1451,56835,3578759452,3578759452,0
0,1451,56836,3578759452,3578759452,0
0,1451,56837,3578759452,3578759452,0
0,1451,56838,3578759452,3578759452,0
0,1451,56839,3578759452,3578759452,0
0,1451,56840,3578759452,3578759452,0
0,1451,56841,3578759452,3578759452,0
0,1451,56842,3578759452,3578759452,0
0,1451,56843,3578759452,3578759452,0
0,1451,56844,3578759452,3578759452,0
0,1451,56845,3578759452,3578759452,0
0,1451,56846,3578759452,3578759452,0
0,1451,56847,3578759452,3578759453,1
0,1451,56848,3578759452,3578759453,1
0,1451,56849,3578759452,3578759456,4
0,1451,56850,3578759452,3578759457,5
0,1451,56851,3578759452,3578759457,5
0,1451,56852,3578759452,3578759459,7
0,1451,56853,3578759452,3578759459,7
0,1451,56854,3578759452,3578759459,7
0,1451,56855,3578759452,3578759459,7
0,1451,56856,3578759452,3578759460,8
0,1451,56857,3578759452,3578759462,10
0,1451,56858,3578759452,3578759462,10
0,1451,56859,3578759452,3578759462,10
0,1451,56860,3578759452,3578759463,11
0,1451,56861,3578759452,3578759464,12
0,1451,56862,3578759452,3578759464,12
0,1451,56863,3578759452,3578759465,13
0,1451,56864,3578759452,3578759466,14
0,1451,56865,3578759452,3578759466,14
0,1451,56866,3578759452,3578759467,15
0,1451,56867,3578759452,3578759467,15
0,1451,56868,3578759452,3578759467,15
0,1451,56869,3578759452,3578759470,18
0,1451,56870,3578759452,3578759481,29
0,1451,56871,3578759452,3578759482,30
0,1451,56872,3578759452,3578759485,33
0,1451,56873,3578759452,3578759487,35
0,1451,56874,3578759452,3578759487,35
0,1451,56875,3578759452,3578759487,35
0,1451,56876,3578759452,3578759489,37
0,1451,56877,3578759452,3578759489,37
0,1451,56878,3578759452,3578759490,38
0,1451,56879,3578759452,3578759490,38
0,1451,56880,3578759452,3578759490,38
0,1451,56881,3578759452,3578759490,38
0,1451,56882,3578759452,3578759491,39
0,1451,56883,3578759452,3578759491,39
0,1451,56884,3578759452,3578759492,40
0,1451,56885,3578759452,3578759492,40
0,1451,56886,3578759452,3578759494,42
0,1451,56887,3578759452,3578759494,42
0,1451,56888,3578759452,3578759497,45
0,1451,56889,3578759452,3578759498,46
0,1451,56890,3578759452,3578759498,46
0,1451,56891,3578759452,3578759498,46
0,1451,56892,3578759452,3578759499,47
0,1451,56893,3578759452,3578759499,47
0,1451,56894,3578759452,3578759500,48
0,1452,56895,3578759515,3578759515,0
0,1452,56896,3578759515,3578759515,0
0,1452,56897,3578759515,3578759515,0
0,1452,56898,3578759515,3578759515,0
0,1452,56899,3578759515,3578759515,0
0,1452,56900,3578759515,3578759515,0
0,1452,56901,3578759515,3578759515,0
0,1452,56902,3578759515,3578759515,0
0,1452,56903,3578759515,3578759515,0
0,1452,56904,3578759515,3578759515,0
0,1452,56905,3578759515,3578759515,0
0,1452,56906,3578759515,3578759515,0
0,1452,56907,3578759515,3578759515,0
0,1452,56908,3578759515,3578759515,0
0,1452,56909,3578759515,3578759515,0
0,1452,56910,3578759515,3578759515,0
0,1452,56911,3578759515,3578759515,0
0,1452,56912,3578759515,3578759515,0
0,1452,56913,3578759515,3578759515,0
0,1452,56914,3578759515,3578759515,0
0,1452,56915,3578759515,3578759515,0
0,1452,56916,3578759515,3578759515,0
0,1452,56917,3578759515,3578759515,0
0,1452,56918,3578759515,3578759515,0
0,1452,56919,3578759515,3578759515,0
0,1452,56920,3578759515,3578759515,0
0,1452,56921,3578759515,3578759515,0
0,1452,56922,3578759515,3578759516,1
0,1452,56923,3578759515,3578759516,1
0,1452,56924,3578759515,3578759516,1
0,1452,56925,3578759515,3578759516,1
0,1452,56926,3578759515,3578759516,1
0,1452,56927,3578759515,3578759517,2
0,1452,56928,3578759515,3578759517,2
0,1452,56929,3578759515,3578759518,3
0,1452,56930,3578759515,3578759518,3
0,1452,56931,3578759515,3578759520,5
0,1452,56932,3578759515,3578759520,5
0,1452,56933,3578759515,3578759521,6
0,1452,56934,3578759515,3578759523,8
0,1452,56935,3578759515,3578759523,8
0,1452,56936,3578759515,3578759524,9
0,1452,56937,3578759515,3578759525,10
0,1452,56938,3578759515,3578759526,11
0,1452,56939,3578759515,3578759526,11
0,1452,56940,3578759515,3578759526,11
0,1452,56941,3578759515,3578759526,11
0,1452,56942,3578759515,3578759526,11
0,1452,56943,3578759515,3578759528,13
0,1452,56944,3578759515,3578759528,13
0,1452,56945,3578759515,3578759528,13
0,1452,56946,3578759515,3578759529,14
0,1452,56947,3578759515,3578759530,15
0,1452,56948,3578759515,3578759531,16
0,1452,56949,3578759515,3578759531,16
0,1452,56950,3578759515,3578759531,16
0,1452,56951,3578759515,3578759531,16
0,1452,56952,3578759515,3578759532,17
0,1452,56953,3578759515,3578759532,17
0,1452,56954,3578759515,3578759533,18
0,1452,56955,3578759515,3578759534,19
0,1452,56956,3578759515,3578759536,21
0,1452,56957,3578759515,3578759538,23
0,1452,56958,3578759515,3578759538,23
0,1452,56959,3578759515,3578759539,24
0,1452,56960,3578759515,3578759539,24
0,1452,56961,3578759515,3578759539,24
0,1452,56962,3578759515,3578759540,25
0,1452,56963,3578759515,3578759540,25
0,1452,56964,3578759515,3578759541,26
0,1452,56965,3578759515,3578759541,26
0,1452,56966,3578759515,3578759542,27
0,1452,56967,3578759515,3578759542,27
0,1452,56968,3578759515,3578759542,27
0,1452,56969,3578759515,3578759543,28
0,1452,56970,3578759515,3578759544,29
0,1452,56971,3578759515,3578759544,29
0,1452,56972,3578759515,3578759544,29
0,1452,56973,3578759515,3578759545,30
0,1452,56974,3578759515,3578759545,30
0,1452,56975,3578759515,3578759546,31
0,1452,56976,3578759515,3578759547,32
0,1452,56977,3578759515,3578759547,32
0,1452,56978,3578759515,3578759547,32
0,1452,56979,3578759515,3578759549,34
0,1452,56980,3578759515,3578759549,34
0,1452,56981,3578759515,3578759550,35
0,1452,56982,3578759515,3578759550,35
0,1452,56983,3578759515,3578759551,36
0,1452,56984,3578759515,3578759552,37
0,1452,56985,3578759515,3578759552,37
0,1452,56986,3578759515,3578759552,37
0,1452,56987,3578759515,3578759552,37
0,1452,56988,3578759515,3578759553,38
0,1452,56989,3578759515,3578759555,40
0,1452,56990,3578759515,3578759555,40
0,1452,56991,3578759515,3578759555,40
0,1452,56992,3578759515,3578759555,40
0,1452,56993,3578759515,3578759556,41
0,1452,56994,3578759515,3578759557,42
0,1452,56995,3578759515,3578759557,42
0,1452,56996,3578759515,3578759558,43
0,1452,56997,3578759515,3578759558,43
0,1452,56998,3578759515,3578759559,44
0,1452,56999,3578759515,3578759559,44
0,1452,57000,3578759515,3578759560,45
0,1452,57001,3578759515,3578759560,45
0,1452,57002,3578759515,3578759560,45
0,1452,57003,3578759515,3578759561,46
0,1452,57004,3578759515,3578759561,46
0,1452,57005,3578759515,3578759562,47
0,1452,57006,3578759515,3578759562,47
0,1452,57007,3578759515,3578759564,49
0,1452,57008,3578759515,3578759564,49
0,1452,57009,3578759515,3578759564,49
0,1452,57010,3578759515,3578759565,50
0,1453,57011,3578759577,3578759577,0
0,1453,57012,3578759577,3578759577,0
0,1453,57013,3578759577,3578759577,0
0,1453,57014,3578759577,3578759577,0
0,1453,57015,3578759577,3578759577,0
0,1453,57016,3578759577,3578759577,0
0,1453,57017,3578759577,3578759577,0
0,1453,57018,3578759577,3578759577,0
0,1453,57019,3578759577,3578759577,0
0,1453,57020,3578759577,3578759577,0
0,1453,57021,3578759577,3578759577,0
0,1453,57022,3578759577,3578759577,0
0,1453,57023,3578759577,3578759578,1
0,1453,57024,3578759577,3578759578,1
0,1453,57025,3578759577,3578759578,1
0,1453,57026,3578759577,3578759578,1
0,1453,57027,3578759577,3578759578,1
0,1453,57028,3578759577,3578759578,1
0,1453,57029,3578759577,3578759579,2
0,1453,57030,3578759577,3578759579,2
0,1453,57031,3578759577,3578759580,3
0,1453,57032,3578759577,3578759580,3
0,1453,57033,3578759577,3578759581,4
0,1453,57034,3578759577,3578759581,4
0,1453,57035,3578759577,3578759581,4
0,1453,57036,3578759577,3578759583,6
0,1453,57037,3578759577,3578759583,6
0,1453,57038,3578759577,3578759585,8
0,1453,57039,3578759577,3578759586,9
0,1453,57040,3578759577,3578759587,10
0,1453,57041,3578759577,3578759587,10
0,1453,57042,3578759577,3578759589,12
0,1453,57043,3578759577,3578759589,12
0,1453,57044,3578759577,3578759589,12
0,1453,57045,3578759577,3578759590,13
0,1453,57046,3578759577,3578759590,13
0,1453,57047,3578759577,3578759592,15
0,1453,57048,3578759577,3578759593,16
0,1453,57049,3578759577,3578759596,19
0,1453,57050,3578759577,3578759596,19
0,1453,57051,3578759577,3578759596,19
0,1453,57052,3578759577,3578759597,20
0,1453,57053,3578759577,3578759598,21
0,1453,57054,3578759577,3578759598,21
0,1453,57055,3578759577,3578759600,23
0,1453,57056,3578759577,3578759600,23
0,1453,57057,3578759577,3578759602,25
0,1453,57058,3578759577,3578759602,25
0,1453,57059,3578759577,3578759604,27
0,1453,57060,3578759577,3578759604,27
0,1453,57061,3578759577,3578759604,27
0,1453,57062,3578759577,3578759604,27
0,1453,57063,3578759577,3578759605,28
0,1453,57064,3578759577,3578759606,29
0,1453,57065,3578759577,3578759606,29
0,1453,57066,3578759577,3578759607,30
0,1453,57067,3578759577,3578759608,31
0,1453,57068,3578759577,3578759609,32
0,1453,57069,3578759577,3578759611,34
0,1453,57070,3578759577,3578759613,36
0,1453,57071,3578759577,3578759613,36
0,1453,57072,3578759577,3578759613,36
0,1453,57073,3578759577,3578759613,36
0,1453,57074,3578759577,3578759614,37
0,1453,57075,3578759577,3578759615,38
0,1453,57076,3578759577,3578759615,38
0,1453,57077,3578759577,3578759616,39
0,1453,57078,3578759577,3578759616,39
0,1453,57079,3578759577,3578759616,39
0,1453,57080,3578759577,3578759617,40
0,1453,57081,3578759577,3578759617,40
0,1453,57082,3578759577,3578759618,41
0,1453,57083,3578759577,3578759618,41
0,1453,57084,3578759577,3578759619,42
0,1453,57085,3578759577,3578759619,42
0,1453,57086,3578759577,3578759620,43
0,1453,57087,3578759577,3578759621,44
0,1453,57088,3578759577,3578759621,44
0,1453,57089,3578759577,3578759622,45
0,1453,57090,3578759577,3578759623,46
0,1453,57091,3578759577,3578759623,46
0,1453,57092,3578759577,3578759624,47
0,1453,57093,3578759577,3578759624,47
0,1454,57094,3578759642,3578759642,0
0,1454,57095,3578759642,3578759642,0
0,1454,57096,3578759642,3578759642,0
0,1454,57097,3578759642,3578759642,0
0,1454,57098,3578759642,3578759642,0
0,1454,57099,3578759642,3578759642,0
0,1454,57100,3578759642,3578759642,0
0,1454,57101,3578759642,3578759642,0
0,1454,57102,3578759642,3578759642,0
0,1454,57103,3578759642,3578759642,0
0,1454,57104,3578759642,3578759642,0
0,1454,57105,3578759642,3578759642,0
0,1454,57106,3578759642,3578759642,0
0,1454,57107,3578759642,3578759642,0
0,1454,57108,3578759642,3578759642,0
0,1454,57109,3578759642,3578759642,0
0,1454,57110,3578759642,3578759642,0
0,1454,57111,3578759642,3578759642,0
0,1454,57112,3578759642,3578759642,0
0,1454,57113,3578759642,3578759642,0
0,1454,57114,3578759642,3578759642,0
0,1454,57115,3578759642,3578759642,0
0,1454,57116,3578759642,3578759642,0
0,1454,57117,3578759642,3578759642,0
0,1454,57118,3578759642,3578759642,0
0,1454,57119,3578759642,3578759642,0
0,1454,57120,3578759642,3578759643,1
0,1454,57121,3578759642,3578759644,2
0,1454,57122,3578759642,3578759644,2
0,1454,57123,3578759642,3578759646,4
0,1454,57124,3578759642,3578759647,5
0,1454,57125,3578759642,3578759647,5
0,1454,57126,3578759642,3578759647,5
0,1454,57127,3578759642,3578759648,6
0,1454,57128,3578759642,3578759649,7
0,1454,57129,3578759642,3578759649,7
0,1454,57130,3578759642,3578759649,7
0,1454,57131,3578759642,3578759651,9
0,1454,57132,3578759642,3578759652,10
0,1454,57133,3578759642,3578759652,10
0,1454,57134,3578759642,3578759655,13
0,1454,57135,3578759642,3578759655,13
0,1454,57136,3578759642,3578759655,13
0,1454,57137,3578759642,3578759656,14
0,1454,57138,3578759642,3578759657,15
0,1454,57139,3578759642,3578759658,16
0,1454,57140,3578759642,3578759658,16
0,1454,57141,3578759642,3578759659,17
0,1454,57142,3578759642,3578759659,17
0,1454,57143,3578759642,3578759661,19
0,1454,57144,3578759642,3578759661,19
0,1454,57145,3578759642,3578759661,19
0,1454,57146,3578759642,3578759662,20
0,1454,57147,3578759642,3578759662,20
0,1454,57148,3578759642,3578759663,21
0,1454,57149,3578759642,3578759664,22
0,1454,57150,3578759642,3578759664,22
0,1454,57151,3578759642,3578759664,22
0,1454,57152,3578759642,3578759665,23
0,1454,57153,3578759642,3578759665,23
0,1454,57154,3578759642,3578759666,24
0,1454,57155,3578759642,3578759666,24
0,1454,57156,3578759642,3578759667,25
0,1454,57157,3578759642,3578759667,25
0,1454,57158,3578759642,3578759670,28
0,1454,57159,3578759642,3578759681,39
0,1454,57160,3578759642,3578759682,40
0,1454,57161,3578759642,3578759682,40
0,1454,57162,3578759642,3578759686,44
0,1454,57163,3578759642,3578759687,45
0,1454,57164,3578759642,3578759687,45
0,1454,57165,3578759642,3578759687,45
0,1454,57166,3578759642,3578759689,47
0,1454,57167,3578759642,3578759689,47
0,1454,57168,3578759642,3578759690,48
0,1454,57169,3578759642,3578759690,48
0,1454,57170,3578759642,3578759690,48
0,1454,57171,3578759642,3578759690,48
0,1454,57172,3578759642,3578759691,49
0,1454,57173,3578759642,3578759691,49
0,1454,57174,3578759642,3578759691,49
0,1454,57175,3578759642,3578759691,49
0,1454,57176,3578759642,3578759691,49
0,1455,57177,3578759706,3578759706,0
0,1455,57178,3578759706,3578759706,0
0,1455,57179,3578759706,3578759706,0
0,1455,57180,3578759706,3578759706,0
0,1455,57181,3578759706,3578759706,0
0,1455,57182,3578759706,3578759706,0
0,1455,57183,3578759706,3578759706,0
0,1455,57184,3578759706,3578759706,0
0,1455,57185,3578759706,3578759706,0
0,1455,57186,3578759706,3578759706,0
0,1455,57187,3578759706,3578759706,0
0,1455,57188,3578759706,3578759706,0
0,1455,57189,3578759706,3578759706,0
0,1455,57190,3578759706,3578759706,0
0,1455,57191,3578759706,3578759706,0
0,1455,57192,3578759706,3578759706,0
0,1455,57193,3578759706,3578759706,0
0,1455,57194,3578759706,3578759707,1
0,1455,57195,3578759706,3578759707,1
0,1455,57196,3578759706,3578759707,1
0,1455,57197,3578759706,3578759707,1
0,1455,57198,3578759706,3578759708,2
0,1455,57199,3578759706,3578759708,2
0,1455,57200,3578759706,3578759708,2
0,1455,57201,3578759706,3578759709,3
0,1455,57202,3578759706,3578759709,3
0,1455,57203,3578759706,3578759709,3
0,1455,57204,3578759706,3578759709,3
0,1455,57205,3578759706,3578759710,4
0,1455,57206,3578759706,3578759711,5
0,1455,57207,3578759706,3578759711,5
0,1455,57208,3578759706,3578759712,6
0,1455,57209,3578759706,3578759712,6
0,1455,57210,3578759706,3578759713,7
0,1455,57211,3578759706,3578759714,8
0,1455,57212,3578759706,3578759714,8
0,1455,57213,3578759706,3578759714,8
0,1455,57214,3578759706,3578759714,8
0,1455,57215,3578759706,3578759715,9
0,1455,57216,3578759706,3578759715,9
0,1455,57217,3578759706,3578759715,9
0,1455,57218,3578759706,3578759716,10
0,1455,57219,3578759706,3578759716,10
0,1455,57220,3578759706,3578759717,11
0,1455,57221,3578759706,3578759717,11
0,1455,57222,3578759706,3578759717,11
0,1455,57223,3578759706,3578759717,11
0,1455,57224,3578759706,3578759717,11
0,1455,57225,3578759706,3578759718,12
0,1455,57226,3578759706,3578759718,12
0,1455,57227,3578759706,3578759718,12
0,1455,57228,3578759706,3578759720,14
0,1455,57229,3578759706,3578759720,14
0,1455,57230,3578759706,3578759720,14
0,1455,57231,3578759706,3578759720,14
0,1455,57232,3578759706,3578759722,16
0,1455,57233,3578759706,3578759724,18
0,1455,57234,3578759706,3578759724,18
0,1455,57235,3578759706,3578759725,19
0,1455,57236,3578759706,3578759725,19
0,1455,57237,3578759706,3578759726,20
0,1455,57238,3578759706,3578759726,20
0,1455,57239,3578759706,3578759726,20
0,1455,57240,3578759706,3578759726,20
0,1455,57241,3578759706,3578759727,21
0,1455,57242,3578759706,3578759727,21
0,1455,57243,3578759706,3578759727,21
0,1455,57244,3578759706,3578759727,21
0,1455,57245,3578759706,3578759727,21
0,1455,57246,3578759706,3578759728,22
0,1455,57247,3578759706,3578759728,22
0,1455,57248,3578759706,3578759728,22
0,1455,57249,3578759706,3578759728,22
0,1455,57250,3578759706,3578759729,23
0,1455,57251,3578759706,3578759729,23
0,1455,57252,3578759706,3578759729,23
0,1455,57253,3578759706,3578759730,24
0,1455,57254,3578759706,3578759731,25
0,1455,57255,3578759706,3578759731,25
0,1455,57256,3578759706,3578759731,25
0,1455,57257,3578759706,3578759731,25
0,1455,57258,3578759706,3578759732,26
0,1455,57259,3578759706,3578759732,26
0,1455,57260,3578759706,3578759733,27
0,1455,57261,3578759706,3578759734,28
0,1455,57262,3578759706,3578759735,29
0,1455,57263,3578759706,3578759736,30
0,1455,57264,3578759706,3578759738,32
0,1455,57265,3578759706,3578759739,33
0,1455,57266,3578759706,3578759739,33
0,1455,57267,3578759706,3578759739,33
0,1455,57268,3578759706,3578759740,34
0,1455,57269,3578759706,3578759740,34
0,1455,57270,3578759706,3578759740,34
0,1455,57271,3578759706,3578759741,35
0,1455,57272,3578759706,3578759741,35
0,1455,57273,3578759706,3578759741,35
0,1455,57274,3578759706,3578759742,36
0,1455,57275,3578759706,3578759742,36
0,1455,57276,3578759706,3578759742,36
0,1455,57277,3578759706,3578759743,37
0,1455,57278,3578759706,3578759743,37
0,1455,57279,3578759706,3578759744,38
0,1455,57280,3578759706,3578759745,39
0,1455,57281,3578759706,3578759745,39
0,1455,57282,3578759706,3578759745,39
0,1455,57283,3578759706,3578759745,39
0,1455,57284,3578759706,3578759746,40
0,1455,57285,3578759706,3578759747,41
0,1455,57286,3578759706,3578759747,41
0,1455,57287,3578759706,3578759747,41
0,1455,57288,3578759706,3578759748,42
0,1455,57289,3578759706,3578759750,44
0,1455,57290,3578759706,3578759750,44
0,1455,57291,3578759706,3578759752,46
0,1455,57292,3578759706,3578759752,46
0,1455,57293,3578759706,3578759753,47
0,1455,57294,3578759706,3578759753,47
0,1455,57295,3578759706,3578759755,49
0,1455,57296,3578759706,3578759755,49
0,1455,57297,3578759706,3578759756,50
0,1456,57298,3578759770,3578759770,0
0,1456,57299,3578759770,3578759770,0
0,1456,57300,3578759770,3578759770,0
0,1456,57301,3578759770,3578759770,0
0,1456,57302,3578759770,3578759770,0
0,1456,57303,3578759770,3578759770,0
0,1456,57304,3578759770,3578759770,0
0,1456,57305,3578759770,3578759770,0
0,1456,57306,3578759770,3578759770,0
0,1456,57307,3578759770,3578759770,0
0,1456,57308,3578759770,3578759770,0
0,1456,57309,3578759770,3578759770,0
0,1456,57310,3578759770,3578759770,0
0,1456,57311,3578759770,3578759770,0
0,1456,57312,3578759770,3578759770,0
0,1456,57313,3578759770,3578759770,0
0,1456,57314,3578759770,3578759770,0
0,1456,57315,3578759770,3578759770,0
0,1456,57316,3578759770,3578759770,0
0,1456,57317,3578759770,3578759770,0
0,1456,57318,3578759770,3578759770,0
0,1456,57319,3578759770,3578759770,0
0,1456,57320,3578759770,3578759771,1
0,1456,57321,3578759770,3578759771,1
0,1456,57322,3578759770,3578759771,1
0,1456,57323,3578759770,3578759772,2
0,1456,57324,3578759770,3578759773,3
0,1456,57325,3578759770,3578759773,3
0,1456,57326,3578759770,3578759773,3
0,1456,57327,3578759770,3578759774,4
0,1456,57328,3578759770,3578759774,4
0,1456,57329,3578759770,3578759775,5
0,1456,57330,3578759770,3578759776,6
0,1456,57331,3578759770,3578759776,6
0,1456,57332,3578759770,3578759778,8
0,1456,57333,3578759770,3578759779,9
0,1456,57334,3578759770,3578759779,9
0,1456,57335,3578759770,3578759780,10
0,1456,57336,3578759770,3578759780,10
0,1456,57337,3578759770,3578759780,10
0,1456,57338,3578759770,3578759780,10
0,1456,57339,3578759770,3578759781,11
0,1456,57340,3578759770,3578759782,12
0,1456,57341,3578759770,3578759783,13
0,1456,57342,3578759770,3578759784,14
0,1456,57343,3578759770,3578759786,16
0,1456,57344,3578759770,3578759787,17
0,1456,57345,3578759770,3578759789,19
0,1456,57346,3578759770,3578759789,19
0,1456,57347,3578759770,3578759789,19
0,1456,57348,3578759770,3578759789,19
0,1456,57349,3578759770,3578759791,21
0,1456,57350,3578759770,3578759792,22
0,1456,57351,3578759770,3578759793,23
0,1456,57352,3578759770,3578759793,23
0,1456,57353,3578759770,3578759794,24
0,1456,57354,3578759770,3578759796,26
0,1456,57355,3578759770,3578759796,26
0,1456,57356,3578759770,3578759797,27
0,1456,57357,3578759770,3578759797,27
0,1456,57358,3578759770,3578759798,28
0,1456,57359,3578759770,3578759798,28
0,1456,57360,3578759770,3578759800,30
0,1456,57361,3578759770,3578759800,30
0,1456,57362,3578759770,3578759802,32
0,1456,57363,3578759770,3578759803,33
0,1456,57364,3578759770,3578759803,33
0,1456,57365,3578759770,3578759804,34
0,1456,57366,3578759770,3578759805,35
0,1456,57367,3578759770,3578759805,35
0,1456,57368,3578759770,3578759806,36
0,1456,57369,3578759770,3578759806,36
0,1456,57370,3578759770,3578759807,37
0,1456,57371,3578759770,3578759808,38
0,1456,57372,3578759770,3578759809,39
0,1456,57373,3578759770,3578759809,39
0,1456,57374,3578759770,3578759811,41
0,1456,57375,3578759770,3578759812,42
0,1456,57376,3578759770,3578759813,43
0,1456,57377,3578759770,3578759813,43
0,1456,57378,3578759770,3578759813,43
0,1456,57379,3578759770,3578759813,43
0,1456,57380,3578759770,3578759815,45
0,1456,57381,3578759770,3578759815,45
0,1456,57382,3578759770,3578759815,45
0,1456,57383,3578759770,3578759816,46
0,1456,57384,3578759770,3578759817,47
0,1456,57385,3578759770,3578759817,47
0,1456,57386,3578759770,3578759819,49
0,1456,57387,3578759770,3578759819,49
0,1456,57388,3578759770,3578759820,50
0,1457,57389,3578759833,3578759833,0
0,1457,57390,3578759833,3578759833,0
0,1457,57391,3578759833,3578759833,0
0,1457,57392,3578759833,3578759833,0
0,1457,57393,3578759833,3578759833,0
0,1457,57394,3578759833,3578759833,0
0,1457,57395,3578759833,3578759833,0
0,1457,57396,3578759833,3578759833,0
0,1457,57397,3578759833,3578759833,0
0,1457,57398,3578759833,3578759833,0
0,1457,57399,3578759833,3578759833,0
0,1457,57400,3578759833,3578759833,0
0,1457,57401,3578759833,3578759833,0
0,1457,57402,3578759833,3578759833,0
0,1457,57403,3578759833,3578759833,0
0,1457,57404,3578759833,3578759833,0
0,1457,57405,3578759833,3578759833,0
0,1457,57406,3578759833,3578759833,0
0,1457,57407,3578759833,3578759833,0
0,1457,57408,3578759833,3578759833,0
0,1457,57409,3578759833,3578759833,0
0,1457,57410,3578759833,3578759834,1
0,1457,57411,3578759833,3578759834,1
0,1457,57412,3578759833,3578759836,3
0,1457,57413,3578759833,3578759838,5
0,1457,57414,3578759833,3578759838,5
0,1457,57415,3578759833,3578759838,5
0,1457,57416,3578759833,3578759839,6
0,1457,57417,3578759833,3578759840,7
0,1457,57418,3578759833,3578759841,8
0,1457,57419,3578759833,3578759841,8
0,1457,57420,3578759833,3578759842,9
0,1457,57421,3578759833,3578759843,10
0,1457,57422,3578759833,3578759843,10
0,1457,57423,3578759833,3578759844,11
0,1457,57424,3578759833,3578759846,13
0,1457,57425,3578759833,3578759846,13
0,1457,57426,3578759833,3578759846,13
0,1457,57427,3578759833,3578759847,14
0,1457,57428,3578759833,3578759848,15
0,1457,57429,3578759833,3578759848,15
0,1457,57430,3578759833,3578759849,16
0,1457,57431,3578759833,3578759849,16
0,1457,57432,3578759833,3578759849,16
0,1457,57433,3578759833,3578759849,16
0,1457,57434,3578759833,3578759850,17
0,1457,57435,3578759833,3578759850,17
0,1457,57436,3578759833,3578759850,17
0,1457,57437,3578759833,3578759852,19
0,1457,57438,3578759833,3578759855,22
0,1457,57439,3578759833,3578759856,23
0,1457,57440,3578759833,3578759857,24
0,1457,57441,3578759833,3578759858,25
0,1457,57442,3578759833,3578759858,25
0,1457,57443,3578759833,3578759858,25
0,1457,57444,3578759833,3578759858,25
0,1457,57445,3578759833,3578759859,26
0,1457,57446,3578759833,3578759861,28
0,1457,57447,3578759833,3578759862,29
0,1457,57448,3578759833,3578759862,29
0,1457,57449,3578759833,3578759862,29
0,1457,57450,3578759833,3578759863,30
0,1457,57451,3578759833,3578759863,30
0,1457,57452,3578759833,3578759863,30
0,1457,57453,3578759833,3578759864,31
0,1457,57454,3578759833,3578759864,31
0,1457,57455,3578759833,3578759865,32
0,1457,57456,3578759833,3578759866,33
0,1457,57457,3578759833,3578759866,33
0,1457,57458,3578759833,3578759866,33
0,1457,57459,3578759833,3578759867,34
0,1457,57460,3578759833,3578759867,34
0,1457,57461,3578759833,3578759869,36
0,1457,57462,3578759833,3578759871,38
0,1457,57463,3578759833,3578759881,48
0,1457,57464,3578759833,3578759882,49
0,1457,57465,3578759833,3578759883,50
0,1458,57466,3578759897,3578759897,0
0,1458,57467,3578759897,3578759897,0
0,1458,57468,3578759897,3578759897,0
0,1458,57469,3578759897,3578759897,0
0,1458,57470,3578759897,3578759897,0
0,1458,57471,3578759897,3578759897,0
0,1458,57472,3578759897,3578759897,0
0,1458,57473,3578759897,3578759897,0
0,1458,57474,3578759897,3578759897,0
0,1458,57475,3578759897,3578759897,0
0,1458,57476,3578759897,3578759897,0
0,1458,57477,3578759897,3578759897,0
0,1458,57478,3578759897,3578759897,0
0,1458,57479,3578759897,3578759897,0
0,1458,57480,3578759897,3578759897,0
0,1458,57481,3578759897,3578759897,0
0,1458,57482,3578759897,3578759897,0
0,1458,57483,3578759897,3578759897,0
0,1458,57484,3578759897,3578759897,0
0,1458,57485,3578759897,3578759897,0
0,1458,57486,3578759897,3578759897,0
0,1458,57487,3578759897,3578759898,1
0,1458,57488,3578759897,3578759898,1
0,1458,57489,3578759897,3578759899,2
0,1458,57490,3578759897,3578759900,3
0,1458,57491,3578759897,3578759900,3
0,1458,57492,3578759897,3578759900,3
0,1458,57493,3578759897,3578759900,3
0,1458,57494,3578759897,3578759900,3
0,1458,57495,3578759897,3578759900,3
0,1458,57496,3578759897,3578759900,3
0,1458,57497,3578759897,3578759903,6
0,1458,57498,3578759897,3578759905,8
0,1458,57499,3578759897,3578759906,9
0,1458,57500,3578759897,3578759906,9
0,1458,57501,3578759897,3578759907,10
0,1458,57502,3578759897,3578759907,10
0,1458,57503,3578759897,3578759907,10
0,1458,57504,3578759897,3578759908,11
0,1458,57505,3578759897,3578759908,11
0,1458,57506,3578759897,3578759909,12
0,1458,57507,3578759897,3578759909,12
0,1458,57508,3578759897,3578759909,12
0,1458,57509,3578759897,3578759909,12
0,1458,57510,3578759897,3578759910,13
0,1458,57511,3578759897,3578759911,14
0,1458,57512,3578759897,3578759912,15
0,1458,57513,3578759897,3578759913,16
0,1458,57514,3578759897,3578759914,17
0,1458,57515,3578759897,3578759915,18
0,1458,57516,3578759897,3578759915,18
0,1458,57517,3578759897,3578759915,18
0,1458,57518,3578759897,3578759916,19
0,1458,57519,3578759897,3578759916,19
0,1458,57520,3578759897,3578759917,20
0,1458,57521,3578759897,3578759917,20
0,1458,57522,3578759897,3578759917,20
0,1458,57523,3578759897,3578759917,20
0,1458,57524,3578759897,3578759917,20
0,1458,57525,3578759897,3578759917,20
0,1458,57526,3578759897,3578759917,20
0,1458,57527,3578759897,3578759918,21
0,1458,57528,3578759897,3578759919,22
0,1458,57529,3578759897,3578759923,26
0,1458,57530,3578759897,3578759923,26
0,1458,57531,3578759897,3578759925,28
0,1458,57532,3578759897,3578759925,28
0,1458,57533,3578759897,3578759925,28
0,1458,57534,3578759897,3578759926,29
0,1458,57535,3578759897,3578759926,29
0,1458,57536,3578759897,3578759926,29
0,1458,57537,3578759897,3578759928,31
0,1458,57538,3578759897,3578759928,31
0,1458,57539,3578759897,3578759928,31
0,1458,57540,3578759897,3578759928,31
0,1458,57541,3578759897,3578759928,31
0,1458,57542,3578759897,3578759928,31
0,1458,57543,3578759897,3578759928,31
0,1458,57544,3578759897,3578759928,31
0,1458,57545,3578759897,3578759928,31
0,1458,57546,3578759897,3578759929,32
0,1458,57547,3578759897,3578759929,32
0,1458,57548,3578759897,3578759929,32
0,1458,57549,3578759897,3578759930,33
0,1458,57550,3578759897,3578759931,34
0,1458,57551,3578759897,3578759931,34
0,1458,57552,3578759897,3578759931,34
0,1458,57553,3578759897,3578759931,34
0,1458,57554,3578759897,3578759932,35
0,1458,57555,3578759897,3578759932,35
0,1458,57556,3578759897,3578759932,35
0,1458,57557,3578759897,3578759934,37
0,1458,57558,3578759897,3578759934,37
0,1458,57559,3578759897,3578759935,38
0,1458,57560,3578759897,3578759935,38
0,1458,57561,3578759897,3578759935,38
0,1458,57562,3578759897,3578759936,39
0,1458,57563,3578759897,3578759938,41
0,1458,57564,3578759897,3578759938,41
0,1458,57565,3578759897,3578759939,42
0,1458,57566,3578759897,3578759939,42
0,1458,57567,3578759897,3578759939,42
0,1458,57568,3578759897,3578759940,43
0,1458,57569,3578759897,3578759940,43
0,1458,57570,3578759897,3578759941,44
0,1458,57571,3578759897,3578759941,44
0,1458,57572,3578759897,3578759942,45
0,1458,57573,3578759897,3578759942,45
0,1458,57574,3578759897,3578759943,46
0,1458,57575,3578759897,3578759943,46
0,1458,57576,3578759897,3578759943,46
0,1458,57577,3578759897,3578759944,47
0,1458,57578,3578759897,3578759945,48
0,1458,57579,3578759897,3578759945,48
0,1458,57580,3578759897,3578759947,50
0,1459,57581,3578759960,3578759960,0
0,1459,57582,3578759960,3578759960,0
0,1459,57583,3578759960,3578759960,0
0,1459,57584,3578759960,3578759960,0
0,1459,57585,3578759960,3578759960,0
0,1459,57586,3578759960,3578759960,0
0,1459,57587,3578759960,3578759960,0
0,1459,57588,3578759960,3578759960,0
0,1459,57589,3578759960,3578759960,0
0,1459,57590,3578759960,3578759960,0
0,1459,57591,3578759960,3578759960,0
0,1459,57592,3578759960,3578759960,0
0,1459,57593,3578759960,3578759960,0
0,1459,57594,3578759960,3578759960,0
0,1459,57595,3578759960,3578759960,0
0,1459,57596,3578759960,3578759960,0
0,1459,57597,3578759960,3578759960,0
0,1459,57598,3578759960,3578759960,0
0,1459,57599,3578759960,3578759960,0
0,1459,57600,3578759960,3578759961,1
0,1459,57601,3578759960,3578759961,1
0,1459,57602,3578759960,3578759961,1
0,1459,57603,3578759960,3578759962,2
0,1459,57604,3578759960,3578759962,2
0,1459,57605,3578759960,3578759962,2
0,1459,57606,3578759960,3578759962,2
0,1459,57607,3578759960,3578759964,4
0,1459,57608,3578759960,3578759965,5
0,1459,57609,3578759960,3578759965,5
0,1459,57610,3578759960,3578759965,5
0,1459,57611,3578759960,3578759970,10
0,1459,57612,3578759960,3578759970,10
0,1459,57613,3578759960,3578759970,10
0,1459,57614,3578759960,3578759971,11
0,1459,57615,3578759960,3578759971,11
0,1459,57616,3578759960,3578759972,12
0,1459,57617,3578759960,3578759973,13
0,1459,57618,3578759960,3578759973,13
0,1459,57619,3578759960,3578759974,14
0,1459,57620,3578759960,3578759975,15
0,1459,57621,3578759960,3578759976,16
0,1459,57622,3578759960,3578759976,16
0,1459,57623,3578759960,3578759977,17
0,1459,57624,3578759960,3578759978,18
0,1459,57625,3578759960,3578759978,18
0,1459,57626,3578759960,3578759980,20
0,1459,57627,3578759960,3578759980,20
0,1459,57628,3578759960,3578759980,20
0,1459,57629,3578759960,3578759980,20
0,1459,57630,3578759960,3578759981,21
0,1459,57631,3578759960,3578759982,22
0,1459,57632,3578759960,3578759983,23
0,1459,57633,3578759960,3578759983,23
0,1459,57634,3578759960,3578759985,25
0,1459,57635,3578759960,3578759987,27
0,1459,57636,3578759960,3578759987,27
0,1459,57637,3578759960,3578759988,28
0,1459,57638,3578759960,3578759989,29
0,1459,57639,3578759960,3578759989,29
0,1459,57640,3578759960,3578759989,29
0,1459,57641,3578759960,3578759990,30
0,1459,57642,3578759960,3578759990,30
0,1459,57643,3578759960,3578759991,31
0,1459,57644,3578759960,3578759992,32
0,1459,57645,3578759960,3578759993,33
0,1459,57646,3578759960,3578759993,33
0,1459,57647,3578759960,3578759994,34
0,1459,57648,3578759960,3578759995,35
0,1459,57649,3578759960,3578759996,36
0,1459,57650,3578759960,3578759996,36
0,1459,57651,3578759960,3578759997,37
0,1459,57652,3578759960,3578759998,38
0,1459,57653,3578759960,3578759998,38
0,1459,57654,3578759960,3578760000,40
0,1459,57655,3578759960,3578760000,40
0,1459,57656,3578759960,3578760003,43
0,1459,57657,3578759960,3578760003,43
0,1459,57658,3578759960,3578760003,43
0,1459,57659,3578759960,3578760005,45
0,1459,57660,3578759960,3578760006,46
0,1459,57661,3578759960,3578760006,46
0,1459,57662,3578759960,3578760006,46
0,1459,57663,3578759960,3578760008,48
0,1459,57664,3578759960,3578760009,49
0,1459,57665,3578759960,3578760010,50
0,1460,57666,3578760026,3578760026,0
0,1460,57667,3578760026,3578760026,0
0,1460,57668,3578760026,3578760026,0
0,1460,57669,3578760026,3578760026,0
0,1460,57670,3578760026,3578760026,0
0,1460,57671,3578760026,3578760026,0
0,1460,57672,3578760026,3578760026,0
0,1460,57673,3578760026,3578760026,0
0,1460,57674,3578760026,3578760026,0
0,1460,57675,3578760026,3578760026,0
0,1460,57676,3578760026,3578760026,0
0,1460,57677,3578760026,3578760026,0
0,1460,57678,3578760026,3578760026,0
0,1460,57679,3578760026,3578760026,0
0,1460,57680,3578760026,3578760026,0
0,1460,57681,3578760026,3578760026,0
0,1460,57682,3578760026,3578760026,0
0,1460,57683,3578760026,3578760026,0
0,1460,57684,3578760026,3578760026,0
0,1460,57685,3578760026,3578760026,0
0,1460,57686,3578760026,3578760026,0
0,1460,57687,3578760026,3578760026,0
0,1460,57688,3578760026,3578760026,0
0,1460,57689,3578760026,3578760027,1
0,1460,57690,3578760026,3578760027,1
0,1460,57691,3578760026,3578760028,2
0,1460,57692,3578760026,3578760029,3
0,1460,57693,3578760026,3578760030,4
0,1460,57694,3578760026,3578760031,5
0,1460,57695,3578760026,3578760031,5
0,1460,57696,3578760026,3578760032,6
0,1460,57697,3578760026,3578760032,6
0,1460,57698,3578760026,3578760033,7
0,1460,57699,3578760026,3578760033,7
0,1460,57700,3578760026,3578760034,8
0,1460,57701,3578760026,3578760034,8
0,1460,57702,3578760026,3578760035,9
0,1460,57703,3578760026,3578760035,9
0,1460,57704,3578760026,3578760037,11
0,1460,57705,3578760026,3578760037,11
0,1460,57706,3578760026,3578760038,12
0,1460,57707,3578760026,3578760038,12
0,1460,57708,3578760026,3578760039,13
0,1460,57709,3578760026,3578760039,13
0,1460,57710,3578760026,3578760039,13
0,1460,57711,3578760026,3578760040,14
0,1460,57712,3578760026,3578760040,14
0,1460,57713,3578760026,3578760041,15
0,1460,57714,3578760026,3578760042,16
0,1460,57715,3578760026,3578760042,16
0,1460,57716,3578760026,3578760043,17
0,1460,57717,3578760026,3578760043,17
0,1460,57718,3578760026,3578760046,20
0,1460,57719,3578760026,3578760047,21
0,1460,57720,3578760026,3578760048,22
0,1460,57721,3578760026,3578760048,22
0,1460,57722,3578760026,3578760048,22
0,1460,57723,3578760026,3578760049,23
0,1460,57724,3578760026,3578760049,23
0,1460,57725,3578760026,3578760049,23
0,1460,57726,3578760026,3578760049,23
0,1460,57727,3578760026,3578760050,24
0,1460,57728,3578760026,3578760051,25
0,1460,57729,3578760026,3578760053,27
0,1460,57730,3578760026,3578760054,28
0,1460,57731,3578760026,3578760056,30
0,1460,57732,3578760026,3578760056,30
0,1460,57733,3578760026,3578760056,30
0,1460,57734,3578760026,3578760057,31
0,1460,57735,3578760026,3578760058,32
0,1460,57736,3578760026,3578760058,32
0,1460,57737,3578760026,3578760058,32
0,1460,57738,3578760026,3578760058,32
0,1460,57739,3578760026,3578760058,32
0,1460,57740,3578760026,3578760061,35
0,1460,57741,3578760026,3578760061,35
0,1460,57742,3578760026,3578760062,36
0,1460,57743,3578760026,3578760063,37
0,1460,57744,3578760026,3578760064,38
0,1460,57745,3578760026,3578760064,38
0,1460,57746,3578760026,3578760064,38
0,1460,57747,3578760026,3578760065,39
0,1460,57748,3578760026,3578760065,39
0,1460,57749,3578760026,3578760065,39
0,1460,57750,3578760026,3578760066,40
0,1460,57751,3578760026,3578760066,40
0,1460,57752,3578760026,3578760066,40
0,1460,57753,3578760026,3578760067,41
0,1460,57754,3578760026,3578760067,41
0,1460,57755,3578760026,3578760071,45
0,1461,57756,3578760089,3578760089,0
0,1461,57757,3578760089,3578760089,0
0,1461,57758,3578760089,3578760089,0
0,1461,57759,3578760089,3578760089,0
0,1461,57760,3578760089,3578760089,0
0,1461,57761,3578760089,3578760089,0
0,1461,57762,3578760089,3578760089,0
0,1461,57763,3578760089,3578760089,0
0,1461,57764,3578760089,3578760089,0
0,1461,57765,3578760089,3578760089,0
0,1461,57766,3578760089,3578760090,1
0,1461,57767,3578760089,3578760090,1
0,1461,57768,3578760089,3578760090,1
0,1461,57769,3578760089,3578760091,2
0,1461,57770,3578760089,3578760091,2
0,1461,57771,3578760089,3578760091,2
0,1461,57772,3578760089,3578760092,3
0,1461,57773,3578760089,3578760092,3
0,1461,57774,3578760089,3578760092,3
0,1461,57775,3578760089,3578760094,5
0,1461,57776,3578760089,3578760094,5
0,1461,57777,3578760089,3578760095,6
0,1461,57778,3578760089,3578760095,6
0,1461,57779,3578760089,3578760096,7
0,1461,57780,3578760089,3578760099,10
0,1461,57781,3578760089,3578760099,10
0,1461,57782,3578760089,3578760099,10
0,1461,57783,3578760089,3578760099,10
0,1461,57784,3578760089,3578760099,10
0,1461,57785,3578760089,3578760100,11
0,1461,57786,3578760089,3578760100,11
0,1461,57787,3578760089,3578760100,11
0,1461,57788,3578760089,3578760101,12
0,1461,57789,3578760089,3578760103,14
0,1461,57790,3578760089,3578760103,14
0,1461,57791,3578760089,3578760105,16
0,1461,57792,3578760089,3578760106,17
0,1461,57793,3578760089,3578760106,17
0,1461,57794,3578760089,3578760107,18
0,1461,57795,3578760089,3578760107,18
0,1461,57796,3578760089,3578760107,18
0,1461,57797,3578760089,3578760108,19
0,1461,57798,3578760089,3578760108,19
0,1461,57799,3578760089,3578760108,19
0,1461,57800,3578760089,3578760108,19
0,1461,57801,3578760089,3578760109,20
0,1461,57802,3578760089,3578760109,20
0,1461,57803,3578760089,3578760109,20
0,1461,57804,3578760089,3578760110,21
0,1461,57805,3578760089,3578760112,23
0,1461,57806,3578760089,3578760112,23
0,1461,57807,3578760089,3578760113,24
0,1461,57808,3578760089,3578760113,24
0,1461,57809,3578760089,3578760115,26
0,1461,57810,3578760089,3578760115,26
0,1461,57811,3578760089,3578760115,26
0,1461,57812,3578760089,3578760116,27
0,1461,57813,3578760089,3578760116,27
0,1461,57814,3578760089,3578760116,27
0,1461,57815,3578760089,3578760116,27
0,1461,57816,3578760089,3578760117,28
0,1461,57817,3578760089,3578760117,28
0,1461,57818,3578760089,3578760117,28
0,1461,57819,3578760089,3578760118,29
0,1461,57820,3578760089,3578760118,29
0,1461,57821,3578760089,3578760119,30
0,1461,57822,3578760089,3578760119,30
0,1461,57823,3578760089,3578760119,30
0,1461,57824,3578760089,3578760122,33
0,1461,57825,3578760089,3578760122,33
0,1461,57826,3578760089,3578760123,34
0,1461,57827,3578760089,3578760124,35
0,1461,57828,3578760089,3578760125,36
0,1461,57829,3578760089,3578760125,36
0,1461,57830,3578760089,3578760126,37
0,1461,57831,3578760089,3578760126,37
0,1461,57832,3578760089,3578760126,37
0,1461,57833,3578760089,3578760127,38
0,1461,57834,3578760089,3578760128,39
0,1461,57835,3578760089,3578760128,39
0,1461,57836,3578760089,3578760128,39
0,1461,57837,3578760089,3578760128,39
0,1461,57838,3578760089,3578760128,39
0,1461,57839,3578760089,3578760128,39
0,1461,57840,3578760089,3578760128,39
0,1461,57841,3578760089,3578760128,39
0,1461,57842,3578760089,3578760129,40
0,1461,57843,3578760089,3578760129,40
0,1461,57844,3578760089,3578760130,41
0,1461,57845,3578760089,3578760130,41
0,1461,57846,3578760089,3578760131,42
0,1461,57847,3578760089,3578760131,42
0,1461,57848,3578760089,3578760131,42
0,1461,57849,3578760089,3578760131,42
0,1461,57850,3578760089,3578760132,43
0,1461,57851,3578760089,3578760132,43
0,1461,57852,3578760089,3578760132,43
0,1461,57853,3578760089,3578760134,45
0,1461,57854,3578760089,3578760134,45
0,1461,57855,3578760089,3578760135,46
0,1461,57856,3578760089,3578760135,46
0,1461,57857,3578760089,3578760135,46
0,1461,57858,3578760089,3578760136,47
0,1461,57859,3578760089,3578760138,49
0,1461,57860,3578760089,3578760138,49
0,1461,57861,3578760089,3578760138,49
0,1462,57862,3578760153,3578760153,0
0,1462,57863,3578760153,3578760153,0
0,1462,57864,3578760153,3578760153,0
0,1462,57865,3578760153,3578760153,0
0,1462,57866,3578760153,3578760153,0
0,1462,57867,3578760153,3578760153,0
0,1462,57868,3578760153,3578760153,0
0,1462,57869,3578760153,3578760153,0
0,1462,57870,3578760153,3578760153,0
0,1462,57871,3578760153,3578760153,0
0,1462,57872,3578760153,3578760153,0
0,1462,57873,3578760153,3578760153,0
0,1462,57874,3578760153,3578760153,0
0,1462,57875,3578760153,3578760153,0
0,1462,57876,3578760153,3578760153,0
0,1462,57877,3578760153,3578760153,0
0,1462,57878,3578760153,3578760153,0
0,1462,57879,3578760153,3578760153,0
0,1462,57880,3578760153,3578760153,0
0,1462,57881,3578760153,3578760153,0
0,1462,57882,3578760153,3578760153,0
0,1462,57883,3578760153,3578760153,0
0,1462,57884,3578760153,3578760153,0
0,1462,57885,3578760153,3578760154,1
0,1462,57886,3578760153,3578760154,1
0,1462,57887,3578760153,3578760155,2
0,1462,57888,3578760153,3578760155,2
0,1462,57889,3578760153,3578760156,3
0,1462,57890,3578760153,3578760156,3
0,1462,57891,3578760153,3578760157,4
0,1462,57892,3578760153,3578760158,5
0,1462,57893,3578760153,3578760159,6
0,1462,57894,3578760153,3578760159,6
0,1462,57895,3578760153,3578760160,7
0,1462,57896,3578760153,3578760161,8
0,1462,57897,3578760153,3578760161,8
0,1462,57898,3578760153,3578760161,8
0,1462,57899,3578760153,3578760161,8
0,1462,57900,3578760153,3578760162,9
0,1462,57901,3578760153,3578760162,9
0,1462,57902,3578760153,3578760162,9
0,1462,57903,3578760153,3578760163,10
0,1462,57904,3578760153,3578760165,12
0,1462,57905,3578760153,3578760165,12
0,1462,57906,3578760153,3578760165,12
0,1462,57907,3578760153,3578760166,13
0,1462,57908,3578760153,3578760168,15
0,1462,57909,3578760153,3578760170,17
0,1462,57910,3578760153,3578760170,17
0,1462,57911,3578760153,3578760171,18
0,1462,57912,3578760153,3578760171,18
0,1462,57913,3578760153,3578760171,18
0,1462,57914,3578760153,3578760173,20
0,1462,57915,3578760153,3578760173,20
0,1462,57916,3578760153,3578760173,20
0,1462,57917,3578760153,3578760174,21
0,1462,57918,3578760153,3578760174,21
0,1462,57919,3578760153,3578760175,22
0,1462,57920,3578760153,3578760176,23
0,1462,57921,3578760153,3578760176,23
0,1462,57922,3578760153,3578760176,23
0,1462,57923,3578760153,3578760178,25
0,1462,57924,3578760153,3578760179,26
0,1462,57925,3578760153,3578760179,26
0,1462,57926,3578760153,3578760179,26
0,1462,57927,3578760153,3578760180,27
0,1462,57928,3578760153,3578760180,27
0,1462,57929,3578760153,3578760180,27
0,1462,57930,3578760153,3578760181,28
0,1462,57931,3578760153,3578760182,29
0,1462,57932,3578760153,3578760183,30
0,1462,57933,3578760153,3578760184,31
0,1462,57934,3578760153,3578760185,32
0,1462,57935,3578760153,3578760186,33
0,1462,57936,3578760153,3578760187,34
0,1462,57937,3578760153,3578760189,36
0,1462,57938,3578760153,3578760190,37
0,1462,57939,3578760153,3578760190,37
0,1462,57940,3578760153,3578760191,38
0,1462,57941,3578760153,3578760191,38
0,1462,57942,3578760153,3578760192,39
0,1462,57943,3578760153,3578760193,40
0,1462,57944,3578760153,3578760193,40
0,1462,57945,3578760153,3578760194,41
0,1462,57946,3578760153,3578760196,43
0,1462,57947,3578760153,3578760197,44
0,1462,57948,3578760153,3578760198,45
0,1462,57949,3578760153,3578760198,45
0,1462,57950,3578760153,3578760198,45
0,1462,57951,3578760153,3578760200,47
0,1462,57952,3578760153,3578760200,47
0,1462,57953,3578760153,3578760202,49
0,1462,57954,3578760153,3578760203,50
0,1463,57955,3578760216,3578760216,0
0,1463,57956,3578760216,3578760216,0
0,1463,57957,3578760216,3578760216,0
0,1463,57958,3578760216,3578760216,0
0,1463,57959,3578760216,3578760216,0
0,1463,57960,3578760216,3578760216,0
0,1463,57961,3578760216,3578760216,0
0,1463,57962,3578760216,3578760216,0
0,1463,57963,3578760216,3578760216,0
0,1463,57964,3578760216,3578760216,0
0,1463,57965,3578760216,3578760216,0
0,1463,57966,3578760216,3578760216,0
0,1463,57967,3578760216,3578760216,0
0,1463,57968,3578760216,3578760216,0
0,1463,57969,3578760216,3578760216,0
0,1463,57970,3578760216,3578760216,0
0,1463,57971,3578760216,3578760216,0
0,1463,57972,3578760216,3578760216,0
0,1463,57973,3578760216,3578760216,0
0,1463,57974,3578760216,3578760218,2
0,1463,57975,3578760216,3578760219,3
0,1463,57976,3578760216,3578760219,3
0,1463,57977,3578760216,3578760219,3
0,1463,57978,3578760216,3578760220,4
0,1463,57979,3578760216,3578760220,4
0,1463,57980,3578760216,3578760222,6
0,1463,57981,3578760216,3578760223,7
0,1463,57982,3578760216,3578760224,8
0,1463,57983,3578760216,3578760224,8
0,1463,57984,3578760216,3578760225,9
0,1463,57985,3578760216,3578760226,10
0,1463,57986,3578760216,3578760228,12
0,1463,57987,3578760216,3578760230,14
0,1463,57988,3578760216,3578760230,14
0,1463,57989,3578760216,3578760230,14
0,1463,57990,3578760216,3578760231,15
0,1463,57991,3578760216,3578760232,16
0,1463,57992,3578760216,3578760232,16
0,1463,57993,3578760216,3578760232,16
0,1463,57994,3578760216,3578760232,16
0,1463,57995,3578760216,3578760233,17
0,1463,57996,3578760216,3578760234,18
0,1463,57997,3578760216,3578760234,18
0,1463,57998,3578760216,3578760235,19
0,1463,57999,3578760216,3578760236,20
0,1463,58000,3578760216,3578760237,21
0,1463,58001,3578760216,3578760237,21
0,1463,58002,3578760216,3578760237,21
0,1463,58003,3578760216,3578760238,22
0,1463,58004,3578760216,3578760239,23
0,1463,58005,3578760216,3578760239,23
0,1463,58006,3578760216,3578760239,23
0,1463,58007,3578760216,3578760240,24
0,1463,58008,3578760216,3578760241,25
0,1463,58009,3578760216,3578760241,25
0,1463,58010,3578760216,3578760242,26
0,1463,58011,3578760216,3578760243,27
0,1463,58012,3578760216,3578760243,27
0,1463,58013,3578760216,3578760244,28
0,1463,58014,3578760216,3578760247,31
0,1463,58015,3578760216,3578760248,32
0,1463,58016,3578760216,3578760248,32
0,1463,58017,3578760216,3578760248,32
0,1463,58018,3578760216,3578760249,33
0,1463,58019,3578760216,3578760249,33
0,1463,58020,3578760216,3578760249,33
0,1463,58021,3578760216,3578760250,34
0,1463,58022,3578760216,3578760250,34
0,1463,58023,3578760216,3578760252,36
0,1463,58024,3578760216,3578760253,37
0,1463,58025,3578760216,3578760256,40
0,1463,58026,3578760216,3578760257,41
0,1463,58027,3578760216,3578760257,41
0,1463,58028,3578760216,3578760258,42
0,1463,58029,3578760216,3578760259,43
0,1463,58030,3578760216,3578760259,43
0,1463,58031,3578760216,3578760259,43
0,1463,58032,3578760216,3578760259,43
0,1463,58033,3578760216,3578760260,44
0,1463,58034,3578760216,3578760261,45
0,1463,58035,3578760216,3578760263,47
0,1463,58036,3578760216,3578760263,47
0,1463,58037,3578760216,3578760264,48
0,1463,58038,3578760216,3578760264,48
0,1463,58039,3578760216,3578760265,49
0,1463,58040,3578760216,3578760265,49
0,1464,58041,3578760281,3578760281,0
0,1464,58042,3578760281,3578760281,0
0,1464,58043,3578760281,3578760281,0
0,1464,58044,3578760281,3578760281,0
0,1464,58045,3578760281,3578760281,0
0,1464,58046,3578760281,3578760281,0
0,1464,58047,3578760281,3578760281,0
0,1464,58048,3578760281,3578760281,0
0,1464,58049,3578760281,3578760281,0
0,1464,58050,3578760281,3578760283,2
0,1464,58051,3578760281,3578760285,4
0,1464,58052,3578760281,3578760287,6
0,1464,58053,3578760281,3578760287,6
0,1464,58054,3578760281,3578760287,6
0,1464,58055,3578760281,3578760289,8
0,1464,58056,3578760281,3578760290,9
0,1464,58057,3578760281,3578760290,9
0,1464,58058,3578760281,3578760290,9
0,1464,58059,3578760281,3578760290,9
0,1464,58060,3578760281,3578760291,10
0,1464,58061,3578760281,3578760291,10
0,1464,58062,3578760281,3578760292,11
0,1464,58063,3578760281,3578760292,11
0,1464,58064,3578760281,3578760293,12
0,1464,58065,3578760281,3578760293,12
0,1464,58066,3578760281,3578760294,13
0,1464,58067,3578760281,3578760294,13
0,1464,58068,3578760281,3578760295,14
0,1464,58069,3578760281,3578760295,14
0,1464,58070,3578760281,3578760295,14
0,1464,58071,3578760281,3578760296,15
0,1464,58072,3578760281,3578760296,15
0,1464,58073,3578760281,3578760298,17
0,1464,58074,3578760281,3578760299,18
0,1464,58075,3578760281,3578760299,18
0,1464,58076,3578760281,3578760299,18
0,1464,58077,3578760281,3578760300,19
0,1464,58078,3578760281,3578760301,20
0,1464,58079,3578760281,3578760302,21
0,1464,58080,3578760281,3578760303,22
0,1464,58081,3578760281,3578760305,24
0,1464,58082,3578760281,3578760305,24
0,1464,58083,3578760281,3578760306,25
0,1464,58084,3578760281,3578760307,26
0,1464,58085,3578760281,3578760307,26
0,1464,58086,3578760281,3578760308,27
0,1464,58087,3578760281,3578760308,27
0,1464,58088,3578760281,3578760309,28
0,1464,58089,3578760281,3578760309,28
0,1464,58090,3578760281,3578760310,29
0,1464,58091,3578760281,3578760311,30
0,1464,58092,3578760281,3578760311,30
0,1464,58093,3578760281,3578760312,31
0,1464,58094,3578760281,3578760312,31
0,1464,58095,3578760281,3578760313,32
0,1464,58096,3578760281,3578760315,34
0,1464,58097,3578760281,3578760315,34
0,1464,58098,3578760281,3578760316,35
0,1464,58099,3578760281,3578760316,35
0,1464,58100,3578760281,3578760316,35
0,1464,58101,3578760281,3578760316,35
0,1464,58102,3578760281,3578760317,36
0,1464,58103,3578760281,3578760317,36
0,1464,58104,3578760281,3578760317,36
0,1464,58105,3578760281,3578760317,36
0,1464,58106,3578760281,3578760317,36
0,1464,58107,3578760281,3578760317,36
0,1464,58108,3578760281,3578760318,37
0,1464,58109,3578760281,3578760319,38
0,1464,58110,3578760281,3578760319,38
0,1464,58111,3578760281,3578760319,38
0,1464,58112,3578760281,3578760320,39
0,1464,58113,3578760281,3578760321,40
0,1464,58114,3578760281,3578760323,42
0,1464,58115,3578760281,3578760323,42
0,1464,58116,3578760281,3578760324,43
0,1464,58117,3578760281,3578760325,44
0,1464,58118,3578760281,3578760325,44
0,1464,58119,3578760281,3578760325,44
0,1464,58120,3578760281,3578760326,45
0,1464,58121,3578760281,3578760326,45
0,1464,58122,3578760281,3578760327,46
0,1464,58123,3578760281,3578760327,46
0,1464,58124,3578760281,3578760328,47
0,1464,58125,3578760281,3578760328,47
0,1464,58126,3578760281,3578760328,47
0,1464,58127,3578760281,3578760328,47
0,1464,58128,3578760281,3578760328,47
0,1464,58129,3578760281,3578760330,49
0,1464,58130,3578760281,3578760330,49
0,1464,58131,3578760281,3578760330,49
0,1464,58132,3578760281,3578760331,50
0,1465,58133,3578760345,3578760345,0
0,1465,58134,3578760345,3578760345,0
0,1465,58135,3578760345,3578760345,0
0,1465,58136,3578760345,3578760345,0
0,1465,58137,3578760345,3578760345,0
0,1465,58138,3578760345,3578760345,0
0,1465,58139,3578760345,3578760345,0
0,1465,58140,3578760345,3578760345,0
0,1465,58141,3578760345,3578760345,0
0,1465,58142,3578760345,3578760345,0
0,1465,58143,3578760345,3578760345,0
0,1465,58144,3578760345,3578760345,0
0,1465,58145,3578760345,3578760345,0
0,1465,58146,3578760345,3578760345,0
0,1465,58147,3578760345,3578760345,0
0,1465,58148,3578760345,3578760345,0
0,1465,58149,3578760345,3578760345,0
0,1465,58150,3578760345,3578760345,0
0,1465,58151,3578760345,3578760345,0
0,1465,58152,3578760345,3578760345,0
0,1465,58153,3578760345,3578760345,0
0,1465,58154,3578760345,3578760345,0
0,1465,58155,3578760345,3578760345,0
0,1465,58156,3578760345,3578760346,1
0,1465,58157,3578760345,3578760346,1
0,1465,58158,3578760345,3578760346,1
0,1465,58159,3578760345,3578760348,3
0,1465,58160,3578760345,3578760348,3
0,1465,58161,3578760345,3578760350,5
0,1465,58162,3578760345,3578760351,6
0,1465,58163,3578760345,3578760351,6
0,1465,58164,3578760345,3578760352,7
0,1465,58165,3578760345,3578760352,7
0,1465,58166,3578760345,3578760353,8
0,1465,58167,3578760345,3578760353,8
0,1465,58168,3578760345,3578760353,8
0,1465,58169,3578760345,3578760356,11
0,1465,58170,3578760345,3578760357,12
0,1465,58171,3578760345,3578760357,12
0,1465,58172,3578760345,3578760357,12
0,1465,58173,3578760345,3578760358,13
0,1465,58174,3578760345,3578760359,14
0,1465,58175,3578760345,3578760359,14
0,1465,58176,3578760345,3578760360,15
0,1465,58177,3578760345,3578760360,15
0,1465,58178,3578760345,3578760360,15
0,1465,58179,3578760345,3578760360,15
0,1465,58180,3578760345,3578760361,16
0,1465,58181,3578760345,3578760362,17
0,1465,58182,3578760345,3578760362,17
0,1465,58183,3578760345,3578760362,17
0,1465,58184,3578760345,3578760362,17
0,1465,58185,3578760345,3578760362,17
0,1465,58186,3578760345,3578760363,18
0,1465,58187,3578760345,3578760363,18
0,1465,58188,3578760345,3578760365,20
0,1465,58189,3578760345,3578760365,20
0,1465,58190,3578760345,3578760369,24
0,1465,58191,3578760345,3578760370,25
0,1465,58192,3578760345,3578760370,25
0,1465,58193,3578760345,3578760371,26
0,1465,58194,3578760345,3578760371,26
0,1465,58195,3578760345,3578760371,26
0,1465,58196,3578760345,3578760372,27
0,1465,58197,3578760345,3578760373,28
0,1465,58198,3578760345,3578760374,29
0,1465,58199,3578760345,3578760374,29
0,1465,58200,3578760345,3578760374,29
0,1465,58201,3578760345,3578760374,29
0,1465,58202,3578760345,3578760376,31
0,1465,58203,3578760345,3578760376,31
0,1465,58204,3578760345,3578760377,32
0,1465,58205,3578760345,3578760378,33
0,1465,58206,3578760345,3578760379,34
0,1465,58207,3578760345,3578760379,34
0,1465,58208,3578760345,3578760380,35
0,1465,58209,3578760345,3578760380,35
0,1465,58210,3578760345,3578760381,36
0,1465,58211,3578760345,3578760382,37
0,1465,58212,3578760345,3578760383,38
0,1465,58213,3578760345,3578760383,38
0,1465,58214,3578760345,3578760385,40
0,1465,58215,3578760345,3578760386,41
0,1465,58216,3578760345,3578760386,41
0,1465,58217,3578760345,3578760386,41
0,1465,58218,3578760345,3578760388,43
0,1465,58219,3578760345,3578760389,44
0,1465,58220,3578760345,3578760390,45
0,1465,58221,3578760345,3578760390,45
0,1465,58222,3578760345,3578760390,45
0,1465,58223,3578760345,3578760391,46
0,1465,58224,3578760345,3578760392,47
0,1465,58225,3578760345,3578760393,48
0,1465,58226,3578760345,3578760394,49
0,1465,58227,3578760345,3578760394,49
0,1465,58228,3578760345,3578760394,49
0,1466,58229,3578760409,3578760409,0
0,1466,58230,3578760409,3578760409,0
0,1466,58231,3578760409,3578760409,0
0,1466,58232,3578760409,3578760409,0
0,1466,58233,3578760409,3578760409,0
0,1466,58234,3578760409,3578760409,0
0,1466,58235,3578760409,3578760409,0
0,1466,58236,3578760409,3578760409,0
0,1466,58237,3578760409,3578760409,0
0,1466,58238,3578760409,3578760409,0
0,1466,58239,3578760409,3578760409,0
0,1466,58240,3578760409,3578760409,0
0,1466,58241,3578760409,3578760409,0
0,1466,58242,3578760409,3578760409,0
0,1466,58243,3578760409,3578760409,0
0,1466,58244,3578760409,3578760409,0
0,1466,58245,3578760409,3578760411,2
0,1466,58246,3578760409,3578760413,4
0,1466,58247,3578760409,3578760414,5
0,1466,58248,3578760409,3578760415,6
0,1466,58249,3578760409,3578760415,6
0,1466,58250,3578760409,3578760415,6
0,1466,58251,3578760409,3578760415,6
0,1466,58252,3578760409,3578760415,6
0,1466,58253,3578760409,3578760416,7
0,1466,58254,3578760409,3578760417,8
0,1466,58255,3578760409,3578760417,8
0,1466,58256,3578760409,3578760417,8
0,1466,58257,3578760409,3578760418,9
0,1466,58258,3578760409,3578760419,10
0,1466,58259,3578760409,3578760419,10
0,1466,58260,3578760409,3578760419,10
0,1466,58261,3578760409,3578760419,10
0,1466,58262,3578760409,3578760420,11
0,1466,58263,3578760409,3578760421,12
0,1466,58264,3578760409,3578760421,12
0,1466,58265,3578760409,3578760422,13
0,1466,58266,3578760409,3578760422,13
0,1466,58267,3578760409,3578760423,14
0,1466,58268,3578760409,3578760424,15
0,1466,58269,3578760409,3578760425,16
0,1466,58270,3578760409,3578760425,16
0,1466,58271,3578760409,3578760426,17
0,1466,58272,3578760409,3578760429,20
0,1466,58273,3578760409,3578760429,20
0,1466,58274,3578760409,3578760430,21
0,1466,58275,3578760409,3578760431,22
0,1466,58276,3578760409,3578760432,23
0,1466,58277,3578760409,3578760432,23
0,1466,58278,3578760409,3578760433,24
0,1466,58279,3578760409,3578760433,24
0,1466,58280,3578760409,3578760434,25
0,1466,58281,3578760409,3578760434,25
0,1466,58282,3578760409,3578760437,28
0,1466,58283,3578760409,3578760437,28
0,1466,58284,3578760409,3578760437,28
0,1466,58285,3578760409,3578760438,29
0,1466,58286,3578760409,3578760439,30
0,1466,58287,3578760409,3578760440,31
0,1466,58288,3578760409,3578760440,31
0,1466,58289,3578760409,3578760440,31
0,1466,58290,3578760409,3578760441,32
0,1466,58291,3578760409,3578760442,33
0,1466,58292,3578760409,3578760443,34
0,1466,58293,3578760409,3578760443,34
0,1466,58294,3578760409,3578760443,34
0,1466,58295,3578760409,3578760444,35
0,1466,58296,3578760409,3578760447,38
0,1466,58297,3578760409,3578760447,38
0,1466,58298,3578760409,3578760447,38
0,1466,58299,3578760409,3578760447,38
0,1466,58300,3578760409,3578760448,39
0,1466,58301,3578760409,3578760448,39
0,1466,58302,3578760409,3578760449,40
0,1466,58303,3578760409,3578760449,40
0,1466,58304,3578760409,3578760450,41
0,1466,58305,3578760409,3578760450,41
0,1466,58306,3578760409,3578760451,42
0,1466,58307,3578760409,3578760452,43
0,1466,58308,3578760409,3578760453,44
0,1466,58309,3578760409,3578760453,44
0,1466,58310,3578760409,3578760455,46
0,1466,58311,3578760409,3578760457,48
0,1466,58312,3578760409,3578760457,48
0,1466,58313,3578760409,3578760458,49
0,1466,58314,3578760409,3578760459,50
0,1467,58315,3578760473,3578760473,0
0,1467,58316,3578760473,3578760473,0
0,1467,58317,3578760473,3578760473,0
0,1467,58318,3578760473,3578760473,0
0,1467,58319,3578760473,3578760473,0
0,1467,58320,3578760473,3578760473,0
0,1467,58321,3578760473,3578760473,0
0,1467,58322,3578760473,3578760473,0
0,1467,58323,3578760473,3578760473,0
0,1467,58324,3578760473,3578760473,0
0,1467,58325,3578760473,3578760473,0
0,1467,58326,3578760473,3578760473,0
0,1467,58327,3578760473,3578760473,0
0,1467,58328,3578760473,3578760473,0
0,1467,58329,3578760473,3578760473,0
0,1467,58330,3578760473,3578760473,0
0,1467,58331,3578760473,3578760473,0
0,1467,58332,3578760473,3578760473,0
0,1467,58333,3578760473,3578760473,0
0,1467,58334,3578760473,3578760482,9
0,1467,58335,3578760473,3578760486,13
0,1467,58336,3578760473,3578760487,14
0,1467,58337,3578760473,3578760487,14
0,1467,58338,3578760473,3578760488,15
0,1467,58339,3578760473,3578760488,15
0,1467,58340,3578760473,3578760489,16
0,1467,58341,3578760473,3578760490,17
0,1467,58342,3578760473,3578760490,17
0,1467,58343,3578760473,3578760490,17
0,1467,58344,3578760473,3578760490,17
0,1467,58345,3578760473,3578760491,18
0,1467,58346,3578760473,3578760492,19
0,1467,58347,3578760473,3578760492,19
0,1467,58348,3578760473,3578760492,19
0,1467,58349,3578760473,3578760494,21
0,1467,58350,3578760473,3578760494,21
0,1467,58351,3578760473,3578760494,21
0,1467,58352,3578760473,3578760495,22
0,1467,58353,3578760473,3578760495,22
0,1467,58354,3578760473,3578760496,23
0,1467,58355,3578760473,3578760496,23
0,1467,58356,3578760473,3578760496,23
0,1467,58357,3578760473,3578760499,26
0,1467,58358,3578760473,3578760499,26
0,1467,58359,3578760473,3578760499,26
0,1467,58360,3578760473,3578760500,27
0,1467,58361,3578760473,3578760500,27
0,1467,58362,3578760473,3578760501,28
0,1467,58363,3578760473,3578760501,28
0,1467,58364,3578760473,3578760501,28
0,1467,58365,3578760473,3578760502,29
0,1467,58366,3578760473,3578760503,30
0,1467,58367,3578760473,3578760505,32
0,1467,58368,3578760473,3578760505,32
0,1467,58369,3578760473,3578760506,33
0,1467,58370,3578760473,3578760506,33
0,1467,58371,3578760473,3578760506,33
0,1467,58372,3578760473,3578760506,33
0,1467,58373,3578760473,3578760507,34
0,1467,58374,3578760473,3578760508,35
0,1467,58375,3578760473,3578760508,35
0,1467,58376,3578760473,3578760508,35
0,1467,58377,3578760473,3578760508,35
0,1467,58378,3578760473,3578760509,36
0,1467,58379,3578760473,3578760509,36
0,1467,58380,3578760473,3578760509,36
0,1467,58381,3578760473,3578760511,38
0,1467,58382,3578760473,3578760511,38
0,1467,58383,3578760473,3578760511,38
0,1467,58384,3578760473,3578760511,38
0,1467,58385,3578760473,3578760513,40
0,1467,58386,3578760473,3578760513,40
0,1467,58387,3578760473,3578760514,41
0,1467,58388,3578760473,3578760515,42
0,1467,58389,3578760473,3578760515,42
0,1467,58390,3578760473,3578760515,42
0,1467,58391,3578760473,3578760516,43
0,1467,58392,3578760473,3578760516,43
0,1467,58393,3578760473,3578760516,43
0,1467,58394,3578760473,3578760516,43
0,1467,58395,3578760473,3578760517,44
0,1467,58396,3578760473,3578760517,44
0,1467,58397,3578760473,3578760517,44
0,1467,58398,3578760473,3578760517,44
0,1467,58399,3578760473,3578760518,45
0,1467,58400,3578760473,3578760518,45
0,1467,58401,3578760473,3578760519,46
0,1467,58402,3578760473,3578760520,47
0,1467,58403,3578760473,3578760521,48
0,1467,58404,3578760473,3578760522,49
0,1467,58405,3578760473,3578760523,50
0,1468,58406,3578760536,3578760536,0
0,1468,58407,3578760536,3578760536,0
0,1468,58408,3578760536,3578760536,0
0,1468,58409,3578760536,3578760536,0
0,1468,58410,3578760536,3578760536,0
0,1468,58411,3578760536,3578760536,0
0,1468,58412,3578760536,3578760536,0
0,1468,58413,3578760536,3578760536,0
0,1468,58414,3578760536,3578760536,0
0,1468,58415,3578760536,3578760536,0
0,1468,58416,3578760536,3578760536,0
0,1468,58417,3578760536,3578760536,0
0,1468,58418,3578760536,3578760536,0
0,1468,58419,3578760536,3578760536,0
0,1468,58420,3578760536,3578760536,0
0,1468,58421,3578760536,3578760536,0
0,1468,58422,3578760536,3578760536,0
0,1468,58423,3578760536,3578760536,0
0,1468,58424,3578760536,3578760536,0
0,1468,58425,3578760536,3578760536,0
0,1468,58426,3578760536,3578760536,0
0,1468,58427,3578760536,3578760536,0
0,1468,58428,3578760536,3578760536,0
0,1468,58429,3578760536,3578760536,0
0,1468,58430,3578760536,3578760536,0
0,1468,58431,3578760536,3578760536,0
0,1468,58432,3578760536,3578760536,0
0,1468,58433,3578760536,3578760536,0
0,1468,58434,3578760536,3578760536,0
0,1468,58435,3578760536,3578760538,2
0,1468,58436,3578760536,3578760538,2
0,1468,58437,3578760536,3578760538,2
0,1468,58438,3578760536,3578760539,3
0,1468,58439,3578760536,3578760539,3
0,1468,58440,3578760536,3578760539,3
0,1468,58441,3578760536,3578760540,4
0,1468,58442,3578760536,3578760540,4
0,1468,58443,3578760536,3578760540,4
0,1468,58444,3578760536,3578760541,5
0,1468,58445,3578760536,3578760541,5
0,1468,58446,3578760536,3578760542,6
0,1468,58447,3578760536,3578760543,7
0,1468,58448,3578760536,3578760544,8
0,1468,58449,3578760536,3578760544,8
0,1468,58450,3578760536,3578760545,9
0,1468,58451,3578760536,3578760545,9
0,1468,58452,3578760536,3578760546,10
0,1468,58453,3578760536,3578760546,10
0,1468,58454,3578760536,3578760547,11
0,1468,58455,3578760536,3578760548,12
0,1468,58456,3578760536,3578760550,14
0,1468,58457,3578760536,3578760552,16
0,1468,58458,3578760536,3578760552,16
0,1468,58459,3578760536,3578760552,16
0,1468,58460,3578760536,3578760552,16
0,1468,58461,3578760536,3578760553,17
0,1468,58462,3578760536,3578760553,17
0,1468,58463,3578760536,3578760555,19
0,1468,58464,3578760536,3578760555,19
0,1468,58465,3578760536,3578760555,19
0,1468,58466,3578760536,3578760556,20
0,1468,58467,3578760536,3578760556,20
0,1468,58468,3578760536,3578760556,20
0,1468,58469,3578760536,3578760557,21
0,1468,58470,3578760536,3578760557,21
0,1468,58471,3578760536,3578760558,22
0,1468,58472,3578760536,3578760559,23
0,1468,58473,3578760536,3578760559,23
0,1468,58474,3578760536,3578760559,23
0,1468,58475,3578760536,3578760559,23
0,1468,58476,3578760536,3578760560,24
0,1468,58477,3578760536,3578760560,24
0,1468,58478,3578760536,3578760560,24
0,1468,58479,3578760536,3578760560,24
0,1468,58480,3578760536,3578760561,25
0,1468,58481,3578760536,3578760561,25
0,1468,58482,3578760536,3578760562,26
0,1468,58483,3578760536,3578760562,26
0,1468,58484,3578760536,3578760562,26
0,1468,58485,3578760536,3578760562,26
0,1468,58486,3578760536,3578760564,28
0,1468,58487,3578760536,3578760565,29
0,1468,58488,3578760536,3578760565,29
0,1468,58489,3578760536,3578760565,29
0,1468,58490,3578760536,3578760567,31
0,1468,58491,3578760536,3578760567,31
0,1468,58492,3578760536,3578760568,32
0,1468,58493,3578760536,3578760569,33
0,1468,58494,3578760536,3578760569,33
0,1468,58495,3578760536,3578760570,34
0,1468,58496,3578760536,3578760570,34
0,1468,58497,3578760536,3578760571,35
0,1468,58498,3578760536,3578760571,35
0,1468,58499,3578760536,3578760572,36
0,1468,58500,3578760536,3578760572,36
0,1468,58501,3578760536,3578760573,37
0,1468,58502,3578760536,3578760573,37
0,1468,58503,3578760536,3578760577,41
0,1468,58504,3578760536,3578760577,41
0,1468,58505,3578760536,3578760578,42
0,1468,58506,3578760536,3578760580,44
0,1468,58507,3578760536,3578760580,44
0,1468,58508,3578760536,3578760581,45
0,1468,58509,3578760536,3578760582,46
0,1468,58510,3578760536,3578760582,46
0,1468,58511,3578760536,3578760584,48
0,1468,58512,3578760536,3578760584,48
0,1468,58513,3578760536,3578760585,49
0,1469,58514,3578760598,3578760598,0
0,1469,58515,3578760598,3578760598,0
0,1469,58516,3578760598,3578760598,0
0,1469,58517,3578760598,3578760598,0
0,1469,58518,3578760598,3578760598,0
0,1469,58519,3578760598,3578760598,0
0,1469,58520,3578760598,3578760598,0
0,1469,58521,3578760598,3578760598,0
0,1469,58522,3578760598,3578760598,0
0,1469,58523,3578760598,3578760598,0
0,1469,58524,3578760598,3578760598,0
0,1469,58525,3578760598,3578760598,0
0,1469,58526,3578760598,3578760598,0
0,1469,58527,3578760598,3578760598,0
0,1469,58528,3578760598,3578760598,0
0,1469,58529,3578760598,3578760599,1
0,1469,58530,3578760598,3578760599,1
0,1469,58531,3578760598,3578760600,2
0,1469,58532,3578760598,3578760601,3
0,1469,58533,3578760598,3578760602,4
0,1469,58534,3578760598,3578760603,5
0,1469,58535,3578760598,3578760604,6
0,1469,58536,3578760598,3578760604,6
0,1469,58537,3578760598,3578760605,7
0,1469,58538,3578760598,3578760605,7
0,1469,58539,3578760598,3578760607,9
0,1469,58540,3578760598,3578760607,9
0,1469,58541,3578760598,3578760607,9
0,1469,58542,3578760598,3578760609,11
0,1469,58543,3578760598,3578760609,11
0,1469,58544,3578760598,3578760612,14
0,1469,58545,3578760598,3578760613,15
0,1469,58546,3578760598,3578760614,16
0,1469,58547,3578760598,3578760614,16
0,1469,58548,3578760598,3578760614,16
0,1469,58549,3578760598,3578760614,16
0,1469,58550,3578760598,3578760615,17
0,1469,58551,3578760598,3578760615,17
0,1469,58552,3578760598,3578760616,18
0,1469,58553,3578760598,3578760617,19
0,1469,58554,3578760598,3578760617,19
0,1469,58555,3578760598,3578760617,19
0,1469,58556,3578760598,3578760618,20
0,1469,58557,3578760598,3578760618,20
0,1469,58558,3578760598,3578760618,20
0,1469,58559,3578760598,3578760619,21
0,1469,58560,3578760598,3578760620,22
0,1469,58561,3578760598,3578760620,22
0,1469,58562,3578760598,3578760621,23
0,1469,58563,3578760598,3578760621,23
0,1469,58564,3578760598,3578760622,24
0,1469,58565,3578760598,3578760623,25
0,1469,58566,3578760598,3578760623,25
0,1469,58567,3578760598,3578760624,26
0,1469,58568,3578760598,3578760624,26
0,1469,58569,3578760598,3578760625,27
0,1469,58570,3578760598,3578760629,31
0,1469,58571,3578760598,3578760629,31
0,1469,58572,3578760598,3578760631,33
0,1469,58573,3578760598,3578760631,33
0,1469,58574,3578760598,3578760631,33
0,1469,58575,3578760598,3578760631,33
0,1469,58576,3578760598,3578760632,34
0,1469,58577,3578760598,3578760633,35
0,1469,58578,3578760598,3578760633,35
0,1469,58579,3578760598,3578760633,35
0,1469,58580,3578760598,3578760633,35
0,1469,58581,3578760598,3578760636,38
0,1469,58582,3578760598,3578760636,38
0,1469,58583,3578760598,3578760637,39
0,1469,58584,3578760598,3578760638,40
0,1469,58585,3578760598,3578760638,40
0,1469,58586,3578760598,3578760638,40
0,1469,58587,3578760598,3578760638,40
0,1469,58588,3578760598,3578760639,41
0,1469,58589,3578760598,3578760639,41
0,1469,58590,3578760598,3578760640,42
0,1469,58591,3578760598,3578760640,42
0,1469,58592,3578760598,3578760642,44
0,1469,58593,3578760598,3578760643,45
0,1469,58594,3578760598,3578760644,46
0,1469,58595,3578760598,3578760644,46
0,1469,58596,3578760598,3578760645,47
0,1469,58597,3578760598,3578760646,48
0,1469,58598,3578760598,3578760646,48
0,1469,58599,3578760598,3578760647,49
0,1469,58600,3578760598,3578760648,50
0,1470,58601,3578760663,3578760663,0
0,1470,58602,3578760663,3578760663,0
0,1470,58603,3578760663,3578760663,0
0,1470,58604,3578760663,3578760663,0
0,1470,58605,3578760663,3578760663,0
0,1470,58606,3578760663,3578760663,0
0,1470,58607,3578760663,3578760663,0
0,1470,58608,3578760663,3578760663,0
0,1470,58609,3578760663,3578760663,0
0,1470,58610,3578760663,3578760663,0
0,1470,58611,3578760663,3578760663,0
0,1470,58612,3578760663,3578760663,0
0,1470,58613,3578760663,3578760663,0
0,1470,58614,3578760663,3578760663,0
0,1470,58615,3578760663,3578760663,0
0,1470,58616,3578760663,3578760663,0
0,1470,58617,3578760663,3578760663,0
0,1470,58618,3578760663,3578760663,0
0,1470,58619,3578760663,3578760663,0
0,1470,58620,3578760663,3578760663,0
0,1470,58621,3578760663,3578760663,0
0,1470,58622,3578760663,3578760664,1
0,1470,58623,3578760663,3578760664,1
0,1470,58624,3578760663,3578760665,2
0,1470,58625,3578760663,3578760665,2
0,1470,58626,3578760663,3578760666,3
0,1470,58627,3578760663,3578760667,4
0,1470,58628,3578760663,3578760667,4
0,1470,58629,3578760663,3578760669,6
0,1470,58630,3578760663,3578760670,7
0,1470,58631,3578760663,3578760681,18
0,1470,58632,3578760663,3578760683,20
0,1470,58633,3578760663,3578760687,24
0,1470,58634,3578760663,3578760687,24
0,1470,58635,3578760663,3578760688,25
0,1470,58636,3578760663,3578760689,26
0,1470,58637,3578760663,3578760689,26
0,1470,58638,3578760663,3578760690,27
0,1470,58639,3578760663,3578760690,27
0,1470,58640,3578760663,3578760690,27
0,1470,58641,3578760663,3578760692,29
0,1470,58642,3578760663,3578760692,29
0,1470,58643,3578760663,3578760693,30
0,1470,58644,3578760663,3578760694,31
0,1470,58645,3578760663,3578760694,31
0,1470,58646,3578760663,3578760694,31
0,1470,58647,3578760663,3578760695,32
0,1470,58648,3578760663,3578760695,32
0,1470,58649,3578760663,3578760696,33
0,1470,58650,3578760663,3578760696,33
0,1470,58651,3578760663,3578760698,35
0,1470,58652,3578760663,3578760699,36
0,1470,58653,3578760663,3578760699,36
0,1470,58654,3578760663,3578760700,37
0,1470,58655,3578760663,3578760700,37
0,1470,58656,3578760663,3578760700,37
0,1470,58657,3578760663,3578760701,38
0,1470,58658,3578760663,3578760702,39
0,1470,58659,3578760663,3578760702,39
0,1470,58660,3578760663,3578760704,41
0,1470,58661,3578760663,3578760705,42
0,1470,58662,3578760663,3578760705,42
0,1470,58663,3578760663,3578760706,43
0,1470,58664,3578760663,3578760706,43
0,1470,58665,3578760663,3578760707,44
0,1470,58666,3578760663,3578760708,45
0,1470,58667,3578760663,3578760708,45
0,1470,58668,3578760663,3578760708,45
0,1470,58669,3578760663,3578760708,45
0,1470,58670,3578760663,3578760708,45
0,1470,58671,3578760663,3578760709,46
0,1470,58672,3578760663,3578760709,46
0,1470,58673,3578760663,3578760709,46
0,1470,58674,3578760663,3578760710,47
0,1470,58675,3578760663,3578760711,48
0,1470,58676,3578760663,3578760711,48
0,1470,58677,3578760663,3578760712,49
0,1470,58678,3578760663,3578760712,49
0,1470,58679,3578760663,3578760713,50
0,1471,58680,3578760729,3578760729,0
0,1471,58681,3578760729,3578760729,0
0,1471,58682,3578760729,3578760729,0
0,1471,58683,3578760729,3578760729,0
0,1471,58684,3578760729,3578760729,0
0,1471,58685,3578760729,3578760729,0
0,1471,58686,3578760729,3578760729,0
0,1471,58687,3578760729,3578760729,0
0,1471,58688,3578760729,3578760729,0
0,1471,58689,3578760729,3578760729,0
0,1471,58690,3578760729,3578760729,0
0,1471,58691,3578760729,3578760729,0
0,1471,58692,3578760729,3578760729,0
0,1471,58693,3578760729,3578760729,0
0,1471,58694,3578760729,3578760729,0
0,1471,58695,3578760729,3578760729,0
0,1471,58696,3578760729,3578760729,0
0,1471,58697,3578760729,3578760729,0
0,1471,58698,3578760729,3578760729,0
0,1471,58699,3578760729,3578760729,0
0,1471,58700,3578760729,3578760729,0
0,1471,58701,3578760729,3578760729,0
0,1471,58702,3578760729,3578760729,0
0,1471,58703,3578760729,3578760729,0
0,1471,58704,3578760729,3578760729,0
0,1471,58705,3578760729,3578760729,0
0,1471,58706,3578760729,3578760729,0
0,1471,58707,3578760729,3578760729,0
0,1471,58708,3578760729,3578760729,0
0,1471,58709,3578760729,3578760729,0
0,1471,58710,3578760729,3578760729,0
0,1471,58711,3578760729,3578760729,0
0,1471,58712,3578760729,3578760729,0
0,1471,58713,3578760729,3578760729,0
0,1471,58714,3578760729,3578760729,0
0,1471,58715,3578760729,3578760729,0
0,1471,58716,3578760729,3578760729,0
0,1471,58717,3578760729,3578760729,0
0,1471,58718,3578760729,3578760729,0
0,1471,58719,3578760729,3578760730,1
0,1471,58720,3578760729,3578760730,1
0,1471,58721,3578760729,3578760731,2
0,1471,58722,3578760729,3578760731,2
0,1471,58723,3578760729,3578760731,2
0,1471,58724,3578760729,3578760732,3
0,1471,58725,3578760729,3578760732,3
0,1471,58726,3578760729,3578760733,4
0,1471,58727,3578760729,3578760734,5
0,1471,58728,3578760729,3578760734,5
0,1471,58729,3578760729,3578760734,5
0,1471,58730,3578760729,3578760735,6
0,1471,58731,3578760729,3578760736,7
0,1471,58732,3578760729,3578760737,8
0,1471,58733,3578760729,3578760738,9
0,1471,58734,3578760729,3578760739,10
0,1471,58735,3578760729,3578760739,10
0,1471,58736,3578760729,3578760739,10
0,1471,58737,3578760729,3578760739,10
0,1471,58738,3578760729,3578760739,10
0,1471,58739,3578760729,3578760740,11
0,1471,58740,3578760729,3578760740,11
0,1471,58741,3578760729,3578760740,11
0,1471,58742,3578760729,3578760741,12
0,1471,58743,3578760729,3578760742,13
0,1471,58744,3578760729,3578760742,13
0,1471,58745,3578760729,3578760743,14
0,1471,58746,3578760729,3578760743,14
0,1471,58747,3578760729,3578760743,14
0,1471,58748,3578760729,3578760745,16
0,1471,58749,3578760729,3578760745,16
0,1471,58750,3578760729,3578760746,17
0,1471,58751,3578760729,3578760746,17
0,1471,58752,3578760729,3578760746,17
0,1471,58753,3578760729,3578760746,17
0,1471,58754,3578760729,3578760748,19
0,1471,58755,3578760729,3578760748,19
0,1471,58756,3578760729,3578760749,20
0,1471,58757,3578760729,3578760750,21
0,1471,58758,3578760729,3578760751,22
0,1471,58759,3578760729,3578760752,23
0,1471,58760,3578760729,3578760752,23
0,1471,58761,3578760729,3578760753,24
0,1471,58762,3578760729,3578760753,24
0,1471,58763,3578760729,3578760755,26
0,1471,58764,3578760729,3578760755,26
0,1471,58765,3578760729,3578760756,27
0,1471,58766,3578760729,3578760756,27
0,1471,58767,3578760729,3578760757,28
0,1471,58768,3578760729,3578760758,29
0,1471,58769,3578760729,3578760759,30
0,1471,58770,3578760729,3578760759,30
0,1471,58771,3578760729,3578760760,31
0,1471,58772,3578760729,3578760760,31
0,1471,58773,3578760729,3578760760,31
0,1471,58774,3578760729,3578760760,31
0,1471,58775,3578760729,3578760761,32
0,1471,58776,3578760729,3578760761,32
0,1471,58777,3578760729,3578760761,32
0,1471,58778,3578760729,3578760762,33
0,1471,58779,3578760729,3578760762,33
0,1471,58780,3578760729,3578760763,34
0,1471,58781,3578760729,3578760763,34
0,1471,58782,3578760729,3578760763,34
0,1471,58783,3578760729,3578760764,35
0,1471,58784,3578760729,3578760765,36
0,1471,58785,3578760729,3578760766,37
0,1471,58786,3578760729,3578760766,37
0,1471,58787,3578760729,3578760767,38
0,1471,58788,3578760729,3578760767,38
0,1471,58789,3578760729,3578760768,39
0,1471,58790,3578760729,3578760769,40
0,1471,58791,3578760729,3578760769,40
0,1471,58792,3578760729,3578760771,42
0,1471,58793,3578760729,3578760771,42
0,1471,58794,3578760729,3578760771,42
0,1471,58795,3578760729,3578760773,44
0,1471,58796,3578760729,3578760773,44
0,1471,58797,3578760729,3578760774,45
0,1471,58798,3578760729,3578760775,46
0,1471,58799,3578760729,3578760778,49
0,1471,58800,3578760729,3578760778,49
0,1471,58801,3578760729,3578760779,50
0,1472,58802,3578760792,3578760792,0
0,1472,58803,3578760792,3578760792,0
0,1472,58804,3578760792,3578760792,0
0,1472,58805,3578760792,3578760792,0
0,1472,58806,3578760792,3578760792,0
0,1472,58807,3578760792,3578760792,0
0,1472,58808,3578760792,3578760792,0
0,1472,58809,3578760792,3578760792,0
0,1472,58810,3578760792,3578760792,0
0,1472,58811,3578760792,3578760792,0
0,1472,58812,3578760792,3578760792,0
0,1472,58813,3578760792,3578760792,0
0,1472,58814,3578760792,3578760792,0
0,1472,58815,3578760792,3578760792,0
0,1472,58816,3578760792,3578760792,0
0,1472,58817,3578760792,3578760792,0
0,1472,58818,3578760792,3578760792,0
0,1472,58819,3578760792,3578760792,0
0,1472,58820,3578760792,3578760793,1
0,1472,58821,3578760792,3578760793,1
0,1472,58822,3578760792,3578760795,3
0,1472,58823,3578760792,3578760795,3
0,1472,58824,3578760792,3578760796,4
0,1472,58825,3578760792,3578760797,5
0,1472,58826,3578760792,3578760797,5
0,1472,58827,3578760792,3578760797,5
0,1472,58828,3578760792,3578760798,6
0,1472,58829,3578760792,3578760799,7
0,1472,58830,3578760792,3578760799,7
0,1472,58831,3578760792,3578760800,8
0,1472,58832,3578760792,3578760804,12
0,1472,58833,3578760792,3578760804,12
0,1472,58834,3578760792,3578760804,12
0,1472,58835,3578760792,3578760805,13
0,1472,58836,3578760792,3578760805,13
0,1472,58837,3578760792,3578760807,15
0,1472,58838,3578760792,3578760807,15
0,1472,58839,3578760792,3578760808,16
0,1472,58840,3578760792,3578760808,16
0,1472,58841,3578760792,3578760810,18
0,1472,58842,3578760792,3578760811,19
0,1472,58843,3578760792,3578760812,20
0,1472,58844,3578760792,3578760814,22
0,1472,58845,3578760792,3578760814,22
0,1472,58846,3578760792,3578760815,23
0,1472,58847,3578760792,3578760815,23
0,1472,58848,3578760792,3578760815,23
0,1472,58849,3578760792,3578760816,24
0,1472,58850,3578760792,3578760816,24
0,1472,58851,3578760792,3578760816,24
0,1472,58852,3578760792,3578760817,25
0,1472,58853,3578760792,3578760817,25
0,1472,58854,3578760792,3578760818,26
0,1472,58855,3578760792,3578760819,27
0,1472,58856,3578760792,3578760819,27
0,1472,58857,3578760792,3578760820,28
0,1472,58858,3578760792,3578760821,29
0,1472,58859,3578760792,3578760822,30
0,1472,58860,3578760792,3578760823,31
0,1472,58861,3578760792,3578760824,32
0,1472,58862,3578760792,3578760824,32
0,1472,58863,3578760792,3578760826,34
0,1472,58864,3578760792,3578760827,35
0,1472,58865,3578760792,3578760828,36
0,1472,58866,3578760792,3578760829,37
0,1472,58867,3578760792,3578760829,37
0,1472,58868,3578760792,3578760831,39
0,1472,58869,3578760792,3578760831,39
0,1472,58870,3578760792,3578760831,39
0,1472,58871,3578760792,3578760831,39
0,1472,58872,3578760792,3578760832,40
0,1472,58873,3578760792,3578760833,41
0,1472,58874,3578760792,3578760834,42
0,1472,58875,3578760792,3578760834,42
0,1472,58876,3578760792,3578760836,44
0,1472,58877,3578760792,3578760836,44
0,1472,58878,3578760792,3578760837,45
0,1472,58879,3578760792,3578760837,45
0,1472,58880,3578760792,3578760838,46
0,1472,58881,3578760792,3578760838,46
0,1472,58882,3578760792,3578760839,47
0,1472,58883,3578760792,3578760839,47
0,1472,58884,3578760792,3578760840,48
0,1472,58885,3578760792,3578760840,48
0,1473,58886,3578760855,3578760855,0
0,1473,58887,3578760855,3578760855,0
0,1473,58888,3578760855,3578760855,0
0,1473,58889,3578760855,3578760855,0
0,1473,58890,3578760855,3578760855,0
0,1473,58891,3578760855,3578760855,0
0,1473,58892,3578760855,3578760855,0
0,1473,58893,3578760855,3578760855,0
0,1473,58894,3578760855,3578760855,0
0,1473,58895,3578760855,3578760855,0
0,1473,58896,3578760855,3578760855,0
0,1473,58897,3578760855,3578760855,0
0,1473,58898,3578760855,3578760855,0
0,1473,58899,3578760855,3578760855,0
0,1473,58900,3578760855,3578760855,0
0,1473,58901,3578760855,3578760855,0
0,1473,58902,3578760855,3578760856,1
0,1473,58903,3578760855,3578760857,2
0,1473,58904,3578760855,3578760858,3
0,1473,58905,3578760855,3578760858,3
0,1473,58906,3578760855,3578760858,3
0,1473,58907,3578760855,3578760858,3
0,1473,58908,3578760855,3578760859,4
0,1473,58909,3578760855,3578760859,4
0,1473,58910,3578760855,3578760859,4
0,1473,58911,3578760855,3578760861,6
0,1473,58912,3578760855,3578760861,6
0,1473,58913,3578760855,3578760862,7
0,1473,58914,3578760855,3578760862,7
0,1473,58915,3578760855,3578760863,8
0,1473,58916,3578760855,3578760863,8
0,1473,58917,3578760855,3578760863,8
0,1473,58918,3578760855,3578760864,9
0,1473,58919,3578760855,3578760865,10
0,1473,58920,3578760855,3578760865,10
0,1473,58921,3578760855,3578760865,10
0,1473,58922,3578760855,3578760866,11
0,1473,58923,3578760855,3578760866,11
0,1473,58924,3578760855,3578760868,13
0,1473,58925,3578760855,3578760869,14
0,1473,58926,3578760855,3578760870,15
0,1473,58927,3578760855,3578760882,27
0,1473,58928,3578760855,3578760882,27
0,1473,58929,3578760855,3578760882,27
0,1473,58930,3578760855,3578760887,32
0,1473,58931,3578760855,3578760887,32
0,1473,58932,3578760855,3578760888,33
0,1473,58933,3578760855,3578760888,33
0,1473,58934,3578760855,3578760889,34
0,1473,58935,3578760855,3578760889,34
0,1473,58936,3578760855,3578760890,35
0,1473,58937,3578760855,3578760890,35
0,1473,58938,3578760855,3578760890,35
0,1473,58939,3578760855,3578760892,37
0,1473,58940,3578760855,3578760892,37
0,1473,58941,3578760855,3578760893,38
0,1473,58942,3578760855,3578760894,39
0,1473,58943,3578760855,3578760894,39
0,1473,58944,3578760855,3578760894,39
0,1473,58945,3578760855,3578760895,40
0,1473,58946,3578760855,3578760896,41
0,1473,58947,3578760855,3578760896,41
0,1473,58948,3578760855,3578760896,41
0,1473,58949,3578760855,3578760896,41
0,1473,58950,3578760855,3578760899,44
0,1473,58951,3578760855,3578760899,44
0,1473,58952,3578760855,3578760899,44
0,1473,58953,3578760855,3578760899,44
0,1473,58954,3578760855,3578760899,44
0,1473,58955,3578760855,3578760900,45
0,1473,58956,3578760855,3578760900,45
0,1473,58957,3578760855,3578760902,47
0,1473,58958,3578760855,3578760902,47
0,1473,58959,3578760855,3578760903,48
0,1473,58960,3578760855,3578760904,49
0,1474,58961,3578760919,3578760919,0
0,1474,58962,3578760919,3578760919,0
0,1474,58963,3578760919,3578760919,0
0,1474,58964,3578760919,3578760919,0
0,1474,58965,3578760919,3578760919,0
0,1474,58966,3578760919,3578760919,0
0,1474,58967,3578760919,3578760919,0
0,1474,58968,3578760919,3578760919,0
0,1474,58969,3578760919,3578760919,0
0,1474,58970,3578760919,3578760919,0
0,1474,58971,3578760919,3578760919,0
0,1474,58972,3578760919,3578760919,0
0,1474,58973,3578760919,3578760919,0
0,1474,58974,3578760919,3578760919,0
0,1474,58975,3578760919,3578760919,0
0,1474,58976,3578760919,3578760919,0
0,1474,58977,3578760919,3578760919,0
0,1474,58978,3578760919,3578760919,0
0,1474,58979,3578760919,3578760919,0
0,1474,58980,3578760919,3578760919,0
0,1474,58981,3578760919,3578760919,0
0,1474,58982,3578760919,3578760919,0
0,1474,58983,3578760919,3578760919,0
0,1474,58984,3578760919,3578760919,0
0,1474,58985,3578760919,3578760919,0
0,1474,58986,3578760919,3578760919,0
0,1474,58987,3578760919,3578760919,0
0,1474,58988,3578760919,3578760919,0
0,1474,58989,3578760919,3578760919,0
0,1474,58990,3578760919,3578760919,0
0,1474,58991,3578760919,3578760919,0
0,1474,58992,3578760919,3578760919,0
0,1474,58993,3578760919,3578760919,0
0,1474,58994,3578760919,3578760919,0
0,1474,58995,3578760919,3578760919,0
0,1474,58996,3578760919,3578760919,0
0,1474,58997,3578760919,3578760919,0
0,1474,58998,3578760919,3578760919,0
0,1474,58999,3578760919,3578760919,0
0,1474,59000,3578760919,3578760919,0
0,1474,59001,3578760919,3578760919,0
0,1474,59002,3578760919,3578760919,0
0,1474,59003,3578760919,3578760919,0
0,1474,59004,3578760919,3578760920,1
0,1474,59005,3578760919,3578760921,2
0,1474,59006,3578760919,3578760923,4
0,1474,59007,3578760919,3578760923,4
0,1474,59008,3578760919,3578760923,4
0,1474,59009,3578760919,3578760924,5
0,1474,59010,3578760919,3578760925,6
0,1474,59011,3578760919,3578760926,7
0,1474,59012,3578760919,3578760926,7
0,1474,59013,3578760919,3578760926,7
0,1474,59014,3578760919,3578760926,7
0,1474,59015,3578760919,3578760927,8
0,1474,59016,3578760919,3578760927,8
0,1474,59017,3578760919,3578760927,8
0,1474,59018,3578760919,3578760928,9
0,1474,59019,3578760919,3578760928,9
0,1474,59020,3578760919,3578760928,9
0,1474,59021,3578760919,3578760929,10
0,1474,59022,3578760919,3578760929,10
0,1474,59023,3578760919,3578760929,10
0,1474,59024,3578760919,3578760929,10
0,1474,59025,3578760919,3578760929,10
0,1474,59026,3578760919,3578760929,10
0,1474,59027,3578760919,3578760930,11
0,1474,59028,3578760919,3578760930,11
0,1474,59029,3578760919,3578760930,11
0,1474,59030,3578760919,3578760931,12
0,1474,59031,3578760919,3578760931,12
0,1474,59032,3578760919,3578760932,13
0,1474,59033,3578760919,3578760932,13
0,1474,59034,3578760919,3578760933,14
0,1474,59035,3578760919,3578760934,15
0,1474,59036,3578760919,3578760934,15
0,1474,59037,3578760919,3578760935,16
0,1474,59038,3578760919,3578760935,16
0,1474,59039,3578760919,3578760936,17
0,1474,59040,3578760919,3578760936,17
0,1474,59041,3578760919,3578760937,18
0,1474,59042,3578760919,3578760938,19
0,1474,59043,3578760919,3578760938,19
0,1474,59044,3578760919,3578760939,20
0,1474,59045,3578760919,3578760939,20
0,1474,59046,3578760919,3578760939,20
0,1474,59047,3578760919,3578760940,21
0,1474,59048,3578760919,3578760940,21
0,1474,59049,3578760919,3578760940,21
0,1474,59050,3578760919,3578760940,21
0,1474,59051,3578760919,3578760941,22
0,1474,59052,3578760919,3578760942,23
0,1474,59053,3578760919,3578760943,24
0,1474,59054,3578760919,3578760943,24
0,1474,59055,3578760919,3578760943,24
0,1474,59056,3578760919,3578760944,25
0,1474,59057,3578760919,3578760945,26
0,1474,59058,3578760919,3578760946,27
0,1474,59059,3578760919,3578760946,27
0,1474,59060,3578760919,3578760946,27
0,1474,59061,3578760919,3578760947,28
0,1474,59062,3578760919,3578760948,29
0,1474,59063,3578760919,3578760948,29
0,1474,59064,3578760919,3578760949,30
0,1474,59065,3578760919,3578760950,31
0,1474,59066,3578760919,3578760950,31
0,1474,59067,3578760919,3578760951,32
0,1474,59068,3578760919,3578760952,33
0,1474,59069,3578760919,3578760952,33
0,1474,59070,3578760919,3578760952,33
0,1474,59071,3578760919,3578760952,33
0,1474,59072,3578760919,3578760955,36
0,1474,59073,3578760919,3578760956,37
0,1474,59074,3578760919,3578760956,37
0,1474,59075,3578760919,3578760956,37
0,1474,59076,3578760919,3578760957,38
0,1474,59077,3578760919,3578760958,39
0,1474,59078,3578760919,3578760959,40
0,1474,59079,3578760919,3578760959,40
0,1474,59080,3578760919,3578760960,41
0,1474,59081,3578760919,3578760960,41
0,1474,59082,3578760919,3578760960,41
0,1474,59083,3578760919,3578760961,42
0,1474,59084,3578760919,3578760961,42
0,1474,59085,3578760919,3578760961,42
0,1474,59086,3578760919,3578760961,42
0,1474,59087,3578760919,3578760962,43
0,1474,59088,3578760919,3578760963,44
0,1474,59089,3578760919,3578760963,44
0,1474,59090,3578760919,3578760964,45
0,1474,59091,3578760919,3578760965,46
0,1474,59092,3578760919,3578760965,46
0,1474,59093,3578760919,3578760966,47
0,1474,59094,3578760919,3578760966,47
0,1474,59095,3578760919,3578760967,48
0,1474,59096,3578760919,3578760968,49
0,1475,59097,3578760982,3578760982,0
0,1475,59098,3578760982,3578760982,0
0,1475,59099,3578760982,3578760982,0
0,1475,59100,3578760982,3578760982,0
0,1475,59101,3578760982,3578760982,0
0,1475,59102,3578760982,3578760982,0
0,1475,59103,3578760982,3578760982,0
0,1475,59104,3578760982,3578760982,0
0,1475,59105,3578760982,3578760982,0
0,1475,59106,3578760982,3578760982,0
0,1475,59107,3578760982,3578760982,0
0,1475,59108,3578760982,3578760982,0
0,1475,59109,3578760982,3578760982,0
0,1475,59110,3578760982,3578760982,0
0,1475,59111,3578760982,3578760982,0
0,1475,59112,3578760982,3578760982,0
0,1475,59113,3578760982,3578760982,0
0,1475,59114,3578760982,3578760982,0
0,1475,59115,3578760982,3578760983,1
0,1475,59116,3578760982,3578760983,1
0,1475,59117,3578760982,3578760984,2
0,1475,59118,3578760982,3578760985,3
0,1475,59119,3578760982,3578760985,3
0,1475,59120,3578760982,3578760987,5
0,1475,59121,3578760982,3578760988,6
0,1475,59122,3578760982,3578760988,6
0,1475,59123,3578760982,3578760989,7
0,1475,59124,3578760982,3578760989,7
0,1475,59125,3578760982,3578760990,8
0,1475,59126,3578760982,3578760990,8
0,1475,59127,3578760982,3578760992,10
0,1475,59128,3578760982,3578760993,11
0,1475,59129,3578760982,3578760994,12
0,1475,59130,3578760982,3578760995,13
0,1475,59131,3578760982,3578760997,15
0,1475,59132,3578760982,3578760997,15
0,1475,59133,3578760982,3578760998,16
0,1475,59134,3578760982,3578760999,17
0,1475,59135,3578760982,3578760999,17
0,1475,59136,3578760982,3578760999,17
0,1475,59137,3578760982,3578761000,18
0,1475,59138,3578760982,3578761001,19
0,1475,59139,3578760982,3578761002,20
0,1475,59140,3578760982,3578761003,21
0,1475,59141,3578760982,3578761003,21
0,1475,59142,3578760982,3578761004,22
0,1475,59143,3578760982,3578761005,23
0,1475,59144,3578760982,3578761005,23
0,1475,59145,3578760982,3578761005,23
0,1475,59146,3578760982,3578761007,25
0,1475,59147,3578760982,3578761007,25
0,1475,59148,3578760982,3578761008,26
0,1475,59149,3578760982,3578761009,27
0,1475,59150,3578760982,3578761010,28
0,1475,59151,3578760982,3578761011,29
0,1475,59152,3578760982,3578761012,30
0,1475,59153,3578760982,3578761012,30
0,1475,59154,3578760982,3578761012,30
0,1475,59155,3578760982,3578761014,32
0,1475,59156,3578760982,3578761014,32
0,1475,59157,3578760982,3578761015,33
0,1475,59158,3578760982,3578761015,33
0,1475,59159,3578760982,3578761015,33
0,1475,59160,3578760982,3578761016,34
0,1475,59161,3578760982,3578761016,34
0,1475,59162,3578760982,3578761016,34
0,1475,59163,3578760982,3578761017,35
0,1475,59164,3578760982,3578761018,36
0,1475,59165,3578760982,3578761018,36
0,1475,59166,3578760982,3578761019,37
0,1475,59167,3578760982,3578761020,38
0,1475,59168,3578760982,3578761021,39
0,1475,59169,3578760982,3578761021,39
0,1475,59170,3578760982,3578761023,41
0,1475,59171,3578760982,3578761023,41
0,1475,59172,3578760982,3578761024,42
0,1475,59173,3578760982,3578761024,42
0,1475,59174,3578760982,3578761024,42
0,1475,59175,3578760982,3578761025,43
0,1475,59176,3578760982,3578761025,43
0,1475,59177,3578760982,3578761027,45
0,1475,59178,3578760982,3578761027,45
0,1475,59179,3578760982,3578761029,47
0,1475,59180,3578760982,3578761030,48
0,1475,59181,3578760982,3578761031,49
0,1475,59182,3578760982,3578761031,49
0,1475,59183,3578760982,3578761031,49
0,1476,59184,3578761046,3578761046,0
0,1476,59185,3578761046,3578761046,0
0,1476,59186,3578761046,3578761046,0
0,1476,59187,3578761046,3578761046,0
0,1476,59188,3578761046,3578761046,0
0,1476,59189,3578761046,3578761046,0
0,1476,59190,3578761046,3578761046,0
0,1476,59191,3578761046,3578761046,0
0,1476,59192,3578761046,3578761046,0
0,1476,59193,3578761046,3578761046,0
0,1476,59194,3578761046,3578761046,0
0,1476,59195,3578761046,3578761046,0
0,1476,59196,3578761046,3578761046,0
0,1476,59197,3578761046,3578761046,0
0,1476,59198,3578761046,3578761046,0
0,1476,59199,3578761046,3578761046,0
0,1476,59200,3578761046,3578761046,0
0,1476,59201,3578761046,3578761046,0
0,1476,59202,3578761046,3578761047,1
0,1476,59203,3578761046,3578761047,1
0,1476,59204,3578761046,3578761047,1
0,1476,59205,3578761046,3578761047,1
0,1476,59206,3578761046,3578761047,1
0,1476,59207,3578761046,3578761047,1
0,1476,59208,3578761046,3578761047,1
0,1476,59209,3578761046,3578761047,1
0,1476,59210,3578761046,3578761048,2
0,1476,59211,3578761046,3578761048,2
0,1476,59212,3578761046,3578761049,3
0,1476,59213,3578761046,3578761050,4
0,1476,59214,3578761046,3578761050,4
0,1476,59215,3578761046,3578761051,5
0,1476,59216,3578761046,3578761052,6
0,1476,59217,3578761046,3578761053,7
0,1476,59218,3578761046,3578761056,10
0,1476,59219,3578761046,3578761056,10
0,1476,59220,3578761046,3578761058,12
0,1476,59221,3578761046,3578761058,12
0,1476,59222,3578761046,3578761058,12
0,1476,59223,3578761046,3578761059,13
0,1476,59224,3578761046,3578761059,13
0,1476,59225,3578761046,3578761059,13
0,1476,59226,3578761046,3578761061,15
0,1476,59227,3578761046,3578761062,16
0,1476,59228,3578761046,3578761062,16
0,1476,59229,3578761046,3578761062,16
0,1476,59230,3578761046,3578761063,17
0,1476,59231,3578761046,3578761063,17
0,1476,59232,3578761046,3578761063,17
0,1476,59233,3578761046,3578761065,19
0,1476,59234,3578761046,3578761065,19
0,1476,59235,3578761046,3578761065,19
0,1476,59236,3578761046,3578761066,20
0,1476,59237,3578761046,3578761067,21
0,1476,59238,3578761046,3578761067,21
0,1476,59239,3578761046,3578761068,22
0,1476,59240,3578761046,3578761068,22
0,1476,59241,3578761046,3578761069,23
0,1476,59242,3578761046,3578761070,24
0,1476,59243,3578761046,3578761082,36
0,1476,59244,3578761046,3578761082,36
0,1476,59245,3578761046,3578761087,41
0,1476,59246,3578761046,3578761087,41
0,1476,59247,3578761046,3578761089,43
0,1476,59248,3578761046,3578761089,43
0,1476,59249,3578761046,3578761090,44
0,1476,59250,3578761046,3578761090,44
0,1476,59251,3578761046,3578761090,44
0,1476,59252,3578761046,3578761090,44
0,1476,59253,3578761046,3578761090,44
0,1476,59254,3578761046,3578761092,46
0,1476,59255,3578761046,3578761092,46
0,1476,59256,3578761046,3578761093,47
0,1476,59257,3578761046,3578761094,48
0,1476,59258,3578761046,3578761094,48
0,1476,59259,3578761046,3578761095,49
0,1476,59260,3578761046,3578761095,49
0,1476,59261,3578761046,3578761096,50
0,1477,59262,3578761111,3578761111,0
0,1477,59263,3578761111,3578761111,0
0,1477,59264,3578761111,3578761111,0
0,1477,59265,3578761111,3578761111,0
0,1477,59266,3578761111,3578761111,0
0,1477,59267,3578761111,3578761111,0
0,1477,59268,3578761111,3578761111,0
0,1477,59269,3578761111,3578761111,0
0,1477,59270,3578761111,3578761111,0
0,1477,59271,3578761111,3578761111,0
0,1477,59272,3578761111,3578761111,0
0,1477,59273,3578761111,3578761111,0
0,1477,59274,3578761111,3578761111,0
0,1477,59275,3578761111,3578761111,0
0,1477,59276,3578761111,3578761111,0
0,1477,59277,3578761111,3578761111,0
0,1477,59278,3578761111,3578761111,0
0,1477,59279,3578761111,3578761111,0
0,1477,59280,3578761111,3578761111,0
0,1477,59281,3578761111,3578761111,0
0,1477,59282,3578761111,3578761111,0
0,1477,59283,3578761111,3578761111,0
0,1477,59284,3578761111,3578761111,0
0,1477,59285,3578761111,3578761111,0
0,1477,59286,3578761111,3578761111,0
0,1477,59287,3578761111,3578761111,0
0,1477,59288,3578761111,3578761111,0
0,1477,59289,3578761111,3578761111,0
0,1477,59290,3578761111,3578761113,2
0,1477,59291,3578761111,3578761113,2
0,1477,59292,3578761111,3578761114,3
0,1477,59293,3578761111,3578761114,3
0,1477,59294,3578761111,3578761115,4
0,1477,59295,3578761111,3578761116,5
0,1477,59296,3578761111,3578761116,5
0,1477,59297,3578761111,3578761116,5
0,1477,59298,3578761111,3578761116,5
0,1477,59299,3578761111,3578761116,5
0,1477,59300,3578761111,3578761116,5
0,1477,59301,3578761111,3578761116,5
0,1477,59302,3578761111,3578761116,5
0,1477,59303,3578761111,3578761117,6
0,1477,59304,3578761111,3578761117,6
0,1477,59305,3578761111,3578761117,6
0,1477,59306,3578761111,3578761118,7
0,1477,59307,3578761111,3578761118,7
0,1477,59308,3578761111,3578761118,7
0,1477,59309,3578761111,3578761119,8
0,1477,59310,3578761111,3578761119,8
0,1477,59311,3578761111,3578761120,9
0,1477,59312,3578761111,3578761121,10
0,1477,59313,3578761111,3578761123,12
0,1477,59314,3578761111,3578761123,12
0,1477,59315,3578761111,3578761123,12
0,1477,59316,3578761111,3578761123,12
0,1477,59317,3578761111,3578761125,14
0,1477,59318,3578761111,3578761126,15
0,1477,59319,3578761111,3578761126,15
0,1477,59320,3578761111,3578761126,15
0,1477,59321,3578761111,3578761127,16
0,1477,59322,3578761111,3578761128,17
0,1477,59323,3578761111,3578761128,17
0,1477,59324,3578761111,3578761128,17
0,1477,59325,3578761111,3578761128,17
0,1477,59326,3578761111,3578761129,18
0,1477,59327,3578761111,3578761129,18
0,1477,59328,3578761111,3578761129,18
0,1477,59329,3578761111,3578761129,18
0,1477,59330,3578761111,3578761130,19
0,1477,59331,3578761111,3578761130,19
0,1477,59332,3578761111,3578761130,19
0,1477,59333,3578761111,3578761131,20
0,1477,59334,3578761111,3578761131,20
0,1477,59335,3578761111,3578761132,21
0,1477,59336,3578761111,3578761132,21
0,1477,59337,3578761111,3578761132,21
0,1477,59338,3578761111,3578761132,21
0,1477,59339,3578761111,3578761133,22
0,1477,59340,3578761111,3578761134,23
0,1477,59341,3578761111,3578761134,23
0,1477,59342,3578761111,3578761135,24
0,1477,59343,3578761111,3578761135,24
0,1477,59344,3578761111,3578761136,25
0,1477,59345,3578761111,3578761138,27
0,1477,59346,3578761111,3578761138,27
0,1477,59347,3578761111,3578761139,28
0,1477,59348,3578761111,3578761139,28
0,1477,59349,3578761111,3578761139,28
0,1477,59350,3578761111,3578761140,29
0,1477,59351,3578761111,3578761140,29
0,1477,59352,3578761111,3578761140,29
0,1477,59353,3578761111,3578761141,30
0,1477,59354,3578761111,3578761142,31
0,1477,59355,3578761111,3578761143,32
0,1477,59356,3578761111,3578761144,33
0,1477,59357,3578761111,3578761144,33
0,1477,59358,3578761111,3578761145,34
0,1477,59359,3578761111,3578761145,34
0,1477,59360,3578761111,3578761146,35
0,1477,59361,3578761111,3578761146,35
0,1477,59362,3578761111,3578761147,36
0,1477,59363,3578761111,3578761148,37
0,1477,59364,3578761111,3578761149,38
0,1477,59365,3578761111,3578761149,38
0,1477,59366,3578761111,3578761150,39
0,1477,59367,3578761111,3578761150,39
0,1477,59368,3578761111,3578761151,40
0,1477,59369,3578761111,3578761152,41
0,1477,59370,3578761111,3578761152,41
0,1477,59371,3578761111,3578761152,41
0,1477,59372,3578761111,3578761153,42
0,1477,59373,3578761111,3578761153,42
0,1477,59374,3578761111,3578761155,44
0,1477,59375,3578761111,3578761155,44
0,1477,59376,3578761111,3578761155,44
0,1477,59377,3578761111,3578761156,45
0,1477,59378,3578761111,3578761157,46
0,1477,59379,3578761111,3578761158,47
0,1477,59380,3578761111,3578761159,48
0,1477,59381,3578761111,3578761159,48
0,1477,59382,3578761111,3578761160,49
0,1477,59383,3578761111,3578761160,49
0,1477,59384,3578761111,3578761160,49
0,1477,59385,3578761111,3578761160,49
0,1477,59386,3578761111,3578761160,49
0,1477,59387,3578761111,3578761161,50
0,1478,59388,3578761176,3578761176,0
0,1478,59389,3578761176,3578761176,0
0,1478,59390,3578761176,3578761176,0
0,1478,59391,3578761176,3578761176,0
0,1478,59392,3578761176,3578761176,0
0,1478,59393,3578761176,3578761176,0
0,1478,59394,3578761176,3578761176,0
0,1478,59395,3578761176,3578761176,0
0,1478,59396,3578761176,3578761176,0
0,1478,59397,3578761176,3578761176,0
0,1478,59398,3578761176,3578761176,0
0,1478,59399,3578761176,3578761176,0
0,1478,59400,3578761176,3578761176,0
0,1478,59401,3578761176,3578761176,0
0,1478,59402,3578761176,3578761176,0
0,1478,59403,3578761176,3578761176,0
0,1478,59404,3578761176,3578761176,0
0,1478,59405,3578761176,3578761176,0
0,1478,59406,3578761176,3578761176,0
0,1478,59407,3578761176,3578761176,0
0,1478,59408,3578761176,3578761178,2
0,1478,59409,3578761176,3578761178,2
0,1478,59410,3578761176,3578761178,2
0,1478,59411,3578761176,3578761179,3
0,1478,59412,3578761176,3578761179,3
0,1478,59413,3578761176,3578761179,3
0,1478,59414,3578761176,3578761180,4
0,1478,59415,3578761176,3578761182,6
0,1478,59416,3578761176,3578761182,6
0,1478,59417,3578761176,3578761183,7
0,1478,59418,3578761176,3578761184,8
0,1478,59419,3578761176,3578761185,9
0,1478,59420,3578761176,3578761185,9
0,1478,59421,3578761176,3578761185,9
0,1478,59422,3578761176,3578761186,10
0,1478,59423,3578761176,3578761187,11
0,1478,59424,3578761176,3578761188,12
0,1478,59425,3578761176,3578761188,12
0,1478,59426,3578761176,3578761189,13
0,1478,59427,3578761176,3578761190,14
0,1478,59428,3578761176,3578761190,14
0,1478,59429,3578761176,3578761191,15
0,1478,59430,3578761176,3578761192,16
0,1478,59431,3578761176,3578761192,16
0,1478,59432,3578761176,3578761193,17
0,1478,59433,3578761176,3578761193,17
0,1478,59434,3578761176,3578761194,18
0,1478,59435,3578761176,3578761195,19
0,1478,59436,3578761176,3578761197,21
0,1478,59437,3578761176,3578761198,22
0,1478,59438,3578761176,3578761198,22
0,1478,59439,3578761176,3578761198,22
0,1478,59440,3578761176,3578761199,23
0,1478,59441,3578761176,3578761199,23
0,1478,59442,3578761176,3578761199,23
0,1478,59443,3578761176,3578761200,24
0,1478,59444,3578761176,3578761202,26
0,1478,59445,3578761176,3578761204,28
0,1478,59446,3578761176,3578761204,28
0,1478,59447,3578761176,3578761204,28
0,1478,59448,3578761176,3578761205,29
0,1478,59449,3578761176,3578761206,30
0,1478,59450,3578761176,3578761207,31
0,1478,59451,3578761176,3578761207,31
0,1478,59452,3578761176,3578761208,32
0,1478,59453,3578761176,3578761209,33
0,1478,59454,3578761176,3578761210,34
0,1478,59455,3578761176,3578761212,36
0,1478,59456,3578761176,3578761213,37
0,1478,59457,3578761176,3578761214,38
0,1478,59458,3578761176,3578761215,39
0,1478,59459,3578761176,3578761215,39
0,1478,59460,3578761176,3578761215,39
0,1478,59461,3578761176,3578761216,40
0,1478,59462,3578761176,3578761216,40
0,1478,59463,3578761176,3578761216,40
0,1478,59464,3578761176,3578761218,42
0,1478,59465,3578761176,3578761218,42
0,1478,59466,3578761176,3578761219,43
0,1478,59467,3578761176,3578761219,43
0,1478,59468,3578761176,3578761220,44
0,1478,59469,3578761176,3578761221,45
0,1478,59470,3578761176,3578761221,45
0,1478,59471,3578761176,3578761221,45
0,1478,59472,3578761176,3578761223,47
0,1478,59473,3578761176,3578761224,48
0,1478,59474,3578761176,3578761224,48
0,1478,59475,3578761176,3578761224,48
0,1478,59476,3578761176,3578761224,48
0,1478,59477,3578761176,3578761224,48
0,1479,59478,3578761240,3578761240,0
0,1479,59479,3578761240,3578761240,0
0,1479,59480,3578761240,3578761240,0
0,1479,59481,3578761240,3578761240,0
0,1479,59482,3578761240,3578761240,0
0,1479,59483,3578761240,3578761240,0
0,1479,59484,3578761240,3578761240,0
0,1479,59485,3578761240,3578761240,0
0,1479,59486,3578761240,3578761240,0
0,1479,59487,3578761240,3578761240,0
0,1479,59488,3578761240,3578761240,0
0,1479,59489,3578761240,3578761240,0
0,1479,59490,3578761240,3578761240,0
0,1479,59491,3578761240,3578761240,0
0,1479,59492,3578761240,3578761240,0
0,1479,59493,3578761240,3578761240,0
0,1479,59494,3578761240,3578761240,0
0,1479,59495,3578761240,3578761240,0
0,1479,59496,3578761240,3578761240,0
0,1479,59497,3578761240,3578761240,0
0,1479,59498,3578761240,3578761240,0
0,1479,59499,3578761240,3578761240,0
0,1479,59500,3578761240,3578761240,0
0,1479,59501,3578761240,3578761241,1
0,1479,59502,3578761240,3578761242,2
0,1479,59503,3578761240,3578761243,3
0,1479,59504,3578761240,3578761243,3
0,1479,59505,3578761240,3578761243,3
0,1479,59506,3578761240,3578761244,4
0,1479,59507,3578761240,3578761244,4
0,1479,59508,3578761240,3578761245,5
0,1479,59509,3578761240,3578761246,6
0,1479,59510,3578761240,3578761247,7
0,1479,59511,3578761240,3578761247,7
0,1479,59512,3578761240,3578761247,7
0,1479,59513,3578761240,3578761248,8
0,1479,59514,3578761240,3578761248,8
0,1479,59515,3578761240,3578761249,9
0,1479,59516,3578761240,3578761250,10
0,1479,59517,3578761240,3578761250,10
0,1479,59518,3578761240,3578761251,11
0,1479,59519,3578761240,3578761253,13
0,1479,59520,3578761240,3578761256,16
0,1479,59521,3578761240,3578761256,16
0,1479,59522,3578761240,3578761256,16
0,1479,59523,3578761240,3578761258,18
0,1479,59524,3578761240,3578761258,18
0,1479,59525,3578761240,3578761259,19
0,1479,59526,3578761240,3578761259,19
0,1479,59527,3578761240,3578761259,19
0,1479,59528,3578761240,3578761259,19
0,1479,59529,3578761240,3578761261,21
0,1479,59530,3578761240,3578761262,22
0,1479,59531,3578761240,3578761262,22
0,1479,59532,3578761240,3578761264,24
0,1479,59533,3578761240,3578761264,24
0,1479,59534,3578761240,3578761265,25
0,1479,59535,3578761240,3578761265,25
0,1479,59536,3578761240,3578761265,25
0,1479,59537,3578761240,3578761267,27
0,1479,59538,3578761240,3578761267,27
0,1479,59539,3578761240,3578761268,28
0,1479,59540,3578761240,3578761268,28
0,1479,59541,3578761240,3578761270,30
0,1479,59542,3578761240,3578761271,31
0,1479,59543,3578761240,3578761282,42
0,1479,59544,3578761240,3578761282,42
0,1479,59545,3578761240,3578761283,43
0,1479,59546,3578761240,3578761286,46
0,1479,59547,3578761240,3578761287,47
0,1479,59548,3578761240,3578761288,48
0,1479,59549,3578761240,3578761288,48
0,1479,59550,3578761240,3578761289,49
0,1479,59551,3578761240,3578761289,49
0,1479,59552,3578761240,3578761289,49
0,1479,59553,3578761240,3578761290,50
0,1480,59554,3578761303,3578761303,0
0,1480,59555,3578761303,3578761303,0
0,1480,59556,3578761303,3578761303,0
0,1480,59557,3578761303,3578761303,0
0,1480,59558,3578761303,3578761303,0
0,1480,59559,3578761303,3578761303,0
0,1480,59560,3578761303,3578761303,0
0,1480,59561,3578761303,3578761303,0
0,1480,59562,3578761303,3578761303,0
0,1480,59563,3578761303,3578761303,0
0,1480,59564,3578761303,3578761303,0
0,1480,59565,3578761303,3578761303,0
0,1480,59566,3578761303,3578761303,0
0,1480,59567,3578761303,3578761303,0
0,1480,59568,3578761303,3578761303,0
0,1480,59569,3578761303,3578761303,0
0,1480,59570,3578761303,3578761303,0
0,1480,59571,3578761303,3578761303,0
0,1480,59572,3578761303,3578761303,0
0,1480,59573,3578761303,3578761303,0
0,1480,59574,3578761303,3578761304,1
0,1480,59575,3578761303,3578761305,2
0,1480,59576,3578761303,3578761305,2
0,1480,59577,3578761303,3578761305,2
0,1480,59578,3578761303,3578761306,3
0,1480,59579,3578761303,3578761306,3
0,1480,59580,3578761303,3578761308,5
0,1480,59581,3578761303,3578761308,5
0,1480,59582,3578761303,3578761308,5
0,1480,59583,3578761303,3578761308,5
0,1480,59584,3578761303,3578761308,5
0,1480,59585,3578761303,3578761308,5
0,1480,59586,3578761303,3578761309,6
0,1480,59587,3578761303,3578761309,6
0,1480,59588,3578761303,3578761309,6
0,1480,59589,3578761303,3578761309,6
0,1480,59590,3578761303,3578761309,6
0,1480,59591,3578761303,3578761310,7
0,1480,59592,3578761303,3578761311,8
0,1480,59593,3578761303,3578761311,8
0,1480,59594,3578761303,3578761311,8
0,1480,59595,3578761303,3578761311,8
0,1480,59596,3578761303,3578761312,9
0,1480,59597,3578761303,3578761313,10
0,1480,59598,3578761303,3578761314,11
0,1480,59599,3578761303,3578761315,12
0,1480,59600,3578761303,3578761315,12
0,1480,59601,3578761303,3578761315,12
0,1480,59602,3578761303,3578761315,12
0,1480,59603,3578761303,3578761316,13
0,1480,59604,3578761303,3578761316,13
0,1480,59605,3578761303,3578761316,13
0,1480,59606,3578761303,3578761317,14
0,1480,59607,3578761303,3578761317,14
0,1480,59608,3578761303,3578761317,14
0,1480,59609,3578761303,3578761317,14
0,1480,59610,3578761303,3578761317,14
0,1480,59611,3578761303,3578761317,14
0,1480,59612,3578761303,3578761318,15
0,1480,59613,3578761303,3578761319,16
0,1480,59614,3578761303,3578761319,16
0,1480,59615,3578761303,3578761319,16
0,1480,59616,3578761303,3578761319,16
0,1480,59617,3578761303,3578761319,16
0,1480,59618,3578761303,3578761323,20
0,1480,59619,3578761303,3578761323,20
0,1480,59620,3578761303,3578761323,20
0,1480,59621,3578761303,3578761326,23
0,1480,59622,3578761303,3578761326,23
0,1480,59623,3578761303,3578761326,23
0,1480,59624,3578761303,3578761327,24
0,1480,59625,3578761303,3578761327,24
0,1480,59626,3578761303,3578761328,25
0,1480,59627,3578761303,3578761328,25
0,1480,59628,3578761303,3578761328,25
0,1480,59629,3578761303,3578761329,26
0,1480,59630,3578761303,3578761329,26
0,1480,59631,3578761303,3578761329,26
0,1480,59632,3578761303,3578761329,26
0,1480,59633,3578761303,3578761330,27
0,1480,59634,3578761303,3578761330,27
0,1480,59635,3578761303,3578761330,27
0,1480,59636,3578761303,3578761330,27
0,1480,59637,3578761303,3578761331,28
0,1480,59638,3578761303,3578761331,28
0,1480,59639,3578761303,3578761332,29
0,1480,59640,3578761303,3578761332,29
0,1480,59641,3578761303,3578761332,29
0,1480,59642,3578761303,3578761332,29
0,1480,59643,3578761303,3578761333,30
0,1480,59644,3578761303,3578761333,30
0,1480,59645,3578761303,3578761333,30
0,1480,59646,3578761303,3578761334,31
0,1480,59647,3578761303,3578761334,31
0,1480,59648,3578761303,3578761335,32
0,1480,59649,3578761303,3578761335,32
0,1480,59650,3578761303,3578761336,33
0,1480,59651,3578761303,3578761336,33
0,1480,59652,3578761303,3578761337,34
0,1480,59653,3578761303,3578761338,35
0,1480,59654,3578761303,3578761339,36
0,1480,59655,3578761303,3578761339,36
0,1480,59656,3578761303,3578761340,37
0,1480,59657,3578761303,3578761340,37
0,1480,59658,3578761303,3578761341,38
0,1480,59659,3578761303,3578761342,39
0,1480,59660,3578761303,3578761343,40
0,1480,59661,3578761303,3578761343,40
0,1480,59662,3578761303,3578761344,41
0,1480,59663,3578761303,3578761344,41
0,1480,59664,3578761303,3578761346,43
0,1480,59665,3578761303,3578761346,43
0,1480,59666,3578761303,3578761346,43
0,1480,59667,3578761303,3578761347,44
0,1480,59668,3578761303,3578761347,44
0,1480,59669,3578761303,3578761350,47
0,1480,59670,3578761303,3578761351,48
0,1480,59671,3578761303,3578761352,49
0,1480,59672,3578761303,3578761352,49
0,1480,59673,3578761303,3578761352,49
0,1480,59674,3578761303,3578761352,49
0,1480,59675,3578761303,3578761353,50
0,1481,59676,3578761368,3578761368,0
0,1481,59677,3578761368,3578761368,0
0,1481,59678,3578761368,3578761368,0
0,1481,59679,3578761368,3578761368,0
0,1481,59680,3578761368,3578761368,0
0,1481,59681,3578761368,3578761368,0
0,1481,59682,3578761368,3578761368,0
0,1481,59683,3578761368,3578761368,0
0,1481,59684,3578761368,3578761368,0
0,1481,59685,3578761368,3578761368,0
0,1481,59686,3578761368,3578761368,0
0,1481,59687,3578761368,3578761368,0
0,1481,59688,3578761368,3578761368,0
0,1481,59689,3578761368,3578761368,0
0,1481,59690,3578761368,3578761368,0
0,1481,59691,3578761368,3578761368,0
0,1481,59692,3578761368,3578761368,0
0,1481,59693,3578761368,3578761368,0
0,1481,59694,3578761368,3578761368,0
0,1481,59695,3578761368,3578761368,0
0,1481,59696,3578761368,3578761368,0
0,1481,59697,3578761368,3578761368,0
0,1481,59698,3578761368,3578761368,0
0,1481,59699,3578761368,3578761368,0
0,1481,59700,3578761368,3578761368,0
0,1481,59701,3578761368,3578761368,0
0,1481,59702,3578761368,3578761369,1
0,1481,59703,3578761368,3578761370,2
0,1481,59704,3578761368,3578761370,2
0,1481,59705,3578761368,3578761371,3
0,1481,59706,3578761368,3578761372,4
0,1481,59707,3578761368,3578761372,4
0,1481,59708,3578761368,3578761373,5
0,1481,59709,3578761368,3578761374,6
0,1481,59710,3578761368,3578761374,6
0,1481,59711,3578761368,3578761374,6
0,1481,59712,3578761368,3578761374,6
0,1481,59713,3578761368,3578761375,7
0,1481,59714,3578761368,3578761376,8
0,1481,59715,3578761368,3578761378,10
0,1481,59716,3578761368,3578761379,11
0,1481,59717,3578761368,3578761379,11
0,1481,59718,3578761368,3578761379,11
0,1481,59719,3578761368,3578761379,11
0,1481,59720,3578761368,3578761380,12
0,1481,59721,3578761368,3578761381,13
0,1481,59722,3578761368,3578761382,14
0,1481,59723,3578761368,3578761383,15
0,1481,59724,3578761368,3578761383,15
0,1481,59725,3578761368,3578761385,17
0,1481,59726,3578761368,3578761385,17
0,1481,59727,3578761368,3578761386,18
0,1481,59728,3578761368,3578761386,18
0,1481,59729,3578761368,3578761386,18
0,1481,59730,3578761368,3578761389,21
0,1481,59731,3578761368,3578761389,21
0,1481,59732,3578761368,3578761389,21
0,1481,59733,3578761368,3578761390,22
0,1481,59734,3578761368,3578761391,23
0,1481,59735,3578761368,3578761392,24
0,1481,59736,3578761368,3578761392,24
0,1481,59737,3578761368,3578761393,25
0,1481,59738,3578761368,3578761393,25
0,1481,59739,3578761368,3578761394,26
0,1481,59740,3578761368,3578761395,27
0,1481,59741,3578761368,3578761398,30
0,1481,59742,3578761368,3578761398,30
0,1481,59743,3578761368,3578761398,30
0,1481,59744,3578761368,3578761398,30
0,1481,59745,3578761368,3578761399,31
0,1481,59746,3578761368,3578761399,31
0,1481,59747,3578761368,3578761400,32
0,1481,59748,3578761368,3578761401,33
0,1481,59749,3578761368,3578761401,33
0,1481,59750,3578761368,3578761403,35
0,1481,59751,3578761368,3578761404,36
0,1481,59752,3578761368,3578761404,36
0,1481,59753,3578761368,3578761404,36
0,1481,59754,3578761368,3578761404,36
0,1481,59755,3578761368,3578761406,38
0,1481,59756,3578761368,3578761406,38
0,1481,59757,3578761368,3578761407,39
0,1481,59758,3578761368,3578761407,39
0,1481,59759,3578761368,3578761408,40
0,1481,59760,3578761368,3578761411,43
0,1481,59761,3578761368,3578761412,44
0,1481,59762,3578761368,3578761413,45
0,1481,59763,3578761368,3578761413,45
0,1481,59764,3578761368,3578761413,45
0,1481,59765,3578761368,3578761415,47
0,1481,59766,3578761368,3578761415,47
0,1481,59767,3578761368,3578761415,47
0,1481,59768,3578761368,3578761415,47
0,1481,59769,3578761368,3578761416,48
0,1481,59770,3578761368,3578761416,48
0,1481,59771,3578761368,3578761416,48
0,1481,59772,3578761368,3578761417,49
0,1482,59773,3578761432,3578761432,0
0,1482,59774,3578761432,3578761432,0
0,1482,59775,3578761432,3578761432,0
0,1482,59776,3578761432,3578761432,0
0,1482,59777,3578761432,3578761432,0
0,1482,59778,3578761432,3578761433,1
0,1482,59779,3578761432,3578761433,1
0,1482,59780,3578761432,3578761433,1
0,1482,59781,3578761432,3578761433,1
0,1482,59782,3578761432,3578761433,1
0,1482,59783,3578761432,3578761433,1
0,1482,59784,3578761432,3578761433,1
0,1482,59785,3578761432,3578761433,1
0,1482,59786,3578761432,3578761433,1
0,1482,59787,3578761432,3578761433,1
0,1482,59788,3578761432,3578761433,1
0,1482,59789,3578761432,3578761433,1
0,1482,59790,3578761432,3578761433,1
0,1482,59791,3578761432,3578761433,1
0,1482,59792,3578761432,3578761433,1
0,1482,59793,3578761432,3578761433,1
0,1482,59794,3578761432,3578761433,1
0,1482,59795,3578761432,3578761433,1
0,1482,59796,3578761432,3578761433,1
0,1482,59797,3578761432,3578761434,2
0,1482,59798,3578761432,3578761434,2
0,1482,59799,3578761432,3578761434,2
0,1482,59800,3578761432,3578761437,5
0,1482,59801,3578761432,3578761437,5
0,1482,59802,3578761432,3578761439,7
0,1482,59803,3578761432,3578761439,7
0,1482,59804,3578761432,3578761439,7
0,1482,59805,3578761432,3578761439,7
0,1482,59806,3578761432,3578761440,8
0,1482,59807,3578761432,3578761440,8
0,1482,59808,3578761432,3578761440,8
0,1482,59809,3578761432,3578761441,9
0,1482,59810,3578761432,3578761441,9
0,1482,59811,3578761432,3578761442,10
0,1482,59812,3578761432,3578761442,10
0,1482,59813,3578761432,3578761443,11
0,1482,59814,3578761432,3578761444,12
0,1482,59815,3578761432,3578761444,12
0,1482,59816,3578761432,3578761446,14
0,1482,59817,3578761432,3578761447,15
0,1482,59818,3578761432,3578761447,15
0,1482,59819,3578761432,3578761448,16
0,1482,59820,3578761432,3578761448,16
0,1482,59821,3578761432,3578761448,16
0,1482,59822,3578761432,3578761448,16
0,1482,59823,3578761432,3578761449,17
0,1482,59824,3578761432,3578761449,17
0,1482,59825,3578761432,3578761450,18
0,1482,59826,3578761432,3578761450,18
0,1482,59827,3578761432,3578761451,19
0,1482,59828,3578761432,3578761452,20
0,1482,59829,3578761432,3578761453,21
0,1482,59830,3578761432,3578761456,24
0,1482,59831,3578761432,3578761456,24
0,1482,59832,3578761432,3578761457,25
0,1482,59833,3578761432,3578761458,26
0,1482,59834,3578761432,3578761458,26
0,1482,59835,3578761432,3578761459,27
0,1482,59836,3578761432,3578761459,27
0,1482,59837,3578761432,3578761459,27
0,1482,59838,3578761432,3578761460,28
0,1482,59839,3578761432,3578761461,29
0,1482,59840,3578761432,3578761461,29
0,1482,59841,3578761432,3578761462,30
0,1482,59842,3578761432,3578761463,31
0,1482,59843,3578761432,3578761464,32
0,1482,59844,3578761432,3578761464,32
0,1482,59845,3578761432,3578761465,33
0,1482,59846,3578761432,3578761465,33
0,1482,59847,3578761432,3578761465,33
0,1482,59848,3578761432,3578761466,34
0,1482,59849,3578761432,3578761466,34
0,1482,59850,3578761432,3578761467,35
0,1482,59851,3578761432,3578761468,36
0,1482,59852,3578761432,3578761469,37
0,1483,59853,3578761496,3578761496,0
0,1483,59854,3578761496,3578761496,0
0,1483,59855,3578761496,3578761496,0
0,1483,59856,3578761496,3578761496,0
0,1483,59857,3578761496,3578761496,0
0,1483,59858,3578761496,3578761496,0
0,1483,59859,3578761496,3578761496,0
0,1483,59860,3578761496,3578761496,0
0,1483,59861,3578761496,3578761496,0
0,1483,59862,3578761496,3578761496,0
0,1483,59863,3578761496,3578761496,0
0,1483,59864,3578761496,3578761496,0
0,1483,59865,3578761496,3578761496,0
0,1483,59866,3578761496,3578761496,0
0,1483,59867,3578761496,3578761496,0
0,1483,59868,3578761496,3578761496,0
0,1483,59869,3578761496,3578761496,0
0,1483,59870,3578761496,3578761496,0
0,1483,59871,3578761496,3578761496,0
0,1483,59872,3578761496,3578761496,0
0,1483,59873,3578761496,3578761496,0
0,1483,59874,3578761496,3578761496,0
0,1483,59875,3578761496,3578761496,0
0,1483,59876,3578761496,3578761496,0
0,1483,59877,3578761496,3578761498,2
0,1483,59878,3578761496,3578761498,2
0,1483,59879,3578761496,3578761499,3
0,1483,59880,3578761496,3578761499,3
0,1483,59881,3578761496,3578761500,4
0,1483,59882,3578761496,3578761501,5
0,1483,59883,3578761496,3578761503,7
0,1483,59884,3578761496,3578761504,8
0,1483,59885,3578761496,3578761505,9
0,1483,59886,3578761496,3578761505,9
0,1483,59887,3578761496,3578761505,9
0,1483,59888,3578761496,3578761507,11
0,1483,59889,3578761496,3578761507,11
0,1483,59890,3578761496,3578761507,11
0,1483,59891,3578761496,3578761507,11
0,1483,59892,3578761496,3578761507,11
0,1483,59893,3578761496,3578761507,11
0,1483,59894,3578761496,3578761508,12
0,1483,59895,3578761496,3578761508,12
0,1483,59896,3578761496,3578761508,12
0,1483,59897,3578761496,3578761508,12
0,1483,59898,3578761496,3578761509,13
0,1483,59899,3578761496,3578761510,14
0,1483,59900,3578761496,3578761510,14
0,1483,59901,3578761496,3578761510,14
0,1483,59902,3578761496,3578761511,15
0,1483,59903,3578761496,3578761513,17
0,1483,59904,3578761496,3578761513,17
0,1483,59905,3578761496,3578761514,18
0,1483,59906,3578761496,3578761515,19
0,1483,59907,3578761496,3578761515,19
0,1483,59908,3578761496,3578761515,19
0,1483,59909,3578761496,3578761515,19
0,1483,59910,3578761496,3578761516,20
0,1483,59911,3578761496,3578761516,20
0,1483,59912,3578761496,3578761516,20
0,1483,59913,3578761496,3578761516,20
0,1483,59914,3578761496,3578761516,20
0,1483,59915,3578761496,3578761517,21
0,1483,59916,3578761496,3578761518,22
0,1483,59917,3578761496,3578761518,22
0,1483,59918,3578761496,3578761518,22
0,1483,59919,3578761496,3578761522,26
0,1483,59920,3578761496,3578761522,26
0,1483,59921,3578761496,3578761522,26
0,1483,59922,3578761496,3578761522,26
0,1483,59923,3578761496,3578761525,29
0,1483,59924,3578761496,3578761525,29
0,1483,59925,3578761496,3578761525,29
0,1483,59926,3578761496,3578761525,29
0,1483,59927,3578761496,3578761527,31
0,1483,59928,3578761496,3578761527,31
0,1483,59929,3578761496,3578761527,31
0,1483,59930,3578761496,3578761528,32
0,1483,59931,3578761496,3578761528,32
0,1483,59932,3578761496,3578761528,32
0,1483,59933,3578761496,3578761528,32
0,1483,59934,3578761496,3578761528,32
0,1483,59935,3578761496,3578761528,32
0,1483,59936,3578761496,3578761529,33
0,1483,59937,3578761496,3578761529,33
0,1483,59938,3578761496,3578761529,33
0,1483,59939,3578761496,3578761530,34
0,1483,59940,3578761496,3578761530,34
0,1483,59941,3578761496,3578761531,35
0,1483,59942,3578761496,3578761532,36
0,1483,59943,3578761496,3578761532,36
0,1483,59944,3578761496,3578761532,36
0,1483,59945,3578761496,3578761532,36
0,1483,59946,3578761496,3578761533,37
0,1483,59947,3578761496,3578761533,37
0,1483,59948,3578761496,3578761533,37
0,1483,59949,3578761496,3578761534,38
0,1483,59950,3578761496,3578761534,38
0,1483,59951,3578761496,3578761535,39
0,1483,59952,3578761496,3578761536,40
0,1483,59953,3578761496,3578761537,41
0,1483,59954,3578761496,3578761537,41
0,1483,59955,3578761496,3578761538,42
0,1483,59956,3578761496,3578761539,43
0,1483,59957,3578761496,3578761539,43
0,1483,59958,3578761496,3578761539,43
0,1483,59959,3578761496,3578761540,44
0,1483,59960,3578761496,3578761542,46
0,1483,59961,3578761496,3578761543,47
0,1483,59962,3578761496,3578761544,48
0,1483,59963,3578761496,3578761544,48
0,1483,59964,3578761496,3578761544,48
0,1483,59965,3578761496,3578761545,49
0,1483,59966,3578761496,3578761545,49
0,1483,59967,3578761496,3578761545,49
0,1484,59968,3578761560,3578761560,0
0,1484,59969,3578761560,3578761560,0
0,1484,59970,3578761560,3578761560,0
0,1484,59971,3578761560,3578761560,0
0,1484,59972,3578761560,3578761560,0
0,1484,59973,3578761560,3578761560,0
0,1484,59974,3578761560,3578761560,0
0,1484,59975,3578761560,3578761560,0
0,1484,59976,3578761560,3578761560,0
0,1484,59977,3578761560,3578761560,0
0,1484,59978,3578761560,3578761560,0
0,1484,59979,3578761560,3578761560,0
0,1484,59980,3578761560,3578761560,0
0,1484,59981,3578761560,3578761560,0
0,1484,59982,3578761560,3578761560,0
0,1484,59983,3578761560,3578761560,0
0,1484,59984,3578761560,3578761560,0
0,1484,59985,3578761560,3578761560,0
0,1484,59986,3578761560,3578761560,0
0,1484,59987,3578761560,3578761560,0
0,1484,59988,3578761560,3578761560,0
0,1484,59989,3578761560,3578761560,0
0,1484,59990,3578761560,3578761560,0
0,1484,59991,3578761560,3578761560,0
0,1484,59992,3578761560,3578761560,0
0,1484,59993,3578761560,3578761560,0
0,1484,59994,3578761560,3578761560,0
0,1484,59995,3578761560,3578761560,0
0,1484,59996,3578761560,3578761561,1
0,1484,59997,3578761560,3578761561,1
0,1484,59998,3578761560,3578761561,1
0,1484,59999,3578761560,3578761562,2
0,1484,60000,3578761560,3578761562,2
0,1484,60001,3578761560,3578761564,4
0,1484,60002,3578761560,3578761564,4
0,1484,60003,3578761560,3578761564,4
0,1484,60004,3578761560,3578761564,4
0,1484,60005,3578761560,3578761567,7
0,1484,60006,3578761560,3578761568,8
0,1484,60007,3578761560,3578761569,9
0,1484,60008,3578761560,3578761569,9
0,1484,60009,3578761560,3578761569,9
0,1484,60010,3578761560,3578761569,9
0,1484,60011,3578761560,3578761571,11
0,1484,60012,3578761560,3578761571,11
0,1484,60013,3578761560,3578761572,12
0,1484,60014,3578761560,3578761572,12
0,1484,60015,3578761560,3578761573,13
0,1484,60016,3578761560,3578761573,13
0,1484,60017,3578761560,3578761574,14
0,1484,60018,3578761560,3578761575,15
0,1484,60019,3578761560,3578761575,15
0,1484,60020,3578761560,3578761576,16
0,1484,60021,3578761560,3578761577,17
0,1484,60022,3578761560,3578761578,18
0,1484,60023,3578761560,3578761578,18
0,1484,60024,3578761560,3578761578,18
0,1484,60025,3578761560,3578761578,18
0,1484,60026,3578761560,3578761579,19
0,1484,60027,3578761560,3578761579,19
0,1484,60028,3578761560,3578761581,21
0,1484,60029,3578761560,3578761583,23
0,1484,60030,3578761560,3578761583,23
0,1484,60031,3578761560,3578761584,24
0,1484,60032,3578761560,3578761585,25
0,1484,60033,3578761560,3578761585,25
0,1484,60034,3578761560,3578761586,26
0,1484,60035,3578761560,3578761587,27
0,1484,60036,3578761560,3578761587,27
0,1484,60037,3578761560,3578761587,27
0,1484,60038,3578761560,3578761589,29
0,1484,60039,3578761560,3578761590,30
0,1484,60040,3578761560,3578761591,31
0,1484,60041,3578761560,3578761591,31
0,1484,60042,3578761560,3578761593,33
0,1484,60043,3578761560,3578761593,33
0,1484,60044,3578761560,3578761593,33
0,1484,60045,3578761560,3578761597,37
0,1484,60046,3578761560,3578761597,37
0,1484,60047,3578761560,3578761597,37
0,1484,60048,3578761560,3578761597,37
0,1484,60049,3578761560,3578761598,38
0,1484,60050,3578761560,3578761599,39
0,1484,60051,3578761560,3578761599,39
0,1484,60052,3578761560,3578761600,40
0,1484,60053,3578761560,3578761603,43
0,1484,60054,3578761560,3578761603,43
0,1484,60055,3578761560,3578761603,43
0,1484,60056,3578761560,3578761603,43
0,1484,60057,3578761560,3578761604,44
0,1484,60058,3578761560,3578761605,45
0,1484,60059,3578761560,3578761605,45
0,1484,60060,3578761560,3578761606,46
0,1484,60061,3578761560,3578761607,47
0,1484,60062,3578761560,3578761607,47
0,1484,60063,3578761560,3578761609,49
0,1484,60064,3578761560,3578761609,49
0,1485,60065,3578761625,3578761625,0
0,1485,60066,3578761625,3578761625,0
0,1485,60067,3578761625,3578761625,0
0,1485,60068,3578761625,3578761625,0
0,1485,60069,3578761625,3578761625,0
0,1485,60070,3578761625,3578761625,0
0,1485,60071,3578761625,3578761625,0
0,1485,60072,3578761625,3578761625,0
0,1485,60073,3578761625,3578761625,0
0,1485,60074,3578761625,3578761625,0
0,1485,60075,3578761625,3578761625,0
0,1485,60076,3578761625,3578761625,0
0,1485,60077,3578761625,3578761625,0
0,1485,60078,3578761625,3578761625,0
0,1485,60079,3578761625,3578761625,0
0,1485,60080,3578761625,3578761625,0
0,1485,60081,3578761625,3578761625,0
0,1485,60082,3578761625,3578761625,0
0,1485,60083,3578761625,3578761625,0
0,1485,60084,3578761625,3578761625,0
0,1485,60085,3578761625,3578761625,0
0,1485,60086,3578761625,3578761625,0
0,1485,60087,3578761625,3578761625,0
0,1485,60088,3578761625,3578761626,1
0,1485,60089,3578761625,3578761627,2
0,1485,60090,3578761625,3578761627,2
0,1485,60091,3578761625,3578761627,2
0,1485,60092,3578761625,3578761629,4
0,1485,60093,3578761625,3578761629,4
0,1485,60094,3578761625,3578761630,5
0,1485,60095,3578761625,3578761631,6
0,1485,60096,3578761625,3578761631,6
0,1485,60097,3578761625,3578761631,6
0,1485,60098,3578761625,3578761633,8
0,1485,60099,3578761625,3578761633,8
0,1485,60100,3578761625,3578761633,8
0,1485,60101,3578761625,3578761634,9
0,1485,60102,3578761625,3578761636,11
0,1485,60103,3578761625,3578761636,11
0,1485,60104,3578761625,3578761637,12
0,1485,60105,3578761625,3578761637,12
0,1485,60106,3578761625,3578761638,13
0,1485,60107,3578761625,3578761639,14
0,1485,60108,3578761625,3578761639,14
0,1485,60109,3578761625,3578761639,14
0,1485,60110,3578761625,3578761639,14
0,1485,60111,3578761625,3578761640,15
0,1485,60112,3578761625,3578761640,15
0,1485,60113,3578761625,3578761641,16
0,1485,60114,3578761625,3578761641,16
0,1485,60115,3578761625,3578761642,17
0,1485,60116,3578761625,3578761643,18
0,1485,60117,3578761625,3578761644,19
0,1485,60118,3578761625,3578761645,20
0,1485,60119,3578761625,3578761646,21
0,1485,60120,3578761625,3578761646,21
0,1485,60121,3578761625,3578761647,22
0,1485,60122,3578761625,3578761647,22
0,1485,60123,3578761625,3578761647,22
0,1485,60124,3578761625,3578761648,23
0,1485,60125,3578761625,3578761648,23
0,1485,60126,3578761625,3578761649,24
0,1485,60127,3578761625,3578761649,24
0,1485,60128,3578761625,3578761649,24
0,1485,60129,3578761625,3578761650,25
0,1485,60130,3578761625,3578761651,26
0,1485,60131,3578761625,3578761652,27
0,1485,60132,3578761625,3578761655,30
0,1485,60133,3578761625,3578761656,31
0,1485,60134,3578761625,3578761657,32
0,1485,60135,3578761625,3578761658,33
0,1485,60136,3578761625,3578761658,33
0,1485,60137,3578761625,3578761659,34
0,1485,60138,3578761625,3578761659,34
0,1485,60139,3578761625,3578761659,34
0,1485,60140,3578761625,3578761660,35
0,1485,60141,3578761625,3578761661,36
0,1485,60142,3578761625,3578761661,36
0,1485,60143,3578761625,3578761663,38
0,1485,60144,3578761625,3578761663,38
0,1485,60145,3578761625,3578761664,39
0,1485,60146,3578761625,3578761664,39
0,1485,60147,3578761625,3578761664,39
0,1485,60148,3578761625,3578761664,39
0,1485,60149,3578761625,3578761665,40
0,1485,60150,3578761625,3578761666,41
0,1485,60151,3578761625,3578761666,41
0,1485,60152,3578761625,3578761667,42
0,1485,60153,3578761625,3578761667,42
0,1485,60154,3578761625,3578761667,42
0,1485,60155,3578761625,3578761670,45
0,1486,60156,3578761688,3578761688,0
0,1486,60157,3578761688,3578761688,0
0,1486,60158,3578761688,3578761688,0
0,1486,60159,3578761688,3578761688,0
0,1486,60160,3578761688,3578761688,0
0,1486,60161,3578761688,3578761688,0
0,1486,60162,3578761688,3578761688,0
0,1486,60163,3578761688,3578761688,0
0,1486,60164,3578761688,3578761689,1
0,1486,60165,3578761688,3578761689,1
0,1486,60166,3578761688,3578761689,1
0,1486,60167,3578761688,3578761690,2
0,1486,60168,3578761688,3578761690,2
0,1486,60169,3578761688,3578761691,3
0,1486,60170,3578761688,3578761692,4
0,1486,60171,3578761688,3578761692,4
0,1486,60172,3578761688,3578761692,4
0,1486,60173,3578761688,3578761693,5
0,1486,60174,3578761688,3578761693,5
0,1486,60175,3578761688,3578761694,6
0,1486,60176,3578761688,3578761694,6
0,1486,60177,3578761688,3578761694,6
0,1486,60178,3578761688,3578761694,6
0,1486,60179,3578761688,3578761696,8
0,1486,60180,3578761688,3578761698,10
0,1486,60181,3578761688,3578761698,10
0,1486,60182,3578761688,3578761698,10
0,1486,60183,3578761688,3578761699,11
0,1486,60184,3578761688,3578761699,11
0,1486,60185,3578761688,3578761699,11
0,1486,60186,3578761688,3578761702,14
0,1486,60187,3578761688,3578761703,15
0,1486,60188,3578761688,3578761704,16
0,1486,60189,3578761688,3578761705,17
0,1486,60190,3578761688,3578761705,17
0,1486,60191,3578761688,3578761705,17
0,1486,60192,3578761688,3578761706,18
0,1486,60193,3578761688,3578761707,19
0,1486,60194,3578761688,3578761707,19
0,1486,60195,3578761688,3578761707,19
0,1486,60196,3578761688,3578761707,19
0,1486,60197,3578761688,3578761707,19
0,1486,60198,3578761688,3578761708,20
0,1486,60199,3578761688,3578761708,20
0,1486,60200,3578761688,3578761708,20
0,1486,60201,3578761688,3578761708,20
0,1486,60202,3578761688,3578761709,21
0,1486,60203,3578761688,3578761709,21
0,1486,60204,3578761688,3578761710,22
0,1486,60205,3578761688,3578761710,22
0,1486,60206,3578761688,3578761710,22
0,1486,60207,3578761688,3578761711,23
0,1486,60208,3578761688,3578761712,24
0,1486,60209,3578761688,3578761712,24
0,1486,60210,3578761688,3578761713,25
0,1486,60211,3578761688,3578761714,26
0,1486,60212,3578761688,3578761715,27
0,1486,60213,3578761688,3578761715,27
0,1486,60214,3578761688,3578761715,27
0,1486,60215,3578761688,3578761715,27
0,1486,60216,3578761688,3578761715,27
0,1486,60217,3578761688,3578761716,28
0,1486,60218,3578761688,3578761716,28
0,1486,60219,3578761688,3578761716,28
0,1486,60220,3578761688,3578761716,28
0,1486,60221,3578761688,3578761717,29
0,1486,60222,3578761688,3578761717,29
0,1486,60223,3578761688,3578761718,30
0,1486,60224,3578761688,3578761718,30
0,1486,60225,3578761688,3578761718,30
0,1486,60226,3578761688,3578761718,30
0,1486,60227,3578761688,3578761719,31
0,1486,60228,3578761688,3578761719,31
0,1486,60229,3578761688,3578761721,33
0,1486,60230,3578761688,3578761722,34
0,1486,60231,3578761688,3578761722,34
0,1486,60232,3578761688,3578761725,37
0,1486,60233,3578761688,3578761725,37
0,1486,60234,3578761688,3578761725,37
0,1486,60235,3578761688,3578761725,37
0,1486,60236,3578761688,3578761725,37
0,1486,60237,3578761688,3578761727,39
0,1486,60238,3578761688,3578761727,39
0,1486,60239,3578761688,3578761727,39
0,1486,60240,3578761688,3578761728,40
0,1486,60241,3578761688,3578761728,40
0,1486,60242,3578761688,3578761728,40
0,1486,60243,3578761688,3578761728,40
0,1486,60244,3578761688,3578761728,40
0,1486,60245,3578761688,3578761728,40
0,1486,60246,3578761688,3578761729,41
0,1486,60247,3578761688,3578761729,41
0,1486,60248,3578761688,3578761729,41
0,1486,60249,3578761688,3578761730,42
0,1486,60250,3578761688,3578761730,42
0,1486,60251,3578761688,3578761730,42
0,1486,60252,3578761688,3578761731,43
0,1486,60253,3578761688,3578761731,43
0,1486,60254,3578761688,3578761731,43
0,1486,60255,3578761688,3578761731,43
0,1486,60256,3578761688,3578761732,44
0,1486,60257,3578761688,3578761732,44
0,1486,60258,3578761688,3578761732,44
0,1486,60259,3578761688,3578761734,46
0,1486,60260,3578761688,3578761735,47
0,1486,60261,3578761688,3578761736,48
0,1486,60262,3578761688,3578761736,48
0,1486,60263,3578761688,3578761736,48
0,1486,60264,3578761688,3578761736,48
0,1486,60265,3578761688,3578761737,49
0,1487,60266,3578761753,3578761753,0
0,1487,60267,3578761753,3578761753,0
0,1487,60268,3578761753,3578761753,0
0,1487,60269,3578761753,3578761753,0
0,1487,60270,3578761753,3578761753,0
0,1487,60271,3578761753,3578761753,0
0,1487,60272,3578761753,3578761753,0
0,1487,60273,3578761753,3578761753,0
0,1487,60274,3578761753,3578761753,0
0,1487,60275,3578761753,3578761753,0
0,1487,60276,3578761753,3578761753,0
0,1487,60277,3578761753,3578761753,0
0,1487,60278,3578761753,3578761753,0
0,1487,60279,3578761753,3578761753,0
0,1487,60280,3578761753,3578761753,0
0,1487,60281,3578761753,3578761753,0
0,1487,60282,3578761753,3578761753,0
0,1487,60283,3578761753,3578761753,0
0,1487,60284,3578761753,3578761753,0
0,1487,60285,3578761753,3578761753,0
0,1487,60286,3578761753,3578761753,0
0,1487,60287,3578761753,3578761753,0
0,1487,60288,3578761753,3578761753,0
0,1487,60289,3578761753,3578761754,1
0,1487,60290,3578761753,3578761755,2
0,1487,60291,3578761753,3578761757,4
0,1487,60292,3578761753,3578761757,4
0,1487,60293,3578761753,3578761757,4
0,1487,60294,3578761753,3578761759,6
0,1487,60295,3578761753,3578761759,6
0,1487,60296,3578761753,3578761759,6
0,1487,60297,3578761753,3578761760,7
0,1487,60298,3578761753,3578761760,7
0,1487,60299,3578761753,3578761760,7
0,1487,60300,3578761753,3578761760,7
0,1487,60301,3578761753,3578761760,7
0,1487,60302,3578761753,3578761761,8
0,1487,60303,3578761753,3578761761,8
0,1487,60304,3578761753,3578761762,9
0,1487,60305,3578761753,3578761762,9
0,1487,60306,3578761753,3578761762,9
0,1487,60307,3578761753,3578761762,9
0,1487,60308,3578761753,3578761763,10
0,1487,60309,3578761753,3578761764,11
0,1487,60310,3578761753,3578761765,12
0,1487,60311,3578761753,3578761765,12
0,1487,60312,3578761753,3578761766,13
0,1487,60313,3578761753,3578761768,15
0,1487,60314,3578761753,3578761768,15
0,1487,60315,3578761753,3578761768,15
0,1487,60316,3578761753,3578761769,16
0,1487,60317,3578761753,3578761769,16
0,1487,60318,3578761753,3578761770,17
0,1487,60319,3578761753,3578761771,18
0,1487,60320,3578761753,3578761773,20
0,1487,60321,3578761753,3578761773,20
0,1487,60322,3578761753,3578761773,20
0,1487,60323,3578761753,3578761773,20
0,1487,60324,3578761753,3578761774,21
0,1487,60325,3578761753,3578761776,23
0,1487,60326,3578761753,3578761776,23
0,1487,60327,3578761753,3578761778,25
0,1487,60328,3578761753,3578761778,25
0,1487,60329,3578761753,3578761778,25
0,1487,60330,3578761753,3578761778,25
0,1487,60331,3578761753,3578761779,26
0,1487,60332,3578761753,3578761780,27
0,1487,60333,3578761753,3578761781,28
0,1487,60334,3578761753,3578761782,29
0,1487,60335,3578761753,3578761782,29
0,1487,60336,3578761753,3578761783,30
0,1487,60337,3578761753,3578761784,31
0,1487,60338,3578761753,3578761784,31
0,1487,60339,3578761753,3578761785,32
0,1487,60340,3578761753,3578761787,34
0,1487,60341,3578761753,3578761787,34
0,1487,60342,3578761753,3578761788,35
0,1487,60343,3578761753,3578761788,35
0,1487,60344,3578761753,3578761788,35
0,1487,60345,3578761753,3578761789,36
0,1487,60346,3578761753,3578761790,37
0,1487,60347,3578761753,3578761791,38
0,1487,60348,3578761753,3578761791,38
0,1487,60349,3578761753,3578761793,40
0,1487,60350,3578761753,3578761793,40
0,1487,60351,3578761753,3578761793,40
0,1487,60352,3578761753,3578761795,42
0,1487,60353,3578761753,3578761796,43
0,1487,60354,3578761753,3578761796,43
0,1487,60355,3578761753,3578761797,44
0,1487,60356,3578761753,3578761798,45
0,1487,60357,3578761753,3578761799,46
0,1487,60358,3578761753,3578761799,46
0,1487,60359,3578761753,3578761799,46
0,1487,60360,3578761753,3578761800,47
0,1487,60361,3578761753,3578761800,47
0,1487,60362,3578761753,3578761803,50
0,1488,60363,3578761817,3578761817,0
0,1488,60364,3578761817,3578761817,0
0,1488,60365,3578761817,3578761817,0
0,1488,60366,3578761817,3578761817,0
0,1488,60367,3578761817,3578761817,0
0,1488,60368,3578761817,3578761817,0
0,1488,60369,3578761817,3578761817,0
0,1488,60370,3578761817,3578761817,0
0,1488,60371,3578761817,3578761817,0
0,1488,60372,3578761817,3578761817,0
0,1488,60373,3578761817,3578761817,0
0,1488,60374,3578761817,3578761817,0
0,1488,60375,3578761817,3578761817,0
0,1488,60376,3578761817,3578761817,0
0,1488,60377,3578761817,3578761817,0
0,1488,60378,3578761817,3578761817,0
0,1488,60379,3578761817,3578761817,0
0,1488,60380,3578761817,3578761817,0
0,1488,60381,3578761817,3578761817,0
0,1488,60382,3578761817,3578761817,0
0,1488,60383,3578761817,3578761817,0
0,1488,60384,3578761817,3578761817,0
0,1488,60385,3578761817,3578761817,0
0,1488,60386,3578761817,3578761817,0
0,1488,60387,3578761817,3578761818,1
0,1488,60388,3578761817,3578761818,1
0,1488,60389,3578761817,3578761818,1
0,1488,60390,3578761817,3578761819,2
0,1488,60391,3578761817,3578761819,2
0,1488,60392,3578761817,3578761819,2
0,1488,60393,3578761817,3578761820,3
0,1488,60394,3578761817,3578761821,4
0,1488,60395,3578761817,3578761822,5
0,1488,60396,3578761817,3578761823,6
0,1488,60397,3578761817,3578761824,7
0,1488,60398,3578761817,3578761825,8
0,1488,60399,3578761817,3578761826,9
0,1488,60400,3578761817,3578761827,10
0,1488,60401,3578761817,3578761827,10
0,1488,60402,3578761817,3578761827,10
0,1488,60403,3578761817,3578761827,10
0,1488,60404,3578761817,3578761828,11
0,1488,60405,3578761817,3578761829,12
0,1488,60406,3578761817,3578761830,13
0,1488,60407,3578761817,3578761832,15
0,1488,60408,3578761817,3578761832,15
0,1488,60409,3578761817,3578761833,16
0,1488,60410,3578761817,3578761833,16
0,1488,60411,3578761817,3578761834,17
0,1488,60412,3578761817,3578761834,17
0,1488,60413,3578761817,3578761834,17
0,1488,60414,3578761817,3578761835,18
0,1488,60415,3578761817,3578761837,20
0,1488,60416,3578761817,3578761837,20
0,1488,60417,3578761817,3578761837,20
0,1488,60418,3578761817,3578761838,21
0,1488,60419,3578761817,3578761838,21
0,1488,60420,3578761817,3578761839,22
0,1488,60421,3578761817,3578761839,22
0,1488,60422,3578761817,3578761839,22
0,1488,60423,3578761817,3578761839,22
0,1488,60424,3578761817,3578761840,23
0,1488,60425,3578761817,3578761840,23
0,1488,60426,3578761817,3578761840,23
0,1488,60427,3578761817,3578761840,23
0,1488,60428,3578761817,3578761842,25
0,1488,60429,3578761817,3578761842,25
0,1488,60430,3578761817,3578761842,25
0,1488,60431,3578761817,3578761843,26
0,1488,60432,3578761817,3578761843,26
0,1488,60433,3578761817,3578761843,26
0,1488,60434,3578761817,3578761845,28
0,1488,60435,3578761817,3578761847,30
0,1488,60436,3578761817,3578761847,30
0,1488,60437,3578761817,3578761849,32
0,1488,60438,3578761817,3578761849,32
0,1488,60439,3578761817,3578761850,33
0,1488,60440,3578761817,3578761850,33
0,1488,60441,3578761817,3578761851,34
0,1488,60442,3578761817,3578761852,35
0,1488,60443,3578761817,3578761855,38
0,1488,60444,3578761817,3578761856,39
0,1488,60445,3578761817,3578761856,39
0,1488,60446,3578761817,3578761857,40
0,1488,60447,3578761817,3578761858,41
0,1488,60448,3578761817,3578761858,41
0,1488,60449,3578761817,3578761859,42
0,1488,60450,3578761817,3578761859,42
0,1488,60451,3578761817,3578761859,42
0,1488,60452,3578761817,3578761861,44
0,1488,60453,3578761817,3578761861,44
0,1488,60454,3578761817,3578761862,45
0,1488,60455,3578761817,3578761862,45
0,1488,60456,3578761817,3578761863,46
0,1488,60457,3578761817,3578761863,46
0,1488,60458,3578761817,3578761864,47
0,1488,60459,3578761817,3578761864,47
0,1488,60460,3578761817,3578761865,48
0,1488,60461,3578761817,3578761865,48
0,1488,60462,3578761817,3578761865,48
0,1488,60463,3578761817,3578761866,49
0,1488,60464,3578761817,3578761867,50
0,1489,60465,3578761881,3578761881,0
0,1489,60466,3578761881,3578761881,0
0,1489,60467,3578761881,3578761882,1
0,1489,60468,3578761881,3578761883,2
0,1489,60469,3578761881,3578761887,6
0,1489,60470,3578761881,3578761888,7
0,1489,60471,3578761881,3578761888,7
0,1489,60472,3578761881,3578761888,7
0,1489,60473,3578761881,3578761888,7
0,1489,60474,3578761881,3578761888,7
0,1489,60475,3578761881,3578761889,8
0,1489,60476,3578761881,3578761889,8
0,1489,60477,3578761881,3578761889,8
0,1489,60478,3578761881,3578761890,9
0,1489,60479,3578761881,3578761891,10
0,1489,60480,3578761881,3578761891,10
0,1489,60481,3578761881,3578761892,11
0,1489,60482,3578761881,3578761892,11
0,1489,60483,3578761881,3578761893,12
0,1489,60484,3578761881,3578761893,12
0,1489,60485,3578761881,3578761894,13
0,1489,60486,3578761881,3578761894,13
0,1489,60487,3578761881,3578761894,13
0,1489,60488,3578761881,3578761895,14
0,1489,60489,3578761881,3578761896,15
0,1489,60490,3578761881,3578761896,15
0,1489,60491,3578761881,3578761898,17
0,1489,60492,3578761881,3578761898,17
0,1489,60493,3578761881,3578761899,18
0,1489,60494,3578761881,3578761899,18
0,1489,60495,3578761881,3578761899,18
0,1489,60496,3578761881,3578761899,18
0,1489,60497,3578761881,3578761902,21
0,1489,60498,3578761881,3578761903,22
0,1489,60499,3578761881,3578761905,24
0,1489,60500,3578761881,3578761905,24
0,1489,60501,3578761881,3578761905,24
0,1489,60502,3578761881,3578761905,24
0,1489,60503,3578761881,3578761907,26
0,1489,60504,3578761881,3578761907,26
0,1489,60505,3578761881,3578761907,26
0,1489,60506,3578761881,3578761907,26
0,1489,60507,3578761881,3578761907,26
0,1489,60508,3578761881,3578761908,27
0,1489,60509,3578761881,3578761908,27
0,1489,60510,3578761881,3578761909,28
0,1489,60511,3578761881,3578761909,28
0,1489,60512,3578761881,3578761910,29
0,1489,60513,3578761881,3578761910,29
0,1489,60514,3578761881,3578761911,30
0,1489,60515,3578761881,3578761912,31
0,1489,60516,3578761881,3578761912,31
0,1489,60517,3578761881,3578761912,31
0,1489,60518,3578761881,3578761915,34
0,1489,60519,3578761881,3578761915,34
0,1489,60520,3578761881,3578761915,34
0,1489,60521,3578761881,3578761916,35
0,1489,60522,3578761881,3578761916,35
0,1489,60523,3578761881,3578761916,35
0,1489,60524,3578761881,3578761916,35
0,1489,60525,3578761881,3578761916,35
0,1489,60526,3578761881,3578761917,36
0,1489,60527,3578761881,3578761917,36
0,1489,60528,3578761881,3578761917,36
0,1489,60529,3578761881,3578761918,37
0,1489,60530,3578761881,3578761918,37
0,1489,60531,3578761881,3578761918,37
0,1489,60532,3578761881,3578761919,38
0,1489,60533,3578761881,3578761919,38
0,1489,60534,3578761881,3578761920,39
0,1489,60535,3578761881,3578761922,41
0,1489,60536,3578761881,3578761922,41
0,1489,60537,3578761881,3578761923,42
0,1489,60538,3578761881,3578761925,44
0,1489,60539,3578761881,3578761925,44
0,1489,60540,3578761881,3578761926,45
0,1489,60541,3578761881,3578761926,45
0,1489,60542,3578761881,3578761927,46
0,1489,60543,3578761881,3578761927,46
0,1489,60544,3578761881,3578761927,46
0,1489,60545,3578761881,3578761928,47
0,1489,60546,3578761881,3578761928,47
0,1489,60547,3578761881,3578761928,47
0,1489,60548,3578761881,3578761928,47
0,1489,60549,3578761881,3578761928,47
0,1489,60550,3578761881,3578761928,47
0,1489,60551,3578761881,3578761928,47
0,1489,60552,3578761881,3578761929,48
0,1489,60553,3578761881,3578761929,48
0,1489,60554,3578761881,3578761929,48
0,1489,60555,3578761881,3578761929,48
0,1489,60556,3578761881,3578761930,49
0,1489,60557,3578761881,3578761930,49
0,1489,60558,3578761881,3578761931,50
0,1489,60559,3578761881,3578761931,50
0,1490,60560,3578761946,3578761946,0
0,1490,60561,3578761946,3578761946,0
0,1490,60562,3578761946,3578761946,0
0,1490,60563,3578761946,3578761946,0
0,1490,60564,3578761946,3578761946,0
0,1490,60565,3578761946,3578761946,0
0,1490,60566,3578761946,3578761946,0
0,1490,60567,3578761946,3578761946,0
0,1490,60568,3578761946,3578761946,0
0,1490,60569,3578761946,3578761946,0
0,1490,60570,3578761946,3578761946,0
0,1490,60571,3578761946,3578761946,0
0,1490,60572,3578761946,3578761946,0
0,1490,60573,3578761946,3578761946,0
0,1490,60574,3578761946,3578761946,0
0,1490,60575,3578761946,3578761946,0
0,1490,60576,3578761946,3578761946,0
0,1490,60577,3578761946,3578761946,0
0,1490,60578,3578761946,3578761946,0
0,1490,60579,3578761946,3578761946,0
0,1490,60580,3578761946,3578761946,0
0,1490,60581,3578761946,3578761946,0
0,1490,60582,3578761946,3578761946,0
0,1490,60583,3578761946,3578761946,0
0,1490,60584,3578761946,3578761946,0
0,1490,60585,3578761946,3578761946,0
0,1490,60586,3578761946,3578761946,0
0,1490,60587,3578761946,3578761946,0
0,1490,60588,3578761946,3578761946,0
0,1490,60589,3578761946,3578761947,1
0,1490,60590,3578761946,3578761948,2
0,1490,60591,3578761946,3578761948,2
0,1490,60592,3578761946,3578761948,2
0,1490,60593,3578761946,3578761949,3
0,1490,60594,3578761946,3578761950,4
0,1490,60595,3578761946,3578761951,5
0,1490,60596,3578761946,3578761951,5
0,1490,60597,3578761946,3578761952,6
0,1490,60598,3578761946,3578761952,6
0,1490,60599,3578761946,3578761952,6
0,1490,60600,3578761946,3578761954,8
0,1490,60601,3578761946,3578761955,9
0,1490,60602,3578761946,3578761955,9
0,1490,60603,3578761946,3578761957,11
0,1490,60604,3578761946,3578761957,11
0,1490,60605,3578761946,3578761958,12
0,1490,60606,3578761946,3578761958,12
0,1490,60607,3578761946,3578761958,12
0,1490,60608,3578761946,3578761960,14
0,1490,60609,3578761946,3578761960,14
0,1490,60610,3578761946,3578761960,14
0,1490,60611,3578761946,3578761960,14
0,1490,60612,3578761946,3578761961,15
0,1490,60613,3578761946,3578761961,15
0,1490,60614,3578761946,3578761961,15
0,1490,60615,3578761946,3578761961,15
0,1490,60616,3578761946,3578761961,15
0,1490,60617,3578761946,3578761962,16
0,1490,60618,3578761946,3578761962,16
0,1490,60619,3578761946,3578761962,16
0,1490,60620,3578761946,3578761963,17
0,1490,60621,3578761946,3578761963,17
0,1490,60622,3578761946,3578761964,18
0,1490,60623,3578761946,3578761964,18
0,1490,60624,3578761946,3578761965,19
0,1490,60625,3578761946,3578761966,20
0,1490,60626,3578761946,3578761969,23
0,1490,60627,3578761946,3578761969,23
0,1490,60628,3578761946,3578761969,23
0,1490,60629,3578761946,3578761970,24
0,1490,60630,3578761946,3578761970,24
0,1490,60631,3578761946,3578761970,24
0,1490,60632,3578761946,3578761971,25
0,1490,60633,3578761946,3578761971,25
0,1490,60634,3578761946,3578761972,26
0,1490,60635,3578761946,3578761973,27
0,1490,60636,3578761946,3578761973,27
0,1490,60637,3578761946,3578761974,28
0,1490,60638,3578761946,3578761974,28
0,1490,60639,3578761946,3578761974,28
0,1490,60640,3578761946,3578761976,30
0,1490,60641,3578761946,3578761976,30
0,1490,60642,3578761946,3578761978,32
0,1490,60643,3578761946,3578761978,32
0,1490,60644,3578761946,3578761978,32
0,1490,60645,3578761946,3578761978,32
0,1490,60646,3578761946,3578761980,34
0,1490,60647,3578761946,3578761981,35
0,1490,60648,3578761946,3578761982,36
0,1490,60649,3578761946,3578761983,37
0,1490,60650,3578761946,3578761984,38
0,1490,60651,3578761946,3578761985,39
0,1490,60652,3578761946,3578761985,39
0,1490,60653,3578761946,3578761987,41
0,1490,60654,3578761946,3578761987,41
0,1490,60655,3578761946,3578761988,42
0,1490,60656,3578761946,3578761988,42
0,1490,60657,3578761946,3578761989,43
0,1490,60658,3578761946,3578761989,43
0,1490,60659,3578761946,3578761990,44
0,1490,60660,3578761946,3578761991,45
0,1490,60661,3578761946,3578761991,45
0,1490,60662,3578761946,3578761993,47
0,1490,60663,3578761946,3578761993,47
0,1490,60664,3578761946,3578761994,48
0,1490,60665,3578761946,3578761994,48
0,1490,60666,3578761946,3578761995,49
0,1491,60667,3578762011,3578762011,0
0,1491,60668,3578762011,3578762011,0
0,1491,60669,3578762011,3578762011,0
0,1491,60670,3578762011,3578762011,0
0,1491,60671,3578762011,3578762011,0
0,1491,60672,3578762011,3578762011,0
0,1491,60673,3578762011,3578762011,0
0,1491,60674,3578762011,3578762011,0
0,1491,60675,3578762011,3578762011,0
0,1491,60676,3578762011,3578762011,0
0,1491,60677,3578762011,3578762011,0
0,1491,60678,3578762011,3578762011,0
0,1491,60679,3578762011,3578762011,0
0,1491,60680,3578762011,3578762011,0
0,1491,60681,3578762011,3578762011,0
0,1491,60682,3578762011,3578762011,0
0,1491,60683,3578762011,3578762011,0
0,1491,60684,3578762011,3578762011,0
0,1491,60685,3578762011,3578762011,0
0,1491,60686,3578762011,3578762011,0
0,1491,60687,3578762011,3578762011,0
0,1491,60688,3578762011,3578762012,1
0,1491,60689,3578762011,3578762012,1
0,1491,60690,3578762011,3578762012,1
0,1491,60691,3578762011,3578762013,2
0,1491,60692,3578762011,3578762014,3
0,1491,60693,3578762011,3578762014,3
0,1491,60694,3578762011,3578762015,4
0,1491,60695,3578762011,3578762015,4
0,1491,60696,3578762011,3578762015,4
0,1491,60697,3578762011,3578762017,6
0,1491,60698,3578762011,3578762018,7
0,1491,60699,3578762011,3578762018,7
0,1491,60700,3578762011,3578762019,8
0,1491,60701,3578762011,3578762019,8
0,1491,60702,3578762011,3578762020,9
0,1491,60703,3578762011,3578762020,9
0,1491,60704,3578762011,3578762021,10
0,1491,60705,3578762011,3578762021,10
0,1491,60706,3578762011,3578762022,11
0,1491,60707,3578762011,3578762023,12
0,1491,60708,3578762011,3578762024,13
0,1491,60709,3578762011,3578762024,13
0,1491,60710,3578762011,3578762026,15
0,1491,60711,3578762011,3578762027,16
0,1491,60712,3578762011,3578762027,16
0,1491,60713,3578762011,3578762028,17
0,1491,60714,3578762011,3578762028,17
0,1491,60715,3578762011,3578762029,18
0,1491,60716,3578762011,3578762029,18
0,1491,60717,3578762011,3578762030,19
0,1491,60718,3578762011,3578762030,19
0,1491,60719,3578762011,3578762033,22
0,1491,60720,3578762011,3578762033,22
0,1491,60721,3578762011,3578762034,23
0,1491,60722,3578762011,3578762034,23
0,1491,60723,3578762011,3578762034,23
0,1491,60724,3578762011,3578762034,23
0,1491,60725,3578762011,3578762036,25
0,1491,60726,3578762011,3578762037,26
0,1491,60727,3578762011,3578762038,27
0,1491,60728,3578762011,3578762038,27
0,1491,60729,3578762011,3578762038,27
0,1491,60730,3578762011,3578762039,28
0,1491,60731,3578762011,3578762039,28
0,1491,60732,3578762011,3578762039,28
0,1491,60733,3578762011,3578762040,29
0,1491,60734,3578762011,3578762041,30
0,1491,60735,3578762011,3578762041,30
0,1491,60736,3578762011,3578762041,30
0,1491,60737,3578762011,3578762042,31
0,1491,60738,3578762011,3578762043,32
0,1491,60739,3578762011,3578762043,32
0,1491,60740,3578762011,3578762046,35
0,1491,60741,3578762011,3578762047,36
0,1491,60742,3578762011,3578762047,36
0,1491,60743,3578762011,3578762047,36
0,1491,60744,3578762011,3578762048,37
0,1491,60745,3578762011,3578762049,38
0,1491,60746,3578762011,3578762049,38
0,1491,60747,3578762011,3578762049,38
0,1491,60748,3578762011,3578762049,38
0,1491,60749,3578762011,3578762050,39
0,1491,60750,3578762011,3578762051,40
0,1491,60751,3578762011,3578762052,41
0,1491,60752,3578762011,3578762055,44
0,1491,60753,3578762011,3578762055,44
0,1491,60754,3578762011,3578762056,45
0,1491,60755,3578762011,3578762057,46
0,1491,60756,3578762011,3578762058,47
0,1491,60757,3578762011,3578762058,47
0,1491,60758,3578762011,3578762058,47
0,1491,60759,3578762011,3578762058,47
0,1491,60760,3578762011,3578762060,49
0,1492,60761,3578762073,3578762073,0
0,1492,60762,3578762073,3578762074,1
0,1492,60763,3578762073,3578762074,1
0,1492,60764,3578762073,3578762074,1
0,1492,60765,3578762073,3578762074,1
0,1492,60766,3578762073,3578762074,1
0,1492,60767,3578762073,3578762074,1
0,1492,60768,3578762073,3578762074,1
0,1492,60769,3578762073,3578762074,1
0,1492,60770,3578762073,3578762074,1
0,1492,60771,3578762073,3578762074,1
0,1492,60772,3578762073,3578762074,1
0,1492,60773,3578762073,3578762074,1
0,1492,60774,3578762073,3578762074,1
0,1492,60775,3578762073,3578762074,1
0,1492,60776,3578762073,3578762074,1
0,1492,60777,3578762073,3578762074,1
0,1492,60778,3578762073,3578762082,9
0,1492,60779,3578762073,3578762083,10
0,1492,60780,3578762073,3578762087,14
0,1492,60781,3578762073,3578762088,15
0,1492,60782,3578762073,3578762088,15
0,1492,60783,3578762073,3578762088,15
0,1492,60784,3578762073,3578762088,15
0,1492,60785,3578762073,3578762089,16
0,1492,60786,3578762073,3578762089,16
0,1492,60787,3578762073,3578762089,16
0,1492,60788,3578762073,3578762090,17
0,1492,60789,3578762073,3578762090,17
0,1492,60790,3578762073,3578762090,17
0,1492,60791,3578762073,3578762091,18
0,1492,60792,3578762073,3578762092,19
0,1492,60793,3578762073,3578762092,19
0,1492,60794,3578762073,3578762093,20
0,1492,60795,3578762073,3578762093,20
0,1492,60796,3578762073,3578762093,20
0,1492,60797,3578762073,3578762093,20
0,1492,60798,3578762073,3578762093,20
0,1492,60799,3578762073,3578762094,21
0,1492,60800,3578762073,3578762095,22
0,1492,60801,3578762073,3578762095,22
0,1492,60802,3578762073,3578762095,22
0,1492,60803,3578762073,3578762096,23
0,1492,60804,3578762073,3578762096,23
0,1492,60805,3578762073,3578762098,25
0,1492,60806,3578762073,3578762098,25
0,1492,60807,3578762073,3578762098,25
0,1492,60808,3578762073,3578762099,26
0,1492,60809,3578762073,3578762099,26
0,1492,60810,3578762073,3578762099,26
0,1492,60811,3578762073,3578762100,27
0,1492,60812,3578762073,3578762100,27
0,1492,60813,3578762073,3578762101,28
0,1492,60814,3578762073,3578762104,31
0,1492,60815,3578762073,3578762104,31
0,1492,60816,3578762073,3578762105,32
0,1492,60817,3578762073,3578762105,32
0,1492,60818,3578762073,3578762105,32
0,1492,60819,3578762073,3578762107,34
0,1492,60820,3578762073,3578762107,34
0,1492,60821,3578762073,3578762107,34
0,1492,60822,3578762073,3578762108,35
0,1492,60823,3578762073,3578762108,35
0,1492,60824,3578762073,3578762108,35
0,1492,60825,3578762073,3578762108,35
0,1492,60826,3578762073,3578762109,36
0,1492,60827,3578762073,3578762109,36
0,1492,60828,3578762073,3578762110,37
0,1492,60829,3578762073,3578762110,37
0,1492,60830,3578762073,3578762110,37
0,1492,60831,3578762073,3578762111,38
0,1492,60832,3578762073,3578762112,39
0,1492,60833,3578762073,3578762112,39
0,1492,60834,3578762073,3578762114,41
0,1492,60835,3578762073,3578762115,42
0,1492,60836,3578762073,3578762115,42
0,1492,60837,3578762073,3578762115,42
0,1492,60838,3578762073,3578762115,42
0,1492,60839,3578762073,3578762116,43
0,1492,60840,3578762073,3578762116,43
0,1492,60841,3578762073,3578762116,43
0,1492,60842,3578762073,3578762116,43
0,1492,60843,3578762073,3578762116,43
0,1492,60844,3578762073,3578762117,44
0,1492,60845,3578762073,3578762117,44
0,1492,60846,3578762073,3578762117,44
0,1492,60847,3578762073,3578762117,44
0,1492,60848,3578762073,3578762117,44
0,1492,60849,3578762073,3578762118,45
0,1492,60850,3578762073,3578762119,46
0,1492,60851,3578762073,3578762119,46
0,1492,60852,3578762073,3578762120,47
0,1492,60853,3578762073,3578762120,47
0,1492,60854,3578762073,3578762122,49
0,1492,60855,3578762073,3578762122,49
0,1493,60856,3578762137,3578762137,0
0,1493,60857,3578762137,3578762137,0
0,1493,60858,3578762137,3578762137,0
0,1493,60859,3578762137,3578762137,0
0,1493,60860,3578762137,3578762137,0
0,1493,60861,3578762137,3578762137,0
0,1493,60862,3578762137,3578762137,0
0,1493,60863,3578762137,3578762137,0
0,1493,60864,3578762137,3578762137,0
0,1493,60865,3578762137,3578762137,0
0,1493,60866,3578762137,3578762137,0
0,1493,60867,3578762137,3578762137,0
0,1493,60868,3578762137,3578762137,0
0,1493,60869,3578762137,3578762137,0
0,1493,60870,3578762137,3578762137,0
0,1493,60871,3578762137,3578762137,0
0,1493,60872,3578762137,3578762137,0
0,1493,60873,3578762137,3578762137,0
0,1493,60874,3578762137,3578762137,0
0,1493,60875,3578762137,3578762137,0
0,1493,60876,3578762137,3578762137,0
0,1493,60877,3578762137,3578762137,0
0,1493,60878,3578762137,3578762137,0
0,1493,60879,3578762137,3578762137,0
0,1493,60880,3578762137,3578762137,0
0,1493,60881,3578762137,3578762138,1
0,1493,60882,3578762137,3578762138,1
0,1493,60883,3578762137,3578762138,1
0,1493,60884,3578762137,3578762138,1
0,1493,60885,3578762137,3578762138,1
0,1493,60886,3578762137,3578762138,1
0,1493,60887,3578762137,3578762138,1
0,1493,60888,3578762137,3578762139,2
0,1493,60889,3578762137,3578762140,3
0,1493,60890,3578762137,3578762141,4
0,1493,60891,3578762137,3578762141,4
0,1493,60892,3578762137,3578762141,4
0,1493,60893,3578762137,3578762142,5
0,1493,60894,3578762137,3578762142,5
0,1493,60895,3578762137,3578762143,6
0,1493,60896,3578762137,3578762143,6
0,1493,60897,3578762137,3578762144,7
0,1493,60898,3578762137,3578762144,7
0,1493,60899,3578762137,3578762144,7
0,1493,60900,3578762137,3578762145,8
0,1493,60901,3578762137,3578762145,8
0,1493,60902,3578762137,3578762146,9
0,1493,60903,3578762137,3578762146,9
0,1493,60904,3578762137,3578762147,10
0,1493,60905,3578762137,3578762147,10
0,1493,60906,3578762137,3578762148,11
0,1493,60907,3578762137,3578762148,11
0,1493,60908,3578762137,3578762148,11
0,1493,60909,3578762137,3578762149,12
0,1493,60910,3578762137,3578762150,13
0,1493,60911,3578762137,3578762151,14
0,1493,60912,3578762137,3578762152,15
0,1493,60913,3578762137,3578762152,15
0,1493,60914,3578762137,3578762153,16
0,1493,60915,3578762137,3578762153,16
0,1493,60916,3578762137,3578762153,16
0,1493,60917,3578762137,3578762153,16
0,1493,60918,3578762137,3578762154,17
0,1493,60919,3578762137,3578762155,18
0,1493,60920,3578762137,3578762155,18
0,1493,60921,3578762137,3578762157,20
0,1493,60922,3578762137,3578762158,21
0,1493,60923,3578762137,3578762158,21
0,1493,60924,3578762137,3578762158,21
0,1493,60925,3578762137,3578762159,22
0,1493,60926,3578762137,3578762160,23
0,1493,60927,3578762137,3578762160,23
0,1493,60928,3578762137,3578762161,24
0,1493,60929,3578762137,3578762161,24
0,1493,60930,3578762137,3578762161,24
0,1493,60931,3578762137,3578762161,24
0,1493,60932,3578762137,3578762161,24
0,1493,60933,3578762137,3578762162,25
0,1493,60934,3578762137,3578762162,25
0,1493,60935,3578762137,3578762162,25
0,1493,60936,3578762137,3578762163,26
0,1493,60937,3578762137,3578762164,27
0,1493,60938,3578762137,3578762165,28
0,1493,60939,3578762137,3578762165,28
0,1493,60940,3578762137,3578762166,29
0,1493,60941,3578762137,3578762167,30
0,1493,60942,3578762137,3578762169,32
0,1493,60943,3578762137,3578762169,32
0,1493,60944,3578762137,3578762169,32
0,1493,60945,3578762137,3578762170,33
0,1493,60946,3578762137,3578762171,34
0,1493,60947,3578762137,3578762171,34
0,1493,60948,3578762137,3578762171,34
0,1493,60949,3578762137,3578762171,34
0,1493,60950,3578762137,3578762173,36
0,1493,60951,3578762137,3578762173,36
0,1493,60952,3578762137,3578762173,36
0,1493,60953,3578762137,3578762173,36
0,1493,60954,3578762137,3578762174,37
0,1493,60955,3578762137,3578762174,37
0,1493,60956,3578762137,3578762175,38
0,1493,60957,3578762137,3578762176,39
0,1493,60958,3578762137,3578762178,41
0,1493,60959,3578762137,3578762179,42
0,1493,60960,3578762137,3578762179,42
0,1493,60961,3578762137,3578762179,42
0,1493,60962,3578762137,3578762179,42
0,1493,60963,3578762137,3578762180,43
0,1493,60964,3578762137,3578762182,45
0,1493,60965,3578762137,3578762182,45
0,1493,60966,3578762137,3578762183,46
0,1493,60967,3578762137,3578762184,47
0,1493,60968,3578762137,3578762185,48
0,1493,60969,3578762137,3578762185,48
0,1493,60970,3578762137,3578762185,48
0,1493,60971,3578762137,3578762187,50
0,1494,60972,3578762200,3578762200,0
0,1494,60973,3578762200,3578762200,0
0,1494,60974,3578762200,3578762200,0
0,1494,60975,3578762200,3578762200,0
0,1494,60976,3578762200,3578762200,0
0,1494,60977,3578762200,3578762200,0
0,1494,60978,3578762200,3578762200,0
0,1494,60979,3578762200,3578762200,0
0,1494,60980,3578762200,3578762200,0
0,1494,60981,3578762200,3578762200,0
0,1494,60982,3578762200,3578762200,0
0,1494,60983,3578762200,3578762200,0
0,1494,60984,3578762200,3578762200,0
0,1494,60985,3578762200,3578762200,0
0,1494,60986,3578762200,3578762200,0
0,1494,60987,3578762200,3578762200,0
0,1494,60988,3578762200,3578762200,0
0,1494,60989,3578762200,3578762200,0
0,1494,60990,3578762200,3578762200,0
0,1494,60991,3578762200,3578762201,1
0,1494,60992,3578762200,3578762203,3
0,1494,60993,3578762200,3578762203,3
0,1494,60994,3578762200,3578762204,4
0,1494,60995,3578762200,3578762204,4
0,1494,60996,3578762200,3578762205,5
0,1494,60997,3578762200,3578762205,5
0,1494,60998,3578762200,3578762205,5
0,1494,60999,3578762200,3578762206,6
0,1494,61000,3578762200,3578762206,6
0,1494,61001,3578762200,3578762207,7
0,1494,61002,3578762200,3578762207,7
0,1494,61003,3578762200,3578762209,9
0,1494,61004,3578762200,3578762210,10
0,1494,61005,3578762200,3578762211,11
0,1494,61006,3578762200,3578762212,12
0,1494,61007,3578762200,3578762212,12
0,1494,61008,3578762200,3578762212,12
0,1494,61009,3578762200,3578762213,13
0,1494,61010,3578762200,3578762214,14
0,1494,61011,3578762200,3578762214,14
0,1494,61012,3578762200,3578762216,16
0,1494,61013,3578762200,3578762216,16
0,1494,61014,3578762200,3578762217,17
0,1494,61015,3578762200,3578762218,18
0,1494,61016,3578762200,3578762218,18
0,1494,61017,3578762200,3578762219,19
0,1494,61018,3578762200,3578762219,19
0,1494,61019,3578762200,3578762219,19
0,1494,61020,3578762200,3578762220,20
0,1494,61021,3578762200,3578762220,20
0,1494,61022,3578762200,3578762220,20
0,1494,61023,3578762200,3578762221,21
0,1494,61024,3578762200,3578762221,21
0,1494,61025,3578762200,3578762222,22
0,1494,61026,3578762200,3578762224,24
0,1494,61027,3578762200,3578762224,24
0,1494,61028,3578762200,3578762224,24
0,1494,61029,3578762200,3578762227,27
0,1494,61030,3578762200,3578762227,27
0,1494,61031,3578762200,3578762228,28
0,1494,61032,3578762200,3578762228,28
0,1494,61033,3578762200,3578762228,28
0,1494,61034,3578762200,3578762230,30
0,1494,61035,3578762200,3578762230,30
0,1494,61036,3578762200,3578762230,30
0,1494,61037,3578762200,3578762230,30
0,1494,61038,3578762200,3578762231,31
0,1494,61039,3578762200,3578762232,32
0,1494,61040,3578762200,3578762234,34
0,1494,61041,3578762200,3578762234,34
0,1494,61042,3578762200,3578762234,34
0,1494,61043,3578762200,3578762234,34
0,1494,61044,3578762200,3578762235,35
0,1494,61045,3578762200,3578762235,35
0,1494,61046,3578762200,3578762235,35
0,1494,61047,3578762200,3578762236,36
0,1494,61048,3578762200,3578762238,38
0,1494,61049,3578762200,3578762239,39
0,1494,61050,3578762200,3578762239,39
0,1494,61051,3578762200,3578762239,39
0,1494,61052,3578762200,3578762239,39
0,1494,61053,3578762200,3578762239,39
0,1494,61054,3578762200,3578762240,40
0,1494,61055,3578762200,3578762240,40
0,1494,61056,3578762200,3578762241,41
0,1494,61057,3578762200,3578762241,41
0,1494,61058,3578762200,3578762242,42
0,1494,61059,3578762200,3578762242,42
0,1494,61060,3578762200,3578762242,42
0,1494,61061,3578762200,3578762243,43
0,1494,61062,3578762200,3578762243,43
0,1494,61063,3578762200,3578762245,45
0,1494,61064,3578762200,3578762246,46
0,1494,61065,3578762200,3578762248,48
0,1494,61066,3578762200,3578762248,48
0,1494,61067,3578762200,3578762248,48
0,1494,61068,3578762200,3578762248,48
0,1494,61069,3578762200,3578762248,48
0,1494,61070,3578762200,3578762249,49
0,1494,61071,3578762200,3578762249,49
0,1494,61072,3578762200,3578762250,50
0,1494,61073,3578762200,3578762250,50
0,1495,61074,3578762263,3578762263,0
0,1495,61075,3578762263,3578762263,0
0,1495,61076,3578762263,3578762263,0
0,1495,61077,3578762263,3578762263,0
0,1495,61078,3578762263,3578762263,0
0,1495,61079,3578762263,3578762263,0
0,1495,61080,3578762263,3578762263,0
0,1495,61081,3578762263,3578762263,0
0,1495,61082,3578762263,3578762263,0
0,1495,61083,3578762263,3578762263,0
0,1495,61084,3578762263,3578762263,0
0,1495,61085,3578762263,3578762263,0
0,1495,61086,3578762263,3578762263,0
0,1495,61087,3578762263,3578762263,0
0,1495,61088,3578762263,3578762263,0
0,1495,61089,3578762263,3578762264,1
0,1495,61090,3578762263,3578762264,1
0,1495,61091,3578762263,3578762264,1
0,1495,61092,3578762263,3578762265,2
0,1495,61093,3578762263,3578762265,2
0,1495,61094,3578762263,3578762265,2
0,1495,61095,3578762263,3578762266,3
0,1495,61096,3578762263,3578762266,3
0,1495,61097,3578762263,3578762267,4
0,1495,61098,3578762263,3578762267,4
0,1495,61099,3578762263,3578762268,5
0,1495,61100,3578762263,3578762269,6
0,1495,61101,3578762263,3578762270,7
0,1495,61102,3578762263,3578762282,19
0,1495,61103,3578762263,3578762284,21
0,1495,61104,3578762263,3578762287,24
0,1495,61105,3578762263,3578762288,25
0,1495,61106,3578762263,3578762288,25
0,1495,61107,3578762263,3578762288,25
0,1495,61108,3578762263,3578762288,25
0,1495,61109,3578762263,3578762288,25
0,1495,61110,3578762263,3578762289,26
0,1495,61111,3578762263,3578762289,26
0,1495,61112,3578762263,3578762289,26
0,1495,61113,3578762263,3578762290,27
0,1495,61114,3578762263,3578762290,27
0,1495,61115,3578762263,3578762292,29
0,1495,61116,3578762263,3578762292,29
0,1495,61117,3578762263,3578762292,29
0,1495,61118,3578762263,3578762293,30
0,1495,61119,3578762263,3578762293,30
0,1495,61120,3578762263,3578762294,31
0,1495,61121,3578762263,3578762294,31
0,1495,61122,3578762263,3578762294,31
0,1495,61123,3578762263,3578762294,31
0,1495,61124,3578762263,3578762295,32
0,1495,61125,3578762263,3578762295,32
0,1495,61126,3578762263,3578762295,32
0,1495,61127,3578762263,3578762296,33
0,1495,61128,3578762263,3578762298,35
0,1495,61129,3578762263,3578762299,36
0,1495,61130,3578762263,3578762299,36
0,1495,61131,3578762263,3578762299,36
0,1495,61132,3578762263,3578762299,36
0,1495,61133,3578762263,3578762300,37
0,1495,61134,3578762263,3578762301,38
0,1495,61135,3578762263,3578762304,41
0,1495,61136,3578762263,3578762304,41
0,1495,61137,3578762263,3578762305,42
0,1495,61138,3578762263,3578762305,42
0,1495,61139,3578762263,3578762305,42
0,1495,61140,3578762263,3578762305,42
0,1495,61141,3578762263,3578762307,44
0,1495,61142,3578762263,3578762307,44
0,1495,61143,3578762263,3578762308,45
0,1495,61144,3578762263,3578762308,45
0,1495,61145,3578762263,3578762308,45
0,1495,61146,3578762263,3578762308,45
0,1495,61147,3578762263,3578762308,45
0,1495,61148,3578762263,3578762308,45
0,1495,61149,3578762263,3578762309,46
0,1495,61150,3578762263,3578762309,46
0,1495,61151,3578762263,3578762310,47
0,1495,61152,3578762263,3578762310,47
0,1495,61153,3578762263,3578762310,47
0,1495,61154,3578762263,3578762311,48
0,1495,61155,3578762263,3578762311,48
0,1495,61156,3578762263,3578762311,48
0,1495,61157,3578762263,3578762311,48
0,1496,61158,3578762326,3578762326,0
0,1496,61159,3578762326,3578762326,0
0,1496,61160,3578762326,3578762326,0
0,1496,61161,3578762326,3578762326,0
0,1496,61162,3578762326,3578762326,0
0,1496,61163,3578762326,3578762326,0
0,1496,61164,3578762326,3578762326,0
0,1496,61165,3578762326,3578762326,0
0,1496,61166,3578762326,3578762326,0
0,1496,61167,3578762326,3578762326,0
0,1496,61168,3578762326,3578762326,0
0,1496,61169,3578762326,3578762326,0
0,1496,61170,3578762326,3578762326,0
0,1496,61171,3578762326,3578762326,0
0,1496,61172,3578762326,3578762326,0
0,1496,61173,3578762326,3578762326,0
0,1496,61174,3578762326,3578762326,0
0,1496,61175,3578762326,3578762326,0
0,1496,61176,3578762326,3578762326,0
0,1496,61177,3578762326,3578762326,0
0,1496,61178,3578762326,3578762326,0
0,1496,61179,3578762326,3578762326,0
0,1496,61180,3578762326,3578762326,0
0,1496,61181,3578762326,3578762326,0
0,1496,61182,3578762326,3578762327,1
0,1496,61183,3578762326,3578762327,1
0,1496,61184,3578762326,3578762327,1
0,1496,61185,3578762326,3578762328,2
0,1496,61186,3578762326,3578762328,2
0,1496,61187,3578762326,3578762328,2
0,1496,61188,3578762326,3578762328,2
0,1496,61189,3578762326,3578762329,3
0,1496,61190,3578762326,3578762329,3
0,1496,61191,3578762326,3578762330,4
0,1496,61192,3578762326,3578762330,4
0,1496,61193,3578762326,3578762330,4
0,1496,61194,3578762326,3578762330,4
0,1496,61195,3578762326,3578762331,5
0,1496,61196,3578762326,3578762331,5
0,1496,61197,3578762326,3578762332,6
0,1496,61198,3578762326,3578762332,6
0,1496,61199,3578762326,3578762332,6
0,1496,61200,3578762326,3578762333,7
0,1496,61201,3578762326,3578762334,8
0,1496,61202,3578762326,3578762335,9
0,1496,61203,3578762326,3578762336,10
0,1496,61204,3578762326,3578762336,10
0,1496,61205,3578762326,3578762336,10
0,1496,61206,3578762326,3578762336,10
0,1496,61207,3578762326,3578762337,11
0,1496,61208,3578762326,3578762337,11
0,1496,61209,3578762326,3578762340,14
0,1496,61210,3578762326,3578762340,14
0,1496,61211,3578762326,3578762340,14
0,1496,61212,3578762326,3578762341,15
0,1496,61213,3578762326,3578762341,15
0,1496,61214,3578762326,3578762341,15
0,1496,61215,3578762326,3578762343,17
0,1496,61216,3578762326,3578762343,17
0,1496,61217,3578762326,3578762343,17
0,1496,61218,3578762326,3578762344,18
0,1496,61219,3578762326,3578762344,18
0,1496,61220,3578762326,3578762344,18
0,1496,61221,3578762326,3578762344,18
0,1496,61222,3578762326,3578762344,18
0,1496,61223,3578762326,3578762345,19
0,1496,61224,3578762326,3578762346,20
0,1496,61225,3578762326,3578762347,21
0,1496,61226,3578762326,3578762348,22
0,1496,61227,3578762326,3578762348,22
0,1496,61228,3578762326,3578762348,22
0,1496,61229,3578762326,3578762349,23
0,1496,61230,3578762326,3578762350,24
0,1496,61231,3578762326,3578762351,25
0,1496,61232,3578762326,3578762352,26
0,1496,61233,3578762326,3578762352,26
0,1496,61234,3578762326,3578762352,26
0,1496,61235,3578762326,3578762353,27
0,1496,61236,3578762326,3578762353,27
0,1496,61237,3578762326,3578762353,27
0,1496,61238,3578762326,3578762354,28
0,1496,61239,3578762326,3578762355,29
0,1496,61240,3578762326,3578762355,29
0,1496,61241,3578762326,3578762356,30
0,1496,61242,3578762326,3578762357,31
0,1496,61243,3578762326,3578762357,31
0,1496,61244,3578762326,3578762357,31
0,1496,61245,3578762326,3578762358,32
0,1496,61246,3578762326,3578762358,32
0,1496,61247,3578762326,3578762358,32
0,1496,61248,3578762326,3578762359,33
0,1496,61249,3578762326,3578762360,34
0,1496,61250,3578762326,3578762360,34
0,1496,61251,3578762326,3578762361,35
0,1496,61252,3578762326,3578762361,35
0,1496,61253,3578762326,3578762361,35
0,1496,61254,3578762326,3578762361,35
0,1496,61255,3578762326,3578762361,35
0,1496,61256,3578762326,3578762362,36
0,1496,61257,3578762326,3578762363,37
0,1496,61258,3578762326,3578762363,37
0,1496,61259,3578762326,3578762364,38
0,1496,61260,3578762326,3578762365,39
0,1496,61261,3578762326,3578762366,40
0,1496,61262,3578762326,3578762369,43
0,1496,61263,3578762326,3578762369,43
0,1496,61264,3578762326,3578762369,43
0,1496,61265,3578762326,3578762370,44
0,1496,61266,3578762326,3578762371,45
0,1496,61267,3578762326,3578762372,46
0,1496,61268,3578762326,3578762372,46
0,1496,61269,3578762326,3578762373,47
0,1496,61270,3578762326,3578762374,48
0,1496,61271,3578762326,3578762374,48
0,1496,61272,3578762326,3578762374,48
0,1496,61273,3578762326,3578762374,48
0,1496,61274,3578762326,3578762375,49
0,1497,61275,3578762390,3578762390,0
0,1497,61276,3578762390,3578762390,0
0,1497,61277,3578762390,3578762390,0
0,1497,61278,3578762390,3578762390,0
0,1497,61279,3578762390,3578762390,0
0,1497,61280,3578762390,3578762390,0
0,1497,61281,3578762390,3578762390,0
0,1497,61282,3578762390,3578762390,0
0,1497,61283,3578762390,3578762390,0
0,1497,61284,3578762390,3578762390,0
0,1497,61285,3578762390,3578762390,0
0,1497,61286,3578762390,3578762390,0
0,1497,61287,3578762390,3578762390,0
0,1497,61288,3578762390,3578762390,0
0,1497,61289,3578762390,3578762390,0
0,1497,61290,3578762390,3578762390,0
0,1497,61291,3578762390,3578762390,0
0,1497,61292,3578762390,3578762390,0
0,1497,61293,3578762390,3578762390,0
0,1497,61294,3578762390,3578762390,0
0,1497,61295,3578762390,3578762391,1
0,1497,61296,3578762390,3578762393,3
0,1497,61297,3578762390,3578762393,3
0,1497,61298,3578762390,3578762394,4
0,1497,61299,3578762390,3578762394,4
0,1497,61300,3578762390,3578762394,4
0,1497,61301,3578762390,3578762394,4
0,1497,61302,3578762390,3578762396,6
0,1497,61303,3578762390,3578762397,7
0,1497,61304,3578762390,3578762398,8
0,1497,61305,3578762390,3578762399,9
0,1497,61306,3578762390,3578762400,10
0,1497,61307,3578762390,3578762401,11
0,1497,61308,3578762390,3578762402,12
0,1497,61309,3578762390,3578762403,13
0,1497,61310,3578762390,3578762403,13
0,1497,61311,3578762390,3578762404,14
0,1497,61312,3578762390,3578762404,14
0,1497,61313,3578762390,3578762404,14
0,1497,61314,3578762390,3578762405,15
0,1497,61315,3578762390,3578762405,15
0,1497,61316,3578762390,3578762406,16
0,1497,61317,3578762390,3578762407,17
0,1497,61318,3578762390,3578762407,17
0,1497,61319,3578762390,3578762407,17
0,1497,61320,3578762390,3578762409,19
0,1497,61321,3578762390,3578762410,20
0,1497,61322,3578762390,3578762411,21
0,1497,61323,3578762390,3578762412,22
0,1497,61324,3578762390,3578762412,22
0,1497,61325,3578762390,3578762412,22
0,1497,61326,3578762390,3578762412,22
0,1497,61327,3578762390,3578762414,24
0,1497,61328,3578762390,3578762414,24
0,1497,61329,3578762390,3578762414,24
0,1497,61330,3578762390,3578762415,25
0,1497,61331,3578762390,3578762416,26
0,1497,61332,3578762390,3578762416,26
0,1497,61333,3578762390,3578762417,27
0,1497,61334,3578762390,3578762417,27
0,1497,61335,3578762390,3578762418,28
0,1497,61336,3578762390,3578762419,29
0,1497,61337,3578762390,3578762419,29
0,1497,61338,3578762390,3578762420,30
0,1497,61339,3578762390,3578762420,30
0,1497,61340,3578762390,3578762420,30
0,1497,61341,3578762390,3578762421,31
0,1497,61342,3578762390,3578762422,32
0,1497,61343,3578762390,3578762422,32
0,1497,61344,3578762390,3578762423,33
0,1497,61345,3578762390,3578762424,34
0,1497,61346,3578762390,3578762424,34
0,1497,61347,3578762390,3578762425,35
0,1497,61348,3578762390,3578762427,37
0,1497,61349,3578762390,3578762427,37
0,1497,61350,3578762390,3578762428,38
0,1497,61351,3578762390,3578762428,38
0,1497,61352,3578762390,3578762428,38
0,1497,61353,3578762390,3578762429,39
0,1497,61354,3578762390,3578762430,40
0,1497,61355,3578762390,3578762430,40
0,1497,61356,3578762390,3578762431,41
0,1497,61357,3578762390,3578762432,42
0,1497,61358,3578762390,3578762432,42
0,1497,61359,3578762390,3578762432,42
0,1497,61360,3578762390,3578762434,44
0,1497,61361,3578762390,3578762434,44
0,1497,61362,3578762390,3578762434,44
0,1497,61363,3578762390,3578762435,45
0,1497,61364,3578762390,3578762435,45
0,1497,61365,3578762390,3578762437,47
0,1497,61366,3578762390,3578762438,48
0,1497,61367,3578762390,3578762439,49
0,1497,61368,3578762390,3578762439,49
0,1497,61369,3578762390,3578762440,50
0,1498,61370,3578762455,3578762455,0
0,1498,61371,3578762455,3578762455,0
0,1498,61372,3578762455,3578762455,0
0,1498,61373,3578762455,3578762455,0
0,1498,61374,3578762455,3578762455,0
0,1498,61375,3578762455,3578762455,0
0,1498,61376,3578762455,3578762455,0
0,1498,61377,3578762455,3578762455,0
0,1498,61378,3578762455,3578762455,0
0,1498,61379,3578762455,3578762455,0
0,1498,61380,3578762455,3578762455,0
0,1498,61381,3578762455,3578762455,0
0,1498,61382,3578762455,3578762455,0
0,1498,61383,3578762455,3578762455,0
0,1498,61384,3578762455,3578762455,0
0,1498,61385,3578762455,3578762455,0
0,1498,61386,3578762455,3578762455,0
0,1498,61387,3578762455,3578762455,0
0,1498,61388,3578762455,3578762455,0
0,1498,61389,3578762455,3578762455,0
0,1498,61390,3578762455,3578762455,0
0,1498,61391,3578762455,3578762455,0
0,1498,61392,3578762455,3578762455,0
0,1498,61393,3578762455,3578762455,0
0,1498,61394,3578762455,3578762456,1
0,1498,61395,3578762455,3578762457,2
0,1498,61396,3578762455,3578762458,3
0,1498,61397,3578762455,3578762459,4
0,1498,61398,3578762455,3578762459,4
0,1498,61399,3578762455,3578762459,4
0,1498,61400,3578762455,3578762459,4
0,1498,61401,3578762455,3578762460,5
0,1498,61402,3578762455,3578762461,6
0,1498,61403,3578762455,3578762462,7
0,1498,61404,3578762455,3578762462,7
0,1498,61405,3578762455,3578762463,8
0,1498,61406,3578762455,3578762464,9
0,1498,61407,3578762455,3578762464,9
0,1498,61408,3578762455,3578762464,9
0,1498,61409,3578762455,3578762465,10
0,1498,61410,3578762455,3578762465,10
0,1498,61411,3578762455,3578762465,10
0,1498,61412,3578762455,3578762466,11
0,1498,61413,3578762455,3578762466,11
0,1498,61414,3578762455,3578762467,12
0,1498,61415,3578762455,3578762467,12
0,1498,61416,3578762455,3578762468,13
0,1498,61417,3578762455,3578762468,13
0,1498,61418,3578762455,3578762470,15
0,1498,61419,3578762455,3578762471,16
0,1498,61420,3578762455,3578762483,28
0,1498,61421,3578762455,3578762484,29
0,1498,61422,3578762455,3578762487,32
0,1498,61423,3578762455,3578762488,33
0,1498,61424,3578762455,3578762488,33
0,1498,61425,3578762455,3578762489,34
0,1498,61426,3578762455,3578762489,34
0,1498,61427,3578762455,3578762489,34
0,1498,61428,3578762455,3578762489,34
0,1498,61429,3578762455,3578762490,35
0,1498,61430,3578762455,3578762490,35
0,1498,61431,3578762455,3578762491,36
0,1498,61432,3578762455,3578762492,37
0,1498,61433,3578762455,3578762492,37
0,1498,61434,3578762455,3578762492,37
0,1498,61435,3578762455,3578762492,37
0,1498,61436,3578762455,3578762494,39
0,1498,61437,3578762455,3578762494,39
0,1498,61438,3578762455,3578762494,39
0,1498,61439,3578762455,3578762494,39
0,1498,61440,3578762455,3578762495,40
0,1498,61441,3578762455,3578762495,40
0,1498,61442,3578762455,3578762495,40
0,1498,61443,3578762455,3578762495,40
0,1498,61444,3578762455,3578762496,41
0,1498,61445,3578762455,3578762499,44
0,1498,61446,3578762455,3578762499,44
0,1498,61447,3578762455,3578762499,44
0,1498,61448,3578762455,3578762499,44
0,1498,61449,3578762455,3578762499,44
0,1498,61450,3578762455,3578762499,44
0,1498,61451,3578762455,3578762502,47
0,1498,61452,3578762455,3578762504,49
0,1498,61453,3578762455,3578762505,50
0,1498,61454,3578762455,3578762505,50
0,1499,61455,3578762519,3578762519,0
0,1499,61456,3578762519,3578762519,0
0,1499,61457,3578762519,3578762519,0
0,1499,61458,3578762519,3578762519,0
0,1499,61459,3578762519,3578762519,0
0,1499,61460,3578762519,3578762519,0
0,1499,61461,3578762519,3578762519,0
0,1499,61462,3578762519,3578762519,0
0,1499,61463,3578762519,3578762519,0
0,1499,61464,3578762519,3578762519,0
0,1499,61465,3578762519,3578762519,0
0,1499,61466,3578762519,3578762519,0
0,1499,61467,3578762519,3578762519,0
0,1499,61468,3578762519,3578762519,0
0,1499,61469,3578762519,3578762519,0
0,1499,61470,3578762519,3578762519,0
0,1499,61471,3578762519,3578762519,0
0,1499,61472,3578762519,3578762519,0
0,1499,61473,3578762519,3578762519,0
0,1499,61474,3578762519,3578762519,0
0,1499,61475,3578762519,3578762519,0
0,1499,61476,3578762519,3578762519,0
0,1499,61477,3578762519,3578762519,0
0,1499,61478,3578762519,3578762519,0
0,1499,61479,3578762519,3578762519,0
0,1499,61480,3578762519,3578762519,0
0,1499,61481,3578762519,3578762519,0
0,1499,61482,3578762519,3578762519,0
0,1499,61483,3578762519,3578762519,0
0,1499,61484,3578762519,3578762519,0
0,1499,61485,3578762519,3578762519,0
0,1499,61486,3578762519,3578762519,0
0,1499,61487,3578762519,3578762519,0
0,1499,61488,3578762519,3578762519,0
0,1499,61489,3578762519,3578762519,0
0,1499,61490,3578762519,3578762519,0
0,1499,61491,3578762519,3578762519,0
0,1499,61492,3578762519,3578762519,0
0,1499,61493,3578762519,3578762519,0
0,1499,61494,3578762519,3578762520,1
0,1499,61495,3578762519,3578762521,2
0,1499,61496,3578762519,3578762523,4
0,1499,61497,3578762519,3578762523,4
0,1499,61498,3578762519,3578762524,5
0,1499,61499,3578762519,3578762524,5
0,1499,61500,3578762519,3578762525,6
0,1499,61501,3578762519,3578762525,6
0,1499,61502,3578762519,3578762525,6
0,1499,61503,3578762519,3578762526,7
0,1499,61504,3578762519,3578762526,7
0,1499,61505,3578762519,3578762526,7
0,1499,61506,3578762519,3578762526,7
0,1499,61507,3578762519,3578762527,8
0,1499,61508,3578762519,3578762527,8
0,1499,61509,3578762519,3578762527,8
0,1499,61510,3578762519,3578762528,9
0,1499,61511,3578762519,3578762529,10
0,1499,61512,3578762519,3578762529,10
0,1499,61513,3578762519,3578762529,10
0,1499,61514,3578762519,3578762530,11
0,1499,61515,3578762519,3578762530,11
0,1499,61516,3578762519,3578762530,11
0,1499,61517,3578762519,3578762530,11
0,1499,61518,3578762519,3578762531,12
0,1499,61519,3578762519,3578762531,12
0,1499,61520,3578762519,3578762531,12
0,1499,61521,3578762519,3578762532,13
0,1499,61522,3578762519,3578762532,13
0,1499,61523,3578762519,3578762533,14
0,1499,61524,3578762519,3578762534,15
0,1499,61525,3578762519,3578762534,15
0,1499,61526,3578762519,3578762535,16
0,1499,61527,3578762519,3578762535,16
0,1499,61528,3578762519,3578762536,17
0,1499,61529,3578762519,3578762536,17
0,1499,61530,3578762519,3578762536,17
0,1499,61531,3578762519,3578762539,20
0,1499,61532,3578762519,3578762539,20
0,1499,61533,3578762519,3578762539,20
0,1499,61534,3578762519,3578762539,20
0,1499,61535,3578762519,3578762540,21
0,1499,61536,3578762519,3578762540,21
0,1499,61537,3578762519,3578762542,23
0,1499,61538,3578762519,3578762542,23
0,1499,61539,3578762519,3578762543,24
0,1499,61540,3578762519,3578762543,24
0,1499,61541,3578762519,3578762543,24
0,1499,61542,3578762519,3578762543,24
0,1499,61543,3578762519,3578762544,25
0,1499,61544,3578762519,3578762545,26
0,1499,61545,3578762519,3578762545,26
0,1499,61546,3578762519,3578762546,27
0,1499,61547,3578762519,3578762546,27
0,1499,61548,3578762519,3578762547,28
0,1499,61549,3578762519,3578762547,28
0,1499,61550,3578762519,3578762547,28
0,1499,61551,3578762519,3578762548,29
0,1499,61552,3578762519,3578762549,30
0,1499,61553,3578762519,3578762550,31
0,1499,61554,3578762519,3578762551,32
0,1499,61555,3578762519,3578762552,33
0,1499,61556,3578762519,3578762552,33
0,1499,61557,3578762519,3578762552,33
0,1499,61558,3578762519,3578762552,33
0,1499,61559,3578762519,3578762553,34
0,1499,61560,3578762519,3578762554,35
0,1499,61561,3578762519,3578762554,35
0,1499,61562,3578762519,3578762555,36
0,1499,61563,3578762519,3578762556,37
0,1499,61564,3578762519,3578762556,37
0,1499,61565,3578762519,3578762557,38
0,1499,61566,3578762519,3578762557,38
0,1499,61567,3578762519,3578762557,38
0,1499,61568,3578762519,3578762557,38
0,1499,61569,3578762519,3578762558,39
0,1499,61570,3578762519,3578762559,40
0,1499,61571,3578762519,3578762559,40
0,1499,61572,3578762519,3578762560,41
0,1499,61573,3578762519,3578762560,41
0,1499,61574,3578762519,3578762560,41
0,1499,61575,3578762519,3578762560,41
0,1499,61576,3578762519,3578762561,42
0,1499,61577,3578762519,3578762561,42
0,1499,61578,3578762519,3578762562,43
0,1499,61579,3578762519,3578762562,43
0,1499,61580,3578762519,3578762562,43
0,1499,61581,3578762519,3578762564,45
0,1499,61582,3578762519,3578762564,45
0,1499,61583,3578762519,3578762567,48
0,1499,61584,3578762519,3578762568,49
0,1499,61585,3578762519,3578762568,49
0,1499,61586,3578762519,3578762569,50
0,1499,61587,3578762519,3578762569,50
0,1500,61588,3578762583,3578762583,0
0,1500,61589,3578762583,3578762583,0
0,1500,61590,3578762583,3578762583,0
0,1500,61591,3578762583,3578762583,0
0,1500,61592,3578762583,3578762583,0
0,1500,61593,3578762583,3578762583,0
0,1500,61594,3578762583,3578762583,0
0,1500,61595,3578762583,3578762583,0
0,1500,61596,3578762583,3578762583,0
0,1500,61597,3578762583,3578762583,0
0,1500,61598,3578762583,3578762583,0
0,1500,61599,3578762583,3578762583,0
0,1500,61600,3578762583,3578762583,0
0,1500,61601,3578762583,3578762583,0
0,1500,61602,3578762583,3578762583,0
0,1500,61603,3578762583,3578762583,0
0,1500,61604,3578762583,3578762583,0
0,1500,61605,3578762583,3578762585,2
0,1500,61606,3578762583,3578762585,2
0,1500,61607,3578762583,3578762585,2
0,1500,61608,3578762583,3578762587,4
0,1500,61609,3578762583,3578762588,5
0,1500,61610,3578762583,3578762589,6
0,1500,61611,3578762583,3578762589,6
0,1500,61612,3578762583,3578762590,7
0,1500,61613,3578762583,3578762590,7
0,1500,61614,3578762583,3578762591,8
0,1500,61615,3578762583,3578762592,9
0,1500,61616,3578762583,3578762593,10
0,1500,61617,3578762583,3578762593,10
0,1500,61618,3578762583,3578762593,10
0,1500,61619,3578762583,3578762593,10
0,1500,61620,3578762583,3578762595,12
0,1500,61621,3578762583,3578762596,13
0,1500,61622,3578762583,3578762597,14
0,1500,61623,3578762583,3578762598,15
0,1500,61624,3578762583,3578762598,15
0,1500,61625,3578762583,3578762599,16
0,1500,61626,3578762583,3578762600,17
0,1500,61627,3578762583,3578762601,18
0,1500,61628,3578762583,3578762602,19
0,1500,61629,3578762583,3578762602,19
0,1500,61630,3578762583,3578762603,20
0,1500,61631,3578762583,3578762603,20
0,1500,61632,3578762583,3578762604,21
0,1500,61633,3578762583,3578762604,21
0,1500,61634,3578762583,3578762605,22
0,1500,61635,3578762583,3578762606,23
0,1500,61636,3578762583,3578762606,23
0,1500,61637,3578762583,3578762607,24
0,1500,61638,3578762583,3578762608,25
0,1500,61639,3578762583,3578762610,27
0,1500,61640,3578762583,3578762610,27
0,1500,61641,3578762583,3578762611,28
0,1500,61642,3578762583,3578762611,28
0,1500,61643,3578762583,3578762612,29
0,1500,61644,3578762583,3578762612,29
0,1500,61645,3578762583,3578762613,30
0,1500,61646,3578762583,3578762614,31
0,1500,61647,3578762583,3578762614,31
0,1500,61648,3578762583,3578762615,32
0,1500,61649,3578762583,3578762615,32
0,1500,61650,3578762583,3578762616,33
0,1500,61651,3578762583,3578762617,34
0,1500,61652,3578762583,3578762618,35
0,1500,61653,3578762583,3578762618,35
0,1500,61654,3578762583,3578762619,36
0,1500,61655,3578762583,3578762619,36
0,1500,61656,3578762583,3578762619,36
0,1500,61657,3578762583,3578762620,37
0,1500,61658,3578762583,3578762620,37
0,1500,61659,3578762583,3578762621,38
0,1500,61660,3578762583,3578762621,38
0,1500,61661,3578762583,3578762621,38
0,1500,61662,3578762583,3578762623,40
0,1500,61663,3578762583,3578762623,40
0,1500,61664,3578762583,3578762624,41
0,1500,61665,3578762583,3578762626,43
0,1500,61666,3578762583,3578762627,44
0,1500,61667,3578762583,3578762628,45
0,1500,61668,3578762583,3578762629,46
0,1500,61669,3578762583,3578762629,46
0,1500,61670,3578762583,3578762630,47
0,1500,61671,3578762583,3578762630,47
0,1500,61672,3578762583,3578762631,48
0,1500,61673,3578762583,3578762631,48
0,1500,61674,3578762583,3578762632,49
0,1500,61675,3578762583,3578762632,49
0,1501,61676,3578762649,3578762649,0
0,1501,61677,3578762649,3578762649,0
0,1501,61678,3578762649,3578762649,0
0,1501,61679,3578762649,3578762649,0
0,1501,61680,3578762649,3578762649,0
0,1501,61681,3578762649,3578762649,0
0,1501,61682,3578762649,3578762649,0
0,1501,61683,3578762649,3578762649,0
0,1501,61684,3578762649,3578762649,0
0,1501,61685,3578762649,3578762649,0
0,1501,61686,3578762649,3578762649,0
0,1501,61687,3578762649,3578762649,0
0,1501,61688,3578762649,3578762649,0
0,1501,61689,3578762649,3578762649,0
0,1501,61690,3578762649,3578762649,0
0,1501,61691,3578762649,3578762649,0
0,1501,61692,3578762649,3578762649,0
0,1501,61693,3578762649,3578762649,0
0,1501,61694,3578762649,3578762649,0
0,1501,61695,3578762649,3578762649,0
0,1501,61696,3578762649,3578762649,0
0,1501,61697,3578762649,3578762649,0
0,1501,61698,3578762649,3578762649,0
0,1501,61699,3578762649,3578762649,0
0,1501,61700,3578762649,3578762649,0
0,1501,61701,3578762649,3578762649,0
0,1501,61702,3578762649,3578762649,0
0,1501,61703,3578762649,3578762649,0
0,1501,61704,3578762649,3578762649,0
0,1501,61705,3578762649,3578762649,0
0,1501,61706,3578762649,3578762649,0
0,1501,61707,3578762649,3578762649,0
0,1501,61708,3578762649,3578762649,0
0,1501,61709,3578762649,3578762649,0
0,1501,61710,3578762649,3578762650,1
0,1501,61711,3578762649,3578762651,2
0,1501,61712,3578762649,3578762652,3
0,1501,61713,3578762649,3578762654,5
0,1501,61714,3578762649,3578762655,6
0,1501,61715,3578762649,3578762655,6
0,1501,61716,3578762649,3578762656,7
0,1501,61717,3578762649,3578762658,9
0,1501,61718,3578762649,3578762658,9
0,1501,61719,3578762649,3578762658,9
0,1501,61720,3578762649,3578762658,9
0,1501,61721,3578762649,3578762658,9
0,1501,61722,3578762649,3578762659,10
0,1501,61723,3578762649,3578762661,12
0,1501,61724,3578762649,3578762661,12
0,1501,61725,3578762649,3578762662,13
0,1501,61726,3578762649,3578762662,13
0,1501,61727,3578762649,3578762663,14
0,1501,61728,3578762649,3578762663,14
0,1501,61729,3578762649,3578762664,15
0,1501,61730,3578762649,3578762664,15
0,1501,61731,3578762649,3578762664,15
0,1501,61732,3578762649,3578762664,15
0,1501,61733,3578762649,3578762664,15
0,1501,61734,3578762649,3578762665,16
0,1501,61735,3578762649,3578762666,17
0,1501,61736,3578762649,3578762667,18
0,1501,61737,3578762649,3578762667,18
0,1501,61738,3578762649,3578762669,20
0,1501,61739,3578762649,3578762670,21
0,1501,61740,3578762649,3578762683,34
0,1501,61741,3578762649,3578762683,34
0,1501,61742,3578762649,3578762688,39
0,1501,61743,3578762649,3578762688,39
0,1501,61744,3578762649,3578762689,40
0,1501,61745,3578762649,3578762689,40
0,1501,61746,3578762649,3578762689,40
0,1501,61747,3578762649,3578762689,40
0,1501,61748,3578762649,3578762690,41
0,1501,61749,3578762649,3578762690,41
0,1501,61750,3578762649,3578762691,42
0,1501,61751,3578762649,3578762692,43
0,1501,61752,3578762649,3578762692,43
0,1501,61753,3578762649,3578762693,44
0,1501,61754,3578762649,3578762693,44
0,1501,61755,3578762649,3578762694,45
0,1501,61756,3578762649,3578762694,45
0,1501,61757,3578762649,3578762695,46
0,1501,61758,3578762649,3578762695,46
0,1501,61759,3578762649,3578762695,46
0,1501,61760,3578762649,3578762696,47
0,1501,61761,3578762649,3578762696,47
0,1501,61762,3578762649,3578762698,49
0,1501,61763,3578762649,3578762699,50
0,1502,61764,3578762714,3578762714,0
0,1502,61765,3578762714,3578762714,0
0,1502,61766,3578762714,3578762714,0
0,1502,61767,3578762714,3578762714,0
0,1502,61768,3578762714,3578762714,0
0,1502,61769,3578762714,3578762714,0
0,1502,61770,3578762714,3578762714,0
0,1502,61771,3578762714,3578762714,0
0,1502,61772,3578762714,3578762714,0
0,1502,61773,3578762714,3578762714,0
0,1502,61774,3578762714,3578762714,0
0,1502,61775,3578762714,3578762714,0
0,1502,61776,3578762714,3578762714,0
0,1502,61777,3578762714,3578762714,0
0,1502,61778,3578762714,3578762714,0
0,1502,61779,3578762714,3578762714,0
0,1502,61780,3578762714,3578762714,0
0,1502,61781,3578762714,3578762714,0
0,1502,61782,3578762714,3578762714,0
0,1502,61783,3578762714,3578762714,0
0,1502,61784,3578762714,3578762714,0
0,1502,61785,3578762714,3578762714,0
0,1502,61786,3578762714,3578762714,0
0,1502,61787,3578762714,3578762714,0
0,1502,61788,3578762714,3578762714,0
0,1502,61789,3578762714,3578762714,0
0,1502,61790,3578762714,3578762714,0
0,1502,61791,3578762714,3578762714,0
0,1502,61792,3578762714,3578762714,0
0,1502,61793,3578762714,3578762714,0
0,1502,61794,3578762714,3578762714,0
0,1502,61795,3578762714,3578762715,1
0,1502,61796,3578762714,3578762716,2
0,1502,61797,3578762714,3578762716,2
0,1502,61798,3578762714,3578762716,2
0,1502,61799,3578762714,3578762716,2
0,1502,61800,3578762714,3578762717,3
0,1502,61801,3578762714,3578762718,4
0,1502,61802,3578762714,3578762718,4
0,1502,61803,3578762714,3578762718,4
0,1502,61804,3578762714,3578762719,5
0,1502,61805,3578762714,3578762719,5
0,1502,61806,3578762714,3578762720,6
0,1502,61807,3578762714,3578762722,8
0,1502,61808,3578762714,3578762722,8
0,1502,61809,3578762714,3578762723,9
0,1502,61810,3578762714,3578762723,9
0,1502,61811,3578762714,3578762724,10
0,1502,61812,3578762714,3578762725,11
0,1502,61813,3578762714,3578762725,11
0,1502,61814,3578762714,3578762725,11
0,1502,61815,3578762714,3578762725,11
0,1502,61816,3578762714,3578762726,12
0,1502,61817,3578762714,3578762726,12
0,1502,61818,3578762714,3578762726,12
0,1502,61819,3578762714,3578762727,13
0,1502,61820,3578762714,3578762727,13
0,1502,61821,3578762714,3578762727,13
0,1502,61822,3578762714,3578762728,14
0,1502,61823,3578762714,3578762728,14
0,1502,61824,3578762714,3578762728,14
0,1502,61825,3578762714,3578762728,14
0,1502,61826,3578762714,3578762729,15
0,1502,61827,3578762714,3578762729,15
0,1502,61828,3578762714,3578762730,16
0,1502,61829,3578762714,3578762730,16
0,1502,61830,3578762714,3578762731,17
0,1502,61831,3578762714,3578762731,17
0,1502,61832,3578762714,3578762731,17
0,1502,61833,3578762714,3578762731,17
0,1502,61834,3578762714,3578762732,18
0,1502,61835,3578762714,3578762733,19
0,1502,61836,3578762714,3578762735,21
0,1502,61837,3578762714,3578762735,21
0,1502,61838,3578762714,3578762735,21
0,1502,61839,3578762714,3578762736,22
0,1502,61840,3578762714,3578762736,22
0,1502,61841,3578762714,3578762736,22
0,1502,61842,3578762714,3578762738,24
0,1502,61843,3578762714,3578762739,25
0,1502,61844,3578762714,3578762739,25
0,1502,61845,3578762714,3578762739,25
0,1502,61846,3578762714,3578762739,25
0,1502,61847,3578762714,3578762740,26
0,1502,61848,3578762714,3578762741,27
0,1502,61849,3578762714,3578762741,27
0,1502,61850,3578762714,3578762742,28
0,1502,61851,3578762714,3578762743,29
0,1502,61852,3578762714,3578762743,29
0,1502,61853,3578762714,3578762743,29
0,1502,61854,3578762714,3578762743,29
0,1502,61855,3578762714,3578762743,29
0,1502,61856,3578762714,3578762744,30
0,1502,61857,3578762714,3578762745,31
0,1502,61858,3578762714,3578762746,32
0,1502,61859,3578762714,3578762746,32
0,1502,61860,3578762714,3578762746,32
0,1502,61861,3578762714,3578762747,33
0,1502,61862,3578762714,3578762747,33
0,1502,61863,3578762714,3578762747,33
0,1502,61864,3578762714,3578762748,34
0,1502,61865,3578762714,3578762749,35
0,1502,61866,3578762714,3578762750,36
0,1502,61867,3578762714,3578762752,38
0,1502,61868,3578762714,3578762752,38
0,1502,61869,3578762714,3578762752,38
0,1502,61870,3578762714,3578762752,38
0,1502,61871,3578762714,3578762752,38
0,1502,61872,3578762714,3578762753,39
0,1502,61873,3578762714,3578762753,39
0,1502,61874,3578762714,3578762754,40
0,1502,61875,3578762714,3578762755,41
0,1502,61876,3578762714,3578762756,42
0,1502,61877,3578762714,3578762756,42
0,1502,61878,3578762714,3578762757,43
0,1502,61879,3578762714,3578762758,44
0,1502,61880,3578762714,3578762759,45
0,1502,61881,3578762714,3578762759,45
0,1502,61882,3578762714,3578762759,45
0,1502,61883,3578762714,3578762760,46
0,1502,61884,3578762714,3578762760,46
0,1502,61885,3578762714,3578762760,46
0,1502,61886,3578762714,3578762760,46
0,1502,61887,3578762714,3578762761,47
0,1502,61888,3578762714,3578762762,48
0,1502,61889,3578762714,3578762763,49
0,1502,61890,3578762714,3578762764,50
0,1503,61891,3578762778,3578762778,0
0,1503,61892,3578762778,3578762778,0
0,1503,61893,3578762778,3578762778,0
0,1503,61894,3578762778,3578762778,0
0,1503,61895,3578762778,3578762778,0
0,1503,61896,3578762778,3578762778,0
0,1503,61897,3578762778,3578762778,0
0,1503,61898,3578762778,3578762778,0
0,1503,61899,3578762778,3578762778,0
0,1503,61900,3578762778,3578762778,0
0,1503,61901,3578762778,3578762778,0
0,1503,61902,3578762778,3578762778,0
0,1503,61903,3578762778,3578762778,0
0,1503,61904,3578762778,3578762778,0
0,1503,61905,3578762778,3578762778,0
0,1503,61906,3578762778,3578762778,0
0,1503,61907,3578762778,3578762778,0
0,1503,61908,3578762778,3578762779,1
0,1503,61909,3578762778,3578762780,2
0,1503,61910,3578762778,3578762781,3
0,1503,61911,3578762778,3578762782,4
0,1503,61912,3578762778,3578762783,5
0,1503,61913,3578762778,3578762783,5
0,1503,61914,3578762778,3578762786,8
0,1503,61915,3578762778,3578762787,9
0,1503,61916,3578762778,3578762787,9
0,1503,61917,3578762778,3578762789,11
0,1503,61918,3578762778,3578762789,11
0,1503,61919,3578762778,3578762790,12
0,1503,61920,3578762778,3578762790,12
0,1503,61921,3578762778,3578762791,13
0,1503,61922,3578762778,3578762791,13
0,1503,61923,3578762778,3578762792,14
0,1503,61924,3578762778,3578762793,15
0,1503,61925,3578762778,3578762793,15
0,1503,61926,3578762778,3578762793,15
0,1503,61927,3578762778,3578762795,17
0,1503,61928,3578762778,3578762796,18
0,1503,61929,3578762778,3578762797,19
0,1503,61930,3578762778,3578762797,19
0,1503,61931,3578762778,3578762799,21
0,1503,61932,3578762778,3578762799,21
0,1503,61933,3578762778,3578762800,22
0,1503,61934,3578762778,3578762801,23
0,1503,61935,3578762778,3578762801,23
0,1503,61936,3578762778,3578762802,24
0,1503,61937,3578762778,3578762802,24
0,1503,61938,3578762778,3578762803,25
0,1503,61939,3578762778,3578762803,25
0,1503,61940,3578762778,3578762804,26
0,1503,61941,3578762778,3578762805,27
0,1503,61942,3578762778,3578762805,27
0,1503,61943,3578762778,3578762806,28
0,1503,61944,3578762778,3578762807,29
0,1503,61945,3578762778,3578762808,30
0,1503,61946,3578762778,3578762808,30
0,1503,61947,3578762778,3578762810,32
0,1503,61948,3578762778,3578762811,33
0,1503,61949,3578762778,3578762811,33
0,1503,61950,3578762778,3578762812,34
0,1503,61951,3578762778,3578762813,35
0,1503,61952,3578762778,3578762813,35
0,1503,61953,3578762778,3578762814,36
0,1503,61954,3578762778,3578762815,37
0,1503,61955,3578762778,3578762815,37
0,1503,61956,3578762778,3578762816,38
0,1503,61957,3578762778,3578762816,38
0,1503,61958,3578762778,3578762817,39
0,1503,61959,3578762778,3578762817,39
0,1503,61960,3578762778,3578762818,40
0,1503,61961,3578762778,3578762818,40
0,1503,61962,3578762778,3578762819,41
0,1503,61963,3578762778,3578762819,41
0,1503,61964,3578762778,3578762819,41
0,1503,61965,3578762778,3578762820,42
0,1503,61966,3578762778,3578762820,42
0,1503,61967,3578762778,3578762820,42
0,1503,61968,3578762778,3578762821,43
0,1503,61969,3578762778,3578762821,43
0,1503,61970,3578762778,3578762821,43
0,1503,61971,3578762778,3578762822,44
0,1503,61972,3578762778,3578762823,45
0,1503,61973,3578762778,3578762824,46
0,1503,61974,3578762778,3578762827,49
0,1503,61975,3578762778,3578762827,49
0,1503,61976,3578762778,3578762827,49
0,1503,61977,3578762778,3578762828,50
0,1504,61978,3578762844,3578762844,0
0,1504,61979,3578762844,3578762844,0
0,1504,61980,3578762844,3578762844,0
0,1504,61981,3578762844,3578762844,0
0,1504,61982,3578762844,3578762844,0
0,1504,61983,3578762844,3578762844,0
0,1504,61984,3578762844,3578762844,0
0,1504,61985,3578762844,3578762845,1
0,1504,61986,3578762844,3578762845,1
0,1504,61987,3578762844,3578762845,1
0,1504,61988,3578762844,3578762845,1
0,1504,61989,3578762844,3578762845,1
0,1504,61990,3578762844,3578762845,1
0,1504,61991,3578762844,3578762845,1
0,1504,61992,3578762844,3578762845,1
0,1504,61993,3578762844,3578762845,1
0,1504,61994,3578762844,3578762845,1
0,1504,61995,3578762844,3578762845,1
0,1504,61996,3578762844,3578762845,1
0,1504,61997,3578762844,3578762845,1
0,1504,61998,3578762844,3578762845,1
0,1504,61999,3578762844,3578762845,1
0,1504,62000,3578762844,3578762845,1
0,1504,62001,3578762844,3578762845,1
0,1504,62002,3578762844,3578762845,1
0,1504,62003,3578762844,3578762845,1
0,1504,62004,3578762844,3578762845,1
0,1504,62005,3578762844,3578762845,1
0,1504,62006,3578762844,3578762845,1
0,1504,62007,3578762844,3578762845,1
0,1504,62008,3578762844,3578762845,1
0,1504,62009,3578762844,3578762845,1
0,1504,62010,3578762844,3578762845,1
0,1504,62011,3578762844,3578762845,1
0,1504,62012,3578762844,3578762847,3
0,1504,62013,3578762844,3578762847,3
0,1504,62014,3578762844,3578762848,4
0,1504,62015,3578762844,3578762848,4
0,1504,62016,3578762844,3578762849,5
0,1504,62017,3578762844,3578762849,5
0,1504,62018,3578762844,3578762849,5
0,1504,62019,3578762844,3578762849,5
0,1504,62020,3578762844,3578762849,5
0,1504,62021,3578762844,3578762850,6
0,1504,62022,3578762844,3578762851,7
0,1504,62023,3578762844,3578762852,8
0,1504,62024,3578762844,3578762854,10
0,1504,62025,3578762844,3578762855,11
0,1504,62026,3578762844,3578762856,12
0,1504,62027,3578762844,3578762857,13
0,1504,62028,3578762844,3578762858,14
0,1504,62029,3578762844,3578762858,14
0,1504,62030,3578762844,3578762858,14
0,1504,62031,3578762844,3578762859,15
0,1504,62032,3578762844,3578762859,15
0,1504,62033,3578762844,3578762861,17
0,1504,62034,3578762844,3578762861,17
0,1504,62035,3578762844,3578762862,18
0,1504,62036,3578762844,3578762862,18
0,1504,62037,3578762844,3578762863,19
0,1504,62038,3578762844,3578762863,19
0,1504,62039,3578762844,3578762863,19
0,1504,62040,3578762844,3578762864,20
0,1504,62041,3578762844,3578762864,20
0,1504,62042,3578762844,3578762865,21
0,1504,62043,3578762844,3578762865,21
0,1504,62044,3578762844,3578762866,22
0,1504,62045,3578762844,3578762867,23
0,1504,62046,3578762844,3578762867,23
0,1504,62047,3578762844,3578762869,25
0,1504,62048,3578762844,3578762869,25
0,1504,62049,3578762844,3578762869,25
0,1504,62050,3578762844,3578762882,38
0,1504,62051,3578762844,3578762882,38
0,1504,62052,3578762844,3578762883,39
0,1504,62053,3578762844,3578762887,43
0,1504,62054,3578762844,3578762888,44
0,1504,62055,3578762844,3578762889,45
0,1504,62056,3578762844,3578762889,45
0,1504,62057,3578762844,3578762889,45
0,1504,62058,3578762844,3578762889,45
0,1504,62059,3578762844,3578762890,46
0,1504,62060,3578762844,3578762891,47
0,1504,62061,3578762844,3578762892,48
0,1504,62062,3578762844,3578762892,48
0,1504,62063,3578762844,3578762893,49
0,1504,62064,3578762844,3578762894,50
0,1505,62065,3578762909,3578762909,0
0,1505,62066,3578762909,3578762909,0
0,1505,62067,3578762909,3578762909,0
0,1505,62068,3578762909,3578762909,0
0,1505,62069,3578762909,3578762909,0
0,1505,62070,3578762909,3578762909,0
0,1505,62071,3578762909,3578762909,0
0,1505,62072,3578762909,3578762909,0
0,1505,62073,3578762909,3578762909,0
0,1505,62074,3578762909,3578762909,0
0,1505,62075,3578762909,3578762909,0
0,1505,62076,3578762909,3578762909,0
0,1505,62077,3578762909,3578762909,0
0,1505,62078,3578762909,3578762909,0
0,1505,62079,3578762909,3578762909,0
0,1505,62080,3578762909,3578762909,0
0,1505,62081,3578762909,3578762909,0
0,1505,62082,3578762909,3578762909,0
0,1505,62083,3578762909,3578762909,0
0,1505,62084,3578762909,3578762909,0
0,1505,62085,3578762909,3578762909,0
0,1505,62086,3578762909,3578762909,0
0,1505,62087,3578762909,3578762909,0
0,1505,62088,3578762909,3578762909,0
0,1505,62089,3578762909,3578762909,0
0,1505,62090,3578762909,3578762909,0
0,1505,62091,3578762909,3578762909,0
0,1505,62092,3578762909,3578762909,0
0,1505,62093,3578762909,3578762909,0
0,1505,62094,3578762909,3578762910,1
0,1505,62095,3578762909,3578762910,1
0,1505,62096,3578762909,3578762910,1
0,1505,62097,3578762909,3578762911,2
0,1505,62098,3578762909,3578762911,2
0,1505,62099,3578762909,3578762912,3
0,1505,62100,3578762909,3578762912,3
0,1505,62101,3578762909,3578762913,4
0,1505,62102,3578762909,3578762913,4
0,1505,62103,3578762909,3578762915,6
0,1505,62104,3578762909,3578762915,6
0,1505,62105,3578762909,3578762915,6
0,1505,62106,3578762909,3578762915,6
0,1505,62107,3578762909,3578762916,7
0,1505,62108,3578762909,3578762917,8
0,1505,62109,3578762909,3578762917,8
0,1505,62110,3578762909,3578762919,10
0,1505,62111,3578762909,3578762920,11
0,1505,62112,3578762909,3578762920,11
0,1505,62113,3578762909,3578762922,13
0,1505,62114,3578762909,3578762922,13
0,1505,62115,3578762909,3578762922,13
0,1505,62116,3578762909,3578762923,14
0,1505,62117,3578762909,3578762925,16
0,1505,62118,3578762909,3578762925,16
0,1505,62119,3578762909,3578762926,17
0,1505,62120,3578762909,3578762926,17
0,1505,62121,3578762909,3578762926,17
0,1505,62122,3578762909,3578762926,17
0,1505,62123,3578762909,3578762926,17
0,1505,62124,3578762909,3578762927,18
0,1505,62125,3578762909,3578762927,18
0,1505,62126,3578762909,3578762928,19
0,1505,62127,3578762909,3578762928,19
0,1505,62128,3578762909,3578762928,19
0,1505,62129,3578762909,3578762928,19
0,1505,62130,3578762909,3578762928,19
0,1505,62131,3578762909,3578762928,19
0,1505,62132,3578762909,3578762929,20
0,1505,62133,3578762909,3578762929,20
0,1505,62134,3578762909,3578762929,20
0,1505,62135,3578762909,3578762929,20
0,1505,62136,3578762909,3578762930,21
0,1505,62137,3578762909,3578762930,21
0,1505,62138,3578762909,3578762930,21
0,1505,62139,3578762909,3578762930,21
0,1505,62140,3578762909,3578762931,22
0,1505,62141,3578762909,3578762931,22
0,1505,62142,3578762909,3578762932,23
0,1505,62143,3578762909,3578762932,23
0,1505,62144,3578762909,3578762932,23
0,1505,62145,3578762909,3578762932,23
0,1505,62146,3578762909,3578762932,23
0,1505,62147,3578762909,3578762933,24
0,1505,62148,3578762909,3578762934,25
0,1505,62149,3578762909,3578762936,27
0,1505,62150,3578762909,3578762936,27
0,1505,62151,3578762909,3578762936,27
0,1505,62152,3578762909,3578762936,27
0,1505,62153,3578762909,3578762939,30
0,1505,62154,3578762909,3578762939,30
0,1505,62155,3578762909,3578762939,30
0,1505,62156,3578762909,3578762939,30
0,1505,62157,3578762909,3578762940,31
0,1505,62158,3578762909,3578762940,31
0,1505,62159,3578762909,3578762942,33
0,1505,62160,3578762909,3578762942,33
0,1505,62161,3578762909,3578762943,34
0,1505,62162,3578762909,3578762943,34
0,1505,62163,3578762909,3578762944,35
0,1505,62164,3578762909,3578762945,36
0,1505,62165,3578762909,3578762945,36
0,1505,62166,3578762909,3578762946,37
0,1505,62167,3578762909,3578762946,37
0,1505,62168,3578762909,3578762947,38
0,1505,62169,3578762909,3578762947,38
0,1505,62170,3578762909,3578762948,39
0,1505,62171,3578762909,3578762948,39
0,1505,62172,3578762909,3578762949,40
0,1505,62173,3578762909,3578762950,41
0,1505,62174,3578762909,3578762951,42
0,1505,62175,3578762909,3578762952,43
0,1505,62176,3578762909,3578762952,43
0,1505,62177,3578762909,3578762953,44
0,1505,62178,3578762909,3578762953,44
0,1505,62179,3578762909,3578762953,44
0,1505,62180,3578762909,3578762954,45
0,1505,62181,3578762909,3578762955,46
0,1505,62182,3578762909,3578762956,47
0,1505,62183,3578762909,3578762956,47
0,1505,62184,3578762909,3578762956,47
0,1505,62185,3578762909,3578762957,48
0,1505,62186,3578762909,3578762958,49
0,1505,62187,3578762909,3578762958,49
0,1505,62188,3578762909,3578762959,50
0,1506,62189,3578762974,3578762974,0
0,1506,62190,3578762974,3578762974,0
0,1506,62191,3578762974,3578762974,0
0,1506,62192,3578762974,3578762974,0
0,1506,62193,3578762974,3578762974,0
0,1506,62194,3578762974,3578762974,0
0,1506,62195,3578762974,3578762974,0
0,1506,62196,3578762974,3578762974,0
0,1506,62197,3578762974,3578762974,0
0,1506,62198,3578762974,3578762974,0
0,1506,62199,3578762974,3578762974,0
0,1506,62200,3578762974,3578762974,0
0,1506,62201,3578762974,3578762974,0
0,1506,62202,3578762974,3578762974,0
0,1506,62203,3578762974,3578762974,0
0,1506,62204,3578762974,3578762974,0
0,1506,62205,3578762974,3578762974,0
0,1506,62206,3578762974,3578762974,0
0,1506,62207,3578762974,3578762974,0
0,1506,62208,3578762974,3578762974,0
0,1506,62209,3578762974,3578762974,0
0,1506,62210,3578762974,3578762974,0
0,1506,62211,3578762974,3578762974,0
0,1506,62212,3578762974,3578762974,0
0,1506,62213,3578762974,3578762974,0
0,1506,62214,3578762974,3578762974,0
0,1506,62215,3578762974,3578762974,0
0,1506,62216,3578762974,3578762974,0
0,1506,62217,3578762974,3578762975,1
0,1506,62218,3578762974,3578762976,2
0,1506,62219,3578762974,3578762978,4
0,1506,62220,3578762974,3578762978,4
0,1506,62221,3578762974,3578762978,4
0,1506,62222,3578762974,3578762978,4
0,1506,62223,3578762974,3578762980,6
0,1506,62224,3578762974,3578762980,6
0,1506,62225,3578762974,3578762981,7
0,1506,62226,3578762974,3578762981,7
0,1506,62227,3578762974,3578762984,10
0,1506,62228,3578762974,3578762984,10
0,1506,62229,3578762974,3578762984,10
0,1506,62230,3578762974,3578762985,11
0,1506,62231,3578762974,3578762986,12
0,1506,62232,3578762974,3578762986,12
0,1506,62233,3578762974,3578762986,12
0,1506,62234,3578762974,3578762988,14
0,1506,62235,3578762974,3578762988,14
0,1506,62236,3578762974,3578762989,15
0,1506,62237,3578762974,3578762989,15
0,1506,62238,3578762974,3578762989,15
0,1506,62239,3578762974,3578762990,16
0,1506,62240,3578762974,3578762990,16
0,1506,62241,3578762974,3578762991,17
0,1506,62242,3578762974,3578762992,18
0,1506,62243,3578762974,3578762993,19
0,1506,62244,3578762974,3578762993,19
0,1506,62245,3578762974,3578762993,19
0,1506,62246,3578762974,3578762996,22
0,1506,62247,3578762974,3578762997,23
0,1506,62248,3578762974,3578762997,23
0,1506,62249,3578762974,3578762997,23
0,1506,62250,3578762974,3578762999,25
0,1506,62251,3578762974,3578762999,25
0,1506,62252,3578762974,3578763000,26
0,1506,62253,3578762974,3578763001,27
0,1506,62254,3578762974,3578763002,28
0,1506,62255,3578762974,3578763002,28
0,1506,62256,3578762974,3578763003,29
0,1506,62257,3578762974,3578763003,29
0,1506,62258,3578762974,3578763004,30
0,1506,62259,3578762974,3578763006,32
0,1506,62260,3578762974,3578763006,32
0,1506,62261,3578762974,3578763007,33
0,1506,62262,3578762974,3578763008,34
0,1506,62263,3578762974,3578763009,35
0,1506,62264,3578762974,3578763010,36
0,1506,62265,3578762974,3578763011,37
0,1506,62266,3578762974,3578763012,38
0,1506,62267,3578762974,3578763012,38
0,1506,62268,3578762974,3578763013,39
0,1506,62269,3578762974,3578763014,40
0,1506,62270,3578762974,3578763014,40
0,1506,62271,3578762974,3578763015,41
0,1506,62272,3578762974,3578763015,41
0,1506,62273,3578762974,3578763015,41
0,1506,62274,3578762974,3578763016,42
0,1506,62275,3578762974,3578763016,42
0,1506,62276,3578762974,3578763017,43
0,1506,62277,3578762974,3578763018,44
0,1506,62278,3578762974,3578763018,44
0,1506,62279,3578762974,3578763018,44
0,1506,62280,3578762974,3578763019,45
0,1506,62281,3578762974,3578763020,46
0,1506,62282,3578762974,3578763021,47
0,1506,62283,3578762974,3578763021,47
0,1506,62284,3578762974,3578763021,47
0,1506,62285,3578762974,3578763022,48
0,1506,62286,3578762974,3578763023,49
0,1507,62287,3578763038,3578763038,0
0,1507,62288,3578763038,3578763038,0
0,1507,62289,3578763038,3578763038,0
0,1507,62290,3578763038,3578763038,0
0,1507,62291,3578763038,3578763038,0
0,1507,62292,3578763038,3578763038,0
0,1507,62293,3578763038,3578763038,0
0,1507,62294,3578763038,3578763038,0
0,1507,62295,3578763038,3578763038,0
0,1507,62296,3578763038,3578763038,0
0,1507,62297,3578763038,3578763038,0
0,1507,62298,3578763038,3578763038,0
0,1507,62299,3578763038,3578763038,0
0,1507,62300,3578763038,3578763038,0
0,1507,62301,3578763038,3578763038,0
0,1507,62302,3578763038,3578763038,0
0,1507,62303,3578763038,3578763038,0
0,1507,62304,3578763038,3578763038,0
0,1507,62305,3578763038,3578763039,1
0,1507,62306,3578763038,3578763039,1
0,1507,62307,3578763038,3578763039,1
0,1507,62308,3578763038,3578763040,2
0,1507,62309,3578763038,3578763040,2
0,1507,62310,3578763038,3578763040,2
0,1507,62311,3578763038,3578763040,2
0,1507,62312,3578763038,3578763041,3
0,1507,62313,3578763038,3578763041,3
0,1507,62314,3578763038,3578763042,4
0,1507,62315,3578763038,3578763042,4
0,1507,62316,3578763038,3578763044,6
0,1507,62317,3578763038,3578763044,6
0,1507,62318,3578763038,3578763044,6
0,1507,62319,3578763038,3578763046,8
0,1507,62320,3578763038,3578763047,9
0,1507,62321,3578763038,3578763047,9
0,1507,62322,3578763038,3578763048,10
0,1507,62323,3578763038,3578763048,10
0,1507,62324,3578763038,3578763049,11
0,1507,62325,3578763038,3578763049,11
0,1507,62326,3578763038,3578763049,11
0,1507,62327,3578763038,3578763050,12
0,1507,62328,3578763038,3578763050,12
0,1507,62329,3578763038,3578763051,13
0,1507,62330,3578763038,3578763052,14
0,1507,62331,3578763038,3578763055,17
0,1507,62332,3578763038,3578763056,18
0,1507,62333,3578763038,3578763056,18
0,1507,62334,3578763038,3578763057,19
0,1507,62335,3578763038,3578763058,20
0,1507,62336,3578763038,3578763058,20
0,1507,62337,3578763038,3578763059,21
0,1507,62338,3578763038,3578763059,21
0,1507,62339,3578763038,3578763059,21
0,1507,62340,3578763038,3578763060,22
0,1507,62341,3578763038,3578763061,23
0,1507,62342,3578763038,3578763062,24
0,1507,62343,3578763038,3578763062,24
0,1507,62344,3578763038,3578763063,25
0,1507,62345,3578763038,3578763063,25
0,1507,62346,3578763038,3578763063,25
0,1507,62347,3578763038,3578763064,26
0,1507,62348,3578763038,3578763064,26
0,1507,62349,3578763038,3578763065,27
0,1507,62350,3578763038,3578763065,27
0,1507,62351,3578763038,3578763066,28
0,1507,62352,3578763038,3578763066,28
0,1507,62353,3578763038,3578763067,29
0,1507,62354,3578763038,3578763068,30
0,1507,62355,3578763038,3578763069,31
0,1507,62356,3578763038,3578763070,32
0,1507,62357,3578763038,3578763083,45
0,1507,62358,3578763038,3578763083,45
0,1507,62359,3578763038,3578763087,49
0,1507,62360,3578763038,3578763088,50
0,1508,62361,3578763103,3578763103,0
0,1508,62362,3578763103,3578763103,0
0,1508,62363,3578763103,3578763103,0
0,1508,62364,3578763103,3578763103,0
0,1508,62365,3578763103,3578763103,0
0,1508,62366,3578763103,3578763103,0
0,1508,62367,3578763103,3578763103,0
0,1508,62368,3578763103,3578763103,0
0,1508,62369,3578763103,3578763103,0
0,1508,62370,3578763103,3578763103,0
0,1508,62371,3578763103,3578763103,0
0,1508,62372,3578763103,3578763103,0
0,1508,62373,3578763103,3578763103,0
0,1508,62374,3578763103,3578763103,0
0,1508,62375,3578763103,3578763103,0
0,1508,62376,3578763103,3578763103,0
0,1508,62377,3578763103,3578763103,0
0,1508,62378,3578763103,3578763103,0
0,1508,62379,3578763103,3578763103,0
0,1508,62380,3578763103,3578763103,0
0,1508,62381,3578763103,3578763103,0
0,1508,62382,3578763103,3578763103,0
0,1508,62383,3578763103,3578763103,0
0,1508,62384,3578763103,3578763103,0
0,1508,62385,3578763103,3578763103,0
0,1508,62386,3578763103,3578763103,0
0,1508,62387,3578763103,3578763103,0
0,1508,62388,3578763103,3578763104,1
0,1508,62389,3578763103,3578763104,1
0,1508,62390,3578763103,3578763105,2
0,1508,62391,3578763103,3578763106,3
0,1508,62392,3578763103,3578763106,3
0,1508,62393,3578763103,3578763107,4
0,1508,62394,3578763103,3578763108,5
0,1508,62395,3578763103,3578763108,5
0,1508,62396,3578763103,3578763108,5
0,1508,62397,3578763103,3578763109,6
0,1508,62398,3578763103,3578763109,6
0,1508,62399,3578763103,3578763109,6
0,1508,62400,3578763103,3578763109,6
0,1508,62401,3578763103,3578763109,6
0,1508,62402,3578763103,3578763109,6
0,1508,62403,3578763103,3578763110,7
0,1508,62404,3578763103,3578763110,7
0,1508,62405,3578763103,3578763110,7
0,1508,62406,3578763103,3578763111,8
0,1508,62407,3578763103,3578763111,8
0,1508,62408,3578763103,3578763112,9
0,1508,62409,3578763103,3578763112,9
0,1508,62410,3578763103,3578763113,10
0,1508,62411,3578763103,3578763113,10
0,1508,62412,3578763103,3578763113,10
0,1508,62413,3578763103,3578763115,12
0,1508,62414,3578763103,3578763115,12
0,1508,62415,3578763103,3578763116,13
0,1508,62416,3578763103,3578763116,13
0,1508,62417,3578763103,3578763116,13
0,1508,62418,3578763103,3578763116,13
0,1508,62419,3578763103,3578763116,13
0,1508,62420,3578763103,3578763117,14
0,1508,62421,3578763103,3578763117,14
0,1508,62422,3578763103,3578763117,14
0,1508,62423,3578763103,3578763118,15
0,1508,62424,3578763103,3578763119,16
0,1508,62425,3578763103,3578763119,16
0,1508,62426,3578763103,3578763119,16
0,1508,62427,3578763103,3578763122,19
0,1508,62428,3578763103,3578763122,19
0,1508,62429,3578763103,3578763123,20
0,1508,62430,3578763103,3578763124,21
0,1508,62431,3578763103,3578763125,22
0,1508,62432,3578763103,3578763126,23
0,1508,62433,3578763103,3578763126,23
0,1508,62434,3578763103,3578763126,23
0,1508,62435,3578763103,3578763127,24
0,1508,62436,3578763103,3578763127,24
0,1508,62437,3578763103,3578763127,24
0,1508,62438,3578763103,3578763127,24
0,1508,62439,3578763103,3578763128,25
0,1508,62440,3578763103,3578763128,25
0,1508,62441,3578763103,3578763128,25
0,1508,62442,3578763103,3578763129,26
0,1508,62443,3578763103,3578763129,26
0,1508,62444,3578763103,3578763129,26
0,1508,62445,3578763103,3578763129,26
0,1508,62446,3578763103,3578763129,26
0,1508,62447,3578763103,3578763129,26
0,1508,62448,3578763103,3578763129,26
0,1508,62449,3578763103,3578763130,27
0,1508,62450,3578763103,3578763131,28
0,1508,62451,3578763103,3578763131,28
0,1508,62452,3578763103,3578763131,28
0,1508,62453,3578763103,3578763131,28
0,1508,62454,3578763103,3578763132,29
0,1508,62455,3578763103,3578763132,29
0,1508,62456,3578763103,3578763132,29
0,1508,62457,3578763103,3578763132,29
0,1508,62458,3578763103,3578763134,31
0,1508,62459,3578763103,3578763134,31
0,1508,62460,3578763103,3578763136,33
0,1508,62461,3578763103,3578763136,33
0,1508,62462,3578763103,3578763136,33
0,1508,62463,3578763103,3578763136,33
0,1508,62464,3578763103,3578763137,34
0,1508,62465,3578763103,3578763138,35
0,1508,62466,3578763103,3578763139,36
0,1508,62467,3578763103,3578763140,37
0,1508,62468,3578763103,3578763140,37
0,1508,62469,3578763103,3578763140,37
0,1508,62470,3578763103,3578763141,38
0,1508,62471,3578763103,3578763142,39
0,1508,62472,3578763103,3578763143,40
0,1508,62473,3578763103,3578763143,40
0,1508,62474,3578763103,3578763143,40
0,1508,62475,3578763103,3578763143,40
0,1508,62476,3578763103,3578763144,41
0,1508,62477,3578763103,3578763144,41
0,1508,62478,3578763103,3578763145,42
0,1508,62479,3578763103,3578763146,43
0,1508,62480,3578763103,3578763146,43
0,1508,62481,3578763103,3578763147,44
0,1508,62482,3578763103,3578763147,44
0,1508,62483,3578763103,3578763147,44
0,1508,62484,3578763103,3578763148,45
0,1508,62485,3578763103,3578763148,45
0,1508,62486,3578763103,3578763149,46
0,1508,62487,3578763103,3578763151,48
0,1508,62488,3578763103,3578763151,48
0,1508,62489,3578763103,3578763152,49
0,1508,62490,3578763103,3578763152,49
0,1508,62491,3578763103,3578763153,50
0,1509,62492,3578763168,3578763168,0
0,1509,62493,3578763168,3578763168,0
0,1509,62494,3578763168,3578763168,0
0,1509,62495,3578763168,3578763168,0
0,1509,62496,3578763168,3578763168,0
0,1509,62497,3578763168,3578763168,0
0,1509,62498,3578763168,3578763168,0
0,1509,62499,3578763168,3578763168,0
0,1509,62500,3578763168,3578763168,0
0,1509,62501,3578763168,3578763168,0
0,1509,62502,3578763168,3578763168,0
0,1509,62503,3578763168,3578763168,0
0,1509,62504,3578763168,3578763168,0
0,1509,62505,3578763168,3578763168,0
0,1509,62506,3578763168,3578763168,0
0,1509,62507,3578763168,3578763168,0
0,1509,62508,3578763168,3578763168,0
0,1509,62509,3578763168,3578763168,0
0,1509,62510,3578763168,3578763168,0
0,1509,62511,3578763168,3578763168,0
0,1509,62512,3578763168,3578763168,0
0,1509,62513,3578763168,3578763168,0
0,1509,62514,3578763168,3578763168,0
0,1509,62515,3578763168,3578763168,0
0,1509,62516,3578763168,3578763168,0
0,1509,62517,3578763168,3578763168,0
0,1509,62518,3578763168,3578763168,0
0,1509,62519,3578763168,3578763169,1
0,1509,62520,3578763168,3578763169,1
0,1509,62521,3578763168,3578763169,1
0,1509,62522,3578763168,3578763170,2
0,1509,62523,3578763168,3578763172,4
0,1509,62524,3578763168,3578763173,5
0,1509,62525,3578763168,3578763173,5
0,1509,62526,3578763168,3578763173,5
0,1509,62527,3578763168,3578763174,6
0,1509,62528,3578763168,3578763174,6
0,1509,62529,3578763168,3578763175,7
0,1509,62530,3578763168,3578763176,8
0,1509,62531,3578763168,3578763176,8
0,1509,62532,3578763168,3578763178,10
0,1509,62533,3578763168,3578763178,10
0,1509,62534,3578763168,3578763178,10
0,1509,62535,3578763168,3578763179,11
0,1509,62536,3578763168,3578763179,11
0,1509,62537,3578763168,3578763180,12
0,1509,62538,3578763168,3578763180,12
0,1509,62539,3578763168,3578763182,14
0,1509,62540,3578763168,3578763183,15
0,1509,62541,3578763168,3578763183,15
0,1509,62542,3578763168,3578763184,16
0,1509,62543,3578763168,3578763184,16
0,1509,62544,3578763168,3578763184,16
0,1509,62545,3578763168,3578763186,18
0,1509,62546,3578763168,3578763186,18
0,1509,62547,3578763168,3578763187,19
0,1509,62548,3578763168,3578763188,20
0,1509,62549,3578763168,3578763188,20
0,1509,62550,3578763168,3578763189,21
0,1509,62551,3578763168,3578763189,21
0,1509,62552,3578763168,3578763190,22
0,1509,62553,3578763168,3578763190,22
0,1509,62554,3578763168,3578763191,23
0,1509,62555,3578763168,3578763192,24
0,1509,62556,3578763168,3578763193,25
0,1509,62557,3578763168,3578763193,25
0,1509,62558,3578763168,3578763196,28
0,1509,62559,3578763168,3578763197,29
0,1509,62560,3578763168,3578763197,29
0,1509,62561,3578763168,3578763198,30
0,1509,62562,3578763168,3578763199,31
0,1509,62563,3578763168,3578763201,33
0,1509,62564,3578763168,3578763201,33
0,1509,62565,3578763168,3578763201,33
0,1509,62566,3578763168,3578763202,34
0,1509,62567,3578763168,3578763203,35
0,1509,62568,3578763168,3578763204,36
0,1509,62569,3578763168,3578763204,36
0,1509,62570,3578763168,3578763205,37
0,1509,62571,3578763168,3578763206,38
0,1509,62572,3578763168,3578763206,38
0,1509,62573,3578763168,3578763207,39
0,1509,62574,3578763168,3578763208,40
0,1509,62575,3578763168,3578763209,41
0,1509,62576,3578763168,3578763210,42
0,1509,62577,3578763168,3578763211,43
0,1509,62578,3578763168,3578763212,44
0,1509,62579,3578763168,3578763212,44
0,1509,62580,3578763168,3578763213,45
0,1509,62581,3578763168,3578763214,46
0,1509,62582,3578763168,3578763214,46
0,1509,62583,3578763168,3578763215,47
0,1509,62584,3578763168,3578763215,47
0,1509,62585,3578763168,3578763216,48
0,1509,62586,3578763168,3578763216,48
0,1509,62587,3578763168,3578763216,48
0,1509,62588,3578763168,3578763216,48
0,1509,62589,3578763168,3578763217,49
0,1509,62590,3578763168,3578763218,50
0,1510,62591,3578763234,3578763234,0
0,1510,62592,3578763234,3578763234,0
0,1510,62593,3578763234,3578763234,0
0,1510,62594,3578763234,3578763234,0
0,1510,62595,3578763234,3578763234,0
0,1510,62596,3578763234,3578763234,0
0,1510,62597,3578763234,3578763234,0
0,1510,62598,3578763234,3578763234,0
0,1510,62599,3578763234,3578763234,0
0,1510,62600,3578763234,3578763234,0
0,1510,62601,3578763234,3578763234,0
0,1510,62602,3578763234,3578763234,0
0,1510,62603,3578763234,3578763234,0
0,1510,62604,3578763234,3578763234,0
0,1510,62605,3578763234,3578763234,0
0,1510,62606,3578763234,3578763234,0
0,1510,62607,3578763234,3578763234,0
0,1510,62608,3578763234,3578763234,0
0,1510,62609,3578763234,3578763234,0
0,1510,62610,3578763234,3578763234,0
0,1510,62611,3578763234,3578763234,0
0,1510,62612,3578763234,3578763234,0
0,1510,62613,3578763234,3578763234,0
0,1510,62614,3578763234,3578763234,0
0,1510,62615,3578763234,3578763234,0
0,1510,62616,3578763234,3578763235,1
0,1510,62617,3578763234,3578763235,1
0,1510,62618,3578763234,3578763236,2
0,1510,62619,3578763234,3578763238,4
0,1510,62620,3578763234,3578763239,5
0,1510,62621,3578763234,3578763239,5
0,1510,62622,3578763234,3578763239,5
0,1510,62623,3578763234,3578763240,6
0,1510,62624,3578763234,3578763241,7
0,1510,62625,3578763234,3578763241,7
0,1510,62626,3578763234,3578763241,7
0,1510,62627,3578763234,3578763241,7
0,1510,62628,3578763234,3578763243,9
0,1510,62629,3578763234,3578763244,10
0,1510,62630,3578763234,3578763247,13
0,1510,62631,3578763234,3578763247,13
0,1510,62632,3578763234,3578763247,13
0,1510,62633,3578763234,3578763248,14
0,1510,62634,3578763234,3578763248,14
0,1510,62635,3578763234,3578763248,14
0,1510,62636,3578763234,3578763249,15
0,1510,62637,3578763234,3578763249,15
0,1510,62638,3578763234,3578763249,15
0,1510,62639,3578763234,3578763249,15
0,1510,62640,3578763234,3578763250,16
0,1510,62641,3578763234,3578763252,18
0,1510,62642,3578763234,3578763255,21
0,1510,62643,3578763234,3578763255,21
0,1510,62644,3578763234,3578763256,22
0,1510,62645,3578763234,3578763257,23
0,1510,62646,3578763234,3578763257,23
0,1510,62647,3578763234,3578763258,24
0,1510,62648,3578763234,3578763258,24
0,1510,62649,3578763234,3578763258,24
0,1510,62650,3578763234,3578763259,25
0,1510,62651,3578763234,3578763259,25
0,1510,62652,3578763234,3578763260,26
0,1510,62653,3578763234,3578763261,27
0,1510,62654,3578763234,3578763263,29
0,1510,62655,3578763234,3578763263,29
0,1510,62656,3578763234,3578763264,30
0,1510,62657,3578763234,3578763265,31
0,1510,62658,3578763234,3578763265,31
0,1510,62659,3578763234,3578763265,31
0,1510,62660,3578763234,3578763267,33
0,1510,62661,3578763234,3578763267,33
0,1510,62662,3578763234,3578763267,33
0,1510,62663,3578763234,3578763267,33
0,1510,62664,3578763234,3578763269,35
0,1510,62665,3578763234,3578763271,37
0,1510,62666,3578763234,3578763283,49
0,1510,62667,3578763234,3578763284,50
0,1511,62668,3578763298,3578763298,0
0,1511,62669,3578763298,3578763298,0
0,1511,62670,3578763298,3578763298,0
0,1511,62671,3578763298,3578763298,0
0,1511,62672,3578763298,3578763298,0
0,1511,62673,3578763298,3578763298,0
0,1511,62674,3578763298,3578763298,0
0,1511,62675,3578763298,3578763298,0
0,1511,62676,3578763298,3578763298,0
0,1511,62677,3578763298,3578763298,0
0,1511,62678,3578763298,3578763298,0
0,1511,62679,3578763298,3578763298,0
0,1511,62680,3578763298,3578763298,0
0,1511,62681,3578763298,3578763298,0
0,1511,62682,3578763298,3578763298,0
0,1511,62683,3578763298,3578763298,0
0,1511,62684,3578763298,3578763298,0
0,1511,62685,3578763298,3578763298,0
0,1511,62686,3578763298,3578763298,0
0,1511,62687,3578763298,3578763298,0
0,1511,62688,3578763298,3578763299,1
0,1511,62689,3578763298,3578763299,1
0,1511,62690,3578763298,3578763300,2
0,1511,62691,3578763298,3578763300,2
0,1511,62692,3578763298,3578763300,2
0,1511,62693,3578763298,3578763302,4
0,1511,62694,3578763298,3578763304,6
0,1511,62695,3578763298,3578763304,6
0,1511,62696,3578763298,3578763305,7
0,1511,62697,3578763298,3578763305,7
0,1511,62698,3578763298,3578763306,8
0,1511,62699,3578763298,3578763306,8
0,1511,62700,3578763298,3578763307,9
0,1511,62701,3578763298,3578763308,10
0,1511,62702,3578763298,3578763308,10
0,1511,62703,3578763298,3578763308,10
0,1511,62704,3578763298,3578763308,10
0,1511,62705,3578763298,3578763309,11
0,1511,62706,3578763298,3578763309,11
0,1511,62707,3578763298,3578763309,11
0,1511,62708,3578763298,3578763309,11
0,1511,62709,3578763298,3578763309,11
0,1511,62710,3578763298,3578763309,11
0,1511,62711,3578763298,3578763310,12
0,1511,62712,3578763298,3578763310,12
0,1511,62713,3578763298,3578763310,12
0,1511,62714,3578763298,3578763311,13
0,1511,62715,3578763298,3578763311,13
0,1511,62716,3578763298,3578763311,13
0,1511,62717,3578763298,3578763311,13
0,1511,62718,3578763298,3578763312,14
0,1511,62719,3578763298,3578763312,14
0,1511,62720,3578763298,3578763313,15
0,1511,62721,3578763298,3578763313,15
0,1511,62722,3578763298,3578763314,16
0,1511,62723,3578763298,3578763316,18
0,1511,62724,3578763298,3578763316,18
0,1511,62725,3578763298,3578763316,18
0,1511,62726,3578763298,3578763316,18
0,1511,62727,3578763298,3578763316,18
0,1511,62728,3578763298,3578763317,19
0,1511,62729,3578763298,3578763317,19
0,1511,62730,3578763298,3578763317,19
0,1511,62731,3578763298,3578763318,20
0,1511,62732,3578763298,3578763318,20
0,1511,62733,3578763298,3578763318,20
0,1511,62734,3578763298,3578763318,20
0,1511,62735,3578763298,3578763319,21
0,1511,62736,3578763298,3578763320,22
0,1511,62737,3578763298,3578763322,24
0,1511,62738,3578763298,3578763323,25
0,1511,62739,3578763298,3578763323,25
0,1511,62740,3578763298,3578763325,27
0,1511,62741,3578763298,3578763325,27
0,1511,62742,3578763298,3578763327,29
0,1511,62743,3578763298,3578763327,29
0,1511,62744,3578763298,3578763327,29
0,1511,62745,3578763298,3578763327,29
0,1511,62746,3578763298,3578763327,29
0,1511,62747,3578763298,3578763327,29
0,1511,62748,3578763298,3578763328,30
0,1511,62749,3578763298,3578763328,30
0,1511,62750,3578763298,3578763328,30
0,1511,62751,3578763298,3578763328,30
0,1511,62752,3578763298,3578763329,31
0,1511,62753,3578763298,3578763329,31
0,1511,62754,3578763298,3578763329,31
0,1511,62755,3578763298,3578763330,32
0,1511,62756,3578763298,3578763330,32
0,1511,62757,3578763298,3578763331,33
0,1511,62758,3578763298,3578763331,33
0,1511,62759,3578763298,3578763331,33
0,1511,62760,3578763298,3578763331,33
0,1511,62761,3578763298,3578763331,33
0,1511,62762,3578763298,3578763333,35
0,1511,62763,3578763298,3578763333,35
0,1511,62764,3578763298,3578763333,35
0,1511,62765,3578763298,3578763334,36
0,1511,62766,3578763298,3578763334,36
0,1511,62767,3578763298,3578763335,37
0,1511,62768,3578763298,3578763335,37
0,1511,62769,3578763298,3578763335,37
0,1511,62770,3578763298,3578763336,38
0,1511,62771,3578763298,3578763337,39
0,1511,62772,3578763298,3578763337,39
0,1511,62773,3578763298,3578763337,39
0,1511,62774,3578763298,3578763339,41
0,1511,62775,3578763298,3578763340,42
0,1511,62776,3578763298,3578763340,42
0,1511,62777,3578763298,3578763341,43
0,1511,62778,3578763298,3578763343,45
0,1511,62779,3578763298,3578763343,45
0,1511,62780,3578763298,3578763343,45
0,1511,62781,3578763298,3578763343,45
0,1511,62782,3578763298,3578763343,45
0,1511,62783,3578763298,3578763344,46
0,1511,62784,3578763298,3578763344,46
0,1511,62785,3578763298,3578763344,46
0,1511,62786,3578763298,3578763345,47
0,1511,62787,3578763298,3578763345,47
0,1511,62788,3578763298,3578763346,48
0,1511,62789,3578763298,3578763346,48
0,1511,62790,3578763298,3578763346,48
0,1511,62791,3578763298,3578763347,49
0,1511,62792,3578763298,3578763347,49
0,1511,62793,3578763298,3578763348,50
0,1512,62794,3578763362,3578763362,0
0,1512,62795,3578763362,3578763362,0
0,1512,62796,3578763362,3578763362,0
0,1512,62797,3578763362,3578763362,0
0,1512,62798,3578763362,3578763362,0
0,1512,62799,3578763362,3578763362,0
0,1512,62800,3578763362,3578763362,0
0,1512,62801,3578763362,3578763362,0
0,1512,62802,3578763362,3578763362,0
0,1512,62803,3578763362,3578763362,0
0,1512,62804,3578763362,3578763362,0
0,1512,62805,3578763362,3578763362,0
0,1512,62806,3578763362,3578763362,0
0,1512,62807,3578763362,3578763362,0
0,1512,62808,3578763362,3578763362,0
0,1512,62809,3578763362,3578763362,0
0,1512,62810,3578763362,3578763362,0
0,1512,62811,3578763362,3578763362,0
0,1512,62812,3578763362,3578763362,0
0,1512,62813,3578763362,3578763362,0
0,1512,62814,3578763362,3578763362,0
0,1512,62815,3578763362,3578763362,0
0,1512,62816,3578763362,3578763362,0
0,1512,62817,3578763362,3578763362,0
0,1512,62818,3578763362,3578763362,0
0,1512,62819,3578763362,3578763362,0
0,1512,62820,3578763362,3578763362,0
0,1512,62821,3578763362,3578763362,0
0,1512,62822,3578763362,3578763363,1
0,1512,62823,3578763362,3578763363,1
0,1512,62824,3578763362,3578763365,3
0,1512,62825,3578763362,3578763366,4
0,1512,62826,3578763362,3578763369,7
0,1512,62827,3578763362,3578763369,7
0,1512,62828,3578763362,3578763370,8
0,1512,62829,3578763362,3578763370,8
0,1512,62830,3578763362,3578763372,10
0,1512,62831,3578763362,3578763373,11
0,1512,62832,3578763362,3578763373,11
0,1512,62833,3578763362,3578763373,11
0,1512,62834,3578763362,3578763374,12
0,1512,62835,3578763362,3578763374,12
0,1512,62836,3578763362,3578763374,12
0,1512,62837,3578763362,3578763374,12
0,1512,62838,3578763362,3578763376,14
0,1512,62839,3578763362,3578763378,16
0,1512,62840,3578763362,3578763378,16
0,1512,62841,3578763362,3578763379,17
0,1512,62842,3578763362,3578763379,17
0,1512,62843,3578763362,3578763379,17
0,1512,62844,3578763362,3578763379,17
0,1512,62845,3578763362,3578763380,18
0,1512,62846,3578763362,3578763380,18
0,1512,62847,3578763362,3578763382,20
0,1512,62848,3578763362,3578763383,21
0,1512,62849,3578763362,3578763383,21
0,1512,62850,3578763362,3578763383,21
0,1512,62851,3578763362,3578763384,22
0,1512,62852,3578763362,3578763385,23
0,1512,62853,3578763362,3578763385,23
0,1512,62854,3578763362,3578763386,24
0,1512,62855,3578763362,3578763387,25
0,1512,62856,3578763362,3578763388,26
0,1512,62857,3578763362,3578763388,26
0,1512,62858,3578763362,3578763389,27
0,1512,62859,3578763362,3578763389,27
0,1512,62860,3578763362,3578763390,28
0,1512,62861,3578763362,3578763391,29
0,1512,62862,3578763362,3578763391,29
0,1512,62863,3578763362,3578763393,31
0,1512,62864,3578763362,3578763394,32
0,1512,62865,3578763362,3578763394,32
0,1512,62866,3578763362,3578763397,35
0,1512,62867,3578763362,3578763397,35
0,1512,62868,3578763362,3578763397,35
0,1512,62869,3578763362,3578763398,36
0,1512,62870,3578763362,3578763398,36
0,1512,62871,3578763362,3578763399,37
0,1512,62872,3578763362,3578763401,39
0,1512,62873,3578763362,3578763401,39
0,1512,62874,3578763362,3578763401,39
0,1512,62875,3578763362,3578763403,41
0,1512,62876,3578763362,3578763403,41
0,1512,62877,3578763362,3578763404,42
0,1512,62878,3578763362,3578763404,42
0,1512,62879,3578763362,3578763405,43
0,1512,62880,3578763362,3578763405,43
0,1512,62881,3578763362,3578763406,44
0,1512,62882,3578763362,3578763406,44
0,1512,62883,3578763362,3578763408,46
0,1512,62884,3578763362,3578763409,47
0,1512,62885,3578763362,3578763411,49
0,1512,62886,3578763362,3578763411,49
0,1512,62887,3578763362,3578763412,50
0,1513,62888,3578763425,3578763425,0
0,1513,62889,3578763425,3578763425,0
0,1513,62890,3578763425,3578763425,0
0,1513,62891,3578763425,3578763425,0
0,1513,62892,3578763425,3578763425,0
0,1513,62893,3578763425,3578763425,0
0,1513,62894,3578763425,3578763425,0
0,1513,62895,3578763425,3578763425,0
0,1513,62896,3578763425,3578763425,0
0,1513,62897,3578763425,3578763425,0
0,1513,62898,3578763425,3578763425,0
0,1513,62899,3578763425,3578763425,0
0,1513,62900,3578763425,3578763426,1
0,1513,62901,3578763425,3578763426,1
0,1513,62902,3578763425,3578763426,1
0,1513,62903,3578763425,3578763426,1
0,1513,62904,3578763425,3578763426,1
0,1513,62905,3578763425,3578763426,1
0,1513,62906,3578763425,3578763426,1
0,1513,62907,3578763425,3578763426,1
0,1513,62908,3578763425,3578763426,1
0,1513,62909,3578763425,3578763427,2
0,1513,62910,3578763425,3578763427,2
0,1513,62911,3578763425,3578763427,2
0,1513,62912,3578763425,3578763427,2
0,1513,62913,3578763425,3578763429,4
0,1513,62914,3578763425,3578763429,4
0,1513,62915,3578763425,3578763429,4
0,1513,62916,3578763425,3578763429,4
0,1513,62917,3578763425,3578763429,4
0,1513,62918,3578763425,3578763431,6
0,1513,62919,3578763425,3578763431,6
0,1513,62920,3578763425,3578763431,6
0,1513,62921,3578763425,3578763433,8
0,1513,62922,3578763425,3578763433,8
0,1513,62923,3578763425,3578763433,8
0,1513,62924,3578763425,3578763433,8
0,1513,62925,3578763425,3578763434,9
0,1513,62926,3578763425,3578763434,9
0,1513,62927,3578763425,3578763435,10
0,1513,62928,3578763425,3578763436,11
0,1513,62929,3578763425,3578763436,11
0,1513,62930,3578763425,3578763438,13
0,1513,62931,3578763425,3578763439,14
0,1513,62932,3578763425,3578763439,14
0,1513,62933,3578763425,3578763439,14
0,1513,62934,3578763425,3578763440,15
0,1513,62935,3578763425,3578763440,15
0,1513,62936,3578763425,3578763441,16
0,1513,62937,3578763425,3578763441,16
0,1513,62938,3578763425,3578763441,16
0,1513,62939,3578763425,3578763441,16
0,1513,62940,3578763425,3578763441,16
0,1513,62941,3578763425,3578763444,19
0,1513,62942,3578763425,3578763444,19
0,1513,62943,3578763425,3578763445,20
0,1513,62944,3578763425,3578763446,21
0,1513,62945,3578763425,3578763448,23
0,1513,62946,3578763425,3578763448,23
0,1513,62947,3578763425,3578763448,23
0,1513,62948,3578763425,3578763449,24
0,1513,62949,3578763425,3578763449,24
0,1513,62950,3578763425,3578763450,25
0,1513,62951,3578763425,3578763450,25
0,1513,62952,3578763425,3578763450,25
0,1513,62953,3578763425,3578763450,25
0,1513,62954,3578763425,3578763452,27
0,1513,62955,3578763425,3578763453,28
0,1513,62956,3578763425,3578763454,29
0,1513,62957,3578763425,3578763455,30
0,1513,62958,3578763425,3578763457,32
0,1513,62959,3578763425,3578763457,32
0,1513,62960,3578763425,3578763457,32
0,1513,62961,3578763425,3578763458,33
0,1513,62962,3578763425,3578763458,33
0,1513,62963,3578763425,3578763459,34
0,1513,62964,3578763425,3578763459,34
0,1513,62965,3578763425,3578763459,34
0,1513,62966,3578763425,3578763461,36
0,1513,62967,3578763425,3578763461,36
0,1513,62968,3578763425,3578763462,37
0,1513,62969,3578763425,3578763462,37
0,1513,62970,3578763425,3578763462,37
0,1513,62971,3578763425,3578763463,38
0,1513,62972,3578763425,3578763464,39
0,1513,62973,3578763425,3578763464,39
0,1513,62974,3578763425,3578763465,40
0,1513,62975,3578763425,3578763465,40
0,1513,62976,3578763425,3578763467,42
0,1513,62977,3578763425,3578763467,42
0,1513,62978,3578763425,3578763468,43
0,1513,62979,3578763425,3578763468,43
0,1513,62980,3578763425,3578763469,44
0,1513,62981,3578763425,3578763471,46
0,1514,62982,3578763490,3578763490,0
0,1514,62983,3578763490,3578763490,0
0,1514,62984,3578763490,3578763490,0
0,1514,62985,3578763490,3578763490,0
0,1514,62986,3578763490,3578763490,0
0,1514,62987,3578763490,3578763490,0
0,1514,62988,3578763490,3578763490,0
0,1514,62989,3578763490,3578763490,0
0,1514,62990,3578763490,3578763490,0
0,1514,62991,3578763490,3578763490,0
0,1514,62992,3578763490,3578763490,0
0,1514,62993,3578763490,3578763490,0
0,1514,62994,3578763490,3578763490,0
0,1514,62995,3578763490,3578763491,1
0,1514,62996,3578763490,3578763492,2
0,1514,62997,3578763490,3578763492,2
0,1514,62998,3578763490,3578763492,2
0,1514,62999,3578763490,3578763493,3
0,1514,63000,3578763490,3578763494,4
0,1514,63001,3578763490,3578763494,4
0,1514,63002,3578763490,3578763495,5
0,1514,63003,3578763490,3578763495,5
0,1514,63004,3578763490,3578763495,5
0,1514,63005,3578763490,3578763496,6
0,1514,63006,3578763490,3578763496,6
0,1514,63007,3578763490,3578763497,7
0,1514,63008,3578763490,3578763498,8
0,1514,63009,3578763490,3578763499,9
0,1514,63010,3578763490,3578763501,11
0,1514,63011,3578763490,3578763503,13
0,1514,63012,3578763490,3578763504,14
0,1514,63013,3578763490,3578763504,14
0,1514,63014,3578763490,3578763505,15
0,1514,63015,3578763490,3578763506,16
0,1514,63016,3578763490,3578763507,17
0,1514,63017,3578763490,3578763507,17
0,1514,63018,3578763490,3578763507,17
0,1514,63019,3578763490,3578763507,17
0,1514,63020,3578763490,3578763508,18
0,1514,63021,3578763490,3578763508,18
0,1514,63022,3578763490,3578763508,18
0,1514,63023,3578763490,3578763508,18
0,1514,63024,3578763490,3578763508,18
0,1514,63025,3578763490,3578763509,19
0,1514,63026,3578763490,3578763509,19
0,1514,63027,3578763490,3578763510,20
0,1514,63028,3578763490,3578763510,20
0,1514,63029,3578763490,3578763510,20
0,1514,63030,3578763490,3578763511,21
0,1514,63031,3578763490,3578763511,21
0,1514,63032,3578763490,3578763511,21
0,1514,63033,3578763490,3578763512,22
0,1514,63034,3578763490,3578763513,23
0,1514,63035,3578763490,3578763514,24
0,1514,63036,3578763490,3578763515,25
0,1514,63037,3578763490,3578763515,25
0,1514,63038,3578763490,3578763515,25
0,1514,63039,3578763490,3578763515,25
0,1514,63040,3578763490,3578763515,25
0,1514,63041,3578763490,3578763515,25
0,1514,63042,3578763490,3578763516,26
0,1514,63043,3578763490,3578763516,26
0,1514,63044,3578763490,3578763516,26
0,1514,63045,3578763490,3578763517,27
0,1514,63046,3578763490,3578763518,28
0,1514,63047,3578763490,3578763518,28
0,1514,63048,3578763490,3578763519,29
0,1514,63049,3578763490,3578763519,29
0,1514,63050,3578763490,3578763519,29
0,1514,63051,3578763490,3578763521,31
0,1514,63052,3578763490,3578763522,32
0,1514,63053,3578763490,3578763522,32
0,1514,63054,3578763490,3578763524,34
0,1514,63055,3578763490,3578763524,34
0,1514,63056,3578763490,3578763526,36
0,1514,63057,3578763490,3578763526,36
0,1514,63058,3578763490,3578763526,36
0,1514,63059,3578763490,3578763526,36
0,1514,63060,3578763490,3578763526,36
0,1514,63061,3578763490,3578763527,37
0,1514,63062,3578763490,3578763527,37
0,1514,63063,3578763490,3578763527,37
0,1514,63064,3578763490,3578763528,38
0,1514,63065,3578763490,3578763528,38
0,1514,63066,3578763490,3578763529,39
0,1514,63067,3578763490,3578763529,39
0,1514,63068,3578763490,3578763530,40
0,1514,63069,3578763490,3578763530,40
0,1514,63070,3578763490,3578763530,40
0,1514,63071,3578763490,3578763530,40
0,1514,63072,3578763490,3578763530,40
0,1514,63073,3578763490,3578763531,41
0,1514,63074,3578763490,3578763531,41
0,1514,63075,3578763490,3578763531,41
0,1514,63076,3578763490,3578763531,41
0,1514,63077,3578763490,3578763533,43
0,1514,63078,3578763490,3578763533,43
0,1514,63079,3578763490,3578763533,43
0,1514,63080,3578763490,3578763533,43
0,1514,63081,3578763490,3578763535,45
0,1514,63082,3578763490,3578763535,45
0,1514,63083,3578763490,3578763535,45
0,1514,63084,3578763490,3578763536,46
0,1514,63085,3578763490,3578763536,46
0,1514,63086,3578763490,3578763536,46
0,1514,63087,3578763490,3578763539,49
0,1514,63088,3578763490,3578763539,49
0,1514,63089,3578763490,3578763539,49
0,1514,63090,3578763490,3578763540,50
0,1515,63091,3578763555,3578763555,0
0,1515,63092,3578763555,3578763555,0
0,1515,63093,3578763555,3578763555,0
0,1515,63094,3578763555,3578763555,0
0,1515,63095,3578763555,3578763555,0
0,1515,63096,3578763555,3578763555,0
0,1515,63097,3578763555,3578763555,0
0,1515,63098,3578763555,3578763555,0
0,1515,63099,3578763555,3578763555,0
0,1515,63100,3578763555,3578763555,0
0,1515,63101,3578763555,3578763555,0
0,1515,63102,3578763555,3578763555,0
0,1515,63103,3578763555,3578763555,0
0,1515,63104,3578763555,3578763555,0
0,1515,63105,3578763555,3578763555,0
0,1515,63106,3578763555,3578763555,0
0,1515,63107,3578763555,3578763555,0
0,1515,63108,3578763555,3578763555,0
0,1515,63109,3578763555,3578763555,0
0,1515,63110,3578763555,3578763555,0
0,1515,63111,3578763555,3578763555,0
0,1515,63112,3578763555,3578763555,0
0,1515,63113,3578763555,3578763555,0
0,1515,63114,3578763555,3578763555,0
0,1515,63115,3578763555,3578763555,0
0,1515,63116,3578763555,3578763555,0
0,1515,63117,3578763555,3578763555,0
0,1515,63118,3578763555,3578763555,0
0,1515,63119,3578763555,3578763555,0
0,1515,63120,3578763555,3578763555,0
0,1515,63121,3578763555,3578763556,1
0,1515,63122,3578763555,3578763557,2
0,1515,63123,3578763555,3578763557,2
0,1515,63124,3578763555,3578763558,3
0,1515,63125,3578763555,3578763560,5
0,1515,63126,3578763555,3578763560,5
0,1515,63127,3578763555,3578763560,5
0,1515,63128,3578763555,3578763561,6
0,1515,63129,3578763555,3578763561,6
0,1515,63130,3578763555,3578763561,6
0,1515,63131,3578763555,3578763561,6
0,1515,63132,3578763555,3578763562,7
0,1515,63133,3578763555,3578763562,7
0,1515,63134,3578763555,3578763562,7
0,1515,63135,3578763555,3578763563,8
0,1515,63136,3578763555,3578763564,9
0,1515,63137,3578763555,3578763564,9
0,1515,63138,3578763555,3578763566,11
0,1515,63139,3578763555,3578763566,11
0,1515,63140,3578763555,3578763568,13
0,1515,63141,3578763555,3578763569,14
0,1515,63142,3578763555,3578763569,14
0,1515,63143,3578763555,3578763570,15
0,1515,63144,3578763555,3578763571,16
0,1515,63145,3578763555,3578763572,17
0,1515,63146,3578763555,3578763572,17
0,1515,63147,3578763555,3578763573,18
0,1515,63148,3578763555,3578763573,18
0,1515,63149,3578763555,3578763573,18
0,1515,63150,3578763555,3578763575,20
0,1515,63151,3578763555,3578763577,22
0,1515,63152,3578763555,3578763577,22
0,1515,63153,3578763555,3578763578,23
0,1515,63154,3578763555,3578763578,23
0,1515,63155,3578763555,3578763579,24
0,1515,63156,3578763555,3578763579,24
0,1515,63157,3578763555,3578763579,24
0,1515,63158,3578763555,3578763581,26
0,1515,63159,3578763555,3578763581,26
0,1515,63160,3578763555,3578763583,28
0,1515,63161,3578763555,3578763583,28
0,1515,63162,3578763555,3578763583,28
0,1515,63163,3578763555,3578763584,29
0,1515,63164,3578763555,3578763585,30
0,1515,63165,3578763555,3578763586,31
0,1515,63166,3578763555,3578763587,32
0,1515,63167,3578763555,3578763587,32
0,1515,63168,3578763555,3578763588,33
0,1515,63169,3578763555,3578763589,34
0,1515,63170,3578763555,3578763589,34
0,1515,63171,3578763555,3578763593,38
0,1515,63172,3578763555,3578763593,38
0,1515,63173,3578763555,3578763593,38
0,1515,63174,3578763555,3578763593,38
0,1515,63175,3578763555,3578763596,41
0,1515,63176,3578763555,3578763596,41
0,1515,63177,3578763555,3578763596,41
0,1515,63178,3578763555,3578763598,43
0,1515,63179,3578763555,3578763598,43
0,1515,63180,3578763555,3578763599,44
0,1515,63181,3578763555,3578763600,45
0,1515,63182,3578763555,3578763600,45
0,1515,63183,3578763555,3578763602,47
0,1515,63184,3578763555,3578763602,47
0,1515,63185,3578763555,3578763604,49
0,1515,63186,3578763555,3578763604,49
0,1515,63187,3578763555,3578763605,50
0,1516,63188,3578763619,3578763619,0
0,1516,63189,3578763619,3578763619,0
0,1516,63190,3578763619,3578763619,0
0,1516,63191,3578763619,3578763619,0
0,1516,63192,3578763619,3578763619,0
0,1516,63193,3578763619,3578763619,0
0,1516,63194,3578763619,3578763619,0
0,1516,63195,3578763619,3578763619,0
0,1516,63196,3578763619,3578763619,0
0,1516,63197,3578763619,3578763619,0
0,1516,63198,3578763619,3578763619,0
0,1516,63199,3578763619,3578763619,0
0,1516,63200,3578763619,3578763619,0
0,1516,63201,3578763619,3578763619,0
0,1516,63202,3578763619,3578763619,0
0,1516,63203,3578763619,3578763619,0
0,1516,63204,3578763619,3578763619,0
0,1516,63205,3578763619,3578763619,0
0,1516,63206,3578763619,3578763619,0
0,1516,63207,3578763619,3578763619,0
0,1516,63208,3578763619,3578763619,0
0,1516,63209,3578763619,3578763619,0
0,1516,63210,3578763619,3578763620,1
0,1516,63211,3578763619,3578763620,1
0,1516,63212,3578763619,3578763620,1
0,1516,63213,3578763619,3578763621,2
0,1516,63214,3578763619,3578763621,2
0,1516,63215,3578763619,3578763621,2
0,1516,63216,3578763619,3578763622,3
0,1516,63217,3578763619,3578763622,3
0,1516,63218,3578763619,3578763625,6
0,1516,63219,3578763619,3578763626,7
0,1516,63220,3578763619,3578763626,7
0,1516,63221,3578763619,3578763627,8
0,1516,63222,3578763619,3578763628,9
0,1516,63223,3578763619,3578763628,9
0,1516,63224,3578763619,3578763628,9
0,1516,63225,3578763619,3578763629,10
0,1516,63226,3578763619,3578763630,11
0,1516,63227,3578763619,3578763631,12
0,1516,63228,3578763619,3578763631,12
0,1516,63229,3578763619,3578763631,12
0,1516,63230,3578763619,3578763632,13
0,1516,63231,3578763619,3578763633,14
0,1516,63232,3578763619,3578763633,14
0,1516,63233,3578763619,3578763633,14
0,1516,63234,3578763619,3578763634,15
0,1516,63235,3578763619,3578763635,16
0,1516,63236,3578763619,3578763635,16
0,1516,63237,3578763619,3578763636,17
0,1516,63238,3578763619,3578763637,18
0,1516,63239,3578763619,3578763638,19
0,1516,63240,3578763619,3578763639,20
0,1516,63241,3578763619,3578763639,20
0,1516,63242,3578763619,3578763639,20
0,1516,63243,3578763619,3578763639,20
0,1516,63244,3578763619,3578763639,20
0,1516,63245,3578763619,3578763641,22
0,1516,63246,3578763619,3578763641,22
0,1516,63247,3578763619,3578763641,22
0,1516,63248,3578763619,3578763642,23
0,1516,63249,3578763619,3578763642,23
0,1516,63250,3578763619,3578763643,24
0,1516,63251,3578763619,3578763644,25
0,1516,63252,3578763619,3578763644,25
0,1516,63253,3578763619,3578763644,25
0,1516,63254,3578763619,3578763646,27
0,1516,63255,3578763619,3578763647,28
0,1516,63256,3578763619,3578763648,29
0,1516,63257,3578763619,3578763648,29
0,1516,63258,3578763619,3578763648,29
0,1516,63259,3578763619,3578763650,31
0,1516,63260,3578763619,3578763651,32
0,1516,63261,3578763619,3578763652,33
0,1516,63262,3578763619,3578763653,34
0,1516,63263,3578763619,3578763655,36
0,1516,63264,3578763619,3578763655,36
0,1516,63265,3578763619,3578763656,37
0,1516,63266,3578763619,3578763656,37
0,1516,63267,3578763619,3578763657,38
0,1516,63268,3578763619,3578763658,39
0,1516,63269,3578763619,3578763658,39
0,1516,63270,3578763619,3578763659,40
0,1516,63271,3578763619,3578763659,40
0,1516,63272,3578763619,3578763660,41
0,1516,63273,3578763619,3578763660,41
0,1516,63274,3578763619,3578763661,42
0,1516,63275,3578763619,3578763661,42
0,1516,63276,3578763619,3578763662,43
0,1516,63277,3578763619,3578763663,44
0,1516,63278,3578763619,3578763663,44
0,1516,63279,3578763619,3578763663,44
0,1516,63280,3578763619,3578763663,44
0,1516,63281,3578763619,3578763664,45
0,1516,63282,3578763619,3578763665,46
0,1516,63283,3578763619,3578763665,46
0,1516,63284,3578763619,3578763666,47
0,1516,63285,3578763619,3578763667,48
0,1516,63286,3578763619,3578763668,49
0,1516,63287,3578763619,3578763668,49
0,1517,63288,3578763683,3578763683,0
0,1517,63289,3578763683,3578763683,0
0,1517,63290,3578763683,3578763683,0
0,1517,63291,3578763683,3578763687,4
0,1517,63292,3578763683,3578763687,4
0,1517,63293,3578763683,3578763688,5
0,1517,63294,3578763683,3578763688,5
0,1517,63295,3578763683,3578763689,6
0,1517,63296,3578763683,3578763689,6
0,1517,63297,3578763683,3578763689,6
0,1517,63298,3578763683,3578763690,7
0,1517,63299,3578763683,3578763690,7
0,1517,63300,3578763683,3578763690,7
0,1517,63301,3578763683,3578763690,7
0,1517,63302,3578763683,3578763692,9
0,1517,63303,3578763683,3578763692,9
0,1517,63304,3578763683,3578763693,10
0,1517,63305,3578763683,3578763694,11
0,1517,63306,3578763683,3578763694,11
0,1517,63307,3578763683,3578763694,11
0,1517,63308,3578763683,3578763696,13
0,1517,63309,3578763683,3578763696,13
0,1517,63310,3578763683,3578763696,13
0,1517,63311,3578763683,3578763696,13
0,1517,63312,3578763683,3578763696,13
0,1517,63313,3578763683,3578763698,15
0,1517,63314,3578763683,3578763698,15
0,1517,63315,3578763683,3578763699,16
0,1517,63316,3578763683,3578763699,16
0,1517,63317,3578763683,3578763701,18
0,1517,63318,3578763683,3578763704,21
0,1517,63319,3578763683,3578763704,21
0,1517,63320,3578763683,3578763704,21
0,1517,63321,3578763683,3578763705,22
0,1517,63322,3578763683,3578763706,23
0,1517,63323,3578763683,3578763706,23
0,1517,63324,3578763683,3578763706,23
0,1517,63325,3578763683,3578763707,24
0,1517,63326,3578763683,3578763707,24
0,1517,63327,3578763683,3578763707,24
0,1517,63328,3578763683,3578763708,25
0,1517,63329,3578763683,3578763708,25
0,1517,63330,3578763683,3578763708,25
0,1517,63331,3578763683,3578763709,26
0,1517,63332,3578763683,3578763709,26
0,1517,63333,3578763683,3578763709,26
0,1517,63334,3578763683,3578763709,26
0,1517,63335,3578763683,3578763710,27
0,1517,63336,3578763683,3578763711,28
0,1517,63337,3578763683,3578763711,28
0,1517,63338,3578763683,3578763711,28
0,1517,63339,3578763683,3578763712,29
0,1517,63340,3578763683,3578763717,34
0,1517,63341,3578763683,3578763717,34
0,1517,63342,3578763683,3578763717,34
0,1517,63343,3578763683,3578763717,34
0,1517,63344,3578763683,3578763717,34
0,1517,63345,3578763683,3578763717,34
0,1517,63346,3578763683,3578763717,34
0,1517,63347,3578763683,3578763717,34
0,1517,63348,3578763683,3578763717,34
0,1517,63349,3578763683,3578763717,34
0,1517,63350,3578763683,3578763717,34
0,1517,63351,3578763683,3578763717,34
0,1517,63352,3578763683,3578763717,34
0,1517,63353,3578763683,3578763717,34
0,1517,63354,3578763683,3578763718,35
0,1517,63355,3578763683,3578763718,35
0,1517,63356,3578763683,3578763719,36
0,1517,63357,3578763683,3578763719,36
0,1517,63358,3578763683,3578763720,37
0,1517,63359,3578763683,3578763720,37
0,1517,63360,3578763683,3578763722,39
0,1517,63361,3578763683,3578763723,40
0,1517,63362,3578763683,3578763724,41
0,1517,63363,3578763683,3578763724,41
0,1517,63364,3578763683,3578763725,42
0,1517,63365,3578763683,3578763726,43
0,1517,63366,3578763683,3578763726,43
0,1517,63367,3578763683,3578763726,43
0,1517,63368,3578763683,3578763726,43
0,1517,63369,3578763683,3578763726,43
0,1517,63370,3578763683,3578763727,44
0,1517,63371,3578763683,3578763727,44
0,1517,63372,3578763683,3578763727,44
0,1517,63373,3578763683,3578763727,44
0,1517,63374,3578763683,3578763728,45
0,1517,63375,3578763683,3578763728,45
0,1517,63376,3578763683,3578763729,46
0,1517,63377,3578763683,3578763729,46
0,1517,63378,3578763683,3578763730,47
0,1517,63379,3578763683,3578763730,47
0,1517,63380,3578763683,3578763730,47
0,1517,63381,3578763683,3578763731,48
0,1517,63382,3578763683,3578763731,48
0,1517,63383,3578763683,3578763731,48
0,1517,63384,3578763683,3578763731,48
0,1517,63385,3578763683,3578763732,49
0,1517,63386,3578763683,3578763732,49
0,1517,63387,3578763683,3578763732,49
0,1517,63388,3578763683,3578763733,50
0,1518,63389,3578763747,3578763747,0
0,1518,63390,3578763747,3578763747,0
0,1518,63391,3578763747,3578763747,0
0,1518,63392,3578763747,3578763747,0
0,1518,63393,3578763747,3578763747,0
0,1518,63394,3578763747,3578763747,0
0,1518,63395,3578763747,3578763747,0
0,1518,63396,3578763747,3578763747,0
0,1518,63397,3578763747,3578763747,0
0,1518,63398,3578763747,3578763747,0
0,1518,63399,3578763747,3578763747,0
0,1518,63400,3578763747,3578763747,0
0,1518,63401,3578763747,3578763747,0
0,1518,63402,3578763747,3578763747,0
0,1518,63403,3578763747,3578763747,0
0,1518,63404,3578763747,3578763747,0
0,1518,63405,3578763747,3578763747,0
0,1518,63406,3578763747,3578763747,0
0,1518,63407,3578763747,3578763747,0
0,1518,63408,3578763747,3578763747,0
0,1518,63409,3578763747,3578763747,0
0,1518,63410,3578763747,3578763747,0
0,1518,63411,3578763747,3578763747,0
0,1518,63412,3578763747,3578763747,0
0,1518,63413,3578763747,3578763747,0
0,1518,63414,3578763747,3578763747,0
0,1518,63415,3578763747,3578763750,3
0,1518,63416,3578763747,3578763750,3
0,1518,63417,3578763747,3578763751,4
0,1518,63418,3578763747,3578763751,4
0,1518,63419,3578763747,3578763751,4
0,1518,63420,3578763747,3578763752,5
0,1518,63421,3578763747,3578763753,6
0,1518,63422,3578763747,3578763753,6
0,1518,63423,3578763747,3578763753,6
0,1518,63424,3578763747,3578763754,7
0,1518,63425,3578763747,3578763754,7
0,1518,63426,3578763747,3578763755,8
0,1518,63427,3578763747,3578763755,8
0,1518,63428,3578763747,3578763755,8
0,1518,63429,3578763747,3578763757,10
0,1518,63430,3578763747,3578763757,10
0,1518,63431,3578763747,3578763758,11
0,1518,63432,3578763747,3578763759,12
0,1518,63433,3578763747,3578763759,12
0,1518,63434,3578763747,3578763760,13
0,1518,63435,3578763747,3578763760,13
0,1518,63436,3578763747,3578763761,14
0,1518,63437,3578763747,3578763761,14
0,1518,63438,3578763747,3578763762,15
0,1518,63439,3578763747,3578763762,15
0,1518,63440,3578763747,3578763762,15
0,1518,63441,3578763747,3578763762,15
0,1518,63442,3578763747,3578763762,15
0,1518,63443,3578763747,3578763762,15
0,1518,63444,3578763747,3578763763,16
0,1518,63445,3578763747,3578763763,16
0,1518,63446,3578763747,3578763764,17
0,1518,63447,3578763747,3578763765,18
0,1518,63448,3578763747,3578763765,18
0,1518,63449,3578763747,3578763767,20
0,1518,63450,3578763747,3578763767,20
0,1518,63451,3578763747,3578763768,21
0,1518,63452,3578763747,3578763769,22
0,1518,63453,3578763747,3578763769,22
0,1518,63454,3578763747,3578763771,24
0,1518,63455,3578763747,3578763772,25
0,1518,63456,3578763747,3578763772,25
0,1518,63457,3578763747,3578763772,25
0,1518,63458,3578763747,3578763773,26
0,1518,63459,3578763747,3578763773,26
0,1518,63460,3578763747,3578763773,26
0,1518,63461,3578763747,3578763774,27
0,1518,63462,3578763747,3578763776,29
0,1518,63463,3578763747,3578763778,31
0,1518,63464,3578763747,3578763778,31
0,1518,63465,3578763747,3578763778,31
0,1518,63466,3578763747,3578763778,31
0,1518,63467,3578763747,3578763779,32
0,1518,63468,3578763747,3578763779,32
0,1518,63469,3578763747,3578763780,33
0,1518,63470,3578763747,3578763780,33
0,1518,63471,3578763747,3578763781,34
0,1518,63472,3578763747,3578763781,34
0,1518,63473,3578763747,3578763783,36
0,1518,63474,3578763747,3578763784,37
0,1518,63475,3578763747,3578763785,38
0,1518,63476,3578763747,3578763785,38
0,1518,63477,3578763747,3578763786,39
0,1518,63478,3578763747,3578763787,40
0,1518,63479,3578763747,3578763787,40
0,1518,63480,3578763747,3578763788,41
0,1518,63481,3578763747,3578763788,41
0,1518,63482,3578763747,3578763789,42
0,1518,63483,3578763747,3578763789,42
0,1518,63484,3578763747,3578763789,42
0,1518,63485,3578763747,3578763792,45
0,1518,63486,3578763747,3578763793,46
0,1518,63487,3578763747,3578763793,46
0,1518,63488,3578763747,3578763794,47
0,1518,63489,3578763747,3578763796,49
0,1518,63490,3578763747,3578763796,49
0,1518,63491,3578763747,3578763796,49
0,1518,63492,3578763747,3578763797,50
0,1519,63493,3578763812,3578763812,0
0,1519,63494,3578763812,3578763812,0
0,1519,63495,3578763812,3578763812,0
0,1519,63496,3578763812,3578763812,0
0,1519,63497,3578763812,3578763812,0
0,1519,63498,3578763812,3578763812,0
0,1519,63499,3578763812,3578763812,0
0,1519,63500,3578763812,3578763812,0
0,1519,63501,3578763812,3578763812,0
0,1519,63502,3578763812,3578763812,0
0,1519,63503,3578763812,3578763812,0
0,1519,63504,3578763812,3578763812,0
0,1519,63505,3578763812,3578763812,0
0,1519,63506,3578763812,3578763812,0
0,1519,63507,3578763812,3578763812,0
0,1519,63508,3578763812,3578763812,0
0,1519,63509,3578763812,3578763812,0
0,1519,63510,3578763812,3578763812,0
0,1519,63511,3578763812,3578763812,0
0,1519,63512,3578763812,3578763812,0
0,1519,63513,3578763812,3578763815,3
0,1519,63514,3578763812,3578763815,3
0,1519,63515,3578763812,3578763815,3
0,1519,63516,3578763812,3578763816,4
0,1519,63517,3578763812,3578763816,4
0,1519,63518,3578763812,3578763816,4
0,1519,63519,3578763812,3578763816,4
0,1519,63520,3578763812,3578763817,5
0,1519,63521,3578763812,3578763817,5
0,1519,63522,3578763812,3578763817,5
0,1519,63523,3578763812,3578763818,6
0,1519,63524,3578763812,3578763818,6
0,1519,63525,3578763812,3578763818,6
0,1519,63526,3578763812,3578763819,7
0,1519,63527,3578763812,3578763820,8
0,1519,63528,3578763812,3578763821,9
0,1519,63529,3578763812,3578763821,9
0,1519,63530,3578763812,3578763822,10
0,1519,63531,3578763812,3578763822,10
0,1519,63532,3578763812,3578763823,11
0,1519,63533,3578763812,3578763825,13
0,1519,63534,3578763812,3578763826,14
0,1519,63535,3578763812,3578763826,14
0,1519,63536,3578763812,3578763827,15
0,1519,63537,3578763812,3578763827,15
0,1519,63538,3578763812,3578763828,16
0,1519,63539,3578763812,3578763829,17
0,1519,63540,3578763812,3578763829,17
0,1519,63541,3578763812,3578763830,18
0,1519,63542,3578763812,3578763831,19
0,1519,63543,3578763812,3578763831,19
0,1519,63544,3578763812,3578763832,20
0,1519,63545,3578763812,3578763832,20
0,1519,63546,3578763812,3578763833,21
0,1519,63547,3578763812,3578763834,22
0,1519,63548,3578763812,3578763834,22
0,1519,63549,3578763812,3578763835,23
0,1519,63550,3578763812,3578763836,24
0,1519,63551,3578763812,3578763836,24
0,1519,63552,3578763812,3578763838,26
0,1519,63553,3578763812,3578763838,26
0,1519,63554,3578763812,3578763838,26
0,1519,63555,3578763812,3578763839,27
0,1519,63556,3578763812,3578763839,27
0,1519,63557,3578763812,3578763839,27
0,1519,63558,3578763812,3578763839,27
0,1519,63559,3578763812,3578763840,28
0,1519,63560,3578763812,3578763840,28
0,1519,63561,3578763812,3578763841,29
0,1519,63562,3578763812,3578763842,30
0,1519,63563,3578763812,3578763842,30
0,1519,63564,3578763812,3578763843,31
0,1519,63565,3578763812,3578763844,32
0,1519,63566,3578763812,3578763845,33
0,1519,63567,3578763812,3578763845,33
0,1519,63568,3578763812,3578763846,34
0,1519,63569,3578763812,3578763848,36
0,1519,63570,3578763812,3578763848,36
0,1519,63571,3578763812,3578763848,36
0,1519,63572,3578763812,3578763849,37
0,1519,63573,3578763812,3578763849,37
0,1519,63574,3578763812,3578763849,37
0,1519,63575,3578763812,3578763849,37
0,1519,63576,3578763812,3578763850,38
0,1519,63577,3578763812,3578763851,39
0,1519,63578,3578763812,3578763852,40
0,1519,63579,3578763812,3578763854,42
0,1519,63580,3578763812,3578763855,43
0,1519,63581,3578763812,3578763856,44
0,1519,63582,3578763812,3578763856,44
0,1519,63583,3578763812,3578763856,44
0,1519,63584,3578763812,3578763857,45
0,1519,63585,3578763812,3578763857,45
0,1519,63586,3578763812,3578763858,46
0,1519,63587,3578763812,3578763859,47
0,1519,63588,3578763812,3578763860,48
0,1519,63589,3578763812,3578763861,49
0,1520,63590,3578763876,3578763876,0
0,1520,63591,3578763876,3578763876,0
0,1520,63592,3578763876,3578763876,0
0,1520,63593,3578763876,3578763876,0
0,1520,63594,3578763876,3578763876,0
0,1520,63595,3578763876,3578763876,0
0,1520,63596,3578763876,3578763876,0
0,1520,63597,3578763876,3578763876,0
0,1520,63598,3578763876,3578763876,0
0,1520,63599,3578763876,3578763876,0
0,1520,63600,3578763876,3578763876,0
0,1520,63601,3578763876,3578763876,0
0,1520,63602,3578763876,3578763876,0
0,1520,63603,3578763876,3578763882,6
0,1520,63604,3578763876,3578763884,8
0,1520,63605,3578763876,3578763887,11
0,1520,63606,3578763876,3578763887,11
0,1520,63607,3578763876,3578763888,12
0,1520,63608,3578763876,3578763888,12
0,1520,63609,3578763876,3578763888,12
0,1520,63610,3578763876,3578763889,13
0,1520,63611,3578763876,3578763889,13
0,1520,63612,3578763876,3578763889,13
0,1520,63613,3578763876,3578763889,13
0,1520,63614,3578763876,3578763890,14
0,1520,63615,3578763876,3578763890,14
0,1520,63616,3578763876,3578763891,15
0,1520,63617,3578763876,3578763891,15
0,1520,63618,3578763876,3578763892,16
0,1520,63619,3578763876,3578763892,16
0,1520,63620,3578763876,3578763893,17
0,1520,63621,3578763876,3578763894,18
0,1520,63622,3578763876,3578763894,18
0,1520,63623,3578763876,3578763894,18
0,1520,63624,3578763876,3578763895,19
0,1520,63625,3578763876,3578763896,20
0,1520,63626,3578763876,3578763896,20
0,1520,63627,3578763876,3578763896,20
0,1520,63628,3578763876,3578763897,21
0,1520,63629,3578763876,3578763898,22
0,1520,63630,3578763876,3578763899,23
0,1520,63631,3578763876,3578763899,23
0,1520,63632,3578763876,3578763899,23
0,1520,63633,3578763876,3578763899,23
0,1520,63634,3578763876,3578763900,24
0,1520,63635,3578763876,3578763902,26
0,1520,63636,3578763876,3578763903,27
0,1520,63637,3578763876,3578763904,28
0,1520,63638,3578763876,3578763904,28
0,1520,63639,3578763876,3578763905,29
0,1520,63640,3578763876,3578763906,30
0,1520,63641,3578763876,3578763906,30
0,1520,63642,3578763876,3578763907,31
0,1520,63643,3578763876,3578763907,31
0,1520,63644,3578763876,3578763907,31
0,1520,63645,3578763876,3578763908,32
0,1520,63646,3578763876,3578763908,32
0,1520,63647,3578763876,3578763908,32
0,1520,63648,3578763876,3578763908,32
0,1520,63649,3578763876,3578763908,32
0,1520,63650,3578763876,3578763909,33
0,1520,63651,3578763876,3578763909,33
0,1520,63652,3578763876,3578763909,33
0,1520,63653,3578763876,3578763909,33
0,1520,63654,3578763876,3578763909,33
0,1520,63655,3578763876,3578763910,34
0,1520,63656,3578763876,3578763910,34
0,1520,63657,3578763876,3578763910,34
0,1520,63658,3578763876,3578763911,35
0,1520,63659,3578763876,3578763911,35
0,1520,63660,3578763876,3578763912,36
0,1520,63661,3578763876,3578763912,36
0,1520,63662,3578763876,3578763914,38
0,1520,63663,3578763876,3578763915,39
0,1520,63664,3578763876,3578763915,39
0,1520,63665,3578763876,3578763915,39
0,1520,63666,3578763876,3578763915,39
0,1520,63667,3578763876,3578763915,39
0,1520,63668,3578763876,3578763916,40
0,1520,63669,3578763876,3578763916,40
0,1520,63670,3578763876,3578763916,40
0,1520,63671,3578763876,3578763916,40
0,1520,63672,3578763876,3578763916,40
0,1520,63673,3578763876,3578763917,41
0,1520,63674,3578763876,3578763917,41
0,1520,63675,3578763876,3578763917,41
0,1520,63676,3578763876,3578763917,41
0,1520,63677,3578763876,3578763918,42
0,1520,63678,3578763876,3578763919,43
0,1520,63679,3578763876,3578763919,43
0,1520,63680,3578763876,3578763919,43
0,1520,63681,3578763876,3578763920,44
0,1520,63682,3578763876,3578763921,45
0,1520,63683,3578763876,3578763922,46
0,1520,63684,3578763876,3578763923,47
0,1520,63685,3578763876,3578763924,48
0,1520,63686,3578763876,3578763925,49
0,1520,63687,3578763876,3578763925,49
0,1520,63688,3578763876,3578763925,49
0,1520,63689,3578763876,3578763926,50
0,1521,63690,3578763940,3578763940,0
0,1521,63691,3578763940,3578763940,0
0,1521,63692,3578763940,3578763940,0
0,1521,63693,3578763940,3578763940,0
0,1521,63694,3578763940,3578763940,0
0,1521,63695,3578763940,3578763940,0
0,1521,63696,3578763940,3578763940,0
0,1521,63697,3578763940,3578763940,0
0,1521,63698,3578763940,3578763940,0
0,1521,63699,3578763940,3578763940,0
0,1521,63700,3578763940,3578763940,0
0,1521,63701,3578763940,3578763940,0
0,1521,63702,3578763940,3578763940,0
0,1521,63703,3578763940,3578763940,0
0,1521,63704,3578763940,3578763940,0
0,1521,63705,3578763940,3578763940,0
0,1521,63706,3578763940,3578763940,0
0,1521,63707,3578763940,3578763940,0
0,1521,63708,3578763940,3578763940,0
0,1521,63709,3578763940,3578763940,0
0,1521,63710,3578763940,3578763940,0
0,1521,63711,3578763940,3578763940,0
0,1521,63712,3578763940,3578763940,0
0,1521,63713,3578763940,3578763940,0
0,1521,63714,3578763940,3578763940,0
0,1521,63715,3578763940,3578763940,0
0,1521,63716,3578763940,3578763940,0
0,1521,63717,3578763940,3578763940,0
0,1521,63718,3578763940,3578763940,0
0,1521,63719,3578763940,3578763940,0
0,1521,63720,3578763940,3578763940,0
0,1521,63721,3578763940,3578763940,0
0,1521,63722,3578763940,3578763940,0
0,1521,63723,3578763940,3578763940,0
0,1521,63724,3578763940,3578763940,0
0,1521,63725,3578763940,3578763941,1
0,1521,63726,3578763940,3578763942,2
0,1521,63727,3578763940,3578763942,2
0,1521,63728,3578763940,3578763943,3
0,1521,63729,3578763940,3578763943,3
0,1521,63730,3578763940,3578763943,3
0,1521,63731,3578763940,3578763943,3
0,1521,63732,3578763940,3578763945,5
0,1521,63733,3578763940,3578763946,6
0,1521,63734,3578763940,3578763946,6
0,1521,63735,3578763940,3578763946,6
0,1521,63736,3578763940,3578763947,7
0,1521,63737,3578763940,3578763947,7
0,1521,63738,3578763940,3578763947,7
0,1521,63739,3578763940,3578763948,8
0,1521,63740,3578763940,3578763948,8
0,1521,63741,3578763940,3578763950,10
0,1521,63742,3578763940,3578763950,10
0,1521,63743,3578763940,3578763951,11
0,1521,63744,3578763940,3578763951,11
0,1521,63745,3578763940,3578763952,12
0,1521,63746,3578763940,3578763952,12
0,1521,63747,3578763940,3578763952,12
0,1521,63748,3578763940,3578763953,13
0,1521,63749,3578763940,3578763954,14
0,1521,63750,3578763940,3578763954,14
0,1521,63751,3578763940,3578763955,15
0,1521,63752,3578763940,3578763956,16
0,1521,63753,3578763940,3578763956,16
0,1521,63754,3578763940,3578763956,16
0,1521,63755,3578763940,3578763958,18
0,1521,63756,3578763940,3578763959,19
0,1521,63757,3578763940,3578763959,19
0,1521,63758,3578763940,3578763959,19
0,1521,63759,3578763940,3578763960,20
0,1521,63760,3578763940,3578763961,21
0,1521,63761,3578763940,3578763962,22
0,1521,63762,3578763940,3578763962,22
0,1521,63763,3578763940,3578763962,22
0,1521,63764,3578763940,3578763962,22
0,1521,63765,3578763940,3578763962,22
0,1521,63766,3578763940,3578763962,22
0,1521,63767,3578763940,3578763962,22
0,1521,63768,3578763940,3578763963,23
0,1521,63769,3578763940,3578763963,23
0,1521,63770,3578763940,3578763965,25
0,1521,63771,3578763940,3578763967,27
0,1521,63772,3578763940,3578763968,28
0,1521,63773,3578763940,3578763969,29
0,1521,63774,3578763940,3578763969,29
0,1521,63775,3578763940,3578763970,30
0,1521,63776,3578763940,3578763970,30
0,1521,63777,3578763940,3578763970,30
0,1521,63778,3578763940,3578763972,32
0,1521,63779,3578763940,3578763973,33
0,1521,63780,3578763940,3578763973,33
0,1521,63781,3578763940,3578763974,34
0,1521,63782,3578763940,3578763974,34
0,1521,63783,3578763940,3578763975,35
0,1521,63784,3578763940,3578763975,35
0,1521,63785,3578763940,3578763976,36
0,1521,63786,3578763940,3578763977,37
0,1521,63787,3578763940,3578763978,38
0,1521,63788,3578763940,3578763978,38
0,1521,63789,3578763940,3578763979,39
0,1521,63790,3578763940,3578763979,39
0,1521,63791,3578763940,3578763979,39
0,1521,63792,3578763940,3578763980,40
0,1521,63793,3578763940,3578763980,40
0,1521,63794,3578763940,3578763983,43
0,1521,63795,3578763940,3578763983,43
0,1521,63796,3578763940,3578763984,44
0,1521,63797,3578763940,3578763984,44
0,1521,63798,3578763940,3578763985,45
0,1521,63799,3578763940,3578763985,45
0,1521,63800,3578763940,3578763985,45
0,1521,63801,3578763940,3578763987,47
0,1521,63802,3578763940,3578763988,48
0,1521,63803,3578763940,3578763988,48
0,1521,63804,3578763940,3578763988,48
0,1521,63805,3578763940,3578763989,49
0,1521,63806,3578763940,3578763989,49
0,1522,63807,3578764019,3578764019,0
0,1522,63808,3578764019,3578764019,0
0,1522,63809,3578764019,3578764019,0
0,1522,63810,3578764019,3578764019,0
0,1522,63811,3578764019,3578764019,0
0,1522,63812,3578764019,3578764019,0
0,1522,63813,3578764019,3578764019,0
0,1522,63814,3578764019,3578764019,0
0,1522,63815,3578764019,3578764019,0
0,1522,63816,3578764019,3578764019,0
0,1522,63817,3578764019,3578764019,0
0,1522,63818,3578764019,3578764019,0
0,1522,63819,3578764019,3578764019,0
0,1522,63820,3578764019,3578764019,0
0,1522,63821,3578764019,3578764019,0
0,1522,63822,3578764019,3578764019,0
0,1522,63823,3578764019,3578764019,0
0,1522,63824,3578764019,3578764019,0
0,1522,63825,3578764019,3578764019,0
0,1522,63826,3578764019,3578764019,0
0,1522,63827,3578764019,3578764019,0
0,1522,63828,3578764019,3578764019,0
0,1522,63829,3578764019,3578764019,0
0,1522,63830,3578764019,3578764019,0
0,1522,63831,3578764019,3578764019,0
0,1522,63832,3578764019,3578764019,0
0,1522,63833,3578764019,3578764019,0
0,1522,63834,3578764019,3578764019,0
0,1522,63835,3578764019,3578764019,0
0,1522,63836,3578764019,3578764019,0
0,1522,63837,3578764019,3578764019,0
0,1522,63838,3578764019,3578764019,0
0,1522,63839,3578764019,3578764019,0
0,1522,63840,3578764019,3578764019,0
0,1522,63841,3578764019,3578764019,0
0,1522,63842,3578764019,3578764019,0
0,1522,63843,3578764019,3578764019,0
0,1522,63844,3578764019,3578764019,0
0,1522,63845,3578764019,3578764019,0
0,1522,63846,3578764019,3578764019,0
0,1522,63847,3578764019,3578764019,0
0,1522,63848,3578764019,3578764019,0
0,1522,63849,3578764019,3578764019,0
0,1522,63850,3578764019,3578764019,0
0,1522,63851,3578764019,3578764019,0
0,1522,63852,3578764019,3578764020,1
0,1522,63853,3578764019,3578764020,1
0,1522,63854,3578764019,3578764021,2
0,1522,63855,3578764019,3578764021,2
0,1522,63856,3578764019,3578764023,4
0,1522,63857,3578764019,3578764023,4
0,1522,63858,3578764019,3578764024,5
0,1522,63859,3578764019,3578764024,5
0,1522,63860,3578764019,3578764025,6
0,1522,63861,3578764019,3578764026,7
0,1522,63862,3578764019,3578764026,7
0,1522,63863,3578764019,3578764027,8
0,1522,63864,3578764019,3578764028,9
0,1522,63865,3578764019,3578764028,9
0,1522,63866,3578764019,3578764029,10
0,1522,63867,3578764019,3578764029,10
0,1522,63868,3578764019,3578764030,11
0,1522,63869,3578764019,3578764031,12
0,1522,63870,3578764019,3578764032,13
0,1522,63871,3578764019,3578764032,13
0,1522,63872,3578764019,3578764032,13
0,1522,63873,3578764019,3578764033,14
0,1522,63874,3578764019,3578764034,15
0,1522,63875,3578764019,3578764035,16
0,1522,63876,3578764019,3578764035,16
0,1522,63877,3578764019,3578764036,17
0,1522,63878,3578764019,3578764036,17
0,1522,63879,3578764019,3578764038,19
0,1522,63880,3578764019,3578764038,19
0,1522,63881,3578764019,3578764039,20
0,1522,63882,3578764019,3578764039,20
0,1522,63883,3578764019,3578764040,21
0,1522,63884,3578764019,3578764040,21
0,1522,63885,3578764019,3578764041,22
0,1522,63886,3578764019,3578764041,22
0,1522,63887,3578764019,3578764042,23
0,1522,63888,3578764019,3578764043,24
0,1522,63889,3578764019,3578764044,25
0,1522,63890,3578764019,3578764044,25
0,1522,63891,3578764019,3578764045,26
0,1522,63892,3578764019,3578764045,26
0,1522,63893,3578764019,3578764047,28
0,1522,63894,3578764019,3578764048,29
0,1522,63895,3578764019,3578764048,29
0,1522,63896,3578764019,3578764048,29
0,1522,63897,3578764019,3578764049,30
0,1522,63898,3578764019,3578764049,30
0,1522,63899,3578764019,3578764049,30
0,1522,63900,3578764019,3578764050,31
0,1522,63901,3578764019,3578764050,31
0,1522,63902,3578764019,3578764050,31
0,1522,63903,3578764019,3578764052,33
0,1522,63904,3578764019,3578764053,34
0,1522,63905,3578764019,3578764054,35
0,1522,63906,3578764019,3578764055,36
0,1522,63907,3578764019,3578764056,37
0,1522,63908,3578764019,3578764057,38
0,1522,63909,3578764019,3578764057,38
0,1522,63910,3578764019,3578764057,38
0,1522,63911,3578764019,3578764058,39
0,1522,63912,3578764019,3578764059,40
0,1522,63913,3578764019,3578764059,40
0,1522,63914,3578764019,3578764060,41
0,1522,63915,3578764019,3578764061,42
0,1522,63916,3578764019,3578764062,43
0,1522,63917,3578764019,3578764062,43
0,1522,63918,3578764019,3578764063,44
0,1522,63919,3578764019,3578764063,44
0,1522,63920,3578764019,3578764063,44
0,1522,63921,3578764019,3578764064,45
0,1522,63922,3578764019,3578764064,45
0,1522,63923,3578764019,3578764065,46
0,1522,63924,3578764019,3578764066,47
0,1522,63925,3578764019,3578764067,48
0,1522,63926,3578764019,3578764067,48
0,1522,63927,3578764019,3578764068,49
0,1523,63928,3578764083,3578764083,0
0,1523,63929,3578764083,3578764083,0
0,1523,63930,3578764083,3578764085,2
0,1523,63931,3578764083,3578764087,4
0,1523,63932,3578764083,3578764088,5
0,1523,63933,3578764083,3578764088,5
0,1523,63934,3578764083,3578764088,5
0,1523,63935,3578764083,3578764088,5
0,1523,63936,3578764083,3578764089,6
0,1523,63937,3578764083,3578764089,6
0,1523,63938,3578764083,3578764090,7
0,1523,63939,3578764083,3578764090,7
0,1523,63940,3578764083,3578764090,7
0,1523,63941,3578764083,3578764091,8
0,1523,63942,3578764083,3578764091,8
0,1523,63943,3578764083,3578764092,9
0,1523,63944,3578764083,3578764093,10
0,1523,63945,3578764083,3578764094,11
0,1523,63946,3578764083,3578764095,12
0,1523,63947,3578764083,3578764095,12
0,1523,63948,3578764083,3578764096,13
0,1523,63949,3578764083,3578764096,13
0,1523,63950,3578764083,3578764096,13
0,1523,63951,3578764083,3578764096,13
0,1523,63952,3578764083,3578764097,14
0,1523,63953,3578764083,3578764098,15
0,1523,63954,3578764083,3578764098,15
0,1523,63955,3578764083,3578764099,16
0,1523,63956,3578764083,3578764099,16
0,1523,63957,3578764083,3578764100,17
0,1523,63958,3578764083,3578764100,17
0,1523,63959,3578764083,3578764101,18
0,1523,63960,3578764083,3578764101,18
0,1523,63961,3578764083,3578764102,19
0,1523,63962,3578764083,3578764103,20
0,1523,63963,3578764083,3578764103,20
0,1523,63964,3578764083,3578764104,21
0,1523,63965,3578764083,3578764105,22
0,1523,63966,3578764083,3578764106,23
0,1523,63967,3578764083,3578764106,23
0,1523,63968,3578764083,3578764107,24
0,1523,63969,3578764083,3578764107,24
0,1523,63970,3578764083,3578764107,24
0,1523,63971,3578764083,3578764108,25
0,1523,63972,3578764083,3578764108,25
0,1523,63973,3578764083,3578764108,25
0,1523,63974,3578764083,3578764108,25
0,1523,63975,3578764083,3578764108,25
0,1523,63976,3578764083,3578764108,25
0,1523,63977,3578764083,3578764109,26
0,1523,63978,3578764083,3578764109,26
0,1523,63979,3578764083,3578764109,26
0,1523,63980,3578764083,3578764110,27
0,1523,63981,3578764083,3578764110,27
0,1523,63982,3578764083,3578764110,27
0,1523,63983,3578764083,3578764110,27
0,1523,63984,3578764083,3578764110,27
0,1523,63985,3578764083,3578764110,27
0,1523,63986,3578764083,3578764110,27
0,1523,63987,3578764083,3578764113,30
0,1523,63988,3578764083,3578764114,31
0,1523,63989,3578764083,3578764115,32
0,1523,63990,3578764083,3578764116,33
0,1523,63991,3578764083,3578764116,33
0,1523,63992,3578764083,3578764116,33
0,1523,63993,3578764083,3578764116,33
0,1523,63994,3578764083,3578764116,33
0,1523,63995,3578764083,3578764116,33
0,1523,63996,3578764083,3578764117,34
0,1523,63997,3578764083,3578764117,34
0,1523,63998,3578764083,3578764117,34
0,1523,63999,3578764083,3578764117,34
0,1523,64000,3578764083,3578764117,34
0,1523,64001,3578764083,3578764119,36
0,1523,64002,3578764083,3578764119,36
0,1523,64003,3578764083,3578764119,36
0,1523,64004,3578764083,3578764120,37
0,1523,64005,3578764083,3578764120,37
0,1523,64006,3578764083,3578764120,37
0,1523,64007,3578764083,3578764122,39
0,1523,64008,3578764083,3578764123,40
0,1523,64009,3578764083,3578764124,41
0,1523,64010,3578764083,3578764124,41
0,1523,64011,3578764083,3578764125,42
0,1523,64012,3578764083,3578764126,43
0,1523,64013,3578764083,3578764126,43
0,1523,64014,3578764083,3578764126,43
0,1523,64015,3578764083,3578764126,43
0,1523,64016,3578764083,3578764126,43
0,1523,64017,3578764083,3578764126,43
0,1523,64018,3578764083,3578764127,44
0,1523,64019,3578764083,3578764127,44
0,1523,64020,3578764083,3578764127,44
0,1523,64021,3578764083,3578764127,44
0,1523,64022,3578764083,3578764127,44
0,1523,64023,3578764083,3578764127,44
0,1523,64024,3578764083,3578764128,45
0,1523,64025,3578764083,3578764128,45
0,1523,64026,3578764083,3578764128,45
0,1523,64027,3578764083,3578764129,46
0,1523,64028,3578764083,3578764130,47
0,1523,64029,3578764083,3578764130,47
0,1523,64030,3578764083,3578764130,47
0,1523,64031,3578764083,3578764130,47
0,1523,64032,3578764083,3578764130,47
0,1523,64033,3578764083,3578764131,48
0,1523,64034,3578764083,3578764132,49
0,1523,64035,3578764083,3578764132,49
0,1523,64036,3578764083,3578764132,49
0,1523,64037,3578764083,3578764132,49
0,1523,64038,3578764083,3578764133,50
0,1524,64039,3578764147,3578764147,0
0,1524,64040,3578764147,3578764147,0
0,1524,64041,3578764147,3578764147,0
0,1524,64042,3578764147,3578764147,0
0,1524,64043,3578764147,3578764147,0
0,1524,64044,3578764147,3578764147,0
0,1524,64045,3578764147,3578764147,0
0,1524,64046,3578764147,3578764147,0
0,1524,64047,3578764147,3578764147,0
0,1524,64048,3578764147,3578764147,0
0,1524,64049,3578764147,3578764147,0
0,1524,64050,3578764147,3578764147,0
0,1524,64051,3578764147,3578764147,0
0,1524,64052,3578764147,3578764147,0
0,1524,64053,3578764147,3578764147,0
0,1524,64054,3578764147,3578764147,0
0,1524,64055,3578764147,3578764147,0
0,1524,64056,3578764147,3578764147,0
0,1524,64057,3578764147,3578764147,0
0,1524,64058,3578764147,3578764147,0
0,1524,64059,3578764147,3578764147,0
0,1524,64060,3578764147,3578764147,0
0,1524,64061,3578764147,3578764147,0
0,1524,64062,3578764147,3578764148,1
0,1524,64063,3578764147,3578764149,2
0,1524,64064,3578764147,3578764150,3
0,1524,64065,3578764147,3578764151,4
0,1524,64066,3578764147,3578764151,4
0,1524,64067,3578764147,3578764151,4
0,1524,64068,3578764147,3578764152,5
0,1524,64069,3578764147,3578764152,5
0,1524,64070,3578764147,3578764153,6
0,1524,64071,3578764147,3578764153,6
0,1524,64072,3578764147,3578764153,6
0,1524,64073,3578764147,3578764154,7
0,1524,64074,3578764147,3578764154,7
0,1524,64075,3578764147,3578764155,8
0,1524,64076,3578764147,3578764156,9
0,1524,64077,3578764147,3578764156,9
0,1524,64078,3578764147,3578764156,9
0,1524,64079,3578764147,3578764157,10
0,1524,64080,3578764147,3578764157,10
0,1524,64081,3578764147,3578764158,11
0,1524,64082,3578764147,3578764158,11
0,1524,64083,3578764147,3578764159,12
0,1524,64084,3578764147,3578764159,12
0,1524,64085,3578764147,3578764161,14
0,1524,64086,3578764147,3578764161,14
0,1524,64087,3578764147,3578764161,14
0,1524,64088,3578764147,3578764161,14
0,1524,64089,3578764147,3578764162,15
0,1524,64090,3578764147,3578764162,15
0,1524,64091,3578764147,3578764162,15
0,1524,64092,3578764147,3578764162,15
0,1524,64093,3578764147,3578764163,16
0,1524,64094,3578764147,3578764163,16
0,1524,64095,3578764147,3578764163,16
0,1524,64096,3578764147,3578764163,16
0,1524,64097,3578764147,3578764165,18
0,1524,64098,3578764147,3578764168,21
0,1524,64099,3578764147,3578764169,22
0,1524,64100,3578764147,3578764170,23
0,1524,64101,3578764147,3578764171,24
0,1524,64102,3578764147,3578764171,24
0,1524,64103,3578764147,3578764172,25
0,1524,64104,3578764147,3578764172,25
0,1524,64105,3578764147,3578764173,26
0,1524,64106,3578764147,3578764173,26
0,1524,64107,3578764147,3578764173,26
0,1524,64108,3578764147,3578764174,27
0,1524,64109,3578764147,3578764174,27
0,1524,64110,3578764147,3578764174,27
0,1524,64111,3578764147,3578764176,29
0,1524,64112,3578764147,3578764176,29
0,1524,64113,3578764147,3578764176,29
0,1524,64114,3578764147,3578764178,31
0,1524,64115,3578764147,3578764178,31
0,1524,64116,3578764147,3578764179,32
0,1524,64117,3578764147,3578764179,32
0,1524,64118,3578764147,3578764179,32
0,1524,64119,3578764147,3578764179,32
0,1524,64120,3578764147,3578764181,34
0,1524,64121,3578764147,3578764182,35
0,1524,64122,3578764147,3578764183,36
0,1524,64123,3578764147,3578764183,36
0,1524,64124,3578764147,3578764184,37
0,1524,64125,3578764147,3578764185,38
0,1524,64126,3578764147,3578764186,39
0,1524,64127,3578764147,3578764187,40
0,1524,64128,3578764147,3578764188,41
0,1524,64129,3578764147,3578764188,41
0,1524,64130,3578764147,3578764189,42
0,1524,64131,3578764147,3578764189,42
0,1524,64132,3578764147,3578764189,42
0,1524,64133,3578764147,3578764192,45
0,1524,64134,3578764147,3578764192,45
0,1524,64135,3578764147,3578764193,46
0,1524,64136,3578764147,3578764193,46
0,1524,64137,3578764147,3578764193,46
0,1524,64138,3578764147,3578764194,47
0,1524,64139,3578764147,3578764195,48
0,1524,64140,3578764147,3578764196,49
0,1524,64141,3578764147,3578764197,50
0,1525,64142,3578764211,3578764211,0
0,1525,64143,3578764211,3578764211,0
0,1525,64144,3578764211,3578764211,0
0,1525,64145,3578764211,3578764211,0
0,1525,64146,3578764211,3578764211,0
0,1525,64147,3578764211,3578764211,0
0,1525,64148,3578764211,3578764211,0
0,1525,64149,3578764211,3578764211,0
0,1525,64150,3578764211,3578764211,0
0,1525,64151,3578764211,3578764211,0
0,1525,64152,3578764211,3578764211,0
0,1525,64153,3578764211,3578764211,0
0,1525,64154,3578764211,3578764211,0
0,1525,64155,3578764211,3578764211,0
0,1525,64156,3578764211,3578764211,0
0,1525,64157,3578764211,3578764211,0
0,1525,64158,3578764211,3578764211,0
0,1525,64159,3578764211,3578764211,0
0,1525,64160,3578764211,3578764212,1
0,1525,64161,3578764211,3578764212,1
0,1525,64162,3578764211,3578764212,1
0,1525,64163,3578764211,3578764213,2
0,1525,64164,3578764211,3578764214,3
0,1525,64165,3578764211,3578764214,3
0,1525,64166,3578764211,3578764215,4
0,1525,64167,3578764211,3578764215,4
0,1525,64168,3578764211,3578764216,5
0,1525,64169,3578764211,3578764216,5
0,1525,64170,3578764211,3578764216,5
0,1525,64171,3578764211,3578764216,5
0,1525,64172,3578764211,3578764217,6
0,1525,64173,3578764211,3578764217,6
0,1525,64174,3578764211,3578764217,6
0,1525,64175,3578764211,3578764217,6
0,1525,64176,3578764211,3578764218,7
0,1525,64177,3578764211,3578764218,7
0,1525,64178,3578764211,3578764218,7
0,1525,64179,3578764211,3578764218,7
0,1525,64180,3578764211,3578764219,8
0,1525,64181,3578764211,3578764220,9
0,1525,64182,3578764211,3578764220,9
0,1525,64183,3578764211,3578764221,10
0,1525,64184,3578764211,3578764221,10
0,1525,64185,3578764211,3578764222,11
0,1525,64186,3578764211,3578764223,12
0,1525,64187,3578764211,3578764224,13
0,1525,64188,3578764211,3578764224,13
0,1525,64189,3578764211,3578764225,14
0,1525,64190,3578764211,3578764226,15
0,1525,64191,3578764211,3578764227,16
0,1525,64192,3578764211,3578764227,16
0,1525,64193,3578764211,3578764228,17
0,1525,64194,3578764211,3578764228,17
0,1525,64195,3578764211,3578764230,19
0,1525,64196,3578764211,3578764230,19
0,1525,64197,3578764211,3578764230,19
0,1525,64198,3578764211,3578764230,19
0,1525,64199,3578764211,3578764230,19
0,1525,64200,3578764211,3578764231,20
0,1525,64201,3578764211,3578764231,20
0,1525,64202,3578764211,3578764232,21
0,1525,64203,3578764211,3578764232,21
0,1525,64204,3578764211,3578764233,22
0,1525,64205,3578764211,3578764233,22
0,1525,64206,3578764211,3578764235,24
0,1525,64207,3578764211,3578764235,24
0,1525,64208,3578764211,3578764235,24
0,1525,64209,3578764211,3578764235,24
0,1525,64210,3578764211,3578764237,26
0,1525,64211,3578764211,3578764237,26
0,1525,64212,3578764211,3578764238,27
0,1525,64213,3578764211,3578764239,28
0,1525,64214,3578764211,3578764239,28
0,1525,64215,3578764211,3578764239,28
0,1525,64216,3578764211,3578764239,28
0,1525,64217,3578764211,3578764240,29
0,1525,64218,3578764211,3578764240,29
0,1525,64219,3578764211,3578764241,30
0,1525,64220,3578764211,3578764242,31
0,1525,64221,3578764211,3578764242,31
0,1525,64222,3578764211,3578764243,32
0,1525,64223,3578764211,3578764243,32
0,1525,64224,3578764211,3578764245,34
0,1525,64225,3578764211,3578764245,34
0,1525,64226,3578764211,3578764245,34
0,1525,64227,3578764211,3578764246,35
0,1525,64228,3578764211,3578764247,36
0,1525,64229,3578764211,3578764247,36
0,1525,64230,3578764211,3578764247,36
0,1525,64231,3578764211,3578764248,37
0,1525,64232,3578764211,3578764249,38
0,1525,64233,3578764211,3578764249,38
0,1525,64234,3578764211,3578764249,38
0,1525,64235,3578764211,3578764249,38
0,1525,64236,3578764211,3578764249,38
0,1525,64237,3578764211,3578764250,39
0,1525,64238,3578764211,3578764250,39
0,1525,64239,3578764211,3578764250,39
0,1525,64240,3578764211,3578764252,41
0,1525,64241,3578764211,3578764253,42
0,1525,64242,3578764211,3578764256,45
0,1525,64243,3578764211,3578764256,45
0,1525,64244,3578764211,3578764256,45
0,1525,64245,3578764211,3578764256,45
0,1525,64246,3578764211,3578764259,48
0,1525,64247,3578764211,3578764259,48
0,1525,64248,3578764211,3578764259,48
0,1525,64249,3578764211,3578764260,49
0,1526,64250,3578764274,3578764274,0
0,1526,64251,3578764274,3578764274,0
0,1526,64252,3578764274,3578764274,0
0,1526,64253,3578764274,3578764274,0
0,1526,64254,3578764274,3578764274,0
0,1526,64255,3578764274,3578764274,0
0,1526,64256,3578764274,3578764274,0
0,1526,64257,3578764274,3578764274,0
0,1526,64258,3578764274,3578764274,0
0,1526,64259,3578764274,3578764274,0
0,1526,64260,3578764274,3578764274,0
0,1526,64261,3578764274,3578764274,0
0,1526,64262,3578764274,3578764274,0
0,1526,64263,3578764274,3578764274,0
0,1526,64264,3578764274,3578764274,0
0,1526,64265,3578764274,3578764274,0
0,1526,64266,3578764274,3578764281,7
0,1526,64267,3578764274,3578764285,11
0,1526,64268,3578764274,3578764287,13
0,1526,64269,3578764274,3578764287,13
0,1526,64270,3578764274,3578764288,14
0,1526,64271,3578764274,3578764288,14
0,1526,64272,3578764274,3578764288,14
0,1526,64273,3578764274,3578764289,15
0,1526,64274,3578764274,3578764290,16
0,1526,64275,3578764274,3578764290,16
0,1526,64276,3578764274,3578764290,16
0,1526,64277,3578764274,3578764290,16
0,1526,64278,3578764274,3578764291,17
0,1526,64279,3578764274,3578764291,17
0,1526,64280,3578764274,3578764292,18
0,1526,64281,3578764274,3578764292,18
0,1526,64282,3578764274,3578764293,19
0,1526,64283,3578764274,3578764293,19
0,1526,64284,3578764274,3578764294,20
0,1526,64285,3578764274,3578764295,21
0,1526,64286,3578764274,3578764295,21
0,1526,64287,3578764274,3578764296,22
0,1526,64288,3578764274,3578764296,22
0,1526,64289,3578764274,3578764297,23
0,1526,64290,3578764274,3578764298,24
0,1526,64291,3578764274,3578764299,25
0,1526,64292,3578764274,3578764299,25
0,1526,64293,3578764274,3578764299,25
0,1526,64294,3578764274,3578764299,25
0,1526,64295,3578764274,3578764300,26
0,1526,64296,3578764274,3578764301,27
0,1526,64297,3578764274,3578764301,27
0,1526,64298,3578764274,3578764302,28
0,1526,64299,3578764274,3578764302,28
0,1526,64300,3578764274,3578764304,30
0,1526,64301,3578764274,3578764304,30
0,1526,64302,3578764274,3578764305,31
0,1526,64303,3578764274,3578764305,31
0,1526,64304,3578764274,3578764306,32
0,1526,64305,3578764274,3578764307,33
0,1526,64306,3578764274,3578764307,33
0,1526,64307,3578764274,3578764308,34
0,1526,64308,3578764274,3578764308,34
0,1526,64309,3578764274,3578764308,34
0,1526,64310,3578764274,3578764308,34
0,1526,64311,3578764274,3578764308,34
0,1526,64312,3578764274,3578764309,35
0,1526,64313,3578764274,3578764309,35
0,1526,64314,3578764274,3578764310,36
0,1526,64315,3578764274,3578764310,36
0,1526,64316,3578764274,3578764310,36
0,1526,64317,3578764274,3578764310,36
0,1526,64318,3578764274,3578764310,36
0,1526,64319,3578764274,3578764310,36
0,1526,64320,3578764274,3578764311,37
0,1526,64321,3578764274,3578764311,37
0,1526,64322,3578764274,3578764311,37
0,1526,64323,3578764274,3578764313,39
0,1526,64324,3578764274,3578764315,41
0,1526,64325,3578764274,3578764315,41
0,1526,64326,3578764274,3578764315,41
0,1526,64327,3578764274,3578764316,42
0,1526,64328,3578764274,3578764316,42
0,1526,64329,3578764274,3578764316,42
0,1526,64330,3578764274,3578764316,42
0,1526,64331,3578764274,3578764316,42
0,1526,64332,3578764274,3578764317,43
0,1526,64333,3578764274,3578764317,43
0,1526,64334,3578764274,3578764317,43
0,1526,64335,3578764274,3578764318,44
0,1526,64336,3578764274,3578764319,45
0,1526,64337,3578764274,3578764319,45
0,1526,64338,3578764274,3578764319,45
0,1526,64339,3578764274,3578764319,45
0,1526,64340,3578764274,3578764319,45
0,1526,64341,3578764274,3578764320,46
0,1526,64342,3578764274,3578764320,46
0,1526,64343,3578764274,3578764321,47
0,1526,64344,3578764274,3578764323,49
0,1526,64345,3578764274,3578764323,49
0,1527,64346,3578764340,3578764340,0
0,1527,64347,3578764340,3578764340,0
0,1527,64348,3578764340,3578764340,0
0,1527,64349,3578764340,3578764340,0
0,1527,64350,3578764340,3578764340,0
0,1527,64351,3578764340,3578764340,0
0,1527,64352,3578764340,3578764340,0
0,1527,64353,3578764340,3578764340,0
0,1527,64354,3578764340,3578764340,0
0,1527,64355,3578764340,3578764340,0
0,1527,64356,3578764340,3578764340,0
0,1527,64357,3578764340,3578764340,0
0,1527,64358,3578764340,3578764340,0
0,1527,64359,3578764340,3578764340,0
0,1527,64360,3578764340,3578764340,0
0,1527,64361,3578764340,3578764340,0
0,1527,64362,3578764340,3578764340,0
0,1527,64363,3578764340,3578764340,0
0,1527,64364,3578764340,3578764340,0
0,1527,64365,3578764340,3578764340,0
0,1527,64366,3578764340,3578764340,0
0,1527,64367,3578764340,3578764340,0
0,1527,64368,3578764340,3578764340,0
0,1527,64369,3578764340,3578764340,0
0,1527,64370,3578764340,3578764340,0
0,1527,64371,3578764340,3578764340,0
0,1527,64372,3578764340,3578764340,0
0,1527,64373,3578764340,3578764340,0
0,1527,64374,3578764340,3578764340,0
0,1527,64375,3578764340,3578764340,0
0,1527,64376,3578764340,3578764340,0
0,1527,64377,3578764340,3578764340,0
0,1527,64378,3578764340,3578764340,0
0,1527,64379,3578764340,3578764340,0
0,1527,64380,3578764340,3578764340,0
0,1527,64381,3578764340,3578764340,0
0,1527,64382,3578764340,3578764340,0
0,1527,64383,3578764340,3578764340,0
0,1527,64384,3578764340,3578764340,0
0,1527,64385,3578764340,3578764340,0
0,1527,64386,3578764340,3578764340,0
0,1527,64387,3578764340,3578764340,0
0,1527,64388,3578764340,3578764340,0
0,1527,64389,3578764340,3578764341,1
0,1527,64390,3578764340,3578764341,1
0,1527,64391,3578764340,3578764342,2
0,1527,64392,3578764340,3578764342,2
0,1527,64393,3578764340,3578764343,3
0,1527,64394,3578764340,3578764343,3
0,1527,64395,3578764340,3578764343,3
0,1527,64396,3578764340,3578764343,3
0,1527,64397,3578764340,3578764344,4
0,1527,64398,3578764340,3578764345,5
0,1527,64399,3578764340,3578764346,6
0,1527,64400,3578764340,3578764347,7
0,1527,64401,3578764340,3578764347,7
0,1527,64402,3578764340,3578764347,7
0,1527,64403,3578764340,3578764348,8
0,1527,64404,3578764340,3578764348,8
0,1527,64405,3578764340,3578764349,9
0,1527,64406,3578764340,3578764349,9
0,1527,64407,3578764340,3578764351,11
0,1527,64408,3578764340,3578764351,11
0,1527,64409,3578764340,3578764352,12
0,1527,64410,3578764340,3578764352,12
0,1527,64411,3578764340,3578764352,12
0,1527,64412,3578764340,3578764353,13
0,1527,64413,3578764340,3578764353,13
0,1527,64414,3578764340,3578764353,13
0,1527,64415,3578764340,3578764354,14
0,1527,64416,3578764340,3578764355,15
0,1527,64417,3578764340,3578764356,16
0,1527,64418,3578764340,3578764356,16
0,1527,64419,3578764340,3578764357,17
0,1527,64420,3578764340,3578764358,18
0,1527,64421,3578764340,3578764358,18
0,1527,64422,3578764340,3578764358,18
0,1527,64423,3578764340,3578764359,19
0,1527,64424,3578764340,3578764359,19
0,1527,64425,3578764340,3578764360,20
0,1527,64426,3578764340,3578764360,20
0,1527,64427,3578764340,3578764361,21
0,1527,64428,3578764340,3578764361,21
0,1527,64429,3578764340,3578764361,21
0,1527,64430,3578764340,3578764362,22
0,1527,64431,3578764340,3578764362,22
0,1527,64432,3578764340,3578764362,22
0,1527,64433,3578764340,3578764362,22
0,1527,64434,3578764340,3578764362,22
0,1527,64435,3578764340,3578764363,23
0,1527,64436,3578764340,3578764363,23
0,1527,64437,3578764340,3578764363,23
0,1527,64438,3578764340,3578764364,24
0,1527,64439,3578764340,3578764366,26
0,1527,64440,3578764340,3578764367,27
0,1527,64441,3578764340,3578764367,27
0,1527,64442,3578764340,3578764368,28
0,1527,64443,3578764340,3578764369,29
0,1527,64444,3578764340,3578764370,30
0,1527,64445,3578764340,3578764371,31
0,1527,64446,3578764340,3578764371,31
0,1527,64447,3578764340,3578764371,31
0,1527,64448,3578764340,3578764372,32
0,1527,64449,3578764340,3578764373,33
0,1527,64450,3578764340,3578764373,33
0,1527,64451,3578764340,3578764374,34
0,1527,64452,3578764340,3578764374,34
0,1527,64453,3578764340,3578764374,34
0,1527,64454,3578764340,3578764375,35
0,1527,64455,3578764340,3578764375,35
0,1527,64456,3578764340,3578764376,36
0,1527,64457,3578764340,3578764376,36
0,1527,64458,3578764340,3578764378,38
0,1527,64459,3578764340,3578764378,38
0,1527,64460,3578764340,3578764379,39
0,1527,64461,3578764340,3578764379,39
0,1527,64462,3578764340,3578764379,39
0,1527,64463,3578764340,3578764379,39
0,1527,64464,3578764340,3578764380,40
0,1527,64465,3578764340,3578764382,42
0,1527,64466,3578764340,3578764383,43
0,1527,64467,3578764340,3578764383,43
0,1527,64468,3578764340,3578764383,43
0,1527,64469,3578764340,3578764384,44
0,1527,64470,3578764340,3578764386,46
0,1527,64471,3578764340,3578764387,47
0,1527,64472,3578764340,3578764387,47
0,1527,64473,3578764340,3578764388,48
0,1527,64474,3578764340,3578764389,49
0,1527,64475,3578764340,3578764389,49
0,1527,64476,3578764340,3578764389,49
0,1527,64477,3578764340,3578764390,50
0,1528,64478,3578764404,3578764404,0
0,1528,64479,3578764404,3578764404,0
0,1528,64480,3578764404,3578764404,0
0,1528,64481,3578764404,3578764404,0
0,1528,64482,3578764404,3578764404,0
0,1528,64483,3578764404,3578764404,0
0,1528,64484,3578764404,3578764404,0
0,1528,64485,3578764404,3578764404,0
0,1528,64486,3578764404,3578764404,0
0,1528,64487,3578764404,3578764404,0
0,1528,64488,3578764404,3578764404,0
0,1528,64489,3578764404,3578764404,0
0,1528,64490,3578764404,3578764405,1
0,1528,64491,3578764404,3578764405,1
0,1528,64492,3578764404,3578764405,1
0,1528,64493,3578764404,3578764405,1
0,1528,64494,3578764404,3578764405,1
0,1528,64495,3578764404,3578764405,1
0,1528,64496,3578764404,3578764406,2
0,1528,64497,3578764404,3578764406,2
0,1528,64498,3578764404,3578764407,3
0,1528,64499,3578764404,3578764407,3
0,1528,64500,3578764404,3578764409,5
0,1528,64501,3578764404,3578764409,5
0,1528,64502,3578764404,3578764410,6
0,1528,64503,3578764404,3578764412,8
0,1528,64504,3578764404,3578764412,8
0,1528,64505,3578764404,3578764412,8
0,1528,64506,3578764404,3578764413,9
0,1528,64507,3578764404,3578764414,10
0,1528,64508,3578764404,3578764414,10
0,1528,64509,3578764404,3578764415,11
0,1528,64510,3578764404,3578764415,11
0,1528,64511,3578764404,3578764415,11
0,1528,64512,3578764404,3578764415,11
0,1528,64513,3578764404,3578764416,12
0,1528,64514,3578764404,3578764417,13
0,1528,64515,3578764404,3578764417,13
0,1528,64516,3578764404,3578764417,13
0,1528,64517,3578764404,3578764417,13
0,1528,64518,3578764404,3578764417,13
0,1528,64519,3578764404,3578764418,14
0,1528,64520,3578764404,3578764418,14
0,1528,64521,3578764404,3578764419,15
0,1528,64522,3578764404,3578764419,15
0,1528,64523,3578764404,3578764419,15
0,1528,64524,3578764404,3578764420,16
0,1528,64525,3578764404,3578764421,17
0,1528,64526,3578764404,3578764422,18
0,1528,64527,3578764404,3578764422,18
0,1528,64528,3578764404,3578764422,18
0,1528,64529,3578764404,3578764423,19
0,1528,64530,3578764404,3578764424,20
0,1528,64531,3578764404,3578764425,21
0,1528,64532,3578764404,3578764425,21
0,1528,64533,3578764404,3578764426,22
0,1528,64534,3578764404,3578764427,23
0,1528,64535,3578764404,3578764427,23
0,1528,64536,3578764404,3578764427,23
0,1528,64537,3578764404,3578764429,25
0,1528,64538,3578764404,3578764429,25
0,1528,64539,3578764404,3578764430,26
0,1528,64540,3578764404,3578764431,27
0,1528,64541,3578764404,3578764431,27
0,1528,64542,3578764404,3578764431,27
0,1528,64543,3578764404,3578764431,27
0,1528,64544,3578764404,3578764431,27
0,1528,64545,3578764404,3578764432,28
0,1528,64546,3578764404,3578764433,29
0,1528,64547,3578764404,3578764433,29
0,1528,64548,3578764404,3578764433,29
0,1528,64549,3578764404,3578764435,31
0,1528,64550,3578764404,3578764435,31
0,1528,64551,3578764404,3578764435,31
0,1528,64552,3578764404,3578764435,31
0,1528,64553,3578764404,3578764438,34
0,1528,64554,3578764404,3578764438,34
0,1528,64555,3578764404,3578764439,35
0,1528,64556,3578764404,3578764439,35
0,1528,64557,3578764404,3578764439,35
0,1528,64558,3578764404,3578764439,35
0,1528,64559,3578764404,3578764440,36
0,1528,64560,3578764404,3578764440,36
0,1528,64561,3578764404,3578764441,37
0,1528,64562,3578764404,3578764441,37
0,1528,64563,3578764404,3578764441,37
0,1528,64564,3578764404,3578764442,38
0,1528,64565,3578764404,3578764443,39
0,1528,64566,3578764404,3578764443,39
0,1528,64567,3578764404,3578764445,41
0,1528,64568,3578764404,3578764445,41
0,1528,64569,3578764404,3578764446,42
0,1528,64570,3578764404,3578764447,43
0,1528,64571,3578764404,3578764447,43
0,1528,64572,3578764404,3578764448,44
0,1528,64573,3578764404,3578764448,44
0,1528,64574,3578764404,3578764449,45
0,1528,64575,3578764404,3578764449,45
0,1528,64576,3578764404,3578764449,45
0,1528,64577,3578764404,3578764449,45
0,1528,64578,3578764404,3578764450,46
0,1528,64579,3578764404,3578764450,46
0,1528,64580,3578764404,3578764452,48
0,1528,64581,3578764404,3578764453,49
0,1529,64582,3578764468,3578764468,0
0,1529,64583,3578764468,3578764468,0
0,1529,64584,3578764468,3578764468,0
0,1529,64585,3578764468,3578764468,0
0,1529,64586,3578764468,3578764468,0
0,1529,64587,3578764468,3578764468,0
0,1529,64588,3578764468,3578764468,0
0,1529,64589,3578764468,3578764468,0
0,1529,64590,3578764468,3578764468,0
0,1529,64591,3578764468,3578764468,0
0,1529,64592,3578764468,3578764468,0
0,1529,64593,3578764468,3578764468,0
0,1529,64594,3578764468,3578764468,0
0,1529,64595,3578764468,3578764468,0
0,1529,64596,3578764468,3578764468,0
0,1529,64597,3578764468,3578764468,0
0,1529,64598,3578764468,3578764468,0
0,1529,64599,3578764468,3578764468,0
0,1529,64600,3578764468,3578764468,0
0,1529,64601,3578764468,3578764468,0
0,1529,64602,3578764468,3578764469,1
0,1529,64603,3578764468,3578764471,3
0,1529,64604,3578764468,3578764481,13
0,1529,64605,3578764468,3578764482,14
0,1529,64606,3578764468,3578764487,19
0,1529,64607,3578764468,3578764488,20
0,1529,64608,3578764468,3578764488,20
0,1529,64609,3578764468,3578764488,20
0,1529,64610,3578764468,3578764489,21
0,1529,64611,3578764468,3578764489,21
0,1529,64612,3578764468,3578764490,22
0,1529,64613,3578764468,3578764490,22
0,1529,64614,3578764468,3578764490,22
0,1529,64615,3578764468,3578764490,22
0,1529,64616,3578764468,3578764491,23
0,1529,64617,3578764468,3578764492,24
0,1529,64618,3578764468,3578764493,25
0,1529,64619,3578764468,3578764494,26
0,1529,64620,3578764468,3578764494,26
0,1529,64621,3578764468,3578764494,26
0,1529,64622,3578764468,3578764495,27
0,1529,64623,3578764468,3578764496,28
0,1529,64624,3578764468,3578764496,28
0,1529,64625,3578764468,3578764496,28
0,1529,64626,3578764468,3578764497,29
0,1529,64627,3578764468,3578764498,30
0,1529,64628,3578764468,3578764498,30
0,1529,64629,3578764468,3578764498,30
0,1529,64630,3578764468,3578764499,31
0,1529,64631,3578764468,3578764499,31
0,1529,64632,3578764468,3578764500,32
0,1529,64633,3578764468,3578764501,33
0,1529,64634,3578764468,3578764501,33
0,1529,64635,3578764468,3578764501,33
0,1529,64636,3578764468,3578764503,35
0,1529,64637,3578764468,3578764504,36
0,1529,64638,3578764468,3578764504,36
0,1529,64639,3578764468,3578764505,37
0,1529,64640,3578764468,3578764505,37
0,1529,64641,3578764468,3578764506,38
0,1529,64642,3578764468,3578764507,39
0,1529,64643,3578764468,3578764508,40
0,1529,64644,3578764468,3578764508,40
0,1529,64645,3578764468,3578764508,40
0,1529,64646,3578764468,3578764508,40
0,1529,64647,3578764468,3578764508,40
0,1529,64648,3578764468,3578764508,40
0,1529,64649,3578764468,3578764508,40
0,1529,64650,3578764468,3578764508,40
0,1529,64651,3578764468,3578764509,41
0,1529,64652,3578764468,3578764509,41
0,1529,64653,3578764468,3578764509,41
0,1529,64654,3578764468,3578764510,42
0,1529,64655,3578764468,3578764510,42
0,1529,64656,3578764468,3578764510,42
0,1529,64657,3578764468,3578764510,42
0,1529,64658,3578764468,3578764510,42
0,1529,64659,3578764468,3578764511,43
0,1529,64660,3578764468,3578764512,44
0,1529,64661,3578764468,3578764512,44
0,1529,64662,3578764468,3578764513,45
0,1529,64663,3578764468,3578764515,47
0,1529,64664,3578764468,3578764515,47
0,1529,64665,3578764468,3578764516,48
0,1529,64666,3578764468,3578764516,48
0,1529,64667,3578764468,3578764516,48
0,1529,64668,3578764468,3578764516,48
0,1529,64669,3578764468,3578764517,49
0,1529,64670,3578764468,3578764517,49
0,1529,64671,3578764468,3578764517,49
0,1529,64672,3578764468,3578764517,49
0,1529,64673,3578764468,3578764518,50
0,1530,64674,3578764532,3578764532,0
0,1530,64675,3578764532,3578764532,0
0,1530,64676,3578764532,3578764532,0
0,1530,64677,3578764532,3578764532,0
0,1530,64678,3578764532,3578764532,0
0,1530,64679,3578764532,3578764532,0
0,1530,64680,3578764532,3578764532,0
0,1530,64681,3578764532,3578764532,0
0,1530,64682,3578764532,3578764532,0
0,1530,64683,3578764532,3578764532,0
0,1530,64684,3578764532,3578764532,0
0,1530,64685,3578764532,3578764532,0
0,1530,64686,3578764532,3578764532,0
0,1530,64687,3578764532,3578764532,0
0,1530,64688,3578764532,3578764532,0
0,1530,64689,3578764532,3578764532,0
0,1530,64690,3578764532,3578764532,0
0,1530,64691,3578764532,3578764532,0
0,1530,64692,3578764532,3578764532,0
0,1530,64693,3578764532,3578764532,0
0,1530,64694,3578764532,3578764532,0
0,1530,64695,3578764532,3578764532,0
0,1530,64696,3578764532,3578764532,0
0,1530,64697,3578764532,3578764532,0
0,1530,64698,3578764532,3578764532,0
0,1530,64699,3578764532,3578764532,0
0,1530,64700,3578764532,3578764532,0
0,1530,64701,3578764532,3578764532,0
0,1530,64702,3578764532,3578764532,0
0,1530,64703,3578764532,3578764532,0
0,1530,64704,3578764532,3578764532,0
0,1530,64705,3578764532,3578764532,0
0,1530,64706,3578764532,3578764532,0
0,1530,64707,3578764532,3578764532,0
0,1530,64708,3578764532,3578764533,1
0,1530,64709,3578764532,3578764533,1
0,1530,64710,3578764532,3578764534,2
0,1530,64711,3578764532,3578764534,2
0,1530,64712,3578764532,3578764534,2
0,1530,64713,3578764532,3578764536,4
0,1530,64714,3578764532,3578764537,5
0,1530,64715,3578764532,3578764538,6
0,1530,64716,3578764532,3578764538,6
0,1530,64717,3578764532,3578764539,7
0,1530,64718,3578764532,3578764539,7
0,1530,64719,3578764532,3578764539,7
0,1530,64720,3578764532,3578764539,7
0,1530,64721,3578764532,3578764540,8
0,1530,64722,3578764532,3578764540,8
0,1530,64723,3578764532,3578764541,9
0,1530,64724,3578764532,3578764541,9
0,1530,64725,3578764532,3578764542,10
0,1530,64726,3578764532,3578764542,10
0,1530,64727,3578764532,3578764543,11
0,1530,64728,3578764532,3578764543,11
0,1530,64729,3578764532,3578764543,11
0,1530,64730,3578764532,3578764544,12
0,1530,64731,3578764532,3578764545,13
0,1530,64732,3578764532,3578764545,13
0,1530,64733,3578764532,3578764545,13
0,1530,64734,3578764532,3578764546,14
0,1530,64735,3578764532,3578764547,15
0,1530,64736,3578764532,3578764547,15
0,1530,64737,3578764532,3578764547,15
0,1530,64738,3578764532,3578764549,17
0,1530,64739,3578764532,3578764549,17
0,1530,64740,3578764532,3578764550,18
0,1530,64741,3578764532,3578764550,18
0,1530,64742,3578764532,3578764552,20
0,1530,64743,3578764532,3578764552,20
0,1530,64744,3578764532,3578764552,20
0,1530,64745,3578764532,3578764552,20
0,1530,64746,3578764532,3578764552,20
0,1530,64747,3578764532,3578764552,20
0,1530,64748,3578764532,3578764553,21
0,1530,64749,3578764532,3578764555,23
0,1530,64750,3578764532,3578764555,23
0,1530,64751,3578764532,3578764555,23
0,1530,64752,3578764532,3578764556,24
0,1530,64753,3578764532,3578764556,24
0,1530,64754,3578764532,3578764557,25
0,1530,64755,3578764532,3578764557,25
0,1530,64756,3578764532,3578764558,26
0,1530,64757,3578764532,3578764558,26
0,1530,64758,3578764532,3578764558,26
0,1530,64759,3578764532,3578764560,28
0,1530,64760,3578764532,3578764560,28
0,1530,64761,3578764532,3578764560,28
0,1530,64762,3578764532,3578764560,28
0,1530,64763,3578764532,3578764561,29
0,1530,64764,3578764532,3578764561,29
0,1530,64765,3578764532,3578764561,29
0,1530,64766,3578764532,3578764561,29
0,1530,64767,3578764532,3578764562,30
0,1530,64768,3578764532,3578764562,30
0,1530,64769,3578764532,3578764562,30
0,1530,64770,3578764532,3578764562,30
0,1530,64771,3578764532,3578764564,32
0,1530,64772,3578764532,3578764564,32
0,1530,64773,3578764532,3578764564,32
0,1530,64774,3578764532,3578764565,33
0,1530,64775,3578764532,3578764566,34
0,1530,64776,3578764532,3578764567,35
0,1530,64777,3578764532,3578764569,37
0,1530,64778,3578764532,3578764571,39
0,1530,64779,3578764532,3578764571,39
0,1530,64780,3578764532,3578764571,39
0,1530,64781,3578764532,3578764571,39
0,1530,64782,3578764532,3578764571,39
0,1530,64783,3578764532,3578764572,40
0,1530,64784,3578764532,3578764572,40
0,1530,64785,3578764532,3578764573,41
0,1530,64786,3578764532,3578764573,41
0,1530,64787,3578764532,3578764573,41
0,1530,64788,3578764532,3578764574,42
0,1530,64789,3578764532,3578764574,42
0,1530,64790,3578764532,3578764575,43
0,1530,64791,3578764532,3578764577,45
0,1530,64792,3578764532,3578764577,45
0,1530,64793,3578764532,3578764578,46
0,1530,64794,3578764532,3578764578,46
0,1530,64795,3578764532,3578764578,46
0,1530,64796,3578764532,3578764578,46
0,1530,64797,3578764532,3578764579,47
0,1530,64798,3578764532,3578764580,48
0,1530,64799,3578764532,3578764580,48
0,1530,64800,3578764532,3578764581,49
0,1531,64801,3578764598,3578764598,0
0,1531,64802,3578764598,3578764598,0
0,1531,64803,3578764598,3578764598,0
0,1531,64804,3578764598,3578764598,0
0,1531,64805,3578764598,3578764598,0
0,1531,64806,3578764598,3578764598,0
0,1531,64807,3578764598,3578764598,0
0,1531,64808,3578764598,3578764598,0
0,1531,64809,3578764598,3578764598,0
0,1531,64810,3578764598,3578764598,0
0,1531,64811,3578764598,3578764598,0
0,1531,64812,3578764598,3578764598,0
0,1531,64813,3578764598,3578764598,0
0,1531,64814,3578764598,3578764598,0
0,1531,64815,3578764598,3578764598,0
0,1531,64816,3578764598,3578764598,0
0,1531,64817,3578764598,3578764598,0
0,1531,64818,3578764598,3578764598,0
0,1531,64819,3578764598,3578764598,0
0,1531,64820,3578764598,3578764598,0
0,1531,64821,3578764598,3578764599,1
0,1531,64822,3578764598,3578764600,2
0,1531,64823,3578764598,3578764601,3
0,1531,64824,3578764598,3578764602,4
0,1531,64825,3578764598,3578764603,5
0,1531,64826,3578764598,3578764603,5
0,1531,64827,3578764598,3578764604,6
0,1531,64828,3578764598,3578764604,6
0,1531,64829,3578764598,3578764604,6
0,1531,64830,3578764598,3578764606,8
0,1531,64831,3578764598,3578764606,8
0,1531,64832,3578764598,3578764608,10
0,1531,64833,3578764598,3578764608,10
0,1531,64834,3578764598,3578764610,12
0,1531,64835,3578764598,3578764611,13
0,1531,64836,3578764598,3578764612,14
0,1531,64837,3578764598,3578764612,14
0,1531,64838,3578764598,3578764613,15
0,1531,64839,3578764598,3578764614,16
0,1531,64840,3578764598,3578764614,16
0,1531,64841,3578764598,3578764614,16
0,1531,64842,3578764598,3578764614,16
0,1531,64843,3578764598,3578764615,17
0,1531,64844,3578764598,3578764615,17
0,1531,64845,3578764598,3578764616,18
0,1531,64846,3578764598,3578764616,18
0,1531,64847,3578764598,3578764617,19
0,1531,64848,3578764598,3578764617,19
0,1531,64849,3578764598,3578764617,19
0,1531,64850,3578764598,3578764617,19
0,1531,64851,3578764598,3578764617,19
0,1531,64852,3578764598,3578764618,20
0,1531,64853,3578764598,3578764619,21
0,1531,64854,3578764598,3578764621,23
0,1531,64855,3578764598,3578764621,23
0,1531,64856,3578764598,3578764621,23
0,1531,64857,3578764598,3578764622,24
0,1531,64858,3578764598,3578764622,24
0,1531,64859,3578764598,3578764623,25
0,1531,64860,3578764598,3578764624,26
0,1531,64861,3578764598,3578764624,26
0,1531,64862,3578764598,3578764624,26
0,1531,64863,3578764598,3578764625,27
0,1531,64864,3578764598,3578764627,29
0,1531,64865,3578764598,3578764628,30
0,1531,64866,3578764598,3578764628,30
0,1531,64867,3578764598,3578764629,31
0,1531,64868,3578764598,3578764629,31
0,1531,64869,3578764598,3578764630,32
0,1531,64870,3578764598,3578764630,32
0,1531,64871,3578764598,3578764630,32
0,1531,64872,3578764598,3578764630,32
0,1531,64873,3578764598,3578764632,34
0,1531,64874,3578764598,3578764632,34
0,1531,64875,3578764598,3578764632,34
0,1531,64876,3578764598,3578764633,35
0,1531,64877,3578764598,3578764633,35
0,1531,64878,3578764598,3578764634,36
0,1531,64879,3578764598,3578764635,37
0,1531,64880,3578764598,3578764636,38
0,1531,64881,3578764598,3578764637,39
0,1531,64882,3578764598,3578764637,39
0,1531,64883,3578764598,3578764638,40
0,1531,64884,3578764598,3578764638,40
0,1531,64885,3578764598,3578764639,41
0,1531,64886,3578764598,3578764639,41
0,1531,64887,3578764598,3578764639,41
0,1531,64888,3578764598,3578764639,41
0,1531,64889,3578764598,3578764640,42
0,1531,64890,3578764598,3578764640,42
0,1531,64891,3578764598,3578764641,43
0,1531,64892,3578764598,3578764641,43
0,1531,64893,3578764598,3578764642,44
0,1531,64894,3578764598,3578764644,46
0,1531,64895,3578764598,3578764644,46
0,1531,64896,3578764598,3578764645,47
0,1531,64897,3578764598,3578764646,48
0,1531,64898,3578764598,3578764646,48
0,1531,64899,3578764598,3578764647,49
0,1531,64900,3578764598,3578764648,50
0,1532,64901,3578764663,3578764663,0
0,1532,64902,3578764663,3578764663,0
0,1532,64903,3578764663,3578764663,0
0,1532,64904,3578764663,3578764663,0
0,1532,64905,3578764663,3578764663,0
0,1532,64906,3578764663,3578764663,0
0,1532,64907,3578764663,3578764663,0
0,1532,64908,3578764663,3578764663,0
0,1532,64909,3578764663,3578764663,0
0,1532,64910,3578764663,3578764663,0
0,1532,64911,3578764663,3578764663,0
0,1532,64912,3578764663,3578764663,0
0,1532,64913,3578764663,3578764663,0
0,1532,64914,3578764663,3578764663,0
0,1532,64915,3578764663,3578764663,0
0,1532,64916,3578764663,3578764663,0
0,1532,64917,3578764663,3578764663,0
0,1532,64918,3578764663,3578764663,0
0,1532,64919,3578764663,3578764664,1
0,1532,64920,3578764663,3578764664,1
0,1532,64921,3578764663,3578764664,1
0,1532,64922,3578764663,3578764664,1
0,1532,64923,3578764663,3578764664,1
0,1532,64924,3578764663,3578764664,1
0,1532,64925,3578764663,3578764665,2
0,1532,64926,3578764663,3578764665,2
0,1532,64927,3578764663,3578764666,3
0,1532,64928,3578764663,3578764666,3
0,1532,64929,3578764663,3578764667,4
0,1532,64930,3578764663,3578764667,4
0,1532,64931,3578764663,3578764667,4
0,1532,64932,3578764663,3578764668,5
0,1532,64933,3578764663,3578764669,6
0,1532,64934,3578764663,3578764671,8
0,1532,64935,3578764663,3578764682,19
0,1532,64936,3578764663,3578764685,22
0,1532,64937,3578764663,3578764687,24
0,1532,64938,3578764663,3578764688,25
0,1532,64939,3578764663,3578764688,25
0,1532,64940,3578764663,3578764688,25
0,1532,64941,3578764663,3578764689,26
0,1532,64942,3578764663,3578764689,26
0,1532,64943,3578764663,3578764690,27
0,1532,64944,3578764663,3578764690,27
0,1532,64945,3578764663,3578764691,28
0,1532,64946,3578764663,3578764691,28
0,1532,64947,3578764663,3578764691,28
0,1532,64948,3578764663,3578764692,29
0,1532,64949,3578764663,3578764693,30
0,1532,64950,3578764663,3578764693,30
0,1532,64951,3578764663,3578764693,30
0,1532,64952,3578764663,3578764694,31
0,1532,64953,3578764663,3578764694,31
0,1532,64954,3578764663,3578764694,31
0,1532,64955,3578764663,3578764695,32
0,1532,64956,3578764663,3578764696,33
0,1532,64957,3578764663,3578764696,33
0,1532,64958,3578764663,3578764698,35
0,1532,64959,3578764663,3578764698,35
0,1532,64960,3578764663,3578764698,35
0,1532,64961,3578764663,3578764698,35
0,1532,64962,3578764663,3578764699,36
0,1532,64963,3578764663,3578764699,36
0,1532,64964,3578764663,3578764700,37
0,1532,64965,3578764663,3578764701,38
0,1532,64966,3578764663,3578764701,38
0,1532,64967,3578764663,3578764702,39
0,1532,64968,3578764663,3578764703,40
0,1532,64969,3578764663,3578764704,41
0,1532,64970,3578764663,3578764705,42
0,1532,64971,3578764663,3578764705,42
0,1532,64972,3578764663,3578764706,43
0,1532,64973,3578764663,3578764706,43
0,1532,64974,3578764663,3578764706,43
0,1532,64975,3578764663,3578764707,44
0,1532,64976,3578764663,3578764707,44
0,1532,64977,3578764663,3578764707,44
0,1532,64978,3578764663,3578764708,45
0,1532,64979,3578764663,3578764708,45
0,1532,64980,3578764663,3578764708,45
0,1532,64981,3578764663,3578764708,45
0,1532,64982,3578764663,3578764708,45
0,1532,64983,3578764663,3578764709,46
0,1532,64984,3578764663,3578764709,46
0,1532,64985,3578764663,3578764709,46
0,1532,64986,3578764663,3578764710,47
0,1532,64987,3578764663,3578764710,47
0,1532,64988,3578764663,3578764710,47
0,1532,64989,3578764663,3578764710,47
0,1532,64990,3578764663,3578764711,48
0,1532,64991,3578764663,3578764711,48
0,1532,64992,3578764663,3578764712,49
0,1532,64993,3578764663,3578764712,49
0,1532,64994,3578764663,3578764713,50
0,1533,64995,3578764727,3578764727,0
0,1533,64996,3578764727,3578764727,0
0,1533,64997,3578764727,3578764727,0
0,1533,64998,3578764727,3578764727,0
0,1533,64999,3578764727,3578764727,0
0,1533,65000,3578764727,3578764727,0
0,1533,65001,3578764727,3578764727,0
0,1533,65002,3578764727,3578764727,0
0,1533,65003,3578764727,3578764727,0
0,1533,65004,3578764727,3578764727,0
0,1533,65005,3578764727,3578764727,0
0,1533,65006,3578764727,3578764727,0
0,1533,65007,3578764727,3578764727,0
0,1533,65008,3578764727,3578764727,0
0,1533,65009,3578764727,3578764727,0
0,1533,65010,3578764727,3578764727,0
0,1533,65011,3578764727,3578764727,0
0,1533,65012,3578764727,3578764727,0
0,1533,65013,3578764727,3578764727,0
0,1533,65014,3578764727,3578764727,0
0,1533,65015,3578764727,3578764727,0
0,1533,65016,3578764727,3578764727,0
0,1533,65017,3578764727,3578764727,0
0,1533,65018,3578764727,3578764727,0
0,1533,65019,3578764727,3578764727,0
0,1533,65020,3578764727,3578764727,0
0,1533,65021,3578764727,3578764727,0
0,1533,65022,3578764727,3578764727,0
0,1533,65023,3578764727,3578764727,0
0,1533,65024,3578764727,3578764727,0
0,1533,65025,3578764727,3578764727,0
0,1533,65026,3578764727,3578764727,0
0,1533,65027,3578764727,3578764728,1
0,1533,65028,3578764727,3578764728,1
0,1533,65029,3578764727,3578764728,1
0,1533,65030,3578764727,3578764729,2
0,1533,65031,3578764727,3578764730,3
0,1533,65032,3578764727,3578764730,3
0,1533,65033,3578764727,3578764731,4
0,1533,65034,3578764727,3578764732,5
0,1533,65035,3578764727,3578764732,5
0,1533,65036,3578764727,3578764732,5
0,1533,65037,3578764727,3578764732,5
0,1533,65038,3578764727,3578764732,5
0,1533,65039,3578764727,3578764732,5
0,1533,65040,3578764727,3578764733,6
0,1533,65041,3578764727,3578764734,7
0,1533,65042,3578764727,3578764734,7
0,1533,65043,3578764727,3578764734,7
0,1533,65044,3578764727,3578764734,7
0,1533,65045,3578764727,3578764735,8
0,1533,65046,3578764727,3578764736,9
0,1533,65047,3578764727,3578764738,11
0,1533,65048,3578764727,3578764739,12
0,1533,65049,3578764727,3578764739,12
0,1533,65050,3578764727,3578764739,12
0,1533,65051,3578764727,3578764739,12
0,1533,65052,3578764727,3578764740,13
0,1533,65053,3578764727,3578764740,13
0,1533,65054,3578764727,3578764741,14
0,1533,65055,3578764727,3578764741,14
0,1533,65056,3578764727,3578764742,15
0,1533,65057,3578764727,3578764742,15
0,1533,65058,3578764727,3578764743,16
0,1533,65059,3578764727,3578764743,16
0,1533,65060,3578764727,3578764743,16
0,1533,65061,3578764727,3578764744,17
0,1533,65062,3578764727,3578764745,18
0,1533,65063,3578764727,3578764746,19
0,1533,65064,3578764727,3578764746,19
0,1533,65065,3578764727,3578764746,19
0,1533,65066,3578764727,3578764747,20
0,1533,65067,3578764727,3578764747,20
0,1533,65068,3578764727,3578764747,20
0,1533,65069,3578764727,3578764747,20
0,1533,65070,3578764727,3578764748,21
0,1533,65071,3578764727,3578764748,21
0,1533,65072,3578764727,3578764748,21
0,1533,65073,3578764727,3578764749,22
0,1533,65074,3578764727,3578764750,23
0,1533,65075,3578764727,3578764751,24
0,1533,65076,3578764727,3578764752,25
0,1533,65077,3578764727,3578764752,25
0,1533,65078,3578764727,3578764752,25
0,1533,65079,3578764727,3578764753,26
0,1533,65080,3578764727,3578764753,26
0,1533,65081,3578764727,3578764753,26
0,1533,65082,3578764727,3578764755,28
0,1533,65083,3578764727,3578764756,29
0,1533,65084,3578764727,3578764756,29
0,1533,65085,3578764727,3578764757,30
0,1533,65086,3578764727,3578764757,30
0,1533,65087,3578764727,3578764757,30
0,1533,65088,3578764727,3578764758,31
0,1533,65089,3578764727,3578764758,31
0,1533,65090,3578764727,3578764759,32
0,1533,65091,3578764727,3578764760,33
0,1533,65092,3578764727,3578764760,33
0,1533,65093,3578764727,3578764761,34
0,1533,65094,3578764727,3578764761,34
0,1533,65095,3578764727,3578764761,34
0,1533,65096,3578764727,3578764761,34
0,1533,65097,3578764727,3578764761,34
0,1533,65098,3578764727,3578764761,34
0,1533,65099,3578764727,3578764762,35
0,1533,65100,3578764727,3578764762,35
0,1533,65101,3578764727,3578764762,35
0,1533,65102,3578764727,3578764762,35
0,1533,65103,3578764727,3578764764,37
0,1533,65104,3578764727,3578764764,37
0,1533,65105,3578764727,3578764765,38
0,1533,65106,3578764727,3578764765,38
0,1533,65107,3578764727,3578764765,38
0,1533,65108,3578764727,3578764766,39
0,1533,65109,3578764727,3578764767,40
0,1533,65110,3578764727,3578764769,42
0,1533,65111,3578764727,3578764770,43
0,1533,65112,3578764727,3578764770,43
0,1533,65113,3578764727,3578764771,44
0,1533,65114,3578764727,3578764771,44
0,1533,65115,3578764727,3578764771,44
0,1533,65116,3578764727,3578764772,45
0,1533,65117,3578764727,3578764773,46
0,1533,65118,3578764727,3578764773,46
0,1533,65119,3578764727,3578764773,46
0,1533,65120,3578764727,3578764773,46
0,1533,65121,3578764727,3578764773,46
0,1533,65122,3578764727,3578764774,47
0,1533,65123,3578764727,3578764776,49
0,1534,65124,3578764791,3578764791,0
0,1534,65125,3578764791,3578764791,0
0,1534,65126,3578764791,3578764791,0
0,1534,65127,3578764791,3578764791,0
0,1534,65128,3578764791,3578764791,0
0,1534,65129,3578764791,3578764791,0
0,1534,65130,3578764791,3578764791,0
0,1534,65131,3578764791,3578764791,0
0,1534,65132,3578764791,3578764791,0
0,1534,65133,3578764791,3578764791,0
0,1534,65134,3578764791,3578764791,0
0,1534,65135,3578764791,3578764791,0
0,1534,65136,3578764791,3578764791,0
0,1534,65137,3578764791,3578764791,0
0,1534,65138,3578764791,3578764791,0
0,1534,65139,3578764791,3578764791,0
0,1534,65140,3578764791,3578764791,0
0,1534,65141,3578764791,3578764791,0
0,1534,65142,3578764791,3578764791,0
0,1534,65143,3578764791,3578764791,0
0,1534,65144,3578764791,3578764791,0
0,1534,65145,3578764791,3578764791,0
0,1534,65146,3578764791,3578764792,1
0,1534,65147,3578764791,3578764793,2
0,1534,65148,3578764791,3578764793,2
0,1534,65149,3578764791,3578764793,2
0,1534,65150,3578764791,3578764795,4
0,1534,65151,3578764791,3578764796,5
0,1534,65152,3578764791,3578764797,6
0,1534,65153,3578764791,3578764798,7
0,1534,65154,3578764791,3578764799,8
0,1534,65155,3578764791,3578764799,8
0,1534,65156,3578764791,3578764800,9
0,1534,65157,3578764791,3578764802,11
0,1534,65158,3578764791,3578764802,11
0,1534,65159,3578764791,3578764803,12
0,1534,65160,3578764791,3578764803,12
0,1534,65161,3578764791,3578764804,13
0,1534,65162,3578764791,3578764805,14
0,1534,65163,3578764791,3578764806,15
0,1534,65164,3578764791,3578764807,16
0,1534,65165,3578764791,3578764808,17
0,1534,65166,3578764791,3578764809,18
0,1534,65167,3578764791,3578764810,19
0,1534,65168,3578764791,3578764811,20
0,1534,65169,3578764791,3578764811,20
0,1534,65170,3578764791,3578764812,21
0,1534,65171,3578764791,3578764813,22
0,1534,65172,3578764791,3578764814,23
0,1534,65173,3578764791,3578764814,23
0,1534,65174,3578764791,3578764814,23
0,1534,65175,3578764791,3578764815,24
0,1534,65176,3578764791,3578764815,24
0,1534,65177,3578764791,3578764816,25
0,1534,65178,3578764791,3578764816,25
0,1534,65179,3578764791,3578764817,26
0,1534,65180,3578764791,3578764817,26
0,1534,65181,3578764791,3578764817,26
0,1534,65182,3578764791,3578764817,26
0,1534,65183,3578764791,3578764818,27
0,1534,65184,3578764791,3578764818,27
0,1534,65185,3578764791,3578764818,27
0,1534,65186,3578764791,3578764819,28
0,1534,65187,3578764791,3578764821,30
0,1534,65188,3578764791,3578764821,30
0,1534,65189,3578764791,3578764821,30
0,1534,65190,3578764791,3578764822,31
0,1534,65191,3578764791,3578764823,32
0,1534,65192,3578764791,3578764824,33
0,1534,65193,3578764791,3578764824,33
0,1534,65194,3578764791,3578764824,33
0,1534,65195,3578764791,3578764824,33
0,1534,65196,3578764791,3578764826,35
0,1534,65197,3578764791,3578764828,37
0,1534,65198,3578764791,3578764829,38
0,1534,65199,3578764791,3578764829,38
0,1534,65200,3578764791,3578764829,38
0,1534,65201,3578764791,3578764830,39
0,1534,65202,3578764791,3578764830,39
0,1534,65203,3578764791,3578764830,39
0,1534,65204,3578764791,3578764831,40
0,1534,65205,3578764791,3578764832,41
0,1534,65206,3578764791,3578764834,43
0,1534,65207,3578764791,3578764834,43
0,1534,65208,3578764791,3578764835,44
0,1534,65209,3578764791,3578764836,45
0,1534,65210,3578764791,3578764836,45
0,1534,65211,3578764791,3578764837,46
0,1534,65212,3578764791,3578764838,47
0,1534,65213,3578764791,3578764838,47
0,1534,65214,3578764791,3578764838,47
0,1534,65215,3578764791,3578764839,48
0,1534,65216,3578764791,3578764839,48
0,1534,65217,3578764791,3578764839,48
0,1534,65218,3578764791,3578764839,48
0,1534,65219,3578764791,3578764841,50
0,1535,65220,3578764855,3578764855,0
0,1535,65221,3578764855,3578764855,0
0,1535,65222,3578764855,3578764855,0
0,1535,65223,3578764855,3578764855,0
0,1535,65224,3578764855,3578764855,0
0,1535,65225,3578764855,3578764855,0
0,1535,65226,3578764855,3578764855,0
0,1535,65227,3578764855,3578764855,0
0,1535,65228,3578764855,3578764855,0
0,1535,65229,3578764855,3578764855,0
0,1535,65230,3578764855,3578764855,0
0,1535,65231,3578764855,3578764855,0
0,1535,65232,3578764855,3578764855,0
0,1535,65233,3578764855,3578764855,0
0,1535,65234,3578764855,3578764855,0
0,1535,65235,3578764855,3578764855,0
0,1535,65236,3578764855,3578764855,0
0,1535,65237,3578764855,3578764855,0
0,1535,65238,3578764855,3578764855,0
0,1535,65239,3578764855,3578764855,0
0,1535,65240,3578764855,3578764855,0
0,1535,65241,3578764855,3578764856,1
0,1535,65242,3578764855,3578764856,1
0,1535,65243,3578764855,3578764857,2
0,1535,65244,3578764855,3578764857,2
0,1535,65245,3578764855,3578764858,3
0,1535,65246,3578764855,3578764858,3
0,1535,65247,3578764855,3578764860,5
0,1535,65248,3578764855,3578764860,5
0,1535,65249,3578764855,3578764862,7
0,1535,65250,3578764855,3578764862,7
0,1535,65251,3578764855,3578764863,8
0,1535,65252,3578764855,3578764863,8
0,1535,65253,3578764855,3578764864,9
0,1535,65254,3578764855,3578764864,9
0,1535,65255,3578764855,3578764864,9
0,1535,65256,3578764855,3578764865,10
0,1535,65257,3578764855,3578764865,10
0,1535,65258,3578764855,3578764866,11
0,1535,65259,3578764855,3578764866,11
0,1535,65260,3578764855,3578764867,12
0,1535,65261,3578764855,3578764867,12
0,1535,65262,3578764855,3578764869,14
0,1535,65263,3578764855,3578764881,26
0,1535,65264,3578764855,3578764882,27
0,1535,65265,3578764855,3578764885,30
0,1535,65266,3578764855,3578764887,32
0,1535,65267,3578764855,3578764887,32
0,1535,65268,3578764855,3578764888,33
0,1535,65269,3578764855,3578764889,34
0,1535,65270,3578764855,3578764890,35
0,1535,65271,3578764855,3578764890,35
0,1535,65272,3578764855,3578764891,36
0,1535,65273,3578764855,3578764891,36
0,1535,65274,3578764855,3578764892,37
0,1535,65275,3578764855,3578764893,38
0,1535,65276,3578764855,3578764893,38
0,1535,65277,3578764855,3578764894,39
0,1535,65278,3578764855,3578764894,39
0,1535,65279,3578764855,3578764894,39
0,1535,65280,3578764855,3578764894,39
0,1535,65281,3578764855,3578764895,40
0,1535,65282,3578764855,3578764896,41
0,1535,65283,3578764855,3578764896,41
0,1535,65284,3578764855,3578764896,41
0,1535,65285,3578764855,3578764898,43
0,1535,65286,3578764855,3578764898,43
0,1535,65287,3578764855,3578764899,44
0,1535,65288,3578764855,3578764899,44
0,1535,65289,3578764855,3578764899,44
0,1535,65290,3578764855,3578764899,44
0,1535,65291,3578764855,3578764900,45
0,1535,65292,3578764855,3578764901,46
0,1535,65293,3578764855,3578764901,46
0,1535,65294,3578764855,3578764902,47
0,1535,65295,3578764855,3578764904,49
0,1535,65296,3578764855,3578764905,50
0,1536,65297,3578764919,3578764919,0
0,1536,65298,3578764919,3578764919,0
0,1536,65299,3578764919,3578764919,0
0,1536,65300,3578764919,3578764919,0
0,1536,65301,3578764919,3578764919,0
0,1536,65302,3578764919,3578764919,0
0,1536,65303,3578764919,3578764919,0
0,1536,65304,3578764919,3578764919,0
0,1536,65305,3578764919,3578764919,0
0,1536,65306,3578764919,3578764919,0
0,1536,65307,3578764919,3578764919,0
0,1536,65308,3578764919,3578764919,0
0,1536,65309,3578764919,3578764919,0
0,1536,65310,3578764919,3578764919,0
0,1536,65311,3578764919,3578764919,0
0,1536,65312,3578764919,3578764919,0
0,1536,65313,3578764919,3578764919,0
0,1536,65314,3578764919,3578764919,0
0,1536,65315,3578764919,3578764919,0
0,1536,65316,3578764919,3578764919,0
0,1536,65317,3578764919,3578764919,0
0,1536,65318,3578764919,3578764919,0
0,1536,65319,3578764919,3578764919,0
0,1536,65320,3578764919,3578764919,0
0,1536,65321,3578764919,3578764919,0
0,1536,65322,3578764919,3578764919,0
0,1536,65323,3578764919,3578764919,0
0,1536,65324,3578764919,3578764920,1
0,1536,65325,3578764919,3578764920,1
0,1536,65326,3578764919,3578764920,1
0,1536,65327,3578764919,3578764920,1
0,1536,65328,3578764919,3578764920,1
0,1536,65329,3578764919,3578764920,1
0,1536,65330,3578764919,3578764920,1
0,1536,65331,3578764919,3578764920,1
0,1536,65332,3578764919,3578764920,1
0,1536,65333,3578764919,3578764920,1
0,1536,65334,3578764919,3578764920,1
0,1536,65335,3578764919,3578764920,1
0,1536,65336,3578764919,3578764920,1
0,1536,65337,3578764919,3578764920,1
0,1536,65338,3578764919,3578764920,1
0,1536,65339,3578764919,3578764920,1
0,1536,65340,3578764919,3578764922,3
0,1536,65341,3578764919,3578764922,3
0,1536,65342,3578764919,3578764923,4
0,1536,65343,3578764919,3578764925,6
0,1536,65344,3578764919,3578764925,6
0,1536,65345,3578764919,3578764926,7
0,1536,65346,3578764919,3578764926,7
0,1536,65347,3578764919,3578764926,7
0,1536,65348,3578764919,3578764926,7
0,1536,65349,3578764919,3578764927,8
0,1536,65350,3578764919,3578764927,8
0,1536,65351,3578764919,3578764927,8
0,1536,65352,3578764919,3578764927,8
0,1536,65353,3578764919,3578764928,9
0,1536,65354,3578764919,3578764928,9
0,1536,65355,3578764919,3578764928,9
0,1536,65356,3578764919,3578764928,9
0,1536,65357,3578764919,3578764928,9
0,1536,65358,3578764919,3578764929,10
0,1536,65359,3578764919,3578764929,10
0,1536,65360,3578764919,3578764929,10
0,1536,65361,3578764919,3578764930,11
0,1536,65362,3578764919,3578764931,12
0,1536,65363,3578764919,3578764931,12
0,1536,65364,3578764919,3578764931,12
0,1536,65365,3578764919,3578764932,13
0,1536,65366,3578764919,3578764932,13
0,1536,65367,3578764919,3578764932,13
0,1536,65368,3578764919,3578764932,13
0,1536,65369,3578764919,3578764932,13
0,1536,65370,3578764919,3578764933,14
0,1536,65371,3578764919,3578764933,14
0,1536,65372,3578764919,3578764933,14
0,1536,65373,3578764919,3578764934,15
0,1536,65374,3578764919,3578764934,15
0,1536,65375,3578764919,3578764934,15
0,1536,65376,3578764919,3578764934,15
0,1536,65377,3578764919,3578764935,16
0,1536,65378,3578764919,3578764936,17
0,1536,65379,3578764919,3578764937,18
0,1536,65380,3578764919,3578764938,19
0,1536,65381,3578764919,3578764939,20
0,1536,65382,3578764919,3578764939,20
0,1536,65383,3578764919,3578764939,20
0,1536,65384,3578764919,3578764940,21
0,1536,65385,3578764919,3578764940,21
0,1536,65386,3578764919,3578764941,22
0,1536,65387,3578764919,3578764942,23
0,1536,65388,3578764919,3578764942,23
0,1536,65389,3578764919,3578764942,23
0,1536,65390,3578764919,3578764942,23
0,1536,65391,3578764919,3578764942,23
0,1536,65392,3578764919,3578764943,24
0,1536,65393,3578764919,3578764943,24
0,1536,65394,3578764919,3578764943,24
0,1536,65395,3578764919,3578764944,25
0,1536,65396,3578764919,3578764945,26
0,1536,65397,3578764919,3578764945,26
0,1536,65398,3578764919,3578764946,27
0,1536,65399,3578764919,3578764946,27
0,1536,65400,3578764919,3578764947,28
0,1536,65401,3578764919,3578764948,29
0,1536,65402,3578764919,3578764948,29
0,1536,65403,3578764919,3578764948,29
0,1536,65404,3578764919,3578764948,29
0,1536,65405,3578764919,3578764949,30
0,1536,65406,3578764919,3578764949,30
0,1536,65407,3578764919,3578764950,31
0,1536,65408,3578764919,3578764952,33
0,1536,65409,3578764919,3578764952,33
0,1536,65410,3578764919,3578764953,34
0,1536,65411,3578764919,3578764953,34
0,1536,65412,3578764919,3578764953,34
0,1536,65413,3578764919,3578764954,35
0,1536,65414,3578764919,3578764956,37
0,1536,65415,3578764919,3578764957,38
0,1536,65416,3578764919,3578764957,38
0,1536,65417,3578764919,3578764957,38
0,1536,65418,3578764919,3578764958,39
0,1536,65419,3578764919,3578764959,40
0,1536,65420,3578764919,3578764959,40
0,1536,65421,3578764919,3578764960,41
0,1536,65422,3578764919,3578764961,42
0,1536,65423,3578764919,3578764961,42
0,1536,65424,3578764919,3578764961,42
0,1536,65425,3578764919,3578764961,42
0,1536,65426,3578764919,3578764962,43
0,1536,65427,3578764919,3578764962,43
0,1536,65428,3578764919,3578764962,43
0,1536,65429,3578764919,3578764962,43
0,1536,65430,3578764919,3578764962,43
0,1536,65431,3578764919,3578764962,43
0,1536,65432,3578764919,3578764962,43
0,1536,65433,3578764919,3578764964,45
0,1536,65434,3578764919,3578764964,45
0,1536,65435,3578764919,3578764964,45
0,1536,65436,3578764919,3578764964,45
0,1536,65437,3578764919,3578764966,47
0,1536,65438,3578764919,3578764967,48
0,1536,65439,3578764919,3578764967,48
0,1536,65440,3578764919,3578764969,50
0,1537,65441,3578764983,3578764983,0
0,1537,65442,3578764983,3578764983,0
0,1537,65443,3578764983,3578764983,0
0,1537,65444,3578764983,3578764983,0
0,1537,65445,3578764983,3578764983,0
0,1537,65446,3578764983,3578764983,0
0,1537,65447,3578764983,3578764983,0
0,1537,65448,3578764983,3578764983,0
0,1537,65449,3578764983,3578764983,0
0,1537,65450,3578764983,3578764983,0
0,1537,65451,3578764983,3578764983,0
0,1537,65452,3578764983,3578764983,0
0,1537,65453,3578764983,3578764983,0
0,1537,65454,3578764983,3578764983,0
0,1537,65455,3578764983,3578764983,0
0,1537,65456,3578764983,3578764983,0
0,1537,65457,3578764983,3578764983,0
0,1537,65458,3578764983,3578764983,0
0,1537,65459,3578764983,3578764983,0
0,1537,65460,3578764983,3578764983,0
0,1537,65461,3578764983,3578764983,0
0,1537,65462,3578764983,3578764983,0
0,1537,65463,3578764983,3578764983,0
0,1537,65464,3578764983,3578764983,0
0,1537,65465,3578764983,3578764983,0
0,1537,65466,3578764983,3578764983,0
0,1537,65467,3578764983,3578764984,1
0,1537,65468,3578764983,3578764985,2
0,1537,65469,3578764983,3578764985,2
0,1537,65470,3578764983,3578764986,3
0,1537,65471,3578764983,3578764987,4
0,1537,65472,3578764983,3578764988,5
0,1537,65473,3578764983,3578764988,5
0,1537,65474,3578764983,3578764989,6
0,1537,65475,3578764983,3578764989,6
0,1537,65476,3578764983,3578764990,7
0,1537,65477,3578764983,3578764993,10
0,1537,65478,3578764983,3578764993,10
0,1537,65479,3578764983,3578764994,11
0,1537,65480,3578764983,3578764995,12
0,1537,65481,3578764983,3578764996,13
0,1537,65482,3578764983,3578764996,13
0,1537,65483,3578764983,3578764998,15
0,1537,65484,3578764983,3578764999,16
0,1537,65485,3578764983,3578764999,16
0,1537,65486,3578764983,3578765000,17
0,1537,65487,3578764983,3578765000,17
0,1537,65488,3578764983,3578765002,19
0,1537,65489,3578764983,3578765003,20
0,1537,65490,3578764983,3578765003,20
0,1537,65491,3578764983,3578765003,20
0,1537,65492,3578764983,3578765004,21
0,1537,65493,3578764983,3578765005,22
0,1537,65494,3578764983,3578765006,23
0,1537,65495,3578764983,3578765007,24
0,1537,65496,3578764983,3578765009,26
0,1537,65497,3578764983,3578765009,26
0,1537,65498,3578764983,3578765010,27
0,1537,65499,3578764983,3578765012,29
0,1537,65500,3578764983,3578765012,29
0,1537,65501,3578764983,3578765013,30
0,1537,65502,3578764983,3578765014,31
0,1537,65503,3578764983,3578765015,32
0,1537,65504,3578764983,3578765015,32
0,1537,65505,3578764983,3578765016,33
0,1537,65506,3578764983,3578765016,33
0,1537,65507,3578764983,3578765017,34
0,1537,65508,3578764983,3578765018,35
0,1537,65509,3578764983,3578765018,35
0,1537,65510,3578764983,3578765019,36
0,1537,65511,3578764983,3578765019,36
0,1537,65512,3578764983,3578765019,36
0,1537,65513,3578764983,3578765019,36
0,1537,65514,3578764983,3578765020,37
0,1537,65515,3578764983,3578765021,38
0,1537,65516,3578764983,3578765021,38
0,1537,65517,3578764983,3578765021,38
0,1537,65518,3578764983,3578765023,40
0,1537,65519,3578764983,3578765024,41
0,1537,65520,3578764983,3578765024,41
0,1537,65521,3578764983,3578765025,42
0,1537,65522,3578764983,3578765025,42
0,1537,65523,3578764983,3578765027,44
0,1537,65524,3578764983,3578765029,46
0,1537,65525,3578764983,3578765029,46
0,1537,65526,3578764983,3578765029,46
0,1537,65527,3578764983,3578765029,46
0,1537,65528,3578764983,3578765030,47
0,1537,65529,3578764983,3578765031,48
0,1537,65530,3578764983,3578765033,50
0,1538,65531,3578765046,3578765046,0
0,1538,65532,3578765046,3578765046,0
0,1538,65533,3578765046,3578765046,0
0,1538,65534,3578765046,3578765046,0
0,1538,65535,3578765046,3578765046,0
0,1538,65536,3578765046,3578765046,0
0,1538,65537,3578765046,3578765046,0
0,1538,65538,3578765046,3578765046,0
0,1538,65539,3578765046,3578765046,0
0,1538,65540,3578765046,3578765046,0
0,1538,65541,3578765046,3578765046,0
0,1538,65542,3578765046,3578765046,0
0,1538,65543,3578765046,3578765046,0
0,1538,65544,3578765046,3578765046,0
0,1538,65545,3578765046,3578765046,0
0,1538,65546,3578765046,3578765046,0
0,1538,65547,3578765046,3578765046,0
0,1538,65548,3578765046,3578765046,0
0,1538,65549,3578765046,3578765046,0
0,1538,65550,3578765046,3578765046,0
0,1538,65551,3578765046,3578765046,0
0,1538,65552,3578765046,3578765047,1
0,1538,65553,3578765046,3578765048,2
0,1538,65554,3578765046,3578765049,3
0,1538,65555,3578765046,3578765049,3
0,1538,65556,3578765046,3578765049,3
0,1538,65557,3578765046,3578765050,4
0,1538,65558,3578765046,3578765050,4
0,1538,65559,3578765046,3578765050,4
0,1538,65560,3578765046,3578765051,5
0,1538,65561,3578765046,3578765052,6
0,1538,65562,3578765046,3578765053,7
0,1538,65563,3578765046,3578765056,10
0,1538,65564,3578765046,3578765056,10
0,1538,65565,3578765046,3578765057,11
0,1538,65566,3578765046,3578765057,11
0,1538,65567,3578765046,3578765058,12
0,1538,65568,3578765046,3578765059,13
0,1538,65569,3578765046,3578765060,14
0,1538,65570,3578765046,3578765061,15
0,1538,65571,3578765046,3578765062,16
0,1538,65572,3578765046,3578765062,16
0,1538,65573,3578765046,3578765063,17
0,1538,65574,3578765046,3578765063,17
0,1538,65575,3578765046,3578765064,18
0,1538,65576,3578765046,3578765064,18
0,1538,65577,3578765046,3578765065,19
0,1538,65578,3578765046,3578765066,20
0,1538,65579,3578765046,3578765066,20
0,1538,65580,3578765046,3578765066,20
0,1538,65581,3578765046,3578765066,20
0,1538,65582,3578765046,3578765067,21
0,1538,65583,3578765046,3578765067,21
0,1538,65584,3578765046,3578765072,26
0,1538,65585,3578765046,3578765082,36
0,1538,65586,3578765046,3578765082,36
0,1538,65587,3578765046,3578765087,41
0,1538,65588,3578765046,3578765087,41
0,1538,65589,3578765046,3578765087,41
0,1538,65590,3578765046,3578765090,44
0,1538,65591,3578765046,3578765090,44
0,1538,65592,3578765046,3578765091,45
0,1538,65593,3578765046,3578765091,45
0,1538,65594,3578765046,3578765092,46
0,1538,65595,3578765046,3578765094,48
0,1538,65596,3578765046,3578765094,48
0,1538,65597,3578765046,3578765094,48
0,1538,65598,3578765046,3578765095,49
0,1538,65599,3578765046,3578765095,49
0,1538,65600,3578765046,3578765095,49
0,1539,65601,3578765111,3578765111,0
0,1539,65602,3578765111,3578765111,0
0,1539,65603,3578765111,3578765111,0
0,1539,65604,3578765111,3578765111,0
0,1539,65605,3578765111,3578765111,0
0,1539,65606,3578765111,3578765111,0
0,1539,65607,3578765111,3578765111,0
0,1539,65608,3578765111,3578765111,0
0,1539,65609,3578765111,3578765111,0
0,1539,65610,3578765111,3578765111,0
0,1539,65611,3578765111,3578765111,0
0,1539,65612,3578765111,3578765111,0
0,1539,65613,3578765111,3578765111,0
0,1539,65614,3578765111,3578765111,0
0,1539,65615,3578765111,3578765111,0
0,1539,65616,3578765111,3578765111,0
0,1539,65617,3578765111,3578765111,0
0,1539,65618,3578765111,3578765111,0
0,1539,65619,3578765111,3578765111,0
0,1539,65620,3578765111,3578765111,0
0,1539,65621,3578765111,3578765111,0
0,1539,65622,3578765111,3578765111,0
0,1539,65623,3578765111,3578765111,0
0,1539,65624,3578765111,3578765111,0
0,1539,65625,3578765111,3578765111,0
0,1539,65626,3578765111,3578765111,0
0,1539,65627,3578765111,3578765111,0
0,1539,65628,3578765111,3578765111,0
0,1539,65629,3578765111,3578765111,0
0,1539,65630,3578765111,3578765111,0
0,1539,65631,3578765111,3578765111,0
0,1539,65632,3578765111,3578765112,1
0,1539,65633,3578765111,3578765113,2
0,1539,65634,3578765111,3578765115,4
0,1539,65635,3578765111,3578765115,4
0,1539,65636,3578765111,3578765116,5
0,1539,65637,3578765111,3578765116,5
0,1539,65638,3578765111,3578765116,5
0,1539,65639,3578765111,3578765117,6
0,1539,65640,3578765111,3578765117,6
0,1539,65641,3578765111,3578765117,6
0,1539,65642,3578765111,3578765117,6
0,1539,65643,3578765111,3578765117,6
0,1539,65644,3578765111,3578765117,6
0,1539,65645,3578765111,3578765118,7
0,1539,65646,3578765111,3578765119,8
0,1539,65647,3578765111,3578765119,8
0,1539,65648,3578765111,3578765119,8
0,1539,65649,3578765111,3578765119,8
0,1539,65650,3578765111,3578765119,8
0,1539,65651,3578765111,3578765119,8
0,1539,65652,3578765111,3578765120,9
0,1539,65653,3578765111,3578765122,11
0,1539,65654,3578765111,3578765122,11
0,1539,65655,3578765111,3578765123,12
0,1539,65656,3578765111,3578765124,13
0,1539,65657,3578765111,3578765125,14
0,1539,65658,3578765111,3578765126,15
0,1539,65659,3578765111,3578765126,15
0,1539,65660,3578765111,3578765126,15
0,1539,65661,3578765111,3578765126,15
0,1539,65662,3578765111,3578765126,15
0,1539,65663,3578765111,3578765127,16
0,1539,65664,3578765111,3578765127,16
0,1539,65665,3578765111,3578765127,16
0,1539,65666,3578765111,3578765128,17
0,1539,65667,3578765111,3578765128,17
0,1539,65668,3578765111,3578765128,17
0,1539,65669,3578765111,3578765128,17
0,1539,65670,3578765111,3578765128,17
0,1539,65671,3578765111,3578765129,18
0,1539,65672,3578765111,3578765129,18
0,1539,65673,3578765111,3578765129,18
0,1539,65674,3578765111,3578765129,18
0,1539,65675,3578765111,3578765130,19
0,1539,65676,3578765111,3578765130,19
0,1539,65677,3578765111,3578765130,19
0,1539,65678,3578765111,3578765131,20
0,1539,65679,3578765111,3578765131,20
0,1539,65680,3578765111,3578765132,21
0,1539,65681,3578765111,3578765132,21
0,1539,65682,3578765111,3578765132,21
0,1539,65683,3578765111,3578765133,22
0,1539,65684,3578765111,3578765134,23
0,1539,65685,3578765111,3578765134,23
0,1539,65686,3578765111,3578765135,24
0,1539,65687,3578765111,3578765135,24
0,1539,65688,3578765111,3578765136,25
0,1539,65689,3578765111,3578765137,26
0,1539,65690,3578765111,3578765139,28
0,1539,65691,3578765111,3578765139,28
0,1539,65692,3578765111,3578765140,29
0,1539,65693,3578765111,3578765140,29
0,1539,65694,3578765111,3578765140,29
0,1539,65695,3578765111,3578765141,30
0,1539,65696,3578765111,3578765142,31
0,1539,65697,3578765111,3578765142,31
0,1539,65698,3578765111,3578765142,31
0,1539,65699,3578765111,3578765143,32
0,1539,65700,3578765111,3578765143,32
0,1539,65701,3578765111,3578765143,32
0,1539,65702,3578765111,3578765143,32
0,1539,65703,3578765111,3578765144,33
0,1539,65704,3578765111,3578765144,33
0,1539,65705,3578765111,3578765145,34
0,1539,65706,3578765111,3578765146,35
0,1539,65707,3578765111,3578765146,35
0,1539,65708,3578765111,3578765147,36
0,1539,65709,3578765111,3578765147,36
0,1539,65710,3578765111,3578765147,36
0,1539,65711,3578765111,3578765148,37
0,1539,65712,3578765111,3578765149,38
0,1539,65713,3578765111,3578765149,38
0,1539,65714,3578765111,3578765150,39
0,1539,65715,3578765111,3578765151,40
0,1539,65716,3578765111,3578765152,41
0,1539,65717,3578765111,3578765152,41
0,1539,65718,3578765111,3578765153,42
0,1539,65719,3578765111,3578765154,43
0,1539,65720,3578765111,3578765154,43
0,1539,65721,3578765111,3578765156,45
0,1539,65722,3578765111,3578765157,46
0,1539,65723,3578765111,3578765157,46
0,1539,65724,3578765111,3578765157,46
0,1539,65725,3578765111,3578765158,47
0,1539,65726,3578765111,3578765158,47
0,1539,65727,3578765111,3578765158,47
0,1539,65728,3578765111,3578765159,48
0,1539,65729,3578765111,3578765160,49
0,1539,65730,3578765111,3578765161,50
0,1540,65731,3578765176,3578765176,0
0,1540,65732,3578765176,3578765176,0
0,1540,65733,3578765176,3578765176,0
0,1540,65734,3578765176,3578765176,0
0,1540,65735,3578765176,3578765176,0
0,1540,65736,3578765176,3578765176,0
0,1540,65737,3578765176,3578765176,0
0,1540,65738,3578765176,3578765176,0
0,1540,65739,3578765176,3578765176,0
0,1540,65740,3578765176,3578765176,0
0,1540,65741,3578765176,3578765176,0
0,1540,65742,3578765176,3578765176,0
0,1540,65743,3578765176,3578765176,0
0,1540,65744,3578765176,3578765176,0
0,1540,65745,3578765176,3578765176,0
0,1540,65746,3578765176,3578765176,0
0,1540,65747,3578765176,3578765176,0
0,1540,65748,3578765176,3578765176,0
0,1540,65749,3578765176,3578765176,0
0,1540,65750,3578765176,3578765176,0
0,1540,65751,3578765176,3578765176,0
0,1540,65752,3578765176,3578765176,0
0,1540,65753,3578765176,3578765176,0
0,1540,65754,3578765176,3578765176,0
0,1540,65755,3578765176,3578765176,0
0,1540,65756,3578765176,3578765176,0
0,1540,65757,3578765176,3578765176,0
0,1540,65758,3578765176,3578765178,2
0,1540,65759,3578765176,3578765178,2
0,1540,65760,3578765176,3578765178,2
0,1540,65761,3578765176,3578765179,3
0,1540,65762,3578765176,3578765179,3
0,1540,65763,3578765176,3578765180,4
0,1540,65764,3578765176,3578765180,4
0,1540,65765,3578765176,3578765181,5
0,1540,65766,3578765176,3578765181,5
0,1540,65767,3578765176,3578765182,6
0,1540,65768,3578765176,3578765182,6
0,1540,65769,3578765176,3578765183,7
0,1540,65770,3578765176,3578765183,7
0,1540,65771,3578765176,3578765183,7
0,1540,65772,3578765176,3578765184,8
0,1540,65773,3578765176,3578765185,9
0,1540,65774,3578765176,3578765185,9
0,1540,65775,3578765176,3578765186,10
0,1540,65776,3578765176,3578765186,10
0,1540,65777,3578765176,3578765188,12
0,1540,65778,3578765176,3578765188,12
0,1540,65779,3578765176,3578765188,12
0,1540,65780,3578765176,3578765189,13
0,1540,65781,3578765176,3578765189,13
0,1540,65782,3578765176,3578765190,14
0,1540,65783,3578765176,3578765191,15
0,1540,65784,3578765176,3578765192,16
0,1540,65785,3578765176,3578765193,17
0,1540,65786,3578765176,3578765194,18
0,1540,65787,3578765176,3578765194,18
0,1540,65788,3578765176,3578765195,19
0,1540,65789,3578765176,3578765195,19
0,1540,65790,3578765176,3578765196,20
0,1540,65791,3578765176,3578765197,21
0,1540,65792,3578765176,3578765198,22
0,1540,65793,3578765176,3578765199,23
0,1540,65794,3578765176,3578765200,24
0,1540,65795,3578765176,3578765200,24
0,1540,65796,3578765176,3578765201,25
0,1540,65797,3578765176,3578765202,26
0,1540,65798,3578765176,3578765203,27
0,1540,65799,3578765176,3578765203,27
0,1540,65800,3578765176,3578765204,28
0,1540,65801,3578765176,3578765204,28
0,1540,65802,3578765176,3578765205,29
0,1540,65803,3578765176,3578765205,29
0,1540,65804,3578765176,3578765206,30
0,1540,65805,3578765176,3578765207,31
0,1540,65806,3578765176,3578765208,32
0,1540,65807,3578765176,3578765209,33
0,1540,65808,3578765176,3578765209,33
0,1540,65809,3578765176,3578765209,33
0,1540,65810,3578765176,3578765212,36
0,1540,65811,3578765176,3578765213,37
0,1540,65812,3578765176,3578765214,38
0,1540,65813,3578765176,3578765214,38
0,1540,65814,3578765176,3578765215,39
0,1540,65815,3578765176,3578765215,39
0,1540,65816,3578765176,3578765215,39
0,1540,65817,3578765176,3578765215,39
0,1540,65818,3578765176,3578765216,40
0,1540,65819,3578765176,3578765217,41
0,1540,65820,3578765176,3578765218,42
0,1540,65821,3578765176,3578765219,43
0,1540,65822,3578765176,3578765219,43
0,1540,65823,3578765176,3578765220,44
0,1540,65824,3578765176,3578765220,44
0,1540,65825,3578765176,3578765220,44
0,1540,65826,3578765176,3578765221,45
0,1540,65827,3578765176,3578765221,45
0,1540,65828,3578765176,3578765222,46
0,1540,65829,3578765176,3578765222,46
0,1540,65830,3578765176,3578765224,48
0,1540,65831,3578765176,3578765225,49
0,1540,65832,3578765176,3578765225,49
0,1541,65833,3578765241,3578765241,0
0,1541,65834,3578765241,3578765241,0
0,1541,65835,3578765241,3578765241,0
0,1541,65836,3578765241,3578765241,0
0,1541,65837,3578765241,3578765241,0
0,1541,65838,3578765241,3578765241,0
0,1541,65839,3578765241,3578765241,0
0,1541,65840,3578765241,3578765241,0
0,1541,65841,3578765241,3578765241,0
0,1541,65842,3578765241,3578765241,0
0,1541,65843,3578765241,3578765241,0
0,1541,65844,3578765241,3578765241,0
0,1541,65845,3578765241,3578765242,1
0,1541,65846,3578765241,3578765242,1
0,1541,65847,3578765241,3578765242,1
0,1541,65848,3578765241,3578765242,1
0,1541,65849,3578765241,3578765242,1
0,1541,65850,3578765241,3578765242,1
0,1541,65851,3578765241,3578765242,1
0,1541,65852,3578765241,3578765242,1
0,1541,65853,3578765241,3578765242,1
0,1541,65854,3578765241,3578765242,1
0,1541,65855,3578765241,3578765242,1
0,1541,65856,3578765241,3578765242,1
0,1541,65857,3578765241,3578765243,2
0,1541,65858,3578765241,3578765243,2
0,1541,65859,3578765241,3578765244,3
0,1541,65860,3578765241,3578765244,3
0,1541,65861,3578765241,3578765245,4
0,1541,65862,3578765241,3578765245,4
0,1541,65863,3578765241,3578765246,5
0,1541,65864,3578765241,3578765246,5
0,1541,65865,3578765241,3578765247,6
0,1541,65866,3578765241,3578765248,7
0,1541,65867,3578765241,3578765248,7
0,1541,65868,3578765241,3578765249,8
0,1541,65869,3578765241,3578765249,8
0,1541,65870,3578765241,3578765249,8
0,1541,65871,3578765241,3578765249,8
0,1541,65872,3578765241,3578765249,8
0,1541,65873,3578765241,3578765249,8
0,1541,65874,3578765241,3578765250,9
0,1541,65875,3578765241,3578765252,11
0,1541,65876,3578765241,3578765254,13
0,1541,65877,3578765241,3578765254,13
0,1541,65878,3578765241,3578765257,16
0,1541,65879,3578765241,3578765258,17
0,1541,65880,3578765241,3578765258,17
0,1541,65881,3578765241,3578765258,17
0,1541,65882,3578765241,3578765260,19
0,1541,65883,3578765241,3578765261,20
0,1541,65884,3578765241,3578765262,21
0,1541,65885,3578765241,3578765262,21
0,1541,65886,3578765241,3578765263,22
0,1541,65887,3578765241,3578765263,22
0,1541,65888,3578765241,3578765264,23
0,1541,65889,3578765241,3578765265,24
0,1541,65890,3578765241,3578765265,24
0,1541,65891,3578765241,3578765265,24
0,1541,65892,3578765241,3578765265,24
0,1541,65893,3578765241,3578765267,26
0,1541,65894,3578765241,3578765267,26
0,1541,65895,3578765241,3578765267,26
0,1541,65896,3578765241,3578765268,27
0,1541,65897,3578765241,3578765268,27
0,1541,65898,3578765241,3578765269,28
0,1541,65899,3578765241,3578765271,30
0,1541,65900,3578765241,3578765271,30
0,1541,65901,3578765241,3578765282,41
0,1541,65902,3578765241,3578765283,42
0,1541,65903,3578765241,3578765287,46
0,1541,65904,3578765241,3578765288,47
0,1541,65905,3578765241,3578765288,47
0,1541,65906,3578765241,3578765289,48
0,1541,65907,3578765241,3578765289,48
0,1541,65908,3578765241,3578765290,49
0,1541,65909,3578765241,3578765290,49
0,1542,65910,3578765305,3578765305,0
0,1542,65911,3578765305,3578765305,0
0,1542,65912,3578765305,3578765305,0
0,1542,65913,3578765305,3578765305,0
0,1542,65914,3578765305,3578765305,0
0,1542,65915,3578765305,3578765305,0
0,1542,65916,3578765305,3578765305,0
0,1542,65917,3578765305,3578765305,0
0,1542,65918,3578765305,3578765305,0
0,1542,65919,3578765305,3578765305,0
0,1542,65920,3578765305,3578765305,0
0,1542,65921,3578765305,3578765305,0
0,1542,65922,3578765305,3578765305,0
0,1542,65923,3578765305,3578765305,0
0,1542,65924,3578765305,3578765305,0
0,1542,65925,3578765305,3578765305,0
0,1542,65926,3578765305,3578765305,0
0,1542,65927,3578765305,3578765305,0
0,1542,65928,3578765305,3578765306,1
0,1542,65929,3578765305,3578765306,1
0,1542,65930,3578765305,3578765306,1
0,1542,65931,3578765305,3578765306,1
0,1542,65932,3578765305,3578765306,1
0,1542,65933,3578765305,3578765306,1
0,1542,65934,3578765305,3578765306,1
0,1542,65935,3578765305,3578765307,2
0,1542,65936,3578765305,3578765307,2
0,1542,65937,3578765305,3578765307,2
0,1542,65938,3578765305,3578765308,3
0,1542,65939,3578765305,3578765308,3
0,1542,65940,3578765305,3578765308,3
0,1542,65941,3578765305,3578765309,4
0,1542,65942,3578765305,3578765309,4
0,1542,65943,3578765305,3578765309,4
0,1542,65944,3578765305,3578765309,4
0,1542,65945,3578765305,3578765310,5
0,1542,65946,3578765305,3578765310,5
0,1542,65947,3578765305,3578765310,5
0,1542,65948,3578765305,3578765310,5
0,1542,65949,3578765305,3578765310,5
0,1542,65950,3578765305,3578765310,5
0,1542,65951,3578765305,3578765310,5
0,1542,65952,3578765305,3578765310,5
0,1542,65953,3578765305,3578765311,6
0,1542,65954,3578765305,3578765311,6
0,1542,65955,3578765305,3578765312,7
0,1542,65956,3578765305,3578765312,7
0,1542,65957,3578765305,3578765315,10
0,1542,65958,3578765305,3578765316,11
0,1542,65959,3578765305,3578765316,11
0,1542,65960,3578765305,3578765316,11
0,1542,65961,3578765305,3578765316,11
0,1542,65962,3578765305,3578765316,11
0,1542,65963,3578765305,3578765316,11
0,1542,65964,3578765305,3578765316,11
0,1542,65965,3578765305,3578765317,12
0,1542,65966,3578765305,3578765317,12
0,1542,65967,3578765305,3578765318,13
0,1542,65968,3578765305,3578765318,13
0,1542,65969,3578765305,3578765318,13
0,1542,65970,3578765305,3578765319,14
0,1542,65971,3578765305,3578765319,14
0,1542,65972,3578765305,3578765319,14
0,1542,65973,3578765305,3578765320,15
0,1542,65974,3578765305,3578765320,15
0,1542,65975,3578765305,3578765322,17
0,1542,65976,3578765305,3578765322,17
0,1542,65977,3578765305,3578765323,18
0,1542,65978,3578765305,3578765323,18
0,1542,65979,3578765305,3578765324,19
0,1542,65980,3578765305,3578765325,20
0,1542,65981,3578765305,3578765326,21
0,1542,65982,3578765305,3578765326,21
0,1542,65983,3578765305,3578765327,22
0,1542,65984,3578765305,3578765327,22
0,1542,65985,3578765305,3578765327,22
0,1542,65986,3578765305,3578765327,22
0,1542,65987,3578765305,3578765328,23
0,1542,65988,3578765305,3578765328,23
0,1542,65989,3578765305,3578765328,23
0,1542,65990,3578765305,3578765328,23
0,1542,65991,3578765305,3578765329,24
0,1542,65992,3578765305,3578765329,24
0,1542,65993,3578765305,3578765329,24
0,1542,65994,3578765305,3578765329,24
0,1542,65995,3578765305,3578765330,25
0,1542,65996,3578765305,3578765330,25
0,1542,65997,3578765305,3578765330,25
0,1542,65998,3578765305,3578765331,26
0,1542,65999,3578765305,3578765332,27
0,1542,66000,3578765305,3578765332,27
0,1542,66001,3578765305,3578765332,27
0,1542,66002,3578765305,3578765333,28
0,1542,66003,3578765305,3578765333,28
0,1542,66004,3578765305,3578765334,29
0,1542,66005,3578765305,3578765335,30
0,1542,66006,3578765305,3578765335,30
0,1542,66007,3578765305,3578765336,31
0,1542,66008,3578765305,3578765336,31
0,1542,66009,3578765305,3578765337,32
0,1542,66010,3578765305,3578765339,34
0,1542,66011,3578765305,3578765339,34
0,1542,66012,3578765305,3578765340,35
0,1542,66013,3578765305,3578765340,35
0,1542,66014,3578765305,3578765342,37
0,1542,66015,3578765305,3578765342,37
0,1542,66016,3578765305,3578765343,38
0,1542,66017,3578765305,3578765343,38
0,1542,66018,3578765305,3578765343,38
0,1542,66019,3578765305,3578765343,38
0,1542,66020,3578765305,3578765344,39
0,1542,66021,3578765305,3578765344,39
0,1542,66022,3578765305,3578765344,39
0,1542,66023,3578765305,3578765345,40
0,1542,66024,3578765305,3578765345,40
0,1542,66025,3578765305,3578765347,42
0,1542,66026,3578765305,3578765348,43
0,1542,66027,3578765305,3578765348,43
0,1542,66028,3578765305,3578765348,43
0,1542,66029,3578765305,3578765348,43
0,1542,66030,3578765305,3578765349,44
0,1542,66031,3578765305,3578765349,44
0,1542,66032,3578765305,3578765351,46
0,1542,66033,3578765305,3578765353,48
0,1542,66034,3578765305,3578765353,48
0,1542,66035,3578765305,3578765353,48
0,1542,66036,3578765305,3578765355,50
0,1543,66037,3578765369,3578765369,0
0,1543,66038,3578765369,3578765369,0
0,1543,66039,3578765369,3578765369,0
0,1543,66040,3578765369,3578765369,0
0,1543,66041,3578765369,3578765369,0
0,1543,66042,3578765369,3578765369,0
0,1543,66043,3578765369,3578765369,0
0,1543,66044,3578765369,3578765369,0
0,1543,66045,3578765369,3578765369,0
0,1543,66046,3578765369,3578765369,0
0,1543,66047,3578765369,3578765369,0
0,1543,66048,3578765369,3578765369,0
0,1543,66049,3578765369,3578765369,0
0,1543,66050,3578765369,3578765369,0
0,1543,66051,3578765369,3578765369,0
0,1543,66052,3578765369,3578765369,0
0,1543,66053,3578765369,3578765369,0
0,1543,66054,3578765369,3578765369,0
0,1543,66055,3578765369,3578765369,0
0,1543,66056,3578765369,3578765369,0
0,1543,66057,3578765369,3578765369,0
0,1543,66058,3578765369,3578765369,0
0,1543,66059,3578765369,3578765369,0
0,1543,66060,3578765369,3578765370,1
0,1543,66061,3578765369,3578765371,2
0,1543,66062,3578765369,3578765371,2
0,1543,66063,3578765369,3578765371,2
0,1543,66064,3578765369,3578765372,3
0,1543,66065,3578765369,3578765372,3
0,1543,66066,3578765369,3578765373,4
0,1543,66067,3578765369,3578765373,4
0,1543,66068,3578765369,3578765374,5
0,1543,66069,3578765369,3578765374,5
0,1543,66070,3578765369,3578765374,5
0,1543,66071,3578765369,3578765375,6
0,1543,66072,3578765369,3578765376,7
0,1543,66073,3578765369,3578765377,8
0,1543,66074,3578765369,3578765378,9
0,1543,66075,3578765369,3578765378,9
0,1543,66076,3578765369,3578765378,9
0,1543,66077,3578765369,3578765379,10
0,1543,66078,3578765369,3578765379,10
0,1543,66079,3578765369,3578765379,10
0,1543,66080,3578765369,3578765379,10
0,1543,66081,3578765369,3578765380,11
0,1543,66082,3578765369,3578765383,14
0,1543,66083,3578765369,3578765384,15
0,1543,66084,3578765369,3578765384,15
0,1543,66085,3578765369,3578765385,16
0,1543,66086,3578765369,3578765386,17
0,1543,66087,3578765369,3578765387,18
0,1543,66088,3578765369,3578765387,18
0,1543,66089,3578765369,3578765388,19
0,1543,66090,3578765369,3578765389,20
0,1543,66091,3578765369,3578765389,20
0,1543,66092,3578765369,3578765390,21
0,1543,66093,3578765369,3578765390,21
0,1543,66094,3578765369,3578765391,22
0,1543,66095,3578765369,3578765391,22
0,1543,66096,3578765369,3578765392,23
0,1543,66097,3578765369,3578765393,24
0,1543,66098,3578765369,3578765393,24
0,1543,66099,3578765369,3578765393,24
0,1543,66100,3578765369,3578765395,26
0,1543,66101,3578765369,3578765395,26
0,1543,66102,3578765369,3578765397,28
0,1543,66103,3578765369,3578765398,29
0,1543,66104,3578765369,3578765399,30
0,1543,66105,3578765369,3578765399,30
0,1543,66106,3578765369,3578765400,31
0,1543,66107,3578765369,3578765400,31
0,1543,66108,3578765369,3578765400,31
0,1543,66109,3578765369,3578765401,32
0,1543,66110,3578765369,3578765402,33
0,1543,66111,3578765369,3578765404,35
0,1543,66112,3578765369,3578765404,35
0,1543,66113,3578765369,3578765404,35
0,1543,66114,3578765369,3578765404,35
0,1543,66115,3578765369,3578765404,35
0,1543,66116,3578765369,3578765405,36
0,1543,66117,3578765369,3578765406,37
0,1543,66118,3578765369,3578765406,37
0,1543,66119,3578765369,3578765408,39
0,1543,66120,3578765369,3578765408,39
0,1543,66121,3578765369,3578765409,40
0,1543,66122,3578765369,3578765411,42
0,1543,66123,3578765369,3578765413,44
0,1543,66124,3578765369,3578765413,44
0,1543,66125,3578765369,3578765413,44
0,1543,66126,3578765369,3578765414,45
0,1543,66127,3578765369,3578765414,45
0,1543,66128,3578765369,3578765415,46
0,1543,66129,3578765369,3578765415,46
0,1543,66130,3578765369,3578765415,46
0,1543,66131,3578765369,3578765416,47
0,1543,66132,3578765369,3578765416,47
0,1543,66133,3578765369,3578765417,48
0,1543,66134,3578765369,3578765418,49
0,1543,66135,3578765369,3578765419,50
0,1544,66136,3578765434,3578765434,0
0,1544,66137,3578765434,3578765434,0
0,1544,66138,3578765434,3578765434,0
0,1544,66139,3578765434,3578765434,0
0,1544,66140,3578765434,3578765434,0
0,1544,66141,3578765434,3578765434,0
0,1544,66142,3578765434,3578765434,0
0,1544,66143,3578765434,3578765434,0
0,1544,66144,3578765434,3578765434,0
0,1544,66145,3578765434,3578765434,0
0,1544,66146,3578765434,3578765434,0
0,1544,66147,3578765434,3578765434,0
0,1544,66148,3578765434,3578765434,0
0,1544,66149,3578765434,3578765434,0
0,1544,66150,3578765434,3578765434,0
0,1544,66151,3578765434,3578765434,0
0,1544,66152,3578765434,3578765434,0
0,1544,66153,3578765434,3578765434,0
0,1544,66154,3578765434,3578765434,0
0,1544,66155,3578765434,3578765434,0
0,1544,66156,3578765434,3578765434,0
0,1544,66157,3578765434,3578765434,0
0,1544,66158,3578765434,3578765434,0
0,1544,66159,3578765434,3578765434,0
0,1544,66160,3578765434,3578765434,0
0,1544,66161,3578765434,3578765434,0
0,1544,66162,3578765434,3578765435,1
0,1544,66163,3578765434,3578765436,2
0,1544,66164,3578765434,3578765436,2
0,1544,66165,3578765434,3578765437,3
0,1544,66166,3578765434,3578765438,4
0,1544,66167,3578765434,3578765439,5
0,1544,66168,3578765434,3578765439,5
0,1544,66169,3578765434,3578765439,5
0,1544,66170,3578765434,3578765440,6
0,1544,66171,3578765434,3578765440,6
0,1544,66172,3578765434,3578765441,7
0,1544,66173,3578765434,3578765441,7
0,1544,66174,3578765434,3578765441,7
0,1544,66175,3578765434,3578765441,7
0,1544,66176,3578765434,3578765442,8
0,1544,66177,3578765434,3578765442,8
0,1544,66178,3578765434,3578765442,8
0,1544,66179,3578765434,3578765444,10
0,1544,66180,3578765434,3578765444,10
0,1544,66181,3578765434,3578765446,12
0,1544,66182,3578765434,3578765446,12
0,1544,66183,3578765434,3578765446,12
0,1544,66184,3578765434,3578765447,13
0,1544,66185,3578765434,3578765447,13
0,1544,66186,3578765434,3578765447,13
0,1544,66187,3578765434,3578765448,14
0,1544,66188,3578765434,3578765449,15
0,1544,66189,3578765434,3578765449,15
0,1544,66190,3578765434,3578765449,15
0,1544,66191,3578765434,3578765450,16
0,1544,66192,3578765434,3578765450,16
0,1544,66193,3578765434,3578765452,18
0,1544,66194,3578765434,3578765453,19
0,1544,66195,3578765434,3578765453,19
0,1544,66196,3578765434,3578765454,20
0,1544,66197,3578765434,3578765456,22
0,1544,66198,3578765434,3578765456,22
0,1544,66199,3578765434,3578765457,23
0,1544,66200,3578765434,3578765458,24
0,1544,66201,3578765434,3578765459,25
0,1544,66202,3578765434,3578765460,26
0,1544,66203,3578765434,3578765460,26
0,1544,66204,3578765434,3578765461,27
0,1544,66205,3578765434,3578765461,27
0,1544,66206,3578765434,3578765462,28
0,1544,66207,3578765434,3578765463,29
0,1544,66208,3578765434,3578765463,29
0,1544,66209,3578765434,3578765464,30
0,1544,66210,3578765434,3578765464,30
0,1544,66211,3578765434,3578765465,31
0,1544,66212,3578765434,3578765465,31
0,1544,66213,3578765434,3578765465,31
0,1544,66214,3578765434,3578765465,31
0,1544,66215,3578765434,3578765466,32
0,1544,66216,3578765434,3578765467,33
0,1544,66217,3578765434,3578765467,33
0,1544,66218,3578765434,3578765468,34
0,1544,66219,3578765434,3578765471,37
0,1544,66220,3578765434,3578765472,38
0,1544,66221,3578765434,3578765482,48
0,1544,66222,3578765434,3578765483,49
0,1545,66223,3578765499,3578765499,0
0,1545,66224,3578765499,3578765499,0
0,1545,66225,3578765499,3578765499,0
0,1545,66226,3578765499,3578765499,0
0,1545,66227,3578765499,3578765499,0
0,1545,66228,3578765499,3578765499,0
0,1545,66229,3578765499,3578765499,0
0,1545,66230,3578765499,3578765499,0
0,1545,66231,3578765499,3578765499,0
0,1545,66232,3578765499,3578765499,0
0,1545,66233,3578765499,3578765499,0
0,1545,66234,3578765499,3578765499,0
0,1545,66235,3578765499,3578765499,0
0,1545,66236,3578765499,3578765499,0
0,1545,66237,3578765499,3578765499,0
0,1545,66238,3578765499,3578765499,0
0,1545,66239,3578765499,3578765499,0
0,1545,66240,3578765499,3578765499,0
0,1545,66241,3578765499,3578765499,0
0,1545,66242,3578765499,3578765499,0
0,1545,66243,3578765499,3578765499,0
0,1545,66244,3578765499,3578765499,0
0,1545,66245,3578765499,3578765499,0
0,1545,66246,3578765499,3578765500,1
0,1545,66247,3578765499,3578765500,1
0,1545,66248,3578765499,3578765503,4
0,1545,66249,3578765499,3578765503,4
0,1545,66250,3578765499,3578765504,5
0,1545,66251,3578765499,3578765504,5
0,1545,66252,3578765499,3578765505,6
0,1545,66253,3578765499,3578765505,6
0,1545,66254,3578765499,3578765506,7
0,1545,66255,3578765499,3578765507,8
0,1545,66256,3578765499,3578765507,8
0,1545,66257,3578765499,3578765507,8
0,1545,66258,3578765499,3578765507,8
0,1545,66259,3578765499,3578765508,9
0,1545,66260,3578765499,3578765508,9
0,1545,66261,3578765499,3578765508,9
0,1545,66262,3578765499,3578765509,10
0,1545,66263,3578765499,3578765509,10
0,1545,66264,3578765499,3578765509,10
0,1545,66265,3578765499,3578765509,10
0,1545,66266,3578765499,3578765509,10
0,1545,66267,3578765499,3578765509,10
0,1545,66268,3578765499,3578765509,10
0,1545,66269,3578765499,3578765510,11
0,1545,66270,3578765499,3578765510,11
0,1545,66271,3578765499,3578765511,12
0,1545,66272,3578765499,3578765512,13
0,1545,66273,3578765499,3578765512,13
0,1545,66274,3578765499,3578765512,13
0,1545,66275,3578765499,3578765515,16
0,1545,66276,3578765499,3578765515,16
0,1545,66277,3578765499,3578765515,16
0,1545,66278,3578765499,3578765515,16
0,1545,66279,3578765499,3578765516,17
0,1545,66280,3578765499,3578765516,17
0,1545,66281,3578765499,3578765516,17
0,1545,66282,3578765499,3578765516,17
0,1545,66283,3578765499,3578765516,17
0,1545,66284,3578765499,3578765518,19
0,1545,66285,3578765499,3578765518,19
0,1545,66286,3578765499,3578765518,19
0,1545,66287,3578765499,3578765518,19
0,1545,66288,3578765499,3578765519,20
0,1545,66289,3578765499,3578765519,20
0,1545,66290,3578765499,3578765521,22
0,1545,66291,3578765499,3578765521,22
0,1545,66292,3578765499,3578765522,23
0,1545,66293,3578765499,3578765523,24
0,1545,66294,3578765499,3578765523,24
0,1545,66295,3578765499,3578765524,25
0,1545,66296,3578765499,3578765524,25
0,1545,66297,3578765499,3578765525,26
0,1545,66298,3578765499,3578765526,27
0,1545,66299,3578765499,3578765526,27
0,1545,66300,3578765499,3578765526,27
0,1545,66301,3578765499,3578765526,27
0,1545,66302,3578765499,3578765527,28
0,1545,66303,3578765499,3578765527,28
0,1545,66304,3578765499,3578765527,28
0,1545,66305,3578765499,3578765527,28
0,1545,66306,3578765499,3578765528,29
0,1545,66307,3578765499,3578765528,29
0,1545,66308,3578765499,3578765528,29
0,1545,66309,3578765499,3578765528,29
0,1545,66310,3578765499,3578765528,29
0,1545,66311,3578765499,3578765528,29
0,1545,66312,3578765499,3578765529,30
0,1545,66313,3578765499,3578765529,30
0,1545,66314,3578765499,3578765530,31
0,1545,66315,3578765499,3578765530,31
0,1545,66316,3578765499,3578765531,32
0,1545,66317,3578765499,3578765531,32
0,1545,66318,3578765499,3578765532,33
0,1545,66319,3578765499,3578765533,34
0,1545,66320,3578765499,3578765533,34
0,1545,66321,3578765499,3578765533,34
0,1545,66322,3578765499,3578765534,35
0,1545,66323,3578765499,3578765536,37
0,1545,66324,3578765499,3578765536,37
0,1545,66325,3578765499,3578765538,39
0,1545,66326,3578765499,3578765539,40
0,1545,66327,3578765499,3578765539,40
0,1545,66328,3578765499,3578765540,41
0,1545,66329,3578765499,3578765541,42
0,1545,66330,3578765499,3578765541,42
0,1545,66331,3578765499,3578765542,43
0,1545,66332,3578765499,3578765542,43
0,1545,66333,3578765499,3578765542,43
0,1545,66334,3578765499,3578765543,44
0,1545,66335,3578765499,3578765544,45
0,1545,66336,3578765499,3578765544,45
0,1545,66337,3578765499,3578765544,45
0,1545,66338,3578765499,3578765544,45
0,1545,66339,3578765499,3578765546,47
0,1545,66340,3578765499,3578765547,48
0,1545,66341,3578765499,3578765547,48
0,1545,66342,3578765499,3578765547,48
0,1545,66343,3578765499,3578765547,48
0,1545,66344,3578765499,3578765547,48
0,1545,66345,3578765499,3578765548,49
0,1545,66346,3578765499,3578765548,49
0,1545,66347,3578765499,3578765548,49
0,1545,66348,3578765499,3578765549,50
0,1546,66349,3578765564,3578765564,0
0,1546,66350,3578765564,3578765564,0
0,1546,66351,3578765564,3578765564,0
0,1546,66352,3578765564,3578765564,0
0,1546,66353,3578765564,3578765564,0
0,1546,66354,3578765564,3578765564,0
0,1546,66355,3578765564,3578765564,0
0,1546,66356,3578765564,3578765564,0
0,1546,66357,3578765564,3578765564,0
0,1546,66358,3578765564,3578765564,0
0,1546,66359,3578765564,3578765564,0
0,1546,66360,3578765564,3578765564,0
0,1546,66361,3578765564,3578765564,0
0,1546,66362,3578765564,3578765564,0
0,1546,66363,3578765564,3578765564,0
0,1546,66364,3578765564,3578765564,0
0,1546,66365,3578765564,3578765564,0
0,1546,66366,3578765564,3578765564,0
0,1546,66367,3578765564,3578765564,0
0,1546,66368,3578765564,3578765564,0
0,1546,66369,3578765564,3578765564,0
0,1546,66370,3578765564,3578765564,0
0,1546,66371,3578765564,3578765564,0
0,1546,66372,3578765564,3578765564,0
0,1546,66373,3578765564,3578765564,0
0,1546,66374,3578765564,3578765564,0
0,1546,66375,3578765564,3578765564,0
0,1546,66376,3578765564,3578765566,2
0,1546,66377,3578765564,3578765569,5
0,1546,66378,3578765564,3578765570,6
0,1546,66379,3578765564,3578765571,7
0,1546,66380,3578765564,3578765571,7
0,1546,66381,3578765564,3578765571,7
0,1546,66382,3578765564,3578765571,7
0,1546,66383,3578765564,3578765572,8
0,1546,66384,3578765564,3578765573,9
0,1546,66385,3578765564,3578765573,9
0,1546,66386,3578765564,3578765573,9
0,1546,66387,3578765564,3578765574,10
0,1546,66388,3578765564,3578765574,10
0,1546,66389,3578765564,3578765574,10
0,1546,66390,3578765564,3578765575,11
0,1546,66391,3578765564,3578765575,11
0,1546,66392,3578765564,3578765578,14
0,1546,66393,3578765564,3578765578,14
0,1546,66394,3578765564,3578765578,14
0,1546,66395,3578765564,3578765578,14
0,1546,66396,3578765564,3578765578,14
0,1546,66397,3578765564,3578765578,14
0,1546,66398,3578765564,3578765579,15
0,1546,66399,3578765564,3578765581,17
0,1546,66400,3578765564,3578765584,20
0,1546,66401,3578765564,3578765584,20
0,1546,66402,3578765564,3578765585,21
0,1546,66403,3578765564,3578765586,22
0,1546,66404,3578765564,3578765586,22
0,1546,66405,3578765564,3578765587,23
0,1546,66406,3578765564,3578765587,23
0,1546,66407,3578765564,3578765587,23
0,1546,66408,3578765564,3578765588,24
0,1546,66409,3578765564,3578765588,24
0,1546,66410,3578765564,3578765589,25
0,1546,66411,3578765564,3578765589,25
0,1546,66412,3578765564,3578765590,26
0,1546,66413,3578765564,3578765593,29
0,1546,66414,3578765564,3578765593,29
0,1546,66415,3578765564,3578765593,29
0,1546,66416,3578765564,3578765594,30
0,1546,66417,3578765564,3578765595,31
0,1546,66418,3578765564,3578765595,31
0,1546,66419,3578765564,3578765596,32
0,1546,66420,3578765564,3578765597,33
0,1546,66421,3578765564,3578765597,33
0,1546,66422,3578765564,3578765598,34
0,1546,66423,3578765564,3578765599,35
0,1546,66424,3578765564,3578765599,35
0,1546,66425,3578765564,3578765600,36
0,1546,66426,3578765564,3578765602,38
0,1546,66427,3578765564,3578765602,38
0,1546,66428,3578765564,3578765603,39
0,1546,66429,3578765564,3578765603,39
0,1546,66430,3578765564,3578765604,40
0,1546,66431,3578765564,3578765604,40
0,1546,66432,3578765564,3578765605,41
0,1546,66433,3578765564,3578765606,42
0,1546,66434,3578765564,3578765607,43
0,1546,66435,3578765564,3578765608,44
0,1546,66436,3578765564,3578765608,44
0,1546,66437,3578765564,3578765610,46
0,1546,66438,3578765564,3578765612,48
0,1546,66439,3578765564,3578765612,48
0,1546,66440,3578765564,3578765612,48
0,1546,66441,3578765564,3578765614,50
0,1547,66442,3578765627,3578765627,0
0,1547,66443,3578765627,3578765627,0
0,1547,66444,3578765627,3578765627,0
0,1547,66445,3578765627,3578765627,0
0,1547,66446,3578765627,3578765627,0
0,1547,66447,3578765627,3578765627,0
0,1547,66448,3578765627,3578765627,0
0,1547,66449,3578765627,3578765627,0
0,1547,66450,3578765627,3578765627,0
0,1547,66451,3578765627,3578765627,0
0,1547,66452,3578765627,3578765627,0
0,1547,66453,3578765627,3578765627,0
0,1547,66454,3578765627,3578765627,0
0,1547,66455,3578765627,3578765627,0
0,1547,66456,3578765627,3578765627,0
0,1547,66457,3578765627,3578765627,0
0,1547,66458,3578765627,3578765627,0
0,1547,66459,3578765627,3578765627,0
0,1547,66460,3578765627,3578765627,0
0,1547,66461,3578765627,3578765627,0
0,1547,66462,3578765627,3578765627,0
0,1547,66463,3578765627,3578765627,0
0,1547,66464,3578765627,3578765627,0
0,1547,66465,3578765627,3578765628,1
0,1547,66466,3578765627,3578765629,2
0,1547,66467,3578765627,3578765629,2
0,1547,66468,3578765627,3578765630,3
0,1547,66469,3578765627,3578765630,3
0,1547,66470,3578765627,3578765631,4
0,1547,66471,3578765627,3578765631,4
0,1547,66472,3578765627,3578765631,4
0,1547,66473,3578765627,3578765632,5
0,1547,66474,3578765627,3578765633,6
0,1547,66475,3578765627,3578765633,6
0,1547,66476,3578765627,3578765633,6
0,1547,66477,3578765627,3578765634,7
0,1547,66478,3578765627,3578765635,8
0,1547,66479,3578765627,3578765636,9
0,1547,66480,3578765627,3578765637,10
0,1547,66481,3578765627,3578765637,10
0,1547,66482,3578765627,3578765638,11
0,1547,66483,3578765627,3578765638,11
0,1547,66484,3578765627,3578765639,12
0,1547,66485,3578765627,3578765639,12
0,1547,66486,3578765627,3578765640,13
0,1547,66487,3578765627,3578765640,13
0,1547,66488,3578765627,3578765640,13
0,1547,66489,3578765627,3578765641,14
0,1547,66490,3578765627,3578765642,15
0,1547,66491,3578765627,3578765642,15
0,1547,66492,3578765627,3578765643,16
0,1547,66493,3578765627,3578765643,16
0,1547,66494,3578765627,3578765643,16
0,1547,66495,3578765627,3578765645,18
0,1547,66496,3578765627,3578765646,19
0,1547,66497,3578765627,3578765647,20
0,1547,66498,3578765627,3578765648,21
0,1547,66499,3578765627,3578765648,21
0,1547,66500,3578765627,3578765648,21
0,1547,66501,3578765627,3578765649,22
0,1547,66502,3578765627,3578765649,22
0,1547,66503,3578765627,3578765649,22
0,1547,66504,3578765627,3578765649,22
0,1547,66505,3578765627,3578765649,22
0,1547,66506,3578765627,3578765651,24
0,1547,66507,3578765627,3578765651,24
0,1547,66508,3578765627,3578765652,25
0,1547,66509,3578765627,3578765656,29
0,1547,66510,3578765627,3578765656,29
0,1547,66511,3578765627,3578765658,31
0,1547,66512,3578765627,3578765660,33
0,1547,66513,3578765627,3578765660,33
0,1547,66514,3578765627,3578765660,33
0,1547,66515,3578765627,3578765661,34
0,1547,66516,3578765627,3578765661,34
0,1547,66517,3578765627,3578765662,35
0,1547,66518,3578765627,3578765663,36
0,1547,66519,3578765627,3578765663,36
0,1547,66520,3578765627,3578765664,37
0,1547,66521,3578765627,3578765664,37
0,1547,66522,3578765627,3578765664,37
0,1547,66523,3578765627,3578765664,37
0,1547,66524,3578765627,3578765665,38
0,1547,66525,3578765627,3578765666,39
0,1547,66526,3578765627,3578765666,39
0,1547,66527,3578765627,3578765666,39
0,1547,66528,3578765627,3578765670,43
0,1548,66529,3578765691,3578765691,0
0,1548,66530,3578765691,3578765691,0
0,1548,66531,3578765691,3578765691,0
0,1548,66532,3578765691,3578765691,0
0,1548,66533,3578765691,3578765691,0
0,1548,66534,3578765691,3578765691,0
0,1548,66535,3578765691,3578765691,0
0,1548,66536,3578765691,3578765691,0
0,1548,66537,3578765691,3578765691,0
0,1548,66538,3578765691,3578765691,0
0,1548,66539,3578765691,3578765692,1
0,1548,66540,3578765691,3578765692,1
0,1548,66541,3578765691,3578765693,2
0,1548,66542,3578765691,3578765694,3
0,1548,66543,3578765691,3578765694,3
0,1548,66544,3578765691,3578765695,4
0,1548,66545,3578765691,3578765696,5
0,1548,66546,3578765691,3578765697,6
0,1548,66547,3578765691,3578765697,6
0,1548,66548,3578765691,3578765697,6
0,1548,66549,3578765691,3578765698,7
0,1548,66550,3578765691,3578765698,7
0,1548,66551,3578765691,3578765699,8
0,1548,66552,3578765691,3578765699,8
0,1548,66553,3578765691,3578765699,8
0,1548,66554,3578765691,3578765699,8
0,1548,66555,3578765691,3578765701,10
0,1548,66556,3578765691,3578765702,11
0,1548,66557,3578765691,3578765702,11
0,1548,66558,3578765691,3578765703,12
0,1548,66559,3578765691,3578765704,13
0,1548,66560,3578765691,3578765704,13
0,1548,66561,3578765691,3578765704,13
0,1548,66562,3578765691,3578765705,14
0,1548,66563,3578765691,3578765705,14
0,1548,66564,3578765691,3578765707,16
0,1548,66565,3578765691,3578765707,16
0,1548,66566,3578765691,3578765708,17
0,1548,66567,3578765691,3578765708,17
0,1548,66568,3578765691,3578765708,17
0,1548,66569,3578765691,3578765708,17
0,1548,66570,3578765691,3578765709,18
0,1548,66571,3578765691,3578765709,18
0,1548,66572,3578765691,3578765709,18
0,1548,66573,3578765691,3578765709,18
0,1548,66574,3578765691,3578765709,18
0,1548,66575,3578765691,3578765710,19
0,1548,66576,3578765691,3578765711,20
0,1548,66577,3578765691,3578765711,20
0,1548,66578,3578765691,3578765711,20
0,1548,66579,3578765691,3578765712,21
0,1548,66580,3578765691,3578765713,22
0,1548,66581,3578765691,3578765714,23
0,1548,66582,3578765691,3578765715,24
0,1548,66583,3578765691,3578765716,25
0,1548,66584,3578765691,3578765716,25
0,1548,66585,3578765691,3578765716,25
0,1548,66586,3578765691,3578765716,25
0,1548,66587,3578765691,3578765716,25
0,1548,66588,3578765691,3578765716,25
0,1548,66589,3578765691,3578765717,26
0,1548,66590,3578765691,3578765718,27
0,1548,66591,3578765691,3578765718,27
0,1548,66592,3578765691,3578765719,28
0,1548,66593,3578765691,3578765719,28
0,1548,66594,3578765691,3578765719,28
0,1548,66595,3578765691,3578765721,30
0,1548,66596,3578765691,3578765721,30
0,1548,66597,3578765691,3578765722,31
0,1548,66598,3578765691,3578765723,32
0,1548,66599,3578765691,3578765724,33
0,1548,66600,3578765691,3578765725,34
0,1548,66601,3578765691,3578765725,34
0,1548,66602,3578765691,3578765725,34
0,1548,66603,3578765691,3578765726,35
0,1548,66604,3578765691,3578765726,35
0,1548,66605,3578765691,3578765726,35
0,1548,66606,3578765691,3578765726,35
0,1548,66607,3578765691,3578765727,36
0,1548,66608,3578765691,3578765727,36
0,1548,66609,3578765691,3578765727,36
0,1548,66610,3578765691,3578765727,36
0,1548,66611,3578765691,3578765727,36
0,1548,66612,3578765691,3578765728,37
0,1548,66613,3578765691,3578765728,37
0,1548,66614,3578765691,3578765729,38
0,1548,66615,3578765691,3578765729,38
0,1548,66616,3578765691,3578765729,38
0,1548,66617,3578765691,3578765729,38
0,1548,66618,3578765691,3578765729,38
0,1548,66619,3578765691,3578765730,39
0,1548,66620,3578765691,3578765730,39
0,1548,66621,3578765691,3578765731,40
0,1548,66622,3578765691,3578765731,40
0,1548,66623,3578765691,3578765731,40
0,1548,66624,3578765691,3578765733,42
0,1548,66625,3578765691,3578765733,42
0,1548,66626,3578765691,3578765733,42
0,1548,66627,3578765691,3578765734,43
0,1548,66628,3578765691,3578765734,43
0,1548,66629,3578765691,3578765734,43
0,1548,66630,3578765691,3578765735,44
0,1548,66631,3578765691,3578765736,45
0,1548,66632,3578765691,3578765737,46
0,1548,66633,3578765691,3578765740,49
0,1548,66634,3578765691,3578765740,49
0,1548,66635,3578765691,3578765740,49
0,1548,66636,3578765691,3578765740,49
0,1548,66637,3578765691,3578765741,50
0,1549,66638,3578765754,3578765754,0
0,1549,66639,3578765754,3578765754,0
0,1549,66640,3578765754,3578765754,0
0,1549,66641,3578765754,3578765754,0
0,1549,66642,3578765754,3578765754,0
0,1549,66643,3578765754,3578765754,0
0,1549,66644,3578765754,3578765754,0
0,1549,66645,3578765754,3578765754,0
0,1549,66646,3578765754,3578765754,0
0,1549,66647,3578765754,3578765754,0
0,1549,66648,3578765754,3578765754,0
0,1549,66649,3578765754,3578765754,0
0,1549,66650,3578765754,3578765754,0
0,1549,66651,3578765754,3578765754,0
0,1549,66652,3578765754,3578765754,0
0,1549,66653,3578765754,3578765754,0
0,1549,66654,3578765754,3578765754,0
0,1549,66655,3578765754,3578765754,0
0,1549,66656,3578765754,3578765755,1
0,1549,66657,3578765754,3578765755,1
0,1549,66658,3578765754,3578765755,1
0,1549,66659,3578765754,3578765755,1
0,1549,66660,3578765754,3578765755,1
0,1549,66661,3578765754,3578765755,1
0,1549,66662,3578765754,3578765755,1
0,1549,66663,3578765754,3578765755,1
0,1549,66664,3578765754,3578765755,1
0,1549,66665,3578765754,3578765755,1
0,1549,66666,3578765754,3578765755,1
0,1549,66667,3578765754,3578765756,2
0,1549,66668,3578765754,3578765757,3
0,1549,66669,3578765754,3578765757,3
0,1549,66670,3578765754,3578765757,3
0,1549,66671,3578765754,3578765758,4
0,1549,66672,3578765754,3578765759,5
0,1549,66673,3578765754,3578765759,5
0,1549,66674,3578765754,3578765760,6
0,1549,66675,3578765754,3578765760,6
0,1549,66676,3578765754,3578765761,7
0,1549,66677,3578765754,3578765761,7
0,1549,66678,3578765754,3578765761,7
0,1549,66679,3578765754,3578765761,7
0,1549,66680,3578765754,3578765761,7
0,1549,66681,3578765754,3578765761,7
0,1549,66682,3578765754,3578765761,7
0,1549,66683,3578765754,3578765762,8
0,1549,66684,3578765754,3578765762,8
0,1549,66685,3578765754,3578765764,10
0,1549,66686,3578765754,3578765764,10
0,1549,66687,3578765754,3578765765,11
0,1549,66688,3578765754,3578765767,13
0,1549,66689,3578765754,3578765768,14
0,1549,66690,3578765754,3578765769,15
0,1549,66691,3578765754,3578765770,16
0,1549,66692,3578765754,3578765770,16
0,1549,66693,3578765754,3578765771,17
0,1549,66694,3578765754,3578765771,17
0,1549,66695,3578765754,3578765771,17
0,1549,66696,3578765754,3578765772,18
0,1549,66697,3578765754,3578765772,18
0,1549,66698,3578765754,3578765773,19
0,1549,66699,3578765754,3578765773,19
0,1549,66700,3578765754,3578765773,19
0,1549,66701,3578765754,3578765773,19
0,1549,66702,3578765754,3578765773,19
0,1549,66703,3578765754,3578765774,20
0,1549,66704,3578765754,3578765776,22
0,1549,66705,3578765754,3578765776,22
0,1549,66706,3578765754,3578765778,24
0,1549,66707,3578765754,3578765778,24
0,1549,66708,3578765754,3578765778,24
0,1549,66709,3578765754,3578765778,24
0,1549,66710,3578765754,3578765779,25
0,1549,66711,3578765754,3578765779,25
0,1549,66712,3578765754,3578765779,25
0,1549,66713,3578765754,3578765780,26
0,1549,66714,3578765754,3578765784,30
0,1549,66715,3578765754,3578765786,32
0,1549,66716,3578765754,3578765787,33
0,1549,66717,3578765754,3578765787,33
0,1549,66718,3578765754,3578765787,33
0,1549,66719,3578765754,3578765787,33
0,1549,66720,3578765754,3578765788,34
0,1549,66721,3578765754,3578765788,34
0,1549,66722,3578765754,3578765789,35
0,1549,66723,3578765754,3578765790,36
0,1549,66724,3578765754,3578765790,36
0,1549,66725,3578765754,3578765792,38
0,1549,66726,3578765754,3578765794,40
0,1549,66727,3578765754,3578765794,40
0,1549,66728,3578765754,3578765794,40
0,1549,66729,3578765754,3578765794,40
0,1549,66730,3578765754,3578765795,41
0,1549,66731,3578765754,3578765796,42
0,1549,66732,3578765754,3578765796,42
0,1549,66733,3578765754,3578765797,43
0,1549,66734,3578765754,3578765798,44
0,1549,66735,3578765754,3578765799,45
0,1549,66736,3578765754,3578765799,45
0,1549,66737,3578765754,3578765799,45
0,1549,66738,3578765754,3578765800,46
0,1549,66739,3578765754,3578765802,48
0,1549,66740,3578765754,3578765803,49
0,1549,66741,3578765754,3578765803,49
0,1549,66742,3578765754,3578765804,50
0,1550,66743,3578765818,3578765819,1
0,1550,66744,3578765818,3578765819,1
0,1550,66745,3578765818,3578765819,1
0,1550,66746,3578765818,3578765819,1
0,1550,66747,3578765818,3578765819,1
0,1550,66748,3578765818,3578765819,1
0,1550,66749,3578765818,3578765819,1
0,1550,66750,3578765818,3578765819,1
0,1550,66751,3578765818,3578765819,1
0,1550,66752,3578765818,3578765819,1
0,1550,66753,3578765818,3578765819,1
0,1550,66754,3578765818,3578765819,1
0,1550,66755,3578765818,3578765819,1
0,1550,66756,3578765818,3578765819,1
0,1550,66757,3578765818,3578765819,1
0,1550,66758,3578765818,3578765819,1
0,1550,66759,3578765818,3578765819,1
0,1550,66760,3578765818,3578765819,1
0,1550,66761,3578765818,3578765819,1
0,1550,66762,3578765818,3578765819,1
0,1550,66763,3578765818,3578765819,1
0,1550,66764,3578765818,3578765821,3
0,1550,66765,3578765818,3578765821,3
0,1550,66766,3578765818,3578765821,3
0,1550,66767,3578765818,3578765822,4
0,1550,66768,3578765818,3578765824,6
0,1550,66769,3578765818,3578765824,6
0,1550,66770,3578765818,3578765824,6
0,1550,66771,3578765818,3578765825,7
0,1550,66772,3578765818,3578765826,8
0,1550,66773,3578765818,3578765828,10
0,1550,66774,3578765818,3578765828,10
0,1550,66775,3578765818,3578765829,11
0,1550,66776,3578765818,3578765830,12
0,1550,66777,3578765818,3578765830,12
0,1550,66778,3578765818,3578765831,13
0,1550,66779,3578765818,3578765831,13
0,1550,66780,3578765818,3578765832,14
0,1550,66781,3578765818,3578765832,14
0,1550,66782,3578765818,3578765833,15
0,1550,66783,3578765818,3578765834,16
0,1550,66784,3578765818,3578765836,18
0,1550,66785,3578765818,3578765837,19
0,1550,66786,3578765818,3578765837,19
0,1550,66787,3578765818,3578765838,20
0,1550,66788,3578765818,3578765839,21
0,1550,66789,3578765818,3578765839,21
0,1550,66790,3578765818,3578765839,21
0,1550,66791,3578765818,3578765839,21
0,1550,66792,3578765818,3578765840,22
0,1550,66793,3578765818,3578765840,22
0,1550,66794,3578765818,3578765840,22
0,1550,66795,3578765818,3578765841,23
0,1550,66796,3578765818,3578765842,24
0,1550,66797,3578765818,3578765843,25
0,1550,66798,3578765818,3578765843,25
0,1550,66799,3578765818,3578765843,25
0,1550,66800,3578765818,3578765845,27
0,1550,66801,3578765818,3578765846,28
0,1550,66802,3578765818,3578765846,28
0,1550,66803,3578765818,3578765846,28
0,1550,66804,3578765818,3578765848,30
0,1550,66805,3578765818,3578765848,30
0,1550,66806,3578765818,3578765848,30
0,1550,66807,3578765818,3578765848,30
0,1550,66808,3578765818,3578765848,30
0,1550,66809,3578765818,3578765849,31
0,1550,66810,3578765818,3578765850,32
0,1550,66811,3578765818,3578765850,32
0,1550,66812,3578765818,3578765851,33
0,1550,66813,3578765818,3578765852,34
0,1550,66814,3578765818,3578765854,36
0,1550,66815,3578765818,3578765856,38
0,1550,66816,3578765818,3578765856,38
0,1550,66817,3578765818,3578765856,38
0,1550,66818,3578765818,3578765857,39
0,1550,66819,3578765818,3578765857,39
0,1550,66820,3578765818,3578765858,40
0,1550,66821,3578765818,3578765860,42
0,1550,66822,3578765818,3578765860,42
0,1550,66823,3578765818,3578765860,42
0,1550,66824,3578765818,3578765861,43
0,1550,66825,3578765818,3578765862,44
0,1550,66826,3578765818,3578765863,45
0,1550,66827,3578765818,3578765864,46
0,1550,66828,3578765818,3578765864,46
0,1550,66829,3578765818,3578765865,47
0,1550,66830,3578765818,3578765865,47
0,1550,66831,3578765818,3578765865,47
0,1550,66832,3578765818,3578765865,47
0,1550,66833,3578765818,3578765866,48
0,1550,66834,3578765818,3578765866,48
0,1550,66835,3578765818,3578765866,48
0,1551,66836,3578765883,3578765883,0
0,1551,66837,3578765883,3578765883,0
0,1551,66838,3578765883,3578765883,0
0,1551,66839,3578765883,3578765886,3
0,1551,66840,3578765883,3578765887,4
0,1551,66841,3578765883,3578765888,5
0,1551,66842,3578765883,3578765888,5
0,1551,66843,3578765883,3578765890,7
0,1551,66844,3578765883,3578765890,7
0,1551,66845,3578765883,3578765890,7
0,1551,66846,3578765883,3578765892,9
0,1551,66847,3578765883,3578765892,9
0,1551,66848,3578765883,3578765892,9
0,1551,66849,3578765883,3578765892,9
0,1551,66850,3578765883,3578765893,10
0,1551,66851,3578765883,3578765893,10
0,1551,66852,3578765883,3578765894,11
0,1551,66853,3578765883,3578765895,12
0,1551,66854,3578765883,3578765896,13
0,1551,66855,3578765883,3578765896,13
0,1551,66856,3578765883,3578765897,14
0,1551,66857,3578765883,3578765897,14
0,1551,66858,3578765883,3578765898,15
0,1551,66859,3578765883,3578765898,15
0,1551,66860,3578765883,3578765898,15
0,1551,66861,3578765883,3578765899,16
0,1551,66862,3578765883,3578765900,17
0,1551,66863,3578765883,3578765900,17
0,1551,66864,3578765883,3578765901,18
0,1551,66865,3578765883,3578765902,19
0,1551,66866,3578765883,3578765902,19
0,1551,66867,3578765883,3578765903,20
0,1551,66868,3578765883,3578765903,20
0,1551,66869,3578765883,3578765904,21
0,1551,66870,3578765883,3578765904,21
0,1551,66871,3578765883,3578765905,22
0,1551,66872,3578765883,3578765905,22
0,1551,66873,3578765883,3578765907,24
0,1551,66874,3578765883,3578765908,25
0,1551,66875,3578765883,3578765908,25
0,1551,66876,3578765883,3578765908,25
0,1551,66877,3578765883,3578765908,25
0,1551,66878,3578765883,3578765908,25
0,1551,66879,3578765883,3578765909,26
0,1551,66880,3578765883,3578765909,26
0,1551,66881,3578765883,3578765909,26
0,1551,66882,3578765883,3578765909,26
0,1551,66883,3578765883,3578765910,27
0,1551,66884,3578765883,3578765911,28
0,1551,66885,3578765883,3578765911,28
0,1551,66886,3578765883,3578765912,29
0,1551,66887,3578765883,3578765912,29
0,1551,66888,3578765883,3578765913,30
0,1551,66889,3578765883,3578765914,31
0,1551,66890,3578765883,3578765915,32
0,1551,66891,3578765883,3578765915,32
0,1551,66892,3578765883,3578765916,33
0,1551,66893,3578765883,3578765916,33
0,1551,66894,3578765883,3578765916,33
0,1551,66895,3578765883,3578765916,33
0,1551,66896,3578765883,3578765916,33
0,1551,66897,3578765883,3578765918,35
0,1551,66898,3578765883,3578765919,36
0,1551,66899,3578765883,3578765919,36
0,1551,66900,3578765883,3578765919,36
0,1551,66901,3578765883,3578765919,36
0,1551,66902,3578765883,3578765920,37
0,1551,66903,3578765883,3578765920,37
0,1551,66904,3578765883,3578765922,39
0,1551,66905,3578765883,3578765923,40
0,1551,66906,3578765883,3578765924,41
0,1551,66907,3578765883,3578765925,42
0,1551,66908,3578765883,3578765925,42
0,1551,66909,3578765883,3578765926,43
0,1551,66910,3578765883,3578765926,43
0,1551,66911,3578765883,3578765926,43
0,1551,66912,3578765883,3578765927,44
0,1551,66913,3578765883,3578765927,44
0,1551,66914,3578765883,3578765927,44
0,1551,66915,3578765883,3578765928,45
0,1551,66916,3578765883,3578765928,45
0,1551,66917,3578765883,3578765928,45
0,1551,66918,3578765883,3578765928,45
0,1551,66919,3578765883,3578765929,46
0,1551,66920,3578765883,3578765929,46
0,1551,66921,3578765883,3578765930,47
0,1551,66922,3578765883,3578765930,47
0,1551,66923,3578765883,3578765930,47
0,1551,66924,3578765883,3578765931,48
0,1551,66925,3578765883,3578765931,48
0,1551,66926,3578765883,3578765931,48
0,1551,66927,3578765883,3578765933,50
0,1552,66928,3578765947,3578765947,0
0,1552,66929,3578765947,3578765947,0
0,1552,66930,3578765947,3578765947,0
0,1552,66931,3578765947,3578765947,0
0,1552,66932,3578765947,3578765947,0
0,1552,66933,3578765947,3578765947,0
0,1552,66934,3578765947,3578765947,0
0,1552,66935,3578765947,3578765947,0
0,1552,66936,3578765947,3578765947,0
0,1552,66937,3578765947,3578765947,0
0,1552,66938,3578765947,3578765947,0
0,1552,66939,3578765947,3578765947,0
0,1552,66940,3578765947,3578765947,0
0,1552,66941,3578765947,3578765947,0
0,1552,66942,3578765947,3578765947,0
0,1552,66943,3578765947,3578765947,0
0,1552,66944,3578765947,3578765947,0
0,1552,66945,3578765947,3578765947,0
0,1552,66946,3578765947,3578765947,0
0,1552,66947,3578765947,3578765947,0
0,1552,66948,3578765947,3578765947,0
0,1552,66949,3578765947,3578765947,0
0,1552,66950,3578765947,3578765947,0
0,1552,66951,3578765947,3578765947,0
0,1552,66952,3578765947,3578765948,1
0,1552,66953,3578765947,3578765948,1
0,1552,66954,3578765947,3578765948,1
0,1552,66955,3578765947,3578765948,1
0,1552,66956,3578765947,3578765948,1
0,1552,66957,3578765947,3578765950,3
0,1552,66958,3578765947,3578765950,3
0,1552,66959,3578765947,3578765951,4
0,1552,66960,3578765947,3578765952,5
0,1552,66961,3578765947,3578765952,5
0,1552,66962,3578765947,3578765952,5
0,1552,66963,3578765947,3578765953,6
0,1552,66964,3578765947,3578765953,6
0,1552,66965,3578765947,3578765954,7
0,1552,66966,3578765947,3578765954,7
0,1552,66967,3578765947,3578765954,7
0,1552,66968,3578765947,3578765955,8
0,1552,66969,3578765947,3578765956,9
0,1552,66970,3578765947,3578765956,9
0,1552,66971,3578765947,3578765957,10
0,1552,66972,3578765947,3578765958,11
0,1552,66973,3578765947,3578765958,11
0,1552,66974,3578765947,3578765959,12
0,1552,66975,3578765947,3578765959,12
0,1552,66976,3578765947,3578765960,13
0,1552,66977,3578765947,3578765960,13
0,1552,66978,3578765947,3578765960,13
0,1552,66979,3578765947,3578765961,14
0,1552,66980,3578765947,3578765961,14
0,1552,66981,3578765947,3578765961,14
0,1552,66982,3578765947,3578765961,14
0,1552,66983,3578765947,3578765962,15
0,1552,66984,3578765947,3578765962,15
0,1552,66985,3578765947,3578765962,15
0,1552,66986,3578765947,3578765962,15
0,1552,66987,3578765947,3578765963,16
0,1552,66988,3578765947,3578765963,16
0,1552,66989,3578765947,3578765964,17
0,1552,66990,3578765947,3578765965,18
0,1552,66991,3578765947,3578765967,20
0,1552,66992,3578765947,3578765967,20
0,1552,66993,3578765947,3578765970,23
0,1552,66994,3578765947,3578765971,24
0,1552,66995,3578765947,3578765971,24
0,1552,66996,3578765947,3578765971,24
0,1552,66997,3578765947,3578765972,25
0,1552,66998,3578765947,3578765973,26
0,1552,66999,3578765947,3578765973,26
0,1552,67000,3578765947,3578765974,27
0,1552,67001,3578765947,3578765974,27
0,1552,67002,3578765947,3578765974,27
0,1552,67003,3578765947,3578765974,27
0,1552,67004,3578765947,3578765978,31
0,1552,67005,3578765947,3578765978,31
0,1552,67006,3578765947,3578765978,31
0,1552,67007,3578765947,3578765978,31
0,1552,67008,3578765947,3578765979,32
0,1552,67009,3578765947,3578765979,32
0,1552,67010,3578765947,3578765979,32
0,1552,67011,3578765947,3578765982,35
0,1552,67012,3578765947,3578765983,36
0,1552,67013,3578765947,3578765985,38
0,1552,67014,3578765947,3578765985,38
0,1552,67015,3578765947,3578765986,39
0,1552,67016,3578765947,3578765987,40
0,1552,67017,3578765947,3578765987,40
0,1552,67018,3578765947,3578765987,40
0,1552,67019,3578765947,3578765989,42
0,1552,67020,3578765947,3578765989,42
0,1552,67021,3578765947,3578765989,42
0,1552,67022,3578765947,3578765990,43
0,1552,67023,3578765947,3578765991,44
0,1552,67024,3578765947,3578765993,46
0,1552,67025,3578765947,3578765993,46
0,1552,67026,3578765947,3578765994,47
0,1552,67027,3578765947,3578765996,49
0,1553,67028,3578766010,3578766010,0
0,1553,67029,3578766010,3578766010,0
0,1553,67030,3578766010,3578766010,0
0,1553,67031,3578766010,3578766010,0
0,1553,67032,3578766010,3578766011,1
0,1553,67033,3578766010,3578766011,1
0,1553,67034,3578766010,3578766011,1
0,1553,67035,3578766010,3578766011,1
0,1553,67036,3578766010,3578766011,1
0,1553,67037,3578766010,3578766011,1
0,1553,67038,3578766010,3578766011,1
0,1553,67039,3578766010,3578766011,1
0,1553,67040,3578766010,3578766011,1
0,1553,67041,3578766010,3578766011,1
0,1553,67042,3578766010,3578766011,1
0,1553,67043,3578766010,3578766011,1
0,1553,67044,3578766010,3578766011,1
0,1553,67045,3578766010,3578766011,1
0,1553,67046,3578766010,3578766013,3
0,1553,67047,3578766010,3578766013,3
0,1553,67048,3578766010,3578766014,4
0,1553,67049,3578766010,3578766015,5
0,1553,67050,3578766010,3578766015,5
0,1553,67051,3578766010,3578766015,5
0,1553,67052,3578766010,3578766015,5
0,1553,67053,3578766010,3578766016,6
0,1553,67054,3578766010,3578766017,7
0,1553,67055,3578766010,3578766017,7
0,1553,67056,3578766010,3578766018,8
0,1553,67057,3578766010,3578766018,8
0,1553,67058,3578766010,3578766019,9
0,1553,67059,3578766010,3578766019,9
0,1553,67060,3578766010,3578766019,9
0,1553,67061,3578766010,3578766019,9
0,1553,67062,3578766010,3578766019,9
0,1553,67063,3578766010,3578766020,10
0,1553,67064,3578766010,3578766021,11
0,1553,67065,3578766010,3578766021,11
0,1553,67066,3578766010,3578766024,14
0,1553,67067,3578766010,3578766024,14
0,1553,67068,3578766010,3578766024,14
0,1553,67069,3578766010,3578766025,15
0,1553,67070,3578766010,3578766026,16
0,1553,67071,3578766010,3578766026,16
0,1553,67072,3578766010,3578766026,16
0,1553,67073,3578766010,3578766027,17
0,1553,67074,3578766010,3578766028,18
0,1553,67075,3578766010,3578766028,18
0,1553,67076,3578766010,3578766029,19
0,1553,67077,3578766010,3578766030,20
0,1553,67078,3578766010,3578766030,20
0,1553,67079,3578766010,3578766030,20
0,1553,67080,3578766010,3578766030,20
0,1553,67081,3578766010,3578766032,22
0,1553,67082,3578766010,3578766032,22
0,1553,67083,3578766010,3578766033,23
0,1553,67084,3578766010,3578766033,23
0,1553,67085,3578766010,3578766034,24
0,1553,67086,3578766010,3578766035,25
0,1553,67087,3578766010,3578766035,25
0,1553,67088,3578766010,3578766038,28
0,1553,67089,3578766010,3578766038,28
0,1553,67090,3578766010,3578766039,29
0,1553,67091,3578766010,3578766039,29
0,1553,67092,3578766010,3578766039,29
0,1553,67093,3578766010,3578766040,30
0,1553,67094,3578766010,3578766040,30
0,1553,67095,3578766010,3578766040,30
0,1553,67096,3578766010,3578766041,31
0,1553,67097,3578766010,3578766041,31
0,1553,67098,3578766010,3578766042,32
0,1553,67099,3578766010,3578766043,33
0,1553,67100,3578766010,3578766043,33
0,1553,67101,3578766010,3578766045,35
0,1553,67102,3578766010,3578766047,37
0,1553,67103,3578766010,3578766048,38
0,1553,67104,3578766010,3578766048,38
0,1553,67105,3578766010,3578766049,39
0,1553,67106,3578766010,3578766049,39
0,1553,67107,3578766010,3578766049,39
0,1553,67108,3578766010,3578766049,39
0,1553,67109,3578766010,3578766049,39
0,1553,67110,3578766010,3578766050,40
0,1553,67111,3578766010,3578766050,40
0,1553,67112,3578766010,3578766051,41
0,1553,67113,3578766010,3578766052,42
0,1553,67114,3578766010,3578766054,44
0,1553,67115,3578766010,3578766056,46
0,1553,67116,3578766010,3578766057,47
0,1553,67117,3578766010,3578766057,47
0,1553,67118,3578766010,3578766057,47
0,1553,67119,3578766010,3578766058,48
0,1553,67120,3578766010,3578766060,50
0,1554,67121,3578766074,3578766074,0
0,1554,67122,3578766074,3578766074,0
0,1554,67123,3578766074,3578766074,0
0,1554,67124,3578766074,3578766074,0
0,1554,67125,3578766074,3578766074,0
0,1554,67126,3578766074,3578766074,0
0,1554,67127,3578766074,3578766074,0
0,1554,67128,3578766074,3578766074,0
0,1554,67129,3578766074,3578766074,0
0,1554,67130,3578766074,3578766074,0
0,1554,67131,3578766074,3578766074,0
0,1554,67132,3578766074,3578766074,0
0,1554,67133,3578766074,3578766074,0
0,1554,67134,3578766074,3578766074,0
0,1554,67135,3578766074,3578766074,0
0,1554,67136,3578766074,3578766082,8
0,1554,67137,3578766074,3578766088,14
0,1554,67138,3578766074,3578766088,14
0,1554,67139,3578766074,3578766089,15
0,1554,67140,3578766074,3578766090,16
0,1554,67141,3578766074,3578766090,16
0,1554,67142,3578766074,3578766090,16
0,1554,67143,3578766074,3578766092,18
0,1554,67144,3578766074,3578766092,18
0,1554,67145,3578766074,3578766093,19
0,1554,67146,3578766074,3578766093,19
0,1554,67147,3578766074,3578766094,20
0,1554,67148,3578766074,3578766094,20
0,1554,67149,3578766074,3578766095,21
0,1554,67150,3578766074,3578766095,21
0,1554,67151,3578766074,3578766096,22
0,1554,67152,3578766074,3578766097,23
0,1554,67153,3578766074,3578766097,23
0,1554,67154,3578766074,3578766097,23
0,1554,67155,3578766074,3578766097,23
0,1554,67156,3578766074,3578766098,24
0,1554,67157,3578766074,3578766098,24
0,1554,67158,3578766074,3578766098,24
0,1554,67159,3578766074,3578766099,25
0,1554,67160,3578766074,3578766100,26
0,1554,67161,3578766074,3578766101,27
0,1554,67162,3578766074,3578766101,27
0,1554,67163,3578766074,3578766102,28
0,1554,67164,3578766074,3578766103,29
0,1554,67165,3578766074,3578766104,30
0,1554,67166,3578766074,3578766104,30
0,1554,67167,3578766074,3578766104,30
0,1554,67168,3578766074,3578766105,31
0,1554,67169,3578766074,3578766105,31
0,1554,67170,3578766074,3578766106,32
0,1554,67171,3578766074,3578766106,32
0,1554,67172,3578766074,3578766106,32
0,1554,67173,3578766074,3578766106,32
0,1554,67174,3578766074,3578766107,33
0,1554,67175,3578766074,3578766108,34
0,1554,67176,3578766074,3578766108,34
0,1554,67177,3578766074,3578766108,34
0,1554,67178,3578766074,3578766108,34
0,1554,67179,3578766074,3578766109,35
0,1554,67180,3578766074,3578766109,35
0,1554,67181,3578766074,3578766109,35
0,1554,67182,3578766074,3578766110,36
0,1554,67183,3578766074,3578766110,36
0,1554,67184,3578766074,3578766111,37
0,1554,67185,3578766074,3578766111,37
0,1554,67186,3578766074,3578766112,38
0,1554,67187,3578766074,3578766113,39
0,1554,67188,3578766074,3578766113,39
0,1554,67189,3578766074,3578766115,41
0,1554,67190,3578766074,3578766115,41
0,1554,67191,3578766074,3578766115,41
0,1554,67192,3578766074,3578766115,41
0,1554,67193,3578766074,3578766116,42
0,1554,67194,3578766074,3578766116,42
0,1554,67195,3578766074,3578766116,42
0,1554,67196,3578766074,3578766116,42
0,1554,67197,3578766074,3578766116,42
0,1554,67198,3578766074,3578766116,42
0,1554,67199,3578766074,3578766117,43
0,1554,67200,3578766074,3578766117,43
0,1554,67201,3578766074,3578766117,43
0,1554,67202,3578766074,3578766118,44
0,1554,67203,3578766074,3578766119,45
0,1554,67204,3578766074,3578766119,45
0,1554,67205,3578766074,3578766119,45
0,1554,67206,3578766074,3578766119,45
0,1554,67207,3578766074,3578766120,46
0,1554,67208,3578766074,3578766121,47
0,1554,67209,3578766074,3578766122,48
0,1554,67210,3578766074,3578766123,49
0,1555,67211,3578766140,3578766140,0
0,1555,67212,3578766140,3578766140,0
0,1555,67213,3578766140,3578766140,0
0,1555,67214,3578766140,3578766140,0
0,1555,67215,3578766140,3578766140,0
0,1555,67216,3578766140,3578766140,0
0,1555,67217,3578766140,3578766140,0
0,1555,67218,3578766140,3578766140,0
0,1555,67219,3578766140,3578766140,0
0,1555,67220,3578766140,3578766140,0
0,1555,67221,3578766140,3578766140,0
0,1555,67222,3578766140,3578766140,0
0,1555,67223,3578766140,3578766140,0
0,1555,67224,3578766140,3578766140,0
0,1555,67225,3578766140,3578766140,0
0,1555,67226,3578766140,3578766140,0
0,1555,67227,3578766140,3578766140,0
0,1555,67228,3578766140,3578766140,0
0,1555,67229,3578766140,3578766140,0
0,1555,67230,3578766140,3578766140,0
0,1555,67231,3578766140,3578766140,0
0,1555,67232,3578766140,3578766140,0
0,1555,67233,3578766140,3578766140,0
0,1555,67234,3578766140,3578766140,0
0,1555,67235,3578766140,3578766140,0
0,1555,67236,3578766140,3578766140,0
0,1555,67237,3578766140,3578766140,0
0,1555,67238,3578766140,3578766140,0
0,1555,67239,3578766140,3578766140,0
0,1555,67240,3578766140,3578766140,0
0,1555,67241,3578766140,3578766140,0
0,1555,67242,3578766140,3578766140,0
0,1555,67243,3578766140,3578766140,0
0,1555,67244,3578766140,3578766140,0
0,1555,67245,3578766140,3578766140,0
0,1555,67246,3578766140,3578766141,1
0,1555,67247,3578766140,3578766141,1
0,1555,67248,3578766140,3578766142,2
0,1555,67249,3578766140,3578766143,3
0,1555,67250,3578766140,3578766143,3
0,1555,67251,3578766140,3578766143,3
0,1555,67252,3578766140,3578766144,4
0,1555,67253,3578766140,3578766145,5
0,1555,67254,3578766140,3578766145,5
0,1555,67255,3578766140,3578766146,6
0,1555,67256,3578766140,3578766147,7
0,1555,67257,3578766140,3578766147,7
0,1555,67258,3578766140,3578766147,7
0,1555,67259,3578766140,3578766147,7
0,1555,67260,3578766140,3578766148,8
0,1555,67261,3578766140,3578766148,8
0,1555,67262,3578766140,3578766148,8
0,1555,67263,3578766140,3578766148,8
0,1555,67264,3578766140,3578766150,10
0,1555,67265,3578766140,3578766151,11
0,1555,67266,3578766140,3578766152,12
0,1555,67267,3578766140,3578766152,12
0,1555,67268,3578766140,3578766152,12
0,1555,67269,3578766140,3578766153,13
0,1555,67270,3578766140,3578766154,14
0,1555,67271,3578766140,3578766154,14
0,1555,67272,3578766140,3578766155,15
0,1555,67273,3578766140,3578766155,15
0,1555,67274,3578766140,3578766156,16
0,1555,67275,3578766140,3578766157,17
0,1555,67276,3578766140,3578766157,17
0,1555,67277,3578766140,3578766158,18
0,1555,67278,3578766140,3578766158,18
0,1555,67279,3578766140,3578766158,18
0,1555,67280,3578766140,3578766158,18
0,1555,67281,3578766140,3578766159,19
0,1555,67282,3578766140,3578766159,19
0,1555,67283,3578766140,3578766161,21
0,1555,67284,3578766140,3578766161,21
0,1555,67285,3578766140,3578766161,21
0,1555,67286,3578766140,3578766161,21
0,1555,67287,3578766140,3578766162,22
0,1555,67288,3578766140,3578766162,22
0,1555,67289,3578766140,3578766163,23
0,1555,67290,3578766140,3578766163,23
0,1555,67291,3578766140,3578766163,23
0,1555,67292,3578766140,3578766165,25
0,1555,67293,3578766140,3578766166,26
0,1555,67294,3578766140,3578766166,26
0,1555,67295,3578766140,3578766167,27
0,1555,67296,3578766140,3578766168,28
0,1555,67297,3578766140,3578766171,31
0,1555,67298,3578766140,3578766171,31
0,1555,67299,3578766140,3578766171,31
0,1555,67300,3578766140,3578766171,31
0,1555,67301,3578766140,3578766173,33
0,1555,67302,3578766140,3578766173,33
0,1555,67303,3578766140,3578766173,33
0,1555,67304,3578766140,3578766173,33
0,1555,67305,3578766140,3578766174,34
0,1555,67306,3578766140,3578766174,34
0,1555,67307,3578766140,3578766177,37
0,1555,67308,3578766140,3578766177,37
0,1555,67309,3578766140,3578766178,38
0,1555,67310,3578766140,3578766179,39
0,1555,67311,3578766140,3578766179,39
0,1555,67312,3578766140,3578766179,39
0,1555,67313,3578766140,3578766179,39
0,1555,67314,3578766140,3578766179,39
0,1555,67315,3578766140,3578766179,39
0,1555,67316,3578766140,3578766179,39
0,1555,67317,3578766140,3578766183,43
0,1555,67318,3578766140,3578766184,44
0,1555,67319,3578766140,3578766185,45
0,1555,67320,3578766140,3578766185,45
0,1555,67321,3578766140,3578766186,46
0,1555,67322,3578766140,3578766186,46
0,1555,67323,3578766140,3578766187,47
0,1555,67324,3578766140,3578766187,47
0,1555,67325,3578766140,3578766188,48
0,1555,67326,3578766140,3578766189,49
0,1555,67327,3578766140,3578766190,50
0,1556,67328,3578766204,3578766204,0
0,1556,67329,3578766204,3578766204,0
0,1556,67330,3578766204,3578766204,0
0,1556,67331,3578766204,3578766204,0
0,1556,67332,3578766204,3578766204,0
0,1556,67333,3578766204,3578766204,0
0,1556,67334,3578766204,3578766204,0
0,1556,67335,3578766204,3578766204,0
0,1556,67336,3578766204,3578766204,0
0,1556,67337,3578766204,3578766204,0
0,1556,67338,3578766204,3578766204,0
0,1556,67339,3578766204,3578766204,0
0,1556,67340,3578766204,3578766204,0
0,1556,67341,3578766204,3578766204,0
0,1556,67342,3578766204,3578766204,0
0,1556,67343,3578766204,3578766204,0
0,1556,67344,3578766204,3578766204,0
0,1556,67345,3578766204,3578766206,2
0,1556,67346,3578766204,3578766206,2
0,1556,67347,3578766204,3578766206,2
0,1556,67348,3578766204,3578766206,2
0,1556,67349,3578766204,3578766207,3
0,1556,67350,3578766204,3578766208,4
0,1556,67351,3578766204,3578766209,5
0,1556,67352,3578766204,3578766213,9
0,1556,67353,3578766204,3578766214,10
0,1556,67354,3578766204,3578766214,10
0,1556,67355,3578766204,3578766215,11
0,1556,67356,3578766204,3578766215,11
0,1556,67357,3578766204,3578766215,11
0,1556,67358,3578766204,3578766215,11
0,1556,67359,3578766204,3578766216,12
0,1556,67360,3578766204,3578766216,12
0,1556,67361,3578766204,3578766217,13
0,1556,67362,3578766204,3578766218,14
0,1556,67363,3578766204,3578766218,14
0,1556,67364,3578766204,3578766219,15
0,1556,67365,3578766204,3578766219,15
0,1556,67366,3578766204,3578766219,15
0,1556,67367,3578766204,3578766220,16
0,1556,67368,3578766204,3578766220,16
0,1556,67369,3578766204,3578766221,17
0,1556,67370,3578766204,3578766221,17
0,1556,67371,3578766204,3578766221,17
0,1556,67372,3578766204,3578766222,18
0,1556,67373,3578766204,3578766222,18
0,1556,67374,3578766204,3578766224,20
0,1556,67375,3578766204,3578766224,20
0,1556,67376,3578766204,3578766224,20
0,1556,67377,3578766204,3578766225,21
0,1556,67378,3578766204,3578766226,22
0,1556,67379,3578766204,3578766228,24
0,1556,67380,3578766204,3578766228,24
0,1556,67381,3578766204,3578766229,25
0,1556,67382,3578766204,3578766230,26
0,1556,67383,3578766204,3578766230,26
0,1556,67384,3578766204,3578766230,26
0,1556,67385,3578766204,3578766230,26
0,1556,67386,3578766204,3578766230,26
0,1556,67387,3578766204,3578766232,28
0,1556,67388,3578766204,3578766233,29
0,1556,67389,3578766204,3578766233,29
0,1556,67390,3578766204,3578766233,29
0,1556,67391,3578766204,3578766234,30
0,1556,67392,3578766204,3578766236,32
0,1556,67393,3578766204,3578766237,33
0,1556,67394,3578766204,3578766237,33
0,1556,67395,3578766204,3578766238,34
0,1556,67396,3578766204,3578766238,34
0,1556,67397,3578766204,3578766239,35
0,1556,67398,3578766204,3578766239,35
0,1556,67399,3578766204,3578766240,36
0,1556,67400,3578766204,3578766240,36
0,1556,67401,3578766204,3578766241,37
0,1556,67402,3578766204,3578766242,38
0,1556,67403,3578766204,3578766242,38
0,1556,67404,3578766204,3578766242,38
0,1556,67405,3578766204,3578766242,38
0,1556,67406,3578766204,3578766243,39
0,1556,67407,3578766204,3578766244,40
0,1556,67408,3578766204,3578766245,41
0,1556,67409,3578766204,3578766245,41
0,1556,67410,3578766204,3578766246,42
0,1556,67411,3578766204,3578766246,42
0,1556,67412,3578766204,3578766247,43
0,1556,67413,3578766204,3578766248,44
0,1556,67414,3578766204,3578766248,44
0,1556,67415,3578766204,3578766248,44
0,1556,67416,3578766204,3578766249,45
0,1556,67417,3578766204,3578766250,46
0,1556,67418,3578766204,3578766250,46
0,1556,67419,3578766204,3578766250,46
0,1556,67420,3578766204,3578766250,46
0,1556,67421,3578766204,3578766251,47
0,1556,67422,3578766204,3578766251,47
0,1556,67423,3578766204,3578766253,49
0,1557,67424,3578766269,3578766269,0
0,1557,67425,3578766269,3578766269,0
0,1557,67426,3578766269,3578766269,0
0,1557,67427,3578766269,3578766269,0
0,1557,67428,3578766269,3578766269,0
0,1557,67429,3578766269,3578766269,0
0,1557,67430,3578766269,3578766269,0
0,1557,67431,3578766269,3578766269,0
0,1557,67432,3578766269,3578766269,0
0,1557,67433,3578766269,3578766269,0
0,1557,67434,3578766269,3578766269,0
0,1557,67435,3578766269,3578766269,0
0,1557,67436,3578766269,3578766269,0
0,1557,67437,3578766269,3578766269,0
0,1557,67438,3578766269,3578766269,0
0,1557,67439,3578766269,3578766269,0
0,1557,67440,3578766269,3578766269,0
0,1557,67441,3578766269,3578766269,0
0,1557,67442,3578766269,3578766269,0
0,1557,67443,3578766269,3578766269,0
0,1557,67444,3578766269,3578766269,0
0,1557,67445,3578766269,3578766269,0
0,1557,67446,3578766269,3578766269,0
0,1557,67447,3578766269,3578766269,0
0,1557,67448,3578766269,3578766269,0
0,1557,67449,3578766269,3578766273,4
0,1557,67450,3578766269,3578766273,4
0,1557,67451,3578766269,3578766285,16
0,1557,67452,3578766269,3578766287,18
0,1557,67453,3578766269,3578766288,19
0,1557,67454,3578766269,3578766289,20
0,1557,67455,3578766269,3578766290,21
0,1557,67456,3578766269,3578766290,21
0,1557,67457,3578766269,3578766290,21
0,1557,67458,3578766269,3578766291,22
0,1557,67459,3578766269,3578766292,23
0,1557,67460,3578766269,3578766292,23
0,1557,67461,3578766269,3578766292,23
0,1557,67462,3578766269,3578766292,23
0,1557,67463,3578766269,3578766293,24
0,1557,67464,3578766269,3578766293,24
0,1557,67465,3578766269,3578766293,24
0,1557,67466,3578766269,3578766294,25
0,1557,67467,3578766269,3578766294,25
0,1557,67468,3578766269,3578766294,25
0,1557,67469,3578766269,3578766294,25
0,1557,67470,3578766269,3578766295,26
0,1557,67471,3578766269,3578766296,27
0,1557,67472,3578766269,3578766296,27
0,1557,67473,3578766269,3578766297,28
0,1557,67474,3578766269,3578766298,29
0,1557,67475,3578766269,3578766298,29
0,1557,67476,3578766269,3578766298,29
0,1557,67477,3578766269,3578766299,30
0,1557,67478,3578766269,3578766299,30
0,1557,67479,3578766269,3578766300,31
0,1557,67480,3578766269,3578766302,33
0,1557,67481,3578766269,3578766303,34
0,1557,67482,3578766269,3578766304,35
0,1557,67483,3578766269,3578766304,35
0,1557,67484,3578766269,3578766304,35
0,1557,67485,3578766269,3578766304,35
0,1557,67486,3578766269,3578766305,36
0,1557,67487,3578766269,3578766306,37
0,1557,67488,3578766269,3578766306,37
0,1557,67489,3578766269,3578766307,38
0,1557,67490,3578766269,3578766307,38
0,1557,67491,3578766269,3578766307,38
0,1557,67492,3578766269,3578766308,39
0,1557,67493,3578766269,3578766309,40
0,1557,67494,3578766269,3578766309,40
0,1557,67495,3578766269,3578766309,40
0,1557,67496,3578766269,3578766309,40
0,1557,67497,3578766269,3578766309,40
0,1557,67498,3578766269,3578766309,40
0,1557,67499,3578766269,3578766310,41
0,1557,67500,3578766269,3578766310,41
0,1557,67501,3578766269,3578766310,41
0,1557,67502,3578766269,3578766310,41
0,1557,67503,3578766269,3578766311,42
0,1557,67504,3578766269,3578766312,43
0,1557,67505,3578766269,3578766312,43
0,1557,67506,3578766269,3578766313,44
0,1557,67507,3578766269,3578766313,44
0,1557,67508,3578766269,3578766314,45
0,1557,67509,3578766269,3578766315,46
0,1557,67510,3578766269,3578766315,46
0,1557,67511,3578766269,3578766315,46
0,1557,67512,3578766269,3578766316,47
0,1557,67513,3578766269,3578766316,47
0,1557,67514,3578766269,3578766316,47
0,1557,67515,3578766269,3578766316,47
0,1557,67516,3578766269,3578766316,47
0,1557,67517,3578766269,3578766316,47
0,1557,67518,3578766269,3578766316,47
0,1557,67519,3578766269,3578766316,47
0,1557,67520,3578766269,3578766316,47
0,1557,67521,3578766269,3578766317,48
0,1557,67522,3578766269,3578766317,48
0,1557,67523,3578766269,3578766318,49
0,1557,67524,3578766269,3578766319,50
0,1558,67525,3578766333,3578766333,0
0,1558,67526,3578766333,3578766333,0
0,1558,67527,3578766333,3578766333,0
0,1558,67528,3578766333,3578766333,0
0,1558,67529,3578766333,3578766333,0
0,1558,67530,3578766333,3578766333,0
0,1558,67531,3578766333,3578766333,0
0,1558,67532,3578766333,3578766333,0
0,1558,67533,3578766333,3578766333,0
0,1558,67534,3578766333,3578766333,0
0,1558,67535,3578766333,3578766333,0
0,1558,67536,3578766333,3578766333,0
0,1558,67537,3578766333,3578766333,0
0,1558,67538,3578766333,3578766333,0
0,1558,67539,3578766333,3578766333,0
0,1558,67540,3578766333,3578766333,0
0,1558,67541,3578766333,3578766333,0
0,1558,67542,3578766333,3578766333,0
0,1558,67543,3578766333,3578766333,0
0,1558,67544,3578766333,3578766333,0
0,1558,67545,3578766333,3578766333,0
0,1558,67546,3578766333,3578766333,0
0,1558,67547,3578766333,3578766333,0
0,1558,67548,3578766333,3578766333,0
0,1558,67549,3578766333,3578766333,0
0,1558,67550,3578766333,3578766333,0
0,1558,67551,3578766333,3578766333,0
0,1558,67552,3578766333,3578766333,0
0,1558,67553,3578766333,3578766333,0
0,1558,67554,3578766333,3578766333,0
0,1558,67555,3578766333,3578766333,0
0,1558,67556,3578766333,3578766333,0
0,1558,67557,3578766333,3578766333,0
0,1558,67558,3578766333,3578766333,0
0,1558,67559,3578766333,3578766333,0
0,1558,67560,3578766333,3578766333,0
0,1558,67561,3578766333,3578766333,0
0,1558,67562,3578766333,3578766334,1
0,1558,67563,3578766333,3578766335,2
0,1558,67564,3578766333,3578766336,3
0,1558,67565,3578766333,3578766337,4
0,1558,67566,3578766333,3578766337,4
0,1558,67567,3578766333,3578766339,6
0,1558,67568,3578766333,3578766340,7
0,1558,67569,3578766333,3578766340,7
0,1558,67570,3578766333,3578766340,7
0,1558,67571,3578766333,3578766340,7
0,1558,67572,3578766333,3578766341,8
0,1558,67573,3578766333,3578766341,8
0,1558,67574,3578766333,3578766341,8
0,1558,67575,3578766333,3578766342,9
0,1558,67576,3578766333,3578766343,10
0,1558,67577,3578766333,3578766343,10
0,1558,67578,3578766333,3578766343,10
0,1558,67579,3578766333,3578766343,10
0,1558,67580,3578766333,3578766344,11
0,1558,67581,3578766333,3578766344,11
0,1558,67582,3578766333,3578766344,11
0,1558,67583,3578766333,3578766345,12
0,1558,67584,3578766333,3578766346,13
0,1558,67585,3578766333,3578766347,14
0,1558,67586,3578766333,3578766348,15
0,1558,67587,3578766333,3578766348,15
0,1558,67588,3578766333,3578766348,15
0,1558,67589,3578766333,3578766349,16
0,1558,67590,3578766333,3578766350,17
0,1558,67591,3578766333,3578766351,18
0,1558,67592,3578766333,3578766351,18
0,1558,67593,3578766333,3578766353,20
0,1558,67594,3578766333,3578766353,20
0,1558,67595,3578766333,3578766353,20
0,1558,67596,3578766333,3578766354,21
0,1558,67597,3578766333,3578766355,22
0,1558,67598,3578766333,3578766356,23
0,1558,67599,3578766333,3578766356,23
0,1558,67600,3578766333,3578766356,23
0,1558,67601,3578766333,3578766358,25
0,1558,67602,3578766333,3578766358,25
0,1558,67603,3578766333,3578766358,25
0,1558,67604,3578766333,3578766359,26
0,1558,67605,3578766333,3578766359,26
0,1558,67606,3578766333,3578766360,27
0,1558,67607,3578766333,3578766360,27
0,1558,67608,3578766333,3578766361,28
0,1558,67609,3578766333,3578766361,28
0,1558,67610,3578766333,3578766361,28
0,1558,67611,3578766333,3578766362,29
0,1558,67612,3578766333,3578766363,30
0,1558,67613,3578766333,3578766363,30
0,1558,67614,3578766333,3578766364,31
0,1558,67615,3578766333,3578766365,32
0,1558,67616,3578766333,3578766365,32
0,1558,67617,3578766333,3578766365,32
0,1558,67618,3578766333,3578766367,34
0,1558,67619,3578766333,3578766368,35
0,1558,67620,3578766333,3578766370,37
0,1558,67621,3578766333,3578766370,37
0,1558,67622,3578766333,3578766371,38
0,1558,67623,3578766333,3578766371,38
0,1558,67624,3578766333,3578766372,39
0,1558,67625,3578766333,3578766372,39
0,1558,67626,3578766333,3578766372,39
0,1558,67627,3578766333,3578766374,41
0,1558,67628,3578766333,3578766374,41
0,1558,67629,3578766333,3578766375,42
0,1558,67630,3578766333,3578766375,42
0,1558,67631,3578766333,3578766376,43
0,1558,67632,3578766333,3578766378,45
0,1558,67633,3578766333,3578766378,45
0,1558,67634,3578766333,3578766378,45
0,1558,67635,3578766333,3578766379,46
0,1558,67636,3578766333,3578766379,46
0,1558,67637,3578766333,3578766379,46
0,1558,67638,3578766333,3578766379,46
0,1558,67639,3578766333,3578766380,47
0,1558,67640,3578766333,3578766380,47
0,1558,67641,3578766333,3578766382,49
0,1559,67642,3578766397,3578766397,0
0,1559,67643,3578766397,3578766397,0
0,1559,67644,3578766397,3578766397,0
0,1559,67645,3578766397,3578766397,0
0,1559,67646,3578766397,3578766397,0
0,1559,67647,3578766397,3578766397,0
0,1559,67648,3578766397,3578766398,1
0,1559,67649,3578766397,3578766398,1
0,1559,67650,3578766397,3578766398,1
0,1559,67651,3578766397,3578766398,1
0,1559,67652,3578766397,3578766398,1
0,1559,67653,3578766397,3578766398,1
0,1559,67654,3578766397,3578766398,1
0,1559,67655,3578766397,3578766398,1
0,1559,67656,3578766397,3578766398,1
0,1559,67657,3578766397,3578766398,1
0,1559,67658,3578766397,3578766398,1
0,1559,67659,3578766397,3578766398,1
0,1559,67660,3578766397,3578766398,1
0,1559,67661,3578766397,3578766398,1
0,1559,67662,3578766397,3578766399,2
0,1559,67663,3578766397,3578766399,2
0,1559,67664,3578766397,3578766400,3
0,1559,67665,3578766397,3578766401,4
0,1559,67666,3578766397,3578766402,5
0,1559,67667,3578766397,3578766402,5
0,1559,67668,3578766397,3578766404,7
0,1559,67669,3578766397,3578766404,7
0,1559,67670,3578766397,3578766405,8
0,1559,67671,3578766397,3578766405,8
0,1559,67672,3578766397,3578766405,8
0,1559,67673,3578766397,3578766406,9
0,1559,67674,3578766397,3578766407,10
0,1559,67675,3578766397,3578766407,10
0,1559,67676,3578766397,3578766408,11
0,1559,67677,3578766397,3578766409,12
0,1559,67678,3578766397,3578766411,14
0,1559,67679,3578766397,3578766413,16
0,1559,67680,3578766397,3578766413,16
0,1559,67681,3578766397,3578766413,16
0,1559,67682,3578766397,3578766413,16
0,1559,67683,3578766397,3578766414,17
0,1559,67684,3578766397,3578766415,18
0,1559,67685,3578766397,3578766415,18
0,1559,67686,3578766397,3578766415,18
0,1559,67687,3578766397,3578766415,18
0,1559,67688,3578766397,3578766416,19
0,1559,67689,3578766397,3578766416,19
0,1559,67690,3578766397,3578766416,19
0,1559,67691,3578766397,3578766417,20
0,1559,67692,3578766397,3578766417,20
0,1559,67693,3578766397,3578766418,21
0,1559,67694,3578766397,3578766418,21
0,1559,67695,3578766397,3578766419,22
0,1559,67696,3578766397,3578766419,22
0,1559,67697,3578766397,3578766419,22
0,1559,67698,3578766397,3578766420,23
0,1559,67699,3578766397,3578766421,24
0,1559,67700,3578766397,3578766421,24
0,1559,67701,3578766397,3578766421,24
0,1559,67702,3578766397,3578766422,25
0,1559,67703,3578766397,3578766422,25
0,1559,67704,3578766397,3578766424,27
0,1559,67705,3578766397,3578766424,27
0,1559,67706,3578766397,3578766425,28
0,1559,67707,3578766397,3578766426,29
0,1559,67708,3578766397,3578766427,30
0,1559,67709,3578766397,3578766427,30
0,1559,67710,3578766397,3578766430,33
0,1559,67711,3578766397,3578766430,33
0,1559,67712,3578766397,3578766430,33
0,1559,67713,3578766397,3578766430,33
0,1559,67714,3578766397,3578766431,34
0,1559,67715,3578766397,3578766431,34
0,1559,67716,3578766397,3578766432,35
0,1559,67717,3578766397,3578766433,36
0,1559,67718,3578766397,3578766433,36
0,1559,67719,3578766397,3578766433,36
0,1559,67720,3578766397,3578766434,37
0,1559,67721,3578766397,3578766436,39
0,1559,67722,3578766397,3578766436,39
0,1559,67723,3578766397,3578766436,39
0,1559,67724,3578766397,3578766438,41
0,1559,67725,3578766397,3578766439,42
0,1559,67726,3578766397,3578766439,42
0,1559,67727,3578766397,3578766439,42
0,1559,67728,3578766397,3578766440,43
0,1559,67729,3578766397,3578766440,43
0,1559,67730,3578766397,3578766440,43
0,1559,67731,3578766397,3578766441,44
0,1559,67732,3578766397,3578766441,44
0,1559,67733,3578766397,3578766442,45
0,1559,67734,3578766397,3578766443,46
0,1559,67735,3578766397,3578766443,46
0,1559,67736,3578766397,3578766443,46
0,1559,67737,3578766397,3578766443,46
0,1559,67738,3578766397,3578766444,47
0,1559,67739,3578766397,3578766446,49
0,1560,67740,3578766461,3578766461,0
0,1560,67741,3578766461,3578766461,0
0,1560,67742,3578766461,3578766461,0
0,1560,67743,3578766461,3578766461,0
0,1560,67744,3578766461,3578766461,0
0,1560,67745,3578766461,3578766461,0
0,1560,67746,3578766461,3578766461,0
0,1560,67747,3578766461,3578766461,0
0,1560,67748,3578766461,3578766461,0
0,1560,67749,3578766461,3578766461,0
0,1560,67750,3578766461,3578766461,0
0,1560,67751,3578766461,3578766461,0
0,1560,67752,3578766461,3578766461,0
0,1560,67753,3578766461,3578766461,0
0,1560,67754,3578766461,3578766461,0
0,1560,67755,3578766461,3578766461,0
0,1560,67756,3578766461,3578766461,0
0,1560,67757,3578766461,3578766461,0
0,1560,67758,3578766461,3578766461,0
0,1560,67759,3578766461,3578766462,1
0,1560,67760,3578766461,3578766462,1
0,1560,67761,3578766461,3578766463,2
0,1560,67762,3578766461,3578766464,3
0,1560,67763,3578766461,3578766464,3
0,1560,67764,3578766461,3578766465,4
0,1560,67765,3578766461,3578766465,4
0,1560,67766,3578766461,3578766465,4
0,1560,67767,3578766461,3578766467,6
0,1560,67768,3578766461,3578766467,6
0,1560,67769,3578766461,3578766467,6
0,1560,67770,3578766461,3578766468,7
0,1560,67771,3578766461,3578766469,8
0,1560,67772,3578766461,3578766473,12
0,1560,67773,3578766461,3578766486,25
0,1560,67774,3578766461,3578766487,26
0,1560,67775,3578766461,3578766488,27
0,1560,67776,3578766461,3578766488,27
0,1560,67777,3578766461,3578766490,29
0,1560,67778,3578766461,3578766490,29
0,1560,67779,3578766461,3578766490,29
0,1560,67780,3578766461,3578766491,30
0,1560,67781,3578766461,3578766491,30
0,1560,67782,3578766461,3578766492,31
0,1560,67783,3578766461,3578766492,31
0,1560,67784,3578766461,3578766493,32
0,1560,67785,3578766461,3578766493,32
0,1560,67786,3578766461,3578766493,32
0,1560,67787,3578766461,3578766493,32
0,1560,67788,3578766461,3578766493,32
0,1560,67789,3578766461,3578766494,33
0,1560,67790,3578766461,3578766495,34
0,1560,67791,3578766461,3578766496,35
0,1560,67792,3578766461,3578766496,35
0,1560,67793,3578766461,3578766497,36
0,1560,67794,3578766461,3578766498,37
0,1560,67795,3578766461,3578766498,37
0,1560,67796,3578766461,3578766498,37
0,1560,67797,3578766461,3578766498,37
0,1560,67798,3578766461,3578766498,37
0,1560,67799,3578766461,3578766500,39
0,1560,67800,3578766461,3578766500,39
0,1560,67801,3578766461,3578766503,42
0,1560,67802,3578766461,3578766503,42
0,1560,67803,3578766461,3578766504,43
0,1560,67804,3578766461,3578766504,43
0,1560,67805,3578766461,3578766504,43
0,1560,67806,3578766461,3578766505,44
0,1560,67807,3578766461,3578766505,44
0,1560,67808,3578766461,3578766506,45
0,1560,67809,3578766461,3578766506,45
0,1560,67810,3578766461,3578766506,45
0,1560,67811,3578766461,3578766507,46
0,1560,67812,3578766461,3578766507,46
0,1560,67813,3578766461,3578766508,47
0,1560,67814,3578766461,3578766508,47
0,1560,67815,3578766461,3578766508,47
0,1560,67816,3578766461,3578766509,48
0,1560,67817,3578766461,3578766509,48
0,1560,67818,3578766461,3578766509,48
0,1560,67819,3578766461,3578766509,48
0,1560,67820,3578766461,3578766509,48
0,1560,67821,3578766461,3578766509,48
0,1560,67822,3578766461,3578766510,49
0,1560,67823,3578766461,3578766510,49
0,1560,67824,3578766461,3578766510,49
0,1560,67825,3578766461,3578766510,49
0,1560,67826,3578766461,3578766511,50
0,1561,67827,3578766526,3578766526,0
0,1561,67828,3578766526,3578766526,0
0,1561,67829,3578766526,3578766526,0
0,1561,67830,3578766526,3578766526,0
0,1561,67831,3578766526,3578766526,0
0,1561,67832,3578766526,3578766526,0
0,1561,67833,3578766526,3578766526,0
0,1561,67834,3578766526,3578766526,0
0,1561,67835,3578766526,3578766526,0
0,1561,67836,3578766526,3578766526,0
0,1561,67837,3578766526,3578766526,0
0,1561,67838,3578766526,3578766526,0
0,1561,67839,3578766526,3578766526,0
0,1561,67840,3578766526,3578766526,0
0,1561,67841,3578766526,3578766526,0
0,1561,67842,3578766526,3578766526,0
0,1561,67843,3578766526,3578766526,0
0,1561,67844,3578766526,3578766526,0
0,1561,67845,3578766526,3578766526,0
0,1561,67846,3578766526,3578766526,0
0,1561,67847,3578766526,3578766526,0
0,1561,67848,3578766526,3578766526,0
0,1561,67849,3578766526,3578766526,0
0,1561,67850,3578766526,3578766526,0
0,1561,67851,3578766526,3578766526,0
0,1561,67852,3578766526,3578766526,0
0,1561,67853,3578766526,3578766526,0
0,1561,67854,3578766526,3578766526,0
0,1561,67855,3578766526,3578766526,0
0,1561,67856,3578766526,3578766526,0
0,1561,67857,3578766526,3578766526,0
0,1561,67858,3578766526,3578766526,0
0,1561,67859,3578766526,3578766526,0
0,1561,67860,3578766526,3578766526,0
0,1561,67861,3578766526,3578766526,0
0,1561,67862,3578766526,3578766526,0
0,1561,67863,3578766526,3578766526,0
0,1561,67864,3578766526,3578766526,0
0,1561,67865,3578766526,3578766527,1
0,1561,67866,3578766526,3578766527,1
0,1561,67867,3578766526,3578766527,1
0,1561,67868,3578766526,3578766527,1
0,1561,67869,3578766526,3578766527,1
0,1561,67870,3578766526,3578766528,2
0,1561,67871,3578766526,3578766528,2
0,1561,67872,3578766526,3578766529,3
0,1561,67873,3578766526,3578766529,3
0,1561,67874,3578766526,3578766529,3
0,1561,67875,3578766526,3578766530,4
0,1561,67876,3578766526,3578766530,4
0,1561,67877,3578766526,3578766530,4
0,1561,67878,3578766526,3578766531,5
0,1561,67879,3578766526,3578766531,5
0,1561,67880,3578766526,3578766532,6
0,1561,67881,3578766526,3578766532,6
0,1561,67882,3578766526,3578766532,6
0,1561,67883,3578766526,3578766533,7
0,1561,67884,3578766526,3578766533,7
0,1561,67885,3578766526,3578766534,8
0,1561,67886,3578766526,3578766535,9
0,1561,67887,3578766526,3578766536,10
0,1561,67888,3578766526,3578766536,10
0,1561,67889,3578766526,3578766537,11
0,1561,67890,3578766526,3578766538,12
0,1561,67891,3578766526,3578766539,13
0,1561,67892,3578766526,3578766539,13
0,1561,67893,3578766526,3578766540,14
0,1561,67894,3578766526,3578766540,14
0,1561,67895,3578766526,3578766540,14
0,1561,67896,3578766526,3578766541,15
0,1561,67897,3578766526,3578766541,15
0,1561,67898,3578766526,3578766542,16
0,1561,67899,3578766526,3578766543,17
0,1561,67900,3578766526,3578766543,17
0,1561,67901,3578766526,3578766544,18
0,1561,67902,3578766526,3578766544,18
0,1561,67903,3578766526,3578766544,18
0,1561,67904,3578766526,3578766545,19
0,1561,67905,3578766526,3578766546,20
0,1561,67906,3578766526,3578766547,21
0,1561,67907,3578766526,3578766547,21
0,1561,67908,3578766526,3578766549,23
0,1561,67909,3578766526,3578766549,23
0,1561,67910,3578766526,3578766550,24
0,1561,67911,3578766526,3578766552,26
0,1561,67912,3578766526,3578766552,26
0,1561,67913,3578766526,3578766553,27
0,1561,67914,3578766526,3578766554,28
0,1561,67915,3578766526,3578766555,29
0,1561,67916,3578766526,3578766556,30
0,1561,67917,3578766526,3578766556,30
0,1561,67918,3578766526,3578766557,31
0,1561,67919,3578766526,3578766558,32
0,1561,67920,3578766526,3578766558,32
0,1561,67921,3578766526,3578766558,32
0,1561,67922,3578766526,3578766558,32
0,1561,67923,3578766526,3578766559,33
0,1561,67924,3578766526,3578766560,34
0,1561,67925,3578766526,3578766560,34
0,1561,67926,3578766526,3578766560,34
0,1561,67927,3578766526,3578766560,34
0,1561,67928,3578766526,3578766561,35
0,1561,67929,3578766526,3578766561,35
0,1561,67930,3578766526,3578766561,35
0,1561,67931,3578766526,3578766562,36
0,1561,67932,3578766526,3578766562,36
0,1561,67933,3578766526,3578766563,37
0,1561,67934,3578766526,3578766564,38
0,1561,67935,3578766526,3578766564,38
0,1561,67936,3578766526,3578766564,38
0,1561,67937,3578766526,3578766565,39
0,1561,67938,3578766526,3578766566,40
0,1561,67939,3578766526,3578766569,43
0,1561,67940,3578766526,3578766569,43
0,1561,67941,3578766526,3578766571,45
0,1561,67942,3578766526,3578766571,45
0,1561,67943,3578766526,3578766571,45
0,1561,67944,3578766526,3578766571,45
0,1561,67945,3578766526,3578766571,45
0,1561,67946,3578766526,3578766572,46
0,1561,67947,3578766526,3578766572,46
0,1561,67948,3578766526,3578766572,46
0,1561,67949,3578766526,3578766573,47
0,1561,67950,3578766526,3578766574,48
0,1561,67951,3578766526,3578766575,49
0,1561,67952,3578766526,3578766575,49
0,1562,67953,3578766591,3578766591,0
0,1562,67954,3578766591,3578766591,0
0,1562,67955,3578766591,3578766591,0
0,1562,67956,3578766591,3578766591,0
0,1562,67957,3578766591,3578766591,0
0,1562,67958,3578766591,3578766591,0
0,1562,67959,3578766591,3578766591,0
0,1562,67960,3578766591,3578766591,0
0,1562,67961,3578766591,3578766591,0
0,1562,67962,3578766591,3578766591,0
0,1562,67963,3578766591,3578766591,0
0,1562,67964,3578766591,3578766591,0
0,1562,67965,3578766591,3578766591,0
0,1562,67966,3578766591,3578766591,0
0,1562,67967,3578766591,3578766591,0
0,1562,67968,3578766591,3578766591,0
0,1562,67969,3578766591,3578766591,0
0,1562,67970,3578766591,3578766591,0
0,1562,67971,3578766591,3578766591,0
0,1562,67972,3578766591,3578766591,0
0,1562,67973,3578766591,3578766591,0
0,1562,67974,3578766591,3578766591,0
0,1562,67975,3578766591,3578766591,0
0,1562,67976,3578766591,3578766591,0
0,1562,67977,3578766591,3578766592,1
0,1562,67978,3578766591,3578766593,2
0,1562,67979,3578766591,3578766593,2
0,1562,67980,3578766591,3578766596,5
0,1562,67981,3578766591,3578766596,5
0,1562,67982,3578766591,3578766597,6
0,1562,67983,3578766591,3578766598,7
0,1562,67984,3578766591,3578766599,8
0,1562,67985,3578766591,3578766599,8
0,1562,67986,3578766591,3578766601,10
0,1562,67987,3578766591,3578766602,11
0,1562,67988,3578766591,3578766603,12
0,1562,67989,3578766591,3578766604,13
0,1562,67990,3578766591,3578766604,13
0,1562,67991,3578766591,3578766604,13
0,1562,67992,3578766591,3578766606,15
0,1562,67993,3578766591,3578766606,15
0,1562,67994,3578766591,3578766607,16
0,1562,67995,3578766591,3578766607,16
0,1562,67996,3578766591,3578766608,17
0,1562,67997,3578766591,3578766610,19
0,1562,67998,3578766591,3578766612,21
0,1562,67999,3578766591,3578766612,21
0,1562,68000,3578766591,3578766612,21
0,1562,68001,3578766591,3578766613,22
0,1562,68002,3578766591,3578766613,22
0,1562,68003,3578766591,3578766614,23
0,1562,68004,3578766591,3578766615,24
0,1562,68005,3578766591,3578766615,24
0,1562,68006,3578766591,3578766615,24
0,1562,68007,3578766591,3578766615,24
0,1562,68008,3578766591,3578766615,24
0,1562,68009,3578766591,3578766616,25
0,1562,68010,3578766591,3578766616,25
0,1562,68011,3578766591,3578766617,26
0,1562,68012,3578766591,3578766618,27
0,1562,68013,3578766591,3578766618,27
0,1562,68014,3578766591,3578766618,27
0,1562,68015,3578766591,3578766618,27
0,1562,68016,3578766591,3578766618,27
0,1562,68017,3578766591,3578766619,28
0,1562,68018,3578766591,3578766620,29
0,1562,68019,3578766591,3578766620,29
0,1562,68020,3578766591,3578766621,30
0,1562,68021,3578766591,3578766621,30
0,1562,68022,3578766591,3578766623,32
0,1562,68023,3578766591,3578766623,32
0,1562,68024,3578766591,3578766624,33
0,1562,68025,3578766591,3578766626,35
0,1562,68026,3578766591,3578766626,35
0,1562,68027,3578766591,3578766627,36
0,1562,68028,3578766591,3578766629,38
0,1562,68029,3578766591,3578766629,38
0,1562,68030,3578766591,3578766630,39
0,1562,68031,3578766591,3578766631,40
0,1562,68032,3578766591,3578766631,40
0,1562,68033,3578766591,3578766632,41
0,1562,68034,3578766591,3578766632,41
0,1562,68035,3578766591,3578766633,42
0,1562,68036,3578766591,3578766633,42
0,1562,68037,3578766591,3578766635,44
0,1562,68038,3578766591,3578766635,44
0,1562,68039,3578766591,3578766636,45
0,1562,68040,3578766591,3578766637,46
0,1562,68041,3578766591,3578766639,48
0,1562,68042,3578766591,3578766639,48
0,1562,68043,3578766591,3578766639,48
0,1562,68044,3578766591,3578766639,48
0,1562,68045,3578766591,3578766639,48
0,1562,68046,3578766591,3578766639,48
0,1562,68047,3578766591,3578766640,49
0,1562,68048,3578766591,3578766641,50
0,1562,68049,3578766591,3578766641,50
0,1563,68050,3578766656,3578766656,0
0,1563,68051,3578766656,3578766656,0
0,1563,68052,3578766656,3578766656,0
0,1563,68053,3578766656,3578766656,0
0,1563,68054,3578766656,3578766656,0
0,1563,68055,3578766656,3578766656,0
0,1563,68056,3578766656,3578766656,0
0,1563,68057,3578766656,3578766656,0
0,1563,68058,3578766656,3578766656,0
0,1563,68059,3578766656,3578766656,0
0,1563,68060,3578766656,3578766656,0
0,1563,68061,3578766656,3578766656,0
0,1563,68062,3578766656,3578766657,1
0,1563,68063,3578766656,3578766657,1
0,1563,68064,3578766656,3578766657,1
0,1563,68065,3578766656,3578766657,1
0,1563,68066,3578766656,3578766657,1
0,1563,68067,3578766656,3578766657,1
0,1563,68068,3578766656,3578766657,1
0,1563,68069,3578766656,3578766657,1
0,1563,68070,3578766656,3578766657,1
0,1563,68071,3578766656,3578766659,3
0,1563,68072,3578766656,3578766659,3
0,1563,68073,3578766656,3578766659,3
0,1563,68074,3578766656,3578766661,5
0,1563,68075,3578766656,3578766661,5
0,1563,68076,3578766656,3578766661,5
0,1563,68077,3578766656,3578766663,7
0,1563,68078,3578766656,3578766663,7
0,1563,68079,3578766656,3578766664,8
0,1563,68080,3578766656,3578766664,8
0,1563,68081,3578766656,3578766664,8
0,1563,68082,3578766656,3578766664,8
0,1563,68083,3578766656,3578766665,9
0,1563,68084,3578766656,3578766666,10
0,1563,68085,3578766656,3578766667,11
0,1563,68086,3578766656,3578766667,11
0,1563,68087,3578766656,3578766668,12
0,1563,68088,3578766656,3578766673,17
0,1563,68089,3578766656,3578766685,29
0,1563,68090,3578766656,3578766687,31
0,1563,68091,3578766656,3578766688,32
0,1563,68092,3578766656,3578766688,32
0,1563,68093,3578766656,3578766688,32
0,1563,68094,3578766656,3578766690,34
0,1563,68095,3578766656,3578766690,34
0,1563,68096,3578766656,3578766690,34
0,1563,68097,3578766656,3578766690,34
0,1563,68098,3578766656,3578766691,35
0,1563,68099,3578766656,3578766692,36
0,1563,68100,3578766656,3578766692,36
0,1563,68101,3578766656,3578766693,37
0,1563,68102,3578766656,3578766693,37
0,1563,68103,3578766656,3578766693,37
0,1563,68104,3578766656,3578766693,37
0,1563,68105,3578766656,3578766694,38
0,1563,68106,3578766656,3578766694,38
0,1563,68107,3578766656,3578766694,38
0,1563,68108,3578766656,3578766694,38
0,1563,68109,3578766656,3578766696,40
0,1563,68110,3578766656,3578766697,41
0,1563,68111,3578766656,3578766697,41
0,1563,68112,3578766656,3578766697,41
0,1563,68113,3578766656,3578766698,42
0,1563,68114,3578766656,3578766698,42
0,1563,68115,3578766656,3578766698,42
0,1563,68116,3578766656,3578766699,43
0,1563,68117,3578766656,3578766699,43
0,1563,68118,3578766656,3578766699,43
0,1563,68119,3578766656,3578766700,44
0,1563,68120,3578766656,3578766703,47
0,1563,68121,3578766656,3578766704,48
0,1563,68122,3578766656,3578766704,48
0,1563,68123,3578766656,3578766704,48
0,1563,68124,3578766656,3578766704,48
0,1563,68125,3578766656,3578766705,49
0,1563,68126,3578766656,3578766706,50
0,1564,68127,3578766721,3578766721,0
0,1564,68128,3578766721,3578766721,0
0,1564,68129,3578766721,3578766721,0
0,1564,68130,3578766721,3578766721,0
0,1564,68131,3578766721,3578766721,0
0,1564,68132,3578766721,3578766721,0
0,1564,68133,3578766721,3578766721,0
0,1564,68134,3578766721,3578766721,0
0,1564,68135,3578766721,3578766721,0
0,1564,68136,3578766721,3578766721,0
0,1564,68137,3578766721,3578766721,0
0,1564,68138,3578766721,3578766721,0
0,1564,68139,3578766721,3578766721,0
0,1564,68140,3578766721,3578766721,0
0,1564,68141,3578766721,3578766721,0
0,1564,68142,3578766721,3578766722,1
0,1564,68143,3578766721,3578766722,1
0,1564,68144,3578766721,3578766722,1
0,1564,68145,3578766721,3578766722,1
0,1564,68146,3578766721,3578766722,1
0,1564,68147,3578766721,3578766722,1
0,1564,68148,3578766721,3578766722,1
0,1564,68149,3578766721,3578766722,1
0,1564,68150,3578766721,3578766722,1
0,1564,68151,3578766721,3578766722,1
0,1564,68152,3578766721,3578766722,1
0,1564,68153,3578766721,3578766722,1
0,1564,68154,3578766721,3578766722,1
0,1564,68155,3578766721,3578766722,1
0,1564,68156,3578766721,3578766722,1
0,1564,68157,3578766721,3578766722,1
0,1564,68158,3578766721,3578766722,1
0,1564,68159,3578766721,3578766722,1
0,1564,68160,3578766721,3578766722,1
0,1564,68161,3578766721,3578766722,1
0,1564,68162,3578766721,3578766722,1
0,1564,68163,3578766721,3578766722,1
0,1564,68164,3578766721,3578766722,1
0,1564,68165,3578766721,3578766722,1
0,1564,68166,3578766721,3578766722,1
0,1564,68167,3578766721,3578766722,1
0,1564,68168,3578766721,3578766723,2
0,1564,68169,3578766721,3578766723,2
0,1564,68170,3578766721,3578766723,2
0,1564,68171,3578766721,3578766724,3
0,1564,68172,3578766721,3578766724,3
0,1564,68173,3578766721,3578766725,4
0,1564,68174,3578766721,3578766726,5
0,1564,68175,3578766721,3578766726,5
0,1564,68176,3578766721,3578766727,6
0,1564,68177,3578766721,3578766727,6
0,1564,68178,3578766721,3578766727,6
0,1564,68179,3578766721,3578766727,6
0,1564,68180,3578766721,3578766727,6
0,1564,68181,3578766721,3578766727,6
0,1564,68182,3578766721,3578766727,6
0,1564,68183,3578766721,3578766728,7
0,1564,68184,3578766721,3578766728,7
0,1564,68185,3578766721,3578766728,7
0,1564,68186,3578766721,3578766729,8
0,1564,68187,3578766721,3578766729,8
0,1564,68188,3578766721,3578766730,9
0,1564,68189,3578766721,3578766730,9
0,1564,68190,3578766721,3578766731,10
0,1564,68191,3578766721,3578766731,10
0,1564,68192,3578766721,3578766732,11
0,1564,68193,3578766721,3578766732,11
0,1564,68194,3578766721,3578766732,11
0,1564,68195,3578766721,3578766733,12
0,1564,68196,3578766721,3578766733,12
0,1564,68197,3578766721,3578766733,12
0,1564,68198,3578766721,3578766734,13
0,1564,68199,3578766721,3578766734,13
0,1564,68200,3578766721,3578766735,14
0,1564,68201,3578766721,3578766736,15
0,1564,68202,3578766721,3578766736,15
0,1564,68203,3578766721,3578766736,15
0,1564,68204,3578766721,3578766739,18
0,1564,68205,3578766721,3578766740,19
0,1564,68206,3578766721,3578766740,19
0,1564,68207,3578766721,3578766740,19
0,1564,68208,3578766721,3578766740,19
0,1564,68209,3578766721,3578766742,21
0,1564,68210,3578766721,3578766743,22
0,1564,68211,3578766721,3578766744,23
0,1564,68212,3578766721,3578766744,23
0,1564,68213,3578766721,3578766744,23
0,1564,68214,3578766721,3578766745,24
0,1564,68215,3578766721,3578766746,25
0,1564,68216,3578766721,3578766747,26
0,1564,68217,3578766721,3578766749,28
0,1564,68218,3578766721,3578766750,29
0,1564,68219,3578766721,3578766752,31
0,1564,68220,3578766721,3578766752,31
0,1564,68221,3578766721,3578766752,31
0,1564,68222,3578766721,3578766753,32
0,1564,68223,3578766721,3578766753,32
0,1564,68224,3578766721,3578766753,32
0,1564,68225,3578766721,3578766754,33
0,1564,68226,3578766721,3578766754,33
0,1564,68227,3578766721,3578766755,34
0,1564,68228,3578766721,3578766756,35
0,1564,68229,3578766721,3578766756,35
0,1564,68230,3578766721,3578766757,36
0,1564,68231,3578766721,3578766758,37
0,1564,68232,3578766721,3578766758,37
0,1564,68233,3578766721,3578766759,38
0,1564,68234,3578766721,3578766759,38
0,1564,68235,3578766721,3578766759,38
0,1564,68236,3578766721,3578766760,39
0,1564,68237,3578766721,3578766760,39
0,1564,68238,3578766721,3578766760,39
0,1564,68239,3578766721,3578766760,39
0,1564,68240,3578766721,3578766761,40
0,1564,68241,3578766721,3578766761,40
0,1564,68242,3578766721,3578766761,40
0,1564,68243,3578766721,3578766761,40
0,1564,68244,3578766721,3578766762,41
0,1564,68245,3578766721,3578766762,41
0,1564,68246,3578766721,3578766764,43
0,1564,68247,3578766721,3578766764,43
0,1564,68248,3578766721,3578766765,44
0,1564,68249,3578766721,3578766765,44
0,1564,68250,3578766721,3578766767,46
0,1564,68251,3578766721,3578766768,47
0,1564,68252,3578766721,3578766769,48
0,1564,68253,3578766721,3578766770,49
0,1564,68254,3578766721,3578766770,49
0,1564,68255,3578766721,3578766771,50
0,1565,68256,3578766787,3578766787,0
0,1565,68257,3578766787,3578766787,0
0,1565,68258,3578766787,3578766787,0
0,1565,68259,3578766787,3578766787,0
0,1565,68260,3578766787,3578766787,0
0,1565,68261,3578766787,3578766787,0
0,1565,68262,3578766787,3578766787,0
0,1565,68263,3578766787,3578766787,0
0,1565,68264,3578766787,3578766787,0
0,1565,68265,3578766787,3578766787,0
0,1565,68266,3578766787,3578766787,0
0,1565,68267,3578766787,3578766787,0
0,1565,68268,3578766787,3578766787,0
0,1565,68269,3578766787,3578766787,0
0,1565,68270,3578766787,3578766787,0
0,1565,68271,3578766787,3578766787,0
0,1565,68272,3578766787,3578766787,0
0,1565,68273,3578766787,3578766787,0
0,1565,68274,3578766787,3578766787,0
0,1565,68275,3578766787,3578766787,0
0,1565,68276,3578766787,3578766787,0
0,1565,68277,3578766787,3578766787,0
0,1565,68278,3578766787,3578766787,0
0,1565,68279,3578766787,3578766787,0
0,1565,68280,3578766787,3578766787,0
0,1565,68281,3578766787,3578766787,0
0,1565,68282,3578766787,3578766787,0
0,1565,68283,3578766787,3578766787,0
0,1565,68284,3578766787,3578766787,0
0,1565,68285,3578766787,3578766787,0
0,1565,68286,3578766787,3578766788,1
0,1565,68287,3578766787,3578766788,1
0,1565,68288,3578766787,3578766789,2
0,1565,68289,3578766787,3578766789,2
0,1565,68290,3578766787,3578766789,2
0,1565,68291,3578766787,3578766790,3
0,1565,68292,3578766787,3578766791,4
0,1565,68293,3578766787,3578766792,5
0,1565,68294,3578766787,3578766793,6
0,1565,68295,3578766787,3578766793,6
0,1565,68296,3578766787,3578766795,8
0,1565,68297,3578766787,3578766797,10
0,1565,68298,3578766787,3578766797,10
0,1565,68299,3578766787,3578766798,11
0,1565,68300,3578766787,3578766799,12
0,1565,68301,3578766787,3578766799,12
0,1565,68302,3578766787,3578766799,12
0,1565,68303,3578766787,3578766801,14
0,1565,68304,3578766787,3578766802,15
0,1565,68305,3578766787,3578766803,16
0,1565,68306,3578766787,3578766803,16
0,1565,68307,3578766787,3578766804,17
0,1565,68308,3578766787,3578766804,17
0,1565,68309,3578766787,3578766804,17
0,1565,68310,3578766787,3578766805,18
0,1565,68311,3578766787,3578766806,19
0,1565,68312,3578766787,3578766807,20
0,1565,68313,3578766787,3578766807,20
0,1565,68314,3578766787,3578766808,21
0,1565,68315,3578766787,3578766808,21
0,1565,68316,3578766787,3578766810,23
0,1565,68317,3578766787,3578766811,24
0,1565,68318,3578766787,3578766812,25
0,1565,68319,3578766787,3578766813,26
0,1565,68320,3578766787,3578766813,26
0,1565,68321,3578766787,3578766814,27
0,1565,68322,3578766787,3578766815,28
0,1565,68323,3578766787,3578766815,28
0,1565,68324,3578766787,3578766815,28
0,1565,68325,3578766787,3578766815,28
0,1565,68326,3578766787,3578766815,28
0,1565,68327,3578766787,3578766816,29
0,1565,68328,3578766787,3578766816,29
0,1565,68329,3578766787,3578766817,30
0,1565,68330,3578766787,3578766818,31
0,1565,68331,3578766787,3578766818,31
0,1565,68332,3578766787,3578766818,31
0,1565,68333,3578766787,3578766819,32
0,1565,68334,3578766787,3578766819,32
0,1565,68335,3578766787,3578766819,32
0,1565,68336,3578766787,3578766820,33
0,1565,68337,3578766787,3578766821,34
0,1565,68338,3578766787,3578766821,34
0,1565,68339,3578766787,3578766821,34
0,1565,68340,3578766787,3578766821,34
0,1565,68341,3578766787,3578766823,36
0,1565,68342,3578766787,3578766824,37
0,1565,68343,3578766787,3578766824,37
0,1565,68344,3578766787,3578766824,37
0,1565,68345,3578766787,3578766826,39
0,1565,68346,3578766787,3578766826,39
0,1565,68347,3578766787,3578766827,40
0,1565,68348,3578766787,3578766828,41
0,1565,68349,3578766787,3578766829,42
0,1565,68350,3578766787,3578766829,42
0,1565,68351,3578766787,3578766830,43
0,1565,68352,3578766787,3578766831,44
0,1565,68353,3578766787,3578766831,44
0,1565,68354,3578766787,3578766832,45
0,1565,68355,3578766787,3578766832,45
0,1565,68356,3578766787,3578766832,45
0,1565,68357,3578766787,3578766834,47
0,1565,68358,3578766787,3578766836,49
0,1565,68359,3578766787,3578766836,49
0,1566,68360,3578766852,3578766852,0
0,1566,68361,3578766852,3578766852,0
0,1566,68362,3578766852,3578766852,0
0,1566,68363,3578766852,3578766852,0
0,1566,68364,3578766852,3578766852,0
0,1566,68365,3578766852,3578766852,0
0,1566,68366,3578766852,3578766852,0
0,1566,68367,3578766852,3578766852,0
0,1566,68368,3578766852,3578766852,0
0,1566,68369,3578766852,3578766852,0
0,1566,68370,3578766852,3578766852,0
0,1566,68371,3578766852,3578766852,0
0,1566,68372,3578766852,3578766852,0
0,1566,68373,3578766852,3578766852,0
0,1566,68374,3578766852,3578766852,0
0,1566,68375,3578766852,3578766852,0
0,1566,68376,3578766852,3578766852,0
0,1566,68377,3578766852,3578766852,0
0,1566,68378,3578766852,3578766852,0
0,1566,68379,3578766852,3578766852,0
0,1566,68380,3578766852,3578766852,0
0,1566,68381,3578766852,3578766852,0
0,1566,68382,3578766852,3578766852,0
0,1566,68383,3578766852,3578766852,0
0,1566,68384,3578766852,3578766852,0
0,1566,68385,3578766852,3578766852,0
0,1566,68386,3578766852,3578766852,0
0,1566,68387,3578766852,3578766852,0
0,1566,68388,3578766852,3578766852,0
0,1566,68389,3578766852,3578766852,0
0,1566,68390,3578766852,3578766855,3
0,1566,68391,3578766852,3578766856,4
0,1566,68392,3578766852,3578766856,4
0,1566,68393,3578766852,3578766857,5
0,1566,68394,3578766852,3578766859,7
0,1566,68395,3578766852,3578766859,7
0,1566,68396,3578766852,3578766859,7
0,1566,68397,3578766852,3578766861,9
0,1566,68398,3578766852,3578766861,9
0,1566,68399,3578766852,3578766862,10
0,1566,68400,3578766852,3578766862,10
0,1566,68401,3578766852,3578766863,11
0,1566,68402,3578766852,3578766864,12
0,1566,68403,3578766852,3578766864,12
0,1566,68404,3578766852,3578766865,13
0,1566,68405,3578766852,3578766866,14
0,1566,68406,3578766852,3578766866,14
0,1566,68407,3578766852,3578766866,14
0,1566,68408,3578766852,3578766866,14
0,1566,68409,3578766852,3578766868,16
0,1566,68410,3578766852,3578766868,16
0,1566,68411,3578766852,3578766873,21
0,1566,68412,3578766852,3578766874,22
0,1566,68413,3578766852,3578766883,31
0,1566,68414,3578766852,3578766886,34
0,1566,68415,3578766852,3578766888,36
0,1566,68416,3578766852,3578766888,36
0,1566,68417,3578766852,3578766889,37
0,1566,68418,3578766852,3578766889,37
0,1566,68419,3578766852,3578766890,38
0,1566,68420,3578766852,3578766891,39
0,1566,68421,3578766852,3578766891,39
0,1566,68422,3578766852,3578766892,40
0,1566,68423,3578766852,3578766892,40
0,1566,68424,3578766852,3578766893,41
0,1566,68425,3578766852,3578766893,41
0,1566,68426,3578766852,3578766893,41
0,1566,68427,3578766852,3578766894,42
0,1566,68428,3578766852,3578766894,42
0,1566,68429,3578766852,3578766895,43
0,1566,68430,3578766852,3578766896,44
0,1566,68431,3578766852,3578766897,45
0,1566,68432,3578766852,3578766897,45
0,1566,68433,3578766852,3578766897,45
0,1566,68434,3578766852,3578766897,45
0,1566,68435,3578766852,3578766898,46
0,1566,68436,3578766852,3578766898,46
0,1566,68437,3578766852,3578766899,47
0,1566,68438,3578766852,3578766899,47
0,1566,68439,3578766852,3578766900,48
0,1566,68440,3578766852,3578766901,49
0,1567,68441,3578766916,3578766916,0
0,1567,68442,3578766916,3578766916,0
0,1567,68443,3578766916,3578766916,0
0,1567,68444,3578766916,3578766916,0
0,1567,68445,3578766916,3578766916,0
0,1567,68446,3578766916,3578766916,0
0,1567,68447,3578766916,3578766916,0
0,1567,68448,3578766916,3578766916,0
0,1567,68449,3578766916,3578766916,0
0,1567,68450,3578766916,3578766916,0
0,1567,68451,3578766916,3578766916,0
0,1567,68452,3578766916,3578766916,0
0,1567,68453,3578766916,3578766916,0
0,1567,68454,3578766916,3578766916,0
0,1567,68455,3578766916,3578766916,0
0,1567,68456,3578766916,3578766916,0
0,1567,68457,3578766916,3578766916,0
0,1567,68458,3578766916,3578766916,0
0,1567,68459,3578766916,3578766916,0
0,1567,68460,3578766916,3578766916,0
0,1567,68461,3578766916,3578766916,0
0,1567,68462,3578766916,3578766916,0
0,1567,68463,3578766916,3578766916,0
0,1567,68464,3578766916,3578766916,0
0,1567,68465,3578766916,3578766916,0
0,1567,68466,3578766916,3578766916,0
0,1567,68467,3578766916,3578766916,0
0,1567,68468,3578766916,3578766916,0
0,1567,68469,3578766916,3578766916,0
0,1567,68470,3578766916,3578766916,0
0,1567,68471,3578766916,3578766916,0
0,1567,68472,3578766916,3578766916,0
0,1567,68473,3578766916,3578766916,0
0,1567,68474,3578766916,3578766916,0
0,1567,68475,3578766916,3578766916,0
0,1567,68476,3578766916,3578766916,0
0,1567,68477,3578766916,3578766916,0
0,1567,68478,3578766916,3578766917,1
0,1567,68479,3578766916,3578766918,2
0,1567,68480,3578766916,3578766918,2
0,1567,68481,3578766916,3578766919,3
0,1567,68482,3578766916,3578766920,4
0,1567,68483,3578766916,3578766921,5
0,1567,68484,3578766916,3578766921,5
0,1567,68485,3578766916,3578766921,5
0,1567,68486,3578766916,3578766923,7
0,1567,68487,3578766916,3578766923,7
0,1567,68488,3578766916,3578766923,7
0,1567,68489,3578766916,3578766923,7
0,1567,68490,3578766916,3578766924,8
0,1567,68491,3578766916,3578766925,9
0,1567,68492,3578766916,3578766926,10
0,1567,68493,3578766916,3578766926,10
0,1567,68494,3578766916,3578766927,11
0,1567,68495,3578766916,3578766927,11
0,1567,68496,3578766916,3578766927,11
0,1567,68497,3578766916,3578766928,12
0,1567,68498,3578766916,3578766928,12
0,1567,68499,3578766916,3578766928,12
0,1567,68500,3578766916,3578766928,12
0,1567,68501,3578766916,3578766928,12
0,1567,68502,3578766916,3578766928,12
0,1567,68503,3578766916,3578766929,13
0,1567,68504,3578766916,3578766929,13
0,1567,68505,3578766916,3578766929,13
0,1567,68506,3578766916,3578766930,14
0,1567,68507,3578766916,3578766930,14
0,1567,68508,3578766916,3578766931,15
0,1567,68509,3578766916,3578766931,15
0,1567,68510,3578766916,3578766931,15
0,1567,68511,3578766916,3578766931,15
0,1567,68512,3578766916,3578766932,16
0,1567,68513,3578766916,3578766932,16
0,1567,68514,3578766916,3578766933,17
0,1567,68515,3578766916,3578766933,17
0,1567,68516,3578766916,3578766933,17
0,1567,68517,3578766916,3578766934,18
0,1567,68518,3578766916,3578766935,19
0,1567,68519,3578766916,3578766935,19
0,1567,68520,3578766916,3578766935,19
0,1567,68521,3578766916,3578766937,21
0,1567,68522,3578766916,3578766937,21
0,1567,68523,3578766916,3578766939,23
0,1567,68524,3578766916,3578766939,23
0,1567,68525,3578766916,3578766940,24
0,1567,68526,3578766916,3578766940,24
0,1567,68527,3578766916,3578766940,24
0,1567,68528,3578766916,3578766942,26
0,1567,68529,3578766916,3578766943,27
0,1567,68530,3578766916,3578766944,28
0,1567,68531,3578766916,3578766944,28
0,1567,68532,3578766916,3578766944,28
0,1567,68533,3578766916,3578766944,28
0,1567,68534,3578766916,3578766946,30
0,1567,68535,3578766916,3578766946,30
0,1567,68536,3578766916,3578766947,31
0,1567,68537,3578766916,3578766947,31
0,1567,68538,3578766916,3578766947,31
0,1567,68539,3578766916,3578766947,31
0,1567,68540,3578766916,3578766947,31
0,1567,68541,3578766916,3578766948,32
0,1567,68542,3578766916,3578766948,32
0,1567,68543,3578766916,3578766949,33
0,1567,68544,3578766916,3578766949,33
0,1567,68545,3578766916,3578766950,34
0,1567,68546,3578766916,3578766951,35
0,1567,68547,3578766916,3578766952,36
0,1567,68548,3578766916,3578766952,36
0,1567,68549,3578766916,3578766952,36
0,1567,68550,3578766916,3578766953,37
0,1567,68551,3578766916,3578766953,37
0,1567,68552,3578766916,3578766955,39
0,1567,68553,3578766916,3578766956,40
0,1567,68554,3578766916,3578766957,41
0,1567,68555,3578766916,3578766958,42
0,1567,68556,3578766916,3578766958,42
0,1567,68557,3578766916,3578766959,43
0,1567,68558,3578766916,3578766959,43
0,1567,68559,3578766916,3578766960,44
0,1567,68560,3578766916,3578766961,45
0,1567,68561,3578766916,3578766961,45
0,1567,68562,3578766916,3578766961,45
0,1567,68563,3578766916,3578766961,45
0,1567,68564,3578766916,3578766962,46
0,1567,68565,3578766916,3578766962,46
0,1567,68566,3578766916,3578766962,46
0,1567,68567,3578766916,3578766962,46
0,1567,68568,3578766916,3578766963,47
0,1567,68569,3578766916,3578766964,48
0,1567,68570,3578766916,3578766965,49
0,1567,68571,3578766916,3578766965,49
0,1568,68572,3578766981,3578766981,0
0,1568,68573,3578766981,3578766981,0
0,1568,68574,3578766981,3578766981,0
0,1568,68575,3578766981,3578766981,0
0,1568,68576,3578766981,3578766981,0
0,1568,68577,3578766981,3578766981,0
0,1568,68578,3578766981,3578766981,0
0,1568,68579,3578766981,3578766981,0
0,1568,68580,3578766981,3578766981,0
0,1568,68581,3578766981,3578766981,0
0,1568,68582,3578766981,3578766981,0
0,1568,68583,3578766981,3578766981,0
0,1568,68584,3578766981,3578766981,0
0,1568,68585,3578766981,3578766981,0
0,1568,68586,3578766981,3578766981,0
0,1568,68587,3578766981,3578766981,0
0,1568,68588,3578766981,3578766981,0
0,1568,68589,3578766981,3578766981,0
0,1568,68590,3578766981,3578766981,0
0,1568,68591,3578766981,3578766981,0
0,1568,68592,3578766981,3578766981,0
0,1568,68593,3578766981,3578766981,0
0,1568,68594,3578766981,3578766981,0
0,1568,68595,3578766981,3578766981,0
0,1568,68596,3578766981,3578766981,0
0,1568,68597,3578766981,3578766983,2
0,1568,68598,3578766981,3578766984,3
0,1568,68599,3578766981,3578766985,4
0,1568,68600,3578766981,3578766986,5
0,1568,68601,3578766981,3578766987,6
0,1568,68602,3578766981,3578766987,6
0,1568,68603,3578766981,3578766987,6
0,1568,68604,3578766981,3578766988,7
0,1568,68605,3578766981,3578766989,8
0,1568,68606,3578766981,3578766989,8
0,1568,68607,3578766981,3578766989,8
0,1568,68608,3578766981,3578766990,9
0,1568,68609,3578766981,3578766991,10
0,1568,68610,3578766981,3578766992,11
0,1568,68611,3578766981,3578766993,12
0,1568,68612,3578766981,3578766994,13
0,1568,68613,3578766981,3578766995,14
0,1568,68614,3578766981,3578766995,14
0,1568,68615,3578766981,3578766997,16
0,1568,68616,3578766981,3578766997,16
0,1568,68617,3578766981,3578766997,16
0,1568,68618,3578766981,3578766998,17
0,1568,68619,3578766981,3578766998,17
0,1568,68620,3578766981,3578766999,18
0,1568,68621,3578766981,3578767002,21
0,1568,68622,3578766981,3578767002,21
0,1568,68623,3578766981,3578767003,22
0,1568,68624,3578766981,3578767004,23
0,1568,68625,3578766981,3578767005,24
0,1568,68626,3578766981,3578767005,24
0,1568,68627,3578766981,3578767005,24
0,1568,68628,3578766981,3578767006,25
0,1568,68629,3578766981,3578767007,26
0,1568,68630,3578766981,3578767007,26
0,1568,68631,3578766981,3578767009,28
0,1568,68632,3578766981,3578767010,29
0,1568,68633,3578766981,3578767010,29
0,1568,68634,3578766981,3578767012,31
0,1568,68635,3578766981,3578767012,31
0,1568,68636,3578766981,3578767013,32
0,1568,68637,3578766981,3578767014,33
0,1568,68638,3578766981,3578767014,33
0,1568,68639,3578766981,3578767015,34
0,1568,68640,3578766981,3578767015,34
0,1568,68641,3578766981,3578767015,34
0,1568,68642,3578766981,3578767016,35
0,1568,68643,3578766981,3578767016,35
0,1568,68644,3578766981,3578767016,35
0,1568,68645,3578766981,3578767016,35
0,1568,68646,3578766981,3578767018,37
0,1568,68647,3578766981,3578767018,37
0,1568,68648,3578766981,3578767018,37
0,1568,68649,3578766981,3578767019,38
0,1568,68650,3578766981,3578767020,39
0,1568,68651,3578766981,3578767020,39
0,1568,68652,3578766981,3578767021,40
0,1568,68653,3578766981,3578767021,40
0,1568,68654,3578766981,3578767022,41
0,1568,68655,3578766981,3578767023,42
0,1568,68656,3578766981,3578767024,43
0,1568,68657,3578766981,3578767026,45
0,1568,68658,3578766981,3578767026,45
0,1568,68659,3578766981,3578767027,46
0,1568,68660,3578766981,3578767028,47
0,1568,68661,3578766981,3578767029,48
0,1568,68662,3578766981,3578767029,48
0,1568,68663,3578766981,3578767030,49
0,1568,68664,3578766981,3578767030,49
0,1568,68665,3578766981,3578767031,50
0,1569,68666,3578767045,3578767045,0
0,1569,68667,3578767045,3578767045,0
0,1569,68668,3578767045,3578767045,0
0,1569,68669,3578767045,3578767045,0
0,1569,68670,3578767045,3578767045,0
0,1569,68671,3578767045,3578767045,0
0,1569,68672,3578767045,3578767045,0
0,1569,68673,3578767045,3578767045,0
0,1569,68674,3578767045,3578767045,0
0,1569,68675,3578767045,3578767045,0
0,1569,68676,3578767045,3578767045,0
0,1569,68677,3578767045,3578767045,0
0,1569,68678,3578767045,3578767045,0
0,1569,68679,3578767045,3578767045,0
0,1569,68680,3578767045,3578767045,0
0,1569,68681,3578767045,3578767045,0
0,1569,68682,3578767045,3578767045,0
0,1569,68683,3578767045,3578767045,0
0,1569,68684,3578767045,3578767045,0
0,1569,68685,3578767045,3578767045,0
0,1569,68686,3578767045,3578767045,0
0,1569,68687,3578767045,3578767045,0
0,1569,68688,3578767045,3578767045,0
0,1569,68689,3578767045,3578767045,0
0,1569,68690,3578767045,3578767045,0
0,1569,68691,3578767045,3578767047,2
0,1569,68692,3578767045,3578767048,3
0,1569,68693,3578767045,3578767048,3
0,1569,68694,3578767045,3578767048,3
0,1569,68695,3578767045,3578767049,4
0,1569,68696,3578767045,3578767049,4
0,1569,68697,3578767045,3578767049,4
0,1569,68698,3578767045,3578767049,4
0,1569,68699,3578767045,3578767050,5
0,1569,68700,3578767045,3578767051,6
0,1569,68701,3578767045,3578767051,6
0,1569,68702,3578767045,3578767051,6
0,1569,68703,3578767045,3578767053,8
0,1569,68704,3578767045,3578767053,8
0,1569,68705,3578767045,3578767055,10
0,1569,68706,3578767045,3578767056,11
0,1569,68707,3578767045,3578767056,11
0,1569,68708,3578767045,3578767057,12
0,1569,68709,3578767045,3578767058,13
0,1569,68710,3578767045,3578767059,14
0,1569,68711,3578767045,3578767061,16
0,1569,68712,3578767045,3578767061,16
0,1569,68713,3578767045,3578767062,17
0,1569,68714,3578767045,3578767063,18
0,1569,68715,3578767045,3578767063,18
0,1569,68716,3578767045,3578767064,19
0,1569,68717,3578767045,3578767064,19
0,1569,68718,3578767045,3578767064,19
0,1569,68719,3578767045,3578767065,20
0,1569,68720,3578767045,3578767065,20
0,1569,68721,3578767045,3578767066,21
0,1569,68722,3578767045,3578767066,21
0,1569,68723,3578767045,3578767066,21
0,1569,68724,3578767045,3578767067,22
0,1569,68725,3578767045,3578767068,23
0,1569,68726,3578767045,3578767073,28
0,1569,68727,3578767045,3578767086,41
0,1569,68728,3578767045,3578767088,43
0,1569,68729,3578767045,3578767088,43
0,1569,68730,3578767045,3578767089,44
0,1569,68731,3578767045,3578767090,45
0,1569,68732,3578767045,3578767090,45
0,1569,68733,3578767045,3578767091,46
0,1569,68734,3578767045,3578767091,46
0,1569,68735,3578767045,3578767092,47
0,1569,68736,3578767045,3578767092,47
0,1569,68737,3578767045,3578767093,48
0,1569,68738,3578767045,3578767093,48
0,1569,68739,3578767045,3578767093,48
0,1569,68740,3578767045,3578767093,48
0,1569,68741,3578767045,3578767093,48
0,1569,68742,3578767045,3578767094,49
0,1569,68743,3578767045,3578767094,49
0,1569,68744,3578767045,3578767094,49
0,1570,68745,3578767109,3578767109,0
0,1570,68746,3578767109,3578767109,0
0,1570,68747,3578767109,3578767109,0
0,1570,68748,3578767109,3578767109,0
0,1570,68749,3578767109,3578767109,0
0,1570,68750,3578767109,3578767109,0
0,1570,68751,3578767109,3578767109,0
0,1570,68752,3578767109,3578767109,0
0,1570,68753,3578767109,3578767109,0
0,1570,68754,3578767109,3578767109,0
0,1570,68755,3578767109,3578767109,0
0,1570,68756,3578767109,3578767109,0
0,1570,68757,3578767109,3578767109,0
0,1570,68758,3578767109,3578767109,0
0,1570,68759,3578767109,3578767109,0
0,1570,68760,3578767109,3578767109,0
0,1570,68761,3578767109,3578767109,0
0,1570,68762,3578767109,3578767109,0
0,1570,68763,3578767109,3578767109,0
0,1570,68764,3578767109,3578767109,0
0,1570,68765,3578767109,3578767109,0
0,1570,68766,3578767109,3578767109,0
0,1570,68767,3578767109,3578767109,0
0,1570,68768,3578767109,3578767109,0
0,1570,68769,3578767109,3578767109,0
0,1570,68770,3578767109,3578767109,0
0,1570,68771,3578767109,3578767109,0
0,1570,68772,3578767109,3578767110,1
0,1570,68773,3578767109,3578767110,1
0,1570,68774,3578767109,3578767110,1
0,1570,68775,3578767109,3578767110,1
0,1570,68776,3578767109,3578767111,2
0,1570,68777,3578767109,3578767112,3
0,1570,68778,3578767109,3578767113,4
0,1570,68779,3578767109,3578767115,6
0,1570,68780,3578767109,3578767115,6
0,1570,68781,3578767109,3578767115,6
0,1570,68782,3578767109,3578767116,7
0,1570,68783,3578767109,3578767116,7
0,1570,68784,3578767109,3578767116,7
0,1570,68785,3578767109,3578767116,7
0,1570,68786,3578767109,3578767116,7
0,1570,68787,3578767109,3578767116,7
0,1570,68788,3578767109,3578767117,8
0,1570,68789,3578767109,3578767117,8
0,1570,68790,3578767109,3578767117,8
0,1570,68791,3578767109,3578767117,8
0,1570,68792,3578767109,3578767118,9
0,1570,68793,3578767109,3578767118,9
0,1570,68794,3578767109,3578767119,10
0,1570,68795,3578767109,3578767119,10
0,1570,68796,3578767109,3578767119,10
0,1570,68797,3578767109,3578767120,11
0,1570,68798,3578767109,3578767120,11
0,1570,68799,3578767109,3578767121,12
0,1570,68800,3578767109,3578767121,12
0,1570,68801,3578767109,3578767123,14
0,1570,68802,3578767109,3578767123,14
0,1570,68803,3578767109,3578767123,14
0,1570,68804,3578767109,3578767123,14
0,1570,68805,3578767109,3578767124,15
0,1570,68806,3578767109,3578767124,15
0,1570,68807,3578767109,3578767125,16
0,1570,68808,3578767109,3578767125,16
0,1570,68809,3578767109,3578767125,16
0,1570,68810,3578767109,3578767126,17
0,1570,68811,3578767109,3578767127,18
0,1570,68812,3578767109,3578767127,18
0,1570,68813,3578767109,3578767128,19
0,1570,68814,3578767109,3578767128,19
0,1570,68815,3578767109,3578767128,19
0,1570,68816,3578767109,3578767129,20
0,1570,68817,3578767109,3578767129,20
0,1570,68818,3578767109,3578767129,20
0,1570,68819,3578767109,3578767129,20
0,1570,68820,3578767109,3578767131,22
0,1570,68821,3578767109,3578767131,22
0,1570,68822,3578767109,3578767131,22
0,1570,68823,3578767109,3578767131,22
0,1570,68824,3578767109,3578767131,22
0,1570,68825,3578767109,3578767131,22
0,1570,68826,3578767109,3578767132,23
0,1570,68827,3578767109,3578767132,23
0,1570,68828,3578767109,3578767132,23
0,1570,68829,3578767109,3578767133,24
0,1570,68830,3578767109,3578767134,25
0,1570,68831,3578767109,3578767134,25
0,1570,68832,3578767109,3578767135,26
0,1570,68833,3578767109,3578767135,26
0,1570,68834,3578767109,3578767135,26
0,1570,68835,3578767109,3578767136,27
0,1570,68836,3578767109,3578767136,27
0,1570,68837,3578767109,3578767137,28
0,1570,68838,3578767109,3578767139,30
0,1570,68839,3578767109,3578767139,30
0,1570,68840,3578767109,3578767140,31
0,1570,68841,3578767109,3578767141,32
0,1570,68842,3578767109,3578767141,32
0,1570,68843,3578767109,3578767141,32
0,1570,68844,3578767109,3578767142,33
0,1570,68845,3578767109,3578767143,34
0,1570,68846,3578767109,3578767143,34
0,1570,68847,3578767109,3578767143,34
0,1570,68848,3578767109,3578767144,35
0,1570,68849,3578767109,3578767144,35
0,1570,68850,3578767109,3578767144,35
0,1570,68851,3578767109,3578767144,35
0,1570,68852,3578767109,3578767146,37
0,1570,68853,3578767109,3578767146,37
0,1570,68854,3578767109,3578767146,37
0,1570,68855,3578767109,3578767147,38
0,1570,68856,3578767109,3578767148,39
0,1570,68857,3578767109,3578767148,39
0,1570,68858,3578767109,3578767150,41
0,1570,68859,3578767109,3578767151,42
0,1570,68860,3578767109,3578767151,42
0,1570,68861,3578767109,3578767152,43
0,1570,68862,3578767109,3578767153,44
0,1570,68863,3578767109,3578767153,44
0,1570,68864,3578767109,3578767153,44
0,1570,68865,3578767109,3578767154,45
0,1570,68866,3578767109,3578767154,45
0,1570,68867,3578767109,3578767155,46
0,1570,68868,3578767109,3578767156,47
0,1570,68869,3578767109,3578767156,47
0,1570,68870,3578767109,3578767158,49
0,1570,68871,3578767109,3578767158,49
0,1570,68872,3578767109,3578767159,50
0,1571,68873,3578767173,3578767173,0
0,1571,68874,3578767173,3578767173,0
0,1571,68875,3578767173,3578767173,0
0,1571,68876,3578767173,3578767173,0
0,1571,68877,3578767173,3578767173,0
0,1571,68878,3578767173,3578767173,0
0,1571,68879,3578767173,3578767173,0
0,1571,68880,3578767173,3578767173,0
0,1571,68881,3578767173,3578767173,0
0,1571,68882,3578767173,3578767173,0
0,1571,68883,3578767173,3578767173,0
0,1571,68884,3578767173,3578767173,0
0,1571,68885,3578767173,3578767173,0
0,1571,68886,3578767173,3578767173,0
0,1571,68887,3578767173,3578767173,0
0,1571,68888,3578767173,3578767173,0
0,1571,68889,3578767173,3578767173,0
0,1571,68890,3578767173,3578767173,0
0,1571,68891,3578767173,3578767173,0
0,1571,68892,3578767173,3578767173,0
0,1571,68893,3578767173,3578767173,0
0,1571,68894,3578767173,3578767173,0
0,1571,68895,3578767173,3578767173,0
0,1571,68896,3578767173,3578767173,0
0,1571,68897,3578767173,3578767173,0
0,1571,68898,3578767173,3578767173,0
0,1571,68899,3578767173,3578767173,0
0,1571,68900,3578767173,3578767174,1
0,1571,68901,3578767173,3578767174,1
0,1571,68902,3578767173,3578767174,1
0,1571,68903,3578767173,3578767177,4
0,1571,68904,3578767173,3578767178,5
0,1571,68905,3578767173,3578767179,6
0,1571,68906,3578767173,3578767179,6
0,1571,68907,3578767173,3578767179,6
0,1571,68908,3578767173,3578767179,6
0,1571,68909,3578767173,3578767179,6
0,1571,68910,3578767173,3578767181,8
0,1571,68911,3578767173,3578767182,9
0,1571,68912,3578767173,3578767184,11
0,1571,68913,3578767173,3578767185,12
0,1571,68914,3578767173,3578767186,13
0,1571,68915,3578767173,3578767186,13
0,1571,68916,3578767173,3578767187,14
0,1571,68917,3578767173,3578767188,15
0,1571,68918,3578767173,3578767188,15
0,1571,68919,3578767173,3578767188,15
0,1571,68920,3578767173,3578767189,16
0,1571,68921,3578767173,3578767189,16
0,1571,68922,3578767173,3578767189,16
0,1571,68923,3578767173,3578767190,17
0,1571,68924,3578767173,3578767191,18
0,1571,68925,3578767173,3578767191,18
0,1571,68926,3578767173,3578767193,20
0,1571,68927,3578767173,3578767194,21
0,1571,68928,3578767173,3578767195,22
0,1571,68929,3578767173,3578767197,24
0,1571,68930,3578767173,3578767197,24
0,1571,68931,3578767173,3578767197,24
0,1571,68932,3578767173,3578767198,25
0,1571,68933,3578767173,3578767199,26
0,1571,68934,3578767173,3578767199,26
0,1571,68935,3578767173,3578767199,26
0,1571,68936,3578767173,3578767202,29
0,1571,68937,3578767173,3578767202,29
0,1571,68938,3578767173,3578767203,30
0,1571,68939,3578767173,3578767204,31
0,1571,68940,3578767173,3578767204,31
0,1571,68941,3578767173,3578767205,32
0,1571,68942,3578767173,3578767205,32
0,1571,68943,3578767173,3578767205,32
0,1571,68944,3578767173,3578767206,33
0,1571,68945,3578767173,3578767206,33
0,1571,68946,3578767173,3578767207,34
0,1571,68947,3578767173,3578767207,34
0,1571,68948,3578767173,3578767209,36
0,1571,68949,3578767173,3578767210,37
0,1571,68950,3578767173,3578767210,37
0,1571,68951,3578767173,3578767212,39
0,1571,68952,3578767173,3578767213,40
0,1571,68953,3578767173,3578767214,41
0,1571,68954,3578767173,3578767214,41
0,1571,68955,3578767173,3578767214,41
0,1571,68956,3578767173,3578767215,42
0,1571,68957,3578767173,3578767216,43
0,1571,68958,3578767173,3578767216,43
0,1571,68959,3578767173,3578767216,43
0,1571,68960,3578767173,3578767216,43
0,1571,68961,3578767173,3578767218,45
0,1571,68962,3578767173,3578767218,45
0,1571,68963,3578767173,3578767218,45
0,1571,68964,3578767173,3578767219,46
0,1571,68965,3578767173,3578767219,46
0,1571,68966,3578767173,3578767219,46
0,1571,68967,3578767173,3578767219,46
0,1571,68968,3578767173,3578767220,47
0,1571,68969,3578767173,3578767221,48
0,1571,68970,3578767173,3578767221,48
0,1571,68971,3578767173,3578767222,49
0,1572,68972,3578767239,3578767239,0
0,1572,68973,3578767239,3578767239,0
0,1572,68974,3578767239,3578767239,0
0,1572,68975,3578767239,3578767239,0
0,1572,68976,3578767239,3578767239,0
0,1572,68977,3578767239,3578767239,0
0,1572,68978,3578767239,3578767239,0
0,1572,68979,3578767239,3578767239,0
0,1572,68980,3578767239,3578767239,0
0,1572,68981,3578767239,3578767239,0
0,1572,68982,3578767239,3578767239,0
0,1572,68983,3578767239,3578767239,0
0,1572,68984,3578767239,3578767239,0
0,1572,68985,3578767239,3578767239,0
0,1572,68986,3578767239,3578767239,0
0,1572,68987,3578767239,3578767239,0
0,1572,68988,3578767239,3578767239,0
0,1572,68989,3578767239,3578767239,0
0,1572,68990,3578767239,3578767239,0
0,1572,68991,3578767239,3578767239,0
0,1572,68992,3578767239,3578767240,1
0,1572,68993,3578767239,3578767240,1
0,1572,68994,3578767239,3578767240,1
0,1572,68995,3578767239,3578767241,2
0,1572,68996,3578767239,3578767241,2
0,1572,68997,3578767239,3578767242,3
0,1572,68998,3578767239,3578767242,3
0,1572,68999,3578767239,3578767243,4
0,1572,69000,3578767239,3578767244,5
0,1572,69001,3578767239,3578767244,5
0,1572,69002,3578767239,3578767245,6
0,1572,69003,3578767239,3578767247,8
0,1572,69004,3578767239,3578767248,9
0,1572,69005,3578767239,3578767249,10
0,1572,69006,3578767239,3578767249,10
0,1572,69007,3578767239,3578767249,10
0,1572,69008,3578767239,3578767249,10
0,1572,69009,3578767239,3578767249,10
0,1572,69010,3578767239,3578767252,13
0,1572,69011,3578767239,3578767253,14
0,1572,69012,3578767239,3578767254,15
0,1572,69013,3578767239,3578767255,16
0,1572,69014,3578767239,3578767256,17
0,1572,69015,3578767239,3578767256,17
0,1572,69016,3578767239,3578767256,17
0,1572,69017,3578767239,3578767257,18
0,1572,69018,3578767239,3578767257,18
0,1572,69019,3578767239,3578767258,19
0,1572,69020,3578767239,3578767259,20
0,1572,69021,3578767239,3578767259,20
0,1572,69022,3578767239,3578767261,22
0,1572,69023,3578767239,3578767261,22
0,1572,69024,3578767239,3578767262,23
0,1572,69025,3578767239,3578767262,23
0,1572,69026,3578767239,3578767264,25
0,1572,69027,3578767239,3578767265,26
0,1572,69028,3578767239,3578767265,26
0,1572,69029,3578767239,3578767265,26
0,1572,69030,3578767239,3578767265,26
0,1572,69031,3578767239,3578767266,27
0,1572,69032,3578767239,3578767267,28
0,1572,69033,3578767239,3578767267,28
0,1572,69034,3578767239,3578767268,29
0,1572,69035,3578767239,3578767273,34
0,1572,69036,3578767239,3578767274,35
0,1572,69037,3578767239,3578767283,44
0,1572,69038,3578767239,3578767286,47
0,1572,69039,3578767239,3578767287,48
0,1572,69040,3578767239,3578767288,49
0,1572,69041,3578767239,3578767288,49
0,1573,69042,3578767304,3578767304,0
0,1573,69043,3578767304,3578767304,0
0,1573,69044,3578767304,3578767304,0
0,1573,69045,3578767304,3578767304,0
0,1573,69046,3578767304,3578767304,0
0,1573,69047,3578767304,3578767304,0
0,1573,69048,3578767304,3578767304,0
0,1573,69049,3578767304,3578767304,0
0,1573,69050,3578767304,3578767304,0
0,1573,69051,3578767304,3578767304,0
0,1573,69052,3578767304,3578767304,0
0,1573,69053,3578767304,3578767304,0
0,1573,69054,3578767304,3578767304,0
0,1573,69055,3578767304,3578767304,0
0,1573,69056,3578767304,3578767304,0
0,1573,69057,3578767304,3578767304,0
0,1573,69058,3578767304,3578767304,0
0,1573,69059,3578767304,3578767304,0
0,1573,69060,3578767304,3578767304,0
0,1573,69061,3578767304,3578767304,0
0,1573,69062,3578767304,3578767304,0
0,1573,69063,3578767304,3578767304,0
0,1573,69064,3578767304,3578767304,0
0,1573,69065,3578767304,3578767304,0
0,1573,69066,3578767304,3578767304,0
0,1573,69067,3578767304,3578767304,0
0,1573,69068,3578767304,3578767305,1
0,1573,69069,3578767304,3578767306,2
0,1573,69070,3578767304,3578767306,2
0,1573,69071,3578767304,3578767307,3
0,1573,69072,3578767304,3578767307,3
0,1573,69073,3578767304,3578767308,4
0,1573,69074,3578767304,3578767308,4
0,1573,69075,3578767304,3578767308,4
0,1573,69076,3578767304,3578767309,5
0,1573,69077,3578767304,3578767309,5
0,1573,69078,3578767304,3578767309,5
0,1573,69079,3578767304,3578767309,5
0,1573,69080,3578767304,3578767310,6
0,1573,69081,3578767304,3578767310,6
0,1573,69082,3578767304,3578767310,6
0,1573,69083,3578767304,3578767311,7
0,1573,69084,3578767304,3578767311,7
0,1573,69085,3578767304,3578767312,8
0,1573,69086,3578767304,3578767313,9
0,1573,69087,3578767304,3578767314,10
0,1573,69088,3578767304,3578767315,11
0,1573,69089,3578767304,3578767315,11
0,1573,69090,3578767304,3578767315,11
0,1573,69091,3578767304,3578767316,12
0,1573,69092,3578767304,3578767316,12
0,1573,69093,3578767304,3578767316,12
0,1573,69094,3578767304,3578767316,12
0,1573,69095,3578767304,3578767317,13
0,1573,69096,3578767304,3578767317,13
0,1573,69097,3578767304,3578767317,13
0,1573,69098,3578767304,3578767318,14
0,1573,69099,3578767304,3578767319,15
0,1573,69100,3578767304,3578767319,15
0,1573,69101,3578767304,3578767320,16
0,1573,69102,3578767304,3578767320,16
0,1573,69103,3578767304,3578767321,17
0,1573,69104,3578767304,3578767321,17
0,1573,69105,3578767304,3578767323,19
0,1573,69106,3578767304,3578767323,19
0,1573,69107,3578767304,3578767323,19
0,1573,69108,3578767304,3578767324,20
0,1573,69109,3578767304,3578767324,20
0,1573,69110,3578767304,3578767325,21
0,1573,69111,3578767304,3578767326,22
0,1573,69112,3578767304,3578767327,23
0,1573,69113,3578767304,3578767327,23
0,1573,69114,3578767304,3578767328,24
0,1573,69115,3578767304,3578767328,24
0,1573,69116,3578767304,3578767328,24
0,1573,69117,3578767304,3578767329,25
0,1573,69118,3578767304,3578767329,25
0,1573,69119,3578767304,3578767329,25
0,1573,69120,3578767304,3578767329,25
0,1573,69121,3578767304,3578767330,26
0,1573,69122,3578767304,3578767330,26
0,1573,69123,3578767304,3578767331,27
0,1573,69124,3578767304,3578767331,27
0,1573,69125,3578767304,3578767331,27
0,1573,69126,3578767304,3578767332,28
0,1573,69127,3578767304,3578767332,28
0,1573,69128,3578767304,3578767332,28
0,1573,69129,3578767304,3578767332,28
0,1573,69130,3578767304,3578767333,29
0,1573,69131,3578767304,3578767333,29
0,1573,69132,3578767304,3578767334,30
0,1573,69133,3578767304,3578767334,30
0,1573,69134,3578767304,3578767335,31
0,1573,69135,3578767304,3578767335,31
0,1573,69136,3578767304,3578767336,32
0,1573,69137,3578767304,3578767337,33
0,1573,69138,3578767304,3578767337,33
0,1573,69139,3578767304,3578767340,36
0,1573,69140,3578767304,3578767340,36
0,1573,69141,3578767304,3578767340,36
0,1573,69142,3578767304,3578767340,36
0,1573,69143,3578767304,3578767341,37
0,1573,69144,3578767304,3578767341,37
0,1573,69145,3578767304,3578767342,38
0,1573,69146,3578767304,3578767343,39
0,1573,69147,3578767304,3578767343,39
0,1573,69148,3578767304,3578767343,39
0,1573,69149,3578767304,3578767343,39
0,1573,69150,3578767304,3578767344,40
0,1573,69151,3578767304,3578767345,41
0,1573,69152,3578767304,3578767345,41
0,1573,69153,3578767304,3578767346,42
0,1573,69154,3578767304,3578767346,42
0,1573,69155,3578767304,3578767347,43
0,1573,69156,3578767304,3578767347,43
0,1573,69157,3578767304,3578767348,44
0,1573,69158,3578767304,3578767348,44
0,1573,69159,3578767304,3578767349,45
0,1573,69160,3578767304,3578767349,45
0,1573,69161,3578767304,3578767350,46
0,1573,69162,3578767304,3578767351,47
0,1573,69163,3578767304,3578767352,48
0,1573,69164,3578767304,3578767352,48
0,1573,69165,3578767304,3578767352,48
0,1573,69166,3578767304,3578767353,49
0,1573,69167,3578767304,3578767353,49
0,1574,69168,3578767368,3578767369,1
0,1574,69169,3578767368,3578767369,1
0,1574,69170,3578767368,3578767369,1
0,1574,69171,3578767368,3578767369,1
0,1574,69172,3578767368,3578767369,1
0,1574,69173,3578767368,3578767369,1
0,1574,69174,3578767368,3578767369,1
0,1574,69175,3578767368,3578767369,1
0,1574,69176,3578767368,3578767369,1
0,1574,69177,3578767368,3578767369,1
0,1574,69178,3578767368,3578767369,1
0,1574,69179,3578767368,3578767369,1
0,1574,69180,3578767368,3578767369,1
0,1574,69181,3578767368,3578767369,1
0,1574,69182,3578767368,3578767369,1
0,1574,69183,3578767368,3578767369,1
0,1574,69184,3578767368,3578767369,1
0,1574,69185,3578767368,3578767369,1
0,1574,69186,3578767368,3578767369,1
0,1574,69187,3578767368,3578767369,1
0,1574,69188,3578767368,3578767369,1
0,1574,69189,3578767368,3578767369,1
0,1574,69190,3578767368,3578767369,1
0,1574,69191,3578767368,3578767369,1
0,1574,69192,3578767368,3578767370,2
0,1574,69193,3578767368,3578767371,3
0,1574,69194,3578767368,3578767371,3
0,1574,69195,3578767368,3578767372,4
0,1574,69196,3578767368,3578767373,5
0,1574,69197,3578767368,3578767374,6
0,1574,69198,3578767368,3578767374,6
0,1574,69199,3578767368,3578767374,6
0,1574,69200,3578767368,3578767377,9
0,1574,69201,3578767368,3578767377,9
0,1574,69202,3578767368,3578767378,10
0,1574,69203,3578767368,3578767378,10
0,1574,69204,3578767368,3578767378,10
0,1574,69205,3578767368,3578767379,11
0,1574,69206,3578767368,3578767379,11
0,1574,69207,3578767368,3578767379,11
0,1574,69208,3578767368,3578767379,11
0,1574,69209,3578767368,3578767382,14
0,1574,69210,3578767368,3578767382,14
0,1574,69211,3578767368,3578767383,15
0,1574,69212,3578767368,3578767385,17
0,1574,69213,3578767368,3578767386,18
0,1574,69214,3578767368,3578767387,19
0,1574,69215,3578767368,3578767388,20
0,1574,69216,3578767368,3578767388,20
0,1574,69217,3578767368,3578767389,21
0,1574,69218,3578767368,3578767389,21
0,1574,69219,3578767368,3578767389,21
0,1574,69220,3578767368,3578767390,22
0,1574,69221,3578767368,3578767390,22
0,1574,69222,3578767368,3578767391,23
0,1574,69223,3578767368,3578767391,23
0,1574,69224,3578767368,3578767392,24
0,1574,69225,3578767368,3578767393,25
0,1574,69226,3578767368,3578767393,25
0,1574,69227,3578767368,3578767394,26
0,1574,69228,3578767368,3578767395,27
0,1574,69229,3578767368,3578767397,29
0,1574,69230,3578767368,3578767397,29
0,1574,69231,3578767368,3578767398,30
0,1574,69232,3578767368,3578767399,31
0,1574,69233,3578767368,3578767399,31
0,1574,69234,3578767368,3578767402,34
0,1574,69235,3578767368,3578767403,35
0,1574,69236,3578767368,3578767403,35
0,1574,69237,3578767368,3578767404,36
0,1574,69238,3578767368,3578767404,36
0,1574,69239,3578767368,3578767404,36
0,1574,69240,3578767368,3578767405,37
0,1574,69241,3578767368,3578767405,37
0,1574,69242,3578767368,3578767406,38
0,1574,69243,3578767368,3578767406,38
0,1574,69244,3578767368,3578767407,39
0,1574,69245,3578767368,3578767408,40
0,1574,69246,3578767368,3578767409,41
0,1574,69247,3578767368,3578767410,42
0,1574,69248,3578767368,3578767411,43
0,1574,69249,3578767368,3578767412,44
0,1574,69250,3578767368,3578767412,44
0,1574,69251,3578767368,3578767412,44
0,1574,69252,3578767368,3578767414,46
0,1574,69253,3578767368,3578767414,46
0,1574,69254,3578767368,3578767415,47
0,1574,69255,3578767368,3578767415,47
0,1574,69256,3578767368,3578767415,47
0,1574,69257,3578767368,3578767415,47
0,1574,69258,3578767368,3578767416,48
0,1574,69259,3578767368,3578767416,48
0,1574,69260,3578767368,3578767417,49
0,1575,69261,3578767435,3578767435,0
0,1575,69262,3578767435,3578767435,0
0,1575,69263,3578767435,3578767435,0
0,1575,69264,3578767435,3578767435,0
0,1575,69265,3578767435,3578767435,0
0,1575,69266,3578767435,3578767435,0
0,1575,69267,3578767435,3578767435,0
0,1575,69268,3578767435,3578767435,0
0,1575,69269,3578767435,3578767435,0
0,1575,69270,3578767435,3578767435,0
0,1575,69271,3578767435,3578767435,0
0,1575,69272,3578767435,3578767435,0
0,1575,69273,3578767435,3578767435,0
0,1575,69274,3578767435,3578767435,0
0,1575,69275,3578767435,3578767435,0
0,1575,69276,3578767435,3578767435,0
0,1575,69277,3578767435,3578767435,0
0,1575,69278,3578767435,3578767435,0
0,1575,69279,3578767435,3578767435,0
0,1575,69280,3578767435,3578767435,0
0,1575,69281,3578767435,3578767435,0
0,1575,69282,3578767435,3578767435,0
0,1575,69283,3578767435,3578767435,0
0,1575,69284,3578767435,3578767435,0
0,1575,69285,3578767435,3578767435,0
0,1575,69286,3578767435,3578767435,0
0,1575,69287,3578767435,3578767435,0
0,1575,69288,3578767435,3578767436,1
0,1575,69289,3578767435,3578767437,2
0,1575,69290,3578767435,3578767439,4
0,1575,69291,3578767435,3578767439,4
0,1575,69292,3578767435,3578767440,5
0,1575,69293,3578767435,3578767440,5
0,1575,69294,3578767435,3578767440,5
0,1575,69295,3578767435,3578767440,5
0,1575,69296,3578767435,3578767442,7
0,1575,69297,3578767435,3578767442,7
0,1575,69298,3578767435,3578767443,8
0,1575,69299,3578767435,3578767443,8
0,1575,69300,3578767435,3578767443,8
0,1575,69301,3578767435,3578767443,8
0,1575,69302,3578767435,3578767444,9
0,1575,69303,3578767435,3578767444,9
0,1575,69304,3578767435,3578767445,10
0,1575,69305,3578767435,3578767446,11
0,1575,69306,3578767435,3578767447,12
0,1575,69307,3578767435,3578767448,13
0,1575,69308,3578767435,3578767449,14
0,1575,69309,3578767435,3578767449,14
0,1575,69310,3578767435,3578767450,15
0,1575,69311,3578767435,3578767450,15
0,1575,69312,3578767435,3578767450,15
0,1575,69313,3578767435,3578767450,15
0,1575,69314,3578767435,3578767452,17
0,1575,69315,3578767435,3578767452,17
0,1575,69316,3578767435,3578767454,19
0,1575,69317,3578767435,3578767455,20
0,1575,69318,3578767435,3578767456,21
0,1575,69319,3578767435,3578767457,22
0,1575,69320,3578767435,3578767458,23
0,1575,69321,3578767435,3578767458,23
0,1575,69322,3578767435,3578767458,23
0,1575,69323,3578767435,3578767459,24
0,1575,69324,3578767435,3578767459,24
0,1575,69325,3578767435,3578767462,27
0,1575,69326,3578767435,3578767463,28
0,1575,69327,3578767435,3578767464,29
0,1575,69328,3578767435,3578767464,29
0,1575,69329,3578767435,3578767464,29
0,1575,69330,3578767435,3578767465,30
0,1575,69331,3578767435,3578767465,30
0,1575,69332,3578767435,3578767467,32
0,1575,69333,3578767435,3578767467,32
0,1575,69334,3578767435,3578767467,32
0,1575,69335,3578767435,3578767468,33
0,1575,69336,3578767435,3578767468,33
0,1575,69337,3578767435,3578767473,38
0,1575,69338,3578767435,3578767474,39
0,1576,69339,3578767499,3578767499,0
0,1576,69340,3578767499,3578767499,0
0,1576,69341,3578767499,3578767499,0
0,1576,69342,3578767499,3578767499,0
0,1576,69343,3578767499,3578767499,0
0,1576,69344,3578767499,3578767499,0
0,1576,69345,3578767499,3578767499,0
0,1576,69346,3578767499,3578767499,0
0,1576,69347,3578767499,3578767499,0
0,1576,69348,3578767499,3578767499,0
0,1576,69349,3578767499,3578767499,0
0,1576,69350,3578767499,3578767499,0
0,1576,69351,3578767499,3578767499,0
0,1576,69352,3578767499,3578767499,0
0,1576,69353,3578767499,3578767499,0
0,1576,69354,3578767499,3578767499,0
0,1576,69355,3578767499,3578767499,0
0,1576,69356,3578767499,3578767499,0
0,1576,69357,3578767499,3578767499,0
0,1576,69358,3578767499,3578767499,0
0,1576,69359,3578767499,3578767499,0
0,1576,69360,3578767499,3578767499,0
0,1576,69361,3578767499,3578767499,0
0,1576,69362,3578767499,3578767499,0
0,1576,69363,3578767499,3578767499,0
0,1576,69364,3578767499,3578767499,0
0,1576,69365,3578767499,3578767499,0
0,1576,69366,3578767499,3578767500,1
0,1576,69367,3578767499,3578767500,1
0,1576,69368,3578767499,3578767501,2
0,1576,69369,3578767499,3578767503,4
0,1576,69370,3578767499,3578767504,5
0,1576,69371,3578767499,3578767504,5
0,1576,69372,3578767499,3578767504,5
0,1576,69373,3578767499,3578767506,7
0,1576,69374,3578767499,3578767506,7
0,1576,69375,3578767499,3578767506,7
0,1576,69376,3578767499,3578767507,8
0,1576,69377,3578767499,3578767507,8
0,1576,69378,3578767499,3578767507,8
0,1576,69379,3578767499,3578767508,9
0,1576,69380,3578767499,3578767508,9
0,1576,69381,3578767499,3578767508,9
0,1576,69382,3578767499,3578767508,9
0,1576,69383,3578767499,3578767508,9
0,1576,69384,3578767499,3578767509,10
0,1576,69385,3578767499,3578767509,10
0,1576,69386,3578767499,3578767510,11
0,1576,69387,3578767499,3578767510,11
0,1576,69388,3578767499,3578767510,11
0,1576,69389,3578767499,3578767510,11
0,1576,69390,3578767499,3578767511,12
0,1576,69391,3578767499,3578767512,13
0,1576,69392,3578767499,3578767512,13
0,1576,69393,3578767499,3578767513,14
0,1576,69394,3578767499,3578767514,15
0,1576,69395,3578767499,3578767514,15
0,1576,69396,3578767499,3578767514,15
0,1576,69397,3578767499,3578767514,15
0,1576,69398,3578767499,3578767515,16
0,1576,69399,3578767499,3578767515,16
0,1576,69400,3578767499,3578767515,16
0,1576,69401,3578767499,3578767515,16
0,1576,69402,3578767499,3578767516,17
0,1576,69403,3578767499,3578767516,17
0,1576,69404,3578767499,3578767516,17
0,1576,69405,3578767499,3578767516,17
0,1576,69406,3578767499,3578767517,18
0,1576,69407,3578767499,3578767517,18
0,1576,69408,3578767499,3578767518,19
0,1576,69409,3578767499,3578767518,19
0,1576,69410,3578767499,3578767519,20
0,1576,69411,3578767499,3578767520,21
0,1576,69412,3578767499,3578767520,21
0,1576,69413,3578767499,3578767520,21
0,1576,69414,3578767499,3578767522,23
0,1576,69415,3578767499,3578767522,23
0,1576,69416,3578767499,3578767522,23
0,1576,69417,3578767499,3578767523,24
0,1576,69418,3578767499,3578767523,24
0,1576,69419,3578767499,3578767525,26
0,1576,69420,3578767499,3578767526,27
0,1576,69421,3578767499,3578767526,27
0,1576,69422,3578767499,3578767527,28
0,1576,69423,3578767499,3578767527,28
0,1576,69424,3578767499,3578767528,29
0,1576,69425,3578767499,3578767528,29
0,1576,69426,3578767499,3578767528,29
0,1576,69427,3578767499,3578767529,30
0,1576,69428,3578767499,3578767529,30
0,1576,69429,3578767499,3578767530,31
0,1576,69430,3578767499,3578767530,31
0,1576,69431,3578767499,3578767530,31
0,1576,69432,3578767499,3578767530,31
0,1576,69433,3578767499,3578767531,32
0,1576,69434,3578767499,3578767531,32
0,1576,69435,3578767499,3578767532,33
0,1576,69436,3578767499,3578767533,34
0,1576,69437,3578767499,3578767534,35
0,1576,69438,3578767499,3578767534,35
0,1576,69439,3578767499,3578767535,36
0,1576,69440,3578767499,3578767536,37
0,1576,69441,3578767499,3578767539,40
0,1576,69442,3578767499,3578767539,40
0,1576,69443,3578767499,3578767539,40
0,1576,69444,3578767499,3578767540,41
0,1576,69445,3578767499,3578767540,41
0,1576,69446,3578767499,3578767541,42
0,1576,69447,3578767499,3578767541,42
0,1576,69448,3578767499,3578767541,42
0,1576,69449,3578767499,3578767542,43
0,1576,69450,3578767499,3578767542,43
0,1576,69451,3578767499,3578767543,44
0,1576,69452,3578767499,3578767544,45
0,1576,69453,3578767499,3578767544,45
0,1576,69454,3578767499,3578767545,46
0,1576,69455,3578767499,3578767545,46
0,1576,69456,3578767499,3578767546,47
0,1576,69457,3578767499,3578767546,47
0,1576,69458,3578767499,3578767547,48
0,1576,69459,3578767499,3578767548,49
0,1576,69460,3578767499,3578767548,49
0,1576,69461,3578767499,3578767548,49
0,1576,69462,3578767499,3578767549,50
0,1577,69463,3578767564,3578767564,0
0,1577,69464,3578767564,3578767564,0
0,1577,69465,3578767564,3578767564,0
0,1577,69466,3578767564,3578767564,0
0,1577,69467,3578767564,3578767564,0
0,1577,69468,3578767564,3578767564,0
0,1577,69469,3578767564,3578767564,0
0,1577,69470,3578767564,3578767564,0
0,1577,69471,3578767564,3578767564,0
0,1577,69472,3578767564,3578767564,0
0,1577,69473,3578767564,3578767564,0
0,1577,69474,3578767564,3578767564,0
0,1577,69475,3578767564,3578767564,0
0,1577,69476,3578767564,3578767564,0
0,1577,69477,3578767564,3578767564,0
0,1577,69478,3578767564,3578767564,0
0,1577,69479,3578767564,3578767564,0
0,1577,69480,3578767564,3578767564,0
0,1577,69481,3578767564,3578767564,0
0,1577,69482,3578767564,3578767564,0
0,1577,69483,3578767564,3578767564,0
0,1577,69484,3578767564,3578767564,0
0,1577,69485,3578767564,3578767564,0
0,1577,69486,3578767564,3578767564,0
0,1577,69487,3578767564,3578767564,0
0,1577,69488,3578767564,3578767564,0
0,1577,69489,3578767564,3578767564,0
0,1577,69490,3578767564,3578767564,0
0,1577,69491,3578767564,3578767564,0
0,1577,69492,3578767564,3578767564,0
0,1577,69493,3578767564,3578767564,0
0,1577,69494,3578767564,3578767565,1
0,1577,69495,3578767564,3578767565,1
0,1577,69496,3578767564,3578767565,1
0,1577,69497,3578767564,3578767567,3
0,1577,69498,3578767564,3578767567,3
0,1577,69499,3578767564,3578767568,4
0,1577,69500,3578767564,3578767569,5
0,1577,69501,3578767564,3578767570,6
0,1577,69502,3578767564,3578767570,6
0,1577,69503,3578767564,3578767571,7
0,1577,69504,3578767564,3578767571,7
0,1577,69505,3578767564,3578767573,9
0,1577,69506,3578767564,3578767573,9
0,1577,69507,3578767564,3578767573,9
0,1577,69508,3578767564,3578767573,9
0,1577,69509,3578767564,3578767578,14
0,1577,69510,3578767564,3578767578,14
0,1577,69511,3578767564,3578767578,14
0,1577,69512,3578767564,3578767579,15
0,1577,69513,3578767564,3578767581,17
0,1577,69514,3578767564,3578767581,17
0,1577,69515,3578767564,3578767581,17
0,1577,69516,3578767564,3578767582,18
0,1577,69517,3578767564,3578767585,21
0,1577,69518,3578767564,3578767585,21
0,1577,69519,3578767564,3578767585,21
0,1577,69520,3578767564,3578767586,22
0,1577,69521,3578767564,3578767587,23
0,1577,69522,3578767564,3578767587,23
0,1577,69523,3578767564,3578767588,24
0,1577,69524,3578767564,3578767588,24
0,1577,69525,3578767564,3578767589,25
0,1577,69526,3578767564,3578767590,26
0,1577,69527,3578767564,3578767591,27
0,1577,69528,3578767564,3578767591,27
0,1577,69529,3578767564,3578767593,29
0,1577,69530,3578767564,3578767593,29
0,1577,69531,3578767564,3578767593,29
0,1577,69532,3578767564,3578767594,30
0,1577,69533,3578767564,3578767595,31
0,1577,69534,3578767564,3578767596,32
0,1577,69535,3578767564,3578767596,32
0,1577,69536,3578767564,3578767598,34
0,1577,69537,3578767564,3578767599,35
0,1577,69538,3578767564,3578767602,38
0,1577,69539,3578767564,3578767602,38
0,1577,69540,3578767564,3578767603,39
0,1577,69541,3578767564,3578767604,40
0,1577,69542,3578767564,3578767604,40
0,1577,69543,3578767564,3578767605,41
0,1577,69544,3578767564,3578767606,42
0,1577,69545,3578767564,3578767607,43
0,1577,69546,3578767564,3578767607,43
0,1577,69547,3578767564,3578767608,44
0,1577,69548,3578767564,3578767609,45
0,1577,69549,3578767564,3578767609,45
0,1577,69550,3578767564,3578767611,47
0,1577,69551,3578767564,3578767611,47
0,1577,69552,3578767564,3578767612,48
0,1577,69553,3578767564,3578767613,49
0,1577,69554,3578767564,3578767613,49
0,1577,69555,3578767564,3578767614,50
0,1578,69556,3578767629,3578767629,0
0,1578,69557,3578767629,3578767629,0
0,1578,69558,3578767629,3578767629,0
0,1578,69559,3578767629,3578767629,0
0,1578,69560,3578767629,3578767629,0
0,1578,69561,3578767629,3578767629,0
0,1578,69562,3578767629,3578767629,0
0,1578,69563,3578767629,3578767629,0
0,1578,69564,3578767629,3578767629,0
0,1578,69565,3578767629,3578767629,0
0,1578,69566,3578767629,3578767629,0
0,1578,69567,3578767629,3578767629,0
0,1578,69568,3578767629,3578767629,0
0,1578,69569,3578767629,3578767629,0
0,1578,69570,3578767629,3578767629,0
0,1578,69571,3578767629,3578767629,0
0,1578,69572,3578767629,3578767629,0
0,1578,69573,3578767629,3578767629,0
0,1578,69574,3578767629,3578767629,0
0,1578,69575,3578767629,3578767629,0
0,1578,69576,3578767629,3578767629,0
0,1578,69577,3578767629,3578767629,0
0,1578,69578,3578767629,3578767629,0
0,1578,69579,3578767629,3578767629,0
0,1578,69580,3578767629,3578767629,0
0,1578,69581,3578767629,3578767629,0
0,1578,69582,3578767629,3578767630,1
0,1578,69583,3578767629,3578767630,1
0,1578,69584,3578767629,3578767630,1
0,1578,69585,3578767629,3578767631,2
0,1578,69586,3578767629,3578767631,2
0,1578,69587,3578767629,3578767632,3
0,1578,69588,3578767629,3578767633,4
0,1578,69589,3578767629,3578767634,5
0,1578,69590,3578767629,3578767636,7
0,1578,69591,3578767629,3578767638,9
0,1578,69592,3578767629,3578767638,9
0,1578,69593,3578767629,3578767639,10
0,1578,69594,3578767629,3578767639,10
0,1578,69595,3578767629,3578767639,10
0,1578,69596,3578767629,3578767639,10
0,1578,69597,3578767629,3578767640,11
0,1578,69598,3578767629,3578767641,12
0,1578,69599,3578767629,3578767641,12
0,1578,69600,3578767629,3578767642,13
0,1578,69601,3578767629,3578767643,14
0,1578,69602,3578767629,3578767643,14
0,1578,69603,3578767629,3578767643,14
0,1578,69604,3578767629,3578767644,15
0,1578,69605,3578767629,3578767644,15
0,1578,69606,3578767629,3578767645,16
0,1578,69607,3578767629,3578767646,17
0,1578,69608,3578767629,3578767647,18
0,1578,69609,3578767629,3578767647,18
0,1578,69610,3578767629,3578767648,19
0,1578,69611,3578767629,3578767648,19
0,1578,69612,3578767629,3578767648,19
0,1578,69613,3578767629,3578767649,20
0,1578,69614,3578767629,3578767649,20
0,1578,69615,3578767629,3578767650,21
0,1578,69616,3578767629,3578767651,22
0,1578,69617,3578767629,3578767653,24
0,1578,69618,3578767629,3578767653,24
0,1578,69619,3578767629,3578767655,26
0,1578,69620,3578767629,3578767656,27
0,1578,69621,3578767629,3578767656,27
0,1578,69622,3578767629,3578767657,28
0,1578,69623,3578767629,3578767657,28
0,1578,69624,3578767629,3578767657,28
0,1578,69625,3578767629,3578767658,29
0,1578,69626,3578767629,3578767659,30
0,1578,69627,3578767629,3578767661,32
0,1578,69628,3578767629,3578767661,32
0,1578,69629,3578767629,3578767662,33
0,1578,69630,3578767629,3578767664,35
0,1578,69631,3578767629,3578767664,35
0,1578,69632,3578767629,3578767664,35
0,1578,69633,3578767629,3578767664,35
0,1578,69634,3578767629,3578767665,36
0,1578,69635,3578767629,3578767666,37
0,1578,69636,3578767629,3578767666,37
0,1578,69637,3578767629,3578767666,37
0,1578,69638,3578767629,3578767667,38
0,1578,69639,3578767629,3578767668,39
0,1578,69640,3578767629,3578767673,44
0,1579,69641,3578767695,3578767695,0
0,1579,69642,3578767695,3578767695,0
0,1579,69643,3578767695,3578767695,0
0,1579,69644,3578767695,3578767695,0
0,1579,69645,3578767695,3578767695,0
0,1579,69646,3578767695,3578767695,0
0,1579,69647,3578767695,3578767695,0
0,1579,69648,3578767695,3578767695,0
0,1579,69649,3578767695,3578767695,0
0,1579,69650,3578767695,3578767695,0
0,1579,69651,3578767695,3578767695,0
0,1579,69652,3578767695,3578767695,0
0,1579,69653,3578767695,3578767695,0
0,1579,69654,3578767695,3578767695,0
0,1579,69655,3578767695,3578767695,0
0,1579,69656,3578767695,3578767695,0
0,1579,69657,3578767695,3578767695,0
0,1579,69658,3578767695,3578767695,0
0,1579,69659,3578767695,3578767695,0
0,1579,69660,3578767695,3578767695,0
0,1579,69661,3578767695,3578767696,1
0,1579,69662,3578767695,3578767696,1
0,1579,69663,3578767695,3578767697,2
0,1579,69664,3578767695,3578767697,2
0,1579,69665,3578767695,3578767697,2
0,1579,69666,3578767695,3578767697,2
0,1579,69667,3578767695,3578767697,2
0,1579,69668,3578767695,3578767698,3
0,1579,69669,3578767695,3578767698,3
0,1579,69670,3578767695,3578767698,3
0,1579,69671,3578767695,3578767702,7
0,1579,69672,3578767695,3578767702,7
0,1579,69673,3578767695,3578767703,8
0,1579,69674,3578767695,3578767703,8
0,1579,69675,3578767695,3578767704,9
0,1579,69676,3578767695,3578767704,9
0,1579,69677,3578767695,3578767706,11
0,1579,69678,3578767695,3578767706,11
0,1579,69679,3578767695,3578767707,12
0,1579,69680,3578767695,3578767708,13
0,1579,69681,3578767695,3578767708,13
0,1579,69682,3578767695,3578767708,13
0,1579,69683,3578767695,3578767708,13
0,1579,69684,3578767695,3578767708,13
0,1579,69685,3578767695,3578767708,13
0,1579,69686,3578767695,3578767708,13
0,1579,69687,3578767695,3578767709,14
0,1579,69688,3578767695,3578767709,14
0,1579,69689,3578767695,3578767709,14
0,1579,69690,3578767695,3578767710,15
0,1579,69691,3578767695,3578767710,15
0,1579,69692,3578767695,3578767710,15
0,1579,69693,3578767695,3578767711,16
0,1579,69694,3578767695,3578767711,16
0,1579,69695,3578767695,3578767713,18
0,1579,69696,3578767695,3578767713,18
0,1579,69697,3578767695,3578767714,19
0,1579,69698,3578767695,3578767714,19
0,1579,69699,3578767695,3578767714,19
0,1579,69700,3578767695,3578767715,20
0,1579,69701,3578767695,3578767715,20
0,1579,69702,3578767695,3578767715,20
0,1579,69703,3578767695,3578767716,21
0,1579,69704,3578767695,3578767716,21
0,1579,69705,3578767695,3578767716,21
0,1579,69706,3578767695,3578767716,21
0,1579,69707,3578767695,3578767718,23
0,1579,69708,3578767695,3578767718,23
0,1579,69709,3578767695,3578767718,23
0,1579,69710,3578767695,3578767720,25
0,1579,69711,3578767695,3578767720,25
0,1579,69712,3578767695,3578767720,25
0,1579,69713,3578767695,3578767720,25
0,1579,69714,3578767695,3578767720,25
0,1579,69715,3578767695,3578767722,27
0,1579,69716,3578767695,3578767722,27
0,1579,69717,3578767695,3578767722,27
0,1579,69718,3578767695,3578767723,28
0,1579,69719,3578767695,3578767723,28
0,1579,69720,3578767695,3578767727,32
0,1579,69721,3578767695,3578767727,32
0,1579,69722,3578767695,3578767728,33
0,1579,69723,3578767695,3578767728,33
0,1579,69724,3578767695,3578767728,33
0,1579,69725,3578767695,3578767728,33
0,1579,69726,3578767695,3578767728,33
0,1579,69727,3578767695,3578767728,33
0,1579,69728,3578767695,3578767729,34
0,1579,69729,3578767695,3578767729,34
0,1579,69730,3578767695,3578767730,35
0,1579,69731,3578767695,3578767730,35
0,1579,69732,3578767695,3578767730,35
0,1579,69733,3578767695,3578767731,36
0,1579,69734,3578767695,3578767731,36
0,1579,69735,3578767695,3578767731,36
0,1579,69736,3578767695,3578767732,37
0,1579,69737,3578767695,3578767732,37
0,1579,69738,3578767695,3578767733,38
0,1579,69739,3578767695,3578767734,39
0,1579,69740,3578767695,3578767735,40
0,1579,69741,3578767695,3578767736,41
0,1579,69742,3578767695,3578767736,41
0,1579,69743,3578767695,3578767736,41
0,1579,69744,3578767695,3578767737,42
0,1579,69745,3578767695,3578767739,44
0,1579,69746,3578767695,3578767739,44
0,1579,69747,3578767695,3578767739,44
0,1579,69748,3578767695,3578767739,44
0,1579,69749,3578767695,3578767740,45
0,1579,69750,3578767695,3578767740,45
0,1579,69751,3578767695,3578767741,46
0,1579,69752,3578767695,3578767741,46
0,1579,69753,3578767695,3578767742,47
0,1579,69754,3578767695,3578767742,47
0,1579,69755,3578767695,3578767743,48
0,1579,69756,3578767695,3578767744,49
0,1579,69757,3578767695,3578767745,50
0,1580,69758,3578767762,3578767762,0
0,1580,69759,3578767762,3578767762,0
0,1580,69760,3578767762,3578767762,0
0,1580,69761,3578767762,3578767762,0
0,1580,69762,3578767762,3578767762,0
0,1580,69763,3578767762,3578767762,0
0,1580,69764,3578767762,3578767762,0
0,1580,69765,3578767762,3578767762,0
0,1580,69766,3578767762,3578767762,0
0,1580,69767,3578767762,3578767762,0
0,1580,69768,3578767762,3578767762,0
0,1580,69769,3578767762,3578767762,0
0,1580,69770,3578767762,3578767762,0
0,1580,69771,3578767762,3578767762,0
0,1580,69772,3578767762,3578767762,0
0,1580,69773,3578767762,3578767762,0
0,1580,69774,3578767762,3578767762,0
0,1580,69775,3578767762,3578767762,0
0,1580,69776,3578767762,3578767762,0
0,1580,69777,3578767762,3578767762,0
0,1580,69778,3578767762,3578767762,0
0,1580,69779,3578767762,3578767762,0
0,1580,69780,3578767762,3578767762,0
0,1580,69781,3578767762,3578767762,0
0,1580,69782,3578767762,3578767762,0
0,1580,69783,3578767762,3578767762,0
0,1580,69784,3578767762,3578767762,0
0,1580,69785,3578767762,3578767762,0
0,1580,69786,3578767762,3578767762,0
0,1580,69787,3578767762,3578767762,0
0,1580,69788,3578767762,3578767762,0
0,1580,69789,3578767762,3578767762,0
0,1580,69790,3578767762,3578767762,0
0,1580,69791,3578767762,3578767762,0
0,1580,69792,3578767762,3578767762,0
0,1580,69793,3578767762,3578767762,0
0,1580,69794,3578767762,3578767762,0
0,1580,69795,3578767762,3578767763,1
0,1580,69796,3578767762,3578767764,2
0,1580,69797,3578767762,3578767764,2
0,1580,69798,3578767762,3578767764,2
0,1580,69799,3578767762,3578767766,4
0,1580,69800,3578767762,3578767767,5
0,1580,69801,3578767762,3578767768,6
0,1580,69802,3578767762,3578767770,8
0,1580,69803,3578767762,3578767770,8
0,1580,69804,3578767762,3578767770,8
0,1580,69805,3578767762,3578767771,9
0,1580,69806,3578767762,3578767773,11
0,1580,69807,3578767762,3578767773,11
0,1580,69808,3578767762,3578767774,12
0,1580,69809,3578767762,3578767774,12
0,1580,69810,3578767762,3578767774,12
0,1580,69811,3578767762,3578767775,13
0,1580,69812,3578767762,3578767777,15
0,1580,69813,3578767762,3578767778,16
0,1580,69814,3578767762,3578767778,16
0,1580,69815,3578767762,3578767778,16
0,1580,69816,3578767762,3578767778,16
0,1580,69817,3578767762,3578767778,16
0,1580,69818,3578767762,3578767778,16
0,1580,69819,3578767762,3578767779,17
0,1580,69820,3578767762,3578767780,18
0,1580,69821,3578767762,3578767781,19
0,1580,69822,3578767762,3578767782,20
0,1580,69823,3578767762,3578767782,20
0,1580,69824,3578767762,3578767783,21
0,1580,69825,3578767762,3578767784,22
0,1580,69826,3578767762,3578767785,23
0,1580,69827,3578767762,3578767785,23
0,1580,69828,3578767762,3578767785,23
0,1580,69829,3578767762,3578767787,25
0,1580,69830,3578767762,3578767788,26
0,1580,69831,3578767762,3578767788,26
0,1580,69832,3578767762,3578767788,26
0,1580,69833,3578767762,3578767788,26
0,1580,69834,3578767762,3578767789,27
0,1580,69835,3578767762,3578767791,29
0,1580,69836,3578767762,3578767792,30
0,1580,69837,3578767762,3578767793,31
0,1580,69838,3578767762,3578767793,31
0,1580,69839,3578767762,3578767793,31
0,1580,69840,3578767762,3578767795,33
0,1580,69841,3578767762,3578767796,34
0,1580,69842,3578767762,3578767797,35
0,1580,69843,3578767762,3578767799,37
0,1580,69844,3578767762,3578767799,37
0,1580,69845,3578767762,3578767799,37
0,1580,69846,3578767762,3578767802,40
0,1580,69847,3578767762,3578767802,40
0,1580,69848,3578767762,3578767803,41
0,1580,69849,3578767762,3578767803,41
0,1580,69850,3578767762,3578767803,41
0,1580,69851,3578767762,3578767804,42
0,1580,69852,3578767762,3578767804,42
0,1580,69853,3578767762,3578767806,44
0,1580,69854,3578767762,3578767806,44
0,1580,69855,3578767762,3578767807,45
0,1580,69856,3578767762,3578767808,46
0,1580,69857,3578767762,3578767809,47
0,1580,69858,3578767762,3578767810,48
0,1581,69859,3578767825,3578767825,0
0,1581,69860,3578767825,3578767826,1
0,1581,69861,3578767825,3578767826,1
0,1581,69862,3578767825,3578767826,1
0,1581,69863,3578767825,3578767826,1
0,1581,69864,3578767825,3578767826,1
0,1581,69865,3578767825,3578767826,1
0,1581,69866,3578767825,3578767826,1
0,1581,69867,3578767825,3578767826,1
0,1581,69868,3578767825,3578767826,1
0,1581,69869,3578767825,3578767826,1
0,1581,69870,3578767825,3578767826,1
0,1581,69871,3578767825,3578767826,1
0,1581,69872,3578767825,3578767826,1
0,1581,69873,3578767825,3578767826,1
0,1581,69874,3578767825,3578767826,1
0,1581,69875,3578767825,3578767826,1
0,1581,69876,3578767825,3578767826,1
0,1581,69877,3578767825,3578767826,1
0,1581,69878,3578767825,3578767826,1
0,1581,69879,3578767825,3578767826,1
0,1581,69880,3578767825,3578767826,1
0,1581,69881,3578767825,3578767826,1
0,1581,69882,3578767825,3578767826,1
0,1581,69883,3578767825,3578767826,1
0,1581,69884,3578767825,3578767826,1
0,1581,69885,3578767825,3578767826,1
0,1581,69886,3578767825,3578767827,2
0,1581,69887,3578767825,3578767828,3
0,1581,69888,3578767825,3578767828,3
0,1581,69889,3578767825,3578767828,3
0,1581,69890,3578767825,3578767830,5
0,1581,69891,3578767825,3578767830,5
0,1581,69892,3578767825,3578767830,5
0,1581,69893,3578767825,3578767832,7
0,1581,69894,3578767825,3578767833,8
0,1581,69895,3578767825,3578767833,8
0,1581,69896,3578767825,3578767835,10
0,1581,69897,3578767825,3578767835,10
0,1581,69898,3578767825,3578767836,11
0,1581,69899,3578767825,3578767836,11
0,1581,69900,3578767825,3578767836,11
0,1581,69901,3578767825,3578767839,14
0,1581,69902,3578767825,3578767839,14
0,1581,69903,3578767825,3578767839,14
0,1581,69904,3578767825,3578767839,14
0,1581,69905,3578767825,3578767840,15
0,1581,69906,3578767825,3578767840,15
0,1581,69907,3578767825,3578767840,15
0,1581,69908,3578767825,3578767840,15
0,1581,69909,3578767825,3578767842,17
0,1581,69910,3578767825,3578767843,18
0,1581,69911,3578767825,3578767844,19
0,1581,69912,3578767825,3578767844,19
0,1581,69913,3578767825,3578767844,19
0,1581,69914,3578767825,3578767847,22
0,1581,69915,3578767825,3578767848,23
0,1581,69916,3578767825,3578767848,23
0,1581,69917,3578767825,3578767849,24
0,1581,69918,3578767825,3578767849,24
0,1581,69919,3578767825,3578767849,24
0,1581,69920,3578767825,3578767849,24
0,1581,69921,3578767825,3578767850,25
0,1581,69922,3578767825,3578767850,25
0,1581,69923,3578767825,3578767851,26
0,1581,69924,3578767825,3578767851,26
0,1581,69925,3578767825,3578767854,29
0,1581,69926,3578767825,3578767855,30
0,1581,69927,3578767825,3578767856,31
0,1581,69928,3578767825,3578767857,32
0,1581,69929,3578767825,3578767858,33
0,1581,69930,3578767825,3578767859,34
0,1581,69931,3578767825,3578767862,37
0,1581,69932,3578767825,3578767862,37
0,1581,69933,3578767825,3578767863,38
0,1581,69934,3578767825,3578767863,38
0,1581,69935,3578767825,3578767864,39
0,1581,69936,3578767825,3578767864,39
0,1581,69937,3578767825,3578767864,39
0,1581,69938,3578767825,3578767865,40
0,1581,69939,3578767825,3578767865,40
0,1581,69940,3578767825,3578767866,41
0,1581,69941,3578767825,3578767866,41
0,1581,69942,3578767825,3578767867,42
0,1581,69943,3578767825,3578767868,43
0,1581,69944,3578767825,3578767872,47
0,1582,69945,3578767892,3578767892,0
0,1582,69946,3578767892,3578767892,0
0,1582,69947,3578767892,3578767892,0
0,1582,69948,3578767892,3578767892,0
0,1582,69949,3578767892,3578767892,0
0,1582,69950,3578767892,3578767892,0
0,1582,69951,3578767892,3578767892,0
0,1582,69952,3578767892,3578767892,0
0,1582,69953,3578767892,3578767892,0
0,1582,69954,3578767892,3578767892,0
0,1582,69955,3578767892,3578767892,0
0,1582,69956,3578767892,3578767892,0
0,1582,69957,3578767892,3578767892,0
0,1582,69958,3578767892,3578767893,1
0,1582,69959,3578767892,3578767893,1
0,1582,69960,3578767892,3578767893,1
0,1582,69961,3578767892,3578767893,1
0,1582,69962,3578767892,3578767894,2
0,1582,69963,3578767892,3578767894,2
0,1582,69964,3578767892,3578767894,2
0,1582,69965,3578767892,3578767895,3
0,1582,69966,3578767892,3578767896,4
0,1582,69967,3578767892,3578767896,4
0,1582,69968,3578767892,3578767896,4
0,1582,69969,3578767892,3578767897,5
0,1582,69970,3578767892,3578767897,5
0,1582,69971,3578767892,3578767898,6
0,1582,69972,3578767892,3578767898,6
0,1582,69973,3578767892,3578767898,6
0,1582,69974,3578767892,3578767899,7
0,1582,69975,3578767892,3578767901,9
0,1582,69976,3578767892,3578767901,9
0,1582,69977,3578767892,3578767902,10
0,1582,69978,3578767892,3578767902,10
0,1582,69979,3578767892,3578767903,11
0,1582,69980,3578767892,3578767903,11
0,1582,69981,3578767892,3578767904,12
0,1582,69982,3578767892,3578767904,12
0,1582,69983,3578767892,3578767904,12
0,1582,69984,3578767892,3578767906,14
0,1582,69985,3578767892,3578767906,14
0,1582,69986,3578767892,3578767907,15
0,1582,69987,3578767892,3578767907,15
0,1582,69988,3578767892,3578767908,16
0,1582,69989,3578767892,3578767908,16
0,1582,69990,3578767892,3578767908,16
0,1582,69991,3578767892,3578767908,16
0,1582,69992,3578767892,3578767908,16
0,1582,69993,3578767892,3578767909,17
0,1582,69994,3578767892,3578767909,17
0,1582,69995,3578767892,3578767909,17
0,1582,69996,3578767892,3578767910,18
0,1582,69997,3578767892,3578767910,18
0,1582,69998,3578767892,3578767910,18
0,1582,69999,3578767892,3578767910,18
0,1582,70000,3578767892,3578767910,18
0,1582,70001,3578767892,3578767911,19
0,1582,70002,3578767892,3578767912,20
0,1582,70003,3578767892,3578767913,21
0,1582,70004,3578767892,3578767915,23
0,1582,70005,3578767892,3578767915,23
0,1582,70006,3578767892,3578767915,23
0,1582,70007,3578767892,3578767915,23
0,1582,70008,3578767892,3578767915,23
0,1582,70009,3578767892,3578767915,23
0,1582,70010,3578767892,3578767916,24
0,1582,70011,3578767892,3578767916,24
0,1582,70012,3578767892,3578767916,24
0,1582,70013,3578767892,3578767916,24
0,1582,70014,3578767892,3578767916,24
0,1582,70015,3578767892,3578767917,25
0,1582,70016,3578767892,3578767917,25
0,1582,70017,3578767892,3578767918,26
0,1582,70018,3578767892,3578767919,27
0,1582,70019,3578767892,3578767919,27
0,1582,70020,3578767892,3578767919,27
0,1582,70021,3578767892,3578767920,28
0,1582,70022,3578767892,3578767920,28
0,1582,70023,3578767892,3578767920,28
0,1582,70024,3578767892,3578767920,28
0,1582,70025,3578767892,3578767920,28
0,1582,70026,3578767892,3578767920,28
0,1582,70027,3578767892,3578767922,30
0,1582,70028,3578767892,3578767922,30
0,1582,70029,3578767892,3578767922,30
0,1582,70030,3578767892,3578767923,31
0,1582,70031,3578767892,3578767923,31
0,1582,70032,3578767892,3578767924,32
0,1582,70033,3578767892,3578767925,33
0,1582,70034,3578767892,3578767925,33
0,1582,70035,3578767892,3578767926,34
0,1582,70036,3578767892,3578767927,35
0,1582,70037,3578767892,3578767928,36
0,1582,70038,3578767892,3578767929,37
0,1582,70039,3578767892,3578767930,38
0,1582,70040,3578767892,3578767930,38
0,1582,70041,3578767892,3578767930,38
0,1582,70042,3578767892,3578767930,38
0,1582,70043,3578767892,3578767930,38
0,1582,70044,3578767892,3578767930,38
0,1582,70045,3578767892,3578767931,39
0,1582,70046,3578767892,3578767931,39
0,1582,70047,3578767892,3578767931,39
0,1582,70048,3578767892,3578767932,40
0,1582,70049,3578767892,3578767932,40
0,1582,70050,3578767892,3578767933,41
0,1582,70051,3578767892,3578767933,41
0,1582,70052,3578767892,3578767934,42
0,1582,70053,3578767892,3578767935,43
0,1582,70054,3578767892,3578767935,43
0,1582,70055,3578767892,3578767936,44
0,1582,70056,3578767892,3578767936,44
0,1582,70057,3578767892,3578767937,45
0,1582,70058,3578767892,3578767938,46
0,1582,70059,3578767892,3578767939,47
0,1582,70060,3578767892,3578767939,47
0,1582,70061,3578767892,3578767939,47
0,1582,70062,3578767892,3578767939,47
0,1582,70063,3578767892,3578767940,48
0,1582,70064,3578767892,3578767941,49
0,1582,70065,3578767892,3578767941,49
0,1582,70066,3578767892,3578767943,51
0,1583,70067,3578767958,3578767958,0
0,1583,70068,3578767958,3578767958,0
0,1583,70069,3578767958,3578767958,0
0,1583,70070,3578767958,3578767958,0
0,1583,70071,3578767958,3578767958,0
0,1583,70072,3578767958,3578767958,0
0,1583,70073,3578767958,3578767958,0
0,1583,70074,3578767958,3578767958,0
0,1583,70075,3578767958,3578767958,0
0,1583,70076,3578767958,3578767958,0
0,1583,70077,3578767958,3578767958,0
0,1583,70078,3578767958,3578767958,0
0,1583,70079,3578767958,3578767958,0
0,1583,70080,3578767958,3578767958,0
0,1583,70081,3578767958,3578767958,0
0,1583,70082,3578767958,3578767958,0
0,1583,70083,3578767958,3578767958,0
0,1583,70084,3578767958,3578767958,0
0,1583,70085,3578767958,3578767958,0
0,1583,70086,3578767958,3578767958,0
0,1583,70087,3578767958,3578767958,0
0,1583,70088,3578767958,3578767958,0
0,1583,70089,3578767958,3578767958,0
0,1583,70090,3578767958,3578767958,0
0,1583,70091,3578767958,3578767958,0
0,1583,70092,3578767958,3578767958,0
0,1583,70093,3578767958,3578767958,0
0,1583,70094,3578767958,3578767958,0
0,1583,70095,3578767958,3578767958,0
0,1583,70096,3578767958,3578767959,1
0,1583,70097,3578767958,3578767959,1
0,1583,70098,3578767958,3578767959,1
0,1583,70099,3578767958,3578767959,1
0,1583,70100,3578767958,3578767960,2
0,1583,70101,3578767958,3578767961,3
0,1583,70102,3578767958,3578767961,3
0,1583,70103,3578767958,3578767961,3
0,1583,70104,3578767958,3578767961,3
0,1583,70105,3578767958,3578767962,4
0,1583,70106,3578767958,3578767962,4
0,1583,70107,3578767958,3578767962,4
0,1583,70108,3578767958,3578767962,4
0,1583,70109,3578767958,3578767963,5
0,1583,70110,3578767958,3578767963,5
0,1583,70111,3578767958,3578767964,6
0,1583,70112,3578767958,3578767964,6
0,1583,70113,3578767958,3578767965,7
0,1583,70114,3578767958,3578767967,9
0,1583,70115,3578767958,3578767969,11
0,1583,70116,3578767958,3578767970,12
0,1583,70117,3578767958,3578767970,12
0,1583,70118,3578767958,3578767970,12
0,1583,70119,3578767958,3578767970,12
0,1583,70120,3578767958,3578767970,12
0,1583,70121,3578767958,3578767972,14
0,1583,70122,3578767958,3578767972,14
0,1583,70123,3578767958,3578767973,15
0,1583,70124,3578767958,3578767974,16
0,1583,70125,3578767958,3578767974,16
0,1583,70126,3578767958,3578767974,16
0,1583,70127,3578767958,3578767977,19
0,1583,70128,3578767958,3578767977,19
0,1583,70129,3578767958,3578767978,20
0,1583,70130,3578767958,3578767978,20
0,1583,70131,3578767958,3578767979,21
0,1583,70132,3578767958,3578767979,21
0,1583,70133,3578767958,3578767979,21
0,1583,70134,3578767958,3578767979,21
0,1583,70135,3578767958,3578767979,21
0,1583,70136,3578767958,3578767981,23
0,1583,70137,3578767958,3578767981,23
0,1583,70138,3578767958,3578767981,23
0,1583,70139,3578767958,3578767982,24
0,1583,70140,3578767958,3578767984,26
0,1583,70141,3578767958,3578767986,28
0,1583,70142,3578767958,3578767986,28
0,1583,70143,3578767958,3578767987,29
0,1583,70144,3578767958,3578767988,30
0,1583,70145,3578767958,3578767988,30
0,1583,70146,3578767958,3578767988,30
0,1583,70147,3578767958,3578767989,31
0,1583,70148,3578767958,3578767990,32
0,1583,70149,3578767958,3578767991,33
0,1583,70150,3578767958,3578767992,34
0,1583,70151,3578767958,3578767993,35
0,1583,70152,3578767958,3578767993,35
0,1583,70153,3578767958,3578767993,35
0,1583,70154,3578767958,3578767995,37
0,1583,70155,3578767958,3578767996,38
0,1583,70156,3578767958,3578767996,38
0,1583,70157,3578767958,3578767996,38
0,1583,70158,3578767958,3578767997,39
0,1583,70159,3578767958,3578767997,39
0,1583,70160,3578767958,3578767999,41
0,1583,70161,3578767958,3578767999,41
0,1583,70162,3578767958,3578767999,41
0,1583,70163,3578767958,3578768002,44
0,1583,70164,3578767958,3578768003,45
0,1583,70165,3578767958,3578768003,45
0,1583,70166,3578767958,3578768003,45
0,1583,70167,3578767958,3578768003,45
0,1583,70168,3578767958,3578768004,46
0,1583,70169,3578767958,3578768005,47
0,1583,70170,3578767958,3578768006,48
0,1583,70171,3578767958,3578768006,48
0,1583,70172,3578767958,3578768006,48
0,1583,70173,3578767958,3578768007,49
0,1584,70174,3578768021,3578768021,0
0,1584,70175,3578768021,3578768021,0
0,1584,70176,3578768021,3578768021,0
0,1584,70177,3578768021,3578768021,0
0,1584,70178,3578768021,3578768021,0
0,1584,70179,3578768021,3578768021,0
0,1584,70180,3578768021,3578768021,0
0,1584,70181,3578768021,3578768021,0
0,1584,70182,3578768021,3578768021,0
0,1584,70183,3578768021,3578768021,0
0,1584,70184,3578768021,3578768021,0
0,1584,70185,3578768021,3578768021,0
0,1584,70186,3578768021,3578768021,0
0,1584,70187,3578768021,3578768021,0
0,1584,70188,3578768021,3578768021,0
0,1584,70189,3578768021,3578768021,0
0,1584,70190,3578768021,3578768021,0
0,1584,70191,3578768021,3578768021,0
0,1584,70192,3578768021,3578768021,0
0,1584,70193,3578768021,3578768021,0
0,1584,70194,3578768021,3578768021,0
0,1584,70195,3578768021,3578768021,0
0,1584,70196,3578768021,3578768021,0
0,1584,70197,3578768021,3578768021,0
0,1584,70198,3578768021,3578768021,0
0,1584,70199,3578768021,3578768022,1
0,1584,70200,3578768021,3578768022,1
0,1584,70201,3578768021,3578768023,2
0,1584,70202,3578768021,3578768024,3
0,1584,70203,3578768021,3578768024,3
0,1584,70204,3578768021,3578768025,4
0,1584,70205,3578768021,3578768026,5
0,1584,70206,3578768021,3578768026,5
0,1584,70207,3578768021,3578768027,6
0,1584,70208,3578768021,3578768028,7
0,1584,70209,3578768021,3578768029,8
0,1584,70210,3578768021,3578768029,8
0,1584,70211,3578768021,3578768030,9
0,1584,70212,3578768021,3578768031,10
0,1584,70213,3578768021,3578768033,12
0,1584,70214,3578768021,3578768033,12
0,1584,70215,3578768021,3578768033,12
0,1584,70216,3578768021,3578768033,12
0,1584,70217,3578768021,3578768035,14
0,1584,70218,3578768021,3578768036,15
0,1584,70219,3578768021,3578768036,15
0,1584,70220,3578768021,3578768037,16
0,1584,70221,3578768021,3578768039,18
0,1584,70222,3578768021,3578768039,18
0,1584,70223,3578768021,3578768039,18
0,1584,70224,3578768021,3578768039,18
0,1584,70225,3578768021,3578768039,18
0,1584,70226,3578768021,3578768040,19
0,1584,70227,3578768021,3578768040,19
0,1584,70228,3578768021,3578768041,20
0,1584,70229,3578768021,3578768041,20
0,1584,70230,3578768021,3578768042,21
0,1584,70231,3578768021,3578768043,22
0,1584,70232,3578768021,3578768043,22
0,1584,70233,3578768021,3578768043,22
0,1584,70234,3578768021,3578768043,22
0,1584,70235,3578768021,3578768044,23
0,1584,70236,3578768021,3578768046,25
0,1584,70237,3578768021,3578768047,26
0,1584,70238,3578768021,3578768048,27
0,1584,70239,3578768021,3578768048,27
0,1584,70240,3578768021,3578768048,27
0,1584,70241,3578768021,3578768049,28
0,1584,70242,3578768021,3578768049,28
0,1584,70243,3578768021,3578768049,28
0,1584,70244,3578768021,3578768049,28
0,1584,70245,3578768021,3578768051,30
0,1584,70246,3578768021,3578768057,36
0,1584,70247,3578768021,3578768058,37
0,1584,70248,3578768021,3578768059,38
0,1584,70249,3578768021,3578768062,41
0,1584,70250,3578768021,3578768062,41
0,1584,70251,3578768021,3578768062,41
0,1584,70252,3578768021,3578768062,41
0,1584,70253,3578768021,3578768063,42
0,1584,70254,3578768021,3578768064,43
0,1584,70255,3578768021,3578768064,43
0,1584,70256,3578768021,3578768064,43
0,1584,70257,3578768021,3578768064,43
0,1584,70258,3578768021,3578768065,44
0,1584,70259,3578768021,3578768065,44
0,1584,70260,3578768021,3578768066,45
0,1584,70261,3578768021,3578768066,45
0,1584,70262,3578768021,3578768067,46
0,1584,70263,3578768021,3578768068,47
0,1585,70264,3578768084,3578768084,0
0,1585,70265,3578768084,3578768087,3
0,1585,70266,3578768084,3578768088,4
0,1585,70267,3578768084,3578768088,4
0,1585,70268,3578768084,3578768089,5
0,1585,70269,3578768084,3578768090,6
0,1585,70270,3578768084,3578768090,6
0,1585,70271,3578768084,3578768090,6
0,1585,70272,3578768084,3578768091,7
0,1585,70273,3578768084,3578768092,8
0,1585,70274,3578768084,3578768093,9
0,1585,70275,3578768084,3578768093,9
0,1585,70276,3578768084,3578768094,10
0,1585,70277,3578768084,3578768094,10
0,1585,70278,3578768084,3578768094,10
0,1585,70279,3578768084,3578768095,11
0,1585,70280,3578768084,3578768096,12
0,1585,70281,3578768084,3578768096,12
0,1585,70282,3578768084,3578768096,12
0,1585,70283,3578768084,3578768097,13
0,1585,70284,3578768084,3578768097,13
0,1585,70285,3578768084,3578768097,13
0,1585,70286,3578768084,3578768098,14
0,1585,70287,3578768084,3578768098,14
0,1585,70288,3578768084,3578768099,15
0,1585,70289,3578768084,3578768099,15
0,1585,70290,3578768084,3578768101,17
0,1585,70291,3578768084,3578768102,18
0,1585,70292,3578768084,3578768102,18
0,1585,70293,3578768084,3578768102,18
0,1585,70294,3578768084,3578768103,19
0,1585,70295,3578768084,3578768103,19
0,1585,70296,3578768084,3578768105,21
0,1585,70297,3578768084,3578768106,22
0,1585,70298,3578768084,3578768106,22
0,1585,70299,3578768084,3578768106,22
0,1585,70300,3578768084,3578768107,23
0,1585,70301,3578768084,3578768108,24
0,1585,70302,3578768084,3578768108,24
0,1585,70303,3578768084,3578768108,24
0,1585,70304,3578768084,3578768108,24
0,1585,70305,3578768084,3578768109,25
0,1585,70306,3578768084,3578768109,25
0,1585,70307,3578768084,3578768109,25
0,1585,70308,3578768084,3578768109,25
0,1585,70309,3578768084,3578768110,26
0,1585,70310,3578768084,3578768110,26
0,1585,70311,3578768084,3578768110,26
0,1585,70312,3578768084,3578768110,26
0,1585,70313,3578768084,3578768110,26
0,1585,70314,3578768084,3578768111,27
0,1585,70315,3578768084,3578768111,27
0,1585,70316,3578768084,3578768113,29
0,1585,70317,3578768084,3578768113,29
0,1585,70318,3578768084,3578768113,29
0,1585,70319,3578768084,3578768114,30
0,1585,70320,3578768084,3578768115,31
0,1585,70321,3578768084,3578768115,31
0,1585,70322,3578768084,3578768115,31
0,1585,70323,3578768084,3578768115,31
0,1585,70324,3578768084,3578768116,32
0,1585,70325,3578768084,3578768116,32
0,1585,70326,3578768084,3578768116,32
0,1585,70327,3578768084,3578768116,32
0,1585,70328,3578768084,3578768116,32
0,1585,70329,3578768084,3578768116,32
0,1585,70330,3578768084,3578768117,33
0,1585,70331,3578768084,3578768118,34
0,1585,70332,3578768084,3578768118,34
0,1585,70333,3578768084,3578768118,34
0,1585,70334,3578768084,3578768119,35
0,1585,70335,3578768084,3578768119,35
0,1585,70336,3578768084,3578768120,36
0,1585,70337,3578768084,3578768120,36
0,1585,70338,3578768084,3578768120,36
0,1585,70339,3578768084,3578768120,36
0,1585,70340,3578768084,3578768121,37
0,1585,70341,3578768084,3578768121,37
0,1585,70342,3578768084,3578768121,37
0,1585,70343,3578768084,3578768122,38
0,1585,70344,3578768084,3578768122,38
0,1585,70345,3578768084,3578768123,39
0,1585,70346,3578768084,3578768123,39
0,1585,70347,3578768084,3578768124,40
0,1585,70348,3578768084,3578768124,40
0,1585,70349,3578768084,3578768124,40
0,1585,70350,3578768084,3578768124,40
0,1585,70351,3578768084,3578768126,42
0,1585,70352,3578768084,3578768126,42
0,1585,70353,3578768084,3578768127,43
0,1585,70354,3578768084,3578768127,43
0,1585,70355,3578768084,3578768128,44
0,1585,70356,3578768084,3578768128,44
0,1585,70357,3578768084,3578768129,45
0,1585,70358,3578768084,3578768129,45
0,1585,70359,3578768084,3578768129,45
0,1585,70360,3578768084,3578768129,45
0,1585,70361,3578768084,3578768129,45
0,1585,70362,3578768084,3578768130,46
0,1585,70363,3578768084,3578768131,47
0,1585,70364,3578768084,3578768131,47
0,1585,70365,3578768084,3578768131,47
0,1585,70366,3578768084,3578768131,47
0,1585,70367,3578768084,3578768131,47
0,1585,70368,3578768084,3578768131,47
0,1585,70369,3578768084,3578768132,48
0,1585,70370,3578768084,3578768132,48
0,1585,70371,3578768084,3578768132,48
0,1585,70372,3578768084,3578768133,49
0,1585,70373,3578768084,3578768133,49
0,1585,70374,3578768084,3578768134,50
0,1586,70375,3578768149,3578768149,0
0,1586,70376,3578768149,3578768149,0
0,1586,70377,3578768149,3578768149,0
0,1586,70378,3578768149,3578768149,0
0,1586,70379,3578768149,3578768149,0
0,1586,70380,3578768149,3578768149,0
0,1586,70381,3578768149,3578768149,0
0,1586,70382,3578768149,3578768149,0
0,1586,70383,3578768149,3578768149,0
0,1586,70384,3578768149,3578768149,0
0,1586,70385,3578768149,3578768149,0
0,1586,70386,3578768149,3578768149,0
0,1586,70387,3578768149,3578768149,0
0,1586,70388,3578768149,3578768149,0
0,1586,70389,3578768149,3578768149,0
0,1586,70390,3578768149,3578768149,0
0,1586,70391,3578768149,3578768149,0
0,1586,70392,3578768149,3578768149,0
0,1586,70393,3578768149,3578768149,0
0,1586,70394,3578768149,3578768149,0
0,1586,70395,3578768149,3578768149,0
0,1586,70396,3578768149,3578768149,0
0,1586,70397,3578768149,3578768149,0
0,1586,70398,3578768149,3578768149,0
0,1586,70399,3578768149,3578768149,0
0,1586,70400,3578768149,3578768149,0
0,1586,70401,3578768149,3578768149,0
0,1586,70402,3578768149,3578768149,0
0,1586,70403,3578768149,3578768151,2
0,1586,70404,3578768149,3578768151,2
0,1586,70405,3578768149,3578768151,2
0,1586,70406,3578768149,3578768152,3
0,1586,70407,3578768149,3578768152,3
0,1586,70408,3578768149,3578768153,4
0,1586,70409,3578768149,3578768153,4
0,1586,70410,3578768149,3578768153,4
0,1586,70411,3578768149,3578768154,5
0,1586,70412,3578768149,3578768154,5
0,1586,70413,3578768149,3578768154,5
0,1586,70414,3578768149,3578768154,5
0,1586,70415,3578768149,3578768156,7
0,1586,70416,3578768149,3578768156,7
0,1586,70417,3578768149,3578768157,8
0,1586,70418,3578768149,3578768158,9
0,1586,70419,3578768149,3578768158,9
0,1586,70420,3578768149,3578768159,10
0,1586,70421,3578768149,3578768159,10
0,1586,70422,3578768149,3578768159,10
0,1586,70423,3578768149,3578768160,11
0,1586,70424,3578768149,3578768160,11
0,1586,70425,3578768149,3578768160,11
0,1586,70426,3578768149,3578768160,11
0,1586,70427,3578768149,3578768161,12
0,1586,70428,3578768149,3578768161,12
0,1586,70429,3578768149,3578768161,12
0,1586,70430,3578768149,3578768162,13
0,1586,70431,3578768149,3578768162,13
0,1586,70432,3578768149,3578768162,13
0,1586,70433,3578768149,3578768163,14
0,1586,70434,3578768149,3578768165,16
0,1586,70435,3578768149,3578768165,16
0,1586,70436,3578768149,3578768166,17
0,1586,70437,3578768149,3578768167,18
0,1586,70438,3578768149,3578768170,21
0,1586,70439,3578768149,3578768170,21
0,1586,70440,3578768149,3578768170,21
0,1586,70441,3578768149,3578768171,22
0,1586,70442,3578768149,3578768172,23
0,1586,70443,3578768149,3578768173,24
0,1586,70444,3578768149,3578768174,25
0,1586,70445,3578768149,3578768174,25
0,1586,70446,3578768149,3578768174,25
0,1586,70447,3578768149,3578768175,26
0,1586,70448,3578768149,3578768176,27
0,1586,70449,3578768149,3578768177,28
0,1586,70450,3578768149,3578768178,29
0,1586,70451,3578768149,3578768178,29
0,1586,70452,3578768149,3578768179,30
0,1586,70453,3578768149,3578768179,30
0,1586,70454,3578768149,3578768179,30
0,1586,70455,3578768149,3578768179,30
0,1586,70456,3578768149,3578768179,30
0,1586,70457,3578768149,3578768179,30
0,1586,70458,3578768149,3578768181,32
0,1586,70459,3578768149,3578768182,33
0,1586,70460,3578768149,3578768184,35
0,1586,70461,3578768149,3578768186,37
0,1586,70462,3578768149,3578768187,38
0,1586,70463,3578768149,3578768188,39
0,1586,70464,3578768149,3578768188,39
0,1586,70465,3578768149,3578768188,39
0,1586,70466,3578768149,3578768188,39
0,1586,70467,3578768149,3578768189,40
0,1586,70468,3578768149,3578768190,41
0,1586,70469,3578768149,3578768190,41
0,1586,70470,3578768149,3578768191,42
0,1586,70471,3578768149,3578768191,42
0,1586,70472,3578768149,3578768192,43
0,1586,70473,3578768149,3578768193,44
0,1586,70474,3578768149,3578768193,44
0,1586,70475,3578768149,3578768195,46
0,1586,70476,3578768149,3578768196,47
0,1586,70477,3578768149,3578768196,47
0,1586,70478,3578768149,3578768197,48
0,1586,70479,3578768149,3578768198,49
0,1586,70480,3578768149,3578768198,49
0,1586,70481,3578768149,3578768199,50
0,1587,70482,3578768215,3578768215,0
0,1587,70483,3578768215,3578768215,0
0,1587,70484,3578768215,3578768215,0
0,1587,70485,3578768215,3578768215,0
0,1587,70486,3578768215,3578768215,0
0,1587,70487,3578768215,3578768215,0
0,1587,70488,3578768215,3578768215,0
0,1587,70489,3578768215,3578768215,0
0,1587,70490,3578768215,3578768215,0
0,1587,70491,3578768215,3578768215,0
0,1587,70492,3578768215,3578768215,0
0,1587,70493,3578768215,3578768215,0
0,1587,70494,3578768215,3578768215,0
0,1587,70495,3578768215,3578768215,0
0,1587,70496,3578768215,3578768215,0
0,1587,70497,3578768215,3578768215,0
0,1587,70498,3578768215,3578768215,0
0,1587,70499,3578768215,3578768215,0
0,1587,70500,3578768215,3578768216,1
0,1587,70501,3578768215,3578768216,1
0,1587,70502,3578768215,3578768217,2
0,1587,70503,3578768215,3578768217,2
0,1587,70504,3578768215,3578768218,3
0,1587,70505,3578768215,3578768218,3
0,1587,70506,3578768215,3578768218,3
0,1587,70507,3578768215,3578768219,4
0,1587,70508,3578768215,3578768219,4
0,1587,70509,3578768215,3578768219,4
0,1587,70510,3578768215,3578768219,4
0,1587,70511,3578768215,3578768220,5
0,1587,70512,3578768215,3578768220,5
0,1587,70513,3578768215,3578768220,5
0,1587,70514,3578768215,3578768221,6
0,1587,70515,3578768215,3578768222,7
0,1587,70516,3578768215,3578768222,7
0,1587,70517,3578768215,3578768223,8
0,1587,70518,3578768215,3578768224,9
0,1587,70519,3578768215,3578768224,9
0,1587,70520,3578768215,3578768225,10
0,1587,70521,3578768215,3578768226,11
0,1587,70522,3578768215,3578768226,11
0,1587,70523,3578768215,3578768228,13
0,1587,70524,3578768215,3578768228,13
0,1587,70525,3578768215,3578768230,15
0,1587,70526,3578768215,3578768230,15
0,1587,70527,3578768215,3578768230,15
0,1587,70528,3578768215,3578768231,16
0,1587,70529,3578768215,3578768231,16
0,1587,70530,3578768215,3578768231,16
0,1587,70531,3578768215,3578768232,17
0,1587,70532,3578768215,3578768233,18
0,1587,70533,3578768215,3578768234,19
0,1587,70534,3578768215,3578768234,19
0,1587,70535,3578768215,3578768235,20
0,1587,70536,3578768215,3578768235,20
0,1587,70537,3578768215,3578768237,22
0,1587,70538,3578768215,3578768238,23
0,1587,70539,3578768215,3578768238,23
0,1587,70540,3578768215,3578768239,24
0,1587,70541,3578768215,3578768240,25
0,1587,70542,3578768215,3578768240,25
0,1587,70543,3578768215,3578768240,25
0,1587,70544,3578768215,3578768240,25
0,1587,70545,3578768215,3578768242,27
0,1587,70546,3578768215,3578768242,27
0,1587,70547,3578768215,3578768243,28
0,1587,70548,3578768215,3578768243,28
0,1587,70549,3578768215,3578768243,28
0,1587,70550,3578768215,3578768244,29
0,1587,70551,3578768215,3578768247,32
0,1587,70552,3578768215,3578768247,32
0,1587,70553,3578768215,3578768247,32
0,1587,70554,3578768215,3578768247,32
0,1587,70555,3578768215,3578768248,33
0,1587,70556,3578768215,3578768248,33
0,1587,70557,3578768215,3578768249,34
0,1587,70558,3578768215,3578768249,34
0,1587,70559,3578768215,3578768250,35
0,1587,70560,3578768215,3578768250,35
0,1587,70561,3578768215,3578768250,35
0,1587,70562,3578768215,3578768253,38
0,1587,70563,3578768215,3578768255,40
0,1587,70564,3578768215,3578768257,42
0,1587,70565,3578768215,3578768259,44
0,1587,70566,3578768215,3578768259,44
0,1587,70567,3578768215,3578768262,47
0,1587,70568,3578768215,3578768262,47
0,1587,70569,3578768215,3578768262,47
0,1587,70570,3578768215,3578768263,48
0,1587,70571,3578768215,3578768263,48
0,1587,70572,3578768215,3578768264,49
0,1587,70573,3578768215,3578768265,50
0,1588,70574,3578768280,3578768280,0
0,1588,70575,3578768280,3578768280,0
0,1588,70576,3578768280,3578768280,0
0,1588,70577,3578768280,3578768280,0
0,1588,70578,3578768280,3578768280,0
0,1588,70579,3578768280,3578768280,0
0,1588,70580,3578768280,3578768280,0
0,1588,70581,3578768280,3578768280,0
0,1588,70582,3578768280,3578768280,0
0,1588,70583,3578768280,3578768280,0
0,1588,70584,3578768280,3578768288,8
0,1588,70585,3578768280,3578768288,8
0,1588,70586,3578768280,3578768288,8
0,1588,70587,3578768280,3578768289,9
0,1588,70588,3578768280,3578768289,9
0,1588,70589,3578768280,3578768290,10
0,1588,70590,3578768280,3578768290,10
0,1588,70591,3578768280,3578768291,11
0,1588,70592,3578768280,3578768292,12
0,1588,70593,3578768280,3578768292,12
0,1588,70594,3578768280,3578768293,13
0,1588,70595,3578768280,3578768293,13
0,1588,70596,3578768280,3578768293,13
0,1588,70597,3578768280,3578768293,13
0,1588,70598,3578768280,3578768294,14
0,1588,70599,3578768280,3578768294,14
0,1588,70600,3578768280,3578768296,16
0,1588,70601,3578768280,3578768296,16
0,1588,70602,3578768280,3578768296,16
0,1588,70603,3578768280,3578768297,17
0,1588,70604,3578768280,3578768297,17
0,1588,70605,3578768280,3578768298,18
0,1588,70606,3578768280,3578768298,18
0,1588,70607,3578768280,3578768299,19
0,1588,70608,3578768280,3578768299,19
0,1588,70609,3578768280,3578768299,19
0,1588,70610,3578768280,3578768299,19
0,1588,70611,3578768280,3578768300,20
0,1588,70612,3578768280,3578768301,21
0,1588,70613,3578768280,3578768302,22
0,1588,70614,3578768280,3578768302,22
0,1588,70615,3578768280,3578768302,22
0,1588,70616,3578768280,3578768303,23
0,1588,70617,3578768280,3578768303,23
0,1588,70618,3578768280,3578768304,24
0,1588,70619,3578768280,3578768306,26
0,1588,70620,3578768280,3578768306,26
0,1588,70621,3578768280,3578768306,26
0,1588,70622,3578768280,3578768306,26
0,1588,70623,3578768280,3578768307,27
0,1588,70624,3578768280,3578768307,27
0,1588,70625,3578768280,3578768307,27
0,1588,70626,3578768280,3578768307,27
0,1588,70627,3578768280,3578768308,28
0,1588,70628,3578768280,3578768308,28
0,1588,70629,3578768280,3578768308,28
0,1588,70630,3578768280,3578768308,28
0,1588,70631,3578768280,3578768309,29
0,1588,70632,3578768280,3578768309,29
0,1588,70633,3578768280,3578768310,30
0,1588,70634,3578768280,3578768310,30
0,1588,70635,3578768280,3578768310,30
0,1588,70636,3578768280,3578768310,30
0,1588,70637,3578768280,3578768310,30
0,1588,70638,3578768280,3578768311,31
0,1588,70639,3578768280,3578768311,31
0,1588,70640,3578768280,3578768312,32
0,1588,70641,3578768280,3578768313,33
0,1588,70642,3578768280,3578768313,33
0,1588,70643,3578768280,3578768315,35
0,1588,70644,3578768280,3578768315,35
0,1588,70645,3578768280,3578768315,35
0,1588,70646,3578768280,3578768316,36
0,1588,70647,3578768280,3578768316,36
0,1588,70648,3578768280,3578768316,36
0,1588,70649,3578768280,3578768316,36
0,1588,70650,3578768280,3578768316,36
0,1588,70651,3578768280,3578768317,37
0,1588,70652,3578768280,3578768317,37
0,1588,70653,3578768280,3578768318,38
0,1588,70654,3578768280,3578768318,38
0,1588,70655,3578768280,3578768318,38
0,1588,70656,3578768280,3578768318,38
0,1588,70657,3578768280,3578768319,39
0,1588,70658,3578768280,3578768319,39
0,1588,70659,3578768280,3578768320,40
0,1588,70660,3578768280,3578768320,40
0,1588,70661,3578768280,3578768320,40
0,1588,70662,3578768280,3578768321,41
0,1588,70663,3578768280,3578768321,41
0,1588,70664,3578768280,3578768322,42
0,1588,70665,3578768280,3578768322,42
0,1588,70666,3578768280,3578768323,43
0,1588,70667,3578768280,3578768323,43
0,1588,70668,3578768280,3578768323,43
0,1588,70669,3578768280,3578768323,43
0,1588,70670,3578768280,3578768324,44
0,1588,70671,3578768280,3578768324,44
0,1588,70672,3578768280,3578768325,45
0,1588,70673,3578768280,3578768325,45
0,1588,70674,3578768280,3578768326,46
0,1588,70675,3578768280,3578768327,47
0,1588,70676,3578768280,3578768327,47
0,1588,70677,3578768280,3578768327,47
0,1588,70678,3578768280,3578768327,47
0,1588,70679,3578768280,3578768328,48
0,1588,70680,3578768280,3578768329,49
0,1588,70681,3578768280,3578768329,49
0,1588,70682,3578768280,3578768329,49
0,1588,70683,3578768280,3578768330,50
0,1588,70684,3578768280,3578768330,50
0,1589,70685,3578768347,3578768347,0
0,1589,70686,3578768347,3578768347,0
0,1589,70687,3578768347,3578768347,0
0,1589,70688,3578768347,3578768347,0
0,1589,70689,3578768347,3578768347,0
0,1589,70690,3578768347,3578768347,0
0,1589,70691,3578768347,3578768347,0
0,1589,70692,3578768347,3578768347,0
0,1589,70693,3578768347,3578768347,0
0,1589,70694,3578768347,3578768347,0
0,1589,70695,3578768347,3578768347,0
0,1589,70696,3578768347,3578768347,0
0,1589,70697,3578768347,3578768347,0
0,1589,70698,3578768347,3578768347,0
0,1589,70699,3578768347,3578768347,0
0,1589,70700,3578768347,3578768347,0
0,1589,70701,3578768347,3578768347,0
0,1589,70702,3578768347,3578768347,0
0,1589,70703,3578768347,3578768347,0
0,1589,70704,3578768347,3578768347,0
0,1589,70705,3578768347,3578768347,0
0,1589,70706,3578768347,3578768347,0
0,1589,70707,3578768347,3578768347,0
0,1589,70708,3578768347,3578768347,0
0,1589,70709,3578768347,3578768347,0
0,1589,70710,3578768347,3578768347,0
0,1589,70711,3578768347,3578768347,0
0,1589,70712,3578768347,3578768347,0
0,1589,70713,3578768347,3578768347,0
0,1589,70714,3578768347,3578768347,0
0,1589,70715,3578768347,3578768347,0
0,1589,70716,3578768347,3578768347,0
0,1589,70717,3578768347,3578768347,0
0,1589,70718,3578768347,3578768347,0
0,1589,70719,3578768347,3578768347,0
0,1589,70720,3578768347,3578768347,0
0,1589,70721,3578768347,3578768348,1
0,1589,70722,3578768347,3578768348,1
0,1589,70723,3578768347,3578768348,1
0,1589,70724,3578768347,3578768349,2
0,1589,70725,3578768347,3578768349,2
0,1589,70726,3578768347,3578768350,3
0,1589,70727,3578768347,3578768351,4
0,1589,70728,3578768347,3578768351,4
0,1589,70729,3578768347,3578768352,5
0,1589,70730,3578768347,3578768352,5
0,1589,70731,3578768347,3578768353,6
0,1589,70732,3578768347,3578768353,6
0,1589,70733,3578768347,3578768353,6
0,1589,70734,3578768347,3578768354,7
0,1589,70735,3578768347,3578768354,7
0,1589,70736,3578768347,3578768355,8
0,1589,70737,3578768347,3578768355,8
0,1589,70738,3578768347,3578768356,9
0,1589,70739,3578768347,3578768356,9
0,1589,70740,3578768347,3578768357,10
0,1589,70741,3578768347,3578768357,10
0,1589,70742,3578768347,3578768358,11
0,1589,70743,3578768347,3578768359,12
0,1589,70744,3578768347,3578768359,12
0,1589,70745,3578768347,3578768360,13
0,1589,70746,3578768347,3578768360,13
0,1589,70747,3578768347,3578768361,14
0,1589,70748,3578768347,3578768361,14
0,1589,70749,3578768347,3578768361,14
0,1589,70750,3578768347,3578768362,15
0,1589,70751,3578768347,3578768362,15
0,1589,70752,3578768347,3578768362,15
0,1589,70753,3578768347,3578768363,16
0,1589,70754,3578768347,3578768364,17
0,1589,70755,3578768347,3578768364,17
0,1589,70756,3578768347,3578768365,18
0,1589,70757,3578768347,3578768365,18
0,1589,70758,3578768347,3578768366,19
0,1589,70759,3578768347,3578768368,21
0,1589,70760,3578768347,3578768369,22
0,1589,70761,3578768347,3578768370,23
0,1589,70762,3578768347,3578768370,23
0,1589,70763,3578768347,3578768370,23
0,1589,70764,3578768347,3578768371,24
0,1589,70765,3578768347,3578768371,24
0,1589,70766,3578768347,3578768372,25
0,1589,70767,3578768347,3578768373,26
0,1589,70768,3578768347,3578768373,26
0,1589,70769,3578768347,3578768373,26
0,1589,70770,3578768347,3578768373,26
0,1589,70771,3578768347,3578768375,28
0,1589,70772,3578768347,3578768375,28
0,1589,70773,3578768347,3578768377,30
0,1589,70774,3578768347,3578768378,31
0,1589,70775,3578768347,3578768378,31
0,1589,70776,3578768347,3578768379,32
0,1589,70777,3578768347,3578768379,32
0,1589,70778,3578768347,3578768379,32
0,1589,70779,3578768347,3578768379,32
0,1589,70780,3578768347,3578768381,34
0,1589,70781,3578768347,3578768382,35
0,1589,70782,3578768347,3578768384,37
0,1589,70783,3578768347,3578768384,37
0,1589,70784,3578768347,3578768386,39
0,1589,70785,3578768347,3578768387,40
0,1589,70786,3578768347,3578768388,41
0,1589,70787,3578768347,3578768388,41
0,1589,70788,3578768347,3578768388,41
0,1589,70789,3578768347,3578768389,42
0,1589,70790,3578768347,3578768390,43
0,1589,70791,3578768347,3578768391,44
0,1589,70792,3578768347,3578768392,45
0,1589,70793,3578768347,3578768393,46
0,1589,70794,3578768347,3578768395,48
0,1589,70795,3578768347,3578768395,48
0,1589,70796,3578768347,3578768396,49
0,1589,70797,3578768347,3578768397,50
0,1590,70798,3578768412,3578768412,0
0,1590,70799,3578768412,3578768412,0
0,1590,70800,3578768412,3578768412,0
0,1590,70801,3578768412,3578768412,0
0,1590,70802,3578768412,3578768412,0
0,1590,70803,3578768412,3578768412,0
0,1590,70804,3578768412,3578768412,0
0,1590,70805,3578768412,3578768412,0
0,1590,70806,3578768412,3578768412,0
0,1590,70807,3578768412,3578768412,0
0,1590,70808,3578768412,3578768412,0
0,1590,70809,3578768412,3578768412,0
0,1590,70810,3578768412,3578768412,0
0,1590,70811,3578768412,3578768412,0
0,1590,70812,3578768412,3578768412,0
0,1590,70813,3578768412,3578768412,0
0,1590,70814,3578768412,3578768412,0
0,1590,70815,3578768412,3578768412,0
0,1590,70816,3578768412,3578768413,1
0,1590,70817,3578768412,3578768415,3
0,1590,70818,3578768412,3578768415,3
0,1590,70819,3578768412,3578768416,4
0,1590,70820,3578768412,3578768416,4
0,1590,70821,3578768412,3578768416,4
0,1590,70822,3578768412,3578768416,4
0,1590,70823,3578768412,3578768418,6
0,1590,70824,3578768412,3578768418,6
0,1590,70825,3578768412,3578768419,7
0,1590,70826,3578768412,3578768419,7
0,1590,70827,3578768412,3578768419,7
0,1590,70828,3578768412,3578768420,8
0,1590,70829,3578768412,3578768420,8
0,1590,70830,3578768412,3578768421,9
0,1590,70831,3578768412,3578768421,9
0,1590,70832,3578768412,3578768424,12
0,1590,70833,3578768412,3578768425,13
0,1590,70834,3578768412,3578768426,14
0,1590,70835,3578768412,3578768426,14
0,1590,70836,3578768412,3578768427,15
0,1590,70837,3578768412,3578768427,15
0,1590,70838,3578768412,3578768428,16
0,1590,70839,3578768412,3578768430,18
0,1590,70840,3578768412,3578768431,19
0,1590,70841,3578768412,3578768431,19
0,1590,70842,3578768412,3578768433,21
0,1590,70843,3578768412,3578768434,22
0,1590,70844,3578768412,3578768435,23
0,1590,70845,3578768412,3578768435,23
0,1590,70846,3578768412,3578768437,25
0,1590,70847,3578768412,3578768438,26
0,1590,70848,3578768412,3578768439,27
0,1590,70849,3578768412,3578768439,27
0,1590,70850,3578768412,3578768439,27
0,1590,70851,3578768412,3578768440,28
0,1590,70852,3578768412,3578768440,28
0,1590,70853,3578768412,3578768440,28
0,1590,70854,3578768412,3578768441,29
0,1590,70855,3578768412,3578768442,30
0,1590,70856,3578768412,3578768444,32
0,1590,70857,3578768412,3578768444,32
0,1590,70858,3578768412,3578768444,32
0,1590,70859,3578768412,3578768444,32
0,1590,70860,3578768412,3578768444,32
0,1590,70861,3578768412,3578768445,33
0,1590,70862,3578768412,3578768445,33
0,1590,70863,3578768412,3578768446,34
0,1590,70864,3578768412,3578768447,35
0,1590,70865,3578768412,3578768447,35
0,1590,70866,3578768412,3578768448,36
0,1590,70867,3578768412,3578768449,37
0,1590,70868,3578768412,3578768450,38
0,1590,70869,3578768412,3578768450,38
0,1590,70870,3578768412,3578768451,39
0,1590,70871,3578768412,3578768453,41
0,1590,70872,3578768412,3578768455,43
0,1590,70873,3578768412,3578768455,43
0,1590,70874,3578768412,3578768456,44
0,1590,70875,3578768412,3578768458,46
0,1590,70876,3578768412,3578768458,46
0,1590,70877,3578768412,3578768459,47
0,1590,70878,3578768412,3578768460,48
0,1590,70879,3578768412,3578768462,50
0,1591,70880,3578768477,3578768477,0
0,1591,70881,3578768477,3578768477,0
0,1591,70882,3578768477,3578768477,0
0,1591,70883,3578768477,3578768477,0
0,1591,70884,3578768477,3578768477,0
0,1591,70885,3578768477,3578768477,0
0,1591,70886,3578768477,3578768477,0
0,1591,70887,3578768477,3578768477,0
0,1591,70888,3578768477,3578768477,0
0,1591,70889,3578768477,3578768477,0
0,1591,70890,3578768477,3578768477,0
0,1591,70891,3578768477,3578768477,0
0,1591,70892,3578768477,3578768477,0
0,1591,70893,3578768477,3578768477,0
0,1591,70894,3578768477,3578768477,0
0,1591,70895,3578768477,3578768485,8
0,1591,70896,3578768477,3578768488,11
0,1591,70897,3578768477,3578768488,11
0,1591,70898,3578768477,3578768488,11
0,1591,70899,3578768477,3578768488,11
0,1591,70900,3578768477,3578768488,11
0,1591,70901,3578768477,3578768489,12
0,1591,70902,3578768477,3578768489,12
0,1591,70903,3578768477,3578768491,14
0,1591,70904,3578768477,3578768493,16
0,1591,70905,3578768477,3578768493,16
0,1591,70906,3578768477,3578768494,17
0,1591,70907,3578768477,3578768494,17
0,1591,70908,3578768477,3578768494,17
0,1591,70909,3578768477,3578768494,17
0,1591,70910,3578768477,3578768495,18
0,1591,70911,3578768477,3578768496,19
0,1591,70912,3578768477,3578768497,20
0,1591,70913,3578768477,3578768498,21
0,1591,70914,3578768477,3578768498,21
0,1591,70915,3578768477,3578768498,21
0,1591,70916,3578768477,3578768499,22
0,1591,70917,3578768477,3578768499,22
0,1591,70918,3578768477,3578768500,23
0,1591,70919,3578768477,3578768500,23
0,1591,70920,3578768477,3578768501,24
0,1591,70921,3578768477,3578768502,25
0,1591,70922,3578768477,3578768503,26
0,1591,70923,3578768477,3578768503,26
0,1591,70924,3578768477,3578768504,27
0,1591,70925,3578768477,3578768505,28
0,1591,70926,3578768477,3578768505,28
0,1591,70927,3578768477,3578768505,28
0,1591,70928,3578768477,3578768505,28
0,1591,70929,3578768477,3578768505,28
0,1591,70930,3578768477,3578768506,29
0,1591,70931,3578768477,3578768507,30
0,1591,70932,3578768477,3578768507,30
0,1591,70933,3578768477,3578768507,30
0,1591,70934,3578768477,3578768507,30
0,1591,70935,3578768477,3578768507,30
0,1591,70936,3578768477,3578768508,31
0,1591,70937,3578768477,3578768509,32
0,1591,70938,3578768477,3578768509,32
0,1591,70939,3578768477,3578768509,32
0,1591,70940,3578768477,3578768509,32
0,1591,70941,3578768477,3578768509,32
0,1591,70942,3578768477,3578768510,33
0,1591,70943,3578768477,3578768510,33
0,1591,70944,3578768477,3578768510,33
0,1591,70945,3578768477,3578768511,34
0,1591,70946,3578768477,3578768512,35
0,1591,70947,3578768477,3578768513,36
0,1591,70948,3578768477,3578768514,37
0,1591,70949,3578768477,3578768515,38
0,1591,70950,3578768477,3578768515,38
0,1591,70951,3578768477,3578768515,38
0,1591,70952,3578768477,3578768515,38
0,1591,70953,3578768477,3578768516,39
0,1591,70954,3578768477,3578768516,39
0,1591,70955,3578768477,3578768516,39
0,1591,70956,3578768477,3578768516,39
0,1591,70957,3578768477,3578768517,40
0,1591,70958,3578768477,3578768517,40
0,1591,70959,3578768477,3578768518,41
0,1591,70960,3578768477,3578768518,41
0,1591,70961,3578768477,3578768518,41
0,1591,70962,3578768477,3578768518,41
0,1591,70963,3578768477,3578768518,41
0,1591,70964,3578768477,3578768519,42
0,1591,70965,3578768477,3578768520,43
0,1591,70966,3578768477,3578768522,45
0,1591,70967,3578768477,3578768522,45
0,1591,70968,3578768477,3578768522,45
0,1591,70969,3578768477,3578768522,45
0,1591,70970,3578768477,3578768523,46
0,1591,70971,3578768477,3578768524,47
0,1591,70972,3578768477,3578768524,47
0,1591,70973,3578768477,3578768525,48
0,1591,70974,3578768477,3578768525,48
0,1591,70975,3578768477,3578768526,49
0,1591,70976,3578768477,3578768526,49
0,1591,70977,3578768477,3578768527,50
0,1592,70978,3578768542,3578768542,0
0,1592,70979,3578768542,3578768542,0
0,1592,70980,3578768542,3578768542,0
0,1592,70981,3578768542,3578768542,0
0,1592,70982,3578768542,3578768542,0
0,1592,70983,3578768542,3578768542,0
0,1592,70984,3578768542,3578768542,0
0,1592,70985,3578768542,3578768542,0
0,1592,70986,3578768542,3578768542,0
0,1592,70987,3578768542,3578768542,0
0,1592,70988,3578768542,3578768542,0
0,1592,70989,3578768542,3578768542,0
0,1592,70990,3578768542,3578768542,0
0,1592,70991,3578768542,3578768542,0
0,1592,70992,3578768542,3578768542,0
0,1592,70993,3578768542,3578768542,0
0,1592,70994,3578768542,3578768542,0
0,1592,70995,3578768542,3578768542,0
0,1592,70996,3578768542,3578768542,0
0,1592,70997,3578768542,3578768542,0
0,1592,70998,3578768542,3578768542,0
0,1592,70999,3578768542,3578768542,0
0,1592,71000,3578768542,3578768542,0
0,1592,71001,3578768542,3578768542,0
0,1592,71002,3578768542,3578768542,0
0,1592,71003,3578768542,3578768542,0
0,1592,71004,3578768542,3578768542,0
0,1592,71005,3578768542,3578768542,0
0,1592,71006,3578768542,3578768542,0
0,1592,71007,3578768542,3578768542,0
0,1592,71008,3578768542,3578768542,0
0,1592,71009,3578768542,3578768542,0
0,1592,71010,3578768542,3578768542,0
0,1592,71011,3578768542,3578768542,0
0,1592,71012,3578768542,3578768543,1
0,1592,71013,3578768542,3578768543,1
0,1592,71014,3578768542,3578768544,2
0,1592,71015,3578768542,3578768545,3
0,1592,71016,3578768542,3578768546,4
0,1592,71017,3578768542,3578768546,4
0,1592,71018,3578768542,3578768546,4
0,1592,71019,3578768542,3578768547,5
0,1592,71020,3578768542,3578768547,5
0,1592,71021,3578768542,3578768547,5
0,1592,71022,3578768542,3578768547,5
0,1592,71023,3578768542,3578768548,6
0,1592,71024,3578768542,3578768548,6
0,1592,71025,3578768542,3578768550,8
0,1592,71026,3578768542,3578768550,8
0,1592,71027,3578768542,3578768552,10
0,1592,71028,3578768542,3578768552,10
0,1592,71029,3578768542,3578768552,10
0,1592,71030,3578768542,3578768552,10
0,1592,71031,3578768542,3578768552,10
0,1592,71032,3578768542,3578768552,10
0,1592,71033,3578768542,3578768553,11
0,1592,71034,3578768542,3578768554,12
0,1592,71035,3578768542,3578768555,13
0,1592,71036,3578768542,3578768555,13
0,1592,71037,3578768542,3578768556,14
0,1592,71038,3578768542,3578768556,14
0,1592,71039,3578768542,3578768557,15
0,1592,71040,3578768542,3578768557,15
0,1592,71041,3578768542,3578768558,16
0,1592,71042,3578768542,3578768559,17
0,1592,71043,3578768542,3578768559,17
0,1592,71044,3578768542,3578768559,17
0,1592,71045,3578768542,3578768559,17
0,1592,71046,3578768542,3578768560,18
0,1592,71047,3578768542,3578768560,18
0,1592,71048,3578768542,3578768560,18
0,1592,71049,3578768542,3578768560,18
0,1592,71050,3578768542,3578768561,19
0,1592,71051,3578768542,3578768561,19
0,1592,71052,3578768542,3578768562,20
0,1592,71053,3578768542,3578768563,21
0,1592,71054,3578768542,3578768563,21
0,1592,71055,3578768542,3578768564,22
0,1592,71056,3578768542,3578768564,22
0,1592,71057,3578768542,3578768566,24
0,1592,71058,3578768542,3578768569,27
0,1592,71059,3578768542,3578768569,27
0,1592,71060,3578768542,3578768569,27
0,1592,71061,3578768542,3578768570,28
0,1592,71062,3578768542,3578768570,28
0,1592,71063,3578768542,3578768571,29
0,1592,71064,3578768542,3578768572,30
0,1592,71065,3578768542,3578768572,30
0,1592,71066,3578768542,3578768573,31
0,1592,71067,3578768542,3578768573,31
0,1592,71068,3578768542,3578768573,31
0,1592,71069,3578768542,3578768574,32
0,1592,71070,3578768542,3578768575,33
0,1592,71071,3578768542,3578768576,34
0,1592,71072,3578768542,3578768576,34
0,1592,71073,3578768542,3578768577,35
0,1592,71074,3578768542,3578768577,35
0,1592,71075,3578768542,3578768578,36
0,1592,71076,3578768542,3578768578,36
0,1592,71077,3578768542,3578768579,37
0,1592,71078,3578768542,3578768579,37
0,1592,71079,3578768542,3578768581,39
0,1592,71080,3578768542,3578768582,40
0,1592,71081,3578768542,3578768583,41
0,1592,71082,3578768542,3578768583,41
0,1592,71083,3578768542,3578768583,41
0,1592,71084,3578768542,3578768585,43
0,1592,71085,3578768542,3578768586,44
0,1592,71086,3578768542,3578768586,44
0,1592,71087,3578768542,3578768586,44
0,1592,71088,3578768542,3578768588,46
0,1592,71089,3578768542,3578768588,46
0,1592,71090,3578768542,3578768588,46
0,1592,71091,3578768542,3578768589,47
0,1592,71092,3578768542,3578768589,47
0,1592,71093,3578768542,3578768590,48
0,1592,71094,3578768542,3578768590,48
0,1592,71095,3578768542,3578768591,49
0,1593,71096,3578768606,3578768606,0
0,1593,71097,3578768606,3578768606,0
0,1593,71098,3578768606,3578768606,0
0,1593,71099,3578768606,3578768606,0
0,1593,71100,3578768606,3578768606,0
0,1593,71101,3578768606,3578768606,0
0,1593,71102,3578768606,3578768606,0
0,1593,71103,3578768606,3578768606,0
0,1593,71104,3578768606,3578768606,0
0,1593,71105,3578768606,3578768606,0
0,1593,71106,3578768606,3578768606,0
0,1593,71107,3578768606,3578768606,0
0,1593,71108,3578768606,3578768606,0
0,1593,71109,3578768606,3578768606,0
0,1593,71110,3578768606,3578768606,0
0,1593,71111,3578768606,3578768606,0
0,1593,71112,3578768606,3578768606,0
0,1593,71113,3578768606,3578768606,0
0,1593,71114,3578768606,3578768607,1
0,1593,71115,3578768606,3578768608,2
0,1593,71116,3578768606,3578768609,3
0,1593,71117,3578768606,3578768609,3
0,1593,71118,3578768606,3578768611,5
0,1593,71119,3578768606,3578768612,6
0,1593,71120,3578768606,3578768612,6
0,1593,71121,3578768606,3578768615,9
0,1593,71122,3578768606,3578768615,9
0,1593,71123,3578768606,3578768615,9
0,1593,71124,3578768606,3578768615,9
0,1593,71125,3578768606,3578768615,9
0,1593,71126,3578768606,3578768616,10
0,1593,71127,3578768606,3578768617,11
0,1593,71128,3578768606,3578768617,11
0,1593,71129,3578768606,3578768617,11
0,1593,71130,3578768606,3578768618,12
0,1593,71131,3578768606,3578768618,12
0,1593,71132,3578768606,3578768618,12
0,1593,71133,3578768606,3578768618,12
0,1593,71134,3578768606,3578768618,12
0,1593,71135,3578768606,3578768618,12
0,1593,71136,3578768606,3578768620,14
0,1593,71137,3578768606,3578768620,14
0,1593,71138,3578768606,3578768621,15
0,1593,71139,3578768606,3578768621,15
0,1593,71140,3578768606,3578768621,15
0,1593,71141,3578768606,3578768623,17
0,1593,71142,3578768606,3578768625,19
0,1593,71143,3578768606,3578768626,20
0,1593,71144,3578768606,3578768627,21
0,1593,71145,3578768606,3578768628,22
0,1593,71146,3578768606,3578768628,22
0,1593,71147,3578768606,3578768628,22
0,1593,71148,3578768606,3578768629,23
0,1593,71149,3578768606,3578768629,23
0,1593,71150,3578768606,3578768630,24
0,1593,71151,3578768606,3578768631,25
0,1593,71152,3578768606,3578768631,25
0,1593,71153,3578768606,3578768631,25
0,1593,71154,3578768606,3578768632,26
0,1593,71155,3578768606,3578768634,28
0,1593,71156,3578768606,3578768635,29
0,1593,71157,3578768606,3578768636,30
0,1593,71158,3578768606,3578768636,30
0,1593,71159,3578768606,3578768638,32
0,1593,71160,3578768606,3578768638,32
0,1593,71161,3578768606,3578768638,32
0,1593,71162,3578768606,3578768639,33
0,1593,71163,3578768606,3578768639,33
0,1593,71164,3578768606,3578768640,34
0,1593,71165,3578768606,3578768642,36
0,1593,71166,3578768606,3578768643,37
0,1593,71167,3578768606,3578768643,37
0,1593,71168,3578768606,3578768643,37
0,1593,71169,3578768606,3578768643,37
0,1593,71170,3578768606,3578768644,38
0,1593,71171,3578768606,3578768646,40
0,1593,71172,3578768606,3578768646,40
0,1593,71173,3578768606,3578768647,41
0,1593,71174,3578768606,3578768648,42
0,1593,71175,3578768606,3578768649,43
0,1593,71176,3578768606,3578768649,43
0,1593,71177,3578768606,3578768649,43
0,1593,71178,3578768606,3578768650,44
0,1593,71179,3578768606,3578768650,44
0,1593,71180,3578768606,3578768651,45
0,1593,71181,3578768606,3578768652,46
0,1593,71182,3578768606,3578768654,48
0,1593,71183,3578768606,3578768654,48
0,1593,71184,3578768606,3578768655,49
0,1593,71185,3578768606,3578768655,49
0,1593,71186,3578768606,3578768656,50
0,1594,71187,3578768671,3578768671,0
0,1594,71188,3578768671,3578768671,0
0,1594,71189,3578768671,3578768671,0
0,1594,71190,3578768671,3578768671,0
0,1594,71191,3578768671,3578768671,0
0,1594,71192,3578768671,3578768671,0
0,1594,71193,3578768671,3578768671,0
0,1594,71194,3578768671,3578768671,0
0,1594,71195,3578768671,3578768671,0
0,1594,71196,3578768671,3578768671,0
0,1594,71197,3578768671,3578768671,0
0,1594,71198,3578768671,3578768671,0
0,1594,71199,3578768671,3578768671,0
0,1594,71200,3578768671,3578768671,0
0,1594,71201,3578768671,3578768671,0
0,1594,71202,3578768671,3578768671,0
0,1594,71203,3578768671,3578768671,0
0,1594,71204,3578768671,3578768671,0
0,1594,71205,3578768671,3578768671,0
0,1594,71206,3578768671,3578768684,13
0,1594,71207,3578768671,3578768687,16
0,1594,71208,3578768671,3578768688,17
0,1594,71209,3578768671,3578768688,17
0,1594,71210,3578768671,3578768688,17
0,1594,71211,3578768671,3578768689,18
0,1594,71212,3578768671,3578768689,18
0,1594,71213,3578768671,3578768689,18
0,1594,71214,3578768671,3578768689,18
0,1594,71215,3578768671,3578768690,19
0,1594,71216,3578768671,3578768691,20
0,1594,71217,3578768671,3578768691,20
0,1594,71218,3578768671,3578768692,21
0,1594,71219,3578768671,3578768693,22
0,1594,71220,3578768671,3578768693,22
0,1594,71221,3578768671,3578768693,22
0,1594,71222,3578768671,3578768693,22
0,1594,71223,3578768671,3578768693,22
0,1594,71224,3578768671,3578768694,23
0,1594,71225,3578768671,3578768694,23
0,1594,71226,3578768671,3578768695,24
0,1594,71227,3578768671,3578768695,24
0,1594,71228,3578768671,3578768696,25
0,1594,71229,3578768671,3578768698,27
0,1594,71230,3578768671,3578768698,27
0,1594,71231,3578768671,3578768699,28
0,1594,71232,3578768671,3578768699,28
0,1594,71233,3578768671,3578768700,29
0,1594,71234,3578768671,3578768701,30
0,1594,71235,3578768671,3578768702,31
0,1594,71236,3578768671,3578768702,31
0,1594,71237,3578768671,3578768703,32
0,1594,71238,3578768671,3578768704,33
0,1594,71239,3578768671,3578768704,33
0,1594,71240,3578768671,3578768704,33
0,1594,71241,3578768671,3578768705,34
0,1594,71242,3578768671,3578768706,35
0,1594,71243,3578768671,3578768706,35
0,1594,71244,3578768671,3578768706,35
0,1594,71245,3578768671,3578768706,35
0,1594,71246,3578768671,3578768706,35
0,1594,71247,3578768671,3578768707,36
0,1594,71248,3578768671,3578768707,36
0,1594,71249,3578768671,3578768707,36
0,1594,71250,3578768671,3578768707,36
0,1594,71251,3578768671,3578768708,37
0,1594,71252,3578768671,3578768708,37
0,1594,71253,3578768671,3578768708,37
0,1594,71254,3578768671,3578768709,38
0,1594,71255,3578768671,3578768709,38
0,1594,71256,3578768671,3578768710,39
0,1594,71257,3578768671,3578768710,39
0,1594,71258,3578768671,3578768710,39
0,1594,71259,3578768671,3578768710,39
0,1594,71260,3578768671,3578768712,41
0,1594,71261,3578768671,3578768712,41
0,1594,71262,3578768671,3578768713,42
0,1594,71263,3578768671,3578768715,44
0,1594,71264,3578768671,3578768716,45
0,1594,71265,3578768671,3578768716,45
0,1594,71266,3578768671,3578768716,45
0,1594,71267,3578768671,3578768716,45
0,1594,71268,3578768671,3578768716,45
0,1594,71269,3578768671,3578768717,46
0,1594,71270,3578768671,3578768718,47
0,1594,71271,3578768671,3578768718,47
0,1594,71272,3578768671,3578768718,47
0,1594,71273,3578768671,3578768718,47
0,1594,71274,3578768671,3578768718,47
0,1594,71275,3578768671,3578768718,47
0,1594,71276,3578768671,3578768719,48
0,1594,71277,3578768671,3578768720,49
0,1594,71278,3578768671,3578768720,49
0,1595,71279,3578768736,3578768736,0
0,1595,71280,3578768736,3578768736,0
0,1595,71281,3578768736,3578768736,0
0,1595,71282,3578768736,3578768736,0
0,1595,71283,3578768736,3578768736,0
0,1595,71284,3578768736,3578768736,0
0,1595,71285,3578768736,3578768736,0
0,1595,71286,3578768736,3578768736,0
0,1595,71287,3578768736,3578768736,0
0,1595,71288,3578768736,3578768736,0
0,1595,71289,3578768736,3578768736,0
0,1595,71290,3578768736,3578768736,0
0,1595,71291,3578768736,3578768736,0
0,1595,71292,3578768736,3578768736,0
0,1595,71293,3578768736,3578768736,0
0,1595,71294,3578768736,3578768736,0
0,1595,71295,3578768736,3578768736,0
0,1595,71296,3578768736,3578768736,0
0,1595,71297,3578768736,3578768736,0
0,1595,71298,3578768736,3578768736,0
0,1595,71299,3578768736,3578768736,0
0,1595,71300,3578768736,3578768736,0
0,1595,71301,3578768736,3578768736,0
0,1595,71302,3578768736,3578768736,0
0,1595,71303,3578768736,3578768736,0
0,1595,71304,3578768736,3578768736,0
0,1595,71305,3578768736,3578768736,0
0,1595,71306,3578768736,3578768736,0
0,1595,71307,3578768736,3578768736,0
0,1595,71308,3578768736,3578768736,0
0,1595,71309,3578768736,3578768736,0
0,1595,71310,3578768736,3578768736,0
0,1595,71311,3578768736,3578768736,0
0,1595,71312,3578768736,3578768736,0
0,1595,71313,3578768736,3578768736,0
0,1595,71314,3578768736,3578768736,0
0,1595,71315,3578768736,3578768736,0
0,1595,71316,3578768736,3578768737,1
0,1595,71317,3578768736,3578768738,2
0,1595,71318,3578768736,3578768738,2
0,1595,71319,3578768736,3578768739,3
0,1595,71320,3578768736,3578768739,3
0,1595,71321,3578768736,3578768740,4
0,1595,71322,3578768736,3578768740,4
0,1595,71323,3578768736,3578768740,4
0,1595,71324,3578768736,3578768741,5
0,1595,71325,3578768736,3578768743,7
0,1595,71326,3578768736,3578768743,7
0,1595,71327,3578768736,3578768743,7
0,1595,71328,3578768736,3578768743,7
0,1595,71329,3578768736,3578768744,8
0,1595,71330,3578768736,3578768744,8
0,1595,71331,3578768736,3578768745,9
0,1595,71332,3578768736,3578768747,11
0,1595,71333,3578768736,3578768747,11
0,1595,71334,3578768736,3578768747,11
0,1595,71335,3578768736,3578768747,11
0,1595,71336,3578768736,3578768747,11
0,1595,71337,3578768736,3578768747,11
0,1595,71338,3578768736,3578768748,12
0,1595,71339,3578768736,3578768748,12
0,1595,71340,3578768736,3578768748,12
0,1595,71341,3578768736,3578768750,14
0,1595,71342,3578768736,3578768750,14
0,1595,71343,3578768736,3578768751,15
0,1595,71344,3578768736,3578768751,15
0,1595,71345,3578768736,3578768752,16
0,1595,71346,3578768736,3578768753,17
0,1595,71347,3578768736,3578768753,17
0,1595,71348,3578768736,3578768753,17
0,1595,71349,3578768736,3578768753,17
0,1595,71350,3578768736,3578768755,19
0,1595,71351,3578768736,3578768757,21
0,1595,71352,3578768736,3578768757,21
0,1595,71353,3578768736,3578768757,21
0,1595,71354,3578768736,3578768757,21
0,1595,71355,3578768736,3578768759,23
0,1595,71356,3578768736,3578768759,23
0,1595,71357,3578768736,3578768760,24
0,1595,71358,3578768736,3578768760,24
0,1595,71359,3578768736,3578768760,24
0,1595,71360,3578768736,3578768760,24
0,1595,71361,3578768736,3578768761,25
0,1595,71362,3578768736,3578768761,25
0,1595,71363,3578768736,3578768762,26
0,1595,71364,3578768736,3578768762,26
0,1595,71365,3578768736,3578768762,26
0,1595,71366,3578768736,3578768763,27
0,1595,71367,3578768736,3578768763,27
0,1595,71368,3578768736,3578768764,28
0,1595,71369,3578768736,3578768764,28
0,1595,71370,3578768736,3578768765,29
0,1595,71371,3578768736,3578768765,29
0,1595,71372,3578768736,3578768769,33
0,1595,71373,3578768736,3578768769,33
0,1595,71374,3578768736,3578768770,34
0,1595,71375,3578768736,3578768770,34
0,1595,71376,3578768736,3578768771,35
0,1595,71377,3578768736,3578768771,35
0,1595,71378,3578768736,3578768773,37
0,1595,71379,3578768736,3578768773,37
0,1595,71380,3578768736,3578768773,37
0,1595,71381,3578768736,3578768774,38
0,1595,71382,3578768736,3578768774,38
0,1595,71383,3578768736,3578768775,39
0,1595,71384,3578768736,3578768776,40
0,1595,71385,3578768736,3578768776,40
0,1595,71386,3578768736,3578768778,42
0,1595,71387,3578768736,3578768778,42
0,1595,71388,3578768736,3578768778,42
0,1595,71389,3578768736,3578768778,42
0,1595,71390,3578768736,3578768778,42
0,1595,71391,3578768736,3578768778,42
0,1595,71392,3578768736,3578768779,43
0,1595,71393,3578768736,3578768780,44
0,1595,71394,3578768736,3578768781,45
0,1595,71395,3578768736,3578768783,47
0,1595,71396,3578768736,3578768783,47
0,1595,71397,3578768736,3578768784,48
0,1595,71398,3578768736,3578768785,49
0,1595,71399,3578768736,3578768785,49
0,1596,71400,3578768801,3578768801,0
0,1596,71401,3578768801,3578768801,0
0,1596,71402,3578768801,3578768801,0
0,1596,71403,3578768801,3578768801,0
0,1596,71404,3578768801,3578768801,0
0,1596,71405,3578768801,3578768801,0
0,1596,71406,3578768801,3578768801,0
0,1596,71407,3578768801,3578768801,0
0,1596,71408,3578768801,3578768801,0
0,1596,71409,3578768801,3578768801,0
0,1596,71410,3578768801,3578768801,0
0,1596,71411,3578768801,3578768801,0
0,1596,71412,3578768801,3578768801,0
0,1596,71413,3578768801,3578768801,0
0,1596,71414,3578768801,3578768801,0
0,1596,71415,3578768801,3578768801,0
0,1596,71416,3578768801,3578768801,0
0,1596,71417,3578768801,3578768801,0
0,1596,71418,3578768801,3578768801,0
0,1596,71419,3578768801,3578768801,0
0,1596,71420,3578768801,3578768801,0
0,1596,71421,3578768801,3578768801,0
0,1596,71422,3578768801,3578768801,0
0,1596,71423,3578768801,3578768803,2
0,1596,71424,3578768801,3578768803,2
0,1596,71425,3578768801,3578768803,2
0,1596,71426,3578768801,3578768804,3
0,1596,71427,3578768801,3578768805,4
0,1596,71428,3578768801,3578768805,4
0,1596,71429,3578768801,3578768806,5
0,1596,71430,3578768801,3578768807,6
0,1596,71431,3578768801,3578768808,7
0,1596,71432,3578768801,3578768809,8
0,1596,71433,3578768801,3578768809,8
0,1596,71434,3578768801,3578768811,10
0,1596,71435,3578768801,3578768812,11
0,1596,71436,3578768801,3578768814,13
0,1596,71437,3578768801,3578768814,13
0,1596,71438,3578768801,3578768815,14
0,1596,71439,3578768801,3578768815,14
0,1596,71440,3578768801,3578768815,14
0,1596,71441,3578768801,3578768815,14
0,1596,71442,3578768801,3578768816,15
0,1596,71443,3578768801,3578768818,17
0,1596,71444,3578768801,3578768818,17
0,1596,71445,3578768801,3578768818,17
0,1596,71446,3578768801,3578768818,17
0,1596,71447,3578768801,3578768818,17
0,1596,71448,3578768801,3578768819,18
0,1596,71449,3578768801,3578768819,18
0,1596,71450,3578768801,3578768822,21
0,1596,71451,3578768801,3578768822,21
0,1596,71452,3578768801,3578768822,21
0,1596,71453,3578768801,3578768825,24
0,1596,71454,3578768801,3578768826,25
0,1596,71455,3578768801,3578768826,25
0,1596,71456,3578768801,3578768827,26
0,1596,71457,3578768801,3578768828,27
0,1596,71458,3578768801,3578768828,27
0,1596,71459,3578768801,3578768828,27
0,1596,71460,3578768801,3578768829,28
0,1596,71461,3578768801,3578768829,28
0,1596,71462,3578768801,3578768829,28
0,1596,71463,3578768801,3578768831,30
0,1596,71464,3578768801,3578768832,31
0,1596,71465,3578768801,3578768832,31
0,1596,71466,3578768801,3578768833,32
0,1596,71467,3578768801,3578768833,32
0,1596,71468,3578768801,3578768834,33
0,1596,71469,3578768801,3578768835,34
0,1596,71470,3578768801,3578768836,35
0,1596,71471,3578768801,3578768836,35
0,1596,71472,3578768801,3578768836,35
0,1596,71473,3578768801,3578768838,37
0,1596,71474,3578768801,3578768838,37
0,1596,71475,3578768801,3578768839,38
0,1596,71476,3578768801,3578768839,38
0,1596,71477,3578768801,3578768839,38
0,1596,71478,3578768801,3578768840,39
0,1596,71479,3578768801,3578768840,39
0,1596,71480,3578768801,3578768840,39
0,1596,71481,3578768801,3578768841,40
0,1596,71482,3578768801,3578768841,40
0,1596,71483,3578768801,3578768842,41
0,1596,71484,3578768801,3578768843,42
0,1596,71485,3578768801,3578768843,42
0,1596,71486,3578768801,3578768843,42
0,1596,71487,3578768801,3578768843,42
0,1596,71488,3578768801,3578768844,43
0,1596,71489,3578768801,3578768847,46
0,1596,71490,3578768801,3578768847,46
0,1596,71491,3578768801,3578768848,47
0,1596,71492,3578768801,3578768848,47
0,1596,71493,3578768801,3578768849,48
0,1596,71494,3578768801,3578768849,48
0,1596,71495,3578768801,3578768849,48
0,1596,71496,3578768801,3578768850,49
0,1596,71497,3578768801,3578768851,50
0,1597,71498,3578768866,3578768866,0
0,1597,71499,3578768866,3578768866,0
0,1597,71500,3578768866,3578768866,0
0,1597,71501,3578768866,3578768866,0
0,1597,71502,3578768866,3578768866,0
0,1597,71503,3578768866,3578768866,0
0,1597,71504,3578768866,3578768866,0
0,1597,71505,3578768866,3578768866,0
0,1597,71506,3578768866,3578768866,0
0,1597,71507,3578768866,3578768866,0
0,1597,71508,3578768866,3578768866,0
0,1597,71509,3578768866,3578768866,0
0,1597,71510,3578768866,3578768866,0
0,1597,71511,3578768866,3578768866,0
0,1597,71512,3578768866,3578768866,0
0,1597,71513,3578768866,3578768866,0
0,1597,71514,3578768866,3578768866,0
0,1597,71515,3578768866,3578768866,0
0,1597,71516,3578768866,3578768866,0
0,1597,71517,3578768866,3578768867,1
0,1597,71518,3578768866,3578768867,1
0,1597,71519,3578768866,3578768868,2
0,1597,71520,3578768866,3578768868,2
0,1597,71521,3578768866,3578768873,7
0,1597,71522,3578768866,3578768884,18
0,1597,71523,3578768866,3578768887,21
0,1597,71524,3578768866,3578768888,22
0,1597,71525,3578768866,3578768888,22
0,1597,71526,3578768866,3578768888,22
0,1597,71527,3578768866,3578768888,22
0,1597,71528,3578768866,3578768889,23
0,1597,71529,3578768866,3578768889,23
0,1597,71530,3578768866,3578768889,23
0,1597,71531,3578768866,3578768890,24
0,1597,71532,3578768866,3578768891,25
0,1597,71533,3578768866,3578768892,26
0,1597,71534,3578768866,3578768892,26
0,1597,71535,3578768866,3578768892,26
0,1597,71536,3578768866,3578768893,27
0,1597,71537,3578768866,3578768893,27
0,1597,71538,3578768866,3578768893,27
0,1597,71539,3578768866,3578768893,27
0,1597,71540,3578768866,3578768894,28
0,1597,71541,3578768866,3578768894,28
0,1597,71542,3578768866,3578768894,28
0,1597,71543,3578768866,3578768896,30
0,1597,71544,3578768866,3578768896,30
0,1597,71545,3578768866,3578768898,32
0,1597,71546,3578768866,3578768898,32
0,1597,71547,3578768866,3578768899,33
0,1597,71548,3578768866,3578768899,33
0,1597,71549,3578768866,3578768900,34
0,1597,71550,3578768866,3578768901,35
0,1597,71551,3578768866,3578768902,36
0,1597,71552,3578768866,3578768903,37
0,1597,71553,3578768866,3578768903,37
0,1597,71554,3578768866,3578768905,39
0,1597,71555,3578768866,3578768905,39
0,1597,71556,3578768866,3578768905,39
0,1597,71557,3578768866,3578768905,39
0,1597,71558,3578768866,3578768905,39
0,1597,71559,3578768866,3578768905,39
0,1597,71560,3578768866,3578768906,40
0,1597,71561,3578768866,3578768906,40
0,1597,71562,3578768866,3578768907,41
0,1597,71563,3578768866,3578768907,41
0,1597,71564,3578768866,3578768907,41
0,1597,71565,3578768866,3578768908,42
0,1597,71566,3578768866,3578768908,42
0,1597,71567,3578768866,3578768908,42
0,1597,71568,3578768866,3578768909,43
0,1597,71569,3578768866,3578768909,43
0,1597,71570,3578768866,3578768909,43
0,1597,71571,3578768866,3578768909,43
0,1597,71572,3578768866,3578768909,43
0,1597,71573,3578768866,3578768910,44
0,1597,71574,3578768866,3578768910,44
0,1597,71575,3578768866,3578768912,46
0,1597,71576,3578768866,3578768913,47
0,1597,71577,3578768866,3578768913,47
0,1597,71578,3578768866,3578768913,47
0,1597,71579,3578768866,3578768914,48
0,1597,71580,3578768866,3578768914,48
0,1597,71581,3578768866,3578768916,50
0,1598,71582,3578768932,3578768932,0
0,1598,71583,3578768932,3578768932,0
0,1598,71584,3578768932,3578768932,0
0,1598,71585,3578768932,3578768932,0
0,1598,71586,3578768932,3578768932,0
0,1598,71587,3578768932,3578768932,0
0,1598,71588,3578768932,3578768932,0
0,1598,71589,3578768932,3578768932,0
0,1598,71590,3578768932,3578768932,0
0,1598,71591,3578768932,3578768932,0
0,1598,71592,3578768932,3578768932,0
0,1598,71593,3578768932,3578768932,0
0,1598,71594,3578768932,3578768932,0
0,1598,71595,3578768932,3578768932,0
0,1598,71596,3578768932,3578768932,0
0,1598,71597,3578768932,3578768932,0
0,1598,71598,3578768932,3578768932,0
0,1598,71599,3578768932,3578768932,0
0,1598,71600,3578768932,3578768932,0
0,1598,71601,3578768932,3578768932,0
0,1598,71602,3578768932,3578768932,0
0,1598,71603,3578768932,3578768932,0
0,1598,71604,3578768932,3578768932,0
0,1598,71605,3578768932,3578768932,0
0,1598,71606,3578768932,3578768932,0
0,1598,71607,3578768932,3578768932,0
0,1598,71608,3578768932,3578768932,0
0,1598,71609,3578768932,3578768932,0
0,1598,71610,3578768932,3578768932,0
0,1598,71611,3578768932,3578768932,0
0,1598,71612,3578768932,3578768932,0
0,1598,71613,3578768932,3578768932,0
0,1598,71614,3578768932,3578768932,0
0,1598,71615,3578768932,3578768932,0
0,1598,71616,3578768932,3578768932,0
0,1598,71617,3578768932,3578768932,0
0,1598,71618,3578768932,3578768932,0
0,1598,71619,3578768932,3578768932,0
0,1598,71620,3578768932,3578768932,0
0,1598,71621,3578768932,3578768933,1
0,1598,71622,3578768932,3578768933,1
0,1598,71623,3578768932,3578768934,2
0,1598,71624,3578768932,3578768935,3
0,1598,71625,3578768932,3578768935,3
0,1598,71626,3578768932,3578768936,4
0,1598,71627,3578768932,3578768936,4
0,1598,71628,3578768932,3578768937,5
0,1598,71629,3578768932,3578768937,5
0,1598,71630,3578768932,3578768938,6
0,1598,71631,3578768932,3578768938,6
0,1598,71632,3578768932,3578768939,7
0,1598,71633,3578768932,3578768940,8
0,1598,71634,3578768932,3578768940,8
0,1598,71635,3578768932,3578768941,9
0,1598,71636,3578768932,3578768943,11
0,1598,71637,3578768932,3578768943,11
0,1598,71638,3578768932,3578768943,11
0,1598,71639,3578768932,3578768944,12
0,1598,71640,3578768932,3578768944,12
0,1598,71641,3578768932,3578768946,14
0,1598,71642,3578768932,3578768946,14
0,1598,71643,3578768932,3578768947,15
0,1598,71644,3578768932,3578768947,15
0,1598,71645,3578768932,3578768947,15
0,1598,71646,3578768932,3578768947,15
0,1598,71647,3578768932,3578768948,16
0,1598,71648,3578768932,3578768948,16
0,1598,71649,3578768932,3578768949,17
0,1598,71650,3578768932,3578768949,17
0,1598,71651,3578768932,3578768949,17
0,1598,71652,3578768932,3578768950,18
0,1598,71653,3578768932,3578768951,19
0,1598,71654,3578768932,3578768951,19
0,1598,71655,3578768932,3578768952,20
0,1598,71656,3578768932,3578768952,20
0,1598,71657,3578768932,3578768952,20
0,1598,71658,3578768932,3578768953,21
0,1598,71659,3578768932,3578768955,23
0,1598,71660,3578768932,3578768956,24
0,1598,71661,3578768932,3578768957,25
0,1598,71662,3578768932,3578768958,26
0,1598,71663,3578768932,3578768958,26
0,1598,71664,3578768932,3578768959,27
0,1598,71665,3578768932,3578768959,27
0,1598,71666,3578768932,3578768960,28
0,1598,71667,3578768932,3578768960,28
0,1598,71668,3578768932,3578768961,29
0,1598,71669,3578768932,3578768961,29
0,1598,71670,3578768932,3578768961,29
0,1598,71671,3578768932,3578768961,29
0,1598,71672,3578768932,3578768962,30
0,1598,71673,3578768932,3578768962,30
0,1598,71674,3578768932,3578768962,30
0,1598,71675,3578768932,3578768963,31
0,1598,71676,3578768932,3578768963,31
0,1598,71677,3578768932,3578768963,31
0,1598,71678,3578768932,3578768964,32
0,1598,71679,3578768932,3578768965,33
0,1598,71680,3578768932,3578768965,33
0,1598,71681,3578768932,3578768969,37
0,1598,71682,3578768932,3578768970,38
0,1598,71683,3578768932,3578768970,38
0,1598,71684,3578768932,3578768970,38
0,1598,71685,3578768932,3578768970,38
0,1598,71686,3578768932,3578768971,39
0,1598,71687,3578768932,3578768972,40
0,1598,71688,3578768932,3578768972,40
0,1598,71689,3578768932,3578768973,41
0,1598,71690,3578768932,3578768973,41
0,1598,71691,3578768932,3578768973,41
0,1598,71692,3578768932,3578768974,42
0,1598,71693,3578768932,3578768975,43
0,1598,71694,3578768932,3578768976,44
0,1598,71695,3578768932,3578768977,45
0,1598,71696,3578768932,3578768978,46
0,1598,71697,3578768932,3578768978,46
0,1598,71698,3578768932,3578768978,46
0,1598,71699,3578768932,3578768978,46
0,1598,71700,3578768932,3578768978,46
0,1598,71701,3578768932,3578768979,47
0,1598,71702,3578768932,3578768979,47
0,1598,71703,3578768932,3578768981,49
0,1598,71704,3578768932,3578768981,49
0,1599,71705,3578768997,3578768997,0
0,1599,71706,3578768997,3578768997,0
0,1599,71707,3578768997,3578768997,0
0,1599,71708,3578768997,3578768997,0
0,1599,71709,3578768997,3578768997,0
0,1599,71710,3578768997,3578768997,0
0,1599,71711,3578768997,3578768997,0
0,1599,71712,3578768997,3578768997,0
0,1599,71713,3578768997,3578768997,0
0,1599,71714,3578768997,3578768997,0
0,1599,71715,3578768997,3578768997,0
0,1599,71716,3578768997,3578768997,0
0,1599,71717,3578768997,3578768997,0
0,1599,71718,3578768997,3578768997,0
0,1599,71719,3578768997,3578768997,0
0,1599,71720,3578768997,3578768997,0
0,1599,71721,3578768997,3578768997,0
0,1599,71722,3578768997,3578768997,0
0,1599,71723,3578768997,3578768997,0
0,1599,71724,3578768997,3578768997,0
0,1599,71725,3578768997,3578768997,0
0,1599,71726,3578768997,3578768997,0
0,1599,71727,3578768997,3578768998,1
0,1599,71728,3578768997,3578768998,1
0,1599,71729,3578768997,3578768999,2
0,1599,71730,3578768997,3578769001,4
0,1599,71731,3578768997,3578769002,5
0,1599,71732,3578768997,3578769003,6
0,1599,71733,3578768997,3578769004,7
0,1599,71734,3578768997,3578769004,7
0,1599,71735,3578768997,3578769006,9
0,1599,71736,3578768997,3578769006,9
0,1599,71737,3578768997,3578769006,9
0,1599,71738,3578768997,3578769006,9
0,1599,71739,3578768997,3578769007,10
0,1599,71740,3578768997,3578769008,11
0,1599,71741,3578768997,3578769009,12
0,1599,71742,3578768997,3578769009,12
0,1599,71743,3578768997,3578769012,15
0,1599,71744,3578768997,3578769013,16
0,1599,71745,3578768997,3578769015,18
0,1599,71746,3578768997,3578769015,18
0,1599,71747,3578768997,3578769015,18
0,1599,71748,3578768997,3578769015,18
0,1599,71749,3578768997,3578769015,18
0,1599,71750,3578768997,3578769015,18
0,1599,71751,3578768997,3578769016,19
0,1599,71752,3578768997,3578769017,20
0,1599,71753,3578768997,3578769017,20
0,1599,71754,3578768997,3578769018,21
0,1599,71755,3578768997,3578769018,21
0,1599,71756,3578768997,3578769018,21
0,1599,71757,3578768997,3578769018,21
0,1599,71758,3578768997,3578769019,22
0,1599,71759,3578768997,3578769019,22
0,1599,71760,3578768997,3578769020,23
0,1599,71761,3578768997,3578769021,24
0,1599,71762,3578768997,3578769022,25
0,1599,71763,3578768997,3578769022,25
0,1599,71764,3578768997,3578769023,26
0,1599,71765,3578768997,3578769025,28
0,1599,71766,3578768997,3578769026,29
0,1599,71767,3578768997,3578769026,29
0,1599,71768,3578768997,3578769026,29
0,1599,71769,3578768997,3578769027,30
0,1599,71770,3578768997,3578769028,31
0,1599,71771,3578768997,3578769030,33
0,1599,71772,3578768997,3578769030,33
0,1599,71773,3578768997,3578769030,33
0,1599,71774,3578768997,3578769032,35
0,1599,71775,3578768997,3578769032,35
0,1599,71776,3578768997,3578769032,35
0,1599,71777,3578768997,3578769033,36
0,1599,71778,3578768997,3578769034,37
0,1599,71779,3578768997,3578769035,38
0,1599,71780,3578768997,3578769035,38
0,1599,71781,3578768997,3578769036,39
0,1599,71782,3578768997,3578769036,39
0,1599,71783,3578768997,3578769037,40
0,1599,71784,3578768997,3578769038,41
0,1599,71785,3578768997,3578769038,41
0,1599,71786,3578768997,3578769039,42
0,1599,71787,3578768997,3578769039,42
0,1599,71788,3578768997,3578769040,43
0,1599,71789,3578768997,3578769040,43
0,1599,71790,3578768997,3578769041,44
0,1599,71791,3578768997,3578769041,44
0,1599,71792,3578768997,3578769042,45
0,1599,71793,3578768997,3578769043,46
0,1599,71794,3578768997,3578769043,46
0,1599,71795,3578768997,3578769043,46
0,1599,71796,3578768997,3578769043,46
0,1599,71797,3578768997,3578769044,47
0,1600,71798,3578769062,3578769062,0
0,1600,71799,3578769062,3578769062,0
0,1600,71800,3578769062,3578769062,0
0,1600,71801,3578769062,3578769062,0
0,1600,71802,3578769062,3578769062,0
0,1600,71803,3578769062,3578769062,0
0,1600,71804,3578769062,3578769062,0
0,1600,71805,3578769062,3578769062,0
0,1600,71806,3578769062,3578769062,0
0,1600,71807,3578769062,3578769062,0
0,1600,71808,3578769062,3578769062,0
0,1600,71809,3578769062,3578769062,0
0,1600,71810,3578769062,3578769062,0
0,1600,71811,3578769062,3578769062,0
0,1600,71812,3578769062,3578769062,0
0,1600,71813,3578769062,3578769062,0
0,1600,71814,3578769062,3578769062,0
0,1600,71815,3578769062,3578769062,0
0,1600,71816,3578769062,3578769062,0
0,1600,71817,3578769062,3578769063,1
0,1600,71818,3578769062,3578769063,1
0,1600,71819,3578769062,3578769064,2
0,1600,71820,3578769062,3578769065,3
0,1600,71821,3578769062,3578769065,3
0,1600,71822,3578769062,3578769065,3
0,1600,71823,3578769062,3578769066,4
0,1600,71824,3578769062,3578769067,5
0,1600,71825,3578769062,3578769068,6
0,1600,71826,3578769062,3578769068,6
0,1600,71827,3578769062,3578769073,11
0,1600,71828,3578769062,3578769084,22
0,1600,71829,3578769062,3578769087,25
0,1600,71830,3578769062,3578769087,25
0,1600,71831,3578769062,3578769088,26
0,1600,71832,3578769062,3578769088,26
0,1600,71833,3578769062,3578769089,27
0,1600,71834,3578769062,3578769089,27
0,1600,71835,3578769062,3578769089,27
0,1600,71836,3578769062,3578769090,28
0,1600,71837,3578769062,3578769090,28
0,1600,71838,3578769062,3578769091,29
0,1600,71839,3578769062,3578769092,30
0,1600,71840,3578769062,3578769092,30
0,1600,71841,3578769062,3578769093,31
0,1600,71842,3578769062,3578769093,31
0,1600,71843,3578769062,3578769093,31
0,1600,71844,3578769062,3578769093,31
0,1600,71845,3578769062,3578769094,32
0,1600,71846,3578769062,3578769094,32
0,1600,71847,3578769062,3578769094,32
0,1600,71848,3578769062,3578769094,32
0,1600,71849,3578769062,3578769094,32
0,1600,71850,3578769062,3578769096,34
0,1600,71851,3578769062,3578769096,34
0,1600,71852,3578769062,3578769096,34
0,1600,71853,3578769062,3578769096,34
0,1600,71854,3578769062,3578769098,36
0,1600,71855,3578769062,3578769098,36
0,1600,71856,3578769062,3578769098,36
0,1600,71857,3578769062,3578769098,36
0,1600,71858,3578769062,3578769099,37
0,1600,71859,3578769062,3578769100,38
0,1600,71860,3578769062,3578769102,40
0,1600,71861,3578769062,3578769102,40
0,1600,71862,3578769062,3578769102,40
0,1600,71863,3578769062,3578769103,41
0,1600,71864,3578769062,3578769103,41
0,1600,71865,3578769062,3578769103,41
0,1600,71866,3578769062,3578769105,43
0,1600,71867,3578769062,3578769105,43
0,1600,71868,3578769062,3578769105,43
0,1600,71869,3578769062,3578769106,44
0,1600,71870,3578769062,3578769106,44
0,1600,71871,3578769062,3578769106,44
0,1600,71872,3578769062,3578769107,45
0,1600,71873,3578769062,3578769107,45
0,1600,71874,3578769062,3578769107,45
0,1600,71875,3578769062,3578769107,45
0,1600,71876,3578769062,3578769108,46
0,1600,71877,3578769062,3578769108,46
0,1600,71878,3578769062,3578769108,46
0,1600,71879,3578769062,3578769109,47
0,1600,71880,3578769062,3578769109,47
0,1600,71881,3578769062,3578769109,47
0,1600,71882,3578769062,3578769110,48
0,1600,71883,3578769062,3578769110,48
0,1600,71884,3578769062,3578769111,49
0,1600,71885,3578769062,3578769111,49
0,1600,71886,3578769062,3578769112,50
0,1601,71887,3578769128,3578769128,0
0,1601,71888,3578769128,3578769128,0
0,1601,71889,3578769128,3578769128,0
0,1601,71890,3578769128,3578769128,0
0,1601,71891,3578769128,3578769128,0
0,1601,71892,3578769128,3578769128,0
0,1601,71893,3578769128,3578769128,0
0,1601,71894,3578769128,3578769128,0
0,1601,71895,3578769128,3578769128,0
0,1601,71896,3578769128,3578769128,0
0,1601,71897,3578769128,3578769128,0
0,1601,71898,3578769128,3578769128,0
0,1601,71899,3578769128,3578769128,0
0,1601,71900,3578769128,3578769128,0
0,1601,71901,3578769128,3578769128,0
0,1601,71902,3578769128,3578769128,0
0,1601,71903,3578769128,3578769128,0
0,1601,71904,3578769128,3578769128,0
0,1601,71905,3578769128,3578769128,0
0,1601,71906,3578769128,3578769128,0
0,1601,71907,3578769128,3578769128,0
0,1601,71908,3578769128,3578769128,0
0,1601,71909,3578769128,3578769128,0
0,1601,71910,3578769128,3578769128,0
0,1601,71911,3578769128,3578769128,0
0,1601,71912,3578769128,3578769128,0
0,1601,71913,3578769128,3578769128,0
0,1601,71914,3578769128,3578769128,0
0,1601,71915,3578769128,3578769128,0
0,1601,71916,3578769128,3578769128,0
0,1601,71917,3578769128,3578769128,0
0,1601,71918,3578769128,3578769128,0
0,1601,71919,3578769128,3578769128,0
0,1601,71920,3578769128,3578769128,0
0,1601,71921,3578769128,3578769128,0
0,1601,71922,3578769128,3578769128,0
0,1601,71923,3578769128,3578769129,1
0,1601,71924,3578769128,3578769129,1
0,1601,71925,3578769128,3578769130,2
0,1601,71926,3578769128,3578769130,2
0,1601,71927,3578769128,3578769130,2
0,1601,71928,3578769128,3578769130,2
0,1601,71929,3578769128,3578769131,3
0,1601,71930,3578769128,3578769131,3
0,1601,71931,3578769128,3578769131,3
0,1601,71932,3578769128,3578769131,3
0,1601,71933,3578769128,3578769131,3
0,1601,71934,3578769128,3578769131,3
0,1601,71935,3578769128,3578769132,4
0,1601,71936,3578769128,3578769132,4
0,1601,71937,3578769128,3578769132,4
0,1601,71938,3578769128,3578769132,4
0,1601,71939,3578769128,3578769134,6
0,1601,71940,3578769128,3578769135,7
0,1601,71941,3578769128,3578769135,7
0,1601,71942,3578769128,3578769135,7
0,1601,71943,3578769128,3578769136,8
0,1601,71944,3578769128,3578769136,8
0,1601,71945,3578769128,3578769137,9
0,1601,71946,3578769128,3578769137,9
0,1601,71947,3578769128,3578769139,11
0,1601,71948,3578769128,3578769140,12
0,1601,71949,3578769128,3578769141,13
0,1601,71950,3578769128,3578769141,13
0,1601,71951,3578769128,3578769141,13
0,1601,71952,3578769128,3578769143,15
0,1601,71953,3578769128,3578769143,15
0,1601,71954,3578769128,3578769143,15
0,1601,71955,3578769128,3578769144,16
0,1601,71956,3578769128,3578769144,16
0,1601,71957,3578769128,3578769144,16
0,1601,71958,3578769128,3578769146,18
0,1601,71959,3578769128,3578769146,18
0,1601,71960,3578769128,3578769147,19
0,1601,71961,3578769128,3578769147,19
0,1601,71962,3578769128,3578769148,20
0,1601,71963,3578769128,3578769148,20
0,1601,71964,3578769128,3578769148,20
0,1601,71965,3578769128,3578769148,20
0,1601,71966,3578769128,3578769148,20
0,1601,71967,3578769128,3578769148,20
0,1601,71968,3578769128,3578769150,22
0,1601,71969,3578769128,3578769151,23
0,1601,71970,3578769128,3578769151,23
0,1601,71971,3578769128,3578769152,24
0,1601,71972,3578769128,3578769152,24
0,1601,71973,3578769128,3578769152,24
0,1601,71974,3578769128,3578769153,25
0,1601,71975,3578769128,3578769153,25
0,1601,71976,3578769128,3578769154,26
0,1601,71977,3578769128,3578769156,28
0,1601,71978,3578769128,3578769157,29
0,1601,71979,3578769128,3578769157,29
0,1601,71980,3578769128,3578769158,30
0,1601,71981,3578769128,3578769158,30
0,1601,71982,3578769128,3578769159,31
0,1601,71983,3578769128,3578769159,31
0,1601,71984,3578769128,3578769160,32
0,1601,71985,3578769128,3578769160,32
0,1601,71986,3578769128,3578769161,33
0,1601,71987,3578769128,3578769161,33
0,1601,71988,3578769128,3578769161,33
0,1601,71989,3578769128,3578769162,34
0,1601,71990,3578769128,3578769162,34
0,1601,71991,3578769128,3578769162,34
0,1601,71992,3578769128,3578769162,34
0,1601,71993,3578769128,3578769163,35
0,1601,71994,3578769128,3578769163,35
0,1601,71995,3578769128,3578769163,35
0,1601,71996,3578769128,3578769165,37
0,1601,71997,3578769128,3578769165,37
0,1601,71998,3578769128,3578769166,38
0,1601,71999,3578769128,3578769167,39
0,1601,72000,3578769128,3578769170,42
0,1601,72001,3578769128,3578769170,42
0,1601,72002,3578769128,3578769170,42
0,1601,72003,3578769128,3578769170,42
0,1601,72004,3578769128,3578769171,43
0,1601,72005,3578769128,3578769171,43
0,1601,72006,3578769128,3578769172,44
0,1601,72007,3578769128,3578769173,45
0,1601,72008,3578769128,3578769173,45
0,1601,72009,3578769128,3578769174,46
0,1601,72010,3578769128,3578769175,47
0,1601,72011,3578769128,3578769175,47
0,1601,72012,3578769128,3578769175,47
0,1601,72013,3578769128,3578769176,48
0,1601,72014,3578769128,3578769176,48
0,1601,72015,3578769128,3578769178,50
0,1602,72016,3578769193,3578769193,0
0,1602,72017,3578769193,3578769193,0
0,1602,72018,3578769193,3578769193,0
0,1602,72019,3578769193,3578769193,0
0,1602,72020,3578769193,3578769193,0
0,1602,72021,3578769193,3578769193,0
0,1602,72022,3578769193,3578769193,0
0,1602,72023,3578769193,3578769193,0
0,1602,72024,3578769193,3578769193,0
0,1602,72025,3578769193,3578769193,0
0,1602,72026,3578769193,3578769193,0
0,1602,72027,3578769193,3578769193,0
0,1602,72028,3578769193,3578769193,0
0,1602,72029,3578769193,3578769193,0
0,1602,72030,3578769193,3578769193,0
0,1602,72031,3578769193,3578769193,0
0,1602,72032,3578769193,3578769193,0
0,1602,72033,3578769193,3578769193,0
0,1602,72034,3578769193,3578769193,0
0,1602,72035,3578769193,3578769193,0
0,1602,72036,3578769193,3578769193,0
0,1602,72037,3578769193,3578769193,0
0,1602,72038,3578769193,3578769193,0
0,1602,72039,3578769193,3578769193,0
0,1602,72040,3578769193,3578769195,2
0,1602,72041,3578769193,3578769196,3
0,1602,72042,3578769193,3578769196,3
0,1602,72043,3578769193,3578769197,4
0,1602,72044,3578769193,3578769197,4
0,1602,72045,3578769193,3578769198,5
0,1602,72046,3578769193,3578769199,6
0,1602,72047,3578769193,3578769199,6
0,1602,72048,3578769193,3578769201,8
0,1602,72049,3578769193,3578769202,9
0,1602,72050,3578769193,3578769204,11
0,1602,72051,3578769193,3578769204,11
0,1602,72052,3578769193,3578769204,11
0,1602,72053,3578769193,3578769205,12
0,1602,72054,3578769193,3578769205,12
0,1602,72055,3578769193,3578769206,13
0,1602,72056,3578769193,3578769207,14
0,1602,72057,3578769193,3578769207,14
0,1602,72058,3578769193,3578769209,16
0,1602,72059,3578769193,3578769209,16
0,1602,72060,3578769193,3578769212,19
0,1602,72061,3578769193,3578769214,21
0,1602,72062,3578769193,3578769214,21
0,1602,72063,3578769193,3578769214,21
0,1602,72064,3578769193,3578769215,22
0,1602,72065,3578769193,3578769215,22
0,1602,72066,3578769193,3578769215,22
0,1602,72067,3578769193,3578769218,25
0,1602,72068,3578769193,3578769218,25
0,1602,72069,3578769193,3578769218,25
0,1602,72070,3578769193,3578769218,25
0,1602,72071,3578769193,3578769219,26
0,1602,72072,3578769193,3578769219,26
0,1602,72073,3578769193,3578769220,27
0,1602,72074,3578769193,3578769220,27
0,1602,72075,3578769193,3578769221,28
0,1602,72076,3578769193,3578769222,29
0,1602,72077,3578769193,3578769224,31
0,1602,72078,3578769193,3578769224,31
0,1602,72079,3578769193,3578769224,31
0,1602,72080,3578769193,3578769226,33
0,1602,72081,3578769193,3578769226,33
0,1602,72082,3578769193,3578769227,34
0,1602,72083,3578769193,3578769227,34
0,1602,72084,3578769193,3578769229,36
0,1602,72085,3578769193,3578769230,37
0,1602,72086,3578769193,3578769230,37
0,1602,72087,3578769193,3578769230,37
0,1602,72088,3578769193,3578769231,38
0,1602,72089,3578769193,3578769232,39
0,1602,72090,3578769193,3578769232,39
0,1602,72091,3578769193,3578769233,40
0,1602,72092,3578769193,3578769235,42
0,1602,72093,3578769193,3578769236,43
0,1602,72094,3578769193,3578769238,45
0,1602,72095,3578769193,3578769238,45
0,1602,72096,3578769193,3578769238,45
0,1602,72097,3578769193,3578769238,45
0,1602,72098,3578769193,3578769239,46
0,1602,72099,3578769193,3578769239,46
0,1602,72100,3578769193,3578769240,47
0,1602,72101,3578769193,3578769240,47
0,1602,72102,3578769193,3578769240,47
0,1602,72103,3578769193,3578769241,48
0,1602,72104,3578769193,3578769243,50
0,1602,72105,3578769193,3578769243,50
0,1603,72106,3578769257,3578769257,0
0,1603,72107,3578769257,3578769257,0
0,1603,72108,3578769257,3578769257,0
0,1603,72109,3578769257,3578769257,0
0,1603,72110,3578769257,3578769257,0
0,1603,72111,3578769257,3578769257,0
0,1603,72112,3578769257,3578769258,1
0,1603,72113,3578769257,3578769258,1
0,1603,72114,3578769257,3578769258,1
0,1603,72115,3578769257,3578769258,1
0,1603,72116,3578769257,3578769258,1
0,1603,72117,3578769257,3578769258,1
0,1603,72118,3578769257,3578769258,1
0,1603,72119,3578769257,3578769258,1
0,1603,72120,3578769257,3578769258,1
0,1603,72121,3578769257,3578769258,1
0,1603,72122,3578769257,3578769258,1
0,1603,72123,3578769257,3578769258,1
0,1603,72124,3578769257,3578769258,1
0,1603,72125,3578769257,3578769258,1
0,1603,72126,3578769257,3578769258,1
0,1603,72127,3578769257,3578769258,1
0,1603,72128,3578769257,3578769259,2
0,1603,72129,3578769257,3578769259,2
0,1603,72130,3578769257,3578769259,2
0,1603,72131,3578769257,3578769260,3
0,1603,72132,3578769257,3578769261,4
0,1603,72133,3578769257,3578769262,5
0,1603,72134,3578769257,3578769262,5
0,1603,72135,3578769257,3578769263,6
0,1603,72136,3578769257,3578769263,6
0,1603,72137,3578769257,3578769264,7
0,1603,72138,3578769257,3578769264,7
0,1603,72139,3578769257,3578769264,7
0,1603,72140,3578769257,3578769265,8
0,1603,72141,3578769257,3578769265,8
0,1603,72142,3578769257,3578769266,9
0,1603,72143,3578769257,3578769267,10
0,1603,72144,3578769257,3578769267,10
0,1603,72145,3578769257,3578769268,11
0,1603,72146,3578769257,3578769275,18
0,1603,72147,3578769257,3578769287,30
0,1603,72148,3578769257,3578769287,30
0,1603,72149,3578769257,3578769288,31
0,1603,72150,3578769257,3578769288,31
0,1603,72151,3578769257,3578769288,31
0,1603,72152,3578769257,3578769288,31
0,1603,72153,3578769257,3578769289,32
0,1603,72154,3578769257,3578769289,32
0,1603,72155,3578769257,3578769290,33
0,1603,72156,3578769257,3578769290,33
0,1603,72157,3578769257,3578769292,35
0,1603,72158,3578769257,3578769292,35
0,1603,72159,3578769257,3578769292,35
0,1603,72160,3578769257,3578769292,35
0,1603,72161,3578769257,3578769293,36
0,1603,72162,3578769257,3578769293,36
0,1603,72163,3578769257,3578769294,37
0,1603,72164,3578769257,3578769294,37
0,1603,72165,3578769257,3578769294,37
0,1603,72166,3578769257,3578769294,37
0,1603,72167,3578769257,3578769294,37
0,1603,72168,3578769257,3578769294,37
0,1603,72169,3578769257,3578769294,37
0,1603,72170,3578769257,3578769294,37
0,1603,72171,3578769257,3578769295,38
0,1603,72172,3578769257,3578769296,39
0,1603,72173,3578769257,3578769296,39
0,1603,72174,3578769257,3578769298,41
0,1603,72175,3578769257,3578769298,41
0,1603,72176,3578769257,3578769299,42
0,1603,72177,3578769257,3578769299,42
0,1603,72178,3578769257,3578769300,43
0,1603,72179,3578769257,3578769301,44
0,1603,72180,3578769257,3578769302,45
0,1603,72181,3578769257,3578769302,45
0,1603,72182,3578769257,3578769303,46
0,1603,72183,3578769257,3578769304,47
0,1603,72184,3578769257,3578769304,47
0,1603,72185,3578769257,3578769305,48
0,1603,72186,3578769257,3578769305,48
0,1603,72187,3578769257,3578769305,48
0,1603,72188,3578769257,3578769306,49
0,1603,72189,3578769257,3578769306,49
0,1603,72190,3578769257,3578769307,50
0,1604,72191,3578769322,3578769322,0
0,1604,72192,3578769322,3578769322,0
0,1604,72193,3578769322,3578769322,0
0,1604,72194,3578769322,3578769322,0
0,1604,72195,3578769322,3578769322,0
0,1604,72196,3578769322,3578769322,0
0,1604,72197,3578769322,3578769322,0
0,1604,72198,3578769322,3578769322,0
0,1604,72199,3578769322,3578769322,0
0,1604,72200,3578769322,3578769322,0
0,1604,72201,3578769322,3578769322,0
0,1604,72202,3578769322,3578769322,0
0,1604,72203,3578769322,3578769322,0
0,1604,72204,3578769322,3578769322,0
0,1604,72205,3578769322,3578769322,0
0,1604,72206,3578769322,3578769322,0
0,1604,72207,3578769322,3578769322,0
0,1604,72208,3578769322,3578769322,0
0,1604,72209,3578769322,3578769322,0
0,1604,72210,3578769322,3578769322,0
0,1604,72211,3578769322,3578769322,0
0,1604,72212,3578769322,3578769322,0
0,1604,72213,3578769322,3578769322,0
0,1604,72214,3578769322,3578769322,0
0,1604,72215,3578769322,3578769322,0
0,1604,72216,3578769322,3578769322,0
0,1604,72217,3578769322,3578769322,0
0,1604,72218,3578769322,3578769322,0
0,1604,72219,3578769322,3578769322,0
0,1604,72220,3578769322,3578769322,0
0,1604,72221,3578769322,3578769322,0
0,1604,72222,3578769322,3578769322,0
0,1604,72223,3578769322,3578769322,0
0,1604,72224,3578769322,3578769322,0
0,1604,72225,3578769322,3578769322,0
0,1604,72226,3578769322,3578769322,0
0,1604,72227,3578769322,3578769322,0
0,1604,72228,3578769322,3578769323,1
0,1604,72229,3578769322,3578769323,1
0,1604,72230,3578769322,3578769323,1
0,1604,72231,3578769322,3578769324,2
0,1604,72232,3578769322,3578769325,3
0,1604,72233,3578769322,3578769325,3
0,1604,72234,3578769322,3578769325,3
0,1604,72235,3578769322,3578769325,3
0,1604,72236,3578769322,3578769327,5
0,1604,72237,3578769322,3578769327,5
0,1604,72238,3578769322,3578769328,6
0,1604,72239,3578769322,3578769328,6
0,1604,72240,3578769322,3578769328,6
0,1604,72241,3578769322,3578769328,6
0,1604,72242,3578769322,3578769329,7
0,1604,72243,3578769322,3578769329,7
0,1604,72244,3578769322,3578769329,7
0,1604,72245,3578769322,3578769330,8
0,1604,72246,3578769322,3578769331,9
0,1604,72247,3578769322,3578769331,9
0,1604,72248,3578769322,3578769331,9
0,1604,72249,3578769322,3578769331,9
0,1604,72250,3578769322,3578769331,9
0,1604,72251,3578769322,3578769331,9
0,1604,72252,3578769322,3578769331,9
0,1604,72253,3578769322,3578769332,10
0,1604,72254,3578769322,3578769332,10
0,1604,72255,3578769322,3578769332,10
0,1604,72256,3578769322,3578769332,10
0,1604,72257,3578769322,3578769334,12
0,1604,72258,3578769322,3578769335,13
0,1604,72259,3578769322,3578769335,13
0,1604,72260,3578769322,3578769335,13
0,1604,72261,3578769322,3578769336,14
0,1604,72262,3578769322,3578769337,15
0,1604,72263,3578769322,3578769337,15
0,1604,72264,3578769322,3578769339,17
0,1604,72265,3578769322,3578769339,17
0,1604,72266,3578769322,3578769339,17
0,1604,72267,3578769322,3578769340,18
0,1604,72268,3578769322,3578769340,18
0,1604,72269,3578769322,3578769341,19
0,1604,72270,3578769322,3578769341,19
0,1604,72271,3578769322,3578769341,19
0,1604,72272,3578769322,3578769343,21
0,1604,72273,3578769322,3578769343,21
0,1604,72274,3578769322,3578769344,22
0,1604,72275,3578769322,3578769344,22
0,1604,72276,3578769322,3578769344,22
0,1604,72277,3578769322,3578769345,23
0,1604,72278,3578769322,3578769346,24
0,1604,72279,3578769322,3578769346,24
0,1604,72280,3578769322,3578769347,25
0,1604,72281,3578769322,3578769347,25
0,1604,72282,3578769322,3578769348,26
0,1604,72283,3578769322,3578769348,26
0,1604,72284,3578769322,3578769348,26
0,1604,72285,3578769322,3578769348,26
0,1604,72286,3578769322,3578769348,26
0,1604,72287,3578769322,3578769349,27
0,1604,72288,3578769322,3578769350,28
0,1604,72289,3578769322,3578769351,29
0,1604,72290,3578769322,3578769351,29
0,1604,72291,3578769322,3578769352,30
0,1604,72292,3578769322,3578769353,31
0,1604,72293,3578769322,3578769353,31
0,1604,72294,3578769322,3578769353,31
0,1604,72295,3578769322,3578769354,32
0,1604,72296,3578769322,3578769355,33
0,1604,72297,3578769322,3578769356,34
0,1604,72298,3578769322,3578769356,34
0,1604,72299,3578769322,3578769357,35
0,1604,72300,3578769322,3578769357,35
0,1604,72301,3578769322,3578769358,36
0,1604,72302,3578769322,3578769358,36
0,1604,72303,3578769322,3578769359,37
0,1604,72304,3578769322,3578769359,37
0,1604,72305,3578769322,3578769360,38
0,1604,72306,3578769322,3578769360,38
0,1604,72307,3578769322,3578769360,38
0,1604,72308,3578769322,3578769361,39
0,1604,72309,3578769322,3578769361,39
0,1604,72310,3578769322,3578769361,39
0,1604,72311,3578769322,3578769361,39
0,1604,72312,3578769322,3578769361,39
0,1604,72313,3578769322,3578769362,40
0,1604,72314,3578769322,3578769363,41
0,1604,72315,3578769322,3578769363,41
0,1604,72316,3578769322,3578769363,41
0,1604,72317,3578769322,3578769365,43
0,1604,72318,3578769322,3578769365,43
0,1604,72319,3578769322,3578769366,44
0,1604,72320,3578769322,3578769367,45
0,1604,72321,3578769322,3578769369,47
0,1604,72322,3578769322,3578769370,48
0,1604,72323,3578769322,3578769371,49
0,1604,72324,3578769322,3578769372,50
0,1605,72325,3578769388,3578769388,0
0,1605,72326,3578769388,3578769388,0
0,1605,72327,3578769388,3578769388,0
0,1605,72328,3578769388,3578769388,0
0,1605,72329,3578769388,3578769388,0
0,1605,72330,3578769388,3578769388,0
0,1605,72331,3578769388,3578769388,0
0,1605,72332,3578769388,3578769388,0
0,1605,72333,3578769388,3578769388,0
0,1605,72334,3578769388,3578769388,0
0,1605,72335,3578769388,3578769388,0
0,1605,72336,3578769388,3578769388,0
0,1605,72337,3578769388,3578769388,0
0,1605,72338,3578769388,3578769388,0
0,1605,72339,3578769388,3578769388,0
0,1605,72340,3578769388,3578769388,0
0,1605,72341,3578769388,3578769388,0
0,1605,72342,3578769388,3578769388,0
0,1605,72343,3578769388,3578769388,0
0,1605,72344,3578769388,3578769388,0
0,1605,72345,3578769388,3578769388,0
0,1605,72346,3578769388,3578769388,0
0,1605,72347,3578769388,3578769388,0
0,1605,72348,3578769388,3578769388,0
0,1605,72349,3578769388,3578769388,0
0,1605,72350,3578769388,3578769389,1
0,1605,72351,3578769388,3578769389,1
0,1605,72352,3578769388,3578769389,1
0,1605,72353,3578769388,3578769390,2
0,1605,72354,3578769388,3578769390,2
0,1605,72355,3578769388,3578769391,3
0,1605,72356,3578769388,3578769391,3
0,1605,72357,3578769388,3578769392,4
0,1605,72358,3578769388,3578769392,4
0,1605,72359,3578769388,3578769393,5
0,1605,72360,3578769388,3578769394,6
0,1605,72361,3578769388,3578769396,8
0,1605,72362,3578769388,3578769396,8
0,1605,72363,3578769388,3578769396,8
0,1605,72364,3578769388,3578769396,8
0,1605,72365,3578769388,3578769398,10
0,1605,72366,3578769388,3578769398,10
0,1605,72367,3578769388,3578769399,11
0,1605,72368,3578769388,3578769399,11
0,1605,72369,3578769388,3578769399,11
0,1605,72370,3578769388,3578769401,13
0,1605,72371,3578769388,3578769402,14
0,1605,72372,3578769388,3578769404,16
0,1605,72373,3578769388,3578769405,17
0,1605,72374,3578769388,3578769405,17
0,1605,72375,3578769388,3578769405,17
0,1605,72376,3578769388,3578769406,18
0,1605,72377,3578769388,3578769408,20
0,1605,72378,3578769388,3578769409,21
0,1605,72379,3578769388,3578769409,21
0,1605,72380,3578769388,3578769412,24
0,1605,72381,3578769388,3578769413,25
0,1605,72382,3578769388,3578769415,27
0,1605,72383,3578769388,3578769415,27
0,1605,72384,3578769388,3578769415,27
0,1605,72385,3578769388,3578769416,28
0,1605,72386,3578769388,3578769417,29
0,1605,72387,3578769388,3578769418,30
0,1605,72388,3578769388,3578769418,30
0,1605,72389,3578769388,3578769419,31
0,1605,72390,3578769388,3578769419,31
0,1605,72391,3578769388,3578769419,31
0,1605,72392,3578769388,3578769419,31
0,1605,72393,3578769388,3578769419,31
0,1605,72394,3578769388,3578769420,32
0,1605,72395,3578769388,3578769421,33
0,1605,72396,3578769388,3578769422,34
0,1605,72397,3578769388,3578769422,34
0,1605,72398,3578769388,3578769423,35
0,1605,72399,3578769388,3578769424,36
0,1605,72400,3578769388,3578769425,37
0,1605,72401,3578769388,3578769425,37
0,1605,72402,3578769388,3578769426,38
0,1605,72403,3578769388,3578769426,38
0,1605,72404,3578769388,3578769428,40
0,1605,72405,3578769388,3578769429,41
0,1605,72406,3578769388,3578769429,41
0,1605,72407,3578769388,3578769429,41
0,1605,72408,3578769388,3578769429,41
0,1605,72409,3578769388,3578769429,41
0,1605,72410,3578769388,3578769431,43
0,1605,72411,3578769388,3578769431,43
0,1605,72412,3578769388,3578769432,44
0,1605,72413,3578769388,3578769433,45
0,1605,72414,3578769388,3578769434,46
0,1605,72415,3578769388,3578769435,47
0,1605,72416,3578769388,3578769435,47
0,1605,72417,3578769388,3578769436,48
0,1605,72418,3578769388,3578769436,48
0,1605,72419,3578769388,3578769437,49
0,1606,72420,3578769453,3578769453,0
0,1606,72421,3578769453,3578769453,0
0,1606,72422,3578769453,3578769453,0
0,1606,72423,3578769453,3578769453,0
0,1606,72424,3578769453,3578769453,0
0,1606,72425,3578769453,3578769453,0
0,1606,72426,3578769453,3578769453,0
0,1606,72427,3578769453,3578769453,0
0,1606,72428,3578769453,3578769453,0
0,1606,72429,3578769453,3578769453,0
0,1606,72430,3578769453,3578769453,0
0,1606,72431,3578769453,3578769453,0
0,1606,72432,3578769453,3578769453,0
0,1606,72433,3578769453,3578769453,0
0,1606,72434,3578769453,3578769453,0
0,1606,72435,3578769453,3578769453,0
0,1606,72436,3578769453,3578769453,0
0,1606,72437,3578769453,3578769453,0
0,1606,72438,3578769453,3578769453,0
0,1606,72439,3578769453,3578769453,0
0,1606,72440,3578769453,3578769453,0
0,1606,72441,3578769453,3578769453,0
0,1606,72442,3578769453,3578769453,0
0,1606,72443,3578769453,3578769453,0
0,1606,72444,3578769453,3578769453,0
0,1606,72445,3578769453,3578769453,0
0,1606,72446,3578769453,3578769455,2
0,1606,72447,3578769453,3578769456,3
0,1606,72448,3578769453,3578769456,3
0,1606,72449,3578769453,3578769457,4
0,1606,72450,3578769453,3578769459,6
0,1606,72451,3578769453,3578769459,6
0,1606,72452,3578769453,3578769459,6
0,1606,72453,3578769453,3578769460,7
0,1606,72454,3578769453,3578769461,8
0,1606,72455,3578769453,3578769462,9
0,1606,72456,3578769453,3578769462,9
0,1606,72457,3578769453,3578769463,10
0,1606,72458,3578769453,3578769463,10
0,1606,72459,3578769453,3578769464,11
0,1606,72460,3578769453,3578769464,11
0,1606,72461,3578769453,3578769465,12
0,1606,72462,3578769453,3578769465,12
0,1606,72463,3578769453,3578769465,12
0,1606,72464,3578769453,3578769467,14
0,1606,72465,3578769453,3578769467,14
0,1606,72466,3578769453,3578769468,15
0,1606,72467,3578769453,3578769469,16
0,1606,72468,3578769453,3578769476,23
0,1606,72469,3578769453,3578769486,33
0,1606,72470,3578769453,3578769487,34
0,1606,72471,3578769453,3578769487,34
0,1606,72472,3578769453,3578769488,35
0,1606,72473,3578769453,3578769488,35
0,1606,72474,3578769453,3578769489,36
0,1606,72475,3578769453,3578769489,36
0,1606,72476,3578769453,3578769490,37
0,1606,72477,3578769453,3578769490,37
0,1606,72478,3578769453,3578769492,39
0,1606,72479,3578769453,3578769492,39
0,1606,72480,3578769453,3578769492,39
0,1606,72481,3578769453,3578769492,39
0,1606,72482,3578769453,3578769494,41
0,1606,72483,3578769453,3578769494,41
0,1606,72484,3578769453,3578769494,41
0,1606,72485,3578769453,3578769494,41
0,1606,72486,3578769453,3578769494,41
0,1606,72487,3578769453,3578769494,41
0,1606,72488,3578769453,3578769494,41
0,1606,72489,3578769453,3578769494,41
0,1606,72490,3578769453,3578769495,42
0,1606,72491,3578769453,3578769495,42
0,1606,72492,3578769453,3578769495,42
0,1606,72493,3578769453,3578769496,43
0,1606,72494,3578769453,3578769496,43
0,1606,72495,3578769453,3578769498,45
0,1606,72496,3578769453,3578769498,45
0,1606,72497,3578769453,3578769499,46
0,1606,72498,3578769453,3578769499,46
0,1606,72499,3578769453,3578769499,46
0,1606,72500,3578769453,3578769499,46
0,1606,72501,3578769453,3578769500,47
0,1606,72502,3578769453,3578769501,48
0,1606,72503,3578769453,3578769502,49
0,1606,72504,3578769453,3578769502,49
0,1607,72505,3578769520,3578769520,0
0,1607,72506,3578769520,3578769520,0
0,1607,72507,3578769520,3578769520,0
0,1607,72508,3578769520,3578769520,0
0,1607,72509,3578769520,3578769520,0
0,1607,72510,3578769520,3578769520,0
0,1607,72511,3578769520,3578769520,0
0,1607,72512,3578769520,3578769520,0
0,1607,72513,3578769520,3578769520,0
0,1607,72514,3578769520,3578769520,0
0,1607,72515,3578769520,3578769520,0
0,1607,72516,3578769520,3578769520,0
0,1607,72517,3578769520,3578769520,0
0,1607,72518,3578769520,3578769520,0
0,1607,72519,3578769520,3578769520,0
0,1607,72520,3578769520,3578769520,0
0,1607,72521,3578769520,3578769520,0
0,1607,72522,3578769520,3578769520,0
0,1607,72523,3578769520,3578769521,1
0,1607,72524,3578769520,3578769521,1
0,1607,72525,3578769520,3578769521,1
0,1607,72526,3578769520,3578769521,1
0,1607,72527,3578769520,3578769521,1
0,1607,72528,3578769520,3578769521,1
0,1607,72529,3578769520,3578769521,1
0,1607,72530,3578769520,3578769521,1
0,1607,72531,3578769520,3578769521,1
0,1607,72532,3578769520,3578769521,1
0,1607,72533,3578769520,3578769521,1
0,1607,72534,3578769520,3578769521,1
0,1607,72535,3578769520,3578769521,1
0,1607,72536,3578769520,3578769521,1
0,1607,72537,3578769520,3578769521,1
0,1607,72538,3578769520,3578769521,1
0,1607,72539,3578769520,3578769521,1
0,1607,72540,3578769520,3578769521,1
0,1607,72541,3578769520,3578769521,1
0,1607,72542,3578769520,3578769521,1
0,1607,72543,3578769520,3578769521,1
0,1607,72544,3578769520,3578769521,1
0,1607,72545,3578769520,3578769521,1
0,1607,72546,3578769520,3578769521,1
0,1607,72547,3578769520,3578769521,1
0,1607,72548,3578769520,3578769522,2
0,1607,72549,3578769520,3578769522,2
0,1607,72550,3578769520,3578769523,3
0,1607,72551,3578769520,3578769524,4
0,1607,72552,3578769520,3578769524,4
0,1607,72553,3578769520,3578769524,4
0,1607,72554,3578769520,3578769526,6
0,1607,72555,3578769520,3578769527,7
0,1607,72556,3578769520,3578769527,7
0,1607,72557,3578769520,3578769527,7
0,1607,72558,3578769520,3578769527,7
0,1607,72559,3578769520,3578769527,7
0,1607,72560,3578769520,3578769528,8
0,1607,72561,3578769520,3578769528,8
0,1607,72562,3578769520,3578769529,9
0,1607,72563,3578769520,3578769530,10
0,1607,72564,3578769520,3578769530,10
0,1607,72565,3578769520,3578769530,10
0,1607,72566,3578769520,3578769530,10
0,1607,72567,3578769520,3578769530,10
0,1607,72568,3578769520,3578769530,10
0,1607,72569,3578769520,3578769531,11
0,1607,72570,3578769520,3578769531,11
0,1607,72571,3578769520,3578769531,11
0,1607,72572,3578769520,3578769531,11
0,1607,72573,3578769520,3578769532,12
0,1607,72574,3578769520,3578769532,12
0,1607,72575,3578769520,3578769533,13
0,1607,72576,3578769520,3578769534,14
0,1607,72577,3578769520,3578769535,15
0,1607,72578,3578769520,3578769536,16
0,1607,72579,3578769520,3578769536,16
0,1607,72580,3578769520,3578769536,16
0,1607,72581,3578769520,3578769537,17
0,1607,72582,3578769520,3578769537,17
0,1607,72583,3578769520,3578769538,18
0,1607,72584,3578769520,3578769539,19
0,1607,72585,3578769520,3578769539,19
0,1607,72586,3578769520,3578769539,19
0,1607,72587,3578769520,3578769539,19
0,1607,72588,3578769520,3578769539,19
0,1607,72589,3578769520,3578769540,20
0,1607,72590,3578769520,3578769541,21
0,1607,72591,3578769520,3578769542,22
0,1607,72592,3578769520,3578769542,22
0,1607,72593,3578769520,3578769543,23
0,1607,72594,3578769520,3578769544,24
0,1607,72595,3578769520,3578769545,25
0,1607,72596,3578769520,3578769545,25
0,1607,72597,3578769520,3578769546,26
0,1607,72598,3578769520,3578769546,26
0,1607,72599,3578769520,3578769546,26
0,1607,72600,3578769520,3578769547,27
0,1607,72601,3578769520,3578769547,27
0,1607,72602,3578769520,3578769548,28
0,1607,72603,3578769520,3578769548,28
0,1607,72604,3578769520,3578769550,30
0,1607,72605,3578769520,3578769551,31
0,1607,72606,3578769520,3578769551,31
0,1607,72607,3578769520,3578769552,32
0,1607,72608,3578769520,3578769552,32
0,1607,72609,3578769520,3578769552,32
0,1607,72610,3578769520,3578769553,33
0,1607,72611,3578769520,3578769553,33
0,1607,72612,3578769520,3578769555,35
0,1607,72613,3578769520,3578769556,36
0,1607,72614,3578769520,3578769557,37
0,1607,72615,3578769520,3578769558,38
0,1607,72616,3578769520,3578769558,38
0,1607,72617,3578769520,3578769558,38
0,1607,72618,3578769520,3578769559,39
0,1607,72619,3578769520,3578769560,40
0,1607,72620,3578769520,3578769560,40
0,1607,72621,3578769520,3578769560,40
0,1607,72622,3578769520,3578769560,40
0,1607,72623,3578769520,3578769561,41
0,1607,72624,3578769520,3578769561,41
0,1607,72625,3578769520,3578769561,41
0,1607,72626,3578769520,3578769562,42
0,1607,72627,3578769520,3578769562,42
0,1607,72628,3578769520,3578769563,43
0,1607,72629,3578769520,3578769564,44
0,1607,72630,3578769520,3578769565,45
0,1607,72631,3578769520,3578769569,49
0,1607,72632,3578769520,3578769569,49
0,1607,72633,3578769520,3578769570,50
0,1608,72634,3578769586,3578769586,0
0,1608,72635,3578769586,3578769586,0
0,1608,72636,3578769586,3578769586,0
0,1608,72637,3578769586,3578769586,0
0,1608,72638,3578769586,3578769586,0
0,1608,72639,3578769586,3578769586,0
0,1608,72640,3578769586,3578769586,0
0,1608,72641,3578769586,3578769586,0
0,1608,72642,3578769586,3578769586,0
0,1608,72643,3578769586,3578769586,0
0,1608,72644,3578769586,3578769586,0
0,1608,72645,3578769586,3578769586,0
0,1608,72646,3578769586,3578769586,0
0,1608,72647,3578769586,3578769586,0
0,1608,72648,3578769586,3578769586,0
0,1608,72649,3578769586,3578769586,0
0,1608,72650,3578769586,3578769586,0
0,1608,72651,3578769586,3578769586,0
0,1608,72652,3578769586,3578769586,0
0,1608,72653,3578769586,3578769586,0
0,1608,72654,3578769586,3578769586,0
0,1608,72655,3578769586,3578769586,0
0,1608,72656,3578769586,3578769586,0
0,1608,72657,3578769586,3578769586,0
0,1608,72658,3578769586,3578769586,0
0,1608,72659,3578769586,3578769586,0
0,1608,72660,3578769586,3578769586,0
0,1608,72661,3578769586,3578769586,0
0,1608,72662,3578769586,3578769586,0
0,1608,72663,3578769586,3578769586,0
0,1608,72664,3578769586,3578769588,2
0,1608,72665,3578769586,3578769588,2
0,1608,72666,3578769586,3578769588,2
0,1608,72667,3578769586,3578769589,3
0,1608,72668,3578769586,3578769589,3
0,1608,72669,3578769586,3578769590,4
0,1608,72670,3578769586,3578769591,5
0,1608,72671,3578769586,3578769592,6
0,1608,72672,3578769586,3578769593,7
0,1608,72673,3578769586,3578769594,8
0,1608,72674,3578769586,3578769595,9
0,1608,72675,3578769586,3578769595,9
0,1608,72676,3578769586,3578769595,9
0,1608,72677,3578769586,3578769596,10
0,1608,72678,3578769586,3578769598,12
0,1608,72679,3578769586,3578769598,12
0,1608,72680,3578769586,3578769598,12
0,1608,72681,3578769586,3578769599,13
0,1608,72682,3578769586,3578769600,14
0,1608,72683,3578769586,3578769602,16
0,1608,72684,3578769586,3578769603,17
0,1608,72685,3578769586,3578769603,17
0,1608,72686,3578769586,3578769603,17
0,1608,72687,3578769586,3578769604,18
0,1608,72688,3578769586,3578769604,18
0,1608,72689,3578769586,3578769605,19
0,1608,72690,3578769586,3578769606,20
0,1608,72691,3578769586,3578769606,20
0,1608,72692,3578769586,3578769608,22
0,1608,72693,3578769586,3578769608,22
0,1608,72694,3578769586,3578769609,23
0,1608,72695,3578769586,3578769610,24
0,1608,72696,3578769586,3578769611,25
0,1608,72697,3578769586,3578769611,25
0,1608,72698,3578769586,3578769612,26
0,1608,72699,3578769586,3578769612,26
0,1608,72700,3578769586,3578769613,27
0,1608,72701,3578769586,3578769614,28
0,1608,72702,3578769586,3578769614,28
0,1608,72703,3578769586,3578769615,29
0,1608,72704,3578769586,3578769617,31
0,1608,72705,3578769586,3578769617,31
0,1608,72706,3578769586,3578769617,31
0,1608,72707,3578769586,3578769617,31
0,1608,72708,3578769586,3578769618,32
0,1608,72709,3578769586,3578769618,32
0,1608,72710,3578769586,3578769618,32
0,1608,72711,3578769586,3578769619,33
0,1608,72712,3578769586,3578769619,33
0,1608,72713,3578769586,3578769621,35
0,1608,72714,3578769586,3578769621,35
0,1608,72715,3578769586,3578769622,36
0,1608,72716,3578769586,3578769622,36
0,1608,72717,3578769586,3578769624,38
0,1608,72718,3578769586,3578769624,38
0,1608,72719,3578769586,3578769625,39
0,1608,72720,3578769586,3578769625,39
0,1608,72721,3578769586,3578769626,40
0,1608,72722,3578769586,3578769628,42
0,1608,72723,3578769586,3578769628,42
0,1608,72724,3578769586,3578769629,43
0,1608,72725,3578769586,3578769629,43
0,1608,72726,3578769586,3578769629,43
0,1608,72727,3578769586,3578769629,43
0,1608,72728,3578769586,3578769630,44
0,1608,72729,3578769586,3578769631,45
0,1608,72730,3578769586,3578769632,46
0,1608,72731,3578769586,3578769632,46
0,1608,72732,3578769586,3578769633,47
0,1608,72733,3578769586,3578769633,47
0,1608,72734,3578769586,3578769634,48
0,1608,72735,3578769586,3578769635,49
0,1608,72736,3578769586,3578769635,49
0,1608,72737,3578769586,3578769635,49
0,1609,72738,3578769650,3578769650,0
0,1609,72739,3578769650,3578769650,0
0,1609,72740,3578769650,3578769650,0
0,1609,72741,3578769650,3578769650,0
0,1609,72742,3578769650,3578769650,0
0,1609,72743,3578769650,3578769650,0
0,1609,72744,3578769650,3578769650,0
0,1609,72745,3578769650,3578769650,0
0,1609,72746,3578769650,3578769650,0
0,1609,72747,3578769650,3578769650,0
0,1609,72748,3578769650,3578769650,0
0,1609,72749,3578769650,3578769650,0
0,1609,72750,3578769650,3578769650,0
0,1609,72751,3578769650,3578769650,0
0,1609,72752,3578769650,3578769650,0
0,1609,72753,3578769650,3578769650,0
0,1609,72754,3578769650,3578769650,0
0,1609,72755,3578769650,3578769650,0
0,1609,72756,3578769650,3578769650,0
0,1609,72757,3578769650,3578769650,0
0,1609,72758,3578769650,3578769650,0
0,1609,72759,3578769650,3578769650,0
0,1609,72760,3578769650,3578769650,0
0,1609,72761,3578769650,3578769650,0
0,1609,72762,3578769650,3578769651,1
0,1609,72763,3578769650,3578769652,2
0,1609,72764,3578769650,3578769654,4
0,1609,72765,3578769650,3578769654,4
0,1609,72766,3578769650,3578769655,5
0,1609,72767,3578769650,3578769655,5
0,1609,72768,3578769650,3578769657,7
0,1609,72769,3578769650,3578769659,9
0,1609,72770,3578769650,3578769659,9
0,1609,72771,3578769650,3578769661,11
0,1609,72772,3578769650,3578769661,11
0,1609,72773,3578769650,3578769661,11
0,1609,72774,3578769650,3578769662,12
0,1609,72775,3578769650,3578769662,12
0,1609,72776,3578769650,3578769662,12
0,1609,72777,3578769650,3578769663,13
0,1609,72778,3578769650,3578769664,14
0,1609,72779,3578769650,3578769665,15
0,1609,72780,3578769650,3578769665,15
0,1609,72781,3578769650,3578769666,16
0,1609,72782,3578769650,3578769667,17
0,1609,72783,3578769650,3578769667,17
0,1609,72784,3578769650,3578769668,18
0,1609,72785,3578769650,3578769668,18
0,1609,72786,3578769650,3578769684,34
0,1609,72787,3578769650,3578769687,37
0,1609,72788,3578769650,3578769687,37
0,1609,72789,3578769650,3578769688,38
0,1609,72790,3578769650,3578769688,38
0,1609,72791,3578769650,3578769689,39
0,1609,72792,3578769650,3578769689,39
0,1609,72793,3578769650,3578769690,40
0,1609,72794,3578769650,3578769690,40
0,1609,72795,3578769650,3578769692,42
0,1609,72796,3578769650,3578769692,42
0,1609,72797,3578769650,3578769693,43
0,1609,72798,3578769650,3578769693,43
0,1609,72799,3578769650,3578769694,44
0,1609,72800,3578769650,3578769694,44
0,1609,72801,3578769650,3578769694,44
0,1609,72802,3578769650,3578769695,45
0,1609,72803,3578769650,3578769695,45
0,1609,72804,3578769650,3578769696,46
0,1609,72805,3578769650,3578769696,46
0,1609,72806,3578769650,3578769696,46
0,1609,72807,3578769650,3578769698,48
0,1609,72808,3578769650,3578769699,49
0,1609,72809,3578769650,3578769700,50
0,1610,72810,3578769716,3578769716,0
0,1610,72811,3578769716,3578769716,0
0,1610,72812,3578769716,3578769716,0
0,1610,72813,3578769716,3578769716,0
0,1610,72814,3578769716,3578769716,0
0,1610,72815,3578769716,3578769716,0
0,1610,72816,3578769716,3578769716,0
0,1610,72817,3578769716,3578769716,0
0,1610,72818,3578769716,3578769716,0
0,1610,72819,3578769716,3578769716,0
0,1610,72820,3578769716,3578769716,0
0,1610,72821,3578769716,3578769716,0
0,1610,72822,3578769716,3578769716,0
0,1610,72823,3578769716,3578769716,0
0,1610,72824,3578769716,3578769716,0
0,1610,72825,3578769716,3578769716,0
0,1610,72826,3578769716,3578769716,0
0,1610,72827,3578769716,3578769716,0
0,1610,72828,3578769716,3578769716,0
0,1610,72829,3578769716,3578769716,0
0,1610,72830,3578769716,3578769716,0
0,1610,72831,3578769716,3578769716,0
0,1610,72832,3578769716,3578769716,0
0,1610,72833,3578769716,3578769716,0
0,1610,72834,3578769716,3578769716,0
0,1610,72835,3578769716,3578769716,0
0,1610,72836,3578769716,3578769716,0
0,1610,72837,3578769716,3578769716,0
0,1610,72838,3578769716,3578769716,0
0,1610,72839,3578769716,3578769716,0
0,1610,72840,3578769716,3578769716,0
0,1610,72841,3578769716,3578769716,0
0,1610,72842,3578769716,3578769716,0
0,1610,72843,3578769716,3578769716,0
0,1610,72844,3578769716,3578769716,0
0,1610,72845,3578769716,3578769716,0
0,1610,72846,3578769716,3578769716,0
0,1610,72847,3578769716,3578769716,0
0,1610,72848,3578769716,3578769716,0
0,1610,72849,3578769716,3578769716,0
0,1610,72850,3578769716,3578769716,0
0,1610,72851,3578769716,3578769716,0
0,1610,72852,3578769716,3578769717,1
0,1610,72853,3578769716,3578769717,1
0,1610,72854,3578769716,3578769717,1
0,1610,72855,3578769716,3578769717,1
0,1610,72856,3578769716,3578769718,2
0,1610,72857,3578769716,3578769719,3
0,1610,72858,3578769716,3578769719,3
0,1610,72859,3578769716,3578769719,3
0,1610,72860,3578769716,3578769720,4
0,1610,72861,3578769716,3578769720,4
0,1610,72862,3578769716,3578769722,6
0,1610,72863,3578769716,3578769722,6
0,1610,72864,3578769716,3578769723,7
0,1610,72865,3578769716,3578769723,7
0,1610,72866,3578769716,3578769723,7
0,1610,72867,3578769716,3578769723,7
0,1610,72868,3578769716,3578769724,8
0,1610,72869,3578769716,3578769724,8
0,1610,72870,3578769716,3578769724,8
0,1610,72871,3578769716,3578769725,9
0,1610,72872,3578769716,3578769725,9
0,1610,72873,3578769716,3578769727,11
0,1610,72874,3578769716,3578769727,11
0,1610,72875,3578769716,3578769727,11
0,1610,72876,3578769716,3578769727,11
0,1610,72877,3578769716,3578769727,11
0,1610,72878,3578769716,3578769727,11
0,1610,72879,3578769716,3578769727,11
0,1610,72880,3578769716,3578769728,12
0,1610,72881,3578769716,3578769730,14
0,1610,72882,3578769716,3578769730,14
0,1610,72883,3578769716,3578769730,14
0,1610,72884,3578769716,3578769730,14
0,1610,72885,3578769716,3578769730,14
0,1610,72886,3578769716,3578769730,14
0,1610,72887,3578769716,3578769731,15
0,1610,72888,3578769716,3578769731,15
0,1610,72889,3578769716,3578769731,15
0,1610,72890,3578769716,3578769731,15
0,1610,72891,3578769716,3578769732,16
0,1610,72892,3578769716,3578769732,16
0,1610,72893,3578769716,3578769732,16
0,1610,72894,3578769716,3578769733,17
0,1610,72895,3578769716,3578769733,17
0,1610,72896,3578769716,3578769733,17
0,1610,72897,3578769716,3578769734,18
0,1610,72898,3578769716,3578769734,18
0,1610,72899,3578769716,3578769735,19
0,1610,72900,3578769716,3578769736,20
0,1610,72901,3578769716,3578769736,20
0,1610,72902,3578769716,3578769738,22
0,1610,72903,3578769716,3578769739,23
0,1610,72904,3578769716,3578769739,23
0,1610,72905,3578769716,3578769739,23
0,1610,72906,3578769716,3578769739,23
0,1610,72907,3578769716,3578769739,23
0,1610,72908,3578769716,3578769740,24
0,1610,72909,3578769716,3578769741,25
0,1610,72910,3578769716,3578769742,26
0,1610,72911,3578769716,3578769742,26
0,1610,72912,3578769716,3578769742,26
0,1610,72913,3578769716,3578769743,27
0,1610,72914,3578769716,3578769744,28
0,1610,72915,3578769716,3578769744,28
0,1610,72916,3578769716,3578769745,29
0,1610,72917,3578769716,3578769745,29
0,1610,72918,3578769716,3578769745,29
0,1610,72919,3578769716,3578769746,30
0,1610,72920,3578769716,3578769746,30
0,1610,72921,3578769716,3578769747,31
0,1610,72922,3578769716,3578769747,31
0,1610,72923,3578769716,3578769747,31
0,1610,72924,3578769716,3578769748,32
0,1610,72925,3578769716,3578769748,32
0,1610,72926,3578769716,3578769749,33
0,1610,72927,3578769716,3578769750,34
0,1610,72928,3578769716,3578769752,36
0,1610,72929,3578769716,3578769752,36
0,1610,72930,3578769716,3578769752,36
0,1610,72931,3578769716,3578769752,36
0,1610,72932,3578769716,3578769752,36
0,1610,72933,3578769716,3578769753,37
0,1610,72934,3578769716,3578769754,38
0,1610,72935,3578769716,3578769754,38
0,1610,72936,3578769716,3578769756,40
0,1610,72937,3578769716,3578769756,40
0,1610,72938,3578769716,3578769757,41
0,1610,72939,3578769716,3578769758,42
0,1610,72940,3578769716,3578769759,43
0,1610,72941,3578769716,3578769759,43
0,1610,72942,3578769716,3578769759,43
0,1610,72943,3578769716,3578769760,44
0,1610,72944,3578769716,3578769760,44
0,1610,72945,3578769716,3578769760,44
0,1610,72946,3578769716,3578769760,44
0,1610,72947,3578769716,3578769761,45
0,1610,72948,3578769716,3578769761,45
0,1610,72949,3578769716,3578769762,46
0,1610,72950,3578769716,3578769762,46
0,1610,72951,3578769716,3578769762,46
0,1610,72952,3578769716,3578769764,48
0,1610,72953,3578769716,3578769765,49
0,1611,72954,3578769781,3578769781,0
0,1611,72955,3578769781,3578769781,0
0,1611,72956,3578769781,3578769781,0
0,1611,72957,3578769781,3578769781,0
0,1611,72958,3578769781,3578769781,0
0,1611,72959,3578769781,3578769781,0
0,1611,72960,3578769781,3578769781,0
0,1611,72961,3578769781,3578769781,0
0,1611,72962,3578769781,3578769781,0
0,1611,72963,3578769781,3578769781,0
0,1611,72964,3578769781,3578769781,0
0,1611,72965,3578769781,3578769781,0
0,1611,72966,3578769781,3578769781,0
0,1611,72967,3578769781,3578769781,0
0,1611,72968,3578769781,3578769781,0
0,1611,72969,3578769781,3578769781,0
0,1611,72970,3578769781,3578769781,0
0,1611,72971,3578769781,3578769781,0
0,1611,72972,3578769781,3578769781,0
0,1611,72973,3578769781,3578769781,0
0,1611,72974,3578769781,3578769781,0
0,1611,72975,3578769781,3578769781,0
0,1611,72976,3578769781,3578769783,2
0,1611,72977,3578769781,3578769783,2
0,1611,72978,3578769781,3578769784,3
0,1611,72979,3578769781,3578769785,4
0,1611,72980,3578769781,3578769785,4
0,1611,72981,3578769781,3578769786,5
0,1611,72982,3578769781,3578769787,6
0,1611,72983,3578769781,3578769788,7
0,1611,72984,3578769781,3578769788,7
0,1611,72985,3578769781,3578769789,8
0,1611,72986,3578769781,3578769789,8
0,1611,72987,3578769781,3578769791,10
0,1611,72988,3578769781,3578769791,10
0,1611,72989,3578769781,3578769793,12
0,1611,72990,3578769781,3578769793,12
0,1611,72991,3578769781,3578769793,12
0,1611,72992,3578769781,3578769795,14
0,1611,72993,3578769781,3578769796,15
0,1611,72994,3578769781,3578769799,18
0,1611,72995,3578769781,3578769799,18
0,1611,72996,3578769781,3578769799,18
0,1611,72997,3578769781,3578769799,18
0,1611,72998,3578769781,3578769800,19
0,1611,72999,3578769781,3578769800,19
0,1611,73000,3578769781,3578769803,22
0,1611,73001,3578769781,3578769804,23
0,1611,73002,3578769781,3578769804,23
0,1611,73003,3578769781,3578769804,23
0,1611,73004,3578769781,3578769804,23
0,1611,73005,3578769781,3578769805,24
0,1611,73006,3578769781,3578769806,25
0,1611,73007,3578769781,3578769807,26
0,1611,73008,3578769781,3578769808,27
0,1611,73009,3578769781,3578769808,27
0,1611,73010,3578769781,3578769809,28
0,1611,73011,3578769781,3578769812,31
0,1611,73012,3578769781,3578769813,32
0,1611,73013,3578769781,3578769813,32
0,1611,73014,3578769781,3578769813,32
0,1611,73015,3578769781,3578769814,33
0,1611,73016,3578769781,3578769815,34
0,1611,73017,3578769781,3578769815,34
0,1611,73018,3578769781,3578769816,35
0,1611,73019,3578769781,3578769816,35
0,1611,73020,3578769781,3578769817,36
0,1611,73021,3578769781,3578769817,36
0,1611,73022,3578769781,3578769817,36
0,1611,73023,3578769781,3578769818,37
0,1611,73024,3578769781,3578769819,38
0,1611,73025,3578769781,3578769820,39
0,1611,73026,3578769781,3578769821,40
0,1611,73027,3578769781,3578769821,40
0,1611,73028,3578769781,3578769821,40
0,1611,73029,3578769781,3578769821,40
0,1611,73030,3578769781,3578769822,41
0,1611,73031,3578769781,3578769823,42
0,1611,73032,3578769781,3578769823,42
0,1611,73033,3578769781,3578769824,43
0,1611,73034,3578769781,3578769825,44
0,1611,73035,3578769781,3578769825,44
0,1611,73036,3578769781,3578769826,45
0,1611,73037,3578769781,3578769827,46
0,1611,73038,3578769781,3578769828,47
0,1611,73039,3578769781,3578769828,47
0,1611,73040,3578769781,3578769829,48
0,1611,73041,3578769781,3578769830,49
0,1611,73042,3578769781,3578769830,49
0,1612,73043,3578769847,3578769847,0
0,1612,73044,3578769847,3578769847,0
0,1612,73045,3578769847,3578769848,1
0,1612,73046,3578769847,3578769848,1
0,1612,73047,3578769847,3578769848,1
0,1612,73048,3578769847,3578769848,1
0,1612,73049,3578769847,3578769848,1
0,1612,73050,3578769847,3578769848,1
0,1612,73051,3578769847,3578769848,1
0,1612,73052,3578769847,3578769848,1
0,1612,73053,3578769847,3578769848,1
0,1612,73054,3578769847,3578769848,1
0,1612,73055,3578769847,3578769848,1
0,1612,73056,3578769847,3578769848,1
0,1612,73057,3578769847,3578769848,1
0,1612,73058,3578769847,3578769848,1
0,1612,73059,3578769847,3578769848,1
0,1612,73060,3578769847,3578769848,1
0,1612,73061,3578769847,3578769848,1
0,1612,73062,3578769847,3578769848,1
0,1612,73063,3578769847,3578769848,1
0,1612,73064,3578769847,3578769848,1
0,1612,73065,3578769847,3578769848,1
0,1612,73066,3578769847,3578769848,1
0,1612,73067,3578769847,3578769848,1
0,1612,73068,3578769847,3578769848,1
0,1612,73069,3578769847,3578769848,1
0,1612,73070,3578769847,3578769848,1
0,1612,73071,3578769847,3578769848,1
0,1612,73072,3578769847,3578769848,1
0,1612,73073,3578769847,3578769848,1
0,1612,73074,3578769847,3578769849,2
0,1612,73075,3578769847,3578769849,2
0,1612,73076,3578769847,3578769850,3
0,1612,73077,3578769847,3578769851,4
0,1612,73078,3578769847,3578769851,4
0,1612,73079,3578769847,3578769852,5
0,1612,73080,3578769847,3578769854,7
0,1612,73081,3578769847,3578769855,8
0,1612,73082,3578769847,3578769856,9
0,1612,73083,3578769847,3578769857,10
0,1612,73084,3578769847,3578769857,10
0,1612,73085,3578769847,3578769859,12
0,1612,73086,3578769847,3578769859,12
0,1612,73087,3578769847,3578769861,14
0,1612,73088,3578769847,3578769862,15
0,1612,73089,3578769847,3578769862,15
0,1612,73090,3578769847,3578769862,15
0,1612,73091,3578769847,3578769863,16
0,1612,73092,3578769847,3578769864,17
0,1612,73093,3578769847,3578769864,17
0,1612,73094,3578769847,3578769864,17
0,1612,73095,3578769847,3578769864,17
0,1612,73096,3578769847,3578769865,18
0,1612,73097,3578769847,3578769866,19
0,1612,73098,3578769847,3578769866,19
0,1612,73099,3578769847,3578769867,20
0,1612,73100,3578769847,3578769868,21
0,1612,73101,3578769847,3578769868,21
0,1612,73102,3578769847,3578769875,28
0,1612,73103,3578769847,3578769886,39
0,1612,73104,3578769847,3578769888,41
0,1612,73105,3578769847,3578769888,41
0,1612,73106,3578769847,3578769889,42
0,1612,73107,3578769847,3578769889,42
0,1612,73108,3578769847,3578769889,42
0,1612,73109,3578769847,3578769889,42
0,1612,73110,3578769847,3578769891,44
0,1612,73111,3578769847,3578769892,45
0,1612,73112,3578769847,3578769892,45
0,1612,73113,3578769847,3578769894,47
0,1612,73114,3578769847,3578769894,47
0,1612,73115,3578769847,3578769894,47
0,1612,73116,3578769847,3578769895,48
0,1612,73117,3578769847,3578769895,48
0,1612,73118,3578769847,3578769895,48
0,1612,73119,3578769847,3578769895,48
0,1612,73120,3578769847,3578769895,48
0,1612,73121,3578769847,3578769895,48
0,1613,73122,3578769913,3578769913,0
0,1613,73123,3578769913,3578769913,0
0,1613,73124,3578769913,3578769913,0
0,1613,73125,3578769913,3578769913,0
0,1613,73126,3578769913,3578769913,0
0,1613,73127,3578769913,3578769913,0
0,1613,73128,3578769913,3578769913,0
0,1613,73129,3578769913,3578769913,0
0,1613,73130,3578769913,3578769913,0
0,1613,73131,3578769913,3578769913,0
0,1613,73132,3578769913,3578769913,0
0,1613,73133,3578769913,3578769913,0
0,1613,73134,3578769913,3578769913,0
0,1613,73135,3578769913,3578769913,0
0,1613,73136,3578769913,3578769913,0
0,1613,73137,3578769913,3578769913,0
0,1613,73138,3578769913,3578769913,0
0,1613,73139,3578769913,3578769913,0
0,1613,73140,3578769913,3578769913,0
0,1613,73141,3578769913,3578769913,0
0,1613,73142,3578769913,3578769913,0
0,1613,73143,3578769913,3578769913,0
0,1613,73144,3578769913,3578769913,0
0,1613,73145,3578769913,3578769913,0
0,1613,73146,3578769913,3578769913,0
0,1613,73147,3578769913,3578769913,0
0,1613,73148,3578769913,3578769913,0
0,1613,73149,3578769913,3578769913,0
0,1613,73150,3578769913,3578769913,0
0,1613,73151,3578769913,3578769913,0
0,1613,73152,3578769913,3578769913,0
0,1613,73153,3578769913,3578769913,0
0,1613,73154,3578769913,3578769913,0
0,1613,73155,3578769913,3578769913,0
0,1613,73156,3578769913,3578769914,1
0,1613,73157,3578769913,3578769914,1
0,1613,73158,3578769913,3578769915,2
0,1613,73159,3578769913,3578769916,3
0,1613,73160,3578769913,3578769916,3
0,1613,73161,3578769913,3578769916,3
0,1613,73162,3578769913,3578769916,3
0,1613,73163,3578769913,3578769916,3
0,1613,73164,3578769913,3578769916,3
0,1613,73165,3578769913,3578769917,4
0,1613,73166,3578769913,3578769917,4
0,1613,73167,3578769913,3578769917,4
0,1613,73168,3578769913,3578769918,5
0,1613,73169,3578769913,3578769919,6
0,1613,73170,3578769913,3578769919,6
0,1613,73171,3578769913,3578769919,6
0,1613,73172,3578769913,3578769920,7
0,1613,73173,3578769913,3578769920,7
0,1613,73174,3578769913,3578769920,7
0,1613,73175,3578769913,3578769920,7
0,1613,73176,3578769913,3578769921,8
0,1613,73177,3578769913,3578769922,9
0,1613,73178,3578769913,3578769922,9
0,1613,73179,3578769913,3578769922,9
0,1613,73180,3578769913,3578769923,10
0,1613,73181,3578769913,3578769923,10
0,1613,73182,3578769913,3578769923,10
0,1613,73183,3578769913,3578769923,10
0,1613,73184,3578769913,3578769924,11
0,1613,73185,3578769913,3578769925,12
0,1613,73186,3578769913,3578769925,12
0,1613,73187,3578769913,3578769925,12
0,1613,73188,3578769913,3578769927,14
0,1613,73189,3578769913,3578769927,14
0,1613,73190,3578769913,3578769927,14
0,1613,73191,3578769913,3578769928,15
0,1613,73192,3578769913,3578769928,15
0,1613,73193,3578769913,3578769929,16
0,1613,73194,3578769913,3578769929,16
0,1613,73195,3578769913,3578769930,17
0,1613,73196,3578769913,3578769930,17
0,1613,73197,3578769913,3578769930,17
0,1613,73198,3578769913,3578769931,18
0,1613,73199,3578769913,3578769931,18
0,1613,73200,3578769913,3578769931,18
0,1613,73201,3578769913,3578769931,18
0,1613,73202,3578769913,3578769931,18
0,1613,73203,3578769913,3578769931,18
0,1613,73204,3578769913,3578769931,18
0,1613,73205,3578769913,3578769932,19
0,1613,73206,3578769913,3578769932,19
0,1613,73207,3578769913,3578769933,20
0,1613,73208,3578769913,3578769933,20
0,1613,73209,3578769913,3578769933,20
0,1613,73210,3578769913,3578769933,20
0,1613,73211,3578769913,3578769933,20
0,1613,73212,3578769913,3578769934,21
0,1613,73213,3578769913,3578769935,22
0,1613,73214,3578769913,3578769935,22
0,1613,73215,3578769913,3578769935,22
0,1613,73216,3578769913,3578769935,22
0,1613,73217,3578769913,3578769937,24
0,1613,73218,3578769913,3578769939,26
0,1613,73219,3578769913,3578769939,26
0,1613,73220,3578769913,3578769939,26
0,1613,73221,3578769913,3578769939,26
0,1613,73222,3578769913,3578769939,26
0,1613,73223,3578769913,3578769940,27
0,1613,73224,3578769913,3578769940,27
0,1613,73225,3578769913,3578769941,28
0,1613,73226,3578769913,3578769941,28
0,1613,73227,3578769913,3578769941,28
0,1613,73228,3578769913,3578769942,29
0,1613,73229,3578769913,3578769943,30
0,1613,73230,3578769913,3578769944,31
0,1613,73231,3578769913,3578769944,31
0,1613,73232,3578769913,3578769945,32
0,1613,73233,3578769913,3578769945,32
0,1613,73234,3578769913,3578769946,33
0,1613,73235,3578769913,3578769946,33
0,1613,73236,3578769913,3578769947,34
0,1613,73237,3578769913,3578769947,34
0,1613,73238,3578769913,3578769947,34
0,1613,73239,3578769913,3578769948,35
0,1613,73240,3578769913,3578769948,35
0,1613,73241,3578769913,3578769948,35
0,1613,73242,3578769913,3578769948,35
0,1613,73243,3578769913,3578769950,37
0,1613,73244,3578769913,3578769951,38
0,1613,73245,3578769913,3578769952,39
0,1613,73246,3578769913,3578769953,40
0,1613,73247,3578769913,3578769953,40
0,1613,73248,3578769913,3578769953,40
0,1613,73249,3578769913,3578769953,40
0,1613,73250,3578769913,3578769954,41
0,1613,73251,3578769913,3578769954,41
0,1613,73252,3578769913,3578769955,42
0,1613,73253,3578769913,3578769957,44
0,1613,73254,3578769913,3578769958,45
0,1613,73255,3578769913,3578769958,45
0,1613,73256,3578769913,3578769958,45
0,1613,73257,3578769913,3578769959,46
0,1613,73258,3578769913,3578769959,46
0,1613,73259,3578769913,3578769960,47
0,1613,73260,3578769913,3578769961,48
0,1613,73261,3578769913,3578769961,48
0,1613,73262,3578769913,3578769961,48
0,1613,73263,3578769913,3578769962,49
0,1613,73264,3578769913,3578769962,49
0,1613,73265,3578769913,3578769962,49
0,1613,73266,3578769913,3578769963,50
0,1613,73267,3578769913,3578769963,50
0,1614,73268,3578769979,3578769979,0
0,1614,73269,3578769979,3578769979,0
0,1614,73270,3578769979,3578769979,0
0,1614,73271,3578769979,3578769979,0
0,1614,73272,3578769979,3578769979,0
0,1614,73273,3578769979,3578769979,0
0,1614,73274,3578769979,3578769979,0
0,1614,73275,3578769979,3578769979,0
0,1614,73276,3578769979,3578769979,0
0,1614,73277,3578769979,3578769979,0
0,1614,73278,3578769979,3578769979,0
0,1614,73279,3578769979,3578769979,0
0,1614,73280,3578769979,3578769979,0
0,1614,73281,3578769979,3578769979,0
0,1614,73282,3578769979,3578769979,0
0,1614,73283,3578769979,3578769979,0
0,1614,73284,3578769979,3578769979,0
0,1614,73285,3578769979,3578769979,0
0,1614,73286,3578769979,3578769979,0
0,1614,73287,3578769979,3578769979,0
0,1614,73288,3578769979,3578769979,0
0,1614,73289,3578769979,3578769979,0
0,1614,73290,3578769979,3578769979,0
0,1614,73291,3578769979,3578769979,0
0,1614,73292,3578769979,3578769980,1
0,1614,73293,3578769979,3578769983,4
0,1614,73294,3578769979,3578769983,4
0,1614,73295,3578769979,3578769984,5
0,1614,73296,3578769979,3578769985,6
0,1614,73297,3578769979,3578769986,7
0,1614,73298,3578769979,3578769986,7
0,1614,73299,3578769979,3578769987,8
0,1614,73300,3578769979,3578769988,9
0,1614,73301,3578769979,3578769989,10
0,1614,73302,3578769979,3578769989,10
0,1614,73303,3578769979,3578769989,10
0,1614,73304,3578769979,3578769989,10
0,1614,73305,3578769979,3578769990,11
0,1614,73306,3578769979,3578769991,12
0,1614,73307,3578769979,3578769991,12
0,1614,73308,3578769979,3578769993,14
0,1614,73309,3578769979,3578769993,14
0,1614,73310,3578769979,3578769993,14
0,1614,73311,3578769979,3578769995,16
0,1614,73312,3578769979,3578769995,16
0,1614,73313,3578769979,3578769996,17
0,1614,73314,3578769979,3578769996,17
0,1614,73315,3578769979,3578769998,19
0,1614,73316,3578769979,3578769999,20
0,1614,73317,3578769979,3578769999,20
0,1614,73318,3578769979,3578770000,21
0,1614,73319,3578769979,3578770000,21
0,1614,73320,3578769979,3578770002,23
0,1614,73321,3578769979,3578770003,24
0,1614,73322,3578769979,3578770003,24
0,1614,73323,3578769979,3578770004,25
0,1614,73324,3578769979,3578770005,26
0,1614,73325,3578769979,3578770005,26
0,1614,73326,3578769979,3578770007,28
0,1614,73327,3578769979,3578770007,28
0,1614,73328,3578769979,3578770008,29
0,1614,73329,3578769979,3578770008,29
0,1614,73330,3578769979,3578770009,30
0,1614,73331,3578769979,3578770009,30
0,1614,73332,3578769979,3578770010,31
0,1614,73333,3578769979,3578770012,33
0,1614,73334,3578769979,3578770013,34
0,1614,73335,3578769979,3578770014,35
0,1614,73336,3578769979,3578770014,35
0,1614,73337,3578769979,3578770015,36
0,1614,73338,3578769979,3578770016,37
0,1614,73339,3578769979,3578770016,37
0,1614,73340,3578769979,3578770016,37
0,1614,73341,3578769979,3578770018,39
0,1614,73342,3578769979,3578770018,39
0,1614,73343,3578769979,3578770019,40
0,1614,73344,3578769979,3578770019,40
0,1614,73345,3578769979,3578770020,41
0,1614,73346,3578769979,3578770020,41
0,1614,73347,3578769979,3578770022,43
0,1614,73348,3578769979,3578770022,43
0,1614,73349,3578769979,3578770023,44
0,1614,73350,3578769979,3578770024,45
0,1614,73351,3578769979,3578770025,46
0,1614,73352,3578769979,3578770025,46
0,1614,73353,3578769979,3578770026,47
0,1614,73354,3578769979,3578770027,48
0,1614,73355,3578769979,3578770028,49
0,1614,73356,3578769979,3578770028,49
0,1614,73357,3578769979,3578770029,50
0,1615,73358,3578770044,3578770044,0
0,1615,73359,3578770044,3578770044,0
0,1615,73360,3578770044,3578770044,0
0,1615,73361,3578770044,3578770044,0
0,1615,73362,3578770044,3578770044,0
0,1615,73363,3578770044,3578770044,0
0,1615,73364,3578770044,3578770044,0
0,1615,73365,3578770044,3578770044,0
0,1615,73366,3578770044,3578770044,0
0,1615,73367,3578770044,3578770044,0
0,1615,73368,3578770044,3578770044,0
0,1615,73369,3578770044,3578770044,0
0,1615,73370,3578770044,3578770044,0
0,1615,73371,3578770044,3578770044,0
0,1615,73372,3578770044,3578770044,0
0,1615,73373,3578770044,3578770044,0
0,1615,73374,3578770044,3578770044,0
0,1615,73375,3578770044,3578770044,0
0,1615,73376,3578770044,3578770044,0
0,1615,73377,3578770044,3578770044,0
0,1615,73378,3578770044,3578770044,0
0,1615,73379,3578770044,3578770044,0
0,1615,73380,3578770044,3578770044,0
0,1615,73381,3578770044,3578770045,1
0,1615,73382,3578770044,3578770045,1
0,1615,73383,3578770044,3578770048,4
0,1615,73384,3578770044,3578770048,4
0,1615,73385,3578770044,3578770048,4
0,1615,73386,3578770044,3578770049,5
0,1615,73387,3578770044,3578770049,5
0,1615,73388,3578770044,3578770049,5
0,1615,73389,3578770044,3578770049,5
0,1615,73390,3578770044,3578770050,6
0,1615,73391,3578770044,3578770051,7
0,1615,73392,3578770044,3578770052,8
0,1615,73393,3578770044,3578770052,8
0,1615,73394,3578770044,3578770054,10
0,1615,73395,3578770044,3578770056,12
0,1615,73396,3578770044,3578770056,12
0,1615,73397,3578770044,3578770056,12
0,1615,73398,3578770044,3578770059,15
0,1615,73399,3578770044,3578770060,16
0,1615,73400,3578770044,3578770062,18
0,1615,73401,3578770044,3578770062,18
0,1615,73402,3578770044,3578770063,19
0,1615,73403,3578770044,3578770063,19
0,1615,73404,3578770044,3578770064,20
0,1615,73405,3578770044,3578770064,20
0,1615,73406,3578770044,3578770065,21
0,1615,73407,3578770044,3578770065,21
0,1615,73408,3578770044,3578770065,21
0,1615,73409,3578770044,3578770065,21
0,1615,73410,3578770044,3578770066,22
0,1615,73411,3578770044,3578770066,22
0,1615,73412,3578770044,3578770067,23
0,1615,73413,3578770044,3578770084,40
0,1615,73414,3578770044,3578770088,44
0,1615,73415,3578770044,3578770088,44
0,1615,73416,3578770044,3578770088,44
0,1615,73417,3578770044,3578770089,45
0,1615,73418,3578770044,3578770089,45
0,1615,73419,3578770044,3578770090,46
0,1615,73420,3578770044,3578770090,46
0,1615,73421,3578770044,3578770091,47
0,1615,73422,3578770044,3578770092,48
0,1615,73423,3578770044,3578770092,48
0,1615,73424,3578770044,3578770094,50
0,1615,73425,3578770044,3578770094,50
0,1616,73426,3578770109,3578770109,0
0,1616,73427,3578770109,3578770109,0
0,1616,73428,3578770109,3578770109,0
0,1616,73429,3578770109,3578770109,0
0,1616,73430,3578770109,3578770109,0
0,1616,73431,3578770109,3578770109,0
0,1616,73432,3578770109,3578770109,0
0,1616,73433,3578770109,3578770109,0
0,1616,73434,3578770109,3578770109,0
0,1616,73435,3578770109,3578770109,0
0,1616,73436,3578770109,3578770109,0
0,1616,73437,3578770109,3578770109,0
0,1616,73438,3578770109,3578770109,0
0,1616,73439,3578770109,3578770109,0
0,1616,73440,3578770109,3578770109,0
0,1616,73441,3578770109,3578770109,0
0,1616,73442,3578770109,3578770109,0
0,1616,73443,3578770109,3578770109,0
0,1616,73444,3578770109,3578770109,0
0,1616,73445,3578770109,3578770109,0
0,1616,73446,3578770109,3578770109,0
0,1616,73447,3578770109,3578770109,0
0,1616,73448,3578770109,3578770109,0
0,1616,73449,3578770109,3578770109,0
0,1616,73450,3578770109,3578770109,0
0,1616,73451,3578770109,3578770109,0
0,1616,73452,3578770109,3578770109,0
0,1616,73453,3578770109,3578770109,0
0,1616,73454,3578770109,3578770109,0
0,1616,73455,3578770109,3578770109,0
0,1616,73456,3578770109,3578770110,1
0,1616,73457,3578770109,3578770110,1
0,1616,73458,3578770109,3578770111,2
0,1616,73459,3578770109,3578770112,3
0,1616,73460,3578770109,3578770113,4
0,1616,73461,3578770109,3578770113,4
0,1616,73462,3578770109,3578770113,4
0,1616,73463,3578770109,3578770114,5
0,1616,73464,3578770109,3578770114,5
0,1616,73465,3578770109,3578770114,5
0,1616,73466,3578770109,3578770115,6
0,1616,73467,3578770109,3578770115,6
0,1616,73468,3578770109,3578770116,7
0,1616,73469,3578770109,3578770116,7
0,1616,73470,3578770109,3578770117,8
0,1616,73471,3578770109,3578770117,8
0,1616,73472,3578770109,3578770117,8
0,1616,73473,3578770109,3578770117,8
0,1616,73474,3578770109,3578770117,8
0,1616,73475,3578770109,3578770117,8
0,1616,73476,3578770109,3578770119,10
0,1616,73477,3578770109,3578770119,10
0,1616,73478,3578770109,3578770120,11
0,1616,73479,3578770109,3578770120,11
0,1616,73480,3578770109,3578770120,11
0,1616,73481,3578770109,3578770120,11
0,1616,73482,3578770109,3578770120,11
0,1616,73483,3578770109,3578770121,12
0,1616,73484,3578770109,3578770122,13
0,1616,73485,3578770109,3578770122,13
0,1616,73486,3578770109,3578770123,14
0,1616,73487,3578770109,3578770123,14
0,1616,73488,3578770109,3578770123,14
0,1616,73489,3578770109,3578770124,15
0,1616,73490,3578770109,3578770124,15
0,1616,73491,3578770109,3578770124,15
0,1616,73492,3578770109,3578770125,16
0,1616,73493,3578770109,3578770125,16
0,1616,73494,3578770109,3578770126,17
0,1616,73495,3578770109,3578770127,18
0,1616,73496,3578770109,3578770128,19
0,1616,73497,3578770109,3578770128,19
0,1616,73498,3578770109,3578770128,19
0,1616,73499,3578770109,3578770128,19
0,1616,73500,3578770109,3578770129,20
0,1616,73501,3578770109,3578770130,21
0,1616,73502,3578770109,3578770131,22
0,1616,73503,3578770109,3578770131,22
0,1616,73504,3578770109,3578770131,22
0,1616,73505,3578770109,3578770131,22
0,1616,73506,3578770109,3578770131,22
0,1616,73507,3578770109,3578770131,22
0,1616,73508,3578770109,3578770131,22
0,1616,73509,3578770109,3578770132,23
0,1616,73510,3578770109,3578770132,23
0,1616,73511,3578770109,3578770132,23
0,1616,73512,3578770109,3578770133,24
0,1616,73513,3578770109,3578770133,24
0,1616,73514,3578770109,3578770134,25
0,1616,73515,3578770109,3578770134,25
0,1616,73516,3578770109,3578770135,26
0,1616,73517,3578770109,3578770135,26
0,1616,73518,3578770109,3578770136,27
0,1616,73519,3578770109,3578770136,27
0,1616,73520,3578770109,3578770136,27
0,1616,73521,3578770109,3578770136,27
0,1616,73522,3578770109,3578770139,30
0,1616,73523,3578770109,3578770139,30
0,1616,73524,3578770109,3578770139,30
0,1616,73525,3578770109,3578770139,30
0,1616,73526,3578770109,3578770140,31
0,1616,73527,3578770109,3578770141,32
0,1616,73528,3578770109,3578770141,32
0,1616,73529,3578770109,3578770141,32
0,1616,73530,3578770109,3578770141,32
0,1616,73531,3578770109,3578770143,34
0,1616,73532,3578770109,3578770143,34
0,1616,73533,3578770109,3578770143,34
0,1616,73534,3578770109,3578770144,35
0,1616,73535,3578770109,3578770145,36
0,1616,73536,3578770109,3578770145,36
0,1616,73537,3578770109,3578770145,36
0,1616,73538,3578770109,3578770146,37
0,1616,73539,3578770109,3578770146,37
0,1616,73540,3578770109,3578770147,38
0,1616,73541,3578770109,3578770147,38
0,1616,73542,3578770109,3578770148,39
0,1616,73543,3578770109,3578770148,39
0,1616,73544,3578770109,3578770149,40
0,1616,73545,3578770109,3578770149,40
0,1616,73546,3578770109,3578770151,42
0,1616,73547,3578770109,3578770151,42
0,1616,73548,3578770109,3578770152,43
0,1616,73549,3578770109,3578770153,44
0,1616,73550,3578770109,3578770153,44
0,1616,73551,3578770109,3578770153,44
0,1616,73552,3578770109,3578770153,44
0,1616,73553,3578770109,3578770154,45
0,1616,73554,3578770109,3578770154,45
0,1616,73555,3578770109,3578770155,46
0,1616,73556,3578770109,3578770155,46
0,1616,73557,3578770109,3578770155,46
0,1616,73558,3578770109,3578770158,49
0,1616,73559,3578770109,3578770159,50
0,1617,73560,3578770173,3578770173,0
0,1617,73561,3578770173,3578770173,0
0,1617,73562,3578770173,3578770173,0
0,1617,73563,3578770173,3578770173,0
0,1617,73564,3578770173,3578770173,0
0,1617,73565,3578770173,3578770173,0
0,1617,73566,3578770173,3578770173,0
0,1617,73567,3578770173,3578770173,0
0,1617,73568,3578770173,3578770173,0
0,1617,73569,3578770173,3578770173,0
0,1617,73570,3578770173,3578770173,0
0,1617,73571,3578770173,3578770173,0
0,1617,73572,3578770173,3578770173,0
0,1617,73573,3578770173,3578770173,0
0,1617,73574,3578770173,3578770173,0
0,1617,73575,3578770173,3578770173,0
0,1617,73576,3578770173,3578770173,0
0,1617,73577,3578770173,3578770173,0
0,1617,73578,3578770173,3578770173,0
0,1617,73579,3578770173,3578770173,0
0,1617,73580,3578770173,3578770173,0
0,1617,73581,3578770173,3578770173,0
0,1617,73582,3578770173,3578770173,0
0,1617,73583,3578770173,3578770174,1
0,1617,73584,3578770173,3578770174,1
0,1617,73585,3578770173,3578770174,1
0,1617,73586,3578770173,3578770175,2
0,1617,73587,3578770173,3578770178,5
0,1617,73588,3578770173,3578770178,5
0,1617,73589,3578770173,3578770179,6
0,1617,73590,3578770173,3578770179,6
0,1617,73591,3578770173,3578770179,6
0,1617,73592,3578770173,3578770180,7
0,1617,73593,3578770173,3578770181,8
0,1617,73594,3578770173,3578770182,9
0,1617,73595,3578770173,3578770184,11
0,1617,73596,3578770173,3578770184,11
0,1617,73597,3578770173,3578770185,12
0,1617,73598,3578770173,3578770186,13
0,1617,73599,3578770173,3578770186,13
0,1617,73600,3578770173,3578770187,14
0,1617,73601,3578770173,3578770188,15
0,1617,73602,3578770173,3578770188,15
0,1617,73603,3578770173,3578770188,15
0,1617,73604,3578770173,3578770189,16
0,1617,73605,3578770173,3578770190,17
0,1617,73606,3578770173,3578770191,18
0,1617,73607,3578770173,3578770191,18
0,1617,73608,3578770173,3578770191,18
0,1617,73609,3578770173,3578770192,19
0,1617,73610,3578770173,3578770193,20
0,1617,73611,3578770173,3578770193,20
0,1617,73612,3578770173,3578770194,21
0,1617,73613,3578770173,3578770195,22
0,1617,73614,3578770173,3578770195,22
0,1617,73615,3578770173,3578770195,22
0,1617,73616,3578770173,3578770197,24
0,1617,73617,3578770173,3578770197,24
0,1617,73618,3578770173,3578770198,25
0,1617,73619,3578770173,3578770199,26
0,1617,73620,3578770173,3578770199,26
0,1617,73621,3578770173,3578770200,27
0,1617,73622,3578770173,3578770202,29
0,1617,73623,3578770173,3578770203,30
0,1617,73624,3578770173,3578770204,31
0,1617,73625,3578770173,3578770205,32
0,1617,73626,3578770173,3578770205,32
0,1617,73627,3578770173,3578770206,33
0,1617,73628,3578770173,3578770206,33
0,1617,73629,3578770173,3578770207,34
0,1617,73630,3578770173,3578770208,35
0,1617,73631,3578770173,3578770208,35
0,1617,73632,3578770173,3578770209,36
0,1617,73633,3578770173,3578770209,36
0,1617,73634,3578770173,3578770210,37
0,1617,73635,3578770173,3578770211,38
0,1617,73636,3578770173,3578770212,39
0,1617,73637,3578770173,3578770212,39
0,1617,73638,3578770173,3578770213,40
0,1617,73639,3578770173,3578770214,41
0,1617,73640,3578770173,3578770214,41
0,1617,73641,3578770173,3578770215,42
0,1617,73642,3578770173,3578770216,43
0,1617,73643,3578770173,3578770216,43
0,1617,73644,3578770173,3578770217,44
0,1617,73645,3578770173,3578770217,44
0,1617,73646,3578770173,3578770218,45
0,1617,73647,3578770173,3578770219,46
0,1617,73648,3578770173,3578770219,46
0,1617,73649,3578770173,3578770220,47
0,1617,73650,3578770173,3578770221,48
0,1617,73651,3578770173,3578770222,49
0,1617,73652,3578770173,3578770222,49
0,1617,73653,3578770173,3578770222,49
0,1617,73654,3578770173,3578770223,50
0,1618,73655,3578770239,3578770239,0
0,1618,73656,3578770239,3578770239,0
0,1618,73657,3578770239,3578770239,0
0,1618,73658,3578770239,3578770239,0
0,1618,73659,3578770239,3578770239,0
0,1618,73660,3578770239,3578770239,0
0,1618,73661,3578770239,3578770239,0
0,1618,73662,3578770239,3578770239,0
0,1618,73663,3578770239,3578770239,0
0,1618,73664,3578770239,3578770239,0
0,1618,73665,3578770239,3578770239,0
0,1618,73666,3578770239,3578770239,0
0,1618,73667,3578770239,3578770239,0
0,1618,73668,3578770239,3578770239,0
0,1618,73669,3578770239,3578770239,0
0,1618,73670,3578770239,3578770239,0
0,1618,73671,3578770239,3578770239,0
0,1618,73672,3578770239,3578770239,0
0,1618,73673,3578770239,3578770239,0
0,1618,73674,3578770239,3578770239,0
0,1618,73675,3578770239,3578770239,0
0,1618,73676,3578770239,3578770239,0
0,1618,73677,3578770239,3578770239,0
0,1618,73678,3578770239,3578770240,1
0,1618,73679,3578770239,3578770240,1
0,1618,73680,3578770239,3578770240,1
0,1618,73681,3578770239,3578770240,1
0,1618,73682,3578770239,3578770241,2
0,1618,73683,3578770239,3578770242,3
0,1618,73684,3578770239,3578770242,3
0,1618,73685,3578770239,3578770243,4
0,1618,73686,3578770239,3578770243,4
0,1618,73687,3578770239,3578770244,5
0,1618,73688,3578770239,3578770244,5
0,1618,73689,3578770239,3578770245,6
0,1618,73690,3578770239,3578770246,7
0,1618,73691,3578770239,3578770247,8
0,1618,73692,3578770239,3578770247,8
0,1618,73693,3578770239,3578770248,9
0,1618,73694,3578770239,3578770249,10
0,1618,73695,3578770239,3578770249,10
0,1618,73696,3578770239,3578770249,10
0,1618,73697,3578770239,3578770250,11
0,1618,73698,3578770239,3578770250,11
0,1618,73699,3578770239,3578770251,12
0,1618,73700,3578770239,3578770252,13
0,1618,73701,3578770239,3578770253,14
0,1618,73702,3578770239,3578770255,16
0,1618,73703,3578770239,3578770255,16
0,1618,73704,3578770239,3578770256,17
0,1618,73705,3578770239,3578770256,17
0,1618,73706,3578770239,3578770256,17
0,1618,73707,3578770239,3578770259,20
0,1618,73708,3578770239,3578770259,20
0,1618,73709,3578770239,3578770259,20
0,1618,73710,3578770239,3578770261,22
0,1618,73711,3578770239,3578770262,23
0,1618,73712,3578770239,3578770263,24
0,1618,73713,3578770239,3578770263,24
0,1618,73714,3578770239,3578770263,24
0,1618,73715,3578770239,3578770265,26
0,1618,73716,3578770239,3578770265,26
0,1618,73717,3578770239,3578770265,26
0,1618,73718,3578770239,3578770265,26
0,1618,73719,3578770239,3578770266,27
0,1618,73720,3578770239,3578770267,28
0,1618,73721,3578770239,3578770267,28
0,1618,73722,3578770239,3578770275,36
0,1618,73723,3578770239,3578770277,38
0,1618,73724,3578770239,3578770287,48
0,1618,73725,3578770239,3578770288,49
0,1618,73726,3578770239,3578770289,50
0,1619,73727,3578770305,3578770305,0
0,1619,73728,3578770305,3578770305,0
0,1619,73729,3578770305,3578770305,0
0,1619,73730,3578770305,3578770305,0
0,1619,73731,3578770305,3578770305,0
0,1619,73732,3578770305,3578770305,0
0,1619,73733,3578770305,3578770305,0
0,1619,73734,3578770305,3578770305,0
0,1619,73735,3578770305,3578770305,0
0,1619,73736,3578770305,3578770305,0
0,1619,73737,3578770305,3578770305,0
0,1619,73738,3578770305,3578770305,0
0,1619,73739,3578770305,3578770305,0
0,1619,73740,3578770305,3578770305,0
0,1619,73741,3578770305,3578770305,0
0,1619,73742,3578770305,3578770305,0
0,1619,73743,3578770305,3578770305,0
0,1619,73744,3578770305,3578770305,0
0,1619,73745,3578770305,3578770305,0
0,1619,73746,3578770305,3578770305,0
0,1619,73747,3578770305,3578770305,0
0,1619,73748,3578770305,3578770305,0
0,1619,73749,3578770305,3578770305,0
0,1619,73750,3578770305,3578770305,0
0,1619,73751,3578770305,3578770305,0
0,1619,73752,3578770305,3578770305,0
0,1619,73753,3578770305,3578770305,0
0,1619,73754,3578770305,3578770305,0
0,1619,73755,3578770305,3578770305,0
0,1619,73756,3578770305,3578770306,1
0,1619,73757,3578770305,3578770306,1
0,1619,73758,3578770305,3578770306,1
0,1619,73759,3578770305,3578770306,1
0,1619,73760,3578770305,3578770307,2
0,1619,73761,3578770305,3578770307,2
0,1619,73762,3578770305,3578770307,2
0,1619,73763,3578770305,3578770307,2
0,1619,73764,3578770305,3578770308,3
0,1619,73765,3578770305,3578770308,3
0,1619,73766,3578770305,3578770309,4
0,1619,73767,3578770305,3578770309,4
0,1619,73768,3578770305,3578770309,4
0,1619,73769,3578770305,3578770309,4
0,1619,73770,3578770305,3578770310,5
0,1619,73771,3578770305,3578770310,5
0,1619,73772,3578770305,3578770311,6
0,1619,73773,3578770305,3578770311,6
0,1619,73774,3578770305,3578770312,7
0,1619,73775,3578770305,3578770312,7
0,1619,73776,3578770305,3578770312,7
0,1619,73777,3578770305,3578770312,7
0,1619,73778,3578770305,3578770313,8
0,1619,73779,3578770305,3578770313,8
0,1619,73780,3578770305,3578770315,10
0,1619,73781,3578770305,3578770315,10
0,1619,73782,3578770305,3578770315,10
0,1619,73783,3578770305,3578770316,11
0,1619,73784,3578770305,3578770316,11
0,1619,73785,3578770305,3578770316,11
0,1619,73786,3578770305,3578770316,11
0,1619,73787,3578770305,3578770317,12
0,1619,73788,3578770305,3578770317,12
0,1619,73789,3578770305,3578770318,13
0,1619,73790,3578770305,3578770318,13
0,1619,73791,3578770305,3578770318,13
0,1619,73792,3578770305,3578770318,13
0,1619,73793,3578770305,3578770319,14
0,1619,73794,3578770305,3578770319,14
0,1619,73795,3578770305,3578770319,14
0,1619,73796,3578770305,3578770319,14
0,1619,73797,3578770305,3578770320,15
0,1619,73798,3578770305,3578770320,15
0,1619,73799,3578770305,3578770320,15
0,1619,73800,3578770305,3578770321,16
0,1619,73801,3578770305,3578770322,17
0,1619,73802,3578770305,3578770322,17
0,1619,73803,3578770305,3578770323,18
0,1619,73804,3578770305,3578770323,18
0,1619,73805,3578770305,3578770324,19
0,1619,73806,3578770305,3578770324,19
0,1619,73807,3578770305,3578770325,20
0,1619,73808,3578770305,3578770325,20
0,1619,73809,3578770305,3578770325,20
0,1619,73810,3578770305,3578770328,23
0,1619,73811,3578770305,3578770328,23
0,1619,73812,3578770305,3578770328,23
0,1619,73813,3578770305,3578770328,23
0,1619,73814,3578770305,3578770328,23
0,1619,73815,3578770305,3578770329,24
0,1619,73816,3578770305,3578770330,25
0,1619,73817,3578770305,3578770330,25
0,1619,73818,3578770305,3578770331,26
0,1619,73819,3578770305,3578770331,26
0,1619,73820,3578770305,3578770331,26
0,1619,73821,3578770305,3578770331,26
0,1619,73822,3578770305,3578770331,26
0,1619,73823,3578770305,3578770331,26
0,1619,73824,3578770305,3578770331,26
0,1619,73825,3578770305,3578770332,27
0,1619,73826,3578770305,3578770332,27
0,1619,73827,3578770305,3578770332,27
0,1619,73828,3578770305,3578770332,27
0,1619,73829,3578770305,3578770334,29
0,1619,73830,3578770305,3578770334,29
0,1619,73831,3578770305,3578770335,30
0,1619,73832,3578770305,3578770335,30
0,1619,73833,3578770305,3578770336,31
0,1619,73834,3578770305,3578770336,31
0,1619,73835,3578770305,3578770336,31
0,1619,73836,3578770305,3578770338,33
0,1619,73837,3578770305,3578770339,34
0,1619,73838,3578770305,3578770339,34
0,1619,73839,3578770305,3578770339,34
0,1619,73840,3578770305,3578770340,35
0,1619,73841,3578770305,3578770341,36
0,1619,73842,3578770305,3578770341,36
0,1619,73843,3578770305,3578770341,36
0,1619,73844,3578770305,3578770343,38
0,1619,73845,3578770305,3578770343,38
0,1619,73846,3578770305,3578770344,39
0,1619,73847,3578770305,3578770345,40
0,1619,73848,3578770305,3578770345,40
0,1619,73849,3578770305,3578770345,40
0,1619,73850,3578770305,3578770346,41
0,1619,73851,3578770305,3578770346,41
0,1619,73852,3578770305,3578770348,43
0,1619,73853,3578770305,3578770348,43
0,1619,73854,3578770305,3578770348,43
0,1619,73855,3578770305,3578770349,44
0,1619,73856,3578770305,3578770349,44
0,1619,73857,3578770305,3578770351,46
0,1619,73858,3578770305,3578770351,46
0,1619,73859,3578770305,3578770352,47
0,1619,73860,3578770305,3578770353,48
0,1619,73861,3578770305,3578770353,48
0,1619,73862,3578770305,3578770353,48
0,1619,73863,3578770305,3578770353,48
0,1619,73864,3578770305,3578770355,50
0,1620,73865,3578770369,3578770369,0
0,1620,73866,3578770369,3578770369,0
0,1620,73867,3578770369,3578770369,0
0,1620,73868,3578770369,3578770369,0
0,1620,73869,3578770369,3578770369,0
0,1620,73870,3578770369,3578770369,0
0,1620,73871,3578770369,3578770369,0
0,1620,73872,3578770369,3578770369,0
0,1620,73873,3578770369,3578770369,0
0,1620,73874,3578770369,3578770369,0
0,1620,73875,3578770369,3578770369,0
0,1620,73876,3578770369,3578770369,0
0,1620,73877,3578770369,3578770369,0
0,1620,73878,3578770369,3578770369,0
0,1620,73879,3578770369,3578770369,0
0,1620,73880,3578770369,3578770369,0
0,1620,73881,3578770369,3578770369,0
0,1620,73882,3578770369,3578770369,0
0,1620,73883,3578770369,3578770369,0
0,1620,73884,3578770369,3578770369,0
0,1620,73885,3578770369,3578770369,0
0,1620,73886,3578770369,3578770369,0
0,1620,73887,3578770369,3578770369,0
0,1620,73888,3578770369,3578770371,2
0,1620,73889,3578770369,3578770372,3
0,1620,73890,3578770369,3578770372,3
0,1620,73891,3578770369,3578770372,3
0,1620,73892,3578770369,3578770372,3
0,1620,73893,3578770369,3578770373,4
0,1620,73894,3578770369,3578770373,4
0,1620,73895,3578770369,3578770374,5
0,1620,73896,3578770369,3578770374,5
0,1620,73897,3578770369,3578770374,5
0,1620,73898,3578770369,3578770375,6
0,1620,73899,3578770369,3578770375,6
0,1620,73900,3578770369,3578770376,7
0,1620,73901,3578770369,3578770378,9
0,1620,73902,3578770369,3578770378,9
0,1620,73903,3578770369,3578770379,10
0,1620,73904,3578770369,3578770379,10
0,1620,73905,3578770369,3578770379,10
0,1620,73906,3578770369,3578770379,10
0,1620,73907,3578770369,3578770380,11
0,1620,73908,3578770369,3578770381,12
0,1620,73909,3578770369,3578770382,13
0,1620,73910,3578770369,3578770383,14
0,1620,73911,3578770369,3578770384,15
0,1620,73912,3578770369,3578770384,15
0,1620,73913,3578770369,3578770384,15
0,1620,73914,3578770369,3578770385,16
0,1620,73915,3578770369,3578770386,17
0,1620,73916,3578770369,3578770387,18
0,1620,73917,3578770369,3578770387,18
0,1620,73918,3578770369,3578770388,19
0,1620,73919,3578770369,3578770388,19
0,1620,73920,3578770369,3578770389,20
0,1620,73921,3578770369,3578770389,20
0,1620,73922,3578770369,3578770390,21
0,1620,73923,3578770369,3578770391,22
0,1620,73924,3578770369,3578770391,22
0,1620,73925,3578770369,3578770391,22
0,1620,73926,3578770369,3578770392,23
0,1620,73927,3578770369,3578770393,24
0,1620,73928,3578770369,3578770393,24
0,1620,73929,3578770369,3578770394,25
0,1620,73930,3578770369,3578770395,26
0,1620,73931,3578770369,3578770395,26
0,1620,73932,3578770369,3578770397,28
0,1620,73933,3578770369,3578770397,28
0,1620,73934,3578770369,3578770398,29
0,1620,73935,3578770369,3578770399,30
0,1620,73936,3578770369,3578770399,30
0,1620,73937,3578770369,3578770399,30
0,1620,73938,3578770369,3578770399,30
0,1620,73939,3578770369,3578770400,31
0,1620,73940,3578770369,3578770401,32
0,1620,73941,3578770369,3578770402,33
0,1620,73942,3578770369,3578770402,33
0,1620,73943,3578770369,3578770404,35
0,1620,73944,3578770369,3578770404,35
0,1620,73945,3578770369,3578770405,36
0,1620,73946,3578770369,3578770406,37
0,1620,73947,3578770369,3578770406,37
0,1620,73948,3578770369,3578770407,38
0,1620,73949,3578770369,3578770407,38
0,1620,73950,3578770369,3578770408,39
0,1620,73951,3578770369,3578770408,39
0,1620,73952,3578770369,3578770409,40
0,1620,73953,3578770369,3578770409,40
0,1620,73954,3578770369,3578770410,41
0,1620,73955,3578770369,3578770411,42
0,1620,73956,3578770369,3578770412,43
0,1620,73957,3578770369,3578770412,43
0,1620,73958,3578770369,3578770413,44
0,1620,73959,3578770369,3578770414,45
0,1620,73960,3578770369,3578770414,45
0,1620,73961,3578770369,3578770415,46
0,1620,73962,3578770369,3578770415,46
0,1620,73963,3578770369,3578770416,47
0,1620,73964,3578770369,3578770416,47
0,1620,73965,3578770369,3578770417,48
0,1620,73966,3578770369,3578770418,49
0,1620,73967,3578770369,3578770419,50
0,1620,73968,3578770369,3578770419,50
0,1621,73969,3578770434,3578770434,0
0,1621,73970,3578770434,3578770434,0
0,1621,73971,3578770434,3578770434,0
0,1621,73972,3578770434,3578770434,0
0,1621,73973,3578770434,3578770434,0
0,1621,73974,3578770434,3578770434,0
0,1621,73975,3578770434,3578770434,0
0,1621,73976,3578770434,3578770434,0
0,1621,73977,3578770434,3578770434,0
0,1621,73978,3578770434,3578770434,0
0,1621,73979,3578770434,3578770434,0
0,1621,73980,3578770434,3578770434,0
0,1621,73981,3578770434,3578770434,0
0,1621,73982,3578770434,3578770434,0
0,1621,73983,3578770434,3578770434,0
0,1621,73984,3578770434,3578770434,0
0,1621,73985,3578770434,3578770434,0
0,1621,73986,3578770434,3578770434,0
0,1621,73987,3578770434,3578770434,0
0,1621,73988,3578770434,3578770434,0
0,1621,73989,3578770434,3578770434,0
0,1621,73990,3578770434,3578770434,0
0,1621,73991,3578770434,3578770436,2
0,1621,73992,3578770434,3578770436,2
0,1621,73993,3578770434,3578770436,2
0,1621,73994,3578770434,3578770437,3
0,1621,73995,3578770434,3578770437,3
0,1621,73996,3578770434,3578770439,5
0,1621,73997,3578770434,3578770440,6
0,1621,73998,3578770434,3578770440,6
0,1621,73999,3578770434,3578770440,6
0,1621,74000,3578770434,3578770441,7
0,1621,74001,3578770434,3578770441,7
0,1621,74002,3578770434,3578770442,8
0,1621,74003,3578770434,3578770442,8
0,1621,74004,3578770434,3578770443,9
0,1621,74005,3578770434,3578770443,9
0,1621,74006,3578770434,3578770443,9
0,1621,74007,3578770434,3578770444,10
0,1621,74008,3578770434,3578770445,11
0,1621,74009,3578770434,3578770446,12
0,1621,74010,3578770434,3578770446,12
0,1621,74011,3578770434,3578770447,13
0,1621,74012,3578770434,3578770447,13
0,1621,74013,3578770434,3578770447,13
0,1621,74014,3578770434,3578770449,15
0,1621,74015,3578770434,3578770449,15
0,1621,74016,3578770434,3578770449,15
0,1621,74017,3578770434,3578770449,15
0,1621,74018,3578770434,3578770450,16
0,1621,74019,3578770434,3578770450,16
0,1621,74020,3578770434,3578770450,16
0,1621,74021,3578770434,3578770450,16
0,1621,74022,3578770434,3578770451,17
0,1621,74023,3578770434,3578770455,21
0,1621,74024,3578770434,3578770456,22
0,1621,74025,3578770434,3578770457,23
0,1621,74026,3578770434,3578770457,23
0,1621,74027,3578770434,3578770458,24
0,1621,74028,3578770434,3578770460,26
0,1621,74029,3578770434,3578770461,27
0,1621,74030,3578770434,3578770463,29
0,1621,74031,3578770434,3578770463,29
0,1621,74032,3578770434,3578770463,29
0,1621,74033,3578770434,3578770463,29
0,1621,74034,3578770434,3578770465,31
0,1621,74035,3578770434,3578770465,31
0,1621,74036,3578770434,3578770465,31
0,1621,74037,3578770434,3578770465,31
0,1621,74038,3578770434,3578770467,33
0,1621,74039,3578770434,3578770467,33
0,1621,74040,3578770434,3578770467,33
0,1621,74041,3578770434,3578770469,35
0,1621,74042,3578770434,3578770475,41
0,1621,74043,3578770434,3578770477,43
0,1622,74044,3578770500,3578770500,0
0,1622,74045,3578770500,3578770500,0
0,1622,74046,3578770500,3578770500,0
0,1622,74047,3578770500,3578770500,0
0,1622,74048,3578770500,3578770500,0
0,1622,74049,3578770500,3578770500,0
0,1622,74050,3578770500,3578770500,0
0,1622,74051,3578770500,3578770500,0
0,1622,74052,3578770500,3578770500,0
0,1622,74053,3578770500,3578770500,0
0,1622,74054,3578770500,3578770500,0
0,1622,74055,3578770500,3578770500,0
0,1622,74056,3578770500,3578770500,0
0,1622,74057,3578770500,3578770500,0
0,1622,74058,3578770500,3578770500,0
0,1622,74059,3578770500,3578770500,0
0,1622,74060,3578770500,3578770500,0
0,1622,74061,3578770500,3578770500,0
0,1622,74062,3578770500,3578770500,0
0,1622,74063,3578770500,3578770500,0
0,1622,74064,3578770500,3578770500,0
0,1622,74065,3578770500,3578770500,0
0,1622,74066,3578770500,3578770500,0
0,1622,74067,3578770500,3578770500,0
0,1622,74068,3578770500,3578770500,0
0,1622,74069,3578770500,3578770500,0
0,1622,74070,3578770500,3578770500,0
0,1622,74071,3578770500,3578770501,1
0,1622,74072,3578770500,3578770501,1
0,1622,74073,3578770500,3578770502,2
0,1622,74074,3578770500,3578770505,5
0,1622,74075,3578770500,3578770505,5
0,1622,74076,3578770500,3578770505,5
0,1622,74077,3578770500,3578770505,5
0,1622,74078,3578770500,3578770506,6
0,1622,74079,3578770500,3578770506,6
0,1622,74080,3578770500,3578770506,6
0,1622,74081,3578770500,3578770506,6
0,1622,74082,3578770500,3578770507,7
0,1622,74083,3578770500,3578770507,7
0,1622,74084,3578770500,3578770508,8
0,1622,74085,3578770500,3578770508,8
0,1622,74086,3578770500,3578770508,8
0,1622,74087,3578770500,3578770509,9
0,1622,74088,3578770500,3578770509,9
0,1622,74089,3578770500,3578770509,9
0,1622,74090,3578770500,3578770510,10
0,1622,74091,3578770500,3578770510,10
0,1622,74092,3578770500,3578770510,10
0,1622,74093,3578770500,3578770510,10
0,1622,74094,3578770500,3578770510,10
0,1622,74095,3578770500,3578770512,12
0,1622,74096,3578770500,3578770513,13
0,1622,74097,3578770500,3578770513,13
0,1622,74098,3578770500,3578770513,13
0,1622,74099,3578770500,3578770514,14
0,1622,74100,3578770500,3578770514,14
0,1622,74101,3578770500,3578770514,14
0,1622,74102,3578770500,3578770514,14
0,1622,74103,3578770500,3578770515,15
0,1622,74104,3578770500,3578770515,15
0,1622,74105,3578770500,3578770515,15
0,1622,74106,3578770500,3578770516,16
0,1622,74107,3578770500,3578770516,16
0,1622,74108,3578770500,3578770517,17
0,1622,74109,3578770500,3578770517,17
0,1622,74110,3578770500,3578770517,17
0,1622,74111,3578770500,3578770517,17
0,1622,74112,3578770500,3578770517,17
0,1622,74113,3578770500,3578770518,18
0,1622,74114,3578770500,3578770518,18
0,1622,74115,3578770500,3578770519,19
0,1622,74116,3578770500,3578770519,19
0,1622,74117,3578770500,3578770519,19
0,1622,74118,3578770500,3578770520,20
0,1622,74119,3578770500,3578770520,20
0,1622,74120,3578770500,3578770521,21
0,1622,74121,3578770500,3578770521,21
0,1622,74122,3578770500,3578770522,22
0,1622,74123,3578770500,3578770522,22
0,1622,74124,3578770500,3578770522,22
0,1622,74125,3578770500,3578770524,24
0,1622,74126,3578770500,3578770524,24
0,1622,74127,3578770500,3578770527,27
0,1622,74128,3578770500,3578770527,27
0,1622,74129,3578770500,3578770528,28
0,1622,74130,3578770500,3578770528,28
0,1622,74131,3578770500,3578770528,28
0,1622,74132,3578770500,3578770528,28
0,1622,74133,3578770500,3578770529,29
0,1622,74134,3578770500,3578770530,30
0,1622,74135,3578770500,3578770530,30
0,1622,74136,3578770500,3578770530,30
0,1622,74137,3578770500,3578770530,30
0,1622,74138,3578770500,3578770530,30
0,1622,74139,3578770500,3578770531,31
0,1622,74140,3578770500,3578770531,31
0,1622,74141,3578770500,3578770531,31
0,1622,74142,3578770500,3578770531,31
0,1622,74143,3578770500,3578770531,31
0,1622,74144,3578770500,3578770531,31
0,1622,74145,3578770500,3578770532,32
0,1622,74146,3578770500,3578770532,32
0,1622,74147,3578770500,3578770532,32
0,1622,74148,3578770500,3578770533,33
0,1622,74149,3578770500,3578770534,34
0,1622,74150,3578770500,3578770535,35
0,1622,74151,3578770500,3578770535,35
0,1622,74152,3578770500,3578770535,35
0,1622,74153,3578770500,3578770536,36
0,1622,74154,3578770500,3578770536,36
0,1622,74155,3578770500,3578770537,37
0,1622,74156,3578770500,3578770537,37
0,1622,74157,3578770500,3578770538,38
0,1622,74158,3578770500,3578770538,38
0,1622,74159,3578770500,3578770539,39
0,1622,74160,3578770500,3578770539,39
0,1622,74161,3578770500,3578770539,39
0,1622,74162,3578770500,3578770540,40
0,1622,74163,3578770500,3578770540,40
0,1622,74164,3578770500,3578770542,42
0,1622,74165,3578770500,3578770543,43
0,1622,74166,3578770500,3578770543,43
0,1622,74167,3578770500,3578770544,44
0,1622,74168,3578770500,3578770545,45
0,1622,74169,3578770500,3578770545,45
0,1622,74170,3578770500,3578770546,46
0,1622,74171,3578770500,3578770546,46
0,1622,74172,3578770500,3578770547,47
0,1622,74173,3578770500,3578770547,47
0,1622,74174,3578770500,3578770548,48
0,1622,74175,3578770500,3578770549,49
0,1622,74176,3578770500,3578770549,49
0,1622,74177,3578770500,3578770550,50
0,1623,74178,3578770565,3578770565,0
0,1623,74179,3578770565,3578770565,0
0,1623,74180,3578770565,3578770565,0
0,1623,74181,3578770565,3578770565,0
0,1623,74182,3578770565,3578770565,0
0,1623,74183,3578770565,3578770565,0
0,1623,74184,3578770565,3578770565,0
0,1623,74185,3578770565,3578770565,0
0,1623,74186,3578770565,3578770565,0
0,1623,74187,3578770565,3578770565,0
0,1623,74188,3578770565,3578770565,0
0,1623,74189,3578770565,3578770565,0
0,1623,74190,3578770565,3578770565,0
0,1623,74191,3578770565,3578770565,0
0,1623,74192,3578770565,3578770565,0
0,1623,74193,3578770565,3578770565,0
0,1623,74194,3578770565,3578770565,0
0,1623,74195,3578770565,3578770565,0
0,1623,74196,3578770565,3578770565,0
0,1623,74197,3578770565,3578770565,0
0,1623,74198,3578770565,3578770565,0
0,1623,74199,3578770565,3578770565,0
0,1623,74200,3578770565,3578770565,0
0,1623,74201,3578770565,3578770565,0
0,1623,74202,3578770565,3578770565,0
0,1623,74203,3578770565,3578770565,0
0,1623,74204,3578770565,3578770565,0
0,1623,74205,3578770565,3578770565,0
0,1623,74206,3578770565,3578770565,0
0,1623,74207,3578770565,3578770565,0
0,1623,74208,3578770565,3578770566,1
0,1623,74209,3578770565,3578770567,2
0,1623,74210,3578770565,3578770568,3
0,1623,74211,3578770565,3578770569,4
0,1623,74212,3578770565,3578770569,4
0,1623,74213,3578770565,3578770570,5
0,1623,74214,3578770565,3578770570,5
0,1623,74215,3578770565,3578770571,6
0,1623,74216,3578770565,3578770572,7
0,1623,74217,3578770565,3578770572,7
0,1623,74218,3578770565,3578770572,7
0,1623,74219,3578770565,3578770573,8
0,1623,74220,3578770565,3578770573,8
0,1623,74221,3578770565,3578770573,8
0,1623,74222,3578770565,3578770573,8
0,1623,74223,3578770565,3578770574,9
0,1623,74224,3578770565,3578770574,9
0,1623,74225,3578770565,3578770576,11
0,1623,74226,3578770565,3578770577,12
0,1623,74227,3578770565,3578770578,13
0,1623,74228,3578770565,3578770578,13
0,1623,74229,3578770565,3578770578,13
0,1623,74230,3578770565,3578770578,13
0,1623,74231,3578770565,3578770578,13
0,1623,74232,3578770565,3578770579,14
0,1623,74233,3578770565,3578770580,15
0,1623,74234,3578770565,3578770581,16
0,1623,74235,3578770565,3578770582,17
0,1623,74236,3578770565,3578770583,18
0,1623,74237,3578770565,3578770585,20
0,1623,74238,3578770565,3578770585,20
0,1623,74239,3578770565,3578770586,21
0,1623,74240,3578770565,3578770586,21
0,1623,74241,3578770565,3578770588,23
0,1623,74242,3578770565,3578770588,23
0,1623,74243,3578770565,3578770588,23
0,1623,74244,3578770565,3578770589,24
0,1623,74245,3578770565,3578770591,26
0,1623,74246,3578770565,3578770591,26
0,1623,74247,3578770565,3578770592,27
0,1623,74248,3578770565,3578770593,28
0,1623,74249,3578770565,3578770593,28
0,1623,74250,3578770565,3578770593,28
0,1623,74251,3578770565,3578770594,29
0,1623,74252,3578770565,3578770595,30
0,1623,74253,3578770565,3578770596,31
0,1623,74254,3578770565,3578770597,32
0,1623,74255,3578770565,3578770598,33
0,1623,74256,3578770565,3578770598,33
0,1623,74257,3578770565,3578770598,33
0,1623,74258,3578770565,3578770600,35
0,1623,74259,3578770565,3578770601,36
0,1623,74260,3578770565,3578770602,37
0,1623,74261,3578770565,3578770603,38
0,1623,74262,3578770565,3578770604,39
0,1623,74263,3578770565,3578770604,39
0,1623,74264,3578770565,3578770605,40
0,1623,74265,3578770565,3578770606,41
0,1623,74266,3578770565,3578770606,41
0,1623,74267,3578770565,3578770607,42
0,1623,74268,3578770565,3578770607,42
0,1623,74269,3578770565,3578770608,43
0,1623,74270,3578770565,3578770610,45
0,1623,74271,3578770565,3578770610,45
0,1623,74272,3578770565,3578770613,48
0,1623,74273,3578770565,3578770613,48
0,1623,74274,3578770565,3578770614,49
0,1623,74275,3578770565,3578770615,50
0,1624,74276,3578770631,3578770631,0
0,1624,74277,3578770631,3578770631,0
0,1624,74278,3578770631,3578770631,0
0,1624,74279,3578770631,3578770631,0
0,1624,74280,3578770631,3578770631,0
0,1624,74281,3578770631,3578770631,0
0,1624,74282,3578770631,3578770631,0
0,1624,74283,3578770631,3578770631,0
0,1624,74284,3578770631,3578770631,0
0,1624,74285,3578770631,3578770631,0
0,1624,74286,3578770631,3578770631,0
0,1624,74287,3578770631,3578770631,0
0,1624,74288,3578770631,3578770631,0
0,1624,74289,3578770631,3578770631,0
0,1624,74290,3578770631,3578770631,0
0,1624,74291,3578770631,3578770631,0
0,1624,74292,3578770631,3578770631,0
0,1624,74293,3578770631,3578770631,0
0,1624,74294,3578770631,3578770631,0
0,1624,74295,3578770631,3578770631,0
0,1624,74296,3578770631,3578770631,0
0,1624,74297,3578770631,3578770631,0
0,1624,74298,3578770631,3578770631,0
0,1624,74299,3578770631,3578770631,0
0,1624,74300,3578770631,3578770631,0
0,1624,74301,3578770631,3578770631,0
0,1624,74302,3578770631,3578770631,0
0,1624,74303,3578770631,3578770631,0
0,1624,74304,3578770631,3578770632,1
0,1624,74305,3578770631,3578770632,1
0,1624,74306,3578770631,3578770633,2
0,1624,74307,3578770631,3578770635,4
0,1624,74308,3578770631,3578770635,4
0,1624,74309,3578770631,3578770636,5
0,1624,74310,3578770631,3578770637,6
0,1624,74311,3578770631,3578770638,7
0,1624,74312,3578770631,3578770639,8
0,1624,74313,3578770631,3578770639,8
0,1624,74314,3578770631,3578770639,8
0,1624,74315,3578770631,3578770639,8
0,1624,74316,3578770631,3578770639,8
0,1624,74317,3578770631,3578770639,8
0,1624,74318,3578770631,3578770639,8
0,1624,74319,3578770631,3578770640,9
0,1624,74320,3578770631,3578770640,9
0,1624,74321,3578770631,3578770641,10
0,1624,74322,3578770631,3578770641,10
0,1624,74323,3578770631,3578770642,11
0,1624,74324,3578770631,3578770643,12
0,1624,74325,3578770631,3578770643,12
0,1624,74326,3578770631,3578770644,13
0,1624,74327,3578770631,3578770645,14
0,1624,74328,3578770631,3578770646,15
0,1624,74329,3578770631,3578770647,16
0,1624,74330,3578770631,3578770647,16
0,1624,74331,3578770631,3578770648,17
0,1624,74332,3578770631,3578770648,17
0,1624,74333,3578770631,3578770648,17
0,1624,74334,3578770631,3578770648,17
0,1624,74335,3578770631,3578770649,18
0,1624,74336,3578770631,3578770649,18
0,1624,74337,3578770631,3578770649,18
0,1624,74338,3578770631,3578770651,20
0,1624,74339,3578770631,3578770653,22
0,1624,74340,3578770631,3578770653,22
0,1624,74341,3578770631,3578770655,24
0,1624,74342,3578770631,3578770656,25
0,1624,74343,3578770631,3578770657,26
0,1624,74344,3578770631,3578770657,26
0,1624,74345,3578770631,3578770658,27
0,1624,74346,3578770631,3578770660,29
0,1624,74347,3578770631,3578770660,29
0,1624,74348,3578770631,3578770661,30
0,1624,74349,3578770631,3578770661,30
0,1624,74350,3578770631,3578770662,31
0,1624,74351,3578770631,3578770662,31
0,1624,74352,3578770631,3578770662,31
0,1624,74353,3578770631,3578770663,32
0,1624,74354,3578770631,3578770664,33
0,1624,74355,3578770631,3578770664,33
0,1624,74356,3578770631,3578770666,35
0,1624,74357,3578770631,3578770666,35
0,1624,74358,3578770631,3578770666,35
0,1624,74359,3578770631,3578770668,37
0,1624,74360,3578770631,3578770668,37
0,1624,74361,3578770631,3578770668,37
0,1624,74362,3578770631,3578770674,43
0,1625,74363,3578770697,3578770697,0
0,1625,74364,3578770697,3578770697,0
0,1625,74365,3578770697,3578770697,0
0,1625,74366,3578770697,3578770697,0
0,1625,74367,3578770697,3578770697,0
0,1625,74368,3578770697,3578770697,0
0,1625,74369,3578770697,3578770697,0
0,1625,74370,3578770697,3578770697,0
0,1625,74371,3578770697,3578770697,0
0,1625,74372,3578770697,3578770697,0
0,1625,74373,3578770697,3578770697,0
0,1625,74374,3578770697,3578770697,0
0,1625,74375,3578770697,3578770697,0
0,1625,74376,3578770697,3578770697,0
0,1625,74377,3578770697,3578770697,0
0,1625,74378,3578770697,3578770697,0
0,1625,74379,3578770697,3578770697,0
0,1625,74380,3578770697,3578770698,1
0,1625,74381,3578770697,3578770698,1
0,1625,74382,3578770697,3578770698,1
0,1625,74383,3578770697,3578770699,2
0,1625,74384,3578770697,3578770699,2
0,1625,74385,3578770697,3578770699,2
0,1625,74386,3578770697,3578770700,3
0,1625,74387,3578770697,3578770700,3
0,1625,74388,3578770697,3578770701,4
0,1625,74389,3578770697,3578770701,4
0,1625,74390,3578770697,3578770702,5
0,1625,74391,3578770697,3578770702,5
0,1625,74392,3578770697,3578770704,7
0,1625,74393,3578770697,3578770705,8
0,1625,74394,3578770697,3578770705,8
0,1625,74395,3578770697,3578770705,8
0,1625,74396,3578770697,3578770705,8
0,1625,74397,3578770697,3578770706,9
0,1625,74398,3578770697,3578770706,9
0,1625,74399,3578770697,3578770706,9
0,1625,74400,3578770697,3578770706,9
0,1625,74401,3578770697,3578770707,10
0,1625,74402,3578770697,3578770707,10
0,1625,74403,3578770697,3578770707,10
0,1625,74404,3578770697,3578770707,10
0,1625,74405,3578770697,3578770707,10
0,1625,74406,3578770697,3578770707,10
0,1625,74407,3578770697,3578770708,11
0,1625,74408,3578770697,3578770709,12
0,1625,74409,3578770697,3578770709,12
0,1625,74410,3578770697,3578770709,12
0,1625,74411,3578770697,3578770709,12
0,1625,74412,3578770697,3578770709,12
0,1625,74413,3578770697,3578770709,12
0,1625,74414,3578770697,3578770710,13
0,1625,74415,3578770697,3578770710,13
0,1625,74416,3578770697,3578770711,14
0,1625,74417,3578770697,3578770712,15
0,1625,74418,3578770697,3578770712,15
0,1625,74419,3578770697,3578770712,15
0,1625,74420,3578770697,3578770713,16
0,1625,74421,3578770697,3578770713,16
0,1625,74422,3578770697,3578770713,16
0,1625,74423,3578770697,3578770714,17
0,1625,74424,3578770697,3578770714,17
0,1625,74425,3578770697,3578770714,17
0,1625,74426,3578770697,3578770714,17
0,1625,74427,3578770697,3578770715,18
0,1625,74428,3578770697,3578770715,18
0,1625,74429,3578770697,3578770716,19
0,1625,74430,3578770697,3578770716,19
0,1625,74431,3578770697,3578770716,19
0,1625,74432,3578770697,3578770717,20
0,1625,74433,3578770697,3578770717,20
0,1625,74434,3578770697,3578770718,21
0,1625,74435,3578770697,3578770718,21
0,1625,74436,3578770697,3578770718,21
0,1625,74437,3578770697,3578770718,21
0,1625,74438,3578770697,3578770719,22
0,1625,74439,3578770697,3578770720,23
0,1625,74440,3578770697,3578770720,23
0,1625,74441,3578770697,3578770720,23
0,1625,74442,3578770697,3578770720,23
0,1625,74443,3578770697,3578770721,24
0,1625,74444,3578770697,3578770722,25
0,1625,74445,3578770697,3578770722,25
0,1625,74446,3578770697,3578770724,27
0,1625,74447,3578770697,3578770724,27
0,1625,74448,3578770697,3578770725,28
0,1625,74449,3578770697,3578770727,30
0,1625,74450,3578770697,3578770727,30
0,1625,74451,3578770697,3578770728,31
0,1625,74452,3578770697,3578770728,31
0,1625,74453,3578770697,3578770728,31
0,1625,74454,3578770697,3578770728,31
0,1625,74455,3578770697,3578770728,31
0,1625,74456,3578770697,3578770728,31
0,1625,74457,3578770697,3578770729,32
0,1625,74458,3578770697,3578770730,33
0,1625,74459,3578770697,3578770730,33
0,1625,74460,3578770697,3578770730,33
0,1625,74461,3578770697,3578770731,34
0,1625,74462,3578770697,3578770731,34
0,1625,74463,3578770697,3578770731,34
0,1625,74464,3578770697,3578770731,34
0,1625,74465,3578770697,3578770731,34
0,1625,74466,3578770697,3578770731,34
0,1625,74467,3578770697,3578770731,34
0,1625,74468,3578770697,3578770732,35
0,1625,74469,3578770697,3578770732,35
0,1625,74470,3578770697,3578770733,36
0,1625,74471,3578770697,3578770733,36
0,1625,74472,3578770697,3578770733,36
0,1625,74473,3578770697,3578770734,37
0,1625,74474,3578770697,3578770735,38
0,1625,74475,3578770697,3578770735,38
0,1625,74476,3578770697,3578770735,38
0,1625,74477,3578770697,3578770735,38
0,1625,74478,3578770697,3578770737,40
0,1625,74479,3578770697,3578770737,40
0,1625,74480,3578770697,3578770738,41
0,1625,74481,3578770697,3578770739,42
0,1625,74482,3578770697,3578770739,42
0,1625,74483,3578770697,3578770739,42
0,1625,74484,3578770697,3578770739,42
0,1625,74485,3578770697,3578770740,43
0,1625,74486,3578770697,3578770741,44
0,1625,74487,3578770697,3578770742,45
0,1625,74488,3578770697,3578770742,45
0,1625,74489,3578770697,3578770743,46
0,1625,74490,3578770697,3578770744,47
0,1625,74491,3578770697,3578770744,47
0,1625,74492,3578770697,3578770744,47
0,1625,74493,3578770697,3578770745,48
0,1625,74494,3578770697,3578770745,48
0,1625,74495,3578770697,3578770746,49
0,1625,74496,3578770697,3578770747,50
0,1626,74497,3578770762,3578770762,0
0,1626,74498,3578770762,3578770762,0
0,1626,74499,3578770762,3578770762,0
0,1626,74500,3578770762,3578770762,0
0,1626,74501,3578770762,3578770762,0
0,1626,74502,3578770762,3578770762,0
0,1626,74503,3578770762,3578770762,0
0,1626,74504,3578770762,3578770762,0
0,1626,74505,3578770762,3578770762,0
0,1626,74506,3578770762,3578770762,0
0,1626,74507,3578770762,3578770762,0
0,1626,74508,3578770762,3578770762,0
0,1626,74509,3578770762,3578770762,0
0,1626,74510,3578770762,3578770762,0
0,1626,74511,3578770762,3578770762,0
0,1626,74512,3578770762,3578770762,0
0,1626,74513,3578770762,3578770762,0
0,1626,74514,3578770762,3578770762,0
0,1626,74515,3578770762,3578770762,0
0,1626,74516,3578770762,3578770762,0
0,1626,74517,3578770762,3578770762,0
0,1626,74518,3578770762,3578770762,0
0,1626,74519,3578770762,3578770762,0
0,1626,74520,3578770762,3578770762,0
0,1626,74521,3578770762,3578770762,0
0,1626,74522,3578770762,3578770762,0
0,1626,74523,3578770762,3578770763,1
0,1626,74524,3578770762,3578770763,1
0,1626,74525,3578770762,3578770764,2
0,1626,74526,3578770762,3578770765,3
0,1626,74527,3578770762,3578770765,3
0,1626,74528,3578770762,3578770765,3
0,1626,74529,3578770762,3578770767,5
0,1626,74530,3578770762,3578770767,5
0,1626,74531,3578770762,3578770769,7
0,1626,74532,3578770762,3578770770,8
0,1626,74533,3578770762,3578770770,8
0,1626,74534,3578770762,3578770771,9
0,1626,74535,3578770762,3578770772,10
0,1626,74536,3578770762,3578770772,10
0,1626,74537,3578770762,3578770772,10
0,1626,74538,3578770762,3578770773,11
0,1626,74539,3578770762,3578770773,11
0,1626,74540,3578770762,3578770774,12
0,1626,74541,3578770762,3578770775,13
0,1626,74542,3578770762,3578770776,14
0,1626,74543,3578770762,3578770776,14
0,1626,74544,3578770762,3578770778,16
0,1626,74545,3578770762,3578770778,16
0,1626,74546,3578770762,3578770778,16
0,1626,74547,3578770762,3578770778,16
0,1626,74548,3578770762,3578770778,16
0,1626,74549,3578770762,3578770779,17
0,1626,74550,3578770762,3578770779,17
0,1626,74551,3578770762,3578770779,17
0,1626,74552,3578770762,3578770780,18
0,1626,74553,3578770762,3578770781,19
0,1626,74554,3578770762,3578770781,19
0,1626,74555,3578770762,3578770782,20
0,1626,74556,3578770762,3578770783,21
0,1626,74557,3578770762,3578770785,23
0,1626,74558,3578770762,3578770785,23
0,1626,74559,3578770762,3578770785,23
0,1626,74560,3578770762,3578770787,25
0,1626,74561,3578770762,3578770788,26
0,1626,74562,3578770762,3578770788,26
0,1626,74563,3578770762,3578770789,27
0,1626,74564,3578770762,3578770789,27
0,1626,74565,3578770762,3578770790,28
0,1626,74566,3578770762,3578770791,29
0,1626,74567,3578770762,3578770791,29
0,1626,74568,3578770762,3578770792,30
0,1626,74569,3578770762,3578770794,32
0,1626,74570,3578770762,3578770794,32
0,1626,74571,3578770762,3578770794,32
0,1626,74572,3578770762,3578770795,33
0,1626,74573,3578770762,3578770796,34
0,1626,74574,3578770762,3578770796,34
0,1626,74575,3578770762,3578770798,36
0,1626,74576,3578770762,3578770798,36
0,1626,74577,3578770762,3578770798,36
0,1626,74578,3578770762,3578770798,36
0,1626,74579,3578770762,3578770800,38
0,1626,74580,3578770762,3578770802,40
0,1626,74581,3578770762,3578770803,41
0,1626,74582,3578770762,3578770805,43
0,1626,74583,3578770762,3578770805,43
0,1626,74584,3578770762,3578770805,43
0,1626,74585,3578770762,3578770805,43
0,1626,74586,3578770762,3578770806,44
0,1626,74587,3578770762,3578770807,45
0,1626,74588,3578770762,3578770808,46
0,1626,74589,3578770762,3578770808,46
0,1626,74590,3578770762,3578770810,48
0,1626,74591,3578770762,3578770810,48
0,1626,74592,3578770762,3578770812,50
0,1627,74593,3578770827,3578770828,1
0,1627,74594,3578770827,3578770828,1
0,1627,74595,3578770827,3578770828,1
0,1627,74596,3578770827,3578770828,1
0,1627,74597,3578770827,3578770828,1
0,1627,74598,3578770827,3578770828,1
0,1627,74599,3578770827,3578770828,1
0,1627,74600,3578770827,3578770828,1
0,1627,74601,3578770827,3578770828,1
0,1627,74602,3578770827,3578770828,1
0,1627,74603,3578770827,3578770828,1
0,1627,74604,3578770827,3578770828,1
0,1627,74605,3578770827,3578770828,1
0,1627,74606,3578770827,3578770828,1
0,1627,74607,3578770827,3578770828,1
0,1627,74608,3578770827,3578770828,1
0,1627,74609,3578770827,3578770828,1
0,1627,74610,3578770827,3578770828,1
0,1627,74611,3578770827,3578770828,1
0,1627,74612,3578770827,3578770828,1
0,1627,74613,3578770827,3578770828,1
0,1627,74614,3578770827,3578770828,1
0,1627,74615,3578770827,3578770828,1
0,1627,74616,3578770827,3578770828,1
0,1627,74617,3578770827,3578770828,1
0,1627,74618,3578770827,3578770829,2
0,1627,74619,3578770827,3578770830,3
0,1627,74620,3578770827,3578770831,4
0,1627,74621,3578770827,3578770831,4
0,1627,74622,3578770827,3578770831,4
0,1627,74623,3578770827,3578770831,4
0,1627,74624,3578770827,3578770832,5
0,1627,74625,3578770827,3578770832,5
0,1627,74626,3578770827,3578770833,6
0,1627,74627,3578770827,3578770836,9
0,1627,74628,3578770827,3578770837,10
0,1627,74629,3578770827,3578770837,10
0,1627,74630,3578770827,3578770838,11
0,1627,74631,3578770827,3578770839,12
0,1627,74632,3578770827,3578770839,12
0,1627,74633,3578770827,3578770839,12
0,1627,74634,3578770827,3578770839,12
0,1627,74635,3578770827,3578770840,13
0,1627,74636,3578770827,3578770840,13
0,1627,74637,3578770827,3578770840,13
0,1627,74638,3578770827,3578770840,13
0,1627,74639,3578770827,3578770841,14
0,1627,74640,3578770827,3578770841,14
0,1627,74641,3578770827,3578770842,15
0,1627,74642,3578770827,3578770842,15
0,1627,74643,3578770827,3578770843,16
0,1627,74644,3578770827,3578770844,17
0,1627,74645,3578770827,3578770844,17
0,1627,74646,3578770827,3578770845,18
0,1627,74647,3578770827,3578770845,18
0,1627,74648,3578770827,3578770846,19
0,1627,74649,3578770827,3578770847,20
0,1627,74650,3578770827,3578770847,20
0,1627,74651,3578770827,3578770848,21
0,1627,74652,3578770827,3578770849,22
0,1627,74653,3578770827,3578770849,22
0,1627,74654,3578770827,3578770849,22
0,1627,74655,3578770827,3578770849,22
0,1627,74656,3578770827,3578770849,22
0,1627,74657,3578770827,3578770850,23
0,1627,74658,3578770827,3578770851,24
0,1627,74659,3578770827,3578770851,24
0,1627,74660,3578770827,3578770853,26
0,1627,74661,3578770827,3578770853,26
0,1627,74662,3578770827,3578770855,28
0,1627,74663,3578770827,3578770855,28
0,1627,74664,3578770827,3578770857,30
0,1627,74665,3578770827,3578770857,30
0,1627,74666,3578770827,3578770858,31
0,1627,74667,3578770827,3578770860,33
0,1627,74668,3578770827,3578770861,34
0,1627,74669,3578770827,3578770861,34
0,1627,74670,3578770827,3578770862,35
0,1627,74671,3578770827,3578770862,35
0,1627,74672,3578770827,3578770862,35
0,1627,74673,3578770827,3578770863,36
0,1627,74674,3578770827,3578770863,36
0,1627,74675,3578770827,3578770863,36
0,1627,74676,3578770827,3578770864,37
0,1627,74677,3578770827,3578770864,37
0,1627,74678,3578770827,3578770864,37
0,1627,74679,3578770827,3578770865,38
0,1627,74680,3578770827,3578770865,38
0,1627,74681,3578770827,3578770866,39
0,1627,74682,3578770827,3578770867,40
0,1627,74683,3578770827,3578770868,41
0,1627,74684,3578770827,3578770868,41
0,1627,74685,3578770827,3578770869,42
0,1627,74686,3578770827,3578770875,48
0,1628,74687,3578770896,3578770896,0
0,1628,74688,3578770896,3578770896,0
0,1628,74689,3578770896,3578770896,0
0,1628,74690,3578770896,3578770896,0
0,1628,74691,3578770896,3578770896,0
0,1628,74692,3578770896,3578770896,0
0,1628,74693,3578770896,3578770896,0
0,1628,74694,3578770896,3578770896,0
0,1628,74695,3578770896,3578770896,0
0,1628,74696,3578770896,3578770896,0
0,1628,74697,3578770896,3578770896,0
0,1628,74698,3578770896,3578770896,0
0,1628,74699,3578770896,3578770896,0
0,1628,74700,3578770896,3578770896,0
0,1628,74701,3578770896,3578770896,0
0,1628,74702,3578770896,3578770896,0
0,1628,74703,3578770896,3578770896,0
0,1628,74704,3578770896,3578770896,0
0,1628,74705,3578770896,3578770896,0
0,1628,74706,3578770896,3578770897,1
0,1628,74707,3578770896,3578770897,1
0,1628,74708,3578770896,3578770897,1
0,1628,74709,3578770896,3578770897,1
0,1628,74710,3578770896,3578770898,2
0,1628,74711,3578770896,3578770898,2
0,1628,74712,3578770896,3578770898,2
0,1628,74713,3578770896,3578770898,2
0,1628,74714,3578770896,3578770899,3
0,1628,74715,3578770896,3578770899,3
0,1628,74716,3578770896,3578770900,4
0,1628,74717,3578770896,3578770900,4
0,1628,74718,3578770896,3578770900,4
0,1628,74719,3578770896,3578770901,5
0,1628,74720,3578770896,3578770901,5
0,1628,74721,3578770896,3578770902,6
0,1628,74722,3578770896,3578770902,6
0,1628,74723,3578770896,3578770904,8
0,1628,74724,3578770896,3578770904,8
0,1628,74725,3578770896,3578770905,9
0,1628,74726,3578770896,3578770905,9
0,1628,74727,3578770896,3578770905,9
0,1628,74728,3578770896,3578770905,9
0,1628,74729,3578770896,3578770906,10
0,1628,74730,3578770896,3578770906,10
0,1628,74731,3578770896,3578770906,10
0,1628,74732,3578770896,3578770907,11
0,1628,74733,3578770896,3578770907,11
0,1628,74734,3578770896,3578770907,11
0,1628,74735,3578770896,3578770908,12
0,1628,74736,3578770896,3578770908,12
0,1628,74737,3578770896,3578770908,12
0,1628,74738,3578770896,3578770909,13
0,1628,74739,3578770896,3578770909,13
0,1628,74740,3578770896,3578770909,13
0,1628,74741,3578770896,3578770909,13
0,1628,74742,3578770896,3578770909,13
0,1628,74743,3578770896,3578770910,14
0,1628,74744,3578770896,3578770910,14
0,1628,74745,3578770896,3578770911,15
0,1628,74746,3578770896,3578770911,15
0,1628,74747,3578770896,3578770911,15
0,1628,74748,3578770896,3578770912,16
0,1628,74749,3578770896,3578770912,16
0,1628,74750,3578770896,3578770913,17
0,1628,74751,3578770896,3578770914,18
0,1628,74752,3578770896,3578770914,18
0,1628,74753,3578770896,3578770914,18
0,1628,74754,3578770896,3578770914,18
0,1628,74755,3578770896,3578770915,19
0,1628,74756,3578770896,3578770915,19
0,1628,74757,3578770896,3578770915,19
0,1628,74758,3578770896,3578770916,20
0,1628,74759,3578770896,3578770916,20
0,1628,74760,3578770896,3578770916,20
0,1628,74761,3578770896,3578770917,21
0,1628,74762,3578770896,3578770917,21
0,1628,74763,3578770896,3578770917,21
0,1628,74764,3578770896,3578770917,21
0,1628,74765,3578770896,3578770918,22
0,1628,74766,3578770896,3578770919,23
0,1628,74767,3578770896,3578770919,23
0,1628,74768,3578770896,3578770919,23
0,1628,74769,3578770896,3578770919,23
0,1628,74770,3578770896,3578770920,24
0,1628,74771,3578770896,3578770920,24
0,1628,74772,3578770896,3578770920,24
0,1628,74773,3578770896,3578770920,24
0,1628,74774,3578770896,3578770921,25
0,1628,74775,3578770896,3578770922,26
0,1628,74776,3578770896,3578770923,27
0,1628,74777,3578770896,3578770924,28
0,1628,74778,3578770896,3578770924,28
0,1628,74779,3578770896,3578770924,28
0,1628,74780,3578770896,3578770925,29
0,1628,74781,3578770896,3578770927,31
0,1628,74782,3578770896,3578770927,31
0,1628,74783,3578770896,3578770928,32
0,1628,74784,3578770896,3578770928,32
0,1628,74785,3578770896,3578770928,32
0,1628,74786,3578770896,3578770929,33
0,1628,74787,3578770896,3578770929,33
0,1628,74788,3578770896,3578770929,33
0,1628,74789,3578770896,3578770929,33
0,1628,74790,3578770896,3578770930,34
0,1628,74791,3578770896,3578770930,34
0,1628,74792,3578770896,3578770930,34
0,1628,74793,3578770896,3578770931,35
0,1628,74794,3578770896,3578770931,35
0,1628,74795,3578770896,3578770931,35
0,1628,74796,3578770896,3578770931,35
0,1628,74797,3578770896,3578770931,35
0,1628,74798,3578770896,3578770931,35
0,1628,74799,3578770896,3578770932,36
0,1628,74800,3578770896,3578770933,37
0,1628,74801,3578770896,3578770933,37
0,1628,74802,3578770896,3578770933,37
0,1628,74803,3578770896,3578770933,37
0,1628,74804,3578770896,3578770935,39
0,1628,74805,3578770896,3578770935,39
0,1628,74806,3578770896,3578770938,42
0,1628,74807,3578770896,3578770938,42
0,1628,74808,3578770896,3578770939,43
0,1628,74809,3578770896,3578770940,44
0,1628,74810,3578770896,3578770940,44
0,1628,74811,3578770896,3578770940,44
0,1628,74812,3578770896,3578770941,45
0,1628,74813,3578770896,3578770942,46
0,1628,74814,3578770896,3578770942,46
0,1628,74815,3578770896,3578770942,46
0,1628,74816,3578770896,3578770943,47
0,1628,74817,3578770896,3578770944,48
0,1628,74818,3578770896,3578770944,48
0,1628,74819,3578770896,3578770944,48
0,1628,74820,3578770896,3578770944,48
0,1628,74821,3578770896,3578770946,50
0,1629,74822,3578770963,3578770963,0
0,1629,74823,3578770963,3578770963,0
0,1629,74824,3578770963,3578770963,0
0,1629,74825,3578770963,3578770963,0
0,1629,74826,3578770963,3578770963,0
0,1629,74827,3578770963,3578770963,0
0,1629,74828,3578770963,3578770963,0
0,1629,74829,3578770963,3578770963,0
0,1629,74830,3578770963,3578770963,0
0,1629,74831,3578770963,3578770963,0
0,1629,74832,3578770963,3578770963,0
0,1629,74833,3578770963,3578770963,0
0,1629,74834,3578770963,3578770963,0
0,1629,74835,3578770963,3578770963,0
0,1629,74836,3578770963,3578770963,0
0,1629,74837,3578770963,3578770963,0
0,1629,74838,3578770963,3578770963,0
0,1629,74839,3578770963,3578770963,0
0,1629,74840,3578770963,3578770963,0
0,1629,74841,3578770963,3578770963,0
0,1629,74842,3578770963,3578770963,0
0,1629,74843,3578770963,3578770963,0
0,1629,74844,3578770963,3578770963,0
0,1629,74845,3578770963,3578770963,0
0,1629,74846,3578770963,3578770963,0
0,1629,74847,3578770963,3578770963,0
0,1629,74848,3578770963,3578770963,0
0,1629,74849,3578770963,3578770963,0
0,1629,74850,3578770963,3578770963,0
0,1629,74851,3578770963,3578770963,0
0,1629,74852,3578770963,3578770963,0
0,1629,74853,3578770963,3578770963,0
0,1629,74854,3578770963,3578770963,0
0,1629,74855,3578770963,3578770963,0
0,1629,74856,3578770963,3578770964,1
0,1629,74857,3578770963,3578770964,1
0,1629,74858,3578770963,3578770965,2
0,1629,74859,3578770963,3578770965,2
0,1629,74860,3578770963,3578770965,2
0,1629,74861,3578770963,3578770967,4
0,1629,74862,3578770963,3578770968,5
0,1629,74863,3578770963,3578770968,5
0,1629,74864,3578770963,3578770969,6
0,1629,74865,3578770963,3578770970,7
0,1629,74866,3578770963,3578770970,7
0,1629,74867,3578770963,3578770971,8
0,1629,74868,3578770963,3578770971,8
0,1629,74869,3578770963,3578770972,9
0,1629,74870,3578770963,3578770972,9
0,1629,74871,3578770963,3578770973,10
0,1629,74872,3578770963,3578770973,10
0,1629,74873,3578770963,3578770973,10
0,1629,74874,3578770963,3578770974,11
0,1629,74875,3578770963,3578770974,11
0,1629,74876,3578770963,3578770975,12
0,1629,74877,3578770963,3578770976,13
0,1629,74878,3578770963,3578770977,14
0,1629,74879,3578770963,3578770978,15
0,1629,74880,3578770963,3578770978,15
0,1629,74881,3578770963,3578770978,15
0,1629,74882,3578770963,3578770979,16
0,1629,74883,3578770963,3578770979,16
0,1629,74884,3578770963,3578770980,17
0,1629,74885,3578770963,3578770980,17
0,1629,74886,3578770963,3578770980,17
0,1629,74887,3578770963,3578770982,19
0,1629,74888,3578770963,3578770983,20
0,1629,74889,3578770963,3578770985,22
0,1629,74890,3578770963,3578770985,22
0,1629,74891,3578770963,3578770986,23
0,1629,74892,3578770963,3578770988,25
0,1629,74893,3578770963,3578770988,25
0,1629,74894,3578770963,3578770988,25
0,1629,74895,3578770963,3578770989,26
0,1629,74896,3578770963,3578770989,26
0,1629,74897,3578770963,3578770989,26
0,1629,74898,3578770963,3578770989,26
0,1629,74899,3578770963,3578770991,28
0,1629,74900,3578770963,3578770992,29
0,1629,74901,3578770963,3578770994,31
0,1629,74902,3578770963,3578770994,31
0,1629,74903,3578770963,3578770994,31
0,1629,74904,3578770963,3578770995,32
0,1629,74905,3578770963,3578770995,32
0,1629,74906,3578770963,3578770997,34
0,1629,74907,3578770963,3578770997,34
0,1629,74908,3578770963,3578770998,35
0,1629,74909,3578770963,3578770998,35
0,1629,74910,3578770963,3578770999,36
0,1629,74911,3578770963,3578770999,36
0,1629,74912,3578770963,3578771000,37
0,1629,74913,3578770963,3578771000,37
0,1629,74914,3578770963,3578771002,39
0,1629,74915,3578770963,3578771003,40
0,1629,74916,3578770963,3578771004,41
0,1629,74917,3578770963,3578771005,42
0,1629,74918,3578770963,3578771006,43
0,1629,74919,3578770963,3578771006,43
0,1629,74920,3578770963,3578771006,43
0,1629,74921,3578770963,3578771007,44
0,1629,74922,3578770963,3578771007,44
0,1629,74923,3578770963,3578771010,47
0,1629,74924,3578770963,3578771013,50
0,1630,74925,3578771030,3578771030,0
0,1630,74926,3578771030,3578771030,0
0,1630,74927,3578771030,3578771030,0
0,1630,74928,3578771030,3578771030,0
0,1630,74929,3578771030,3578771030,0
0,1630,74930,3578771030,3578771030,0
0,1630,74931,3578771030,3578771030,0
0,1630,74932,3578771030,3578771030,0
0,1630,74933,3578771030,3578771030,0
0,1630,74934,3578771030,3578771030,0
0,1630,74935,3578771030,3578771030,0
0,1630,74936,3578771030,3578771030,0
0,1630,74937,3578771030,3578771030,0
0,1630,74938,3578771030,3578771030,0
0,1630,74939,3578771030,3578771030,0
0,1630,74940,3578771030,3578771030,0
0,1630,74941,3578771030,3578771030,0
0,1630,74942,3578771030,3578771030,0
0,1630,74943,3578771030,3578771030,0
0,1630,74944,3578771030,3578771030,0
0,1630,74945,3578771030,3578771030,0
0,1630,74946,3578771030,3578771030,0
0,1630,74947,3578771030,3578771030,0
0,1630,74948,3578771030,3578771030,0
0,1630,74949,3578771030,3578771030,0
0,1630,74950,3578771030,3578771030,0
0,1630,74951,3578771030,3578771030,0
0,1630,74952,3578771030,3578771030,0
0,1630,74953,3578771030,3578771031,1
0,1630,74954,3578771030,3578771031,1
0,1630,74955,3578771030,3578771031,1
0,1630,74956,3578771030,3578771031,1
0,1630,74957,3578771030,3578771033,3
0,1630,74958,3578771030,3578771034,4
0,1630,74959,3578771030,3578771036,6
0,1630,74960,3578771030,3578771037,7
0,1630,74961,3578771030,3578771037,7
0,1630,74962,3578771030,3578771037,7
0,1630,74963,3578771030,3578771038,8
0,1630,74964,3578771030,3578771039,9
0,1630,74965,3578771030,3578771039,9
0,1630,74966,3578771030,3578771039,9
0,1630,74967,3578771030,3578771039,9
0,1630,74968,3578771030,3578771040,10
0,1630,74969,3578771030,3578771041,11
0,1630,74970,3578771030,3578771041,11
0,1630,74971,3578771030,3578771041,11
0,1630,74972,3578771030,3578771042,12
0,1630,74973,3578771030,3578771042,12
0,1630,74974,3578771030,3578771043,13
0,1630,74975,3578771030,3578771043,13
0,1630,74976,3578771030,3578771044,14
0,1630,74977,3578771030,3578771044,14
0,1630,74978,3578771030,3578771044,14
0,1630,74979,3578771030,3578771047,17
0,1630,74980,3578771030,3578771047,17
0,1630,74981,3578771030,3578771047,17
0,1630,74982,3578771030,3578771048,18
0,1630,74983,3578771030,3578771048,18
0,1630,74984,3578771030,3578771049,19
0,1630,74985,3578771030,3578771049,19
0,1630,74986,3578771030,3578771049,19
0,1630,74987,3578771030,3578771050,20
0,1630,74988,3578771030,3578771050,20
0,1630,74989,3578771030,3578771051,21
0,1630,74990,3578771030,3578771051,21
0,1630,74991,3578771030,3578771053,23
0,1630,74992,3578771030,3578771053,23
0,1630,74993,3578771030,3578771055,25
0,1630,74994,3578771030,3578771056,26
0,1630,74995,3578771030,3578771058,28
0,1630,74996,3578771030,3578771058,28
0,1630,74997,3578771030,3578771058,28
0,1630,74998,3578771030,3578771059,29
0,1630,74999,3578771030,3578771060,30
0,1630,75000,3578771030,3578771061,31
0,1630,75001,3578771030,3578771061,31
0,1630,75002,3578771030,3578771062,32
0,1630,75003,3578771030,3578771062,32
0,1630,75004,3578771030,3578771062,32
0,1630,75005,3578771030,3578771063,33
0,1630,75006,3578771030,3578771063,33
0,1630,75007,3578771030,3578771064,34
0,1630,75008,3578771030,3578771064,34
0,1630,75009,3578771030,3578771064,34
0,1630,75010,3578771030,3578771064,34
0,1630,75011,3578771030,3578771065,35
0,1630,75012,3578771030,3578771066,36
0,1630,75013,3578771030,3578771067,37
0,1630,75014,3578771030,3578771067,37
0,1630,75015,3578771030,3578771068,38
0,1630,75016,3578771030,3578771069,39
0,1630,75017,3578771030,3578771069,39
0,1630,75018,3578771030,3578771074,44
0,1631,75019,3578771096,3578771096,0
0,1631,75020,3578771096,3578771096,0
0,1631,75021,3578771096,3578771096,0
0,1631,75022,3578771096,3578771096,0
0,1631,75023,3578771096,3578771096,0
0,1631,75024,3578771096,3578771096,0
0,1631,75025,3578771096,3578771096,0
0,1631,75026,3578771096,3578771096,0
0,1631,75027,3578771096,3578771096,0
0,1631,75028,3578771096,3578771096,0
0,1631,75029,3578771096,3578771096,0
0,1631,75030,3578771096,3578771096,0
0,1631,75031,3578771096,3578771096,0
0,1631,75032,3578771096,3578771096,0
0,1631,75033,3578771096,3578771096,0
0,1631,75034,3578771096,3578771096,0
0,1631,75035,3578771096,3578771096,0
0,1631,75036,3578771096,3578771096,0
0,1631,75037,3578771096,3578771097,1
0,1631,75038,3578771096,3578771097,1
0,1631,75039,3578771096,3578771097,1
0,1631,75040,3578771096,3578771098,2
0,1631,75041,3578771096,3578771098,2
0,1631,75042,3578771096,3578771098,2
0,1631,75043,3578771096,3578771098,2
0,1631,75044,3578771096,3578771098,2
0,1631,75045,3578771096,3578771099,3
0,1631,75046,3578771096,3578771099,3
0,1631,75047,3578771096,3578771099,3
0,1631,75048,3578771096,3578771100,4
0,1631,75049,3578771096,3578771100,4
0,1631,75050,3578771096,3578771100,4
0,1631,75051,3578771096,3578771101,5
0,1631,75052,3578771096,3578771101,5
0,1631,75053,3578771096,3578771101,5
0,1631,75054,3578771096,3578771102,6
0,1631,75055,3578771096,3578771102,6
0,1631,75056,3578771096,3578771104,8
0,1631,75057,3578771096,3578771105,9
0,1631,75058,3578771096,3578771105,9
0,1631,75059,3578771096,3578771105,9
0,1631,75060,3578771096,3578771105,9
0,1631,75061,3578771096,3578771106,10
0,1631,75062,3578771096,3578771106,10
0,1631,75063,3578771096,3578771106,10
0,1631,75064,3578771096,3578771106,10
0,1631,75065,3578771096,3578771107,11
0,1631,75066,3578771096,3578771107,11
0,1631,75067,3578771096,3578771107,11
0,1631,75068,3578771096,3578771108,12
0,1631,75069,3578771096,3578771109,13
0,1631,75070,3578771096,3578771109,13
0,1631,75071,3578771096,3578771109,13
0,1631,75072,3578771096,3578771109,13
0,1631,75073,3578771096,3578771110,14
0,1631,75074,3578771096,3578771110,14
0,1631,75075,3578771096,3578771110,14
0,1631,75076,3578771096,3578771110,14
0,1631,75077,3578771096,3578771110,14
0,1631,75078,3578771096,3578771111,15
0,1631,75079,3578771096,3578771111,15
0,1631,75080,3578771096,3578771112,16
0,1631,75081,3578771096,3578771112,16
0,1631,75082,3578771096,3578771112,16
0,1631,75083,3578771096,3578771114,18
0,1631,75084,3578771096,3578771114,18
0,1631,75085,3578771096,3578771114,18
0,1631,75086,3578771096,3578771115,19
0,1631,75087,3578771096,3578771115,19
0,1631,75088,3578771096,3578771115,19
0,1631,75089,3578771096,3578771115,19
0,1631,75090,3578771096,3578771115,19
0,1631,75091,3578771096,3578771116,20
0,1631,75092,3578771096,3578771116,20
0,1631,75093,3578771096,3578771116,20
0,1631,75094,3578771096,3578771117,21
0,1631,75095,3578771096,3578771117,21
0,1631,75096,3578771096,3578771117,21
0,1631,75097,3578771096,3578771118,22
0,1631,75098,3578771096,3578771118,22
0,1631,75099,3578771096,3578771119,23
0,1631,75100,3578771096,3578771119,23
0,1631,75101,3578771096,3578771119,23
0,1631,75102,3578771096,3578771120,24
0,1631,75103,3578771096,3578771120,24
0,1631,75104,3578771096,3578771121,25
0,1631,75105,3578771096,3578771122,26
0,1631,75106,3578771096,3578771123,27
0,1631,75107,3578771096,3578771123,27
0,1631,75108,3578771096,3578771123,27
0,1631,75109,3578771096,3578771123,27
0,1631,75110,3578771096,3578771124,28
0,1631,75111,3578771096,3578771124,28
0,1631,75112,3578771096,3578771125,29
0,1631,75113,3578771096,3578771126,30
0,1631,75114,3578771096,3578771127,31
0,1631,75115,3578771096,3578771128,32
0,1631,75116,3578771096,3578771128,32
0,1631,75117,3578771096,3578771128,32
0,1631,75118,3578771096,3578771128,32
0,1631,75119,3578771096,3578771129,33
0,1631,75120,3578771096,3578771129,33
0,1631,75121,3578771096,3578771129,33
0,1631,75122,3578771096,3578771130,34
0,1631,75123,3578771096,3578771130,34
0,1631,75124,3578771096,3578771131,35
0,1631,75125,3578771096,3578771131,35
0,1631,75126,3578771096,3578771131,35
0,1631,75127,3578771096,3578771131,35
0,1631,75128,3578771096,3578771132,36
0,1631,75129,3578771096,3578771132,36
0,1631,75130,3578771096,3578771132,36
0,1631,75131,3578771096,3578771132,36
0,1631,75132,3578771096,3578771133,37
0,1631,75133,3578771096,3578771133,37
0,1631,75134,3578771096,3578771134,38
0,1631,75135,3578771096,3578771134,38
0,1631,75136,3578771096,3578771135,39
0,1631,75137,3578771096,3578771135,39
0,1631,75138,3578771096,3578771135,39
0,1631,75139,3578771096,3578771139,43
0,1631,75140,3578771096,3578771140,44
0,1631,75141,3578771096,3578771141,45
0,1631,75142,3578771096,3578771141,45
0,1631,75143,3578771096,3578771142,46
0,1631,75144,3578771096,3578771142,46
0,1631,75145,3578771096,3578771143,47
0,1631,75146,3578771096,3578771143,47
0,1631,75147,3578771096,3578771144,48
0,1631,75148,3578771096,3578771144,48
0,1631,75149,3578771096,3578771144,48
0,1631,75150,3578771096,3578771145,49
0,1632,75151,3578771160,3578771160,0
0,1632,75152,3578771160,3578771160,0
0,1632,75153,3578771160,3578771160,0
0,1632,75154,3578771160,3578771160,0
0,1632,75155,3578771160,3578771160,0
0,1632,75156,3578771160,3578771160,0
0,1632,75157,3578771160,3578771160,0
0,1632,75158,3578771160,3578771160,0
0,1632,75159,3578771160,3578771160,0
0,1632,75160,3578771160,3578771160,0
0,1632,75161,3578771160,3578771160,0
0,1632,75162,3578771160,3578771160,0
0,1632,75163,3578771160,3578771160,0
0,1632,75164,3578771160,3578771160,0
0,1632,75165,3578771160,3578771160,0
0,1632,75166,3578771160,3578771160,0
0,1632,75167,3578771160,3578771160,0
0,1632,75168,3578771160,3578771160,0
0,1632,75169,3578771160,3578771160,0
0,1632,75170,3578771160,3578771160,0
0,1632,75171,3578771160,3578771160,0
0,1632,75172,3578771160,3578771160,0
0,1632,75173,3578771160,3578771160,0
0,1632,75174,3578771160,3578771160,0
0,1632,75175,3578771160,3578771160,0
0,1632,75176,3578771160,3578771160,0
0,1632,75177,3578771160,3578771160,0
0,1632,75178,3578771160,3578771161,1
0,1632,75179,3578771160,3578771161,1
0,1632,75180,3578771160,3578771161,1
0,1632,75181,3578771160,3578771161,1
0,1632,75182,3578771160,3578771162,2
0,1632,75183,3578771160,3578771162,2
0,1632,75184,3578771160,3578771163,3
0,1632,75185,3578771160,3578771163,3
0,1632,75186,3578771160,3578771164,4
0,1632,75187,3578771160,3578771165,5
0,1632,75188,3578771160,3578771166,6
0,1632,75189,3578771160,3578771166,6
0,1632,75190,3578771160,3578771168,8
0,1632,75191,3578771160,3578771170,10
0,1632,75192,3578771160,3578771171,11
0,1632,75193,3578771160,3578771171,11
0,1632,75194,3578771160,3578771171,11
0,1632,75195,3578771160,3578771172,12
0,1632,75196,3578771160,3578771172,12
0,1632,75197,3578771160,3578771172,12
0,1632,75198,3578771160,3578771172,12
0,1632,75199,3578771160,3578771174,14
0,1632,75200,3578771160,3578771174,14
0,1632,75201,3578771160,3578771175,15
0,1632,75202,3578771160,3578771175,15
0,1632,75203,3578771160,3578771178,18
0,1632,75204,3578771160,3578771178,18
0,1632,75205,3578771160,3578771178,18
0,1632,75206,3578771160,3578771178,18
0,1632,75207,3578771160,3578771179,19
0,1632,75208,3578771160,3578771179,19
0,1632,75209,3578771160,3578771179,19
0,1632,75210,3578771160,3578771179,19
0,1632,75211,3578771160,3578771180,20
0,1632,75212,3578771160,3578771182,22
0,1632,75213,3578771160,3578771183,23
0,1632,75214,3578771160,3578771184,24
0,1632,75215,3578771160,3578771185,25
0,1632,75216,3578771160,3578771185,25
0,1632,75217,3578771160,3578771187,27
0,1632,75218,3578771160,3578771188,28
0,1632,75219,3578771160,3578771188,28
0,1632,75220,3578771160,3578771189,29
0,1632,75221,3578771160,3578771189,29
0,1632,75222,3578771160,3578771190,30
0,1632,75223,3578771160,3578771190,30
0,1632,75224,3578771160,3578771190,30
0,1632,75225,3578771160,3578771191,31
0,1632,75226,3578771160,3578771191,31
0,1632,75227,3578771160,3578771191,31
0,1632,75228,3578771160,3578771194,34
0,1632,75229,3578771160,3578771194,34
0,1632,75230,3578771160,3578771195,35
0,1632,75231,3578771160,3578771196,36
0,1632,75232,3578771160,3578771197,37
0,1632,75233,3578771160,3578771198,38
0,1632,75234,3578771160,3578771199,39
0,1632,75235,3578771160,3578771199,39
0,1632,75236,3578771160,3578771199,39
0,1632,75237,3578771160,3578771199,39
0,1632,75238,3578771160,3578771200,40
0,1632,75239,3578771160,3578771202,42
0,1632,75240,3578771160,3578771204,44
0,1632,75241,3578771160,3578771204,44
0,1632,75242,3578771160,3578771205,45
0,1632,75243,3578771160,3578771205,45
0,1632,75244,3578771160,3578771206,46
0,1632,75245,3578771160,3578771206,46
0,1632,75246,3578771160,3578771207,47
0,1632,75247,3578771160,3578771209,49
0,1632,75248,3578771160,3578771209,49
0,1632,75249,3578771160,3578771210,50
0,1633,75250,3578771226,3578771226,0
0,1633,75251,3578771226,3578771226,0
0,1633,75252,3578771226,3578771226,0
0,1633,75253,3578771226,3578771226,0
0,1633,75254,3578771226,3578771226,0
0,1633,75255,3578771226,3578771226,0
0,1633,75256,3578771226,3578771226,0
0,1633,75257,3578771226,3578771226,0
0,1633,75258,3578771226,3578771226,0
0,1633,75259,3578771226,3578771226,0
0,1633,75260,3578771226,3578771226,0
0,1633,75261,3578771226,3578771226,0
0,1633,75262,3578771226,3578771226,0
0,1633,75263,3578771226,3578771226,0
0,1633,75264,3578771226,3578771226,0
0,1633,75265,3578771226,3578771226,0
0,1633,75266,3578771226,3578771226,0
0,1633,75267,3578771226,3578771226,0
0,1633,75268,3578771226,3578771226,0
0,1633,75269,3578771226,3578771226,0
0,1633,75270,3578771226,3578771226,0
0,1633,75271,3578771226,3578771226,0
0,1633,75272,3578771226,3578771226,0
0,1633,75273,3578771226,3578771226,0
0,1633,75274,3578771226,3578771226,0
0,1633,75275,3578771226,3578771226,0
0,1633,75276,3578771226,3578771227,1
0,1633,75277,3578771226,3578771228,2
0,1633,75278,3578771226,3578771228,2
0,1633,75279,3578771226,3578771229,3
0,1633,75280,3578771226,3578771229,3
0,1633,75281,3578771226,3578771230,4
0,1633,75282,3578771226,3578771230,4
0,1633,75283,3578771226,3578771231,5
0,1633,75284,3578771226,3578771231,5
0,1633,75285,3578771226,3578771231,5
0,1633,75286,3578771226,3578771232,6
0,1633,75287,3578771226,3578771234,8
0,1633,75288,3578771226,3578771235,9
0,1633,75289,3578771226,3578771236,10
0,1633,75290,3578771226,3578771237,11
0,1633,75291,3578771226,3578771237,11
0,1633,75292,3578771226,3578771238,12
0,1633,75293,3578771226,3578771238,12
0,1633,75294,3578771226,3578771239,13
0,1633,75295,3578771226,3578771240,14
0,1633,75296,3578771226,3578771240,14
0,1633,75297,3578771226,3578771240,14
0,1633,75298,3578771226,3578771240,14
0,1633,75299,3578771226,3578771241,15
0,1633,75300,3578771226,3578771242,16
0,1633,75301,3578771226,3578771242,16
0,1633,75302,3578771226,3578771242,16
0,1633,75303,3578771226,3578771242,16
0,1633,75304,3578771226,3578771243,17
0,1633,75305,3578771226,3578771244,18
0,1633,75306,3578771226,3578771245,19
0,1633,75307,3578771226,3578771246,20
0,1633,75308,3578771226,3578771247,21
0,1633,75309,3578771226,3578771247,21
0,1633,75310,3578771226,3578771248,22
0,1633,75311,3578771226,3578771248,22
0,1633,75312,3578771226,3578771249,23
0,1633,75313,3578771226,3578771249,23
0,1633,75314,3578771226,3578771249,23
0,1633,75315,3578771226,3578771249,23
0,1633,75316,3578771226,3578771250,24
0,1633,75317,3578771226,3578771251,25
0,1633,75318,3578771226,3578771252,26
0,1633,75319,3578771226,3578771252,26
0,1633,75320,3578771226,3578771253,27
0,1633,75321,3578771226,3578771254,28
0,1633,75322,3578771226,3578771255,29
0,1633,75323,3578771226,3578771256,30
0,1633,75324,3578771226,3578771257,31
0,1633,75325,3578771226,3578771258,32
0,1633,75326,3578771226,3578771258,32
0,1633,75327,3578771226,3578771259,33
0,1633,75328,3578771226,3578771260,34
0,1633,75329,3578771226,3578771260,34
0,1633,75330,3578771226,3578771260,34
0,1633,75331,3578771226,3578771261,35
0,1633,75332,3578771226,3578771262,36
0,1633,75333,3578771226,3578771262,36
0,1633,75334,3578771226,3578771262,36
0,1633,75335,3578771226,3578771263,37
0,1633,75336,3578771226,3578771264,38
0,1633,75337,3578771226,3578771264,38
0,1633,75338,3578771226,3578771265,39
0,1633,75339,3578771226,3578771265,39
0,1633,75340,3578771226,3578771265,39
0,1633,75341,3578771226,3578771266,40
0,1633,75342,3578771226,3578771266,40
0,1633,75343,3578771226,3578771267,41
0,1633,75344,3578771226,3578771268,42
0,1633,75345,3578771226,3578771268,42
0,1633,75346,3578771226,3578771269,43
0,1634,75347,3578771292,3578771292,0
0,1634,75348,3578771292,3578771292,0
0,1634,75349,3578771292,3578771292,0
0,1634,75350,3578771292,3578771292,0
0,1634,75351,3578771292,3578771292,0
0,1634,75352,3578771292,3578771292,0
0,1634,75353,3578771292,3578771292,0
0,1634,75354,3578771292,3578771292,0
0,1634,75355,3578771292,3578771292,0
0,1634,75356,3578771292,3578771292,0
0,1634,75357,3578771292,3578771292,0
0,1634,75358,3578771292,3578771292,0
0,1634,75359,3578771292,3578771293,1
0,1634,75360,3578771292,3578771293,1
0,1634,75361,3578771292,3578771294,2
0,1634,75362,3578771292,3578771295,3
0,1634,75363,3578771292,3578771295,3
0,1634,75364,3578771292,3578771296,4
0,1634,75365,3578771292,3578771297,5
0,1634,75366,3578771292,3578771297,5
0,1634,75367,3578771292,3578771298,6
0,1634,75368,3578771292,3578771298,6
0,1634,75369,3578771292,3578771298,6
0,1634,75370,3578771292,3578771298,6
0,1634,75371,3578771292,3578771299,7
0,1634,75372,3578771292,3578771299,7
0,1634,75373,3578771292,3578771300,8
0,1634,75374,3578771292,3578771300,8
0,1634,75375,3578771292,3578771300,8
0,1634,75376,3578771292,3578771301,9
0,1634,75377,3578771292,3578771301,9
0,1634,75378,3578771292,3578771302,10
0,1634,75379,3578771292,3578771302,10
0,1634,75380,3578771292,3578771304,12
0,1634,75381,3578771292,3578771305,13
0,1634,75382,3578771292,3578771305,13
0,1634,75383,3578771292,3578771305,13
0,1634,75384,3578771292,3578771305,13
0,1634,75385,3578771292,3578771306,14
0,1634,75386,3578771292,3578771306,14
0,1634,75387,3578771292,3578771307,15
0,1634,75388,3578771292,3578771307,15
0,1634,75389,3578771292,3578771307,15
0,1634,75390,3578771292,3578771307,15
0,1634,75391,3578771292,3578771308,16
0,1634,75392,3578771292,3578771308,16
0,1634,75393,3578771292,3578771308,16
0,1634,75394,3578771292,3578771308,16
0,1634,75395,3578771292,3578771309,17
0,1634,75396,3578771292,3578771309,17
0,1634,75397,3578771292,3578771309,17
0,1634,75398,3578771292,3578771310,18
0,1634,75399,3578771292,3578771310,18
0,1634,75400,3578771292,3578771310,18
0,1634,75401,3578771292,3578771310,18
0,1634,75402,3578771292,3578771310,18
0,1634,75403,3578771292,3578771311,19
0,1634,75404,3578771292,3578771312,20
0,1634,75405,3578771292,3578771312,20
0,1634,75406,3578771292,3578771312,20
0,1634,75407,3578771292,3578771312,20
0,1634,75408,3578771292,3578771313,21
0,1634,75409,3578771292,3578771315,23
0,1634,75410,3578771292,3578771315,23
0,1634,75411,3578771292,3578771315,23
0,1634,75412,3578771292,3578771315,23
0,1634,75413,3578771292,3578771315,23
0,1634,75414,3578771292,3578771316,24
0,1634,75415,3578771292,3578771316,24
0,1634,75416,3578771292,3578771316,24
0,1634,75417,3578771292,3578771317,25
0,1634,75418,3578771292,3578771317,25
0,1634,75419,3578771292,3578771317,25
0,1634,75420,3578771292,3578771318,26
0,1634,75421,3578771292,3578771318,26
0,1634,75422,3578771292,3578771318,26
0,1634,75423,3578771292,3578771318,26
0,1634,75424,3578771292,3578771319,27
0,1634,75425,3578771292,3578771320,28
0,1634,75426,3578771292,3578771320,28
0,1634,75427,3578771292,3578771320,28
0,1634,75428,3578771292,3578771320,28
0,1634,75429,3578771292,3578771321,29
0,1634,75430,3578771292,3578771322,30
0,1634,75431,3578771292,3578771323,31
0,1634,75432,3578771292,3578771323,31
0,1634,75433,3578771292,3578771323,31
0,1634,75434,3578771292,3578771323,31
0,1634,75435,3578771292,3578771324,32
0,1634,75436,3578771292,3578771325,33
0,1634,75437,3578771292,3578771325,33
0,1634,75438,3578771292,3578771326,34
0,1634,75439,3578771292,3578771327,35
0,1634,75440,3578771292,3578771327,35
0,1634,75441,3578771292,3578771328,36
0,1634,75442,3578771292,3578771328,36
0,1634,75443,3578771292,3578771329,37
0,1634,75444,3578771292,3578771329,37
0,1634,75445,3578771292,3578771329,37
0,1634,75446,3578771292,3578771329,37
0,1634,75447,3578771292,3578771329,37
0,1634,75448,3578771292,3578771330,38
0,1634,75449,3578771292,3578771330,38
0,1634,75450,3578771292,3578771331,39
0,1634,75451,3578771292,3578771331,39
0,1634,75452,3578771292,3578771331,39
0,1634,75453,3578771292,3578771331,39
0,1634,75454,3578771292,3578771331,39
0,1634,75455,3578771292,3578771331,39
0,1634,75456,3578771292,3578771332,40
0,1634,75457,3578771292,3578771332,40
0,1634,75458,3578771292,3578771332,40
0,1634,75459,3578771292,3578771332,40
0,1634,75460,3578771292,3578771333,41
0,1634,75461,3578771292,3578771333,41
0,1634,75462,3578771292,3578771334,42
0,1634,75463,3578771292,3578771334,42
0,1634,75464,3578771292,3578771335,43
0,1634,75465,3578771292,3578771335,43
0,1634,75466,3578771292,3578771336,44
0,1634,75467,3578771292,3578771336,44
0,1634,75468,3578771292,3578771337,45
0,1634,75469,3578771292,3578771338,46
0,1634,75470,3578771292,3578771339,47
0,1634,75471,3578771292,3578771340,48
0,1634,75472,3578771292,3578771341,49
0,1634,75473,3578771292,3578771341,49
0,1634,75474,3578771292,3578771342,50
0,1635,75475,3578771359,3578771359,0
0,1635,75476,3578771359,3578771359,0
0,1635,75477,3578771359,3578771359,0
0,1635,75478,3578771359,3578771359,0
0,1635,75479,3578771359,3578771359,0
0,1635,75480,3578771359,3578771359,0
0,1635,75481,3578771359,3578771359,0
0,1635,75482,3578771359,3578771359,0
0,1635,75483,3578771359,3578771359,0
0,1635,75484,3578771359,3578771359,0
0,1635,75485,3578771359,3578771359,0
0,1635,75486,3578771359,3578771359,0
0,1635,75487,3578771359,3578771359,0
0,1635,75488,3578771359,3578771359,0
0,1635,75489,3578771359,3578771359,0
0,1635,75490,3578771359,3578771359,0
0,1635,75491,3578771359,3578771359,0
0,1635,75492,3578771359,3578771359,0
0,1635,75493,3578771359,3578771359,0
0,1635,75494,3578771359,3578771359,0
0,1635,75495,3578771359,3578771359,0
0,1635,75496,3578771359,3578771359,0
0,1635,75497,3578771359,3578771359,0
0,1635,75498,3578771359,3578771359,0
0,1635,75499,3578771359,3578771359,0
0,1635,75500,3578771359,3578771359,0
0,1635,75501,3578771359,3578771359,0
0,1635,75502,3578771359,3578771359,0
0,1635,75503,3578771359,3578771359,0
0,1635,75504,3578771359,3578771359,0
0,1635,75505,3578771359,3578771359,0
0,1635,75506,3578771359,3578771359,0
0,1635,75507,3578771359,3578771359,0
0,1635,75508,3578771359,3578771359,0
0,1635,75509,3578771359,3578771359,0
0,1635,75510,3578771359,3578771360,1
0,1635,75511,3578771359,3578771361,2
0,1635,75512,3578771359,3578771361,2
0,1635,75513,3578771359,3578771361,2
0,1635,75514,3578771359,3578771361,2
0,1635,75515,3578771359,3578771362,3
0,1635,75516,3578771359,3578771362,3
0,1635,75517,3578771359,3578771363,4
0,1635,75518,3578771359,3578771364,5
0,1635,75519,3578771359,3578771365,6
0,1635,75520,3578771359,3578771367,8
0,1635,75521,3578771359,3578771367,8
0,1635,75522,3578771359,3578771369,10
0,1635,75523,3578771359,3578771370,11
0,1635,75524,3578771359,3578771370,11
0,1635,75525,3578771359,3578771370,11
0,1635,75526,3578771359,3578771372,13
0,1635,75527,3578771359,3578771372,13
0,1635,75528,3578771359,3578771372,13
0,1635,75529,3578771359,3578771372,13
0,1635,75530,3578771359,3578771372,13
0,1635,75531,3578771359,3578771372,13
0,1635,75532,3578771359,3578771372,13
0,1635,75533,3578771359,3578771373,14
0,1635,75534,3578771359,3578771374,15
0,1635,75535,3578771359,3578771374,15
0,1635,75536,3578771359,3578771374,15
0,1635,75537,3578771359,3578771374,15
0,1635,75538,3578771359,3578771376,17
0,1635,75539,3578771359,3578771377,18
0,1635,75540,3578771359,3578771378,19
0,1635,75541,3578771359,3578771378,19
0,1635,75542,3578771359,3578771379,20
0,1635,75543,3578771359,3578771379,20
0,1635,75544,3578771359,3578771379,20
0,1635,75545,3578771359,3578771379,20
0,1635,75546,3578771359,3578771379,20
0,1635,75547,3578771359,3578771379,20
0,1635,75548,3578771359,3578771382,23
0,1635,75549,3578771359,3578771383,24
0,1635,75550,3578771359,3578771385,26
0,1635,75551,3578771359,3578771385,26
0,1635,75552,3578771359,3578771385,26
0,1635,75553,3578771359,3578771386,27
0,1635,75554,3578771359,3578771387,28
0,1635,75555,3578771359,3578771388,29
0,1635,75556,3578771359,3578771388,29
0,1635,75557,3578771359,3578771389,30
0,1635,75558,3578771359,3578771390,31
0,1635,75559,3578771359,3578771390,31
0,1635,75560,3578771359,3578771391,32
0,1635,75561,3578771359,3578771391,32
0,1635,75562,3578771359,3578771392,33
0,1635,75563,3578771359,3578771392,33
0,1635,75564,3578771359,3578771393,34
0,1635,75565,3578771359,3578771395,36
0,1635,75566,3578771359,3578771395,36
0,1635,75567,3578771359,3578771395,36
0,1635,75568,3578771359,3578771395,36
0,1635,75569,3578771359,3578771398,39
0,1635,75570,3578771359,3578771398,39
0,1635,75571,3578771359,3578771399,40
0,1635,75572,3578771359,3578771399,40
0,1635,75573,3578771359,3578771400,41
0,1635,75574,3578771359,3578771400,41
0,1635,75575,3578771359,3578771400,41
0,1635,75576,3578771359,3578771401,42
0,1635,75577,3578771359,3578771402,43
0,1635,75578,3578771359,3578771402,43
0,1635,75579,3578771359,3578771402,43
0,1635,75580,3578771359,3578771404,45
0,1635,75581,3578771359,3578771405,46
0,1635,75582,3578771359,3578771405,46
0,1635,75583,3578771359,3578771405,46
0,1635,75584,3578771359,3578771405,46
0,1635,75585,3578771359,3578771406,47
0,1635,75586,3578771359,3578771406,47
0,1635,75587,3578771359,3578771407,48
0,1635,75588,3578771359,3578771408,49
0,1635,75589,3578771359,3578771408,49
0,1635,75590,3578771359,3578771409,50
0,1636,75591,3578771425,3578771425,0
0,1636,75592,3578771425,3578771425,0
0,1636,75593,3578771425,3578771425,0
0,1636,75594,3578771425,3578771425,0
0,1636,75595,3578771425,3578771425,0
0,1636,75596,3578771425,3578771425,0
0,1636,75597,3578771425,3578771425,0
0,1636,75598,3578771425,3578771425,0
0,1636,75599,3578771425,3578771425,0
0,1636,75600,3578771425,3578771425,0
0,1636,75601,3578771425,3578771425,0
0,1636,75602,3578771425,3578771425,0
0,1636,75603,3578771425,3578771425,0
0,1636,75604,3578771425,3578771425,0
0,1636,75605,3578771425,3578771425,0
0,1636,75606,3578771425,3578771425,0
0,1636,75607,3578771425,3578771425,0
0,1636,75608,3578771425,3578771425,0
0,1636,75609,3578771425,3578771425,0
0,1636,75610,3578771425,3578771425,0
0,1636,75611,3578771425,3578771425,0
0,1636,75612,3578771425,3578771425,0
0,1636,75613,3578771425,3578771425,0
0,1636,75614,3578771425,3578771425,0
0,1636,75615,3578771425,3578771425,0
0,1636,75616,3578771425,3578771426,1
0,1636,75617,3578771425,3578771427,2
0,1636,75618,3578771425,3578771428,3
0,1636,75619,3578771425,3578771429,4
0,1636,75620,3578771425,3578771429,4
0,1636,75621,3578771425,3578771430,5
0,1636,75622,3578771425,3578771431,6
0,1636,75623,3578771425,3578771431,6
0,1636,75624,3578771425,3578771431,6
0,1636,75625,3578771425,3578771431,6
0,1636,75626,3578771425,3578771432,7
0,1636,75627,3578771425,3578771433,8
0,1636,75628,3578771425,3578771434,9
0,1636,75629,3578771425,3578771436,11
0,1636,75630,3578771425,3578771437,12
0,1636,75631,3578771425,3578771437,12
0,1636,75632,3578771425,3578771437,12
0,1636,75633,3578771425,3578771438,13
0,1636,75634,3578771425,3578771438,13
0,1636,75635,3578771425,3578771439,14
0,1636,75636,3578771425,3578771439,14
0,1636,75637,3578771425,3578771439,14
0,1636,75638,3578771425,3578771440,15
0,1636,75639,3578771425,3578771441,16
0,1636,75640,3578771425,3578771441,16
0,1636,75641,3578771425,3578771441,16
0,1636,75642,3578771425,3578771443,18
0,1636,75643,3578771425,3578771444,19
0,1636,75644,3578771425,3578771444,19
0,1636,75645,3578771425,3578771444,19
0,1636,75646,3578771425,3578771445,20
0,1636,75647,3578771425,3578771446,21
0,1636,75648,3578771425,3578771447,22
0,1636,75649,3578771425,3578771448,23
0,1636,75650,3578771425,3578771448,23
0,1636,75651,3578771425,3578771449,24
0,1636,75652,3578771425,3578771450,25
0,1636,75653,3578771425,3578771450,25
0,1636,75654,3578771425,3578771450,25
0,1636,75655,3578771425,3578771450,25
0,1636,75656,3578771425,3578771450,25
0,1636,75657,3578771425,3578771453,28
0,1636,75658,3578771425,3578771453,28
0,1636,75659,3578771425,3578771454,29
0,1636,75660,3578771425,3578771457,32
0,1636,75661,3578771425,3578771458,33
0,1636,75662,3578771425,3578771458,33
0,1636,75663,3578771425,3578771459,34
0,1636,75664,3578771425,3578771460,35
0,1636,75665,3578771425,3578771460,35
0,1636,75666,3578771425,3578771463,38
0,1636,75667,3578771425,3578771463,38
0,1636,75668,3578771425,3578771463,38
0,1636,75669,3578771425,3578771463,38
0,1636,75670,3578771425,3578771463,38
0,1636,75671,3578771425,3578771463,38
0,1636,75672,3578771425,3578771464,39
0,1636,75673,3578771425,3578771465,40
0,1636,75674,3578771425,3578771465,40
0,1636,75675,3578771425,3578771466,41
0,1636,75676,3578771425,3578771467,42
0,1636,75677,3578771425,3578771467,42
0,1636,75678,3578771425,3578771468,43
0,1636,75679,3578771425,3578771469,44
0,1637,75680,3578771489,3578771489,0
0,1637,75681,3578771489,3578771489,0
0,1637,75682,3578771489,3578771490,1
0,1637,75683,3578771489,3578771490,1
0,1637,75684,3578771489,3578771490,1
0,1637,75685,3578771489,3578771490,1
0,1637,75686,3578771489,3578771490,1
0,1637,75687,3578771489,3578771490,1
0,1637,75688,3578771489,3578771491,2
0,1637,75689,3578771489,3578771492,3
0,1637,75690,3578771489,3578771492,3
0,1637,75691,3578771489,3578771492,3
0,1637,75692,3578771489,3578771492,3
0,1637,75693,3578771489,3578771492,3
0,1637,75694,3578771489,3578771493,4
0,1637,75695,3578771489,3578771494,5
0,1637,75696,3578771489,3578771494,5
0,1637,75697,3578771489,3578771495,6
0,1637,75698,3578771489,3578771496,7
0,1637,75699,3578771489,3578771496,7
0,1637,75700,3578771489,3578771497,8
0,1637,75701,3578771489,3578771497,8
0,1637,75702,3578771489,3578771497,8
0,1637,75703,3578771489,3578771497,8
0,1637,75704,3578771489,3578771498,9
0,1637,75705,3578771489,3578771499,10
0,1637,75706,3578771489,3578771499,10
0,1637,75707,3578771489,3578771500,11
0,1637,75708,3578771489,3578771500,11
0,1637,75709,3578771489,3578771501,12
0,1637,75710,3578771489,3578771501,12
0,1637,75711,3578771489,3578771501,12
0,1637,75712,3578771489,3578771501,12
0,1637,75713,3578771489,3578771503,14
0,1637,75714,3578771489,3578771504,15
0,1637,75715,3578771489,3578771504,15
0,1637,75716,3578771489,3578771504,15
0,1637,75717,3578771489,3578771505,16
0,1637,75718,3578771489,3578771506,17
0,1637,75719,3578771489,3578771506,17
0,1637,75720,3578771489,3578771506,17
0,1637,75721,3578771489,3578771506,17
0,1637,75722,3578771489,3578771507,18
0,1637,75723,3578771489,3578771507,18
0,1637,75724,3578771489,3578771507,18
0,1637,75725,3578771489,3578771508,19
0,1637,75726,3578771489,3578771508,19
0,1637,75727,3578771489,3578771508,19
0,1637,75728,3578771489,3578771509,20
0,1637,75729,3578771489,3578771509,20
0,1637,75730,3578771489,3578771509,20
0,1637,75731,3578771489,3578771509,20
0,1637,75732,3578771489,3578771510,21
0,1637,75733,3578771489,3578771510,21
0,1637,75734,3578771489,3578771510,21
0,1637,75735,3578771489,3578771511,22
0,1637,75736,3578771489,3578771511,22
0,1637,75737,3578771489,3578771511,22
0,1637,75738,3578771489,3578771512,23
0,1637,75739,3578771489,3578771512,23
0,1637,75740,3578771489,3578771513,24
0,1637,75741,3578771489,3578771514,25
0,1637,75742,3578771489,3578771514,25
0,1637,75743,3578771489,3578771514,25
0,1637,75744,3578771489,3578771514,25
0,1637,75745,3578771489,3578771515,26
0,1637,75746,3578771489,3578771515,26
0,1637,75747,3578771489,3578771515,26
0,1637,75748,3578771489,3578771515,26
0,1637,75749,3578771489,3578771516,27
0,1637,75750,3578771489,3578771516,27
0,1637,75751,3578771489,3578771516,27
0,1637,75752,3578771489,3578771517,28
0,1637,75753,3578771489,3578771518,29
0,1637,75754,3578771489,3578771518,29
0,1637,75755,3578771489,3578771519,30
0,1637,75756,3578771489,3578771520,31
0,1637,75757,3578771489,3578771520,31
0,1637,75758,3578771489,3578771521,32
0,1637,75759,3578771489,3578771522,33
0,1637,75760,3578771489,3578771522,33
0,1637,75761,3578771489,3578771523,34
0,1637,75762,3578771489,3578771523,34
0,1637,75763,3578771489,3578771524,35
0,1637,75764,3578771489,3578771524,35
0,1637,75765,3578771489,3578771526,37
0,1637,75766,3578771489,3578771527,38
0,1637,75767,3578771489,3578771527,38
0,1637,75768,3578771489,3578771527,38
0,1637,75769,3578771489,3578771527,38
0,1637,75770,3578771489,3578771528,39
0,1637,75771,3578771489,3578771528,39
0,1637,75772,3578771489,3578771529,40
0,1637,75773,3578771489,3578771529,40
0,1637,75774,3578771489,3578771529,40
0,1637,75775,3578771489,3578771530,41
0,1637,75776,3578771489,3578771530,41
0,1637,75777,3578771489,3578771530,41
0,1637,75778,3578771489,3578771530,41
0,1637,75779,3578771489,3578771531,42
0,1637,75780,3578771489,3578771531,42
0,1637,75781,3578771489,3578771531,42
0,1637,75782,3578771489,3578771531,42
0,1637,75783,3578771489,3578771531,42
0,1637,75784,3578771489,3578771532,43
0,1637,75785,3578771489,3578771532,43
0,1637,75786,3578771489,3578771533,44
0,1637,75787,3578771489,3578771533,44
0,1637,75788,3578771489,3578771534,45
0,1637,75789,3578771489,3578771534,45
0,1637,75790,3578771489,3578771534,45
0,1637,75791,3578771489,3578771535,46
0,1637,75792,3578771489,3578771535,46
0,1637,75793,3578771489,3578771536,47
0,1637,75794,3578771489,3578771536,47
0,1637,75795,3578771489,3578771537,48
0,1637,75796,3578771489,3578771539,50
0,1638,75797,3578771556,3578771556,0
0,1638,75798,3578771556,3578771556,0
0,1638,75799,3578771556,3578771556,0
0,1638,75800,3578771556,3578771556,0
0,1638,75801,3578771556,3578771556,0
0,1638,75802,3578771556,3578771556,0
0,1638,75803,3578771556,3578771556,0
0,1638,75804,3578771556,3578771556,0
0,1638,75805,3578771556,3578771556,0
0,1638,75806,3578771556,3578771556,0
0,1638,75807,3578771556,3578771556,0
0,1638,75808,3578771556,3578771556,0
0,1638,75809,3578771556,3578771556,0
0,1638,75810,3578771556,3578771556,0
0,1638,75811,3578771556,3578771556,0
0,1638,75812,3578771556,3578771556,0
0,1638,75813,3578771556,3578771556,0
0,1638,75814,3578771556,3578771556,0
0,1638,75815,3578771556,3578771556,0
0,1638,75816,3578771556,3578771556,0
0,1638,75817,3578771556,3578771556,0
0,1638,75818,3578771556,3578771556,0
0,1638,75819,3578771556,3578771556,0
0,1638,75820,3578771556,3578771556,0
0,1638,75821,3578771556,3578771556,0
0,1638,75822,3578771556,3578771556,0
0,1638,75823,3578771556,3578771556,0
0,1638,75824,3578771556,3578771556,0
0,1638,75825,3578771556,3578771556,0
0,1638,75826,3578771556,3578771556,0
0,1638,75827,3578771556,3578771556,0
0,1638,75828,3578771556,3578771556,0
0,1638,75829,3578771556,3578771557,1
0,1638,75830,3578771556,3578771557,1
0,1638,75831,3578771556,3578771557,1
0,1638,75832,3578771556,3578771558,2
0,1638,75833,3578771556,3578771558,2
0,1638,75834,3578771556,3578771558,2
0,1638,75835,3578771556,3578771559,3
0,1638,75836,3578771556,3578771560,4
0,1638,75837,3578771556,3578771560,4
0,1638,75838,3578771556,3578771560,4
0,1638,75839,3578771556,3578771560,4
0,1638,75840,3578771556,3578771561,5
0,1638,75841,3578771556,3578771561,5
0,1638,75842,3578771556,3578771562,6
0,1638,75843,3578771556,3578771565,9
0,1638,75844,3578771556,3578771566,10
0,1638,75845,3578771556,3578771566,10
0,1638,75846,3578771556,3578771566,10
0,1638,75847,3578771556,3578771568,12
0,1638,75848,3578771556,3578771570,14
0,1638,75849,3578771556,3578771571,15
0,1638,75850,3578771556,3578771571,15
0,1638,75851,3578771556,3578771572,16
0,1638,75852,3578771556,3578771572,16
0,1638,75853,3578771556,3578771572,16
0,1638,75854,3578771556,3578771572,16
0,1638,75855,3578771556,3578771573,17
0,1638,75856,3578771556,3578771573,17
0,1638,75857,3578771556,3578771574,18
0,1638,75858,3578771556,3578771575,19
0,1638,75859,3578771556,3578771576,20
0,1638,75860,3578771556,3578771576,20
0,1638,75861,3578771556,3578771577,21
0,1638,75862,3578771556,3578771577,21
0,1638,75863,3578771556,3578771578,22
0,1638,75864,3578771556,3578771578,22
0,1638,75865,3578771556,3578771578,22
0,1638,75866,3578771556,3578771578,22
0,1638,75867,3578771556,3578771578,22
0,1638,75868,3578771556,3578771578,22
0,1638,75869,3578771556,3578771583,27
0,1638,75870,3578771556,3578771584,28
0,1638,75871,3578771556,3578771585,29
0,1638,75872,3578771556,3578771586,30
0,1638,75873,3578771556,3578771586,30
0,1638,75874,3578771556,3578771586,30
0,1638,75875,3578771556,3578771587,31
0,1638,75876,3578771556,3578771588,32
0,1638,75877,3578771556,3578771588,32
0,1638,75878,3578771556,3578771588,32
0,1638,75879,3578771556,3578771588,32
0,1638,75880,3578771556,3578771589,33
0,1638,75881,3578771556,3578771590,34
0,1638,75882,3578771556,3578771591,35
0,1638,75883,3578771556,3578771592,36
0,1638,75884,3578771556,3578771593,37
0,1638,75885,3578771556,3578771593,37
0,1638,75886,3578771556,3578771593,37
0,1638,75887,3578771556,3578771594,38
0,1638,75888,3578771556,3578771595,39
0,1638,75889,3578771556,3578771596,40
0,1638,75890,3578771556,3578771598,42
0,1638,75891,3578771556,3578771598,42
0,1638,75892,3578771556,3578771599,43
0,1638,75893,3578771556,3578771599,43
0,1638,75894,3578771556,3578771599,43
0,1638,75895,3578771556,3578771600,44
0,1638,75896,3578771556,3578771601,45
0,1638,75897,3578771556,3578771602,46
0,1638,75898,3578771556,3578771602,46
0,1638,75899,3578771556,3578771603,47
0,1638,75900,3578771556,3578771604,48
0,1638,75901,3578771556,3578771604,48
0,1638,75902,3578771556,3578771604,48
0,1638,75903,3578771556,3578771605,49
0,1639,75904,3578771621,3578771621,0
0,1639,75905,3578771621,3578771621,0
0,1639,75906,3578771621,3578771621,0
0,1639,75907,3578771621,3578771621,0
0,1639,75908,3578771621,3578771621,0
0,1639,75909,3578771621,3578771621,0
0,1639,75910,3578771621,3578771621,0
0,1639,75911,3578771621,3578771621,0
0,1639,75912,3578771621,3578771621,0
0,1639,75913,3578771621,3578771621,0
0,1639,75914,3578771621,3578771621,0
0,1639,75915,3578771621,3578771621,0
0,1639,75916,3578771621,3578771621,0
0,1639,75917,3578771621,3578771621,0
0,1639,75918,3578771621,3578771621,0
0,1639,75919,3578771621,3578771621,0
0,1639,75920,3578771621,3578771621,0
0,1639,75921,3578771621,3578771621,0
0,1639,75922,3578771621,3578771621,0
0,1639,75923,3578771621,3578771621,0
0,1639,75924,3578771621,3578771621,0
0,1639,75925,3578771621,3578771621,0
0,1639,75926,3578771621,3578771621,0
0,1639,75927,3578771621,3578771621,0
0,1639,75928,3578771621,3578771621,0
0,1639,75929,3578771621,3578771621,0
0,1639,75930,3578771621,3578771621,0
0,1639,75931,3578771621,3578771623,2
0,1639,75932,3578771621,3578771623,2
0,1639,75933,3578771621,3578771624,3
0,1639,75934,3578771621,3578771624,3
0,1639,75935,3578771621,3578771626,5
0,1639,75936,3578771621,3578771627,6
0,1639,75937,3578771621,3578771627,6
0,1639,75938,3578771621,3578771627,6
0,1639,75939,3578771621,3578771629,8
0,1639,75940,3578771621,3578771629,8
0,1639,75941,3578771621,3578771630,9
0,1639,75942,3578771621,3578771631,10
0,1639,75943,3578771621,3578771631,10
0,1639,75944,3578771621,3578771631,10
0,1639,75945,3578771621,3578771631,10
0,1639,75946,3578771621,3578771631,10
0,1639,75947,3578771621,3578771632,11
0,1639,75948,3578771621,3578771632,11
0,1639,75949,3578771621,3578771633,12
0,1639,75950,3578771621,3578771636,15
0,1639,75951,3578771621,3578771636,15
0,1639,75952,3578771621,3578771637,16
0,1639,75953,3578771621,3578771637,16
0,1639,75954,3578771621,3578771638,17
0,1639,75955,3578771621,3578771638,17
0,1639,75956,3578771621,3578771639,18
0,1639,75957,3578771621,3578771639,18
0,1639,75958,3578771621,3578771639,18
0,1639,75959,3578771621,3578771639,18
0,1639,75960,3578771621,3578771639,18
0,1639,75961,3578771621,3578771640,19
0,1639,75962,3578771621,3578771640,19
0,1639,75963,3578771621,3578771641,20
0,1639,75964,3578771621,3578771641,20
0,1639,75965,3578771621,3578771642,21
0,1639,75966,3578771621,3578771643,22
0,1639,75967,3578771621,3578771644,23
0,1639,75968,3578771621,3578771644,23
0,1639,75969,3578771621,3578771645,24
0,1639,75970,3578771621,3578771647,26
0,1639,75971,3578771621,3578771647,26
0,1639,75972,3578771621,3578771648,27
0,1639,75973,3578771621,3578771649,28
0,1639,75974,3578771621,3578771649,28
0,1639,75975,3578771621,3578771649,28
0,1639,75976,3578771621,3578771649,28
0,1639,75977,3578771621,3578771649,28
0,1639,75978,3578771621,3578771650,29
0,1639,75979,3578771621,3578771650,29
0,1639,75980,3578771621,3578771651,30
0,1639,75981,3578771621,3578771653,32
0,1639,75982,3578771621,3578771653,32
0,1639,75983,3578771621,3578771655,34
0,1639,75984,3578771621,3578771657,36
0,1639,75985,3578771621,3578771658,37
0,1639,75986,3578771621,3578771658,37
0,1639,75987,3578771621,3578771658,37
0,1639,75988,3578771621,3578771659,38
0,1639,75989,3578771621,3578771660,39
0,1639,75990,3578771621,3578771661,40
0,1639,75991,3578771621,3578771661,40
0,1639,75992,3578771621,3578771661,40
0,1639,75993,3578771621,3578771661,40
0,1639,75994,3578771621,3578771662,41
0,1639,75995,3578771621,3578771662,41
0,1639,75996,3578771621,3578771663,42
0,1639,75997,3578771621,3578771663,42
0,1639,75998,3578771621,3578771665,44
0,1639,75999,3578771621,3578771665,44
0,1639,76000,3578771621,3578771666,45
0,1639,76001,3578771621,3578771668,47
0,1640,76002,3578771686,3578771686,0
0,1640,76003,3578771686,3578771686,0
0,1640,76004,3578771686,3578771686,0
0,1640,76005,3578771686,3578771687,1
0,1640,76006,3578771686,3578771688,2
0,1640,76007,3578771686,3578771688,2
0,1640,76008,3578771686,3578771688,2
0,1640,76009,3578771686,3578771689,3
0,1640,76010,3578771686,3578771689,3
0,1640,76011,3578771686,3578771689,3
0,1640,76012,3578771686,3578771690,4
0,1640,76013,3578771686,3578771691,5
0,1640,76014,3578771686,3578771691,5
0,1640,76015,3578771686,3578771692,6
0,1640,76016,3578771686,3578771692,6
0,1640,76017,3578771686,3578771693,7
0,1640,76018,3578771686,3578771693,7
0,1640,76019,3578771686,3578771694,8
0,1640,76020,3578771686,3578771694,8
0,1640,76021,3578771686,3578771695,9
0,1640,76022,3578771686,3578771695,9
0,1640,76023,3578771686,3578771696,10
0,1640,76024,3578771686,3578771697,11
0,1640,76025,3578771686,3578771697,11
0,1640,76026,3578771686,3578771697,11
0,1640,76027,3578771686,3578771697,11
0,1640,76028,3578771686,3578771697,11
0,1640,76029,3578771686,3578771697,11
0,1640,76030,3578771686,3578771699,13
0,1640,76031,3578771686,3578771699,13
0,1640,76032,3578771686,3578771699,13
0,1640,76033,3578771686,3578771700,14
0,1640,76034,3578771686,3578771701,15
0,1640,76035,3578771686,3578771701,15
0,1640,76036,3578771686,3578771702,16
0,1640,76037,3578771686,3578771704,18
0,1640,76038,3578771686,3578771704,18
0,1640,76039,3578771686,3578771704,18
0,1640,76040,3578771686,3578771705,19
0,1640,76041,3578771686,3578771705,19
0,1640,76042,3578771686,3578771705,19
0,1640,76043,3578771686,3578771706,20
0,1640,76044,3578771686,3578771706,20
0,1640,76045,3578771686,3578771706,20
0,1640,76046,3578771686,3578771706,20
0,1640,76047,3578771686,3578771707,21
0,1640,76048,3578771686,3578771708,22
0,1640,76049,3578771686,3578771708,22
0,1640,76050,3578771686,3578771708,22
0,1640,76051,3578771686,3578771708,22
0,1640,76052,3578771686,3578771709,23
0,1640,76053,3578771686,3578771709,23
0,1640,76054,3578771686,3578771710,24
0,1640,76055,3578771686,3578771710,24
0,1640,76056,3578771686,3578771711,25
0,1640,76057,3578771686,3578771711,25
0,1640,76058,3578771686,3578771711,25
0,1640,76059,3578771686,3578771711,25
0,1640,76060,3578771686,3578771711,25
0,1640,76061,3578771686,3578771712,26
0,1640,76062,3578771686,3578771713,27
0,1640,76063,3578771686,3578771714,28
0,1640,76064,3578771686,3578771714,28
0,1640,76065,3578771686,3578771714,28
0,1640,76066,3578771686,3578771714,28
0,1640,76067,3578771686,3578771715,29
0,1640,76068,3578771686,3578771716,30
0,1640,76069,3578771686,3578771717,31
0,1640,76070,3578771686,3578771717,31
0,1640,76071,3578771686,3578771717,31
0,1640,76072,3578771686,3578771718,32
0,1640,76073,3578771686,3578771718,32
0,1640,76074,3578771686,3578771719,33
0,1640,76075,3578771686,3578771720,34
0,1640,76076,3578771686,3578771720,34
0,1640,76077,3578771686,3578771720,34
0,1640,76078,3578771686,3578771721,35
0,1640,76079,3578771686,3578771722,36
0,1640,76080,3578771686,3578771723,37
0,1640,76081,3578771686,3578771723,37
0,1640,76082,3578771686,3578771725,39
0,1640,76083,3578771686,3578771725,39
0,1640,76084,3578771686,3578771726,40
0,1640,76085,3578771686,3578771727,41
0,1640,76086,3578771686,3578771727,41
0,1640,76087,3578771686,3578771728,42
0,1640,76088,3578771686,3578771728,42
0,1640,76089,3578771686,3578771728,42
0,1640,76090,3578771686,3578771728,42
0,1640,76091,3578771686,3578771729,43
0,1640,76092,3578771686,3578771729,43
0,1640,76093,3578771686,3578771729,43
0,1640,76094,3578771686,3578771729,43
0,1640,76095,3578771686,3578771729,43
0,1640,76096,3578771686,3578771730,44
0,1640,76097,3578771686,3578771730,44
0,1640,76098,3578771686,3578771730,44
0,1640,76099,3578771686,3578771730,44
0,1640,76100,3578771686,3578771731,45
0,1640,76101,3578771686,3578771731,45
0,1640,76102,3578771686,3578771731,45
0,1640,76103,3578771686,3578771731,45
0,1640,76104,3578771686,3578771731,45
0,1640,76105,3578771686,3578771732,46
0,1640,76106,3578771686,3578771732,46
0,1640,76107,3578771686,3578771733,47
0,1640,76108,3578771686,3578771734,48
0,1640,76109,3578771686,3578771734,48
0,1640,76110,3578771686,3578771735,49
0,1640,76111,3578771686,3578771735,49
0,1640,76112,3578771686,3578771735,49
0,1640,76113,3578771686,3578771736,50
0,1641,76114,3578771752,3578771752,0
0,1641,76115,3578771752,3578771752,0
0,1641,76116,3578771752,3578771752,0
0,1641,76117,3578771752,3578771752,0
0,1641,76118,3578771752,3578771752,0
0,1641,76119,3578771752,3578771752,0
0,1641,76120,3578771752,3578771752,0
0,1641,76121,3578771752,3578771752,0
0,1641,76122,3578771752,3578771752,0
0,1641,76123,3578771752,3578771752,0
0,1641,76124,3578771752,3578771752,0
0,1641,76125,3578771752,3578771752,0
0,1641,76126,3578771752,3578771752,0
0,1641,76127,3578771752,3578771752,0
0,1641,76128,3578771752,3578771752,0
0,1641,76129,3578771752,3578771752,0
0,1641,76130,3578771752,3578771752,0
0,1641,76131,3578771752,3578771752,0
0,1641,76132,3578771752,3578771752,0
0,1641,76133,3578771752,3578771752,0
0,1641,76134,3578771752,3578771752,0
0,1641,76135,3578771752,3578771752,0
0,1641,76136,3578771752,3578771752,0
0,1641,76137,3578771752,3578771752,0
0,1641,76138,3578771752,3578771752,0
0,1641,76139,3578771752,3578771752,0
0,1641,76140,3578771752,3578771752,0
0,1641,76141,3578771752,3578771752,0
0,1641,76142,3578771752,3578771752,0
0,1641,76143,3578771752,3578771752,0
0,1641,76144,3578771752,3578771752,0
0,1641,76145,3578771752,3578771753,1
0,1641,76146,3578771752,3578771754,2
0,1641,76147,3578771752,3578771755,3
0,1641,76148,3578771752,3578771756,4
0,1641,76149,3578771752,3578771757,5
0,1641,76150,3578771752,3578771757,5
0,1641,76151,3578771752,3578771758,6
0,1641,76152,3578771752,3578771758,6
0,1641,76153,3578771752,3578771759,7
0,1641,76154,3578771752,3578771759,7
0,1641,76155,3578771752,3578771760,8
0,1641,76156,3578771752,3578771760,8
0,1641,76157,3578771752,3578771760,8
0,1641,76158,3578771752,3578771760,8
0,1641,76159,3578771752,3578771761,9
0,1641,76160,3578771752,3578771761,9
0,1641,76161,3578771752,3578771761,9
0,1641,76162,3578771752,3578771765,13
0,1641,76163,3578771752,3578771765,13
0,1641,76164,3578771752,3578771765,13
0,1641,76165,3578771752,3578771766,14
0,1641,76166,3578771752,3578771766,14
0,1641,76167,3578771752,3578771767,15
0,1641,76168,3578771752,3578771769,17
0,1641,76169,3578771752,3578771771,19
0,1641,76170,3578771752,3578771771,19
0,1641,76171,3578771752,3578771771,19
0,1641,76172,3578771752,3578771771,19
0,1641,76173,3578771752,3578771772,20
0,1641,76174,3578771752,3578771773,21
0,1641,76175,3578771752,3578771773,21
0,1641,76176,3578771752,3578771773,21
0,1641,76177,3578771752,3578771774,22
0,1641,76178,3578771752,3578771776,24
0,1641,76179,3578771752,3578771776,24
0,1641,76180,3578771752,3578771778,26
0,1641,76181,3578771752,3578771778,26
0,1641,76182,3578771752,3578771778,26
0,1641,76183,3578771752,3578771778,26
0,1641,76184,3578771752,3578771778,26
0,1641,76185,3578771752,3578771778,26
0,1641,76186,3578771752,3578771779,27
0,1641,76187,3578771752,3578771780,28
0,1641,76188,3578771752,3578771781,29
0,1641,76189,3578771752,3578771783,31
0,1641,76190,3578771752,3578771784,32
0,1641,76191,3578771752,3578771785,33
0,1641,76192,3578771752,3578771785,33
0,1641,76193,3578771752,3578771785,33
0,1641,76194,3578771752,3578771786,34
0,1641,76195,3578771752,3578771787,35
0,1641,76196,3578771752,3578771788,36
0,1641,76197,3578771752,3578771788,36
0,1641,76198,3578771752,3578771788,36
0,1641,76199,3578771752,3578771788,36
0,1641,76200,3578771752,3578771789,37
0,1641,76201,3578771752,3578771789,37
0,1641,76202,3578771752,3578771789,37
0,1641,76203,3578771752,3578771790,38
0,1641,76204,3578771752,3578771790,38
0,1641,76205,3578771752,3578771792,40
0,1641,76206,3578771752,3578771792,40
0,1641,76207,3578771752,3578771793,41
0,1641,76208,3578771752,3578771793,41
0,1641,76209,3578771752,3578771794,42
0,1641,76210,3578771752,3578771795,43
0,1641,76211,3578771752,3578771797,45
0,1641,76212,3578771752,3578771797,45
0,1641,76213,3578771752,3578771797,45
0,1641,76214,3578771752,3578771798,46
0,1641,76215,3578771752,3578771798,46
0,1641,76216,3578771752,3578771799,47
0,1641,76217,3578771752,3578771799,47
0,1641,76218,3578771752,3578771800,48
0,1642,76219,3578771819,3578771820,1
0,1642,76220,3578771819,3578771820,1
0,1642,76221,3578771819,3578771820,1
0,1642,76222,3578771819,3578771820,1
0,1642,76223,3578771819,3578771820,1
0,1642,76224,3578771819,3578771820,1
0,1642,76225,3578771819,3578771820,1
0,1642,76226,3578771819,3578771820,1
0,1642,76227,3578771819,3578771820,1
0,1642,76228,3578771819,3578771820,1
0,1642,76229,3578771819,3578771820,1
0,1642,76230,3578771819,3578771820,1
0,1642,76231,3578771819,3578771820,1
0,1642,76232,3578771819,3578771820,1
0,1642,76233,3578771819,3578771820,1
0,1642,76234,3578771819,3578771820,1
0,1642,76235,3578771819,3578771820,1
0,1642,76236,3578771819,3578771820,1
0,1642,76237,3578771819,3578771820,1
0,1642,76238,3578771819,3578771820,1
0,1642,76239,3578771819,3578771820,1
0,1642,76240,3578771819,3578771820,1
0,1642,76241,3578771819,3578771820,1
0,1642,76242,3578771819,3578771820,1
0,1642,76243,3578771819,3578771820,1
0,1642,76244,3578771819,3578771820,1
0,1642,76245,3578771819,3578771820,1
0,1642,76246,3578771819,3578771821,2
0,1642,76247,3578771819,3578771822,3
0,1642,76248,3578771819,3578771823,4
0,1642,76249,3578771819,3578771823,4
0,1642,76250,3578771819,3578771824,5
0,1642,76251,3578771819,3578771824,5
0,1642,76252,3578771819,3578771825,6
0,1642,76253,3578771819,3578771825,6
0,1642,76254,3578771819,3578771826,7
0,1642,76255,3578771819,3578771826,7
0,1642,76256,3578771819,3578771827,8
0,1642,76257,3578771819,3578771827,8
0,1642,76258,3578771819,3578771828,9
0,1642,76259,3578771819,3578771828,9
0,1642,76260,3578771819,3578771828,9
0,1642,76261,3578771819,3578771829,10
0,1642,76262,3578771819,3578771830,11
0,1642,76263,3578771819,3578771831,12
0,1642,76264,3578771819,3578771832,13
0,1642,76265,3578771819,3578771832,13
0,1642,76266,3578771819,3578771833,14
0,1642,76267,3578771819,3578771833,14
0,1642,76268,3578771819,3578771836,17
0,1642,76269,3578771819,3578771836,17
0,1642,76270,3578771819,3578771837,18
0,1642,76271,3578771819,3578771838,19
0,1642,76272,3578771819,3578771838,19
0,1642,76273,3578771819,3578771839,20
0,1642,76274,3578771819,3578771839,20
0,1642,76275,3578771819,3578771840,21
0,1642,76276,3578771819,3578771840,21
0,1642,76277,3578771819,3578771840,21
0,1642,76278,3578771819,3578771840,21
0,1642,76279,3578771819,3578771840,21
0,1642,76280,3578771819,3578771842,23
0,1642,76281,3578771819,3578771842,23
0,1642,76282,3578771819,3578771843,24
0,1642,76283,3578771819,3578771843,24
0,1642,76284,3578771819,3578771843,24
0,1642,76285,3578771819,3578771843,24
0,1642,76286,3578771819,3578771845,26
0,1642,76287,3578771819,3578771848,29
0,1642,76288,3578771819,3578771848,29
0,1642,76289,3578771819,3578771848,29
0,1642,76290,3578771819,3578771848,29
0,1642,76291,3578771819,3578771849,30
0,1642,76292,3578771819,3578771849,30
0,1642,76293,3578771819,3578771849,30
0,1642,76294,3578771819,3578771849,30
0,1642,76295,3578771819,3578771849,30
0,1642,76296,3578771819,3578771850,31
0,1642,76297,3578771819,3578771851,32
0,1642,76298,3578771819,3578771852,33
0,1642,76299,3578771819,3578771853,34
0,1642,76300,3578771819,3578771853,34
0,1642,76301,3578771819,3578771857,38
0,1642,76302,3578771819,3578771858,39
0,1642,76303,3578771819,3578771858,39
0,1642,76304,3578771819,3578771858,39
0,1642,76305,3578771819,3578771859,40
0,1642,76306,3578771819,3578771860,41
0,1642,76307,3578771819,3578771862,43
0,1642,76308,3578771819,3578771862,43
0,1642,76309,3578771819,3578771862,43
0,1642,76310,3578771819,3578771862,43
0,1642,76311,3578771819,3578771863,44
0,1642,76312,3578771819,3578771864,45
0,1642,76313,3578771819,3578771864,45
0,1642,76314,3578771819,3578771865,46
0,1642,76315,3578771819,3578771865,46
0,1642,76316,3578771819,3578771865,46
0,1642,76317,3578771819,3578771866,47
0,1642,76318,3578771819,3578771866,47
0,1642,76319,3578771819,3578771868,49
0,1643,76320,3578771884,3578771886,2
0,1643,76321,3578771884,3578771888,4
0,1643,76322,3578771884,3578771889,5
0,1643,76323,3578771884,3578771889,5
0,1643,76324,3578771884,3578771889,5
0,1643,76325,3578771884,3578771889,5
0,1643,76326,3578771884,3578771889,5
0,1643,76327,3578771884,3578771890,6
0,1643,76328,3578771884,3578771891,7
0,1643,76329,3578771884,3578771891,7
0,1643,76330,3578771884,3578771892,8
0,1643,76331,3578771884,3578771892,8
0,1643,76332,3578771884,3578771892,8
0,1643,76333,3578771884,3578771892,8
0,1643,76334,3578771884,3578771892,8
0,1643,76335,3578771884,3578771892,8
0,1643,76336,3578771884,3578771893,9
0,1643,76337,3578771884,3578771894,10
0,1643,76338,3578771884,3578771896,12
0,1643,76339,3578771884,3578771896,12
0,1643,76340,3578771884,3578771897,13
0,1643,76341,3578771884,3578771897,13
0,1643,76342,3578771884,3578771897,13
0,1643,76343,3578771884,3578771897,13
0,1643,76344,3578771884,3578771898,14
0,1643,76345,3578771884,3578771898,14
0,1643,76346,3578771884,3578771898,14
0,1643,76347,3578771884,3578771899,15
0,1643,76348,3578771884,3578771899,15
0,1643,76349,3578771884,3578771899,15
0,1643,76350,3578771884,3578771899,15
0,1643,76351,3578771884,3578771902,18
0,1643,76352,3578771884,3578771904,20
0,1643,76353,3578771884,3578771904,20
0,1643,76354,3578771884,3578771905,21
0,1643,76355,3578771884,3578771905,21
0,1643,76356,3578771884,3578771905,21
0,1643,76357,3578771884,3578771905,21
0,1643,76358,3578771884,3578771905,21
0,1643,76359,3578771884,3578771906,22
0,1643,76360,3578771884,3578771907,23
0,1643,76361,3578771884,3578771907,23
0,1643,76362,3578771884,3578771907,23
0,1643,76363,3578771884,3578771908,24
0,1643,76364,3578771884,3578771908,24
0,1643,76365,3578771884,3578771908,24
0,1643,76366,3578771884,3578771908,24
0,1643,76367,3578771884,3578771909,25
0,1643,76368,3578771884,3578771909,25
0,1643,76369,3578771884,3578771910,26
0,1643,76370,3578771884,3578771911,27
0,1643,76371,3578771884,3578771911,27
0,1643,76372,3578771884,3578771911,27
0,1643,76373,3578771884,3578771911,27
0,1643,76374,3578771884,3578771912,28
0,1643,76375,3578771884,3578771912,28
0,1643,76376,3578771884,3578771913,29
0,1643,76377,3578771884,3578771914,30
0,1643,76378,3578771884,3578771914,30
0,1643,76379,3578771884,3578771914,30
0,1643,76380,3578771884,3578771915,31
0,1643,76381,3578771884,3578771915,31
0,1643,76382,3578771884,3578771916,32
0,1643,76383,3578771884,3578771916,32
0,1643,76384,3578771884,3578771917,33
0,1643,76385,3578771884,3578771918,34
0,1643,76386,3578771884,3578771918,34
0,1643,76387,3578771884,3578771918,34
0,1643,76388,3578771884,3578771919,35
0,1643,76389,3578771884,3578771920,36
0,1643,76390,3578771884,3578771920,36
0,1643,76391,3578771884,3578771921,37
0,1643,76392,3578771884,3578771922,38
0,1643,76393,3578771884,3578771922,38
0,1643,76394,3578771884,3578771922,38
0,1643,76395,3578771884,3578771924,40
0,1643,76396,3578771884,3578771924,40
0,1643,76397,3578771884,3578771925,41
0,1643,76398,3578771884,3578771926,42
0,1643,76399,3578771884,3578771927,43
0,1643,76400,3578771884,3578771927,43
0,1643,76401,3578771884,3578771927,43
0,1643,76402,3578771884,3578771928,44
0,1643,76403,3578771884,3578771928,44
0,1643,76404,3578771884,3578771928,44
0,1643,76405,3578771884,3578771929,45
0,1643,76406,3578771884,3578771930,46
0,1643,76407,3578771884,3578771930,46
0,1643,76408,3578771884,3578771930,46
0,1643,76409,3578771884,3578771931,47
0,1643,76410,3578771884,3578771931,47
0,1643,76411,3578771884,3578771931,47
0,1643,76412,3578771884,3578771931,47
0,1643,76413,3578771884,3578771931,47
0,1643,76414,3578771884,3578771932,48
0,1643,76415,3578771884,3578771933,49
0,1643,76416,3578771884,3578771934,50
0,1644,76417,3578771950,3578771950,0
0,1644,76418,3578771950,3578771950,0
0,1644,76419,3578771950,3578771950,0
0,1644,76420,3578771950,3578771950,0
0,1644,76421,3578771950,3578771950,0
0,1644,76422,3578771950,3578771950,0
0,1644,76423,3578771950,3578771950,0
0,1644,76424,3578771950,3578771950,0
0,1644,76425,3578771950,3578771950,0
0,1644,76426,3578771950,3578771950,0
0,1644,76427,3578771950,3578771950,0
0,1644,76428,3578771950,3578771950,0
0,1644,76429,3578771950,3578771950,0
0,1644,76430,3578771950,3578771950,0
0,1644,76431,3578771950,3578771950,0
0,1644,76432,3578771950,3578771950,0
0,1644,76433,3578771950,3578771950,0
0,1644,76434,3578771950,3578771950,0
0,1644,76435,3578771950,3578771950,0
0,1644,76436,3578771950,3578771950,0
0,1644,76437,3578771950,3578771950,0
0,1644,76438,3578771950,3578771950,0
0,1644,76439,3578771950,3578771950,0
0,1644,76440,3578771950,3578771950,0
0,1644,76441,3578771950,3578771950,0
0,1644,76442,3578771950,3578771950,0
0,1644,76443,3578771950,3578771950,0
0,1644,76444,3578771950,3578771950,0
0,1644,76445,3578771950,3578771952,2
0,1644,76446,3578771950,3578771952,2
0,1644,76447,3578771950,3578771952,2
0,1644,76448,3578771950,3578771952,2
0,1644,76449,3578771950,3578771953,3
0,1644,76450,3578771950,3578771953,3
0,1644,76451,3578771950,3578771955,5
0,1644,76452,3578771950,3578771956,6
0,1644,76453,3578771950,3578771956,6
0,1644,76454,3578771950,3578771958,8
0,1644,76455,3578771950,3578771958,8
0,1644,76456,3578771950,3578771958,8
0,1644,76457,3578771950,3578771958,8
0,1644,76458,3578771950,3578771959,9
0,1644,76459,3578771950,3578771961,11
0,1644,76460,3578771950,3578771961,11
0,1644,76461,3578771950,3578771962,12
0,1644,76462,3578771950,3578771962,12
0,1644,76463,3578771950,3578771962,12
0,1644,76464,3578771950,3578771962,12
0,1644,76465,3578771950,3578771963,13
0,1644,76466,3578771950,3578771965,15
0,1644,76467,3578771950,3578771966,16
0,1644,76468,3578771950,3578771966,16
0,1644,76469,3578771950,3578771966,16
0,1644,76470,3578771950,3578771967,17
0,1644,76471,3578771950,3578771968,18
0,1644,76472,3578771950,3578771968,18
0,1644,76473,3578771950,3578771970,20
0,1644,76474,3578771950,3578771971,21
0,1644,76475,3578771950,3578771971,21
0,1644,76476,3578771950,3578771971,21
0,1644,76477,3578771950,3578771972,22
0,1644,76478,3578771950,3578771972,22
0,1644,76479,3578771950,3578771973,23
0,1644,76480,3578771950,3578771973,23
0,1644,76481,3578771950,3578771973,23
0,1644,76482,3578771950,3578771975,25
0,1644,76483,3578771950,3578771975,25
0,1644,76484,3578771950,3578771977,27
0,1644,76485,3578771950,3578771978,28
0,1644,76486,3578771950,3578771978,28
0,1644,76487,3578771950,3578771978,28
0,1644,76488,3578771950,3578771978,28
0,1644,76489,3578771950,3578771979,29
0,1644,76490,3578771950,3578771979,29
0,1644,76491,3578771950,3578771980,30
0,1644,76492,3578771950,3578771981,31
0,1644,76493,3578771950,3578771983,33
0,1644,76494,3578771950,3578771984,34
0,1644,76495,3578771950,3578771984,34
0,1644,76496,3578771950,3578771985,35
0,1644,76497,3578771950,3578771985,35
0,1644,76498,3578771950,3578771986,36
0,1644,76499,3578771950,3578771986,36
0,1644,76500,3578771950,3578771987,37
0,1644,76501,3578771950,3578771988,38
0,1644,76502,3578771950,3578771989,39
0,1644,76503,3578771950,3578771989,39
0,1644,76504,3578771950,3578771989,39
0,1644,76505,3578771950,3578771990,40
0,1644,76506,3578771950,3578771990,40
0,1644,76507,3578771950,3578771991,41
0,1644,76508,3578771950,3578771991,41
0,1644,76509,3578771950,3578771992,42
0,1644,76510,3578771950,3578771992,42
0,1644,76511,3578771950,3578771992,42
0,1644,76512,3578771950,3578771993,43
0,1644,76513,3578771950,3578771994,44
0,1644,76514,3578771950,3578771995,45
0,1644,76515,3578771950,3578771997,47
0,1644,76516,3578771950,3578771997,47
0,1644,76517,3578771950,3578771997,47
0,1644,76518,3578771950,3578771998,48
0,1644,76519,3578771950,3578771998,48
0,1644,76520,3578771950,3578771999,49
0,1644,76521,3578771950,3578771999,49
0,1644,76522,3578771950,3578772000,50
0,1645,76523,3578772014,3578772014,0
0,1645,76524,3578772014,3578772014,0
0,1645,76525,3578772014,3578772014,0
0,1645,76526,3578772014,3578772014,0
0,1645,76527,3578772014,3578772014,0
0,1645,76528,3578772014,3578772014,0
0,1645,76529,3578772014,3578772014,0
0,1645,76530,3578772014,3578772014,0
0,1645,76531,3578772014,3578772015,1
0,1645,76532,3578772014,3578772015,1
0,1645,76533,3578772014,3578772015,1
0,1645,76534,3578772014,3578772015,1
0,1645,76535,3578772014,3578772015,1
0,1645,76536,3578772014,3578772015,1
0,1645,76537,3578772014,3578772015,1
0,1645,76538,3578772014,3578772015,1
0,1645,76539,3578772014,3578772015,1
0,1645,76540,3578772014,3578772016,2
0,1645,76541,3578772014,3578772017,3
0,1645,76542,3578772014,3578772017,3
0,1645,76543,3578772014,3578772018,4
0,1645,76544,3578772014,3578772018,4
0,1645,76545,3578772014,3578772019,5
0,1645,76546,3578772014,3578772019,5
0,1645,76547,3578772014,3578772020,6
0,1645,76548,3578772014,3578772021,7
0,1645,76549,3578772014,3578772021,7
0,1645,76550,3578772014,3578772022,8
0,1645,76551,3578772014,3578772022,8
0,1645,76552,3578772014,3578772022,8
0,1645,76553,3578772014,3578772023,9
0,1645,76554,3578772014,3578772023,9
0,1645,76555,3578772014,3578772024,10
0,1645,76556,3578772014,3578772025,11
0,1645,76557,3578772014,3578772026,12
0,1645,76558,3578772014,3578772026,12
0,1645,76559,3578772014,3578772027,13
0,1645,76560,3578772014,3578772027,13
0,1645,76561,3578772014,3578772028,14
0,1645,76562,3578772014,3578772028,14
0,1645,76563,3578772014,3578772029,15
0,1645,76564,3578772014,3578772030,16
0,1645,76565,3578772014,3578772030,16
0,1645,76566,3578772014,3578772030,16
0,1645,76567,3578772014,3578772031,17
0,1645,76568,3578772014,3578772031,17
0,1645,76569,3578772014,3578772033,19
0,1645,76570,3578772014,3578772033,19
0,1645,76571,3578772014,3578772033,19
0,1645,76572,3578772014,3578772035,21
0,1645,76573,3578772014,3578772036,22
0,1645,76574,3578772014,3578772037,23
0,1645,76575,3578772014,3578772037,23
0,1645,76576,3578772014,3578772038,24
0,1645,76577,3578772014,3578772039,25
0,1645,76578,3578772014,3578772039,25
0,1645,76579,3578772014,3578772039,25
0,1645,76580,3578772014,3578772040,26
0,1645,76581,3578772014,3578772040,26
0,1645,76582,3578772014,3578772040,26
0,1645,76583,3578772014,3578772041,27
0,1645,76584,3578772014,3578772041,27
0,1645,76585,3578772014,3578772042,28
0,1645,76586,3578772014,3578772042,28
0,1645,76587,3578772014,3578772043,29
0,1645,76588,3578772014,3578772043,29
0,1645,76589,3578772014,3578772043,29
0,1645,76590,3578772014,3578772044,30
0,1645,76591,3578772014,3578772044,30
0,1645,76592,3578772014,3578772046,32
0,1645,76593,3578772014,3578772047,33
0,1645,76594,3578772014,3578772047,33
0,1645,76595,3578772014,3578772047,33
0,1645,76596,3578772014,3578772048,34
0,1645,76597,3578772014,3578772048,34
0,1645,76598,3578772014,3578772049,35
0,1645,76599,3578772014,3578772049,35
0,1645,76600,3578772014,3578772050,36
0,1645,76601,3578772014,3578772050,36
0,1645,76602,3578772014,3578772050,36
0,1645,76603,3578772014,3578772050,36
0,1645,76604,3578772014,3578772050,36
0,1645,76605,3578772014,3578772050,36
0,1645,76606,3578772014,3578772052,38
0,1645,76607,3578772014,3578772053,39
0,1645,76608,3578772014,3578772053,39
0,1645,76609,3578772014,3578772054,40
0,1645,76610,3578772014,3578772055,41
0,1645,76611,3578772014,3578772056,42
0,1645,76612,3578772014,3578772057,43
0,1645,76613,3578772014,3578772059,45
0,1645,76614,3578772014,3578772059,45
0,1645,76615,3578772014,3578772062,48
0,1645,76616,3578772014,3578772063,49
0,1645,76617,3578772014,3578772063,49
0,1645,76618,3578772014,3578772063,49
0,1645,76619,3578772014,3578772063,49
0,1645,76620,3578772014,3578772063,49
0,1646,76621,3578772080,3578772080,0
0,1646,76622,3578772080,3578772080,0
0,1646,76623,3578772080,3578772080,0
0,1646,76624,3578772080,3578772080,0
0,1646,76625,3578772080,3578772080,0
0,1646,76626,3578772080,3578772080,0
0,1646,76627,3578772080,3578772080,0
0,1646,76628,3578772080,3578772080,0
0,1646,76629,3578772080,3578772080,0
0,1646,76630,3578772080,3578772087,7
0,1646,76631,3578772080,3578772088,8
0,1646,76632,3578772080,3578772089,9
0,1646,76633,3578772080,3578772089,9
0,1646,76634,3578772080,3578772089,9
0,1646,76635,3578772080,3578772089,9
0,1646,76636,3578772080,3578772089,9
0,1646,76637,3578772080,3578772091,11
0,1646,76638,3578772080,3578772092,12
0,1646,76639,3578772080,3578772092,12
0,1646,76640,3578772080,3578772092,12
0,1646,76641,3578772080,3578772092,12
0,1646,76642,3578772080,3578772096,16
0,1646,76643,3578772080,3578772097,17
0,1646,76644,3578772080,3578772097,17
0,1646,76645,3578772080,3578772097,17
0,1646,76646,3578772080,3578772097,17
0,1646,76647,3578772080,3578772097,17
0,1646,76648,3578772080,3578772097,17
0,1646,76649,3578772080,3578772097,17
0,1646,76650,3578772080,3578772097,17
0,1646,76651,3578772080,3578772098,18
0,1646,76652,3578772080,3578772098,18
0,1646,76653,3578772080,3578772099,19
0,1646,76654,3578772080,3578772099,19
0,1646,76655,3578772080,3578772099,19
0,1646,76656,3578772080,3578772100,20
0,1646,76657,3578772080,3578772101,21
0,1646,76658,3578772080,3578772102,22
0,1646,76659,3578772080,3578772104,24
0,1646,76660,3578772080,3578772104,24
0,1646,76661,3578772080,3578772104,24
0,1646,76662,3578772080,3578772104,24
0,1646,76663,3578772080,3578772105,25
0,1646,76664,3578772080,3578772105,25
0,1646,76665,3578772080,3578772106,26
0,1646,76666,3578772080,3578772106,26
0,1646,76667,3578772080,3578772106,26
0,1646,76668,3578772080,3578772107,27
0,1646,76669,3578772080,3578772107,27
0,1646,76670,3578772080,3578772107,27
0,1646,76671,3578772080,3578772108,28
0,1646,76672,3578772080,3578772108,28
0,1646,76673,3578772080,3578772108,28
0,1646,76674,3578772080,3578772108,28
0,1646,76675,3578772080,3578772108,28
0,1646,76676,3578772080,3578772109,29
0,1646,76677,3578772080,3578772109,29
0,1646,76678,3578772080,3578772109,29
0,1646,76679,3578772080,3578772110,30
0,1646,76680,3578772080,3578772110,30
0,1646,76681,3578772080,3578772111,31
0,1646,76682,3578772080,3578772111,31
0,1646,76683,3578772080,3578772111,31
0,1646,76684,3578772080,3578772111,31
0,1646,76685,3578772080,3578772113,33
0,1646,76686,3578772080,3578772114,34
0,1646,76687,3578772080,3578772114,34
0,1646,76688,3578772080,3578772114,34
0,1646,76689,3578772080,3578772115,35
0,1646,76690,3578772080,3578772115,35
0,1646,76691,3578772080,3578772116,36
0,1646,76692,3578772080,3578772116,36
0,1646,76693,3578772080,3578772116,36
0,1646,76694,3578772080,3578772117,37
0,1646,76695,3578772080,3578772118,38
0,1646,76696,3578772080,3578772118,38
0,1646,76697,3578772080,3578772119,39
0,1646,76698,3578772080,3578772119,39
0,1646,76699,3578772080,3578772119,39
0,1646,76700,3578772080,3578772119,39
0,1646,76701,3578772080,3578772119,39
0,1646,76702,3578772080,3578772120,40
0,1646,76703,3578772080,3578772121,41
0,1646,76704,3578772080,3578772121,41
0,1646,76705,3578772080,3578772122,42
0,1646,76706,3578772080,3578772123,43
0,1646,76707,3578772080,3578772123,43
0,1646,76708,3578772080,3578772123,43
0,1646,76709,3578772080,3578772124,44
0,1646,76710,3578772080,3578772124,44
0,1646,76711,3578772080,3578772125,45
0,1646,76712,3578772080,3578772126,46
0,1646,76713,3578772080,3578772127,47
0,1646,76714,3578772080,3578772127,47
0,1646,76715,3578772080,3578772127,47
0,1646,76716,3578772080,3578772128,48
0,1646,76717,3578772080,3578772128,48
0,1646,76718,3578772080,3578772129,49
0,1646,76719,3578772080,3578772129,49
0,1646,76720,3578772080,3578772129,49
0,1646,76721,3578772080,3578772129,49
0,1646,76722,3578772080,3578772130,50
0,1647,76723,3578772144,3578772144,0
0,1647,76724,3578772144,3578772144,0
0,1647,76725,3578772144,3578772144,0
0,1647,76726,3578772144,3578772144,0
0,1647,76727,3578772144,3578772144,0
0,1647,76728,3578772144,3578772144,0
0,1647,76729,3578772144,3578772144,0
0,1647,76730,3578772144,3578772144,0
0,1647,76731,3578772144,3578772144,0
0,1647,76732,3578772144,3578772144,0
0,1647,76733,3578772144,3578772144,0
0,1647,76734,3578772144,3578772144,0
0,1647,76735,3578772144,3578772144,0
0,1647,76736,3578772144,3578772144,0
0,1647,76737,3578772144,3578772144,0
0,1647,76738,3578772144,3578772144,0
0,1647,76739,3578772144,3578772144,0
0,1647,76740,3578772144,3578772144,0
0,1647,76741,3578772144,3578772144,0
0,1647,76742,3578772144,3578772144,0
0,1647,76743,3578772144,3578772144,0
0,1647,76744,3578772144,3578772144,0
0,1647,76745,3578772144,3578772144,0
0,1647,76746,3578772144,3578772144,0
0,1647,76747,3578772144,3578772144,0
0,1647,76748,3578772144,3578772144,0
0,1647,76749,3578772144,3578772144,0
0,1647,76750,3578772144,3578772144,0
0,1647,76751,3578772144,3578772144,0
0,1647,76752,3578772144,3578772144,0
0,1647,76753,3578772144,3578772144,0
0,1647,76754,3578772144,3578772145,1
0,1647,76755,3578772144,3578772146,2
0,1647,76756,3578772144,3578772147,3
0,1647,76757,3578772144,3578772147,3
0,1647,76758,3578772144,3578772147,3
0,1647,76759,3578772144,3578772147,3
0,1647,76760,3578772144,3578772149,5
0,1647,76761,3578772144,3578772149,5
0,1647,76762,3578772144,3578772150,6
0,1647,76763,3578772144,3578772151,7
0,1647,76764,3578772144,3578772153,9
0,1647,76765,3578772144,3578772153,9
0,1647,76766,3578772144,3578772153,9
0,1647,76767,3578772144,3578772155,11
0,1647,76768,3578772144,3578772157,13
0,1647,76769,3578772144,3578772157,13
0,1647,76770,3578772144,3578772157,13
0,1647,76771,3578772144,3578772158,14
0,1647,76772,3578772144,3578772158,14
0,1647,76773,3578772144,3578772158,14
0,1647,76774,3578772144,3578772158,14
0,1647,76775,3578772144,3578772160,16
0,1647,76776,3578772144,3578772160,16
0,1647,76777,3578772144,3578772161,17
0,1647,76778,3578772144,3578772161,17
0,1647,76779,3578772144,3578772162,18
0,1647,76780,3578772144,3578772162,18
0,1647,76781,3578772144,3578772162,18
0,1647,76782,3578772144,3578772163,19
0,1647,76783,3578772144,3578772163,19
0,1647,76784,3578772144,3578772164,20
0,1647,76785,3578772144,3578772165,21
0,1647,76786,3578772144,3578772166,22
0,1647,76787,3578772144,3578772166,22
0,1647,76788,3578772144,3578772166,22
0,1647,76789,3578772144,3578772167,23
0,1647,76790,3578772144,3578772168,24
0,1647,76791,3578772144,3578772170,26
0,1647,76792,3578772144,3578772170,26
0,1647,76793,3578772144,3578772171,27
0,1647,76794,3578772144,3578772171,27
0,1647,76795,3578772144,3578772172,28
0,1647,76796,3578772144,3578772172,28
0,1647,76797,3578772144,3578772172,28
0,1647,76798,3578772144,3578772173,29
0,1647,76799,3578772144,3578772173,29
0,1647,76800,3578772144,3578772174,30
0,1647,76801,3578772144,3578772175,31
0,1647,76802,3578772144,3578772176,32
0,1647,76803,3578772144,3578772176,32
0,1647,76804,3578772144,3578772178,34
0,1647,76805,3578772144,3578772178,34
0,1647,76806,3578772144,3578772178,34
0,1647,76807,3578772144,3578772178,34
0,1647,76808,3578772144,3578772179,35
0,1647,76809,3578772144,3578772179,35
0,1647,76810,3578772144,3578772179,35
0,1647,76811,3578772144,3578772179,35
0,1647,76812,3578772144,3578772179,35
0,1647,76813,3578772144,3578772181,37
0,1647,76814,3578772144,3578772181,37
0,1647,76815,3578772144,3578772182,38
0,1647,76816,3578772144,3578772184,40
0,1647,76817,3578772144,3578772184,40
0,1647,76818,3578772144,3578772185,41
0,1647,76819,3578772144,3578772185,41
0,1647,76820,3578772144,3578772186,42
0,1647,76821,3578772144,3578772188,44
0,1647,76822,3578772144,3578772188,44
0,1647,76823,3578772144,3578772188,44
0,1647,76824,3578772144,3578772188,44
0,1647,76825,3578772144,3578772189,45
0,1647,76826,3578772144,3578772190,46
0,1647,76827,3578772144,3578772190,46
0,1647,76828,3578772144,3578772191,47
0,1647,76829,3578772144,3578772191,47
0,1647,76830,3578772144,3578772192,48
0,1647,76831,3578772144,3578772193,49
0,1647,76832,3578772144,3578772193,49
0,1647,76833,3578772144,3578772194,50
0,1648,76834,3578772208,3578772208,0
0,1648,76835,3578772208,3578772208,0
0,1648,76836,3578772208,3578772208,0
0,1648,76837,3578772208,3578772208,0
0,1648,76838,3578772208,3578772208,0
0,1648,76839,3578772208,3578772208,0
0,1648,76840,3578772208,3578772208,0
0,1648,76841,3578772208,3578772208,0
0,1648,76842,3578772208,3578772208,0
0,1648,76843,3578772208,3578772208,0
0,1648,76844,3578772208,3578772208,0
0,1648,76845,3578772208,3578772208,0
0,1648,76846,3578772208,3578772208,0
0,1648,76847,3578772208,3578772208,0
0,1648,76848,3578772208,3578772208,0
0,1648,76849,3578772208,3578772208,0
0,1648,76850,3578772208,3578772208,0
0,1648,76851,3578772208,3578772208,0
0,1648,76852,3578772208,3578772212,4
0,1648,76853,3578772208,3578772214,6
0,1648,76854,3578772208,3578772214,6
0,1648,76855,3578772208,3578772215,7
0,1648,76856,3578772208,3578772216,8
0,1648,76857,3578772208,3578772216,8
0,1648,76858,3578772208,3578772216,8
0,1648,76859,3578772208,3578772218,10
0,1648,76860,3578772208,3578772218,10
0,1648,76861,3578772208,3578772218,10
0,1648,76862,3578772208,3578772219,11
0,1648,76863,3578772208,3578772220,12
0,1648,76864,3578772208,3578772222,14
0,1648,76865,3578772208,3578772222,14
0,1648,76866,3578772208,3578772222,14
0,1648,76867,3578772208,3578772222,14
0,1648,76868,3578772208,3578772223,15
0,1648,76869,3578772208,3578772223,15
0,1648,76870,3578772208,3578772223,15
0,1648,76871,3578772208,3578772224,16
0,1648,76872,3578772208,3578772224,16
0,1648,76873,3578772208,3578772226,18
0,1648,76874,3578772208,3578772226,18
0,1648,76875,3578772208,3578772227,19
0,1648,76876,3578772208,3578772227,19
0,1648,76877,3578772208,3578772228,20
0,1648,76878,3578772208,3578772229,21
0,1648,76879,3578772208,3578772230,22
0,1648,76880,3578772208,3578772230,22
0,1648,76881,3578772208,3578772231,23
0,1648,76882,3578772208,3578772231,23
0,1648,76883,3578772208,3578772232,24
0,1648,76884,3578772208,3578772232,24
0,1648,76885,3578772208,3578772232,24
0,1648,76886,3578772208,3578772233,25
0,1648,76887,3578772208,3578772235,27
0,1648,76888,3578772208,3578772236,28
0,1648,76889,3578772208,3578772236,28
0,1648,76890,3578772208,3578772237,29
0,1648,76891,3578772208,3578772238,30
0,1648,76892,3578772208,3578772238,30
0,1648,76893,3578772208,3578772239,31
0,1648,76894,3578772208,3578772239,31
0,1648,76895,3578772208,3578772239,31
0,1648,76896,3578772208,3578772239,31
0,1648,76897,3578772208,3578772240,32
0,1648,76898,3578772208,3578772240,32
0,1648,76899,3578772208,3578772241,33
0,1648,76900,3578772208,3578772242,34
0,1648,76901,3578772208,3578772242,34
0,1648,76902,3578772208,3578772243,35
0,1648,76903,3578772208,3578772243,35
0,1648,76904,3578772208,3578772243,35
0,1648,76905,3578772208,3578772243,35
0,1648,76906,3578772208,3578772243,35
0,1648,76907,3578772208,3578772244,36
0,1648,76908,3578772208,3578772247,39
0,1648,76909,3578772208,3578772247,39
0,1648,76910,3578772208,3578772247,39
0,1648,76911,3578772208,3578772248,40
0,1648,76912,3578772208,3578772248,40
0,1648,76913,3578772208,3578772249,41
0,1648,76914,3578772208,3578772249,41
0,1648,76915,3578772208,3578772250,42
0,1648,76916,3578772208,3578772250,42
0,1648,76917,3578772208,3578772250,42
0,1648,76918,3578772208,3578772251,43
0,1648,76919,3578772208,3578772253,45
0,1648,76920,3578772208,3578772256,48
0,1648,76921,3578772208,3578772256,48
0,1648,76922,3578772208,3578772256,48
0,1648,76923,3578772208,3578772258,50
0,1649,76924,3578772274,3578772274,0
0,1649,76925,3578772274,3578772274,0
0,1649,76926,3578772274,3578772274,0
0,1649,76927,3578772274,3578772274,0
0,1649,76928,3578772274,3578772274,0
0,1649,76929,3578772274,3578772274,0
0,1649,76930,3578772274,3578772274,0
0,1649,76931,3578772274,3578772274,0
0,1649,76932,3578772274,3578772274,0
0,1649,76933,3578772274,3578772274,0
0,1649,76934,3578772274,3578772274,0
0,1649,76935,3578772274,3578772274,0
0,1649,76936,3578772274,3578772274,0
0,1649,76937,3578772274,3578772274,0
0,1649,76938,3578772274,3578772274,0
0,1649,76939,3578772274,3578772274,0
0,1649,76940,3578772274,3578772274,0
0,1649,76941,3578772274,3578772274,0
0,1649,76942,3578772274,3578772274,0
0,1649,76943,3578772274,3578772274,0
0,1649,76944,3578772274,3578772280,6
0,1649,76945,3578772274,3578772285,11
0,1649,76946,3578772274,3578772287,13
0,1649,76947,3578772274,3578772288,14
0,1649,76948,3578772274,3578772289,15
0,1649,76949,3578772274,3578772290,16
0,1649,76950,3578772274,3578772290,16
0,1649,76951,3578772274,3578772292,18
0,1649,76952,3578772274,3578772292,18
0,1649,76953,3578772274,3578772292,18
0,1649,76954,3578772274,3578772292,18
0,1649,76955,3578772274,3578772292,18
0,1649,76956,3578772274,3578772292,18
0,1649,76957,3578772274,3578772293,19
0,1649,76958,3578772274,3578772297,23
0,1649,76959,3578772274,3578772297,23
0,1649,76960,3578772274,3578772297,23
0,1649,76961,3578772274,3578772297,23
0,1649,76962,3578772274,3578772297,23
0,1649,76963,3578772274,3578772297,23
0,1649,76964,3578772274,3578772298,24
0,1649,76965,3578772274,3578772298,24
0,1649,76966,3578772274,3578772298,24
0,1649,76967,3578772274,3578772298,24
0,1649,76968,3578772274,3578772298,24
0,1649,76969,3578772274,3578772299,25
0,1649,76970,3578772274,3578772299,25
0,1649,76971,3578772274,3578772300,26
0,1649,76972,3578772274,3578772302,28
0,1649,76973,3578772274,3578772304,30
0,1649,76974,3578772274,3578772304,30
0,1649,76975,3578772274,3578772304,30
0,1649,76976,3578772274,3578772304,30
0,1649,76977,3578772274,3578772305,31
0,1649,76978,3578772274,3578772305,31
0,1649,76979,3578772274,3578772305,31
0,1649,76980,3578772274,3578772305,31
0,1649,76981,3578772274,3578772306,32
0,1649,76982,3578772274,3578772306,32
0,1649,76983,3578772274,3578772306,32
0,1649,76984,3578772274,3578772307,33
0,1649,76985,3578772274,3578772308,34
0,1649,76986,3578772274,3578772308,34
0,1649,76987,3578772274,3578772308,34
0,1649,76988,3578772274,3578772308,34
0,1649,76989,3578772274,3578772308,34
0,1649,76990,3578772274,3578772308,34
0,1649,76991,3578772274,3578772308,34
0,1649,76992,3578772274,3578772309,35
0,1649,76993,3578772274,3578772309,35
0,1649,76994,3578772274,3578772309,35
0,1649,76995,3578772274,3578772310,36
0,1649,76996,3578772274,3578772310,36
0,1649,76997,3578772274,3578772310,36
0,1649,76998,3578772274,3578772310,36
0,1649,76999,3578772274,3578772311,37
0,1649,77000,3578772274,3578772311,37
0,1649,77001,3578772274,3578772311,37
0,1649,77002,3578772274,3578772311,37
0,1649,77003,3578772274,3578772312,38
0,1649,77004,3578772274,3578772313,39
0,1649,77005,3578772274,3578772314,40
0,1649,77006,3578772274,3578772314,40
0,1649,77007,3578772274,3578772315,41
0,1649,77008,3578772274,3578772315,41
0,1649,77009,3578772274,3578772316,42
0,1649,77010,3578772274,3578772316,42
0,1649,77011,3578772274,3578772316,42
0,1649,77012,3578772274,3578772316,42
0,1649,77013,3578772274,3578772316,42
0,1649,77014,3578772274,3578772317,43
0,1649,77015,3578772274,3578772317,43
0,1649,77016,3578772274,3578772317,43
0,1649,77017,3578772274,3578772317,43
0,1649,77018,3578772274,3578772319,45
0,1649,77019,3578772274,3578772319,45
0,1649,77020,3578772274,3578772320,46
0,1649,77021,3578772274,3578772320,46
0,1649,77022,3578772274,3578772321,47
0,1649,77023,3578772274,3578772321,47
0,1649,77024,3578772274,3578772322,48
0,1649,77025,3578772274,3578772323,49
0,1649,77026,3578772274,3578772323,49
0,1649,77027,3578772274,3578772323,49
0,1649,77028,3578772274,3578772323,49
0,1649,77029,3578772274,3578772323,49
0,1650,77030,3578772340,3578772340,0
0,1650,77031,3578772340,3578772340,0
0,1650,77032,3578772340,3578772340,0
0,1650,77033,3578772340,3578772340,0
0,1650,77034,3578772340,3578772340,0
0,1650,77035,3578772340,3578772340,0
0,1650,77036,3578772340,3578772340,0
0,1650,77037,3578772340,3578772340,0
0,1650,77038,3578772340,3578772340,0
0,1650,77039,3578772340,3578772340,0
0,1650,77040,3578772340,3578772340,0
0,1650,77041,3578772340,3578772340,0
0,1650,77042,3578772340,3578772340,0
0,1650,77043,3578772340,3578772340,0
0,1650,77044,3578772340,3578772340,0
0,1650,77045,3578772340,3578772340,0
0,1650,77046,3578772340,3578772340,0
0,1650,77047,3578772340,3578772340,0
0,1650,77048,3578772340,3578772340,0
0,1650,77049,3578772340,3578772340,0
0,1650,77050,3578772340,3578772340,0
0,1650,77051,3578772340,3578772340,0
0,1650,77052,3578772340,3578772340,0
0,1650,77053,3578772340,3578772340,0
0,1650,77054,3578772340,3578772340,0
0,1650,77055,3578772340,3578772340,0
0,1650,77056,3578772340,3578772340,0
0,1650,77057,3578772340,3578772340,0
0,1650,77058,3578772340,3578772340,0
0,1650,77059,3578772340,3578772340,0
0,1650,77060,3578772340,3578772340,0
0,1650,77061,3578772340,3578772340,0
0,1650,77062,3578772340,3578772340,0
0,1650,77063,3578772340,3578772340,0
0,1650,77064,3578772340,3578772341,1
0,1650,77065,3578772340,3578772341,1
0,1650,77066,3578772340,3578772342,2
0,1650,77067,3578772340,3578772342,2
0,1650,77068,3578772340,3578772343,3
0,1650,77069,3578772340,3578772343,3
0,1650,77070,3578772340,3578772345,5
0,1650,77071,3578772340,3578772345,5
0,1650,77072,3578772340,3578772345,5
0,1650,77073,3578772340,3578772347,7
0,1650,77074,3578772340,3578772347,7
0,1650,77075,3578772340,3578772347,7
0,1650,77076,3578772340,3578772348,8
0,1650,77077,3578772340,3578772348,8
0,1650,77078,3578772340,3578772348,8
0,1650,77079,3578772340,3578772348,8
0,1650,77080,3578772340,3578772349,9
0,1650,77081,3578772340,3578772350,10
0,1650,77082,3578772340,3578772351,11
0,1650,77083,3578772340,3578772353,13
0,1650,77084,3578772340,3578772354,14
0,1650,77085,3578772340,3578772354,14
0,1650,77086,3578772340,3578772355,15
0,1650,77087,3578772340,3578772355,15
0,1650,77088,3578772340,3578772357,17
0,1650,77089,3578772340,3578772357,17
0,1650,77090,3578772340,3578772357,17
0,1650,77091,3578772340,3578772357,17
0,1650,77092,3578772340,3578772358,18
0,1650,77093,3578772340,3578772358,18
0,1650,77094,3578772340,3578772359,19
0,1650,77095,3578772340,3578772359,19
0,1650,77096,3578772340,3578772360,20
0,1650,77097,3578772340,3578772361,21
0,1650,77098,3578772340,3578772361,21
0,1650,77099,3578772340,3578772361,21
0,1650,77100,3578772340,3578772362,22
0,1650,77101,3578772340,3578772362,22
0,1650,77102,3578772340,3578772362,22
0,1650,77103,3578772340,3578772362,22
0,1650,77104,3578772340,3578772363,23
0,1650,77105,3578772340,3578772363,23
0,1650,77106,3578772340,3578772364,24
0,1650,77107,3578772340,3578772365,25
0,1650,77108,3578772340,3578772366,26
0,1650,77109,3578772340,3578772367,27
0,1650,77110,3578772340,3578772367,27
0,1650,77111,3578772340,3578772368,28
0,1650,77112,3578772340,3578772370,30
0,1650,77113,3578772340,3578772370,30
0,1650,77114,3578772340,3578772370,30
0,1650,77115,3578772340,3578772372,32
0,1650,77116,3578772340,3578772372,32
0,1650,77117,3578772340,3578772372,32
0,1650,77118,3578772340,3578772373,33
0,1650,77119,3578772340,3578772373,33
0,1650,77120,3578772340,3578772373,33
0,1650,77121,3578772340,3578772373,33
0,1650,77122,3578772340,3578772375,35
0,1650,77123,3578772340,3578772375,35
0,1650,77124,3578772340,3578772375,35
0,1650,77125,3578772340,3578772376,36
0,1650,77126,3578772340,3578772378,38
0,1650,77127,3578772340,3578772378,38
0,1650,77128,3578772340,3578772378,38
0,1650,77129,3578772340,3578772379,39
0,1650,77130,3578772340,3578772379,39
0,1650,77131,3578772340,3578772379,39
0,1650,77132,3578772340,3578772379,39
0,1650,77133,3578772340,3578772379,39
0,1650,77134,3578772340,3578772380,40
0,1650,77135,3578772340,3578772381,41
0,1650,77136,3578772340,3578772382,42
0,1650,77137,3578772340,3578772382,42
0,1650,77138,3578772340,3578772383,43
0,1650,77139,3578772340,3578772385,45
0,1650,77140,3578772340,3578772385,45
0,1650,77141,3578772340,3578772386,46
0,1650,77142,3578772340,3578772386,46
0,1650,77143,3578772340,3578772388,48
0,1650,77144,3578772340,3578772388,48
0,1650,77145,3578772340,3578772388,48
0,1650,77146,3578772340,3578772389,49
0,1650,77147,3578772340,3578772389,49
0,1650,77148,3578772340,3578772390,50
0,1651,77149,3578772405,3578772405,0
0,1651,77150,3578772405,3578772405,0
0,1651,77151,3578772405,3578772405,0
0,1651,77152,3578772405,3578772405,0
0,1651,77153,3578772405,3578772405,0
0,1651,77154,3578772405,3578772405,0
0,1651,77155,3578772405,3578772405,0
0,1651,77156,3578772405,3578772405,0
0,1651,77157,3578772405,3578772405,0
0,1651,77158,3578772405,3578772405,0
0,1651,77159,3578772405,3578772405,0
0,1651,77160,3578772405,3578772405,0
0,1651,77161,3578772405,3578772405,0
0,1651,77162,3578772405,3578772405,0
0,1651,77163,3578772405,3578772405,0
0,1651,77164,3578772405,3578772405,0
0,1651,77165,3578772405,3578772405,0
0,1651,77166,3578772405,3578772405,0
0,1651,77167,3578772405,3578772405,0
0,1651,77168,3578772405,3578772405,0
0,1651,77169,3578772405,3578772405,0
0,1651,77170,3578772405,3578772405,0
0,1651,77171,3578772405,3578772405,0
0,1651,77172,3578772405,3578772405,0
0,1651,77173,3578772405,3578772406,1
0,1651,77174,3578772405,3578772406,1
0,1651,77175,3578772405,3578772407,2
0,1651,77176,3578772405,3578772408,3
0,1651,77177,3578772405,3578772408,3
0,1651,77178,3578772405,3578772409,4
0,1651,77179,3578772405,3578772410,5
0,1651,77180,3578772405,3578772411,6
0,1651,77181,3578772405,3578772412,7
0,1651,77182,3578772405,3578772413,8
0,1651,77183,3578772405,3578772414,9
0,1651,77184,3578772405,3578772414,9
0,1651,77185,3578772405,3578772415,10
0,1651,77186,3578772405,3578772415,10
0,1651,77187,3578772405,3578772415,10
0,1651,77188,3578772405,3578772416,11
0,1651,77189,3578772405,3578772417,12
0,1651,77190,3578772405,3578772418,13
0,1651,77191,3578772405,3578772418,13
0,1651,77192,3578772405,3578772419,14
0,1651,77193,3578772405,3578772419,14
0,1651,77194,3578772405,3578772420,15
0,1651,77195,3578772405,3578772420,15
0,1651,77196,3578772405,3578772420,15
0,1651,77197,3578772405,3578772421,16
0,1651,77198,3578772405,3578772422,17
0,1651,77199,3578772405,3578772422,17
0,1651,77200,3578772405,3578772422,17
0,1651,77201,3578772405,3578772423,18
0,1651,77202,3578772405,3578772423,18
0,1651,77203,3578772405,3578772423,18
0,1651,77204,3578772405,3578772424,19
0,1651,77205,3578772405,3578772424,19
0,1651,77206,3578772405,3578772425,20
0,1651,77207,3578772405,3578772426,21
0,1651,77208,3578772405,3578772427,22
0,1651,77209,3578772405,3578772427,22
0,1651,77210,3578772405,3578772428,23
0,1651,77211,3578772405,3578772428,23
0,1651,77212,3578772405,3578772428,23
0,1651,77213,3578772405,3578772430,25
0,1651,77214,3578772405,3578772430,25
0,1651,77215,3578772405,3578772431,26
0,1651,77216,3578772405,3578772432,27
0,1651,77217,3578772405,3578772432,27
0,1651,77218,3578772405,3578772432,27
0,1651,77219,3578772405,3578772433,28
0,1651,77220,3578772405,3578772433,28
0,1651,77221,3578772405,3578772433,28
0,1651,77222,3578772405,3578772434,29
0,1651,77223,3578772405,3578772435,30
0,1651,77224,3578772405,3578772435,30
0,1651,77225,3578772405,3578772436,31
0,1651,77226,3578772405,3578772437,32
0,1651,77227,3578772405,3578772437,32
0,1651,77228,3578772405,3578772438,33
0,1651,77229,3578772405,3578772439,34
0,1651,77230,3578772405,3578772439,34
0,1651,77231,3578772405,3578772439,34
0,1651,77232,3578772405,3578772439,34
0,1651,77233,3578772405,3578772439,34
0,1651,77234,3578772405,3578772440,35
0,1651,77235,3578772405,3578772440,35
0,1651,77236,3578772405,3578772442,37
0,1651,77237,3578772405,3578772442,37
0,1651,77238,3578772405,3578772443,38
0,1651,77239,3578772405,3578772443,38
0,1651,77240,3578772405,3578772444,39
0,1651,77241,3578772405,3578772444,39
0,1651,77242,3578772405,3578772444,39
0,1651,77243,3578772405,3578772448,43
0,1651,77244,3578772405,3578772448,43
0,1651,77245,3578772405,3578772448,43
0,1651,77246,3578772405,3578772449,44
0,1651,77247,3578772405,3578772450,45
0,1651,77248,3578772405,3578772450,45
0,1651,77249,3578772405,3578772450,45
0,1651,77250,3578772405,3578772450,45
0,1651,77251,3578772405,3578772450,45
0,1651,77252,3578772405,3578772452,47
0,1651,77253,3578772405,3578772453,48
0,1651,77254,3578772405,3578772455,50
0,1652,77255,3578772471,3578772471,0
0,1652,77256,3578772471,3578772471,0
0,1652,77257,3578772471,3578772471,0
0,1652,77258,3578772471,3578772471,0
0,1652,77259,3578772471,3578772471,0
0,1652,77260,3578772471,3578772471,0
0,1652,77261,3578772471,3578772471,0
0,1652,77262,3578772471,3578772471,0
0,1652,77263,3578772471,3578772471,0
0,1652,77264,3578772471,3578772471,0
0,1652,77265,3578772471,3578772471,0
0,1652,77266,3578772471,3578772471,0
0,1652,77267,3578772471,3578772471,0
0,1652,77268,3578772471,3578772471,0
0,1652,77269,3578772471,3578772471,0
0,1652,77270,3578772471,3578772471,0
0,1652,77271,3578772471,3578772471,0
0,1652,77272,3578772471,3578772471,0
0,1652,77273,3578772471,3578772471,0
0,1652,77274,3578772471,3578772471,0
0,1652,77275,3578772471,3578772471,0
0,1652,77276,3578772471,3578772471,0
0,1652,77277,3578772471,3578772471,0
0,1652,77278,3578772471,3578772471,0
0,1652,77279,3578772471,3578772471,0
0,1652,77280,3578772471,3578772471,0
0,1652,77281,3578772471,3578772471,0
0,1652,77282,3578772471,3578772471,0
0,1652,77283,3578772471,3578772476,5
0,1652,77284,3578772471,3578772480,9
0,1652,77285,3578772471,3578772487,16
0,1652,77286,3578772471,3578772489,18
0,1652,77287,3578772471,3578772489,18
0,1652,77288,3578772471,3578772489,18
0,1652,77289,3578772471,3578772490,19
0,1652,77290,3578772471,3578772492,21
0,1652,77291,3578772471,3578772492,21
0,1652,77292,3578772471,3578772492,21
0,1652,77293,3578772471,3578772492,21
0,1652,77294,3578772471,3578772492,21
0,1652,77295,3578772471,3578772493,22
0,1652,77296,3578772471,3578772495,24
0,1652,77297,3578772471,3578772495,24
0,1652,77298,3578772471,3578772496,25
0,1652,77299,3578772471,3578772497,26
0,1652,77300,3578772471,3578772497,26
0,1652,77301,3578772471,3578772497,26
0,1652,77302,3578772471,3578772498,27
0,1652,77303,3578772471,3578772498,27
0,1652,77304,3578772471,3578772498,27
0,1652,77305,3578772471,3578772498,27
0,1652,77306,3578772471,3578772499,28
0,1652,77307,3578772471,3578772499,28
0,1652,77308,3578772471,3578772499,28
0,1652,77309,3578772471,3578772500,29
0,1652,77310,3578772471,3578772501,30
0,1652,77311,3578772471,3578772502,31
0,1652,77312,3578772471,3578772502,31
0,1652,77313,3578772471,3578772504,33
0,1652,77314,3578772471,3578772504,33
0,1652,77315,3578772471,3578772504,33
0,1652,77316,3578772471,3578772504,33
0,1652,77317,3578772471,3578772505,34
0,1652,77318,3578772471,3578772505,34
0,1652,77319,3578772471,3578772506,35
0,1652,77320,3578772471,3578772506,35
0,1652,77321,3578772471,3578772506,35
0,1652,77322,3578772471,3578772508,37
0,1652,77323,3578772471,3578772508,37
0,1652,77324,3578772471,3578772508,37
0,1652,77325,3578772471,3578772508,37
0,1652,77326,3578772471,3578772508,37
0,1652,77327,3578772471,3578772508,37
0,1652,77328,3578772471,3578772509,38
0,1652,77329,3578772471,3578772509,38
0,1652,77330,3578772471,3578772509,38
0,1652,77331,3578772471,3578772510,39
0,1652,77332,3578772471,3578772510,39
0,1652,77333,3578772471,3578772510,39
0,1652,77334,3578772471,3578772510,39
0,1652,77335,3578772471,3578772511,40
0,1652,77336,3578772471,3578772511,40
0,1652,77337,3578772471,3578772511,40
0,1652,77338,3578772471,3578772511,40
0,1652,77339,3578772471,3578772511,40
0,1652,77340,3578772471,3578772511,40
0,1652,77341,3578772471,3578772512,41
0,1652,77342,3578772471,3578772513,42
0,1652,77343,3578772471,3578772514,43
0,1652,77344,3578772471,3578772515,44
0,1652,77345,3578772471,3578772515,44
0,1652,77346,3578772471,3578772515,44
0,1652,77347,3578772471,3578772516,45
0,1652,77348,3578772471,3578772516,45
0,1652,77349,3578772471,3578772516,45
0,1652,77350,3578772471,3578772516,45
0,1652,77351,3578772471,3578772516,45
0,1652,77352,3578772471,3578772517,46
0,1652,77353,3578772471,3578772518,47
0,1652,77354,3578772471,3578772518,47
0,1652,77355,3578772471,3578772518,47
0,1652,77356,3578772471,3578772519,48
0,1652,77357,3578772471,3578772519,48
0,1652,77358,3578772471,3578772519,48
0,1652,77359,3578772471,3578772520,49
0,1652,77360,3578772471,3578772521,50
0,1653,77361,3578772538,3578772538,0
0,1653,77362,3578772538,3578772538,0
0,1653,77363,3578772538,3578772538,0
0,1653,77364,3578772538,3578772538,0
0,1653,77365,3578772538,3578772538,0
0,1653,77366,3578772538,3578772538,0
0,1653,77367,3578772538,3578772538,0
0,1653,77368,3578772538,3578772538,0
0,1653,77369,3578772538,3578772538,0
0,1653,77370,3578772538,3578772538,0
0,1653,77371,3578772538,3578772538,0
0,1653,77372,3578772538,3578772538,0
0,1653,77373,3578772538,3578772538,0
0,1653,77374,3578772538,3578772538,0
0,1653,77375,3578772538,3578772538,0
0,1653,77376,3578772538,3578772538,0
0,1653,77377,3578772538,3578772538,0
0,1653,77378,3578772538,3578772538,0
0,1653,77379,3578772538,3578772538,0
0,1653,77380,3578772538,3578772538,0
0,1653,77381,3578772538,3578772538,0
0,1653,77382,3578772538,3578772538,0
0,1653,77383,3578772538,3578772538,0
0,1653,77384,3578772538,3578772538,0
0,1653,77385,3578772538,3578772538,0
0,1653,77386,3578772538,3578772538,0
0,1653,77387,3578772538,3578772538,0
0,1653,77388,3578772538,3578772538,0
0,1653,77389,3578772538,3578772538,0
0,1653,77390,3578772538,3578772538,0
0,1653,77391,3578772538,3578772538,0
0,1653,77392,3578772538,3578772538,0
0,1653,77393,3578772538,3578772538,0
0,1653,77394,3578772538,3578772538,0
0,1653,77395,3578772538,3578772538,0
0,1653,77396,3578772538,3578772538,0
0,1653,77397,3578772538,3578772538,0
0,1653,77398,3578772538,3578772538,0
0,1653,77399,3578772538,3578772538,0
0,1653,77400,3578772538,3578772539,1
0,1653,77401,3578772538,3578772540,2
0,1653,77402,3578772538,3578772540,2
0,1653,77403,3578772538,3578772540,2
0,1653,77404,3578772538,3578772540,2
0,1653,77405,3578772538,3578772540,2
0,1653,77406,3578772538,3578772541,3
0,1653,77407,3578772538,3578772542,4
0,1653,77408,3578772538,3578772542,4
0,1653,77409,3578772538,3578772542,4
0,1653,77410,3578772538,3578772542,4
0,1653,77411,3578772538,3578772543,5
0,1653,77412,3578772538,3578772544,6
0,1653,77413,3578772538,3578772544,6
0,1653,77414,3578772538,3578772545,7
0,1653,77415,3578772538,3578772546,8
0,1653,77416,3578772538,3578772546,8
0,1653,77417,3578772538,3578772547,9
0,1653,77418,3578772538,3578772547,9
0,1653,77419,3578772538,3578772547,9
0,1653,77420,3578772538,3578772549,11
0,1653,77421,3578772538,3578772549,11
0,1653,77422,3578772538,3578772549,11
0,1653,77423,3578772538,3578772552,14
0,1653,77424,3578772538,3578772552,14
0,1653,77425,3578772538,3578772553,15
0,1653,77426,3578772538,3578772554,16
0,1653,77427,3578772538,3578772554,16
0,1653,77428,3578772538,3578772556,18
0,1653,77429,3578772538,3578772557,19
0,1653,77430,3578772538,3578772557,19
0,1653,77431,3578772538,3578772557,19
0,1653,77432,3578772538,3578772558,20
0,1653,77433,3578772538,3578772558,20
0,1653,77434,3578772538,3578772558,20
0,1653,77435,3578772538,3578772559,21
0,1653,77436,3578772538,3578772560,22
0,1653,77437,3578772538,3578772560,22
0,1653,77438,3578772538,3578772560,22
0,1653,77439,3578772538,3578772561,23
0,1653,77440,3578772538,3578772561,23
0,1653,77441,3578772538,3578772561,23
0,1653,77442,3578772538,3578772561,23
0,1653,77443,3578772538,3578772562,24
0,1653,77444,3578772538,3578772562,24
0,1653,77445,3578772538,3578772563,25
0,1653,77446,3578772538,3578772564,26
0,1653,77447,3578772538,3578772564,26
0,1653,77448,3578772538,3578772564,26
0,1653,77449,3578772538,3578772566,28
0,1653,77450,3578772538,3578772566,28
0,1653,77451,3578772538,3578772567,29
0,1653,77452,3578772538,3578772569,31
0,1653,77453,3578772538,3578772569,31
0,1653,77454,3578772538,3578772571,33
0,1653,77455,3578772538,3578772571,33
0,1653,77456,3578772538,3578772571,33
0,1653,77457,3578772538,3578772571,33
0,1653,77458,3578772538,3578772572,34
0,1653,77459,3578772538,3578772572,34
0,1653,77460,3578772538,3578772574,36
0,1653,77461,3578772538,3578772575,37
0,1653,77462,3578772538,3578772576,38
0,1653,77463,3578772538,3578772577,39
0,1653,77464,3578772538,3578772577,39
0,1653,77465,3578772538,3578772578,40
0,1653,77466,3578772538,3578772578,40
0,1653,77467,3578772538,3578772578,40
0,1653,77468,3578772538,3578772578,40
0,1653,77469,3578772538,3578772578,40
0,1653,77470,3578772538,3578772578,40
0,1653,77471,3578772538,3578772578,40
0,1653,77472,3578772538,3578772579,41
0,1653,77473,3578772538,3578772580,42
0,1653,77474,3578772538,3578772581,43
0,1653,77475,3578772538,3578772585,47
0,1653,77476,3578772538,3578772585,47
0,1653,77477,3578772538,3578772586,48
0,1653,77478,3578772538,3578772588,50
0,1654,77479,3578772605,3578772605,0
0,1654,77480,3578772605,3578772605,0
0,1654,77481,3578772605,3578772605,0
0,1654,77482,3578772605,3578772605,0
0,1654,77483,3578772605,3578772605,0
0,1654,77484,3578772605,3578772605,0
0,1654,77485,3578772605,3578772605,0
0,1654,77486,3578772605,3578772605,0
0,1654,77487,3578772605,3578772605,0
0,1654,77488,3578772605,3578772605,0
0,1654,77489,3578772605,3578772605,0
0,1654,77490,3578772605,3578772605,0
0,1654,77491,3578772605,3578772605,0
0,1654,77492,3578772605,3578772605,0
0,1654,77493,3578772605,3578772605,0
0,1654,77494,3578772605,3578772605,0
0,1654,77495,3578772605,3578772605,0
0,1654,77496,3578772605,3578772605,0
0,1654,77497,3578772605,3578772605,0
0,1654,77498,3578772605,3578772605,0
0,1654,77499,3578772605,3578772605,0
0,1654,77500,3578772605,3578772605,0
0,1654,77501,3578772605,3578772605,0
0,1654,77502,3578772605,3578772605,0
0,1654,77503,3578772605,3578772605,0
0,1654,77504,3578772605,3578772605,0
0,1654,77505,3578772605,3578772605,0
0,1654,77506,3578772605,3578772605,0
0,1654,77507,3578772605,3578772606,1
0,1654,77508,3578772605,3578772606,1
0,1654,77509,3578772605,3578772607,2
0,1654,77510,3578772605,3578772608,3
0,1654,77511,3578772605,3578772609,4
0,1654,77512,3578772605,3578772611,6
0,1654,77513,3578772605,3578772613,8
0,1654,77514,3578772605,3578772613,8
0,1654,77515,3578772605,3578772614,9
0,1654,77516,3578772605,3578772614,9
0,1654,77517,3578772605,3578772614,9
0,1654,77518,3578772605,3578772614,9
0,1654,77519,3578772605,3578772616,11
0,1654,77520,3578772605,3578772617,12
0,1654,77521,3578772605,3578772617,12
0,1654,77522,3578772605,3578772618,13
0,1654,77523,3578772605,3578772618,13
0,1654,77524,3578772605,3578772618,13
0,1654,77525,3578772605,3578772619,14
0,1654,77526,3578772605,3578772621,16
0,1654,77527,3578772605,3578772621,16
0,1654,77528,3578772605,3578772621,16
0,1654,77529,3578772605,3578772622,17
0,1654,77530,3578772605,3578772622,17
0,1654,77531,3578772605,3578772623,18
0,1654,77532,3578772605,3578772623,18
0,1654,77533,3578772605,3578772624,19
0,1654,77534,3578772605,3578772626,21
0,1654,77535,3578772605,3578772627,22
0,1654,77536,3578772605,3578772627,22
0,1654,77537,3578772605,3578772627,22
0,1654,77538,3578772605,3578772628,23
0,1654,77539,3578772605,3578772628,23
0,1654,77540,3578772605,3578772630,25
0,1654,77541,3578772605,3578772631,26
0,1654,77542,3578772605,3578772631,26
0,1654,77543,3578772605,3578772631,26
0,1654,77544,3578772605,3578772631,26
0,1654,77545,3578772605,3578772631,26
0,1654,77546,3578772605,3578772633,28
0,1654,77547,3578772605,3578772634,29
0,1654,77548,3578772605,3578772635,30
0,1654,77549,3578772605,3578772636,31
0,1654,77550,3578772605,3578772636,31
0,1654,77551,3578772605,3578772636,31
0,1654,77552,3578772605,3578772637,32
0,1654,77553,3578772605,3578772637,32
0,1654,77554,3578772605,3578772638,33
0,1654,77555,3578772605,3578772638,33
0,1654,77556,3578772605,3578772638,33
0,1654,77557,3578772605,3578772638,33
0,1654,77558,3578772605,3578772639,34
0,1654,77559,3578772605,3578772639,34
0,1654,77560,3578772605,3578772639,34
0,1654,77561,3578772605,3578772640,35
0,1654,77562,3578772605,3578772640,35
0,1654,77563,3578772605,3578772641,36
0,1654,77564,3578772605,3578772641,36
0,1654,77565,3578772605,3578772642,37
0,1654,77566,3578772605,3578772643,38
0,1654,77567,3578772605,3578772643,38
0,1654,77568,3578772605,3578772644,39
0,1654,77569,3578772605,3578772647,42
0,1654,77570,3578772605,3578772648,43
0,1654,77571,3578772605,3578772648,43
0,1654,77572,3578772605,3578772648,43
0,1654,77573,3578772605,3578772649,44
0,1654,77574,3578772605,3578772649,44
0,1654,77575,3578772605,3578772650,45
0,1654,77576,3578772605,3578772651,46
0,1654,77577,3578772605,3578772652,47
0,1654,77578,3578772605,3578772653,48
0,1654,77579,3578772605,3578772655,50
0,1655,77580,3578772672,3578772672,0
0,1655,77581,3578772672,3578772672,0
0,1655,77582,3578772672,3578772672,0
0,1655,77583,3578772672,3578772672,0
0,1655,77584,3578772672,3578772672,0
0,1655,77585,3578772672,3578772672,0
0,1655,77586,3578772672,3578772672,0
0,1655,77587,3578772672,3578772672,0
0,1655,77588,3578772672,3578772672,0
0,1655,77589,3578772672,3578772672,0
0,1655,77590,3578772672,3578772672,0
0,1655,77591,3578772672,3578772672,0
0,1655,77592,3578772672,3578772672,0
0,1655,77593,3578772672,3578772672,0
0,1655,77594,3578772672,3578772672,0
0,1655,77595,3578772672,3578772672,0
0,1655,77596,3578772672,3578772672,0
0,1655,77597,3578772672,3578772672,0
0,1655,77598,3578772672,3578772672,0
0,1655,77599,3578772672,3578772672,0
0,1655,77600,3578772672,3578772672,0
0,1655,77601,3578772672,3578772672,0
0,1655,77602,3578772672,3578772672,0
0,1655,77603,3578772672,3578772672,0
0,1655,77604,3578772672,3578772672,0
0,1655,77605,3578772672,3578772680,8
0,1655,77606,3578772672,3578772686,14
0,1655,77607,3578772672,3578772687,15
0,1655,77608,3578772672,3578772689,17
0,1655,77609,3578772672,3578772689,17
0,1655,77610,3578772672,3578772690,18
0,1655,77611,3578772672,3578772690,18
0,1655,77612,3578772672,3578772690,18
0,1655,77613,3578772672,3578772692,20
0,1655,77614,3578772672,3578772692,20
0,1655,77615,3578772672,3578772692,20
0,1655,77616,3578772672,3578772692,20
0,1655,77617,3578772672,3578772692,20
0,1655,77618,3578772672,3578772693,21
0,1655,77619,3578772672,3578772693,21
0,1655,77620,3578772672,3578772694,22
0,1655,77621,3578772672,3578772694,22
0,1655,77622,3578772672,3578772694,22
0,1655,77623,3578772672,3578772695,23
0,1655,77624,3578772672,3578772696,24
0,1655,77625,3578772672,3578772697,25
0,1655,77626,3578772672,3578772697,25
0,1655,77627,3578772672,3578772697,25
0,1655,77628,3578772672,3578772697,25
0,1655,77629,3578772672,3578772697,25
0,1655,77630,3578772672,3578772698,26
0,1655,77631,3578772672,3578772698,26
0,1655,77632,3578772672,3578772698,26
0,1655,77633,3578772672,3578772698,26
0,1655,77634,3578772672,3578772699,27
0,1655,77635,3578772672,3578772700,28
0,1655,77636,3578772672,3578772701,29
0,1655,77637,3578772672,3578772701,29
0,1655,77638,3578772672,3578772702,30
0,1655,77639,3578772672,3578772704,32
0,1655,77640,3578772672,3578772704,32
0,1655,77641,3578772672,3578772704,32
0,1655,77642,3578772672,3578772704,32
0,1655,77643,3578772672,3578772705,33
0,1655,77644,3578772672,3578772705,33
0,1655,77645,3578772672,3578772706,34
0,1655,77646,3578772672,3578772707,35
0,1655,77647,3578772672,3578772708,36
0,1655,77648,3578772672,3578772708,36
0,1655,77649,3578772672,3578772708,36
0,1655,77650,3578772672,3578772708,36
0,1655,77651,3578772672,3578772708,36
0,1655,77652,3578772672,3578772709,37
0,1655,77653,3578772672,3578772709,37
0,1655,77654,3578772672,3578772710,38
0,1655,77655,3578772672,3578772710,38
0,1655,77656,3578772672,3578772710,38
0,1655,77657,3578772672,3578772710,38
0,1655,77658,3578772672,3578772710,38
0,1655,77659,3578772672,3578772711,39
0,1655,77660,3578772672,3578772711,39
0,1655,77661,3578772672,3578772711,39
0,1655,77662,3578772672,3578772711,39
0,1655,77663,3578772672,3578772711,39
0,1655,77664,3578772672,3578772712,40
0,1655,77665,3578772672,3578772713,41
0,1655,77666,3578772672,3578772714,42
0,1655,77667,3578772672,3578772715,43
0,1655,77668,3578772672,3578772715,43
0,1655,77669,3578772672,3578772715,43
0,1655,77670,3578772672,3578772716,44
0,1655,77671,3578772672,3578772716,44
0,1655,77672,3578772672,3578772716,44
0,1655,77673,3578772672,3578772717,45
0,1655,77674,3578772672,3578772717,45
0,1655,77675,3578772672,3578772718,46
0,1655,77676,3578772672,3578772718,46
0,1655,77677,3578772672,3578772718,46
0,1655,77678,3578772672,3578772718,46
0,1655,77679,3578772672,3578772718,46
0,1655,77680,3578772672,3578772719,47
0,1655,77681,3578772672,3578772719,47
0,1655,77682,3578772672,3578772719,47
0,1655,77683,3578772672,3578772720,48
0,1656,77684,3578772738,3578772738,0
0,1656,77685,3578772738,3578772738,0
0,1656,77686,3578772738,3578772738,0
0,1656,77687,3578772738,3578772738,0
0,1656,77688,3578772738,3578772738,0
0,1656,77689,3578772738,3578772738,0
0,1656,77690,3578772738,3578772738,0
0,1656,77691,3578772738,3578772738,0
0,1656,77692,3578772738,3578772738,0
0,1656,77693,3578772738,3578772738,0
0,1656,77694,3578772738,3578772738,0
0,1656,77695,3578772738,3578772738,0
0,1656,77696,3578772738,3578772738,0
0,1656,77697,3578772738,3578772738,0
0,1656,77698,3578772738,3578772738,0
0,1656,77699,3578772738,3578772738,0
0,1656,77700,3578772738,3578772738,0
0,1656,77701,3578772738,3578772738,0
0,1656,77702,3578772738,3578772738,0
0,1656,77703,3578772738,3578772738,0
0,1656,77704,3578772738,3578772738,0
0,1656,77705,3578772738,3578772738,0
0,1656,77706,3578772738,3578772738,0
0,1656,77707,3578772738,3578772738,0
0,1656,77708,3578772738,3578772738,0
0,1656,77709,3578772738,3578772738,0
0,1656,77710,3578772738,3578772738,0
0,1656,77711,3578772738,3578772738,0
0,1656,77712,3578772738,3578772738,0
0,1656,77713,3578772738,3578772738,0
0,1656,77714,3578772738,3578772738,0
0,1656,77715,3578772738,3578772738,0
0,1656,77716,3578772738,3578772738,0
0,1656,77717,3578772738,3578772738,0
0,1656,77718,3578772738,3578772738,0
0,1656,77719,3578772738,3578772738,0
0,1656,77720,3578772738,3578772738,0
0,1656,77721,3578772738,3578772738,0
0,1656,77722,3578772738,3578772738,0
0,1656,77723,3578772738,3578772738,0
0,1656,77724,3578772738,3578772739,1
0,1656,77725,3578772738,3578772739,1
0,1656,77726,3578772738,3578772739,1
0,1656,77727,3578772738,3578772740,2
0,1656,77728,3578772738,3578772740,2
0,1656,77729,3578772738,3578772740,2
0,1656,77730,3578772738,3578772740,2
0,1656,77731,3578772738,3578772740,2
0,1656,77732,3578772738,3578772741,3
0,1656,77733,3578772738,3578772742,4
0,1656,77734,3578772738,3578772742,4
0,1656,77735,3578772738,3578772743,5
0,1656,77736,3578772738,3578772744,6
0,1656,77737,3578772738,3578772744,6
0,1656,77738,3578772738,3578772745,7
0,1656,77739,3578772738,3578772745,7
0,1656,77740,3578772738,3578772746,8
0,1656,77741,3578772738,3578772746,8
0,1656,77742,3578772738,3578772746,8
0,1656,77743,3578772738,3578772747,9
0,1656,77744,3578772738,3578772747,9
0,1656,77745,3578772738,3578772747,9
0,1656,77746,3578772738,3578772748,10
0,1656,77747,3578772738,3578772748,10
0,1656,77748,3578772738,3578772749,11
0,1656,77749,3578772738,3578772752,14
0,1656,77750,3578772738,3578772752,14
0,1656,77751,3578772738,3578772752,14
0,1656,77752,3578772738,3578772752,14
0,1656,77753,3578772738,3578772752,14
0,1656,77754,3578772738,3578772753,15
0,1656,77755,3578772738,3578772754,16
0,1656,77756,3578772738,3578772755,17
0,1656,77757,3578772738,3578772757,19
0,1656,77758,3578772738,3578772757,19
0,1656,77759,3578772738,3578772757,19
0,1656,77760,3578772738,3578772757,19
0,1656,77761,3578772738,3578772757,19
0,1656,77762,3578772738,3578772758,20
0,1656,77763,3578772738,3578772759,21
0,1656,77764,3578772738,3578772759,21
0,1656,77765,3578772738,3578772760,22
0,1656,77766,3578772738,3578772760,22
0,1656,77767,3578772738,3578772761,23
0,1656,77768,3578772738,3578772761,23
0,1656,77769,3578772738,3578772761,23
0,1656,77770,3578772738,3578772761,23
0,1656,77771,3578772738,3578772762,24
0,1656,77772,3578772738,3578772762,24
0,1656,77773,3578772738,3578772763,25
0,1656,77774,3578772738,3578772764,26
0,1656,77775,3578772738,3578772765,27
0,1656,77776,3578772738,3578772766,28
0,1656,77777,3578772738,3578772767,29
0,1656,77778,3578772738,3578772768,30
0,1656,77779,3578772738,3578772768,30
0,1656,77780,3578772738,3578772768,30
0,1656,77781,3578772738,3578772769,31
0,1656,77782,3578772738,3578772771,33
0,1656,77783,3578772738,3578772771,33
0,1656,77784,3578772738,3578772772,34
0,1656,77785,3578772738,3578772772,34
0,1656,77786,3578772738,3578772772,34
0,1656,77787,3578772738,3578772773,35
0,1656,77788,3578772738,3578772774,36
0,1656,77789,3578772738,3578772774,36
0,1656,77790,3578772738,3578772774,36
0,1656,77791,3578772738,3578772775,37
0,1656,77792,3578772738,3578772777,39
0,1656,77793,3578772738,3578772777,39
0,1656,77794,3578772738,3578772778,40
0,1656,77795,3578772738,3578772778,40
0,1656,77796,3578772738,3578772778,40
0,1656,77797,3578772738,3578772778,40
0,1656,77798,3578772738,3578772778,40
0,1656,77799,3578772738,3578772778,40
0,1656,77800,3578772738,3578772779,41
0,1656,77801,3578772738,3578772780,42
0,1656,77802,3578772738,3578772781,43
0,1656,77803,3578772738,3578772783,45
0,1656,77804,3578772738,3578772784,46
0,1656,77805,3578772738,3578772785,47
0,1656,77806,3578772738,3578772785,47
0,1656,77807,3578772738,3578772785,47
0,1656,77808,3578772738,3578772786,48
0,1656,77809,3578772738,3578772788,50
0,1657,77810,3578772803,3578772803,0
0,1657,77811,3578772803,3578772803,0
0,1657,77812,3578772803,3578772803,0
0,1657,77813,3578772803,3578772803,0
0,1657,77814,3578772803,3578772803,0
0,1657,77815,3578772803,3578772803,0
0,1657,77816,3578772803,3578772803,0
0,1657,77817,3578772803,3578772803,0
0,1657,77818,3578772803,3578772803,0
0,1657,77819,3578772803,3578772803,0
0,1657,77820,3578772803,3578772803,0
0,1657,77821,3578772803,3578772803,0
0,1657,77822,3578772803,3578772803,0
0,1657,77823,3578772803,3578772803,0
0,1657,77824,3578772803,3578772803,0
0,1657,77825,3578772803,3578772803,0
0,1657,77826,3578772803,3578772803,0
0,1657,77827,3578772803,3578772803,0
0,1657,77828,3578772803,3578772803,0
0,1657,77829,3578772803,3578772803,0
0,1657,77830,3578772803,3578772803,0
0,1657,77831,3578772803,3578772803,0
0,1657,77832,3578772803,3578772803,0
0,1657,77833,3578772803,3578772803,0
0,1657,77834,3578772803,3578772804,1
0,1657,77835,3578772803,3578772804,1
0,1657,77836,3578772803,3578772805,2
0,1657,77837,3578772803,3578772805,2
0,1657,77838,3578772803,3578772806,3
0,1657,77839,3578772803,3578772807,4
0,1657,77840,3578772803,3578772808,5
0,1657,77841,3578772803,3578772808,5
0,1657,77842,3578772803,3578772808,5
0,1657,77843,3578772803,3578772808,5
0,1657,77844,3578772803,3578772810,7
0,1657,77845,3578772803,3578772811,8
0,1657,77846,3578772803,3578772813,10
0,1657,77847,3578772803,3578772813,10
0,1657,77848,3578772803,3578772815,12
0,1657,77849,3578772803,3578772815,12
0,1657,77850,3578772803,3578772815,12
0,1657,77851,3578772803,3578772815,12
0,1657,77852,3578772803,3578772815,12
0,1657,77853,3578772803,3578772816,13
0,1657,77854,3578772803,3578772817,14
0,1657,77855,3578772803,3578772818,15
0,1657,77856,3578772803,3578772818,15
0,1657,77857,3578772803,3578772818,15
0,1657,77858,3578772803,3578772821,18
0,1657,77859,3578772803,3578772821,18
0,1657,77860,3578772803,3578772821,18
0,1657,77861,3578772803,3578772822,19
0,1657,77862,3578772803,3578772823,20
0,1657,77863,3578772803,3578772824,21
0,1657,77864,3578772803,3578772825,22
0,1657,77865,3578772803,3578772826,23
0,1657,77866,3578772803,3578772827,24
0,1657,77867,3578772803,3578772827,24
0,1657,77868,3578772803,3578772827,24
0,1657,77869,3578772803,3578772828,25
0,1657,77870,3578772803,3578772829,26
0,1657,77871,3578772803,3578772829,26
0,1657,77872,3578772803,3578772830,27
0,1657,77873,3578772803,3578772831,28
0,1657,77874,3578772803,3578772832,29
0,1657,77875,3578772803,3578772835,32
0,1657,77876,3578772803,3578772836,33
0,1657,77877,3578772803,3578772836,33
0,1657,77878,3578772803,3578772836,33
0,1657,77879,3578772803,3578772836,33
0,1657,77880,3578772803,3578772838,35
0,1657,77881,3578772803,3578772838,35
0,1657,77882,3578772803,3578772838,35
0,1657,77883,3578772803,3578772839,36
0,1657,77884,3578772803,3578772839,36
0,1657,77885,3578772803,3578772840,37
0,1657,77886,3578772803,3578772840,37
0,1657,77887,3578772803,3578772840,37
0,1657,77888,3578772803,3578772841,38
0,1657,77889,3578772803,3578772841,38
0,1657,77890,3578772803,3578772841,38
0,1657,77891,3578772803,3578772842,39
0,1657,77892,3578772803,3578772843,40
0,1657,77893,3578772803,3578772843,40
0,1657,77894,3578772803,3578772843,40
0,1657,77895,3578772803,3578772844,41
0,1657,77896,3578772803,3578772847,44
0,1657,77897,3578772803,3578772848,45
0,1657,77898,3578772803,3578772848,45
0,1657,77899,3578772803,3578772848,45
0,1657,77900,3578772803,3578772848,45
0,1657,77901,3578772803,3578772849,46
0,1657,77902,3578772803,3578772849,46
0,1657,77903,3578772803,3578772849,46
0,1657,77904,3578772803,3578772849,46
0,1657,77905,3578772803,3578772849,46
0,1657,77906,3578772803,3578772850,47
0,1657,77907,3578772803,3578772850,47
0,1657,77908,3578772803,3578772850,47
0,1657,77909,3578772803,3578772852,49
0,1658,77910,3578772869,3578772869,0
0,1658,77911,3578772869,3578772869,0
0,1658,77912,3578772869,3578772869,0
0,1658,77913,3578772869,3578772869,0
0,1658,77914,3578772869,3578772869,0
0,1658,77915,3578772869,3578772869,0
0,1658,77916,3578772869,3578772869,0
0,1658,77917,3578772869,3578772869,0
0,1658,77918,3578772869,3578772869,0
0,1658,77919,3578772869,3578772869,0
0,1658,77920,3578772869,3578772869,0
0,1658,77921,3578772869,3578772869,0
0,1658,77922,3578772869,3578772869,0
0,1658,77923,3578772869,3578772869,0
0,1658,77924,3578772869,3578772869,0
0,1658,77925,3578772869,3578772869,0
0,1658,77926,3578772869,3578772869,0
0,1658,77927,3578772869,3578772869,0
0,1658,77928,3578772869,3578772869,0
0,1658,77929,3578772869,3578772869,0
0,1658,77930,3578772869,3578772869,0
0,1658,77931,3578772869,3578772869,0
0,1658,77932,3578772869,3578772869,0
0,1658,77933,3578772869,3578772870,1
0,1658,77934,3578772869,3578772876,7
0,1658,77935,3578772869,3578772880,11
0,1658,77936,3578772869,3578772887,18
0,1658,77937,3578772869,3578772889,20
0,1658,77938,3578772869,3578772889,20
0,1658,77939,3578772869,3578772889,20
0,1658,77940,3578772869,3578772889,20
0,1658,77941,3578772869,3578772890,21
0,1658,77942,3578772869,3578772890,21
0,1658,77943,3578772869,3578772892,23
0,1658,77944,3578772869,3578772892,23
0,1658,77945,3578772869,3578772892,23
0,1658,77946,3578772869,3578772892,23
0,1658,77947,3578772869,3578772892,23
0,1658,77948,3578772869,3578772893,24
0,1658,77949,3578772869,3578772893,24
0,1658,77950,3578772869,3578772894,25
0,1658,77951,3578772869,3578772894,25
0,1658,77952,3578772869,3578772894,25
0,1658,77953,3578772869,3578772895,26
0,1658,77954,3578772869,3578772896,27
0,1658,77955,3578772869,3578772896,27
0,1658,77956,3578772869,3578772897,28
0,1658,77957,3578772869,3578772897,28
0,1658,77958,3578772869,3578772897,28
0,1658,77959,3578772869,3578772897,28
0,1658,77960,3578772869,3578772898,29
0,1658,77961,3578772869,3578772898,29
0,1658,77962,3578772869,3578772898,29
0,1658,77963,3578772869,3578772898,29
0,1658,77964,3578772869,3578772898,29
0,1658,77965,3578772869,3578772899,30
0,1658,77966,3578772869,3578772900,31
0,1658,77967,3578772869,3578772900,31
0,1658,77968,3578772869,3578772901,32
0,1658,77969,3578772869,3578772901,32
0,1658,77970,3578772869,3578772902,33
0,1658,77971,3578772869,3578772902,33
0,1658,77972,3578772869,3578772904,35
0,1658,77973,3578772869,3578772904,35
0,1658,77974,3578772869,3578772904,35
0,1658,77975,3578772869,3578772905,36
0,1658,77976,3578772869,3578772905,36
0,1658,77977,3578772869,3578772905,36
0,1658,77978,3578772869,3578772906,37
0,1658,77979,3578772869,3578772906,37
0,1658,77980,3578772869,3578772907,38
0,1658,77981,3578772869,3578772907,38
0,1658,77982,3578772869,3578772908,39
0,1658,77983,3578772869,3578772908,39
0,1658,77984,3578772869,3578772908,39
0,1658,77985,3578772869,3578772908,39
0,1658,77986,3578772869,3578772910,41
0,1658,77987,3578772869,3578772910,41
0,1658,77988,3578772869,3578772910,41
0,1658,77989,3578772869,3578772910,41
0,1658,77990,3578772869,3578772910,41
0,1658,77991,3578772869,3578772911,42
0,1658,77992,3578772869,3578772911,42
0,1658,77993,3578772869,3578772911,42
0,1658,77994,3578772869,3578772913,44
0,1658,77995,3578772869,3578772913,44
0,1658,77996,3578772869,3578772914,45
0,1658,77997,3578772869,3578772914,45
0,1658,77998,3578772869,3578772914,45
0,1658,77999,3578772869,3578772914,45
0,1658,78000,3578772869,3578772915,46
0,1658,78001,3578772869,3578772915,46
0,1658,78002,3578772869,3578772915,46
0,1658,78003,3578772869,3578772916,47
0,1658,78004,3578772869,3578772917,48
0,1658,78005,3578772869,3578772917,48
0,1658,78006,3578772869,3578772918,49
0,1658,78007,3578772869,3578772918,49
0,1658,78008,3578772869,3578772918,49
0,1658,78009,3578772869,3578772918,49
0,1658,78010,3578772869,3578772919,50
0,1659,78011,3578772936,3578772936,0
0,1659,78012,3578772936,3578772936,0
0,1659,78013,3578772936,3578772936,0
0,1659,78014,3578772936,3578772936,0
0,1659,78015,3578772936,3578772936,0
0,1659,78016,3578772936,3578772936,0
0,1659,78017,3578772936,3578772936,0
0,1659,78018,3578772936,3578772936,0
0,1659,78019,3578772936,3578772936,0
0,1659,78020,3578772936,3578772936,0
0,1659,78021,3578772936,3578772936,0
0,1659,78022,3578772936,3578772936,0
0,1659,78023,3578772936,3578772936,0
0,1659,78024,3578772936,3578772936,0
0,1659,78025,3578772936,3578772936,0
0,1659,78026,3578772936,3578772936,0
0,1659,78027,3578772936,3578772936,0
0,1659,78028,3578772936,3578772936,0
0,1659,78029,3578772936,3578772936,0
0,1659,78030,3578772936,3578772936,0
0,1659,78031,3578772936,3578772936,0
0,1659,78032,3578772936,3578772936,0
0,1659,78033,3578772936,3578772936,0
0,1659,78034,3578772936,3578772936,0
0,1659,78035,3578772936,3578772936,0
0,1659,78036,3578772936,3578772936,0
0,1659,78037,3578772936,3578772936,0
0,1659,78038,3578772936,3578772936,0
0,1659,78039,3578772936,3578772936,0
0,1659,78040,3578772936,3578772936,0
0,1659,78041,3578772936,3578772936,0
0,1659,78042,3578772936,3578772936,0
0,1659,78043,3578772936,3578772936,0
0,1659,78044,3578772936,3578772936,0
0,1659,78045,3578772936,3578772936,0
0,1659,78046,3578772936,3578772936,0
0,1659,78047,3578772936,3578772936,0
0,1659,78048,3578772936,3578772936,0
0,1659,78049,3578772936,3578772936,0
0,1659,78050,3578772936,3578772936,0
0,1659,78051,3578772936,3578772936,0
0,1659,78052,3578772936,3578772936,0
0,1659,78053,3578772936,3578772936,0
0,1659,78054,3578772936,3578772936,0
0,1659,78055,3578772936,3578772936,0
0,1659,78056,3578772936,3578772936,0
0,1659,78057,3578772936,3578772936,0
0,1659,78058,3578772936,3578772936,0
0,1659,78059,3578772936,3578772938,2
0,1659,78060,3578772936,3578772939,3
0,1659,78061,3578772936,3578772939,3
0,1659,78062,3578772936,3578772939,3
0,1659,78063,3578772936,3578772939,3
0,1659,78064,3578772936,3578772940,4
0,1659,78065,3578772936,3578772940,4
0,1659,78066,3578772936,3578772940,4
0,1659,78067,3578772936,3578772941,5
0,1659,78068,3578772936,3578772942,6
0,1659,78069,3578772936,3578772943,7
0,1659,78070,3578772936,3578772944,8
0,1659,78071,3578772936,3578772945,9
0,1659,78072,3578772936,3578772945,9
0,1659,78073,3578772936,3578772946,10
0,1659,78074,3578772936,3578772946,10
0,1659,78075,3578772936,3578772947,11
0,1659,78076,3578772936,3578772948,12
0,1659,78077,3578772936,3578772948,12
0,1659,78078,3578772936,3578772948,12
0,1659,78079,3578772936,3578772948,12
0,1659,78080,3578772936,3578772949,13
0,1659,78081,3578772936,3578772951,15
0,1659,78082,3578772936,3578772952,16
0,1659,78083,3578772936,3578772952,16
0,1659,78084,3578772936,3578772952,16
0,1659,78085,3578772936,3578772953,17
0,1659,78086,3578772936,3578772953,17
0,1659,78087,3578772936,3578772954,18
0,1659,78088,3578772936,3578772954,18
0,1659,78089,3578772936,3578772956,20
0,1659,78090,3578772936,3578772957,21
0,1659,78091,3578772936,3578772958,22
0,1659,78092,3578772936,3578772958,22
0,1659,78093,3578772936,3578772959,23
0,1659,78094,3578772936,3578772959,23
0,1659,78095,3578772936,3578772960,24
0,1659,78096,3578772936,3578772961,25
0,1659,78097,3578772936,3578772961,25
0,1659,78098,3578772936,3578772962,26
0,1659,78099,3578772936,3578772962,26
0,1659,78100,3578772936,3578772962,26
0,1659,78101,3578772936,3578772963,27
0,1659,78102,3578772936,3578772963,27
0,1659,78103,3578772936,3578772964,28
0,1659,78104,3578772936,3578772964,28
0,1659,78105,3578772936,3578772966,30
0,1659,78106,3578772936,3578772967,31
0,1659,78107,3578772936,3578772967,31
0,1659,78108,3578772936,3578772968,32
0,1659,78109,3578772936,3578772969,33
0,1659,78110,3578772936,3578772969,33
0,1659,78111,3578772936,3578772970,34
0,1659,78112,3578772936,3578772971,35
0,1659,78113,3578772936,3578772972,36
0,1659,78114,3578772936,3578772972,36
0,1659,78115,3578772936,3578772972,36
0,1659,78116,3578772936,3578772973,37
0,1659,78117,3578772936,3578772973,37
0,1659,78118,3578772936,3578772973,37
0,1659,78119,3578772936,3578772974,38
0,1659,78120,3578772936,3578772974,38
0,1659,78121,3578772936,3578772974,38
0,1659,78122,3578772936,3578772977,41
0,1659,78123,3578772936,3578772977,41
0,1659,78124,3578772936,3578772978,42
0,1659,78125,3578772936,3578772978,42
0,1659,78126,3578772936,3578772978,42
0,1659,78127,3578772936,3578772978,42
0,1659,78128,3578772936,3578772979,43
0,1659,78129,3578772936,3578772979,43
0,1659,78130,3578772936,3578772980,44
0,1659,78131,3578772936,3578772981,45
0,1659,78132,3578772936,3578772984,48
0,1659,78133,3578772936,3578772985,49
0,1659,78134,3578772936,3578772985,49
0,1659,78135,3578772936,3578772986,50
0,1660,78136,3578773002,3578773002,0
0,1660,78137,3578773002,3578773002,0
0,1660,78138,3578773002,3578773002,0
0,1660,78139,3578773002,3578773002,0
0,1660,78140,3578773002,3578773002,0
0,1660,78141,3578773002,3578773002,0
0,1660,78142,3578773002,3578773002,0
0,1660,78143,3578773002,3578773002,0
0,1660,78144,3578773002,3578773002,0
0,1660,78145,3578773002,3578773002,0
0,1660,78146,3578773002,3578773002,0
0,1660,78147,3578773002,3578773002,0
0,1660,78148,3578773002,3578773002,0
0,1660,78149,3578773002,3578773002,0
0,1660,78150,3578773002,3578773002,0
0,1660,78151,3578773002,3578773002,0
0,1660,78152,3578773002,3578773002,0
0,1660,78153,3578773002,3578773002,0
0,1660,78154,3578773002,3578773002,0
0,1660,78155,3578773002,3578773002,0
0,1660,78156,3578773002,3578773002,0
0,1660,78157,3578773002,3578773002,0
0,1660,78158,3578773002,3578773002,0
0,1660,78159,3578773002,3578773002,0
0,1660,78160,3578773002,3578773002,0
0,1660,78161,3578773002,3578773003,1
0,1660,78162,3578773002,3578773004,2
0,1660,78163,3578773002,3578773005,3
0,1660,78164,3578773002,3578773005,3
0,1660,78165,3578773002,3578773006,4
0,1660,78166,3578773002,3578773006,4
0,1660,78167,3578773002,3578773006,4
0,1660,78168,3578773002,3578773008,6
0,1660,78169,3578773002,3578773008,6
0,1660,78170,3578773002,3578773009,7
0,1660,78171,3578773002,3578773010,8
0,1660,78172,3578773002,3578773014,12
0,1660,78173,3578773002,3578773014,12
0,1660,78174,3578773002,3578773014,12
0,1660,78175,3578773002,3578773015,13
0,1660,78176,3578773002,3578773015,13
0,1660,78177,3578773002,3578773015,13
0,1660,78178,3578773002,3578773016,14
0,1660,78179,3578773002,3578773016,14
0,1660,78180,3578773002,3578773016,14
0,1660,78181,3578773002,3578773017,15
0,1660,78182,3578773002,3578773018,16
0,1660,78183,3578773002,3578773018,16
0,1660,78184,3578773002,3578773019,17
0,1660,78185,3578773002,3578773019,17
0,1660,78186,3578773002,3578773021,19
0,1660,78187,3578773002,3578773021,19
0,1660,78188,3578773002,3578773022,20
0,1660,78189,3578773002,3578773022,20
0,1660,78190,3578773002,3578773023,21
0,1660,78191,3578773002,3578773024,22
0,1660,78192,3578773002,3578773024,22
0,1660,78193,3578773002,3578773025,23
0,1660,78194,3578773002,3578773025,23
0,1660,78195,3578773002,3578773027,25
0,1660,78196,3578773002,3578773027,25
0,1660,78197,3578773002,3578773027,25
0,1660,78198,3578773002,3578773028,26
0,1660,78199,3578773002,3578773029,27
0,1660,78200,3578773002,3578773030,28
0,1660,78201,3578773002,3578773030,28
0,1660,78202,3578773002,3578773031,29
0,1660,78203,3578773002,3578773031,29
0,1660,78204,3578773002,3578773031,29
0,1660,78205,3578773002,3578773033,31
0,1660,78206,3578773002,3578773035,33
0,1660,78207,3578773002,3578773035,33
0,1660,78208,3578773002,3578773036,34
0,1660,78209,3578773002,3578773036,34
0,1660,78210,3578773002,3578773036,34
0,1660,78211,3578773002,3578773037,35
0,1660,78212,3578773002,3578773038,36
0,1660,78213,3578773002,3578773038,36
0,1660,78214,3578773002,3578773039,37
0,1660,78215,3578773002,3578773039,37
0,1660,78216,3578773002,3578773039,37
0,1660,78217,3578773002,3578773039,37
0,1660,78218,3578773002,3578773040,38
0,1660,78219,3578773002,3578773041,39
0,1660,78220,3578773002,3578773041,39
0,1660,78221,3578773002,3578773042,40
0,1660,78222,3578773002,3578773043,41
0,1660,78223,3578773002,3578773043,41
0,1660,78224,3578773002,3578773043,41
0,1660,78225,3578773002,3578773043,41
0,1660,78226,3578773002,3578773043,41
0,1660,78227,3578773002,3578773043,41
0,1660,78228,3578773002,3578773044,42
0,1660,78229,3578773002,3578773047,45
0,1660,78230,3578773002,3578773048,46
0,1660,78231,3578773002,3578773048,46
0,1660,78232,3578773002,3578773049,47
0,1660,78233,3578773002,3578773049,47
0,1660,78234,3578773002,3578773049,47
0,1660,78235,3578773002,3578773050,48
0,1660,78236,3578773002,3578773052,50
0,1661,78237,3578773069,3578773069,0
0,1661,78238,3578773069,3578773069,0
0,1661,78239,3578773069,3578773069,0
0,1661,78240,3578773069,3578773069,0
0,1661,78241,3578773069,3578773069,0
0,1661,78242,3578773069,3578773069,0
0,1661,78243,3578773069,3578773069,0
0,1661,78244,3578773069,3578773069,0
0,1661,78245,3578773069,3578773069,0
0,1661,78246,3578773069,3578773069,0
0,1661,78247,3578773069,3578773069,0
0,1661,78248,3578773069,3578773069,0
0,1661,78249,3578773069,3578773069,0
0,1661,78250,3578773069,3578773069,0
0,1661,78251,3578773069,3578773069,0
0,1661,78252,3578773069,3578773069,0
0,1661,78253,3578773069,3578773069,0
0,1661,78254,3578773069,3578773069,0
0,1661,78255,3578773069,3578773069,0
0,1661,78256,3578773069,3578773069,0
0,1661,78257,3578773069,3578773069,0
0,1661,78258,3578773069,3578773069,0
0,1661,78259,3578773069,3578773069,0
0,1661,78260,3578773069,3578773070,1
0,1661,78261,3578773069,3578773077,8
0,1661,78262,3578773069,3578773080,11
0,1661,78263,3578773069,3578773090,21
0,1661,78264,3578773069,3578773090,21
0,1661,78265,3578773069,3578773090,21
0,1661,78266,3578773069,3578773090,21
0,1661,78267,3578773069,3578773092,23
0,1661,78268,3578773069,3578773092,23
0,1661,78269,3578773069,3578773093,24
0,1661,78270,3578773069,3578773093,24
0,1661,78271,3578773069,3578773093,24
0,1661,78272,3578773069,3578773094,25
0,1661,78273,3578773069,3578773094,25
0,1661,78274,3578773069,3578773094,25
0,1661,78275,3578773069,3578773094,25
0,1661,78276,3578773069,3578773095,26
0,1661,78277,3578773069,3578773096,27
0,1661,78278,3578773069,3578773097,28
0,1661,78279,3578773069,3578773097,28
0,1661,78280,3578773069,3578773097,28
0,1661,78281,3578773069,3578773097,28
0,1661,78282,3578773069,3578773098,29
0,1661,78283,3578773069,3578773098,29
0,1661,78284,3578773069,3578773098,29
0,1661,78285,3578773069,3578773098,29
0,1661,78286,3578773069,3578773099,30
0,1661,78287,3578773069,3578773099,30
0,1661,78288,3578773069,3578773099,30
0,1661,78289,3578773069,3578773100,31
0,1661,78290,3578773069,3578773101,32
0,1661,78291,3578773069,3578773101,32
0,1661,78292,3578773069,3578773101,32
0,1661,78293,3578773069,3578773101,32
0,1661,78294,3578773069,3578773102,33
0,1661,78295,3578773069,3578773104,35
0,1661,78296,3578773069,3578773104,35
0,1661,78297,3578773069,3578773104,35
0,1661,78298,3578773069,3578773105,36
0,1661,78299,3578773069,3578773105,36
0,1661,78300,3578773069,3578773105,36
0,1661,78301,3578773069,3578773105,36
0,1661,78302,3578773069,3578773105,36
0,1661,78303,3578773069,3578773106,37
0,1661,78304,3578773069,3578773107,38
0,1661,78305,3578773069,3578773107,38
0,1661,78306,3578773069,3578773108,39
0,1661,78307,3578773069,3578773108,39
0,1661,78308,3578773069,3578773109,40
0,1661,78309,3578773069,3578773109,40
0,1661,78310,3578773069,3578773110,41
0,1661,78311,3578773069,3578773110,41
0,1661,78312,3578773069,3578773110,41
0,1661,78313,3578773069,3578773110,41
0,1661,78314,3578773069,3578773111,42
0,1661,78315,3578773069,3578773111,42
0,1661,78316,3578773069,3578773112,43
0,1661,78317,3578773069,3578773112,43
0,1661,78318,3578773069,3578773112,43
0,1661,78319,3578773069,3578773114,45
0,1661,78320,3578773069,3578773114,45
0,1661,78321,3578773069,3578773114,45
0,1661,78322,3578773069,3578773114,45
0,1661,78323,3578773069,3578773115,46
0,1661,78324,3578773069,3578773115,46
0,1661,78325,3578773069,3578773116,47
0,1661,78326,3578773069,3578773116,47
0,1661,78327,3578773069,3578773116,47
0,1661,78328,3578773069,3578773116,47
0,1661,78329,3578773069,3578773117,48
0,1661,78330,3578773069,3578773117,48
0,1661,78331,3578773069,3578773118,49
0,1661,78332,3578773069,3578773119,50
0,1662,78333,3578773135,3578773135,0
0,1662,78334,3578773135,3578773135,0
0,1662,78335,3578773135,3578773135,0
0,1662,78336,3578773135,3578773135,0
0,1662,78337,3578773135,3578773135,0
0,1662,78338,3578773135,3578773135,0
0,1662,78339,3578773135,3578773135,0
0,1662,78340,3578773135,3578773135,0
0,1662,78341,3578773135,3578773135,0
0,1662,78342,3578773135,3578773135,0
0,1662,78343,3578773135,3578773135,0
0,1662,78344,3578773135,3578773135,0
0,1662,78345,3578773135,3578773135,0
0,1662,78346,3578773135,3578773135,0
0,1662,78347,3578773135,3578773135,0
0,1662,78348,3578773135,3578773135,0
0,1662,78349,3578773135,3578773135,0
0,1662,78350,3578773135,3578773135,0
0,1662,78351,3578773135,3578773135,0
0,1662,78352,3578773135,3578773135,0
0,1662,78353,3578773135,3578773135,0
0,1662,78354,3578773135,3578773135,0
0,1662,78355,3578773135,3578773135,0
0,1662,78356,3578773135,3578773135,0
0,1662,78357,3578773135,3578773135,0
0,1662,78358,3578773135,3578773135,0
0,1662,78359,3578773135,3578773135,0
0,1662,78360,3578773135,3578773135,0
0,1662,78361,3578773135,3578773135,0
0,1662,78362,3578773135,3578773135,0
0,1662,78363,3578773135,3578773135,0
0,1662,78364,3578773135,3578773135,0
0,1662,78365,3578773135,3578773135,0
0,1662,78366,3578773135,3578773136,1
0,1662,78367,3578773135,3578773136,1
0,1662,78368,3578773135,3578773136,1
0,1662,78369,3578773135,3578773136,1
0,1662,78370,3578773135,3578773136,1
0,1662,78371,3578773135,3578773136,1
0,1662,78372,3578773135,3578773136,1
0,1662,78373,3578773135,3578773136,1
0,1662,78374,3578773135,3578773136,1
0,1662,78375,3578773135,3578773138,3
0,1662,78376,3578773135,3578773139,4
0,1662,78377,3578773135,3578773140,5
0,1662,78378,3578773135,3578773140,5
0,1662,78379,3578773135,3578773140,5
0,1662,78380,3578773135,3578773141,6
0,1662,78381,3578773135,3578773141,6
0,1662,78382,3578773135,3578773143,8
0,1662,78383,3578773135,3578773144,9
0,1662,78384,3578773135,3578773146,11
0,1662,78385,3578773135,3578773146,11
0,1662,78386,3578773135,3578773147,12
0,1662,78387,3578773135,3578773147,12
0,1662,78388,3578773135,3578773147,12
0,1662,78389,3578773135,3578773148,13
0,1662,78390,3578773135,3578773148,13
0,1662,78391,3578773135,3578773148,13
0,1662,78392,3578773135,3578773149,14
0,1662,78393,3578773135,3578773149,14
0,1662,78394,3578773135,3578773150,15
0,1662,78395,3578773135,3578773151,16
0,1662,78396,3578773135,3578773151,16
0,1662,78397,3578773135,3578773152,17
0,1662,78398,3578773135,3578773153,18
0,1662,78399,3578773135,3578773153,18
0,1662,78400,3578773135,3578773153,18
0,1662,78401,3578773135,3578773153,18
0,1662,78402,3578773135,3578773154,19
0,1662,78403,3578773135,3578773155,20
0,1662,78404,3578773135,3578773156,21
0,1662,78405,3578773135,3578773157,22
0,1662,78406,3578773135,3578773157,22
0,1662,78407,3578773135,3578773157,22
0,1662,78408,3578773135,3578773158,23
0,1662,78409,3578773135,3578773158,23
0,1662,78410,3578773135,3578773158,23
0,1662,78411,3578773135,3578773159,24
0,1662,78412,3578773135,3578773159,24
0,1662,78413,3578773135,3578773160,25
0,1662,78414,3578773135,3578773161,26
0,1662,78415,3578773135,3578773161,26
0,1662,78416,3578773135,3578773161,26
0,1662,78417,3578773135,3578773161,26
0,1662,78418,3578773135,3578773162,27
0,1662,78419,3578773135,3578773162,27
0,1662,78420,3578773135,3578773163,28
0,1662,78421,3578773135,3578773163,28
0,1662,78422,3578773135,3578773163,28
0,1662,78423,3578773135,3578773163,28
0,1662,78424,3578773135,3578773166,31
0,1662,78425,3578773135,3578773167,32
0,1662,78426,3578773135,3578773169,34
0,1662,78427,3578773135,3578773170,35
0,1662,78428,3578773135,3578773170,35
0,1662,78429,3578773135,3578773171,36
0,1662,78430,3578773135,3578773171,36
0,1662,78431,3578773135,3578773172,37
0,1662,78432,3578773135,3578773172,37
0,1662,78433,3578773135,3578773172,37
0,1662,78434,3578773135,3578773173,38
0,1662,78435,3578773135,3578773173,38
0,1662,78436,3578773135,3578773173,38
0,1662,78437,3578773135,3578773174,39
0,1662,78438,3578773135,3578773174,39
0,1662,78439,3578773135,3578773175,40
0,1662,78440,3578773135,3578773176,41
0,1662,78441,3578773135,3578773177,42
0,1662,78442,3578773135,3578773178,43
0,1662,78443,3578773135,3578773178,43
0,1662,78444,3578773135,3578773178,43
0,1662,78445,3578773135,3578773179,44
0,1662,78446,3578773135,3578773179,44
0,1662,78447,3578773135,3578773180,45
0,1662,78448,3578773135,3578773180,45
0,1662,78449,3578773135,3578773181,46
0,1662,78450,3578773135,3578773183,48
0,1662,78451,3578773135,3578773184,49
0,1662,78452,3578773135,3578773184,49
0,1662,78453,3578773135,3578773185,50
0,1663,78454,3578773200,3578773200,0
0,1663,78455,3578773200,3578773200,0
0,1663,78456,3578773200,3578773200,0
0,1663,78457,3578773200,3578773200,0
0,1663,78458,3578773200,3578773200,0
0,1663,78459,3578773200,3578773200,0
0,1663,78460,3578773200,3578773200,0
0,1663,78461,3578773200,3578773200,0
0,1663,78462,3578773200,3578773200,0
0,1663,78463,3578773200,3578773200,0
0,1663,78464,3578773200,3578773200,0
0,1663,78465,3578773200,3578773200,0
0,1663,78466,3578773200,3578773200,0
0,1663,78467,3578773200,3578773200,0
0,1663,78468,3578773200,3578773200,0
0,1663,78469,3578773200,3578773200,0
0,1663,78470,3578773200,3578773200,0
0,1663,78471,3578773200,3578773200,0
0,1663,78472,3578773200,3578773200,0
0,1663,78473,3578773200,3578773200,0
0,1663,78474,3578773200,3578773200,0
0,1663,78475,3578773200,3578773200,0
0,1663,78476,3578773200,3578773200,0
0,1663,78477,3578773200,3578773200,0
0,1663,78478,3578773200,3578773201,1
0,1663,78479,3578773200,3578773202,2
0,1663,78480,3578773200,3578773204,4
0,1663,78481,3578773200,3578773204,4
0,1663,78482,3578773200,3578773206,6
0,1663,78483,3578773200,3578773206,6
0,1663,78484,3578773200,3578773207,7
0,1663,78485,3578773200,3578773207,7
0,1663,78486,3578773200,3578773208,8
0,1663,78487,3578773200,3578773208,8
0,1663,78488,3578773200,3578773209,9
0,1663,78489,3578773200,3578773209,9
0,1663,78490,3578773200,3578773210,10
0,1663,78491,3578773200,3578773211,11
0,1663,78492,3578773200,3578773214,14
0,1663,78493,3578773200,3578773214,14
0,1663,78494,3578773200,3578773214,14
0,1663,78495,3578773200,3578773214,14
0,1663,78496,3578773200,3578773214,14
0,1663,78497,3578773200,3578773216,16
0,1663,78498,3578773200,3578773216,16
0,1663,78499,3578773200,3578773216,16
0,1663,78500,3578773200,3578773217,17
0,1663,78501,3578773200,3578773218,18
0,1663,78502,3578773200,3578773218,18
0,1663,78503,3578773200,3578773219,19
0,1663,78504,3578773200,3578773219,19
0,1663,78505,3578773200,3578773219,19
0,1663,78506,3578773200,3578773221,21
0,1663,78507,3578773200,3578773221,21
0,1663,78508,3578773200,3578773222,22
0,1663,78509,3578773200,3578773222,22
0,1663,78510,3578773200,3578773222,22
0,1663,78511,3578773200,3578773224,24
0,1663,78512,3578773200,3578773224,24
0,1663,78513,3578773200,3578773224,24
0,1663,78514,3578773200,3578773225,25
0,1663,78515,3578773200,3578773225,25
0,1663,78516,3578773200,3578773226,26
0,1663,78517,3578773200,3578773227,27
0,1663,78518,3578773200,3578773227,27
0,1663,78519,3578773200,3578773228,28
0,1663,78520,3578773200,3578773228,28
0,1663,78521,3578773200,3578773229,29
0,1663,78522,3578773200,3578773229,29
0,1663,78523,3578773200,3578773230,30
0,1663,78524,3578773200,3578773230,30
0,1663,78525,3578773200,3578773231,31
0,1663,78526,3578773200,3578773231,31
0,1663,78527,3578773200,3578773232,32
0,1663,78528,3578773200,3578773234,34
0,1663,78529,3578773200,3578773235,35
0,1663,78530,3578773200,3578773236,36
0,1663,78531,3578773200,3578773236,36
0,1663,78532,3578773200,3578773236,36
0,1663,78533,3578773200,3578773238,38
0,1663,78534,3578773200,3578773238,38
0,1663,78535,3578773200,3578773238,38
0,1663,78536,3578773200,3578773239,39
0,1663,78537,3578773200,3578773239,39
0,1663,78538,3578773200,3578773239,39
0,1663,78539,3578773200,3578773240,40
0,1663,78540,3578773200,3578773240,40
0,1663,78541,3578773200,3578773240,40
0,1663,78542,3578773200,3578773242,42
0,1663,78543,3578773200,3578773242,42
0,1663,78544,3578773200,3578773243,43
0,1663,78545,3578773200,3578773243,43
0,1663,78546,3578773200,3578773243,43
0,1663,78547,3578773200,3578773243,43
0,1663,78548,3578773200,3578773245,45
0,1663,78549,3578773200,3578773245,45
0,1663,78550,3578773200,3578773247,47
0,1663,78551,3578773200,3578773248,48
0,1663,78552,3578773200,3578773248,48
0,1663,78553,3578773200,3578773249,49
0,1663,78554,3578773200,3578773249,49
0,1663,78555,3578773200,3578773250,50
0,1664,78556,3578773266,3578773266,0
0,1664,78557,3578773266,3578773266,0
0,1664,78558,3578773266,3578773266,0
0,1664,78559,3578773266,3578773266,0
0,1664,78560,3578773266,3578773266,0
0,1664,78561,3578773266,3578773266,0
0,1664,78562,3578773266,3578773266,0
0,1664,78563,3578773266,3578773266,0
0,1664,78564,3578773266,3578773267,1
0,1664,78565,3578773266,3578773267,1
0,1664,78566,3578773266,3578773267,1
0,1664,78567,3578773266,3578773267,1
0,1664,78568,3578773266,3578773267,1
0,1664,78569,3578773266,3578773267,1
0,1664,78570,3578773266,3578773267,1
0,1664,78571,3578773266,3578773267,1
0,1664,78572,3578773266,3578773267,1
0,1664,78573,3578773266,3578773267,1
0,1664,78574,3578773266,3578773267,1
0,1664,78575,3578773266,3578773267,1
0,1664,78576,3578773266,3578773267,1
0,1664,78577,3578773266,3578773267,1
0,1664,78578,3578773266,3578773267,1
0,1664,78579,3578773266,3578773267,1
0,1664,78580,3578773266,3578773268,2
0,1664,78581,3578773266,3578773268,2
0,1664,78582,3578773266,3578773270,4
0,1664,78583,3578773266,3578773280,14
0,1664,78584,3578773266,3578773285,19
0,1664,78585,3578773266,3578773287,21
0,1664,78586,3578773266,3578773289,23
0,1664,78587,3578773266,3578773289,23
0,1664,78588,3578773266,3578773289,23
0,1664,78589,3578773266,3578773290,24
0,1664,78590,3578773266,3578773290,24
0,1664,78591,3578773266,3578773290,24
0,1664,78592,3578773266,3578773292,26
0,1664,78593,3578773266,3578773292,26
0,1664,78594,3578773266,3578773293,27
0,1664,78595,3578773266,3578773293,27
0,1664,78596,3578773266,3578773294,28
0,1664,78597,3578773266,3578773294,28
0,1664,78598,3578773266,3578773295,29
0,1664,78599,3578773266,3578773296,30
0,1664,78600,3578773266,3578773297,31
0,1664,78601,3578773266,3578773297,31
0,1664,78602,3578773266,3578773298,32
0,1664,78603,3578773266,3578773298,32
0,1664,78604,3578773266,3578773298,32
0,1664,78605,3578773266,3578773298,32
0,1664,78606,3578773266,3578773298,32
0,1664,78607,3578773266,3578773298,32
0,1664,78608,3578773266,3578773299,33
0,1664,78609,3578773266,3578773299,33
0,1664,78610,3578773266,3578773299,33
0,1664,78611,3578773266,3578773299,33
0,1664,78612,3578773266,3578773300,34
0,1664,78613,3578773266,3578773300,34
0,1664,78614,3578773266,3578773301,35
0,1664,78615,3578773266,3578773301,35
0,1664,78616,3578773266,3578773301,35
0,1664,78617,3578773266,3578773301,35
0,1664,78618,3578773266,3578773304,38
0,1664,78619,3578773266,3578773304,38
0,1664,78620,3578773266,3578773304,38
0,1664,78621,3578773266,3578773304,38
0,1664,78622,3578773266,3578773304,38
0,1664,78623,3578773266,3578773305,39
0,1664,78624,3578773266,3578773305,39
0,1664,78625,3578773266,3578773305,39
0,1664,78626,3578773266,3578773305,39
0,1664,78627,3578773266,3578773306,40
0,1664,78628,3578773266,3578773307,41
0,1664,78629,3578773266,3578773307,41
0,1664,78630,3578773266,3578773307,41
0,1664,78631,3578773266,3578773308,42
0,1664,78632,3578773266,3578773308,42
0,1664,78633,3578773266,3578773308,42
0,1664,78634,3578773266,3578773308,42
0,1664,78635,3578773266,3578773309,43
0,1664,78636,3578773266,3578773310,44
0,1664,78637,3578773266,3578773310,44
0,1664,78638,3578773266,3578773310,44
0,1664,78639,3578773266,3578773310,44
0,1664,78640,3578773266,3578773311,45
0,1664,78641,3578773266,3578773311,45
0,1664,78642,3578773266,3578773311,45
0,1664,78643,3578773266,3578773312,46
0,1664,78644,3578773266,3578773312,46
0,1664,78645,3578773266,3578773314,48
0,1664,78646,3578773266,3578773314,48
0,1664,78647,3578773266,3578773314,48
0,1664,78648,3578773266,3578773315,49
0,1664,78649,3578773266,3578773315,49
0,1664,78650,3578773266,3578773315,49
0,1664,78651,3578773266,3578773316,50
0,1665,78652,3578773334,3578773334,0
0,1665,78653,3578773334,3578773334,0
0,1665,78654,3578773334,3578773334,0
0,1665,78655,3578773334,3578773334,0
0,1665,78656,3578773334,3578773334,0
0,1665,78657,3578773334,3578773334,0
0,1665,78658,3578773334,3578773334,0
0,1665,78659,3578773334,3578773334,0
0,1665,78660,3578773334,3578773334,0
0,1665,78661,3578773334,3578773334,0
0,1665,78662,3578773334,3578773334,0
0,1665,78663,3578773334,3578773334,0
0,1665,78664,3578773334,3578773334,0
0,1665,78665,3578773334,3578773334,0
0,1665,78666,3578773334,3578773334,0
0,1665,78667,3578773334,3578773334,0
0,1665,78668,3578773334,3578773334,0
0,1665,78669,3578773334,3578773334,0
0,1665,78670,3578773334,3578773334,0
0,1665,78671,3578773334,3578773334,0
0,1665,78672,3578773334,3578773334,0
0,1665,78673,3578773334,3578773334,0
0,1665,78674,3578773334,3578773334,0
0,1665,78675,3578773334,3578773334,0
0,1665,78676,3578773334,3578773334,0
0,1665,78677,3578773334,3578773334,0
0,1665,78678,3578773334,3578773334,0
0,1665,78679,3578773334,3578773334,0
0,1665,78680,3578773334,3578773334,0
0,1665,78681,3578773334,3578773334,0
0,1665,78682,3578773334,3578773334,0
0,1665,78683,3578773334,3578773334,0
0,1665,78684,3578773334,3578773334,0
0,1665,78685,3578773334,3578773334,0
0,1665,78686,3578773334,3578773334,0
0,1665,78687,3578773334,3578773334,0
0,1665,78688,3578773334,3578773334,0
0,1665,78689,3578773334,3578773334,0
0,1665,78690,3578773334,3578773334,0
0,1665,78691,3578773334,3578773334,0
0,1665,78692,3578773334,3578773334,0
0,1665,78693,3578773334,3578773334,0
0,1665,78694,3578773334,3578773334,0
0,1665,78695,3578773334,3578773334,0
0,1665,78696,3578773334,3578773334,0
0,1665,78697,3578773334,3578773334,0
0,1665,78698,3578773334,3578773335,1
0,1665,78699,3578773334,3578773335,1
0,1665,78700,3578773334,3578773335,1
0,1665,78701,3578773334,3578773335,1
0,1665,78702,3578773334,3578773335,1
0,1665,78703,3578773334,3578773336,2
0,1665,78704,3578773334,3578773337,3
0,1665,78705,3578773334,3578773337,3
0,1665,78706,3578773334,3578773338,4
0,1665,78707,3578773334,3578773339,5
0,1665,78708,3578773334,3578773339,5
0,1665,78709,3578773334,3578773339,5
0,1665,78710,3578773334,3578773340,6
0,1665,78711,3578773334,3578773340,6
0,1665,78712,3578773334,3578773341,7
0,1665,78713,3578773334,3578773341,7
0,1665,78714,3578773334,3578773343,9
0,1665,78715,3578773334,3578773343,9
0,1665,78716,3578773334,3578773343,9
0,1665,78717,3578773334,3578773343,9
0,1665,78718,3578773334,3578773344,10
0,1665,78719,3578773334,3578773344,10
0,1665,78720,3578773334,3578773346,12
0,1665,78721,3578773334,3578773346,12
0,1665,78722,3578773334,3578773346,12
0,1665,78723,3578773334,3578773347,13
0,1665,78724,3578773334,3578773348,14
0,1665,78725,3578773334,3578773348,14
0,1665,78726,3578773334,3578773348,14
0,1665,78727,3578773334,3578773349,15
0,1665,78728,3578773334,3578773349,15
0,1665,78729,3578773334,3578773350,16
0,1665,78730,3578773334,3578773351,17
0,1665,78731,3578773334,3578773352,18
0,1665,78732,3578773334,3578773353,19
0,1665,78733,3578773334,3578773353,19
0,1665,78734,3578773334,3578773353,19
0,1665,78735,3578773334,3578773353,19
0,1665,78736,3578773334,3578773354,20
0,1665,78737,3578773334,3578773355,21
0,1665,78738,3578773334,3578773356,22
0,1665,78739,3578773334,3578773356,22
0,1665,78740,3578773334,3578773357,23
0,1665,78741,3578773334,3578773357,23
0,1665,78742,3578773334,3578773358,24
0,1665,78743,3578773334,3578773358,24
0,1665,78744,3578773334,3578773359,25
0,1665,78745,3578773334,3578773359,25
0,1665,78746,3578773334,3578773360,26
0,1665,78747,3578773334,3578773360,26
0,1665,78748,3578773334,3578773361,27
0,1665,78749,3578773334,3578773361,27
0,1665,78750,3578773334,3578773361,27
0,1665,78751,3578773334,3578773362,28
0,1665,78752,3578773334,3578773362,28
0,1665,78753,3578773334,3578773362,28
0,1665,78754,3578773334,3578773362,28
0,1665,78755,3578773334,3578773363,29
0,1665,78756,3578773334,3578773363,29
0,1665,78757,3578773334,3578773364,30
0,1665,78758,3578773334,3578773365,31
0,1665,78759,3578773334,3578773366,32
0,1665,78760,3578773334,3578773368,34
0,1665,78761,3578773334,3578773369,35
0,1665,78762,3578773334,3578773369,35
0,1665,78763,3578773334,3578773369,35
0,1665,78764,3578773334,3578773372,38
0,1665,78765,3578773334,3578773372,38
0,1665,78766,3578773334,3578773372,38
0,1665,78767,3578773334,3578773372,38
0,1665,78768,3578773334,3578773373,39
0,1665,78769,3578773334,3578773373,39
0,1665,78770,3578773334,3578773374,40
0,1665,78771,3578773334,3578773375,41
0,1665,78772,3578773334,3578773375,41
0,1665,78773,3578773334,3578773377,43
0,1665,78774,3578773334,3578773378,44
0,1665,78775,3578773334,3578773379,45
0,1665,78776,3578773334,3578773379,45
0,1665,78777,3578773334,3578773379,45
0,1665,78778,3578773334,3578773380,46
0,1665,78779,3578773334,3578773381,47
0,1665,78780,3578773334,3578773381,47
0,1665,78781,3578773334,3578773381,47
0,1665,78782,3578773334,3578773384,50
0,1666,78783,3578773400,3578773400,0
0,1666,78784,3578773400,3578773400,0
0,1666,78785,3578773400,3578773400,0
0,1666,78786,3578773400,3578773400,0
0,1666,78787,3578773400,3578773400,0
0,1666,78788,3578773400,3578773400,0
0,1666,78789,3578773400,3578773400,0
0,1666,78790,3578773400,3578773400,0
0,1666,78791,3578773400,3578773400,0
0,1666,78792,3578773400,3578773400,0
0,1666,78793,3578773400,3578773400,0
0,1666,78794,3578773400,3578773400,0
0,1666,78795,3578773400,3578773400,0
0,1666,78796,3578773400,3578773400,0
0,1666,78797,3578773400,3578773400,0
0,1666,78798,3578773400,3578773400,0
0,1666,78799,3578773400,3578773400,0
0,1666,78800,3578773400,3578773400,0
0,1666,78801,3578773400,3578773400,0
0,1666,78802,3578773400,3578773400,0
0,1666,78803,3578773400,3578773400,0
0,1666,78804,3578773400,3578773400,0
0,1666,78805,3578773400,3578773400,0
0,1666,78806,3578773400,3578773400,0
0,1666,78807,3578773400,3578773400,0
0,1666,78808,3578773400,3578773400,0
0,1666,78809,3578773400,3578773400,0
0,1666,78810,3578773400,3578773400,0
0,1666,78811,3578773400,3578773401,1
0,1666,78812,3578773400,3578773404,4
0,1666,78813,3578773400,3578773405,5
0,1666,78814,3578773400,3578773405,5
0,1666,78815,3578773400,3578773406,6
0,1666,78816,3578773400,3578773406,6
0,1666,78817,3578773400,3578773408,8
0,1666,78818,3578773400,3578773408,8
0,1666,78819,3578773400,3578773409,9
0,1666,78820,3578773400,3578773409,9
0,1666,78821,3578773400,3578773411,11
0,1666,78822,3578773400,3578773412,12
0,1666,78823,3578773400,3578773413,13
0,1666,78824,3578773400,3578773413,13
0,1666,78825,3578773400,3578773414,14
0,1666,78826,3578773400,3578773415,15
0,1666,78827,3578773400,3578773416,16
0,1666,78828,3578773400,3578773416,16
0,1666,78829,3578773400,3578773416,16
0,1666,78830,3578773400,3578773417,17
0,1666,78831,3578773400,3578773418,18
0,1666,78832,3578773400,3578773419,19
0,1666,78833,3578773400,3578773420,20
0,1666,78834,3578773400,3578773420,20
0,1666,78835,3578773400,3578773420,20
0,1666,78836,3578773400,3578773420,20
0,1666,78837,3578773400,3578773421,21
0,1666,78838,3578773400,3578773421,21
0,1666,78839,3578773400,3578773422,22
0,1666,78840,3578773400,3578773422,22
0,1666,78841,3578773400,3578773422,22
0,1666,78842,3578773400,3578773422,22
0,1666,78843,3578773400,3578773422,22
0,1666,78844,3578773400,3578773424,24
0,1666,78845,3578773400,3578773425,25
0,1666,78846,3578773400,3578773425,25
0,1666,78847,3578773400,3578773426,26
0,1666,78848,3578773400,3578773427,27
0,1666,78849,3578773400,3578773427,27
0,1666,78850,3578773400,3578773428,28
0,1666,78851,3578773400,3578773428,28
0,1666,78852,3578773400,3578773429,29
0,1666,78853,3578773400,3578773429,29
0,1666,78854,3578773400,3578773430,30
0,1666,78855,3578773400,3578773431,31
0,1666,78856,3578773400,3578773431,31
0,1666,78857,3578773400,3578773432,32
0,1666,78858,3578773400,3578773432,32
0,1666,78859,3578773400,3578773432,32
0,1666,78860,3578773400,3578773433,33
0,1666,78861,3578773400,3578773434,34
0,1666,78862,3578773400,3578773434,34
0,1666,78863,3578773400,3578773435,35
0,1666,78864,3578773400,3578773435,35
0,1666,78865,3578773400,3578773435,35
0,1666,78866,3578773400,3578773437,37
0,1666,78867,3578773400,3578773437,37
0,1666,78868,3578773400,3578773438,38
0,1666,78869,3578773400,3578773438,38
0,1666,78870,3578773400,3578773439,39
0,1666,78871,3578773400,3578773439,39
0,1666,78872,3578773400,3578773439,39
0,1666,78873,3578773400,3578773440,40
0,1666,78874,3578773400,3578773440,40
0,1666,78875,3578773400,3578773440,40
0,1666,78876,3578773400,3578773442,42
0,1666,78877,3578773400,3578773443,43
0,1666,78878,3578773400,3578773443,43
0,1666,78879,3578773400,3578773444,44
0,1666,78880,3578773400,3578773444,44
0,1666,78881,3578773400,3578773445,45
0,1666,78882,3578773400,3578773447,47
0,1666,78883,3578773400,3578773447,47
0,1666,78884,3578773400,3578773448,48
0,1666,78885,3578773400,3578773448,48
0,1666,78886,3578773400,3578773449,49
0,1666,78887,3578773400,3578773450,50
0,1667,78888,3578773466,3578773466,0
0,1667,78889,3578773466,3578773466,0
0,1667,78890,3578773466,3578773466,0
0,1667,78891,3578773466,3578773466,0
0,1667,78892,3578773466,3578773466,0
0,1667,78893,3578773466,3578773466,0
0,1667,78894,3578773466,3578773466,0
0,1667,78895,3578773466,3578773466,0
0,1667,78896,3578773466,3578773466,0
0,1667,78897,3578773466,3578773466,0
0,1667,78898,3578773466,3578773466,0
0,1667,78899,3578773466,3578773466,0
0,1667,78900,3578773466,3578773466,0
0,1667,78901,3578773466,3578773466,0
0,1667,78902,3578773466,3578773466,0
0,1667,78903,3578773466,3578773467,1
0,1667,78904,3578773466,3578773467,1
0,1667,78905,3578773466,3578773467,1
0,1667,78906,3578773466,3578773467,1
0,1667,78907,3578773466,3578773467,1
0,1667,78908,3578773466,3578773467,1
0,1667,78909,3578773466,3578773468,2
0,1667,78910,3578773466,3578773468,2
0,1667,78911,3578773466,3578773469,3
0,1667,78912,3578773466,3578773470,4
0,1667,78913,3578773466,3578773478,12
0,1667,78914,3578773466,3578773485,19
0,1667,78915,3578773466,3578773487,21
0,1667,78916,3578773466,3578773488,22
0,1667,78917,3578773466,3578773489,23
0,1667,78918,3578773466,3578773490,24
0,1667,78919,3578773466,3578773490,24
0,1667,78920,3578773466,3578773490,24
0,1667,78921,3578773466,3578773492,26
0,1667,78922,3578773466,3578773492,26
0,1667,78923,3578773466,3578773493,27
0,1667,78924,3578773466,3578773493,27
0,1667,78925,3578773466,3578773494,28
0,1667,78926,3578773466,3578773494,28
0,1667,78927,3578773466,3578773495,29
0,1667,78928,3578773466,3578773496,30
0,1667,78929,3578773466,3578773497,31
0,1667,78930,3578773466,3578773498,32
0,1667,78931,3578773466,3578773498,32
0,1667,78932,3578773466,3578773498,32
0,1667,78933,3578773466,3578773498,32
0,1667,78934,3578773466,3578773498,32
0,1667,78935,3578773466,3578773498,32
0,1667,78936,3578773466,3578773499,33
0,1667,78937,3578773466,3578773499,33
0,1667,78938,3578773466,3578773499,33
0,1667,78939,3578773466,3578773500,34
0,1667,78940,3578773466,3578773501,35
0,1667,78941,3578773466,3578773501,35
0,1667,78942,3578773466,3578773501,35
0,1667,78943,3578773466,3578773501,35
0,1667,78944,3578773466,3578773502,36
0,1667,78945,3578773466,3578773504,38
0,1667,78946,3578773466,3578773504,38
0,1667,78947,3578773466,3578773504,38
0,1667,78948,3578773466,3578773504,38
0,1667,78949,3578773466,3578773504,38
0,1667,78950,3578773466,3578773505,39
0,1667,78951,3578773466,3578773505,39
0,1667,78952,3578773466,3578773506,40
0,1667,78953,3578773466,3578773506,40
0,1667,78954,3578773466,3578773506,40
0,1667,78955,3578773466,3578773507,41
0,1667,78956,3578773466,3578773508,42
0,1667,78957,3578773466,3578773508,42
0,1667,78958,3578773466,3578773508,42
0,1667,78959,3578773466,3578773508,42
0,1667,78960,3578773466,3578773508,42
0,1667,78961,3578773466,3578773508,42
0,1667,78962,3578773466,3578773509,43
0,1667,78963,3578773466,3578773510,44
0,1667,78964,3578773466,3578773510,44
0,1667,78965,3578773466,3578773510,44
0,1667,78966,3578773466,3578773511,45
0,1667,78967,3578773466,3578773511,45
0,1667,78968,3578773466,3578773511,45
0,1667,78969,3578773466,3578773511,45
0,1667,78970,3578773466,3578773511,45
0,1667,78971,3578773466,3578773511,45
0,1667,78972,3578773466,3578773512,46
0,1667,78973,3578773466,3578773514,48
0,1667,78974,3578773466,3578773515,49
0,1667,78975,3578773466,3578773515,49
0,1667,78976,3578773466,3578773515,49
0,1667,78977,3578773466,3578773515,49
0,1667,78978,3578773466,3578773516,50
0,1668,78979,3578773531,3578773531,0
0,1668,78980,3578773531,3578773531,0
0,1668,78981,3578773531,3578773531,0
0,1668,78982,3578773531,3578773531,0
0,1668,78983,3578773531,3578773531,0
0,1668,78984,3578773531,3578773531,0
0,1668,78985,3578773531,3578773531,0
0,1668,78986,3578773531,3578773531,0
0,1668,78987,3578773531,3578773531,0
0,1668,78988,3578773531,3578773531,0
0,1668,78989,3578773531,3578773531,0
0,1668,78990,3578773531,3578773531,0
0,1668,78991,3578773531,3578773531,0
0,1668,78992,3578773531,3578773531,0
0,1668,78993,3578773531,3578773531,0
0,1668,78994,3578773531,3578773531,0
0,1668,78995,3578773531,3578773531,0
0,1668,78996,3578773531,3578773531,0
0,1668,78997,3578773531,3578773531,0
0,1668,78998,3578773531,3578773531,0
0,1668,78999,3578773531,3578773531,0
0,1668,79000,3578773531,3578773531,0
0,1668,79001,3578773531,3578773531,0
0,1668,79002,3578773531,3578773531,0
0,1668,79003,3578773531,3578773531,0
0,1668,79004,3578773531,3578773531,0
0,1668,79005,3578773531,3578773531,0
0,1668,79006,3578773531,3578773531,0
0,1668,79007,3578773531,3578773531,0
0,1668,79008,3578773531,3578773531,0
0,1668,79009,3578773531,3578773531,0
0,1668,79010,3578773531,3578773531,0
0,1668,79011,3578773531,3578773531,0
0,1668,79012,3578773531,3578773531,0
0,1668,79013,3578773531,3578773531,0
0,1668,79014,3578773531,3578773531,0
0,1668,79015,3578773531,3578773531,0
0,1668,79016,3578773531,3578773532,1
0,1668,79017,3578773531,3578773532,1
0,1668,79018,3578773531,3578773532,1
0,1668,79019,3578773531,3578773532,1
0,1668,79020,3578773531,3578773534,3
0,1668,79021,3578773531,3578773534,3
0,1668,79022,3578773531,3578773534,3
0,1668,79023,3578773531,3578773534,3
0,1668,79024,3578773531,3578773534,3
0,1668,79025,3578773531,3578773534,3
0,1668,79026,3578773531,3578773535,4
0,1668,79027,3578773531,3578773536,5
0,1668,79028,3578773531,3578773537,6
0,1668,79029,3578773531,3578773538,7
0,1668,79030,3578773531,3578773538,7
0,1668,79031,3578773531,3578773539,8
0,1668,79032,3578773531,3578773539,8
0,1668,79033,3578773531,3578773539,8
0,1668,79034,3578773531,3578773539,8
0,1668,79035,3578773531,3578773540,9
0,1668,79036,3578773531,3578773540,9
0,1668,79037,3578773531,3578773541,10
0,1668,79038,3578773531,3578773542,11
0,1668,79039,3578773531,3578773542,11
0,1668,79040,3578773531,3578773542,11
0,1668,79041,3578773531,3578773542,11
0,1668,79042,3578773531,3578773543,12
0,1668,79043,3578773531,3578773543,12
0,1668,79044,3578773531,3578773544,13
0,1668,79045,3578773531,3578773544,13
0,1668,79046,3578773531,3578773545,14
0,1668,79047,3578773531,3578773546,15
0,1668,79048,3578773531,3578773546,15
0,1668,79049,3578773531,3578773547,16
0,1668,79050,3578773531,3578773548,17
0,1668,79051,3578773531,3578773548,17
0,1668,79052,3578773531,3578773550,19
0,1668,79053,3578773531,3578773550,19
0,1668,79054,3578773531,3578773551,20
0,1668,79055,3578773531,3578773552,21
0,1668,79056,3578773531,3578773552,21
0,1668,79057,3578773531,3578773553,22
0,1668,79058,3578773531,3578773553,22
0,1668,79059,3578773531,3578773555,24
0,1668,79060,3578773531,3578773555,24
0,1668,79061,3578773531,3578773555,24
0,1668,79062,3578773531,3578773556,25
0,1668,79063,3578773531,3578773557,26
0,1668,79064,3578773531,3578773557,26
0,1668,79065,3578773531,3578773557,26
0,1668,79066,3578773531,3578773557,26
0,1668,79067,3578773531,3578773557,26
0,1668,79068,3578773531,3578773557,26
0,1668,79069,3578773531,3578773558,27
0,1668,79070,3578773531,3578773559,28
0,1668,79071,3578773531,3578773560,29
0,1668,79072,3578773531,3578773560,29
0,1668,79073,3578773531,3578773560,29
0,1668,79074,3578773531,3578773560,29
0,1668,79075,3578773531,3578773560,29
0,1668,79076,3578773531,3578773561,30
0,1668,79077,3578773531,3578773562,31
0,1668,79078,3578773531,3578773562,31
0,1668,79079,3578773531,3578773562,31
0,1668,79080,3578773531,3578773564,33
0,1668,79081,3578773531,3578773564,33
0,1668,79082,3578773531,3578773566,35
0,1668,79083,3578773531,3578773566,35
0,1668,79084,3578773531,3578773567,36
0,1668,79085,3578773531,3578773567,36
0,1668,79086,3578773531,3578773569,38
0,1668,79087,3578773531,3578773569,38
0,1668,79088,3578773531,3578773570,39
0,1668,79089,3578773531,3578773570,39
0,1668,79090,3578773531,3578773570,39
0,1668,79091,3578773531,3578773571,40
0,1668,79092,3578773531,3578773571,40
0,1668,79093,3578773531,3578773573,42
0,1668,79094,3578773531,3578773573,42
0,1668,79095,3578773531,3578773573,42
0,1668,79096,3578773531,3578773573,42
0,1668,79097,3578773531,3578773574,43
0,1668,79098,3578773531,3578773575,44
0,1668,79099,3578773531,3578773577,46
0,1668,79100,3578773531,3578773577,46
0,1668,79101,3578773531,3578773578,47
0,1668,79102,3578773531,3578773578,47
0,1668,79103,3578773531,3578773579,48
0,1668,79104,3578773531,3578773579,48
0,1668,79105,3578773531,3578773580,49
0,1668,79106,3578773531,3578773580,49
0,1669,79107,3578773598,3578773598,0
0,1669,79108,3578773598,3578773598,0
0,1669,79109,3578773598,3578773598,0
0,1669,79110,3578773598,3578773598,0
0,1669,79111,3578773598,3578773598,0
0,1669,79112,3578773598,3578773598,0
0,1669,79113,3578773598,3578773598,0
0,1669,79114,3578773598,3578773598,0
0,1669,79115,3578773598,3578773598,0
0,1669,79116,3578773598,3578773598,0
0,1669,79117,3578773598,3578773598,0
0,1669,79118,3578773598,3578773598,0
0,1669,79119,3578773598,3578773598,0
0,1669,79120,3578773598,3578773598,0
0,1669,79121,3578773598,3578773598,0
0,1669,79122,3578773598,3578773598,0
0,1669,79123,3578773598,3578773598,0
0,1669,79124,3578773598,3578773598,0
0,1669,79125,3578773598,3578773598,0
0,1669,79126,3578773598,3578773598,0
0,1669,79127,3578773598,3578773598,0
0,1669,79128,3578773598,3578773598,0
0,1669,79129,3578773598,3578773598,0
0,1669,79130,3578773598,3578773598,0
0,1669,79131,3578773598,3578773599,1
0,1669,79132,3578773598,3578773600,2
0,1669,79133,3578773598,3578773600,2
0,1669,79134,3578773598,3578773602,4
0,1669,79135,3578773598,3578773604,6
0,1669,79136,3578773598,3578773604,6
0,1669,79137,3578773598,3578773604,6
0,1669,79138,3578773598,3578773605,7
0,1669,79139,3578773598,3578773605,7
0,1669,79140,3578773598,3578773606,8
0,1669,79141,3578773598,3578773606,8
0,1669,79142,3578773598,3578773607,9
0,1669,79143,3578773598,3578773607,9
0,1669,79144,3578773598,3578773607,9
0,1669,79145,3578773598,3578773608,10
0,1669,79146,3578773598,3578773608,10
0,1669,79147,3578773598,3578773608,10
0,1669,79148,3578773598,3578773610,12
0,1669,79149,3578773598,3578773611,13
0,1669,79150,3578773598,3578773611,13
0,1669,79151,3578773598,3578773612,14
0,1669,79152,3578773598,3578773613,15
0,1669,79153,3578773598,3578773615,17
0,1669,79154,3578773598,3578773615,17
0,1669,79155,3578773598,3578773615,17
0,1669,79156,3578773598,3578773617,19
0,1669,79157,3578773598,3578773617,19
0,1669,79158,3578773598,3578773618,20
0,1669,79159,3578773598,3578773618,20
0,1669,79160,3578773598,3578773619,21
0,1669,79161,3578773598,3578773619,21
0,1669,79162,3578773598,3578773619,21
0,1669,79163,3578773598,3578773619,21
0,1669,79164,3578773598,3578773620,22
0,1669,79165,3578773598,3578773621,23
0,1669,79166,3578773598,3578773621,23
0,1669,79167,3578773598,3578773621,23
0,1669,79168,3578773598,3578773621,23
0,1669,79169,3578773598,3578773622,24
0,1669,79170,3578773598,3578773624,26
0,1669,79171,3578773598,3578773625,27
0,1669,79172,3578773598,3578773626,28
0,1669,79173,3578773598,3578773626,28
0,1669,79174,3578773598,3578773627,29
0,1669,79175,3578773598,3578773627,29
0,1669,79176,3578773598,3578773628,30
0,1669,79177,3578773598,3578773629,31
0,1669,79178,3578773598,3578773629,31
0,1669,79179,3578773598,3578773630,32
0,1669,79180,3578773598,3578773630,32
0,1669,79181,3578773598,3578773631,33
0,1669,79182,3578773598,3578773631,33
0,1669,79183,3578773598,3578773631,33
0,1669,79184,3578773598,3578773632,34
0,1669,79185,3578773598,3578773633,35
0,1669,79186,3578773598,3578773633,35
0,1669,79187,3578773598,3578773635,37
0,1669,79188,3578773598,3578773637,39
0,1669,79189,3578773598,3578773637,39
0,1669,79190,3578773598,3578773638,40
0,1669,79191,3578773598,3578773638,40
0,1669,79192,3578773598,3578773639,41
0,1669,79193,3578773598,3578773639,41
0,1669,79194,3578773598,3578773639,41
0,1669,79195,3578773598,3578773639,41
0,1669,79196,3578773598,3578773639,41
0,1669,79197,3578773598,3578773641,43
0,1669,79198,3578773598,3578773642,44
0,1669,79199,3578773598,3578773643,45
0,1669,79200,3578773598,3578773643,45
0,1669,79201,3578773598,3578773644,46
0,1669,79202,3578773598,3578773645,47
0,1669,79203,3578773598,3578773647,49
0,1669,79204,3578773598,3578773647,49
0,1669,79205,3578773598,3578773648,50
0,1670,79206,3578773665,3578773665,0
0,1670,79207,3578773665,3578773665,0
0,1670,79208,3578773665,3578773665,0
0,1670,79209,3578773665,3578773665,0
0,1670,79210,3578773665,3578773665,0
0,1670,79211,3578773665,3578773665,0
0,1670,79212,3578773665,3578773665,0
0,1670,79213,3578773665,3578773665,0
0,1670,79214,3578773665,3578773665,0
0,1670,79215,3578773665,3578773665,0
0,1670,79216,3578773665,3578773665,0
0,1670,79217,3578773665,3578773665,0
0,1670,79218,3578773665,3578773665,0
0,1670,79219,3578773665,3578773665,0
0,1670,79220,3578773665,3578773665,0
0,1670,79221,3578773665,3578773665,0
0,1670,79222,3578773665,3578773665,0
0,1670,79223,3578773665,3578773665,0
0,1670,79224,3578773665,3578773665,0
0,1670,79225,3578773665,3578773665,0
0,1670,79226,3578773665,3578773665,0
0,1670,79227,3578773665,3578773665,0
0,1670,79228,3578773665,3578773665,0
0,1670,79229,3578773665,3578773665,0
0,1670,79230,3578773665,3578773665,0
0,1670,79231,3578773665,3578773665,0
0,1670,79232,3578773665,3578773665,0
0,1670,79233,3578773665,3578773667,2
0,1670,79234,3578773665,3578773667,2
0,1670,79235,3578773665,3578773667,2
0,1670,79236,3578773665,3578773669,4
0,1670,79237,3578773665,3578773677,12
0,1670,79238,3578773665,3578773680,15
0,1670,79239,3578773665,3578773686,21
0,1670,79240,3578773665,3578773686,21
0,1670,79241,3578773665,3578773688,23
0,1670,79242,3578773665,3578773689,24
0,1670,79243,3578773665,3578773690,25
0,1670,79244,3578773665,3578773690,25
0,1670,79245,3578773665,3578773690,25
0,1670,79246,3578773665,3578773692,27
0,1670,79247,3578773665,3578773692,27
0,1670,79248,3578773665,3578773693,28
0,1670,79249,3578773665,3578773693,28
0,1670,79250,3578773665,3578773693,28
0,1670,79251,3578773665,3578773693,28
0,1670,79252,3578773665,3578773694,29
0,1670,79253,3578773665,3578773695,30
0,1670,79254,3578773665,3578773695,30
0,1670,79255,3578773665,3578773696,31
0,1670,79256,3578773665,3578773696,31
0,1670,79257,3578773665,3578773697,32
0,1670,79258,3578773665,3578773698,33
0,1670,79259,3578773665,3578773698,33
0,1670,79260,3578773665,3578773698,33
0,1670,79261,3578773665,3578773699,34
0,1670,79262,3578773665,3578773699,34
0,1670,79263,3578773665,3578773699,34
0,1670,79264,3578773665,3578773699,34
0,1670,79265,3578773665,3578773701,36
0,1670,79266,3578773665,3578773701,36
0,1670,79267,3578773665,3578773701,36
0,1670,79268,3578773665,3578773701,36
0,1670,79269,3578773665,3578773702,37
0,1670,79270,3578773665,3578773703,38
0,1670,79271,3578773665,3578773703,38
0,1670,79272,3578773665,3578773704,39
0,1670,79273,3578773665,3578773704,39
0,1670,79274,3578773665,3578773704,39
0,1670,79275,3578773665,3578773705,40
0,1670,79276,3578773665,3578773706,41
0,1670,79277,3578773665,3578773706,41
0,1670,79278,3578773665,3578773706,41
0,1670,79279,3578773665,3578773706,41
0,1670,79280,3578773665,3578773706,41
0,1670,79281,3578773665,3578773707,42
0,1670,79282,3578773665,3578773708,43
0,1670,79283,3578773665,3578773708,43
0,1670,79284,3578773665,3578773708,43
0,1670,79285,3578773665,3578773708,43
0,1670,79286,3578773665,3578773708,43
0,1670,79287,3578773665,3578773708,43
0,1670,79288,3578773665,3578773709,44
0,1670,79289,3578773665,3578773709,44
0,1670,79290,3578773665,3578773710,45
0,1670,79291,3578773665,3578773710,45
0,1670,79292,3578773665,3578773710,45
0,1670,79293,3578773665,3578773710,45
0,1670,79294,3578773665,3578773711,46
0,1670,79295,3578773665,3578773711,46
0,1670,79296,3578773665,3578773711,46
0,1670,79297,3578773665,3578773712,47
0,1670,79298,3578773665,3578773712,47
0,1670,79299,3578773665,3578773712,47
0,1670,79300,3578773665,3578773713,48
0,1670,79301,3578773665,3578773714,49
0,1670,79302,3578773665,3578773715,50
0,1671,79303,3578773731,3578773731,0
0,1671,79304,3578773731,3578773731,0
0,1671,79305,3578773731,3578773731,0
0,1671,79306,3578773731,3578773731,0
0,1671,79307,3578773731,3578773731,0
0,1671,79308,3578773731,3578773731,0
0,1671,79309,3578773731,3578773731,0
0,1671,79310,3578773731,3578773731,0
0,1671,79311,3578773731,3578773731,0
0,1671,79312,3578773731,3578773731,0
0,1671,79313,3578773731,3578773731,0
0,1671,79314,3578773731,3578773731,0
0,1671,79315,3578773731,3578773731,0
0,1671,79316,3578773731,3578773731,0
0,1671,79317,3578773731,3578773731,0
0,1671,79318,3578773731,3578773731,0
0,1671,79319,3578773731,3578773731,0
0,1671,79320,3578773731,3578773731,0
0,1671,79321,3578773731,3578773731,0
0,1671,79322,3578773731,3578773731,0
0,1671,79323,3578773731,3578773731,0
0,1671,79324,3578773731,3578773731,0
0,1671,79325,3578773731,3578773731,0
0,1671,79326,3578773731,3578773731,0
0,1671,79327,3578773731,3578773731,0
0,1671,79328,3578773731,3578773732,1
0,1671,79329,3578773731,3578773732,1
0,1671,79330,3578773731,3578773732,1
0,1671,79331,3578773731,3578773732,1
0,1671,79332,3578773731,3578773732,1
0,1671,79333,3578773731,3578773732,1
0,1671,79334,3578773731,3578773732,1
0,1671,79335,3578773731,3578773732,1
0,1671,79336,3578773731,3578773732,1
0,1671,79337,3578773731,3578773732,1
0,1671,79338,3578773731,3578773732,1
0,1671,79339,3578773731,3578773732,1
0,1671,79340,3578773731,3578773732,1
0,1671,79341,3578773731,3578773732,1
0,1671,79342,3578773731,3578773732,1
0,1671,79343,3578773731,3578773732,1
0,1671,79344,3578773731,3578773732,1
0,1671,79345,3578773731,3578773732,1
0,1671,79346,3578773731,3578773732,1
0,1671,79347,3578773731,3578773732,1
0,1671,79348,3578773731,3578773732,1
0,1671,79349,3578773731,3578773732,1
0,1671,79350,3578773731,3578773732,1
0,1671,79351,3578773731,3578773732,1
0,1671,79352,3578773731,3578773732,1
0,1671,79353,3578773731,3578773732,1
0,1671,79354,3578773731,3578773732,1
0,1671,79355,3578773731,3578773733,2
0,1671,79356,3578773731,3578773733,2
0,1671,79357,3578773731,3578773733,2
0,1671,79358,3578773731,3578773734,3
0,1671,79359,3578773731,3578773734,3
0,1671,79360,3578773731,3578773734,3
0,1671,79361,3578773731,3578773735,4
0,1671,79362,3578773731,3578773735,4
0,1671,79363,3578773731,3578773736,5
0,1671,79364,3578773731,3578773736,5
0,1671,79365,3578773731,3578773737,6
0,1671,79366,3578773731,3578773738,7
0,1671,79367,3578773731,3578773739,8
0,1671,79368,3578773731,3578773739,8
0,1671,79369,3578773731,3578773739,8
0,1671,79370,3578773731,3578773740,9
0,1671,79371,3578773731,3578773740,9
0,1671,79372,3578773731,3578773740,9
0,1671,79373,3578773731,3578773740,9
0,1671,79374,3578773731,3578773741,10
0,1671,79375,3578773731,3578773742,11
0,1671,79376,3578773731,3578773742,11
0,1671,79377,3578773731,3578773743,12
0,1671,79378,3578773731,3578773743,12
0,1671,79379,3578773731,3578773743,12
0,1671,79380,3578773731,3578773743,12
0,1671,79381,3578773731,3578773744,13
0,1671,79382,3578773731,3578773745,14
0,1671,79383,3578773731,3578773746,15
0,1671,79384,3578773731,3578773746,15
0,1671,79385,3578773731,3578773749,18
0,1671,79386,3578773731,3578773750,19
0,1671,79387,3578773731,3578773750,19
0,1671,79388,3578773731,3578773751,20
0,1671,79389,3578773731,3578773752,21
0,1671,79390,3578773731,3578773752,21
0,1671,79391,3578773731,3578773753,22
0,1671,79392,3578773731,3578773753,22
0,1671,79393,3578773731,3578773755,24
0,1671,79394,3578773731,3578773755,24
0,1671,79395,3578773731,3578773755,24
0,1671,79396,3578773731,3578773755,24
0,1671,79397,3578773731,3578773756,25
0,1671,79398,3578773731,3578773757,26
0,1671,79399,3578773731,3578773757,26
0,1671,79400,3578773731,3578773757,26
0,1671,79401,3578773731,3578773757,26
0,1671,79402,3578773731,3578773757,26
0,1671,79403,3578773731,3578773758,27
0,1671,79404,3578773731,3578773758,27
0,1671,79405,3578773731,3578773759,28
0,1671,79406,3578773731,3578773759,28
0,1671,79407,3578773731,3578773761,30
0,1671,79408,3578773731,3578773762,31
0,1671,79409,3578773731,3578773762,31
0,1671,79410,3578773731,3578773762,31
0,1671,79411,3578773731,3578773762,31
0,1671,79412,3578773731,3578773764,33
0,1671,79413,3578773731,3578773765,34
0,1671,79414,3578773731,3578773765,34
0,1671,79415,3578773731,3578773765,34
0,1671,79416,3578773731,3578773767,36
0,1671,79417,3578773731,3578773768,37
0,1671,79418,3578773731,3578773768,37
0,1671,79419,3578773731,3578773769,38
0,1671,79420,3578773731,3578773770,39
0,1671,79421,3578773731,3578773770,39
0,1671,79422,3578773731,3578773770,39
0,1671,79423,3578773731,3578773771,40
0,1671,79424,3578773731,3578773771,40
0,1671,79425,3578773731,3578773772,41
0,1671,79426,3578773731,3578773772,41
0,1671,79427,3578773731,3578773772,41
0,1671,79428,3578773731,3578773773,42
0,1671,79429,3578773731,3578773773,42
0,1671,79430,3578773731,3578773774,43
0,1671,79431,3578773731,3578773775,44
0,1671,79432,3578773731,3578773775,44
0,1671,79433,3578773731,3578773775,44
0,1671,79434,3578773731,3578773777,46
0,1671,79435,3578773731,3578773777,46
0,1671,79436,3578773731,3578773778,47
0,1671,79437,3578773731,3578773778,47
0,1671,79438,3578773731,3578773778,47
0,1671,79439,3578773731,3578773779,48
0,1671,79440,3578773731,3578773780,49
0,1671,79441,3578773731,3578773780,49
0,1671,79442,3578773731,3578773781,50
0,1672,79443,3578773798,3578773798,0
0,1672,79444,3578773798,3578773798,0
0,1672,79445,3578773798,3578773798,0
0,1672,79446,3578773798,3578773798,0
0,1672,79447,3578773798,3578773798,0
0,1672,79448,3578773798,3578773798,0
0,1672,79449,3578773798,3578773798,0
0,1672,79450,3578773798,3578773798,0
0,1672,79451,3578773798,3578773798,0
0,1672,79452,3578773798,3578773798,0
0,1672,79453,3578773798,3578773798,0
0,1672,79454,3578773798,3578773798,0
0,1672,79455,3578773798,3578773798,0
0,1672,79456,3578773798,3578773798,0
0,1672,79457,3578773798,3578773798,0
0,1672,79458,3578773798,3578773798,0
0,1672,79459,3578773798,3578773798,0
0,1672,79460,3578773798,3578773798,0
0,1672,79461,3578773798,3578773798,0
0,1672,79462,3578773798,3578773798,0
0,1672,79463,3578773798,3578773798,0
0,1672,79464,3578773798,3578773798,0
0,1672,79465,3578773798,3578773798,0
0,1672,79466,3578773798,3578773798,0
0,1672,79467,3578773798,3578773798,0
0,1672,79468,3578773798,3578773798,0
0,1672,79469,3578773798,3578773799,1
0,1672,79470,3578773798,3578773799,1
0,1672,79471,3578773798,3578773799,1
0,1672,79472,3578773798,3578773800,2
0,1672,79473,3578773798,3578773800,2
0,1672,79474,3578773798,3578773802,4
0,1672,79475,3578773798,3578773803,5
0,1672,79476,3578773798,3578773803,5
0,1672,79477,3578773798,3578773804,6
0,1672,79478,3578773798,3578773804,6
0,1672,79479,3578773798,3578773804,6
0,1672,79480,3578773798,3578773804,6
0,1672,79481,3578773798,3578773806,8
0,1672,79482,3578773798,3578773806,8
0,1672,79483,3578773798,3578773807,9
0,1672,79484,3578773798,3578773808,10
0,1672,79485,3578773798,3578773808,10
0,1672,79486,3578773798,3578773808,10
0,1672,79487,3578773798,3578773810,12
0,1672,79488,3578773798,3578773813,15
0,1672,79489,3578773798,3578773813,15
0,1672,79490,3578773798,3578773813,15
0,1672,79491,3578773798,3578773814,16
0,1672,79492,3578773798,3578773814,16
0,1672,79493,3578773798,3578773814,16
0,1672,79494,3578773798,3578773815,17
0,1672,79495,3578773798,3578773815,17
0,1672,79496,3578773798,3578773817,19
0,1672,79497,3578773798,3578773818,20
0,1672,79498,3578773798,3578773818,20
0,1672,79499,3578773798,3578773818,20
0,1672,79500,3578773798,3578773819,21
0,1672,79501,3578773798,3578773819,21
0,1672,79502,3578773798,3578773819,21
0,1672,79503,3578773798,3578773821,23
0,1672,79504,3578773798,3578773821,23
0,1672,79505,3578773798,3578773821,23
0,1672,79506,3578773798,3578773821,23
0,1672,79507,3578773798,3578773824,26
0,1672,79508,3578773798,3578773824,26
0,1672,79509,3578773798,3578773825,27
0,1672,79510,3578773798,3578773827,29
0,1672,79511,3578773798,3578773827,29
0,1672,79512,3578773798,3578773827,29
0,1672,79513,3578773798,3578773828,30
0,1672,79514,3578773798,3578773828,30
0,1672,79515,3578773798,3578773830,32
0,1672,79516,3578773798,3578773830,32
0,1672,79517,3578773798,3578773830,32
0,1672,79518,3578773798,3578773831,33
0,1672,79519,3578773798,3578773832,34
0,1672,79520,3578773798,3578773832,34
0,1672,79521,3578773798,3578773833,35
0,1672,79522,3578773798,3578773834,36
0,1672,79523,3578773798,3578773834,36
0,1672,79524,3578773798,3578773835,37
0,1672,79525,3578773798,3578773836,38
0,1672,79526,3578773798,3578773837,39
0,1672,79527,3578773798,3578773838,40
0,1672,79528,3578773798,3578773838,40
0,1672,79529,3578773798,3578773838,40
0,1672,79530,3578773798,3578773838,40
0,1672,79531,3578773798,3578773839,41
0,1672,79532,3578773798,3578773839,41
0,1672,79533,3578773798,3578773840,42
0,1672,79534,3578773798,3578773840,42
0,1672,79535,3578773798,3578773840,42
0,1672,79536,3578773798,3578773841,43
0,1672,79537,3578773798,3578773841,43
0,1672,79538,3578773798,3578773841,43
0,1672,79539,3578773798,3578773842,44
0,1672,79540,3578773798,3578773842,44
0,1672,79541,3578773798,3578773843,45
0,1672,79542,3578773798,3578773843,45
0,1672,79543,3578773798,3578773843,45
0,1672,79544,3578773798,3578773844,46
0,1672,79545,3578773798,3578773847,49
0,1672,79546,3578773798,3578773847,49
0,1672,79547,3578773798,3578773847,49
0,1672,79548,3578773798,3578773848,50
0,1672,79549,3578773798,3578773848,50
0,1673,79550,3578773864,3578773864,0
0,1673,79551,3578773864,3578773864,0
0,1673,79552,3578773864,3578773864,0
0,1673,79553,3578773864,3578773864,0
0,1673,79554,3578773864,3578773864,0
0,1673,79555,3578773864,3578773864,0
0,1673,79556,3578773864,3578773864,0
0,1673,79557,3578773864,3578773864,0
0,1673,79558,3578773864,3578773864,0
0,1673,79559,3578773864,3578773864,0
0,1673,79560,3578773864,3578773865,1
0,1673,79561,3578773864,3578773865,1
0,1673,79562,3578773864,3578773865,1
0,1673,79563,3578773864,3578773865,1
0,1673,79564,3578773864,3578773865,1
0,1673,79565,3578773864,3578773865,1
0,1673,79566,3578773864,3578773865,1
0,1673,79567,3578773864,3578773865,1
0,1673,79568,3578773864,3578773865,1
0,1673,79569,3578773864,3578773865,1
0,1673,79570,3578773864,3578773865,1
0,1673,79571,3578773864,3578773865,1
0,1673,79572,3578773864,3578773865,1
0,1673,79573,3578773864,3578773866,2
0,1673,79574,3578773864,3578773866,2
0,1673,79575,3578773864,3578773866,2
0,1673,79576,3578773864,3578773867,3
0,1673,79577,3578773864,3578773868,4
0,1673,79578,