t_id, iteration_count, request_count, request_start_time, request_end_time, request_processing_time
0,116,1,3575831821,3575831867,46
0,117,2,3575831871,3575831917,46
0,118,3,3575831922,3575831968,46
0,119,4,3575831972,3575832019,47
0,120,5,3575832022,3575832070,48
0,121,6,3575832073,3575832117,44
0,121,7,3575832073,3575832120,47
0,122,8,3575832123,3575832171,48
0,123,9,3575832174,3575832219,45
0,123,10,3575832174,3575832222,48
0,124,11,3575832224,3575832273,49
0,125,12,3575832274,3575832317,43
0,125,13,3575832274,3575832320,46
0,125,14,3575832274,3575832323,49
0,126,15,3575832325,3575832374,49
0,127,16,3575832375,3575832419,44
0,127,17,3575832375,3575832424,49
0,128,18,3575832425,3575832475,50
0,129,19,3575832476,3575832516,40
0,129,20,3575832476,3575832519,43
0,129,21,3575832476,3575832525,49
0,130,22,3575832527,3575832576,49
0,131,23,3575832577,3575832618,41
0,131,24,3575832577,3575832627,50
0,132,25,3575832628,3575832677,49
0,133,26,3575832679,3575832718,39
0,133,27,3575832679,3575832719,40
0,133,28,3575832679,3575832726,47
0,133,29,3575832679,3575832728,49
0,134,30,3575832729,3575832779,50
0,135,31,3575832780,3575832819,39
0,135,32,3575832780,3575832830,50
0,136,33,3575832830,3575832880,50
0,137,34,3575832881,3575832919,38
0,137,35,3575832881,3575832920,39
0,137,36,3575832881,3575832926,45
0,138,37,3575832931,3575832931,0
0,139,38,3575832981,3575832982,1
0,139,39,3575832981,3575833018,37
0,140,40,3575833032,3575833032,0
0,141,41,3575833082,3575833083,1
0,141,42,3575833082,3575833119,37
0,141,43,3575833082,3575833120,38
0,141,44,3575833082,3575833126,44
0,141,45,3575833082,3575833130,48
0,142,46,3575833133,3575833133,0
0,143,47,3575833184,3575833184,0
0,143,48,3575833184,3575833219,35
0,144,49,3575833235,3575833235,0
0,145,50,3575833285,3575833286,1
0,145,51,3575833285,3575833318,33
0,145,52,3575833285,3575833319,34
0,145,53,3575833285,3575833325,40
0,145,54,3575833285,3575833331,46
0,146,55,3575833336,3575833336,0
0,146,56,3575833336,3575833373,37
0,147,57,3575833386,3575833387,1
0,147,58,3575833386,3575833418,32
0,147,59,3575833386,3575833434,48
0,148,60,3575833437,3575833437,0
0,148,61,3575833437,3575833486,49
0,149,62,3575833487,3575833488,1
0,149,63,3575833487,3575833517,30
0,149,64,3575833487,3575833518,31
0,149,65,3575833487,3575833524,37
0,149,66,3575833487,3575833531,44
0,150,67,3575833538,3575833539,1
0,150,68,3575833538,3575833573,35
0,151,69,3575833588,3575833589,1
0,151,70,3575833588,3575833618,30
0,151,71,3575833588,3575833633,45
0,152,72,3575833639,3575833640,1
0,152,73,3575833639,3575833686,47
0,153,74,3575833689,3575833691,2
0,153,75,3575833689,3575833717,28
0,153,76,3575833689,3575833718,29
0,153,77,3575833689,3575833724,35
0,153,78,3575833689,3575833732,43
0,154,79,3575833740,3575833740,0
0,154,80,3575833740,3575833741,1
0,154,81,3575833740,3575833773,33
0,155,82,3575833791,3575833792,1
0,155,83,3575833791,3575833819,28
0,155,84,3575833791,3575833834,43
0,156,85,3575833842,3575833843,1
0,156,86,3575833842,3575833885,43
0,156,87,3575833842,3575833890,48
0,157,88,3575833893,3575833893,0
0,157,89,3575833893,3575833917,24
0,157,90,3575833893,3575833918,25
0,157,91,3575833893,3575833925,32
0,157,92,3575833893,3575833932,39
0,157,93,3575833893,3575833940,47
0,158,94,3575833943,3575833944,1
0,158,95,3575833943,3575833972,29
0,159,96,3575833994,3575833995,1
0,159,97,3575833994,3575834019,25
0,159,98,3575833994,3575834034,40
0,159,99,3575833994,3575834043,49
0,160,100,3575834044,3575834046,2
0,160,101,3575834044,3575834085,41
0,160,102,3575834044,3575834090,46
0,161,103,3575834095,3575834096,1
0,161,104,3575834095,3575834117,22
0,161,105,3575834095,3575834119,24
0,161,106,3575834095,3575834125,30
0,161,107,3575834095,3575834132,37
0,161,108,3575834095,3575834140,45
0,162,109,3575834145,3575834147,2
0,162,110,3575834145,3575834172,27
0,163,111,3575834196,3575834197,1
0,163,112,3575834196,3575834219,23
0,163,113,3575834196,3575834234,38
0,163,114,3575834196,3575834243,47
0,164,115,3575834246,3575834249,3
0,164,116,3575834246,3575834285,39
0,164,117,3575834246,3575834290,44
0,164,118,3575834246,3575834296,50
0,165,119,3575834297,3575834299,2
0,165,120,3575834297,3575834318,21
0,165,121,3575834297,3575834320,23
0,165,122,3575834297,3575834325,28
0,165,123,3575834297,3575834332,35
0,165,124,3575834297,3575834340,43
0,166,125,3575834347,3575834350,3
0,166,126,3575834347,3575834372,25
0,166,127,3575834347,3575834397,50
0,167,128,3575834398,3575834400,2
0,167,129,3575834398,3575834419,21
0,167,130,3575834398,3575834434,36
0,167,131,3575834398,3575834443,45
0,168,132,3575834449,3575834451,2
0,168,133,3575834449,3575834485,36
0,168,134,3575834449,3575834491,42
0,168,135,3575834449,3575834496,47
0,169,136,3575834500,3575834502,2
0,169,137,3575834500,3575834516,16
0,169,138,3575834500,3575834519,19
0,169,139,3575834500,3575834524,24
0,169,140,3575834500,3575834531,31
0,169,141,3575834500,3575834539,39
0,169,142,3575834500,3575834548,48
0,170,143,3575834551,3575834552,1
0,170,144,3575834551,3575834571,20
0,170,145,3575834551,3575834597,46
0,171,146,3575834602,3575834603,1
0,171,147,3575834602,3575834618,16
0,171,148,3575834602,3575834633,31
0,171,149,3575834602,3575834642,40
0,172,150,3575834653,3575834653,0
0,172,151,3575834653,3575834685,32
0,172,152,3575834653,3575834691,38
0,172,153,3575834653,3575834697,44
0,173,154,3575834704,3575834704,0
0,173,155,3575834704,3575834717,13
0,173,156,3575834704,3575834720,16
0,173,157,3575834704,3575834724,20
0,173,158,3575834704,3575834731,27
0,173,159,3575834704,3575834739,35
0,173,160,3575834704,3575834749,45
0,173,161,3575834704,3575834752,48
0,174,162,3575834755,3575834755,0
0,174,163,3575834755,3575834771,16
0,174,164,3575834755,3575834797,42
0,175,165,3575834805,3575834806,1
0,175,166,3575834805,3575834817,12
0,175,167,3575834805,3575834832,27
0,175,168,3575834805,3575834841,36
0,176,169,3575834856,3575834857,1
0,176,170,3575834856,3575834886,30
0,176,171,3575834856,3575834891,35
0,176,172,3575834856,3575834897,41
0,176,173,3575834856,3575834905,49
0,177,174,3575834906,3575834908,2
0,177,175,3575834906,3575834917,11
0,177,176,3575834906,3575834920,14
0,177,177,3575834906,3575834923,17
0,177,178,3575834906,3575834931,25
0,177,179,3575834906,3575834938,32
0,177,180,3575834906,3575834948,42
0,177,181,3575834906,3575834953,47
0,178,182,3575834957,3575834958,1
0,178,183,3575834957,3575834971,14
0,178,184,3575834957,3575834997,40
0,179,185,3575835008,3575835008,0
0,179,186,3575835008,3575835017,9
0,179,187,3575835008,3575835032,24
0,179,188,3575835008,3575835041,33
0,180,189,3575835059,3575835059,0
0,180,190,3575835059,3575835085,26
0,180,191,3575835059,3575835091,32
0,180,192,3575835059,3575835096,37
0,180,193,3575835059,3575835105,46
0,180,194,3575835059,3575835108,49
0,181,195,3575835109,3575835110,1
0,181,196,3575835109,3575835117,8
0,181,197,3575835109,3575835120,11
0,181,198,3575835109,3575835123,14
0,181,199,3575835109,3575835131,22
0,181,200,3575835109,3575835138,29
0,181,201,3575835109,3575835148,39
0,181,202,3575835109,3575835153,44
0,181,203,3575835109,3575835158,49
0,182,204,3575835160,3575835160,0
0,182,205,3575835160,3575835171,11
0,182,206,3575835160,3575835197,37
0,183,207,3575835211,3575835211,0
0,183,208,3575835211,3575835218,7
0,183,209,3575835211,3575835234,23
0,183,210,3575835211,3575835242,31
0,183,211,3575835211,3575835259,48
0,184,212,3575835262,3575835262,0
0,184,213,3575835262,3575835285,23
0,184,214,3575835262,3575835292,30
0,184,215,3575835262,3575835296,34
0,184,216,3575835262,3575835305,43
0,184,217,3575835262,3575835308,46
0,185,218,3575835313,3575835313,0
0,185,219,3575835313,3575835317,4
0,185,220,3575835313,3575835320,7
0,185,221,3575835313,3575835324,11
0,185,222,3575835313,3575835331,18
0,185,223,3575835313,3575835339,26
0,185,224,3575835313,3575835349,36
0,185,225,3575835313,3575835352,39
0,185,226,3575835313,3575835358,45
0,186,227,3575835363,3575835363,0
0,186,228,3575835363,3575835373,10
0,186,229,3575835363,3575835397,34
0,187,230,3575835414,3575835414,0
0,187,231,3575835414,3575835418,4
0,187,232,3575835414,3575835433,19
0,187,233,3575835414,3575835442,28
0,187,234,3575835414,3575835459,45
0,188,235,3575835465,3575835465,0
0,188,236,3575835465,3575835485,20
0,188,237,3575835465,3575835492,27
0,188,238,3575835465,3575835497,32
0,188,239,3575835465,3575835506,41
0,188,240,3575835465,3575835507,42
0,188,241,3575835465,3575835515,50
0,189,242,3575835516,3575835516,0
0,189,243,3575835516,3575835520,4
0,189,244,3575835516,3575835524,8
0,189,245,3575835516,3575835530,14
0,189,246,3575835516,3575835538,22
0,189,247,3575835516,3575835548,32
0,189,248,3575835516,3575835552,36
0,189,249,3575835516,3575835557,41
0,189,250,3575835516,3575835562,46
0,189,251,3575835516,3575835566,50
0,190,252,3575835567,3575835571,4
0,190,253,3575835567,3575835596,29
0,190,254,3575835567,3575835616,49
0,190,255,3575835567,3575835616,49
0,191,256,3575835618,3575835632,14
0,191,257,3575835618,3575835641,23
0,191,258,3575835618,3575835658,40
0,191,259,3575835618,3575835667,49
0,192,260,3575835669,3575835685,16
0,192,261,3575835669,3575835692,23
0,192,262,3575835669,3575835696,27
0,192,263,3575835669,3575835706,37
0,192,264,3575835669,3575835707,38
0,192,265,3575835669,3575835717,48
0,192,266,3575835669,3575835718,49
0,193,267,3575835719,3575835719,0
0,193,268,3575835719,3575835723,4
0,193,269,3575835719,3575835730,11
0,193,270,3575835719,3575835737,18
0,193,271,3575835719,3575835748,29
0,193,272,3575835719,3575835752,33
0,193,273,3575835719,3575835757,38
0,193,274,3575835719,3575835763,44
0,193,275,3575835719,3575835766,47
0,193,276,3575835719,3575835768,49
0,194,277,3575835770,3575835772,2
0,194,278,3575835770,3575835797,27
0,194,279,3575835770,3575835817,47
0,194,280,3575835770,3575835818,48
0,195,281,3575835821,3575835833,12
0,195,282,3575835821,3575835842,21
0,195,283,3575835821,3575835858,37
0,195,284,3575835821,3575835869,48
0,196,285,3575835872,3575835886,14
0,196,286,3575835872,3575835892,20
0,196,287,3575835872,3575835897,25
0,196,288,3575835872,3575835906,34
0,196,289,3575835872,3575835908,36
0,196,290,3575835872,3575835916,44
0,196,291,3575835872,3575835918,46
0,196,292,3575835872,3575835919,47
0,196,293,3575835872,3575835920,48
0,197,294,3575835922,3575835923,1
0,197,295,3575835922,3575835929,7
0,197,296,3575835922,3575835937,15
0,197,297,3575835922,3575835948,26
0,197,298,3575835922,3575835952,30
0,197,299,3575835922,3575835957,35
0,197,300,3575835922,3575835963,41
0,197,301,3575835922,3575835966,44
0,197,302,3575835922,3575835971,49
0,198,303,3575835973,3575835973,0
0,198,304,3575835973,3575835998,25
0,198,305,3575835973,3575836018,45
0,198,306,3575835973,3575836022,49
0,199,307,3575836024,3575836033,9
0,199,308,3575836024,3575836042,18
0,199,309,3575836024,3575836058,34
0,199,310,3575836024,3575836072,48
0,200,311,3575836075,3575836086,11
0,200,312,3575836075,3575836092,17
0,200,313,3575836075,3575836097,22
0,200,314,3575836075,3575836108,33
0,200,315,3575836075,3575836116,41
0,200,316,3575836075,3575836118,43
0,200,317,3575836075,3575836119,44
0,200,318,3575836075,3575836123,48
0,200,319,3575836075,3575836124,49
0,201,320,3575836126,3575836130,4
0,201,321,3575836126,3575836138,12
0,201,322,3575836126,3575836149,23
0,201,323,3575836126,3575836152,26
0,201,324,3575836126,3575836158,32
0,201,325,3575836126,3575836163,37
0,201,326,3575836126,3575836166,40
0,201,327,3575836126,3575836172,46
0,201,328,3575836126,3575836173,47
0,202,329,3575836177,3575836198,21
0,202,330,3575836177,3575836218,41
0,203,331,3575836228,3575836228,0
0,203,332,3575836228,3575836234,6
0,203,333,3575836228,3575836241,13
0,203,334,3575836228,3575836258,30
0,203,335,3575836228,3575836275,47
0,204,336,3575836279,3575836286,7
0,204,337,3575836279,3575836292,13
0,204,338,3575836279,3575836297,18
0,204,339,3575836279,3575836306,27
0,204,340,3575836279,3575836308,29
0,204,341,3575836279,3575836316,37
0,204,342,3575836279,3575836318,39
0,204,343,3575836279,3575836319,40
0,204,344,3575836279,3575836322,43
0,204,345,3575836279,3575836325,46
0,204,346,3575836279,3575836325,46
0,205,347,3575836330,3575836330,0
0,205,348,3575836330,3575836338,8
0,205,349,3575836330,3575836349,19
0,205,350,3575836330,3575836352,22
0,205,351,3575836330,3575836359,29
0,205,352,3575836330,3575836363,33
0,205,353,3575836330,3575836366,36
0,205,354,3575836330,3575836373,43
0,205,355,3575836330,3575836374,44
0,205,356,3575836330,3575836376,46
0,206,357,3575836381,3575836397,16
0,206,358,3575836381,3575836417,36
0,206,359,3575836381,3575836427,46
0,207,360,3575836432,3575836434,2
0,207,361,3575836432,3575836442,10
0,207,362,3575836432,3575836459,27
0,207,363,3575836432,3575836477,45
0,208,364,3575836483,3575836486,3
0,208,365,3575836483,3575836491,8
0,208,366,3575836483,3575836496,13
0,208,367,3575836483,3575836506,23
0,208,368,3575836483,3575836506,23
0,208,369,3575836483,3575836516,33
0,208,370,3575836483,3575836516,33
0,208,371,3575836483,3575836518,35
0,208,372,3575836483,3575836522,39
0,208,373,3575836483,3575836523,40
0,208,374,3575836483,3575836525,42
0,208,375,3575836483,3575836527,44
0,208,376,3575836483,3575836529,46
0,209,377,3575836534,3575836537,3
0,209,378,3575836534,3575836548,14
0,209,379,3575836534,3575836551,17
0,209,380,3575836534,3575836558,24
0,209,381,3575836534,3575836562,28
0,209,382,3575836534,3575836565,31
0,209,383,3575836534,3575836571,37
0,209,384,3575836534,3575836572,38
0,209,385,3575836534,3575836578,44
0,210,386,3575836585,3575836596,11
0,210,387,3575836585,3575836617,32
0,210,388,3575836585,3575836628,43
0,210,389,3575836585,3575836633,48
0,211,390,3575836636,3575836641,5
0,211,391,3575836636,3575836658,22
0,211,392,3575836636,3575836679,43
0,211,393,3575836636,3575836686,50
0,212,394,3575836687,3575836691,4
0,212,395,3575836687,3575836696,9
0,212,396,3575836687,3575836706,19
0,212,397,3575836687,3575836706,19
0,212,398,3575836687,3575836716,29
0,212,399,3575836687,3575836716,29
0,212,400,3575836687,3575836718,31
0,212,401,3575836687,3575836722,35
0,212,402,3575836687,3575836724,37
0,212,403,3575836687,3575836725,38
0,212,404,3575836687,3575836728,41
0,212,405,3575836687,3575836729,42
0,212,406,3575836687,3575836730,43
0,212,407,3575836687,3575836737,50
0,213,408,3575836738,3575836748,10
0,213,409,3575836738,3575836751,13
0,213,410,3575836738,3575836758,20
0,213,411,3575836738,3575836762,24
0,213,412,3575836738,3575836765,27
0,213,413,3575836738,3575836771,33
0,213,414,3575836738,3575836772,34
0,213,415,3575836738,3575836778,40
0,213,416,3575836738,3575836780,42
0,214,417,3575836789,3575836796,7
0,214,418,3575836789,3575836817,28
0,214,419,3575836789,3575836829,40
0,214,420,3575836789,3575836831,42
0,214,421,3575836789,3575836832,43
0,215,422,3575836840,3575836842,2
0,215,423,3575836840,3575836859,19
0,215,424,3575836840,3575836882,42
0,215,425,3575836840,3575836885,45
0,216,426,3575836891,3575836891,0
0,216,427,3575836891,3575836896,5
0,216,428,3575836891,3575836905,14
0,216,429,3575836891,3575836907,16
0,216,430,3575836891,3575836916,25
0,216,431,3575836891,3575836917,26
0,216,432,3575836891,3575836918,27
0,216,433,3575836891,3575836922,31
0,216,434,3575836891,3575836923,32
0,216,435,3575836891,3575836925,34
0,216,436,3575836891,3575836927,36
0,216,437,3575836891,3575836930,39
0,216,438,3575836891,3575836932,41
0,216,439,3575836891,3575836936,45
0,217,440,3575836942,3575836948,6
0,217,441,3575836942,3575836951,9
0,217,442,3575836942,3575836958,16
0,217,443,3575836942,3575836962,20
0,217,444,3575836942,3575836965,23
0,217,445,3575836942,3575836971,29
0,217,446,3575836942,3575836972,30
0,217,447,3575836942,3575836978,36
0,217,448,3575836942,3575836980,38
0,217,449,3575836942,3575836983,41
0,218,450,3575836993,3575836996,3
0,218,451,3575836993,3575837017,24
0,218,452,3575836993,3575837030,37
0,218,453,3575836993,3575837033,40
0,218,454,3575836993,3575837034,41
0,218,455,3575836993,3575837041,48
0,219,456,3575837044,3575837058,14
0,219,457,3575837044,3575837084,40
0,219,458,3575837044,3575837091,47
0,220,459,3575837095,3575837096,1
0,220,460,3575837095,3575837106,11
0,220,461,3575837095,3575837106,11
0,220,462,3575837095,3575837116,21
0,220,463,3575837095,3575837117,22
0,220,464,3575837095,3575837119,24
0,220,465,3575837095,3575837122,27
0,220,466,3575837095,3575837124,29
0,220,467,3575837095,3575837125,30
0,220,468,3575837095,3575837127,32
0,220,469,3575837095,3575837130,35
0,220,470,3575837095,3575837135,40
0,220,471,3575837095,3575837136,41
0,221,472,3575837146,3575837149,3
0,221,473,3575837146,3575837151,5
0,221,474,3575837146,3575837158,12
0,221,475,3575837146,3575837162,16
0,221,476,3575837146,3575837165,19
0,221,477,3575837146,3575837171,25
0,221,478,3575837146,3575837172,26
0,221,479,3575837146,3575837178,32
0,221,480,3575837146,3575837180,34
0,221,481,3575837146,3575837185,39
0,222,482,3575837197,3575837197,0
0,222,483,3575837197,3575837218,21
0,222,484,3575837197,3575837230,33
0,222,485,3575837197,3575837233,36
0,222,486,3575837197,3575837234,37
0,222,487,3575837197,3575837236,39
0,222,488,3575837197,3575837242,45
0,223,489,3575837248,3575837258,10
0,223,490,3575837248,3575837284,36
0,223,491,3575837248,3575837287,39
0,223,492,3575837248,3575837291,43
0,223,493,3575837248,3575837297,49
0,224,494,3575837299,3575837305,6
0,224,495,3575837299,3575837307,8
0,224,496,3575837299,3575837316,17
0,224,497,3575837299,3575837317,18
0,224,498,3575837299,3575837319,20
0,224,499,3575837299,3575837323,24
0,224,500,3575837299,3575837323,24
0,224,501,3575837299,3575837325,26
0,224,502,3575837299,3575837327,28
0,224,503,3575837299,3575837330,31
0,224,504,3575837299,3575837337,38
0,224,505,3575837299,3575837337,38
0,224,506,3575837299,3575837349,50
0,225,507,3575837350,3575837352,2
0,225,508,3575837350,3575837358,8
0,225,509,3575837350,3575837362,12
0,225,510,3575837350,3575837365,15
0,225,511,3575837350,3575837372,22
0,225,512,3575837350,3575837372,22
0,225,513,3575837350,3575837378,28
0,225,514,3575837350,3575837380,30
0,225,515,3575837350,3575837388,38
0,225,516,3575837350,3575837397,47
0,226,517,3575837401,3575837418,17
0,226,518,3575837401,3575837429,28
0,226,519,3575837401,3575837434,33
0,226,520,3575837401,3575837434,33
0,226,521,3575837401,3575837436,35
0,226,522,3575837401,3575837438,37
0,226,523,3575837401,3575837442,41
0,227,524,3575837452,3575837458,6
0,227,525,3575837452,3575837484,32
0,227,526,3575837452,3575837485,33
0,227,527,3575837452,3575837489,37
0,227,528,3575837452,3575837490,38
0,227,529,3575837452,3575837497,45
0,228,530,3575837503,3575837505,2
0,228,531,3575837503,3575837505,2
0,228,532,3575837503,3575837515,12
0,228,533,3575837503,3575837516,13
0,228,534,3575837503,3575837518,15
0,228,535,3575837503,3575837522,19
0,228,536,3575837503,3575837524,21
0,228,537,3575837503,3575837524,21
0,228,538,3575837503,3575837527,24
0,228,539,3575837503,3575837529,26
0,228,540,3575837503,3575837536,33
0,228,541,3575837503,3575837537,34
0,228,542,3575837503,3575837540,37
0,228,543,3575837503,3575837547,44
0,228,544,3575837503,3575837550,47
0,229,545,3575837554,3575837557,3
0,229,546,3575837554,3575837561,7
0,229,547,3575837554,3575837563,9
0,229,548,3575837554,3575837572,18
0,229,549,3575837554,3575837572,18
0,229,550,3575837554,3575837577,23
0,229,551,3575837554,3575837580,26
0,229,552,3575837554,3575837587,33
0,229,553,3575837554,3575837590,36
0,229,554,3575837554,3575837596,42
0,230,555,3575837605,3575837616,11
0,230,556,3575837605,3575837629,24
0,230,557,3575837605,3575837632,27
0,230,558,3575837605,3575837632,27
0,230,559,3575837605,3575837636,31
0,230,560,3575837605,3575837640,35
0,230,561,3575837605,3575837641,36
0,231,562,3575837656,3575837657,1
0,231,563,3575837656,3575837684,28
0,231,564,3575837656,3575837686,30
0,231,565,3575837656,3575837689,33
0,231,566,3575837656,3575837691,35
0,231,567,3575837656,3575837691,35
0,231,568,3575837656,3575837697,41
0,232,569,3575837707,3575837707,0
0,232,570,3575837707,3575837715,8
0,232,571,3575837707,3575837717,10
0,232,572,3575837707,3575837718,11
0,232,573,3575837707,3575837722,15
0,232,574,3575837707,3575837723,16
0,232,575,3575837707,3575837724,17
0,232,576,3575837707,3575837726,19
0,232,577,3575837707,3575837730,23
0,232,578,3575837707,3575837736,29
0,232,579,3575837707,3575837737,30
0,232,580,3575837707,3575837742,35
0,232,581,3575837707,3575837748,41
0,232,582,3575837707,3575837750,43
0,233,583,3575837758,3575837758,0
0,233,584,3575837758,3575837761,3
0,233,585,3575837758,3575837764,6
0,233,586,3575837758,3575837771,13
0,233,587,3575837758,3575837771,13
0,233,588,3575837758,3575837777,19
0,233,589,3575837758,3575837780,22
0,233,590,3575837758,3575837787,29
0,233,591,3575837758,3575837793,35
0,233,592,3575837758,3575837795,37
0,234,593,3575837809,3575837816,7
0,234,594,3575837809,3575837829,20
0,234,595,3575837809,3575837833,24
0,234,596,3575837809,3575837833,24
0,234,597,3575837809,3575837835,26
0,234,598,3575837809,3575837842,33
0,234,599,3575837809,3575837843,34
0,234,600,3575837809,3575837857,48
0,235,601,3575837860,3575837884,24
0,235,602,3575837860,3575837885,25
0,235,603,3575837860,3575837889,29
0,235,604,3575837860,3575837891,31
0,235,605,3575837860,3575837891,31
0,235,606,3575837860,3575837894,34
0,235,607,3575837860,3575837897,37
0,235,608,3575837860,3575837907,47
0,236,609,3575837911,3575837916,5
0,236,610,3575837911,3575837916,5
0,236,611,3575837911,3575837918,7
0,236,612,3575837911,3575837923,12
0,236,613,3575837911,3575837924,13
0,236,614,3575837911,3575837924,13
0,236,615,3575837911,3575837927,16
0,236,616,3575837911,3575837930,19
0,236,617,3575837911,3575837936,25
0,236,618,3575837911,3575837937,26
0,236,619,3575837911,3575837944,33
0,236,620,3575837911,3575837947,36
0,236,621,3575837911,3575837951,40
0,236,622,3575837911,3575837957,46
0,237,623,3575837962,3575837962,0
0,237,624,3575837962,3575837964,2
0,237,625,3575837962,3575837971,9
0,237,626,3575837962,3575837971,9
0,237,627,3575837962,3575837977,15
0,237,628,3575837962,3575837980,18
0,237,629,3575837962,3575837987,25
0,237,630,3575837962,3575837995,33
0,237,631,3575837962,3575837995,33
0,238,632,3575838013,3575838018,5
0,238,633,3575838013,3575838029,16
0,238,634,3575838013,3575838033,20
0,238,635,3575838013,3575838033,20
0,238,636,3575838013,3575838035,22
0,238,637,3575838013,3575838042,29
0,238,638,3575838013,3575838044,31
0,238,639,3575838013,3575838046,33
0,238,640,3575838013,3575838058,45
0,239,641,3575838064,3575838084,20
0,239,642,3575838064,3575838086,22
0,239,643,3575838064,3575838089,25
0,239,644,3575838064,3575838091,27
0,239,645,3575838064,3575838092,28
0,239,646,3575838064,3575838096,32
0,239,647,3575838064,3575838097,33
0,239,648,3575838064,3575838105,41
0,239,649,3575838064,3575838107,43
0,240,650,3575838115,3575838117,2
0,240,651,3575838115,3575838117,2
0,240,652,3575838115,3575838119,4
0,240,653,3575838115,3575838123,8
0,240,654,3575838115,3575838124,9
0,240,655,3575838115,3575838124,9
0,240,656,3575838115,3575838127,12
0,240,657,3575838115,3575838129,14
0,240,658,3575838115,3575838136,21
0,240,659,3575838115,3575838137,22
0,240,660,3575838115,3575838144,29
0,240,661,3575838115,3575838147,32
0,240,662,3575838115,3575838148,33
0,240,663,3575838115,3575838150,35
0,240,664,3575838115,3575838157,42
0,240,665,3575838115,3575838161,46
0,240,666,3575838115,3575838163,48
0,241,667,3575838166,3575838171,5
0,241,668,3575838166,3575838172,6
0,241,669,3575838166,3575838177,11
0,241,670,3575838166,3575838180,14
0,241,671,3575838166,3575838187,21
0,241,672,3575838166,3575838195,29
0,241,673,3575838166,3575838196,30
0,241,674,3575838166,3575838198,32
0,242,675,3575838217,3575838218,1
0,242,676,3575838217,3575838228,11
0,242,677,3575838217,3575838233,16
0,242,678,3575838217,3575838234,17
0,242,679,3575838217,3575838235,18
0,242,680,3575838217,3575838242,25
0,242,681,3575838217,3575838243,26
0,242,682,3575838217,3575838248,31
0,242,683,3575838217,3575838258,41
0,243,684,3575838268,3575838284,16
0,243,685,3575838268,3575838286,18
0,243,686,3575838268,3575838289,21
0,243,687,3575838268,3575838292,24
0,243,688,3575838268,3575838293,25
0,243,689,3575838268,3575838296,28
0,243,690,3575838268,3575838296,28
0,243,691,3575838268,3575838299,31
0,243,692,3575838268,3575838305,37
0,243,693,3575838268,3575838306,38
0,243,694,3575838268,3575838317,49
0,243,695,3575838268,3575838317,49
0,244,696,3575838319,3575838319,0
0,244,697,3575838319,3575838323,4
0,244,698,3575838319,3575838324,5
0,244,699,3575838319,3575838324,5
0,244,700,3575838319,3575838327,8
0,244,701,3575838319,3575838330,11
0,244,702,3575838319,3575838336,17
0,244,703,3575838319,3575838337,18
0,244,704,3575838319,3575838344,25
0,244,705,3575838319,3575838348,29
0,244,706,3575838319,3575838349,30
0,244,707,3575838319,3575838350,31
0,244,708,3575838319,3575838357,38
0,244,709,3575838319,3575838362,43
0,244,710,3575838319,3575838364,45
0,245,711,3575838370,3575838372,2
0,245,712,3575838370,3575838372,2
0,245,713,3575838370,3575838377,7
0,245,714,3575838370,3575838380,10
0,245,715,3575838370,3575838387,17
0,245,716,3575838370,3575838395,25
0,245,717,3575838370,3575838397,27
0,245,718,3575838370,3575838400,30
0,245,719,3575838370,3575838417,47
0,246,720,3575838421,3575838428,7
0,246,721,3575838421,3575838433,12
0,246,722,3575838421,3575838434,13
0,246,723,3575838421,3575838435,14
0,246,724,3575838421,3575838442,21
0,246,725,3575838421,3575838443,22
0,246,726,3575838421,3575838450,29
0,246,727,3575838421,3575838459,38
0,247,728,3575838472,3575838483,11
0,247,729,3575838472,3575838486,14
0,247,730,3575838472,3575838489,17
0,247,731,3575838472,3575838491,19
0,247,732,3575838472,3575838492,20
0,247,733,3575838472,3575838495,23
0,247,734,3575838472,3575838496,24
0,247,735,3575838472,3575838498,26
0,247,736,3575838472,3575838501,29
0,247,737,3575838472,3575838504,32
0,247,738,3575838472,3575838506,34
0,247,739,3575838472,3575838516,44
0,247,740,3575838472,3575838517,45
0,247,741,3575838472,3575838518,46
0,248,742,3575838523,3575838523,0
0,248,743,3575838523,3575838523,0
0,248,744,3575838523,3575838523,0
0,248,745,3575838523,3575838525,2
0,248,746,3575838523,3575838529,6
0,248,747,3575838523,3575838536,13
0,248,748,3575838523,3575838536,13
0,248,749,3575838523,3575838543,20
0,248,750,3575838523,3575838548,25
0,248,751,3575838523,3575838548,25
0,248,752,3575838523,3575838550,27
0,248,753,3575838523,3575838552,29
0,248,754,3575838523,3575838556,33
0,248,755,3575838523,3575838561,38
0,248,756,3575838523,3575838564,41
0,248,757,3575838523,3575838571,48
0,248,758,3575838523,3575838571,48
0,249,759,3575838574,3575838576,2
0,249,760,3575838574,3575838579,5
0,249,761,3575838574,3575838586,12
0,249,762,3575838574,3575838594,20
0,249,763,3575838574,3575838596,22
0,249,764,3575838574,3575838602,28
0,249,765,3575838574,3575838617,43
0,250,766,3575838625,3575838628,3
0,250,767,3575838625,3575838632,7
0,250,768,3575838625,3575838633,8
0,250,769,3575838625,3575838634,9
0,250,770,3575838625,3575838640,15
0,250,771,3575838625,3575838643,18
0,250,772,3575838625,3575838653,28
0,250,773,3575838625,3575838659,34
0,251,774,3575838677,3575838683,6
0,251,775,3575838677,3575838686,9
0,251,776,3575838677,3575838689,12
0,251,777,3575838677,3575838690,13
0,251,778,3575838677,3575838691,14
0,251,779,3575838677,3575838695,18
0,251,780,3575838677,3575838697,20
0,251,781,3575838677,3575838698,21
0,251,782,3575838677,3575838701,24
0,251,783,3575838677,3575838703,26
0,251,784,3575838677,3575838704,27
0,251,785,3575838677,3575838707,30
0,251,786,3575838677,3575838717,40
0,251,787,3575838677,3575838717,40
0,251,788,3575838677,3575838718,41
0,251,789,3575838677,3575838721,44
0,251,790,3575838677,3575838723,46
0,251,791,3575838677,3575838723,46
0,251,792,3575838677,3575838725,48
0,252,793,3575838729,3575838729,0
0,252,794,3575838729,3575838736,7
0,252,795,3575838729,3575838736,7
0,252,796,3575838729,3575838743,14
0,252,797,3575838729,3575838748,19
0,252,798,3575838729,3575838748,19
0,252,799,3575838729,3575838750,21
0,252,800,3575838729,3575838754,25
0,252,801,3575838729,3575838756,27
0,252,802,3575838729,3575838761,32
0,252,803,3575838729,3575838763,34
0,252,804,3575838729,3575838771,42
0,252,805,3575838729,3575838771,42
0,252,806,3575838729,3575838776,47
0,253,807,3575838780,3575838780,0
0,253,808,3575838780,3575838786,6
0,253,809,3575838780,3575838794,14
0,253,810,3575838780,3575838796,16
0,253,811,3575838780,3575838805,25
0,253,812,3575838780,3575838817,37
0,253,813,3575838780,3575838827,47
0,254,814,3575838831,3575838832,1
0,254,815,3575838831,3575838833,2
0,254,816,3575838831,3575838834,3
0,254,817,3575838831,3575838842,11
0,254,818,3575838831,3575838842,11
0,254,819,3575838831,3575838856,25
0,254,820,3575838831,3575838858,27
0,255,821,3575838882,3575838883,1
0,255,822,3575838882,3575838887,5
0,255,823,3575838882,3575838889,7
0,255,824,3575838882,3575838890,8
0,255,825,3575838882,3575838891,9
0,255,826,3575838882,3575838895,13
0,255,827,3575838882,3575838897,15
0,255,828,3575838882,3575838897,15
0,255,829,3575838882,3575838901,19
0,255,830,3575838882,3575838903,21
0,255,831,3575838882,3575838904,22
0,255,832,3575838882,3575838906,24
0,255,833,3575838882,3575838907,25
0,255,834,3575838882,3575838917,35
0,255,835,3575838882,3575838917,35
0,255,836,3575838882,3575838918,36
0,255,837,3575838882,3575838921,39
0,255,838,3575838882,3575838923,41
0,255,839,3575838882,3575838923,41
0,255,840,3575838882,3575838925,43
0,255,841,3575838882,3575838930,48
0,256,842,3575838933,3575838936,3
0,256,843,3575838933,3575838936,3
0,256,844,3575838933,3575838943,10
0,256,845,3575838933,3575838948,15
0,256,846,3575838933,3575838949,16
0,256,847,3575838933,3575838950,17
0,256,848,3575838933,3575838956,23
0,256,849,3575838933,3575838957,24
0,256,850,3575838933,3575838961,28
0,256,851,3575838933,3575838964,31
0,256,852,3575838933,3575838972,39
0,256,853,3575838933,3575838976,43
0,256,854,3575838933,3575838980,47
0,257,855,3575838984,3575838986,2
0,257,856,3575838984,3575838994,10
0,257,857,3575838984,3575838995,11
0,257,858,3575838984,3575839007,23
0,257,859,3575838984,3575839018,34
0,257,860,3575838984,3575839027,43
0,257,861,3575838984,3575839033,49
0,257,862,3575838984,3575839033,49
0,258,863,3575839035,3575839035,0
0,258,864,3575839035,3575839042,7
0,258,865,3575839035,3575839042,7
0,258,866,3575839035,3575839058,23
0,258,867,3575839035,3575839059,24
0,258,868,3575839035,3575839083,48
0,259,869,3575839087,3575839088,1
0,259,870,3575839087,3575839089,2
0,259,871,3575839087,3575839090,3
0,259,872,3575839087,3575839092,5
0,259,873,3575839087,3575839095,8
0,259,874,3575839087,3575839097,10
0,259,875,3575839087,3575839097,10
0,259,876,3575839087,3575839101,14
0,259,877,3575839087,3575839103,16
0,259,878,3575839087,3575839105,18
0,259,879,3575839087,3575839107,20
0,259,880,3575839087,3575839108,21
0,259,881,3575839087,3575839117,30
0,259,882,3575839087,3575839117,30
0,259,883,3575839087,3575839119,32
0,259,884,3575839087,3575839121,34
0,259,885,3575839087,3575839123,36
0,259,886,3575839087,3575839123,36
0,259,887,3575839087,3575839125,38
0,259,888,3575839087,3575839130,43
0,259,889,3575839087,3575839136,49
0,259,890,3575839087,3575839137,50
0,260,891,3575839138,3575839144,6
0,260,892,3575839138,3575839147,9
0,260,893,3575839138,3575839148,10
0,260,894,3575839138,3575839150,12
0,260,895,3575839138,3575839157,19
0,260,896,3575839138,3575839157,19
0,260,897,3575839138,3575839159,21
0,260,898,3575839138,3575839161,23
0,260,899,3575839138,3575839164,26
0,260,900,3575839138,3575839172,34
0,260,901,3575839138,3575839177,39
0,260,902,3575839138,3575839181,43
0,260,903,3575839138,3575839186,48
0,261,904,3575839190,3575839194,4
0,261,905,3575839190,3575839196,6
0,261,906,3575839190,3575839209,19
0,261,907,3575839190,3575839218,28
0,261,908,3575839190,3575839228,38
0,261,909,3575839190,3575839232,42
0,261,910,3575839190,3575839233,43
0,261,911,3575839190,3575839235,45
0,262,912,3575839241,3575839241,0
0,262,913,3575839241,3575839242,1
0,262,914,3575839241,3575839258,17
0,262,915,3575839241,3575839258,17
0,262,916,3575839241,3575839260,19
0,262,917,3575839241,3575839283,42
0,262,918,3575839241,3575839288,47
0,262,919,3575839241,3575839289,48
0,262,920,3575839241,3575839290,49
0,263,921,3575839292,3575839292,0
0,263,922,3575839292,3575839295,3
0,263,923,3575839292,3575839297,5
0,263,924,3575839292,3575839298,6
0,263,925,3575839292,3575839301,9
0,263,926,3575839292,3575839303,11
0,263,927,3575839292,3575839304,12
0,263,928,3575839292,3575839307,15
0,263,929,3575839292,3575839311,19
0,263,930,3575839292,3575839317,25
0,263,931,3575839292,3575839317,25
0,263,932,3575839292,3575839319,27
0,263,933,3575839292,3575839321,29
0,263,934,3575839292,3575839323,31
0,263,935,3575839292,3575839324,32
0,263,936,3575839292,3575839325,33
0,263,937,3575839292,3575839330,38
0,263,938,3575839292,3575839336,44
0,263,939,3575839292,3575839338,46
0,264,940,3575839343,3575839344,1
0,264,941,3575839343,3575839348,5
0,264,942,3575839343,3575839349,6
0,264,943,3575839343,3575839350,7
0,264,944,3575839343,3575839357,14
0,264,945,3575839343,3575839357,14
0,264,946,3575839343,3575839361,18
0,264,947,3575839343,3575839362,19
0,264,948,3575839343,3575839363,20
0,264,949,3575839343,3575839372,29
0,264,950,3575839343,3575839377,34
0,264,951,3575839343,3575839380,37
0,264,952,3575839343,3575839387,44
0,265,953,3575839394,3575839394,0
0,265,954,3575839394,3575839397,3
0,265,955,3575839394,3575839412,18
0,265,956,3575839394,3575839418,24
0,265,957,3575839394,3575839427,33
0,265,958,3575839394,3575839433,39
0,265,959,3575839394,3575839433,39
0,265,960,3575839394,3575839435,41
0,265,961,3575839394,3575839442,48
0,265,962,3575839394,3575839442,48
0,266,963,3575839445,3575839458,13
0,266,964,3575839445,3575839458,13
0,266,965,3575839445,3575839462,17
0,266,966,3575839445,3575839483,38
0,266,967,3575839445,3575839488,43
0,266,968,3575839445,3575839489,44
0,266,969,3575839445,3575839491,46
0,266,970,3575839445,3575839492,47
0,266,971,3575839445,3575839495,50
0,267,972,3575839496,3575839496,0
0,267,973,3575839496,3575839497,1
0,267,974,3575839496,3575839500,4
0,267,975,3575839496,3575839502,6
0,267,976,3575839496,3575839503,7
0,267,977,3575839496,3575839506,10
0,267,978,3575839496,3575839513,17
0,267,979,3575839496,3575839516,20
0,267,980,3575839496,3575839518,22
0,267,981,3575839496,3575839520,24
0,267,982,3575839496,3575839523,27
0,267,983,3575839496,3575839523,27
0,267,984,3575839496,3575839525,29
0,267,985,3575839496,3575839529,33
0,267,986,3575839496,3575839536,40
0,267,987,3575839496,3575839537,41
0,267,988,3575839496,3575839542,46
0,268,989,3575839547,3575839547,0
0,268,990,3575839547,3575839547,0
0,268,991,3575839547,3575839550,3
0,268,992,3575839547,3575839556,9
0,268,993,3575839547,3575839556,9
0,268,994,3575839547,3575839561,14
0,268,995,3575839547,3575839563,16
0,268,996,3575839547,3575839564,17
0,268,997,3575839547,3575839571,24
0,268,998,3575839547,3575839576,29
0,268,999,3575839547,3575839580,33
0,268,1000,3575839547,3575839586,39
0,268,1001,3575839547,3575839593,46
0,268,1002,3575839547,3575839596,49
0,269,1003,3575839598,3575839601,3
0,269,1004,3575839598,3575839614,16
0,269,1005,3575839598,3575839617,19
0,269,1006,3575839598,3575839626,28
0,269,1007,3575839598,3575839632,34
0,269,1008,3575839598,3575839633,35
0,269,1009,3575839598,3575839634,36
0,269,1010,3575839598,3575839641,43
0,269,1011,3575839598,3575839641,43
0,270,1012,3575839649,3575839657,8
0,270,1013,3575839649,3575839658,9
0,270,1014,3575839649,3575839665,16
0,270,1015,3575839649,3575839683,34
0,270,1016,3575839649,3575839688,39
0,270,1017,3575839649,3575839689,40
0,270,1018,3575839649,3575839690,41
0,270,1019,3575839649,3575839692,43
0,270,1020,3575839649,3575839695,46
0,270,1021,3575839649,3575839695,46
0,270,1022,3575839649,3575839697,48
0,271,1023,3575839701,3575839701,0
0,271,1024,3575839701,3575839702,1
0,271,1025,3575839701,3575839703,2
0,271,1026,3575839701,3575839706,5
0,271,1027,3575839701,3575839716,15
0,271,1028,3575839701,3575839716,15
0,271,1029,3575839701,3575839717,16
0,271,1030,3575839701,3575839718,17
0,271,1031,3575839701,3575839720,19
0,271,1032,3575839701,3575839723,22
0,271,1033,3575839701,3575839724,23
0,271,1034,3575839701,3575839725,24
0,271,1035,3575839701,3575839729,28
0,271,1036,3575839701,3575839736,35
0,271,1037,3575839701,3575839737,36
0,271,1038,3575839701,3575839742,41
0,271,1039,3575839701,3575839747,46
0,271,1040,3575839701,3575839748,47
0,271,1041,3575839701,3575839751,50
0,272,1042,3575839753,3575839756,3
0,272,1043,3575839753,3575839756,3
0,272,1044,3575839753,3575839762,9
0,272,1045,3575839753,3575839764,11
0,272,1046,3575839753,3575839766,13
0,272,1047,3575839753,3575839771,18
0,272,1048,3575839753,3575839776,23
0,272,1049,3575839753,3575839780,27
0,272,1050,3575839753,3575839786,33
0,272,1051,3575839753,3575839793,40
0,272,1052,3575839753,3575839795,42
0,272,1053,3575839753,3575839800,47
0,273,1054,3575839804,3575839817,13
0,273,1055,3575839804,3575839817,13
0,273,1056,3575839804,3575839826,22
0,273,1057,3575839804,3575839832,28
0,273,1058,3575839804,3575839833,29
0,273,1059,3575839804,3575839834,30
0,273,1060,3575839804,3575839842,38
0,273,1061,3575839804,3575839842,38
0,274,1062,3575839855,3575839857,2
0,274,1063,3575839855,3575839858,3
0,274,1064,3575839855,3575839867,12
0,274,1065,3575839855,3575839883,28
0,274,1066,3575839855,3575839889,34
0,274,1067,3575839855,3575839889,34
0,274,1068,3575839855,3575839890,35
0,274,1069,3575839855,3575839891,36
0,274,1070,3575839855,3575839895,40
0,274,1071,3575839855,3575839896,41
0,274,1072,3575839855,3575839897,42
0,274,1073,3575839855,3575839900,45
0,274,1074,3575839855,3575839902,47
0,274,1075,3575839855,3575839903,48
0,275,1076,3575839906,3575839907,1
0,275,1077,3575839906,3575839916,10
0,275,1078,3575839906,3575839917,11
0,275,1079,3575839906,3575839918,12
0,275,1080,3575839906,3575839918,12
0,275,1081,3575839906,3575839920,14
0,275,1082,3575839906,3575839923,17
0,275,1083,3575839906,3575839923,17
0,275,1084,3575839906,3575839925,19
0,275,1085,3575839906,3575839930,24
0,275,1086,3575839906,3575839937,31
0,275,1087,3575839906,3575839937,31
0,275,1088,3575839906,3575839944,38
0,275,1089,3575839906,3575839947,41
0,275,1090,3575839906,3575839948,42
0,275,1091,3575839906,3575839951,45
0,276,1092,3575839957,3575839957,0
0,276,1093,3575839957,3575839957,0
0,276,1094,3575839957,3575839962,5
0,276,1095,3575839957,3575839964,7
0,276,1096,3575839957,3575839969,12
0,276,1097,3575839957,3575839971,14
0,276,1098,3575839957,3575839976,19
0,276,1099,3575839957,3575839980,23
0,276,1100,3575839957,3575839986,29
0,276,1101,3575839957,3575839994,37
0,276,1102,3575839957,3575839995,38
0,276,1103,3575839957,3575840001,44
0,277,1104,3575840009,3575840018,9
0,277,1105,3575840009,3575840019,10
0,277,1106,3575840009,3575840026,17
0,277,1107,3575840009,3575840033,24
0,277,1108,3575840009,3575840033,24
0,277,1109,3575840009,3575840034,25
0,277,1110,3575840009,3575840042,33
0,277,1111,3575840009,3575840042,33
0,277,1112,3575840009,3575840058,49
0,277,1113,3575840009,3575840058,49
0,278,1114,3575840061,3575840068,7
0,278,1115,3575840061,3575840070,9
0,278,1116,3575840061,3575840083,22
0,278,1117,3575840061,3575840088,27
0,278,1118,3575840061,3575840089,28
0,278,1119,3575840061,3575840090,29
0,278,1120,3575840061,3575840092,31
0,278,1121,3575840061,3575840095,34
0,278,1122,3575840061,3575840095,34
0,278,1123,3575840061,3575840097,36
0,278,1124,3575840061,3575840100,39
0,278,1125,3575840061,3575840103,42
0,278,1126,3575840061,3575840103,42
0,278,1127,3575840061,3575840106,45
0,279,1128,3575840112,3575840116,4
0,279,1129,3575840112,3575840117,5
0,279,1130,3575840112,3575840119,7
0,279,1131,3575840112,3575840120,8
0,279,1132,3575840112,3575840122,10
0,279,1133,3575840112,3575840123,11
0,279,1134,3575840112,3575840123,11
0,279,1135,3575840112,3575840125,13
0,279,1136,3575840112,3575840130,18
0,279,1137,3575840112,3575840137,25
0,279,1138,3575840112,3575840138,26
0,279,1139,3575840112,3575840145,33
0,279,1140,3575840112,3575840148,36
0,279,1141,3575840112,3575840148,36
0,279,1142,3575840112,3575840151,39
0,279,1143,3575840112,3575840157,45
0,279,1144,3575840112,3575840157,45
0,279,1145,3575840112,3575840162,50
0,280,1146,3575840163,3575840164,1
0,280,1147,3575840163,3575840171,8
0,280,1148,3575840163,3575840173,10
0,280,1149,3575840163,3575840176,13
0,280,1150,3575840163,3575840180,17
0,280,1151,3575840163,3575840186,23
0,280,1152,3575840163,3575840194,31
0,280,1153,3575840163,3575840196,33
0,280,1154,3575840163,3575840202,39
0,281,1155,3575840215,3575840218,3
0,281,1156,3575840215,3575840222,7
0,281,1157,3575840215,3575840226,11
0,281,1158,3575840215,3575840233,18
0,281,1159,3575840215,3575840233,18
0,281,1160,3575840215,3575840235,20
0,281,1161,3575840215,3575840242,27
0,281,1162,3575840215,3575840242,27
0,281,1163,3575840215,3575840259,44
0,281,1164,3575840215,3575840259,44
0,282,1165,3575840266,3575840267,1
0,282,1166,3575840266,3575840273,7
0,282,1167,3575840266,3575840283,17
0,282,1168,3575840266,3575840289,23
0,282,1169,3575840266,3575840289,23
0,282,1170,3575840266,3575840291,25
0,282,1171,3575840266,3575840292,26
0,282,1172,3575840266,3575840295,29
0,282,1173,3575840266,3575840295,29
0,282,1174,3575840266,3575840298,32
0,282,1175,3575840266,3575840300,34
0,282,1176,3575840266,3575840303,37
0,282,1177,3575840266,3575840304,38
0,282,1178,3575840266,3575840306,40
0,283,1179,3575840317,3575840317,0
0,283,1180,3575840317,3575840319,2
0,283,1181,3575840317,3575840320,3
0,283,1182,3575840317,3575840322,5
0,283,1183,3575840317,3575840323,6
0,283,1184,3575840317,3575840323,6
0,283,1185,3575840317,3575840324,7
0,283,1186,3575840317,3575840325,8
0,283,1187,3575840317,3575840330,13
0,283,1188,3575840317,3575840337,20
0,283,1189,3575840317,3575840337,20
0,283,1190,3575840317,3575840344,27
0,283,1191,3575840317,3575840348,31
0,283,1192,3575840317,3575840352,35
0,283,1193,3575840317,3575840357,40
0,283,1194,3575840317,3575840358,41
0,283,1195,3575840317,3575840362,45
0,283,1196,3575840317,3575840364,47
0,284,1197,3575840368,3575840372,4
0,284,1198,3575840368,3575840374,6
0,284,1199,3575840368,3575840376,8
0,284,1200,3575840368,3575840380,12
0,284,1201,3575840368,3575840387,19
0,284,1202,3575840368,3575840394,26
0,284,1203,3575840368,3575840397,29
0,284,1204,3575840368,3575840402,34
0,285,1205,3575840420,3575840420,0
0,285,1206,3575840420,3575840422,2
0,285,1207,3575840420,3575840424,4
0,285,1208,3575840420,3575840427,7
0,285,1209,3575840420,3575840432,12
0,285,1210,3575840420,3575840433,13
0,285,1211,3575840420,3575840435,15
0,285,1212,3575840420,3575840442,22
0,285,1213,3575840420,3575840442,22
0,285,1214,3575840420,3575840459,39
0,285,1215,3575840420,3575840459,39
0,285,1216,3575840420,3575840468,48
0,286,1217,3575840471,3575840472,1
0,286,1218,3575840471,3575840475,4
0,286,1219,3575840471,3575840484,13
0,286,1220,3575840471,3575840489,18
0,286,1221,3575840471,3575840489,18
0,286,1222,3575840471,3575840491,20
0,286,1223,3575840471,3575840492,21
0,286,1224,3575840471,3575840495,24
0,286,1225,3575840471,3575840496,25
0,286,1226,3575840471,3575840497,26
0,286,1227,3575840471,3575840500,29
0,286,1228,3575840471,3575840504,33
0,286,1229,3575840471,3575840504,33
0,286,1230,3575840471,3575840507,36
0,286,1231,3575840471,3575840517,46
0,286,1232,3575840471,3575840519,48
0,286,1233,3575840471,3575840520,49
0,287,1234,3575840522,3575840522,0
0,287,1235,3575840522,3575840523,1
0,287,1236,3575840522,3575840523,1
0,287,1237,3575840522,3575840525,3
0,287,1238,3575840522,3575840525,3
0,287,1239,3575840522,3575840529,7
0,287,1240,3575840522,3575840535,13
0,287,1241,3575840522,3575840536,14
0,287,1242,3575840522,3575840543,21
0,287,1243,3575840522,3575840547,25
0,287,1244,3575840522,3575840550,28
0,287,1245,3575840522,3575840556,34
0,287,1246,3575840522,3575840557,35
0,287,1247,3575840522,3575840561,39
0,287,1248,3575840522,3575840564,42
0,287,1249,3575840522,3575840571,49
0,288,1250,3575840573,3575840575,2
0,288,1251,3575840573,3575840576,3
0,288,1252,3575840573,3575840579,6
0,288,1253,3575840573,3575840586,13
0,288,1254,3575840573,3575840594,21
0,288,1255,3575840573,3575840595,22
0,288,1256,3575840573,3575840600,27
0,288,1257,3575840573,3575840617,44
0,288,1258,3575840573,3575840621,48
0,289,1259,3575840625,3575840627,2
0,289,1260,3575840625,3575840627,2
0,289,1261,3575840625,3575840631,6
0,289,1262,3575840625,3575840632,7
0,289,1263,3575840625,3575840634,9
0,289,1264,3575840625,3575840641,16
0,289,1265,3575840625,3575840641,16
0,289,1266,3575840625,3575840658,33
0,289,1267,3575840625,3575840658,33
0,289,1268,3575840625,3575840666,41
0,289,1269,3575840625,3575840673,48
0,290,1270,3575840677,3575840677,0
0,290,1271,3575840677,3575840684,7
0,290,1272,3575840677,3575840689,12
0,290,1273,3575840677,3575840689,12
0,290,1274,3575840677,3575840691,14
0,290,1275,3575840677,3575840692,15
0,290,1276,3575840677,3575840695,18
0,290,1277,3575840677,3575840696,19
0,290,1278,3575840677,3575840698,21
0,290,1279,3575840677,3575840700,23
0,290,1280,3575840677,3575840704,27
0,290,1281,3575840677,3575840704,27
0,290,1282,3575840677,3575840707,30
0,290,1283,3575840677,3575840717,40
0,290,1284,3575840677,3575840718,41
0,290,1285,3575840677,3575840720,43
0,290,1286,3575840677,3575840720,43
0,290,1287,3575840677,3575840723,46
0,290,1288,3575840677,3575840723,46
0,290,1289,3575840677,3575840724,47
0,290,1290,3575840677,3575840726,49
0,291,1291,3575840728,3575840729,1
0,291,1292,3575840728,3575840729,1
0,291,1293,3575840728,3575840735,7
0,291,1294,3575840728,3575840736,8
0,291,1295,3575840728,3575840743,15
0,291,1296,3575840728,3575840747,19
0,291,1297,3575840728,3575840748,20
0,291,1298,3575840728,3575840750,22
0,291,1299,3575840728,3575840756,28
0,291,1300,3575840728,3575840757,29
0,291,1301,3575840728,3575840761,33
0,291,1302,3575840728,3575840763,35
0,291,1303,3575840728,3575840771,43
0,291,1304,3575840728,3575840776,48
0,292,1305,3575840781,3575840781,0
0,292,1306,3575840781,3575840781,0
0,292,1307,3575840781,3575840786,5
0,292,1308,3575840781,3575840794,13
0,292,1309,3575840781,3575840795,14
0,292,1310,3575840781,3575840801,20
0,292,1311,3575840781,3575840817,36
0,292,1312,3575840781,3575840821,40
0,292,1313,3575840781,3575840827,46
0,292,1314,3575840781,3575840830,49
0,293,1315,3575840832,3575840832,0
0,293,1316,3575840832,3575840832,0
0,293,1317,3575840832,3575840834,2
0,293,1318,3575840832,3575840841,9
0,293,1319,3575840832,3575840842,10
0,293,1320,3575840832,3575840858,26
0,293,1321,3575840832,3575840858,26
0,293,1322,3575840832,3575840867,35
0,293,1323,3575840832,3575840873,41
0,293,1324,3575840832,3575840881,49
0,294,1325,3575840883,3575840885,2
0,294,1326,3575840883,3575840889,6
0,294,1327,3575840883,3575840889,6
0,294,1328,3575840883,3575840890,7
0,294,1329,3575840883,3575840891,8
0,294,1330,3575840883,3575840895,12
0,294,1331,3575840883,3575840896,13
0,294,1332,3575840883,3575840897,14
0,294,1333,3575840883,3575840900,17
0,294,1334,3575840883,3575840903,20
0,294,1335,3575840883,3575840903,20
0,294,1336,3575840883,3575840906,23
0,294,1337,3575840883,3575840917,34
0,294,1338,3575840883,3575840918,35
0,294,1339,3575840883,3575840919,36
0,294,1340,3575840883,3575840921,38
0,294,1341,3575840883,3575840922,39
0,294,1342,3575840883,3575840923,40
0,294,1343,3575840883,3575840923,40
0,294,1344,3575840883,3575840925,42
0,294,1345,3575840883,3575840929,46
0,294,1346,3575840883,3575840932,49
0,295,1347,3575840935,3575840935,0
0,295,1348,3575840935,3575840937,2
0,295,1349,3575840935,3575840943,8
0,295,1350,3575840935,3575840947,12
0,295,1351,3575840935,3575840947,12
0,295,1352,3575840935,3575840950,15
0,295,1353,3575840935,3575840957,22
0,295,1354,3575840935,3575840958,23
0,295,1355,3575840935,3575840961,26
0,295,1356,3575840935,3575840964,29
0,295,1357,3575840935,3575840971,36
0,295,1358,3575840935,3575840976,41
0,295,1359,3575840935,3575840980,45
0,295,1360,3575840935,3575840982,47
0,296,1361,3575840987,3575840987,0
0,296,1362,3575840987,3575840994,7
0,296,1363,3575840987,3575840995,8
0,296,1364,3575840987,3575841001,14
0,296,1365,3575840987,3575841018,31
0,296,1366,3575840987,3575841021,34
0,296,1367,3575840987,3575841027,40
0,296,1368,3575840987,3575841032,45
0,296,1369,3575840987,3575841032,45
0,296,1370,3575840987,3575841033,46
0,296,1371,3575840987,3575841034,47
0,297,1372,3575841039,3575841042,3
0,297,1373,3575841039,3575841042,3
0,297,1374,3575841039,3575841058,19
0,297,1375,3575841039,3575841058,19
0,297,1376,3575841039,3575841067,28
0,297,1377,3575841039,3575841072,33
0,297,1378,3575841039,3575841084,45
0,297,1379,3575841039,3575841086,47
0,298,1380,3575841090,3575841090,0
0,298,1381,3575841090,3575841090,0
0,298,1382,3575841090,3575841091,1
0,298,1383,3575841090,3575841092,2
0,298,1384,3575841090,3575841095,5
0,298,1385,3575841090,3575841096,6
0,298,1386,3575841090,3575841098,8
0,298,1387,3575841090,3575841101,11
0,298,1388,3575841090,3575841103,13
0,298,1389,3575841090,3575841104,14
0,298,1390,3575841090,3575841106,16
0,298,1391,3575841090,3575841117,27
0,298,1392,3575841090,3575841118,28
0,298,1393,3575841090,3575841119,29
0,298,1394,3575841090,3575841121,31
0,298,1395,3575841090,3575841123,33
0,298,1396,3575841090,3575841123,33
0,298,1397,3575841090,3575841124,34
0,298,1398,3575841090,3575841126,36
0,298,1399,3575841090,3575841129,39
0,298,1400,3575841090,3575841133,43
0,298,1401,3575841090,3575841135,45
0,298,1402,3575841090,3575841137,47
0,299,1403,3575841142,3575841143,1
0,299,1404,3575841142,3575841147,5
0,299,1405,3575841142,3575841148,6
0,299,1406,3575841142,3575841150,8
0,299,1407,3575841142,3575841157,15
0,299,1408,3575841142,3575841158,16
0,299,1409,3575841142,3575841161,19
0,299,1410,3575841142,3575841164,22
0,299,1411,3575841142,3575841172,30
0,299,1412,3575841142,3575841176,34
0,299,1413,3575841142,3575841179,37
0,299,1414,3575841142,3575841184,42
0,299,1415,3575841142,3575841186,44
0,300,1416,3575841194,3575841194,0
0,300,1417,3575841194,3575841196,2
0,300,1418,3575841194,3575841218,24
0,300,1419,3575841194,3575841220,26
0,300,1420,3575841194,3575841226,32
0,300,1421,3575841194,3575841233,39
0,300,1422,3575841194,3575841233,39
0,300,1423,3575841194,3575841235,41
0,300,1424,3575841194,3575841235,41
0,300,1425,3575841194,3575841242,48
0,300,1426,3575841194,3575841242,48
0,301,1427,3575841246,3575841258,12
0,301,1428,3575841246,3575841258,12
0,301,1429,3575841246,3575841266,20
0,301,1430,3575841246,3575841273,27
0,301,1431,3575841246,3575841285,39
0,301,1432,3575841246,3575841285,39
0,301,1433,3575841246,3575841289,43
0,301,1434,3575841246,3575841289,43
0,301,1435,3575841246,3575841290,44
0,301,1436,3575841246,3575841291,45
0,301,1437,3575841246,3575841295,49
0,301,1438,3575841246,3575841296,50
0,302,1439,3575841298,3575841298,0
0,302,1440,3575841298,3575841300,2
0,302,1441,3575841298,3575841303,5
0,302,1442,3575841298,3575841303,5
0,302,1443,3575841298,3575841307,9
0,302,1444,3575841298,3575841317,19
0,302,1445,3575841298,3575841318,20
0,302,1446,3575841298,3575841319,21
0,302,1447,3575841298,3575841321,23
0,302,1448,3575841298,3575841322,24
0,302,1449,3575841298,3575841323,25
0,302,1450,3575841298,3575841324,26
0,302,1451,3575841298,3575841325,27
0,302,1452,3575841298,3575841330,32
0,302,1453,3575841298,3575841336,38
0,302,1454,3575841298,3575841336,38
0,302,1455,3575841298,3575841337,39
0,302,1456,3575841298,3575841343,45
0,302,1457,3575841298,3575841348,50
0,303,1458,3575841350,3575841350,0
0,303,1459,3575841350,3575841350,0
0,303,1460,3575841350,3575841357,7
0,303,1461,3575841350,3575841358,8
0,303,1462,3575841350,3575841362,12
0,303,1463,3575841350,3575841364,14
0,303,1464,3575841350,3575841372,22
0,303,1465,3575841350,3575841376,26
0,303,1466,3575841350,3575841380,30
0,303,1467,3575841350,3575841386,36
0,303,1468,3575841350,3575841386,36
0,303,1469,3575841350,3575841394,44
0,303,1470,3575841350,3575841396,46
0,304,1471,3575841402,3575841418,16
0,304,1472,3575841402,3575841421,19
0,304,1473,3575841402,3575841427,25
0,304,1474,3575841402,3575841434,32
0,304,1475,3575841402,3575841434,32
0,304,1476,3575841402,3575841435,33
0,304,1477,3575841402,3575841437,35
0,304,1478,3575841402,3575841441,39
0,304,1479,3575841402,3575841442,40
0,305,1480,3575841454,3575841458,4
0,305,1481,3575841454,3575841458,4
0,305,1482,3575841454,3575841467,13
0,305,1483,3575841454,3575841473,19
0,305,1484,3575841454,3575841486,32
0,305,1485,3575841454,3575841488,34
0,305,1486,3575841454,3575841489,35
0,305,1487,3575841454,3575841490,36
0,305,1488,3575841454,3575841490,36
0,305,1489,3575841454,3575841491,37
0,305,1490,3575841454,3575841496,42
0,305,1491,3575841454,3575841496,42
0,305,1492,3575841454,3575841498,44
0,305,1493,3575841454,3575841500,46
0,305,1494,3575841454,3575841503,49
0,305,1495,3575841454,3575841503,49
0,306,1496,3575841506,3575841506,0
0,306,1497,3575841506,3575841516,10
0,306,1498,3575841506,3575841516,10
0,306,1499,3575841506,3575841518,12
0,306,1500,3575841506,3575841520,14
0,306,1501,3575841506,3575841522,16
0,306,1502,3575841506,3575841523,17
0,306,1503,3575841506,3575841523,17
0,306,1504,3575841506,3575841529,23
0,306,1505,3575841506,3575841534,28
0,306,1506,3575841506,3575841536,30
0,306,1507,3575841506,3575841536,30
0,306,1508,3575841506,3575841538,32
0,306,1509,3575841506,3575841542,36
0,306,1510,3575841506,3575841547,41
0,306,1511,3575841506,3575841548,42
0,306,1512,3575841506,3575841550,44
0,306,1513,3575841506,3575841556,50
0,307,1514,3575841558,3575841558,0
0,307,1515,3575841558,3575841561,3
0,307,1516,3575841558,3575841564,6
0,307,1517,3575841558,3575841571,13
0,307,1518,3575841558,3575841576,18
0,307,1519,3575841558,3575841579,21
0,307,1520,3575841558,3575841585,27
0,307,1521,3575841558,3575841589,31
0,307,1522,3575841558,3575841593,35
0,307,1523,3575841558,3575841595,37
0,308,1524,3575841611,3575841617,6
0,308,1525,3575841611,3575841620,9
0,308,1526,3575841611,3575841627,16
0,308,1527,3575841611,3575841632,21
0,308,1528,3575841611,3575841632,21
0,308,1529,3575841611,3575841634,23
0,308,1530,3575841611,3575841639,28
0,308,1531,3575841611,3575841640,29
0,308,1532,3575841611,3575841641,30
0,308,1533,3575841611,3575841657,46
0,308,1534,3575841611,3575841658,47
0,309,1535,3575841663,3575841666,3
0,309,1536,3575841663,3575841673,10
0,309,1537,3575841663,3575841686,23
0,309,1538,3575841663,3575841688,25
0,309,1539,3575841663,3575841690,27
0,309,1540,3575841663,3575841690,27
0,309,1541,3575841663,3575841690,27
0,309,1542,3575841663,3575841690,27
0,309,1543,3575841663,3575841692,29
0,309,1544,3575841663,3575841696,33
0,309,1545,3575841663,3575841697,34
0,309,1546,3575841663,3575841697,34
0,309,1547,3575841663,3575841700,37
0,309,1548,3575841663,3575841703,40
0,309,1549,3575841663,3575841704,41
0,309,1550,3575841663,3575841705,42
0,310,1551,3575841715,3575841716,1
0,310,1552,3575841715,3575841717,2
0,310,1553,3575841715,3575841718,3
0,310,1554,3575841715,3575841719,4
0,310,1555,3575841715,3575841722,7
0,310,1556,3575841715,3575841723,8
0,310,1557,3575841715,3575841723,8
0,310,1558,3575841715,3575841729,14
0,310,1559,3575841715,3575841735,20
0,310,1560,3575841715,3575841736,21
0,310,1561,3575841715,3575841736,21
0,310,1562,3575841715,3575841739,24
0,310,1563,3575841715,3575841741,26
0,310,1564,3575841715,3575841742,27
0,310,1565,3575841715,3575841747,32
0,310,1566,3575841715,3575841748,33
0,310,1567,3575841715,3575841751,36
0,310,1568,3575841715,3575841757,42
0,310,1569,3575841715,3575841757,42
0,310,1570,3575841715,3575841761,46
0,310,1571,3575841715,3575841764,49
0,311,1572,3575841767,3575841771,4
0,311,1573,3575841767,3575841776,9
0,311,1574,3575841767,3575841779,12
0,311,1575,3575841767,3575841786,19
0,311,1576,3575841767,3575841791,24
0,311,1577,3575841767,3575841794,27
0,311,1578,3575841767,3575841795,28
0,312,1579,3575841819,3575841819,0
0,312,1580,3575841819,3575841819,0
0,312,1581,3575841819,3575841827,8
0,312,1582,3575841819,3575841833,14
0,312,1583,3575841819,3575841833,14
0,312,1584,3575841819,3575841834,15
0,312,1585,3575841819,3575841842,23
0,312,1586,3575841819,3575841842,23
0,312,1587,3575841819,3575841843,24
0,312,1588,3575841819,3575841857,38
0,312,1589,3575841819,3575841858,39
0,312,1590,3575841819,3575841866,47
0,313,1591,3575841871,3575841874,3
0,313,1592,3575841871,3575841885,14
0,313,1593,3575841871,3575841889,18
0,313,1594,3575841871,3575841890,19
0,313,1595,3575841871,3575841890,19
0,313,1596,3575841871,3575841891,20
0,313,1597,3575841871,3575841891,20
0,313,1598,3575841871,3575841893,22
0,313,1599,3575841871,3575841896,25
0,313,1600,3575841871,3575841896,25
0,313,1601,3575841871,3575841898,27
0,313,1602,3575841871,3575841900,29
0,313,1603,3575841871,3575841903,32
0,313,1604,3575841871,3575841903,32
0,313,1605,3575841871,3575841906,35
0,313,1606,3575841871,3575841916,45
0,313,1607,3575841871,3575841918,47
0,313,1608,3575841871,3575841918,47
0,313,1609,3575841871,3575841920,49
0,314,1610,3575841922,3575841922,0
0,314,1611,3575841922,3575841923,1
0,314,1612,3575841922,3575841924,2
0,314,1613,3575841922,3575841925,3
0,314,1614,3575841922,3575841930,8
0,314,1615,3575841922,3575841935,13
0,314,1616,3575841922,3575841936,14
0,314,1617,3575841922,3575841937,15
0,314,1618,3575841922,3575841938,16
0,314,1619,3575841922,3575841943,21
0,314,1620,3575841922,3575841943,21
0,314,1621,3575841922,3575841947,25
0,314,1622,3575841922,3575841947,25
0,314,1623,3575841922,3575841950,28
0,314,1624,3575841922,3575841957,35
0,314,1625,3575841922,3575841958,36
0,314,1626,3575841922,3575841961,39
0,314,1627,3575841922,3575841964,42
0,314,1628,3575841922,3575841971,49
0,315,1629,3575841974,3575841976,2
0,315,1630,3575841974,3575841979,5
0,315,1631,3575841974,3575841985,11
0,315,1632,3575841974,3575841994,20
0,315,1633,3575841974,3575841994,20
0,315,1634,3575841974,3575841996,22
0,315,1635,3575841974,3575842018,44
0,315,1636,3575841974,3575842020,46
0,316,1637,3575842026,3575842026,0
0,316,1638,3575842026,3575842032,6
0,316,1639,3575842026,3575842032,6
0,316,1640,3575842026,3575842034,8
0,316,1641,3575842026,3575842042,16
0,316,1642,3575842026,3575842043,17
0,316,1643,3575842026,3575842045,19
0,316,1644,3575842026,3575842057,31
0,316,1645,3575842026,3575842058,32
0,316,1646,3575842026,3575842066,40
0,316,1647,3575842026,3575842074,48
0,317,1648,3575842077,3575842085,8
0,317,1649,3575842077,3575842089,12
0,317,1650,3575842077,3575842090,13
0,317,1651,3575842077,3575842090,13
0,317,1652,3575842077,3575842090,13
0,317,1653,3575842077,3575842092,15
0,317,1654,3575842077,3575842095,18
0,317,1655,3575842077,3575842095,18
0,317,1656,3575842077,3575842096,19
0,317,1657,3575842077,3575842098,21
0,317,1658,3575842077,3575842100,23
0,317,1659,3575842077,3575842103,26
0,317,1660,3575842077,3575842104,27
0,317,1661,3575842077,3575842106,29
0,317,1662,3575842077,3575842116,39
0,317,1663,3575842077,3575842118,41
0,317,1664,3575842077,3575842119,42
0,317,1665,3575842077,3575842120,43
0,317,1666,3575842077,3575842121,44
0,317,1667,3575842077,3575842123,46
0,317,1668,3575842077,3575842123,46
0,317,1669,3575842077,3575842125,48
0,318,1670,3575842129,3575842130,1
0,318,1671,3575842129,3575842134,5
0,318,1672,3575842129,3575842136,7
0,318,1673,3575842129,3575842137,8
0,318,1674,3575842129,3575842138,9
0,318,1675,3575842129,3575842143,14
0,318,1676,3575842129,3575842143,14
0,318,1677,3575842129,3575842146,17
0,318,1678,3575842129,3575842147,18
0,318,1679,3575842129,3575842147,18
0,318,1680,3575842129,3575842150,21
0,318,1681,3575842129,3575842156,27
0,318,1682,3575842129,3575842157,28
0,318,1683,3575842129,3575842161,32
0,318,1684,3575842129,3575842164,35
0,318,1685,3575842129,3575842172,43
0,318,1686,3575842129,3575842176,47
0,319,1687,3575842180,3575842180,0
0,319,1688,3575842180,3575842186,6
0,319,1689,3575842180,3575842194,14
0,319,1690,3575842180,3575842196,16
0,319,1691,3575842180,3575842196,16
0,319,1692,3575842180,3575842217,37
0,319,1693,3575842180,3575842221,41
0,319,1694,3575842180,3575842227,47
0,320,1695,3575842231,3575842233,2
0,320,1696,3575842231,3575842233,2
0,320,1697,3575842231,3575842235,4
0,320,1698,3575842231,3575842242,11
0,320,1699,3575842231,3575842243,12
0,320,1700,3575842231,3575842247,16
0,320,1701,3575842231,3575842257,26
0,320,1702,3575842231,3575842258,27
0,320,1703,3575842231,3575842266,35
0,320,1704,3575842231,3575842274,43
0,321,1705,3575842283,3575842285,2
0,321,1706,3575842283,3575842288,5
0,321,1707,3575842283,3575842290,7
0,321,1708,3575842283,3575842290,7
0,321,1709,3575842283,3575842290,7
0,321,1710,3575842283,3575842291,8
0,321,1711,3575842283,3575842295,12
0,321,1712,3575842283,3575842296,13
0,321,1713,3575842283,3575842298,15
0,321,1714,3575842283,3575842298,15
0,321,1715,3575842283,3575842301,18
0,321,1716,3575842283,3575842303,20
0,321,1717,3575842283,3575842304,21
0,321,1718,3575842283,3575842306,23
0,321,1719,3575842283,3575842317,34
0,321,1720,3575842283,3575842318,35
0,321,1721,3575842283,3575842320,37
0,321,1722,3575842283,3575842320,37
0,321,1723,3575842283,3575842321,38
0,321,1724,3575842283,3575842323,40
0,321,1725,3575842283,3575842324,41
0,321,1726,3575842283,3575842325,42
0,321,1727,3575842283,3575842330,47
0,322,1728,3575842334,3575842335,1
0,322,1729,3575842334,3575842336,2
0,322,1730,3575842334,3575842337,3
0,322,1731,3575842334,3575842338,4
0,322,1732,3575842334,3575842343,9
0,322,1733,3575842334,3575842344,10
0,322,1734,3575842334,3575842346,12
0,322,1735,3575842334,3575842348,14
0,322,1736,3575842334,3575842348,14
0,322,1737,3575842334,3575842349,15
0,322,1738,3575842334,3575842351,17
0,322,1739,3575842334,3575842357,23
0,322,1740,3575842334,3575842358,24
0,322,1741,3575842334,3575842362,28
0,322,1742,3575842334,3575842364,30
0,322,1743,3575842334,3575842376,42
0,322,1744,3575842334,3575842380,46
0,323,1745,3575842386,3575842387,1
0,323,1746,3575842386,3575842394,8
0,323,1747,3575842386,3575842396,10
0,323,1748,3575842386,3575842400,14
0,323,1749,3575842386,3575842418,32
0,323,1750,3575842386,3575842421,35
0,323,1751,3575842386,3575842427,41
0,323,1752,3575842386,3575842433,47
0,323,1753,3575842386,3575842434,48
0,323,1754,3575842386,3575842435,49
0,324,1755,3575842438,3575842442,4
0,324,1756,3575842438,3575842443,5
0,324,1757,3575842438,3575842452,14
0,324,1758,3575842438,3575842457,19
0,324,1759,3575842438,3575842458,20
0,324,1760,3575842438,3575842467,29
0,324,1761,3575842438,3575842475,37
0,324,1762,3575842438,3575842485,47
0,325,1763,3575842489,3575842489,0
0,325,1764,3575842489,3575842489,0
0,325,1765,3575842489,3575842489,0
0,325,1766,3575842489,3575842491,2
0,325,1767,3575842489,3575842494,5
0,325,1768,3575842489,3575842495,6
0,325,1769,3575842489,3575842497,8
0,325,1770,3575842489,3575842499,10
0,325,1771,3575842489,3575842500,11
0,325,1772,3575842489,3575842502,13
0,325,1773,3575842489,3575842503,14
0,325,1774,3575842489,3575842505,16
0,325,1775,3575842489,3575842515,26
0,325,1776,3575842489,3575842517,28
0,325,1777,3575842489,3575842518,29
0,325,1778,3575842489,3575842519,30
0,325,1779,3575842489,3575842520,31
0,325,1780,3575842489,3575842523,34
0,325,1781,3575842489,3575842523,34
0,325,1782,3575842489,3575842525,36
0,325,1783,3575842489,3575842529,40
0,325,1784,3575842489,3575842533,44
0,325,1785,3575842489,3575842535,46
0,325,1786,3575842489,3575842536,47
0,325,1787,3575842489,3575842537,48
0,326,1788,3575842541,3575842542,1
0,326,1789,3575842541,3575842543,2
0,326,1790,3575842541,3575842545,4
0,326,1791,3575842541,3575842547,6
0,326,1792,3575842541,3575842548,7
0,326,1793,3575842541,3575842548,7
0,326,1794,3575842541,3575842550,9
0,326,1795,3575842541,3575842551,10
0,326,1796,3575842541,3575842556,15
0,326,1797,3575842541,3575842556,15
0,326,1798,3575842541,3575842561,20
0,326,1799,3575842541,3575842564,23
0,326,1800,3575842541,3575842571,30
0,326,1801,3575842541,3575842575,34
0,326,1802,3575842541,3575842579,38
0,326,1803,3575842541,3575842586,45
0,327,1804,3575842593,3575842594,1
0,327,1805,3575842593,3575842595,2
0,327,1806,3575842593,3575842601,8
0,327,1807,3575842593,3575842617,24
0,327,1808,3575842593,3575842620,27
0,327,1809,3575842593,3575842627,34
0,327,1810,3575842593,3575842632,39
0,327,1811,3575842593,3575842632,39
0,327,1812,3575842593,3575842634,41
0,327,1813,3575842593,3575842642,49
0,327,1814,3575842593,3575842642,49
0,328,1815,3575842645,3575842652,7
0,328,1816,3575842645,3575842656,11
0,328,1817,3575842645,3575842657,12
0,328,1818,3575842645,3575842666,21
0,328,1819,3575842645,3575842674,29
0,328,1820,3575842645,3575842685,40
0,328,1821,3575842645,3575842688,43
0,328,1822,3575842645,3575842689,44
0,328,1823,3575842645,3575842691,46
0,328,1824,3575842645,3575842692,47
0,328,1825,3575842645,3575842695,50
0,329,1826,3575842697,3575842697,0
0,329,1827,3575842697,3575842697,0
0,329,1828,3575842697,3575842699,2
0,329,1829,3575842697,3575842703,6
0,329,1830,3575842697,3575842704,7
0,329,1831,3575842697,3575842704,7
0,329,1832,3575842697,3575842705,8
0,329,1833,3575842697,3575842715,18
0,329,1834,3575842697,3575842717,20
0,329,1835,3575842697,3575842718,21
0,329,1836,3575842697,3575842718,21
0,329,1837,3575842697,3575842721,24
0,329,1838,3575842697,3575842723,26
0,329,1839,3575842697,3575842723,26
0,329,1840,3575842697,3575842726,29
0,329,1841,3575842697,3575842729,32
0,329,1842,3575842697,3575842734,37
0,329,1843,3575842697,3575842735,38
0,329,1844,3575842697,3575842736,39
0,329,1845,3575842697,3575842737,40
0,329,1846,3575842697,3575842742,45
0,329,1847,3575842697,3575842743,46
0,329,1848,3575842697,3575842745,48
0,330,1849,3575842749,3575842749,0
0,330,1850,3575842749,3575842749,0
0,330,1851,3575842749,3575842749,0
0,330,1852,3575842749,3575842750,1
0,330,1853,3575842749,3575842753,4
0,330,1854,3575842749,3575842757,8
0,330,1855,3575842749,3575842757,8
0,330,1856,3575842749,3575842761,12
0,330,1857,3575842749,3575842764,15
0,330,1858,3575842749,3575842771,22
0,330,1859,3575842749,3575842776,27
0,330,1860,3575842749,3575842780,31
0,330,1861,3575842749,3575842786,37
0,330,1862,3575842749,3575842794,45
0,330,1863,3575842749,3575842795,46
0,331,1864,3575842802,3575842802,0
0,331,1865,3575842802,3575842804,2
0,331,1866,3575842802,3575842817,15
0,331,1867,3575842802,3575842820,18
0,331,1868,3575842802,3575842826,24
0,331,1869,3575842802,3575842832,30
0,331,1870,3575842802,3575842833,31
0,331,1871,3575842802,3575842834,32
0,331,1872,3575842802,3575842842,40
0,331,1873,3575842802,3575842842,40
0,332,1874,3575842854,3575842855,1
0,332,1875,3575842854,3575842856,2
0,332,1876,3575842854,3575842857,3
0,332,1877,3575842854,3575842867,13
0,332,1878,3575842854,3575842874,20
0,332,1879,3575842854,3575842885,31
0,332,1880,3575842854,3575842889,35
0,332,1881,3575842854,3575842889,35
0,332,1882,3575842854,3575842891,37
0,332,1883,3575842854,3575842892,38
0,332,1884,3575842854,3575842895,41
0,332,1885,3575842854,3575842895,41
0,332,1886,3575842854,3575842897,43
0,332,1887,3575842854,3575842899,45
0,332,1888,3575842854,3575842903,49
0,332,1889,3575842854,3575842904,50
0,333,1890,3575842906,3575842906,0
0,333,1891,3575842906,3575842907,1
0,333,1892,3575842906,3575842916,10
0,333,1893,3575842906,3575842917,11
0,333,1894,3575842906,3575842918,12
0,333,1895,3575842906,3575842919,13
0,333,1896,3575842906,3575842920,14
0,333,1897,3575842906,3575842923,17
0,333,1898,3575842906,3575842924,18
0,333,1899,3575842906,3575842925,19
0,333,1900,3575842906,3575842930,24
0,333,1901,3575842906,3575842934,28
0,333,1902,3575842906,3575842935,29
0,333,1903,3575842906,3575842937,31
0,333,1904,3575842906,3575842938,32
0,333,1905,3575842906,3575842942,36
0,333,1906,3575842906,3575842944,38
0,333,1907,3575842906,3575842945,39
0,333,1908,3575842906,3575842948,42
0,333,1909,3575842906,3575842948,42
0,333,1910,3575842906,3575842949,43
0,333,1911,3575842906,3575842950,44
0,333,1912,3575842906,3575842956,50
0,334,1913,3575842958,3575842958,0
0,334,1914,3575842958,3575842958,0
0,334,1915,3575842958,3575842961,3
0,334,1916,3575842958,3575842964,6
0,334,1917,3575842958,3575842976,18
0,334,1918,3575842958,3575842979,21
0,334,1919,3575842958,3575842986,28
0,334,1920,3575842958,3575842994,36
0,334,1921,3575842958,3575842996,38
0,334,1922,3575842958,3575843000,42
0,334,1923,3575842958,3575843007,49
0,335,1924,3575843011,3575843018,7
0,335,1925,3575843011,3575843020,9
0,335,1926,3575843011,3575843027,16
0,335,1927,3575843011,3575843033,22
0,335,1928,3575843011,3575843033,22
0,335,1929,3575843011,3575843034,23
0,335,1930,3575843011,3575843042,31
0,335,1931,3575843011,3575843042,31
0,335,1932,3575843011,3575843057,46
0,335,1933,3575843011,3575843058,47
0,335,1934,3575843011,3575843059,48
0,336,1935,3575843063,3575843066,3
0,336,1936,3575843063,3575843075,12
0,336,1937,3575843063,3575843085,22
0,336,1938,3575843063,3575843089,26
0,336,1939,3575843063,3575843090,27
0,336,1940,3575843063,3575843091,28
0,336,1941,3575843063,3575843095,32
0,336,1942,3575843063,3575843095,32
0,336,1943,3575843063,3575843097,34
0,336,1944,3575843063,3575843099,36
0,336,1945,3575843063,3575843103,40
0,336,1946,3575843063,3575843103,40
0,336,1947,3575843063,3575843105,42
0,336,1948,3575843063,3575843106,43
0,336,1949,3575843063,3575843110,47
0,337,1950,3575843115,3575843116,1
0,337,1951,3575843115,3575843117,2
0,337,1952,3575843115,3575843119,4
0,337,1953,3575843115,3575843120,5
0,337,1954,3575843115,3575843121,6
0,337,1955,3575843115,3575843123,8
0,337,1956,3575843115,3575843125,10
0,337,1957,3575843115,3575843126,11
0,337,1958,3575843115,3575843130,15
0,337,1959,3575843115,3575843133,18
0,337,1960,3575843115,3575843135,20
0,337,1961,3575843115,3575843138,23
0,337,1962,3575843115,3575843138,23
0,337,1963,3575843115,3575843142,27
0,337,1964,3575843115,3575843143,28
0,337,1965,3575843115,3575843145,30
0,337,1966,3575843115,3575843148,33
0,337,1967,3575843115,3575843148,33
0,337,1968,3575843115,3575843149,34
0,337,1969,3575843115,3575843150,35
0,337,1970,3575843115,3575843156,41
0,337,1971,3575843115,3575843157,42
0,337,1972,3575843115,3575843157,42
0,337,1973,3575843115,3575843161,46
0,337,1974,3575843115,3575843162,47
0,337,1975,3575843115,3575843163,48
0,338,1976,3575843167,3575843172,5
0,338,1977,3575843167,3575843176,9
0,338,1978,3575843167,3575843180,13
0,338,1979,3575843167,3575843186,19
0,338,1980,3575843167,3575843196,29
0,338,1981,3575843167,3575843201,34
0,338,1982,3575843167,3575843214,47
0,339,1983,3575843219,3575843219,0
0,339,1984,3575843219,3575843221,2
0,339,1985,3575843219,3575843227,8
0,339,1986,3575843219,3575843232,13
0,339,1987,3575843219,3575843233,14
0,339,1988,3575843219,3575843235,16
0,339,1989,3575843219,3575843242,23
0,339,1990,3575843219,3575843242,23
0,339,1991,3575843219,3575843258,39
0,339,1992,3575843219,3575843259,40
0,339,1993,3575843219,3575843264,45
0,339,1994,3575843219,3575843267,48
0,340,1995,3575843271,3575843275,4
0,340,1996,3575843271,3575843285,14
0,340,1997,3575843271,3575843289,18
0,340,1998,3575843271,3575843290,19
0,340,1999,3575843271,3575843290,19
0,340,2000,3575843271,3575843291,20
0,340,2001,3575843271,3575843295,24
0,340,2002,3575843271,3575843295,24
0,340,2003,3575843271,3575843298,27
0,340,2004,3575843271,3575843299,28
0,340,2005,3575843271,3575843303,32
0,340,2006,3575843271,3575843303,32
0,340,2007,3575843271,3575843305,34
0,340,2008,3575843271,3575843306,35
0,340,2009,3575843271,3575843310,39
0,340,2010,3575843271,3575843314,43
0,340,2011,3575843271,3575843316,45
0,340,2012,3575843271,3575843317,46
0,340,2013,3575843271,3575843319,48
0,340,2014,3575843271,3575843319,48
0,341,2015,3575843323,3575843323,0
0,341,2016,3575843323,3575843324,1
0,341,2017,3575843323,3575843325,2
0,341,2018,3575843323,3575843326,3
0,341,2019,3575843323,3575843331,8
0,341,2020,3575843323,3575843335,12
0,341,2021,3575843323,3575843336,13
0,341,2022,3575843323,3575843338,15
0,341,2023,3575843323,3575843339,16
0,341,2024,3575843323,3575843342,19
0,341,2025,3575843323,3575843343,20
0,341,2026,3575843323,3575843345,22
0,341,2027,3575843323,3575843349,26
0,341,2028,3575843323,3575843349,26
0,341,2029,3575843323,3575843349,26
0,341,2030,3575843323,3575843350,27
0,341,2031,3575843323,3575843355,32
0,341,2032,3575843323,3575843356,33
0,341,2033,3575843323,3575843357,34
0,341,2034,3575843323,3575843362,39
0,341,2035,3575843323,3575843364,41
0,341,2036,3575843323,3575843364,41
0,341,2037,3575843323,3575843372,49
0,342,2038,3575843375,3575843376,1
0,342,2039,3575843375,3575843379,4
0,342,2040,3575843375,3575843387,12
0,342,2041,3575843375,3575843397,22
0,342,2042,3575843375,3575843401,26
0,342,2043,3575843375,3575843416,41
0,342,2044,3575843375,3575843419,44
0,342,2045,3575843375,3575843420,45
0,342,2046,3575843375,3575843426,51
0,343,2047,3575843428,3575843433,5
0,343,2048,3575843428,3575843434,6
0,343,2049,3575843428,3575843435,7
0,343,2050,3575843428,3575843442,14
0,343,2051,3575843428,3575843442,14
0,343,2052,3575843428,3575843458,30
0,343,2053,3575843428,3575843460,32
0,343,2054,3575843428,3575843466,38
0,343,2055,3575843428,3575843466,38
0,343,2056,3575843428,3575843474,46
0,344,2057,3575843481,3575843484,3
0,344,2058,3575843481,3575843488,7
0,344,2059,3575843481,3575843489,8
0,344,2060,3575843481,3575843490,9
0,344,2061,3575843481,3575843494,13
0,344,2062,3575843481,3575843495,14
0,344,2063,3575843481,3575843497,16
0,344,2064,3575843481,3575843499,18
0,344,2065,3575843481,3575843502,21
0,344,2066,3575843481,3575843503,22
0,344,2067,3575843481,3575843504,23
0,344,2068,3575843481,3575843506,25
0,344,2069,3575843481,3575843509,28
0,344,2070,3575843481,3575843513,32
0,344,2071,3575843481,3575843515,34
0,344,2072,3575843481,3575843516,35
0,344,2073,3575843481,3575843517,36
0,344,2074,3575843481,3575843518,37
0,344,2075,3575843481,3575843519,38
0,344,2076,3575843481,3575843520,39
0,344,2077,3575843481,3575843523,42
0,344,2078,3575843481,3575843524,43
0,344,2079,3575843481,3575843525,44
0,344,2080,3575843481,3575843530,49
0,345,2081,3575843533,3575843534,1
0,345,2082,3575843533,3575843535,2
0,345,2083,3575843533,3575843537,4
0,345,2084,3575843533,3575843538,5
0,345,2085,3575843533,3575843541,8
0,345,2086,3575843533,3575843542,9
0,345,2087,3575843533,3575843544,11
0,345,2088,3575843533,3575843547,14
0,345,2089,3575843533,3575843548,15
0,345,2090,3575843533,3575843548,15
0,345,2091,3575843533,3575843550,17
0,345,2092,3575843533,3575843555,22
0,345,2093,3575843533,3575843555,22
0,345,2094,3575843533,3575843556,23
0,345,2095,3575843533,3575843561,28
0,345,2096,3575843533,3575843564,31
0,345,2097,3575843533,3575843567,34
0,345,2098,3575843533,3575843571,38
0,345,2099,3575843533,3575843576,43
0,345,2100,3575843533,3575843579,46
0,346,2101,3575843585,3575843585,0
0,346,2102,3575843585,3575843596,11
0,346,2103,3575843585,3575843601,16
0,346,2104,3575843585,3575843615,30
0,346,2105,3575843585,3575843617,32
0,346,2106,3575843585,3575843617,32
0,346,2107,3575843585,3575843620,35
0,346,2108,3575843585,3575843626,41
0,346,2109,3575843585,3575843632,47
0,346,2110,3575843585,3575843634,49
0,346,2111,3575843585,3575843634,49
0,347,2112,3575843637,3575843640,3
0,347,2113,3575843637,3575843641,4
0,347,2114,3575843637,3575843657,20
0,347,2115,3575843637,3575843658,21
0,347,2116,3575843637,3575843666,29
0,347,2117,3575843637,3575843668,31
0,347,2118,3575843637,3575843675,38
0,347,2119,3575843637,3575843685,48
0,348,2120,3575843689,3575843689,0
0,348,2121,3575843689,3575843689,0
0,348,2122,3575843689,3575843689,0
0,348,2123,3575843689,3575843690,1
0,348,2124,3575843689,3575843691,2
0,348,2125,3575843689,3575843695,6
0,348,2126,3575843689,3575843695,6
0,348,2127,3575843689,3575843697,8
0,348,2128,3575843689,3575843699,10
0,348,2129,3575843689,3575843703,14
0,348,2130,3575843689,3575843704,15
0,348,2131,3575843689,3575843705,16
0,348,2132,3575843689,3575843706,17
0,348,2133,3575843689,3575843709,20
0,348,2134,3575843689,3575843713,24
0,348,2135,3575843689,3575843715,26
0,348,2136,3575843689,3575843717,28
0,348,2137,3575843689,3575843718,29
0,348,2138,3575843689,3575843718,29
0,348,2139,3575843689,3575843719,30
0,348,2140,3575843689,3575843721,32
0,348,2141,3575843689,3575843723,34
0,348,2142,3575843689,3575843724,35
0,348,2143,3575843689,3575843725,36
0,348,2144,3575843689,3575843734,45
0,348,2145,3575843689,3575843735,46
0,348,2146,3575843689,3575843736,47
0,348,2147,3575843689,3575843738,49
0,349,2148,3575843741,3575843741,0
0,349,2149,3575843741,3575843743,2
0,349,2150,3575843741,3575843745,4
0,349,2151,3575843741,3575843748,7
0,349,2152,3575843741,3575843748,7
0,349,2153,3575843741,3575843749,8
0,349,2154,3575843741,3575843750,9
0,349,2155,3575843741,3575843755,14
0,349,2156,3575843741,3575843756,15
0,349,2157,3575843741,3575843756,15
0,349,2158,3575843741,3575843761,20
0,349,2159,3575843741,3575843764,23
0,349,2160,3575843741,3575843769,28
0,349,2161,3575843741,3575843771,30
0,349,2162,3575843741,3575843771,30
0,349,2163,3575843741,3575843776,35
0,349,2164,3575843741,3575843779,38
0,349,2165,3575843741,3575843786,45
0,350,2166,3575843793,3575843793,0
0,350,2167,3575843793,3575843796,3
0,350,2168,3575843793,3575843800,7
0,350,2169,3575843793,3575843815,22
0,350,2170,3575843793,3575843818,25
0,350,2171,3575843793,3575843819,26
0,350,2172,3575843793,3575843820,27
0,350,2173,3575843793,3575843826,33
0,350,2174,3575843793,3575843832,39
0,350,2175,3575843793,3575843834,41
0,350,2176,3575843793,3575843834,41
0,350,2177,3575843793,3575843842,49
0,350,2178,3575843793,3575843842,49
0,351,2179,3575843845,3575843857,12
0,351,2180,3575843845,3575843859,14
0,351,2181,3575843845,3575843867,22
0,351,2182,3575843845,3575843868,23
0,351,2183,3575843845,3575843871,26
0,351,2184,3575843845,3575843876,31
0,351,2185,3575843845,3575843885,40
0,351,2186,3575843845,3575843888,43
0,351,2187,3575843845,3575843889,44
0,351,2188,3575843845,3575843889,44
0,351,2189,3575843845,3575843890,45
0,351,2190,3575843845,3575843890,45
0,351,2191,3575843845,3575843894,49
0,351,2192,3575843845,3575843895,50
0,352,2193,3575843897,3575843898,1
0,352,2194,3575843897,3575843899,2
0,352,2195,3575843897,3575843903,6
0,352,2196,3575843897,3575843903,6
0,352,2197,3575843897,3575843904,7
0,352,2198,3575843897,3575843907,10
0,352,2199,3575843897,3575843909,12
0,352,2200,3575843897,3575843914,17
0,352,2201,3575843897,3575843917,20
0,352,2202,3575843897,3575843918,21
0,352,2203,3575843897,3575843918,21
0,352,2204,3575843897,3575843919,22
0,352,2205,3575843897,3575843919,22
0,352,2206,3575843897,3575843920,23
0,352,2207,3575843897,3575843921,24
0,352,2208,3575843897,3575843923,26
0,352,2209,3575843897,3575843925,28
0,352,2210,3575843897,3575843926,29
0,352,2211,3575843897,3575843934,37
0,352,2212,3575843897,3575843935,38
0,352,2213,3575843897,3575843937,40
0,352,2214,3575843897,3575843937,40
0,352,2215,3575843897,3575843942,45
0,352,2216,3575843897,3575843944,47
0,352,2217,3575843897,3575843945,48
0,353,2218,3575843949,3575843949,0
0,353,2219,3575843949,3575843949,0
0,353,2220,3575843949,3575843949,0
0,353,2221,3575843949,3575843950,1
0,353,2222,3575843949,3575843956,7
0,353,2223,3575843949,3575843956,7
0,353,2224,3575843949,3575843957,8
0,353,2225,3575843949,3575843961,12
0,353,2226,3575843949,3575843965,16
0,353,2227,3575843949,3575843971,22
0,353,2228,3575843949,3575843971,22
0,353,2229,3575843949,3575843972,23
0,353,2230,3575843949,3575843976,27
0,353,2231,3575843949,3575843979,30
0,353,2232,3575843949,3575843986,37
0,353,2233,3575843949,3575843994,45
0,353,2234,3575843949,3575843995,46
0,354,2235,3575844001,3575844001,0
0,354,2236,3575844001,3575844015,14
0,354,2237,3575844001,3575844018,17
0,354,2238,3575844001,3575844021,20
0,354,2239,3575844001,3575844023,22
0,354,2240,3575844001,3575844027,26
0,354,2241,3575844001,3575844033,32
0,354,2242,3575844001,3575844034,33
0,354,2243,3575844001,3575844034,33
0,354,2244,3575844001,3575844042,41
0,354,2245,3575844001,3575844042,41
0,355,2246,3575844054,3575844057,3
0,355,2247,3575844054,3575844058,4
0,355,2248,3575844054,3575844067,13
0,355,2249,3575844054,3575844068,14
0,355,2250,3575844054,3575844071,17
0,355,2251,3575844054,3575844074,20
0,355,2252,3575844054,3575844076,22
0,355,2253,3575844054,3575844085,31
0,355,2254,3575844054,3575844089,35
0,355,2255,3575844054,3575844089,35
0,355,2256,3575844054,3575844090,36
0,355,2257,3575844054,3575844090,36
0,355,2258,3575844054,3575844095,41
0,355,2259,3575844054,3575844096,42
0,355,2260,3575844054,3575844097,43
0,355,2261,3575844054,3575844099,45
0,355,2262,3575844054,3575844102,48
0,355,2263,3575844054,3575844103,49
0,355,2264,3575844054,3575844104,50
0,356,2265,3575844106,3575844108,2
0,356,2266,3575844106,3575844109,3
0,356,2267,3575844106,3575844114,8
0,356,2268,3575844106,3575844117,11
0,356,2269,3575844106,3575844117,11
0,356,2270,3575844106,3575844119,13
0,356,2271,3575844106,3575844120,14
0,356,2272,3575844106,3575844120,14
0,356,2273,3575844106,3575844121,15
0,356,2274,3575844106,3575844123,17
0,356,2275,3575844106,3575844124,18
0,356,2276,3575844106,3575844124,18
0,356,2277,3575844106,3575844125,19
0,356,2278,3575844106,3575844134,28
0,356,2279,3575844106,3575844136,30
0,356,2280,3575844106,3575844136,30
0,356,2281,3575844106,3575844137,31
0,356,2282,3575844106,3575844143,37
0,356,2283,3575844106,3575844144,38
0,356,2284,3575844106,3575844145,39
0,356,2285,3575844106,3575844147,41
0,356,2286,3575844106,3575844149,43
0,356,2287,3575844106,3575844149,43
0,356,2288,3575844106,3575844151,45
0,356,2289,3575844106,3575844155,49
0,357,2290,3575844158,3575844158,0
0,357,2291,3575844158,3575844158,0
0,357,2292,3575844158,3575844161,3
0,357,2293,3575844158,3575844165,7
0,357,2294,3575844158,3575844172,14
0,357,2295,3575844158,3575844172,14
0,357,2296,3575844158,3575844172,14
0,357,2297,3575844158,3575844175,17
0,357,2298,3575844158,3575844176,18
0,357,2299,3575844158,3575844179,21
0,357,2300,3575844158,3575844186,28
0,357,2301,3575844158,3575844195,37
0,357,2302,3575844158,3575844196,38
0,357,2303,3575844158,3575844201,43
0,358,2304,3575844210,3575844214,4
0,358,2305,3575844210,3575844218,8
0,358,2306,3575844210,3575844221,11
0,358,2307,3575844210,3575844225,15
0,358,2308,3575844210,3575844227,17
0,358,2309,3575844210,3575844233,23
0,358,2310,3575844210,3575844234,24
0,358,2311,3575844210,3575844236,26
0,358,2312,3575844210,3575844242,32
0,358,2313,3575844210,3575844242,32
0,358,2314,3575844210,3575844257,47
0,358,2315,3575844210,3575844259,49
0,359,2316,3575844262,3575844266,4
0,359,2317,3575844262,3575844268,6
0,359,2318,3575844262,3575844271,9
0,359,2319,3575844262,3575844276,14
0,359,2320,3575844262,3575844276,14
0,359,2321,3575844262,3575844285,23
0,359,2322,3575844262,3575844288,26
0,359,2323,3575844262,3575844289,27
0,359,2324,3575844262,3575844289,27
0,359,2325,3575844262,3575844290,28
0,359,2326,3575844262,3575844290,28
0,359,2327,3575844262,3575844295,33
0,359,2328,3575844262,3575844296,34
0,359,2329,3575844262,3575844298,36
0,359,2330,3575844262,3575844299,37
0,359,2331,3575844262,3575844302,40
0,359,2332,3575844262,3575844303,41
0,359,2333,3575844262,3575844304,42
0,359,2334,3575844262,3575844307,45
0,359,2335,3575844262,3575844309,47
0,360,2336,3575844314,3575844314,0
0,360,2337,3575844314,3575844317,3
0,360,2338,3575844314,3575844318,4
0,360,2339,3575844314,3575844319,5
0,360,2340,3575844314,3575844319,5
0,360,2341,3575844314,3575844319,5
0,360,2342,3575844314,3575844321,7
0,360,2343,3575844314,3575844324,10
0,360,2344,3575844314,3575844324,10
0,360,2345,3575844314,3575844324,10
0,360,2346,3575844314,3575844325,11
0,360,2347,3575844314,3575844327,13
0,360,2348,3575844314,3575844335,21
0,360,2349,3575844314,3575844336,22
0,360,2350,3575844314,3575844337,23
0,360,2351,3575844314,3575844337,23
0,360,2352,3575844314,3575844343,29
0,360,2353,3575844314,3575844344,30
0,360,2354,3575844314,3575844345,31
0,360,2355,3575844314,3575844348,34
0,360,2356,3575844314,3575844348,34
0,360,2357,3575844314,3575844349,35
0,360,2358,3575844314,3575844350,36
0,360,2359,3575844314,3575844356,42
0,360,2360,3575844314,3575844356,42
0,360,2361,3575844314,3575844357,43
0,360,2362,3575844314,3575844362,48
0,361,2363,3575844366,3575844366,0
0,361,2364,3575844366,3575844372,6
0,361,2365,3575844366,3575844372,6
0,361,2366,3575844366,3575844373,7
0,361,2367,3575844366,3575844376,10
0,361,2368,3575844366,3575844377,11
0,361,2369,3575844366,3575844379,13
0,361,2370,3575844366,3575844387,21
0,361,2371,3575844366,3575844395,29
0,361,2372,3575844366,3575844396,30
0,361,2373,3575844366,3575844401,35
0,361,2374,3575844366,3575844415,49
0,362,2375,3575844418,3575844418,0
0,362,2376,3575844418,3575844420,2
0,362,2377,3575844418,3575844427,9
0,362,2378,3575844418,3575844428,10
0,362,2379,3575844418,3575844433,15
0,362,2380,3575844418,3575844433,15
0,362,2381,3575844418,3575844435,17
0,362,2382,3575844418,3575844442,24
0,362,2383,3575844418,3575844442,24
0,362,2384,3575844418,3575844457,39
0,362,2385,3575844418,3575844459,41
0,362,2386,3575844418,3575844467,49
0,363,2387,3575844470,3575844470,0
0,363,2388,3575844470,3575844471,1
0,363,2389,3575844470,3575844476,6
0,363,2390,3575844470,3575844479,9
0,363,2391,3575844470,3575844485,15
0,363,2392,3575844470,3575844489,19
0,363,2393,3575844470,3575844490,20
0,363,2394,3575844470,3575844490,20
0,363,2395,3575844470,3575844491,21
0,363,2396,3575844470,3575844495,25
0,363,2397,3575844470,3575844497,27
0,363,2398,3575844470,3575844498,28
0,363,2399,3575844470,3575844500,30
0,363,2400,3575844470,3575844502,32
0,363,2401,3575844470,3575844504,34
0,363,2402,3575844470,3575844505,35
0,363,2403,3575844470,3575844508,38
0,363,2404,3575844470,3575844509,39
0,363,2405,3575844470,3575844514,44
0,363,2406,3575844470,3575844517,47
0,363,2407,3575844470,3575844517,47
0,363,2408,3575844470,3575844519,49
0,363,2409,3575844470,3575844519,49
0,363,2410,3575844470,3575844520,50
0,364,2411,3575844522,3575844522,0
0,364,2412,3575844522,3575844523,1
0,364,2413,3575844522,3575844523,1
0,364,2414,3575844522,3575844524,2
0,364,2415,3575844522,3575844525,3
0,364,2416,3575844522,3575844526,4
0,364,2417,3575844522,3575844529,7
0,364,2418,3575844522,3575844529,7
0,364,2419,3575844522,3575844534,12
0,364,2420,3575844522,3575844535,13
0,364,2421,3575844522,3575844536,14
0,364,2422,3575844522,3575844537,15
0,364,2423,3575844522,3575844542,20
0,364,2424,3575844522,3575844543,21
0,364,2425,3575844522,3575844544,22
0,364,2426,3575844522,3575844547,25
0,364,2427,3575844522,3575844547,25
0,364,2428,3575844522,3575844548,26
0,364,2429,3575844522,3575844550,28
0,364,2430,3575844522,3575844555,33
0,364,2431,3575844522,3575844555,33
0,364,2432,3575844522,3575844556,34
0,364,2433,3575844522,3575844561,39
0,364,2434,3575844522,3575844564,42
0,364,2435,3575844522,3575844571,49
0,364,2436,3575844522,3575844571,49
0,365,2437,3575844574,3575844576,2
0,365,2438,3575844574,3575844578,4
0,365,2439,3575844574,3575844580,6
0,365,2440,3575844574,3575844586,12
0,365,2441,3575844574,3575844594,20
0,365,2442,3575844574,3575844595,21
0,365,2443,3575844574,3575844601,27
0,365,2444,3575844574,3575844614,40
0,365,2445,3575844574,3575844617,43
0,365,2446,3575844574,3575844620,46
0,366,2447,3575844626,3575844627,1
0,366,2448,3575844626,3575844630,4
0,366,2449,3575844626,3575844632,6
0,366,2450,3575844626,3575844632,6
0,366,2451,3575844626,3575844634,8
0,366,2452,3575844626,3575844641,15
0,366,2453,3575844626,3575844641,15
0,366,2454,3575844626,3575844656,30
0,366,2455,3575844626,3575844658,32
0,366,2456,3575844626,3575844666,40
0,366,2457,3575844626,3575844668,42
0,366,2458,3575844626,3575844670,44
0,366,2459,3575844626,3575844676,50
0,367,2460,3575844678,3575844681,3
0,367,2461,3575844678,3575844685,7
0,367,2462,3575844678,3575844688,10
0,367,2463,3575844678,3575844689,11
0,367,2464,3575844678,3575844690,12
0,367,2465,3575844678,3575844691,13
0,367,2466,3575844678,3575844691,13
0,367,2467,3575844678,3575844695,17
0,367,2468,3575844678,3575844696,18
0,367,2469,3575844678,3575844699,21
0,367,2470,3575844678,3575844700,22
0,367,2471,3575844678,3575844703,25
0,367,2472,3575844678,3575844703,25
0,367,2473,3575844678,3575844704,26
0,367,2474,3575844678,3575844707,29
0,367,2475,3575844678,3575844710,32
0,367,2476,3575844678,3575844714,36
0,367,2477,3575844678,3575844718,40
0,367,2478,3575844678,3575844718,40
0,367,2479,3575844678,3575844719,41
0,367,2480,3575844678,3575844719,41
0,367,2481,3575844678,3575844720,42
0,367,2482,3575844678,3575844722,44
0,367,2483,3575844678,3575844723,45
0,367,2484,3575844678,3575844723,45
0,367,2485,3575844678,3575844723,45
0,367,2486,3575844678,3575844725,47
0,367,2487,3575844678,3575844726,48
0,368,2488,3575844730,3575844730,0
0,368,2489,3575844730,3575844731,1
0,368,2490,3575844730,3575844732,2
0,368,2491,3575844730,3575844734,4
0,368,2492,3575844730,3575844736,6
0,368,2493,3575844730,3575844736,6
0,368,2494,3575844730,3575844737,7
0,368,2495,3575844730,3575844742,12
0,368,2496,3575844730,3575844745,15
0,368,2497,3575844730,3575844747,17
0,368,2498,3575844730,3575844748,18
0,368,2499,3575844730,3575844748,18
0,368,2500,3575844730,3575844751,21
0,368,2501,3575844730,3575844755,25
0,368,2502,3575844730,3575844755,25
0,368,2503,3575844730,3575844756,26
0,368,2504,3575844730,3575844761,31
0,368,2505,3575844730,3575844765,35
0,368,2506,3575844730,3575844771,41
0,368,2507,3575844730,3575844771,41
0,368,2508,3575844730,3575844776,46
0,368,2509,3575844730,3575844779,49
0,368,2510,3575844730,3575844780,50
0,369,2511,3575844782,3575844782,0
0,369,2512,3575844782,3575844786,4
0,369,2513,3575844782,3575844794,12
0,369,2514,3575844782,3575844795,13
0,369,2515,3575844782,3575844801,19
0,369,2516,3575844782,3575844814,32
0,369,2517,3575844782,3575844816,34
0,369,2518,3575844782,3575844820,38
0,369,2519,3575844782,3575844826,44
0,369,2520,3575844782,3575844831,49
0,370,2521,3575844835,3575844835,0
0,370,2522,3575844835,3575844835,0
0,370,2523,3575844835,3575844835,0
0,370,2524,3575844835,3575844835,0
0,370,2525,3575844835,3575844842,7
0,370,2526,3575844835,3575844842,7
0,370,2527,3575844835,3575844856,21
0,370,2528,3575844835,3575844859,24
0,370,2529,3575844835,3575844866,31
0,370,2530,3575844835,3575844869,34
0,370,2531,3575844835,3575844870,35
0,370,2532,3575844835,3575844876,41
0,370,2533,3575844835,3575844884,49
0,371,2534,3575844888,3575844888,0
0,371,2535,3575844888,3575844888,0
0,371,2536,3575844888,3575844890,2
0,371,2537,3575844888,3575844891,3
0,371,2538,3575844888,3575844891,3
0,371,2539,3575844888,3575844896,8
0,371,2540,3575844888,3575844897,9
0,371,2541,3575844888,3575844898,10
0,371,2542,3575844888,3575844900,12
0,371,2543,3575844888,3575844903,15
0,371,2544,3575844888,3575844904,16
0,371,2545,3575844888,3575844904,16
0,371,2546,3575844888,3575844908,20
0,371,2547,3575844888,3575844910,22
0,371,2548,3575844888,3575844914,26
0,371,2549,3575844888,3575844917,29
0,371,2550,3575844888,3575844918,30
0,371,2551,3575844888,3575844919,31
0,371,2552,3575844888,3575844919,31
0,371,2553,3575844888,3575844920,32
0,371,2554,3575844888,3575844922,34
0,371,2555,3575844888,3575844923,35
0,371,2556,3575844888,3575844923,35
0,371,2557,3575844888,3575844923,35
0,371,2558,3575844888,3575844926,38
0,371,2559,3575844888,3575844926,38
0,371,2560,3575844888,3575844929,41
0,371,2561,3575844888,3575844931,43
0,371,2562,3575844888,3575844934,46
0,371,2563,3575844888,3575844935,47
0,371,2564,3575844888,3575844935,47
0,371,2565,3575844888,3575844936,48
0,371,2566,3575844888,3575844936,48
0,372,2567,3575844941,3575844943,2
0,372,2568,3575844941,3575844945,4
0,372,2569,3575844941,3575844947,6
0,372,2570,3575844941,3575844947,6
0,372,2571,3575844941,3575844948,7
0,372,2572,3575844941,3575844950,9
0,372,2573,3575844941,3575844955,14
0,372,2574,3575844941,3575844955,14
0,372,2575,3575844941,3575844957,16
0,372,2576,3575844941,3575844961,20
0,372,2577,3575844941,3575844965,24
0,372,2578,3575844941,3575844971,30
0,372,2579,3575844941,3575844972,31
0,372,2580,3575844941,3575844976,35
0,372,2581,3575844941,3575844980,39
0,372,2582,3575844941,3575844980,39
0,372,2583,3575844941,3575844986,45
0,372,2584,3575844941,3575844986,45
0,373,2585,3575844993,3575844994,1
0,373,2586,3575844993,3575844995,2
0,373,2587,3575844993,3575845001,8
0,373,2588,3575844993,3575845014,21
0,373,2589,3575844993,3575845018,25
0,373,2590,3575844993,3575845020,27
0,373,2591,3575844993,3575845027,34
0,373,2592,3575844993,3575845030,37
0,373,2593,3575844993,3575845032,39
0,373,2594,3575844993,3575845033,40
0,373,2595,3575844993,3575845033,40
0,373,2596,3575844993,3575845034,41
0,373,2597,3575844993,3575845037,44
0,373,2598,3575844993,3575845042,49
0,373,2599,3575844993,3575845043,50
0,374,2600,3575845045,3575845057,12
0,374,2601,3575845045,3575845059,14
0,374,2602,3575845045,3575845067,22
0,374,2603,3575845045,3575845069,24
0,374,2604,3575845045,3575845070,25
0,374,2605,3575845045,3575845076,31
0,374,2606,3575845045,3575845086,41
0,374,2607,3575845045,3575845086,41
0,374,2608,3575845045,3575845089,44
0,374,2609,3575845045,3575845089,44
0,374,2610,3575845045,3575845090,45
0,374,2611,3575845045,3575845090,45
0,374,2612,3575845045,3575845091,46
0,375,2613,3575845097,3575845097,0
0,375,2614,3575845097,3575845097,0
0,375,2615,3575845097,3575845099,2
0,375,2616,3575845097,3575845100,3
0,375,2617,3575845097,3575845102,5
0,375,2618,3575845097,3575845105,8
0,375,2619,3575845097,3575845107,10
0,375,2620,3575845097,3575845113,16
0,375,2621,3575845097,3575845118,21
0,375,2622,3575845097,3575845118,21
0,375,2623,3575845097,3575845119,22
0,375,2624,3575845097,3575845119,22
0,375,2625,3575845097,3575845121,24
0,375,2626,3575845097,3575845121,24
0,375,2627,3575845097,3575845123,26
0,375,2628,3575845097,3575845123,26
0,375,2629,3575845097,3575845123,26
0,375,2630,3575845097,3575845125,28
0,375,2631,3575845097,3575845126,29
0,375,2632,3575845097,3575845129,32
0,375,2633,3575845097,3575845131,34
0,375,2634,3575845097,3575845133,36
0,375,2635,3575845097,3575845136,39
0,375,2636,3575845097,3575845136,39
0,375,2637,3575845097,3575845136,39
0,375,2638,3575845097,3575845137,40
0,375,2639,3575845097,3575845143,46
0,375,2640,3575845097,3575845143,46
0,375,2641,3575845097,3575845145,48
0,376,2642,3575845150,3575845150,0
0,376,2643,3575845150,3575845150,0
0,376,2644,3575845150,3575845150,0
0,376,2645,3575845150,3575845150,0
0,376,2646,3575845150,3575845155,5
0,376,2647,3575845150,3575845156,6
0,376,2648,3575845150,3575845156,6
0,376,2649,3575845150,3575845161,11
0,376,2650,3575845150,3575845165,15
0,376,2651,3575845150,3575845171,21
0,376,2652,3575845150,3575845171,21
0,376,2653,3575845150,3575845172,22
0,376,2654,3575845150,3575845176,26
0,376,2655,3575845150,3575845179,29
0,376,2656,3575845150,3575845179,29
0,376,2657,3575845150,3575845186,36
0,376,2658,3575845150,3575845188,38
0,376,2659,3575845150,3575845194,44
0,376,2660,3575845150,3575845197,47
0,377,2661,3575845203,3575845203,0
0,377,2662,3575845203,3575845213,10
0,377,2663,3575845203,3575845218,15
0,377,2664,3575845203,3575845221,18
0,377,2665,3575845203,3575845226,23
0,377,2666,3575845203,3575845231,28
0,377,2667,3575845203,3575845232,29
0,377,2668,3575845203,3575845233,30
0,377,2669,3575845203,3575845233,30
0,377,2670,3575845203,3575845235,32
0,377,2671,3575845203,3575845238,35
0,377,2672,3575845203,3575845242,39
0,377,2673,3575845203,3575845243,40
0,378,2674,3575845255,3575845257,2
0,378,2675,3575845255,3575845260,5
0,378,2676,3575845255,3575845266,11
0,378,2677,3575845255,3575845268,13
0,378,2678,3575845255,3575845270,15
0,378,2679,3575845255,3575845275,20
0,378,2680,3575845255,3575845285,30
0,378,2681,3575845255,3575845289,34
0,378,2682,3575845255,3575845289,34
0,378,2683,3575845255,3575845289,34
0,378,2684,3575845255,3575845290,35
0,378,2685,3575845255,3575845291,36
0,378,2686,3575845255,3575845291,36
0,378,2687,3575845255,3575845296,41
0,378,2688,3575845255,3575845297,42
0,378,2689,3575845255,3575845299,44
0,378,2690,3575845255,3575845300,45
0,378,2691,3575845255,3575845303,48
0,378,2692,3575845255,3575845305,50
0,379,2693,3575845307,3575845307,0
0,379,2694,3575845307,3575845314,7
0,379,2695,3575845307,3575845318,11
0,379,2696,3575845307,3575845319,12
0,379,2697,3575845307,3575845319,12
0,379,2698,3575845307,3575845320,13
0,379,2699,3575845307,3575845321,14
0,379,2700,3575845307,3575845322,15
0,379,2701,3575845307,3575845323,16
0,379,2702,3575845307,3575845324,17
0,379,2703,3575845307,3575845325,18
0,379,2704,3575845307,3575845326,19
0,379,2705,3575845307,3575845327,20
0,379,2706,3575845307,3575845329,22
0,379,2707,3575845307,3575845330,23
0,379,2708,3575845307,3575845335,28
0,379,2709,3575845307,3575845336,29
0,379,2710,3575845307,3575845337,30
0,379,2711,3575845307,3575845337,30
0,379,2712,3575845307,3575845337,30
0,379,2713,3575845307,3575845340,33
0,379,2714,3575845307,3575845343,36
0,379,2715,3575845307,3575845344,37
0,379,2716,3575845307,3575845345,38
0,379,2717,3575845307,3575845348,41
0,379,2718,3575845307,3575845348,41
0,379,2719,3575845307,3575845349,42
0,379,2720,3575845307,3575845351,44
0,379,2721,3575845307,3575845355,48
0,379,2722,3575845307,3575845356,49
0,379,2723,3575845307,3575845357,50
0,380,2724,3575845359,3575845365,6
0,380,2725,3575845359,3575845371,12
0,380,2726,3575845359,3575845372,13
0,380,2727,3575845359,3575845373,14
0,380,2728,3575845359,3575845376,17
0,380,2729,3575845359,3575845380,21
0,380,2730,3575845359,3575845380,21
0,380,2731,3575845359,3575845387,28
0,380,2732,3575845359,3575845387,28
0,380,2733,3575845359,3575845390,31
0,380,2734,3575845359,3575845394,35
0,380,2735,3575845359,3575845397,38
0,380,2736,3575845359,3575845401,42
0,381,2737,3575845411,3575845415,4
0,381,2738,3575845411,3575845417,6
0,381,2739,3575845411,3575845420,9
0,381,2740,3575845411,3575845427,16
0,381,2741,3575845411,3575845430,19
0,381,2742,3575845411,3575845432,21
0,381,2743,3575845411,3575845433,22
0,381,2744,3575845411,3575845434,23
0,381,2745,3575845411,3575845435,24
0,381,2746,3575845411,3575845441,30
0,381,2747,3575845411,3575845442,31
0,381,2748,3575845411,3575845443,32
0,381,2749,3575845411,3575845457,46
0,381,2750,3575845411,3575845460,49
0,382,2751,3575845463,3575845466,3
0,382,2752,3575845463,3575845469,6
0,382,2753,3575845463,3575845470,7
0,382,2754,3575845463,3575845476,13
0,382,2755,3575845463,3575845485,22
0,382,2756,3575845463,3575845489,26
0,382,2757,3575845463,3575845490,27
0,382,2758,3575845463,3575845491,28
0,382,2759,3575845463,3575845491,28
0,382,2760,3575845463,3575845491,28
0,382,2761,3575845463,3575845496,33
0,382,2762,3575845463,3575845498,35
0,382,2763,3575845463,3575845498,35
0,382,2764,3575845463,3575845500,37
0,382,2765,3575845463,3575845503,40
0,382,2766,3575845463,3575845504,41
0,382,2767,3575845463,3575845505,42
0,382,2768,3575845463,3575845507,44
0,382,2769,3575845463,3575845510,47
0,383,2770,3575845515,3575845515,0
0,383,2771,3575845515,3575845517,2
0,383,2772,3575845515,3575845518,3
0,383,2773,3575845515,3575845519,4
0,383,2774,3575845515,3575845519,4
0,383,2775,3575845515,3575845520,5
0,383,2776,3575845515,3575845521,6
0,383,2777,3575845515,3575845522,7
0,383,2778,3575845515,3575845524,9
0,383,2779,3575845515,3575845524,9
0,383,2780,3575845515,3575845526,11
0,383,2781,3575845515,3575845526,11
0,383,2782,3575845515,3575845528,13
0,383,2783,3575845515,3575845530,15
0,383,2784,3575845515,3575845534,19
0,383,2785,3575845515,3575845536,21
0,383,2786,3575845515,3575845537,22
0,383,2787,3575845515,3575845537,22
0,383,2788,3575845515,3575845537,22
0,383,2789,3575845515,3575845538,23
0,383,2790,3575845515,3575845541,26
0,383,2791,3575845515,3575845542,27
0,383,2792,3575845515,3575845543,28
0,383,2793,3575845515,3575845544,29
0,383,2794,3575845515,3575845546,31
0,383,2795,3575845515,3575845547,32
0,383,2796,3575845515,3575845547,32
0,383,2797,3575845515,3575845550,35
0,383,2798,3575845515,3575845554,39
0,383,2799,3575845515,3575845556,41
0,383,2800,3575845515,3575845556,41
0,383,2801,3575845515,3575845561,46
0,383,2802,3575845515,3575845564,49
0,384,2803,3575845567,3575845571,4
0,384,2804,3575845567,3575845571,4
0,384,2805,3575845567,3575845572,5
0,384,2806,3575845567,3575845576,9
0,384,2807,3575845567,3575845578,11
0,384,2808,3575845567,3575845579,12
0,384,2809,3575845567,3575845586,19
0,384,2810,3575845567,3575845587,20
0,384,2811,3575845567,3575845593,26
0,384,2812,3575845567,3575845593,26
0,384,2813,3575845567,3575845596,29
0,384,2814,3575845567,3575845601,34
0,384,2815,3575845567,3575845615,48
0,384,2816,3575845567,3575845617,50
0,385,2817,3575845619,3575845620,1
0,385,2818,3575845619,3575845627,8
0,385,2819,3575845619,3575845630,11
0,385,2820,3575845619,3575845632,13
0,385,2821,3575845619,3575845632,13
0,385,2822,3575845619,3575845632,13
0,385,2823,3575845619,3575845635,16
0,385,2824,3575845619,3575845641,22
0,385,2825,3575845619,3575845641,22
0,385,2826,3575845619,3575845643,24
0,385,2827,3575845619,3575845657,38
0,385,2828,3575845619,3575845658,39
0,385,2829,3575845619,3575845666,47
0,385,2830,3575845619,3575845668,49
0,386,2831,3575845671,3575845671,0
0,386,2832,3575845671,3575845676,5
0,386,2833,3575845671,3575845685,14
0,386,2834,3575845671,3575845688,17
0,386,2835,3575845671,3575845689,18
0,386,2836,3575845671,3575845690,19
0,386,2837,3575845671,3575845690,19
0,386,2838,3575845671,3575845691,20
0,386,2839,3575845671,3575845691,20
0,386,2840,3575845671,3575845691,20
0,386,2841,3575845671,3575845694,23
0,386,2842,3575845671,3575845696,25
0,386,2843,3575845671,3575845697,26
0,386,2844,3575845671,3575845698,27
0,386,2845,3575845671,3575845700,29
0,386,2846,3575845671,3575845703,32
0,386,2847,3575845671,3575845704,33
0,386,2848,3575845671,3575845705,34
0,386,2849,3575845671,3575845707,36
0,386,2850,3575845671,3575845710,39
0,386,2851,3575845671,3575845714,43
0,386,2852,3575845671,3575845717,46
0,386,2853,3575845671,3575845718,47
0,386,2854,3575845671,3575845719,48
0,386,2855,3575845671,3575845719,48
0,386,2856,3575845671,3575845720,49
0,387,2857,3575845723,3575845723,0
0,387,2858,3575845723,3575845723,0
0,387,2859,3575845723,3575845724,1
0,387,2860,3575845723,3575845724,1
0,387,2861,3575845723,3575845725,2
0,387,2862,3575845723,3575845726,3
0,387,2863,3575845723,3575845728,5
0,387,2864,3575845723,3575845730,7
0,387,2865,3575845723,3575845734,11
0,387,2866,3575845723,3575845736,13
0,387,2867,3575845723,3575845737,14
0,387,2868,3575845723,3575845737,14
0,387,2869,3575845723,3575845737,14
0,387,2870,3575845723,3575845738,15
0,387,2871,3575845723,3575845742,19
0,387,2872,3575845723,3575845742,19
0,387,2873,3575845723,3575845743,20
0,387,2874,3575845723,3575845744,21
0,387,2875,3575845723,3575845745,22
0,387,2876,3575845723,3575845746,23
0,387,2877,3575845723,3575845747,24
0,387,2878,3575845723,3575845747,24
0,387,2879,3575845723,3575845750,27
0,387,2880,3575845723,3575845754,31
0,387,2881,3575845723,3575845756,33
0,387,2882,3575845723,3575845756,33
0,387,2883,3575845723,3575845761,38
0,387,2884,3575845723,3575845764,41
0,387,2885,3575845723,3575845770,47
0,387,2886,3575845723,3575845771,48
0,388,2887,3575845775,3575845776,1
0,388,2888,3575845775,3575845779,4
0,388,2889,3575845775,3575845780,5
0,388,2890,3575845775,3575845786,11
0,388,2891,3575845775,3575845788,13
0,388,2892,3575845775,3575845793,18
0,388,2893,3575845775,3575845795,20
0,388,2894,3575845775,3575845796,21
0,388,2895,3575845775,3575845815,40
0,388,2896,3575845775,3575845820,45
0,389,2897,3575845827,3575845827,0
0,389,2898,3575845827,3575845830,3
0,389,2899,3575845827,3575845831,4
0,389,2900,3575845827,3575845832,5
0,389,2901,3575845827,3575845833,6
0,389,2902,3575845827,3575845834,7
0,389,2903,3575845827,3575845841,14
0,389,2904,3575845827,3575845842,15
0,389,2905,3575845827,3575845843,16
0,389,2906,3575845827,3575845846,19
0,389,2907,3575845827,3575845857,30
0,389,2908,3575845827,3575845858,31
0,389,2909,3575845827,3575845867,40
0,389,2910,3575845827,3575845868,41
0,389,2911,3575845827,3575845870,43
0,389,2912,3575845827,3575845876,49
0,390,2913,3575845879,3575845885,6
0,390,2914,3575845879,3575845888,9
0,390,2915,3575845879,3575845889,10
0,390,2916,3575845879,3575845890,11
0,390,2917,3575845879,3575845890,11
0,390,2918,3575845879,3575845890,11
0,390,2919,3575845879,3575845891,12
0,390,2920,3575845879,3575845892,13
0,390,2921,3575845879,3575845896,17
0,390,2922,3575845879,3575845897,18
0,390,2923,3575845879,3575845898,19
0,390,2924,3575845879,3575845899,20
0,390,2925,3575845879,3575845900,21
0,390,2926,3575845879,3575845902,23
0,390,2927,3575845879,3575845905,26
0,390,2928,3575845879,3575845905,26
0,390,2929,3575845879,3575845907,28
0,390,2930,3575845879,3575845910,31
0,390,2931,3575845879,3575845914,35
0,390,2932,3575845879,3575845918,39
0,390,2933,3575845879,3575845918,39
0,390,2934,3575845879,3575845919,40
0,390,2935,3575845879,3575845919,40
0,390,2936,3575845879,3575845920,41
0,390,2937,3575845879,3575845920,41
0,390,2938,3575845879,3575845922,43
0,390,2939,3575845879,3575845923,44
0,390,2940,3575845879,3575845925,46
0,390,2941,3575845879,3575845925,46
0,390,2942,3575845879,3575845925,46
0,390,2943,3575845879,3575845929,50
0,391,2944,3575845931,3575845931,0
0,391,2945,3575845931,3575845934,3
0,391,2946,3575845931,3575845936,5
0,391,2947,3575845931,3575845937,6
0,391,2948,3575845931,3575845937,6
0,391,2949,3575845931,3575845938,7
0,391,2950,3575845931,3575845939,8
0,391,2951,3575845931,3575845942,11
0,391,2952,3575845931,3575845943,12
0,391,2953,3575845931,3575845943,12
0,391,2954,3575845931,3575845944,13
0,391,2955,3575845931,3575845947,16
0,391,2956,3575845931,3575845947,16
0,391,2957,3575845931,3575845947,16
0,391,2958,3575845931,3575845948,17
0,391,2959,3575845931,3575845951,20
0,391,2960,3575845931,3575845955,24
0,391,2961,3575845931,3575845956,25
0,391,2962,3575845931,3575845957,26
0,391,2963,3575845931,3575845961,30
0,391,2964,3575845931,3575845964,33
0,391,2965,3575845931,3575845971,40
0,391,2966,3575845931,3575845972,41
0,391,2967,3575845931,3575845975,44
0,391,2968,3575845931,3575845979,48
0,391,2969,3575845931,3575845979,48
0,392,2970,3575845983,3575845986,3
0,392,2971,3575845983,3575845987,4
0,392,2972,3575845983,3575845995,12
0,392,2973,3575845983,3575845996,13
0,392,2974,3575845983,3575845998,15
0,392,2975,3575845983,3575846015,32
0,392,2976,3575845983,3575846020,37
0,392,2977,3575845983,3575846027,44
0,392,2978,3575845983,3575846030,47
0,392,2979,3575845983,3575846032,49
0,392,2980,3575845983,3575846032,49
0,392,2981,3575845983,3575846032,49
0,393,2982,3575846036,3575846036,0
0,393,2983,3575846036,3575846041,5
0,393,2984,3575846036,3575846042,6
0,393,2985,3575846036,3575846043,7
0,393,2986,3575846036,3575846049,13
0,393,2987,3575846036,3575846057,21
0,393,2988,3575846036,3575846058,22
0,393,2989,3575846036,3575846067,31
0,393,2990,3575846036,3575846069,33
0,393,2991,3575846036,3575846070,34
0,393,2992,3575846036,3575846075,39
0,393,2993,3575846036,3575846086,50
0,394,2994,3575846088,3575846089,1
0,394,2995,3575846088,3575846089,1
0,394,2996,3575846088,3575846090,2
0,394,2997,3575846088,3575846090,2
0,394,2998,3575846088,3575846091,3
0,394,2999,3575846088,3575846092,4
0,394,3000,3575846088,3575846092,4
0,394,3001,3575846088,3575846097,9
0,394,3002,3575846088,3575846098,10
0,394,3003,3575846088,3575846099,11
0,394,3004,3575846088,3575846099,11
0,394,3005,3575846088,3575846100,12
0,394,3006,3575846088,3575846102,14
0,394,3007,3575846088,3575846104,16
0,394,3008,3575846088,3575846106,18
0,394,3009,3575846088,3575846107,19
0,394,3010,3575846088,3575846110,22
0,394,3011,3575846088,3575846114,26
0,394,3012,3575846088,3575846118,30
0,394,3013,3575846088,3575846118,30
0,394,3014,3575846088,3575846118,30
0,394,3015,3575846088,3575846119,31
0,394,3016,3575846088,3575846120,32
0,394,3017,3575846088,3575846122,34
0,394,3018,3575846088,3575846123,35
0,394,3019,3575846088,3575846124,36
0,394,3020,3575846088,3575846125,37
0,394,3021,3575846088,3575846125,37
0,394,3022,3575846088,3575846125,37
0,394,3023,3575846088,3575846129,41
0,394,3024,3575846088,3575846130,42
0,394,3025,3575846088,3575846134,46
0,394,3026,3575846088,3575846136,48
0,394,3027,3575846088,3575846137,49
0,394,3028,3575846088,3575846137,49
0,394,3029,3575846088,3575846138,50
0,395,3030,3575846140,3575846140,0
0,395,3031,3575846140,3575846142,2
0,395,3032,3575846140,3575846143,3
0,395,3033,3575846140,3575846144,4
0,395,3034,3575846140,3575846145,5
0,395,3035,3575846140,3575846147,7
0,395,3036,3575846140,3575846147,7
0,395,3037,3575846140,3575846148,8
0,395,3038,3575846140,3575846150,10
0,395,3039,3575846140,3575846150,10
0,395,3040,3575846140,3575846155,15
0,395,3041,3575846140,3575846156,16
0,395,3042,3575846140,3575846157,17
0,395,3043,3575846140,3575846161,21
0,395,3044,3575846140,3575846163,23
0,395,3045,3575846140,3575846171,31
0,395,3046,3575846140,3575846172,32
0,395,3047,3575846140,3575846176,36
0,395,3048,3575846140,3575846178,38
0,395,3049,3575846140,3575846179,39
0,395,3050,3575846140,3575846186,46
0,395,3051,3575846140,3575846188,48
0,396,3052,3575846192,3575846194,2
0,396,3053,3575846192,3575846196,4
0,396,3054,3575846192,3575846196,4
0,396,3055,3575846192,3575846201,9
0,396,3056,3575846192,3575846201,9
0,396,3057,3575846192,3575846214,22
0,396,3058,3575846192,3575846219,27
0,396,3059,3575846192,3575846221,29
0,396,3060,3575846192,3575846227,35
0,396,3061,3575846192,3575846229,37
0,396,3062,3575846192,3575846232,40
0,396,3063,3575846192,3575846233,41
0,396,3064,3575846192,3575846233,41
0,396,3065,3575846192,3575846235,43
0,396,3066,3575846192,3575846242,50
0,397,3067,3575846244,3575846244,0
0,397,3068,3575846244,3575846244,0
0,397,3069,3575846244,3575846249,5
0,397,3070,3575846244,3575846252,8
0,397,3071,3575846244,3575846257,13
0,397,3072,3575846244,3575846258,14
0,397,3073,3575846244,3575846267,23
0,397,3074,3575846244,3575846268,24
0,397,3075,3575846244,3575846271,27
0,397,3076,3575846244,3575846275,31
0,397,3077,3575846244,3575846285,41
0,397,3078,3575846244,3575846288,44
0,397,3079,3575846244,3575846289,45
0,397,3080,3575846244,3575846290,46
0,397,3081,3575846244,3575846290,46
0,397,3082,3575846244,3575846290,46
0,397,3083,3575846244,3575846291,47
0,397,3084,3575846244,3575846292,48
0,398,3085,3575846296,3575846297,1
0,398,3086,3575846296,3575846298,2
0,398,3087,3575846296,3575846299,3
0,398,3088,3575846296,3575846300,4
0,398,3089,3575846296,3575846300,4
0,398,3090,3575846296,3575846302,6
0,398,3091,3575846296,3575846302,6
0,398,3092,3575846296,3575846304,8
0,398,3093,3575846296,3575846306,10
0,398,3094,3575846296,3575846307,11
0,398,3095,3575846296,3575846310,14
0,398,3096,3575846296,3575846314,18
0,398,3097,3575846296,3575846318,22
0,398,3098,3575846296,3575846318,22
0,398,3099,3575846296,3575846319,23
0,398,3100,3575846296,3575846319,23
0,398,3101,3575846296,3575846319,23
0,398,3102,3575846296,3575846322,26
0,398,3103,3575846296,3575846323,27
0,398,3104,3575846296,3575846323,27
0,398,3105,3575846296,3575846325,29
0,398,3106,3575846296,3575846325,29
0,398,3107,3575846296,3575846326,30
0,398,3108,3575846296,3575846329,33
0,398,3109,3575846296,3575846329,33
0,398,3110,3575846296,3575846335,39
0,398,3111,3575846296,3575846336,40
0,398,3112,3575846296,3575846337,41
0,398,3113,3575846296,3575846337,41
0,398,3114,3575846296,3575846337,41
0,398,3115,3575846296,3575846340,44
0,398,3116,3575846296,3575846342,46
0,398,3117,3575846296,3575846342,46
0,398,3118,3575846296,3575846343,47
0,398,3119,3575846296,3575846345,49
0,399,3120,3575846348,3575846349,1
0,399,3121,3575846348,3575846349,1
0,399,3122,3575846348,3575846349,1
0,399,3123,3575846348,3575846350,2
0,399,3124,3575846348,3575846353,5
0,399,3125,3575846348,3575846355,7
0,399,3126,3575846348,3575846356,8
0,399,3127,3575846348,3575846357,9
0,399,3128,3575846348,3575846362,14
0,399,3129,3575846348,3575846364,16
0,399,3130,3575846348,3575846371,23
0,399,3131,3575846348,3575846372,24
0,399,3132,3575846348,3575846372,24
0,399,3133,3575846348,3575846377,29
0,399,3134,3575846348,3575846379,31
0,399,3135,3575846348,3575846387,39
0,399,3136,3575846348,3575846388,40
0,399,3137,3575846348,3575846394,46
0,399,3138,3575846348,3575846395,47
0,399,3139,3575846348,3575846396,48
0,400,3140,3575846400,3575846401,1
0,400,3141,3575846400,3575846403,3
0,400,3142,3575846400,3575846415,15
0,400,3143,3575846400,3575846419,19
0,400,3144,3575846400,3575846421,21
0,400,3145,3575846400,3575846426,26
0,400,3146,3575846400,3575846430,30
0,400,3147,3575846400,3575846433,33
0,400,3148,3575846400,3575846434,34
0,400,3149,3575846400,3575846435,35
0,400,3150,3575846400,3575846441,41
0,400,3151,3575846400,3575846443,43
0,400,3152,3575846400,3575846443,43
0,400,3153,3575846400,3575846449,49
0,401,3154,3575846452,3575846454,2
0,401,3155,3575846452,3575846457,5
0,401,3156,3575846452,3575846459,7
0,401,3157,3575846452,3575846467,15
0,401,3158,3575846452,3575846469,17
0,401,3159,3575846452,3575846471,19
0,401,3160,3575846452,3575846476,24
0,401,3161,3575846452,3575846485,33
0,401,3162,3575846452,3575846489,37
0,401,3163,3575846452,3575846489,37
0,401,3164,3575846452,3575846490,38
0,401,3165,3575846452,3575846491,39
0,401,3166,3575846452,3575846491,39
0,401,3167,3575846452,3575846492,40
0,401,3168,3575846452,3575846492,40
0,401,3169,3575846452,3575846497,45
0,401,3170,3575846452,3575846497,45
0,401,3171,3575846452,3575846500,48
0,401,3172,3575846452,3575846500,48
0,402,3173,3575846505,3575846505,0
0,402,3174,3575846505,3575846505,0
0,402,3175,3575846505,3575846505,0
0,402,3176,3575846505,3575846506,1
0,402,3177,3575846505,3575846507,2
0,402,3178,3575846505,3575846509,4
0,402,3179,3575846505,3575846514,9
0,402,3180,3575846505,3575846516,11
0,402,3181,3575846505,3575846517,12
0,402,3182,3575846505,3575846518,13
0,402,3183,3575846505,3575846518,13
0,402,3184,3575846505,3575846519,14
0,402,3185,3575846505,3575846521,16
0,402,3186,3575846505,3575846522,17
0,402,3187,3575846505,3575846524,19
0,402,3188,3575846505,3575846524,19
0,402,3189,3575846505,3575846525,20
0,402,3190,3575846505,3575846526,21
0,402,3191,3575846505,3575846528,23
0,402,3192,3575846505,3575846529,24
0,402,3193,3575846505,3575846534,29
0,402,3194,3575846505,3575846536,31
0,402,3195,3575846505,3575846536,31
0,402,3196,3575846505,3575846537,32
0,402,3197,3575846505,3575846537,32
0,402,3198,3575846505,3575846538,33
0,402,3199,3575846505,3575846541,36
0,402,3200,3575846505,3575846542,37
0,402,3201,3575846505,3575846542,37
0,402,3202,3575846505,3575846544,39
0,402,3203,3575846505,3575846546,41
0,402,3204,3575846505,3575846547,42
0,402,3205,3575846505,3575846549,44
0,402,3206,3575846505,3575846550,45
0,402,3207,3575846505,3575846554,49
0,402,3208,3575846505,3575846554,49
0,402,3209,3575846505,3575846555,50
0,403,3210,3575846558,3575846558,0
0,403,3211,3575846558,3575846561,3
0,403,3212,3575846558,3575846564,6
0,403,3213,3575846558,3575846570,12
0,403,3214,3575846558,3575846571,13
0,403,3215,3575846558,3575846572,14
0,403,3216,3575846558,3575846577,19
0,403,3217,3575846558,3575846578,20
0,403,3218,3575846558,3575846578,20
0,403,3219,3575846558,3575846586,28
0,403,3220,3575846558,3575846587,29
0,403,3221,3575846558,3575846593,35
0,403,3222,3575846558,3575846595,37
0,403,3223,3575846558,3575846595,37
0,403,3224,3575846558,3575846600,42
0,403,3225,3575846558,3575846606,48
0,403,3226,3575846558,3575846607,49
0,404,3227,3575846610,3575846614,4
0,404,3228,3575846610,3575846617,7
0,404,3229,3575846610,3575846620,10
0,404,3230,3575846610,3575846626,16
0,404,3231,3575846610,3575846629,19
0,404,3232,3575846610,3575846631,21
0,404,3233,3575846610,3575846632,22
0,404,3234,3575846610,3575846633,23
0,404,3235,3575846610,3575846634,24
0,404,3236,3575846610,3575846641,31
0,404,3237,3575846610,3575846641,31
0,404,3238,3575846610,3575846643,33
0,404,3239,3575846610,3575846648,38
0,404,3240,3575846610,3575846656,46
0,404,3241,3575846610,3575846656,46
0,404,3242,3575846610,3575846658,48
0,405,3243,3575846662,3575846667,5
0,405,3244,3575846662,3575846668,6
0,405,3245,3575846662,3575846671,9
0,405,3246,3575846662,3575846676,14
0,405,3247,3575846662,3575846685,23
0,405,3248,3575846662,3575846689,27
0,405,3249,3575846662,3575846689,27
0,405,3250,3575846662,3575846690,28
0,405,3251,3575846662,3575846690,28
0,405,3252,3575846662,3575846691,29
0,405,3253,3575846662,3575846691,29
0,405,3254,3575846662,3575846692,30
0,405,3255,3575846662,3575846697,35
0,405,3256,3575846662,3575846697,35
0,405,3257,3575846662,3575846699,37
0,405,3258,3575846662,3575846701,39
0,405,3259,3575846662,3575846702,40
0,405,3260,3575846662,3575846704,42
0,405,3261,3575846662,3575846706,44
0,405,3262,3575846662,3575846707,45
0,405,3263,3575846662,3575846709,47
0,405,3264,3575846662,3575846709,47
0,406,3265,3575846714,3575846714,0
0,406,3266,3575846714,3575846717,3
0,406,3267,3575846714,3575846717,3
0,406,3268,3575846714,3575846718,4
0,406,3269,3575846714,3575846718,4
0,406,3270,3575846714,3575846719,5
0,406,3271,3575846714,3575846720,6
0,406,3272,3575846714,3575846722,8
0,406,3273,3575846714,3575846724,10
0,406,3274,3575846714,3575846724,10
0,406,3275,3575846714,3575846725,11
0,406,3276,3575846714,3575846726,12
0,406,3277,3575846714,3575846728,14
0,406,3278,3575846714,3575846728,14
0,406,3279,3575846714,3575846734,20
0,406,3280,3575846714,3575846736,22
0,406,3281,3575846714,3575846736,22
0,406,3282,3575846714,3575846737,23
0,406,3283,3575846714,3575846737,23
0,406,3284,3575846714,3575846739,25
0,406,3285,3575846714,3575846741,27
0,406,3286,3575846714,3575846742,28
0,406,3287,3575846714,3575846743,29
0,406,3288,3575846714,3575846744,30
0,406,3289,3575846714,3575846747,33
0,406,3290,3575846714,3575846748,34
0,406,3291,3575846714,3575846748,34
0,406,3292,3575846714,3575846751,37
0,406,3293,3575846714,3575846754,40
0,406,3294,3575846714,3575846755,41
0,406,3295,3575846714,3575846757,43
0,406,3296,3575846714,3575846760,46
0,406,3297,3575846714,3575846763,49
0,407,3298,3575846767,3575846770,3
0,407,3299,3575846767,3575846771,4
0,407,3300,3575846767,3575846771,4
0,407,3301,3575846767,3575846777,10
0,407,3302,3575846767,3575846778,11
0,407,3303,3575846767,3575846779,12
0,407,3304,3575846767,3575846786,19
0,407,3305,3575846767,3575846787,20
0,407,3306,3575846767,3575846793,26
0,407,3307,3575846767,3575846794,27
0,407,3308,3575846767,3575846795,28
0,407,3309,3575846767,3575846801,34
0,407,3310,3575846767,3575846807,40
0,407,3311,3575846767,3575846810,43
0,407,3312,3575846767,3575846814,47
0,408,3313,3575846819,3575846819,0
0,408,3314,3575846819,3575846820,1
0,408,3315,3575846819,3575846827,8
0,408,3316,3575846819,3575846828,9
0,408,3317,3575846819,3575846831,12
0,408,3318,3575846819,3575846832,13
0,408,3319,3575846819,3575846833,14
0,408,3320,3575846819,3575846834,15
0,408,3321,3575846819,3575846842,23
0,408,3322,3575846819,3575846842,23
0,408,3323,3575846819,3575846843,24
0,408,3324,3575846819,3575846848,29
0,408,3325,3575846819,3575846856,37
0,408,3326,3575846819,3575846859,40
0,408,3327,3575846819,3575846860,41
0,408,3328,3575846819,3575846867,48
0,408,3329,3575846819,3575846868,49
0,409,3330,3575846872,3575846872,0
0,409,3331,3575846872,3575846875,3
0,409,3332,3575846872,3575846885,13
0,409,3333,3575846872,3575846888,16
0,409,3334,3575846872,3575846889,17
0,409,3335,3575846872,3575846891,19
0,409,3336,3575846872,3575846891,19
0,409,3337,3575846872,3575846891,19
0,409,3338,3575846872,3575846891,19
0,409,3339,3575846872,3575846891,19
0,409,3340,3575846872,3575846897,25
0,409,3341,3575846872,3575846897,25
0,409,3342,3575846872,3575846899,27
0,409,3343,3575846872,3575846900,28
0,409,3344,3575846872,3575846901,29
0,409,3345,3575846872,3575846903,31
0,409,3346,3575846872,3575846904,32
0,409,3347,3575846872,3575846906,34
0,409,3348,3575846872,3575846907,35
0,409,3349,3575846872,3575846909,37
0,409,3350,3575846872,3575846911,39
0,409,3351,3575846872,3575846914,42
0,409,3352,3575846872,3575846916,44
0,409,3353,3575846872,3575846917,45
0,409,3354,3575846872,3575846918,46
0,409,3355,3575846872,3575846918,46
0,409,3356,3575846872,3575846918,46
0,409,3357,3575846872,3575846921,49
0,410,3358,3575846924,3575846924,0
0,410,3359,3575846924,3575846924,0
0,410,3360,3575846924,3575846925,1
0,410,3361,3575846924,3575846925,1
0,410,3362,3575846924,3575846928,4
0,410,3363,3575846924,3575846928,4
0,410,3364,3575846924,3575846930,6
0,410,3365,3575846924,3575846933,9
0,410,3366,3575846924,3575846936,12
0,410,3367,3575846924,3575846937,13
0,410,3368,3575846924,3575846937,13
0,410,3369,3575846924,3575846937,13
0,410,3370,3575846924,3575846938,14
0,410,3371,3575846924,3575846941,17
0,410,3372,3575846924,3575846943,19
0,410,3373,3575846924,3575846943,19
0,410,3374,3575846924,3575846944,20
0,410,3375,3575846924,3575846947,23
0,410,3376,3575846924,3575846947,23
0,410,3377,3575846924,3575846949,25
0,410,3378,3575846924,3575846949,25
0,410,3379,3575846924,3575846950,26
0,410,3380,3575846924,3575846955,31
0,410,3381,3575846924,3575846955,31
0,410,3382,3575846924,3575846957,33
0,410,3383,3575846924,3575846960,36
0,410,3384,3575846924,3575846961,37
0,410,3385,3575846924,3575846961,37
0,410,3386,3575846924,3575846964,40
0,410,3387,3575846924,3575846971,47
0,410,3388,3575846924,3575846971,47
0,410,3389,3575846924,3575846972,48
0,411,3390,3575846977,3575846977,0
0,411,3391,3575846977,3575846978,1
0,411,3392,3575846977,3575846979,2
0,411,3393,3575846977,3575846986,9
0,411,3394,3575846977,3575846988,11
0,411,3395,3575846977,3575846994,17
0,411,3396,3575846977,3575846995,18
0,411,3397,3575846977,3575846995,18
0,411,3398,3575846977,3575847001,24
0,411,3399,3575846977,3575847008,31
0,411,3400,3575846977,3575847012,35
0,411,3401,3575846977,3575847014,37
0,411,3402,3575846977,3575847019,42
0,411,3403,3575846977,3575847020,43
0,412,3404,3575847029,3575847029,0
0,412,3405,3575847029,3575847029,0
0,412,3406,3575847029,3575847032,3
0,412,3407,3575847029,3575847033,4
0,412,3408,3575847029,3575847034,5
0,412,3409,3575847029,3575847034,5
0,412,3410,3575847029,3575847042,13
0,412,3411,3575847029,3575847042,13
0,412,3412,3575847029,3575847042,13
0,412,3413,3575847029,3575847048,19
0,412,3414,3575847029,3575847057,28
0,412,3415,3575847029,3575847059,30
0,412,3416,3575847029,3575847063,34
0,412,3417,3575847029,3575847067,38
0,412,3418,3575847029,3575847067,38
0,412,3419,3575847029,3575847072,43
0,412,3420,3575847029,3575847076,47
0,413,3421,3575847082,3575847085,3
0,413,3422,3575847082,3575847088,6
0,413,3423,3575847082,3575847089,7
0,413,3424,3575847082,3575847091,9
0,413,3425,3575847082,3575847091,9
0,413,3426,3575847082,3575847091,9
0,413,3427,3575847082,3575847092,10
0,413,3428,3575847082,3575847097,15
0,413,3429,3575847082,3575847098,16
0,413,3430,3575847082,3575847100,18
0,413,3431,3575847082,3575847100,18
0,413,3432,3575847082,3575847100,18
0,413,3433,3575847082,3575847103,21
0,413,3434,3575847082,3575847104,22
0,413,3435,3575847082,3575847106,24
0,413,3436,3575847082,3575847107,25
0,413,3437,3575847082,3575847109,27
0,413,3438,3575847082,3575847114,32
0,413,3439,3575847082,3575847114,32
0,413,3440,3575847082,3575847117,35
0,413,3441,3575847082,3575847117,35
0,413,3442,3575847082,3575847118,36
0,413,3443,3575847082,3575847119,37
0,413,3444,3575847082,3575847119,37
0,413,3445,3575847082,3575847122,40
0,413,3446,3575847082,3575847123,41
0,413,3447,3575847082,3575847124,42
0,413,3448,3575847082,3575847125,43
0,413,3449,3575847082,3575847125,43
0,413,3450,3575847082,3575847128,46
0,413,3451,3575847082,3575847128,46
0,413,3452,3575847082,3575847130,48
0,414,3453,3575847134,3575847134,0
0,414,3454,3575847134,3575847136,2
0,414,3455,3575847134,3575847137,3
0,414,3456,3575847134,3575847137,3
0,414,3457,3575847134,3575847137,3
0,414,3458,3575847134,3575847139,5
0,414,3459,3575847134,3575847141,7
0,414,3460,3575847134,3575847143,9
0,414,3461,3575847134,3575847143,9
0,414,3462,3575847134,3575847145,11
0,414,3463,3575847134,3575847147,13
0,414,3464,3575847134,3575847148,14
0,414,3465,3575847134,3575847148,14
0,414,3466,3575847134,3575847149,15
0,414,3467,3575847134,3575847150,16
0,414,3468,3575847134,3575847155,21
0,414,3469,3575847134,3575847155,21
0,414,3470,3575847134,3575847157,23
0,414,3471,3575847134,3575847160,26
0,414,3472,3575847134,3575847161,27
0,414,3473,3575847134,3575847161,27
0,414,3474,3575847134,3575847164,30
0,414,3475,3575847134,3575847164,30
0,414,3476,3575847134,3575847171,37
0,414,3477,3575847134,3575847171,37
0,414,3478,3575847134,3575847172,38
0,414,3479,3575847134,3575847177,43
0,414,3480,3575847134,3575847178,44
0,414,3481,3575847134,3575847180,46
0,415,3482,3575847186,3575847186,0
0,415,3483,3575847186,3575847188,2
0,415,3484,3575847186,3575847194,8
0,415,3485,3575847186,3575847194,8
0,415,3486,3575847186,3575847197,11
0,415,3487,3575847186,3575847200,14
0,415,3488,3575847186,3575847213,27
0,415,3489,3575847186,3575847215,29
0,415,3490,3575847186,3575847220,34
0,415,3491,3575847186,3575847221,35
0,415,3492,3575847186,3575847226,40
0,415,3493,3575847186,3575847229,43
0,415,3494,3575847186,3575847232,46
0,415,3495,3575847186,3575847233,47
0,415,3496,3575847186,3575847235,49
0,415,3497,3575847186,3575847235,49
0,416,3498,3575847239,3575847242,3
0,416,3499,3575847239,3575847242,3
0,416,3500,3575847239,3575847243,4
0,416,3501,3575847239,3575847249,10
0,416,3502,3575847239,3575847257,18
0,416,3503,3575847239,3575847258,19
0,416,3504,3575847239,3575847263,24
0,416,3505,3575847239,3575847266,27
0,416,3506,3575847239,3575847267,28
0,416,3507,3575847239,3575847267,28
0,416,3508,3575847239,3575847271,32
0,416,3509,3575847239,3575847275,36
0,416,3510,3575847239,3575847285,46
0,416,3511,3575847239,3575847288,49
0,416,3512,3575847239,3575847289,50
0,417,3513,3575847291,3575847292,1
0,417,3514,3575847291,3575847292,1
0,417,3515,3575847291,3575847292,1
0,417,3516,3575847291,3575847292,1
0,417,3517,3575847291,3575847297,6
0,417,3518,3575847291,3575847299,8
0,417,3519,3575847291,3575847299,8
0,417,3520,3575847291,3575847300,9
0,417,3521,3575847291,3575847300,9
0,417,3522,3575847291,3575847303,12
0,417,3523,3575847291,3575847305,14
0,417,3524,3575847291,3575847306,15
0,417,3525,3575847291,3575847307,16
0,417,3526,3575847291,3575847309,18
0,417,3527,3575847291,3575847315,24
0,417,3528,3575847291,3575847316,25
0,417,3529,3575847291,3575847317,26
0,417,3530,3575847291,3575847318,27
0,417,3531,3575847291,3575847318,27
0,417,3532,3575847291,3575847319,28
0,417,3533,3575847291,3575847319,28
0,417,3534,3575847291,3575847321,30
0,417,3535,3575847291,3575847323,32
0,417,3536,3575847291,3575847325,34
0,417,3537,3575847291,3575847325,34
0,417,3538,3575847291,3575847326,35
0,417,3539,3575847291,3575847327,36
0,417,3540,3575847291,3575847328,37
0,417,3541,3575847291,3575847330,39
0,417,3542,3575847291,3575847335,44
0,417,3543,3575847291,3575847336,45
0,417,3544,3575847291,3575847337,46
0,417,3545,3575847291,3575847337,46
0,417,3546,3575847291,3575847338,47
0,417,3547,3575847291,3575847338,47
0,417,3548,3575847291,3575847341,50
0,418,3549,3575847344,3575847344,0
0,418,3550,3575847344,3575847344,0
0,418,3551,3575847344,3575847345,1
0,418,3552,3575847344,3575847348,4
0,418,3553,3575847344,3575847348,4
0,418,3554,3575847344,3575847349,5
0,418,3555,3575847344,3575847349,5
0,418,3556,3575847344,3575847350,6
0,418,3557,3575847344,3575847356,12
0,418,3558,3575847344,3575847356,12
0,418,3559,3575847344,3575847357,13
0,418,3560,3575847344,3575847360,16
0,418,3561,3575847344,3575847361,17
0,418,3562,3575847344,3575847362,18
0,418,3563,3575847344,3575847364,20
0,418,3564,3575847344,3575847367,23
0,418,3565,3575847344,3575847371,27
0,418,3566,3575847344,3575847372,28
0,418,3567,3575847344,3575847373,29
0,418,3568,3575847344,3575847377,33
0,418,3569,3575847344,3575847378,34
0,418,3570,3575847344,3575847380,36
0,418,3571,3575847344,3575847387,43
0,418,3572,3575847344,3575847388,44
0,419,3573,3575847396,3575847396,0
0,419,3574,3575847396,3575847397,1
0,419,3575,3575847396,3575847414,18
0,419,3576,3575847396,3575847417,21
0,419,3577,3575847396,3575847420,24
0,419,3578,3575847396,3575847421,25
0,419,3579,3575847396,3575847427,31
0,419,3580,3575847396,3575847429,33
0,419,3581,3575847396,3575847432,36
0,419,3582,3575847396,3575847433,37
0,419,3583,3575847396,3575847434,38
0,419,3584,3575847396,3575847435,39
0,419,3585,3575847396,3575847442,46
0,419,3586,3575847396,3575847442,46
0,419,3587,3575847396,3575847443,47
0,420,3588,3575847449,3575847449,0
0,420,3589,3575847449,3575847457,8
0,420,3590,3575847449,3575847458,9
0,420,3591,3575847449,3575847463,14
0,420,3592,3575847449,3575847468,19
0,420,3593,3575847449,3575847468,19
0,420,3594,3575847449,3575847468,19
0,420,3595,3575847449,3575847471,22
0,420,3596,3575847449,3575847475,26
0,420,3597,3575847449,3575847485,36
0,420,3598,3575847449,3575847488,39
0,420,3599,3575847449,3575847489,40
0,420,3600,3575847449,3575847491,42
0,420,3601,3575847449,3575847491,42
0,420,3602,3575847449,3575847491,42
0,420,3603,3575847449,3575847492,43
0,420,3604,3575847449,3575847492,43
0,420,3605,3575847449,3575847497,48
0,421,3606,3575847502,3575847502,0
0,421,3607,3575847502,3575847502,0
0,421,3608,3575847502,3575847502,0
0,421,3609,3575847502,3575847502,0
0,421,3610,3575847502,3575847502,0
0,421,3611,3575847502,3575847503,1
0,421,3612,3575847502,3575847505,3
0,421,3613,3575847502,3575847506,4
0,421,3614,3575847502,3575847508,6
0,421,3615,3575847502,3575847513,11
0,421,3616,3575847502,3575847516,14
0,421,3617,3575847502,3575847517,15
0,421,3618,3575847502,3575847517,15
0,421,3619,3575847502,3575847518,16
0,421,3620,3575847502,3575847518,16
0,421,3621,3575847502,3575847519,17
0,421,3622,3575847502,3575847521,19
0,421,3623,3575847502,3575847522,20
0,421,3624,3575847502,3575847523,21
0,421,3625,3575847502,3575847524,22
0,421,3626,3575847502,3575847524,22
0,421,3627,3575847502,3575847526,24
0,421,3628,3575847502,3575847527,25
0,421,3629,3575847502,3575847529,27
0,421,3630,3575847502,3575847535,33
0,421,3631,3575847502,3575847535,33
0,421,3632,3575847502,3575847536,34
0,421,3633,3575847502,3575847536,34
0,421,3634,3575847502,3575847536,34
0,421,3635,3575847502,3575847538,36
0,421,3636,3575847502,3575847540,38
0,421,3637,3575847502,3575847542,40
0,421,3638,3575847502,3575847543,41
0,421,3639,3575847502,3575847544,42
0,421,3640,3575847502,3575847547,45
0,421,3641,3575847502,3575847547,45
0,421,3642,3575847502,3575847547,45
0,421,3643,3575847502,3575847549,47
0,421,3644,3575847502,3575847550,48
0,422,3645,3575847555,3575847555,0
0,422,3646,3575847555,3575847555,0
0,422,3647,3575847555,3575847556,1
0,422,3648,3575847555,3575847559,4
0,422,3649,3575847555,3575847561,6
0,422,3650,3575847555,3575847561,6
0,422,3651,3575847555,3575847564,9
0,422,3652,3575847555,3575847566,11
0,422,3653,3575847555,3575847570,15
0,422,3654,3575847555,3575847570,15
0,422,3655,3575847555,3575847571,16
0,422,3656,3575847555,3575847571,16
0,422,3657,3575847555,3575847576,21
0,422,3658,3575847555,3575847578,23
0,422,3659,3575847555,3575847578,23
0,422,3660,3575847555,3575847586,31
0,422,3661,3575847555,3575847587,32
0,422,3662,3575847555,3575847593,38
0,422,3663,3575847555,3575847593,38
0,422,3664,3575847555,3575847597,42
0,423,3665,3575847607,3575847614,7
0,423,3666,3575847607,3575847619,12
0,423,3667,3575847607,3575847619,12
0,423,3668,3575847607,3575847620,13
0,423,3669,3575847607,3575847627,20
0,423,3670,3575847607,3575847628,21
0,423,3671,3575847607,3575847631,24
0,423,3672,3575847607,3575847634,27
0,423,3673,3575847607,3575847634,27
0,423,3674,3575847607,3575847641,34
0,423,3675,3575847607,3575847641,34
0,423,3676,3575847607,3575847642,35
0,423,3677,3575847607,3575847648,41
0,423,3678,3575847607,3575847656,49
0,424,3679,3575847660,3575847660,0
0,424,3680,3575847660,3575847662,2
0,424,3681,3575847660,3575847667,7
0,424,3682,3575847660,3575847667,7
0,424,3683,3575847660,3575847670,10
0,424,3684,3575847660,3575847671,11
0,424,3685,3575847660,3575847676,16
0,424,3686,3575847660,3575847686,26
0,424,3687,3575847660,3575847689,29
0,424,3688,3575847660,3575847689,29
0,424,3689,3575847660,3575847691,31
0,424,3690,3575847660,3575847691,31
0,424,3691,3575847660,3575847692,32
0,424,3692,3575847660,3575847692,32
0,424,3693,3575847660,3575847692,32
0,424,3694,3575847660,3575847698,38
0,424,3695,3575847660,3575847700,40
0,424,3696,3575847660,3575847700,40
0,424,3697,3575847660,3575847701,41
0,424,3698,3575847660,3575847702,42
0,424,3699,3575847660,3575847703,43
0,424,3700,3575847660,3575847704,44
0,424,3701,3575847660,3575847705,45
0,424,3702,3575847660,3575847707,47
0,424,3703,3575847660,3575847708,48
0,425,3704,3575847713,3575847714,1
0,425,3705,3575847713,3575847716,3
0,425,3706,3575847713,3575847717,4
0,425,3707,3575847713,3575847718,5
0,425,3708,3575847713,3575847718,5
0,425,3709,3575847713,3575847720,7
0,425,3710,3575847713,3575847721,8
0,425,3711,3575847713,3575847721,8
0,425,3712,3575847713,3575847722,9
0,425,3713,3575847713,3575847723,10
0,425,3714,3575847713,3575847724,11
0,425,3715,3575847713,3575847724,11
0,425,3716,3575847713,3575847727,14
0,425,3717,3575847713,3575847727,14
0,425,3718,3575847713,3575847729,16
0,425,3719,3575847713,3575847735,22
0,425,3720,3575847713,3575847736,23
0,425,3721,3575847713,3575847736,23
0,425,3722,3575847713,3575847736,23
0,425,3723,3575847713,3575847737,24
0,425,3724,3575847713,3575847738,25
0,425,3725,3575847713,3575847740,27
0,425,3726,3575847713,3575847742,29
0,425,3727,3575847713,3575847743,30
0,425,3728,3575847713,3575847744,31
0,425,3729,3575847713,3575847747,34
0,425,3730,3575847713,3575847747,34
0,425,3731,3575847713,3575847748,35
0,425,3732,3575847713,3575847749,36
0,425,3733,3575847713,3575847750,37
0,425,3734,3575847713,3575847755,42
0,425,3735,3575847713,3575847755,42
0,425,3736,3575847713,3575847756,43
0,425,3737,3575847713,3575847759,46
0,425,3738,3575847713,3575847761,48
0,425,3739,3575847713,3575847762,49
0,426,3740,3575847765,3575847765,0
0,426,3741,3575847765,3575847766,1
0,426,3742,3575847765,3575847771,6
0,426,3743,3575847765,3575847771,6
0,426,3744,3575847765,3575847771,6
0,426,3745,3575847765,3575847773,8
0,426,3746,3575847765,3575847776,11
0,426,3747,3575847765,3575847778,13
0,426,3748,3575847765,3575847779,14
0,426,3749,3575847765,3575847786,21
0,426,3750,3575847765,3575847787,22
0,426,3751,3575847765,3575847793,28
0,426,3752,3575847765,3575847795,30
0,426,3753,3575847765,3575847796,31
0,426,3754,3575847765,3575847801,36
0,426,3755,3575847765,3575847808,43
0,426,3756,3575847765,3575847813,48
0,427,3757,3575847818,3575847818,0
0,427,3758,3575847818,3575847820,2
0,427,3759,3575847818,3575847822,4
0,427,3760,3575847818,3575847826,8
0,427,3761,3575847818,3575847829,11
0,427,3762,3575847818,3575847832,14
0,427,3763,3575847818,3575847833,15
0,427,3764,3575847818,3575847833,15
0,427,3765,3575847818,3575847834,16
0,427,3766,3575847818,3575847841,23
0,427,3767,3575847818,3575847841,23
0,427,3768,3575847818,3575847842,24
0,427,3769,3575847818,3575847848,30
0,427,3770,3575847818,3575847856,38
0,427,3771,3575847818,3575847857,39
0,427,3772,3575847818,3575847862,44
0,427,3773,3575847818,3575847866,48
0,427,3774,3575847818,3575847867,49
0,428,3775,3575847871,3575847871,0
0,428,3776,3575847871,3575847873,2
0,428,3777,3575847871,3575847875,4
0,428,3778,3575847871,3575847885,14
0,428,3779,3575847871,3575847888,17
0,428,3780,3575847871,3575847889,18
0,428,3781,3575847871,3575847891,20
0,428,3782,3575847871,3575847892,21
0,428,3783,3575847871,3575847892,21
0,428,3784,3575847871,3575847892,21
0,428,3785,3575847871,3575847892,21
0,428,3786,3575847871,3575847898,27
0,428,3787,3575847871,3575847900,29
0,428,3788,3575847871,3575847900,29
0,428,3789,3575847871,3575847900,29
0,428,3790,3575847871,3575847901,30
0,428,3791,3575847871,3575847903,32
0,428,3792,3575847871,3575847904,33
0,428,3793,3575847871,3575847907,36
0,428,3794,3575847871,3575847907,36
0,428,3795,3575847871,3575847908,37
0,428,3796,3575847871,3575847914,43
0,428,3797,3575847871,3575847916,45
0,428,3798,3575847871,3575847918,47
0,428,3799,3575847871,3575847919,48
0,428,3800,3575847871,3575847919,48
0,428,3801,3575847871,3575847921,50
0,429,3802,3575847924,3575847924,0
0,429,3803,3575847924,3575847924,0
0,429,3804,3575847924,3575847924,0
0,429,3805,3575847924,3575847924,0
0,429,3806,3575847924,3575847925,1
0,429,3807,3575847924,3575847927,3
0,429,3808,3575847924,3575847927,3
0,429,3809,3575847924,3575847930,6
0,429,3810,3575847924,3575847935,11
0,429,3811,3575847924,3575847936,12
0,429,3812,3575847924,3575847936,12
0,429,3813,3575847924,3575847936,12
0,429,3814,3575847924,3575847937,13
0,429,3815,3575847924,3575847938,14
0,429,3816,3575847924,3575847941,17
0,429,3817,3575847924,3575847943,19
0,429,3818,3575847924,3575847943,19
0,429,3819,3575847924,3575847944,20
0,429,3820,3575847924,3575847947,23
0,429,3821,3575847924,3575847947,23
0,429,3822,3575847924,3575847948,24
0,429,3823,3575847924,3575847949,25
0,429,3824,3575847924,3575847950,26
0,429,3825,3575847924,3575847954,30
0,429,3826,3575847924,3575847955,31
0,429,3827,3575847924,3575847957,33
0,429,3828,3575847924,3575847959,35
0,429,3829,3575847924,3575847961,37
0,429,3830,3575847924,3575847962,38
0,429,3831,3575847924,3575847964,40
0,429,3832,3575847924,3575847966,42
0,429,3833,3575847924,3575847971,47
0,429,3834,3575847924,3575847971,47
0,429,3835,3575847924,3575847971,47
0,429,3836,3575847924,3575847974,50
0,430,3837,3575847977,3575847977,0
0,430,3838,3575847977,3575847978,1
0,430,3839,3575847977,3575847980,3
0,430,3840,3575847977,3575847986,9
0,430,3841,3575847977,3575847987,10
0,430,3842,3575847977,3575847994,17
0,430,3843,3575847977,3575847995,18
0,430,3844,3575847977,3575847996,19
0,430,3845,3575847977,3575848000,23
0,430,3846,3575847977,3575848001,24
0,430,3847,3575847977,3575848007,30
0,430,3848,3575847977,3575848014,37
0,430,3849,3575847977,3575848018,41
0,430,3850,3575847977,3575848020,43
0,430,3851,3575847977,3575848023,46
0,430,3852,3575847977,3575848025,48
0,430,3853,3575847977,3575848026,49
0,431,3854,3575848030,3575848030,0
0,431,3855,3575848030,3575848032,2
0,431,3856,3575848030,3575848033,3
0,431,3857,3575848030,3575848033,3
0,431,3858,3575848030,3575848034,4
0,431,3859,3575848030,3575848042,12
0,431,3860,3575848030,3575848042,12
0,431,3861,3575848030,3575848042,12
0,431,3862,3575848030,3575848047,17
0,431,3863,3575848030,3575848057,27
0,431,3864,3575848030,3575848058,28
0,431,3865,3575848030,3575848061,31
0,431,3866,3575848030,3575848067,37
0,431,3867,3575848030,3575848067,37
0,431,3868,3575848030,3575848075,45
0,431,3869,3575848030,3575848076,46
0,432,3870,3575848083,3575848085,2
0,432,3871,3575848083,3575848089,6
0,432,3872,3575848083,3575848089,6
0,432,3873,3575848083,3575848090,7
0,432,3874,3575848083,3575848092,9
0,432,3875,3575848083,3575848092,9
0,432,3876,3575848083,3575848092,9
0,432,3877,3575848083,3575848092,9
0,432,3878,3575848083,3575848097,14
0,432,3879,3575848083,3575848100,17
0,432,3880,3575848083,3575848100,17
0,432,3881,3575848083,3575848100,17
0,432,3882,3575848083,3575848102,19
0,432,3883,3575848083,3575848103,20
0,432,3884,3575848083,3575848104,21
0,432,3885,3575848083,3575848106,23
0,432,3886,3575848083,3575848107,24
0,432,3887,3575848083,3575848109,26
0,432,3888,3575848083,3575848114,31
0,432,3889,3575848083,3575848117,34
0,432,3890,3575848083,3575848119,36
0,432,3891,3575848083,3575848119,36
0,432,3892,3575848083,3575848119,36
0,432,3893,3575848083,3575848121,38
0,432,3894,3575848083,3575848123,40
0,432,3895,3575848083,3575848124,41
0,432,3896,3575848083,3575848124,41
0,432,3897,3575848083,3575848125,42
0,432,3898,3575848083,3575848126,43
0,432,3899,3575848083,3575848127,44
0,432,3900,3575848083,3575848128,45
0,432,3901,3575848083,3575848130,47
0,433,3902,3575848136,3575848136,0
0,433,3903,3575848136,3575848136,0
0,433,3904,3575848136,3575848136,0
0,433,3905,3575848136,3575848137,1
0,433,3906,3575848136,3575848137,1
0,433,3907,3575848136,3575848137,1
0,433,3908,3575848136,3575848141,5
0,433,3909,3575848136,3575848142,6
0,433,3910,3575848136,3575848144,8
0,433,3911,3575848136,3575848145,9
0,433,3912,3575848136,3575848146,10
0,433,3913,3575848136,3575848147,11
0,433,3914,3575848136,3575848148,12
0,433,3915,3575848136,3575848149,13
0,433,3916,3575848136,3575848150,14
0,433,3917,3575848136,3575848155,19
0,433,3918,3575848136,3575848156,20
0,433,3919,3575848136,3575848157,21
0,433,3920,3575848136,3575848159,23
0,433,3921,3575848136,3575848161,25
0,433,3922,3575848136,3575848163,27
0,433,3923,3575848136,3575848164,28
0,433,3924,3575848136,3575848166,30
0,433,3925,3575848136,3575848171,35
0,433,3926,3575848136,3575848171,35
0,433,3927,3575848136,3575848172,36
0,433,3928,3575848136,3575848174,38
0,433,3929,3575848136,3575848177,41
0,433,3930,3575848136,3575848178,42
0,433,3931,3575848136,3575848179,43
0,433,3932,3575848136,3575848179,43
0,433,3933,3575848136,3575848185,49
0,434,3934,3575848189,3575848189,0
0,434,3935,3575848189,3575848194,5
0,434,3936,3575848189,3575848195,6
0,434,3937,3575848189,3575848196,7
0,434,3938,3575848189,3575848200,11
0,434,3939,3575848189,3575848201,12
0,434,3940,3575848189,3575848209,20
0,434,3941,3575848189,3575848214,25
0,434,3942,3575848189,3575848218,29
0,434,3943,3575848189,3575848221,32
0,434,3944,3575848189,3575848222,33
0,434,3945,3575848189,3575848226,37
0,434,3946,3575848189,3575848229,40
0,434,3947,3575848189,3575848229,40
0,434,3948,3575848189,3575848233,44
0,434,3949,3575848189,3575848233,44
0,434,3950,3575848189,3575848234,45
0,434,3951,3575848189,3575848235,46
0,435,3952,3575848242,3575848242,0
0,435,3953,3575848242,3575848242,0
0,435,3954,3575848242,3575848242,0
0,435,3955,3575848242,3575848248,6
0,435,3956,3575848242,3575848257,15
0,435,3957,3575848242,3575848258,16
0,435,3958,3575848242,3575848262,20
0,435,3959,3575848242,3575848267,25
0,435,3960,3575848242,3575848267,25
0,435,3961,3575848242,3575848276,34
0,435,3962,3575848242,3575848279,37
0,435,3963,3575848242,3575848285,43
0,435,3964,3575848242,3575848288,46
0,435,3965,3575848242,3575848289,47
0,435,3966,3575848242,3575848291,49
0,435,3967,3575848242,3575848292,50
0,436,3968,3575848296,3575848296,0
0,436,3969,3575848296,3575848296,0
0,436,3970,3575848296,3575848296,0
0,436,3971,3575848296,3575848297,1
0,436,3972,3575848296,3575848300,4
0,436,3973,3575848296,3575848300,4
0,436,3974,3575848296,3575848300,4
0,436,3975,3575848296,3575848302,6
0,436,3976,3575848296,3575848304,8
0,436,3977,3575848296,3575848304,8
0,436,3978,3575848296,3575848307,11
0,436,3979,3575848296,3575848307,11
0,436,3980,3575848296,3575848314,18
0,436,3981,3575848296,3575848316,20
0,436,3982,3575848296,3575848317,21
0,436,3983,3575848296,3575848319,23
0,436,3984,3575848296,3575848319,23
0,436,3985,3575848296,3575848320,24
0,436,3986,3575848296,3575848321,25
0,436,3987,3575848296,3575848323,27
0,436,3988,3575848296,3575848324,28
0,436,3989,3575848296,3575848324,28
0,436,3990,3575848296,3575848326,30
0,436,3991,3575848296,3575848326,30
0,436,3992,3575848296,3575848327,31
0,436,3993,3575848296,3575848329,33
0,436,3994,3575848296,3575848330,34
0,436,3995,3575848296,3575848335,39
0,436,3996,3575848296,3575848336,40
0,436,3997,3575848296,3575848336,40
0,436,3998,3575848296,3575848337,41
0,436,3999,3575848296,3575848337,41
0,436,4000,3575848296,3575848339,43
0,436,4001,3575848296,3575848341,45
0,436,4002,3575848296,3575848342,46
0,436,4003,3575848296,3575848344,48
0,436,4004,3575848296,3575848345,49
0,437,4005,3575848349,3575848349,0
0,437,4006,3575848349,3575848349,0
0,437,4007,3575848349,3575848349,0
0,437,4008,3575848349,3575848349,0
0,437,4009,3575848349,3575848350,1
0,437,4010,3575848349,3575848355,6
0,437,4011,3575848349,3575848355,6
0,437,4012,3575848349,3575848357,8
0,437,4013,3575848349,3575848362,13
0,437,4014,3575848349,3575848363,14
0,437,4015,3575848349,3575848364,15
0,437,4016,3575848349,3575848366,17
0,437,4017,3575848349,3575848371,22
0,437,4018,3575848349,3575848372,23
0,437,4019,3575848349,3575848372,23
0,437,4020,3575848349,3575848374,25
0,437,4021,3575848349,3575848377,28
0,437,4022,3575848349,3575848378,29
0,437,4023,3575848349,3575848379,30
0,437,4024,3575848349,3575848379,30
0,437,4025,3575848349,3575848380,31
0,437,4026,3575848349,3575848383,34
0,437,4027,3575848349,3575848386,37
0,437,4028,3575848349,3575848387,38
0,437,4029,3575848349,3575848394,45
0,437,4030,3575848349,3575848395,46
0,437,4031,3575848349,3575848397,48
0,438,4032,3575848401,3575848401,0
0,438,4033,3575848401,3575848401,0
0,438,4034,3575848401,3575848409,8
0,438,4035,3575848401,3575848415,14
0,438,4036,3575848401,3575848419,18
0,438,4037,3575848401,3575848421,20
0,438,4038,3575848401,3575848422,21
0,438,4039,3575848401,3575848426,25
0,438,4040,3575848401,3575848429,28
0,438,4041,3575848401,3575848431,30
0,438,4042,3575848401,3575848433,32
0,438,4043,3575848401,3575848433,32
0,438,4044,3575848401,3575848434,33
0,438,4045,3575848401,3575848435,34
0,438,4046,3575848401,3575848441,40
0,438,4047,3575848401,3575848441,40
0,438,4048,3575848401,3575848442,41
0,438,4049,3575848401,3575848448,47
0,439,4050,3575848454,3575848457,3
0,439,4051,3575848454,3575848458,4
0,439,4052,3575848454,3575848461,7
0,439,4053,3575848454,3575848466,12
0,439,4054,3575848454,3575848467,13
0,439,4055,3575848454,3575848470,16
0,439,4056,3575848454,3575848475,21
0,439,4057,3575848454,3575848479,25
0,439,4058,3575848454,3575848482,28
0,439,4059,3575848454,3575848485,31
0,439,4060,3575848454,3575848489,35
0,439,4061,3575848454,3575848489,35
0,439,4062,3575848454,3575848490,36
0,439,4063,3575848454,3575848491,37
0,439,4064,3575848454,3575848491,37
0,439,4065,3575848454,3575848492,38
0,439,4066,3575848454,3575848492,38
0,439,4067,3575848454,3575848497,43
0,439,4068,3575848454,3575848500,46
0,439,4069,3575848454,3575848500,46
0,439,4070,3575848454,3575848500,46
0,439,4071,3575848454,3575848502,48
0,439,4072,3575848454,3575848503,49
0,440,4073,3575848507,3575848507,0
0,440,4074,3575848507,3575848507,0
0,440,4075,3575848507,3575848507,0
0,440,4076,3575848507,3575848513,6
0,440,4077,3575848507,3575848515,8
0,440,4078,3575848507,3575848516,9
0,440,4079,3575848507,3575848518,11
0,440,4080,3575848507,3575848518,11
0,440,4081,3575848507,3575848519,12
0,440,4082,3575848507,3575848521,14
0,440,4083,3575848507,3575848522,15
0,440,4084,3575848507,3575848523,16
0,440,4085,3575848507,3575848523,16
0,440,4086,3575848507,3575848525,18
0,440,4087,3575848507,3575848526,19
0,440,4088,3575848507,3575848527,20
0,440,4089,3575848507,3575848529,22
0,440,4090,3575848507,3575848532,25
0,440,4091,3575848507,3575848534,27
0,440,4092,3575848507,3575848535,28
0,440,4093,3575848507,3575848535,28
0,440,4094,3575848507,3575848536,29
0,440,4095,3575848507,3575848536,29
0,440,4096,3575848507,3575848538,31
0,440,4097,3575848507,3575848540,33
0,440,4098,3575848507,3575848541,34
0,440,4099,3575848507,3575848542,35
0,440,4100,3575848507,3575848544,37
0,440,4101,3575848507,3575848547,40
0,440,4102,3575848507,3575848548,41
0,440,4103,3575848507,3575848548,41
0,440,4104,3575848507,3575848550,43
0,440,4105,3575848507,3575848550,43
0,440,4106,3575848507,3575848553,46
0,440,4107,3575848507,3575848554,47
0,440,4108,3575848507,3575848557,50
0,441,4109,3575848560,3575848561,1
0,441,4110,3575848560,3575848563,3
0,441,4111,3575848560,3575848563,3
0,441,4112,3575848560,3575848565,5
0,441,4113,3575848560,3575848570,10
0,441,4114,3575848560,3575848571,11
0,441,4115,3575848560,3575848571,11
0,441,4116,3575848560,3575848573,13
0,441,4117,3575848560,3575848576,16
0,441,4118,3575848560,3575848578,18
0,441,4119,3575848560,3575848583,23
0,441,4120,3575848560,3575848583,23
0,441,4121,3575848560,3575848585,25
0,441,4122,3575848560,3575848586,26
0,441,4123,3575848560,3575848593,33
0,441,4124,3575848560,3575848594,34
0,441,4125,3575848560,3575848596,36
0,441,4126,3575848560,3575848599,39
0,441,4127,3575848560,3575848600,40
0,441,4128,3575848560,3575848608,48
0,442,4129,3575848613,3575848614,1
0,442,4130,3575848613,3575848618,5
0,442,4131,3575848613,3575848620,7
0,442,4132,3575848613,3575848621,8
0,442,4133,3575848613,3575848627,14
0,442,4134,3575848613,3575848628,15
0,442,4135,3575848613,3575848631,18
0,442,4136,3575848613,3575848631,18
0,442,4137,3575848613,3575848632,19
0,442,4138,3575848613,3575848633,20
0,442,4139,3575848613,3575848634,21
0,442,4140,3575848613,3575848634,21
0,442,4141,3575848613,3575848640,27
0,442,4142,3575848613,3575848641,28
0,442,4143,3575848613,3575848642,29
0,442,4144,3575848613,3575848647,34
0,442,4145,3575848613,3575848656,43
0,442,4146,3575848613,3575848657,44
0,442,4147,3575848613,3575848661,48
0,443,4148,3575848666,3575848666,0
0,443,4149,3575848666,3575848667,1
0,443,4150,3575848666,3575848670,4
0,443,4151,3575848666,3575848675,9
0,443,4152,3575848666,3575848679,13
0,443,4153,3575848666,3575848682,16
0,443,4154,3575848666,3575848684,18
0,443,4155,3575848666,3575848686,20
0,443,4156,3575848666,3575848689,23
0,443,4157,3575848666,3575848689,23
0,443,4158,3575848666,3575848691,25
0,443,4159,3575848666,3575848691,25
0,443,4160,3575848666,3575848692,26
0,443,4161,3575848666,3575848692,26
0,443,4162,3575848666,3575848692,26
0,443,4163,3575848666,3575848698,32
0,443,4164,3575848666,3575848700,34
0,443,4165,3575848666,3575848700,34
0,443,4166,3575848666,3575848700,34
0,443,4167,3575848666,3575848702,36
0,443,4168,3575848666,3575848703,37
0,443,4169,3575848666,3575848705,39
0,443,4170,3575848666,3575848706,40
0,443,4171,3575848666,3575848707,41
0,443,4172,3575848666,3575848708,42
0,443,4173,3575848666,3575848713,47
0,443,4174,3575848666,3575848715,49
0,444,4175,3575848719,3575848719,0
0,444,4176,3575848719,3575848719,0
0,444,4177,3575848719,3575848719,0
0,444,4178,3575848719,3575848719,0
0,444,4179,3575848719,3575848721,2
0,444,4180,3575848719,3575848722,3
0,444,4181,3575848719,3575848723,4
0,444,4182,3575848719,3575848723,4
0,444,4183,3575848719,3575848725,6
0,444,4184,3575848719,3575848726,7
0,444,4185,3575848719,3575848727,8
0,444,4186,3575848719,3575848729,10
0,444,4187,3575848719,3575848734,15
0,444,4188,3575848719,3575848735,16
0,444,4189,3575848719,3575848735,16
0,444,4190,3575848719,3575848735,16
0,444,4191,3575848719,3575848736,17
0,444,4192,3575848719,3575848736,17
0,444,4193,3575848719,3575848738,19
0,444,4194,3575848719,3575848740,21
0,444,4195,3575848719,3575848741,22
0,444,4196,3575848719,3575848742,23
0,444,4197,3575848719,3575848744,25
0,444,4198,3575848719,3575848747,28
0,444,4199,3575848719,3575848747,28
0,444,4200,3575848719,3575848748,29
0,444,4201,3575848719,3575848750,31
0,444,4202,3575848719,3575848750,31
0,444,4203,3575848719,3575848754,35
0,444,4204,3575848719,3575848754,35
0,444,4205,3575848719,3575848757,38
0,444,4206,3575848719,3575848759,40
0,444,4207,3575848719,3575848761,42
0,444,4208,3575848719,3575848763,44
0,444,4209,3575848719,3575848763,44
0,444,4210,3575848719,3575848766,47
0,445,4211,3575848771,3575848771,0
0,445,4212,3575848771,3575848772,1
0,445,4213,3575848771,3575848772,1
0,445,4214,3575848771,3575848774,3
0,445,4215,3575848771,3575848776,5
0,445,4216,3575848771,3575848778,7
0,445,4217,3575848771,3575848778,7
0,445,4218,3575848771,3575848780,9
0,445,4219,3575848771,3575848783,12
0,445,4220,3575848771,3575848786,15
0,445,4221,3575848771,3575848786,15
0,445,4222,3575848771,3575848786,15
0,445,4223,3575848771,3575848795,24
0,445,4224,3575848771,3575848795,24
0,445,4225,3575848771,3575848800,29
0,445,4226,3575848771,3575848801,30
0,445,4227,3575848771,3575848809,38
0,445,4228,3575848771,3575848814,43
0,445,4229,3575848771,3575848819,48
0,445,4230,3575848771,3575848820,49
0,446,4231,3575848823,3575848823,0
0,446,4232,3575848823,3575848826,3
0,446,4233,3575848823,3575848829,6
0,446,4234,3575848823,3575848830,7
0,446,4235,3575848823,3575848832,9
0,446,4236,3575848823,3575848832,9
0,446,4237,3575848823,3575848832,9
0,446,4238,3575848823,3575848834,11
0,446,4239,3575848823,3575848834,11
0,446,4240,3575848823,3575848836,13
0,446,4241,3575848823,3575848841,18
0,446,4242,3575848823,3575848841,18
0,446,4243,3575848823,3575848843,20
0,446,4244,3575848823,3575848847,24
0,446,4245,3575848823,3575848856,33
0,446,4246,3575848823,3575848857,34
0,446,4247,3575848823,3575848861,38
0,446,4248,3575848823,3575848866,43
0,446,4249,3575848823,3575848867,44
0,446,4250,3575848823,3575848870,47
0,447,4251,3575848876,3575848876,0
0,447,4252,3575848876,3575848879,3
0,447,4253,3575848876,3575848882,6
0,447,4254,3575848876,3575848885,9
0,447,4255,3575848876,3575848887,11
0,447,4256,3575848876,3575848887,11
0,447,4257,3575848876,3575848889,13
0,447,4258,3575848876,3575848889,13
0,447,4259,3575848876,3575848890,14
0,447,4260,3575848876,3575848891,15
0,447,4261,3575848876,3575848892,16
0,447,4262,3575848876,3575848892,16
0,447,4263,3575848876,3575848892,16
0,447,4264,3575848876,3575848897,21
0,447,4265,3575848876,3575848900,24
0,447,4266,3575848876,3575848900,24
0,447,4267,3575848876,3575848901,25
0,447,4268,3575848876,3575848902,26
0,447,4269,3575848876,3575848903,27
0,447,4270,3575848876,3575848905,29
0,447,4271,3575848876,3575848907,31
0,447,4272,3575848876,3575848907,31
0,447,4273,3575848876,3575848908,32
0,447,4274,3575848876,3575848914,38
0,447,4275,3575848876,3575848916,40
0,447,4276,3575848876,3575848918,42
0,447,4277,3575848876,3575848918,42
0,447,4278,3575848876,3575848918,42
0,447,4279,3575848876,3575848919,43
0,447,4280,3575848876,3575848920,44
0,447,4281,3575848876,3575848922,46
0,447,4282,3575848876,3575848923,47
0,447,4283,3575848876,3575848924,48
0,447,4284,3575848876,3575848925,49
0,447,4285,3575848876,3575848925,49
0,448,4286,3575848929,3575848929,0
0,448,4287,3575848929,3575848930,1
0,448,4288,3575848929,3575848934,5
0,448,4289,3575848929,3575848935,6
0,448,4290,3575848929,3575848935,6
0,448,4291,3575848929,3575848936,7
0,448,4292,3575848929,3575848937,8
0,448,4293,3575848929,3575848937,8
0,448,4294,3575848929,3575848938,9
0,448,4295,3575848929,3575848938,9
0,448,4296,3575848929,3575848940,11
0,448,4297,3575848929,3575848944,15
0,448,4298,3575848929,3575848944,15
0,448,4299,3575848929,3575848947,18
0,448,4300,3575848929,3575848947,18
0,448,4301,3575848929,3575848948,19
0,448,4302,3575848929,3575848950,21
0,448,4303,3575848929,3575848950,21
0,448,4304,3575848929,3575848956,27
0,448,4305,3575848929,3575848957,28
0,448,4306,3575848929,3575848959,30
0,448,4307,3575848929,3575848963,34
0,448,4308,3575848929,3575848964,35
0,448,4309,3575848929,3575848966,37
0,448,4310,3575848929,3575848971,42
0,448,4311,3575848929,3575848971,42
0,448,4312,3575848929,3575848971,42
0,448,4313,3575848929,3575848973,44
0,448,4314,3575848929,3575848976,47
0,448,4315,3575848929,3575848978,49
0,448,4316,3575848929,3575848978,49
0,448,4317,3575848929,3575848979,50
0,449,4318,3575848982,3575848983,1
0,449,4319,3575848982,3575848985,3
0,449,4320,3575848982,3575848986,4
0,449,4321,3575848982,3575848988,6
0,449,4322,3575848982,3575848994,12
0,449,4323,3575848982,3575848995,13
0,449,4324,3575848982,3575848995,13
0,449,4325,3575848982,3575848999,17
0,449,4326,3575848982,3575849001,19
0,449,4327,3575848982,3575849014,32
0,449,4328,3575848982,3575849019,37
0,449,4329,3575848982,3575849020,38
0,449,4330,3575848982,3575849022,40
0,449,4331,3575848982,3575849027,45
0,449,4332,3575848982,3575849029,47
0,449,4333,3575848982,3575849030,48
0,450,4334,3575849035,3575849035,0
0,450,4335,3575849035,3575849035,0
0,450,4336,3575849035,3575849035,0
0,450,4337,3575849035,3575849035,0
0,450,4338,3575849035,3575849035,0
0,450,4339,3575849035,3575849039,4
0,450,4340,3575849035,3575849041,6
0,450,4341,3575849035,3575849042,7
0,450,4342,3575849035,3575849043,8
0,450,4343,3575849035,3575849048,13
0,450,4344,3575849035,3575849057,22
0,450,4345,3575849035,3575849058,23
0,450,4346,3575849035,3575849062,27
0,450,4347,3575849035,3575849066,31
0,450,4348,3575849035,3575849066,31
0,450,4349,3575849035,3575849075,40
0,450,4350,3575849035,3575849079,44
0,450,4351,3575849035,3575849082,47
0,451,4352,3575849089,3575849089,0
0,451,4353,3575849089,3575849089,0
0,451,4354,3575849089,3575849089,0
0,451,4355,3575849089,3575849089,0
0,451,4356,3575849089,3575849089,0
0,451,4357,3575849089,3575849090,1
0,451,4358,3575849089,3575849090,1
0,451,4359,3575849089,3575849091,2
0,451,4360,3575849089,3575849092,3
0,451,4361,3575849089,3575849092,3
0,451,4362,3575849089,3575849093,4
0,451,4363,3575849089,3575849097,8
0,451,4364,3575849089,3575849100,11
0,451,4365,3575849089,3575849100,11
0,451,4366,3575849089,3575849101,12
0,451,4367,3575849089,3575849102,13
0,451,4368,3575849089,3575849104,15
0,451,4369,3575849089,3575849106,17
0,451,4370,3575849089,3575849106,17
0,451,4371,3575849089,3575849107,18
0,451,4372,3575849089,3575849109,20
0,451,4373,3575849089,3575849114,25
0,451,4374,3575849089,3575849117,28
0,451,4375,3575849089,3575849117,28
0,451,4376,3575849089,3575849118,29
0,451,4377,3575849089,3575849119,30
0,451,4378,3575849089,3575849119,30
0,451,4379,3575849089,3575849122,33
0,451,4380,3575849089,3575849123,34
0,451,4381,3575849089,3575849123,34
0,451,4382,3575849089,3575849124,35
0,451,4383,3575849089,3575849125,36
0,451,4384,3575849089,3575849125,36
0,451,4385,3575849089,3575849127,38
0,451,4386,3575849089,3575849130,41
0,451,4387,3575849089,3575849134,45
0,451,4388,3575849089,3575849135,46
0,451,4389,3575849089,3575849136,47
0,451,4390,3575849089,3575849136,47
0,451,4391,3575849089,3575849137,48
0,451,4392,3575849089,3575849138,49
0,451,4393,3575849089,3575849138,49
0,452,4394,3575849142,3575849142,0
0,452,4395,3575849142,3575849142,0
0,452,4396,3575849142,3575849142,0
0,452,4397,3575849142,3575849143,1
0,452,4398,3575849142,3575849145,3
0,452,4399,3575849142,3575849146,4
0,452,4400,3575849142,3575849147,5
0,452,4401,3575849142,3575849148,6
0,452,4402,3575849142,3575849150,8
0,452,4403,3575849142,3575849150,8
0,452,4404,3575849142,3575849155,13
0,452,4405,3575849142,3575849156,14
0,452,4406,3575849142,3575849157,15
0,452,4407,3575849142,3575849159,17
0,452,4408,3575849142,3575849161,19
0,452,4409,3575849142,3575849163,21
0,452,4410,3575849142,3575849164,22
0,452,4411,3575849142,3575849166,24
0,452,4412,3575849142,3575849171,29
0,452,4413,3575849142,3575849172,30
0,452,4414,3575849142,3575849172,30
0,452,4415,3575849142,3575849174,32
0,452,4416,3575849142,3575849176,34
0,452,4417,3575849142,3575849178,36
0,452,4418,3575849142,3575849180,38
0,452,4419,3575849142,3575849183,41
0,452,4420,3575849142,3575849186,44
0,452,4421,3575849142,3575849186,44
0,452,4422,3575849142,3575849191,49
0,453,4423,3575849195,3575849195,0
0,453,4424,3575849195,3575849195,0
0,453,4425,3575849195,3575849197,2
0,453,4426,3575849195,3575849199,4
0,453,4427,3575849195,3575849201,6
0,453,4428,3575849195,3575849214,19
0,453,4429,3575849195,3575849218,23
0,453,4430,3575849195,3575849221,26
0,453,4431,3575849195,3575849222,27
0,453,4432,3575849195,3575849228,33
0,453,4433,3575849195,3575849229,34
0,453,4434,3575849195,3575849230,35
0,453,4435,3575849195,3575849232,37
0,453,4436,3575849195,3575849233,38
0,453,4437,3575849195,3575849233,38
0,453,4438,3575849195,3575849234,39
0,453,4439,3575849195,3575849235,40
0,453,4440,3575849195,3575849241,46
0,453,4441,3575849195,3575849242,47
0,453,4442,3575849195,3575849242,47
0,453,4443,3575849195,3575849243,48
0,454,4444,3575849248,3575849248,0
0,454,4445,3575849248,3575849258,10
0,454,4446,3575849248,3575849258,10
0,454,4447,3575849248,3575849263,15
0,454,4448,3575849248,3575849266,18
0,454,4449,3575849248,3575849267,19
0,454,4450,3575849248,3575849276,28
0,454,4451,3575849248,3575849279,31
0,454,4452,3575849248,3575849282,34
0,454,4453,3575849248,3575849285,37
0,454,4454,3575849248,3575849287,39
0,454,4455,3575849248,3575849288,40
0,454,4456,3575849248,3575849289,41
0,454,4457,3575849248,3575849289,41
0,454,4458,3575849248,3575849291,43
0,454,4459,3575849248,3575849291,43
0,454,4460,3575849248,3575849291,43
0,454,4461,3575849248,3575849292,44
0,454,4462,3575849248,3575849294,46
0,454,4463,3575849248,3575849294,46
0,454,4464,3575849248,3575849298,50
0,455,4465,3575849300,3575849300,0
0,455,4466,3575849300,3575849301,1
0,455,4467,3575849300,3575849301,1
0,455,4468,3575849300,3575849302,2
0,455,4469,3575849300,3575849303,3
0,455,4470,3575849300,3575849306,6
0,455,4471,3575849300,3575849306,6
0,455,4472,3575849300,3575849307,7
0,455,4473,3575849300,3575849309,9
0,455,4474,3575849300,3575849314,14
0,455,4475,3575849300,3575849316,16
0,455,4476,3575849300,3575849318,18
0,455,4477,3575849300,3575849318,18
0,455,4478,3575849300,3575849319,19
0,455,4479,3575849300,3575849320,20
0,455,4480,3575849300,3575849323,23
0,455,4481,3575849300,3575849323,23
0,455,4482,3575849300,3575849324,24
0,455,4483,3575849300,3575849324,24
0,455,4484,3575849300,3575849325,25
0,455,4485,3575849300,3575849326,26
0,455,4486,3575849300,3575849327,27
0,455,4487,3575849300,3575849330,30
0,455,4488,3575849300,3575849335,35
0,455,4489,3575849300,3575849336,36
0,455,4490,3575849300,3575849336,36
0,455,4491,3575849300,3575849336,36
0,455,4492,3575849300,3575849336,36
0,455,4493,3575849300,3575849337,37
0,455,4494,3575849300,3575849339,39
0,455,4495,3575849300,3575849340,40
0,455,4496,3575849300,3575849343,43
0,455,4497,3575849300,3575849343,43
0,455,4498,3575849300,3575849345,45
0,455,4499,3575849300,3575849345,45
0,455,4500,3575849300,3575849348,48
0,455,4501,3575849300,3575849348,48
0,455,4502,3575849300,3575849349,49
0,456,4503,3575849353,3575849353,0
0,456,4504,3575849353,3575849353,0
0,456,4505,3575849353,3575849355,2
0,456,4506,3575849353,3575849355,2
0,456,4507,3575849353,3575849357,4
0,456,4508,3575849353,3575849359,6
0,456,4509,3575849353,3575849362,9
0,456,4510,3575849353,3575849363,10
0,456,4511,3575849353,3575849364,11
0,456,4512,3575849353,3575849366,13
0,456,4513,3575849353,3575849371,18
0,456,4514,3575849353,3575849372,19
0,456,4515,3575849353,3575849372,19
0,456,4516,3575849353,3575849374,21
0,456,4517,3575849353,3575849376,23
0,456,4518,3575849353,3575849378,25
0,456,4519,3575849353,3575849380,27
0,456,4520,3575849353,3575849383,30
0,456,4521,3575849353,3575849386,33
0,456,4522,3575849353,3575849387,34
0,456,4523,3575849353,3575849395,42
0,456,4524,3575849353,3575849395,42
0,456,4525,3575849353,3575849395,42
0,456,4526,3575849353,3575849396,43
0,456,4527,3575849353,3575849399,46
0,456,4528,3575849353,3575849400,47
0,457,4529,3575849407,3575849408,1
0,457,4530,3575849407,3575849415,8
0,457,4531,3575849407,3575849419,12
0,457,4532,3575849407,3575849421,14
0,457,4533,3575849407,3575849422,15
0,457,4534,3575849407,3575849427,20
0,457,4535,3575849407,3575849429,22
0,457,4536,3575849407,3575849430,23
0,457,4537,3575849407,3575849432,25
0,457,4538,3575849407,3575849433,26
0,457,4539,3575849407,3575849434,27
0,457,4540,3575849407,3575849434,27
0,457,4541,3575849407,3575849435,28
0,457,4542,3575849407,3575849441,34
0,457,4543,3575849407,3575849441,34
0,457,4544,3575849407,3575849443,36
0,457,4545,3575849407,3575849445,38
0,457,4546,3575849407,3575849447,40
0,458,4547,3575849462,3575849462,0
0,458,4548,3575849462,3575849462,0
0,458,4549,3575849462,3575849463,1
0,458,4550,3575849462,3575849467,5
0,458,4551,3575849462,3575849467,5
0,458,4552,3575849462,3575849470,8
0,458,4553,3575849462,3575849476,14
0,458,4554,3575849462,3575849479,17
0,458,4555,3575849462,3575849482,20
0,458,4556,3575849462,3575849485,23
0,458,4557,3575849462,3575849487,25
0,458,4558,3575849462,3575849489,27
0,458,4559,3575849462,3575849489,27
0,458,4560,3575849462,3575849489,27
0,458,4561,3575849462,3575849491,29
0,458,4562,3575849462,3575849491,29
0,458,4563,3575849462,3575849492,30
0,458,4564,3575849462,3575849492,30
0,458,4565,3575849462,3575849495,33
0,458,4566,3575849462,3575849496,34
0,458,4567,3575849462,3575849497,35
0,458,4568,3575849462,3575849500,38
0,458,4569,3575849462,3575849500,38
0,458,4570,3575849462,3575849501,39
0,458,4571,3575849462,3575849502,40
0,458,4572,3575849462,3575849504,42
0,458,4573,3575849462,3575849506,44
0,458,4574,3575849462,3575849507,45
0,458,4575,3575849462,3575849507,45
0,458,4576,3575849462,3575849509,47
0,459,4577,3575849515,3575849515,0
0,459,4578,3575849515,3575849515,0
0,459,4579,3575849515,3575849517,2
0,459,4580,3575849515,3575849517,2
0,459,4581,3575849515,3575849518,3
0,459,4582,3575849515,3575849520,5
0,459,4583,3575849515,3575849522,7
0,459,4584,3575849515,3575849523,8
0,459,4585,3575849515,3575849523,8
0,459,4586,3575849515,3575849524,9
0,459,4587,3575849515,3575849524,9
0,459,4588,3575849515,3575849525,10
0,459,4589,3575849515,3575849528,13
0,459,4590,3575849515,3575849534,19
0,459,4591,3575849515,3575849535,20
0,459,4592,3575849515,3575849535,20
0,459,4593,3575849515,3575849535,20
0,459,4594,3575849515,3575849536,21
0,459,4595,3575849515,3575849536,21
0,459,4596,3575849515,3575849538,23
0,459,4597,3575849515,3575849540,25
0,459,4598,3575849515,3575849541,26
0,459,4599,3575849515,3575849543,28
0,459,4600,3575849515,3575849544,29
0,459,4601,3575849515,3575849546,31
0,459,4602,3575849515,3575849547,32
0,459,4603,3575849515,3575849547,32
0,459,4604,3575849515,3575849547,32
0,459,4605,3575849515,3575849550,35
0,459,4606,3575849515,3575849551,36
0,459,4607,3575849515,3575849554,39
0,459,4608,3575849515,3575849555,40
0,459,4609,3575849515,3575849557,42
0,459,4610,3575849515,3575849561,46
0,459,4611,3575849515,3575849561,46
0,459,4612,3575849515,3575849564,49
0,459,4613,3575849515,3575849565,50
0,460,4614,3575849568,3575849570,2
0,460,4615,3575849568,3575849571,3
0,460,4616,3575849568,3575849571,3
0,460,4617,3575849568,3575849572,4
0,460,4618,3575849568,3575849576,8
0,460,4619,3575849568,3575849577,9
0,460,4620,3575849568,3575849578,10
0,460,4621,3575849568,3575849582,14
0,460,4622,3575849568,3575849585,17
0,460,4623,3575849568,3575849586,18
0,460,4624,3575849568,3575849594,26
0,460,4625,3575849568,3575849594,26
0,460,4626,3575849568,3575849596,28
0,460,4627,3575849568,3575849597,29
0,460,4628,3575849568,3575849599,31
0,460,4629,3575849568,3575849600,32
0,460,4630,3575849568,3575849607,39
0,460,4631,3575849568,3575849613,45
0,460,4632,3575849568,3575849617,49
0,461,4633,3575849621,3575849621,0
0,461,4634,3575849621,3575849621,0
0,461,4635,3575849621,3575849626,5
0,461,4636,3575849621,3575849629,8
0,461,4637,3575849621,3575849629,8
0,461,4638,3575849621,3575849631,10
0,461,4639,3575849621,3575849632,11
0,461,4640,3575849621,3575849632,11
0,461,4641,3575849621,3575849633,12
0,461,4642,3575849621,3575849634,13
0,461,4643,3575849621,3575849640,19
0,461,4644,3575849621,3575849641,20
0,461,4645,3575849621,3575849642,21
0,461,4646,3575849621,3575849647,26
0,461,4647,3575849621,3575849647,26
0,461,4648,3575849621,3575849658,37
0,461,4649,3575849621,3575849662,41
0,461,4650,3575849621,3575849666,45
0,461,4651,3575849621,3575849666,45
0,461,4652,3575849621,3575849669,48
0,462,4653,3575849674,3575849676,2
0,462,4654,3575849674,3575849679,5
0,462,4655,3575849674,3575849682,8
0,462,4656,3575849674,3575849685,11
0,462,4657,3575849674,3575849687,13
0,462,4658,3575849674,3575849688,14
0,462,4659,3575849674,3575849688,14
0,462,4660,3575849674,3575849689,15
0,462,4661,3575849674,3575849691,17
0,462,4662,3575849674,3575849692,18
0,462,4663,3575849674,3575849692,18
0,462,4664,3575849674,3575849692,18
0,462,4665,3575849674,3575849694,20
0,462,4666,3575849674,3575849696,22
0,462,4667,3575849674,3575849697,23
0,462,4668,3575849674,3575849698,24
0,462,4669,3575849674,3575849701,27
0,462,4670,3575849674,3575849701,27
0,462,4671,3575849674,3575849701,27
0,462,4672,3575849674,3575849702,28
0,462,4673,3575849674,3575849705,31
0,462,4674,3575849674,3575849707,33
0,462,4675,3575849674,3575849707,33
0,462,4676,3575849674,3575849707,33
0,462,4677,3575849674,3575849709,35
0,462,4678,3575849674,3575849714,40
0,462,4679,3575849674,3575849715,41
0,462,4680,3575849674,3575849716,42
0,462,4681,3575849674,3575849718,44
0,462,4682,3575849674,3575849718,44
0,462,4683,3575849674,3575849719,45
0,462,4684,3575849674,3575849722,48
0,462,4685,3575849674,3575849723,49
0,462,4686,3575849674,3575849723,49
0,462,4687,3575849674,3575849724,50
0,463,4688,3575849727,3575849727,0
0,463,4689,3575849727,3575849727,0
0,463,4690,3575849727,3575849727,0
0,463,4691,3575849727,3575849734,7
0,463,4692,3575849727,3575849735,8
0,463,4693,3575849727,3575849735,8
0,463,4694,3575849727,3575849735,8
0,463,4695,3575849727,3575849736,9
0,463,4696,3575849727,3575849737,10
0,463,4697,3575849727,3575849738,11
0,463,4698,3575849727,3575849741,14
0,463,4699,3575849727,3575849742,15
0,463,4700,3575849727,3575849742,15
0,463,4701,3575849727,3575849744,17
0,463,4702,3575849727,3575849747,20
0,463,4703,3575849727,3575849747,20
0,463,4704,3575849727,3575849748,21
0,463,4705,3575849727,3575849749,22
0,463,4706,3575849727,3575849750,23
0,463,4707,3575849727,3575849750,23
0,463,4708,3575849727,3575849753,26
0,463,4709,3575849727,3575849754,27
0,463,4710,3575849727,3575849757,30
0,463,4711,3575849727,3575849761,34
0,463,4712,3575849727,3575849761,34
0,463,4713,3575849727,3575849764,37
0,463,4714,3575849727,3575849765,38
0,463,4715,3575849727,3575849770,43
0,463,4716,3575849727,3575849772,45
0,463,4717,3575849727,3575849773,46
0,463,4718,3575849727,3575849776,49
0,464,4719,3575849780,3575849780,0
0,464,4720,3575849780,3575849780,0
0,464,4721,3575849780,3575849780,0
0,464,4722,3575849780,3575849782,2
0,464,4723,3575849780,3575849785,5
0,464,4724,3575849780,3575849786,6
0,464,4725,3575849780,3575849794,14
0,464,4726,3575849780,3575849795,15
0,464,4727,3575849780,3575849796,16
0,464,4728,3575849780,3575849799,19
0,464,4729,3575849780,3575849800,20
0,464,4730,3575849780,3575849801,21
0,464,4731,3575849780,3575849807,27
0,464,4732,3575849780,3575849813,33
0,464,4733,3575849780,3575849817,37
0,464,4734,3575849780,3575849820,40
0,464,4735,3575849780,3575849821,41
0,464,4736,3575849780,3575849827,47
0,464,4737,3575849780,3575849828,48
0,464,4738,3575849780,3575849830,50
0,465,4739,3575849833,3575849833,0
0,465,4740,3575849833,3575849833,0
0,465,4741,3575849833,3575849833,0
0,465,4742,3575849833,3575849833,0
0,465,4743,3575849833,3575849834,1
0,465,4744,3575849833,3575849841,8
0,465,4745,3575849833,3575849842,9
0,465,4746,3575849833,3575849843,10
0,465,4747,3575849833,3575849847,14
0,465,4748,3575849833,3575849847,14
0,465,4749,3575849833,3575849850,17
0,465,4750,3575849833,3575849858,25
0,465,4751,3575849833,3575849859,26
0,465,4752,3575849833,3575849862,29
0,465,4753,3575849833,3575849866,33
0,465,4754,3575849833,3575849867,34
0,465,4755,3575849833,3575849870,37
0,465,4756,3575849833,3575849877,44
0,465,4757,3575849833,3575849879,46
0,465,4758,3575849833,3575849882,49
0,466,4759,3575849886,3575849886,0
0,466,4760,3575849886,3575849888,2
0,466,4761,3575849886,3575849889,3
0,466,4762,3575849886,3575849889,3
0,466,4763,3575849886,3575849890,4
0,466,4764,3575849886,3575849891,5
0,466,4765,3575849886,3575849891,5
0,466,4766,3575849886,3575849892,6
0,466,4767,3575849886,3575849892,6
0,466,4768,3575849886,3575849894,8
0,466,4769,3575849886,3575849896,10
0,466,4770,3575849886,3575849898,12
0,466,4771,3575849886,3575849900,14
0,466,4772,3575849886,3575849900,14
0,466,4773,3575849886,3575849901,15
0,466,4774,3575849886,3575849901,15
0,466,4775,3575849886,3575849902,16
0,466,4776,3575849886,3575849904,18
0,466,4777,3575849886,3575849906,20
0,466,4778,3575849886,3575849907,21
0,466,4779,3575849886,3575849908,22
0,466,4780,3575849886,3575849909,23
0,466,4781,3575849886,3575849913,27
0,466,4782,3575849886,3575849916,30
0,466,4783,3575849886,3575849917,31
0,466,4784,3575849886,3575849918,32
0,466,4785,3575849886,3575849918,32
0,466,4786,3575849886,3575849920,34
0,466,4787,3575849886,3575849922,36
0,466,4788,3575849886,3575849923,37
0,466,4789,3575849886,3575849923,37
0,466,4790,3575849886,3575849923,37
0,466,4791,3575849886,3575849925,39
0,466,4792,3575849886,3575849927,41
0,466,4793,3575849886,3575849928,42
0,466,4794,3575849886,3575849934,48
0,466,4795,3575849886,3575849935,49
0,466,4796,3575849886,3575849935,49
0,466,4797,3575849886,3575849935,49
0,466,4798,3575849886,3575849936,50
0,467,4799,3575849939,3575849939,0
0,467,4800,3575849939,3575849939,0
0,467,4801,3575849939,3575849941,2
0,467,4802,3575849939,3575849943,4
0,467,4803,3575849939,3575849943,4
0,467,4804,3575849939,3575849944,5
0,467,4805,3575849939,3575849946,7
0,467,4806,3575849939,3575849947,8
0,467,4807,3575849939,3575849948,9
0,467,4808,3575849939,3575849950,11
0,467,4809,3575849939,3575849950,11
0,467,4810,3575849939,3575849953,14
0,467,4811,3575849939,3575849955,16
0,467,4812,3575849939,3575849955,16
0,467,4813,3575849939,3575849956,17
0,467,4814,3575849939,3575849959,20
0,467,4815,3575849939,3575849961,22
0,467,4816,3575849939,3575849962,23
0,467,4817,3575849939,3575849964,25
0,467,4818,3575849939,3575849967,28
0,467,4819,3575849939,3575849971,32
0,467,4820,3575849939,3575849971,32
0,467,4821,3575849939,3575849971,32
0,467,4822,3575849939,3575849973,34
0,467,4823,3575849939,3575849976,37
0,467,4824,3575849939,3575849977,38
0,467,4825,3575849939,3575849978,39
0,467,4826,3575849939,3575849979,40
0,467,4827,3575849939,3575849982,43
0,467,4828,3575849939,3575849985,46
0,467,4829,3575849939,3575849986,47
0,468,4830,3575849992,3575849995,3
0,468,4831,3575849992,3575849995,3
0,468,4832,3575849992,3575849995,3
0,468,4833,3575849992,3575849999,7
0,468,4834,3575849992,3575850000,8
0,468,4835,3575849992,3575850001,9
0,468,4836,3575849992,3575850003,11
0,468,4837,3575849992,3575850008,16
0,468,4838,3575849992,3575850013,21
0,468,4839,3575849992,3575850018,26
0,468,4840,3575849992,3575850020,28
0,468,4841,3575849992,3575850021,29
0,468,4842,3575849992,3575850026,34
0,468,4843,3575849992,3575850028,36
0,468,4844,3575849992,3575850029,37
0,468,4845,3575849992,3575850032,40
0,468,4846,3575849992,3575850032,40
0,468,4847,3575849992,3575850032,40
0,468,4848,3575849992,3575850033,41
0,468,4849,3575849992,3575850035,43
0,468,4850,3575849992,3575850041,49
0,469,4851,3575850045,3575850045,0
0,469,4852,3575850045,3575850045,0
0,469,4853,3575850045,3575850048,3
0,469,4854,3575850045,3575850048,3
0,469,4855,3575850045,3575850053,8
0,469,4856,3575850045,3575850058,13
0,469,4857,3575850045,3575850059,14
0,469,4858,3575850045,3575850062,17
0,469,4859,3575850045,3575850066,21
0,469,4860,3575850045,3575850067,22
0,469,4861,3575850045,3575850070,25
0,469,4862,3575850045,3575850076,31
0,469,4863,3575850045,3575850079,34
0,469,4864,3575850045,3575850083,38
0,469,4865,3575850045,3575850085,40
0,469,4866,3575850045,3575850088,43
0,469,4867,3575850045,3575850088,43
0,469,4868,3575850045,3575850089,44
0,469,4869,3575850045,3575850090,45
0,469,4870,3575850045,3575850091,46
0,469,4871,3575850045,3575850092,47
0,469,4872,3575850045,3575850092,47
0,469,4873,3575850045,3575850092,47
0,469,4874,3575850045,3575850094,49
0,470,4875,3575850097,3575850097,0
0,470,4876,3575850097,3575850097,0
0,470,4877,3575850097,3575850100,3
0,470,4878,3575850097,3575850100,3
0,470,4879,3575850097,3575850101,4
0,470,4880,3575850097,3575850102,5
0,470,4881,3575850097,3575850104,7
0,470,4882,3575850097,3575850104,7
0,470,4883,3575850097,3575850106,9
0,470,4884,3575850097,3575850106,9
0,470,4885,3575850097,3575850108,11
0,470,4886,3575850097,3575850109,12
0,470,4887,3575850097,3575850114,17
0,470,4888,3575850097,3575850116,19
0,470,4889,3575850097,3575850117,20
0,470,4890,3575850097,3575850118,21
0,470,4891,3575850097,3575850119,22
0,470,4892,3575850097,3575850120,23
0,470,4893,3575850097,3575850121,24
0,470,4894,3575850097,3575850123,26
0,470,4895,3575850097,3575850123,26
0,470,4896,3575850097,3575850123,26
0,470,4897,3575850097,3575850125,28
0,470,4898,3575850097,3575850126,29
0,470,4899,3575850097,3575850129,32
0,470,4900,3575850097,3575850131,34
0,470,4901,3575850097,3575850134,37
0,470,4902,3575850097,3575850135,38
0,470,4903,3575850097,3575850135,38
0,470,4904,3575850097,3575850136,39
0,470,4905,3575850097,3575850136,39
0,470,4906,3575850097,3575850136,39
0,470,4907,3575850097,3575850139,42
0,470,4908,3575850097,3575850142,45
0,470,4909,3575850097,3575850143,46
0,470,4910,3575850097,3575850145,48
0,470,4911,3575850097,3575850146,49
0,470,4912,3575850097,3575850147,50
0,471,4913,3575850150,3575850150,0
0,471,4914,3575850150,3575850150,0
0,471,4915,3575850150,3575850151,1
0,471,4916,3575850150,3575850155,5
0,471,4917,3575850150,3575850155,5
0,471,4918,3575850150,3575850156,6
0,471,4919,3575850150,3575850157,7
0,471,4920,3575850150,3575850159,9
0,471,4921,3575850150,3575850161,11
0,471,4922,3575850150,3575850162,12
0,471,4923,3575850150,3575850164,14
0,471,4924,3575850150,3575850167,17
0,471,4925,3575850150,3575850171,21
0,471,4926,3575850150,3575850172,22
0,471,4927,3575850150,3575850172,22
0,471,4928,3575850150,3575850174,24
0,471,4929,3575850150,3575850176,26
0,471,4930,3575850150,3575850178,28
0,471,4931,3575850150,3575850178,28
0,471,4932,3575850150,3575850183,33
0,471,4933,3575850150,3575850186,36
0,471,4934,3575850150,3575850186,36
0,471,4935,3575850150,3575850195,45
0,471,4936,3575850150,3575850195,45
0,471,4937,3575850150,3575850196,46
0,471,4938,3575850150,3575850198,48
0,471,4939,3575850150,3575850199,49
0,471,4940,3575850150,3575850200,50
0,472,4941,3575850203,3575850203,0
0,472,4942,3575850203,3575850205,2
0,472,4943,3575850203,3575850208,5
0,472,4944,3575850203,3575850213,10
0,472,4945,3575850203,3575850217,14
0,472,4946,3575850203,3575850221,18
0,472,4947,3575850203,3575850221,18
0,472,4948,3575850203,3575850227,24
0,472,4949,3575850203,3575850229,26
0,472,4950,3575850203,3575850230,27
0,472,4951,3575850203,3575850232,29
0,472,4952,3575850203,3575850233,30
0,472,4953,3575850203,3575850233,30
0,472,4954,3575850203,3575850233,30
0,472,4955,3575850203,3575850235,32
0,472,4956,3575850203,3575850237,34
0,472,4957,3575850203,3575850241,38
0,472,4958,3575850203,3575850242,39
0,472,4959,3575850203,3575850243,40
0,472,4960,3575850203,3575850247,44
0,472,4961,3575850203,3575850248,45
0,473,4962,3575850258,3575850258,0
0,473,4963,3575850258,3575850258,0
0,473,4964,3575850258,3575850258,0
0,473,4965,3575850258,3575850259,1
0,473,4966,3575850258,3575850262,4
0,473,4967,3575850258,3575850266,8
0,473,4968,3575850258,3575850266,8
0,473,4969,3575850258,3575850270,12
0,473,4970,3575850258,3575850276,18
0,473,4971,3575850258,3575850279,21
0,473,4972,3575850258,3575850283,25
0,473,4973,3575850258,3575850285,27
0,473,4974,3575850258,3575850288,30
0,473,4975,3575850258,3575850289,31
0,473,4976,3575850258,3575850289,31
0,473,4977,3575850258,3575850290,32
0,473,4978,3575850258,3575850290,32
0,473,4979,3575850258,3575850292,34
0,473,4980,3575850258,3575850292,34
0,473,4981,3575850258,3575850292,34
0,473,4982,3575850258,3575850294,36
0,473,4983,3575850258,3575850296,38
0,473,4984,3575850258,3575850297,39
0,473,4985,3575850258,3575850300,42
0,473,4986,3575850258,3575850300,42
0,473,4987,3575850258,3575850301,43
0,473,4988,3575850258,3575850302,44
0,473,4989,3575850258,3575850305,47
0,473,4990,3575850258,3575850306,48
0,473,4991,3575850258,3575850307,49
0,473,4992,3575850258,3575850307,49
0,473,4993,3575850258,3575850307,49
0,474,4994,3575850312,3575850312,0
0,474,4995,3575850312,3575850314,2
0,474,4996,3575850312,3575850316,4
0,474,4997,3575850312,3575850316,4
0,474,4998,3575850312,3575850318,6
0,474,4999,3575850312,3575850320,8
0,474,5000,3575850312,3575850320,8
0,474,5001,3575850312,3575850322,10
0,474,5002,3575850312,3575850323,11
0,474,5003,3575850312,3575850324,12
0,474,5004,3575850312,3575850324,12
0,474,5005,3575850312,3575850326,14
0,474,5006,3575850312,3575850327,15
0,474,5007,3575850312,3575850328,16
0,474,5008,3575850312,3575850331,19
0,474,5009,3575850312,3575850335,23
0,474,5010,3575850312,3575850335,23
0,474,5011,3575850312,3575850336,24
0,474,5012,3575850312,3575850337,25
0,474,5013,3575850312,3575850337,25
0,474,5014,3575850312,3575850337,25
0,474,5015,3575850312,3575850338,26
0,474,5016,3575850312,3575850343,31
0,474,5017,3575850312,3575850345,33
0,474,5018,3575850312,3575850347,35
0,474,5019,3575850312,3575850348,36
0,474,5020,3575850312,3575850348,36
0,474,5021,3575850312,3575850350,38
0,474,5022,3575850312,3575850355,43
0,474,5023,3575850312,3575850356,44
0,474,5024,3575850312,3575850356,44
0,474,5025,3575850312,3575850357,45
0,474,5026,3575850312,3575850358,46
0,474,5027,3575850312,3575850359,47
0,474,5028,3575850312,3575850362,50
0,475,5029,3575850365,3575850365,0
0,475,5030,3575850365,3575850365,0
0,475,5031,3575850365,3575850367,2
0,475,5032,3575850365,3575850371,6
0,475,5033,3575850365,3575850372,7
0,475,5034,3575850365,3575850373,8
0,475,5035,3575850365,3575850373,8
0,475,5036,3575850365,3575850376,11
0,475,5037,3575850365,3575850378,13
0,475,5038,3575850365,3575850379,14
0,475,5039,3575850365,3575850383,18
0,475,5040,3575850365,3575850387,22
0,475,5041,3575850365,3575850387,22
0,475,5042,3575850365,3575850395,30
0,475,5043,3575850365,3575850395,30
0,475,5044,3575850365,3575850396,31
0,475,5045,3575850365,3575850399,34
0,475,5046,3575850365,3575850399,34
0,475,5047,3575850365,3575850400,35
0,475,5048,3575850365,3575850401,36
0,475,5049,3575850365,3575850408,43
0,475,5050,3575850365,3575850408,43
0,475,5051,3575850365,3575850415,50
0,476,5052,3575850418,3575850418,0
0,476,5053,3575850418,3575850420,2
0,476,5054,3575850418,3575850421,3
0,476,5055,3575850418,3575850426,8
0,476,5056,3575850418,3575850429,11
0,476,5057,3575850418,3575850430,12
0,476,5058,3575850418,3575850432,14
0,476,5059,3575850418,3575850433,15
0,476,5060,3575850418,3575850433,15
0,476,5061,3575850418,3575850433,15
0,476,5062,3575850418,3575850436,18
0,476,5063,3575850418,3575850438,20
0,476,5064,3575850418,3575850441,23
0,476,5065,3575850418,3575850442,24
0,476,5066,3575850418,3575850442,24
0,476,5067,3575850418,3575850448,30
0,476,5068,3575850418,3575850448,30
0,476,5069,3575850418,3575850453,35
0,476,5070,3575850418,3575850459,41
0,476,5071,3575850418,3575850459,41
0,476,5072,3575850418,3575850460,42
0,476,5073,3575850418,3575850462,44
0,476,5074,3575850418,3575850467,49
0,476,5075,3575850418,3575850467,49
0,477,5076,3575850471,3575850471,0
0,477,5077,3575850471,3575850476,5
0,477,5078,3575850471,3575850479,8
0,477,5079,3575850471,3575850484,13
0,477,5080,3575850471,3575850485,14
0,477,5081,3575850471,3575850488,17
0,477,5082,3575850471,3575850488,17
0,477,5083,3575850471,3575850489,18
0,477,5084,3575850471,3575850490,19
0,477,5085,3575850471,3575850490,19
0,477,5086,3575850471,3575850492,21
0,477,5087,3575850471,3575850492,21
0,477,5088,3575850471,3575850493,22
0,477,5089,3575850471,3575850495,24
0,477,5090,3575850471,3575850496,25
0,477,5091,3575850471,3575850500,29
0,477,5092,3575850471,3575850501,30
0,477,5093,3575850471,3575850501,30
0,477,5094,3575850471,3575850502,31
0,477,5095,3575850471,3575850505,34
0,477,5096,3575850471,3575850507,36
0,477,5097,3575850471,3575850507,36
0,477,5098,3575850471,3575850507,36
0,477,5099,3575850471,3575850510,39
0,477,5100,3575850471,3575850510,39
0,477,5101,3575850471,3575850514,43
0,477,5102,3575850471,3575850516,45
0,477,5103,3575850471,3575850518,47
0,477,5104,3575850471,3575850519,48
0,477,5105,3575850471,3575850520,49
0,478,5106,3575850525,3575850525,0
0,478,5107,3575850525,3575850525,0
0,478,5108,3575850525,3575850525,0
0,478,5109,3575850525,3575850525,0
0,478,5110,3575850525,3575850525,0
0,478,5111,3575850525,3575850526,1
0,478,5112,3575850525,3575850527,2
0,478,5113,3575850525,3575850530,5
0,478,5114,3575850525,3575850534,9
0,478,5115,3575850525,3575850534,9
0,478,5116,3575850525,3575850535,10
0,478,5117,3575850525,3575850536,11
0,478,5118,3575850525,3575850536,11
0,478,5119,3575850525,3575850537,12
0,478,5120,3575850525,3575850538,13
0,478,5121,3575850525,3575850540,15
0,478,5122,3575850525,3575850541,16
0,478,5123,3575850525,3575850542,17
0,478,5124,3575850525,3575850544,19
0,478,5125,3575850525,3575850547,22
0,478,5126,3575850525,3575850547,22
0,478,5127,3575850525,3575850547,22
0,478,5128,3575850525,3575850550,25
0,478,5129,3575850525,3575850554,29
0,478,5130,3575850525,3575850555,30
0,478,5131,3575850525,3575850555,30
0,478,5132,3575850525,3575850556,31
0,478,5133,3575850525,3575850558,33
0,478,5134,3575850525,3575850560,35
0,478,5135,3575850525,3575850560,35
0,478,5136,3575850525,3575850561,36
0,478,5137,3575850525,3575850565,40
0,478,5138,3575850525,3575850566,41
0,478,5139,3575850525,3575850570,45
0,478,5140,3575850525,3575850571,46
0,478,5141,3575850525,3575850572,47
0,478,5142,3575850525,3575850573,48
0,479,5143,3575850579,3575850579,0
0,479,5144,3575850579,3575850579,0
0,479,5145,3575850579,3575850579,0
0,479,5146,3575850579,3575850582,3
0,479,5147,3575850579,3575850585,6
0,479,5148,3575850579,3575850586,7
0,479,5149,3575850579,3575850594,15
0,479,5150,3575850579,3575850594,15
0,479,5151,3575850579,3575850595,16
0,479,5152,3575850579,3575850597,18
0,479,5153,3575850579,3575850598,19
0,479,5154,3575850579,3575850599,20
0,479,5155,3575850579,3575850601,22
0,479,5156,3575850579,3575850608,29
0,479,5157,3575850579,3575850612,33
0,479,5158,3575850579,3575850613,34
0,479,5159,3575850579,3575850620,41
0,479,5160,3575850579,3575850620,41
0,479,5161,3575850579,3575850626,47
0,479,5162,3575850579,3575850629,50
0,480,5163,3575850632,3575850632,0
0,480,5164,3575850632,3575850632,0
0,480,5165,3575850632,3575850632,0
0,480,5166,3575850632,3575850632,0
0,480,5167,3575850632,3575850632,0
0,480,5168,3575850632,3575850635,3
0,480,5169,3575850632,3575850637,5
0,480,5170,3575850632,3575850641,9
0,480,5171,3575850632,3575850641,9
0,480,5172,3575850632,3575850642,10
0,480,5173,3575850632,3575850646,14
0,480,5174,3575850632,3575850647,15
0,480,5175,3575850632,3575850653,21
0,480,5176,3575850632,3575850658,26
0,480,5177,3575850632,3575850658,26
0,480,5178,3575850632,3575850659,27
0,480,5179,3575850632,3575850661,29
0,480,5180,3575850632,3575850662,30
0,480,5181,3575850632,3575850666,34
0,480,5182,3575850632,3575850667,35
0,480,5183,3575850632,3575850669,37
0,480,5184,3575850632,3575850677,45
0,480,5185,3575850632,3575850679,47
0,481,5186,3575850685,3575850685,0
0,481,5187,3575850685,3575850685,0
0,481,5188,3575850685,3575850688,3
0,481,5189,3575850685,3575850689,4
0,481,5190,3575850685,3575850689,4
0,481,5191,3575850685,3575850690,5
0,481,5192,3575850685,3575850691,6
0,481,5193,3575850685,3575850692,7
0,481,5194,3575850685,3575850693,8
0,481,5195,3575850685,3575850693,8
0,481,5196,3575850685,3575850694,9
0,481,5197,3575850685,3575850696,11
0,481,5198,3575850685,3575850701,16
0,481,5199,3575850685,3575850701,16
0,481,5200,3575850685,3575850702,17
0,481,5201,3575850685,3575850702,17
0,481,5202,3575850685,3575850707,22
0,481,5203,3575850685,3575850707,22
0,481,5204,3575850685,3575850707,22
0,481,5205,3575850685,3575850710,25
0,481,5206,3575850685,3575850710,25
0,481,5207,3575850685,3575850712,27
0,481,5208,3575850685,3575850714,29
0,481,5209,3575850685,3575850716,31
0,481,5210,3575850685,3575850717,32
0,481,5211,3575850685,3575850718,33
0,481,5212,3575850685,3575850719,34
0,481,5213,3575850685,3575850721,36
0,481,5214,3575850685,3575850723,38
0,481,5215,3575850685,3575850723,38
0,481,5216,3575850685,3575850723,38
0,481,5217,3575850685,3575850724,39
0,481,5218,3575850685,3575850725,40
0,481,5219,3575850685,3575850727,42
0,481,5220,3575850685,3575850730,45
0,481,5221,3575850685,3575850734,49
0,481,5222,3575850685,3575850734,49
0,481,5223,3575850685,3575850735,50
0,482,5224,3575850738,3575850739,1
0,482,5225,3575850738,3575850739,1
0,482,5226,3575850738,3575850739,1
0,482,5227,3575850738,3575850739,1
0,482,5228,3575850738,3575850741,3
0,482,5229,3575850738,3575850741,3
0,482,5230,3575850738,3575850742,4
0,482,5231,3575850738,3575850744,6
0,482,5232,3575850738,3575850747,9
0,482,5233,3575850738,3575850747,9
0,482,5234,3575850738,3575850748,10
0,482,5235,3575850738,3575850750,12
0,482,5236,3575850738,3575850750,12
0,482,5237,3575850738,3575850754,16
0,482,5238,3575850738,3575850754,16
0,482,5239,3575850738,3575850754,16
0,482,5240,3575850738,3575850756,18
0,482,5241,3575850738,3575850758,20
0,482,5242,3575850738,3575850760,22
0,482,5243,3575850738,3575850761,23
0,482,5244,3575850738,3575850763,25
0,482,5245,3575850738,3575850765,27
0,482,5246,3575850738,3575850766,28
0,482,5247,3575850738,3575850770,32
0,482,5248,3575850738,3575850771,33
0,482,5249,3575850738,3575850773,35
0,482,5250,3575850738,3575850773,35
0,482,5251,3575850738,3575850777,39
0,482,5252,3575850738,3575850777,39
0,482,5253,3575850738,3575850780,42
0,482,5254,3575850738,3575850782,44
0,482,5255,3575850738,3575850785,47
0,482,5256,3575850738,3575850786,48
0,483,5257,3575850791,3575850795,4
0,483,5258,3575850791,3575850796,5
0,483,5259,3575850791,3575850798,7
0,483,5260,3575850791,3575850799,8
0,483,5261,3575850791,3575850799,8
0,483,5262,3575850791,3575850801,10
0,483,5263,3575850791,3575850808,17
0,483,5264,3575850791,3575850813,22
0,483,5265,3575850791,3575850815,24
0,483,5266,3575850791,3575850820,29
0,483,5267,3575850791,3575850822,31
0,483,5268,3575850791,3575850827,36
0,483,5269,3575850791,3575850828,37
0,483,5270,3575850791,3575850830,39
0,483,5271,3575850791,3575850831,40
0,483,5272,3575850791,3575850831,40
0,483,5273,3575850791,3575850832,41
0,483,5274,3575850791,3575850832,41
0,483,5275,3575850791,3575850835,44
0,483,5276,3575850791,3575850836,45
0,484,5277,3575850844,3575850844,0
0,484,5278,3575850844,3575850844,0
0,484,5279,3575850844,3575850844,0
0,484,5280,3575850844,3575850846,2
0,484,5281,3575850844,3575850847,3
0,484,5282,3575850844,3575850854,10
0,484,5283,3575850844,3575850858,14
0,484,5284,3575850844,3575850858,14
0,484,5285,3575850844,3575850859,15
0,484,5286,3575850844,3575850860,16
0,484,5287,3575850844,3575850865,21
0,484,5288,3575850844,3575850866,22
0,484,5289,3575850844,3575850867,23
0,484,5290,3575850844,3575850870,26
0,484,5291,3575850844,3575850877,33
0,484,5292,3575850844,3575850879,35
0,484,5293,3575850844,3575850884,40
0,484,5294,3575850844,3575850885,41
0,484,5295,3575850844,3575850888,44
0,484,5296,3575850844,3575850889,45
0,484,5297,3575850844,3575850889,45
0,484,5298,3575850844,3575850890,46
0,484,5299,3575850844,3575850891,47
0,484,5300,3575850844,3575850891,47
0,484,5301,3575850844,3575850893,49
0,484,5302,3575850844,3575850893,49
0,484,5303,3575850844,3575850894,50
0,485,5304,3575850897,3575850897,0
0,485,5305,3575850897,3575850898,1
0,485,5306,3575850897,3575850900,3
0,485,5307,3575850897,3575850901,4
0,485,5308,3575850897,3575850903,6
0,485,5309,3575850897,3575850903,6
0,485,5310,3575850897,3575850907,10
0,485,5311,3575850897,3575850907,10
0,485,5312,3575850897,3575850907,10
0,485,5313,3575850897,3575850910,13
0,485,5314,3575850897,3575850911,14
0,485,5315,3575850897,3575850912,15
0,485,5316,3575850897,3575850914,17
0,485,5317,3575850897,3575850915,18
0,485,5318,3575850897,3575850916,19
0,485,5319,3575850897,3575850917,20
0,485,5320,3575850897,3575850918,21
0,485,5321,3575850897,3575850919,22
0,485,5322,3575850897,3575850920,23
0,485,5323,3575850897,3575850923,26
0,485,5324,3575850897,3575850923,26
0,485,5325,3575850897,3575850923,26
0,485,5326,3575850897,3575850924,27
0,485,5327,3575850897,3575850924,27
0,485,5328,3575850897,3575850927,30
0,485,5329,3575850897,3575850929,32
0,485,5330,3575850897,3575850934,37
0,485,5331,3575850897,3575850935,38
0,485,5332,3575850897,3575850935,38
0,485,5333,3575850897,3575850936,39
0,485,5334,3575850897,3575850937,40
0,485,5335,3575850897,3575850937,40
0,485,5336,3575850897,3575850941,44
0,485,5337,3575850897,3575850942,45
0,485,5338,3575850897,3575850944,47
0,485,5339,3575850897,3575850944,47
0,485,5340,3575850897,3575850946,49
0,485,5341,3575850897,3575850947,50
0,486,5342,3575850950,3575850950,0
0,486,5343,3575850950,3575850950,0
0,486,5344,3575850950,3575850950,0
0,486,5345,3575850950,3575850954,4
0,486,5346,3575850950,3575850955,5
0,486,5347,3575850950,3575850955,5
0,486,5348,3575850950,3575850957,7
0,486,5349,3575850950,3575850960,10
0,486,5350,3575850950,3575850961,11
0,486,5351,3575850950,3575850965,15
0,486,5352,3575850950,3575850966,16
0,486,5353,3575850950,3575850966,16
0,486,5354,3575850950,3575850971,21
0,486,5355,3575850950,3575850973,23
0,486,5356,3575850950,3575850974,24
0,486,5357,3575850950,3575850977,27
0,486,5358,3575850950,3575850977,27
0,486,5359,3575850950,3575850978,28
0,486,5360,3575850950,3575850980,30
0,486,5361,3575850950,3575850982,32
0,486,5362,3575850950,3575850985,35
0,486,5363,3575850950,3575850986,36
0,486,5364,3575850950,3575850995,45
0,486,5365,3575850950,3575850995,45
0,486,5366,3575850950,3575850998,48
0,486,5367,3575850950,3575850999,49
0,486,5368,3575850950,3575851000,50
0,487,5369,3575851003,3575851003,0
0,487,5370,3575851003,3575851008,5
0,487,5371,3575851003,3575851014,11
0,487,5372,3575851003,3575851017,14
0,487,5373,3575851003,3575851020,17
0,487,5374,3575851003,3575851022,19
0,487,5375,3575851003,3575851027,24
0,487,5376,3575851003,3575851028,25
0,487,5377,3575851003,3575851029,26
0,487,5378,3575851003,3575851032,29
0,487,5379,3575851003,3575851032,29
0,487,5380,3575851003,3575851032,29
0,487,5381,3575851003,3575851032,29
0,487,5382,3575851003,3575851035,32
0,487,5383,3575851003,3575851037,34
0,487,5384,3575851003,3575851042,39
0,487,5385,3575851003,3575851042,39
0,487,5386,3575851003,3575851043,40
0,487,5387,3575851003,3575851046,43
0,487,5388,3575851003,3575851048,45
0,488,5389,3575851057,3575851057,0
0,488,5390,3575851057,3575851058,1
0,488,5391,3575851057,3575851058,1
0,488,5392,3575851057,3575851059,2
0,488,5393,3575851057,3575851062,5
0,488,5394,3575851057,3575851066,9
0,488,5395,3575851057,3575851066,9
0,488,5396,3575851057,3575851067,10
0,488,5397,3575851057,3575851070,13
0,488,5398,3575851057,3575851077,20
0,488,5399,3575851057,3575851079,22
0,488,5400,3575851057,3575851084,27
0,488,5401,3575851057,3575851086,29
0,488,5402,3575851057,3575851088,31
0,488,5403,3575851057,3575851089,32
0,488,5404,3575851057,3575851090,33
0,488,5405,3575851057,3575851090,33
0,488,5406,3575851057,3575851090,33
0,488,5407,3575851057,3575851091,34
0,488,5408,3575851057,3575851093,36
0,488,5409,3575851057,3575851094,37
0,488,5410,3575851057,3575851094,37
0,488,5411,3575851057,3575851095,38
0,488,5412,3575851057,3575851098,41
0,488,5413,3575851057,3575851100,43
0,488,5414,3575851057,3575851101,44
0,488,5415,3575851057,3575851103,46
0,488,5416,3575851057,3575851103,46
0,488,5417,3575851057,3575851105,48
0,488,5418,3575851057,3575851107,50
0,489,5419,3575851111,3575851111,0
0,489,5420,3575851111,3575851111,0
0,489,5421,3575851111,3575851112,1
0,489,5422,3575851111,3575851113,2
0,489,5423,3575851111,3575851117,6
0,489,5424,3575851111,3575851117,6
0,489,5425,3575851111,3575851118,7
0,489,5426,3575851111,3575851118,7
0,489,5427,3575851111,3575851120,9
0,489,5428,3575851111,3575851120,9
0,489,5429,3575851111,3575851124,13
0,489,5430,3575851111,3575851124,13
0,489,5431,3575851111,3575851124,13
0,489,5432,3575851111,3575851124,13
0,489,5433,3575851111,3575851124,13
0,489,5434,3575851111,3575851126,15
0,489,5435,3575851111,3575851127,16
0,489,5436,3575851111,3575851130,19
0,489,5437,3575851111,3575851134,23
0,489,5438,3575851111,3575851135,24
0,489,5439,3575851111,3575851136,25
0,489,5440,3575851111,3575851137,26
0,489,5441,3575851111,3575851137,26
0,489,5442,3575851111,3575851137,26
0,489,5443,3575851111,3575851141,30
0,489,5444,3575851111,3575851142,31
0,489,5445,3575851111,3575851144,33
0,489,5446,3575851111,3575851145,34
0,489,5447,3575851111,3575851147,36
0,489,5448,3575851111,3575851147,36
0,489,5449,3575851111,3575851147,36
0,489,5450,3575851111,3575851150,39
0,489,5451,3575851111,3575851150,39
0,489,5452,3575851111,3575851154,43
0,489,5453,3575851111,3575851155,44
0,489,5454,3575851111,3575851156,45
0,489,5455,3575851111,3575851157,46
0,489,5456,3575851111,3575851160,49
0,489,5457,3575851111,3575851161,50
0,490,5458,3575851164,3575851165,1
0,490,5459,3575851164,3575851166,2
0,490,5460,3575851164,3575851169,5
0,490,5461,3575851164,3575851171,7
0,490,5462,3575851164,3575851172,8
0,490,5463,3575851164,3575851173,9
0,490,5464,3575851164,3575851177,13
0,490,5465,3575851164,3575851178,14
0,490,5466,3575851164,3575851179,15
0,490,5467,3575851164,3575851179,15
0,490,5468,3575851164,3575851184,20
0,490,5469,3575851164,3575851186,22
0,490,5470,3575851164,3575851187,23
0,490,5471,3575851164,3575851194,30
0,490,5472,3575851164,3575851196,32
0,490,5473,3575851164,3575851197,33
0,490,5474,3575851164,3575851198,34
0,490,5475,3575851164,3575851199,35
0,490,5476,3575851164,3575851200,36
0,490,5477,3575851164,3575851208,44
0,490,5478,3575851164,3575851214,50
0,491,5479,3575851217,3575851217,0
0,491,5480,3575851217,3575851219,2
0,491,5481,3575851217,3575851221,4
0,491,5482,3575851217,3575851223,6
0,491,5483,3575851217,3575851227,10
0,491,5484,3575851217,3575851228,11
0,491,5485,3575851217,3575851230,13
0,491,5486,3575851217,3575851232,15
0,491,5487,3575851217,3575851232,15
0,491,5488,3575851217,3575851233,16
0,491,5489,3575851217,3575851234,17
0,491,5490,3575851217,3575851235,18
0,491,5491,3575851217,3575851237,20
0,491,5492,3575851217,3575851241,24
0,491,5493,3575851217,3575851241,24
0,491,5494,3575851217,3575851243,26
0,491,5495,3575851217,3575851247,30
0,491,5496,3575851217,3575851248,31
0,491,5497,3575851217,3575851253,36
0,491,5498,3575851217,3575851258,41
0,491,5499,3575851217,3575851259,42
0,491,5500,3575851217,3575851259,42
0,491,5501,3575851217,3575851262,45
0,491,5502,3575851217,3575851266,49
0,491,5503,3575851217,3575851267,50
0,492,5504,3575851271,3575851271,0
0,492,5505,3575851271,3575851271,0
0,492,5506,3575851271,3575851276,5
0,492,5507,3575851271,3575851279,8
0,492,5508,3575851271,3575851284,13
0,492,5509,3575851271,3575851285,14
0,492,5510,3575851271,3575851288,17
0,492,5511,3575851271,3575851289,18
0,492,5512,3575851271,3575851290,19
0,492,5513,3575851271,3575851290,19
0,492,5514,3575851271,3575851291,20
0,492,5515,3575851271,3575851293,22
0,492,5516,3575851271,3575851294,23
0,492,5517,3575851271,3575851294,23
0,492,5518,3575851271,3575851296,25
0,492,5519,3575851271,3575851298,27
0,492,5520,3575851271,3575851300,29
0,492,5521,3575851271,3575851302,31
0,492,5522,3575851271,3575851303,32
0,492,5523,3575851271,3575851304,33
0,492,5524,3575851271,3575851306,35
0,492,5525,3575851271,3575851307,36
0,492,5526,3575851271,3575851307,36
0,492,5527,3575851271,3575851310,39
0,492,5528,3575851271,3575851310,39
0,492,5529,3575851271,3575851312,41
0,492,5530,3575851271,3575851313,42
0,492,5531,3575851271,3575851315,44
0,492,5532,3575851271,3575851317,46
0,492,5533,3575851271,3575851317,46
0,492,5534,3575851271,3575851317,46
0,492,5535,3575851271,3575851320,49
0,492,5536,3575851271,3575851320,49
0,492,5537,3575851271,3575851321,50
0,493,5538,3575851325,3575851325,0
0,493,5539,3575851325,3575851325,0
0,493,5540,3575851325,3575851325,0
0,493,5541,3575851325,3575851325,0
0,493,5542,3575851325,3575851325,0
0,493,5543,3575851325,3575851327,2
0,493,5544,3575851325,3575851327,2
0,493,5545,3575851325,3575851330,5
0,493,5546,3575851325,3575851335,10
0,493,5547,3575851325,3575851335,10
0,493,5548,3575851325,3575851336,11
0,493,5549,3575851325,3575851336,11
0,493,5550,3575851325,3575851336,11
0,493,5551,3575851325,3575851338,13
0,493,5552,3575851325,3575851341,16
0,493,5553,3575851325,3575851342,17
0,493,5554,3575851325,3575851343,18
0,493,5555,3575851325,3575851345,20
0,493,5556,3575851325,3575851348,23
0,493,5557,3575851325,3575851348,23
0,493,5558,3575851325,3575851348,23
0,493,5559,3575851325,3575851350,25
0,493,5560,3575851325,3575851351,26
0,493,5561,3575851325,3575851354,29
0,493,5562,3575851325,3575851354,29
0,493,5563,3575851325,3575851356,31
0,493,5564,3575851325,3575851357,32
0,493,5565,3575851325,3575851359,34
0,493,5566,3575851325,3575851360,35
0,493,5567,3575851325,3575851362,37
0,493,5568,3575851325,3575851365,40
0,493,5569,3575851325,3575851366,41
0,493,5570,3575851325,3575851371,46
0,493,5571,3575851325,3575851372,47
0,493,5572,3575851325,3575851372,47
0,493,5573,3575851325,3575851374,49
0,494,5574,3575851379,3575851379,0
0,494,5575,3575851379,3575851379,0
0,494,5576,3575851379,3575851379,0
0,494,5577,3575851379,3575851379,0
0,494,5578,3575851379,3575851379,0
0,494,5579,3575851379,3575851384,5
0,494,5580,3575851379,3575851387,8
0,494,5581,3575851379,3575851394,15
0,494,5582,3575851379,3575851394,15
0,494,5583,3575851379,3575851396,17
0,494,5584,3575851379,3575851398,19
0,494,5585,3575851379,3575851398,19
0,494,5586,3575851379,3575851399,20
0,494,5587,3575851379,3575851401,22
0,494,5588,3575851379,3575851408,29
0,494,5589,3575851379,3575851414,35
0,494,5590,3575851379,3575851417,38
0,494,5591,3575851379,3575851421,42
0,494,5592,3575851379,3575851422,43
0,494,5593,3575851379,3575851426,47
0,494,5594,3575851379,3575851429,50
0,495,5595,3575851432,3575851432,0
0,495,5596,3575851432,3575851432,0
0,495,5597,3575851432,3575851432,0
0,495,5598,3575851432,3575851432,0
0,495,5599,3575851432,3575851433,1
0,495,5600,3575851432,3575851435,3
0,495,5601,3575851432,3575851437,5
0,495,5602,3575851432,3575851441,9
0,495,5603,3575851432,3575851442,10
0,495,5604,3575851432,3575851443,11
0,495,5605,3575851432,3575851447,15
0,495,5606,3575851432,3575851447,15
0,495,5607,3575851432,3575851454,22
0,495,5608,3575851432,3575851459,27
0,495,5609,3575851432,3575851459,27
0,495,5610,3575851432,3575851459,27
0,495,5611,3575851432,3575851462,30
0,495,5612,3575851432,3575851466,34
0,495,5613,3575851432,3575851466,34
0,495,5614,3575851432,3575851470,38
0,495,5615,3575851432,3575851476,44
0,495,5616,3575851432,3575851477,45
0,495,5617,3575851432,3575851479,47
0,496,5618,3575851485,3575851485,0
0,496,5619,3575851485,3575851485,0
0,496,5620,3575851485,3575851487,2
0,496,5621,3575851485,3575851488,3
0,496,5622,3575851485,3575851489,4
0,496,5623,3575851485,3575851489,4
0,496,5624,3575851485,3575851489,4
0,496,5625,3575851485,3575851493,8
0,496,5626,3575851485,3575851493,8
0,496,5627,3575851485,3575851495,10
0,496,5628,3575851485,3575851497,12
0,496,5629,3575851485,3575851499,14
0,496,5630,3575851485,3575851501,16
0,496,5631,3575851485,3575851502,17
0,496,5632,3575851485,3575851502,17
0,496,5633,3575851485,3575851505,20
0,496,5634,3575851485,3575851506,21
0,496,5635,3575851485,3575851506,21
0,496,5636,3575851485,3575851508,23
0,496,5637,3575851485,3575851509,24
0,496,5638,3575851485,3575851511,26
0,496,5639,3575851485,3575851514,29
0,496,5640,3575851485,3575851515,30
0,496,5641,3575851485,3575851517,32
0,496,5642,3575851485,3575851517,32
0,496,5643,3575851485,3575851518,33
0,496,5644,3575851485,3575851519,34
0,496,5645,3575851485,3575851522,37
0,496,5646,3575851485,3575851523,38
0,496,5647,3575851485,3575851523,38
0,496,5648,3575851485,3575851524,39
0,496,5649,3575851485,3575851525,40
0,496,5650,3575851485,3575851525,40
0,496,5651,3575851485,3575851527,42
0,496,5652,3575851485,3575851528,43
0,496,5653,3575851485,3575851529,44
0,496,5654,3575851485,3575851533,48
0,496,5655,3575851485,3575851534,49
0,497,5656,3575851538,3575851538,0
0,497,5657,3575851538,3575851538,0
0,497,5658,3575851538,3575851538,0
0,497,5659,3575851538,3575851538,0
0,497,5660,3575851538,3575851538,0
0,497,5661,3575851538,3575851540,2
0,497,5662,3575851538,3575851542,4
0,497,5663,3575851538,3575851543,5
0,497,5664,3575851538,3575851544,6
0,497,5665,3575851538,3575851547,9
0,497,5666,3575851538,3575851547,9
0,497,5667,3575851538,3575851549,11
0,497,5668,3575851538,3575851550,12
0,497,5669,3575851538,3575851553,15
0,497,5670,3575851538,3575851554,16
0,497,5671,3575851538,3575851555,17
0,497,5672,3575851538,3575851556,18
0,497,5673,3575851538,3575851558,20
0,497,5674,3575851538,3575851560,22
0,497,5675,3575851538,3575851561,23
0,497,5676,3575851538,3575851564,26
0,497,5677,3575851538,3575851565,27
0,497,5678,3575851538,3575851571,33
0,497,5679,3575851538,3575851571,33
0,497,5680,3575851538,3575851572,34
0,497,5681,3575851538,3575851576,38
0,497,5682,3575851538,3575851576,38
0,497,5683,3575851538,3575851577,39
0,497,5684,3575851538,3575851578,40
0,497,5685,3575851538,3575851578,40
0,497,5686,3575851538,3575851583,45
0,497,5687,3575851538,3575851586,48
0,498,5688,3575851592,3575851593,1
0,498,5689,3575851592,3575851594,2
0,498,5690,3575851592,3575851596,4
0,498,5691,3575851592,3575851598,6
0,498,5692,3575851592,3575851599,7
0,498,5693,3575851592,3575851601,9
0,498,5694,3575851592,3575851607,15
0,498,5695,3575851592,3575851613,21
0,498,5696,3575851592,3575851617,25
0,498,5697,3575851592,3575851620,28
0,498,5698,3575851592,3575851622,30
0,498,5699,3575851592,3575851627,35
0,498,5700,3575851592,3575851627,35
0,498,5701,3575851592,3575851629,37
0,498,5702,3575851592,3575851630,38
0,498,5703,3575851592,3575851631,39
0,498,5704,3575851592,3575851632,40
0,498,5705,3575851592,3575851632,40
0,498,5706,3575851592,3575851632,40
0,498,5707,3575851592,3575851634,42
0,498,5708,3575851592,3575851636,44
0,499,5709,3575851646,3575851646,0
0,499,5710,3575851646,3575851646,0
0,499,5711,3575851646,3575851646,0
0,499,5712,3575851646,3575851646,0
0,499,5713,3575851646,3575851647,1
0,499,5714,3575851646,3575851652,6
0,499,5715,3575851646,3575851657,11
0,499,5716,3575851646,3575851658,12
0,499,5717,3575851646,3575851661,15
0,499,5718,3575851646,3575851665,19
0,499,5719,3575851646,3575851666,20
0,499,5720,3575851646,3575851670,24
0,499,5721,3575851646,3575851676,30
0,499,5722,3575851646,3575851679,33
0,499,5723,3575851646,3575851679,33
0,499,5724,3575851646,3575851684,38
0,499,5725,3575851646,3575851686,40
0,499,5726,3575851646,3575851687,41
0,499,5727,3575851646,3575851688,42
0,499,5728,3575851646,3575851689,43
0,499,5729,3575851646,3575851689,43
0,499,5730,3575851646,3575851690,44
0,499,5731,3575851646,3575851693,47
0,499,5732,3575851646,3575851693,47
0,499,5733,3575851646,3575851695,49
0,500,5734,3575851700,3575851700,0
0,500,5735,3575851700,3575851700,0
0,500,5736,3575851700,3575851701,1
0,500,5737,3575851700,3575851701,1
0,500,5738,3575851700,3575851702,2
0,500,5739,3575851700,3575851704,4
0,500,5740,3575851700,3575851706,6
0,500,5741,3575851700,3575851706,6
0,500,5742,3575851700,3575851708,8
0,500,5743,3575851700,3575851709,9
0,500,5744,3575851700,3575851712,12
0,500,5745,3575851700,3575851714,14
0,500,5746,3575851700,3575851716,16
0,500,5747,3575851700,3575851717,17
0,500,5748,3575851700,3575851718,18
0,500,5749,3575851700,3575851719,19
0,500,5750,3575851700,3575851719,19
0,500,5751,3575851700,3575851723,23
0,500,5752,3575851700,3575851723,23
0,500,5753,3575851700,3575851724,24
0,500,5754,3575851700,3575851724,24
0,500,5755,3575851700,3575851725,25
0,500,5756,3575851700,3575851725,25
0,500,5757,3575851700,3575851728,28
0,500,5758,3575851700,3575851728,28
0,500,5759,3575851700,3575851729,29
0,500,5760,3575851700,3575851734,34
0,500,5761,3575851700,3575851734,34
0,500,5762,3575851700,3575851735,35
0,500,5763,3575851700,3575851735,35
0,500,5764,3575851700,3575851736,36
0,500,5765,3575851700,3575851738,38
0,500,5766,3575851700,3575851738,38
0,500,5767,3575851700,3575851740,40
0,500,5768,3575851700,3575851742,42
0,500,5769,3575851700,3575851743,43
0,500,5770,3575851700,3575851744,44
0,500,5771,3575851700,3575851747,47
0,500,5772,3575851700,3575851747,47
0,500,5773,3575851700,3575851749,49
0,500,5774,3575851700,3575851750,50
0,501,5775,3575851753,3575851753,0
0,501,5776,3575851753,3575851754,1
0,501,5777,3575851753,3575851754,1
0,501,5778,3575851753,3575851756,3
0,501,5779,3575851753,3575851759,6
0,501,5780,3575851753,3575851761,8
0,501,5781,3575851753,3575851761,8
0,501,5782,3575851753,3575851763,10
0,501,5783,3575851753,3575851765,12
0,501,5784,3575851753,3575851770,17
0,501,5785,3575851753,3575851771,18
0,501,5786,3575851753,3575851773,20
0,501,5787,3575851753,3575851776,23
0,501,5788,3575851753,3575851777,24
0,501,5789,3575851753,3575851778,25
0,501,5790,3575851753,3575851778,25
0,501,5791,3575851753,3575851778,25
0,501,5792,3575851753,3575851779,26
0,501,5793,3575851753,3575851780,27
0,501,5794,3575851753,3575851784,31
0,501,5795,3575851753,3575851785,32
0,501,5796,3575851753,3575851787,34
0,501,5797,3575851753,3575851793,40
0,501,5798,3575851753,3575851794,41
0,501,5799,3575851753,3575851795,42
0,501,5800,3575851753,3575851798,45
0,501,5801,3575851753,3575851799,46
0,501,5802,3575851753,3575851800,47
0,501,5803,3575851753,3575851801,48
0,502,5804,3575851806,3575851808,2
0,502,5805,3575851806,3575851814,8
0,502,5806,3575851806,3575851817,11
0,502,5807,3575851806,3575851820,14
0,502,5808,3575851806,3575851822,16
0,502,5809,3575851806,3575851826,20
0,502,5810,3575851806,3575851829,23
0,502,5811,3575851806,3575851830,24
0,502,5812,3575851806,3575851830,24
0,502,5813,3575851806,3575851831,25
0,502,5814,3575851806,3575851832,26
0,502,5815,3575851806,3575851832,26
0,502,5816,3575851806,3575851832,26
0,502,5817,3575851806,3575851834,28
0,502,5818,3575851806,3575851836,30
0,502,5819,3575851806,3575851842,36
0,502,5820,3575851806,3575851843,37
0,502,5821,3575851806,3575851846,40
0,502,5822,3575851806,3575851847,41
0,502,5823,3575851806,3575851852,46
0,503,5824,3575851860,3575851860,0
0,503,5825,3575851860,3575851860,0
0,503,5826,3575851860,3575851861,1
0,503,5827,3575851860,3575851866,6
0,503,5828,3575851860,3575851866,6
0,503,5829,3575851860,3575851870,10
0,503,5830,3575851860,3575851877,17
0,503,5831,3575851860,3575851879,19
0,503,5832,3575851860,3575851880,20
0,503,5833,3575851860,3575851880,20
0,503,5834,3575851860,3575851884,24
0,503,5835,3575851860,3575851885,25
0,503,5836,3575851860,3575851887,27
0,503,5837,3575851860,3575851888,28
0,503,5838,3575851860,3575851889,29
0,503,5839,3575851860,3575851889,29
0,503,5840,3575851860,3575851890,30
0,503,5841,3575851860,3575851891,31
0,503,5842,3575851860,3575851892,32
0,503,5843,3575851860,3575851893,33
0,503,5844,3575851860,3575851893,33
0,503,5845,3575851860,3575851895,35
0,503,5846,3575851860,3575851898,38
0,503,5847,3575851860,3575851900,40
0,503,5848,3575851860,3575851901,41
0,503,5849,3575851860,3575851901,41
0,503,5850,3575851860,3575851902,42
0,503,5851,3575851860,3575851905,45
0,503,5852,3575851860,3575851906,46
0,503,5853,3575851860,3575851908,48
0,503,5854,3575851860,3575851909,49
0,504,5855,3575851913,3575851913,0
0,504,5856,3575851913,3575851914,1
0,504,5857,3575851913,3575851916,3
0,504,5858,3575851913,3575851917,4
0,504,5859,3575851913,3575851918,5
0,504,5860,3575851913,3575851919,6
0,504,5861,3575851913,3575851919,6
0,504,5862,3575851913,3575851923,10
0,504,5863,3575851913,3575851923,10
0,504,5864,3575851913,3575851923,10
0,504,5865,3575851913,3575851924,11
0,504,5866,3575851913,3575851926,13
0,504,5867,3575851913,3575851926,13
0,504,5868,3575851913,3575851927,14
0,504,5869,3575851913,3575851928,15
0,504,5870,3575851913,3575851930,17
0,504,5871,3575851913,3575851931,18
0,504,5872,3575851913,3575851934,21
0,504,5873,3575851913,3575851935,22
0,504,5874,3575851913,3575851935,22
0,504,5875,3575851913,3575851937,24
0,504,5876,3575851913,3575851937,24
0,504,5877,3575851913,3575851939,26
0,504,5878,3575851913,3575851940,27
0,504,5879,3575851913,3575851942,29
0,504,5880,3575851913,3575851943,30
0,504,5881,3575851913,3575851944,31
0,504,5882,3575851913,3575851947,34
0,504,5883,3575851913,3575851947,34
0,504,5884,3575851913,3575851948,35
0,504,5885,3575851913,3575851950,37
0,504,5886,3575851913,3575851950,37
0,504,5887,3575851913,3575851953,40
0,504,5888,3575851913,3575851955,42
0,504,5889,3575851913,3575851955,42
0,504,5890,3575851913,3575851957,44
0,504,5891,3575851913,3575851959,46
0,504,5892,3575851913,3575851961,48
0,504,5893,3575851913,3575851961,48
0,505,5894,3575851967,3575851967,0
0,505,5895,3575851967,3575851967,0
0,505,5896,3575851967,3575851971,4
0,505,5897,3575851967,3575851971,4
0,505,5898,3575851967,3575851972,5
0,505,5899,3575851967,3575851974,7
0,505,5900,3575851967,3575851976,9
0,505,5901,3575851967,3575851976,9
0,505,5902,3575851967,3575851977,10
0,505,5903,3575851967,3575851978,11
0,505,5904,3575851967,3575851978,11
0,505,5905,3575851967,3575851980,13
0,505,5906,3575851967,3575851982,15
0,505,5907,3575851967,3575851984,17
0,505,5908,3575851967,3575851986,19
0,505,5909,3575851967,3575851987,20
0,505,5910,3575851967,3575851994,27
0,505,5911,3575851967,3575851995,28
0,505,5912,3575851967,3575851996,29
0,505,5913,3575851967,3575851998,31
0,505,5914,3575851967,3575851999,32
0,505,5915,3575851967,3575852000,33
0,505,5916,3575851967,3575852001,34
0,505,5917,3575851967,3575852008,41
0,505,5918,3575851967,3575852014,47
0,506,5919,3575852020,3575852020,0
0,506,5920,3575852020,3575852021,1
0,506,5921,3575852020,3575852026,6
0,506,5922,3575852020,3575852029,9
0,506,5923,3575852020,3575852030,10
0,506,5924,3575852020,3575852032,12
0,506,5925,3575852020,3575852032,12
0,506,5926,3575852020,3575852033,13
0,506,5927,3575852020,3575852033,13
0,506,5928,3575852020,3575852034,14
0,506,5929,3575852020,3575852034,14
0,506,5930,3575852020,3575852036,16
0,506,5931,3575852020,3575852042,22
0,506,5932,3575852020,3575852043,23
0,506,5933,3575852020,3575852043,23
0,506,5934,3575852020,3575852045,25
0,506,5935,3575852020,3575852048,28
0,506,5936,3575852020,3575852053,33
0,506,5937,3575852020,3575852058,38
0,506,5938,3575852020,3575852059,39
0,506,5939,3575852020,3575852062,42
0,506,5940,3575852020,3575852066,46
0,506,5941,3575852020,3575852067,47
0,506,5942,3575852020,3575852070,50
0,507,5943,3575852073,3575852077,4
0,507,5944,3575852073,3575852079,6
0,507,5945,3575852073,3575852080,7
0,507,5946,3575852073,3575852083,10
0,507,5947,3575852073,3575852084,11
0,507,5948,3575852073,3575852085,12
0,507,5949,3575852073,3575852087,14
0,507,5950,3575852073,3575852088,15
0,507,5951,3575852073,3575852089,16
0,507,5952,3575852073,3575852089,16
0,507,5953,3575852073,3575852090,17
0,507,5954,3575852073,3575852091,18
0,507,5955,3575852073,3575852092,19
0,507,5956,3575852073,3575852092,19
0,507,5957,3575852073,3575852093,20
0,507,5958,3575852073,3575852095,22
0,507,5959,3575852073,3575852098,25
0,507,5960,3575852073,3575852100,27
0,507,5961,3575852073,3575852101,28
0,507,5962,3575852073,3575852101,28
0,507,5963,3575852073,3575852103,30
0,507,5964,3575852073,3575852105,32
0,507,5965,3575852073,3575852107,34
0,507,5966,3575852073,3575852108,35
0,507,5967,3575852073,3575852109,36
0,507,5968,3575852073,3575852112,39
0,507,5969,3575852073,3575852112,39
0,507,5970,3575852073,3575852114,41
0,507,5971,3575852073,3575852116,43
0,507,5972,3575852073,3575852117,44
0,507,5973,3575852073,3575852118,45
0,507,5974,3575852073,3575852119,46
0,507,5975,3575852073,3575852123,50
0,508,5976,3575852126,3575852126,0
0,508,5977,3575852126,3575852126,0
0,508,5978,3575852126,3575852126,0
0,508,5979,3575852126,3575852127,1
0,508,5980,3575852126,3575852127,1
0,508,5981,3575852126,3575852129,3
0,508,5982,3575852126,3575852129,3
0,508,5983,3575852126,3575852134,8
0,508,5984,3575852126,3575852134,8
0,508,5985,3575852126,3575852135,9
0,508,5986,3575852126,3575852135,9
0,508,5987,3575852126,3575852136,10
0,508,5988,3575852126,3575852136,10
0,508,5989,3575852126,3575852138,12
0,508,5990,3575852126,3575852138,12
0,508,5991,3575852126,3575852141,15
0,508,5992,3575852126,3575852143,17
0,508,5993,3575852126,3575852143,17
0,508,5994,3575852126,3575852145,19
0,508,5995,3575852126,3575852147,21
0,508,5996,3575852126,3575852147,21
0,508,5997,3575852126,3575852148,22
0,508,5998,3575852126,3575852149,23
0,508,5999,3575852126,3575852150,24
0,508,6000,3575852126,3575852154,28
0,508,6001,3575852126,3575852155,29
0,508,6002,3575852126,3575852155,29
0,508,6003,3575852126,3575852157,31
0,508,6004,3575852126,3575852160,34
0,508,6005,3575852126,3575852160,34
0,508,6006,3575852126,3575852161,35
0,508,6007,3575852126,3575852163,37
0,508,6008,3575852126,3575852164,38
0,508,6009,3575852126,3575852171,45
0,508,6010,3575852126,3575852173,47
0,508,6011,3575852126,3575852174,48
0,509,6012,3575852181,3575852181,0
0,509,6013,3575852181,3575852181,0
0,509,6014,3575852181,3575852181,0
0,509,6015,3575852181,3575852181,0
0,509,6016,3575852181,3575852181,0
0,509,6017,3575852181,3575852184,3
0,509,6018,3575852181,3575852185,4
0,509,6019,3575852181,3575852187,6
0,509,6020,3575852181,3575852187,6
0,509,6021,3575852181,3575852194,13
0,509,6022,3575852181,3575852195,14
0,509,6023,3575852181,3575852197,16
0,509,6024,3575852181,3575852197,16
0,509,6025,3575852181,3575852199,18
0,509,6026,3575852181,3575852201,20
0,509,6027,3575852181,3575852201,20
0,509,6028,3575852181,3575852208,27
0,509,6029,3575852181,3575852214,33
0,509,6030,3575852181,3575852221,40
0,509,6031,3575852181,3575852221,40
0,509,6032,3575852181,3575852227,46
0,509,6033,3575852181,3575852228,47
0,509,6034,3575852181,3575852231,50
0,510,6035,3575852235,3575852235,0
0,510,6036,3575852235,3575852235,0
0,510,6037,3575852235,3575852235,0
0,510,6038,3575852235,3575852235,0
0,510,6039,3575852235,3575852235,0
0,510,6040,3575852235,3575852236,1
0,510,6041,3575852235,3575852237,2
0,510,6042,3575852235,3575852242,7
0,510,6043,3575852235,3575852243,8
0,510,6044,3575852235,3575852243,8
0,510,6045,3575852235,3575852245,10
0,510,6046,3575852235,3575852248,13
0,510,6047,3575852235,3575852253,18
0,510,6048,3575852235,3575852258,23
0,510,6049,3575852235,3575852258,23
0,510,6050,3575852235,3575852260,25
0,510,6051,3575852235,3575852262,27
0,510,6052,3575852235,3575852266,31
0,510,6053,3575852235,3575852267,32
0,510,6054,3575852235,3575852270,35
0,510,6055,3575852235,3575852278,43
0,510,6056,3575852235,3575852279,44
0,510,6057,3575852235,3575852280,45
0,510,6058,3575852235,3575852284,49
0,511,6059,3575852289,3575852289,0
0,511,6060,3575852289,3575852289,0
0,511,6061,3575852289,3575852289,0
0,511,6062,3575852289,3575852289,0
0,511,6063,3575852289,3575852289,0
0,511,6064,3575852289,3575852290,1
0,511,6065,3575852289,3575852290,1
0,511,6066,3575852289,3575852291,2
0,511,6067,3575852289,3575852292,3
0,511,6068,3575852289,3575852293,4
0,511,6069,3575852289,3575852293,4
0,511,6070,3575852289,3575852295,6
0,511,6071,3575852289,3575852298,9
0,511,6072,3575852289,3575852299,10
0,511,6073,3575852289,3575852302,13
0,511,6074,3575852289,3575852302,13
0,511,6075,3575852289,3575852303,14
0,511,6076,3575852289,3575852305,16
0,511,6077,3575852289,3575852307,18
0,511,6078,3575852289,3575852309,20
0,511,6079,3575852289,3575852310,21
0,511,6080,3575852289,3575852311,22
0,511,6081,3575852289,3575852312,23
0,511,6082,3575852289,3575852314,25
0,511,6083,3575852289,3575852317,28
0,511,6084,3575852289,3575852318,29
0,511,6085,3575852289,3575852318,29
0,511,6086,3575852289,3575852319,30
0,511,6087,3575852289,3575852320,31
0,511,6088,3575852289,3575852322,33
0,511,6089,3575852289,3575852323,34
0,511,6090,3575852289,3575852325,36
0,511,6091,3575852289,3575852326,37
0,511,6092,3575852289,3575852326,37
0,511,6093,3575852289,3575852328,39
0,511,6094,3575852289,3575852329,40
0,511,6095,3575852289,3575852330,41
0,511,6096,3575852289,3575852334,45
0,511,6097,3575852289,3575852334,45
0,511,6098,3575852289,3575852335,46
0,511,6099,3575852289,3575852336,47
0,511,6100,3575852289,3575852336,47
0,511,6101,3575852289,3575852337,48
0,511,6102,3575852289,3575852338,49
0,512,6103,3575852343,3575852343,0
0,512,6104,3575852343,3575852343,0
0,512,6105,3575852343,3575852343,0
0,512,6106,3575852343,3575852343,0
0,512,6107,3575852343,3575852343,0
0,512,6108,3575852343,3575852345,2
0,512,6109,3575852343,3575852347,4
0,512,6110,3575852343,3575852348,5
0,512,6111,3575852343,3575852348,5
0,512,6112,3575852343,3575852349,6
0,512,6113,3575852343,3575852350,7
0,512,6114,3575852343,3575852354,11
0,512,6115,3575852343,3575852355,12
0,512,6116,3575852343,3575852355,12
0,512,6117,3575852343,3575852357,14
0,512,6118,3575852343,3575852360,17
0,512,6119,3575852343,3575852361,18
0,512,6120,3575852343,3575852362,19
0,512,6121,3575852343,3575852364,21
0,512,6122,3575852343,3575852366,23
0,512,6123,3575852343,3575852371,28
0,512,6124,3575852343,3575852373,30
0,512,6125,3575852343,3575852373,30
0,512,6126,3575852343,3575852376,33
0,512,6127,3575852343,3575852377,34
0,512,6128,3575852343,3575852378,35
0,512,6129,3575852343,3575852378,35
0,512,6130,3575852343,3575852378,35
0,512,6131,3575852343,3575852380,37
0,512,6132,3575852343,3575852384,41
0,512,6133,3575852343,3575852387,44
0,512,6134,3575852343,3575852387,44
0,512,6135,3575852343,3575852388,45
0,513,6136,3575852396,3575852396,0
0,513,6137,3575852396,3575852396,0
0,513,6138,3575852396,3575852396,0
0,513,6139,3575852396,3575852398,2
0,513,6140,3575852396,3575852399,3
0,513,6141,3575852396,3575852400,4
0,513,6142,3575852396,3575852400,4
0,513,6143,3575852396,3575852408,12
0,513,6144,3575852396,3575852414,18
0,513,6145,3575852396,3575852421,25
0,513,6146,3575852396,3575852427,31
0,513,6147,3575852396,3575852429,33
0,513,6148,3575852396,3575852431,35
0,513,6149,3575852396,3575852432,36
0,513,6150,3575852396,3575852433,37
0,513,6151,3575852396,3575852433,37
0,513,6152,3575852396,3575852433,37
0,513,6153,3575852396,3575852435,39
0,513,6154,3575852396,3575852438,42
0,513,6155,3575852396,3575852439,43
0,513,6156,3575852396,3575852442,46
0,513,6157,3575852396,3575852442,46
0,513,6158,3575852396,3575852442,46
0,513,6159,3575852396,3575852445,49
0,514,6160,3575852449,3575852449,0
0,514,6161,3575852449,3575852453,4
0,514,6162,3575852449,3575852459,10
0,514,6163,3575852449,3575852459,10
0,514,6164,3575852449,3575852460,11
0,514,6165,3575852449,3575852462,13
0,514,6166,3575852449,3575852466,17
0,514,6167,3575852449,3575852466,17
0,514,6168,3575852449,3575852470,21
0,514,6169,3575852449,3575852477,28
0,514,6170,3575852449,3575852480,31
0,514,6171,3575852449,3575852480,31
0,514,6172,3575852449,3575852484,35
0,514,6173,3575852449,3575852485,36
0,514,6174,3575852449,3575852487,38
0,514,6175,3575852449,3575852489,40
0,514,6176,3575852449,3575852489,40
0,514,6177,3575852449,3575852490,41
0,514,6178,3575852449,3575852491,42
0,514,6179,3575852449,3575852491,42
0,514,6180,3575852449,3575852491,42
0,514,6181,3575852449,3575852492,43
0,514,6182,3575852449,3575852492,43
0,514,6183,3575852449,3575852493,44
0,514,6184,3575852449,3575852495,46
0,514,6185,3575852449,3575852498,49
0,514,6186,3575852449,3575852499,50
0,515,6187,3575852505,3575852505,0
0,515,6188,3575852505,3575852505,0
0,515,6189,3575852505,3575852505,0
0,515,6190,3575852505,3575852505,0
0,515,6191,3575852505,3575852506,1
0,515,6192,3575852505,3575852507,2
0,515,6193,3575852505,3575852509,4
0,515,6194,3575852505,3575852509,4
0,515,6195,3575852505,3575852510,5
0,515,6196,3575852505,3575852513,8
0,515,6197,3575852505,3575852516,11
0,515,6198,3575852505,3575852516,11
0,515,6199,3575852505,3575852518,13
0,515,6200,3575852505,3575852519,14
0,515,6201,3575852505,3575852522,17
0,515,6202,3575852505,3575852522,17
0,515,6203,3575852505,3575852524,19
0,515,6204,3575852505,3575852524,19
0,515,6205,3575852505,3575852525,20
0,515,6206,3575852505,3575852525,20
0,515,6207,3575852505,3575852527,22
0,515,6208,3575852505,3575852527,22
0,515,6209,3575852505,3575852529,24
0,515,6210,3575852505,3575852533,28
0,515,6211,3575852505,3575852534,29
0,515,6212,3575852505,3575852534,29
0,515,6213,3575852505,3575852535,30
0,515,6214,3575852505,3575852536,31
0,515,6215,3575852505,3575852537,32
0,515,6216,3575852505,3575852537,32
0,515,6217,3575852505,3575852538,33
0,515,6218,3575852505,3575852538,33
0,515,6219,3575852505,3575852540,35
0,515,6220,3575852505,3575852540,35
0,515,6221,3575852505,3575852541,36
0,515,6222,3575852505,3575852543,38
0,515,6223,3575852505,3575852544,39
0,515,6224,3575852505,3575852546,41
0,515,6225,3575852505,3575852547,42
0,515,6226,3575852505,3575852548,43
0,515,6227,3575852505,3575852550,45
0,515,6228,3575852505,3575852551,46
0,515,6229,3575852505,3575852553,48
0,515,6230,3575852505,3575852554,49
0,515,6231,3575852505,3575852555,50
0,516,6232,3575852558,3575852558,0
0,516,6233,3575852558,3575852559,1
0,516,6234,3575852558,3575852560,2
0,516,6235,3575852558,3575852561,3
0,516,6236,3575852558,3575852564,6
0,516,6237,3575852558,3575852565,7
0,516,6238,3575852558,3575852570,12
0,516,6239,3575852558,3575852572,14
0,516,6240,3575852558,3575852572,14
0,516,6241,3575852558,3575852576,18
0,516,6242,3575852558,3575852576,18
0,516,6243,3575852558,3575852577,19
0,516,6244,3575852558,3575852577,19
0,516,6245,3575852558,3575852578,20
0,516,6246,3575852558,3575852578,20
0,516,6247,3575852558,3575852583,25
0,516,6248,3575852558,3575852586,28
0,516,6249,3575852558,3575852586,28
0,516,6250,3575852558,3575852591,33
0,516,6251,3575852558,3575852593,35
0,516,6252,3575852558,3575852595,37
0,516,6253,3575852558,3575852597,39
0,516,6254,3575852558,3575852598,40
0,516,6255,3575852558,3575852599,41
0,516,6256,3575852558,3575852600,42
0,516,6257,3575852558,3575852607,49
0,517,6258,3575852611,3575852614,3
0,517,6259,3575852611,3575852617,6
0,517,6260,3575852611,3575852620,9
0,517,6261,3575852611,3575852620,9
0,517,6262,3575852611,3575852626,15
0,517,6263,3575852611,3575852629,18
0,517,6264,3575852611,3575852629,18
0,517,6265,3575852611,3575852632,21
0,517,6266,3575852611,3575852632,21
0,517,6267,3575852611,3575852632,21
0,517,6268,3575852611,3575852633,22
0,517,6269,3575852611,3575852634,23
0,517,6270,3575852611,3575852637,26
0,517,6271,3575852611,3575852641,30
0,517,6272,3575852611,3575852641,30
0,517,6273,3575852611,3575852641,30
0,517,6274,3575852611,3575852642,31
0,517,6275,3575852611,3575852647,36
0,517,6276,3575852611,3575852651,40
0,517,6277,3575852611,3575852657,46
0,517,6278,3575852611,3575852658,47
0,517,6279,3575852611,3575852659,48
0,518,6280,3575852664,3575852664,0
0,518,6281,3575852664,3575852666,2
0,518,6282,3575852664,3575852667,3
0,518,6283,3575852664,3575852669,5
0,518,6284,3575852664,3575852677,13
0,518,6285,3575852664,3575852679,15
0,518,6286,3575852664,3575852680,16
0,518,6287,3575852664,3575852685,21
0,518,6288,3575852664,3575852687,23
0,518,6289,3575852664,3575852689,25
0,518,6290,3575852664,3575852690,26
0,518,6291,3575852664,3575852690,26
0,518,6292,3575852664,3575852690,26
0,518,6293,3575852664,3575852691,27
0,518,6294,3575852664,3575852691,27
0,518,6295,3575852664,3575852692,28
0,518,6296,3575852664,3575852692,28
0,518,6297,3575852664,3575852692,28
0,518,6298,3575852664,3575852693,29
0,518,6299,3575852664,3575852695,31
0,518,6300,3575852664,3575852699,35
0,518,6301,3575852664,3575852699,35
0,518,6302,3575852664,3575852702,38
0,518,6303,3575852664,3575852703,39
0,518,6304,3575852664,3575852704,40
0,518,6305,3575852664,3575852705,41
0,518,6306,3575852664,3575852707,43
0,518,6307,3575852664,3575852708,44
0,518,6308,3575852664,3575852709,45
0,518,6309,3575852664,3575852711,47
0,518,6310,3575852664,3575852712,48
0,518,6311,3575852664,3575852713,49
0,519,6312,3575852717,3575852717,0
0,519,6313,3575852717,3575852718,1
0,519,6314,3575852717,3575852718,1
0,519,6315,3575852717,3575852719,2
0,519,6316,3575852717,3575852722,5
0,519,6317,3575852717,3575852722,5
0,519,6318,3575852717,3575852724,7
0,519,6319,3575852717,3575852725,8
0,519,6320,3575852717,3575852725,8
0,519,6321,3575852717,3575852725,8
0,519,6322,3575852717,3575852728,11
0,519,6323,3575852717,3575852728,11
0,519,6324,3575852717,3575852729,12
0,519,6325,3575852717,3575852734,17
0,519,6326,3575852717,3575852734,17
0,519,6327,3575852717,3575852734,17
0,519,6328,3575852717,3575852735,18
0,519,6329,3575852717,3575852736,19
0,519,6330,3575852717,3575852737,20
0,519,6331,3575852717,3575852737,20
0,519,6332,3575852717,3575852738,21
0,519,6333,3575852717,3575852738,21
0,519,6334,3575852717,3575852740,23
0,519,6335,3575852717,3575852741,24
0,519,6336,3575852717,3575852741,24
0,519,6337,3575852717,3575852743,26
0,519,6338,3575852717,3575852743,26
0,519,6339,3575852717,3575852744,27
0,519,6340,3575852717,3575852746,29
0,519,6341,3575852717,3575852747,30
0,519,6342,3575852717,3575852749,32
0,519,6343,3575852717,3575852751,34
0,519,6344,3575852717,3575852752,35
0,519,6345,3575852717,3575852753,36
0,519,6346,3575852717,3575852754,37
0,519,6347,3575852717,3575852755,38
0,519,6348,3575852717,3575852756,39
0,519,6349,3575852717,3575852759,42
0,519,6350,3575852717,3575852760,43
0,519,6351,3575852717,3575852761,44
0,519,6352,3575852717,3575852764,47
0,519,6353,3575852717,3575852765,48
0,520,6354,3575852771,3575852771,0
0,520,6355,3575852771,3575852771,0
0,520,6356,3575852771,3575852772,1
0,520,6357,3575852771,3575852772,1
0,520,6358,3575852771,3575852776,5
0,520,6359,3575852771,3575852776,5
0,520,6360,3575852771,3575852777,6
0,520,6361,3575852771,3575852777,6
0,520,6362,3575852771,3575852778,7
0,520,6363,3575852771,3575852779,8
0,520,6364,3575852771,3575852783,12
0,520,6365,3575852771,3575852785,14
0,520,6366,3575852771,3575852786,15
0,520,6367,3575852771,3575852791,20
0,520,6368,3575852771,3575852793,22
0,520,6369,3575852771,3575852794,23
0,520,6370,3575852771,3575852795,24
0,520,6371,3575852771,3575852799,28
0,520,6372,3575852771,3575852799,28
0,520,6373,3575852771,3575852799,28
0,520,6374,3575852771,3575852800,29
0,520,6375,3575852771,3575852807,36
0,520,6376,3575852771,3575852813,42
0,520,6377,3575852771,3575852817,46
0,520,6378,3575852771,3575852820,49
0,521,6379,3575852825,3575852825,0
0,521,6380,3575852825,3575852827,2
0,521,6381,3575852825,3575852828,3
0,521,6382,3575852825,3575852829,4
0,521,6383,3575852825,3575852832,7
0,521,6384,3575852825,3575852832,7
0,521,6385,3575852825,3575852832,7
0,521,6386,3575852825,3575852833,8
0,521,6387,3575852825,3575852834,9
0,521,6388,3575852825,3575852837,12
0,521,6389,3575852825,3575852841,16
0,521,6390,3575852825,3575852842,17
0,521,6391,3575852825,3575852842,17
0,521,6392,3575852825,3575852842,17
0,521,6393,3575852825,3575852844,19
0,521,6394,3575852825,3575852846,21
0,521,6395,3575852825,3575852851,26
0,521,6396,3575852825,3575852857,32
0,521,6397,3575852825,3575852858,33
0,521,6398,3575852825,3575852859,34
0,521,6399,3575852825,3575852860,35
0,521,6400,3575852825,3575852867,42
0,521,6401,3575852825,3575852867,42
0,521,6402,3575852825,3575852870,45
0,522,6403,3575852880,3575852880,0
0,522,6404,3575852880,3575852880,0
0,522,6405,3575852880,3575852886,6
0,522,6406,3575852880,3575852887,7
0,522,6407,3575852880,3575852888,8
0,522,6408,3575852880,3575852889,9
0,522,6409,3575852880,3575852890,10
0,522,6410,3575852880,3575852890,10
0,522,6411,3575852880,3575852891,11
0,522,6412,3575852880,3575852892,12
0,522,6413,3575852880,3575852892,12
0,522,6414,3575852880,3575852892,12
0,522,6415,3575852880,3575852893,13
0,522,6416,3575852880,3575852893,13
0,522,6417,3575852880,3575852894,14
0,522,6418,3575852880,3575852895,15
0,522,6419,3575852880,3575852898,18
0,522,6420,3575852880,3575852899,19
0,522,6421,3575852880,3575852901,21
0,522,6422,3575852880,3575852902,22
0,522,6423,3575852880,3575852904,24
0,522,6424,3575852880,3575852904,24
0,522,6425,3575852880,3575852906,26
0,522,6426,3575852880,3575852907,27
0,522,6427,3575852880,3575852908,28
0,522,6428,3575852880,3575852909,29
0,522,6429,3575852880,3575852910,30
0,522,6430,3575852880,3575852911,31
0,522,6431,3575852880,3575852914,34
0,522,6432,3575852880,3575852917,37
0,522,6433,3575852880,3575852917,37
0,522,6434,3575852880,3575852918,38
0,522,6435,3575852880,3575852918,38
0,522,6436,3575852880,3575852922,42
0,522,6437,3575852880,3575852922,42
0,522,6438,3575852880,3575852924,44
0,522,6439,3575852880,3575852925,45
0,522,6440,3575852880,3575852925,45
0,522,6441,3575852880,3575852925,45
0,522,6442,3575852880,3575852927,47
0,522,6443,3575852880,3575852927,47
0,522,6444,3575852880,3575852930,50
0,523,6445,3575852934,3575852934,0
0,523,6446,3575852934,3575852934,0
0,523,6447,3575852934,3575852934,0
0,523,6448,3575852934,3575852935,1
0,523,6449,3575852934,3575852936,2
0,523,6450,3575852934,3575852937,3
0,523,6451,3575852934,3575852937,3
0,523,6452,3575852934,3575852938,4
0,523,6453,3575852934,3575852938,4
0,523,6454,3575852934,3575852940,6
0,523,6455,3575852934,3575852941,7
0,523,6456,3575852934,3575852942,8
0,523,6457,3575852934,3575852943,9
0,523,6458,3575852934,3575852944,10
0,523,6459,3575852934,3575852946,12
0,523,6460,3575852934,3575852946,12
0,523,6461,3575852934,3575852947,13
0,523,6462,3575852934,3575852949,15
0,523,6463,3575852934,3575852951,17
0,523,6464,3575852934,3575852952,18
0,523,6465,3575852934,3575852954,20
0,523,6466,3575852934,3575852955,21
0,523,6467,3575852934,3575852956,22
0,523,6468,3575852934,3575852957,23
0,523,6469,3575852934,3575852960,26
0,523,6470,3575852934,3575852961,27
0,523,6471,3575852934,3575852964,30
0,523,6472,3575852934,3575852965,31
0,523,6473,3575852934,3575852971,37
0,523,6474,3575852934,3575852971,37
0,523,6475,3575852934,3575852972,38
0,523,6476,3575852934,3575852973,39
0,523,6477,3575852934,3575852975,41
0,523,6478,3575852934,3575852976,42
0,523,6479,3575852934,3575852977,43
0,523,6480,3575852934,3575852977,43
0,523,6481,3575852934,3575852979,45
0,523,6482,3575852934,3575852979,45
0,523,6483,3575852934,3575852983,49
0,524,6484,3575852987,3575852987,0
0,524,6485,3575852987,3575852987,0
0,524,6486,3575852987,3575852991,4
0,524,6487,3575852987,3575852994,7
0,524,6488,3575852987,3575852994,7
0,524,6489,3575852987,3575852995,8
0,524,6490,3575852987,3575852997,10
0,524,6491,3575852987,3575852998,11
0,524,6492,3575852987,3575852999,12
0,524,6493,3575852987,3575853000,13
0,524,6494,3575852987,3575853001,14
0,524,6495,3575852987,3575853007,20
0,524,6496,3575852987,3575853014,27
0,524,6497,3575852987,3575853017,30
0,524,6498,3575852987,3575853020,33
0,524,6499,3575852987,3575853021,34
0,524,6500,3575852987,3575853027,40
0,524,6501,3575852987,3575853029,42
0,524,6502,3575852987,3575853029,42
0,524,6503,3575852987,3575853032,45
0,524,6504,3575852987,3575853032,45
0,524,6505,3575852987,3575853033,46
0,524,6506,3575852987,3575853033,46
0,524,6507,3575852987,3575853034,47
0,525,6508,3575853041,3575853041,0
0,525,6509,3575853041,3575853041,0
0,525,6510,3575853041,3575853042,1
0,525,6511,3575853041,3575853042,1
0,525,6512,3575853041,3575853042,1
0,525,6513,3575853041,3575853046,5
0,525,6514,3575853041,3575853047,6
0,525,6515,3575853041,3575853047,6
0,525,6516,3575853041,3575853053,12
0,525,6517,3575853041,3575853057,16
0,525,6518,3575853041,3575853058,17
0,525,6519,3575853041,3575853059,18
0,525,6520,3575853041,3575853061,20
0,525,6521,3575853041,3575853066,25
0,525,6522,3575853041,3575853067,26
0,525,6523,3575853041,3575853070,29
0,525,6524,3575853041,3575853078,37
0,525,6525,3575853041,3575853079,38
0,525,6526,3575853041,3575853081,40
0,525,6527,3575853041,3575853086,45
0,525,6528,3575853041,3575853087,46
0,525,6529,3575853041,3575853089,48
0,525,6530,3575853041,3575853090,49
0,525,6531,3575853041,3575853090,49
0,525,6532,3575853041,3575853090,49
0,525,6533,3575853041,3575853091,50
0,526,6534,3575853095,3575853095,0
0,526,6535,3575853095,3575853095,0
0,526,6536,3575853095,3575853095,0
0,526,6537,3575853095,3575853095,0
0,526,6538,3575853095,3575853095,0
0,526,6539,3575853095,3575853095,0
0,526,6540,3575853095,3575853095,0
0,526,6541,3575853095,3575853098,3
0,526,6542,3575853095,3575853098,3
0,526,6543,3575853095,3575853099,4
0,526,6544,3575853095,3575853101,6
0,526,6545,3575853095,3575853102,7
0,526,6546,3575853095,3575853103,8
0,526,6547,3575853095,3575853105,10
0,526,6548,3575853095,3575853106,11
0,526,6549,3575853095,3575853107,12
0,526,6550,3575853095,3575853108,13
0,526,6551,3575853095,3575853109,14
0,526,6552,3575853095,3575853110,15
0,526,6553,3575853095,3575853112,17
0,526,6554,3575853095,3575853114,19
0,526,6555,3575853095,3575853116,21
0,526,6556,3575853095,3575853118,23
0,526,6557,3575853095,3575853118,23
0,526,6558,3575853095,3575853120,25
0,526,6559,3575853095,3575853123,28
0,526,6560,3575853095,3575853123,28
0,526,6561,3575853095,3575853124,29
0,526,6562,3575853095,3575853125,30
0,526,6563,3575853095,3575853125,30
0,526,6564,3575853095,3575853125,30
0,526,6565,3575853095,3575853127,32
0,526,6566,3575853095,3575853127,32
0,526,6567,3575853095,3575853130,35
0,526,6568,3575853095,3575853134,39
0,526,6569,3575853095,3575853134,39
0,526,6570,3575853095,3575853134,39
0,526,6571,3575853095,3575853136,41
0,526,6572,3575853095,3575853136,41
0,526,6573,3575853095,3575853137,42
0,526,6574,3575853095,3575853138,43
0,526,6575,3575853095,3575853139,44
0,526,6576,3575853095,3575853140,45
0,526,6577,3575853095,3575853140,45
0,526,6578,3575853095,3575853142,47
0,526,6579,3575853095,3575853143,48
0,526,6580,3575853095,3575853145,50
0,527,6581,3575853149,3575853149,0
0,527,6582,3575853149,3575853149,0
0,527,6583,3575853149,3575853149,0
0,527,6584,3575853149,3575853149,0
0,527,6585,3575853149,3575853152,3
0,527,6586,3575853149,3575853152,3
0,527,6587,3575853149,3575853155,6
0,527,6588,3575853149,3575853155,6
0,527,6589,3575853149,3575853156,7
0,527,6590,3575853149,3575853157,8
0,527,6591,3575853149,3575853161,12
0,527,6592,3575853149,3575853161,12
0,527,6593,3575853149,3575853164,15
0,527,6594,3575853149,3575853165,16
0,527,6595,3575853149,3575853171,22
0,527,6596,3575853149,3575853171,22
0,527,6597,3575853149,3575853172,23
0,527,6598,3575853149,3575853173,24
0,527,6599,3575853149,3575853175,26
0,527,6600,3575853149,3575853176,27
0,527,6601,3575853149,3575853176,27
0,527,6602,3575853149,3575853177,28
0,527,6603,3575853149,3575853179,30
0,527,6604,3575853149,3575853183,34
0,527,6605,3575853149,3575853187,38
0,527,6606,3575853149,3575853187,38
0,527,6607,3575853149,3575853191,42
0,527,6608,3575853149,3575853194,45
0,527,6609,3575853149,3575853195,46
0,527,6610,3575853149,3575853197,48
0,527,6611,3575853149,3575853198,49
0,528,6612,3575853204,3575853204,0
0,528,6613,3575853204,3575853204,0
0,528,6614,3575853204,3575853204,0
0,528,6615,3575853204,3575853204,0
0,528,6616,3575853204,3575853208,4
0,528,6617,3575853204,3575853214,10
0,528,6618,3575853204,3575853218,14
0,528,6619,3575853204,3575853221,17
0,528,6620,3575853204,3575853222,18
0,528,6621,3575853204,3575853226,22
0,528,6622,3575853204,3575853229,25
0,528,6623,3575853204,3575853229,25
0,528,6624,3575853204,3575853232,28
0,528,6625,3575853204,3575853232,28
0,528,6626,3575853204,3575853232,28
0,528,6627,3575853204,3575853233,29
0,528,6628,3575853204,3575853236,32
0,528,6629,3575853204,3575853237,33
0,528,6630,3575853204,3575853241,37
0,528,6631,3575853204,3575853241,37
0,528,6632,3575853204,3575853242,38
0,528,6633,3575853204,3575853242,38
0,528,6634,3575853204,3575853246,42
0,528,6635,3575853204,3575853247,43
0,528,6636,3575853204,3575853248,44
0,528,6637,3575853204,3575853250,46
0,528,6638,3575853204,3575853252,48
0,529,6639,3575853258,3575853258,0
0,529,6640,3575853258,3575853259,1
0,529,6641,3575853258,3575853259,1
0,529,6642,3575853258,3575853262,4
0,529,6643,3575853258,3575853267,9
0,529,6644,3575853258,3575853267,9
0,529,6645,3575853258,3575853270,12
0,529,6646,3575853258,3575853277,19
0,529,6647,3575853258,3575853279,21
0,529,6648,3575853258,3575853280,22
0,529,6649,3575853258,3575853286,28
0,529,6650,3575853258,3575853287,29
0,529,6651,3575853258,3575853290,32
0,529,6652,3575853258,3575853290,32
0,529,6653,3575853258,3575853291,33
0,529,6654,3575853258,3575853291,33
0,529,6655,3575853258,3575853292,34
0,529,6656,3575853258,3575853292,34
0,529,6657,3575853258,3575853292,34
0,529,6658,3575853258,3575853292,34
0,529,6659,3575853258,3575853294,36
0,529,6660,3575853258,3575853295,37
0,529,6661,3575853258,3575853295,37
0,529,6662,3575853258,3575853300,42
0,529,6663,3575853258,3575853301,43
0,529,6664,3575853258,3575853301,43
0,529,6665,3575853258,3575853303,45
0,529,6666,3575853258,3575853304,46
0,529,6667,3575853258,3575853304,46
0,529,6668,3575853258,3575853306,48
0,529,6669,3575853258,3575853307,49
0,530,6670,3575853312,3575853312,0
0,530,6671,3575853312,3575853312,0
0,530,6672,3575853312,3575853312,0
0,530,6673,3575853312,3575853312,0
0,530,6674,3575853312,3575853314,2
0,530,6675,3575853312,3575853316,4
0,530,6676,3575853312,3575853317,5
0,530,6677,3575853312,3575853318,6
0,530,6678,3575853312,3575853319,7
0,530,6679,3575853312,3575853320,8
0,530,6680,3575853312,3575853323,11
0,530,6681,3575853312,3575853323,11
0,530,6682,3575853312,3575853323,11
0,530,6683,3575853312,3575853325,13
0,530,6684,3575853312,3575853325,13
0,530,6685,3575853312,3575853326,14
0,530,6686,3575853312,3575853327,15
0,530,6687,3575853312,3575853327,15
0,530,6688,3575853312,3575853329,17
0,530,6689,3575853312,3575853334,22
0,530,6690,3575853312,3575853334,22
0,530,6691,3575853312,3575853334,22
0,530,6692,3575853312,3575853336,24
0,530,6693,3575853312,3575853336,24
0,530,6694,3575853312,3575853336,24
0,530,6695,3575853312,3575853338,26
0,530,6696,3575853312,3575853338,26
0,530,6697,3575853312,3575853338,26
0,530,6698,3575853312,3575853340,28
0,530,6699,3575853312,3575853340,28
0,530,6700,3575853312,3575853343,31
0,530,6701,3575853312,3575853344,32
0,530,6702,3575853312,3575853345,33
0,530,6703,3575853312,3575853347,35
0,530,6704,3575853312,3575853348,36
0,530,6705,3575853312,3575853349,37
0,530,6706,3575853312,3575853349,37
0,530,6707,3575853312,3575853351,39
0,530,6708,3575853312,3575853353,41
0,530,6709,3575853312,3575853353,41
0,530,6710,3575853312,3575853355,43
0,530,6711,3575853312,3575853356,44
0,530,6712,3575853312,3575853356,44
0,530,6713,3575853312,3575853357,45
0,530,6714,3575853312,3575853359,47
0,530,6715,3575853312,3575853362,50
0,531,6716,3575853367,3575853367,0
0,531,6717,3575853367,3575853367,0
0,531,6718,3575853367,3575853367,0
0,531,6719,3575853367,3575853372,5
0,531,6720,3575853367,3575853372,5
0,531,6721,3575853367,3575853372,5
0,531,6722,3575853367,3575853373,6
0,531,6723,3575853367,3575853375,8
0,531,6724,3575853367,3575853376,9
0,531,6725,3575853367,3575853376,9
0,531,6726,3575853367,3575853377,10
0,531,6727,3575853367,3575853379,12
0,531,6728,3575853367,3575853383,16
0,531,6729,3575853367,3575853387,20
0,531,6730,3575853367,3575853387,20
0,531,6731,3575853367,3575853391,24
0,531,6732,3575853367,3575853395,28
0,531,6733,3575853367,3575853396,29
0,531,6734,3575853367,3575853396,29
0,531,6735,3575853367,3575853398,31
0,531,6736,3575853367,3575853400,33
0,531,6737,3575853367,3575853400,33
0,531,6738,3575853367,3575853402,35
0,531,6739,3575853367,3575853407,40
0,531,6740,3575853367,3575853409,42
0,531,6741,3575853367,3575853415,48
0,532,6742,3575853422,3575853422,0
0,532,6743,3575853422,3575853422,0
0,532,6744,3575853422,3575853422,0
0,532,6745,3575853422,3575853426,4
0,532,6746,3575853422,3575853429,7
0,532,6747,3575853422,3575853430,8
0,532,6748,3575853422,3575853432,10
0,532,6749,3575853422,3575853432,10
0,532,6750,3575853422,3575853433,11
0,532,6751,3575853422,3575853433,11
0,532,6752,3575853422,3575853436,14
0,532,6753,3575853422,3575853437,15
0,532,6754,3575853422,3575853441,19
0,532,6755,3575853422,3575853441,19
0,532,6756,3575853422,3575853442,20
0,532,6757,3575853422,3575853443,21
0,532,6758,3575853422,3575853446,24
0,532,6759,3575853422,3575853447,25
0,532,6760,3575853422,3575853448,26
0,532,6761,3575853422,3575853453,31
0,532,6762,3575853422,3575853455,33
0,532,6763,3575853422,3575853459,37
0,532,6764,3575853422,3575853459,37
0,532,6765,3575853422,3575853459,37
0,532,6766,3575853422,3575853462,40
0,532,6767,3575853422,3575853467,45
0,532,6768,3575853422,3575853471,49
0,533,6769,3575853476,3575853476,0
0,533,6770,3575853476,3575853479,3
0,533,6771,3575853476,3575853479,3
0,533,6772,3575853476,3575853486,10
0,533,6773,3575853476,3575853489,13
0,533,6774,3575853476,3575853490,14
0,533,6775,3575853476,3575853490,14
0,533,6776,3575853476,3575853490,14
0,533,6777,3575853476,3575853491,15
0,533,6778,3575853476,3575853491,15
0,533,6779,3575853476,3575853492,16
0,533,6780,3575853476,3575853492,16
0,533,6781,3575853476,3575853493,17
0,533,6782,3575853476,3575853494,18
0,533,6783,3575853476,3575853494,18
0,533,6784,3575853476,3575853499,23
0,533,6785,3575853476,3575853500,24
0,533,6786,3575853476,3575853502,26
0,533,6787,3575853476,3575853502,26
0,533,6788,3575853476,3575853503,27
0,533,6789,3575853476,3575853505,29
0,533,6790,3575853476,3575853506,30
0,533,6791,3575853476,3575853506,30
0,533,6792,3575853476,3575853507,31
0,533,6793,3575853476,3575853508,32
0,533,6794,3575853476,3575853510,34
0,533,6795,3575853476,3575853512,36
0,533,6796,3575853476,3575853513,37
0,533,6797,3575853476,3575853515,39
0,533,6798,3575853476,3575853517,41
0,533,6799,3575853476,3575853517,41
0,533,6800,3575853476,3575853518,42
0,533,6801,3575853476,3575853519,43
0,533,6802,3575853476,3575853522,46
0,533,6803,3575853476,3575853523,47
0,533,6804,3575853476,3575853523,47
0,533,6805,3575853476,3575853524,48
0,533,6806,3575853476,3575853525,49
0,534,6807,3575853530,3575853530,0
0,534,6808,3575853530,3575853530,0
0,534,6809,3575853530,3575853530,0
0,534,6810,3575853530,3575853530,0
0,534,6811,3575853530,3575853533,3
0,534,6812,3575853530,3575853533,3
0,534,6813,3575853530,3575853534,4
0,534,6814,3575853530,3575853535,5
0,534,6815,3575853530,3575853535,5
0,534,6816,3575853530,3575853535,5
0,534,6817,3575853530,3575853537,7
0,534,6818,3575853530,3575853537,7
0,534,6819,3575853530,3575853537,7
0,534,6820,3575853530,3575853539,9
0,534,6821,3575853530,3575853540,10
0,534,6822,3575853530,3575853543,13
0,534,6823,3575853530,3575853543,13
0,534,6824,3575853530,3575853544,14
0,534,6825,3575853530,3575853546,16
0,534,6826,3575853530,3575853547,17
0,534,6827,3575853530,3575853549,19
0,534,6828,3575853530,3575853550,20
0,534,6829,3575853530,3575853552,22
0,534,6830,3575853530,3575853554,24
0,534,6831,3575853530,3575853555,25
0,534,6832,3575853530,3575853555,25
0,534,6833,3575853530,3575853556,26
0,534,6834,3575853530,3575853556,26
0,534,6835,3575853530,3575853558,28
0,534,6836,3575853530,3575853561,31
0,534,6837,3575853530,3575853561,31
0,534,6838,3575853530,3575853563,33
0,534,6839,3575853530,3575853565,35
0,534,6840,3575853530,3575853570,40
0,534,6841,3575853530,3575853572,42
0,534,6842,3575853530,3575853572,42
0,534,6843,3575853530,3575853574,44
0,534,6844,3575853530,3575853576,46
0,534,6845,3575853530,3575853576,46
0,534,6846,3575853530,3575853577,47
0,534,6847,3575853530,3575853578,48
0,534,6848,3575853530,3575853578,48
0,535,6849,3575853584,3575853584,0
0,535,6850,3575853584,3575853586,2
0,535,6851,3575853584,3575853586,2
0,535,6852,3575853584,3575853590,6
0,535,6853,3575853584,3575853594,10
0,535,6854,3575853584,3575853595,11
0,535,6855,3575853584,3575853596,12
0,535,6856,3575853584,3575853599,15
0,535,6857,3575853584,3575853600,16
0,535,6858,3575853584,3575853601,17
0,535,6859,3575853584,3575853606,22
0,535,6860,3575853584,3575853607,23
0,535,6861,3575853584,3575853608,24
0,535,6862,3575853584,3575853614,30
0,535,6863,3575853584,3575853618,34
0,535,6864,3575853584,3575853620,36
0,535,6865,3575853584,3575853622,38
0,535,6866,3575853584,3575853627,43
0,535,6867,3575853584,3575853628,44
0,535,6868,3575853584,3575853630,46
0,535,6869,3575853584,3575853631,47
0,535,6870,3575853584,3575853632,48
0,535,6871,3575853584,3575853632,48
0,535,6872,3575853584,3575853633,49
0,536,6873,3575853637,3575853637,0
0,536,6874,3575853637,3575853637,0
0,536,6875,3575853637,3575853640,3
0,536,6876,3575853637,3575853641,4
0,536,6877,3575853637,3575853641,4
0,536,6878,3575853637,3575853642,5
0,536,6879,3575853637,3575853645,8
0,536,6880,3575853637,3575853646,9
0,536,6881,3575853637,3575853647,10
0,536,6882,3575853637,3575853651,14
0,536,6883,3575853637,3575853657,20
0,536,6884,3575853637,3575853657,20
0,536,6885,3575853637,3575853658,21
0,536,6886,3575853637,3575853658,21
0,536,6887,3575853637,3575853661,24
0,536,6888,3575853637,3575853665,28
0,536,6889,3575853637,3575853671,34
0,536,6890,3575853637,3575853676,39
0,536,6891,3575853637,3575853679,42
0,536,6892,3575853637,3575853679,42
0,536,6893,3575853637,3575853685,48
0,536,6894,3575853637,3575853686,49
0,537,6895,3575853691,3575853691,0
0,537,6896,3575853691,3575853691,0
0,537,6897,3575853691,3575853691,0
0,537,6898,3575853691,3575853691,0
0,537,6899,3575853691,3575853691,0
0,537,6900,3575853691,3575853691,0
0,537,6901,3575853691,3575853691,0
0,537,6902,3575853691,3575853692,1
0,537,6903,3575853691,3575853692,1
0,537,6904,3575853691,3575853693,2
0,537,6905,3575853691,3575853693,2
0,537,6906,3575853691,3575853694,3
0,537,6907,3575853691,3575853697,6
0,537,6908,3575853691,3575853699,8
0,537,6909,3575853691,3575853701,10
0,537,6910,3575853691,3575853703,12
0,537,6911,3575853691,3575853703,12
0,537,6912,3575853691,3575853703,12
0,537,6913,3575853691,3575853705,14
0,537,6914,3575853691,3575853706,15
0,537,6915,3575853691,3575853707,16
0,537,6916,3575853691,3575853708,17
0,537,6917,3575853691,3575853708,17
0,537,6918,3575853691,3575853712,21
0,537,6919,3575853691,3575853714,23
0,537,6920,3575853691,3575853715,24
0,537,6921,3575853691,3575853717,26
0,537,6922,3575853691,3575853718,27
0,537,6923,3575853691,3575853719,28
0,537,6924,3575853691,3575853722,31
0,537,6925,3575853691,3575853723,32
0,537,6926,3575853691,3575853723,32
0,537,6927,3575853691,3575853724,33
0,537,6928,3575853691,3575853725,34
0,537,6929,3575853691,3575853726,35
0,537,6930,3575853691,3575853727,36
0,537,6931,3575853691,3575853727,36
0,537,6932,3575853691,3575853729,38
0,537,6933,3575853691,3575853733,42
0,537,6934,3575853691,3575853734,43
0,537,6935,3575853691,3575853735,44
0,537,6936,3575853691,3575853735,44
0,537,6937,3575853691,3575853736,45
0,537,6938,3575853691,3575853737,46
0,537,6939,3575853691,3575853737,46
0,537,6940,3575853691,3575853739,48
0,537,6941,3575853691,3575853740,49
0,538,6942,3575853744,3575853745,1
0,538,6943,3575853744,3575853745,1
0,538,6944,3575853744,3575853745,1
0,538,6945,3575853744,3575853747,3
0,538,6946,3575853744,3575853747,3
0,538,6947,3575853744,3575853749,5
0,538,6948,3575853744,3575853750,6
0,538,6949,3575853744,3575853752,8
0,538,6950,3575853744,3575853754,10
0,538,6951,3575853744,3575853755,11
0,538,6952,3575853744,3575853755,11
0,538,6953,3575853744,3575853755,11
0,538,6954,3575853744,3575853756,12
0,538,6955,3575853744,3575853759,15
0,538,6956,3575853744,3575853759,15
0,538,6957,3575853744,3575853761,17
0,538,6958,3575853744,3575853764,20
0,538,6959,3575853744,3575853765,21
0,538,6960,3575853744,3575853770,26
0,538,6961,3575853744,3575853772,28
0,538,6962,3575853744,3575853772,28
0,538,6963,3575853744,3575853774,30
0,538,6964,3575853744,3575853775,31
0,538,6965,3575853744,3575853776,32
0,538,6966,3575853744,3575853778,34
0,538,6967,3575853744,3575853780,36
0,538,6968,3575853744,3575853782,38
0,538,6969,3575853744,3575853785,41
0,538,6970,3575853744,3575853786,42
0,538,6971,3575853744,3575853789,45
0,539,6972,3575853798,3575853798,0
0,539,6973,3575853798,3575853798,0
0,539,6974,3575853798,3575853798,0
0,539,6975,3575853798,3575853798,0
0,539,6976,3575853798,3575853800,2
0,539,6977,3575853798,3575853800,2
0,539,6978,3575853798,3575853801,3
0,539,6979,3575853798,3575853806,8
0,539,6980,3575853798,3575853809,11
0,539,6981,3575853798,3575853809,11
0,539,6982,3575853798,3575853814,16
0,539,6983,3575853798,3575853819,21
0,539,6984,3575853798,3575853821,23
0,539,6985,3575853798,3575853822,24
0,539,6986,3575853798,3575853827,29
0,539,6987,3575853798,3575853828,30
0,539,6988,3575853798,3575853830,32
0,539,6989,3575853798,3575853831,33
0,539,6990,3575853798,3575853832,34
0,539,6991,3575853798,3575853833,35
0,539,6992,3575853798,3575853833,35
0,539,6993,3575853798,3575853835,37
0,539,6994,3575853798,3575853836,38
0,539,6995,3575853798,3575853841,43
0,539,6996,3575853798,3575853841,43
0,539,6997,3575853798,3575853842,44
0,539,6998,3575853798,3575853842,44
0,539,6999,3575853798,3575853846,48
0,539,7000,3575853798,3575853846,48
0,539,7001,3575853798,3575853847,49
0,540,7002,3575853852,3575853852,0
0,540,7003,3575853852,3575853857,5
0,540,7004,3575853852,3575853858,6
0,540,7005,3575853852,3575853859,7
0,540,7006,3575853852,3575853860,8
0,540,7007,3575853852,3575853861,9
0,540,7008,3575853852,3575853867,15
0,540,7009,3575853852,3575853867,15
0,540,7010,3575853852,3575853871,19
0,540,7011,3575853852,3575853877,25
0,540,7012,3575853852,3575853879,27
0,540,7013,3575853852,3575853879,27
0,540,7014,3575853852,3575853886,34
0,540,7015,3575853852,3575853886,34
0,540,7016,3575853852,3575853888,36
0,540,7017,3575853852,3575853889,37
0,540,7018,3575853852,3575853889,37
0,540,7019,3575853852,3575853889,37
0,540,7020,3575853852,3575853890,38
0,540,7021,3575853852,3575853891,39
0,540,7022,3575853852,3575853891,39
0,540,7023,3575853852,3575853891,39
0,540,7024,3575853852,3575853894,42
0,540,7025,3575853852,3575853894,42
0,540,7026,3575853852,3575853897,45
0,540,7027,3575853852,3575853898,46
0,540,7028,3575853852,3575853900,48
0,541,7029,3575853906,3575853906,0
0,541,7030,3575853906,3575853906,0
0,541,7031,3575853906,3575853906,0
0,541,7032,3575853906,3575853906,0
0,541,7033,3575853906,3575853907,1
0,541,7034,3575853906,3575853908,2
0,541,7035,3575853906,3575853908,2
0,541,7036,3575853906,3575853911,5
0,541,7037,3575853906,3575853911,5
0,541,7038,3575853906,3575853912,6
0,541,7039,3575853906,3575853914,8
0,541,7040,3575853906,3575853917,11
0,541,7041,3575853906,3575853918,12
0,541,7042,3575853906,3575853919,13
0,541,7043,3575853906,3575853922,16
0,541,7044,3575853906,3575853923,17
0,541,7045,3575853906,3575853923,17
0,541,7046,3575853906,3575853924,18
0,541,7047,3575853906,3575853925,19
0,541,7048,3575853906,3575853926,20
0,541,7049,3575853906,3575853927,21
0,541,7050,3575853906,3575853927,21
0,541,7051,3575853906,3575853930,24
0,541,7052,3575853906,3575853934,28
0,541,7053,3575853906,3575853934,28
0,541,7054,3575853906,3575853934,28
0,541,7055,3575853906,3575853935,29
0,541,7056,3575853906,3575853935,29
0,541,7057,3575853906,3575853936,30
0,541,7058,3575853906,3575853936,30
0,541,7059,3575853906,3575853938,32
0,541,7060,3575853906,3575853939,33
0,541,7061,3575853906,3575853940,34
0,541,7062,3575853906,3575853943,37
0,541,7063,3575853906,3575853943,37
0,541,7064,3575853906,3575853944,38
0,541,7065,3575853906,3575853947,41
0,541,7066,3575853906,3575853947,41
0,541,7067,3575853906,3575853949,43
0,541,7068,3575853906,3575853951,45
0,541,7069,3575853906,3575853952,46
0,541,7070,3575853906,3575853955,49
0,541,7071,3575853906,3575853955,49
0,541,7072,3575853906,3575853955,49
0,541,7073,3575853906,3575853956,50
0,542,7074,3575853960,3575853960,0
0,542,7075,3575853960,3575853960,0
0,542,7076,3575853960,3575853960,0
0,542,7077,3575853960,3575853961,1
0,542,7078,3575853960,3575853961,1
0,542,7079,3575853960,3575853963,3
0,542,7080,3575853960,3575853965,5
0,542,7081,3575853960,3575853971,11
0,542,7082,3575853960,3575853972,12
0,542,7083,3575853960,3575853972,12
0,542,7084,3575853960,3575853973,13
0,542,7085,3575853960,3575853974,14
0,542,7086,3575853960,3575853975,15
0,542,7087,3575853960,3575853976,16
0,542,7088,3575853960,3575853977,17
0,542,7089,3575853960,3575853978,18
0,542,7090,3575853960,3575853979,19
0,542,7091,3575853960,3575853982,22
0,542,7092,3575853960,3575853986,26
0,542,7093,3575853960,3575853986,26
0,542,7094,3575853960,3575853990,30
0,542,7095,3575853960,3575853995,35
0,542,7096,3575853960,3575853996,36
0,542,7097,3575853960,3575853996,36
0,542,7098,3575853960,3575853997,37
0,542,7099,3575853960,3575853999,39
0,542,7100,3575853960,3575854000,40
0,542,7101,3575853960,3575854001,41
0,542,7102,3575853960,3575854006,46
0,542,7103,3575853960,3575854009,49
0,543,7104,3575854014,3575854014,0
0,543,7105,3575854014,3575854014,0
0,543,7106,3575854014,3575854018,4
0,543,7107,3575854014,3575854021,7
0,543,7108,3575854014,3575854023,9
0,543,7109,3575854014,3575854026,12
0,543,7110,3575854014,3575854026,12
0,543,7111,3575854014,3575854029,15
0,543,7112,3575854014,3575854030,16
0,543,7113,3575854014,3575854032,18
0,543,7114,3575854014,3575854032,18
0,543,7115,3575854014,3575854032,18
0,543,7116,3575854014,3575854034,20
0,543,7117,3575854014,3575854035,21
0,543,7118,3575854014,3575854037,23
0,543,7119,3575854014,3575854041,27
0,543,7120,3575854014,3575854041,27
0,543,7121,3575854014,3575854042,28
0,543,7122,3575854014,3575854042,28
0,543,7123,3575854014,3575854045,31
0,543,7124,3575854014,3575854046,32
0,543,7125,3575854014,3575854048,34
0,543,7126,3575854014,3575854052,38
0,543,7127,3575854014,3575854058,44
0,543,7128,3575854014,3575854059,45
0,543,7129,3575854014,3575854059,45
0,543,7130,3575854014,3575854062,48
0,544,7131,3575854069,3575854069,0
0,544,7132,3575854069,3575854069,0
0,544,7133,3575854069,3575854069,0
0,544,7134,3575854069,3575854071,2
0,544,7135,3575854069,3575854076,7
0,544,7136,3575854069,3575854078,9
0,544,7137,3575854069,3575854079,10
0,544,7138,3575854069,3575854087,18
0,544,7139,3575854069,3575854090,21
0,544,7140,3575854069,3575854090,21
0,544,7141,3575854069,3575854090,21
0,544,7142,3575854069,3575854091,22
0,544,7143,3575854069,3575854091,22
0,544,7144,3575854069,3575854091,22
0,544,7145,3575854069,3575854092,23
0,544,7146,3575854069,3575854093,24
0,544,7147,3575854069,3575854094,25
0,544,7148,3575854069,3575854094,25
0,544,7149,3575854069,3575854097,28
0,544,7150,3575854069,3575854098,29
0,544,7151,3575854069,3575854100,31
0,544,7152,3575854069,3575854103,34
0,544,7153,3575854069,3575854104,35
0,544,7154,3575854069,3575854104,35
0,544,7155,3575854069,3575854106,37
0,544,7156,3575854069,3575854107,38
0,544,7157,3575854069,3575854107,38
0,544,7158,3575854069,3575854109,40
0,544,7159,3575854069,3575854111,42
0,544,7160,3575854069,3575854114,45
0,544,7161,3575854069,3575854114,45
0,544,7162,3575854069,3575854116,47
0,544,7163,3575854069,3575854117,48
0,544,7164,3575854069,3575854118,49
0,545,7165,3575854123,3575854123,0
0,545,7166,3575854123,3575854123,0
0,545,7167,3575854123,3575854123,0
0,545,7168,3575854123,3575854124,1
0,545,7169,3575854123,3575854124,1
0,545,7170,3575854123,3575854125,2
0,545,7171,3575854123,3575854127,4
0,545,7172,3575854123,3575854127,4
0,545,7173,3575854123,3575854128,5
0,545,7174,3575854123,3575854130,7
0,545,7175,3575854123,3575854133,10
0,545,7176,3575854123,3575854134,11
0,545,7177,3575854123,3575854134,11
0,545,7178,3575854123,3575854135,12
0,545,7179,3575854123,3575854136,13
0,545,7180,3575854123,3575854137,14
0,545,7181,3575854123,3575854139,16
0,545,7182,3575854123,3575854140,17
0,545,7183,3575854123,3575854140,17
0,545,7184,3575854123,3575854143,20
0,545,7185,3575854123,3575854144,21
0,545,7186,3575854123,3575854145,22
0,545,7187,3575854123,3575854147,24
0,545,7188,3575854123,3575854147,24
0,545,7189,3575854123,3575854148,25
0,545,7190,3575854123,3575854149,26
0,545,7191,3575854123,3575854150,27
0,545,7192,3575854123,3575854152,29
0,545,7193,3575854123,3575854155,32
0,545,7194,3575854123,3575854155,32
0,545,7195,3575854123,3575854156,33
0,545,7196,3575854123,3575854156,33
0,545,7197,3575854123,3575854157,34
0,545,7198,3575854123,3575854159,36
0,545,7199,3575854123,3575854159,36
0,545,7200,3575854123,3575854161,38
0,545,7201,3575854123,3575854162,39
0,545,7202,3575854123,3575854164,41
0,545,7203,3575854123,3575854165,42
0,545,7204,3575854123,3575854165,42
0,545,7205,3575854123,3575854171,48
0,545,7206,3575854123,3575854172,49
0,545,7207,3575854123,3575854172,49
0,546,7208,3575854177,3575854177,0
0,546,7209,3575854177,3575854177,0
0,546,7210,3575854177,3575854177,0
0,546,7211,3575854177,3575854177,0
0,546,7212,3575854177,3575854178,1
0,546,7213,3575854177,3575854179,2
0,546,7214,3575854177,3575854183,6
0,546,7215,3575854177,3575854187,10
0,546,7216,3575854177,3575854187,10
0,546,7217,3575854177,3575854190,13
0,546,7218,3575854177,3575854194,17
0,546,7219,3575854177,3575854196,19
0,546,7220,3575854177,3575854196,19
0,546,7221,3575854177,3575854197,20
0,546,7222,3575854177,3575854200,23
0,546,7223,3575854177,3575854200,23
0,546,7224,3575854177,3575854201,24
0,546,7225,3575854177,3575854206,29
0,546,7226,3575854177,3575854208,31
0,546,7227,3575854177,3575854214,37
0,546,7228,3575854177,3575854217,40
0,546,7229,3575854177,3575854219,42
0,546,7230,3575854177,3575854221,44
0,546,7231,3575854177,3575854223,46
0,546,7232,3575854177,3575854225,48
0,546,7233,3575854177,3575854227,50
0,547,7234,3575854234,3575854234,0
0,547,7235,3575854234,3575854234,0
0,547,7236,3575854234,3575854234,0
0,547,7237,3575854234,3575854234,0
0,547,7238,3575854234,3575854234,0
0,547,7239,3575854234,3575854234,0
0,547,7240,3575854234,3575854235,1
0,547,7241,3575854234,3575854236,2
0,547,7242,3575854234,3575854241,7
0,547,7243,3575854234,3575854242,8
0,547,7244,3575854234,3575854242,8
0,547,7245,3575854234,3575854243,9
0,547,7246,3575854234,3575854245,11
0,547,7247,3575854234,3575854246,12
0,547,7248,3575854234,3575854248,14
0,547,7249,3575854234,3575854252,18
0,547,7250,3575854234,3575854258,24
0,547,7251,3575854234,3575854259,25
0,547,7252,3575854234,3575854259,25
0,547,7253,3575854234,3575854262,28
0,547,7254,3575854234,3575854267,33
0,547,7255,3575854234,3575854268,34
0,547,7256,3575854234,3575854271,37
0,547,7257,3575854234,3575854276,42
0,547,7258,3575854234,3575854279,45
0,547,7259,3575854234,3575854279,45
0,548,7260,3575854288,3575854288,0
0,548,7261,3575854288,3575854288,0
0,548,7262,3575854288,3575854289,1
0,548,7263,3575854288,3575854290,2
0,548,7264,3575854288,3575854290,2
0,548,7265,3575854288,3575854291,3
0,548,7266,3575854288,3575854291,3
0,548,7267,3575854288,3575854292,4
0,548,7268,3575854288,3575854293,5
0,548,7269,3575854288,3575854293,5
0,548,7270,3575854288,3575854294,6
0,548,7271,3575854288,3575854294,6
0,548,7272,3575854288,3575854298,10
0,548,7273,3575854288,3575854300,12
0,548,7274,3575854288,3575854304,16
0,548,7275,3575854288,3575854304,16
0,548,7276,3575854288,3575854305,17
0,548,7277,3575854288,3575854306,18
0,548,7278,3575854288,3575854307,19
0,548,7279,3575854288,3575854308,20
0,548,7280,3575854288,3575854310,22
0,548,7281,3575854288,3575854311,23
0,548,7282,3575854288,3575854313,25
0,548,7283,3575854288,3575854314,26
0,548,7284,3575854288,3575854316,28
0,548,7285,3575854288,3575854317,29
0,548,7286,3575854288,3575854317,29
0,548,7287,3575854288,3575854318,30
0,548,7288,3575854288,3575854320,32
0,548,7289,3575854288,3575854320,32
0,548,7290,3575854288,3575854322,34
0,548,7291,3575854288,3575854323,35
0,548,7292,3575854288,3575854323,35
0,548,7293,3575854288,3575854324,36
0,548,7294,3575854288,3575854326,38
0,548,7295,3575854288,3575854327,39
0,548,7296,3575854288,3575854327,39
0,548,7297,3575854288,3575854327,39
0,548,7298,3575854288,3575854330,42
0,548,7299,3575854288,3575854334,46
0,548,7300,3575854288,3575854334,46
0,548,7301,3575854288,3575854335,47
0,548,7302,3575854288,3575854336,48
0,548,7303,3575854288,3575854336,48
0,548,7304,3575854288,3575854337,49
0,548,7305,3575854288,3575854337,49
0,549,7306,3575854342,3575854342,0
0,549,7307,3575854342,3575854342,0
0,549,7308,3575854342,3575854342,0
0,549,7309,3575854342,3575854342,0
0,549,7310,3575854342,3575854343,1
0,549,7311,3575854342,3575854344,2
0,549,7312,3575854342,3575854345,3
0,549,7313,3575854342,3575854348,6
0,549,7314,3575854342,3575854348,6
0,549,7315,3575854342,3575854349,7
0,549,7316,3575854342,3575854349,7
0,549,7317,3575854342,3575854350,8
0,549,7318,3575854342,3575854353,11
0,549,7319,3575854342,3575854355,13
0,549,7320,3575854342,3575854355,13
0,549,7321,3575854342,3575854355,13
0,549,7322,3575854342,3575854356,14
0,549,7323,3575854342,3575854357,15
0,549,7324,3575854342,3575854359,17
0,549,7325,3575854342,3575854362,20
0,549,7326,3575854342,3575854362,20
0,549,7327,3575854342,3575854365,23
0,549,7328,3575854342,3575854368,26
0,549,7329,3575854342,3575854371,29
0,549,7330,3575854342,3575854372,30
0,549,7331,3575854342,3575854373,31
0,549,7332,3575854342,3575854374,32
0,549,7333,3575854342,3575854375,33
0,549,7334,3575854342,3575854376,34
0,549,7335,3575854342,3575854376,34
0,549,7336,3575854342,3575854377,35
0,549,7337,3575854342,3575854378,36
0,549,7338,3575854342,3575854380,38
0,549,7339,3575854342,3575854383,41
0,549,7340,3575854342,3575854386,44
0,549,7341,3575854342,3575854387,45
0,549,7342,3575854342,3575854390,48
0,550,7343,3575854396,3575854396,0
0,550,7344,3575854396,3575854396,0
0,550,7345,3575854396,3575854396,0
0,550,7346,3575854396,3575854398,2
0,550,7347,3575854396,3575854400,4
0,550,7348,3575854396,3575854400,4
0,550,7349,3575854396,3575854400,4
0,550,7350,3575854396,3575854406,10
0,550,7351,3575854396,3575854408,12
0,550,7352,3575854396,3575854415,19
0,550,7353,3575854396,3575854418,22
0,550,7354,3575854396,3575854418,22
0,550,7355,3575854396,3575854423,27
0,550,7356,3575854396,3575854425,29
0,550,7357,3575854396,3575854426,30
0,550,7358,3575854396,3575854431,35
0,550,7359,3575854396,3575854431,35
0,550,7360,3575854396,3575854432,36
0,550,7361,3575854396,3575854433,37
0,550,7362,3575854396,3575854434,38
0,550,7363,3575854396,3575854435,39
0,550,7364,3575854396,3575854436,40
0,550,7365,3575854396,3575854437,41
0,550,7366,3575854396,3575854441,45
0,550,7367,3575854396,3575854441,45
0,550,7368,3575854396,3575854442,46
0,550,7369,3575854396,3575854442,46
0,550,7370,3575854396,3575854446,50
0,551,7371,3575854450,3575854450,0
0,551,7372,3575854450,3575854450,0
0,551,7373,3575854450,3575854452,2
0,551,7374,3575854450,3575854458,8
0,551,7375,3575854450,3575854459,9
0,551,7376,3575854450,3575854459,9
0,551,7377,3575854450,3575854462,12
0,551,7378,3575854450,3575854466,16
0,551,7379,3575854450,3575854467,17
0,551,7380,3575854450,3575854469,19
0,551,7381,3575854450,3575854471,21
0,551,7382,3575854450,3575854476,26
0,551,7383,3575854450,3575854478,28
0,551,7384,3575854450,3575854480,30
0,551,7385,3575854450,3575854487,37
0,551,7386,3575854450,3575854487,37
0,551,7387,3575854450,3575854489,39
0,551,7388,3575854450,3575854490,40
0,551,7389,3575854450,3575854490,40
0,551,7390,3575854450,3575854491,41
0,551,7391,3575854450,3575854491,41
0,551,7392,3575854450,3575854491,41
0,551,7393,3575854450,3575854493,43
0,551,7394,3575854450,3575854494,44
0,551,7395,3575854450,3575854494,44
0,551,7396,3575854450,3575854495,45
0,551,7397,3575854450,3575854498,48
0,551,7398,3575854450,3575854498,48
0,551,7399,3575854450,3575854500,50
0,552,7400,3575854504,3575854504,0
0,552,7401,3575854504,3575854504,0
0,552,7402,3575854504,3575854505,1
0,552,7403,3575854504,3575854505,1
0,552,7404,3575854504,3575854507,3
0,552,7405,3575854504,3575854507,3
0,552,7406,3575854504,3575854510,6
0,552,7407,3575854504,3575854510,6
0,552,7408,3575854504,3575854512,8
0,552,7409,3575854504,3575854513,9
0,552,7410,3575854504,3575854515,11
0,552,7411,3575854504,3575854516,12
0,552,7412,3575854504,3575854517,13
0,552,7413,3575854504,3575854519,15
0,552,7414,3575854504,3575854520,16
0,552,7415,3575854504,3575854520,16
0,552,7416,3575854504,3575854522,18
0,552,7417,3575854504,3575854522,18
0,552,7418,3575854504,3575854523,19
0,552,7419,3575854504,3575854523,19
0,552,7420,3575854504,3575854525,21
0,552,7421,3575854504,3575854526,22
0,552,7422,3575854504,3575854526,22
0,552,7423,3575854504,3575854527,23
0,552,7424,3575854504,3575854529,25
0,552,7425,3575854504,3575854532,28
0,552,7426,3575854504,3575854533,29
0,552,7427,3575854504,3575854534,30
0,552,7428,3575854504,3575854535,31
0,552,7429,3575854504,3575854535,31
0,552,7430,3575854504,3575854536,32
0,552,7431,3575854504,3575854537,33
0,552,7432,3575854504,3575854538,34
0,552,7433,3575854504,3575854538,34
0,552,7434,3575854504,3575854539,35
0,552,7435,3575854504,3575854541,37
0,552,7436,3575854504,3575854543,39
0,552,7437,3575854504,3575854543,39
0,552,7438,3575854504,3575854544,40
0,552,7439,3575854504,3575854546,42
0,552,7440,3575854504,3575854547,43
0,552,7441,3575854504,3575854548,44
0,552,7442,3575854504,3575854549,45
0,552,7443,3575854504,3575854550,46
0,552,7444,3575854504,3575854552,48
0,552,7445,3575854504,3575854554,50
0,553,7446,3575854558,3575854558,0
0,553,7447,3575854558,3575854558,0
0,553,7448,3575854558,3575854558,0
0,553,7449,3575854558,3575854558,0
0,553,7450,3575854558,3575854558,0
0,553,7451,3575854558,3575854561,3
0,553,7452,3575854558,3575854562,4
0,553,7453,3575854558,3575854564,6
0,553,7454,3575854558,3575854565,7
0,553,7455,3575854558,3575854567,9
0,553,7456,3575854558,3575854570,12
0,553,7457,3575854558,3575854571,13
0,553,7458,3575854558,3575854571,13
0,553,7459,3575854558,3575854571,13
0,553,7460,3575854558,3575854572,14
0,553,7461,3575854558,3575854574,16
0,553,7462,3575854558,3575854576,18
0,553,7463,3575854558,3575854577,19
0,553,7464,3575854558,3575854578,20
0,553,7465,3575854558,3575854582,24
0,553,7466,3575854558,3575854586,28
0,553,7467,3575854558,3575854586,28
0,553,7468,3575854558,3575854589,31
0,553,7469,3575854558,3575854594,36
0,553,7470,3575854558,3575854595,37
0,553,7471,3575854558,3575854595,37
0,553,7472,3575854558,3575854597,39
0,553,7473,3575854558,3575854599,41
0,553,7474,3575854558,3575854599,41
0,553,7475,3575854558,3575854601,43
0,553,7476,3575854558,3575854605,47
0,553,7477,3575854558,3575854607,49
0,554,7478,3575854611,3575854613,2
0,554,7479,3575854611,3575854617,6
0,554,7480,3575854611,3575854620,9
0,554,7481,3575854611,3575854621,10
0,554,7482,3575854611,3575854622,11
0,554,7483,3575854611,3575854626,15
0,554,7484,3575854611,3575854626,15
0,554,7485,3575854611,3575854630,19
0,554,7486,3575854611,3575854632,21
0,554,7487,3575854611,3575854632,21
0,554,7488,3575854611,3575854633,22
0,554,7489,3575854611,3575854634,23
0,554,7490,3575854611,3575854635,24
0,554,7491,3575854611,3575854637,26
0,554,7492,3575854611,3575854640,29
0,554,7493,3575854611,3575854641,30
0,554,7494,3575854611,3575854641,30
0,554,7495,3575854611,3575854642,31
0,554,7496,3575854611,3575854645,34
0,554,7497,3575854611,3575854645,34
0,554,7498,3575854611,3575854646,35
0,554,7499,3575854611,3575854651,40
0,554,7500,3575854611,3575854657,46
0,554,7501,3575854611,3575854658,47
0,554,7502,3575854611,3575854659,48
0,554,7503,3575854611,3575854660,49
0,555,7504,3575854665,3575854665,0
0,555,7505,3575854665,3575854667,2
0,555,7506,3575854665,3575854670,5
0,555,7507,3575854665,3575854672,7
0,555,7508,3575854665,3575854677,12
0,555,7509,3575854665,3575854680,15
0,555,7510,3575854665,3575854687,22
0,555,7511,3575854665,3575854687,22
0,555,7512,3575854665,3575854689,24
0,555,7513,3575854665,3575854690,25
0,555,7514,3575854665,3575854690,25
0,555,7515,3575854665,3575854690,25
0,555,7516,3575854665,3575854690,25
0,555,7517,3575854665,3575854691,26
0,555,7518,3575854665,3575854691,26
0,555,7519,3575854665,3575854692,27
0,555,7520,3575854665,3575854693,28
0,555,7521,3575854665,3575854694,29
0,555,7522,3575854665,3575854694,29
0,555,7523,3575854665,3575854695,30
0,555,7524,3575854665,3575854698,33
0,555,7525,3575854665,3575854699,34
0,555,7526,3575854665,3575854700,35
0,555,7527,3575854665,3575854702,37
0,555,7528,3575854665,3575854703,38
0,555,7529,3575854665,3575854704,39
0,555,7530,3575854665,3575854706,41
0,555,7531,3575854665,3575854706,41
0,555,7532,3575854665,3575854707,42
0,555,7533,3575854665,3575854709,44
0,555,7534,3575854665,3575854712,47
0,555,7535,3575854665,3575854713,48
0,556,7536,3575854719,3575854719,0
0,556,7537,3575854719,3575854719,0
0,556,7538,3575854719,3575854719,0
0,556,7539,3575854719,3575854719,0
0,556,7540,3575854719,3575854719,0
0,556,7541,3575854719,3575854720,1
0,556,7542,3575854719,3575854721,2
0,556,7543,3575854719,3575854722,3
0,556,7544,3575854719,3575854723,4
0,556,7545,3575854719,3575854723,4
0,556,7546,3575854719,3575854724,5
0,556,7547,3575854719,3575854725,6
0,556,7548,3575854719,3575854726,7
0,556,7549,3575854719,3575854728,9
0,556,7550,3575854719,3575854729,10
0,556,7551,3575854719,3575854732,13
0,556,7552,3575854719,3575854734,15
0,556,7553,3575854719,3575854734,15
0,556,7554,3575854719,3575854735,16
0,556,7555,3575854719,3575854735,16
0,556,7556,3575854719,3575854736,17
0,556,7557,3575854719,3575854738,19
0,556,7558,3575854719,3575854739,20
0,556,7559,3575854719,3575854739,20
0,556,7560,3575854719,3575854741,22
0,556,7561,3575854719,3575854742,23
0,556,7562,3575854719,3575854743,24
0,556,7563,3575854719,3575854744,25
0,556,7564,3575854719,3575854747,28
0,556,7565,3575854719,3575854747,28
0,556,7566,3575854719,3575854747,28
0,556,7567,3575854719,3575854749,30
0,556,7568,3575854719,3575854750,31
0,556,7569,3575854719,3575854752,33
0,556,7570,3575854719,3575854754,35
0,556,7571,3575854719,3575854754,35
0,556,7572,3575854719,3575854756,37
0,556,7573,3575854719,3575854757,38
0,556,7574,3575854719,3575854758,39
0,556,7575,3575854719,3575854759,40
0,556,7576,3575854719,3575854761,42
0,556,7577,3575854719,3575854761,42
0,556,7578,3575854719,3575854763,44
0,556,7579,3575854719,3575854765,46
0,556,7580,3575854719,3575854767,48
0,557,7581,3575854773,3575854773,0
0,557,7582,3575854773,3575854773,0
0,557,7583,3575854773,3575854773,0
0,557,7584,3575854773,3575854774,1
0,557,7585,3575854773,3575854774,1
0,557,7586,3575854773,3575854776,3
0,557,7587,3575854773,3575854776,3
0,557,7588,3575854773,3575854777,4
0,557,7589,3575854773,3575854778,5
0,557,7590,3575854773,3575854782,9
0,557,7591,3575854773,3575854786,13
0,557,7592,3575854773,3575854787,14
0,557,7593,3575854773,3575854788,15
0,557,7594,3575854773,3575854794,21
0,557,7595,3575854773,3575854795,22
0,557,7596,3575854773,3575854795,22
0,557,7597,3575854773,3575854798,25
0,557,7598,3575854773,3575854798,25
0,557,7599,3575854773,3575854800,27
0,557,7600,3575854773,3575854804,31
0,557,7601,3575854773,3575854807,34
0,557,7602,3575854773,3575854814,41
0,557,7603,3575854773,3575854818,45
0,557,7604,3575854773,3575854821,48
0,557,7605,3575854773,3575854822,49
0,558,7606,3575854828,3575854828,0
0,558,7607,3575854828,3575854828,0
0,558,7608,3575854828,3575854828,0
0,558,7609,3575854828,3575854830,2
0,558,7610,3575854828,3575854832,4
0,558,7611,3575854828,3575854832,4
0,558,7612,3575854828,3575854833,5
0,558,7613,3575854828,3575854833,5
0,558,7614,3575854828,3575854835,7
0,558,7615,3575854828,3575854837,9
0,558,7616,3575854828,3575854841,13
0,558,7617,3575854828,3575854841,13
0,558,7618,3575854828,3575854842,14
0,558,7619,3575854828,3575854842,14
0,558,7620,3575854828,3575854845,17
0,558,7621,3575854828,3575854846,18
0,558,7622,3575854828,3575854847,19
0,558,7623,3575854828,3575854851,23
0,558,7624,3575854828,3575854857,29
0,558,7625,3575854828,3575854858,30
0,558,7626,3575854828,3575854859,31
0,558,7627,3575854828,3575854861,33
0,558,7628,3575854828,3575854866,38
0,558,7629,3575854828,3575854866,38
0,558,7630,3575854828,3575854871,43
0,558,7631,3575854828,3575854875,47
0,558,7632,3575854828,3575854878,50
0,559,7633,3575854882,3575854882,0
0,559,7634,3575854882,3575854887,5
0,559,7635,3575854882,3575854890,8
0,559,7636,3575854882,3575854890,8
0,559,7637,3575854882,3575854890,8
0,559,7638,3575854882,3575854890,8
0,559,7639,3575854882,3575854891,9
0,559,7640,3575854882,3575854891,9
0,559,7641,3575854882,3575854891,9
0,559,7642,3575854882,3575854892,10
0,559,7643,3575854882,3575854893,11
0,559,7644,3575854882,3575854894,12
0,559,7645,3575854882,3575854895,13
0,559,7646,3575854882,3575854897,15
0,559,7647,3575854882,3575854898,16
0,559,7648,3575854882,3575854900,18
0,559,7649,3575854882,3575854902,20
0,559,7650,3575854882,3575854902,20
0,559,7651,3575854882,3575854904,22
0,559,7652,3575854882,3575854906,24
0,559,7653,3575854882,3575854907,25
0,559,7654,3575854882,3575854907,25
0,559,7655,3575854882,3575854909,27
0,559,7656,3575854882,3575854910,28
0,559,7657,3575854882,3575854911,29
0,559,7658,3575854882,3575854913,31
0,559,7659,3575854882,3575854916,34
0,559,7660,3575854882,3575854916,34
0,559,7661,3575854882,3575854917,35
0,559,7662,3575854882,3575854918,36
0,559,7663,3575854882,3575854919,37
0,559,7664,3575854882,3575854919,37
0,559,7665,3575854882,3575854920,38
0,559,7666,3575854882,3575854921,39
0,559,7667,3575854882,3575854923,41
0,559,7668,3575854882,3575854923,41
0,559,7669,3575854882,3575854923,41
0,559,7670,3575854882,3575854924,42
0,559,7671,3575854882,3575854925,43
0,559,7672,3575854882,3575854926,44
0,559,7673,3575854882,3575854926,44
0,559,7674,3575854882,3575854928,46
0,559,7675,3575854882,3575854930,48
0,559,7676,3575854882,3575854932,50
0,560,7677,3575854936,3575854936,0
0,560,7678,3575854936,3575854936,0
0,560,7679,3575854936,3575854936,0
0,560,7680,3575854936,3575854936,0
0,560,7681,3575854936,3575854936,0
0,560,7682,3575854936,3575854937,1
0,560,7683,3575854936,3575854937,1
0,560,7684,3575854936,3575854939,3
0,560,7685,3575854936,3575854940,4
0,560,7686,3575854936,3575854941,5
0,560,7687,3575854936,3575854942,6
0,560,7688,3575854936,3575854944,8
0,560,7689,3575854936,3575854944,8
0,560,7690,3575854936,3575854947,11
0,560,7691,3575854936,3575854947,11
0,560,7692,3575854936,3575854947,11
0,560,7693,3575854936,3575854949,13
0,560,7694,3575854936,3575854950,14
0,560,7695,3575854936,3575854952,16
0,560,7696,3575854936,3575854954,18
0,560,7697,3575854936,3575854955,19
0,560,7698,3575854936,3575854956,20
0,560,7699,3575854936,3575854956,20
0,560,7700,3575854936,3575854957,21
0,560,7701,3575854936,3575854959,23
0,560,7702,3575854936,3575854961,25
0,560,7703,3575854936,3575854962,26
0,560,7704,3575854936,3575854964,28
0,560,7705,3575854936,3575854966,30
0,560,7706,3575854936,3575854967,31
0,560,7707,3575854936,3575854971,35
0,560,7708,3575854936,3575854972,36
0,560,7709,3575854936,3575854972,36
0,560,7710,3575854936,3575854973,37
0,560,7711,3575854936,3575854974,38
0,560,7712,3575854936,3575854975,39
0,560,7713,3575854936,3575854976,40
0,560,7714,3575854936,3575854977,41
0,560,7715,3575854936,3575854977,41
0,560,7716,3575854936,3575854978,42
0,560,7717,3575854936,3575854979,43
0,560,7718,3575854936,3575854982,46
0,560,7719,3575854936,3575854986,50
0,561,7720,3575854990,3575854990,0
0,561,7721,3575854990,3575854990,0
0,561,7722,3575854990,3575854994,4
0,561,7723,3575854990,3575854995,5
0,561,7724,3575854990,3575854995,5
0,561,7725,3575854990,3575854997,7
0,561,7726,3575854990,3575854998,8
0,561,7727,3575854990,3575855000,10
0,561,7728,3575854990,3575855005,15
0,561,7729,3575854990,3575855006,16
0,561,7730,3575854990,3575855013,23
0,561,7731,3575854990,3575855017,27
0,561,7732,3575854990,3575855021,31
0,561,7733,3575854990,3575855022,32
0,561,7734,3575854990,3575855026,36
0,561,7735,3575854990,3575855027,37
0,561,7736,3575854990,3575855030,40
0,561,7737,3575854990,3575855031,41
0,561,7738,3575854990,3575855032,42
0,561,7739,3575854990,3575855032,42
0,561,7740,3575854990,3575855033,43
0,561,7741,3575854990,3575855034,44
0,561,7742,3575854990,3575855035,45
0,561,7743,3575854990,3575855037,47
0,562,7744,3575855044,3575855044,0
0,562,7745,3575855044,3575855044,0
0,562,7746,3575855044,3575855044,0
0,562,7747,3575855044,3575855044,0
0,562,7748,3575855044,3575855046,2
0,562,7749,3575855044,3575855047,3
0,562,7750,3575855044,3575855048,4
0,562,7751,3575855044,3575855053,9
0,562,7752,3575855044,3575855058,14
0,562,7753,3575855044,3575855058,14
0,562,7754,3575855044,3575855059,15
0,562,7755,3575855044,3575855062,18
0,562,7756,3575855044,3575855066,22
0,562,7757,3575855044,3575855067,23
0,562,7758,3575855044,3575855070,26
0,562,7759,3575855044,3575855076,32
0,562,7760,3575855044,3575855078,34
0,562,7761,3575855044,3575855079,35
0,562,7762,3575855044,3575855080,36
0,562,7763,3575855044,3575855088,44
0,562,7764,3575855044,3575855089,45
0,562,7765,3575855044,3575855089,45
0,562,7766,3575855044,3575855089,45
0,562,7767,3575855044,3575855090,46
0,562,7768,3575855044,3575855091,47
0,562,7769,3575855044,3575855091,47
0,562,7770,3575855044,3575855092,48
0,562,7771,3575855044,3575855092,48
0,562,7772,3575855044,3575855093,49
0,562,7773,3575855044,3575855095,51
0,562,7774,3575855044,3575855095,51
0,563,7775,3575855100,3575855100,0
0,563,7776,3575855100,3575855100,0
0,563,7777,3575855100,3575855100,0
0,563,7778,3575855100,3575855102,2
0,563,7779,3575855100,3575855102,2
0,563,7780,3575855100,3575855104,4
0,563,7781,3575855100,3575855106,6
0,563,7782,3575855100,3575855107,7
0,563,7783,3575855100,3575855107,7
0,563,7784,3575855100,3575855109,9
0,563,7785,3575855100,3575855110,10
0,563,7786,3575855100,3575855112,12
0,563,7787,3575855100,3575855116,16
0,563,7788,3575855100,3575855117,17
0,563,7789,3575855100,3575855117,17
0,563,7790,3575855100,3575855118,18
0,563,7791,3575855100,3575855119,19
0,563,7792,3575855100,3575855120,20
0,563,7793,3575855100,3575855122,22
0,563,7794,3575855100,3575855123,23
0,563,7795,3575855100,3575855123,23
0,563,7796,3575855100,3575855123,23
0,563,7797,3575855100,3575855124,24
0,563,7798,3575855100,3575855124,24
0,563,7799,3575855100,3575855126,26
0,563,7800,3575855100,3575855126,26
0,563,7801,3575855100,3575855126,26
0,563,7802,3575855100,3575855127,27
0,563,7803,3575855100,3575855130,30
0,563,7804,3575855100,3575855130,30
0,563,7805,3575855100,3575855133,33
0,563,7806,3575855100,3575855134,34
0,563,7807,3575855100,3575855135,35
0,563,7808,3575855100,3575855135,35
0,563,7809,3575855100,3575855136,36
0,563,7810,3575855100,3575855136,36
0,563,7811,3575855100,3575855136,36
0,563,7812,3575855100,3575855137,37
0,563,7813,3575855100,3575855139,39
0,563,7814,3575855100,3575855141,41
0,563,7815,3575855100,3575855143,43
0,563,7816,3575855100,3575855143,43
0,563,7817,3575855100,3575855145,45
0,563,7818,3575855100,3575855146,46
0,563,7819,3575855100,3575855147,47
0,563,7820,3575855100,3575855148,48
0,563,7821,3575855100,3575855149,49
0,564,7822,3575855154,3575855154,0
0,564,7823,3575855154,3575855154,0
0,564,7824,3575855154,3575855154,0
0,564,7825,3575855154,3575855155,1
0,564,7826,3575855154,3575855156,2
0,564,7827,3575855154,3575855156,2
0,564,7828,3575855154,3575855157,3
0,564,7829,3575855154,3575855158,4
0,564,7830,3575855154,3575855159,5
0,564,7831,3575855154,3575855161,7
0,564,7832,3575855154,3575855163,9
0,564,7833,3575855154,3575855164,10
0,564,7834,3575855154,3575855166,12
0,564,7835,3575855154,3575855167,13
0,564,7836,3575855154,3575855171,17
0,564,7837,3575855154,3575855171,17
0,564,7838,3575855154,3575855172,18
0,564,7839,3575855154,3575855173,19
0,564,7840,3575855154,3575855174,20
0,564,7841,3575855154,3575855175,21
0,564,7842,3575855154,3575855176,22
0,564,7843,3575855154,3575855178,24
0,564,7844,3575855154,3575855178,24
0,564,7845,3575855154,3575855179,25
0,564,7846,3575855154,3575855180,26
0,564,7847,3575855154,3575855183,29
0,564,7848,3575855154,3575855187,33
0,564,7849,3575855154,3575855187,33
0,564,7850,3575855154,3575855188,34
0,564,7851,3575855154,3575855194,40
0,564,7852,3575855154,3575855195,41
0,564,7853,3575855154,3575855198,44
0,564,7854,3575855154,3575855198,44
0,564,7855,3575855154,3575855199,45
0,565,7856,3575855208,3575855208,0
0,565,7857,3575855208,3575855214,6
0,565,7858,3575855208,3575855217,9
0,565,7859,3575855208,3575855221,13
0,565,7860,3575855208,3575855222,14
0,565,7861,3575855208,3575855226,18
0,565,7862,3575855208,3575855226,18
0,565,7863,3575855208,3575855230,22
0,565,7864,3575855208,3575855230,22
0,565,7865,3575855208,3575855231,23
0,565,7866,3575855208,3575855232,24
0,565,7867,3575855208,3575855232,24
0,565,7868,3575855208,3575855233,25
0,565,7869,3575855208,3575855234,26
0,565,7870,3575855208,3575855236,28
0,565,7871,3575855208,3575855236,28
0,565,7872,3575855208,3575855240,32
0,565,7873,3575855208,3575855241,33
0,565,7874,3575855208,3575855242,34
0,565,7875,3575855208,3575855242,34
0,565,7876,3575855208,3575855247,39
0,565,7877,3575855208,3575855247,39
0,565,7878,3575855208,3575855248,40
0,565,7879,3575855208,3575855253,45
0,566,7880,3575855262,3575855262,0
0,566,7881,3575855262,3575855262,0
0,566,7882,3575855262,3575855262,0
0,566,7883,3575855262,3575855262,0
0,566,7884,3575855262,3575855266,4
0,566,7885,3575855262,3575855267,5
0,566,7886,3575855262,3575855270,8
0,566,7887,3575855262,3575855275,13
0,566,7888,3575855262,3575855278,16
0,566,7889,3575855262,3575855280,18
0,566,7890,3575855262,3575855282,20
0,566,7891,3575855262,3575855287,25
0,566,7892,3575855262,3575855287,25
0,566,7893,3575855262,3575855289,27
0,566,7894,3575855262,3575855290,28
0,566,7895,3575855262,3575855290,28
0,566,7896,3575855262,3575855290,28
0,566,7897,3575855262,3575855291,29
0,566,7898,3575855262,3575855291,29
0,566,7899,3575855262,3575855292,30
0,566,7900,3575855262,3575855293,31
0,566,7901,3575855262,3575855293,31
0,566,7902,3575855262,3575855294,32
0,566,7903,3575855262,3575855295,33
0,566,7904,3575855262,3575855298,36
0,566,7905,3575855262,3575855298,36
0,566,7906,3575855262,3575855300,38
0,566,7907,3575855262,3575855302,40
0,566,7908,3575855262,3575855304,42
0,566,7909,3575855262,3575855306,44
0,566,7910,3575855262,3575855307,45
0,566,7911,3575855262,3575855308,46
0,566,7912,3575855262,3575855310,48
0,566,7913,3575855262,3575855310,48
0,566,7914,3575855262,3575855312,50
0,567,7915,3575855316,3575855316,0
0,567,7916,3575855316,3575855316,0
0,567,7917,3575855316,3575855316,0
0,567,7918,3575855316,3575855317,1
0,567,7919,3575855316,3575855318,2
0,567,7920,3575855316,3575855319,3
0,567,7921,3575855316,3575855321,5
0,567,7922,3575855316,3575855321,5
0,567,7923,3575855316,3575855322,6
0,567,7924,3575855316,3575855323,7
0,567,7925,3575855316,3575855323,7
0,567,7926,3575855316,3575855324,8
0,567,7927,3575855316,3575855324,8
0,567,7928,3575855316,3575855325,9
0,567,7929,3575855316,3575855326,10
0,567,7930,3575855316,3575855326,10
0,567,7931,3575855316,3575855327,11
0,567,7932,3575855316,3575855327,11
0,567,7933,3575855316,3575855329,13
0,567,7934,3575855316,3575855332,16
0,567,7935,3575855316,3575855333,17
0,567,7936,3575855316,3575855335,19
0,567,7937,3575855316,3575855335,19
0,567,7938,3575855316,3575855336,20
0,567,7939,3575855316,3575855336,20
0,567,7940,3575855316,3575855337,21
0,567,7941,3575855316,3575855339,23
0,567,7942,3575855316,3575855339,23
0,567,7943,3575855316,3575855339,23
0,567,7944,3575855316,3575855341,25
0,567,7945,3575855316,3575855343,27
0,567,7946,3575855316,3575855343,27
0,567,7947,3575855316,3575855345,29
0,567,7948,3575855316,3575855348,32
0,567,7949,3575855316,3575855349,33
0,567,7950,3575855316,3575855349,33
0,567,7951,3575855316,3575855350,34
0,567,7952,3575855316,3575855350,34
0,567,7953,3575855316,3575855352,36
0,567,7954,3575855316,3575855354,38
0,567,7955,3575855316,3575855354,38
0,567,7956,3575855316,3575855355,39
0,567,7957,3575855316,3575855357,41
0,567,7958,3575855316,3575855357,41
0,567,7959,3575855316,3575855358,42
0,567,7960,3575855316,3575855358,42
0,567,7961,3575855316,3575855362,46
0,567,7962,3575855316,3575855364,48
0,567,7963,3575855316,3575855364,48
0,567,7964,3575855316,3575855365,49
0,568,7965,3575855370,3575855370,0
0,568,7966,3575855370,3575855371,1
0,568,7967,3575855370,3575855372,2
0,568,7968,3575855370,3575855373,3
0,568,7969,3575855370,3575855374,4
0,568,7970,3575855370,3575855374,4
0,568,7971,3575855370,3575855376,6
0,568,7972,3575855370,3575855376,6
0,568,7973,3575855370,3575855377,7
0,568,7974,3575855370,3575855378,8
0,568,7975,3575855370,3575855380,10
0,568,7976,3575855370,3575855382,12
0,568,7977,3575855370,3575855383,13
0,568,7978,3575855370,3575855383,13
0,568,7979,3575855370,3575855387,17
0,568,7980,3575855370,3575855387,17
0,568,7981,3575855370,3575855389,19
0,568,7982,3575855370,3575855394,24
0,568,7983,3575855370,3575855395,25
0,568,7984,3575855370,3575855397,27
0,568,7985,3575855370,3575855399,29
0,568,7986,3575855370,3575855400,30
0,568,7987,3575855370,3575855401,31
0,568,7988,3575855370,3575855406,36
0,568,7989,3575855370,3575855407,37
0,568,7990,3575855370,3575855407,37
0,568,7991,3575855370,3575855414,44
0,568,7992,3575855370,3575855417,47
0,569,7993,3575855426,3575855426,0
0,569,7994,3575855426,3575855426,0
0,569,7995,3575855426,3575855426,0
0,569,7996,3575855426,3575855427,1
0,569,7997,3575855426,3575855430,4
0,569,7998,3575855426,3575855431,5
0,569,7999,3575855426,3575855431,5
0,569,8000,3575855426,3575855432,6
0,569,8001,3575855426,3575855432,6
0,569,8002,3575855426,3575855433,7
0,569,8003,3575855426,3575855434,8
0,569,8004,3575855426,3575855434,8
0,569,8005,3575855426,3575855437,11
0,569,8006,3575855426,3575855437,11
0,569,8007,3575855426,3575855441,15
0,569,8008,3575855426,3575855441,15
0,569,8009,3575855426,3575855442,16
0,569,8010,3575855426,3575855442,16
0,569,8011,3575855426,3575855447,21
0,569,8012,3575855426,3575855447,21
0,569,8013,3575855426,3575855448,22
0,569,8014,3575855426,3575855453,27
0,569,8015,3575855426,3575855458,32
0,569,8016,3575855426,3575855458,32
0,569,8017,3575855426,3575855461,35
0,569,8018,3575855426,3575855462,36
0,569,8019,3575855426,3575855466,40
0,569,8020,3575855426,3575855466,40
0,569,8021,3575855426,3575855471,45
0,569,8022,3575855426,3575855475,49
0,570,8023,3575855480,3575855480,0
0,570,8024,3575855480,3575855480,0
0,570,8025,3575855480,3575855480,0
0,570,8026,3575855480,3575855485,5
0,570,8027,3575855480,3575855486,6
0,570,8028,3575855480,3575855486,6
0,570,8029,3575855480,3575855488,8
0,570,8030,3575855480,3575855488,8
0,570,8031,3575855480,3575855489,9
0,570,8032,3575855480,3575855489,9
0,570,8033,3575855480,3575855489,9
0,570,8034,3575855480,3575855489,9
0,570,8035,3575855480,3575855490,10
0,570,8036,3575855480,3575855491,11
0,570,8037,3575855480,3575855492,12
0,570,8038,3575855480,3575855492,12
0,570,8039,3575855480,3575855494,14
0,570,8040,3575855480,3575855494,14
0,570,8041,3575855480,3575855496,16
0,570,8042,3575855480,3575855497,17
0,570,8043,3575855480,3575855499,19
0,570,8044,3575855480,3575855501,21
0,570,8045,3575855480,3575855504,24
0,570,8046,3575855480,3575855506,26
0,570,8047,3575855480,3575855506,26
0,570,8048,3575855480,3575855506,26
0,570,8049,3575855480,3575855509,29
0,570,8050,3575855480,3575855509,29
0,570,8051,3575855480,3575855511,31
0,570,8052,3575855480,3575855511,31
0,570,8053,3575855480,3575855515,35
0,570,8054,3575855480,3575855515,35
0,570,8055,3575855480,3575855516,36
0,570,8056,3575855480,3575855517,37
0,570,8057,3575855480,3575855518,38
0,570,8058,3575855480,3575855520,40
0,570,8059,3575855480,3575855520,40
0,570,8060,3575855480,3575855521,41
0,570,8061,3575855480,3575855522,42
0,570,8062,3575855480,3575855523,43
0,570,8063,3575855480,3575855523,43
0,570,8064,3575855480,3575855523,43
0,570,8065,3575855480,3575855524,44
0,570,8066,3575855480,3575855526,46
0,570,8067,3575855480,3575855526,46
0,570,8068,3575855480,3575855527,47
0,570,8069,3575855480,3575855529,49
0,571,8070,3575855534,3575855534,0
0,571,8071,3575855534,3575855534,0
0,571,8072,3575855534,3575855534,0
0,571,8073,3575855534,3575855535,1
0,571,8074,3575855534,3575855535,1
0,571,8075,3575855534,3575855536,2
0,571,8076,3575855534,3575855536,2
0,571,8077,3575855534,3575855537,3
0,571,8078,3575855534,3575855538,4
0,571,8079,3575855534,3575855539,5
0,571,8080,3575855534,3575855540,6
0,571,8081,3575855534,3575855542,8
0,571,8082,3575855534,3575855542,8
0,571,8083,3575855534,3575855544,10
0,571,8084,3575855534,3575855547,13
0,571,8085,3575855534,3575855547,13
0,571,8086,3575855534,3575855547,13
0,571,8087,3575855534,3575855549,15
0,571,8088,3575855534,3575855550,16
0,571,8089,3575855534,3575855551,17
0,571,8090,3575855534,3575855553,19
0,571,8091,3575855534,3575855553,19
0,571,8092,3575855534,3575855555,21
0,571,8093,3575855534,3575855556,22
0,571,8094,3575855534,3575855556,22
0,571,8095,3575855534,3575855557,23
0,571,8096,3575855534,3575855558,24
0,571,8097,3575855534,3575855561,27
0,571,8098,3575855534,3575855563,29
0,571,8099,3575855534,3575855564,30
0,571,8100,3575855534,3575855565,31
0,571,8101,3575855534,3575855566,32
0,571,8102,3575855534,3575855570,36
0,571,8103,3575855534,3575855571,37
0,571,8104,3575855534,3575855572,38
0,571,8105,3575855534,3575855573,39
0,571,8106,3575855534,3575855574,40
0,571,8107,3575855534,3575855575,41
0,571,8108,3575855534,3575855576,42
0,571,8109,3575855534,3575855577,43
0,571,8110,3575855534,3575855578,44
0,571,8111,3575855534,3575855579,45
0,571,8112,3575855534,3575855580,46
0,571,8113,3575855534,3575855582,48
0,572,8114,3575855589,3575855589,0
0,572,8115,3575855589,3575855589,0
0,572,8116,3575855589,3575855589,0
0,572,8117,3575855589,3575855589,0
0,572,8118,3575855589,3575855593,4
0,572,8119,3575855589,3575855594,5
0,572,8120,3575855589,3575855596,7
0,572,8121,3575855589,3575855598,9
0,572,8122,3575855589,3575855598,9
0,572,8123,3575855589,3575855600,11
0,572,8124,3575855589,3575855600,11
0,572,8125,3575855589,3575855605,16
0,572,8126,3575855589,3575855605,16
0,572,8127,3575855589,3575855606,17
0,572,8128,3575855589,3575855614,25
0,572,8129,3575855589,3575855617,28
0,572,8130,3575855589,3575855620,31
0,572,8131,3575855589,3575855623,34
0,572,8132,3575855589,3575855625,36
0,572,8133,3575855589,3575855627,38
0,572,8134,3575855589,3575855629,40
0,572,8135,3575855589,3575855630,41
0,572,8136,3575855589,3575855630,41
0,572,8137,3575855589,3575855632,43
0,572,8138,3575855589,3575855633,44
0,572,8139,3575855589,3575855633,44
0,572,8140,3575855589,3575855636,47
0,572,8141,3575855589,3575855636,47
0,572,8142,3575855589,3575855637,48
0,573,8143,3575855643,3575855643,0
0,573,8144,3575855643,3575855643,0
0,573,8145,3575855643,3575855643,0
0,573,8146,3575855643,3575855643,0
0,573,8147,3575855643,3575855645,2
0,573,8148,3575855643,3575855646,3
0,573,8149,3575855643,3575855647,4
0,573,8150,3575855643,3575855657,14
0,573,8151,3575855643,3575855657,14
0,573,8152,3575855643,3575855661,18
0,573,8153,3575855643,3575855661,18
0,573,8154,3575855643,3575855665,22
0,573,8155,3575855643,3575855666,23
0,573,8156,3575855643,3575855669,26
0,573,8157,3575855643,3575855675,32
0,573,8158,3575855643,3575855679,36
0,573,8159,3575855643,3575855679,36
0,573,8160,3575855643,3575855679,36
0,573,8161,3575855643,3575855686,43
0,573,8162,3575855643,3575855686,43
0,573,8163,3575855643,3575855688,45
0,573,8164,3575855643,3575855688,45
0,573,8165,3575855643,3575855688,45
0,573,8166,3575855643,3575855689,46
0,573,8167,3575855643,3575855690,47
0,573,8168,3575855643,3575855690,47
0,573,8169,3575855643,3575855690,47
0,573,8170,3575855643,3575855691,48
0,573,8171,3575855643,3575855691,48
0,573,8172,3575855643,3575855692,49
0,573,8173,3575855643,3575855693,50
0,574,8174,3575855696,3575855696,0
0,574,8175,3575855696,3575855696,0
0,574,8176,3575855696,3575855696,0
0,574,8177,3575855696,3575855698,2
0,574,8178,3575855696,3575855699,3
0,574,8179,3575855696,3575855702,6
0,574,8180,3575855696,3575855703,7
0,574,8181,3575855696,3575855705,9
0,574,8182,3575855696,3575855706,10
0,574,8183,3575855696,3575855706,10
0,574,8184,3575855696,3575855710,14
0,574,8185,3575855696,3575855712,16
0,574,8186,3575855696,3575855712,16
0,574,8187,3575855696,3575855715,19
0,574,8188,3575855696,3575855716,20
0,574,8189,3575855696,3575855717,21
0,574,8190,3575855696,3575855718,22
0,574,8191,3575855696,3575855718,22
0,574,8192,3575855696,3575855720,24
0,574,8193,3575855696,3575855720,24
0,574,8194,3575855696,3575855721,25
0,574,8195,3575855696,3575855722,26
0,574,8196,3575855696,3575855723,27
0,574,8197,3575855696,3575855723,27
0,574,8198,3575855696,3575855723,27
0,574,8199,3575855696,3575855725,29
0,574,8200,3575855696,3575855726,30
0,574,8201,3575855696,3575855726,30
0,574,8202,3575855696,3575855727,31
0,574,8203,3575855696,3575855729,33
0,574,8204,3575855696,3575855732,36
0,574,8205,3575855696,3575855734,38
0,574,8206,3575855696,3575855735,39
0,574,8207,3575855696,3575855735,39
0,574,8208,3575855696,3575855736,40
0,574,8209,3575855696,3575855736,40
0,574,8210,3575855696,3575855738,42
0,574,8211,3575855696,3575855738,42
0,574,8212,3575855696,3575855738,42
0,574,8213,3575855696,3575855739,43
0,574,8214,3575855696,3575855740,44
0,574,8215,3575855696,3575855742,46
0,574,8216,3575855696,3575855743,47
0,574,8217,3575855696,3575855744,48
0,575,8218,3575855751,3575855751,0
0,575,8219,3575855751,3575855751,0
0,575,8220,3575855751,3575855751,0
0,575,8221,3575855751,3575855751,0
0,575,8222,3575855751,3575855751,0
0,575,8223,3575855751,3575855752,1
0,575,8224,3575855751,3575855753,2
0,575,8225,3575855751,3575855754,3
0,575,8226,3575855751,3575855755,4
0,575,8227,3575855751,3575855756,5
0,575,8228,3575855751,3575855756,5
0,575,8229,3575855751,3575855757,6
0,575,8230,3575855751,3575855759,8
0,575,8231,3575855751,3575855761,10
0,575,8232,3575855751,3575855763,12
0,575,8233,3575855751,3575855764,13
0,575,8234,3575855751,3575855765,14
0,575,8235,3575855751,3575855766,15
0,575,8236,3575855751,3575855770,19
0,575,8237,3575855751,3575855771,20
0,575,8238,3575855751,3575855772,21
0,575,8239,3575855751,3575855773,22
0,575,8240,3575855751,3575855774,23
0,575,8241,3575855751,3575855775,24
0,575,8242,3575855751,3575855776,25
0,575,8243,3575855751,3575855777,26
0,575,8244,3575855751,3575855778,27
0,575,8245,3575855751,3575855780,29
0,575,8246,3575855751,3575855781,30
0,575,8247,3575855751,3575855782,31
0,575,8248,3575855751,3575855787,36
0,575,8249,3575855751,3575855788,37
0,575,8250,3575855751,3575855789,38
0,575,8251,3575855751,3575855792,41
0,575,8252,3575855751,3575855794,43
0,575,8253,3575855751,3575855794,43
0,575,8254,3575855751,3575855797,46
0,575,8255,3575855751,3575855798,47
0,575,8256,3575855751,3575855799,48
0,575,8257,3575855751,3575855800,49
0,576,8258,3575855805,3575855805,0
0,576,8259,3575855805,3575855805,0
0,576,8260,3575855805,3575855805,0
0,576,8261,3575855805,3575855806,1
0,576,8262,3575855805,3575855815,10
0,576,8263,3575855805,3575855817,12
0,576,8264,3575855805,3575855822,17
0,576,8265,3575855805,3575855823,18
0,576,8266,3575855805,3575855825,20
0,576,8267,3575855805,3575855827,22
0,576,8268,3575855805,3575855829,24
0,576,8269,3575855805,3575855830,25
0,576,8270,3575855805,3575855830,25
0,576,8271,3575855805,3575855833,28
0,576,8272,3575855805,3575855834,29
0,576,8273,3575855805,3575855836,31
0,576,8274,3575855805,3575855836,31
0,576,8275,3575855805,3575855840,35
0,576,8276,3575855805,3575855841,36
0,576,8277,3575855805,3575855843,38
0,576,8278,3575855805,3575855843,38
0,576,8279,3575855805,3575855843,38
0,576,8280,3575855805,3575855846,41
0,576,8281,3575855805,3575855847,42
0,576,8282,3575855805,3575855847,42
0,576,8283,3575855805,3575855853,48
0,577,8284,3575855860,3575855860,0
0,577,8285,3575855860,3575855861,1
0,577,8286,3575855860,3575855861,1
0,577,8287,3575855860,3575855867,7
0,577,8288,3575855860,3575855871,11
0,577,8289,3575855860,3575855876,16
0,577,8290,3575855860,3575855878,18
0,577,8291,3575855860,3575855878,18
0,577,8292,3575855860,3575855879,19
0,577,8293,3575855860,3575855886,26
0,577,8294,3575855860,3575855887,27
0,577,8295,3575855860,3575855888,28
0,577,8296,3575855860,3575855889,29
0,577,8297,3575855860,3575855889,29
0,577,8298,3575855860,3575855890,30
0,577,8299,3575855860,3575855890,30
0,577,8300,3575855860,3575855890,30
0,577,8301,3575855860,3575855890,30
0,577,8302,3575855860,3575855891,31
0,577,8303,3575855860,3575855891,31
0,577,8304,3575855860,3575855892,32
0,577,8305,3575855860,3575855894,34
0,577,8306,3575855860,3575855894,34
0,577,8307,3575855860,3575855895,35
0,577,8308,3575855860,3575855897,37
0,577,8309,3575855860,3575855898,38
0,577,8310,3575855860,3575855899,39
0,577,8311,3575855860,3575855902,42
0,577,8312,3575855860,3575855902,42
0,577,8313,3575855860,3575855903,43
0,577,8314,3575855860,3575855905,45
0,577,8315,3575855860,3575855906,46
0,577,8316,3575855860,3575855907,47
0,577,8317,3575855860,3575855909,49
0,577,8318,3575855860,3575855909,49
0,578,8319,3575855915,3575855915,0
0,578,8320,3575855915,3575855915,0
0,578,8321,3575855915,3575855915,0
0,578,8322,3575855915,3575855916,1
0,578,8323,3575855915,3575855918,3
0,578,8324,3575855915,3575855918,3
0,578,8325,3575855915,3575855920,5
0,578,8326,3575855915,3575855920,5
0,578,8327,3575855915,3575855920,5
0,578,8328,3575855915,3575855923,8
0,578,8329,3575855915,3575855923,8
0,578,8330,3575855915,3575855923,8
0,578,8331,3575855915,3575855924,9
0,578,8332,3575855915,3575855925,10
0,578,8333,3575855915,3575855925,10
0,578,8334,3575855915,3575855926,11
0,578,8335,3575855915,3575855928,13
0,578,8336,3575855915,3575855933,18
0,578,8337,3575855915,3575855934,19
0,578,8338,3575855915,3575855935,20
0,578,8339,3575855915,3575855935,20
0,578,8340,3575855915,3575855936,21
0,578,8341,3575855915,3575855936,21
0,578,8342,3575855915,3575855937,22
0,578,8343,3575855915,3575855938,23
0,578,8344,3575855915,3575855939,24
0,578,8345,3575855915,3575855939,24
0,578,8346,3575855915,3575855939,24
0,578,8347,3575855915,3575855940,25
0,578,8348,3575855915,3575855942,27
0,578,8349,3575855915,3575855942,27
0,578,8350,3575855915,3575855943,28
0,578,8351,3575855915,3575855944,29
0,578,8352,3575855915,3575855947,32
0,578,8353,3575855915,3575855947,32
0,578,8354,3575855915,3575855948,33
0,578,8355,3575855915,3575855950,35
0,578,8356,3575855915,3575855951,36
0,578,8357,3575855915,3575855952,37
0,578,8358,3575855915,3575855953,38
0,578,8359,3575855915,3575855955,40
0,578,8360,3575855915,3575855955,40
0,578,8361,3575855915,3575855956,41
0,578,8362,3575855915,3575855957,42
0,578,8363,3575855915,3575855958,43
0,578,8364,3575855915,3575855959,44
0,578,8365,3575855915,3575855961,46
0,578,8366,3575855915,3575855963,48
0,578,8367,3575855915,3575855963,48
0,578,8368,3575855915,3575855965,50
0,579,8369,3575855970,3575855970,0
0,579,8370,3575855970,3575855971,1
0,579,8371,3575855970,3575855971,1
0,579,8372,3575855970,3575855971,1
0,579,8373,3575855970,3575855973,3
0,579,8374,3575855970,3575855975,5
0,579,8375,3575855970,3575855975,5
0,579,8376,3575855970,3575855975,5
0,579,8377,3575855970,3575855978,8
0,579,8378,3575855970,3575855980,10
0,579,8379,3575855970,3575855981,11
0,579,8380,3575855970,3575855982,12
0,579,8381,3575855970,3575855986,16
0,579,8382,3575855970,3575855989,19
0,579,8383,3575855970,3575855989,19
0,579,8384,3575855970,3575855993,23
0,579,8385,3575855970,3575855994,24
0,579,8386,3575855970,3575855994,24
0,579,8387,3575855970,3575855997,27
0,579,8388,3575855970,3575855998,28
0,579,8389,3575855970,3575855999,29
0,579,8390,3575855970,3575856000,30
0,579,8391,3575855970,3575856000,30
0,579,8392,3575855970,3575856005,35
0,579,8393,3575855970,3575856006,36
0,579,8394,3575855970,3575856007,37
0,579,8395,3575855970,3575856015,45
0,579,8396,3575855970,3575856017,47
0,580,8397,3575856025,3575856025,0
0,580,8398,3575856025,3575856025,0
0,580,8399,3575856025,3575856026,1
0,580,8400,3575856025,3575856027,2
0,580,8401,3575856025,3575856029,4
0,580,8402,3575856025,3575856030,5
0,580,8403,3575856025,3575856030,5
0,580,8404,3575856025,3575856032,7
0,580,8405,3575856025,3575856033,8
0,580,8406,3575856025,3575856033,8
0,580,8407,3575856025,3575856036,11
0,580,8408,3575856025,3575856036,11
0,580,8409,3575856025,3575856040,15
0,580,8410,3575856025,3575856042,17
0,580,8411,3575856025,3575856042,17
0,580,8412,3575856025,3575856043,18
0,580,8413,3575856025,3575856044,19
0,580,8414,3575856025,3575856045,20
0,580,8415,3575856025,3575856046,21
0,580,8416,3575856025,3575856048,23
0,580,8417,3575856025,3575856053,28
0,580,8418,3575856025,3575856057,32
0,580,8419,3575856025,3575856059,34
0,580,8420,3575856025,3575856061,36
0,580,8421,3575856025,3575856062,37
0,580,8422,3575856025,3575856066,41
0,580,8423,3575856025,3575856066,41
0,580,8424,3575856025,3575856070,45
0,581,8425,3575856080,3575856080,0
0,581,8426,3575856080,3575856080,0
0,581,8427,3575856080,3575856080,0
0,581,8428,3575856080,3575856080,0
0,581,8429,3575856080,3575856086,6
0,581,8430,3575856080,3575856087,7
0,581,8431,3575856080,3575856088,8
0,581,8432,3575856080,3575856088,8
0,581,8433,3575856080,3575856089,9
0,581,8434,3575856080,3575856090,10
0,581,8435,3575856080,3575856090,10
0,581,8436,3575856080,3575856090,10
0,581,8437,3575856080,3575856090,10
0,581,8438,3575856080,3575856091,11
0,581,8439,3575856080,3575856092,12
0,581,8440,3575856080,3575856092,12
0,581,8441,3575856080,3575856094,14
0,581,8442,3575856080,3575856094,14
0,581,8443,3575856080,3575856094,14
0,581,8444,3575856080,3575856095,15
0,581,8445,3575856080,3575856096,16
0,581,8446,3575856080,3575856099,19
0,581,8447,3575856080,3575856099,19
0,581,8448,3575856080,3575856102,22
0,581,8449,3575856080,3575856103,23
0,581,8450,3575856080,3575856106,26
0,581,8451,3575856080,3575856106,26
0,581,8452,3575856080,3575856109,29
0,581,8453,3575856080,3575856109,29
0,581,8454,3575856080,3575856112,32
0,581,8455,3575856080,3575856112,32
0,581,8456,3575856080,3575856115,35
0,581,8457,3575856080,3575856116,36
0,581,8458,3575856080,3575856118,38
0,581,8459,3575856080,3575856119,39
0,581,8460,3575856080,3575856120,40
0,581,8461,3575856080,3575856120,40
0,581,8462,3575856080,3575856122,42
0,581,8463,3575856080,3575856123,43
0,581,8464,3575856080,3575856123,43
0,581,8465,3575856080,3575856124,44
0,581,8466,3575856080,3575856124,44
0,581,8467,3575856080,3575856125,45
0,581,8468,3575856080,3575856126,46
0,581,8469,3575856080,3575856126,46
0,581,8470,3575856080,3575856127,47
0,581,8471,3575856080,3575856127,47
0,581,8472,3575856080,3575856130,50
0,582,8473,3575856134,3575856134,0
0,582,8474,3575856134,3575856134,0
0,582,8475,3575856134,3575856134,0
0,582,8476,3575856134,3575856136,2
0,582,8477,3575856134,3575856136,2
0,582,8478,3575856134,3575856136,2
0,582,8479,3575856134,3575856137,3
0,582,8480,3575856134,3575856138,4
0,582,8481,3575856134,3575856138,4
0,582,8482,3575856134,3575856139,5
0,582,8483,3575856134,3575856139,5
0,582,8484,3575856134,3575856140,6
0,582,8485,3575856134,3575856143,9
0,582,8486,3575856134,3575856144,10
0,582,8487,3575856134,3575856145,11
0,582,8488,3575856134,3575856145,11
0,582,8489,3575856134,3575856147,13
0,582,8490,3575856134,3575856147,13
0,582,8491,3575856134,3575856147,13
0,582,8492,3575856134,3575856149,15
0,582,8493,3575856134,3575856150,16
0,582,8494,3575856134,3575856152,18
0,582,8495,3575856134,3575856154,20
0,582,8496,3575856134,3575856154,20
0,582,8497,3575856134,3575856156,22
0,582,8498,3575856134,3575856156,22
0,582,8499,3575856134,3575856157,23
0,582,8500,3575856134,3575856159,25
0,582,8501,3575856134,3575856161,27
0,582,8502,3575856134,3575856162,28
0,582,8503,3575856134,3575856164,30
0,582,8504,3575856134,3575856165,31
0,582,8505,3575856134,3575856171,37
0,582,8506,3575856134,3575856172,38
0,582,8507,3575856134,3575856172,38
0,582,8508,3575856134,3575856174,40
0,582,8509,3575856134,3575856175,41
0,582,8510,3575856134,3575856176,42
0,582,8511,3575856134,3575856178,44
0,582,8512,3575856134,3575856178,44
0,582,8513,3575856134,3575856181,47
0,582,8514,3575856134,3575856182,48
0,582,8515,3575856134,3575856183,49
0,583,8516,3575856188,3575856188,0
0,583,8517,3575856188,3575856188,0
0,583,8518,3575856188,3575856189,1
0,583,8519,3575856188,3575856194,6
0,583,8520,3575856188,3575856194,6
0,583,8521,3575856188,3575856195,7
0,583,8522,3575856188,3575856197,9
0,583,8523,3575856188,3575856198,10
0,583,8524,3575856188,3575856198,10
0,583,8525,3575856188,3575856200,12
0,583,8526,3575856188,3575856201,13
0,583,8527,3575856188,3575856205,17
0,583,8528,3575856188,3575856206,18
0,583,8529,3575856188,3575856206,18
0,583,8530,3575856188,3575856215,27
0,583,8531,3575856188,3575856218,30
0,583,8532,3575856188,3575856222,34
0,583,8533,3575856188,3575856224,36
0,583,8534,3575856188,3575856226,38
0,583,8535,3575856188,3575856227,39
0,583,8536,3575856188,3575856228,40
0,583,8537,3575856188,3575856229,41
0,583,8538,3575856188,3575856230,42
0,583,8539,3575856188,3575856232,44
0,583,8540,3575856188,3575856233,45
0,583,8541,3575856188,3575856233,45
0,583,8542,3575856188,3575856234,46
0,583,8543,3575856188,3575856236,48
0,583,8544,3575856188,3575856236,48
0,584,8545,3575856243,3575856243,0
0,584,8546,3575856243,3575856243,0
0,584,8547,3575856243,3575856243,0
0,584,8548,3575856243,3575856243,0
0,584,8549,3575856243,3575856245,2
0,584,8550,3575856243,3575856246,3
0,584,8551,3575856243,3575856247,4
0,584,8552,3575856243,3575856248,5
0,584,8553,3575856243,3575856253,10
0,584,8554,3575856243,3575856258,15
0,584,8555,3575856243,3575856260,17
0,584,8556,3575856243,3575856261,18
0,584,8557,3575856243,3575856262,19
0,584,8558,3575856243,3575856266,23
0,584,8559,3575856243,3575856267,24
0,584,8560,3575856243,3575856271,28
0,584,8561,3575856243,3575856279,36
0,584,8562,3575856243,3575856279,36
0,584,8563,3575856243,3575856279,36
0,584,8564,3575856243,3575856286,43
0,584,8565,3575856243,3575856288,45
0,584,8566,3575856243,3575856288,45
0,584,8567,3575856243,3575856289,46
0,584,8568,3575856243,3575856289,46
0,584,8569,3575856243,3575856290,47
0,584,8570,3575856243,3575856290,47
0,584,8571,3575856243,3575856290,47
0,584,8572,3575856243,3575856291,48
0,584,8573,3575856243,3575856292,49
0,584,8574,3575856243,3575856292,49
0,585,8575,3575856298,3575856298,0
0,585,8576,3575856298,3575856298,0
0,585,8577,3575856298,3575856298,0
0,585,8578,3575856298,3575856298,0
0,585,8579,3575856298,3575856298,0
0,585,8580,3575856298,3575856298,0
0,585,8581,3575856298,3575856299,1
0,585,8582,3575856298,3575856303,5
0,585,8583,3575856298,3575856303,5
0,585,8584,3575856298,3575856305,7
0,585,8585,3575856298,3575856306,8
0,585,8586,3575856298,3575856307,9
0,585,8587,3575856298,3575856309,11
0,585,8588,3575856298,3575856309,11
0,585,8589,3575856298,3575856311,13
0,585,8590,3575856298,3575856313,15
0,585,8591,3575856298,3575856316,18
0,585,8592,3575856298,3575856316,18
0,585,8593,3575856298,3575856316,18
0,585,8594,3575856298,3575856318,20
0,585,8595,3575856298,3575856319,21
0,585,8596,3575856298,3575856319,21
0,585,8597,3575856298,3575856320,22
0,585,8598,3575856298,3575856321,23
0,585,8599,3575856298,3575856322,24
0,585,8600,3575856298,3575856323,25
0,585,8601,3575856298,3575856324,26
0,585,8602,3575856298,3575856324,26
0,585,8603,3575856298,3575856325,27
0,585,8604,3575856298,3575856325,27
0,585,8605,3575856298,3575856326,28
0,585,8606,3575856298,3575856327,29
0,585,8607,3575856298,3575856327,29
0,585,8608,3575856298,3575856330,32
0,585,8609,3575856298,3575856334,36
0,585,8610,3575856298,3575856335,37
0,585,8611,3575856298,3575856336,38
0,585,8612,3575856298,3575856336,38
0,585,8613,3575856298,3575856337,39
0,585,8614,3575856298,3575856337,39
0,585,8615,3575856298,3575856338,40
0,585,8616,3575856298,3575856339,41
0,585,8617,3575856298,3575856339,41
0,585,8618,3575856298,3575856339,41
0,585,8619,3575856298,3575856340,42
0,585,8620,3575856298,3575856343,45
0,585,8621,3575856298,3575856344,46
0,585,8622,3575856298,3575856345,47
0,586,8623,3575856352,3575856352,0
0,586,8624,3575856352,3575856352,0
0,586,8625,3575856352,3575856352,0
0,586,8626,3575856352,3575856352,0
0,586,8627,3575856352,3575856352,0
0,586,8628,3575856352,3575856352,0
0,586,8629,3575856352,3575856352,0
0,586,8630,3575856352,3575856353,1
0,586,8631,3575856352,3575856355,3
0,586,8632,3575856352,3575856356,4
0,586,8633,3575856352,3575856356,4
0,586,8634,3575856352,3575856357,5
0,586,8635,3575856352,3575856359,7
0,586,8636,3575856352,3575856362,10
0,586,8637,3575856352,3575856363,11
0,586,8638,3575856352,3575856364,12
0,586,8639,3575856352,3575856366,14
0,586,8640,3575856352,3575856372,20
0,586,8641,3575856352,3575856372,20
0,586,8642,3575856352,3575856374,22
0,586,8643,3575856352,3575856374,22
0,586,8644,3575856352,3575856376,24
0,586,8645,3575856352,3575856377,25
0,586,8646,3575856352,3575856378,26
0,586,8647,3575856352,3575856378,26
0,586,8648,3575856352,3575856381,29
0,586,8649,3575856352,3575856382,30
0,586,8650,3575856352,3575856383,31
0,586,8651,3575856352,3575856386,34
0,586,8652,3575856352,3575856389,37
0,586,8653,3575856352,3575856389,37
0,586,8654,3575856352,3575856394,42
0,586,8655,3575856352,3575856394,42
0,586,8656,3575856352,3575856398,46
0,586,8657,3575856352,3575856398,46
0,586,8658,3575856352,3575856398,46
0,586,8659,3575856352,3575856399,47
0,586,8660,3575856352,3575856400,48
0,586,8661,3575856352,3575856401,49
0,587,8662,3575856407,3575856407,0
0,587,8663,3575856407,3575856407,0
0,587,8664,3575856407,3575856407,0
0,587,8665,3575856407,3575856415,8
0,587,8666,3575856407,3575856417,10
0,587,8667,3575856407,3575856425,18
0,587,8668,3575856407,3575856425,18
0,587,8669,3575856407,3575856427,20
0,587,8670,3575856407,3575856428,21
0,587,8671,3575856407,3575856430,23
0,587,8672,3575856407,3575856431,24
0,587,8673,3575856407,3575856432,25
0,587,8674,3575856407,3575856433,26
0,587,8675,3575856407,3575856433,26
0,587,8676,3575856407,3575856436,29
0,587,8677,3575856407,3575856437,30
0,587,8678,3575856407,3575856440,33
0,587,8679,3575856407,3575856443,36
0,587,8680,3575856407,3575856443,36
0,587,8681,3575856407,3575856443,36
0,587,8682,3575856407,3575856446,39
0,587,8683,3575856407,3575856447,40
0,587,8684,3575856407,3575856447,40
0,587,8685,3575856407,3575856448,41
0,587,8686,3575856407,3575856451,44
0,587,8687,3575856407,3575856452,45
0,588,8688,3575856461,3575856461,0
0,588,8689,3575856461,3575856461,0
0,588,8690,3575856461,3575856461,0
0,588,8691,3575856461,3575856461,0
0,588,8692,3575856461,3575856467,6
0,588,8693,3575856461,3575856472,11
0,588,8694,3575856461,3575856476,15
0,588,8695,3575856461,3575856478,17
0,588,8696,3575856461,3575856479,18
0,588,8697,3575856461,3575856480,19
0,588,8698,3575856461,3575856486,25
0,588,8699,3575856461,3575856488,27
0,588,8700,3575856461,3575856489,28
0,588,8701,3575856461,3575856489,28
0,588,8702,3575856461,3575856490,29
0,588,8703,3575856461,3575856490,29
0,588,8704,3575856461,3575856490,29
0,588,8705,3575856461,3575856491,30
0,588,8706,3575856461,3575856491,30
0,588,8707,3575856461,3575856494,33
0,588,8708,3575856461,3575856494,33
0,588,8709,3575856461,3575856495,34
0,588,8710,3575856461,3575856495,34
0,588,8711,3575856461,3575856495,34
0,588,8712,3575856461,3575856497,36
0,588,8713,3575856461,3575856498,37
0,588,8714,3575856461,3575856500,39
0,588,8715,3575856461,3575856501,40
0,588,8716,3575856461,3575856503,42
0,588,8717,3575856461,3575856504,43
0,588,8718,3575856461,3575856506,45
0,588,8719,3575856461,3575856506,45
0,588,8720,3575856461,3575856506,45
0,588,8721,3575856461,3575856509,48
0,589,8722,3575856515,3575856515,0
0,589,8723,3575856515,3575856515,0
0,589,8724,3575856515,3575856516,1
0,589,8725,3575856515,3575856516,1
0,589,8726,3575856515,3575856516,1
0,589,8727,3575856515,3575856519,4
0,589,8728,3575856515,3575856519,4
0,589,8729,3575856515,3575856519,4
0,589,8730,3575856515,3575856520,5
0,589,8731,3575856515,3575856523,8
0,589,8732,3575856515,3575856523,8
0,589,8733,3575856515,3575856523,8
0,589,8734,3575856515,3575856524,9
0,589,8735,3575856515,3575856525,10
0,589,8736,3575856515,3575856526,11
0,589,8737,3575856515,3575856528,13
0,589,8738,3575856515,3575856529,14
0,589,8739,3575856515,3575856533,18
0,589,8740,3575856515,3575856534,19
0,589,8741,3575856515,3575856536,21
0,589,8742,3575856515,3575856536,21
0,589,8743,3575856515,3575856537,22
0,589,8744,3575856515,3575856538,23
0,589,8745,3575856515,3575856539,24
0,589,8746,3575856515,3575856539,24
0,589,8747,3575856515,3575856540,25
0,589,8748,3575856515,3575856542,27
0,589,8749,3575856515,3575856544,29
0,589,8750,3575856515,3575856544,29
0,589,8751,3575856515,3575856547,32
0,589,8752,3575856515,3575856547,32
0,589,8753,3575856515,3575856549,34
0,589,8754,3575856515,3575856550,35
0,589,8755,3575856515,3575856551,36
0,589,8756,3575856515,3575856553,38
0,589,8757,3575856515,3575856554,39
0,589,8758,3575856515,3575856554,39
0,589,8759,3575856515,3575856555,40
0,589,8760,3575856515,3575856557,42
0,589,8761,3575856515,3575856561,46
0,589,8762,3575856515,3575856563,48
0,589,8763,3575856515,3575856564,49
0,589,8764,3575856515,3575856565,50
0,590,8765,3575856569,3575856571,2
0,590,8766,3575856569,3575856572,3
0,590,8767,3575856569,3575856574,5
0,590,8768,3575856569,3575856575,6
0,590,8769,3575856569,3575856576,7
0,590,8770,3575856569,3575856577,8
0,590,8771,3575856569,3575856577,8
0,590,8772,3575856569,3575856578,9
0,590,8773,3575856569,3575856580,11
0,590,8774,3575856569,3575856581,12
0,590,8775,3575856569,3575856582,13
0,590,8776,3575856569,3575856586,17
0,590,8777,3575856569,3575856588,19
0,590,8778,3575856569,3575856589,20
0,590,8779,3575856569,3575856593,24
0,590,8780,3575856569,3575856593,24
0,590,8781,3575856569,3575856596,27
0,590,8782,3575856569,3575856597,28
0,590,8783,3575856569,3575856598,29
0,590,8784,3575856569,3575856599,30
0,590,8785,3575856569,3575856600,31
0,590,8786,3575856569,3575856602,33
0,590,8787,3575856569,3575856605,36
0,590,8788,3575856569,3575856605,36
0,590,8789,3575856569,3575856614,45
0,590,8790,3575856569,3575856617,48
0,591,8791,3575856624,3575856624,0
0,591,8792,3575856624,3575856624,0
0,591,8793,3575856624,3575856625,1
0,591,8794,3575856624,3575856627,3
0,591,8795,3575856624,3575856628,4
0,591,8796,3575856624,3575856629,5
0,591,8797,3575856624,3575856630,6
0,591,8798,3575856624,3575856631,7
0,591,8799,3575856624,3575856632,8
0,591,8800,3575856624,3575856632,8
0,591,8801,3575856624,3575856632,8
0,591,8802,3575856624,3575856635,11
0,591,8803,3575856624,3575856636,12
0,591,8804,3575856624,3575856640,16
0,591,8805,3575856624,3575856642,18
0,591,8806,3575856624,3575856643,19
0,591,8807,3575856624,3575856646,22
0,591,8808,3575856624,3575856646,22
0,591,8809,3575856624,3575856646,22
0,591,8810,3575856624,3575856648,24
0,591,8811,3575856624,3575856649,25
0,591,8812,3575856624,3575856651,27
0,591,8813,3575856624,3575856653,29
0,591,8814,3575856624,3575856657,33
0,591,8815,3575856624,3575856658,34
0,591,8816,3575856624,3575856660,36
0,591,8817,3575856624,3575856661,37
0,591,8818,3575856624,3575856666,42
0,591,8819,3575856624,3575856666,42
0,591,8820,3575856624,3575856671,47
0,592,8821,3575856679,3575856679,0
0,592,8822,3575856679,3575856679,0
0,592,8823,3575856679,3575856680,1
0,592,8824,3575856679,3575856681,2
0,592,8825,3575856679,3575856688,9
0,592,8826,3575856679,3575856688,9
0,592,8827,3575856679,3575856688,9
0,592,8828,3575856679,3575856689,10
0,592,8829,3575856679,3575856689,10
0,592,8830,3575856679,3575856689,10
0,592,8831,3575856679,3575856689,10
0,592,8832,3575856679,3575856690,11
0,592,8833,3575856679,3575856691,12
0,592,8834,3575856679,3575856692,13
0,592,8835,3575856679,3575856692,13
0,592,8836,3575856679,3575856692,13
0,592,8837,3575856679,3575856695,16
0,592,8838,3575856679,3575856695,16
0,592,8839,3575856679,3575856696,17
0,592,8840,3575856679,3575856696,17
0,592,8841,3575856679,3575856698,19
0,592,8842,3575856679,3575856700,21
0,592,8843,3575856679,3575856702,23
0,592,8844,3575856679,3575856703,24
0,592,8845,3575856679,3575856703,24
0,592,8846,3575856679,3575856705,26
0,592,8847,3575856679,3575856706,27
0,592,8848,3575856679,3575856707,28
0,592,8849,3575856679,3575856709,30
0,592,8850,3575856679,3575856709,30
0,592,8851,3575856679,3575856709,30
0,592,8852,3575856679,3575856712,33
0,592,8853,3575856679,3575856713,34
0,592,8854,3575856679,3575856716,37
0,592,8855,3575856679,3575856717,38
0,592,8856,3575856679,3575856717,38
0,592,8857,3575856679,3575856718,39
0,592,8858,3575856679,3575856719,40
0,592,8859,3575856679,3575856720,41
0,592,8860,3575856679,3575856720,41
0,592,8861,3575856679,3575856723,44
0,592,8862,3575856679,3575856723,44
0,592,8863,3575856679,3575856724,45
0,592,8864,3575856679,3575856725,46
0,592,8865,3575856679,3575856725,46
0,592,8866,3575856679,3575856725,46
0,592,8867,3575856679,3575856725,46
0,592,8868,3575856679,3575856725,46
0,592,8869,3575856679,3575856727,48
0,592,8870,3575856679,3575856728,49
0,593,8871,3575856733,3575856733,0
0,593,8872,3575856733,3575856734,1
0,593,8873,3575856733,3575856734,1
0,593,8874,3575856733,3575856735,2
0,593,8875,3575856733,3575856736,3
0,593,8876,3575856733,3575856736,3
0,593,8877,3575856733,3575856738,5
0,593,8878,3575856733,3575856738,5
0,593,8879,3575856733,3575856738,5
0,593,8880,3575856733,3575856738,5
0,593,8881,3575856733,3575856740,7
0,593,8882,3575856733,3575856743,10
0,593,8883,3575856733,3575856744,11
0,593,8884,3575856733,3575856744,11
0,593,8885,3575856733,3575856747,14
0,593,8886,3575856733,3575856747,14
0,593,8887,3575856733,3575856751,18
0,593,8888,3575856733,3575856751,18
0,593,8889,3575856733,3575856752,19
0,593,8890,3575856733,3575856753,20
0,593,8891,3575856733,3575856754,21
0,593,8892,3575856733,3575856755,22
0,593,8893,3575856733,3575856756,23
0,593,8894,3575856733,3575856756,23
0,593,8895,3575856733,3575856758,25
0,593,8896,3575856733,3575856761,28
0,593,8897,3575856733,3575856762,29
0,593,8898,3575856733,3575856763,30
0,593,8899,3575856733,3575856764,31
0,593,8900,3575856733,3575856765,32
0,593,8901,3575856733,3575856771,38
0,593,8902,3575856733,3575856771,38
0,593,8903,3575856733,3575856772,39
0,593,8904,3575856733,3575856773,40
0,593,8905,3575856733,3575856774,41
0,593,8906,3575856733,3575856776,43
0,593,8907,3575856733,3575856776,43
0,593,8908,3575856733,3575856777,44
0,593,8909,3575856733,3575856779,46
0,593,8910,3575856733,3575856780,47
0,593,8911,3575856733,3575856782,49
0,594,8912,3575856788,3575856788,0
0,594,8913,3575856788,3575856788,0
0,594,8914,3575856788,3575856789,1
0,594,8915,3575856788,3575856793,5
0,594,8916,3575856788,3575856795,7
0,594,8917,3575856788,3575856797,9
0,594,8918,3575856788,3575856798,10
0,594,8919,3575856788,3575856799,11
0,594,8920,3575856788,3575856800,12
0,594,8921,3575856788,3575856801,13
0,594,8922,3575856788,3575856804,16
0,594,8923,3575856788,3575856805,17
0,594,8924,3575856788,3575856811,23
0,594,8925,3575856788,3575856815,27
0,594,8926,3575856788,3575856817,29
0,594,8927,3575856788,3575856823,35
0,594,8928,3575856788,3575856824,36
0,594,8929,3575856788,3575856826,38
0,594,8930,3575856788,3575856827,39
0,594,8931,3575856788,3575856828,40
0,594,8932,3575856788,3575856829,41
0,594,8933,3575856788,3575856830,42
0,594,8934,3575856788,3575856832,44
0,594,8935,3575856788,3575856832,44
0,594,8936,3575856788,3575856832,44
0,594,8937,3575856788,3575856833,45
0,594,8938,3575856788,3575856835,47
0,594,8939,3575856788,3575856836,48
0,595,8940,3575856842,3575856842,0
0,595,8941,3575856842,3575856842,0
0,595,8942,3575856842,3575856843,1
0,595,8943,3575856842,3575856843,1
0,595,8944,3575856842,3575856845,3
0,595,8945,3575856842,3575856846,4
0,595,8946,3575856842,3575856848,6
0,595,8947,3575856842,3575856849,7
0,595,8948,3575856842,3575856852,10
0,595,8949,3575856842,3575856857,15
0,595,8950,3575856842,3575856858,16
0,595,8951,3575856842,3575856860,18
0,595,8952,3575856842,3575856861,19
0,595,8953,3575856842,3575856862,20
0,595,8954,3575856842,3575856866,24
0,595,8955,3575856842,3575856866,24
0,595,8956,3575856842,3575856871,29
0,595,8957,3575856842,3575856876,34
0,595,8958,3575856842,3575856879,37
0,595,8959,3575856842,3575856880,38
0,595,8960,3575856842,3575856881,39
0,595,8961,3575856842,3575856888,46
0,595,8962,3575856842,3575856888,46
0,595,8963,3575856842,3575856889,47
0,595,8964,3575856842,3575856889,47
0,595,8965,3575856842,3575856889,47
0,595,8966,3575856842,3575856890,48
0,595,8967,3575856842,3575856890,48
0,595,8968,3575856842,3575856892,50
0,596,8969,3575856896,3575856896,0
0,596,8970,3575856896,3575856896,0
0,596,8971,3575856896,3575856896,0
0,596,8972,3575856896,3575856896,0
0,596,8973,3575856896,3575856896,0
0,596,8974,3575856896,3575856896,0
0,596,8975,3575856896,3575856896,0
0,596,8976,3575856896,3575856898,2
0,596,8977,3575856896,3575856900,4
0,596,8978,3575856896,3575856902,6
0,596,8979,3575856896,3575856903,7
0,596,8980,3575856896,3575856905,9
0,596,8981,3575856896,3575856906,10
0,596,8982,3575856896,3575856907,11
0,596,8983,3575856896,3575856909,13
0,596,8984,3575856896,3575856909,13
0,596,8985,3575856896,3575856911,15
0,596,8986,3575856896,3575856913,17
0,596,8987,3575856896,3575856913,17
0,596,8988,3575856896,3575856916,20
0,596,8989,3575856896,3575856917,21
0,596,8990,3575856896,3575856917,21
0,596,8991,3575856896,3575856918,22
0,596,8992,3575856896,3575856919,23
0,596,8993,3575856896,3575856919,23
0,596,8994,3575856896,3575856920,24
0,596,8995,3575856896,3575856920,24
0,596,8996,3575856896,3575856923,27
0,596,8997,3575856896,3575856923,27
0,596,8998,3575856896,3575856924,28
0,596,8999,3575856896,3575856924,28
0,596,9000,3575856896,3575856925,29
0,596,9001,3575856896,3575856925,29
0,596,9002,3575856896,3575856926,30
0,596,9003,3575856896,3575856926,30
0,596,9004,3575856896,3575856928,32
0,596,9005,3575856896,3575856930,34
0,596,9006,3575856896,3575856932,36
0,596,9007,3575856896,3575856934,38
0,596,9008,3575856896,3575856934,38
0,596,9009,3575856896,3575856936,40
0,596,9010,3575856896,3575856936,40
0,596,9011,3575856896,3575856936,40
0,596,9012,3575856896,3575856937,41
0,596,9013,3575856896,3575856938,42
0,596,9014,3575856896,3575856938,42
0,596,9015,3575856896,3575856938,42
0,596,9016,3575856896,3575856939,43
0,596,9017,3575856896,3575856940,44
0,596,9018,3575856896,3575856944,48
0,596,9019,3575856896,3575856944,48
0,596,9020,3575856896,3575856945,49
0,597,9021,3575856950,3575856950,0
0,597,9022,3575856950,3575856950,0
0,597,9023,3575856950,3575856950,0
0,597,9024,3575856950,3575856951,1
0,597,9025,3575856950,3575856952,2
0,597,9026,3575856950,3575856953,3
0,597,9027,3575856950,3575856953,3
0,597,9028,3575856950,3575856954,4
0,597,9029,3575856950,3575856955,5
0,597,9030,3575856950,3575856956,6
0,597,9031,3575856950,3575856958,8
0,597,9032,3575856950,3575856958,8
0,597,9033,3575856950,3575856959,9
0,597,9034,3575856950,3575856961,11
0,597,9035,3575856950,3575856963,13
0,597,9036,3575856950,3575856964,14
0,597,9037,3575856950,3575856964,14
0,597,9038,3575856950,3575856965,15
0,597,9039,3575856950,3575856971,21
0,597,9040,3575856950,3575856971,21
0,597,9041,3575856950,3575856971,21
0,597,9042,3575856950,3575856973,23
0,597,9043,3575856950,3575856974,24
0,597,9044,3575856950,3575856976,26
0,597,9045,3575856950,3575856976,26
0,597,9046,3575856950,3575856977,27
0,597,9047,3575856950,3575856979,29
0,597,9048,3575856950,3575856980,30
0,597,9049,3575856950,3575856981,31
0,597,9050,3575856950,3575856982,32
0,597,9051,3575856950,3575856987,37
0,597,9052,3575856950,3575856988,38
0,597,9053,3575856950,3575856988,38
0,597,9054,3575856950,3575856995,45
0,597,9055,3575856950,3575856995,45
0,597,9056,3575856950,3575856997,47
0,597,9057,3575856950,3575856998,48
0,597,9058,3575856950,3575856998,48
0,597,9059,3575856950,3575856999,49
0,597,9060,3575856950,3575857000,50
0,598,9061,3575857004,3575857005,1
0,598,9062,3575857004,3575857006,2
0,598,9063,3575857004,3575857014,10
0,598,9064,3575857004,3575857015,11
0,598,9065,3575857004,3575857017,13
0,598,9066,3575857004,3575857022,18
0,598,9067,3575857004,3575857024,20
0,598,9068,3575857004,3575857025,21
0,598,9069,3575857004,3575857026,22
0,598,9070,3575857004,3575857029,25
0,598,9071,3575857004,3575857029,25
0,598,9072,3575857004,3575857029,25
0,598,9073,3575857004,3575857032,28
0,598,9074,3575857004,3575857032,28
0,598,9075,3575857004,3575857033,29
0,598,9076,3575857004,3575857033,29
0,598,9077,3575857004,3575857035,31
0,598,9078,3575857004,3575857036,32
0,598,9079,3575857004,3575857039,35
0,598,9080,3575857004,3575857042,38
0,598,9081,3575857004,3575857042,38
0,598,9082,3575857004,3575857043,39
0,598,9083,3575857004,3575857046,42
0,598,9084,3575857004,3575857046,42
0,598,9085,3575857004,3575857048,44
0,598,9086,3575857004,3575857049,45
0,598,9087,3575857004,3575857053,49
0,599,9088,3575857058,3575857058,0
0,599,9089,3575857058,3575857058,0
0,599,9090,3575857058,3575857060,2
0,599,9091,3575857058,3575857062,4
0,599,9092,3575857058,3575857062,4
0,599,9093,3575857058,3575857065,7
0,599,9094,3575857058,3575857067,9
0,599,9095,3575857058,3575857068,10
0,599,9096,3575857058,3575857072,14
0,599,9097,3575857058,3575857076,18
0,599,9098,3575857058,3575857079,21
0,599,9099,3575857058,3575857080,22
0,599,9100,3575857058,3575857080,22
0,599,9101,3575857058,3575857087,29
0,599,9102,3575857058,3575857088,30
0,599,9103,3575857058,3575857088,30
0,599,9104,3575857058,3575857089,31
0,599,9105,3575857058,3575857089,31
0,599,9106,3575857058,3575857090,32
0,599,9107,3575857058,3575857090,32
0,599,9108,3575857058,3575857092,34
0,599,9109,3575857058,3575857092,34
0,599,9110,3575857058,3575857092,34
0,599,9111,3575857058,3575857094,36
0,599,9112,3575857058,3575857095,37
0,599,9113,3575857058,3575857095,37
0,599,9114,3575857058,3575857096,38
0,599,9115,3575857058,3575857097,39
0,599,9116,3575857058,3575857098,40
0,599,9117,3575857058,3575857100,42
0,599,9118,3575857058,3575857103,45
0,599,9119,3575857058,3575857104,46
0,599,9120,3575857058,3575857106,48
0,599,9121,3575857058,3575857107,49
0,599,9122,3575857058,3575857107,49
0,600,9123,3575857113,3575857113,0
0,600,9124,3575857113,3575857113,0
0,600,9125,3575857113,3575857113,0
0,600,9126,3575857113,3575857113,0
0,600,9127,3575857113,3575857116,3
0,600,9128,3575857113,3575857116,3
0,600,9129,3575857113,3575857117,4
0,600,9130,3575857113,3575857117,4
0,600,9131,3575857113,3575857118,5
0,600,9132,3575857113,3575857119,6
0,600,9133,3575857113,3575857120,7
0,600,9134,3575857113,3575857120,7
0,600,9135,3575857113,3575857122,9
0,600,9136,3575857113,3575857123,10
0,600,9137,3575857113,3575857124,11
0,600,9138,3575857113,3575857124,11
0,600,9139,3575857113,3575857125,12
0,600,9140,3575857113,3575857125,12
0,600,9141,3575857113,3575857126,13
0,600,9142,3575857113,3575857126,13
0,600,9143,3575857113,3575857127,14
0,600,9144,3575857113,3575857130,17
0,600,9145,3575857113,3575857133,20
0,600,9146,3575857113,3575857134,21
0,600,9147,3575857113,3575857134,21
0,600,9148,3575857113,3575857135,22
0,600,9149,3575857113,3575857135,22
0,600,9150,3575857113,3575857136,23
0,600,9151,3575857113,3575857137,24
0,600,9152,3575857113,3575857138,25
0,600,9153,3575857113,3575857138,25
0,600,9154,3575857113,3575857138,25
0,600,9155,3575857113,3575857138,25
0,600,9156,3575857113,3575857141,28
0,600,9157,3575857113,3575857143,30
0,600,9158,3575857113,3575857144,31
0,600,9159,3575857113,3575857145,32
0,600,9160,3575857113,3575857146,33
0,600,9161,3575857113,3575857150,37
0,600,9162,3575857113,3575857150,37
0,600,9163,3575857113,3575857151,38
0,600,9164,3575857113,3575857151,38
0,600,9165,3575857113,3575857152,39
0,600,9166,3575857113,3575857154,41
0,600,9167,3575857113,3575857154,41
0,600,9168,3575857113,3575857155,42
0,600,9169,3575857113,3575857156,43
0,600,9170,3575857113,3575857158,45
0,600,9171,3575857113,3575857158,45
0,600,9172,3575857113,3575857158,45
0,600,9173,3575857113,3575857161,48
0,601,9174,3575857168,3575857168,0
0,601,9175,3575857168,3575857168,0
0,601,9176,3575857168,3575857168,0
0,601,9177,3575857168,3575857168,0
0,601,9178,3575857168,3575857168,0
0,601,9179,3575857168,3575857171,3
0,601,9180,3575857168,3575857172,4
0,601,9181,3575857168,3575857172,4
0,601,9182,3575857168,3575857173,5
0,601,9183,3575857168,3575857174,6
0,601,9184,3575857168,3575857176,8
0,601,9185,3575857168,3575857176,8
0,601,9186,3575857168,3575857178,10
0,601,9187,3575857168,3575857179,11
0,601,9188,3575857168,3575857180,12
0,601,9189,3575857168,3575857181,13
0,601,9190,3575857168,3575857183,15
0,601,9191,3575857168,3575857187,19
0,601,9192,3575857168,3575857188,20
0,601,9193,3575857168,3575857188,20
0,601,9194,3575857168,3575857195,27
0,601,9195,3575857168,3575857195,27
0,601,9196,3575857168,3575857198,30
0,601,9197,3575857168,3575857199,31
0,601,9198,3575857168,3575857199,31
0,601,9199,3575857168,3575857199,31
0,601,9200,3575857168,3575857200,32
0,601,9201,3575857168,3575857205,37
0,601,9202,3575857168,3575857206,38
0,601,9203,3575857168,3575857215,47
0,601,9204,3575857168,3575857215,47
0,601,9205,3575857168,3575857217,49
0,601,9206,3575857168,3575857218,50
0,602,9207,3575857223,3575857223,0
0,602,9208,3575857223,3575857225,2
0,602,9209,3575857223,3575857225,2
0,602,9210,3575857223,3575857226,3
0,602,9211,3575857223,3575857229,6
0,602,9212,3575857223,3575857230,7
0,602,9213,3575857223,3575857230,7
0,602,9214,3575857223,3575857231,8
0,602,9215,3575857223,3575857232,9
0,602,9216,3575857223,3575857232,9
0,602,9217,3575857223,3575857234,11
0,602,9218,3575857223,3575857236,13
0,602,9219,3575857223,3575857239,16
0,602,9220,3575857223,3575857242,19
0,602,9221,3575857223,3575857242,19
0,602,9222,3575857223,3575857244,21
0,602,9223,3575857223,3575857246,23
0,602,9224,3575857223,3575857246,23
0,602,9225,3575857223,3575857248,25
0,602,9226,3575857223,3575857249,26
0,602,9227,3575857223,3575857253,30
0,602,9228,3575857223,3575857257,34
0,602,9229,3575857223,3575857258,35
0,602,9230,3575857223,3575857259,36
0,602,9231,3575857223,3575857262,39
0,602,9232,3575857223,3575857262,39
0,602,9233,3575857223,3575857266,43
0,602,9234,3575857223,3575857266,43
0,602,9235,3575857223,3575857268,45
0,602,9236,3575857223,3575857269,46
0,602,9237,3575857223,3575857271,48
0,603,9238,3575857278,3575857278,0
0,603,9239,3575857278,3575857279,1
0,603,9240,3575857278,3575857280,2
0,603,9241,3575857278,3575857280,2
0,603,9242,3575857278,3575857286,8
0,603,9243,3575857278,3575857288,10
0,603,9244,3575857278,3575857288,10
0,603,9245,3575857278,3575857289,11
0,603,9246,3575857278,3575857289,11
0,603,9247,3575857278,3575857289,11
0,603,9248,3575857278,3575857290,12
0,603,9249,3575857278,3575857292,14
0,603,9250,3575857278,3575857292,14
0,603,9251,3575857278,3575857292,14
0,603,9252,3575857278,3575857294,16
0,603,9253,3575857278,3575857295,17
0,603,9254,3575857278,3575857295,17
0,603,9255,3575857278,3575857296,18
0,603,9256,3575857278,3575857298,20
0,603,9257,3575857278,3575857298,20
0,603,9258,3575857278,3575857300,22
0,603,9259,3575857278,3575857303,25
0,603,9260,3575857278,3575857304,26
0,603,9261,3575857278,3575857306,28
0,603,9262,3575857278,3575857306,28
0,603,9263,3575857278,3575857307,29
0,603,9264,3575857278,3575857308,30
0,603,9265,3575857278,3575857309,31
0,603,9266,3575857278,3575857312,34
0,603,9267,3575857278,3575857313,35
0,603,9268,3575857278,3575857316,38
0,603,9269,3575857278,3575857317,39
0,603,9270,3575857278,3575857317,39
0,603,9271,3575857278,3575857318,40
0,603,9272,3575857278,3575857319,41
0,603,9273,3575857278,3575857319,41
0,603,9274,3575857278,3575857320,42
0,603,9275,3575857278,3575857320,42
0,603,9276,3575857278,3575857322,44
0,603,9277,3575857278,3575857323,45
0,603,9278,3575857278,3575857323,45
0,603,9279,3575857278,3575857325,47
0,603,9280,3575857278,3575857325,47
0,603,9281,3575857278,3575857325,47
0,603,9282,3575857278,3575857326,48
0,603,9283,3575857278,3575857326,48
0,603,9284,3575857278,3575857326,48
0,603,9285,3575857278,3575857327,49
0,604,9286,3575857333,3575857333,0
0,604,9287,3575857333,3575857333,0
0,604,9288,3575857333,3575857334,1
0,604,9289,3575857333,3575857335,2
0,604,9290,3575857333,3575857336,3
0,604,9291,3575857333,3575857336,3
0,604,9292,3575857333,3575857337,4
0,604,9293,3575857333,3575857338,5
0,604,9294,3575857333,3575857338,5
0,604,9295,3575857333,3575857339,6
0,604,9296,3575857333,3575857339,6
0,604,9297,3575857333,3575857339,6
0,604,9298,3575857333,3575857341,8
0,604,9299,3575857333,3575857343,10
0,604,9300,3575857333,3575857344,11
0,604,9301,3575857333,3575857345,12
0,604,9302,3575857333,3575857347,14
0,604,9303,3575857333,3575857349,16
0,604,9304,3575857333,3575857350,17
0,604,9305,3575857333,3575857352,19
0,604,9306,3575857333,3575857352,19
0,604,9307,3575857333,3575857354,21
0,604,9308,3575857333,3575857355,22
0,604,9309,3575857333,3575857355,22
0,604,9310,3575857333,3575857356,23
0,604,9311,3575857333,3575857358,25
0,604,9312,3575857333,3575857358,25
0,604,9313,3575857333,3575857359,26
0,604,9314,3575857333,3575857362,29
0,604,9315,3575857333,3575857363,30
0,604,9316,3575857333,3575857364,31
0,604,9317,3575857333,3575857365,32
0,604,9318,3575857333,3575857366,33
0,604,9319,3575857333,3575857367,34
0,604,9320,3575857333,3575857371,38
0,604,9321,3575857333,3575857372,39
0,604,9322,3575857333,3575857372,39
0,604,9323,3575857333,3575857372,39
0,604,9324,3575857333,3575857373,40
0,604,9325,3575857333,3575857374,41
0,604,9326,3575857333,3575857377,44
0,604,9327,3575857333,3575857378,45
0,604,9328,3575857333,3575857379,46
0,604,9329,3575857333,3575857380,47
0,604,9330,3575857333,3575857382,49
0,604,9331,3575857333,3575857383,50
0,605,9332,3575857388,3575857388,0
0,605,9333,3575857388,3575857388,0
0,605,9334,3575857388,3575857388,0
0,605,9335,3575857388,3575857394,6
0,605,9336,3575857388,3575857395,7
0,605,9337,3575857388,3575857397,9
0,605,9338,3575857388,3575857399,11
0,605,9339,3575857388,3575857399,11
0,605,9340,3575857388,3575857399,11
0,605,9341,3575857388,3575857400,12
0,605,9342,3575857388,3575857406,18
0,605,9343,3575857388,3575857406,18
0,605,9344,3575857388,3575857406,18
0,605,9345,3575857388,3575857414,26
0,605,9346,3575857388,3575857415,27
0,605,9347,3575857388,3575857417,29
0,605,9348,3575857388,3575857418,30
0,605,9349,3575857388,3575857423,35
0,605,9350,3575857388,3575857424,36
0,605,9351,3575857388,3575857424,36
0,605,9352,3575857388,3575857425,37
0,605,9353,3575857388,3575857427,39
0,605,9354,3575857388,3575857428,40
0,605,9355,3575857388,3575857430,42
0,605,9356,3575857388,3575857431,43
0,605,9357,3575857388,3575857432,44
0,605,9358,3575857388,3575857432,44
0,605,9359,3575857388,3575857433,45
0,605,9360,3575857388,3575857435,47
0,605,9361,3575857388,3575857437,49
0,606,9362,3575857445,3575857445,0
0,606,9363,3575857445,3575857445,0
0,606,9364,3575857445,3575857445,0
0,606,9365,3575857445,3575857446,1
0,606,9366,3575857445,3575857448,3
0,606,9367,3575857445,3575857449,4
0,606,9368,3575857445,3575857454,9
0,606,9369,3575857445,3575857457,12
0,606,9370,3575857445,3575857458,13
0,606,9371,3575857445,3575857460,15
0,606,9372,3575857445,3575857462,17
0,606,9373,3575857445,3575857462,17
0,606,9374,3575857445,3575857465,20
0,606,9375,3575857445,3575857467,22
0,606,9376,3575857445,3575857468,23
0,606,9377,3575857445,3575857471,26
0,606,9378,3575857445,3575857473,28
0,606,9379,3575857445,3575857476,31
0,606,9380,3575857445,3575857480,35
0,606,9381,3575857445,3575857481,36
0,606,9382,3575857445,3575857487,42
0,606,9383,3575857445,3575857488,43
0,606,9384,3575857445,3575857488,43
0,606,9385,3575857445,3575857489,44
0,606,9386,3575857445,3575857490,45
0,606,9387,3575857445,3575857490,45
0,606,9388,3575857445,3575857490,45
0,606,9389,3575857445,3575857490,45
0,606,9390,3575857445,3575857491,46
0,606,9391,3575857445,3575857492,47
0,606,9392,3575857445,3575857492,47
0,606,9393,3575857445,3575857494,49
0,606,9394,3575857445,3575857494,49
0,606,9395,3575857445,3575857495,50
0,607,9396,3575857499,3575857499,0
0,607,9397,3575857499,3575857499,0
0,607,9398,3575857499,3575857499,0
0,607,9399,3575857499,3575857499,0
0,607,9400,3575857499,3575857500,1
0,607,9401,3575857499,3575857502,3
0,607,9402,3575857499,3575857503,4
0,607,9403,3575857499,3575857505,6
0,607,9404,3575857499,3575857505,6
0,607,9405,3575857499,3575857506,7
0,607,9406,3575857499,3575857508,9
0,607,9407,3575857499,3575857512,13
0,607,9408,3575857499,3575857515,16
0,607,9409,3575857499,3575857515,16
0,607,9410,3575857499,3575857517,18
0,607,9411,3575857499,3575857517,18
0,607,9412,3575857499,3575857518,19
0,607,9413,3575857499,3575857518,19
0,607,9414,3575857499,3575857519,20
0,607,9415,3575857499,3575857520,21
0,607,9416,3575857499,3575857522,23
0,607,9417,3575857499,3575857522,23
0,607,9418,3575857499,3575857524,25
0,607,9419,3575857499,3575857524,25
0,607,9420,3575857499,3575857524,25
0,607,9421,3575857499,3575857524,25
0,607,9422,3575857499,3575857525,26
0,607,9423,3575857499,3575857525,26
0,607,9424,3575857499,3575857525,26
0,607,9425,3575857499,3575857527,28
0,607,9426,3575857499,3575857529,30
0,607,9427,3575857499,3575857532,33
0,607,9428,3575857499,3575857533,34
0,607,9429,3575857499,3575857533,34
0,607,9430,3575857499,3575857535,36
0,607,9431,3575857499,3575857536,37
0,607,9432,3575857499,3575857536,37
0,607,9433,3575857499,3575857537,38
0,607,9434,3575857499,3575857537,38
0,607,9435,3575857499,3575857537,38
0,607,9436,3575857499,3575857538,39
0,607,9437,3575857499,3575857538,39
0,607,9438,3575857499,3575857540,41
0,607,9439,3575857499,3575857543,44
0,607,9440,3575857499,3575857543,44
0,607,9441,3575857499,3575857544,45
0,607,9442,3575857499,3575857547,48
0,608,9443,3575857553,3575857553,0
0,608,9444,3575857553,3575857553,0
0,608,9445,3575857553,3575857553,0
0,608,9446,3575857553,3575857553,0
0,608,9447,3575857553,3575857553,0
0,608,9448,3575857553,3575857554,1
0,608,9449,3575857553,3575857554,1
0,608,9450,3575857553,3575857555,2
0,608,9451,3575857553,3575857556,3
0,608,9452,3575857553,3575857557,4
0,608,9453,3575857553,3575857558,5
0,608,9454,3575857553,3575857561,8
0,608,9455,3575857553,3575857563,10
0,608,9456,3575857553,3575857563,10
0,608,9457,3575857553,3575857564,11
0,608,9458,3575857553,3575857565,12
0,608,9459,3575857553,3575857566,13
0,608,9460,3575857553,3575857570,17
0,608,9461,3575857553,3575857571,18
0,608,9462,3575857553,3575857571,18
0,608,9463,3575857553,3575857572,19
0,608,9464,3575857553,3575857574,21
0,608,9465,3575857553,3575857575,22
0,608,9466,3575857553,3575857576,23
0,608,9467,3575857553,3575857576,23
0,608,9468,3575857553,3575857577,24
0,608,9469,3575857553,3575857578,25
0,608,9470,3575857553,3575857579,26
0,608,9471,3575857553,3575857582,29
0,608,9472,3575857553,3575857586,33
0,608,9473,3575857553,3575857587,34
0,608,9474,3575857553,3575857589,36
0,608,9475,3575857553,3575857593,40
0,608,9476,3575857553,3575857594,41
0,608,9477,3575857553,3575857597,44
0,608,9478,3575857553,3575857597,44
0,608,9479,3575857553,3575857598,45
0,608,9480,3575857553,3575857600,47
0,608,9481,3575857553,3575857601,48
0,609,9482,3575857608,3575857608,0
0,609,9483,3575857608,3575857608,0
0,609,9484,3575857608,3575857608,0
0,609,9485,3575857608,3575857613,5
0,609,9486,3575857608,3575857614,6
0,609,9487,3575857608,3575857617,9
0,609,9488,3575857608,3575857617,9
0,609,9489,3575857608,3575857622,14
0,609,9490,3575857608,3575857624,16
0,609,9491,3575857608,3575857625,17
0,609,9492,3575857608,3575857626,18
0,609,9493,3575857608,3575857627,19
0,609,9494,3575857608,3575857629,21
0,609,9495,3575857608,3575857629,21
0,609,9496,3575857608,3575857630,22
0,609,9497,3575857608,3575857631,23
0,609,9498,3575857608,3575857632,24
0,609,9499,3575857608,3575857632,24
0,609,9500,3575857608,3575857633,25
0,609,9501,3575857608,3575857636,28
0,609,9502,3575857608,3575857637,29
0,609,9503,3575857608,3575857639,31
0,609,9504,3575857608,3575857641,33
0,609,9505,3575857608,3575857641,33
0,609,9506,3575857608,3575857643,35
0,609,9507,3575857608,3575857645,37
0,609,9508,3575857608,3575857647,39
0,609,9509,3575857608,3575857648,40
0,609,9510,3575857608,3575857653,45
0,609,9511,3575857608,3575857656,48
0,609,9512,3575857608,3575857657,49
0,610,9513,3575857663,3575857663,0
0,610,9514,3575857663,3575857663,0
0,610,9515,3575857663,3575857663,0
0,610,9516,3575857663,3575857664,1
0,610,9517,3575857663,3575857666,3
0,610,9518,3575857663,3575857667,4
0,610,9519,3575857663,3575857670,7
0,610,9520,3575857663,3575857676,13
0,610,9521,3575857663,3575857677,14
0,610,9522,3575857663,3575857680,17
0,610,9523,3575857663,3575857680,17
0,610,9524,3575857663,3575857687,24
0,610,9525,3575857663,3575857688,25
0,610,9526,3575857663,3575857689,26
0,610,9527,3575857663,3575857689,26
0,610,9528,3575857663,3575857690,27
0,610,9529,3575857663,3575857690,27
0,610,9530,3575857663,3575857690,27
0,610,9531,3575857663,3575857690,27
0,610,9532,3575857663,3575857691,28
0,610,9533,3575857663,3575857692,29
0,610,9534,3575857663,3575857692,29
0,610,9535,3575857663,3575857695,32
0,610,9536,3575857663,3575857695,32
0,610,9537,3575857663,3575857695,32
0,610,9538,3575857663,3575857697,34
0,610,9539,3575857663,3575857697,34
0,610,9540,3575857663,3575857699,36
0,610,9541,3575857663,3575857700,37
0,610,9542,3575857663,3575857702,39
0,610,9543,3575857663,3575857703,40
0,610,9544,3575857663,3575857705,42
0,610,9545,3575857663,3575857706,43
0,610,9546,3575857663,3575857707,44
0,610,9547,3575857663,3575857708,45
0,610,9548,3575857663,3575857711,48
0,610,9549,3575857663,3575857712,49
0,611,9550,3575857718,3575857718,0
0,611,9551,3575857718,3575857718,0
0,611,9552,3575857718,3575857718,0
0,611,9553,3575857718,3575857718,0
0,611,9554,3575857718,3575857718,0
0,611,9555,3575857718,3575857718,0
0,611,9556,3575857718,3575857719,1
0,611,9557,3575857718,3575857721,3
0,611,9558,3575857718,3575857722,4
0,611,9559,3575857718,3575857722,4
0,611,9560,3575857718,3575857724,6
0,611,9561,3575857718,3575857724,6
0,611,9562,3575857718,3575857725,7
0,611,9563,3575857718,3575857725,7
0,611,9564,3575857718,3575857725,7
0,611,9565,3575857718,3575857725,7
0,611,9566,3575857718,3575857726,8
0,611,9567,3575857718,3575857727,9
0,611,9568,3575857718,3575857727,9
0,611,9569,3575857718,3575857729,11
0,611,9570,3575857718,3575857733,15
0,611,9571,3575857718,3575857734,16
0,611,9572,3575857718,3575857734,16
0,611,9573,3575857718,3575857735,17
0,611,9574,3575857718,3575857735,17
0,611,9575,3575857718,3575857736,18
0,611,9576,3575857718,3575857737,19
0,611,9577,3575857718,3575857738,20
0,611,9578,3575857718,3575857738,20
0,611,9579,3575857718,3575857739,21
0,611,9580,3575857718,3575857740,22
0,611,9581,3575857718,3575857742,24
0,611,9582,3575857718,3575857744,26
0,611,9583,3575857718,3575857744,26
0,611,9584,3575857718,3575857747,29
0,611,9585,3575857718,3575857749,31
0,611,9586,3575857718,3575857749,31
0,611,9587,3575857718,3575857749,31
0,611,9588,3575857718,3575857752,34
0,611,9589,3575857718,3575857752,34
0,611,9590,3575857718,3575857753,35
0,611,9591,3575857718,3575857754,36
0,611,9592,3575857718,3575857754,36
0,611,9593,3575857718,3575857755,37
0,611,9594,3575857718,3575857758,40
0,611,9595,3575857718,3575857759,41
0,611,9596,3575857718,3575857759,41
0,611,9597,3575857718,3575857761,43
0,611,9598,3575857718,3575857763,45
0,611,9599,3575857718,3575857763,45
0,611,9600,3575857718,3575857764,46
0,611,9601,3575857718,3575857766,48
0,612,9602,3575857775,3575857775,0
0,612,9603,3575857775,3575857775,0
0,612,9604,3575857775,3575857775,0
0,612,9605,3575857775,3575857775,0
0,612,9606,3575857775,3575857775,0
0,612,9607,3575857775,3575857775,0
0,612,9608,3575857775,3575857776,1
0,612,9609,3575857775,3575857777,2
0,612,9610,3575857775,3575857777,2
0,612,9611,3575857775,3575857778,3
0,612,9612,3575857775,3575857778,3
0,612,9613,3575857775,3575857780,5
0,612,9614,3575857775,3575857782,7
0,612,9615,3575857775,3575857782,7
0,612,9616,3575857775,3575857786,11
0,612,9617,3575857775,3575857786,11
0,612,9618,3575857775,3575857790,15
0,612,9619,3575857775,3575857794,19
0,612,9620,3575857775,3575857794,19
0,612,9621,3575857775,3575857797,22
0,612,9622,3575857775,3575857798,23
0,612,9623,3575857775,3575857799,24
0,612,9624,3575857775,3575857800,25
0,612,9625,3575857775,3575857801,26
0,612,9626,3575857775,3575857805,30
0,612,9627,3575857775,3575857805,30
0,612,9628,3575857775,3575857806,31
0,612,9629,3575857775,3575857813,38
0,612,9630,3575857775,3575857814,39
0,612,9631,3575857775,3575857816,41
0,612,9632,3575857775,3575857817,42
0,612,9633,3575857775,3575857822,47
0,612,9634,3575857775,3575857824,49
0,613,9635,3575857830,3575857830,0
0,613,9636,3575857830,3575857830,0
0,613,9637,3575857830,3575857830,0
0,613,9638,3575857830,3575857830,0
0,613,9639,3575857830,3575857830,0
0,613,9640,3575857830,3575857830,0
0,613,9641,3575857830,3575857832,2
0,613,9642,3575857830,3575857832,2
0,613,9643,3575857830,3575857833,3
0,613,9644,3575857830,3575857834,4
0,613,9645,3575857830,3575857836,6
0,613,9646,3575857830,3575857837,7
0,613,9647,3575857830,3575857840,10
0,613,9648,3575857830,3575857841,11
0,613,9649,3575857830,3575857842,12
0,613,9650,3575857830,3575857844,14
0,613,9651,3575857830,3575857845,15
0,613,9652,3575857830,3575857845,15
0,613,9653,3575857830,3575857847,17
0,613,9654,3575857830,3575857848,18
0,613,9655,3575857830,3575857854,24
0,613,9656,3575857830,3575857857,27
0,613,9657,3575857830,3575857857,27
0,613,9658,3575857830,3575857859,29
0,613,9659,3575857830,3575857861,31
0,613,9660,3575857830,3575857861,31
0,613,9661,3575857830,3575857864,34
0,613,9662,3575857830,3575857866,36
0,613,9663,3575857830,3575857867,37
0,613,9664,3575857830,3575857870,40
0,613,9665,3575857830,3575857877,47
0,613,9666,3575857830,3575857877,47
0,613,9667,3575857830,3575857879,49
0,613,9668,3575857830,3575857880,50
0,614,9669,3575857885,3575857885,0
0,614,9670,3575857885,3575857885,0
0,614,9671,3575857885,3575857887,2
0,614,9672,3575857885,3575857888,3
0,614,9673,3575857885,3575857889,4
0,614,9674,3575857885,3575857889,4
0,614,9675,3575857885,3575857889,4
0,614,9676,3575857885,3575857890,5
0,614,9677,3575857885,3575857890,5
0,614,9678,3575857885,3575857890,5
0,614,9679,3575857885,3575857892,7
0,614,9680,3575857885,3575857892,7
0,614,9681,3575857885,3575857892,7
0,614,9682,3575857885,3575857894,9
0,614,9683,3575857885,3575857895,10
0,614,9684,3575857885,3575857895,10
0,614,9685,3575857885,3575857898,13
0,614,9686,3575857885,3575857898,13
0,614,9687,3575857885,3575857899,14
0,614,9688,3575857885,3575857900,15
0,614,9689,3575857885,3575857901,16
0,614,9690,3575857885,3575857902,17
0,614,9691,3575857885,3575857902,17
0,614,9692,3575857885,3575857905,20
0,614,9693,3575857885,3575857905,20
0,614,9694,3575857885,3575857907,22
0,614,9695,3575857885,3575857909,24
0,614,9696,3575857885,3575857911,26
0,614,9697,3575857885,3575857912,27
0,614,9698,3575857885,3575857915,30
0,614,9699,3575857885,3575857917,32
0,614,9700,3575857885,3575857918,33
0,614,9701,3575857885,3575857918,33
0,614,9702,3575857885,3575857918,33
0,614,9703,3575857885,3575857919,34
0,614,9704,3575857885,3575857919,34
0,614,9705,3575857885,3575857921,36
0,614,9706,3575857885,3575857922,37
0,614,9707,3575857885,3575857923,38
0,614,9708,3575857885,3575857923,38
0,614,9709,3575857885,3575857924,39
0,614,9710,3575857885,3575857925,40
0,614,9711,3575857885,3575857925,40
0,614,9712,3575857885,3575857926,41
0,614,9713,3575857885,3575857926,41
0,614,9714,3575857885,3575857927,42
0,614,9715,3575857885,3575857927,42
0,614,9716,3575857885,3575857930,45
0,614,9717,3575857885,3575857931,46
0,614,9718,3575857885,3575857932,47
0,614,9719,3575857885,3575857934,49
0,614,9720,3575857885,3575857934,49
0,614,9721,3575857885,3575857935,50
0,614,9722,3575857885,3575857935,50
0,615,9723,3575857940,3575857940,0
0,615,9724,3575857940,3575857940,0
0,615,9725,3575857940,3575857940,0
0,615,9726,3575857940,3575857940,0
0,615,9727,3575857940,3575857940,0
0,615,9728,3575857940,3575857940,0
0,615,9729,3575857940,3575857940,0
0,615,9730,3575857940,3575857942,2
0,615,9731,3575857940,3575857944,4
0,615,9732,3575857940,3575857944,4
0,615,9733,3575857940,3575857947,7
0,615,9734,3575857940,3575857949,9
0,615,9735,3575857940,3575857949,9
0,615,9736,3575857940,3575857950,10
0,615,9737,3575857940,3575857951,11
0,615,9738,3575857940,3575857953,13
0,615,9739,3575857940,3575857955,15
0,615,9740,3575857940,3575857955,15
0,615,9741,3575857940,3575857956,16
0,615,9742,3575857940,3575857958,18
0,615,9743,3575857940,3575857959,19
0,615,9744,3575857940,3575857959,19
0,615,9745,3575857940,3575857961,21
0,615,9746,3575857940,3575857963,23
0,615,9747,3575857940,3575857963,23
0,615,9748,3575857940,3575857964,24
0,615,9749,3575857940,3575857966,26
0,615,9750,3575857940,3575857971,31
0,615,9751,3575857940,3575857971,31
0,615,9752,3575857940,3575857973,33
0,615,9753,3575857940,3575857973,33
0,615,9754,3575857940,3575857974,34
0,615,9755,3575857940,3575857975,35
0,615,9756,3575857940,3575857976,36
0,615,9757,3575857940,3575857976,36
0,615,9758,3575857940,3575857977,37
0,615,9759,3575857940,3575857978,38
0,615,9760,3575857940,3575857980,40
0,615,9761,3575857940,3575857981,41
0,615,9762,3575857940,3575857982,42
0,615,9763,3575857940,3575857986,46
0,615,9764,3575857940,3575857987,47
0,616,9765,3575857995,3575857995,0
0,616,9766,3575857995,3575857995,0
0,616,9767,3575857995,3575857995,0
0,616,9768,3575857995,3575857997,2
0,616,9769,3575857995,3575857998,3
0,616,9770,3575857995,3575857998,3
0,616,9771,3575857995,3575857999,4
0,616,9772,3575857995,3575858001,6
0,616,9773,3575857995,3575858005,10
0,616,9774,3575857995,3575858006,11
0,616,9775,3575857995,3575858013,18
0,616,9776,3575857995,3575858014,19
0,616,9777,3575857995,3575858017,22
0,616,9778,3575857995,3575858018,23
0,616,9779,3575857995,3575858024,29
0,616,9780,3575857995,3575858025,30
0,616,9781,3575857995,3575858028,33
0,616,9782,3575857995,3575858028,33
0,616,9783,3575857995,3575858029,34
0,616,9784,3575857995,3575858032,37
0,616,9785,3575857995,3575858032,37
0,616,9786,3575857995,3575858033,38
0,616,9787,3575857995,3575858034,39
0,616,9788,3575857995,3575858034,39
0,616,9789,3575857995,3575858036,41
0,616,9790,3575857995,3575858036,41
0,616,9791,3575857995,3575858040,45
0,616,9792,3575857995,3575858041,46
0,616,9793,3575857995,3575858042,47
0,616,9794,3575857995,3575858043,48
0,617,9795,3575858049,3575858050,1
0,617,9796,3575858049,3575858050,1
0,617,9797,3575858049,3575858050,1
0,617,9798,3575858049,3575858050,1
0,617,9799,3575858049,3575858057,8
0,617,9800,3575858049,3575858059,10
0,617,9801,3575858049,3575858059,10
0,617,9802,3575858049,3575858061,12
0,617,9803,3575858049,3575858061,12
0,617,9804,3575858049,3575858064,15
0,617,9805,3575858049,3575858067,18
0,617,9806,3575858049,3575858067,18
0,617,9807,3575858049,3575858070,21
0,617,9808,3575858049,3575858077,28
0,617,9809,3575858049,3575858078,29
0,617,9810,3575858049,3575858079,30
0,617,9811,3575858049,3575858080,31
0,617,9812,3575858049,3575858080,31
0,617,9813,3575858049,3575858080,31
0,617,9814,3575858049,3575858082,33
0,617,9815,3575858049,3575858087,38
0,617,9816,3575858049,3575858087,38
0,617,9817,3575858049,3575858088,39
0,617,9818,3575858049,3575858089,40
0,617,9819,3575858049,3575858090,41
0,617,9820,3575858049,3575858090,41
0,617,9821,3575858049,3575858090,41
0,617,9822,3575858049,3575858090,41
0,617,9823,3575858049,3575858090,41
0,617,9824,3575858049,3575858091,42
0,617,9825,3575858049,3575858092,43
0,617,9826,3575858049,3575858093,44
0,617,9827,3575858049,3575858095,46
0,617,9828,3575858049,3575858095,46
0,617,9829,3575858049,3575858095,46
0,617,9830,3575858049,3575858098,49
0,617,9831,3575858049,3575858098,49
0,617,9832,3575858049,3575858099,50
0,618,9833,3575858104,3575858104,0
0,618,9834,3575858104,3575858104,0
0,618,9835,3575858104,3575858104,0
0,618,9836,3575858104,3575858106,2
0,618,9837,3575858104,3575858106,2
0,618,9838,3575858104,3575858107,3
0,618,9839,3575858104,3575858108,4
0,618,9840,3575858104,3575858109,5
0,618,9841,3575858104,3575858111,7
0,618,9842,3575858104,3575858112,8
0,618,9843,3575858104,3575858116,12
0,618,9844,3575858104,3575858116,12
0,618,9845,3575858104,3575858118,14
0,618,9846,3575858104,3575858119,15
0,618,9847,3575858104,3575858119,15
0,618,9848,3575858104,3575858119,15
0,618,9849,3575858104,3575858119,15
0,618,9850,3575858104,3575858121,17
0,618,9851,3575858104,3575858123,19
0,618,9852,3575858104,3575858124,20
0,618,9853,3575858104,3575858124,20
0,618,9854,3575858104,3575858125,21
0,618,9855,3575858104,3575858125,21
0,618,9856,3575858104,3575858125,21
0,618,9857,3575858104,3575858126,22
0,618,9858,3575858104,3575858127,23
0,618,9859,3575858104,3575858127,23
0,618,9860,3575858104,3575858130,26
0,618,9861,3575858104,3575858134,30
0,618,9862,3575858104,3575858134,30
0,618,9863,3575858104,3575858134,30
0,618,9864,3575858104,3575858135,31
0,618,9865,3575858104,3575858136,32
0,618,9866,3575858104,3575858136,32
0,618,9867,3575858104,3575858136,32
0,618,9868,3575858104,3575858138,34
0,618,9869,3575858104,3575858138,34
0,618,9870,3575858104,3575858139,35
0,618,9871,3575858104,3575858139,35
0,618,9872,3575858104,3575858139,35
0,618,9873,3575858104,3575858140,36
0,618,9874,3575858104,3575858142,38
0,618,9875,3575858104,3575858144,40
0,618,9876,3575858104,3575858145,41
0,618,9877,3575858104,3575858147,43
0,618,9878,3575858104,3575858149,45
0,618,9879,3575858104,3575858149,45
0,618,9880,3575858104,3575858149,45
0,618,9881,3575858104,3575858152,48
0,619,9882,3575858158,3575858158,0
0,619,9883,3575858158,3575858158,0
0,619,9884,3575858158,3575858158,0
0,619,9885,3575858158,3575858158,0
0,619,9886,3575858158,3575858158,0
0,619,9887,3575858158,3575858159,1
0,619,9888,3575858158,3575858159,1
0,619,9889,3575858158,3575858161,3
0,619,9890,3575858158,3575858163,5
0,619,9891,3575858158,3575858163,5
0,619,9892,3575858158,3575858164,6
0,619,9893,3575858158,3575858165,7
0,619,9894,3575858158,3575858166,8
0,619,9895,3575858158,3575858172,14
0,619,9896,3575858158,3575858172,14
0,619,9897,3575858158,3575858173,15
0,619,9898,3575858158,3575858173,15
0,619,9899,3575858158,3575858175,17
0,619,9900,3575858158,3575858175,17
0,619,9901,3575858158,3575858176,18
0,619,9902,3575858158,3575858176,18
0,619,9903,3575858158,3575858178,20
0,619,9904,3575858158,3575858178,20
0,619,9905,3575858158,3575858180,22
0,619,9906,3575858158,3575858182,24
0,619,9907,3575858158,3575858183,25
0,619,9908,3575858158,3575858186,28
0,619,9909,3575858158,3575858186,28
0,619,9910,3575858158,3575858187,29
0,619,9911,3575858158,3575858191,33
0,619,9912,3575858158,3575858194,36
0,619,9913,3575858158,3575858195,37
0,619,9914,3575858158,3575858197,39
0,619,9915,3575858158,3575858198,40
0,619,9916,3575858158,3575858198,40
0,619,9917,3575858158,3575858199,41
0,619,9918,3575858158,3575858202,44
0,619,9919,3575858158,3575858205,47
0,619,9920,3575858158,3575858206,48
0,620,9921,3575858212,3575858212,0
0,620,9922,3575858212,3575858214,2
0,620,9923,3575858212,3575858214,2
0,620,9924,3575858212,3575858217,5
0,620,9925,3575858212,3575858222,10
0,620,9926,3575858212,3575858224,12
0,620,9927,3575858212,3575858225,13
0,620,9928,3575858212,3575858229,17
0,620,9929,3575858212,3575858229,17
0,620,9930,3575858212,3575858232,20
0,620,9931,3575858212,3575858233,21
0,620,9932,3575858212,3575858233,21
0,620,9933,3575858212,3575858233,21
0,620,9934,3575858212,3575858236,24
0,620,9935,3575858212,3575858236,24
0,620,9936,3575858212,3575858237,25
0,620,9937,3575858212,3575858239,27
0,620,9938,3575858212,3575858241,29
0,620,9939,3575858212,3575858242,30
0,620,9940,3575858212,3575858244,32
0,620,9941,3575858212,3575858246,34
0,620,9942,3575858212,3575858248,36
0,620,9943,3575858212,3575858248,36
0,620,9944,3575858212,3575858248,36
0,620,9945,3575858212,3575858255,43
0,620,9946,3575858212,3575858257,45
0,620,9947,3575858212,3575858259,47
0,620,9948,3575858212,3575858261,49
0,620,9949,3575858212,3575858261,49
0,621,9950,3575858267,3575858267,0
0,621,9951,3575858267,3575858267,0
0,621,9952,3575858267,3575858267,0
0,621,9953,3575858267,3575858268,1
0,621,9954,3575858267,3575858271,4
0,621,9955,3575858267,3575858278,11
0,621,9956,3575858267,3575858278,11
0,621,9957,3575858267,3575858280,13
0,621,9958,3575858267,3575858280,13
0,621,9959,3575858267,3575858280,13
0,621,9960,3575858267,3575858280,13
0,621,9961,3575858267,3575858282,15
0,621,9962,3575858267,3575858287,20
0,621,9963,3575858267,3575858288,21
0,621,9964,3575858267,3575858288,21
0,621,9965,3575858267,3575858289,22
0,621,9966,3575858267,3575858290,23
0,621,9967,3575858267,3575858290,23
0,621,9968,3575858267,3575858290,23
0,621,9969,3575858267,3575858290,23
0,621,9970,3575858267,3575858290,23
0,621,9971,3575858267,3575858290,23
0,621,9972,3575858267,3575858291,24
0,621,9973,3575858267,3575858292,25
0,621,9974,3575858267,3575858293,26
0,621,9975,3575858267,3575858294,27
0,621,9976,3575858267,3575858295,28
0,621,9977,3575858267,3575858295,28
0,621,9978,3575858267,3575858298,31
0,621,9979,3575858267,3575858298,31
0,621,9980,3575858267,3575858299,32
0,621,9981,3575858267,3575858300,33
0,621,9982,3575858267,3575858301,34
0,621,9983,3575858267,3575858302,35
0,621,9984,3575858267,3575858303,36
0,621,9985,3575858267,3575858305,38
0,621,9986,3575858267,3575858307,40
0,621,9987,3575858267,3575858308,41
0,621,9988,3575858267,3575858309,42
0,621,9989,3575858267,3575858311,44
0,621,9990,3575858267,3575858313,46
0,621,9991,3575858267,3575858316,49
0,621,9992,3575858267,3575858317,50
0,622,9993,3575858321,3575858321,0
0,622,9994,3575858321,3575858321,0
0,622,9995,3575858321,3575858321,0
0,622,9996,3575858321,3575858321,0
0,622,9997,3575858321,3575858321,0
0,622,9998,3575858321,3575858324,3
0,622,9999,3575858321,3575858324,3
0,622,10000,3575858321,3575858324,3
0,622,10001,3575858321,3575858325,4
0,622,10002,3575858321,3575858325,4
0,622,10003,3575858321,3575858325,4
0,622,10004,3575858321,3575858326,5
0,622,10005,3575858321,3575858326,5
0,622,10006,3575858321,3575858326,5
0,622,10007,3575858321,3575858327,6
0,622,10008,3575858321,3575858330,9
0,622,10009,3575858321,3575858334,13
0,622,10010,3575858321,3575858334,13
0,622,10011,3575858321,3575858335,14
0,622,10012,3575858321,3575858336,15
0,622,10013,3575858321,3575858337,16
0,622,10014,3575858321,3575858337,16
0,622,10015,3575858321,3575858338,17
0,622,10016,3575858321,3575858338,17
0,622,10017,3575858321,3575858339,18
0,622,10018,3575858321,3575858339,18
0,622,10019,3575858321,3575858339,18
0,622,10020,3575858321,3575858340,19
0,622,10021,3575858321,3575858340,19
0,622,10022,3575858321,3575858342,21
0,622,10023,3575858321,3575858344,23
0,622,10024,3575858321,3575858348,27
0,622,10025,3575858321,3575858349,28
0,622,10026,3575858321,3575858349,28
0,622,10027,3575858321,3575858350,29
0,622,10028,3575858321,3575858351,30
0,622,10029,3575858321,3575858352,31
0,622,10030,3575858321,3575858355,34
0,622,10031,3575858321,3575858355,34
0,622,10032,3575858321,3575858355,34
0,622,10033,3575858321,3575858356,35
0,622,10034,3575858321,3575858358,37
0,622,10035,3575858321,3575858359,38
0,622,10036,3575858321,3575858359,38
0,622,10037,3575858321,3575858362,41
0,622,10038,3575858321,3575858363,42
0,622,10039,3575858321,3575858364,43
0,622,10040,3575858321,3575858364,43
0,622,10041,3575858321,3575858366,45
0,622,10042,3575858321,3575858366,45
0,622,10043,3575858321,3575858371,50
0,623,10044,3575858375,3575858375,0
0,623,10045,3575858375,3575858375,0
0,623,10046,3575858375,3575858375,0
0,623,10047,3575858375,3575858375,0
0,623,10048,3575858375,3575858376,1
0,623,10049,3575858375,3575858376,1
0,623,10050,3575858375,3575858377,2
0,623,10051,3575858375,3575858378,3
0,623,10052,3575858375,3575858381,6
0,623,10053,3575858375,3575858382,7
0,623,10054,3575858375,3575858384,9
0,623,10055,3575858375,3575858387,12
0,623,10056,3575858375,3575858387,12
0,623,10057,3575858375,3575858389,14
0,623,10058,3575858375,3575858391,16
0,623,10059,3575858375,3575858394,19
0,623,10060,3575858375,3575858395,20
0,623,10061,3575858375,3575858399,24
0,623,10062,3575858375,3575858399,24
0,623,10063,3575858375,3575858399,24
0,623,10064,3575858375,3575858402,27
0,623,10065,3575858375,3575858405,30
0,623,10066,3575858375,3575858406,31
0,623,10067,3575858375,3575858406,31
0,623,10068,3575858375,3575858410,35
0,623,10069,3575858375,3575858414,39
0,623,10070,3575858375,3575858415,40
0,623,10071,3575858375,3575858417,42
0,623,10072,3575858375,3575858423,48
0,623,10073,3575858375,3575858424,49
0,624,10074,3575858429,3575858429,0
0,624,10075,3575858429,3575858429,0
0,624,10076,3575858429,3575858430,1
0,624,10077,3575858429,3575858430,1
0,624,10078,3575858429,3575858432,3
0,624,10079,3575858429,3575858433,4
0,624,10080,3575858429,3575858434,5
0,624,10081,3575858429,3575858434,5
0,624,10082,3575858429,3575858436,7
0,624,10083,3575858429,3575858440,11
0,624,10084,3575858429,3575858440,11
0,624,10085,3575858429,3575858442,13
0,624,10086,3575858429,3575858442,13
0,624,10087,3575858429,3575858444,15
0,624,10088,3575858429,3575858445,16
0,624,10089,3575858429,3575858448,19
0,624,10090,3575858429,3575858448,19
0,624,10091,3575858429,3575858449,20
0,624,10092,3575858429,3575858455,26
0,624,10093,3575858429,3575858457,28
0,624,10094,3575858429,3575858460,31
0,624,10095,3575858429,3575858461,32
0,624,10096,3575858429,3575858461,32
0,624,10097,3575858429,3575858462,33
0,624,10098,3575858429,3575858464,35
0,624,10099,3575858429,3575858469,40
0,624,10100,3575858429,3575858471,42
0,624,10101,3575858429,3575858477,48
0,625,10102,3575858484,3575858484,0
0,625,10103,3575858484,3575858484,0
0,625,10104,3575858484,3575858484,0
0,625,10105,3575858484,3575858484,0
0,625,10106,3575858484,3575858487,3
0,625,10107,3575858484,3575858487,3
0,625,10108,3575858484,3575858488,4
0,625,10109,3575858484,3575858488,4
0,625,10110,3575858484,3575858489,5
0,625,10111,3575858484,3575858489,5
0,625,10112,3575858484,3575858489,5
0,625,10113,3575858484,3575858490,6
0,625,10114,3575858484,3575858490,6
0,625,10115,3575858484,3575858491,7
0,625,10116,3575858484,3575858491,7
0,625,10117,3575858484,3575858493,9
0,625,10118,3575858484,3575858494,10
0,625,10119,3575858484,3575858494,10
0,625,10120,3575858484,3575858497,13
0,625,10121,3575858484,3575858498,14
0,625,10122,3575858484,3575858498,14
0,625,10123,3575858484,3575858499,15
0,625,10124,3575858484,3575858501,17
0,625,10125,3575858484,3575858502,18
0,625,10126,3575858484,3575858504,20
0,625,10127,3575858484,3575858506,22
0,625,10128,3575858484,3575858508,24
0,625,10129,3575858484,3575858509,25
0,625,10130,3575858484,3575858511,27
0,625,10131,3575858484,3575858512,28
0,625,10132,3575858484,3575858515,31
0,625,10133,3575858484,3575858515,31
0,625,10134,3575858484,3575858517,33
0,625,10135,3575858484,3575858518,34
0,625,10136,3575858484,3575858518,34
0,625,10137,3575858484,3575858519,35
0,625,10138,3575858484,3575858519,35
0,625,10139,3575858484,3575858523,39
0,625,10140,3575858484,3575858523,39
0,625,10141,3575858484,3575858523,39
0,625,10142,3575858484,3575858524,40
0,625,10143,3575858484,3575858524,40
0,625,10144,3575858484,3575858525,41
0,625,10145,3575858484,3575858526,42
0,625,10146,3575858484,3575858526,42
0,625,10147,3575858484,3575858526,42
0,625,10148,3575858484,3575858527,43
0,625,10149,3575858484,3575858533,49
0,625,10150,3575858484,3575858533,49
0,625,10151,3575858484,3575858534,50
0,626,10152,3575858539,3575858539,0
0,626,10153,3575858539,3575858539,0
0,626,10154,3575858539,3575858539,0
0,626,10155,3575858539,3575858539,0
0,626,10156,3575858539,3575858539,0
0,626,10157,3575858539,3575858539,0
0,626,10158,3575858539,3575858539,0
0,626,10159,3575858539,3575858539,0
0,626,10160,3575858539,3575858541,2
0,626,10161,3575858539,3575858541,2
0,626,10162,3575858539,3575858542,3
0,626,10163,3575858539,3575858544,5
0,626,10164,3575858539,3575858547,8
0,626,10165,3575858539,3575858549,10
0,626,10166,3575858539,3575858551,12
0,626,10167,3575858539,3575858551,12
0,626,10168,3575858539,3575858554,15
0,626,10169,3575858539,3575858554,15
0,626,10170,3575858539,3575858554,15
0,626,10171,3575858539,3575858554,15
0,626,10172,3575858539,3575858557,18
0,626,10173,3575858539,3575858558,19
0,626,10174,3575858539,3575858559,20
0,626,10175,3575858539,3575858561,22
0,626,10176,3575858539,3575858563,24
0,626,10177,3575858539,3575858564,25
0,626,10178,3575858539,3575858565,26
0,626,10179,3575858539,3575858565,26
0,626,10180,3575858539,3575858570,31
0,626,10181,3575858539,3575858571,32
0,626,10182,3575858539,3575858572,33
0,626,10183,3575858539,3575858572,33
0,626,10184,3575858539,3575858572,33
0,626,10185,3575858539,3575858574,35
0,626,10186,3575858539,3575858576,37
0,626,10187,3575858539,3575858576,37
0,626,10188,3575858539,3575858576,37
0,626,10189,3575858539,3575858577,38
0,626,10190,3575858539,3575858578,39
0,626,10191,3575858539,3575858580,41
0,626,10192,3575858539,3575858582,43
0,626,10193,3575858539,3575858586,47
0,626,10194,3575858539,3575858587,48
0,627,10195,3575858594,3575858594,0
0,627,10196,3575858594,3575858594,0
0,627,10197,3575858594,3575858594,0
0,627,10198,3575858594,3575858594,0
0,627,10199,3575858594,3575858598,4
0,627,10200,3575858594,3575858598,4
0,627,10201,3575858594,3575858600,6
0,627,10202,3575858594,3575858601,7
0,627,10203,3575858594,3575858605,11
0,627,10204,3575858594,3575858605,11
0,627,10205,3575858594,3575858609,15
0,627,10206,3575858594,3575858614,20
0,627,10207,3575858594,3575858614,20
0,627,10208,3575858594,3575858616,22
0,627,10209,3575858594,3575858622,28
0,627,10210,3575858594,3575858623,29
0,627,10211,3575858594,3575858626,32
0,627,10212,3575858594,3575858627,33
0,627,10213,3575858594,3575858628,34
0,627,10214,3575858594,3575858629,35
0,627,10215,3575858594,3575858629,35
0,627,10216,3575858594,3575858632,38
0,627,10217,3575858594,3575858632,38
0,627,10218,3575858594,3575858633,39
0,627,10219,3575858594,3575858633,39
0,627,10220,3575858594,3575858635,41
0,627,10221,3575858594,3575858640,46
0,627,10222,3575858594,3575858641,47
0,627,10223,3575858594,3575858641,47
0,627,10224,3575858594,3575858643,49
0,627,10225,3575858594,3575858644,50
0,628,10226,3575858649,3575858649,0
0,628,10227,3575858649,3575858649,0
0,628,10228,3575858649,3575858649,0
0,628,10229,3575858649,3575858655,6
0,628,10230,3575858649,3575858656,7
0,628,10231,3575858649,3575858660,11
0,628,10232,3575858649,3575858660,11
0,628,10233,3575858649,3575858661,12
0,628,10234,3575858649,3575858661,12
0,628,10235,3575858649,3575858664,15
0,628,10236,3575858649,3575858667,18
0,628,10237,3575858649,3575858668,19
0,628,10238,3575858649,3575858671,22
0,628,10239,3575858649,3575858677,28
0,628,10240,3575858649,3575858678,29
0,628,10241,3575858649,3575858680,31
0,628,10242,3575858649,3575858680,31
0,628,10243,3575858649,3575858681,32
0,628,10244,3575858649,3575858682,33
0,628,10245,3575858649,3575858687,38
0,628,10246,3575858649,3575858687,38
0,628,10247,3575858649,3575858688,39
0,628,10248,3575858649,3575858688,39
0,628,10249,3575858649,3575858689,40
0,628,10250,3575858649,3575858689,40
0,628,10251,3575858649,3575858690,41
0,628,10252,3575858649,3575858690,41
0,628,10253,3575858649,3575858690,41
0,628,10254,3575858649,3575858690,41
0,628,10255,3575858649,3575858692,43
0,628,10256,3575858649,3575858694,45
0,628,10257,3575858649,3575858694,45
0,628,10258,3575858649,3575858694,45
0,628,10259,3575858649,3575858694,45
0,628,10260,3575858649,3575858697,48
0,628,10261,3575858649,3575858697,48
0,628,10262,3575858649,3575858698,49
0,629,10263,3575858704,3575858704,0
0,629,10264,3575858704,3575858704,0
0,629,10265,3575858704,3575858704,0
0,629,10266,3575858704,3575858704,0
0,629,10267,3575858704,3575858704,0
0,629,10268,3575858704,3575858706,2
0,629,10269,3575858704,3575858707,3
0,629,10270,3575858704,3575858709,5
0,629,10271,3575858704,3575858711,7
0,629,10272,3575858704,3575858715,11
0,629,10273,3575858704,3575858717,13
0,629,10274,3575858704,3575858718,14
0,629,10275,3575858704,3575858718,14
0,629,10276,3575858704,3575858718,14
0,629,10277,3575858704,3575858719,15
0,629,10278,3575858704,3575858720,16
0,629,10279,3575858704,3575858721,17
0,629,10280,3575858704,3575858722,18
0,629,10281,3575858704,3575858723,19
0,629,10282,3575858704,3575858724,20
0,629,10283,3575858704,3575858725,21
0,629,10284,3575858704,3575858725,21
0,629,10285,3575858704,3575858725,21
0,629,10286,3575858704,3575858725,21
0,629,10287,3575858704,3575858725,21
0,629,10288,3575858704,3575858726,22
0,629,10289,3575858704,3575858727,23
0,629,10290,3575858704,3575858734,30
0,629,10291,3575858704,3575858734,30
0,629,10292,3575858704,3575858734,30
0,629,10293,3575858704,3575858736,32
0,629,10294,3575858704,3575858736,32
0,629,10295,3575858704,3575858737,33
0,629,10296,3575858704,3575858738,34
0,629,10297,3575858704,3575858738,34
0,629,10298,3575858704,3575858738,34
0,629,10299,3575858704,3575858739,35
0,629,10300,3575858704,3575858741,37
0,629,10301,3575858704,3575858741,37
0,629,10302,3575858704,3575858743,39
0,629,10303,3575858704,3575858744,40
0,629,10304,3575858704,3575858745,41
0,629,10305,3575858704,3575858747,43
0,629,10306,3575858704,3575858750,46
0,629,10307,3575858704,3575858751,47
0,629,10308,3575858704,3575858753,49
0,630,10309,3575858759,3575858759,0
0,630,10310,3575858759,3575858759,0
0,630,10311,3575858759,3575858759,0
0,630,10312,3575858759,3575858759,0
0,630,10313,3575858759,3575858759,0
0,630,10314,3575858759,3575858760,1
0,630,10315,3575858759,3575858761,2
0,630,10316,3575858759,3575858762,3
0,630,10317,3575858759,3575858763,4
0,630,10318,3575858759,3575858764,5
0,630,10319,3575858759,3575858765,6
0,630,10320,3575858759,3575858765,6
0,630,10321,3575858759,3575858770,11
0,630,10322,3575858759,3575858771,12
0,630,10323,3575858759,3575858773,14
0,630,10324,3575858759,3575858773,14
0,630,10325,3575858759,3575858773,14
0,630,10326,3575858759,3575858774,15
0,630,10327,3575858759,3575858775,16
0,630,10328,3575858759,3575858776,17
0,630,10329,3575858759,3575858776,17
0,630,10330,3575858759,3575858777,18
0,630,10331,3575858759,3575858778,19
0,630,10332,3575858759,3575858780,21
0,630,10333,3575858759,3575858783,24
0,630,10334,3575858759,3575858784,25
0,630,10335,3575858759,3575858785,26
0,630,10336,3575858759,3575858787,28
0,630,10337,3575858759,3575858790,31
0,630,10338,3575858759,3575858793,34
0,630,10339,3575858759,3575858795,36
0,630,10340,3575858759,3575858796,37
0,630,10341,3575858759,3575858798,39
0,630,10342,3575858759,3575858799,40
0,630,10343,3575858759,3575858800,41
0,630,10344,3575858759,3575858801,42
0,630,10345,3575858759,3575858805,46
0,630,10346,3575858759,3575858805,46
0,630,10347,3575858759,3575858808,49
0,631,10348,3575858814,3575858814,0
0,631,10349,3575858814,3575858815,1
0,631,10350,3575858814,3575858815,1
0,631,10351,3575858814,3575858817,3
0,631,10352,3575858814,3575858822,8
0,631,10353,3575858814,3575858823,9
0,631,10354,3575858814,3575858827,13
0,631,10355,3575858814,3575858827,13
0,631,10356,3575858814,3575858828,14
0,631,10357,3575858814,3575858829,15
0,631,10358,3575858814,3575858829,15
0,631,10359,3575858814,3575858832,18
0,631,10360,3575858814,3575858833,19
0,631,10361,3575858814,3575858833,19
0,631,10362,3575858814,3575858833,19
0,631,10363,3575858814,3575858835,21
0,631,10364,3575858814,3575858840,26
0,631,10365,3575858814,3575858842,28
0,631,10366,3575858814,3575858844,30
0,631,10367,3575858814,3575858846,32
0,631,10368,3575858814,3575858846,32
0,631,10369,3575858814,3575858848,34
0,631,10370,3575858814,3575858848,34
0,631,10371,3575858814,3575858854,40
0,631,10372,3575858814,3575858855,41
0,631,10373,3575858814,3575858856,42
0,631,10374,3575858814,3575858860,46
0,631,10375,3575858814,3575858861,47
0,631,10376,3575858814,3575858861,47
0,631,10377,3575858814,3575858861,47
0,631,10378,3575858814,3575858863,49
0,632,10379,3575858870,3575858870,0
0,632,10380,3575858870,3575858870,0
0,632,10381,3575858870,3575858871,1
0,632,10382,3575858870,3575858877,7
0,632,10383,3575858870,3575858880,10
0,632,10384,3575858870,3575858881,11
0,632,10385,3575858870,3575858881,11
0,632,10386,3575858870,3575858882,12
0,632,10387,3575858870,3575858882,12
0,632,10388,3575858870,3575858887,17
0,632,10389,3575858870,3575858888,18
0,632,10390,3575858870,3575858888,18
0,632,10391,3575858870,3575858888,18
0,632,10392,3575858870,3575858889,19
0,632,10393,3575858870,3575858889,19
0,632,10394,3575858870,3575858890,20
0,632,10395,3575858870,3575858890,20
0,632,10396,3575858870,3575858890,20
0,632,10397,3575858870,3575858891,21
0,632,10398,3575858870,3575858892,22
0,632,10399,3575858870,3575858894,24
0,632,10400,3575858870,3575858894,24
0,632,10401,3575858870,3575858894,24
0,632,10402,3575858870,3575858894,24
0,632,10403,3575858870,3575858897,27
0,632,10404,3575858870,3575858898,28
0,632,10405,3575858870,3575858898,28
0,632,10406,3575858870,3575858900,30
0,632,10407,3575858870,3575858901,31
0,632,10408,3575858870,3575858902,32
0,632,10409,3575858870,3575858903,33
0,632,10410,3575858870,3575858907,37
0,632,10411,3575858870,3575858907,37
0,632,10412,3575858870,3575858909,39
0,632,10413,3575858870,3575858912,42
0,632,10414,3575858870,3575858915,45
0,632,10415,3575858870,3575858918,48
0,632,10416,3575858870,3575858918,48
0,632,10417,3575858870,3575858918,48
0,632,10418,3575858870,3575858918,48
0,632,10419,3575858870,3575858918,48
0,632,10420,3575858870,3575858920,50
0,633,10421,3575858926,3575858926,0
0,633,10422,3575858926,3575858926,0
0,633,10423,3575858926,3575858926,0
0,633,10424,3575858926,3575858926,0
0,633,10425,3575858926,3575858926,0
0,633,10426,3575858926,3575858926,0
0,633,10427,3575858926,3575858926,0
0,633,10428,3575858926,3575858926,0
0,633,10429,3575858926,3575858926,0
0,633,10430,3575858926,3575858927,1
0,633,10431,3575858926,3575858934,8
0,633,10432,3575858926,3575858934,8
0,633,10433,3575858926,3575858934,8
0,633,10434,3575858926,3575858936,10
0,633,10435,3575858926,3575858937,11
0,633,10436,3575858926,3575858937,11
0,633,10437,3575858926,3575858938,12
0,633,10438,3575858926,3575858938,12
0,633,10439,3575858926,3575858939,13
0,633,10440,3575858926,3575858939,13
0,633,10441,3575858926,3575858941,15
0,633,10442,3575858926,3575858943,17
0,633,10443,3575858926,3575858943,17
0,633,10444,3575858926,3575858944,18
0,633,10445,3575858926,3575858947,21
0,633,10446,3575858926,3575858949,23
0,633,10447,3575858926,3575858950,24
0,633,10448,3575858926,3575858952,26
0,633,10449,3575858926,3575858953,27
0,633,10450,3575858926,3575858954,28
0,633,10451,3575858926,3575858954,28
0,633,10452,3575858926,3575858956,30
0,633,10453,3575858926,3575858958,32
0,633,10454,3575858926,3575858959,33
0,633,10455,3575858926,3575858961,35
0,633,10456,3575858926,3575858961,35
0,633,10457,3575858926,3575858962,36
0,633,10458,3575858926,3575858963,37
0,633,10459,3575858926,3575858964,38
0,633,10460,3575858926,3575858965,39
0,633,10461,3575858926,3575858971,45
0,633,10462,3575858926,3575858971,45
0,633,10463,3575858926,3575858973,47
0,633,10464,3575858926,3575858973,47
0,633,10465,3575858926,3575858974,48
0,633,10466,3575858926,3575858974,48
0,633,10467,3575858926,3575858976,50
0,634,10468,3575858981,3575858981,0
0,634,10469,3575858981,3575858981,0
0,634,10470,3575858981,3575858981,0
0,634,10471,3575858981,3575858983,2
0,634,10472,3575858981,3575858984,3
0,634,10473,3575858981,3575858986,5
0,634,10474,3575858981,3575858987,6
0,634,10475,3575858981,3575858990,9
0,634,10476,3575858981,3575858994,13
0,634,10477,3575858981,3575858995,14
0,634,10478,3575858981,3575858997,16
0,634,10479,3575858981,3575858998,17
0,634,10480,3575858981,3575858999,18
0,634,10481,3575858981,3575859000,19
0,634,10482,3575858981,3575859001,20
0,634,10483,3575858981,3575859003,22
0,634,10484,3575858981,3575859005,24
0,634,10485,3575858981,3575859009,28
0,634,10486,3575858981,3575859014,33
0,634,10487,3575858981,3575859015,34
0,634,10488,3575858981,3575859015,34
0,634,10489,3575858981,3575859018,37
0,634,10490,3575858981,3575859023,42
0,634,10491,3575858981,3575859026,45
0,634,10492,3575858981,3575859028,47
0,634,10493,3575858981,3575859028,47
0,634,10494,3575858981,3575859029,48
0,634,10495,3575858981,3575859029,48
0,635,10496,3575859035,3575859035,0
0,635,10497,3575859035,3575859035,0
0,635,10498,3575859035,3575859035,0
0,635,10499,3575859035,3575859035,0
0,635,10500,3575859035,3575859040,5
0,635,10501,3575859035,3575859041,6
0,635,10502,3575859035,3575859043,8
0,635,10503,3575859035,3575859043,8
0,635,10504,3575859035,3575859046,11
0,635,10505,3575859035,3575859047,12
0,635,10506,3575859035,3575859048,13
0,635,10507,3575859035,3575859048,13
0,635,10508,3575859035,3575859053,18
0,635,10509,3575859035,3575859056,21
0,635,10510,3575859035,3575859057,22
0,635,10511,3575859035,3575859060,25
0,635,10512,3575859035,3575859062,27
0,635,10513,3575859035,3575859062,27
0,635,10514,3575859035,3575859062,27
0,635,10515,3575859035,3575859064,29
0,635,10516,3575859035,3575859067,32
0,635,10517,3575859035,3575859067,32
0,635,10518,3575859035,3575859068,33
0,635,10519,3575859035,3575859070,35
0,635,10520,3575859035,3575859078,43
0,635,10521,3575859035,3575859079,44
0,635,10522,3575859035,3575859080,45
0,635,10523,3575859035,3575859082,47
0,635,10524,3575859035,3575859082,47
0,635,10525,3575859035,3575859084,49
0,636,10526,3575859090,3575859090,0
0,636,10527,3575859090,3575859090,0
0,636,10528,3575859090,3575859090,0
0,636,10529,3575859090,3575859090,0
0,636,10530,3575859090,3575859090,0
0,636,10531,3575859090,3575859090,0
0,636,10532,3575859090,3575859090,0
0,636,10533,3575859090,3575859090,0
0,636,10534,3575859090,3575859091,1
0,636,10535,3575859090,3575859092,2
0,636,10536,3575859090,3575859092,2
0,636,10537,3575859090,3575859093,3
0,636,10538,3575859090,3575859094,4
0,636,10539,3575859090,3575859094,4
0,636,10540,3575859090,3575859095,5
0,636,10541,3575859090,3575859097,7
0,636,10542,3575859090,3575859098,8
0,636,10543,3575859090,3575859098,8
0,636,10544,3575859090,3575859101,11
0,636,10545,3575859090,3575859102,12
0,636,10546,3575859090,3575859102,12
0,636,10547,3575859090,3575859103,13
0,636,10548,3575859090,3575859104,14
0,636,10549,3575859090,3575859104,14
0,636,10550,3575859090,3575859105,15
0,636,10551,3575859090,3575859106,16
0,636,10552,3575859090,3575859108,18
0,636,10553,3575859090,3575859109,19
0,636,10554,3575859090,3575859111,21
0,636,10555,3575859090,3575859112,22
0,636,10556,3575859090,3575859116,26
0,636,10557,3575859090,3575859118,28
0,636,10558,3575859090,3575859118,28
0,636,10559,3575859090,3575859119,29
0,636,10560,3575859090,3575859119,29
0,636,10561,3575859090,3575859121,31
0,636,10562,3575859090,3575859123,33
0,636,10563,3575859090,3575859124,34
0,636,10564,3575859090,3575859125,35
0,636,10565,3575859090,3575859125,35
0,636,10566,3575859090,3575859126,36
0,636,10567,3575859090,3575859126,36
0,636,10568,3575859090,3575859127,37
0,636,10569,3575859090,3575859128,38
0,636,10570,3575859090,3575859130,40
0,636,10571,3575859090,3575859133,43
0,636,10572,3575859090,3575859134,44
0,636,10573,3575859090,3575859134,44
0,636,10574,3575859090,3575859136,46
0,636,10575,3575859090,3575859137,47
0,636,10576,3575859090,3575859137,47
0,636,10577,3575859090,3575859138,48
0,636,10578,3575859090,3575859138,48
0,636,10579,3575859090,3575859138,48
0,636,10580,3575859090,3575859139,49
0,636,10581,3575859090,3575859139,49
0,637,10582,3575859145,3575859145,0
0,637,10583,3575859145,3575859145,0
0,637,10584,3575859145,3575859145,0
0,637,10585,3575859145,3575859145,0
0,637,10586,3575859145,3575859147,2
0,637,10587,3575859145,3575859149,4
0,637,10588,3575859145,3575859149,4
0,637,10589,3575859145,3575859149,4
0,637,10590,3575859145,3575859150,5
0,637,10591,3575859145,3575859152,7
0,637,10592,3575859145,3575859154,9
0,637,10593,3575859145,3575859156,11
0,637,10594,3575859145,3575859158,13
0,637,10595,3575859145,3575859159,14
0,637,10596,3575859145,3575859161,16
0,637,10597,3575859145,3575859161,16
0,637,10598,3575859145,3575859162,17
0,637,10599,3575859145,3575859163,18
0,637,10600,3575859145,3575859164,19
0,637,10601,3575859145,3575859166,21
0,637,10602,3575859145,3575859172,27
0,637,10603,3575859145,3575859173,28
0,637,10604,3575859145,3575859174,29
0,637,10605,3575859145,3575859174,29
0,637,10606,3575859145,3575859175,30
0,637,10607,3575859145,3575859176,31
0,637,10608,3575859145,3575859176,31
0,637,10609,3575859145,3575859177,32
0,637,10610,3575859145,3575859178,33
0,637,10611,3575859145,3575859178,33
0,637,10612,3575859145,3575859181,36
0,637,10613,3575859145,3575859183,38
0,637,10614,3575859145,3575859184,39
0,637,10615,3575859145,3575859186,41
0,637,10616,3575859145,3575859187,42
0,637,10617,3575859145,3575859191,46
0,637,10618,3575859145,3575859194,49
0,637,10619,3575859145,3575859194,49
0,638,10620,3575859200,3575859200,0
0,638,10621,3575859200,3575859200,0
0,638,10622,3575859200,3575859200,0
0,638,10623,3575859200,3575859200,0
0,638,10624,3575859200,3575859201,1
0,638,10625,3575859200,3575859205,5
0,638,10626,3575859200,3575859206,6
0,638,10627,3575859200,3575859206,6
0,638,10628,3575859200,3575859207,7
0,638,10629,3575859200,3575859209,9
0,638,10630,3575859200,3575859214,14
0,638,10631,3575859200,3575859214,14
0,638,10632,3575859200,3575859217,17
0,638,10633,3575859200,3575859218,18
0,638,10634,3575859200,3575859222,22
0,638,10635,3575859200,3575859223,23
0,638,10636,3575859200,3575859226,26
0,638,10637,3575859200,3575859229,29
0,638,10638,3575859200,3575859229,29
0,638,10639,3575859200,3575859230,30
0,638,10640,3575859200,3575859230,30
0,638,10641,3575859200,3575859232,32
0,638,10642,3575859200,3575859232,32
0,638,10643,3575859200,3575859234,34
0,638,10644,3575859200,3575859235,35
0,638,10645,3575859200,3575859235,35
0,638,10646,3575859200,3575859241,41
0,638,10647,3575859200,3575859241,41
0,638,10648,3575859200,3575859244,44
0,638,10649,3575859200,3575859244,44
0,638,10650,3575859200,3575859246,46
0,638,10651,3575859200,3575859247,47
0,638,10652,3575859200,3575859248,48
0,638,10653,3575859200,3575859248,48
0,638,10654,3575859200,3575859248,48
0,639,10655,3575859255,3575859255,0
0,639,10656,3575859255,3575859257,2
0,639,10657,3575859255,3575859257,2
0,639,10658,3575859255,3575859260,5
0,639,10659,3575859255,3575859261,6
0,639,10660,3575859255,3575859262,7
0,639,10661,3575859255,3575859263,8
0,639,10662,3575859255,3575859265,10
0,639,10663,3575859255,3575859267,12
0,639,10664,3575859255,3575859270,15
0,639,10665,3575859255,3575859277,22
0,639,10666,3575859255,3575859278,23
0,639,10667,3575859255,3575859280,25
0,639,10668,3575859255,3575859282,27
0,639,10669,3575859255,3575859282,27
0,639,10670,3575859255,3575859284,29
0,639,10671,3575859255,3575859288,33
0,639,10672,3575859255,3575859288,33
0,639,10673,3575859255,3575859289,34
0,639,10674,3575859255,3575859289,34
0,639,10675,3575859255,3575859289,34
0,639,10676,3575859255,3575859290,35
0,639,10677,3575859255,3575859291,36
0,639,10678,3575859255,3575859292,37
0,639,10679,3575859255,3575859293,38
0,639,10680,3575859255,3575859293,38
0,639,10681,3575859255,3575859294,39
0,639,10682,3575859255,3575859294,39
0,639,10683,3575859255,3575859295,40
0,639,10684,3575859255,3575859297,42
0,639,10685,3575859255,3575859298,43
0,639,10686,3575859255,3575859299,44
0,639,10687,3575859255,3575859301,46
0,639,10688,3575859255,3575859301,46
0,639,10689,3575859255,3575859302,47
0,639,10690,3575859255,3575859302,47
0,639,10691,3575859255,3575859305,50
0,640,10692,3575859310,3575859310,0
0,640,10693,3575859310,3575859310,0
0,640,10694,3575859310,3575859310,0
0,640,10695,3575859310,3575859310,0
0,640,10696,3575859310,3575859312,2
0,640,10697,3575859310,3575859313,3
0,640,10698,3575859310,3575859316,6
0,640,10699,3575859310,3575859318,8
0,640,10700,3575859310,3575859318,8
0,640,10701,3575859310,3575859319,9
0,640,10702,3575859310,3575859320,10
0,640,10703,3575859310,3575859322,12
0,640,10704,3575859310,3575859323,13
0,640,10705,3575859310,3575859325,15
0,640,10706,3575859310,3575859326,16
0,640,10707,3575859310,3575859326,16
0,640,10708,3575859310,3575859326,16
0,640,10709,3575859310,3575859327,17
0,640,10710,3575859310,3575859328,18
0,640,10711,3575859310,3575859330,20
0,640,10712,3575859310,3575859333,23
0,640,10713,3575859310,3575859334,24
0,640,10714,3575859310,3575859335,25
0,640,10715,3575859310,3575859336,26
0,640,10716,3575859310,3575859337,27
0,640,10717,3575859310,3575859337,27
0,640,10718,3575859310,3575859338,28
0,640,10719,3575859310,3575859338,28
0,640,10720,3575859310,3575859338,28
0,640,10721,3575859310,3575859338,28
0,640,10722,3575859310,3575859340,30
0,640,10723,3575859310,3575859342,32
0,640,10724,3575859310,3575859343,33
0,640,10725,3575859310,3575859343,33
0,640,10726,3575859310,3575859345,35
0,640,10727,3575859310,3575859348,38
0,640,10728,3575859310,3575859348,38
0,640,10729,3575859310,3575859350,40
0,640,10730,3575859310,3575859350,40
0,640,10731,3575859310,3575859350,40
0,640,10732,3575859310,3575859352,42
0,640,10733,3575859310,3575859354,44
0,640,10734,3575859310,3575859355,45
0,640,10735,3575859310,3575859356,46
0,640,10736,3575859310,3575859358,48
0,640,10737,3575859310,3575859358,48
0,640,10738,3575859310,3575859359,49
0,641,10739,3575859365,3575859365,0
0,641,10740,3575859365,3575859365,0
0,641,10741,3575859365,3575859365,0
0,641,10742,3575859365,3575859365,0
0,641,10743,3575859365,3575859366,1
0,641,10744,3575859365,3575859372,7
0,641,10745,3575859365,3575859373,8
0,641,10746,3575859365,3575859374,9
0,641,10747,3575859365,3575859375,10
0,641,10748,3575859365,3575859375,10
0,641,10749,3575859365,3575859376,11
0,641,10750,3575859365,3575859377,12
0,641,10751,3575859365,3575859377,12
0,641,10752,3575859365,3575859378,13
0,641,10753,3575859365,3575859380,15
0,641,10754,3575859365,3575859384,19
0,641,10755,3575859365,3575859386,21
0,641,10756,3575859365,3575859387,22
0,641,10757,3575859365,3575859392,27
0,641,10758,3575859365,3575859394,29
0,641,10759,3575859365,3575859398,33
0,641,10760,3575859365,3575859399,34
0,641,10761,3575859365,3575859399,34
0,641,10762,3575859365,3575859400,35
0,641,10763,3575859365,3575859402,37
0,641,10764,3575859365,3575859405,40
0,641,10765,3575859365,3575859406,41
0,641,10766,3575859365,3575859407,42
0,641,10767,3575859365,3575859409,44
0,641,10768,3575859365,3575859409,44
0,641,10769,3575859365,3575859414,49
0,641,10770,3575859365,3575859415,50
0,642,10771,3575859419,3575859419,0
0,642,10772,3575859419,3575859422,3
0,642,10773,3575859419,3575859427,8
0,642,10774,3575859419,3575859428,9
0,642,10775,3575859419,3575859429,10
0,642,10776,3575859419,3575859432,13
0,642,10777,3575859419,3575859433,14
0,642,10778,3575859419,3575859435,16
0,642,10779,3575859419,3575859435,16
0,642,10780,3575859419,3575859435,16
0,642,10781,3575859419,3575859438,19
0,642,10782,3575859419,3575859442,23
0,642,10783,3575859419,3575859442,23
0,642,10784,3575859419,3575859443,24
0,642,10785,3575859419,3575859444,25
0,642,10786,3575859419,3575859446,27
0,642,10787,3575859419,3575859447,28
0,642,10788,3575859419,3575859448,29
0,642,10789,3575859419,3575859449,30
0,642,10790,3575859419,3575859449,30
0,642,10791,3575859419,3575859455,36
0,642,10792,3575859419,3575859457,38
0,642,10793,3575859419,3575859460,41
0,642,10794,3575859419,3575859461,42
0,642,10795,3575859419,3575859461,42
0,642,10796,3575859419,3575859461,42
0,642,10797,3575859419,3575859463,44
0,642,10798,3575859419,3575859465,46
0,642,10799,3575859419,3575859467,48
0,642,10800,3575859419,3575859467,48
0,643,10801,3575859476,3575859476,0
0,643,10802,3575859476,3575859477,1
0,643,10803,3575859476,3575859478,2
0,643,10804,3575859476,3575859479,3
0,643,10805,3575859476,3575859479,3
0,643,10806,3575859476,3575859481,5
0,643,10807,3575859476,3575859482,6
0,643,10808,3575859476,3575859483,7
0,643,10809,3575859476,3575859487,11
0,643,10810,3575859476,3575859487,11
0,643,10811,3575859476,3575859487,11
0,643,10812,3575859476,3575859488,12
0,643,10813,3575859476,3575859488,12
0,643,10814,3575859476,3575859489,13
0,643,10815,3575859476,3575859489,13
0,643,10816,3575859476,3575859489,13
0,643,10817,3575859476,3575859491,15
0,643,10818,3575859476,3575859491,15
0,643,10819,3575859476,3575859492,16
0,643,10820,3575859476,3575859492,16
0,643,10821,3575859476,3575859494,18
0,643,10822,3575859476,3575859494,18
0,643,10823,3575859476,3575859495,19
0,643,10824,3575859476,3575859496,20
0,643,10825,3575859476,3575859497,21
0,643,10826,3575859476,3575859497,21
0,643,10827,3575859476,3575859500,24
0,643,10828,3575859476,3575859500,24
0,643,10829,3575859476,3575859501,25
0,643,10830,3575859476,3575859502,26
0,643,10831,3575859476,3575859504,28
0,643,10832,3575859476,3575859504,28
0,643,10833,3575859476,3575859506,30
0,643,10834,3575859476,3575859507,31
0,643,10835,3575859476,3575859508,32
0,643,10836,3575859476,3575859509,33
0,643,10837,3575859476,3575859510,34
0,643,10838,3575859476,3575859512,36
0,643,10839,3575859476,3575859513,37
0,643,10840,3575859476,3575859515,39
0,643,10841,3575859476,3575859516,40
0,643,10842,3575859476,3575859518,42
0,643,10843,3575859476,3575859518,42
0,643,10844,3575859476,3575859519,43
0,643,10845,3575859476,3575859521,45
0,643,10846,3575859476,3575859522,46
0,643,10847,3575859476,3575859524,48
0,643,10848,3575859476,3575859525,49
0,643,10849,3575859476,3575859525,49
0,643,10850,3575859476,3575859526,50
0,644,10851,3575859532,3575859532,0
0,644,10852,3575859532,3575859532,0
0,644,10853,3575859532,3575859532,0
0,644,10854,3575859532,3575859532,0
0,644,10855,3575859532,3575859533,1
0,644,10856,3575859532,3575859533,1
0,644,10857,3575859532,3575859535,3
0,644,10858,3575859532,3575859535,3
0,644,10859,3575859532,3575859536,4
0,644,10860,3575859532,3575859536,4
0,644,10861,3575859532,3575859536,4
0,644,10862,3575859532,3575859537,5
0,644,10863,3575859532,3575859538,6
0,644,10864,3575859532,3575859538,6
0,644,10865,3575859532,3575859539,7
0,644,10866,3575859532,3575859541,9
0,644,10867,3575859532,3575859542,10
0,644,10868,3575859532,3575859542,10
0,644,10869,3575859532,3575859544,12
0,644,10870,3575859532,3575859547,15
0,644,10871,3575859532,3575859548,16
0,644,10872,3575859532,3575859548,16
0,644,10873,3575859532,3575859549,17
0,644,10874,3575859532,3575859550,18
0,644,10875,3575859532,3575859551,19
0,644,10876,3575859532,3575859553,21
0,644,10877,3575859532,3575859554,22
0,644,10878,3575859532,3575859554,22
0,644,10879,3575859532,3575859556,24
0,644,10880,3575859532,3575859559,27
0,644,10881,3575859532,3575859561,29
0,644,10882,3575859532,3575859561,29
0,644,10883,3575859532,3575859561,29
0,644,10884,3575859532,3575859561,29
0,644,10885,3575859532,3575859564,32
0,644,10886,3575859532,3575859566,34
0,644,10887,3575859532,3575859567,35
0,644,10888,3575859532,3575859570,38
0,644,10889,3575859532,3575859572,40
0,644,10890,3575859532,3575859572,40
0,644,10891,3575859532,3575859574,42
0,644,10892,3575859532,3575859574,42
0,644,10893,3575859532,3575859575,43
0,644,10894,3575859532,3575859576,44
0,644,10895,3575859532,3575859576,44
0,644,10896,3575859532,3575859577,45
0,644,10897,3575859532,3575859577,45
0,644,10898,3575859532,3575859578,46
0,644,10899,3575859532,3575859580,48
0,645,10900,3575859587,3575859587,0
0,645,10901,3575859587,3575859587,0
0,645,10902,3575859587,3575859587,0
0,645,10903,3575859587,3575859587,0
0,645,10904,3575859587,3575859590,3
0,645,10905,3575859587,3575859593,6
0,645,10906,3575859587,3575859594,7
0,645,10907,3575859587,3575859597,10
0,645,10908,3575859587,3575859598,11
0,645,10909,3575859587,3575859598,11
0,645,10910,3575859587,3575859600,13
0,645,10911,3575859587,3575859601,14
0,645,10912,3575859587,3575859605,18
0,645,10913,3575859587,3575859605,18
0,645,10914,3575859587,3575859606,19
0,645,10915,3575859587,3575859608,21
0,645,10916,3575859587,3575859609,22
0,645,10917,3575859587,3575859613,26
0,645,10918,3575859587,3575859614,27
0,645,10919,3575859587,3575859614,27
0,645,10920,3575859587,3575859615,28
0,645,10921,3575859587,3575859620,33
0,645,10922,3575859587,3575859622,35
0,645,10923,3575859587,3575859626,39
0,645,10924,3575859587,3575859628,41
0,645,10925,3575859587,3575859628,41
0,645,10926,3575859587,3575859631,44
0,645,10927,3575859587,3575859633,46
0,645,10928,3575859587,3575859634,47
0,645,10929,3575859587,3575859634,47
0,645,10930,3575859587,3575859635,48
0,646,10931,3575859642,3575859642,0
0,646,10932,3575859642,3575859642,0
0,646,10933,3575859642,3575859642,0
0,646,10934,3575859642,3575859643,1
0,646,10935,3575859642,3575859643,1
0,646,10936,3575859642,3575859646,4
0,646,10937,3575859642,3575859647,5
0,646,10938,3575859642,3575859648,6
0,646,10939,3575859642,3575859654,12
0,646,10940,3575859642,3575859656,14
0,646,10941,3575859642,3575859659,17
0,646,10942,3575859642,3575859659,17
0,646,10943,3575859642,3575859660,18
0,646,10944,3575859642,3575859661,19
0,646,10945,3575859642,3575859663,21
0,646,10946,3575859642,3575859664,22
0,646,10947,3575859642,3575859664,22
0,646,10948,3575859642,3575859666,24
0,646,10949,3575859642,3575859667,25
0,646,10950,3575859642,3575859669,27
0,646,10951,3575859642,3575859677,35
0,646,10952,3575859642,3575859678,36
0,646,10953,3575859642,3575859679,37
0,646,10954,3575859642,3575859679,37
0,646,10955,3575859642,3575859681,39
0,646,10956,3575859642,3575859682,40
0,646,10957,3575859642,3575859683,41
0,646,10958,3575859642,3575859687,45
0,646,10959,3575859642,3575859687,45
0,646,10960,3575859642,3575859688,46
0,646,10961,3575859642,3575859689,47
0,646,10962,3575859642,3575859689,47
0,646,10963,3575859642,3575859689,47
0,646,10964,3575859642,3575859690,48
0,646,10965,3575859642,3575859691,49
0,646,10966,3575859642,3575859691,49
0,647,10967,3575859696,3575859696,0
0,647,10968,3575859696,3575859696,0
0,647,10969,3575859696,3575859696,0
0,647,10970,3575859696,3575859696,0
0,647,10971,3575859696,3575859697,1
0,647,10972,3575859696,3575859697,1
0,647,10973,3575859696,3575859698,2
0,647,10974,3575859696,3575859700,4
0,647,10975,3575859696,3575859701,5
0,647,10976,3575859696,3575859701,5
0,647,10977,3575859696,3575859702,6
0,647,10978,3575859696,3575859706,10
0,647,10979,3575859696,3575859707,11
0,647,10980,3575859696,3575859708,12
0,647,10981,3575859696,3575859708,12
0,647,10982,3575859696,3575859711,15
0,647,10983,3575859696,3575859712,16
0,647,10984,3575859696,3575859715,19
0,647,10985,3575859696,3575859718,22
0,647,10986,3575859696,3575859719,23
0,647,10987,3575859696,3575859719,23
0,647,10988,3575859696,3575859719,23
0,647,10989,3575859696,3575859721,25
0,647,10990,3575859696,3575859723,27
0,647,10991,3575859696,3575859724,28
0,647,10992,3575859696,3575859725,29
0,647,10993,3575859696,3575859725,29
0,647,10994,3575859696,3575859725,29
0,647,10995,3575859696,3575859726,30
0,647,10996,3575859696,3575859726,30
0,647,10997,3575859696,3575859728,32
0,647,10998,3575859696,3575859729,33
0,647,10999,3575859696,3575859729,33
0,647,11000,3575859696,3575859732,36
0,647,11001,3575859696,3575859734,38
0,647,11002,3575859696,3575859735,39
0,647,11003,3575859696,3575859735,39
0,647,11004,3575859696,3575859736,40
0,647,11005,3575859696,3575859736,40
0,647,11006,3575859696,3575859736,40
0,647,11007,3575859696,3575859737,41
0,647,11008,3575859696,3575859737,41
0,647,11009,3575859696,3575859738,42
0,647,11010,3575859696,3575859738,42
0,647,11011,3575859696,3575859740,44
0,647,11012,3575859696,3575859741,45
0,647,11013,3575859696,3575859741,45
0,647,11014,3575859696,3575859742,46
0,647,11015,3575859696,3575859744,48
0,648,11016,3575859753,3575859753,0
0,648,11017,3575859753,3575859753,0
0,648,11018,3575859753,3575859753,0
0,648,11019,3575859753,3575859753,0
0,648,11020,3575859753,3575859753,0
0,648,11021,3575859753,3575859753,0
0,648,11022,3575859753,3575859754,1
0,648,11023,3575859753,3575859755,2
0,648,11024,3575859753,3575859755,2
0,648,11025,3575859753,3575859757,4
0,648,11026,3575859753,3575859757,4
0,648,11027,3575859753,3575859759,6
0,648,11028,3575859753,3575859761,8
0,648,11029,3575859753,3575859762,9
0,648,11030,3575859753,3575859762,9
0,648,11031,3575859753,3575859763,10
0,648,11032,3575859753,3575859764,11
0,648,11033,3575859753,3575859764,11
0,648,11034,3575859753,3575859765,12
0,648,11035,3575859753,3575859766,13
0,648,11036,3575859753,3575859767,14
0,648,11037,3575859753,3575859770,17
0,648,11038,3575859753,3575859772,19
0,648,11039,3575859753,3575859773,20
0,648,11040,3575859753,3575859773,20
0,648,11041,3575859753,3575859774,21
0,648,11042,3575859753,3575859776,23
0,648,11043,3575859753,3575859776,23
0,648,11044,3575859753,3575859776,23
0,648,11045,3575859753,3575859777,24
0,648,11046,3575859753,3575859777,24
0,648,11047,3575859753,3575859778,25
0,648,11048,3575859753,3575859783,30
0,648,11049,3575859753,3575859785,32
0,648,11050,3575859753,3575859786,33
0,648,11051,3575859753,3575859786,33
0,648,11052,3575859753,3575859793,40
0,648,11053,3575859753,3575859795,42
0,648,11054,3575859753,3575859797,44
0,648,11055,3575859753,3575859798,45
0,648,11056,3575859753,3575859798,45
0,648,11057,3575859753,3575859799,46
0,648,11058,3575859753,3575859801,48
0,649,11059,3575859808,3575859808,0
0,649,11060,3575859808,3575859808,0
0,649,11061,3575859808,3575859808,0
0,649,11062,3575859808,3575859809,1
0,649,11063,3575859808,3575859814,6
0,649,11064,3575859808,3575859814,6
0,649,11065,3575859808,3575859815,7
0,649,11066,3575859808,3575859816,8
0,649,11067,3575859808,3575859822,14
0,649,11068,3575859808,3575859829,21
0,649,11069,3575859808,3575859829,21
0,649,11070,3575859808,3575859829,21
0,649,11071,3575859808,3575859832,24
0,649,11072,3575859808,3575859833,25
0,649,11073,3575859808,3575859833,25
0,649,11074,3575859808,3575859834,26
0,649,11075,3575859808,3575859836,28
0,649,11076,3575859808,3575859838,30
0,649,11077,3575859808,3575859841,33
0,649,11078,3575859808,3575859841,33
0,649,11079,3575859808,3575859843,35
0,649,11080,3575859808,3575859843,35
0,649,11081,3575859808,3575859845,37
0,649,11082,3575859808,3575859847,39
0,649,11083,3575859808,3575859848,40
0,649,11084,3575859808,3575859854,46
0,649,11085,3575859808,3575859856,48
0,650,11086,3575859866,3575859866,0
0,650,11087,3575859866,3575859866,0
0,650,11088,3575859866,3575859866,0
0,650,11089,3575859866,3575859866,0
0,650,11090,3575859866,3575859866,0
0,650,11091,3575859866,3575859866,0
0,650,11092,3575859866,3575859866,0
0,650,11093,3575859866,3575859866,0
0,650,11094,3575859866,3575859866,0
0,650,11095,3575859866,3575859868,2
0,650,11096,3575859866,3575859870,4
0,650,11097,3575859866,3575859876,10
0,650,11098,3575859866,3575859877,11
0,650,11099,3575859866,3575859879,13
0,650,11100,3575859866,3575859881,15
0,650,11101,3575859866,3575859882,16
0,650,11102,3575859866,3575859887,21
0,650,11103,3575859866,3575859887,21
0,650,11104,3575859866,3575859888,22
0,650,11105,3575859866,3575859889,23
0,650,11106,3575859866,3575859889,23
0,650,11107,3575859866,3575859889,23
0,650,11108,3575859866,3575859891,25
0,650,11109,3575859866,3575859891,25
0,650,11110,3575859866,3575859891,25
0,650,11111,3575859866,3575859891,25
0,650,11112,3575859866,3575859892,26
0,650,11113,3575859866,3575859894,28
0,650,11114,3575859866,3575859895,29
0,650,11115,3575859866,3575859897,31
0,650,11116,3575859866,3575859897,31
0,650,11117,3575859866,3575859898,32
0,650,11118,3575859866,3575859898,32
0,650,11119,3575859866,3575859900,34
0,650,11120,3575859866,3575859901,35
0,650,11121,3575859866,3575859902,36
0,650,11122,3575859866,3575859904,38
0,650,11123,3575859866,3575859907,41
0,650,11124,3575859866,3575859907,41
0,650,11125,3575859866,3575859907,41
0,650,11126,3575859866,3575859912,46
0,650,11127,3575859866,3575859912,46
0,650,11128,3575859866,3575859915,49
0,651,11129,3575859922,3575859922,0
0,651,11130,3575859922,3575859922,0
0,651,11131,3575859922,3575859922,0
0,651,11132,3575859922,3575859922,0
0,651,11133,3575859922,3575859922,0
0,651,11134,3575859922,3575859922,0
0,651,11135,3575859922,3575859922,0
0,651,11136,3575859922,3575859922,0
0,651,11137,3575859922,3575859925,3
0,651,11138,3575859922,3575859925,3
0,651,11139,3575859922,3575859925,3
0,651,11140,3575859922,3575859926,4
0,651,11141,3575859922,3575859926,4
0,651,11142,3575859922,3575859926,4
0,651,11143,3575859922,3575859928,6
0,651,11144,3575859922,3575859929,7
0,651,11145,3575859922,3575859932,10
0,651,11146,3575859922,3575859934,12
0,651,11147,3575859922,3575859935,13
0,651,11148,3575859922,3575859935,13
0,651,11149,3575859922,3575859936,14
0,651,11150,3575859922,3575859936,14
0,651,11151,3575859922,3575859936,14
0,651,11152,3575859922,3575859937,15
0,651,11153,3575859922,3575859938,16
0,651,11154,3575859922,3575859942,20
0,651,11155,3575859922,3575859943,21
0,651,11156,3575859922,3575859944,22
0,651,11157,3575859922,3575859944,22
0,651,11158,3575859922,3575859947,25
0,651,11159,3575859922,3575859947,25
0,651,11160,3575859922,3575859950,28
0,651,11161,3575859922,3575859952,30
0,651,11162,3575859922,3575859953,31
0,651,11163,3575859922,3575859954,32
0,651,11164,3575859922,3575859956,34
0,651,11165,3575859922,3575859956,34
0,651,11166,3575859922,3575859957,35
0,651,11167,3575859922,3575859958,36
0,651,11168,3575859922,3575859959,37
0,651,11169,3575859922,3575859961,39
0,651,11170,3575859922,3575859962,40
0,651,11171,3575859922,3575859962,40
0,651,11172,3575859922,3575859963,41
0,651,11173,3575859922,3575859963,41
0,651,11174,3575859922,3575859965,43
0,651,11175,3575859922,3575859966,44
0,651,11176,3575859922,3575859966,44
0,651,11177,3575859922,3575859967,45
0,651,11178,3575859922,3575859971,49
0,652,11179,3575859977,3575859977,0
0,652,11180,3575859977,3575859977,0
0,652,11181,3575859977,3575859977,0
0,652,11182,3575859977,3575859977,0
0,652,11183,3575859977,3575859977,0
0,652,11184,3575859977,3575859977,0
0,652,11185,3575859977,3575859977,0
0,652,11186,3575859977,3575859977,0
0,652,11187,3575859977,3575859978,1
0,652,11188,3575859977,3575859983,6
0,652,11189,3575859977,3575859984,7
0,652,11190,3575859977,3575859986,9
0,652,11191,3575859977,3575859986,9
0,652,11192,3575859977,3575859991,14
0,652,11193,3575859977,3575859994,17
0,652,11194,3575859977,3575859995,18
0,652,11195,3575859977,3575859997,20
0,652,11196,3575859977,3575859998,21
0,652,11197,3575859977,3575859999,22
0,652,11198,3575859977,3575859999,22
0,652,11199,3575859977,3575860002,25
0,652,11200,3575859977,3575860005,28
0,652,11201,3575859977,3575860006,29
0,652,11202,3575859977,3575860006,29
0,652,11203,3575859977,3575860009,32
0,652,11204,3575859977,3575860013,36
0,652,11205,3575859977,3575860015,38
0,652,11206,3575859977,3575860017,40
0,652,11207,3575859977,3575860017,40
0,652,11208,3575859977,3575860018,41
0,652,11209,3575859977,3575860021,44
0,652,11210,3575859977,3575860022,45
0,652,11211,3575859977,3575860027,50
0,653,11212,3575860033,3575860033,0
0,653,11213,3575860033,3575860033,0
0,653,11214,3575860033,3575860033,0
0,653,11215,3575860033,3575860033,0
0,653,11216,3575860033,3575860033,0
0,653,11217,3575860033,3575860034,1
0,653,11218,3575860033,3575860034,1
0,653,11219,3575860033,3575860035,2
0,653,11220,3575860033,3575860037,4
0,653,11221,3575860033,3575860037,4
0,653,11222,3575860033,3575860042,9
0,653,11223,3575860033,3575860042,9
0,653,11224,3575860033,3575860043,10
0,653,11225,3575860033,3575860047,14
0,653,11226,3575860033,3575860048,15
0,653,11227,3575860033,3575860048,15
0,653,11228,3575860033,3575860048,15
0,653,11229,3575860033,3575860055,22
0,653,11230,3575860033,3575860057,24
0,653,11231,3575860033,3575860059,26
0,653,11232,3575860033,3575860060,27
0,653,11233,3575860033,3575860061,28
0,653,11234,3575860033,3575860062,29
0,653,11235,3575860033,3575860064,31
0,653,11236,3575860033,3575860064,31
0,653,11237,3575860033,3575860066,33
0,653,11238,3575860033,3575860066,33
0,653,11239,3575860033,3575860070,37
0,653,11240,3575860033,3575860070,37
0,653,11241,3575860033,3575860076,43
0,653,11242,3575860033,3575860078,45
0,653,11243,3575860033,3575860079,46
0,653,11244,3575860033,3575860079,46
0,653,11245,3575860033,3575860080,47
0,653,11246,3575860033,3575860082,49
0,654,11247,3575860090,3575860090,0
0,654,11248,3575860090,3575860090,0
0,654,11249,3575860090,3575860090,0
0,654,11250,3575860090,3575860090,0
0,654,11251,3575860090,3575860090,0
0,654,11252,3575860090,3575860090,0
0,654,11253,3575860090,3575860090,0
0,654,11254,3575860090,3575860091,1
0,654,11255,3575860090,3575860091,1
0,654,11256,3575860090,3575860092,2
0,654,11257,3575860090,3575860092,2
0,654,11258,3575860090,3575860094,4
0,654,11259,3575860090,3575860095,5
0,654,11260,3575860090,3575860097,7
0,654,11261,3575860090,3575860097,7
0,654,11262,3575860090,3575860098,8
0,654,11263,3575860090,3575860100,10
0,654,11264,3575860090,3575860101,11
0,654,11265,3575860090,3575860101,11
0,654,11266,3575860090,3575860102,12
0,654,11267,3575860090,3575860107,17
0,654,11268,3575860090,3575860107,17
0,654,11269,3575860090,3575860108,18
0,654,11270,3575860090,3575860110,20
0,654,11271,3575860090,3575860111,21
0,654,11272,3575860090,3575860112,22
0,654,11273,3575860090,3575860115,25
0,654,11274,3575860090,3575860118,28
0,654,11275,3575860090,3575860119,29
0,654,11276,3575860090,3575860119,29
0,654,11277,3575860090,3575860119,29
0,654,11278,3575860090,3575860119,29
0,654,11279,3575860090,3575860121,31
0,654,11280,3575860090,3575860123,33
0,654,11281,3575860090,3575860123,33
0,654,11282,3575860090,3575860125,35
0,654,11283,3575860090,3575860125,35
0,654,11284,3575860090,3575860126,36
0,654,11285,3575860090,3575860126,36
0,654,11286,3575860090,3575860126,36
0,654,11287,3575860090,3575860127,37
0,654,11288,3575860090,3575860129,39
0,654,11289,3575860090,3575860130,40
0,654,11290,3575860090,3575860130,40
0,654,11291,3575860090,3575860133,43
0,654,11292,3575860090,3575860134,44
0,654,11293,3575860090,3575860135,45
0,654,11294,3575860090,3575860136,46
0,654,11295,3575860090,3575860136,46
0,654,11296,3575860090,3575860137,47
0,654,11297,3575860090,3575860137,47
0,654,11298,3575860090,3575860138,48
0,654,11299,3575860090,3575860138,48
0,654,11300,3575860090,3575860139,49
0,655,11301,3575860145,3575860145,0
0,655,11302,3575860145,3575860145,0
0,655,11303,3575860145,3575860145,0
0,655,11304,3575860145,3575860145,0
0,655,11305,3575860145,3575860145,0
0,655,11306,3575860145,3575860147,2
0,655,11307,3575860145,3575860148,3
0,655,11308,3575860145,3575860149,4
0,655,11309,3575860145,3575860151,6
0,655,11310,3575860145,3575860153,8
0,655,11311,3575860145,3575860154,9
0,655,11312,3575860145,3575860154,9
0,655,11313,3575860145,3575860155,10
0,655,11314,3575860145,3575860156,11
0,655,11315,3575860145,3575860158,13
0,655,11316,3575860145,3575860158,13
0,655,11317,3575860145,3575860158,13
0,655,11318,3575860145,3575860161,16
0,655,11319,3575860145,3575860162,17
0,655,11320,3575860145,3575860162,17
0,655,11321,3575860145,3575860164,19
0,655,11322,3575860145,3575860165,20
0,655,11323,3575860145,3575860166,21
0,655,11324,3575860145,3575860166,21
0,655,11325,3575860145,3575860171,26
0,655,11326,3575860145,3575860171,26
0,655,11327,3575860145,3575860172,27
0,655,11328,3575860145,3575860173,28
0,655,11329,3575860145,3575860174,29
0,655,11330,3575860145,3575860174,29
0,655,11331,3575860145,3575860176,31
0,655,11332,3575860145,3575860177,32
0,655,11333,3575860145,3575860177,32
0,655,11334,3575860145,3575860177,32
0,655,11335,3575860145,3575860180,35
0,655,11336,3575860145,3575860183,38
0,655,11337,3575860145,3575860184,39
0,655,11338,3575860145,3575860186,41
0,655,11339,3575860145,3575860187,42
0,655,11340,3575860145,3575860191,46
0,655,11341,3575860145,3575860195,50
0,656,11342,3575860201,3575860201,0
0,656,11343,3575860201,3575860201,0
0,656,11344,3575860201,3575860201,0
0,656,11345,3575860201,3575860201,0
0,656,11346,3575860201,3575860201,0
0,656,11347,3575860201,3575860202,1
0,656,11348,3575860201,3575860205,4
0,656,11349,3575860201,3575860206,5
0,656,11350,3575860201,3575860209,8
0,656,11351,3575860201,3575860213,12
0,656,11352,3575860201,3575860215,14
0,656,11353,3575860201,3575860216,15
0,656,11354,3575860201,3575860222,21
0,656,11355,3575860201,3575860223,22
0,656,11356,3575860201,3575860227,26
0,656,11357,3575860201,3575860228,27
0,656,11358,3575860201,3575860229,28
0,656,11359,3575860201,3575860231,30
0,656,11360,3575860201,3575860232,31
0,656,11361,3575860201,3575860234,33
0,656,11362,3575860201,3575860235,34
0,656,11363,3575860201,3575860235,34
0,656,11364,3575860201,3575860237,36
0,656,11365,3575860201,3575860238,37
0,656,11366,3575860201,3575860241,40
0,656,11367,3575860201,3575860244,43
0,656,11368,3575860201,3575860244,43
0,656,11369,3575860201,3575860247,46
0,656,11370,3575860201,3575860248,47
0,656,11371,3575860201,3575860248,47
0,657,11372,3575860256,3575860256,0
0,657,11373,3575860256,3575860257,1
0,657,11374,3575860256,3575860259,3
0,657,11375,3575860256,3575860261,5
0,657,11376,3575860256,3575860261,5
0,657,11377,3575860256,3575860262,6
0,657,11378,3575860256,3575860264,8
0,657,11379,3575860256,3575860265,9
0,657,11380,3575860256,3575860267,11
0,657,11381,3575860256,3575860267,11
0,657,11382,3575860256,3575860270,14
0,657,11383,3575860256,3575860273,17
0,657,11384,3575860256,3575860277,21
0,657,11385,3575860256,3575860278,22
0,657,11386,3575860256,3575860282,26
0,657,11387,3575860256,3575860287,31
0,657,11388,3575860256,3575860287,31
0,657,11389,3575860256,3575860288,32
0,657,11390,3575860256,3575860289,33
0,657,11391,3575860256,3575860289,33
0,657,11392,3575860256,3575860290,34
0,657,11393,3575860256,3575860290,34
0,657,11394,3575860256,3575860291,35
0,657,11395,3575860256,3575860292,36
0,657,11396,3575860256,3575860292,36
0,657,11397,3575860256,3575860293,37
0,657,11398,3575860256,3575860294,38
0,657,11399,3575860256,3575860295,39
0,657,11400,3575860256,3575860297,41
0,657,11401,3575860256,3575860297,41
0,657,11402,3575860256,3575860297,41
0,657,11403,3575860256,3575860298,42
0,657,11404,3575860256,3575860300,44
0,657,11405,3575860256,3575860301,45
0,657,11406,3575860256,3575860301,45
0,657,11407,3575860256,3575860303,47
0,657,11408,3575860256,3575860305,49
0,657,11409,3575860256,3575860305,49
0,658,11410,3575860309,3575860309,0
0,658,11411,3575860309,3575860309,0
0,658,11412,3575860309,3575860309,0
0,658,11413,3575860309,3575860310,1
0,658,11414,3575860309,3575860312,3
0,658,11415,3575860309,3575860316,7
0,658,11416,3575860309,3575860317,8
0,658,11417,3575860309,3575860318,9
0,658,11418,3575860309,3575860319,10
0,658,11419,3575860309,3575860319,10
0,658,11420,3575860309,3575860320,11
0,658,11421,3575860309,3575860320,11
0,658,11422,3575860309,3575860322,13
0,658,11423,3575860309,3575860323,14
0,658,11424,3575860309,3575860323,14
0,658,11425,3575860309,3575860323,14
0,658,11426,3575860309,3575860325,16
0,658,11427,3575860309,3575860325,16
0,658,11428,3575860309,3575860326,17
0,658,11429,3575860309,3575860326,17
0,658,11430,3575860309,3575860326,17
0,658,11431,3575860309,3575860327,18
0,658,11432,3575860309,3575860328,19
0,658,11433,3575860309,3575860329,20
0,658,11434,3575860309,3575860329,20
0,658,11435,3575860309,3575860334,25
0,658,11436,3575860309,3575860334,25
0,658,11437,3575860309,3575860335,26
0,658,11438,3575860309,3575860337,28
0,658,11439,3575860309,3575860337,28
0,658,11440,3575860309,3575860337,28
0,658,11441,3575860309,3575860338,29
0,658,11442,3575860309,3575860338,29
0,658,11443,3575860309,3575860339,30
0,658,11444,3575860309,3575860340,31
0,658,11445,3575860309,3575860342,33
0,658,11446,3575860309,3575860343,34
0,658,11447,3575860309,3575860343,34
0,658,11448,3575860309,3575860344,35
0,658,11449,3575860309,3575860347,38
0,658,11450,3575860309,3575860348,39
0,658,11451,3575860309,3575860348,39
0,658,11452,3575860309,3575860350,41
0,658,11453,3575860309,3575860353,44
0,658,11454,3575860309,3575860354,45
0,658,11455,3575860309,3575860355,46
0,658,11456,3575860309,3575860355,46
0,658,11457,3575860309,3575860358,49
0,658,11458,3575860309,3575860358,49
0,658,11459,3575860309,3575860359,50
0,659,11460,3575860365,3575860365,0
0,659,11461,3575860365,3575860365,0
0,659,11462,3575860365,3575860365,0
0,659,11463,3575860365,3575860366,1
0,659,11464,3575860365,3575860366,1
0,659,11465,3575860365,3575860367,2
0,659,11466,3575860365,3575860372,7
0,659,11467,3575860365,3575860372,7
0,659,11468,3575860365,3575860373,8
0,659,11469,3575860365,3575860373,8
0,659,11470,3575860365,3575860374,9
0,659,11471,3575860365,3575860374,9
0,659,11472,3575860365,3575860376,11
0,659,11473,3575860365,3575860376,11
0,659,11474,3575860365,3575860378,13
0,659,11475,3575860365,3575860378,13
0,659,11476,3575860365,3575860378,13
0,659,11477,3575860365,3575860379,14
0,659,11478,3575860365,3575860383,18
0,659,11479,3575860365,3575860384,19
0,659,11480,3575860365,3575860387,22
0,659,11481,3575860365,3575860387,22
0,659,11482,3575860365,3575860392,27
0,659,11483,3575860365,3575860395,30
0,659,11484,3575860365,3575860396,31
0,659,11485,3575860365,3575860399,34
0,659,11486,3575860365,3575860399,34
0,659,11487,3575860365,3575860399,34
0,659,11488,3575860365,3575860400,35
0,659,11489,3575860365,3575860402,37
0,659,11490,3575860365,3575860405,40
0,659,11491,3575860365,3575860406,41
0,659,11492,3575860365,3575860406,41
0,659,11493,3575860365,3575860409,44
0,659,11494,3575860365,3575860415,50
0,660,11495,3575860420,3575860420,0
0,660,11496,3575860420,3575860420,0
0,660,11497,3575860420,3575860422,2
0,660,11498,3575860420,3575860423,3
0,660,11499,3575860420,3575860425,5
0,660,11500,3575860420,3575860426,6
0,660,11501,3575860420,3575860429,9
0,660,11502,3575860420,3575860430,10
0,660,11503,3575860420,3575860432,12
0,660,11504,3575860420,3575860432,12
0,660,11505,3575860420,3575860434,14
0,660,11506,3575860420,3575860435,15
0,660,11507,3575860420,3575860435,15
0,660,11508,3575860420,3575860436,16
0,660,11509,3575860420,3575860437,17
0,660,11510,3575860420,3575860441,21
0,660,11511,3575860420,3575860443,23
0,660,11512,3575860420,3575860445,25
0,660,11513,3575860420,3575860448,28
0,660,11514,3575860420,3575860448,28
0,660,11515,3575860420,3575860448,28
0,660,11516,3575860420,3575860454,34
0,660,11517,3575860420,3575860457,37
0,660,11518,3575860420,3575860459,39
0,660,11519,3575860420,3575860461,41
0,660,11520,3575860420,3575860462,42
0,660,11521,3575860420,3575860462,42
0,660,11522,3575860420,3575860465,45
0,660,11523,3575860420,3575860466,46
0,660,11524,3575860420,3575860467,47
0,661,11525,3575860475,3575860475,0
0,661,11526,3575860475,3575860475,0
0,661,11527,3575860475,3575860476,1
0,661,11528,3575860475,3575860477,2
0,661,11529,3575860475,3575860478,3
0,661,11530,3575860475,3575860479,4
0,661,11531,3575860475,3575860481,6
0,661,11532,3575860475,3575860486,11
0,661,11533,3575860475,3575860486,11
0,661,11534,3575860475,3575860487,12
0,661,11535,3575860475,3575860488,13
0,661,11536,3575860475,3575860489,14
0,661,11537,3575860475,3575860489,14
0,661,11538,3575860475,3575860490,15
0,661,11539,3575860475,3575860490,15
0,661,11540,3575860475,3575860491,16
0,661,11541,3575860475,3575860491,16
0,661,11542,3575860475,3575860492,17
0,661,11543,3575860475,3575860495,20
0,661,11544,3575860475,3575860496,21
0,661,11545,3575860475,3575860497,22
0,661,11546,3575860475,3575860497,22
0,661,11547,3575860475,3575860498,23
0,661,11548,3575860475,3575860499,24
0,661,11549,3575860475,3575860499,24
0,661,11550,3575860475,3575860501,26
0,661,11551,3575860475,3575860501,26
0,661,11552,3575860475,3575860504,29
0,661,11553,3575860475,3575860504,29
0,661,11554,3575860475,3575860506,31
0,661,11555,3575860475,3575860507,32
0,661,11556,3575860475,3575860507,32
0,661,11557,3575860475,3575860509,34
0,661,11558,3575860475,3575860511,36
0,661,11559,3575860475,3575860512,37
0,661,11560,3575860475,3575860515,40
0,661,11561,3575860475,3575860515,40
0,661,11562,3575860475,3575860518,43
0,661,11563,3575860475,3575860518,43
0,661,11564,3575860475,3575860518,43
0,661,11565,3575860475,3575860519,44
0,661,11566,3575860475,3575860522,47
0,661,11567,3575860475,3575860522,47
0,661,11568,3575860475,3575860523,48
0,661,11569,3575860475,3575860524,49
0,661,11570,3575860475,3575860524,49
0,662,11571,3575860531,3575860531,0
0,662,11572,3575860531,3575860531,0
0,662,11573,3575860531,3575860531,0
0,662,11574,3575860531,3575860531,0
0,662,11575,3575860531,3575860531,0
0,662,11576,3575860531,3575860531,0
0,662,11577,3575860531,3575860531,0
0,662,11578,3575860531,3575860531,0
0,662,11579,3575860531,3575860533,2
0,662,11580,3575860531,3575860533,2
0,662,11581,3575860531,3575860534,3
0,662,11582,3575860531,3575860535,4
0,662,11583,3575860531,3575860536,5
0,662,11584,3575860531,3575860537,6
0,662,11585,3575860531,3575860537,6
0,662,11586,3575860531,3575860537,6
0,662,11587,3575860531,3575860538,7
0,662,11588,3575860531,3575860539,8
0,662,11589,3575860531,3575860541,10
0,662,11590,3575860531,3575860541,10
0,662,11591,3575860531,3575860543,12
0,662,11592,3575860531,3575860545,14
0,662,11593,3575860531,3575860546,15
0,662,11594,3575860531,3575860548,17
0,662,11595,3575860531,3575860550,19
0,662,11596,3575860531,3575860550,19
0,662,11597,3575860531,3575860552,21
0,662,11598,3575860531,3575860553,22
0,662,11599,3575860531,3575860554,23
0,662,11600,3575860531,3575860555,24
0,662,11601,3575860531,3575860556,25
0,662,11602,3575860531,3575860556,25
0,662,11603,3575860531,3575860557,26
0,662,11604,3575860531,3575860558,27
0,662,11605,3575860531,3575860561,30
0,662,11606,3575860531,3575860561,30
0,662,11607,3575860531,3575860562,31
0,662,11608,3575860531,3575860562,31
0,662,11609,3575860531,3575860564,33
0,662,11610,3575860531,3575860565,34
0,662,11611,3575860531,3575860565,34
0,662,11612,3575860531,3575860566,35
0,662,11613,3575860531,3575860572,41
0,662,11614,3575860531,3575860572,41
0,662,11615,3575860531,3575860574,43
0,662,11616,3575860531,3575860575,44
0,662,11617,3575860531,3575860575,44
0,662,11618,3575860531,3575860576,45
0,662,11619,3575860531,3575860577,46
0,662,11620,3575860531,3575860577,46
0,662,11621,3575860531,3575860578,47
0,662,11622,3575860531,3575860579,48
0,663,11623,3575860587,3575860587,0
0,663,11624,3575860587,3575860587,0
0,663,11625,3575860587,3575860587,0
0,663,11626,3575860587,3575860587,0
0,663,11627,3575860587,3575860590,3
0,663,11628,3575860587,3575860594,7
0,663,11629,3575860587,3575860595,8
0,663,11630,3575860587,3575860598,11
0,663,11631,3575860587,3575860598,11
0,663,11632,3575860587,3575860599,12
0,663,11633,3575860587,3575860599,12
0,663,11634,3575860587,3575860602,15
0,663,11635,3575860587,3575860605,18
0,663,11636,3575860587,3575860606,19
0,663,11637,3575860587,3575860608,21
0,663,11638,3575860587,3575860614,27
0,663,11639,3575860587,3575860614,27
0,663,11640,3575860587,3575860615,28
0,663,11641,3575860587,3575860621,34
0,663,11642,3575860587,3575860622,35
0,663,11643,3575860587,3575860625,38
0,663,11644,3575860587,3575860628,41
0,663,11645,3575860587,3575860629,42
0,663,11646,3575860587,3575860630,43
0,663,11647,3575860587,3575860631,44
0,663,11648,3575860587,3575860632,45
0,663,11649,3575860587,3575860633,46
0,663,11650,3575860587,3575860634,47
0,663,11651,3575860587,3575860634,47
0,663,11652,3575860587,3575860636,49
0,663,11653,3575860587,3575860636,49
0,664,11654,3575860644,3575860644,0
0,664,11655,3575860644,3575860644,0
0,664,11656,3575860644,3575860644,0
0,664,11657,3575860644,3575860644,0
0,664,11658,3575860644,3575860646,2
0,664,11659,3575860644,3575860647,3
0,664,11660,3575860644,3575860648,4
0,664,11661,3575860644,3575860654,10
0,664,11662,3575860644,3575860656,12
0,664,11663,3575860644,3575860658,14
0,664,11664,3575860644,3575860660,16
0,664,11665,3575860644,3575860661,17
0,664,11666,3575860644,3575860661,17
0,664,11667,3575860644,3575860663,19
0,664,11668,3575860644,3575860665,21
0,664,11669,3575860644,3575860666,22
0,664,11670,3575860644,3575860666,22
0,664,11671,3575860644,3575860667,23
0,664,11672,3575860644,3575860670,26
0,664,11673,3575860644,3575860676,32
0,664,11674,3575860644,3575860677,33
0,664,11675,3575860644,3575860678,34
0,664,11676,3575860644,3575860680,36
0,664,11677,3575860644,3575860680,36
0,664,11678,3575860644,3575860680,36
0,664,11679,3575860644,3575860681,37
0,664,11680,3575860644,3575860686,42
0,664,11681,3575860644,3575860686,42
0,664,11682,3575860644,3575860687,43
0,664,11683,3575860644,3575860688,44
0,664,11684,3575860644,3575860689,45
0,664,11685,3575860644,3575860689,45
0,664,11686,3575860644,3575860690,46
0,664,11687,3575860644,3575860691,47
0,664,11688,3575860644,3575860692,48
0,664,11689,3575860644,3575860692,48
0,665,11690,3575860700,3575860700,0
0,665,11691,3575860700,3575860700,0
0,665,11692,3575860700,3575860700,0
0,665,11693,3575860700,3575860700,0
0,665,11694,3575860700,3575860700,0
0,665,11695,3575860700,3575860700,0
0,665,11696,3575860700,3575860700,0
0,665,11697,3575860700,3575860701,1
0,665,11698,3575860700,3575860702,2
0,665,11699,3575860700,3575860704,4
0,665,11700,3575860700,3575860704,4
0,665,11701,3575860700,3575860706,6
0,665,11702,3575860700,3575860708,8
0,665,11703,3575860700,3575860708,8
0,665,11704,3575860700,3575860709,9
0,665,11705,3575860700,3575860712,12
0,665,11706,3575860700,3575860712,12
0,665,11707,3575860700,3575860715,15
0,665,11708,3575860700,3575860717,17
0,665,11709,3575860700,3575860718,18
0,665,11710,3575860700,3575860719,19
0,665,11711,3575860700,3575860719,19
0,665,11712,3575860700,3575860719,19
0,665,11713,3575860700,3575860722,22
0,665,11714,3575860700,3575860722,22
0,665,11715,3575860700,3575860723,23
0,665,11716,3575860700,3575860725,25
0,665,11717,3575860700,3575860725,25
0,665,11718,3575860700,3575860726,26
0,665,11719,3575860700,3575860726,26
0,665,11720,3575860700,3575860726,26
0,665,11721,3575860700,3575860726,26
0,665,11722,3575860700,3575860727,27
0,665,11723,3575860700,3575860728,28
0,665,11724,3575860700,3575860728,28
0,665,11725,3575860700,3575860733,33
0,665,11726,3575860700,3575860734,34
0,665,11727,3575860700,3575860735,35
0,665,11728,3575860700,3575860735,35
0,665,11729,3575860700,3575860735,35
0,665,11730,3575860700,3575860736,36
0,665,11731,3575860700,3575860736,36
0,665,11732,3575860700,3575860737,37
0,665,11733,3575860700,3575860737,37
0,665,11734,3575860700,3575860738,38
0,665,11735,3575860700,3575860739,39
0,665,11736,3575860700,3575860742,42
0,665,11737,3575860700,3575860742,42
0,665,11738,3575860700,3575860742,42
0,665,11739,3575860700,3575860745,45
0,665,11740,3575860700,3575860747,47
0,665,11741,3575860700,3575860748,48
0,666,11742,3575860756,3575860756,0
0,666,11743,3575860756,3575860756,0
0,666,11744,3575860756,3575860756,0
0,666,11745,3575860756,3575860756,0
0,666,11746,3575860756,3575860756,0
0,666,11747,3575860756,3575860756,0
0,666,11748,3575860756,3575860757,1
0,666,11749,3575860756,3575860757,1
0,666,11750,3575860756,3575860758,2
0,666,11751,3575860756,3575860759,3
0,666,11752,3575860756,3575860762,6
0,666,11753,3575860756,3575860762,6
0,666,11754,3575860756,3575860763,7
0,666,11755,3575860756,3575860764,8
0,666,11756,3575860756,3575860765,9
0,666,11757,3575860756,3575860765,9
0,666,11758,3575860756,3575860770,14
0,666,11759,3575860756,3575860772,16
0,666,11760,3575860756,3575860772,16
0,666,11761,3575860756,3575860773,17
0,666,11762,3575860756,3575860774,18
0,666,11763,3575860756,3575860775,19
0,666,11764,3575860756,3575860775,19
0,666,11765,3575860756,3575860776,20
0,666,11766,3575860756,3575860777,21
0,666,11767,3575860756,3575860778,22
0,666,11768,3575860756,3575860780,24
0,666,11769,3575860756,3575860782,26
0,666,11770,3575860756,3575860782,26
0,666,11771,3575860756,3575860783,27
0,666,11772,3575860756,3575860786,30
0,666,11773,3575860756,3575860786,30
0,666,11774,3575860756,3575860790,34
0,666,11775,3575860756,3575860795,39
0,666,11776,3575860756,3575860797,41
0,666,11777,3575860756,3575860798,42
0,666,11778,3575860756,3575860800,44
0,666,11779,3575860756,3575860800,44
0,666,11780,3575860756,3575860802,46
0,666,11781,3575860756,3575860806,50
0,667,11782,3575860813,3575860813,0
0,667,11783,3575860813,3575860813,0
0,667,11784,3575860813,3575860813,0
0,667,11785,3575860813,3575860814,1
0,667,11786,3575860813,3575860816,3
0,667,11787,3575860813,3575860817,4
0,667,11788,3575860813,3575860822,9
0,667,11789,3575860813,3575860828,15
0,667,11790,3575860813,3575860829,16
0,667,11791,3575860813,3575860831,18
0,667,11792,3575860813,3575860832,19
0,667,11793,3575860813,3575860832,19
0,667,11794,3575860813,3575860833,20
0,667,11795,3575860813,3575860833,20
0,667,11796,3575860813,3575860834,21
0,667,11797,3575860813,3575860834,21
0,667,11798,3575860813,3575860837,24
0,667,11799,3575860813,3575860841,28
0,667,11800,3575860813,3575860841,28
0,667,11801,3575860813,3575860842,29
0,667,11802,3575860813,3575860844,31
0,667,11803,3575860813,3575860847,34
0,667,11804,3575860813,3575860847,34
0,667,11805,3575860813,3575860853,40
0,667,11806,3575860813,3575860856,43
0,667,11807,3575860813,3575860858,45
0,667,11808,3575860813,3575860861,48
0,667,11809,3575860813,3575860861,48
0,667,11810,3575860813,3575860861,48
0,668,11811,3575860869,3575860869,0
0,668,11812,3575860869,3575860869,0
0,668,11813,3575860869,3575860869,0
0,668,11814,3575860869,3575860869,0
0,668,11815,3575860869,3575860870,1
0,668,11816,3575860869,3575860877,8
0,668,11817,3575860869,3575860877,8
0,668,11818,3575860869,3575860878,9
0,668,11819,3575860869,3575860880,11
0,668,11820,3575860869,3575860881,12
0,668,11821,3575860869,3575860881,12
0,668,11822,3575860869,3575860883,14
0,668,11823,3575860869,3575860883,14
0,668,11824,3575860869,3575860886,17
0,668,11825,3575860869,3575860886,17
0,668,11826,3575860869,3575860887,18
0,668,11827,3575860869,3575860887,18
0,668,11828,3575860869,3575860888,19
0,668,11829,3575860869,3575860888,19
0,668,11830,3575860869,3575860890,21
0,668,11831,3575860869,3575860890,21
0,668,11832,3575860869,3575860890,21
0,668,11833,3575860869,3575860892,23
0,668,11834,3575860869,3575860892,23
0,668,11835,3575860869,3575860892,23
0,668,11836,3575860869,3575860894,25
0,668,11837,3575860869,3575860894,25
0,668,11838,3575860869,3575860897,28
0,668,11839,3575860869,3575860897,28
0,668,11840,3575860869,3575860898,29
0,668,11841,3575860869,3575860898,29
0,668,11842,3575860869,3575860900,31
0,668,11843,3575860869,3575860900,31
0,668,11844,3575860869,3575860901,32
0,668,11845,3575860869,3575860902,33
0,668,11846,3575860869,3575860904,35
0,668,11847,3575860869,3575860904,35
0,668,11848,3575860869,3575860906,37
0,668,11849,3575860869,3575860908,39
0,668,11850,3575860869,3575860908,39
0,668,11851,3575860869,3575860909,40
0,668,11852,3575860869,3575860912,43
0,668,11853,3575860869,3575860912,43
0,668,11854,3575860869,3575860915,46
0,668,11855,3575860869,3575860917,48
0,668,11856,3575860869,3575860918,49
0,669,11857,3575860924,3575860924,0
0,669,11858,3575860924,3575860924,0
0,669,11859,3575860924,3575860924,0
0,669,11860,3575860924,3575860924,0
0,669,11861,3575860924,3575860924,0
0,669,11862,3575860924,3575860924,0
0,669,11863,3575860924,3575860925,1
0,669,11864,3575860924,3575860925,1
0,669,11865,3575860924,3575860926,2
0,669,11866,3575860924,3575860926,2
0,669,11867,3575860924,3575860926,2
0,669,11868,3575860924,3575860926,2
0,669,11869,3575860924,3575860927,3
0,669,11870,3575860924,3575860928,4
0,669,11871,3575860924,3575860929,5
0,669,11872,3575860924,3575860930,6
0,669,11873,3575860924,3575860933,9
0,669,11874,3575860924,3575860934,10
0,669,11875,3575860924,3575860934,10
0,669,11876,3575860924,3575860935,11
0,669,11877,3575860924,3575860935,11
0,669,11878,3575860924,3575860936,12
0,669,11879,3575860924,3575860936,12
0,669,11880,3575860924,3575860937,13
0,669,11881,3575860924,3575860938,14
0,669,11882,3575860924,3575860938,14
0,669,11883,3575860924,3575860942,18
0,669,11884,3575860924,3575860943,19
0,669,11885,3575860924,3575860944,20
0,669,11886,3575860924,3575860945,21
0,669,11887,3575860924,3575860947,23
0,669,11888,3575860924,3575860947,23
0,669,11889,3575860924,3575860950,26
0,669,11890,3575860924,3575860952,28
0,669,11891,3575860924,3575860953,29
0,669,11892,3575860924,3575860955,31
0,669,11893,3575860924,3575860956,32
0,669,11894,3575860924,3575860957,33
0,669,11895,3575860924,3575860958,34
0,669,11896,3575860924,3575860959,35
0,669,11897,3575860924,3575860959,35
0,669,11898,3575860924,3575860962,38
0,669,11899,3575860924,3575860962,38
0,669,11900,3575860924,3575860963,39
0,669,11901,3575860924,3575860964,40
0,669,11902,3575860924,3575860965,41
0,669,11903,3575860924,3575860965,41
0,669,11904,3575860924,3575860971,47
0,669,11905,3575860924,3575860972,48
0,669,11906,3575860924,3575860972,48
0,669,11907,3575860924,3575860972,48
0,670,11908,3575860980,3575860980,0
0,670,11909,3575860980,3575860980,0
0,670,11910,3575860980,3575860980,0
0,670,11911,3575860980,3575860980,0
0,670,11912,3575860980,3575860980,0
0,670,11913,3575860980,3575860980,0
0,670,11914,3575860980,3575860980,0
0,670,11915,3575860980,3575860985,5
0,670,11916,3575860980,3575860985,5
0,670,11917,3575860980,3575860985,5
0,670,11918,3575860980,3575860986,6
0,670,11919,3575860980,3575860991,11
0,670,11920,3575860980,3575860994,14
0,670,11921,3575860980,3575860996,16
0,670,11922,3575860980,3575860997,17
0,670,11923,3575860980,3575860998,18
0,670,11924,3575860980,3575860999,19
0,670,11925,3575860980,3575861000,20
0,670,11926,3575860980,3575861003,23
0,670,11927,3575860980,3575861007,27
0,670,11928,3575860980,3575861007,27
0,670,11929,3575860980,3575861008,28
0,670,11930,3575860980,3575861011,31
0,670,11931,3575860980,3575861013,33
0,670,11932,3575860980,3575861014,34
0,670,11933,3575860980,3575861015,35
0,670,11934,3575860980,3575861021,41
0,670,11935,3575860980,3575861022,42
0,670,11936,3575860980,3575861025,45
0,670,11937,3575860980,3575861028,48
0,670,11938,3575860980,3575861030,50
0,671,11939,3575861036,3575861036,0
0,671,11940,3575861036,3575861036,0
0,671,11941,3575861036,3575861036,0
0,671,11942,3575861036,3575861036,0
0,671,11943,3575861036,3575861036,0
0,671,11944,3575861036,3575861036,0
0,671,11945,3575861036,3575861036,0
0,671,11946,3575861036,3575861039,3
0,671,11947,3575861036,3575861040,4
0,671,11948,3575861036,3575861042,6
0,671,11949,3575861036,3575861048,12
0,671,11950,3575861036,3575861048,12
0,671,11951,3575861036,3575861054,18
0,671,11952,3575861036,3575861057,21
0,671,11953,3575861036,3575861058,22
0,671,11954,3575861036,3575861061,25
0,671,11955,3575861036,3575861061,25
0,671,11956,3575861036,3575861062,26
0,671,11957,3575861036,3575861065,29
0,671,11958,3575861036,3575861066,30
0,671,11959,3575861036,3575861067,31
0,671,11960,3575861036,3575861067,31
0,671,11961,3575861036,3575861070,34
0,671,11962,3575861036,3575861076,40
0,671,11963,3575861036,3575861076,40
0,671,11964,3575861036,3575861079,43
0,671,11965,3575861036,3575861079,43
0,671,11966,3575861036,3575861080,44
0,671,11967,3575861036,3575861081,45
0,671,11968,3575861036,3575861081,45
0,671,11969,3575861036,3575861086,50
0,672,11970,3575861092,3575861092,0
0,672,11971,3575861092,3575861092,0
0,672,11972,3575861092,3575861092,0
0,672,11973,3575861092,3575861092,0
0,672,11974,3575861092,3575861092,0
0,672,11975,3575861092,3575861092,0
0,672,11976,3575861092,3575861092,0
0,672,11977,3575861092,3575861092,0
0,672,11978,3575861092,3575861092,0
0,672,11979,3575861092,3575861092,0
0,672,11980,3575861092,3575861093,1
0,672,11981,3575861092,3575861093,1
0,672,11982,3575861092,3575861095,3
0,672,11983,3575861092,3575861096,4
0,672,11984,3575861092,3575861097,5
0,672,11985,3575861092,3575861097,5
0,672,11986,3575861092,3575861098,6
0,672,11987,3575861092,3575861098,6
0,672,11988,3575861092,3575861100,8
0,672,11989,3575861092,3575861101,9
0,672,11990,3575861092,3575861103,11
0,672,11991,3575861092,3575861104,12
0,672,11992,3575861092,3575861104,12
0,672,11993,3575861092,3575861106,14
0,672,11994,3575861092,3575861107,15
0,672,11995,3575861092,3575861107,15
0,672,11996,3575861092,3575861109,17
0,672,11997,3575861092,3575861112,20
0,672,11998,3575861092,3575861113,21
0,672,11999,3575861092,3575861115,23
0,672,12000,3575861092,3575861118,26
0,672,12001,3575861092,3575861118,26
0,672,12002,3575861092,3575861119,27
0,672,12003,3575861092,3575861120,28
0,672,12004,3575861092,3575861120,28
0,672,12005,3575861092,3575861122,30
0,672,12006,3575861092,3575861122,30
0,672,12007,3575861092,3575861123,31
0,672,12008,3575861092,3575861125,33
0,672,12009,3575861092,3575861125,33
0,672,12010,3575861092,3575861126,34
0,672,12011,3575861092,3575861126,34
0,672,12012,3575861092,3575861126,34
0,672,12013,3575861092,3575861126,34
0,672,12014,3575861092,3575861127,35
0,672,12015,3575861092,3575861128,36
0,672,12016,3575861092,3575861129,37
0,672,12017,3575861092,3575861130,38
0,672,12018,3575861092,3575861134,42
0,672,12019,3575861092,3575861134,42
0,672,12020,3575861092,3575861135,43
0,672,12021,3575861092,3575861135,43
0,672,12022,3575861092,3575861136,44
0,672,12023,3575861092,3575861137,45
0,672,12024,3575861092,3575861137,45
0,672,12025,3575861092,3575861139,47
0,672,12026,3575861092,3575861139,47
0,673,12027,3575861147,3575861148,1
0,673,12028,3575861147,3575861148,1
0,673,12029,3575861147,3575861148,1
0,673,12030,3575861147,3575861148,1
0,673,12031,3575861147,3575861148,1
0,673,12032,3575861147,3575861148,1
0,673,12033,3575861147,3575861148,1
0,673,12034,3575861147,3575861149,2
0,673,12035,3575861147,3575861150,3
0,673,12036,3575861147,3575861152,5
0,673,12037,3575861147,3575861154,7
0,673,12038,3575861147,3575861155,8
0,673,12039,3575861147,3575861157,10
0,673,12040,3575861147,3575861157,10
0,673,12041,3575861147,3575861157,10
0,673,12042,3575861147,3575861158,11
0,673,12043,3575861147,3575861159,12
0,673,12044,3575861147,3575861162,15
0,673,12045,3575861147,3575861162,15
0,673,12046,3575861147,3575861164,17
0,673,12047,3575861147,3575861164,17
0,673,12048,3575861147,3575861165,18
0,673,12049,3575861147,3575861166,19
0,673,12050,3575861147,3575861172,25
0,673,12051,3575861147,3575861172,25
0,673,12052,3575861147,3575861173,26
0,673,12053,3575861147,3575861173,26
0,673,12054,3575861147,3575861174,27
0,673,12055,3575861147,3575861176,29
0,673,12056,3575861147,3575861177,30
0,673,12057,3575861147,3575861177,30
0,673,12058,3575861147,3575861178,31
0,673,12059,3575861147,3575861178,31
0,673,12060,3575861147,3575861180,33
0,673,12061,3575861147,3575861184,37
0,673,12062,3575861147,3575861184,37
0,673,12063,3575861147,3575861186,39
0,673,12064,3575861147,3575861187,40
0,673,12065,3575861147,3575861187,40
0,673,12066,3575861147,3575861191,44
0,673,12067,3575861147,3575861194,47
0,673,12068,3575861147,3575861195,48
0,674,12069,3575861202,3575861202,0
0,674,12070,3575861202,3575861202,0
0,674,12071,3575861202,3575861202,0
0,674,12072,3575861202,3575861202,0
0,674,12073,3575861202,3575861203,1
0,674,12074,3575861202,3575861206,4
0,674,12075,3575861202,3575861206,4
0,674,12076,3575861202,3575861207,5
0,674,12077,3575861202,3575861209,7
0,674,12078,3575861202,3575861212,10
0,674,12079,3575861202,3575861213,11
0,674,12080,3575861202,3575861214,12
0,674,12081,3575861202,3575861217,15
0,674,12082,3575861202,3575861218,16
0,674,12083,3575861202,3575861222,20
0,674,12084,3575861202,3575861222,20
0,674,12085,3575861202,3575861226,24
0,674,12086,3575861202,3575861229,27
0,674,12087,3575861202,3575861231,29
0,674,12088,3575861202,3575861232,30
0,674,12089,3575861202,3575861232,30
0,674,12090,3575861202,3575861233,31
0,674,12091,3575861202,3575861234,32
0,674,12092,3575861202,3575861235,33
0,674,12093,3575861202,3575861235,33
0,674,12094,3575861202,3575861235,33
0,674,12095,3575861202,3575861238,36
0,674,12096,3575861202,3575861240,38
0,674,12097,3575861202,3575861240,38
0,674,12098,3575861202,3575861242,40
0,674,12099,3575861202,3575861244,42
0,674,12100,3575861202,3575861248,46
0,674,12101,3575861202,3575861248,46
0,674,12102,3575861202,3575861249,47
0,675,12103,3575861258,3575861258,0
0,675,12104,3575861258,3575861258,0
0,675,12105,3575861258,3575861258,0
0,675,12106,3575861258,3575861261,3
0,675,12107,3575861258,3575861262,4
0,675,12108,3575861258,3575861262,4
0,675,12109,3575861258,3575861266,8
0,675,12110,3575861258,3575861267,9
0,675,12111,3575861258,3575861267,9
0,675,12112,3575861258,3575861271,13
0,675,12113,3575861258,3575861276,18
0,675,12114,3575861258,3575861278,20
0,675,12115,3575861258,3575861279,21
0,675,12116,3575861258,3575861279,21
0,675,12117,3575861258,3575861281,23
0,675,12118,3575861258,3575861281,23
0,675,12119,3575861258,3575861286,28
0,675,12120,3575861258,3575861287,29
0,675,12121,3575861258,3575861287,29
0,675,12122,3575861258,3575861288,30
0,675,12123,3575861258,3575861288,30
0,675,12124,3575861258,3575861289,31
0,675,12125,3575861258,3575861290,32
0,675,12126,3575861258,3575861291,33
0,675,12127,3575861258,3575861291,33
0,675,12128,3575861258,3575861293,35
0,675,12129,3575861258,3575861293,35
0,675,12130,3575861258,3575861294,36
0,675,12131,3575861258,3575861295,37
0,675,12132,3575861258,3575861297,39
0,675,12133,3575861258,3575861297,39
0,675,12134,3575861258,3575861298,40
0,675,12135,3575861258,3575861298,40
0,675,12136,3575861258,3575861299,41
0,675,12137,3575861258,3575861300,42
0,675,12138,3575861258,3575861300,42
0,675,12139,3575861258,3575861301,43
0,675,12140,3575861258,3575861302,44
0,675,12141,3575861258,3575861304,46
0,675,12142,3575861258,3575861304,46
0,675,12143,3575861258,3575861306,48
0,675,12144,3575861258,3575861307,49
0,675,12145,3575861258,3575861308,50
0,676,12146,3575861313,3575861313,0
0,676,12147,3575861313,3575861313,0
0,676,12148,3575861313,3575861313,0
0,676,12149,3575861313,3575861317,4
0,676,12150,3575861313,3575861317,4
0,676,12151,3575861313,3575861318,5
0,676,12152,3575861313,3575861318,5
0,676,12153,3575861313,3575861319,6
0,676,12154,3575861313,3575861319,6
0,676,12155,3575861313,3575861321,8
0,676,12156,3575861313,3575861322,9
0,676,12157,3575861313,3575861322,9
0,676,12158,3575861313,3575861325,12
0,676,12159,3575861313,3575861325,12
0,676,12160,3575861313,3575861326,13
0,676,12161,3575861313,3575861327,14
0,676,12162,3575861313,3575861327,14
0,676,12163,3575861313,3575861328,15
0,676,12164,3575861313,3575861328,15
0,676,12165,3575861313,3575861329,16
0,676,12166,3575861313,3575861330,17
0,676,12167,3575861313,3575861334,21
0,676,12168,3575861313,3575861334,21
0,676,12169,3575861313,3575861335,22
0,676,12170,3575861313,3575861336,23
0,676,12171,3575861313,3575861336,23
0,676,12172,3575861313,3575861337,24
0,676,12173,3575861313,3575861337,24
0,676,12174,3575861313,3575861338,25
0,676,12175,3575861313,3575861339,26
0,676,12176,3575861313,3575861341,28
0,676,12177,3575861313,3575861342,29
0,676,12178,3575861313,3575861343,30
0,676,12179,3575861313,3575861343,30
0,676,12180,3575861313,3575861344,31
0,676,12181,3575861313,3575861345,32
0,676,12182,3575861313,3575861348,35
0,676,12183,3575861313,3575861349,36
0,676,12184,3575861313,3575861350,37
0,676,12185,3575861313,3575861350,37
0,676,12186,3575861313,3575861352,39
0,676,12187,3575861313,3575861354,41
0,676,12188,3575861313,3575861357,44
0,676,12189,3575861313,3575861357,44
0,676,12190,3575861313,3575861359,46
0,676,12191,3575861313,3575861359,46
0,676,12192,3575861313,3575861362,49
0,676,12193,3575861313,3575861362,49
0,677,12194,3575861368,3575861368,0
0,677,12195,3575861368,3575861368,0
0,677,12196,3575861368,3575861368,0
0,677,12197,3575861368,3575861368,0
0,677,12198,3575861368,3575861372,4
0,677,12199,3575861368,3575861372,4
0,677,12200,3575861368,3575861373,5
0,677,12201,3575861368,3575861374,6
0,677,12202,3575861368,3575861374,6
0,677,12203,3575861368,3575861376,8
0,677,12204,3575861368,3575861377,9
0,677,12205,3575861368,3575861378,10
0,677,12206,3575861368,3575861378,10
0,677,12207,3575861368,3575861379,11
0,677,12208,3575861368,3575861379,11
0,677,12209,3575861368,3575861380,12
0,677,12210,3575861368,3575861384,16
0,677,12211,3575861368,3575861384,16
0,677,12212,3575861368,3575861387,19
0,677,12213,3575861368,3575861387,19
0,677,12214,3575861368,3575861390,22
0,677,12215,3575861368,3575861392,24
0,677,12216,3575861368,3575861394,26
0,677,12217,3575861368,3575861396,28
0,677,12218,3575861368,3575861398,30
0,677,12219,3575861368,3575861398,30
0,677,12220,3575861368,3575861400,32
0,677,12221,3575861368,3575861401,33
0,677,12222,3575861368,3575861403,35
0,677,12223,3575861368,3575861406,38
0,677,12224,3575861368,3575861407,39
0,677,12225,3575861368,3575861409,41
0,677,12226,3575861368,3575861412,44
0,677,12227,3575861368,3575861414,46
0,677,12228,3575861368,3575861415,47
0,677,12229,3575861368,3575861417,49
0,678,12230,3575861425,3575861425,0
0,678,12231,3575861425,3575861425,0
0,678,12232,3575861425,3575861425,0
0,678,12233,3575861425,3575861429,4
0,678,12234,3575861425,3575861431,6
0,678,12235,3575861425,3575861433,8
0,678,12236,3575861425,3575861433,8
0,678,12237,3575861425,3575861433,8
0,678,12238,3575861425,3575861435,10
0,678,12239,3575861425,3575861436,11
0,678,12240,3575861425,3575861436,11
0,678,12241,3575861425,3575861438,13
0,678,12242,3575861425,3575861440,15
0,678,12243,3575861425,3575861441,16
0,678,12244,3575861425,3575861443,18
0,678,12245,3575861425,3575861445,20
0,678,12246,3575861425,3575861446,21
0,678,12247,3575861425,3575861448,23
0,678,12248,3575861425,3575861448,23
0,678,12249,3575861425,3575861448,23
0,678,12250,3575861425,3575861454,29
0,678,12251,3575861425,3575861457,32
0,678,12252,3575861425,3575861459,34
0,678,12253,3575861425,3575861461,36
0,678,12254,3575861425,3575861462,37
0,678,12255,3575861425,3575861463,38
0,678,12256,3575861425,3575861465,40
0,678,12257,3575861425,3575861467,42
0,678,12258,3575861425,3575861467,42
0,678,12259,3575861425,3575861468,43
0,678,12260,3575861425,3575861469,44
0,678,12261,3575861425,3575861471,46
0,679,12262,3575861480,3575861480,0
0,679,12263,3575861480,3575861480,0
0,679,12264,3575861480,3575861480,0
0,679,12265,3575861480,3575861480,0
0,679,12266,3575861480,3575861480,0
0,679,12267,3575861480,3575861480,0
0,679,12268,3575861480,3575861480,0
0,679,12269,3575861480,3575861486,6
0,679,12270,3575861480,3575861486,6
0,679,12271,3575861480,3575861486,6
0,679,12272,3575861480,3575861487,7
0,679,12273,3575861480,3575861488,8
0,679,12274,3575861480,3575861489,9
0,679,12275,3575861480,3575861489,9
0,679,12276,3575861480,3575861490,10
0,679,12277,3575861480,3575861491,11
0,679,12278,3575861480,3575861491,11
0,679,12279,3575861480,3575861492,12
0,679,12280,3575861480,3575861492,12
0,679,12281,3575861480,3575861492,12
0,679,12282,3575861480,3575861493,13
0,679,12283,3575861480,3575861494,14
0,679,12284,3575861480,3575861496,16
0,679,12285,3575861480,3575861496,16
0,679,12286,3575861480,3575861497,17
0,679,12287,3575861480,3575861498,18
0,679,12288,3575861480,3575861498,18
0,679,12289,3575861480,3575861499,19
0,679,12290,3575861480,3575861500,20
0,679,12291,3575861480,3575861502,22
0,679,12292,3575861480,3575861503,23
0,679,12293,3575861480,3575861503,23
0,679,12294,3575861480,3575861505,25
0,679,12295,3575861480,3575861507,27
0,679,12296,3575861480,3575861507,27
0,679,12297,3575861480,3575861508,28
0,679,12298,3575861480,3575861510,30
0,679,12299,3575861480,3575861512,32
0,679,12300,3575861480,3575861515,35
0,679,12301,3575861480,3575861517,37
0,679,12302,3575861480,3575861517,37
0,679,12303,3575861480,3575861518,38
0,679,12304,3575861480,3575861518,38
0,679,12305,3575861480,3575861519,39
0,679,12306,3575861480,3575861520,40
0,679,12307,3575861480,3575861520,40
0,679,12308,3575861480,3575861521,41
0,679,12309,3575861480,3575861522,42
0,679,12310,3575861480,3575861524,44
0,679,12311,3575861480,3575861525,45
0,679,12312,3575861480,3575861525,45
0,679,12313,3575861480,3575861525,45
0,679,12314,3575861480,3575861526,46
0,679,12315,3575861480,3575861527,47
0,679,12316,3575861480,3575861527,47
0,679,12317,3575861480,3575861528,48
0,679,12318,3575861480,3575861529,49
0,680,12319,3575861535,3575861535,0
0,680,12320,3575861535,3575861535,0
0,680,12321,3575861535,3575861535,0
0,680,12322,3575861535,3575861535,0
0,680,12323,3575861535,3575861535,0
0,680,12324,3575861535,3575861536,1
0,680,12325,3575861535,3575861537,2
0,680,12326,3575861535,3575861537,2
0,680,12327,3575861535,3575861538,3
0,680,12328,3575861535,3575861538,3
0,680,12329,3575861535,3575861541,6
0,680,12330,3575861535,3575861541,6
0,680,12331,3575861535,3575861542,7
0,680,12332,3575861535,3575861543,8
0,680,12333,3575861535,3575861544,9
0,680,12334,3575861535,3575861545,10
0,680,12335,3575861535,3575861547,12
0,680,12336,3575861535,3575861547,12
0,680,12337,3575861535,3575861549,14
0,680,12338,3575861535,3575861550,15
0,680,12339,3575861535,3575861553,18
0,680,12340,3575861535,3575861555,20
0,680,12341,3575861535,3575861556,21
0,680,12342,3575861535,3575861556,21
0,680,12343,3575861535,3575861557,22
0,680,12344,3575861535,3575861558,23
0,680,12345,3575861535,3575861559,24
0,680,12346,3575861535,3575861561,26
0,680,12347,3575861535,3575861561,26
0,680,12348,3575861535,3575861563,28
0,680,12349,3575861535,3575861564,29
0,680,12350,3575861535,3575861565,30
0,680,12351,3575861535,3575861565,30
0,680,12352,3575861535,3575861571,36
0,680,12353,3575861535,3575861572,37
0,680,12354,3575861535,3575861572,37
0,680,12355,3575861535,3575861574,39
0,680,12356,3575861535,3575861574,39
0,680,12357,3575861535,3575861575,40
0,680,12358,3575861535,3575861576,41
0,680,12359,3575861535,3575861577,42
0,680,12360,3575861535,3575861578,43
0,680,12361,3575861535,3575861578,43
0,680,12362,3575861535,3575861578,43
0,680,12363,3575861535,3575861583,48
0,680,12364,3575861535,3575861583,48
0,681,12365,3575861590,3575861590,0
0,681,12366,3575861590,3575861590,0
0,681,12367,3575861590,3575861590,0
0,681,12368,3575861590,3575861593,3
0,681,12369,3575861590,3575861594,4
0,681,12370,3575861590,3575861595,5
0,681,12371,3575861590,3575861597,7
0,681,12372,3575861590,3575861598,8
0,681,12373,3575861590,3575861599,9
0,681,12374,3575861590,3575861600,10
0,681,12375,3575861590,3575861601,11
0,681,12376,3575861590,3575861605,15
0,681,12377,3575861590,3575861605,15
0,681,12378,3575861590,3575861607,17
0,681,12379,3575861590,3575861608,18
0,681,12380,3575861590,3575861611,21
0,681,12381,3575861590,3575861612,22
0,681,12382,3575861590,3575861614,24
0,681,12383,3575861590,3575861617,27
0,681,12384,3575861590,3575861617,27
0,681,12385,3575861590,3575861620,30
0,681,12386,3575861590,3575861625,35
0,681,12387,3575861590,3575861629,39
0,681,12388,3575861590,3575861630,40
0,681,12389,3575861590,3575861630,40
0,681,12390,3575861590,3575861632,42
0,681,12391,3575861590,3575861632,42
0,681,12392,3575861590,3575861632,42
0,681,12393,3575861590,3575861635,45
0,681,12394,3575861590,3575861635,45
0,681,12395,3575861590,3575861638,48
0,681,12396,3575861590,3575861639,49
0,682,12397,3575861648,3575861648,0
0,682,12398,3575861648,3575861648,0
0,682,12399,3575861648,3575861648,0
0,682,12400,3575861648,3575861648,0
0,682,12401,3575861648,3575861648,0
0,682,12402,3575861648,3575861648,0
0,682,12403,3575861648,3575861648,0
0,682,12404,3575861648,3575861648,0
0,682,12405,3575861648,3575861654,6
0,682,12406,3575861648,3575861656,8
0,682,12407,3575861648,3575861658,10
0,682,12408,3575861648,3575861660,12
0,682,12409,3575861648,3575861661,13
0,682,12410,3575861648,3575861662,14
0,682,12411,3575861648,3575861666,18
0,682,12412,3575861648,3575861667,19
0,682,12413,3575861648,3575861667,19
0,682,12414,3575861648,3575861676,28
0,682,12415,3575861648,3575861678,30
0,682,12416,3575861648,3575861678,30
0,682,12417,3575861648,3575861678,30
0,682,12418,3575861648,3575861679,31
0,682,12419,3575861648,3575861680,32
0,682,12420,3575861648,3575861681,33
0,682,12421,3575861648,3575861684,36
0,682,12422,3575861648,3575861686,38
0,682,12423,3575861648,3575861687,39
0,682,12424,3575861648,3575861687,39
0,682,12425,3575861648,3575861687,39
0,682,12426,3575861648,3575861687,39
0,682,12427,3575861648,3575861690,42
0,682,12428,3575861648,3575861690,42
0,682,12429,3575861648,3575861690,42
0,682,12430,3575861648,3575861691,43
0,682,12431,3575861648,3575861692,44
0,682,12432,3575861648,3575861692,44
0,682,12433,3575861648,3575861693,45
0,682,12434,3575861648,3575861693,45
0,682,12435,3575861648,3575861694,46
0,682,12436,3575861648,3575861696,48
0,682,12437,3575861648,3575861696,48
0,682,12438,3575861648,3575861696,48
0,682,12439,3575861648,3575861696,48
0,682,12440,3575861648,3575861698,50
0,683,12441,3575861704,3575861704,0
0,683,12442,3575861704,3575861704,0
0,683,12443,3575861704,3575861704,0
0,683,12444,3575861704,3575861704,0
0,683,12445,3575861704,3575861704,0
0,683,12446,3575861704,3575861704,0
0,683,12447,3575861704,3575861704,0
0,683,12448,3575861704,3575861705,1
0,683,12449,3575861704,3575861707,3
0,683,12450,3575861704,3575861708,4
0,683,12451,3575861704,3575861712,8
0,683,12452,3575861704,3575861712,8
0,683,12453,3575861704,3575861715,11
0,683,12454,3575861704,3575861717,13
0,683,12455,3575861704,3575861718,14
0,683,12456,3575861704,3575861718,14
0,683,12457,3575861704,3575861718,14
0,683,12458,3575861704,3575861719,15
0,683,12459,3575861704,3575861721,17
0,683,12460,3575861704,3575861721,17
0,683,12461,3575861704,3575861721,17
0,683,12462,3575861704,3575861722,18
0,683,12463,3575861704,3575861724,20
0,683,12464,3575861704,3575861725,21
0,683,12465,3575861704,3575861726,22
0,683,12466,3575861704,3575861726,22
0,683,12467,3575861704,3575861726,22
0,683,12468,3575861704,3575861726,22
0,683,12469,3575861704,3575861727,23
0,683,12470,3575861704,3575861728,24
0,683,12471,3575861704,3575861728,24
0,683,12472,3575861704,3575861730,26
0,683,12473,3575861704,3575861732,28
0,683,12474,3575861704,3575861734,30
0,683,12475,3575861704,3575861734,30
0,683,12476,3575861704,3575861735,31
0,683,12477,3575861704,3575861735,31
0,683,12478,3575861704,3575861736,32
0,683,12479,3575861704,3575861737,33
0,683,12480,3575861704,3575861738,34
0,683,12481,3575861704,3575861738,34
0,683,12482,3575861704,3575861738,34
0,683,12483,3575861704,3575861741,37
0,683,12484,3575861704,3575861741,37
0,683,12485,3575861704,3575861743,39
0,683,12486,3575861704,3575861743,39
0,683,12487,3575861704,3575861744,40
0,683,12488,3575861704,3575861747,43
0,683,12489,3575861704,3575861747,43
0,683,12490,3575861704,3575861747,43
0,683,12491,3575861704,3575861750,46
0,683,12492,3575861704,3575861753,49
0,684,12493,3575861760,3575861760,0
0,684,12494,3575861760,3575861760,0
0,684,12495,3575861760,3575861760,0
0,684,12496,3575861760,3575861760,0
0,684,12497,3575861760,3575861760,0
0,684,12498,3575861760,3575861760,0
0,684,12499,3575861760,3575861761,1
0,684,12500,3575861760,3575861762,2
0,684,12501,3575861760,3575861763,3
0,684,12502,3575861760,3575861765,5
0,684,12503,3575861760,3575861765,5
0,684,12504,3575861760,3575861771,11
0,684,12505,3575861760,3575861771,11
0,684,12506,3575861760,3575861772,12
0,684,12507,3575861760,3575861774,14
0,684,12508,3575861760,3575861775,15
0,684,12509,3575861760,3575861776,16
0,684,12510,3575861760,3575861776,16
0,684,12511,3575861760,3575861777,17
0,684,12512,3575861760,3575861778,18
0,684,12513,3575861760,3575861778,18
0,684,12514,3575861760,3575861778,18
0,684,12515,3575861760,3575861780,20
0,684,12516,3575861760,3575861783,23
0,684,12517,3575861760,3575861783,23
0,684,12518,3575861760,3575861785,25
0,684,12519,3575861760,3575861786,26
0,684,12520,3575861760,3575861790,30
0,684,12521,3575861760,3575861793,33
0,684,12522,3575861760,3575861795,35
0,684,12523,3575861760,3575861797,37
0,684,12524,3575861760,3575861798,38
0,684,12525,3575861760,3575861799,39
0,684,12526,3575861760,3575861800,40
0,684,12527,3575861760,3575861801,41
0,684,12528,3575861760,3575861802,42
0,684,12529,3575861760,3575861805,45
0,684,12530,3575861760,3575861807,47
0,684,12531,3575861760,3575861808,48
0,685,12532,3575861816,3575861816,0
0,685,12533,3575861816,3575861816,0
0,685,12534,3575861816,3575861816,0
0,685,12535,3575861816,3575861817,1
0,685,12536,3575861816,3575861821,5
0,685,12537,3575861816,3575861822,6
0,685,12538,3575861816,3575861826,10
0,685,12539,3575861816,3575861829,13
0,685,12540,3575861816,3575861830,14
0,685,12541,3575861816,3575861830,14
0,685,12542,3575861816,3575861831,15
0,685,12543,3575861816,3575861832,16
0,685,12544,3575861816,3575861833,17
0,685,12545,3575861816,3575861833,17
0,685,12546,3575861816,3575861835,19
0,685,12547,3575861816,3575861835,19
0,685,12548,3575861816,3575861838,22
0,685,12549,3575861816,3575861839,23
0,685,12550,3575861816,3575861842,26
0,685,12551,3575861816,3575861842,26
0,685,12552,3575861816,3575861845,29
0,685,12553,3575861816,3575861847,31
0,685,12554,3575861816,3575861847,31
0,685,12555,3575861816,3575861848,32
0,685,12556,3575861816,3575861851,35
0,685,12557,3575861816,3575861854,38
0,685,12558,3575861816,3575861856,40
0,685,12559,3575861816,3575861861,45
0,685,12560,3575861816,3575861861,45
0,685,12561,3575861816,3575861862,46
0,685,12562,3575861816,3575861864,48
0,685,12563,3575861816,3575861866,50
0,686,12564,3575861871,3575861871,0
0,686,12565,3575861871,3575861871,0
0,686,12566,3575861871,3575861871,0
0,686,12567,3575861871,3575861876,5
0,686,12568,3575861871,3575861877,6
0,686,12569,3575861871,3575861878,7
0,686,12570,3575861871,3575861879,8
0,686,12571,3575861871,3575861880,9
0,686,12572,3575861871,3575861881,10
0,686,12573,3575861871,3575861884,13
0,686,12574,3575861871,3575861885,14
0,686,12575,3575861871,3575861886,15
0,686,12576,3575861871,3575861886,15
0,686,12577,3575861871,3575861887,16
0,686,12578,3575861871,3575861888,17
0,686,12579,3575861871,3575861889,18
0,686,12580,3575861871,3575861890,19
0,686,12581,3575861871,3575861891,20
0,686,12582,3575861871,3575861891,20
0,686,12583,3575861871,3575861892,21
0,686,12584,3575861871,3575861892,21
0,686,12585,3575861871,3575861892,21
0,686,12586,3575861871,3575861893,22
0,686,12587,3575861871,3575861894,23
0,686,12588,3575861871,3575861896,25
0,686,12589,3575861871,3575861896,25
0,686,12590,3575861871,3575861897,26
0,686,12591,3575861871,3575861897,26
0,686,12592,3575861871,3575861899,28
0,686,12593,3575861871,3575861899,28
0,686,12594,3575861871,3575861900,29
0,686,12595,3575861871,3575861901,30
0,686,12596,3575861871,3575861902,31
0,686,12597,3575861871,3575861903,32
0,686,12598,3575861871,3575861904,33
0,686,12599,3575861871,3575861904,33
0,686,12600,3575861871,3575861905,34
0,686,12601,3575861871,3575861906,35
0,686,12602,3575861871,3575861908,37
0,686,12603,3575861871,3575861908,37
0,686,12604,3575861871,3575861912,41
0,686,12605,3575861871,3575861912,41
0,686,12606,3575861871,3575861917,46
0,686,12607,3575861871,3575861917,46
0,686,12608,3575861871,3575861918,47
0,686,12609,3575861871,3575861919,48
0,686,12610,3575861871,3575861919,48
0,686,12611,3575861871,3575861920,49
0,686,12612,3575861871,3575861921,50
0,686,12613,3575861871,3575861921,50
0,687,12614,3575861926,3575861926,0
0,687,12615,3575861926,3575861926,0
0,687,12616,3575861926,3575861926,0
0,687,12617,3575861926,3575861926,0
0,687,12618,3575861926,3575861926,0
0,687,12619,3575861926,3575861927,1
0,687,12620,3575861926,3575861928,2
0,687,12621,3575861926,3575861930,4
0,687,12622,3575861926,3575861933,7
0,687,12623,3575861926,3575861935,9
0,687,12624,3575861926,3575861935,9
0,687,12625,3575861926,3575861935,9
0,687,12626,3575861926,3575861936,10
0,687,12627,3575861926,3575861937,11
0,687,12628,3575861926,3575861938,12
0,687,12629,3575861926,3575861938,12
0,687,12630,3575861926,3575861941,15
0,687,12631,3575861926,3575861942,16
0,687,12632,3575861926,3575861943,17
0,687,12633,3575861926,3575861944,18
0,687,12634,3575861926,3575861944,18
0,687,12635,3575861926,3575861947,21
0,687,12636,3575861926,3575861947,21
0,687,12637,3575861926,3575861947,21
0,687,12638,3575861926,3575861947,21
0,687,12639,3575861926,3575861950,24
0,687,12640,3575861926,3575861950,24
0,687,12641,3575861926,3575861952,26
0,687,12642,3575861926,3575861953,27
0,687,12643,3575861926,3575861955,29
0,687,12644,3575861926,3575861956,30
0,687,12645,3575861926,3575861957,31
0,687,12646,3575861926,3575861957,31
0,687,12647,3575861926,3575861958,32
0,687,12648,3575861926,3575861961,35
0,687,12649,3575861926,3575861962,36
0,687,12650,3575861926,3575861963,37
0,687,12651,3575861926,3575861964,38
0,687,12652,3575861926,3575861965,39
0,687,12653,3575861926,3575861971,45
0,687,12654,3575861926,3575861971,45
0,687,12655,3575861926,3575861972,46
0,687,12656,3575861926,3575861975,49
0,688,12657,3575861981,3575861981,0
0,688,12658,3575861981,3575861981,0
0,688,12659,3575861981,3575861981,0
0,688,12660,3575861981,3575861981,0
0,688,12661,3575861981,3575861981,0
0,688,12662,3575861981,3575861981,0
0,688,12663,3575861981,3575861981,0
0,688,12664,3575861981,3575861981,0
0,688,12665,3575861981,3575861983,2
0,688,12666,3575861981,3575861986,5
0,688,12667,3575861981,3575861986,5
0,688,12668,3575861981,3575861990,9
0,688,12669,3575861981,3575861994,13
0,688,12670,3575861981,3575861994,13
0,688,12671,3575861981,3575861998,17
0,688,12672,3575861981,3575861998,17
0,688,12673,3575861981,3575862001,20
0,688,12674,3575861981,3575862001,20
0,688,12675,3575861981,3575862002,21
0,688,12676,3575861981,3575862003,22
0,688,12677,3575861981,3575862005,24
0,688,12678,3575861981,3575862005,24
0,688,12679,3575861981,3575862007,26
0,688,12680,3575861981,3575862009,28
0,688,12681,3575861981,3575862013,32
0,688,12682,3575861981,3575862013,32
0,688,12683,3575861981,3575862015,34
0,688,12684,3575861981,3575862016,35
0,688,12685,3575861981,3575862018,37
0,688,12686,3575861981,3575862022,41
0,688,12687,3575861981,3575862022,41
0,688,12688,3575861981,3575862026,45
0,688,12689,3575861981,3575862028,47
0,688,12690,3575861981,3575862030,49
0,689,12691,3575862036,3575862036,0
0,689,12692,3575862036,3575862036,0
0,689,12693,3575862036,3575862036,0
0,689,12694,3575862036,3575862036,0
0,689,12695,3575862036,3575862036,0
0,689,12696,3575862036,3575862036,0
0,689,12697,3575862036,3575862039,3
0,689,12698,3575862036,3575862039,3
0,689,12699,3575862036,3575862041,5
0,689,12700,3575862036,3575862043,7
0,689,12701,3575862036,3575862044,8
0,689,12702,3575862036,3575862047,11
0,689,12703,3575862036,3575862048,12
0,689,12704,3575862036,3575862053,17
0,689,12705,3575862036,3575862054,18
0,689,12706,3575862036,3575862057,21
0,689,12707,3575862036,3575862058,22
0,689,12708,3575862036,3575862062,26
0,689,12709,3575862036,3575862062,26
0,689,12710,3575862036,3575862063,27
0,689,12711,3575862036,3575862066,30
0,689,12712,3575862036,3575862067,31
0,689,12713,3575862036,3575862069,33
0,689,12714,3575862036,3575862076,40
0,689,12715,3575862036,3575862078,42
0,689,12716,3575862036,3575862078,42
0,689,12717,3575862036,3575862079,43
0,689,12718,3575862036,3575862079,43
0,689,12719,3575862036,3575862080,44
0,689,12720,3575862036,3575862082,46
0,689,12721,3575862036,3575862084,48
0,689,12722,3575862036,3575862085,49
0,689,12723,3575862036,3575862086,50
0,690,12724,3575862091,3575862091,0
0,690,12725,3575862091,3575862091,0
0,690,12726,3575862091,3575862091,0
0,690,12727,3575862091,3575862091,0
0,690,12728,3575862091,3575862091,0
0,690,12729,3575862091,3575862091,0
0,690,12730,3575862091,3575862092,1
0,690,12731,3575862091,3575862092,1
0,690,12732,3575862091,3575862093,2
0,690,12733,3575862091,3575862093,2
0,690,12734,3575862091,3575862093,2
0,690,12735,3575862091,3575862093,2
0,690,12736,3575862091,3575862096,5
0,690,12737,3575862091,3575862097,6
0,690,12738,3575862091,3575862097,6
0,690,12739,3575862091,3575862098,7
0,690,12740,3575862091,3575862099,8
0,690,12741,3575862091,3575862099,8
0,690,12742,3575862091,3575862101,10
0,690,12743,3575862091,3575862102,11
0,690,12744,3575862091,3575862102,11
0,690,12745,3575862091,3575862102,11
0,690,12746,3575862091,3575862103,12
0,690,12747,3575862091,3575862104,13
0,690,12748,3575862091,3575862104,13
0,690,12749,3575862091,3575862105,14
0,690,12750,3575862091,3575862106,15
0,690,12751,3575862091,3575862107,16
0,690,12752,3575862091,3575862109,18
0,690,12753,3575862091,3575862112,21
0,690,12754,3575862091,3575862116,25
0,690,12755,3575862091,3575862116,25
0,690,12756,3575862091,3575862118,27
0,690,12757,3575862091,3575862119,28
0,690,12758,3575862091,3575862120,29
0,690,12759,3575862091,3575862122,31
0,690,12760,3575862091,3575862122,31
0,690,12761,3575862091,3575862123,32
0,690,12762,3575862091,3575862125,34
0,690,12763,3575862091,3575862125,34
0,690,12764,3575862091,3575862126,35
0,690,12765,3575862091,3575862127,36
0,690,12766,3575862091,3575862128,37
0,690,12767,3575862091,3575862128,37
0,690,12768,3575862091,3575862133,42
0,690,12769,3575862091,3575862135,44
0,690,12770,3575862091,3575862136,45
0,690,12771,3575862091,3575862136,45
0,690,12772,3575862091,3575862137,46
0,690,12773,3575862091,3575862138,47
0,690,12774,3575862091,3575862139,48
0,691,12775,3575862146,3575862146,0
0,691,12776,3575862146,3575862146,0
0,691,12777,3575862146,3575862146,0
0,691,12778,3575862146,3575862146,0
0,691,12779,3575862146,3575862146,0
0,691,12780,3575862146,3575862147,1
0,691,12781,3575862146,3575862148,2
0,691,12782,3575862146,3575862148,2
0,691,12783,3575862146,3575862150,4
0,691,12784,3575862146,3575862153,7
0,691,12785,3575862146,3575862154,8
0,691,12786,3575862146,3575862155,9
0,691,12787,3575862146,3575862155,9
0,691,12788,3575862146,3575862156,10
0,691,12789,3575862146,3575862157,11
0,691,12790,3575862146,3575862159,13
0,691,12791,3575862146,3575862162,16
0,691,12792,3575862146,3575862163,17
0,691,12793,3575862146,3575862164,18
0,691,12794,3575862146,3575862165,19
0,691,12795,3575862146,3575862166,20
0,691,12796,3575862146,3575862166,20
0,691,12797,3575862146,3575862173,27
0,691,12798,3575862146,3575862173,27
0,691,12799,3575862146,3575862174,28
0,691,12800,3575862146,3575862175,29
0,691,12801,3575862146,3575862177,31
0,691,12802,3575862146,3575862177,31
0,691,12803,3575862146,3575862178,32
0,691,12804,3575862146,3575862178,32
0,691,12805,3575862146,3575862179,33
0,691,12806,3575862146,3575862180,34
0,691,12807,3575862146,3575862183,37
0,691,12808,3575862146,3575862185,39
0,691,12809,3575862146,3575862186,40
0,691,12810,3575862146,3575862187,41
0,691,12811,3575862146,3575862189,43
0,691,12812,3575862146,3575862195,49
0,692,12813,3575862201,3575862201,0
0,692,12814,3575862201,3575862201,0
0,692,12815,3575862201,3575862201,0
0,692,12816,3575862201,3575862201,0
0,692,12817,3575862201,3575862203,2
0,692,12818,3575862201,3575862205,4
0,692,12819,3575862201,3575862206,5
0,692,12820,3575862201,3575862206,5
0,692,12821,3575862201,3575862208,7
0,692,12822,3575862201,3575862208,7
0,692,12823,3575862201,3575862213,12
0,692,12824,3575862201,3575862213,12
0,692,12825,3575862201,3575862215,14
0,692,12826,3575862201,3575862216,15
0,692,12827,3575862201,3575862222,21
0,692,12828,3575862201,3575862222,21
0,692,12829,3575862201,3575862225,24
0,692,12830,3575862201,3575862228,27
0,692,12831,3575862201,3575862230,29
0,692,12832,3575862201,3575862232,31
0,692,12833,3575862201,3575862232,31
0,692,12834,3575862201,3575862233,32
0,692,12835,3575862201,3575862234,33
0,692,12836,3575862201,3575862235,34
0,692,12837,3575862201,3575862237,36
0,692,12838,3575862201,3575862239,38
0,692,12839,3575862201,3575862240,39
0,692,12840,3575862201,3575862241,40
0,692,12841,3575862201,3575862243,42
0,692,12842,3575862201,3575862245,44
0,692,12843,3575862201,3575862247,46
0,692,12844,3575862201,3575862248,47
0,693,12845,3575862257,3575862257,0
0,693,12846,3575862257,3575862257,0
0,693,12847,3575862257,3575862257,0
0,693,12848,3575862257,3575862257,0
0,693,12849,3575862257,3575862258,1
0,693,12850,3575862257,3575862262,5
0,693,12851,3575862257,3575862262,5
0,693,12852,3575862257,3575862264,7
0,693,12853,3575862257,3575862265,8
0,693,12854,3575862257,3575862267,10
0,693,12855,3575862257,3575862268,11
0,693,12856,3575862257,3575862269,12
0,693,12857,3575862257,3575862269,12
0,693,12858,3575862257,3575862271,14
0,693,12859,3575862257,3575862276,19
0,693,12860,3575862257,3575862277,20
0,693,12861,3575862257,3575862278,21
0,693,12862,3575862257,3575862278,21
0,693,12863,3575862257,3575862280,23
0,693,12864,3575862257,3575862284,27
0,693,12865,3575862257,3575862285,28
0,693,12866,3575862257,3575862286,29
0,693,12867,3575862257,3575862286,29
0,693,12868,3575862257,3575862287,30
0,693,12869,3575862257,3575862287,30
0,693,12870,3575862257,3575862288,31
0,693,12871,3575862257,3575862290,33
0,693,12872,3575862257,3575862290,33
0,693,12873,3575862257,3575862290,33
0,693,12874,3575862257,3575862291,34
0,693,12875,3575862257,3575862292,35
0,693,12876,3575862257,3575862293,36
0,693,12877,3575862257,3575862293,36
0,693,12878,3575862257,3575862293,36
0,693,12879,3575862257,3575862293,36
0,693,12880,3575862257,3575862294,37
0,693,12881,3575862257,3575862296,39
0,693,12882,3575862257,3575862296,39
0,693,12883,3575862257,3575862298,41
0,693,12884,3575862257,3575862298,41
0,693,12885,3575862257,3575862299,42
0,693,12886,3575862257,3575862299,42
0,693,12887,3575862257,3575862301,44
0,693,12888,3575862257,3575862301,44
0,693,12889,3575862257,3575862302,45
0,693,12890,3575862257,3575862303,46
0,693,12891,3575862257,3575862303,46
0,693,12892,3575862257,3575862304,47
0,693,12893,3575862257,3575862306,49
0,693,12894,3575862257,3575862307,50
0,694,12895,3575862312,3575862312,0
0,694,12896,3575862312,3575862313,1
0,694,12897,3575862312,3575862313,1
0,694,12898,3575862312,3575862316,4
0,694,12899,3575862312,3575862317,5
0,694,12900,3575862312,3575862318,6
0,694,12901,3575862312,3575862320,8
0,694,12902,3575862312,3575862320,8
0,694,12903,3575862312,3575862323,11
0,694,12904,3575862312,3575862323,11
0,694,12905,3575862312,3575862325,13
0,694,12906,3575862312,3575862325,13
0,694,12907,3575862312,3575862325,13
0,694,12908,3575862312,3575862326,14
0,694,12909,3575862312,3575862327,15
0,694,12910,3575862312,3575862328,16
0,694,12911,3575862312,3575862328,16
0,694,12912,3575862312,3575862330,18
0,694,12913,3575862312,3575862334,22
0,694,12914,3575862312,3575862336,24
0,694,12915,3575862312,3575862336,24
0,694,12916,3575862312,3575862336,24
0,694,12917,3575862312,3575862337,25
0,694,12918,3575862312,3575862337,25
0,694,12919,3575862312,3575862338,26
0,694,12920,3575862312,3575862338,26
0,694,12921,3575862312,3575862338,26
0,694,12922,3575862312,3575862342,30
0,694,12923,3575862312,3575862342,30
0,694,12924,3575862312,3575862343,31
0,694,12925,3575862312,3575862345,33
0,694,12926,3575862312,3575862345,33
0,694,12927,3575862312,3575862347,35
0,694,12928,3575862312,3575862348,36
0,694,12929,3575862312,3575862348,36
0,694,12930,3575862312,3575862350,38
0,694,12931,3575862312,3575862351,39
0,694,12932,3575862312,3575862354,42
0,694,12933,3575862312,3575862355,43
0,694,12934,3575862312,3575862356,44
0,694,12935,3575862312,3575862356,44
0,694,12936,3575862312,3575862357,45
0,694,12937,3575862312,3575862358,46
0,694,12938,3575862312,3575862360,48
0,694,12939,3575862312,3575862361,49
0,695,12940,3575862369,3575862369,0
0,695,12941,3575862369,3575862369,0
0,695,12942,3575862369,3575862369,0
0,695,12943,3575862369,3575862369,0
0,695,12944,3575862369,3575862369,0
0,695,12945,3575862369,3575862369,0
0,695,12946,3575862369,3575862372,3
0,695,12947,3575862369,3575862372,3
0,695,12948,3575862369,3575862375,6
0,695,12949,3575862369,3575862377,8
0,695,12950,3575862369,3575862377,8
0,695,12951,3575862369,3575862377,8
0,695,12952,3575862369,3575862378,9
0,695,12953,3575862369,3575862378,9
0,695,12954,3575862369,3575862378,9
0,695,12955,3575862369,3575862379,10
0,695,12956,3575862369,3575862379,10
0,695,12957,3575862369,3575862383,14
0,695,12958,3575862369,3575862385,16
0,695,12959,3575862369,3575862387,18
0,695,12960,3575862369,3575862387,18
0,695,12961,3575862369,3575862390,21
0,695,12962,3575862369,3575862394,25
0,695,12963,3575862369,3575862398,29
0,695,12964,3575862369,3575862401,32
0,695,12965,3575862369,3575862401,32
0,695,12966,3575862369,3575862404,35
0,695,12967,3575862369,3575862405,36
0,695,12968,3575862369,3575862406,37
0,695,12969,3575862369,3575862408,39
0,695,12970,3575862369,3575862409,40
0,695,12971,3575862369,3575862409,40
0,695,12972,3575862369,3575862413,44
0,695,12973,3575862369,3575862413,44
0,695,12974,3575862369,3575862414,45
0,695,12975,3575862369,3575862417,48
0,695,12976,3575862369,3575862417,48
0,696,12977,3575862424,3575862424,0
0,696,12978,3575862424,3575862424,0
0,696,12979,3575862424,3575862425,1
0,696,12980,3575862424,3575862428,4
0,696,12981,3575862424,3575862430,6
0,696,12982,3575862424,3575862432,8
0,696,12983,3575862424,3575862432,8
0,696,12984,3575862424,3575862434,10
0,696,12985,3575862424,3575862434,10
0,696,12986,3575862424,3575862435,11
0,696,12987,3575862424,3575862436,12
0,696,12988,3575862424,3575862437,13
0,696,12989,3575862424,3575862439,15
0,696,12990,3575862424,3575862439,15
0,696,12991,3575862424,3575862442,18
0,696,12992,3575862424,3575862443,19
0,696,12993,3575862424,3575862446,22
0,696,12994,3575862424,3575862449,25
0,696,12995,3575862424,3575862453,29
0,696,12996,3575862424,3575862454,30
0,696,12997,3575862424,3575862457,33
0,696,12998,3575862424,3575862457,33
0,696,12999,3575862424,3575862459,35
0,696,13000,3575862424,3575862461,37
0,696,13001,3575862424,3575862462,38
0,696,13002,3575862424,3575862462,38
0,696,13003,3575862424,3575862463,39
0,696,13004,3575862424,3575862467,43
0,696,13005,3575862424,3575862469,45
0,696,13006,3575862424,3575862469,45
0,697,13007,3575862481,3575862481,0
0,697,13008,3575862481,3575862481,0
0,697,13009,3575862481,3575862481,0
0,697,13010,3575862481,3575862481,0
0,697,13011,3575862481,3575862481,0
0,697,13012,3575862481,3575862483,2
0,697,13013,3575862481,3575862485,4
0,697,13014,3575862481,3575862485,4
0,697,13015,3575862481,3575862486,5
0,697,13016,3575862481,3575862487,6
0,697,13017,3575862481,3575862487,6
0,697,13018,3575862481,3575862488,7
0,697,13019,3575862481,3575862489,8
0,697,13020,3575862481,3575862490,9
0,697,13021,3575862481,3575862491,10
0,697,13022,3575862481,3575862491,10
0,697,13023,3575862481,3575862492,11
0,697,13024,3575862481,3575862492,11
0,697,13025,3575862481,3575862492,11
0,697,13026,3575862481,3575862493,12
0,697,13027,3575862481,3575862495,14
0,697,13028,3575862481,3575862496,15
0,697,13029,3575862481,3575862497,16
0,697,13030,3575862481,3575862498,17
0,697,13031,3575862481,3575862498,17
0,697,13032,3575862481,3575862499,18
0,697,13033,3575862481,3575862500,19
0,697,13034,3575862481,3575862500,19
0,697,13035,3575862481,3575862500,19
0,697,13036,3575862481,3575862502,21
0,697,13037,3575862481,3575862503,22
0,697,13038,3575862481,3575862505,24
0,697,13039,3575862481,3575862505,24
0,697,13040,3575862481,3575862508,27
0,697,13041,3575862481,3575862510,29
0,697,13042,3575862481,3575862512,31
0,697,13043,3575862481,3575862515,34
0,697,13044,3575862481,3575862515,34
0,697,13045,3575862481,3575862515,34
0,697,13046,3575862481,3575862518,37
0,697,13047,3575862481,3575862518,37
0,697,13048,3575862481,3575862519,38
0,697,13049,3575862481,3575862522,41
0,697,13050,3575862481,3575862522,41
0,697,13051,3575862481,3575862524,43
0,697,13052,3575862481,3575862525,44
0,697,13053,3575862481,3575862525,44
0,697,13054,3575862481,3575862525,44
0,697,13055,3575862481,3575862527,46
0,697,13056,3575862481,3575862527,46
0,697,13057,3575862481,3575862527,46
0,697,13058,3575862481,3575862529,48
0,698,13059,3575862538,3575862538,0
0,698,13060,3575862538,3575862538,0
0,698,13061,3575862538,3575862538,0
0,698,13062,3575862538,3575862538,0
0,698,13063,3575862538,3575862538,0
0,698,13064,3575862538,3575862538,0
0,698,13065,3575862538,3575862538,0
0,698,13066,3575862538,3575862538,0
0,698,13067,3575862538,3575862538,0
0,698,13068,3575862538,3575862538,0
0,698,13069,3575862538,3575862541,3
0,698,13070,3575862538,3575862541,3
0,698,13071,3575862538,3575862542,4
0,698,13072,3575862538,3575862544,6
0,698,13073,3575862538,3575862544,6
0,698,13074,3575862538,3575862546,8
0,698,13075,3575862538,3575862546,8
0,698,13076,3575862538,3575862548,10
0,698,13077,3575862538,3575862549,11
0,698,13078,3575862538,3575862551,13
0,698,13079,3575862538,3575862553,15
0,698,13080,3575862538,3575862554,16
0,698,13081,3575862538,3575862556,18
0,698,13082,3575862538,3575862557,19
0,698,13083,3575862538,3575862560,22
0,698,13084,3575862538,3575862561,23
0,698,13085,3575862538,3575862562,24
0,698,13086,3575862538,3575862563,25
0,698,13087,3575862538,3575862564,26
0,698,13088,3575862538,3575862565,27
0,698,13089,3575862538,3575862565,27
0,698,13090,3575862538,3575862566,28
0,698,13091,3575862538,3575862570,32
0,698,13092,3575862538,3575862571,33
0,698,13093,3575862538,3575862571,33
0,698,13094,3575862538,3575862574,36
0,698,13095,3575862538,3575862576,38
0,698,13096,3575862538,3575862576,38
0,698,13097,3575862538,3575862577,39
0,698,13098,3575862538,3575862577,39
0,698,13099,3575862538,3575862577,39
0,698,13100,3575862538,3575862578,40
0,698,13101,3575862538,3575862578,40
0,698,13102,3575862538,3575862578,40
0,698,13103,3575862538,3575862582,44
0,698,13104,3575862538,3575862585,47
0,698,13105,3575862538,3575862586,48
0,699,13106,3575862593,3575862593,0
0,699,13107,3575862593,3575862594,1
0,699,13108,3575862593,3575862597,4
0,699,13109,3575862593,3575862598,5
0,699,13110,3575862593,3575862600,7
0,699,13111,3575862593,3575862600,7
0,699,13112,3575862593,3575862603,10
0,699,13113,3575862593,3575862606,13
0,699,13114,3575862593,3575862607,14
0,699,13115,3575862593,3575862608,15
0,699,13116,3575862593,3575862608,15
0,699,13117,3575862593,3575862612,19
0,699,13118,3575862593,3575862612,19
0,699,13119,3575862593,3575862614,21
0,699,13120,3575862593,3575862614,21
0,699,13121,3575862593,3575862616,23
0,699,13122,3575862593,3575862620,27
0,699,13123,3575862593,3575862626,33
0,699,13124,3575862593,3575862628,35
0,699,13125,3575862593,3575862629,36
0,699,13126,3575862593,3575862630,37
0,699,13127,3575862593,3575862632,39
0,699,13128,3575862593,3575862632,39
0,699,13129,3575862593,3575862633,40
0,699,13130,3575862593,3575862633,40
0,699,13131,3575862593,3575862634,41
0,699,13132,3575862593,3575862636,43
0,699,13133,3575862593,3575862637,44
0,699,13134,3575862593,3575862639,46
0,699,13135,3575862593,3575862639,46
0,699,13136,3575862593,3575862641,48
0,699,13137,3575862593,3575862642,49
0,700,13138,3575862649,3575862649,0
0,700,13139,3575862649,3575862649,0
0,700,13140,3575862649,3575862649,0
0,700,13141,3575862649,3575862649,0
0,700,13142,3575862649,3575862652,3
0,700,13143,3575862649,3575862652,3
0,700,13144,3575862649,3575862656,7
0,700,13145,3575862649,3575862656,7
0,700,13146,3575862649,3575862658,9
0,700,13147,3575862649,3575862660,11
0,700,13148,3575862649,3575862660,11
0,700,13149,3575862649,3575862661,12
0,700,13150,3575862649,3575862663,14
0,700,13151,3575862649,3575862664,15
0,700,13152,3575862649,3575862665,16
0,700,13153,3575862649,3575862666,17
0,700,13154,3575862649,3575862668,19
0,700,13155,3575862649,3575862668,19
0,700,13156,3575862649,3575862670,21
0,700,13157,3575862649,3575862677,28
0,700,13158,3575862649,3575862677,28
0,700,13159,3575862649,3575862677,28
0,700,13160,3575862649,3575862678,29
0,700,13161,3575862649,3575862678,29
0,700,13162,3575862649,3575862679,30
0,700,13163,3575862649,3575862683,34
0,700,13164,3575862649,3575862685,36
0,700,13165,3575862649,3575862685,36
0,700,13166,3575862649,3575862685,36
0,700,13167,3575862649,3575862687,38
0,700,13168,3575862649,3575862689,40
0,700,13169,3575862649,3575862690,41
0,700,13170,3575862649,3575862690,41
0,700,13171,3575862649,3575862691,42
0,700,13172,3575862649,3575862691,42
0,700,13173,3575862649,3575862691,42
0,700,13174,3575862649,3575862692,43
0,700,13175,3575862649,3575862692,43
0,700,13176,3575862649,3575862692,43
0,700,13177,3575862649,3575862693,44
0,700,13178,3575862649,3575862695,46
0,700,13179,3575862649,3575862696,47
0,700,13180,3575862649,3575862697,48
0,700,13181,3575862649,3575862698,49
0,700,13182,3575862649,3575862698,49
0,701,13183,3575862706,3575862706,0
0,701,13184,3575862706,3575862706,0
0,701,13185,3575862706,3575862706,0
0,701,13186,3575862706,3575862706,0
0,701,13187,3575862706,3575862706,0
0,701,13188,3575862706,3575862706,0
0,701,13189,3575862706,3575862706,0
0,701,13190,3575862706,3575862706,0
0,701,13191,3575862706,3575862706,0
0,701,13192,3575862706,3575862707,1
0,701,13193,3575862706,3575862709,3
0,701,13194,3575862706,3575862712,6
0,701,13195,3575862706,3575862712,6
0,701,13196,3575862706,3575862715,9
0,701,13197,3575862706,3575862715,9
0,701,13198,3575862706,3575862716,10
0,701,13199,3575862706,3575862717,11
0,701,13200,3575862706,3575862718,12
0,701,13201,3575862706,3575862718,12
0,701,13202,3575862706,3575862718,12
0,701,13203,3575862706,3575862719,13
0,701,13204,3575862706,3575862719,13
0,701,13205,3575862706,3575862721,15
0,701,13206,3575862706,3575862722,16
0,701,13207,3575862706,3575862723,17
0,701,13208,3575862706,3575862724,18
0,701,13209,3575862706,3575862725,19
0,701,13210,3575862706,3575862725,19
0,701,13211,3575862706,3575862725,19
0,701,13212,3575862706,3575862726,20
0,701,13213,3575862706,3575862726,20
0,701,13214,3575862706,3575862727,21
0,701,13215,3575862706,3575862728,22
0,701,13216,3575862706,3575862729,23
0,701,13217,3575862706,3575862733,27
0,701,13218,3575862706,3575862735,29
0,701,13219,3575862706,3575862736,30
0,701,13220,3575862706,3575862736,30
0,701,13221,3575862706,3575862736,30
0,701,13222,3575862706,3575862737,31
0,701,13223,3575862706,3575862737,31
0,701,13224,3575862706,3575862738,32
0,701,13225,3575862706,3575862741,35
0,701,13226,3575862706,3575862741,35
0,701,13227,3575862706,3575862743,37
0,701,13228,3575862706,3575862744,38
0,701,13229,3575862706,3575862745,39
0,701,13230,3575862706,3575862746,40
0,701,13231,3575862706,3575862747,41
0,701,13232,3575862706,3575862748,42
0,701,13233,3575862706,3575862748,42
0,701,13234,3575862706,3575862750,44
0,701,13235,3575862706,3575862753,47
0,701,13236,3575862706,3575862754,48
0,701,13237,3575862706,3575862756,50
0,702,13238,3575862762,3575862762,0
0,702,13239,3575862762,3575862762,0
0,702,13240,3575862762,3575862762,0
0,702,13241,3575862762,3575862762,0
0,702,13242,3575862762,3575862763,1
0,702,13243,3575862762,3575862765,3
0,702,13244,3575862762,3575862765,3
0,702,13245,3575862762,3575862765,3
0,702,13246,3575862762,3575862767,5
0,702,13247,3575862762,3575862771,9
0,702,13248,3575862762,3575862771,9
0,702,13249,3575862762,3575862776,14
0,702,13250,3575862762,3575862776,14
0,702,13251,3575862762,3575862777,15
0,702,13252,3575862762,3575862777,15
0,702,13253,3575862762,3575862777,15
0,702,13254,3575862762,3575862778,16
0,702,13255,3575862762,3575862779,17
0,702,13256,3575862762,3575862780,18
0,702,13257,3575862762,3575862782,20
0,702,13258,3575862762,3575862786,24
0,702,13259,3575862762,3575862786,24
0,702,13260,3575862762,3575862789,27
0,702,13261,3575862762,3575862794,32
0,702,13262,3575862762,3575862796,34
0,702,13263,3575862762,3575862798,36
0,702,13264,3575862762,3575862799,37
0,702,13265,3575862762,3575862799,37
0,702,13266,3575862762,3575862801,39
0,702,13267,3575862762,3575862803,41
0,702,13268,3575862762,3575862805,43
0,702,13269,3575862762,3575862805,43
0,702,13270,3575862762,3575862807,45
0,702,13271,3575862762,3575862808,46
0,702,13272,3575862762,3575862809,47
0,703,13273,3575862817,3575862817,0
0,703,13274,3575862817,3575862817,0
0,703,13275,3575862817,3575862817,0
0,703,13276,3575862817,3575862817,0
0,703,13277,3575862817,3575862818,1
0,703,13278,3575862817,3575862818,1
0,703,13279,3575862817,3575862821,4
0,703,13280,3575862817,3575862827,10
0,703,13281,3575862817,3575862828,11
0,703,13282,3575862817,3575862830,13
0,703,13283,3575862817,3575862832,15
0,703,13284,3575862817,3575862833,16
0,703,13285,3575862817,3575862833,16
0,703,13286,3575862817,3575862834,17
0,703,13287,3575862817,3575862837,20
0,703,13288,3575862817,3575862837,20
0,703,13289,3575862817,3575862840,23
0,703,13290,3575862817,3575862840,23
0,703,13291,3575862817,3575862842,25
0,703,13292,3575862817,3575862842,25
0,703,13293,3575862817,3575862846,29
0,703,13294,3575862817,3575862846,29
0,703,13295,3575862817,3575862846,29
0,703,13296,3575862817,3575862848,31
0,703,13297,3575862817,3575862848,31
0,703,13298,3575862817,3575862852,35
0,703,13299,3575862817,3575862853,36
0,703,13300,3575862817,3575862856,39
0,703,13301,3575862817,3575862856,39
0,703,13302,3575862817,3575862860,43
0,703,13303,3575862817,3575862860,43
0,703,13304,3575862817,3575862861,44
0,703,13305,3575862817,3575862863,46
0,703,13306,3575862817,3575862864,47
0,703,13307,3575862817,3575862867,50
0,704,13308,3575862874,3575862874,0
0,704,13309,3575862874,3575862874,0
0,704,13310,3575862874,3575862874,0
0,704,13311,3575862874,3575862878,4
0,704,13312,3575862874,3575862878,4
0,704,13313,3575862874,3575862878,4
0,704,13314,3575862874,3575862879,5
0,704,13315,3575862874,3575862879,5
0,704,13316,3575862874,3575862881,7
0,704,13317,3575862874,3575862883,9
0,704,13318,3575862874,3575862884,10
0,704,13319,3575862874,3575862886,12
0,704,13320,3575862874,3575862886,12
0,704,13321,3575862874,3575862886,12
0,704,13322,3575862874,3575862888,14
0,704,13323,3575862874,3575862889,15
0,704,13324,3575862874,3575862890,16
0,704,13325,3575862874,3575862890,16
0,704,13326,3575862874,3575862891,17
0,704,13327,3575862874,3575862892,18
0,704,13328,3575862874,3575862892,18
0,704,13329,3575862874,3575862892,18
0,704,13330,3575862874,3575862892,18
0,704,13331,3575862874,3575862893,19
0,704,13332,3575862874,3575862895,21
0,704,13333,3575862874,3575862896,22
0,704,13334,3575862874,3575862897,23
0,704,13335,3575862874,3575862898,24
0,704,13336,3575862874,3575862898,24
0,704,13337,3575862874,3575862900,26
0,704,13338,3575862874,3575862900,26
0,704,13339,3575862874,3575862901,27
0,704,13340,3575862874,3575862901,27
0,704,13341,3575862874,3575862903,29
0,704,13342,3575862874,3575862903,29
0,704,13343,3575862874,3575862905,31
0,704,13344,3575862874,3575862905,31
0,704,13345,3575862874,3575862906,32
0,704,13346,3575862874,3575862907,33
0,704,13347,3575862874,3575862909,35
0,704,13348,3575862874,3575862912,38
0,704,13349,3575862874,3575862914,40
0,704,13350,3575862874,3575862916,42
0,704,13351,3575862874,3575862916,42
0,704,13352,3575862874,3575862917,43
0,704,13353,3575862874,3575862918,44
0,704,13354,3575862874,3575862918,44
0,704,13355,3575862874,3575862918,44
0,704,13356,3575862874,3575862918,44
0,704,13357,3575862874,3575862920,46
0,704,13358,3575862874,3575862921,47
0,704,13359,3575862874,3575862922,48
0,704,13360,3575862874,3575862923,49
0,705,13361,3575862930,3575862930,0
0,705,13362,3575862930,3575862930,0
0,705,13363,3575862930,3575862930,0
0,705,13364,3575862930,3575862930,0
0,705,13365,3575862930,3575862930,0
0,705,13366,3575862930,3575862930,0
0,705,13367,3575862930,3575862930,0
0,705,13368,3575862930,3575862932,2
0,705,13369,3575862930,3575862935,5
0,705,13370,3575862930,3575862936,6
0,705,13371,3575862930,3575862936,6
0,705,13372,3575862930,3575862937,7
0,705,13373,3575862930,3575862937,7
0,705,13374,3575862930,3575862937,7
0,705,13375,3575862930,3575862938,8
0,705,13376,3575862930,3575862938,8
0,705,13377,3575862930,3575862942,12
0,705,13378,3575862930,3575862944,14
0,705,13379,3575862930,3575862944,14
0,705,13380,3575862930,3575862945,15
0,705,13381,3575862930,3575862946,16
0,705,13382,3575862930,3575862947,17
0,705,13383,3575862930,3575862948,18
0,705,13384,3575862930,3575862949,19
0,705,13385,3575862930,3575862951,21
0,705,13386,3575862930,3575862952,22
0,705,13387,3575862930,3575862955,25
0,705,13388,3575862930,3575862956,26
0,705,13389,3575862930,3575862957,27
0,705,13390,3575862930,3575862960,30
0,705,13391,3575862930,3575862960,30
0,705,13392,3575862930,3575862961,31
0,705,13393,3575862930,3575862963,33
0,705,13394,3575862930,3575862963,33
0,705,13395,3575862930,3575862965,35
0,705,13396,3575862930,3575862965,35
0,705,13397,3575862930,3575862965,35
0,705,13398,3575862930,3575862965,35
0,705,13399,3575862930,3575862966,36
0,705,13400,3575862930,3575862967,37
0,705,13401,3575862930,3575862969,39
0,705,13402,3575862930,3575862971,41
0,705,13403,3575862930,3575862972,42
0,705,13404,3575862930,3575862976,46
0,705,13405,3575862930,3575862977,47
0,705,13406,3575862930,3575862977,47
0,705,13407,3575862930,3575862977,47
0,705,13408,3575862930,3575862978,48
0,705,13409,3575862930,3575862979,49
0,705,13410,3575862930,3575862980,50
0,706,13411,3575862987,3575862987,0
0,706,13412,3575862987,3575862987,0
0,706,13413,3575862987,3575862987,0
0,706,13414,3575862987,3575862989,2
0,706,13415,3575862987,3575862994,7
0,706,13416,3575862987,3575862996,9
0,706,13417,3575862987,3575862998,11
0,706,13418,3575862987,3575862999,12
0,706,13419,3575862987,3575863001,14
0,706,13420,3575862987,3575863004,17
0,706,13421,3575862987,3575863004,17
0,706,13422,3575862987,3575863005,18
0,706,13423,3575862987,3575863007,20
0,706,13424,3575862987,3575863008,21
0,706,13425,3575862987,3575863009,22
0,706,13426,3575862987,3575863013,26
0,706,13427,3575862987,3575863016,29
0,706,13428,3575862987,3575863016,29
0,706,13429,3575862987,3575863016,29
0,706,13430,3575862987,3575863018,31
0,706,13431,3575862987,3575863021,34
0,706,13432,3575862987,3575863023,36
0,706,13433,3575862987,3575863028,41
0,706,13434,3575862987,3575863028,41
0,706,13435,3575862987,3575863030,43
0,706,13436,3575862987,3575863032,45
0,706,13437,3575862987,3575863033,46
0,706,13438,3575862987,3575863037,50
0,706,13439,3575862987,3575863037,50
0,707,13440,3575863043,3575863043,0
0,707,13441,3575863043,3575863043,0
0,707,13442,3575863043,3575863043,0
0,707,13443,3575863043,3575863043,0
0,707,13444,3575863043,3575863046,3
0,707,13445,3575863043,3575863048,5
0,707,13446,3575863043,3575863048,5
0,707,13447,3575863043,3575863049,6
0,707,13448,3575863043,3575863052,9
0,707,13449,3575863043,3575863053,10
0,707,13450,3575863043,3575863056,13
0,707,13451,3575863043,3575863057,14
0,707,13452,3575863043,3575863058,15
0,707,13453,3575863043,3575863060,17
0,707,13454,3575863043,3575863061,18
0,707,13455,3575863043,3575863062,19
0,707,13456,3575863043,3575863064,21
0,707,13457,3575863043,3575863065,22
0,707,13458,3575863043,3575863067,24
0,707,13459,3575863043,3575863068,25
0,707,13460,3575863043,3575863069,26
0,707,13461,3575863043,3575863072,29
0,707,13462,3575863043,3575863073,30
0,707,13463,3575863043,3575863078,35
0,707,13464,3575863043,3575863078,35
0,707,13465,3575863043,3575863078,35
0,707,13466,3575863043,3575863079,36
0,707,13467,3575863043,3575863079,36
0,707,13468,3575863043,3575863079,36
0,707,13469,3575863043,3575863082,39
0,707,13470,3575863043,3575863083,40
0,707,13471,3575863043,3575863084,41
0,707,13472,3575863043,3575863085,42
0,707,13473,3575863043,3575863085,42
0,707,13474,3575863043,3575863086,43
0,707,13475,3575863043,3575863086,43
0,707,13476,3575863043,3575863087,44
0,707,13477,3575863043,3575863088,45
0,707,13478,3575863043,3575863090,47
0,707,13479,3575863043,3575863091,48
0,707,13480,3575863043,3575863091,48
0,707,13481,3575863043,3575863091,48
0,707,13482,3575863043,3575863091,48
0,707,13483,3575863043,3575863092,49
0,707,13484,3575863043,3575863092,49
0,707,13485,3575863043,3575863092,49
0,707,13486,3575863043,3575863093,50
0,708,13487,3575863099,3575863099,0
0,708,13488,3575863099,3575863099,0
0,708,13489,3575863099,3575863099,0
0,708,13490,3575863099,3575863099,0
0,708,13491,3575863099,3575863100,1
0,708,13492,3575863099,3575863101,2
0,708,13493,3575863099,3575863101,2
0,708,13494,3575863099,3575863101,2
0,708,13495,3575863099,3575863103,4
0,708,13496,3575863099,3575863104,5
0,708,13497,3575863099,3575863104,5
0,708,13498,3575863099,3575863105,6
0,708,13499,3575863099,3575863107,8
0,708,13500,3575863099,3575863107,8
0,708,13501,3575863099,3575863109,10
0,708,13502,3575863099,3575863112,13
0,708,13503,3575863099,3575863115,16
0,708,13504,3575863099,3575863116,17
0,708,13505,3575863099,3575863116,17
0,708,13506,3575863099,3575863117,18
0,708,13507,3575863099,3575863118,19
0,708,13508,3575863099,3575863118,19
0,708,13509,3575863099,3575863120,21
0,708,13510,3575863099,3575863120,21
0,708,13511,3575863099,3575863121,22
0,708,13512,3575863099,3575863122,23
0,708,13513,3575863099,3575863122,23
0,708,13514,3575863099,3575863123,24
0,708,13515,3575863099,3575863125,26
0,708,13516,3575863099,3575863126,27
0,708,13517,3575863099,3575863127,28
0,708,13518,3575863099,3575863128,29
0,708,13519,3575863099,3575863128,29
0,708,13520,3575863099,3575863129,30
0,708,13521,3575863099,3575863130,31
0,708,13522,3575863099,3575863134,35
0,708,13523,3575863099,3575863136,37
0,708,13524,3575863099,3575863136,37
0,708,13525,3575863099,3575863136,37
0,708,13526,3575863099,3575863136,37
0,708,13527,3575863099,3575863137,38
0,708,13528,3575863099,3575863137,38
0,708,13529,3575863099,3575863137,38
0,708,13530,3575863099,3575863141,42
0,708,13531,3575863099,3575863143,44
0,708,13532,3575863099,3575863143,44
0,708,13533,3575863099,3575863145,46
0,708,13534,3575863099,3575863147,48
0,708,13535,3575863099,3575863149,50
0,709,13536,3575863156,3575863156,0
0,709,13537,3575863156,3575863156,0
0,709,13538,3575863156,3575863156,0
0,709,13539,3575863156,3575863156,0
0,709,13540,3575863156,3575863157,1
0,709,13541,3575863156,3575863160,4
0,709,13542,3575863156,3575863160,4
0,709,13543,3575863156,3575863161,5
0,709,13544,3575863156,3575863163,7
0,709,13545,3575863156,3575863165,9
0,709,13546,3575863156,3575863165,9
0,709,13547,3575863156,3575863166,10
0,709,13548,3575863156,3575863166,10
0,709,13549,3575863156,3575863167,11
0,709,13550,3575863156,3575863172,16
0,709,13551,3575863156,3575863172,16
0,709,13552,3575863156,3575863173,17
0,709,13553,3575863156,3575863174,18
0,709,13554,3575863156,3575863177,21
0,709,13555,3575863156,3575863177,21
0,709,13556,3575863156,3575863178,22
0,709,13557,3575863156,3575863178,22
0,709,13558,3575863156,3575863179,23
0,709,13559,3575863156,3575863180,24
0,709,13560,3575863156,3575863183,27
0,709,13561,3575863156,3575863187,31
0,709,13562,3575863156,3575863188,32
0,709,13563,3575863156,3575863190,34
0,709,13564,3575863156,3575863194,38
0,709,13565,3575863156,3575863196,40
0,709,13566,3575863156,3575863198,42
0,709,13567,3575863156,3575863199,43
0,709,13568,3575863156,3575863204,48
0,709,13569,3575863156,3575863205,49
0,709,13570,3575863156,3575863205,49
0,710,13571,3575863212,3575863212,0
0,710,13572,3575863212,3575863212,0
0,710,13573,3575863212,3575863212,0
0,710,13574,3575863212,3575863214,2
0,710,13575,3575863212,3575863216,4
0,710,13576,3575863212,3575863217,5
0,710,13577,3575863212,3575863217,5
0,710,13578,3575863212,3575863218,6
0,710,13579,3575863212,3575863221,9
0,710,13580,3575863212,3575863224,12
0,710,13581,3575863212,3575863227,15
0,710,13582,3575863212,3575863228,16
0,710,13583,3575863212,3575863230,18
0,710,13584,3575863212,3575863231,19
0,710,13585,3575863212,3575863232,20
0,710,13586,3575863212,3575863236,24
0,710,13587,3575863212,3575863236,24
0,710,13588,3575863212,3575863240,28
0,710,13589,3575863212,3575863242,30
0,710,13590,3575863212,3575863243,31
0,710,13591,3575863212,3575863246,34
0,710,13592,3575863212,3575863248,36
0,710,13593,3575863212,3575863248,36
0,710,13594,3575863212,3575863249,37
0,710,13595,3575863212,3575863252,40
0,710,13596,3575863212,3575863252,40
0,710,13597,3575863212,3575863256,44
0,710,13598,3575863212,3575863257,45
0,710,13599,3575863212,3575863258,46
0,710,13600,3575863212,3575863260,48
0,710,13601,3575863212,3575863261,49
0,711,13602,3575863268,3575863268,0
0,711,13603,3575863268,3575863268,0
0,711,13604,3575863268,3575863268,0
0,711,13605,3575863268,3575863268,0
0,711,13606,3575863268,3575863269,1
0,711,13607,3575863268,3575863275,7
0,711,13608,3575863268,3575863278,10
0,711,13609,3575863268,3575863278,10
0,711,13610,3575863268,3575863279,11
0,711,13611,3575863268,3575863279,11
0,711,13612,3575863268,3575863279,11
0,711,13613,3575863268,3575863279,11
0,711,13614,3575863268,3575863281,13
0,711,13615,3575863268,3575863283,15
0,711,13616,3575863268,3575863284,16
0,711,13617,3575863268,3575863285,17
0,711,13618,3575863268,3575863285,17
0,711,13619,3575863268,3575863286,18
0,711,13620,3575863268,3575863286,18
0,711,13621,3575863268,3575863287,19
0,711,13622,3575863268,3575863288,20
0,711,13623,3575863268,3575863290,22
0,711,13624,3575863268,3575863290,22
0,711,13625,3575863268,3575863291,23
0,711,13626,3575863268,3575863292,24
0,711,13627,3575863268,3575863292,24
0,711,13628,3575863268,3575863292,24
0,711,13629,3575863268,3575863293,25
0,711,13630,3575863268,3575863293,25
0,711,13631,3575863268,3575863295,27
0,711,13632,3575863268,3575863296,28
0,711,13633,3575863268,3575863297,29
0,711,13634,3575863268,3575863299,31
0,711,13635,3575863268,3575863300,32
0,711,13636,3575863268,3575863300,32
0,711,13637,3575863268,3575863301,33
0,711,13638,3575863268,3575863302,34
0,711,13639,3575863268,3575863303,35
0,711,13640,3575863268,3575863304,36
0,711,13641,3575863268,3575863304,36
0,711,13642,3575863268,3575863306,38
0,711,13643,3575863268,3575863307,39
0,711,13644,3575863268,3575863308,40
0,711,13645,3575863268,3575863312,44
0,711,13646,3575863268,3575863315,47
0,711,13647,3575863268,3575863316,48
0,711,13648,3575863268,3575863316,48
0,711,13649,3575863268,3575863316,48
0,711,13650,3575863268,3575863318,50
0,712,13651,3575863325,3575863325,0
0,712,13652,3575863325,3575863325,0
0,712,13653,3575863325,3575863325,0
0,712,13654,3575863325,3575863325,0
0,712,13655,3575863325,3575863325,0
0,712,13656,3575863325,3575863325,0
0,712,13657,3575863325,3575863325,0
0,712,13658,3575863325,3575863325,0
0,712,13659,3575863325,3575863325,0
0,712,13660,3575863325,3575863325,0
0,712,13661,3575863325,3575863327,2
0,712,13662,3575863325,3575863328,3
0,712,13663,3575863325,3575863329,4
0,712,13664,3575863325,3575863330,5
0,712,13665,3575863325,3575863330,5
0,712,13666,3575863325,3575863333,8
0,712,13667,3575863325,3575863336,11
0,712,13668,3575863325,3575863336,11
0,712,13669,3575863325,3575863336,11
0,712,13670,3575863325,3575863336,11
0,712,13671,3575863325,3575863337,12
0,712,13672,3575863325,3575863338,13
0,712,13673,3575863325,3575863338,13
0,712,13674,3575863325,3575863338,13
0,712,13675,3575863325,3575863338,13
0,712,13676,3575863325,3575863341,16
0,712,13677,3575863325,3575863342,17
0,712,13678,3575863325,3575863343,18
0,712,13679,3575863325,3575863345,20
0,712,13680,3575863325,3575863346,21
0,712,13681,3575863325,3575863348,23
0,712,13682,3575863325,3575863348,23
0,712,13683,3575863325,3575863350,25
0,712,13684,3575863325,3575863350,25
0,712,13685,3575863325,3575863352,27
0,712,13686,3575863325,3575863354,29
0,712,13687,3575863325,3575863356,31
0,712,13688,3575863325,3575863358,33
0,712,13689,3575863325,3575863360,35
0,712,13690,3575863325,3575863361,36
0,712,13691,3575863325,3575863362,37
0,712,13692,3575863325,3575863363,38
0,712,13693,3575863325,3575863364,39
0,712,13694,3575863325,3575863365,40
0,712,13695,3575863325,3575863365,40
0,712,13696,3575863325,3575863365,40
0,712,13697,3575863325,3575863366,41
0,712,13698,3575863325,3575863366,41
0,712,13699,3575863325,3575863367,42
0,712,13700,3575863325,3575863371,46
0,712,13701,3575863325,3575863372,47
0,712,13702,3575863325,3575863373,48
0,712,13703,3575863325,3575863373,48
0,712,13704,3575863325,3575863374,49
0,713,13705,3575863382,3575863382,0
0,713,13706,3575863382,3575863382,0
0,713,13707,3575863382,3575863382,0
0,713,13708,3575863382,3575863382,0
0,713,13709,3575863382,3575863382,0
0,713,13710,3575863382,3575863382,0
0,713,13711,3575863382,3575863382,0
0,713,13712,3575863382,3575863383,1
0,713,13713,3575863382,3575863389,7
0,713,13714,3575863382,3575863390,8
0,713,13715,3575863382,3575863394,12
0,713,13716,3575863382,3575863397,15
0,713,13717,3575863382,3575863399,17
0,713,13718,3575863382,3575863399,17
0,713,13719,3575863382,3575863400,18
0,713,13720,3575863382,3575863405,23
0,713,13721,3575863382,3575863405,23
0,713,13722,3575863382,3575863407,25
0,713,13723,3575863382,3575863409,27
0,713,13724,3575863382,3575863409,27
0,713,13725,3575863382,3575863413,31
0,713,13726,3575863382,3575863416,34
0,713,13727,3575863382,3575863417,35
0,713,13728,3575863382,3575863418,36
0,713,13729,3575863382,3575863421,39
0,713,13730,3575863382,3575863427,45
0,713,13731,3575863382,3575863427,45
0,713,13732,3575863382,3575863429,47
0,713,13733,3575863382,3575863430,48
0,713,13734,3575863382,3575863431,49
0,714,13735,3575863439,3575863439,0
0,714,13736,3575863439,3575863439,0
0,714,13737,3575863439,3575863439,0
0,714,13738,3575863439,3575863439,0
0,714,13739,3575863439,3575863440,1
0,714,13740,3575863439,3575863442,3
0,714,13741,3575863439,3575863442,3
0,714,13742,3575863439,3575863446,7
0,714,13743,3575863439,3575863448,9
0,714,13744,3575863439,3575863448,9
0,714,13745,3575863439,3575863453,14
0,714,13746,3575863439,3575863456,17
0,714,13747,3575863439,3575863457,18
0,714,13748,3575863439,3575863459,20
0,714,13749,3575863439,3575863460,21
0,714,13750,3575863439,3575863461,22
0,714,13751,3575863439,3575863463,24
0,714,13752,3575863439,3575863464,25
0,714,13753,3575863439,3575863465,26
0,714,13754,3575863439,3575863467,28
0,714,13755,3575863439,3575863468,29
0,714,13756,3575863439,3575863469,30
0,714,13757,3575863439,3575863473,34
0,714,13758,3575863439,3575863478,39
0,714,13759,3575863439,3575863478,39
0,714,13760,3575863439,3575863479,40
0,714,13761,3575863439,3575863479,40
0,714,13762,3575863439,3575863482,43
0,714,13763,3575863439,3575863483,44
0,714,13764,3575863439,3575863484,45
0,714,13765,3575863439,3575863486,47
0,714,13766,3575863439,3575863486,47
0,714,13767,3575863439,3575863486,47
0,714,13768,3575863439,3575863488,49
0,714,13769,3575863439,3575863489,50
0,715,13770,3575863496,3575863496,0
0,715,13771,3575863496,3575863496,0
0,715,13772,3575863496,3575863496,0
0,715,13773,3575863496,3575863496,0
0,715,13774,3575863496,3575863496,0
0,715,13775,3575863496,3575863496,0
0,715,13776,3575863496,3575863496,0
0,715,13777,3575863496,3575863496,0
0,715,13778,3575863496,3575863496,0
0,715,13779,3575863496,3575863496,0
0,715,13780,3575863496,3575863496,0
0,715,13781,3575863496,3575863497,1
0,715,13782,3575863496,3575863498,2
0,715,13783,3575863496,3575863499,3
0,715,13784,3575863496,3575863500,4
0,715,13785,3575863496,3575863501,5
0,715,13786,3575863496,3575863502,6
0,715,13787,3575863496,3575863502,6
0,715,13788,3575863496,3575863503,7
0,715,13789,3575863496,3575863504,8
0,715,13790,3575863496,3575863505,9
0,715,13791,3575863496,3575863506,10
0,715,13792,3575863496,3575863508,12
0,715,13793,3575863496,3575863512,16
0,715,13794,3575863496,3575863512,16
0,715,13795,3575863496,3575863513,17
0,715,13796,3575863496,3575863515,19
0,715,13797,3575863496,3575863516,20
0,715,13798,3575863496,3575863516,20
0,715,13799,3575863496,3575863517,21
0,715,13800,3575863496,3575863518,22
0,715,13801,3575863496,3575863518,22
0,715,13802,3575863496,3575863519,23
0,715,13803,3575863496,3575863521,25
0,715,13804,3575863496,3575863521,25
0,715,13805,3575863496,3575863523,27
0,715,13806,3575863496,3575863523,27
0,715,13807,3575863496,3575863525,29
0,715,13808,3575863496,3575863526,30
0,715,13809,3575863496,3575863526,30
0,715,13810,3575863496,3575863527,31
0,715,13811,3575863496,3575863527,31
0,715,13812,3575863496,3575863528,32
0,715,13813,3575863496,3575863529,33
0,715,13814,3575863496,3575863529,33
0,715,13815,3575863496,3575863533,37
0,715,13816,3575863496,3575863535,39
0,715,13817,3575863496,3575863535,39
0,715,13818,3575863496,3575863535,39
0,715,13819,3575863496,3575863536,40
0,715,13820,3575863496,3575863537,41
0,715,13821,3575863496,3575863538,42
0,715,13822,3575863496,3575863538,42
0,715,13823,3575863496,3575863541,45
0,715,13824,3575863496,3575863541,45
0,715,13825,3575863496,3575863543,47
0,715,13826,3575863496,3575863544,48
0,715,13827,3575863496,3575863544,48
0,715,13828,3575863496,3575863545,49
0,716,13829,3575863552,3575863552,0
0,716,13830,3575863552,3575863552,0
0,716,13831,3575863552,3575863552,0
0,716,13832,3575863552,3575863552,0
0,716,13833,3575863552,3575863553,1
0,716,13834,3575863552,3575863555,3
0,716,13835,3575863552,3575863555,3
0,716,13836,3575863552,3575863558,6
0,716,13837,3575863552,3575863559,7
0,716,13838,3575863552,3575863559,7
0,716,13839,3575863552,3575863561,9
0,716,13840,3575863552,3575863562,10
0,716,13841,3575863552,3575863563,11
0,716,13842,3575863552,3575863564,12
0,716,13843,3575863552,3575863564,12
0,716,13844,3575863552,3575863564,12
0,716,13845,3575863552,3575863565,13
0,716,13846,3575863552,3575863567,15
0,716,13847,3575863552,3575863571,19
0,716,13848,3575863552,3575863572,20
0,716,13849,3575863552,3575863572,20
0,716,13850,3575863552,3575863574,22
0,716,13851,3575863552,3575863576,24
0,716,13852,3575863552,3575863576,24
0,716,13853,3575863552,3575863577,25
0,716,13854,3575863552,3575863579,27
0,716,13855,3575863552,3575863579,27
0,716,13856,3575863552,3575863582,30
0,716,13857,3575863552,3575863583,31
0,716,13858,3575863552,3575863588,36
0,716,13859,3575863552,3575863589,37
0,716,13860,3575863552,3575863593,41
0,716,13861,3575863552,3575863595,43
0,716,13862,3575863552,3575863598,46
0,716,13863,3575863552,3575863598,46
0,716,13864,3575863552,3575863600,48
0,717,13865,3575863610,3575863610,0
0,717,13866,3575863610,3575863610,0
0,717,13867,3575863610,3575863610,0
0,717,13868,3575863610,3575863610,0
0,717,13869,3575863610,3575863610,0
0,717,13870,3575863610,3575863610,0
0,717,13871,3575863610,3575863612,2
0,717,13872,3575863610,3575863615,5
0,717,13873,3575863610,3575863616,6
0,717,13874,3575863610,3575863616,6
0,717,13875,3575863610,3575863618,8
0,717,13876,3575863610,3575863629,19
0,717,13877,3575863610,3575863631,21
0,717,13878,3575863610,3575863631,21
0,717,13879,3575863610,3575863631,21
0,717,13880,3575863610,3575863632,22
0,717,13881,3575863610,3575863632,22
0,717,13882,3575863610,3575863635,25
0,717,13883,3575863610,3575863636,26
0,717,13884,3575863610,3575863640,30
0,717,13885,3575863610,3575863641,31
0,717,13886,3575863610,3575863642,32
0,717,13887,3575863610,3575863646,36
0,717,13888,3575863610,3575863648,38
0,717,13889,3575863610,3575863648,38
0,717,13890,3575863610,3575863648,38
0,717,13891,3575863610,3575863651,41
0,717,13892,3575863610,3575863655,45
0,717,13893,3575863610,3575863656,46
0,717,13894,3575863610,3575863658,48
0,717,13895,3575863610,3575863659,49
0,718,13896,3575863666,3575863666,0
0,718,13897,3575863666,3575863666,0
0,718,13898,3575863666,3575863666,0
0,718,13899,3575863666,3575863666,0
0,718,13900,3575863666,3575863667,1
0,718,13901,3575863666,3575863667,1
0,718,13902,3575863666,3575863669,3
0,718,13903,3575863666,3575863677,11
0,718,13904,3575863666,3575863678,12
0,718,13905,3575863666,3575863679,13
0,718,13906,3575863666,3575863679,13
0,718,13907,3575863666,3575863679,13
0,718,13908,3575863666,3575863681,15
0,718,13909,3575863666,3575863682,16
0,718,13910,3575863666,3575863684,18
0,718,13911,3575863666,3575863685,19
0,718,13912,3575863666,3575863687,21
0,718,13913,3575863666,3575863688,22
0,718,13914,3575863666,3575863690,24
0,718,13915,3575863666,3575863690,24
0,718,13916,3575863666,3575863691,25
0,718,13917,3575863666,3575863691,25
0,718,13918,3575863666,3575863692,26
0,718,13919,3575863666,3575863692,26
0,718,13920,3575863666,3575863692,26
0,718,13921,3575863666,3575863693,27
0,718,13922,3575863666,3575863693,27
0,718,13923,3575863666,3575863693,27
0,718,13924,3575863666,3575863695,29
0,718,13925,3575863666,3575863695,29
0,718,13926,3575863666,3575863697,31
0,718,13927,3575863666,3575863697,31
0,718,13928,3575863666,3575863698,32
0,718,13929,3575863666,3575863699,33
0,718,13930,3575863666,3575863700,34
0,718,13931,3575863666,3575863702,36
0,718,13932,3575863666,3575863703,37
0,718,13933,3575863666,3575863703,37
0,718,13934,3575863666,3575863705,39
0,718,13935,3575863666,3575863705,39
0,718,13936,3575863666,3575863706,40
0,718,13937,3575863666,3575863708,42
0,718,13938,3575863666,3575863708,42
0,718,13939,3575863666,3575863712,46
0,718,13940,3575863666,3575863712,46
0,718,13941,3575863666,3575863714,48
0,718,13942,3575863666,3575863715,49
0,718,13943,3575863666,3575863716,50
0,719,13944,3575863722,3575863722,0
0,719,13945,3575863722,3575863722,0
0,719,13946,3575863722,3575863722,0
0,719,13947,3575863722,3575863722,0
0,719,13948,3575863722,3575863722,0
0,719,13949,3575863722,3575863722,0
0,719,13950,3575863722,3575863723,1
0,719,13951,3575863722,3575863724,2
0,719,13952,3575863722,3575863724,2
0,719,13953,3575863722,3575863725,3
0,719,13954,3575863722,3575863725,3
0,719,13955,3575863722,3575863726,4
0,719,13956,3575863722,3575863727,5
0,719,13957,3575863722,3575863727,5
0,719,13958,3575863722,3575863729,7
0,719,13959,3575863722,3575863729,7
0,719,13960,3575863722,3575863729,7
0,719,13961,3575863722,3575863732,10
0,719,13962,3575863722,3575863732,10
0,719,13963,3575863722,3575863735,13
0,719,13964,3575863722,3575863735,13
0,719,13965,3575863722,3575863735,13
0,719,13966,3575863722,3575863736,14
0,719,13967,3575863722,3575863737,15
0,719,13968,3575863722,3575863737,15
0,719,13969,3575863722,3575863738,16
0,719,13970,3575863722,3575863738,16
0,719,13971,3575863722,3575863738,16
0,719,13972,3575863722,3575863741,19
0,719,13973,3575863722,3575863742,20
0,719,13974,3575863722,3575863742,20
0,719,13975,3575863722,3575863744,22
0,719,13976,3575863722,3575863745,23
0,719,13977,3575863722,3575863746,24
0,719,13978,3575863722,3575863747,25
0,719,13979,3575863722,3575863748,26
0,719,13980,3575863722,3575863748,26
0,719,13981,3575863722,3575863749,27
0,719,13982,3575863722,3575863750,28
0,719,13983,3575863722,3575863752,30
0,719,13984,3575863722,3575863754,32
0,719,13985,3575863722,3575863755,33
0,719,13986,3575863722,3575863756,34
0,719,13987,3575863722,3575863758,36
0,719,13988,3575863722,3575863759,37
0,719,13989,3575863722,3575863762,40
0,719,13990,3575863722,3575863764,42
0,719,13991,3575863722,3575863764,42
0,719,13992,3575863722,3575863764,42
0,719,13993,3575863722,3575863764,42
0,719,13994,3575863722,3575863765,43
0,719,13995,3575863722,3575863765,43
0,719,13996,3575863722,3575863767,45
0,719,13997,3575863722,3575863770,48
0,719,13998,3575863722,3575863771,49
0,719,13999,3575863722,3575863772,50
0,720,14000,3575863778,3575863778,0
0,720,14001,3575863778,3575863778,0
0,720,14002,3575863778,3575863778,0
0,720,14003,3575863778,3575863778,0
0,720,14004,3575863778,3575863778,0
0,720,14005,3575863778,3575863780,2
0,720,14006,3575863778,3575863782,4
0,720,14007,3575863778,3575863783,5
0,720,14008,3575863778,3575863788,10
0,720,14009,3575863778,3575863789,11
0,720,14010,3575863778,3575863793,15
0,720,14011,3575863778,3575863796,18
0,720,14012,3575863778,3575863798,20
0,720,14013,3575863778,3575863799,21
0,720,14014,3575863778,3575863799,21
0,720,14015,3575863778,3575863805,27
0,720,14016,3575863778,3575863806,28
0,720,14017,3575863778,3575863806,28
0,720,14018,3575863778,3575863807,29
0,720,14019,3575863778,3575863808,30
0,720,14020,3575863778,3575863809,31
0,720,14021,3575863778,3575863812,34
0,720,14022,3575863778,3575863816,38
0,720,14023,3575863778,3575863816,38
0,720,14024,3575863778,3575863817,39
0,720,14025,3575863778,3575863818,40
0,720,14026,3575863778,3575863821,43
0,720,14027,3575863778,3575863826,48
0,721,14028,3575863835,3575863835,0
0,721,14029,3575863835,3575863835,0
0,721,14030,3575863835,3575863835,0
0,721,14031,3575863835,3575863835,0
0,721,14032,3575863835,3575863835,0
0,721,14033,3575863835,3575863835,0
0,721,14034,3575863835,3575863835,0
0,721,14035,3575863835,3575863835,0
0,721,14036,3575863835,3575863836,1
0,721,14037,3575863835,3575863840,5
0,721,14038,3575863835,3575863841,6
0,721,14039,3575863835,3575863841,6
0,721,14040,3575863835,3575863843,8
0,721,14041,3575863835,3575863845,10
0,721,14042,3575863835,3575863847,12
0,721,14043,3575863835,3575863848,13
0,721,14044,3575863835,3575863851,16
0,721,14045,3575863835,3575863852,17
0,721,14046,3575863835,3575863855,20
0,721,14047,3575863835,3575863856,21
0,721,14048,3575863835,3575863859,24
0,721,14049,3575863835,3575863861,26
0,721,14050,3575863835,3575863862,27
0,721,14051,3575863835,3575863863,28
0,721,14052,3575863835,3575863864,29
0,721,14053,3575863835,3575863866,31
0,721,14054,3575863835,3575863868,33
0,721,14055,3575863835,3575863868,33
0,721,14056,3575863835,3575863869,34
0,721,14057,3575863835,3575863873,38
0,721,14058,3575863835,3575863877,42
0,721,14059,3575863835,3575863878,43
0,721,14060,3575863835,3575863879,44
0,721,14061,3575863835,3575863880,45
0,721,14062,3575863835,3575863881,46
0,721,14063,3575863835,3575863884,49
0,721,14064,3575863835,3575863885,50
0,722,14065,3575863892,3575863892,0
0,722,14066,3575863892,3575863892,0
0,722,14067,3575863892,3575863892,0
0,722,14068,3575863892,3575863892,0
0,722,14069,3575863892,3575863892,0
0,722,14070,3575863892,3575863892,0
0,722,14071,3575863892,3575863892,0
0,722,14072,3575863892,3575863892,0
0,722,14073,3575863892,3575863892,0
0,722,14074,3575863892,3575863893,1
0,722,14075,3575863892,3575863893,1
0,722,14076,3575863892,3575863893,1
0,722,14077,3575863892,3575863893,1
0,722,14078,3575863892,3575863893,1
0,722,14079,3575863892,3575863895,3
0,722,14080,3575863892,3575863896,4
0,722,14081,3575863892,3575863896,4
0,722,14082,3575863892,3575863897,5
0,722,14083,3575863892,3575863899,7
0,722,14084,3575863892,3575863899,7
0,722,14085,3575863892,3575863900,8
0,722,14086,3575863892,3575863901,9
0,722,14087,3575863892,3575863903,11
0,722,14088,3575863892,3575863904,12
0,722,14089,3575863892,3575863905,13
0,722,14090,3575863892,3575863905,13
0,722,14091,3575863892,3575863907,15
0,722,14092,3575863892,3575863908,16
0,722,14093,3575863892,3575863909,17
0,722,14094,3575863892,3575863911,19
0,722,14095,3575863892,3575863913,21
0,722,14096,3575863892,3575863914,22
0,722,14097,3575863892,3575863915,23
0,722,14098,3575863892,3575863915,23
0,722,14099,3575863892,3575863917,25
0,722,14100,3575863892,3575863918,26
0,722,14101,3575863892,3575863918,26
0,722,14102,3575863892,3575863919,27
0,722,14103,3575863892,3575863920,28
0,722,14104,3575863892,3575863920,28
0,722,14105,3575863892,3575863922,30
0,722,14106,3575863892,3575863922,30
0,722,14107,3575863892,3575863923,31
0,722,14108,3575863892,3575863924,32
0,722,14109,3575863892,3575863925,33
0,722,14110,3575863892,3575863925,33
0,722,14111,3575863892,3575863925,33
0,722,14112,3575863892,3575863926,34
0,722,14113,3575863892,3575863927,35
0,722,14114,3575863892,3575863928,36
0,722,14115,3575863892,3575863929,37
0,722,14116,3575863892,3575863931,39
0,722,14117,3575863892,3575863932,40
0,722,14118,3575863892,3575863935,43
0,722,14119,3575863892,3575863935,43
0,722,14120,3575863892,3575863935,43
0,722,14121,3575863892,3575863936,44
0,722,14122,3575863892,3575863936,44
0,722,14123,3575863892,3575863938,46
0,722,14124,3575863892,3575863938,46
0,722,14125,3575863892,3575863938,46
0,722,14126,3575863892,3575863938,46
0,722,14127,3575863892,3575863941,49
0,723,14128,3575863948,3575863948,0
0,723,14129,3575863948,3575863948,0
0,723,14130,3575863948,3575863948,0
0,723,14131,3575863948,3575863948,0
0,723,14132,3575863948,3575863948,0
0,723,14133,3575863948,3575863948,0
0,723,14134,3575863948,3575863949,1
0,723,14135,3575863948,3575863950,2
0,723,14136,3575863948,3575863952,4
0,723,14137,3575863948,3575863954,6
0,723,14138,3575863948,3575863955,7
0,723,14139,3575863948,3575863955,7
0,723,14140,3575863948,3575863959,11
0,723,14141,3575863948,3575863959,11
0,723,14142,3575863948,3575863960,12
0,723,14143,3575863948,3575863962,14
0,723,14144,3575863948,3575863964,16
0,723,14145,3575863948,3575863964,16
0,723,14146,3575863948,3575863964,16
0,723,14147,3575863948,3575863964,16
0,723,14148,3575863948,3575863965,17
0,723,14149,3575863948,3575863968,20
0,723,14150,3575863948,3575863972,24
0,723,14151,3575863948,3575863972,24
0,723,14152,3575863948,3575863972,24
0,723,14153,3575863948,3575863975,27
0,723,14154,3575863948,3575863976,28
0,723,14155,3575863948,3575863977,29
0,723,14156,3575863948,3575863977,29
0,723,14157,3575863948,3575863980,32
0,723,14158,3575863948,3575863981,33
0,723,14159,3575863948,3575863982,34
0,723,14160,3575863948,3575863983,35
0,723,14161,3575863948,3575863985,37
0,723,14162,3575863948,3575863986,38
0,723,14163,3575863948,3575863989,41
0,723,14164,3575863948,3575863989,41
0,723,14165,3575863948,3575863996,48
0,723,14166,3575863948,3575863998,50
0,724,14167,3575864004,3575864004,0
0,724,14168,3575864004,3575864004,0
0,724,14169,3575864004,3575864005,1
0,724,14170,3575864004,3575864006,2
0,724,14171,3575864004,3575864006,2
0,724,14172,3575864004,3575864007,3
0,724,14173,3575864004,3575864008,4
0,724,14174,3575864004,3575864009,5
0,724,14175,3575864004,3575864014,10
0,724,14176,3575864004,3575864016,12
0,724,14177,3575864004,3575864016,12
0,724,14178,3575864004,3575864017,13
0,724,14179,3575864004,3575864018,14
0,724,14180,3575864004,3575864021,17
0,724,14181,3575864004,3575864027,23
0,724,14182,3575864004,3575864030,26
0,724,14183,3575864004,3575864030,26
0,724,14184,3575864004,3575864031,27
0,724,14185,3575864004,3575864032,28
0,724,14186,3575864004,3575864035,31
0,724,14187,3575864004,3575864035,31
0,724,14188,3575864004,3575864036,32
0,724,14189,3575864004,3575864038,34
0,724,14190,3575864004,3575864041,37
0,724,14191,3575864004,3575864042,38
0,724,14192,3575864004,3575864043,39
0,724,14193,3575864004,3575864047,43
0,724,14194,3575864004,3575864048,44
0,724,14195,3575864004,3575864048,44
0,724,14196,3575864004,3575864049,45
0,724,14197,3575864004,3575864053,49
0,725,14198,3575864063,3575864063,0
0,725,14199,3575864063,3575864063,0
0,725,14200,3575864063,3575864063,0
0,725,14201,3575864063,3575864063,0
0,725,14202,3575864063,3575864063,0
0,725,14203,3575864063,3575864063,0
0,725,14204,3575864063,3575864063,0
0,725,14205,3575864063,3575864063,0
0,725,14206,3575864063,3575864066,3
0,725,14207,3575864063,3575864067,4
0,725,14208,3575864063,3575864069,6
0,725,14209,3575864063,3575864078,15
0,725,14210,3575864063,3575864079,16
0,725,14211,3575864063,3575864079,16
0,725,14212,3575864063,3575864079,16
0,725,14213,3575864063,3575864080,17
0,725,14214,3575864063,3575864082,19
0,725,14215,3575864063,3575864084,21
0,725,14216,3575864063,3575864087,24
0,725,14217,3575864063,3575864087,24
0,725,14218,3575864063,3575864088,25
0,725,14219,3575864063,3575864089,26
0,725,14220,3575864063,3575864090,27
0,725,14221,3575864063,3575864090,27
0,725,14222,3575864063,3575864091,28
0,725,14223,3575864063,3575864091,28
0,725,14224,3575864063,3575864092,29
0,725,14225,3575864063,3575864093,30
0,725,14226,3575864063,3575864093,30
0,725,14227,3575864063,3575864093,30
0,725,14228,3575864063,3575864093,30
0,725,14229,3575864063,3575864094,31
0,725,14230,3575864063,3575864095,32
0,725,14231,3575864063,3575864096,33
0,725,14232,3575864063,3575864097,34
0,725,14233,3575864063,3575864097,34
0,725,14234,3575864063,3575864100,37
0,725,14235,3575864063,3575864100,37
0,725,14236,3575864063,3575864101,38
0,725,14237,3575864063,3575864102,39
0,725,14238,3575864063,3575864104,41
0,725,14239,3575864063,3575864104,41
0,725,14240,3575864063,3575864105,42
0,725,14241,3575864063,3575864106,43
0,725,14242,3575864063,3575864106,43
0,725,14243,3575864063,3575864109,46
0,725,14244,3575864063,3575864109,46
0,725,14245,3575864063,3575864112,49
0,726,14246,3575864120,3575864120,0
0,726,14247,3575864120,3575864120,0
0,726,14248,3575864120,3575864120,0
0,726,14249,3575864120,3575864120,0
0,726,14250,3575864120,3575864120,0
0,726,14251,3575864120,3575864120,0
0,726,14252,3575864120,3575864120,0
0,726,14253,3575864120,3575864121,1
0,726,14254,3575864120,3575864123,3
0,726,14255,3575864120,3575864123,3
0,726,14256,3575864120,3575864125,5
0,726,14257,3575864120,3575864125,5
0,726,14258,3575864120,3575864125,5
0,726,14259,3575864120,3575864126,6
0,726,14260,3575864120,3575864128,8
0,726,14261,3575864120,3575864128,8
0,726,14262,3575864120,3575864129,9
0,726,14263,3575864120,3575864129,9
0,726,14264,3575864120,3575864132,12
0,726,14265,3575864120,3575864133,13
0,726,14266,3575864120,3575864135,15
0,726,14267,3575864120,3575864135,15
0,726,14268,3575864120,3575864136,16
0,726,14269,3575864120,3575864136,16
0,726,14270,3575864120,3575864137,17
0,726,14271,3575864120,3575864138,18
0,726,14272,3575864120,3575864138,18
0,726,14273,3575864120,3575864138,18
0,726,14274,3575864120,3575864138,18
0,726,14275,3575864120,3575864140,20
0,726,14276,3575864120,3575864143,23
0,726,14277,3575864120,3575864145,25
0,726,14278,3575864120,3575864146,26
0,726,14279,3575864120,3575864146,26
0,726,14280,3575864120,3575864147,27
0,726,14281,3575864120,3575864149,29
0,726,14282,3575864120,3575864150,30
0,726,14283,3575864120,3575864150,30
0,726,14284,3575864120,3575864152,32
0,726,14285,3575864120,3575864155,35
0,726,14286,3575864120,3575864156,36
0,726,14287,3575864120,3575864159,39
0,726,14288,3575864120,3575864160,40
0,726,14289,3575864120,3575864162,42
0,726,14290,3575864120,3575864162,42
0,726,14291,3575864120,3575864163,43
0,726,14292,3575864120,3575864164,44
0,726,14293,3575864120,3575864165,45
0,726,14294,3575864120,3575864165,45
0,726,14295,3575864120,3575864165,45
0,726,14296,3575864120,3575864166,46
0,726,14297,3575864120,3575864166,46
0,726,14298,3575864120,3575864168,48
0,727,14299,3575864176,3575864176,0
0,727,14300,3575864176,3575864176,0
0,727,14301,3575864176,3575864176,0
0,727,14302,3575864176,3575864176,0
0,727,14303,3575864176,3575864176,0
0,727,14304,3575864176,3575864176,0
0,727,14305,3575864176,3575864177,1
0,727,14306,3575864176,3575864178,2
0,727,14307,3575864176,3575864178,2
0,727,14308,3575864176,3575864178,2
0,727,14309,3575864176,3575864179,3
0,727,14310,3575864176,3575864182,6
0,727,14311,3575864176,3575864183,7
0,727,14312,3575864176,3575864183,7
0,727,14313,3575864176,3575864189,13
0,727,14314,3575864176,3575864189,13
0,727,14315,3575864176,3575864190,14
0,727,14316,3575864176,3575864197,21
0,727,14317,3575864176,3575864198,22
0,727,14318,3575864176,3575864199,23
0,727,14319,3575864176,3575864201,25
0,727,14320,3575864176,3575864205,29
0,727,14321,3575864176,3575864206,30
0,727,14322,3575864176,3575864207,31
0,727,14323,3575864176,3575864208,32
0,727,14324,3575864176,3575864208,32
0,727,14325,3575864176,3575864209,33
0,727,14326,3575864176,3575864216,40
0,727,14327,3575864176,3575864216,40
0,727,14328,3575864176,3575864218,42
0,727,14329,3575864176,3575864218,42
0,727,14330,3575864176,3575864222,46
0,728,14331,3575864234,3575864234,0
0,728,14332,3575864234,3575864234,0
0,728,14333,3575864234,3575864234,0
0,728,14334,3575864234,3575864234,0
0,728,14335,3575864234,3575864234,0
0,728,14336,3575864234,3575864234,0
0,728,14337,3575864234,3575864235,1
0,728,14338,3575864234,3575864236,2
0,728,14339,3575864234,3575864238,4
0,728,14340,3575864234,3575864241,7
0,728,14341,3575864234,3575864242,8
0,728,14342,3575864234,3575864242,8
0,728,14343,3575864234,3575864242,8
0,728,14344,3575864234,3575864243,9
0,728,14345,3575864234,3575864245,11
0,728,14346,3575864234,3575864246,12
0,728,14347,3575864234,3575864248,14
0,728,14348,3575864234,3575864249,15
0,728,14349,3575864234,3575864249,15
0,728,14350,3575864234,3575864253,19
0,728,14351,3575864234,3575864257,23
0,728,14352,3575864234,3575864259,25
0,728,14353,3575864234,3575864260,26
0,728,14354,3575864234,3575864261,27
0,728,14355,3575864234,3575864263,29
0,728,14356,3575864234,3575864263,29
0,728,14357,3575864234,3575864265,31
0,728,14358,3575864234,3575864266,32
0,728,14359,3575864234,3575864268,34
0,728,14360,3575864234,3575864269,35
0,728,14361,3575864234,3575864273,39
0,728,14362,3575864234,3575864277,43
0,728,14363,3575864234,3575864278,44
0,728,14364,3575864234,3575864279,45
0,728,14365,3575864234,3575864280,46
0,728,14366,3575864234,3575864281,47
0,728,14367,3575864234,3575864283,49
0,729,14368,3575864292,3575864292,0
0,729,14369,3575864292,3575864292,0
0,729,14370,3575864292,3575864292,0
0,729,14371,3575864292,3575864292,0
0,729,14372,3575864292,3575864292,0
0,729,14373,3575864292,3575864292,0
0,729,14374,3575864292,3575864292,0
0,729,14375,3575864292,3575864292,0
0,729,14376,3575864292,3575864292,0
0,729,14377,3575864292,3575864293,1
0,729,14378,3575864292,3575864293,1
0,729,14379,3575864292,3575864293,1
0,729,14380,3575864292,3575864293,1
0,729,14381,3575864292,3575864295,3
0,729,14382,3575864292,3575864296,4
0,729,14383,3575864292,3575864297,5
0,729,14384,3575864292,3575864298,6
0,729,14385,3575864292,3575864299,7
0,729,14386,3575864292,3575864301,9
0,729,14387,3575864292,3575864301,9
0,729,14388,3575864292,3575864302,10
0,729,14389,3575864292,3575864304,12
0,729,14390,3575864292,3575864304,12
0,729,14391,3575864292,3575864304,12
0,729,14392,3575864292,3575864306,14
0,729,14393,3575864292,3575864306,14
0,729,14394,3575864292,3575864307,15
0,729,14395,3575864292,3575864309,17
0,729,14396,3575864292,3575864309,17
0,729,14397,3575864292,3575864312,20
0,729,14398,3575864292,3575864313,21
0,729,14399,3575864292,3575864315,23
0,729,14400,3575864292,3575864315,23
0,729,14401,3575864292,3575864316,24
0,729,14402,3575864292,3575864316,24
0,729,14403,3575864292,3575864317,25
0,729,14404,3575864292,3575864319,27
0,729,14405,3575864292,3575864319,27
0,729,14406,3575864292,3575864320,28
0,729,14407,3575864292,3575864322,30
0,729,14408,3575864292,3575864322,30
0,729,14409,3575864292,3575864323,31
0,729,14410,3575864292,3575864324,32
0,729,14411,3575864292,3575864325,33
0,729,14412,3575864292,3575864325,33
0,729,14413,3575864292,3575864326,34
0,729,14414,3575864292,3575864327,35
0,729,14415,3575864292,3575864328,36
0,729,14416,3575864292,3575864329,37
0,729,14417,3575864292,3575864329,37
0,729,14418,3575864292,3575864332,40
0,729,14419,3575864292,3575864333,41
0,729,14420,3575864292,3575864335,43
0,729,14421,3575864292,3575864336,44
0,729,14422,3575864292,3575864336,44
0,729,14423,3575864292,3575864338,46
0,729,14424,3575864292,3575864338,46
0,729,14425,3575864292,3575864339,47
0,729,14426,3575864292,3575864339,47
0,729,14427,3575864292,3575864339,47
0,729,14428,3575864292,3575864342,50
0,730,14429,3575864351,3575864351,0
0,730,14430,3575864351,3575864351,0
0,730,14431,3575864351,3575864351,0
0,730,14432,3575864351,3575864351,0
0,730,14433,3575864351,3575864351,0
0,730,14434,3575864351,3575864351,0
0,730,14435,3575864351,3575864351,0
0,730,14436,3575864351,3575864351,0
0,730,14437,3575864351,3575864352,1
0,730,14438,3575864351,3575864354,3
0,730,14439,3575864351,3575864355,4
0,730,14440,3575864351,3575864359,8
0,730,14441,3575864351,3575864360,9
0,730,14442,3575864351,3575864360,9
0,730,14443,3575864351,3575864362,11
0,730,14444,3575864351,3575864364,13
0,730,14445,3575864351,3575864365,14
0,730,14446,3575864351,3575864367,16
0,730,14447,3575864351,3575864372,21
0,730,14448,3575864351,3575864372,21
0,730,14449,3575864351,3575864373,22
0,730,14450,3575864351,3575864375,24
0,730,14451,3575864351,3575864376,25
0,730,14452,3575864351,3575864377,26
0,730,14453,3575864351,3575864378,27
0,730,14454,3575864351,3575864378,27
0,730,14455,3575864351,3575864379,28
0,730,14456,3575864351,3575864383,32
0,730,14457,3575864351,3575864383,32
0,730,14458,3575864351,3575864383,32
0,730,14459,3575864351,3575864390,39
0,730,14460,3575864351,3575864390,39
0,730,14461,3575864351,3575864391,40
0,730,14462,3575864351,3575864394,43
0,730,14463,3575864351,3575864395,44
0,730,14464,3575864351,3575864397,46
0,730,14465,3575864351,3575864398,47
0,731,14466,3575864409,3575864409,0
0,731,14467,3575864409,3575864409,0
0,731,14468,3575864409,3575864409,0
0,731,14469,3575864409,3575864409,0
0,731,14470,3575864409,3575864409,0
0,731,14471,3575864409,3575864409,0
0,731,14472,3575864409,3575864410,1
0,731,14473,3575864409,3575864415,6
0,731,14474,3575864409,3575864416,7
0,731,14475,3575864409,3575864417,8
0,731,14476,3575864409,3575864417,8
0,731,14477,3575864409,3575864418,9
0,731,14478,3575864409,3575864423,14
0,731,14479,3575864409,3575864429,20
0,731,14480,3575864409,3575864430,21
0,731,14481,3575864409,3575864430,21
0,731,14482,3575864409,3575864432,23
0,731,14483,3575864409,3575864432,23
0,731,14484,3575864409,3575864434,25
0,731,14485,3575864409,3575864435,26
0,731,14486,3575864409,3575864437,28
0,731,14487,3575864409,3575864438,29
0,731,14488,3575864409,3575864441,32
0,731,14489,3575864409,3575864443,34
0,731,14490,3575864409,3575864443,34
0,731,14491,3575864409,3575864443,34
0,731,14492,3575864409,3575864446,37
0,731,14493,3575864409,3575864446,37
0,731,14494,3575864409,3575864447,38
0,731,14495,3575864409,3575864448,39
0,731,14496,3575864409,3575864449,40
0,731,14497,3575864409,3575864453,44
0,731,14498,3575864409,3575864453,44
0,731,14499,3575864409,3575864457,48
0,731,14500,3575864409,3575864459,50
0,732,14501,3575864467,3575864467,0
0,732,14502,3575864467,3575864467,0
0,732,14503,3575864467,3575864467,0
0,732,14504,3575864467,3575864467,0
0,732,14505,3575864467,3575864467,0
0,732,14506,3575864467,3575864467,0
0,732,14507,3575864467,3575864467,0
0,732,14508,3575864467,3575864469,2
0,732,14509,3575864467,3575864478,11
0,732,14510,3575864467,3575864479,12
0,732,14511,3575864467,3575864479,12
0,732,14512,3575864467,3575864480,13
0,732,14513,3575864467,3575864481,14
0,732,14514,3575864467,3575864483,16
0,732,14515,3575864467,3575864484,17
0,732,14516,3575864467,3575864486,19
0,732,14517,3575864467,3575864488,21
0,732,14518,3575864467,3575864489,22
0,732,14519,3575864467,3575864489,22
0,732,14520,3575864467,3575864490,23
0,732,14521,3575864467,3575864490,23
0,732,14522,3575864467,3575864490,23
0,732,14523,3575864467,3575864491,24
0,732,14524,3575864467,3575864492,25
0,732,14525,3575864467,3575864493,26
0,732,14526,3575864467,3575864493,26
0,732,14527,3575864467,3575864493,26
0,732,14528,3575864467,3575864493,26
0,732,14529,3575864467,3575864493,26
0,732,14530,3575864467,3575864493,26
0,732,14531,3575864467,3575864495,28
0,732,14532,3575864467,3575864496,29
0,732,14533,3575864467,3575864498,31
0,732,14534,3575864467,3575864498,31
0,732,14535,3575864467,3575864499,32
0,732,14536,3575864467,3575864501,34
0,732,14537,3575864467,3575864502,35
0,732,14538,3575864467,3575864503,36
0,732,14539,3575864467,3575864504,37
0,732,14540,3575864467,3575864504,37
0,732,14541,3575864467,3575864504,37
0,732,14542,3575864467,3575864506,39
0,732,14543,3575864467,3575864507,40
0,732,14544,3575864467,3575864507,40
0,732,14545,3575864467,3575864509,42
0,732,14546,3575864467,3575864509,42
0,732,14547,3575864467,3575864513,46
0,732,14548,3575864467,3575864513,46
0,732,14549,3575864467,3575864515,48
0,732,14550,3575864467,3575864515,48
0,732,14551,3575864467,3575864516,49
0,732,14552,3575864467,3575864516,49
0,732,14553,3575864467,3575864518,51
0,733,14554,3575864524,3575864524,0
0,733,14555,3575864524,3575864524,0
0,733,14556,3575864524,3575864524,0
0,733,14557,3575864524,3575864524,0
0,733,14558,3575864524,3575864524,0
0,733,14559,3575864524,3575864524,0
0,733,14560,3575864524,3575864524,0
0,733,14561,3575864524,3575864525,1
0,733,14562,3575864524,3575864526,2
0,733,14563,3575864524,3575864528,4
0,733,14564,3575864524,3575864528,4
0,733,14565,3575864524,3575864528,4
0,733,14566,3575864524,3575864529,5
0,733,14567,3575864524,3575864531,7
0,733,14568,3575864524,3575864534,10
0,733,14569,3575864524,3575864535,11
0,733,14570,3575864524,3575864535,11
0,733,14571,3575864524,3575864535,11
0,733,14572,3575864524,3575864537,13
0,733,14573,3575864524,3575864537,13
0,733,14574,3575864524,3575864538,14
0,733,14575,3575864524,3575864538,14
0,733,14576,3575864524,3575864538,14
0,733,14577,3575864524,3575864540,16
0,733,14578,3575864524,3575864544,20
0,733,14579,3575864524,3575864544,20
0,733,14580,3575864524,3575864545,21
0,733,14581,3575864524,3575864547,23
0,733,14582,3575864524,3575864548,24
0,733,14583,3575864524,3575864549,25
0,733,14584,3575864524,3575864549,25
0,733,14585,3575864524,3575864550,26
0,733,14586,3575864524,3575864550,26
0,733,14587,3575864524,3575864550,26
0,733,14588,3575864524,3575864551,27
0,733,14589,3575864524,3575864553,29
0,733,14590,3575864524,3575864554,30
0,733,14591,3575864524,3575864555,31
0,733,14592,3575864524,3575864559,35
0,733,14593,3575864524,3575864559,35
0,733,14594,3575864524,3575864561,37
0,733,14595,3575864524,3575864561,37
0,733,14596,3575864524,3575864563,39
0,733,14597,3575864524,3575864564,40
0,733,14598,3575864524,3575864564,40
0,733,14599,3575864524,3575864564,40
0,733,14600,3575864524,3575864565,41
0,733,14601,3575864524,3575864566,42
0,733,14602,3575864524,3575864566,42
0,733,14603,3575864524,3575864571,47
0,733,14604,3575864524,3575864572,48
0,733,14605,3575864524,3575864572,48
0,734,14606,3575864580,3575864580,0
0,734,14607,3575864580,3575864580,0
0,734,14608,3575864580,3575864580,0
0,734,14609,3575864580,3575864580,0
0,734,14610,3575864580,3575864580,0
0,734,14611,3575864580,3575864580,0
0,734,14612,3575864580,3575864582,2
0,734,14613,3575864580,3575864582,2
0,734,14614,3575864580,3575864582,2
0,734,14615,3575864580,3575864588,8
0,734,14616,3575864580,3575864589,9
0,734,14617,3575864580,3575864591,11
0,734,14618,3575864580,3575864593,13
0,734,14619,3575864580,3575864597,17
0,734,14620,3575864580,3575864597,17
0,734,14621,3575864580,3575864598,18
0,734,14622,3575864580,3575864598,18
0,734,14623,3575864580,3575864602,22
0,734,14624,3575864580,3575864605,25
0,734,14625,3575864580,3575864605,25
0,734,14626,3575864580,3575864607,27
0,734,14627,3575864580,3575864607,27
0,734,14628,3575864580,3575864609,29
0,734,14629,3575864580,3575864610,30
0,734,14630,3575864580,3575864615,35
0,734,14631,3575864580,3575864615,35
0,734,14632,3575864580,3575864617,37
0,734,14633,3575864580,3575864617,37
0,734,14634,3575864580,3575864622,42
0,734,14635,3575864580,3575864629,49
0,734,14636,3575864580,3575864629,49
0,734,14637,3575864580,3575864629,49
0,735,14638,3575864638,3575864638,0
0,735,14639,3575864638,3575864638,0
0,735,14640,3575864638,3575864638,0
0,735,14641,3575864638,3575864638,0
0,735,14642,3575864638,3575864638,0
0,735,14643,3575864638,3575864638,0
0,735,14644,3575864638,3575864638,0
0,735,14645,3575864638,3575864641,3
0,735,14646,3575864638,3575864642,4
0,735,14647,3575864638,3575864642,4
0,735,14648,3575864638,3575864642,4
0,735,14649,3575864638,3575864647,9
0,735,14650,3575864638,3575864648,10
0,735,14651,3575864638,3575864648,10
0,735,14652,3575864638,3575864648,10
0,735,14653,3575864638,3575864652,14
0,735,14654,3575864638,3575864653,15
0,735,14655,3575864638,3575864656,18
0,735,14656,3575864638,3575864658,20
0,735,14657,3575864638,3575864659,21
0,735,14658,3575864638,3575864660,22
0,735,14659,3575864638,3575864662,24
0,735,14660,3575864638,3575864663,25
0,735,14661,3575864638,3575864664,26
0,735,14662,3575864638,3575864666,28
0,735,14663,3575864638,3575864667,29
0,735,14664,3575864638,3575864668,30
0,735,14665,3575864638,3575864668,30
0,735,14666,3575864638,3575864674,36
0,735,14667,3575864638,3575864678,40
0,735,14668,3575864638,3575864680,42
0,735,14669,3575864638,3575864680,42
0,735,14670,3575864638,3575864680,42
0,735,14671,3575864638,3575864681,43
0,735,14672,3575864638,3575864683,45
0,735,14673,3575864638,3575864684,46
0,735,14674,3575864638,3575864687,49
0,735,14675,3575864638,3575864688,50
0,736,14676,3575864695,3575864695,0
0,736,14677,3575864695,3575864695,0
0,736,14678,3575864695,3575864695,0
0,736,14679,3575864695,3575864695,0
0,736,14680,3575864695,3575864695,0
0,736,14681,3575864695,3575864695,0
0,736,14682,3575864695,3575864695,0
0,736,14683,3575864695,3575864695,0
0,736,14684,3575864695,3575864695,0
0,736,14685,3575864695,3575864695,0
0,736,14686,3575864695,3575864695,0
0,736,14687,3575864695,3575864695,0
0,736,14688,3575864695,3575864695,0
0,736,14689,3575864695,3575864697,2
0,736,14690,3575864695,3575864698,3
0,736,14691,3575864695,3575864699,4
0,736,14692,3575864695,3575864699,4
0,736,14693,3575864695,3575864701,6
0,736,14694,3575864695,3575864702,7
0,736,14695,3575864695,3575864704,9
0,736,14696,3575864695,3575864705,10
0,736,14697,3575864695,3575864705,10
0,736,14698,3575864695,3575864706,11
0,736,14699,3575864695,3575864706,11
0,736,14700,3575864695,3575864707,12
0,736,14701,3575864695,3575864713,18
0,736,14702,3575864695,3575864713,18
0,736,14703,3575864695,3575864714,19
0,736,14704,3575864695,3575864716,21
0,736,14705,3575864695,3575864716,21
0,736,14706,3575864695,3575864717,22
0,736,14707,3575864695,3575864718,23
0,736,14708,3575864695,3575864719,24
0,736,14709,3575864695,3575864720,25
0,736,14710,3575864695,3575864721,26
0,736,14711,3575864695,3575864722,27
0,736,14712,3575864695,3575864723,28
0,736,14713,3575864695,3575864724,29
0,736,14714,3575864695,3575864724,29
0,736,14715,3575864695,3575864725,30
0,736,14716,3575864695,3575864725,30
0,736,14717,3575864695,3575864727,32
0,736,14718,3575864695,3575864728,33
0,736,14719,3575864695,3575864728,33
0,736,14720,3575864695,3575864728,33
0,736,14721,3575864695,3575864728,33
0,736,14722,3575864695,3575864731,36
0,736,14723,3575864695,3575864734,39
0,736,14724,3575864695,3575864735,40
0,736,14725,3575864695,3575864735,40
0,736,14726,3575864695,3575864735,40
0,736,14727,3575864695,3575864737,42
0,736,14728,3575864695,3575864737,42
0,736,14729,3575864695,3575864737,42
0,736,14730,3575864695,3575864738,43
0,736,14731,3575864695,3575864738,43
0,736,14732,3575864695,3575864740,45
0,736,14733,3575864695,3575864741,46
0,736,14734,3575864695,3575864744,49
0,737,14735,3575864750,3575864750,0
0,737,14736,3575864750,3575864750,0
0,737,14737,3575864750,3575864750,0
0,737,14738,3575864750,3575864750,0
0,737,14739,3575864750,3575864750,0
0,737,14740,3575864750,3575864750,0
0,737,14741,3575864750,3575864750,0
0,737,14742,3575864750,3575864750,0
0,737,14743,3575864750,3575864751,1
0,737,14744,3575864750,3575864752,2
0,737,14745,3575864750,3575864753,3
0,737,14746,3575864750,3575864753,3
0,737,14747,3575864750,3575864755,5
0,737,14748,3575864750,3575864758,8
0,737,14749,3575864750,3575864759,9
0,737,14750,3575864750,3575864761,11
0,737,14751,3575864750,3575864761,11
0,737,14752,3575864750,3575864763,13
0,737,14753,3575864750,3575864763,13
0,737,14754,3575864750,3575864764,14
0,737,14755,3575864750,3575864764,14
0,737,14756,3575864750,3575864765,15
0,737,14757,3575864750,3575864767,17
0,737,14758,3575864750,3575864767,17
0,737,14759,3575864750,3575864771,21
0,737,14760,3575864750,3575864772,22
0,737,14761,3575864750,3575864772,22
0,737,14762,3575864750,3575864774,24
0,737,14763,3575864750,3575864776,26
0,737,14764,3575864750,3575864776,26
0,737,14765,3575864750,3575864777,27
0,737,14766,3575864750,3575864777,27
0,737,14767,3575864750,3575864780,30
0,737,14768,3575864750,3575864782,32
0,737,14769,3575864750,3575864782,32
0,737,14770,3575864750,3575864786,36
0,737,14771,3575864750,3575864788,38
0,737,14772,3575864750,3575864789,39
0,737,14773,3575864750,3575864790,40
0,737,14774,3575864750,3575864793,43
0,737,14775,3575864750,3575864797,47
0,737,14776,3575864750,3575864798,48
0,737,14777,3575864750,3575864798,48
0,738,14778,3575864808,3575864808,0
0,738,14779,3575864808,3575864808,0
0,738,14780,3575864808,3575864808,0
0,738,14781,3575864808,3575864808,0
0,738,14782,3575864808,3575864808,0
0,738,14783,3575864808,3575864809,1
0,738,14784,3575864808,3575864810,2
0,738,14785,3575864808,3575864815,7
0,738,14786,3575864808,3575864816,8
0,738,14787,3575864808,3575864817,9
0,738,14788,3575864808,3575864817,9
0,738,14789,3575864808,3575864822,14
0,738,14790,3575864808,3575864829,21
0,738,14791,3575864808,3575864829,21
0,738,14792,3575864808,3575864830,22
0,738,14793,3575864808,3575864831,23
0,738,14794,3575864808,3575864831,23
0,738,14795,3575864808,3575864832,24
0,738,14796,3575864808,3575864834,26
0,738,14797,3575864808,3575864834,26
0,738,14798,3575864808,3575864836,28
0,738,14799,3575864808,3575864837,29
0,738,14800,3575864808,3575864841,33
0,738,14801,3575864808,3575864842,34
0,738,14802,3575864808,3575864842,34
0,738,14803,3575864808,3575864847,39
0,738,14804,3575864808,3575864848,40
0,738,14805,3575864808,3575864849,41
0,738,14806,3575864808,3575864851,43
0,738,14807,3575864808,3575864852,44
0,738,14808,3575864808,3575864852,44
0,738,14809,3575864808,3575864858,50
0,739,14810,3575864865,3575864865,0
0,739,14811,3575864865,3575864865,0
0,739,14812,3575864865,3575864865,0
0,739,14813,3575864865,3575864865,0
0,739,14814,3575864865,3575864866,1
0,739,14815,3575864865,3575864867,2
0,739,14816,3575864865,3575864868,3
0,739,14817,3575864865,3575864878,13
0,739,14818,3575864865,3575864879,14
0,739,14819,3575864865,3575864879,14
0,739,14820,3575864865,3575864880,15
0,739,14821,3575864865,3575864880,15
0,739,14822,3575864865,3575864881,16
0,739,14823,3575864865,3575864884,19
0,739,14824,3575864865,3575864887,22
0,739,14825,3575864865,3575864887,22
0,739,14826,3575864865,3575864889,24
0,739,14827,3575864865,3575864890,25
0,739,14828,3575864865,3575864891,26
0,739,14829,3575864865,3575864892,27
0,739,14830,3575864865,3575864892,27
0,739,14831,3575864865,3575864892,27
0,739,14832,3575864865,3575864893,28
0,739,14833,3575864865,3575864893,28
0,739,14834,3575864865,3575864893,28
0,739,14835,3575864865,3575864894,29
0,739,14836,3575864865,3575864894,29
0,739,14837,3575864865,3575864895,30
0,739,14838,3575864865,3575864896,31
0,739,14839,3575864865,3575864897,32
0,739,14840,3575864865,3575864899,34
0,739,14841,3575864865,3575864901,36
0,739,14842,3575864865,3575864902,37
0,739,14843,3575864865,3575864903,38
0,739,14844,3575864865,3575864904,39
0,739,14845,3575864865,3575864904,39
0,739,14846,3575864865,3575864905,40
0,739,14847,3575864865,3575864905,40
0,739,14848,3575864865,3575864906,41
0,739,14849,3575864865,3575864906,41
0,739,14850,3575864865,3575864907,42
0,739,14851,3575864865,3575864909,44
0,739,14852,3575864865,3575864913,48
0,739,14853,3575864865,3575864914,49
0,739,14854,3575864865,3575864914,49
0,740,14855,3575864926,3575864926,0
0,740,14856,3575864926,3575864926,0
0,740,14857,3575864926,3575864926,0
0,740,14858,3575864926,3575864926,0
0,740,14859,3575864926,3575864926,0
0,740,14860,3575864926,3575864926,0
0,740,14861,3575864926,3575864926,0
0,740,14862,3575864926,3575864926,0
0,740,14863,3575864926,3575864926,0
0,740,14864,3575864926,3575864926,0
0,740,14865,3575864926,3575864926,0
0,740,14866,3575864926,3575864926,0
0,740,14867,3575864926,3575864926,0
0,740,14868,3575864926,3575864927,1
0,740,14869,3575864926,3575864928,2
0,740,14870,3575864926,3575864928,2
0,740,14871,3575864926,3575864929,3
0,740,14872,3575864926,3575864932,6
0,740,14873,3575864926,3575864933,7
0,740,14874,3575864926,3575864934,8
0,740,14875,3575864926,3575864935,9
0,740,14876,3575864926,3575864935,9
0,740,14877,3575864926,3575864938,12
0,740,14878,3575864926,3575864938,12
0,740,14879,3575864926,3575864938,12
0,740,14880,3575864926,3575864940,14
0,740,14881,3575864926,3575864943,17
0,740,14882,3575864926,3575864944,18
0,740,14883,3575864926,3575864947,21
0,740,14884,3575864926,3575864948,22
0,740,14885,3575864926,3575864949,23
0,740,14886,3575864926,3575864949,23
0,740,14887,3575864926,3575864950,24
0,740,14888,3575864926,3575864950,24
0,740,14889,3575864926,3575864950,24
0,740,14890,3575864926,3575864952,26
0,740,14891,3575864926,3575864953,27
0,740,14892,3575864926,3575864954,28
0,740,14893,3575864926,3575864955,29
0,740,14894,3575864926,3575864955,29
0,740,14895,3575864926,3575864959,33
0,740,14896,3575864926,3575864961,35
0,740,14897,3575864926,3575864961,35
0,740,14898,3575864926,3575864963,37
0,740,14899,3575864926,3575864964,38
0,740,14900,3575864926,3575864964,38
0,740,14901,3575864926,3575864964,38
0,740,14902,3575864926,3575864965,39
0,740,14903,3575864926,3575864966,40
0,740,14904,3575864926,3575864967,41
0,740,14905,3575864926,3575864968,42
0,740,14906,3575864926,3575864971,45
0,740,14907,3575864926,3575864972,46
0,740,14908,3575864926,3575864972,46
0,740,14909,3575864926,3575864974,48
0,740,14910,3575864926,3575864976,50
0,741,14911,3575864983,3575864983,0
0,741,14912,3575864983,3575864983,0
0,741,14913,3575864983,3575864983,0
0,741,14914,3575864983,3575864983,0
0,741,14915,3575864983,3575864983,0
0,741,14916,3575864983,3575864983,0
0,741,14917,3575864983,3575864983,0
0,741,14918,3575864983,3575864990,7
0,741,14919,3575864983,3575864990,7
0,741,14920,3575864983,3575864994,11
0,741,14921,3575864983,3575864996,13
0,741,14922,3575864983,3575864998,15
0,741,14923,3575864983,3575864998,15
0,741,14924,3575864983,3575865003,20
0,741,14925,3575864983,3575865005,22
0,741,14926,3575864983,3575865005,22
0,741,14927,3575864983,3575865007,24
0,741,14928,3575864983,3575865008,25
0,741,14929,3575864983,3575865008,25
0,741,14930,3575864983,3575865010,27
0,741,14931,3575864983,3575865010,27
0,741,14932,3575864983,3575865015,32
0,741,14933,3575864983,3575865015,32
0,741,14934,3575864983,3575865017,34
0,741,14935,3575864983,3575865018,35
0,741,14936,3575864983,3575865022,39
0,741,14937,3575864983,3575865029,46
0,741,14938,3575864983,3575865030,47
0,741,14939,3575864983,3575865030,47
0,741,14940,3575864983,3575865030,47
0,741,14941,3575864983,3575865033,50
0,742,14942,3575865040,3575865040,0
0,742,14943,3575865040,3575865040,0
0,742,14944,3575865040,3575865040,0
0,742,14945,3575865040,3575865041,1
0,742,14946,3575865040,3575865041,1
0,742,14947,3575865040,3575865042,2
0,742,14948,3575865040,3575865044,4
0,742,14949,3575865040,3575865046,6
0,742,14950,3575865040,3575865047,7
0,742,14951,3575865040,3575865047,7
0,742,14952,3575865040,3575865049,9
0,742,14953,3575865040,3575865049,9
0,742,14954,3575865040,3575865051,11
0,742,14955,3575865040,3575865052,12
0,742,14956,3575865040,3575865053,13
0,742,14957,3575865040,3575865056,16
0,742,14958,3575865040,3575865057,17
0,742,14959,3575865040,3575865057,17
0,742,14960,3575865040,3575865059,19
0,742,14961,3575865040,3575865061,21
0,742,14962,3575865040,3575865064,24
0,742,14963,3575865040,3575865064,24
0,742,14964,3575865040,3575865064,24
0,742,14965,3575865040,3575865066,26
0,742,14966,3575865040,3575865067,27
0,742,14967,3575865040,3575865068,28
0,742,14968,3575865040,3575865074,34
0,742,14969,3575865040,3575865079,39
0,742,14970,3575865040,3575865079,39
0,742,14971,3575865040,3575865080,40
0,742,14972,3575865040,3575865080,40
0,742,14973,3575865040,3575865082,42
0,742,14974,3575865040,3575865083,43
0,742,14975,3575865040,3575865084,44
0,742,14976,3575865040,3575865086,46
0,742,14977,3575865040,3575865087,47
0,742,14978,3575865040,3575865090,50
0,743,14979,3575865097,3575865097,0
0,743,14980,3575865097,3575865097,0
0,743,14981,3575865097,3575865097,0
0,743,14982,3575865097,3575865097,0
0,743,14983,3575865097,3575865097,0
0,743,14984,3575865097,3575865097,0
0,743,14985,3575865097,3575865097,0
0,743,14986,3575865097,3575865097,0
0,743,14987,3575865097,3575865097,0
0,743,14988,3575865097,3575865097,0
0,743,14989,3575865097,3575865097,0
0,743,14990,3575865097,3575865097,0
0,743,14991,3575865097,3575865097,0
0,743,14992,3575865097,3575865097,0
0,743,14993,3575865097,3575865097,0
0,743,14994,3575865097,3575865098,1
0,743,14995,3575865097,3575865099,2
0,743,14996,3575865097,3575865101,4
0,743,14997,3575865097,3575865104,7
0,743,14998,3575865097,3575865105,8
0,743,14999,3575865097,3575865106,9
0,743,15000,3575865097,3575865106,9
0,743,15001,3575865097,3575865107,10
0,743,15002,3575865097,3575865107,10
0,743,15003,3575865097,3575865107,10
0,743,15004,3575865097,3575865109,12
0,743,15005,3575865097,3575865113,16
0,743,15006,3575865097,3575865114,17
0,743,15007,3575865097,3575865115,18
0,743,15008,3575865097,3575865116,19
0,743,15009,3575865097,3575865117,20
0,743,15010,3575865097,3575865117,20
0,743,15011,3575865097,3575865118,21
0,743,15012,3575865097,3575865120,23
0,743,15013,3575865097,3575865121,24
0,743,15014,3575865097,3575865122,25
0,743,15015,3575865097,3575865122,25
0,743,15016,3575865097,3575865123,26
0,743,15017,3575865097,3575865124,27
0,743,15018,3575865097,3575865124,27
0,743,15019,3575865097,3575865125,28
0,743,15020,3575865097,3575865125,28
0,743,15021,3575865097,3575865126,29
0,743,15022,3575865097,3575865126,29
0,743,15023,3575865097,3575865127,30
0,743,15024,3575865097,3575865128,31
0,743,15025,3575865097,3575865128,31
0,743,15026,3575865097,3575865128,31
0,743,15027,3575865097,3575865128,31
0,743,15028,3575865097,3575865132,35
0,743,15029,3575865097,3575865134,37
0,743,15030,3575865097,3575865134,37
0,743,15031,3575865097,3575865135,38
0,743,15032,3575865097,3575865136,39
0,743,15033,3575865097,3575865136,39
0,743,15034,3575865097,3575865137,40
0,743,15035,3575865097,3575865138,41
0,743,15036,3575865097,3575865138,41
0,743,15037,3575865097,3575865139,42
0,743,15038,3575865097,3575865141,44
0,743,15039,3575865097,3575865143,46
0,743,15040,3575865097,3575865144,47
0,743,15041,3575865097,3575865146,49
0,744,15042,3575865154,3575865154,0
0,744,15043,3575865154,3575865154,0
0,744,15044,3575865154,3575865154,0
0,744,15045,3575865154,3575865154,0
0,744,15046,3575865154,3575865154,0
0,744,15047,3575865154,3575865154,0
0,744,15048,3575865154,3575865154,0
0,744,15049,3575865154,3575865154,0
0,744,15050,3575865154,3575865154,0
0,744,15051,3575865154,3575865154,0
0,744,15052,3575865154,3575865155,1
0,744,15053,3575865154,3575865158,4
0,744,15054,3575865154,3575865159,5
0,744,15055,3575865154,3575865161,7
0,744,15056,3575865154,3575865161,7
0,744,15057,3575865154,3575865164,10
0,744,15058,3575865154,3575865164,10
0,744,15059,3575865154,3575865164,10
0,744,15060,3575865154,3575865164,10
0,744,15061,3575865154,3575865166,12
0,744,15062,3575865154,3575865166,12
0,744,15063,3575865154,3575865167,13
0,744,15064,3575865154,3575865168,14
0,744,15065,3575865154,3575865172,18
0,744,15066,3575865154,3575865172,18
0,744,15067,3575865154,3575865172,18
0,744,15068,3575865154,3575865174,20
0,744,15069,3575865154,3575865175,21
0,744,15070,3575865154,3575865176,22
0,744,15071,3575865154,3575865176,22
0,744,15072,3575865154,3575865178,24
0,744,15073,3575865154,3575865179,25
0,744,15074,3575865154,3575865182,28
0,744,15075,3575865154,3575865182,28
0,744,15076,3575865154,3575865189,35
0,744,15077,3575865154,3575865190,36
0,744,15078,3575865154,3575865194,40
0,744,15079,3575865154,3575865196,42
0,744,15080,3575865154,3575865198,44
0,744,15081,3575865154,3575865199,45
0,744,15082,3575865154,3575865203,49
0,745,15083,3575865211,3575865211,0
0,745,15084,3575865211,3575865211,0
0,745,15085,3575865211,3575865211,0
0,745,15086,3575865211,3575865211,0
0,745,15087,3575865211,3575865211,0
0,745,15088,3575865211,3575865211,0
0,745,15089,3575865211,3575865213,2
0,745,15090,3575865211,3575865215,4
0,745,15091,3575865211,3575865216,5
0,745,15092,3575865211,3575865217,6
0,745,15093,3575865211,3575865218,7
0,745,15094,3575865211,3575865222,11
0,745,15095,3575865211,3575865229,18
0,745,15096,3575865211,3575865230,19
0,745,15097,3575865211,3575865230,19
0,745,15098,3575865211,3575865231,20
0,745,15099,3575865211,3575865232,21
0,745,15100,3575865211,3575865235,24
0,745,15101,3575865211,3575865237,26
0,745,15102,3575865211,3575865238,27
0,745,15103,3575865211,3575865242,31
0,745,15104,3575865211,3575865242,31
0,745,15105,3575865211,3575865242,31
0,745,15106,3575865211,3575865245,34
0,745,15107,3575865211,3575865245,34
0,745,15108,3575865211,3575865246,35
0,745,15109,3575865211,3575865247,36
0,745,15110,3575865211,3575865249,38
0,745,15111,3575865211,3575865249,38
0,745,15112,3575865211,3575865251,40
0,745,15113,3575865211,3575865252,41
0,745,15114,3575865211,3575865257,46
0,745,15115,3575865211,3575865258,47
0,745,15116,3575865211,3575865259,48
0,745,15117,3575865211,3575865261,50
0,746,15118,3575865269,3575865269,0
0,746,15119,3575865269,3575865269,0
0,746,15120,3575865269,3575865269,0
0,746,15121,3575865269,3575865269,0
0,746,15122,3575865269,3575865269,0
0,746,15123,3575865269,3575865270,1
0,746,15124,3575865269,3575865277,8
0,746,15125,3575865269,3575865279,10
0,746,15126,3575865269,3575865280,11
0,746,15127,3575865269,3575865280,11
0,746,15128,3575865269,3575865280,11
0,746,15129,3575865269,3575865282,13
0,746,15130,3575865269,3575865283,14
0,746,15131,3575865269,3575865284,15
0,746,15132,3575865269,3575865286,17
0,746,15133,3575865269,3575865287,18
0,746,15134,3575865269,3575865289,20
0,746,15135,3575865269,3575865290,21
0,746,15136,3575865269,3575865290,21
0,746,15137,3575865269,3575865290,21
0,746,15138,3575865269,3575865290,21
0,746,15139,3575865269,3575865291,22
0,746,15140,3575865269,3575865292,23
0,746,15141,3575865269,3575865292,23
0,746,15142,3575865269,3575865292,23
0,746,15143,3575865269,3575865292,23
0,746,15144,3575865269,3575865293,24
0,746,15145,3575865269,3575865293,24
0,746,15146,3575865269,3575865294,25
0,746,15147,3575865269,3575865295,26
0,746,15148,3575865269,3575865297,28
0,746,15149,3575865269,3575865298,29
0,746,15150,3575865269,3575865298,29
0,746,15151,3575865269,3575865300,31
0,746,15152,3575865269,3575865301,32
0,746,15153,3575865269,3575865304,35
0,746,15154,3575865269,3575865305,36
0,746,15155,3575865269,3575865305,36
0,746,15156,3575865269,3575865306,37
0,746,15157,3575865269,3575865306,37
0,746,15158,3575865269,3575865307,38
0,746,15159,3575865269,3575865308,39
0,746,15160,3575865269,3575865309,40
0,746,15161,3575865269,3575865309,40
0,746,15162,3575865269,3575865311,42
0,746,15163,3575865269,3575865313,44
0,746,15164,3575865269,3575865314,45
0,746,15165,3575865269,3575865315,46
0,746,15166,3575865269,3575865316,47
0,746,15167,3575865269,3575865317,48
0,746,15168,3575865269,3575865318,49
0,747,15169,3575865325,3575865325,0
0,747,15170,3575865325,3575865325,0
0,747,15171,3575865325,3575865325,0
0,747,15172,3575865325,3575865325,0
0,747,15173,3575865325,3575865325,0
0,747,15174,3575865325,3575865325,0
0,747,15175,3575865325,3575865326,1
0,747,15176,3575865325,3575865328,3
0,747,15177,3575865325,3575865328,3
0,747,15178,3575865325,3575865329,4
0,747,15179,3575865325,3575865329,4
0,747,15180,3575865325,3575865332,7
0,747,15181,3575865325,3575865334,9
0,747,15182,3575865325,3575865334,9
0,747,15183,3575865325,3575865336,11
0,747,15184,3575865325,3575865337,12
0,747,15185,3575865325,3575865338,13
0,747,15186,3575865325,3575865338,13
0,747,15187,3575865325,3575865338,13
0,747,15188,3575865325,3575865341,16
0,747,15189,3575865325,3575865342,17
0,747,15190,3575865325,3575865345,20
0,747,15191,3575865325,3575865349,24
0,747,15192,3575865325,3575865349,24
0,747,15193,3575865325,3575865349,24
0,747,15194,3575865325,3575865350,25
0,747,15195,3575865325,3575865350,25
0,747,15196,3575865325,3575865350,25
0,747,15197,3575865325,3575865350,25
0,747,15198,3575865325,3575865355,30
0,747,15199,3575865325,3575865355,30
0,747,15200,3575865325,3575865359,34
0,747,15201,3575865325,3575865360,35
0,747,15202,3575865325,3575865361,36
0,747,15203,3575865325,3575865361,36
0,747,15204,3575865325,3575865362,37
0,747,15205,3575865325,3575865362,37
0,747,15206,3575865325,3575865364,39
0,747,15207,3575865325,3575865364,39
0,747,15208,3575865325,3575865364,39
0,747,15209,3575865325,3575865365,40
0,747,15210,3575865325,3575865367,42
0,747,15211,3575865325,3575865367,42
0,747,15212,3575865325,3575865372,47
0,747,15213,3575865325,3575865372,47
0,747,15214,3575865325,3575865373,48
0,747,15215,3575865325,3575865374,49
0,748,15216,3575865384,3575865384,0
0,748,15217,3575865384,3575865384,0
0,748,15218,3575865384,3575865384,0
0,748,15219,3575865384,3575865384,0
0,748,15220,3575865384,3575865384,0
0,748,15221,3575865384,3575865384,0
0,748,15222,3575865384,3575865384,0
0,748,15223,3575865384,3575865384,0
0,748,15224,3575865384,3575865384,0
0,748,15225,3575865384,3575865384,0
0,748,15226,3575865384,3575865390,6
0,748,15227,3575865384,3575865390,6
0,748,15228,3575865384,3575865394,10
0,748,15229,3575865384,3575865397,13
0,748,15230,3575865384,3575865399,15
0,748,15231,3575865384,3575865404,20
0,748,15232,3575865384,3575865406,22
0,748,15233,3575865384,3575865406,22
0,748,15234,3575865384,3575865408,24
0,748,15235,3575865384,3575865409,25
0,748,15236,3575865384,3575865411,27
0,748,15237,3575865384,3575865412,28
0,748,15238,3575865384,3575865413,29
0,748,15239,3575865384,3575865415,31
0,748,15240,3575865384,3575865417,33
0,748,15241,3575865384,3575865418,34
0,748,15242,3575865384,3575865418,34
0,748,15243,3575865384,3575865423,39
0,748,15244,3575865384,3575865429,45
0,748,15245,3575865384,3575865430,46
0,748,15246,3575865384,3575865430,46
0,748,15247,3575865384,3575865431,47
0,748,15248,3575865384,3575865433,49
0,748,15249,3575865384,3575865434,50
0,749,15250,3575865439,3575865439,0
0,749,15251,3575865439,3575865439,0
0,749,15252,3575865439,3575865442,3
0,749,15253,3575865439,3575865442,3
0,749,15254,3575865439,3575865443,4
0,749,15255,3575865439,3575865445,6
0,749,15256,3575865439,3575865446,7
0,749,15257,3575865439,3575865446,7
0,749,15258,3575865439,3575865448,9
0,749,15259,3575865439,3575865448,9
0,749,15260,3575865439,3575865449,10
0,749,15261,3575865439,3575865451,12
0,749,15262,3575865439,3575865453,14
0,749,15263,3575865439,3575865456,17
0,749,15264,3575865439,3575865459,20
0,749,15265,3575865439,3575865460,21
0,749,15266,3575865439,3575865461,22
0,749,15267,3575865439,3575865464,25
0,749,15268,3575865439,3575865465,26
0,749,15269,3575865439,3575865465,26
0,749,15270,3575865439,3575865467,28
0,749,15271,3575865439,3575865468,29
0,749,15272,3575865439,3575865469,30
0,749,15273,3575865439,3575865469,30
0,749,15274,3575865439,3575865470,31
0,749,15275,3575865439,3575865474,35
0,749,15276,3575865439,3575865478,39
0,749,15277,3575865439,3575865479,40
0,749,15278,3575865439,3575865479,40
0,749,15279,3575865439,3575865480,41
0,749,15280,3575865439,3575865480,41
0,749,15281,3575865439,3575865481,42
0,749,15282,3575865439,3575865483,44
0,749,15283,3575865439,3575865485,46
0,749,15284,3575865439,3575865486,47
0,749,15285,3575865439,3575865487,48
0,750,15286,3575865496,3575865496,0
0,750,15287,3575865496,3575865496,0
0,750,15288,3575865496,3575865496,0
0,750,15289,3575865496,3575865496,0
0,750,15290,3575865496,3575865496,0
0,750,15291,3575865496,3575865496,0
0,750,15292,3575865496,3575865496,0
0,750,15293,3575865496,3575865496,0
0,750,15294,3575865496,3575865496,0
0,750,15295,3575865496,3575865496,0
0,750,15296,3575865496,3575865496,0
0,750,15297,3575865496,3575865496,0
0,750,15298,3575865496,3575865496,0
0,750,15299,3575865496,3575865496,0
0,750,15300,3575865496,3575865496,0
0,750,15301,3575865496,3575865497,1
0,750,15302,3575865496,3575865500,4
0,750,15303,3575865496,3575865500,4
0,750,15304,3575865496,3575865503,7
0,750,15305,3575865496,3575865504,8
0,750,15306,3575865496,3575865504,8
0,750,15307,3575865496,3575865505,9
0,750,15308,3575865496,3575865506,10
0,750,15309,3575865496,3575865507,11
0,750,15310,3575865496,3575865508,12
0,750,15311,3575865496,3575865508,12
0,750,15312,3575865496,3575865510,14
0,750,15313,3575865496,3575865511,15
0,750,15314,3575865496,3575865513,17
0,750,15315,3575865496,3575865514,18
0,750,15316,3575865496,3575865516,20
0,750,15317,3575865496,3575865517,21
0,750,15318,3575865496,3575865517,21
0,750,15319,3575865496,3575865520,24
0,750,15320,3575865496,3575865521,25
0,750,15321,3575865496,3575865522,26
0,750,15322,3575865496,3575865522,26
0,750,15323,3575865496,3575865523,27
0,750,15324,3575865496,3575865524,28
0,750,15325,3575865496,3575865524,28
0,750,15326,3575865496,3575865525,29
0,750,15327,3575865496,3575865526,30
0,750,15328,3575865496,3575865527,31
0,750,15329,3575865496,3575865528,32
0,750,15330,3575865496,3575865528,32
0,750,15331,3575865496,3575865529,33
0,750,15332,3575865496,3575865531,35
0,750,15333,3575865496,3575865533,37
0,750,15334,3575865496,3575865533,37
0,750,15335,3575865496,3575865535,39
0,750,15336,3575865496,3575865535,39
0,750,15337,3575865496,3575865535,39
0,750,15338,3575865496,3575865537,41
0,750,15339,3575865496,3575865537,41
0,750,15340,3575865496,3575865537,41
0,750,15341,3575865496,3575865537,41
0,750,15342,3575865496,3575865538,42
0,750,15343,3575865496,3575865540,44
0,750,15344,3575865496,3575865541,45
0,750,15345,3575865496,3575865544,48
0,751,15346,3575865553,3575865553,0
0,751,15347,3575865553,3575865553,0
0,751,15348,3575865553,3575865553,0
0,751,15349,3575865553,3575865553,0
0,751,15350,3575865553,3575865553,0
0,751,15351,3575865553,3575865553,0
0,751,15352,3575865553,3575865553,0
0,751,15353,3575865553,3575865553,0
0,751,15354,3575865553,3575865554,1
0,751,15355,3575865553,3575865554,1
0,751,15356,3575865553,3575865558,5
0,751,15357,3575865553,3575865559,6
0,751,15358,3575865553,3575865560,7
0,751,15359,3575865553,3575865561,8
0,751,15360,3575865553,3575865562,9
0,751,15361,3575865553,3575865563,10
0,751,15362,3575865553,3575865564,11
0,751,15363,3575865553,3575865564,11
0,751,15364,3575865553,3575865565,12
0,751,15365,3575865553,3575865566,13
0,751,15366,3575865553,3575865566,13
0,751,15367,3575865553,3575865567,14
0,751,15368,3575865553,3575865571,18
0,751,15369,3575865553,3575865571,18
0,751,15370,3575865553,3575865572,19
0,751,15371,3575865553,3575865573,20
0,751,15372,3575865553,3575865575,22
0,751,15373,3575865553,3575865575,22
0,751,15374,3575865553,3575865576,23
0,751,15375,3575865553,3575865576,23
0,751,15376,3575865553,3575865577,24
0,751,15377,3575865553,3575865578,25
0,751,15378,3575865553,3575865581,28
0,751,15379,3575865553,3575865582,29
0,751,15380,3575865553,3575865582,29
0,751,15381,3575865553,3575865586,33
0,751,15382,3575865553,3575865588,35
0,751,15383,3575865553,3575865588,35
0,751,15384,3575865553,3575865590,37
0,751,15385,3575865553,3575865594,41
0,751,15386,3575865553,3575865597,44
0,751,15387,3575865553,3575865602,49
0,752,15388,3575865611,3575865611,0
0,752,15389,3575865611,3575865611,0
0,752,15390,3575865611,3575865611,0
0,752,15391,3575865611,3575865611,0
0,752,15392,3575865611,3575865611,0
0,752,15393,3575865611,3575865612,1
0,752,15394,3575865611,3575865612,1
0,752,15395,3575865611,3575865614,3
0,752,15396,3575865611,3575865615,4
0,752,15397,3575865611,3575865617,6
0,752,15398,3575865611,3575865620,9
0,752,15399,3575865611,3575865622,11
0,752,15400,3575865611,3575865628,17
0,752,15401,3575865611,3575865629,18
0,752,15402,3575865611,3575865629,18
0,752,15403,3575865611,3575865632,21
0,752,15404,3575865611,3575865632,21
0,752,15405,3575865611,3575865633,22
0,752,15406,3575865611,3575865634,23
0,752,15407,3575865611,3575865637,26
0,752,15408,3575865611,3575865638,27
0,752,15409,3575865611,3575865641,30
0,752,15410,3575865611,3575865642,31
0,752,15411,3575865611,3575865642,31
0,752,15412,3575865611,3575865645,34
0,752,15413,3575865611,3575865645,34
0,752,15414,3575865611,3575865645,34
0,752,15415,3575865611,3575865647,36
0,752,15416,3575865611,3575865648,37
0,752,15417,3575865611,3575865650,39
0,752,15418,3575865611,3575865651,40
0,752,15419,3575865611,3575865656,45
0,752,15420,3575865611,3575865659,48
0,753,15421,3575865668,3575865668,0
0,753,15422,3575865668,3575865668,0
0,753,15423,3575865668,3575865668,0
0,753,15424,3575865668,3575865668,0
0,753,15425,3575865668,3575865668,0
0,753,15426,3575865668,3575865669,1
0,753,15427,3575865668,3575865669,1
0,753,15428,3575865668,3575865677,9
0,753,15429,3575865668,3575865679,11
0,753,15430,3575865668,3575865680,12
0,753,15431,3575865668,3575865680,12
0,753,15432,3575865668,3575865680,12
0,753,15433,3575865668,3575865682,14
0,753,15434,3575865668,3575865683,15
0,753,15435,3575865668,3575865685,17
0,753,15436,3575865668,3575865686,18
0,753,15437,3575865668,3575865687,19
0,753,15438,3575865668,3575865690,22
0,753,15439,3575865668,3575865690,22
0,753,15440,3575865668,3575865690,22
0,753,15441,3575865668,3575865690,22
0,753,15442,3575865668,3575865691,23
0,753,15443,3575865668,3575865692,24
0,753,15444,3575865668,3575865692,24
0,753,15445,3575865668,3575865692,24
0,753,15446,3575865668,3575865692,24
0,753,15447,3575865668,3575865692,24
0,753,15448,3575865668,3575865693,25
0,753,15449,3575865668,3575865695,27
0,753,15450,3575865668,3575865697,29
0,753,15451,3575865668,3575865697,29
0,753,15452,3575865668,3575865700,32
0,753,15453,3575865668,3575865700,32
0,753,15454,3575865668,3575865703,35
0,753,15455,3575865668,3575865704,36
0,753,15456,3575865668,3575865704,36
0,753,15457,3575865668,3575865705,37
0,753,15458,3575865668,3575865705,37
0,753,15459,3575865668,3575865707,39
0,753,15460,3575865668,3575865707,39
0,753,15461,3575865668,3575865708,40
0,753,15462,3575865668,3575865708,40
0,753,15463,3575865668,3575865710,42
0,753,15464,3575865668,3575865712,44
0,753,15465,3575865668,3575865713,45
0,753,15466,3575865668,3575865713,45
0,753,15467,3575865668,3575865715,47
0,753,15468,3575865668,3575865717,49
0,753,15469,3575865668,3575865718,50
0,753,15470,3575865668,3575865718,50
0,754,15471,3575865726,3575865726,0
0,754,15472,3575865726,3575865726,0
0,754,15473,3575865726,3575865726,0
0,754,15474,3575865726,3575865726,0
0,754,15475,3575865726,3575865726,0
0,754,15476,3575865726,3575865726,0
0,754,15477,3575865726,3575865726,0
0,754,15478,3575865726,3575865726,0
0,754,15479,3575865726,3575865727,1
0,754,15480,3575865726,3575865727,1
0,754,15481,3575865726,3575865728,2
0,754,15482,3575865726,3575865729,3
0,754,15483,3575865726,3575865730,4
0,754,15484,3575865726,3575865733,7
0,754,15485,3575865726,3575865734,8
0,754,15486,3575865726,3575865736,10
0,754,15487,3575865726,3575865737,11
0,754,15488,3575865726,3575865737,11
0,754,15489,3575865726,3575865737,11
0,754,15490,3575865726,3575865738,12
0,754,15491,3575865726,3575865738,12
0,754,15492,3575865726,3575865740,14
0,754,15493,3575865726,3575865742,16
0,754,15494,3575865726,3575865744,18
0,754,15495,3575865726,3575865744,18
0,754,15496,3575865726,3575865748,22
0,754,15497,3575865726,3575865748,22
0,754,15498,3575865726,3575865748,22
0,754,15499,3575865726,3575865749,23
0,754,15500,3575865726,3575865749,23
0,754,15501,3575865726,3575865749,23
0,754,15502,3575865726,3575865750,24
0,754,15503,3575865726,3575865753,27
0,754,15504,3575865726,3575865754,28
0,754,15505,3575865726,3575865755,29
0,754,15506,3575865726,3575865758,32
0,754,15507,3575865726,3575865759,33
0,754,15508,3575865726,3575865760,34
0,754,15509,3575865726,3575865760,34
0,754,15510,3575865726,3575865761,35
0,754,15511,3575865726,3575865763,37
0,754,15512,3575865726,3575865763,37
0,754,15513,3575865726,3575865764,38
0,754,15514,3575865726,3575865765,39
0,754,15515,3575865726,3575865765,39
0,754,15516,3575865726,3575865766,40
0,754,15517,3575865726,3575865766,40
0,754,15518,3575865726,3575865771,45
0,754,15519,3575865726,3575865771,45
0,754,15520,3575865726,3575865772,46
0,754,15521,3575865726,3575865772,46
0,754,15522,3575865726,3575865773,47
0,754,15523,3575865726,3575865776,50
0,755,15524,3575865782,3575865782,0
0,755,15525,3575865782,3575865782,0
0,755,15526,3575865782,3575865782,0
0,755,15527,3575865782,3575865782,0
0,755,15528,3575865782,3575865782,0
0,755,15529,3575865782,3575865782,0
0,755,15530,3575865782,3575865782,0
0,755,15531,3575865782,3575865783,1
0,755,15532,3575865782,3575865789,7
0,755,15533,3575865782,3575865789,7
0,755,15534,3575865782,3575865797,15
0,755,15535,3575865782,3575865797,15
0,755,15536,3575865782,3575865803,21
0,755,15537,3575865782,3575865805,23
0,755,15538,3575865782,3575865808,26
0,755,15539,3575865782,3575865808,26
0,755,15540,3575865782,3575865811,29
0,755,15541,3575865782,3575865812,30
0,755,15542,3575865782,3575865813,31
0,755,15543,3575865782,3575865813,31
0,755,15544,3575865782,3575865816,34
0,755,15545,3575865782,3575865816,34
0,755,15546,3575865782,3575865822,40
0,755,15547,3575865782,3575865823,41
0,755,15548,3575865782,3575865828,46
0,755,15549,3575865782,3575865829,47
0,755,15550,3575865782,3575865829,47
0,755,15551,3575865782,3575865832,50
0,756,15552,3575865839,3575865839,0
0,756,15553,3575865839,3575865839,0
0,756,15554,3575865839,3575865839,0
0,756,15555,3575865839,3575865839,0
0,756,15556,3575865839,3575865841,2
0,756,15557,3575865839,3575865842,3
0,756,15558,3575865839,3575865842,3
0,756,15559,3575865839,3575865844,5
0,756,15560,3575865839,3575865845,6
0,756,15561,3575865839,3575865846,7
0,756,15562,3575865839,3575865847,8
0,756,15563,3575865839,3575865850,11
0,756,15564,3575865839,3575865851,12
0,756,15565,3575865839,3575865852,13
0,756,15566,3575865839,3575865855,16
0,756,15567,3575865839,3575865856,17
0,756,15568,3575865839,3575865858,19
0,756,15569,3575865839,3575865859,20
0,756,15570,3575865839,3575865864,25
0,756,15571,3575865839,3575865864,25
0,756,15572,3575865839,3575865864,25
0,756,15573,3575865839,3575865866,27
0,756,15574,3575865839,3575865867,28
0,756,15575,3575865839,3575865869,30
0,756,15576,3575865839,3575865873,34
0,756,15577,3575865839,3575865874,35
0,756,15578,3575865839,3575865878,39
0,756,15579,3575865839,3575865879,40
0,756,15580,3575865839,3575865879,40
0,756,15581,3575865839,3575865880,41
0,756,15582,3575865839,3575865880,41
0,756,15583,3575865839,3575865882,43
0,756,15584,3575865839,3575865883,44
0,756,15585,3575865839,3575865886,47
0,756,15586,3575865839,3575865886,47
0,756,15587,3575865839,3575865887,48
0,757,15588,3575865898,3575865898,0
0,757,15589,3575865898,3575865898,0
0,757,15590,3575865898,3575865898,0
0,757,15591,3575865898,3575865898,0
0,757,15592,3575865898,3575865898,0
0,757,15593,3575865898,3575865898,0
0,757,15594,3575865898,3575865898,0
0,757,15595,3575865898,3575865898,0
0,757,15596,3575865898,3575865898,0
0,757,15597,3575865898,3575865898,0
0,757,15598,3575865898,3575865898,0
0,757,15599,3575865898,3575865898,0
0,757,15600,3575865898,3575865898,0
0,757,15601,3575865898,3575865898,0
0,757,15602,3575865898,3575865898,0
0,757,15603,3575865898,3575865898,0
0,757,15604,3575865898,3575865900,2
0,757,15605,3575865898,3575865900,2
0,757,15606,3575865898,3575865903,5
0,757,15607,3575865898,3575865904,6
0,757,15608,3575865898,3575865905,7
0,757,15609,3575865898,3575865905,7
0,757,15610,3575865898,3575865907,9
0,757,15611,3575865898,3575865908,10
0,757,15612,3575865898,3575865908,10
0,757,15613,3575865898,3575865908,10
0,757,15614,3575865898,3575865910,12
0,757,15615,3575865898,3575865911,13
0,757,15616,3575865898,3575865913,15
0,757,15617,3575865898,3575865914,16
0,757,15618,3575865898,3575865915,17
0,757,15619,3575865898,3575865916,18
0,757,15620,3575865898,3575865917,19
0,757,15621,3575865898,3575865918,20
0,757,15622,3575865898,3575865918,20
0,757,15623,3575865898,3575865920,22
0,757,15624,3575865898,3575865921,23
0,757,15625,3575865898,3575865921,23
0,757,15626,3575865898,3575865922,24
0,757,15627,3575865898,3575865923,25
0,757,15628,3575865898,3575865923,25
0,757,15629,3575865898,3575865925,27
0,757,15630,3575865898,3575865926,28
0,757,15631,3575865898,3575865927,29
0,757,15632,3575865898,3575865928,30
0,757,15633,3575865898,3575865928,30
0,757,15634,3575865898,3575865929,31
0,757,15635,3575865898,3575865930,32
0,757,15636,3575865898,3575865931,33
0,757,15637,3575865898,3575865933,35
0,757,15638,3575865898,3575865934,36
0,757,15639,3575865898,3575865935,37
0,757,15640,3575865898,3575865935,37
0,757,15641,3575865898,3575865936,38
0,757,15642,3575865898,3575865936,38
0,757,15643,3575865898,3575865937,39
0,757,15644,3575865898,3575865937,39
0,757,15645,3575865898,3575865937,39
0,757,15646,3575865898,3575865938,40
0,757,15647,3575865898,3575865943,45
0,757,15648,3575865898,3575865944,46
0,757,15649,3575865898,3575865944,46
0,757,15650,3575865898,3575865946,48
0,757,15651,3575865898,3575865948,50
0,758,15652,3575865957,3575865957,0
0,758,15653,3575865957,3575865957,0
0,758,15654,3575865957,3575865957,0
0,758,15655,3575865957,3575865957,0
0,758,15656,3575865957,3575865957,0
0,758,15657,3575865957,3575865957,0
0,758,15658,3575865957,3575865957,0
0,758,15659,3575865957,3575865958,1
0,758,15660,3575865957,3575865958,1
0,758,15661,3575865957,3575865960,3
0,758,15662,3575865957,3575865961,4
0,758,15663,3575865957,3575865961,4
0,758,15664,3575865957,3575865963,6
0,758,15665,3575865957,3575865964,7
0,758,15666,3575865957,3575865964,7
0,758,15667,3575865957,3575865965,8
0,758,15668,3575865957,3575865965,8
0,758,15669,3575865957,3575865967,10
0,758,15670,3575865957,3575865971,14
0,758,15671,3575865957,3575865971,14
0,758,15672,3575865957,3575865971,14
0,758,15673,3575865957,3575865972,15
0,758,15674,3575865957,3575865973,16
0,758,15675,3575865957,3575865975,18
0,758,15676,3575865957,3575865975,18
0,758,15677,3575865957,3575865976,19
0,758,15678,3575865957,3575865976,19
0,758,15679,3575865957,3575865977,20
0,758,15680,3575865957,3575865977,20
0,758,15681,3575865957,3575865978,21
0,758,15682,3575865957,3575865979,22
0,758,15683,3575865957,3575865982,25
0,758,15684,3575865957,3575865982,25
0,758,15685,3575865957,3575865984,27
0,758,15686,3575865957,3575865988,31
0,758,15687,3575865957,3575865989,32
0,758,15688,3575865957,3575865989,32
0,758,15689,3575865957,3575865995,38
0,758,15690,3575865957,3575865997,40
0,758,15691,3575865957,3575865998,41
0,758,15692,3575865957,3575865999,42
0,758,15693,3575865957,3575866002,45
0,758,15694,3575865957,3575866005,48
0,758,15695,3575865957,3575866005,48
0,759,15696,3575866013,3575866013,0
0,759,15697,3575866013,3575866013,0
0,759,15698,3575866013,3575866013,0
0,759,15699,3575866013,3575866013,0
0,759,15700,3575866013,3575866014,1
0,759,15701,3575866013,3575866014,1
0,759,15702,3575866013,3575866018,5
0,759,15703,3575866013,3575866022,9
0,759,15704,3575866013,3575866022,9
0,759,15705,3575866013,3575866026,13
0,759,15706,3575866013,3575866028,15
0,759,15707,3575866013,3575866029,16
0,759,15708,3575866013,3575866029,16
0,759,15709,3575866013,3575866031,18
0,759,15710,3575866013,3575866032,19
0,759,15711,3575866013,3575866033,20
0,759,15712,3575866013,3575866033,20
0,759,15713,3575866013,3575866034,21
0,759,15714,3575866013,3575866037,24
0,759,15715,3575866013,3575866038,25
0,759,15716,3575866013,3575866041,28
0,759,15717,3575866013,3575866042,29
0,759,15718,3575866013,3575866042,29
0,759,15719,3575866013,3575866044,31
0,759,15720,3575866013,3575866045,32
0,759,15721,3575866013,3575866046,33
0,759,15722,3575866013,3575866048,35
0,759,15723,3575866013,3575866048,35
0,759,15724,3575866013,3575866050,37
0,759,15725,3575866013,3575866052,39
0,759,15726,3575866013,3575866057,44
0,759,15727,3575866013,3575866059,46
0,760,15728,3575866068,3575866068,0
0,760,15729,3575866068,3575866068,0
0,760,15730,3575866068,3575866068,0
0,760,15731,3575866068,3575866068,0
0,760,15732,3575866068,3575866069,1
0,760,15733,3575866068,3575866069,1
0,760,15734,3575866068,3575866077,9
0,760,15735,3575866068,3575866077,9
0,760,15736,3575866068,3575866079,11
0,760,15737,3575866068,3575866079,11
0,760,15738,3575866068,3575866080,12
0,760,15739,3575866068,3575866080,12
0,760,15740,3575866068,3575866081,13
0,760,15741,3575866068,3575866083,15
0,760,15742,3575866068,3575866086,18
0,760,15743,3575866068,3575866086,18
0,760,15744,3575866068,3575866087,19
0,760,15745,3575866068,3575866089,21
0,760,15746,3575866068,3575866090,22
0,760,15747,3575866068,3575866090,22
0,760,15748,3575866068,3575866090,22
0,760,15749,3575866068,3575866090,22
0,760,15750,3575866068,3575866091,23
0,760,15751,3575866068,3575866092,24
0,760,15752,3575866068,3575866092,24
0,760,15753,3575866068,3575866093,25
0,760,15754,3575866068,3575866093,25
0,760,15755,3575866068,3575866093,25
0,760,15756,3575866068,3575866094,26
0,760,15757,3575866068,3575866095,27
0,760,15758,3575866068,3575866096,28
0,760,15759,3575866068,3575866097,29
0,760,15760,3575866068,3575866097,29
0,760,15761,3575866068,3575866101,33
0,760,15762,3575866068,3575866103,35
0,760,15763,3575866068,3575866104,36
0,760,15764,3575866068,3575866105,37
0,760,15765,3575866068,3575866105,37
0,760,15766,3575866068,3575866106,38
0,760,15767,3575866068,3575866106,38
0,760,15768,3575866068,3575866107,39
0,760,15769,3575866068,3575866109,41
0,760,15770,3575866068,3575866109,41
0,760,15771,3575866068,3575866110,42
0,760,15772,3575866068,3575866112,44
0,760,15773,3575866068,3575866113,45
0,760,15774,3575866068,3575866113,45
0,760,15775,3575866068,3575866116,48
0,760,15776,3575866068,3575866117,49
0,761,15777,3575866126,3575866126,0
0,761,15778,3575866126,3575866126,0
0,761,15779,3575866126,3575866126,0
0,761,15780,3575866126,3575866126,0
0,761,15781,3575866126,3575866126,0
0,761,15782,3575866126,3575866126,0
0,761,15783,3575866126,3575866126,0
0,761,15784,3575866126,3575866126,0
0,761,15785,3575866126,3575866126,0
0,761,15786,3575866126,3575866126,0
0,761,15787,3575866126,3575866126,0
0,761,15788,3575866126,3575866126,0
0,761,15789,3575866126,3575866128,2
0,761,15790,3575866126,3575866128,2
0,761,15791,3575866126,3575866128,2
0,761,15792,3575866126,3575866128,2
0,761,15793,3575866126,3575866131,5
0,761,15794,3575866126,3575866131,5
0,761,15795,3575866126,3575866133,7
0,761,15796,3575866126,3575866134,8
0,761,15797,3575866126,3575866135,9
0,761,15798,3575866126,3575866135,9
0,761,15799,3575866126,3575866136,10
0,761,15800,3575866126,3575866137,11
0,761,15801,3575866126,3575866137,11
0,761,15802,3575866126,3575866137,11
0,761,15803,3575866126,3575866138,12
0,761,15804,3575866126,3575866138,12
0,761,15805,3575866126,3575866140,14
0,761,15806,3575866126,3575866143,17
0,761,15807,3575866126,3575866145,19
0,761,15808,3575866126,3575866146,20
0,761,15809,3575866126,3575866148,22
0,761,15810,3575866126,3575866149,23
0,761,15811,3575866126,3575866149,23
0,761,15812,3575866126,3575866150,24
0,761,15813,3575866126,3575866150,24
0,761,15814,3575866126,3575866154,28
0,761,15815,3575866126,3575866154,28
0,761,15816,3575866126,3575866155,29
0,761,15817,3575866126,3575866158,32
0,761,15818,3575866126,3575866160,34
0,761,15819,3575866126,3575866161,35
0,761,15820,3575866126,3575866161,35
0,761,15821,3575866126,3575866164,38
0,761,15822,3575866126,3575866165,39
0,761,15823,3575866126,3575866165,39
0,761,15824,3575866126,3575866165,39
0,761,15825,3575866126,3575866171,45
0,761,15826,3575866126,3575866172,46
0,761,15827,3575866126,3575866172,46
0,761,15828,3575866126,3575866172,46
0,761,15829,3575866126,3575866173,47
0,761,15830,3575866126,3575866175,49
0,761,15831,3575866126,3575866176,50
0,762,15832,3575866184,3575866184,0
0,762,15833,3575866184,3575866184,0
0,762,15834,3575866184,3575866184,0
0,762,15835,3575866184,3575866184,0
0,762,15836,3575866184,3575866184,0
0,762,15837,3575866184,3575866184,0
0,762,15838,3575866184,3575866184,0
0,762,15839,3575866184,3575866184,0
0,762,15840,3575866184,3575866188,4
0,762,15841,3575866184,3575866189,5
0,762,15842,3575866184,3575866190,6
0,762,15843,3575866184,3575866195,11
0,762,15844,3575866184,3575866197,13
0,762,15845,3575866184,3575866197,13
0,762,15846,3575866184,3575866200,16
0,762,15847,3575866184,3575866203,19
0,762,15848,3575866184,3575866205,21
0,762,15849,3575866184,3575866209,25
0,762,15850,3575866184,3575866210,26
0,762,15851,3575866184,3575866211,27
0,762,15852,3575866184,3575866213,29
0,762,15853,3575866184,3575866217,33
0,762,15854,3575866184,3575866222,38
0,762,15855,3575866184,3575866222,38
0,762,15856,3575866184,3575866229,45
0,762,15857,3575866184,3575866229,45
0,762,15858,3575866184,3575866230,46
0,762,15859,3575866184,3575866232,48
0,762,15860,3575866184,3575866232,48
0,762,15861,3575866184,3575866232,48
0,762,15862,3575866184,3575866233,49
0,763,15863,3575866244,3575866244,0
0,763,15864,3575866244,3575866244,0
0,763,15865,3575866244,3575866244,0
0,763,15866,3575866244,3575866244,0
0,763,15867,3575866244,3575866244,0
0,763,15868,3575866244,3575866244,0
0,763,15869,3575866244,3575866245,1
0,763,15870,3575866244,3575866245,1
0,763,15871,3575866244,3575866246,2
0,763,15872,3575866244,3575866248,4
0,763,15873,3575866244,3575866248,4
0,763,15874,3575866244,3575866251,7
0,763,15875,3575866244,3575866252,8
0,763,15876,3575866244,3575866253,9
0,763,15877,3575866244,3575866256,12
0,763,15878,3575866244,3575866257,13
0,763,15879,3575866244,3575866258,14
0,763,15880,3575866244,3575866259,15
0,763,15881,3575866244,3575866264,20
0,763,15882,3575866244,3575866265,21
0,763,15883,3575866244,3575866266,22
0,763,15884,3575866244,3575866266,22
0,763,15885,3575866244,3575866269,25
0,763,15886,3575866244,3575866270,26
0,763,15887,3575866244,3575866274,30
0,763,15888,3575866244,3575866277,33
0,763,15889,3575866244,3575866277,33
0,763,15890,3575866244,3575866279,35
0,763,15891,3575866244,3575866280,36
0,763,15892,3575866244,3575866280,36
0,763,15893,3575866244,3575866280,36
0,763,15894,3575866244,3575866281,37
0,763,15895,3575866244,3575866282,38
0,763,15896,3575866244,3575866283,39
0,763,15897,3575866244,3575866286,42
0,763,15898,3575866244,3575866286,42
0,763,15899,3575866244,3575866287,43
0,763,15900,3575866244,3575866290,46
0,763,15901,3575866244,3575866291,47
0,763,15902,3575866244,3575866291,47
0,763,15903,3575866244,3575866291,47
0,763,15904,3575866244,3575866291,47
0,763,15905,3575866244,3575866292,48
0,763,15906,3575866244,3575866292,48
0,763,15907,3575866244,3575866292,48
0,763,15908,3575866244,3575866293,49
0,763,15909,3575866244,3575866293,49
0,763,15910,3575866244,3575866293,49
0,763,15911,3575866244,3575866293,49
0,763,15912,3575866244,3575866294,50
0,764,15913,3575866300,3575866300,0
0,764,15914,3575866300,3575866300,0
0,764,15915,3575866300,3575866300,0
0,764,15916,3575866300,3575866300,0
0,764,15917,3575866300,3575866300,0
0,764,15918,3575866300,3575866301,1
0,764,15919,3575866300,3575866303,3
0,764,15920,3575866300,3575866305,5
0,764,15921,3575866300,3575866305,5
0,764,15922,3575866300,3575866306,6
0,764,15923,3575866300,3575866307,7
0,764,15924,3575866300,3575866308,8
0,764,15925,3575866300,3575866309,9
0,764,15926,3575866300,3575866309,9
0,764,15927,3575866300,3575866310,10
0,764,15928,3575866300,3575866311,11
0,764,15929,3575866300,3575866314,14
0,764,15930,3575866300,3575866314,14
0,764,15931,3575866300,3575866315,15
0,764,15932,3575866300,3575866316,16
0,764,15933,3575866300,3575866318,18
0,764,15934,3575866300,3575866318,18
0,764,15935,3575866300,3575866318,18
0,764,15936,3575866300,3575866321,21
0,764,15937,3575866300,3575866321,21
0,764,15938,3575866300,3575866322,22
0,764,15939,3575866300,3575866323,23
0,764,15940,3575866300,3575866323,23
0,764,15941,3575866300,3575866324,24
0,764,15942,3575866300,3575866324,24
0,764,15943,3575866300,3575866326,26
0,764,15944,3575866300,3575866327,27
0,764,15945,3575866300,3575866328,28
0,764,15946,3575866300,3575866329,29
0,764,15947,3575866300,3575866331,31
0,764,15948,3575866300,3575866332,32
0,764,15949,3575866300,3575866332,32
0,764,15950,3575866300,3575866333,33
0,764,15951,3575866300,3575866334,34
0,764,15952,3575866300,3575866336,36
0,764,15953,3575866300,3575866336,36
0,764,15954,3575866300,3575866336,36
0,764,15955,3575866300,3575866337,37
0,764,15956,3575866300,3575866337,37
0,764,15957,3575866300,3575866338,38
0,764,15958,3575866300,3575866338,38
0,764,15959,3575866300,3575866340,40
0,764,15960,3575866300,3575866343,43
0,764,15961,3575866300,3575866343,43
0,764,15962,3575866300,3575866345,45
0,764,15963,3575866300,3575866346,46
0,764,15964,3575866300,3575866348,48
0,764,15965,3575866300,3575866348,48
0,764,15966,3575866300,3575866349,49
0,764,15967,3575866300,3575866349,49
0,764,15968,3575866300,3575866349,49
0,764,15969,3575866300,3575866350,50
0,765,15970,3575866360,3575866360,0
0,765,15971,3575866360,3575866360,0
0,765,15972,3575866360,3575866360,0
0,765,15973,3575866360,3575866360,0
0,765,15974,3575866360,3575866360,0
0,765,15975,3575866360,3575866360,0
0,765,15976,3575866360,3575866361,1
0,765,15977,3575866360,3575866362,2
0,765,15978,3575866360,3575866363,3
0,765,15979,3575866360,3575866364,4
0,765,15980,3575866360,3575866364,4
0,765,15981,3575866360,3575866365,5
0,765,15982,3575866360,3575866366,6
0,765,15983,3575866360,3575866367,7
0,765,15984,3575866360,3575866371,11
0,765,15985,3575866360,3575866372,12
0,765,15986,3575866360,3575866372,12
0,765,15987,3575866360,3575866373,13
0,765,15988,3575866360,3575866373,13
0,765,15989,3575866360,3575866376,16
0,765,15990,3575866360,3575866376,16
0,765,15991,3575866360,3575866377,17
0,765,15992,3575866360,3575866378,18
0,765,15993,3575866360,3575866379,19
0,765,15994,3575866360,3575866379,19
0,765,15995,3575866360,3575866380,20
0,765,15996,3575866360,3575866383,23
0,765,15997,3575866360,3575866384,24
0,765,15998,3575866360,3575866386,26
0,765,15999,3575866360,3575866387,27
0,765,16000,3575866360,3575866388,28
0,765,16001,3575866360,3575866389,29
0,765,16002,3575866360,3575866390,30
0,765,16003,3575866360,3575866397,37
0,765,16004,3575866360,3575866399,39
0,765,16005,3575866360,3575866404,44
0,765,16006,3575866360,3575866405,45
0,765,16007,3575866360,3575866406,46
0,765,16008,3575866360,3575866409,49
0,765,16009,3575866360,3575866410,50
0,766,16010,3575866417,3575866417,0
0,766,16011,3575866417,3575866417,0
0,766,16012,3575866417,3575866417,0
0,766,16013,3575866417,3575866417,0
0,766,16014,3575866417,3575866417,0
0,766,16015,3575866417,3575866417,0
0,766,16016,3575866417,3575866422,5
0,766,16017,3575866417,3575866423,6
0,766,16018,3575866417,3575866428,11
0,766,16019,3575866417,3575866429,12
0,766,16020,3575866417,3575866430,13
0,766,16021,3575866417,3575866430,13
0,766,16022,3575866417,3575866431,14
0,766,16023,3575866417,3575866433,16
0,766,16024,3575866417,3575866433,16
0,766,16025,3575866417,3575866437,20
0,766,16026,3575866417,3575866438,21
0,766,16027,3575866417,3575866439,22
0,766,16028,3575866417,3575866442,25
0,766,16029,3575866417,3575866443,26
0,766,16030,3575866417,3575866443,26
0,766,16031,3575866417,3575866446,29
0,766,16032,3575866417,3575866446,29
0,766,16033,3575866417,3575866446,29
0,766,16034,3575866417,3575866447,30
0,766,16035,3575866417,3575866448,31
0,766,16036,3575866417,3575866449,32
0,766,16037,3575866417,3575866451,34
0,766,16038,3575866417,3575866452,35
0,766,16039,3575866417,3575866452,35
0,766,16040,3575866417,3575866459,42
0,766,16041,3575866417,3575866460,43
0,766,16042,3575866417,3575866464,47
0,766,16043,3575866417,3575866466,49
0,766,16044,3575866417,3575866466,49
0,766,16045,3575866417,3575866467,50
0,767,16046,3575866473,3575866473,0
0,767,16047,3575866473,3575866473,0
0,767,16048,3575866473,3575866473,0
0,767,16049,3575866473,3575866476,3
0,767,16050,3575866473,3575866478,5
0,767,16051,3575866473,3575866480,7
0,767,16052,3575866473,3575866480,7
0,767,16053,3575866473,3575866481,8
0,767,16054,3575866473,3575866481,8
0,767,16055,3575866473,3575866483,10
0,767,16056,3575866473,3575866486,13
0,767,16057,3575866473,3575866487,14
0,767,16058,3575866473,3575866487,14
0,767,16059,3575866473,3575866490,17
0,767,16060,3575866473,3575866490,17
0,767,16061,3575866473,3575866490,17
0,767,16062,3575866473,3575866491,18
0,767,16063,3575866473,3575866491,18
0,767,16064,3575866473,3575866492,19
0,767,16065,3575866473,3575866492,19
0,767,16066,3575866473,3575866492,19
0,767,16067,3575866473,3575866493,20
0,767,16068,3575866473,3575866493,20
0,767,16069,3575866473,3575866494,21
0,767,16070,3575866473,3575866494,21
0,767,16071,3575866473,3575866494,21
0,767,16072,3575866473,3575866496,23
0,767,16073,3575866473,3575866496,23
0,767,16074,3575866473,3575866497,24
0,767,16075,3575866473,3575866498,25
0,767,16076,3575866473,3575866500,27
0,767,16077,3575866473,3575866501,28
0,767,16078,3575866473,3575866503,30
0,767,16079,3575866473,3575866505,32
0,767,16080,3575866473,3575866505,32
0,767,16081,3575866473,3575866506,33
0,767,16082,3575866473,3575866506,33
0,767,16083,3575866473,3575866508,35
0,767,16084,3575866473,3575866508,35
0,767,16085,3575866473,3575866509,36
0,767,16086,3575866473,3575866509,36
0,767,16087,3575866473,3575866510,37
0,767,16088,3575866473,3575866511,38
0,767,16089,3575866473,3575866513,40
0,767,16090,3575866473,3575866514,41
0,767,16091,3575866473,3575866515,42
0,767,16092,3575866473,3575866516,43
0,767,16093,3575866473,3575866517,44
0,767,16094,3575866473,3575866518,45
0,767,16095,3575866473,3575866519,46
0,767,16096,3575866473,3575866520,47
0,767,16097,3575866473,3575866521,48
0,767,16098,3575866473,3575866522,49
0,767,16099,3575866473,3575866522,49
0,767,16100,3575866473,3575866523,50
0,768,16101,3575866530,3575866530,0
0,768,16102,3575866530,3575866530,0
0,768,16103,3575866530,3575866530,0
0,768,16104,3575866530,3575866530,0
0,768,16105,3575866530,3575866530,0
0,768,16106,3575866530,3575866530,0
0,768,16107,3575866530,3575866530,0
0,768,16108,3575866530,3575866530,0
0,768,16109,3575866530,3575866530,0
0,768,16110,3575866530,3575866531,1
0,768,16111,3575866530,3575866532,2
0,768,16112,3575866530,3575866533,3
0,768,16113,3575866530,3575866535,5
0,768,16114,3575866530,3575866535,5
0,768,16115,3575866530,3575866536,6
0,768,16116,3575866530,3575866536,6
0,768,16117,3575866530,3575866537,7
0,768,16118,3575866530,3575866538,8
0,768,16119,3575866530,3575866539,9
0,768,16120,3575866530,3575866540,10
0,768,16121,3575866530,3575866542,12
0,768,16122,3575866530,3575866542,12
0,768,16123,3575866530,3575866542,12
0,768,16124,3575866530,3575866544,14
0,768,16125,3575866530,3575866545,15
0,768,16126,3575866530,3575866548,18
0,768,16127,3575866530,3575866548,18
0,768,16128,3575866530,3575866548,18
0,768,16129,3575866530,3575866548,18
0,768,16130,3575866530,3575866548,18
0,768,16131,3575866530,3575866549,19
0,768,16132,3575866530,3575866550,20
0,768,16133,3575866530,3575866554,24
0,768,16134,3575866530,3575866554,24
0,768,16135,3575866530,3575866557,27
0,768,16136,3575866530,3575866558,28
0,768,16137,3575866530,3575866559,29
0,768,16138,3575866530,3575866561,31
0,768,16139,3575866530,3575866563,33
0,768,16140,3575866530,3575866563,33
0,768,16141,3575866530,3575866564,34
0,768,16142,3575866530,3575866566,36
0,768,16143,3575866530,3575866570,40
0,768,16144,3575866530,3575866571,41
0,768,16145,3575866530,3575866571,41
0,768,16146,3575866530,3575866572,42
0,768,16147,3575866530,3575866572,42
0,768,16148,3575866530,3575866574,44
0,768,16149,3575866530,3575866575,45
0,768,16150,3575866530,3575866576,46
0,768,16151,3575866530,3575866576,46
0,768,16152,3575866530,3575866578,48
0,768,16153,3575866530,3575866578,48
0,768,16154,3575866530,3575866580,50
0,769,16155,3575866587,3575866587,0
0,769,16156,3575866587,3575866587,0
0,769,16157,3575866587,3575866587,0
0,769,16158,3575866587,3575866589,2
0,769,16159,3575866587,3575866593,6
0,769,16160,3575866587,3575866596,9
0,769,16161,3575866587,3575866597,10
0,769,16162,3575866587,3575866599,12
0,769,16163,3575866587,3575866603,16
0,769,16164,3575866587,3575866605,18
0,769,16165,3575866587,3575866608,21
0,769,16166,3575866587,3575866608,21
0,769,16167,3575866587,3575866611,24
0,769,16168,3575866587,3575866613,26
0,769,16169,3575866587,3575866613,26
0,769,16170,3575866587,3575866613,26
0,769,16171,3575866587,3575866615,28
0,769,16172,3575866587,3575866617,30
0,769,16173,3575866587,3575866621,34
0,769,16174,3575866587,3575866622,35
0,769,16175,3575866587,3575866627,40
0,769,16176,3575866587,3575866629,42
0,769,16177,3575866587,3575866629,42
0,769,16178,3575866587,3575866631,44
0,769,16179,3575866587,3575866631,44
0,769,16180,3575866587,3575866632,45
0,769,16181,3575866587,3575866632,45
0,770,16182,3575866646,3575866646,0
0,770,16183,3575866646,3575866646,0
0,770,16184,3575866646,3575866646,0
0,770,16185,3575866646,3575866646,0
0,770,16186,3575866646,3575866646,0
0,770,16187,3575866646,3575866646,0
0,770,16188,3575866646,3575866646,0
0,770,16189,3575866646,3575866646,0
0,770,16190,3575866646,3575866647,1
0,770,16191,3575866646,3575866648,2
0,770,16192,3575866646,3575866650,4
0,770,16193,3575866646,3575866651,5
0,770,16194,3575866646,3575866657,11
0,770,16195,3575866646,3575866657,11
0,770,16196,3575866646,3575866658,12
0,770,16197,3575866646,3575866659,13
0,770,16198,3575866646,3575866663,17
0,770,16199,3575866646,3575866665,19
0,770,16200,3575866646,3575866665,19
0,770,16201,3575866646,3575866666,20
0,770,16202,3575866646,3575866669,23
0,770,16203,3575866646,3575866669,23
0,770,16204,3575866646,3575866673,27
0,770,16205,3575866646,3575866677,31
0,770,16206,3575866646,3575866678,32
0,770,16207,3575866646,3575866680,34
0,770,16208,3575866646,3575866680,34
0,770,16209,3575866646,3575866680,34
0,770,16210,3575866646,3575866680,34
0,770,16211,3575866646,3575866681,35
0,770,16212,3575866646,3575866683,37
0,770,16213,3575866646,3575866686,40
0,770,16214,3575866646,3575866687,41
0,770,16215,3575866646,3575866688,42
0,770,16216,3575866646,3575866689,43
0,770,16217,3575866646,3575866690,44
0,770,16218,3575866646,3575866690,44
0,770,16219,3575866646,3575866691,45
0,770,16220,3575866646,3575866691,45
0,770,16221,3575866646,3575866692,46
0,770,16222,3575866646,3575866692,46
0,770,16223,3575866646,3575866692,46
0,770,16224,3575866646,3575866692,46
0,770,16225,3575866646,3575866692,46
0,770,16226,3575866646,3575866693,47
0,770,16227,3575866646,3575866693,47
0,770,16228,3575866646,3575866694,48
0,770,16229,3575866646,3575866694,48
0,770,16230,3575866646,3575866694,48
0,770,16231,3575866646,3575866695,49
0,771,16232,3575866703,3575866703,0
0,771,16233,3575866703,3575866703,0
0,771,16234,3575866703,3575866703,0
0,771,16235,3575866703,3575866703,0
0,771,16236,3575866703,3575866703,0
0,771,16237,3575866703,3575866703,0
0,771,16238,3575866703,3575866705,2
0,771,16239,3575866703,3575866705,2
0,771,16240,3575866703,3575866706,3
0,771,16241,3575866703,3575866706,3
0,771,16242,3575866703,3575866709,6
0,771,16243,3575866703,3575866709,6
0,771,16244,3575866703,3575866709,6
0,771,16245,3575866703,3575866709,6
0,771,16246,3575866703,3575866710,7
0,771,16247,3575866703,3575866712,9
0,771,16248,3575866703,3575866714,11
0,771,16249,3575866703,3575866714,11
0,771,16250,3575866703,3575866716,13
0,771,16251,3575866703,3575866718,15
0,771,16252,3575866703,3575866718,15
0,771,16253,3575866703,3575866720,17
0,771,16254,3575866703,3575866721,18
0,771,16255,3575866703,3575866722,19
0,771,16256,3575866703,3575866722,19
0,771,16257,3575866703,3575866722,19
0,771,16258,3575866703,3575866723,20
0,771,16259,3575866703,3575866725,22
0,771,16260,3575866703,3575866725,22
0,771,16261,3575866703,3575866727,24
0,771,16262,3575866703,3575866727,24
0,771,16263,3575866703,3575866727,24
0,771,16264,3575866703,3575866727,24
0,771,16265,3575866703,3575866728,25
0,771,16266,3575866703,3575866729,26
0,771,16267,3575866703,3575866730,27
0,771,16268,3575866703,3575866730,27
0,771,16269,3575866703,3575866731,28
0,771,16270,3575866703,3575866732,29
0,771,16271,3575866703,3575866734,31
0,771,16272,3575866703,3575866735,32
0,771,16273,3575866703,3575866736,33
0,771,16274,3575866703,3575866738,35
0,771,16275,3575866703,3575866738,35
0,771,16276,3575866703,3575866740,37
0,771,16277,3575866703,3575866742,39
0,771,16278,3575866703,3575866742,39
0,771,16279,3575866703,3575866742,39
0,771,16280,3575866703,3575866746,43
0,771,16281,3575866703,3575866746,43
0,771,16282,3575866703,3575866747,44
0,771,16283,3575866703,3575866748,45
0,771,16284,3575866703,3575866748,45
0,771,16285,3575866703,3575866748,45
0,771,16286,3575866703,3575866749,46
0,771,16287,3575866703,3575866750,47
0,772,16288,3575866759,3575866759,0
0,772,16289,3575866759,3575866759,0
0,772,16290,3575866759,3575866759,0
0,772,16291,3575866759,3575866759,0
0,772,16292,3575866759,3575866759,0
0,772,16293,3575866759,3575866759,0
0,772,16294,3575866759,3575866761,2
0,772,16295,3575866759,3575866761,2
0,772,16296,3575866759,3575866764,5
0,772,16297,3575866759,3575866764,5
0,772,16298,3575866759,3575866766,7
0,772,16299,3575866759,3575866767,8
0,772,16300,3575866759,3575866770,11
0,772,16301,3575866759,3575866771,12
0,772,16302,3575866759,3575866772,13
0,772,16303,3575866759,3575866772,13
0,772,16304,3575866759,3575866773,14
0,772,16305,3575866759,3575866775,16
0,772,16306,3575866759,3575866775,16
0,772,16307,3575866759,3575866777,18
0,772,16308,3575866759,3575866778,19
0,772,16309,3575866759,3575866778,19
0,772,16310,3575866759,3575866780,21
0,772,16311,3575866759,3575866781,22
0,772,16312,3575866759,3575866783,24
0,772,16313,3575866759,3575866787,28
0,772,16314,3575866759,3575866790,31
0,772,16315,3575866759,3575866797,38
0,772,16316,3575866759,3575866797,38
0,772,16317,3575866759,3575866797,38
0,772,16318,3575866759,3575866799,40
0,772,16319,3575866759,3575866803,44
0,772,16320,3575866759,3575866804,45
0,772,16321,3575866759,3575866806,47
0,772,16322,3575866759,3575866808,49
0,772,16323,3575866759,3575866809,50
0,773,16324,3575866822,3575866822,0
0,773,16325,3575866822,3575866822,0
0,773,16326,3575866822,3575866822,0
0,773,16327,3575866822,3575866822,0
0,773,16328,3575866822,3575866822,0
0,773,16329,3575866822,3575866822,0
0,773,16330,3575866822,3575866822,0
0,773,16331,3575866822,3575866827,5
0,773,16332,3575866822,3575866828,6
0,773,16333,3575866822,3575866829,7
0,773,16334,3575866822,3575866829,7
0,773,16335,3575866822,3575866830,8
0,773,16336,3575866822,3575866831,9
0,773,16337,3575866822,3575866832,10
0,773,16338,3575866822,3575866832,10
0,773,16339,3575866822,3575866836,14
0,773,16340,3575866822,3575866838,16
0,773,16341,3575866822,3575866839,17
0,773,16342,3575866822,3575866841,19
0,773,16343,3575866822,3575866841,19
0,773,16344,3575866822,3575866842,20
0,773,16345,3575866822,3575866845,23
0,773,16346,3575866822,3575866846,24
0,773,16347,3575866822,3575866846,24
0,773,16348,3575866822,3575866847,25
0,773,16349,3575866822,3575866848,26
0,773,16350,3575866822,3575866848,26
0,773,16351,3575866822,3575866850,28
0,773,16352,3575866822,3575866851,29
0,773,16353,3575866822,3575866851,29
0,773,16354,3575866822,3575866857,35
0,773,16355,3575866822,3575866859,37
0,773,16356,3575866822,3575866864,42
0,773,16357,3575866822,3575866866,44
0,773,16358,3575866822,3575866866,44
0,773,16359,3575866822,3575866866,44
0,773,16360,3575866822,3575866868,46
0,773,16361,3575866822,3575866869,47
0,773,16362,3575866822,3575866870,48
0,774,16363,3575866879,3575866879,0
0,774,16364,3575866879,3575866879,0
0,774,16365,3575866879,3575866880,1
0,774,16366,3575866879,3575866880,1
0,774,16367,3575866879,3575866881,2
0,774,16368,3575866879,3575866883,4
0,774,16369,3575866879,3575866886,7
0,774,16370,3575866879,3575866887,8
0,774,16371,3575866879,3575866890,11
0,774,16372,3575866879,3575866890,11
0,774,16373,3575866879,3575866891,12
0,774,16374,3575866879,3575866891,12
0,774,16375,3575866879,3575866891,12
0,774,16376,3575866879,3575866891,12
0,774,16377,3575866879,3575866891,12
0,774,16378,3575866879,3575866892,13
0,774,16379,3575866879,3575866892,13
0,774,16380,3575866879,3575866892,13
0,774,16381,3575866879,3575866894,15
0,774,16382,3575866879,3575866894,15
0,774,16383,3575866879,3575866894,15
0,774,16384,3575866879,3575866895,16
0,774,16385,3575866879,3575866895,16
0,774,16386,3575866879,3575866896,17
0,774,16387,3575866879,3575866897,18
0,774,16388,3575866879,3575866898,19
0,774,16389,3575866879,3575866901,22
0,774,16390,3575866879,3575866901,22
0,774,16391,3575866879,3575866902,23
0,774,16392,3575866879,3575866904,25
0,774,16393,3575866879,3575866905,26
0,774,16394,3575866879,3575866906,27
0,774,16395,3575866879,3575866907,28
0,774,16396,3575866879,3575866909,30
0,774,16397,3575866879,3575866909,30
0,774,16398,3575866879,3575866909,30
0,774,16399,3575866879,3575866910,31
0,774,16400,3575866879,3575866910,31
0,774,16401,3575866879,3575866912,33
0,774,16402,3575866879,3575866913,34
0,774,16403,3575866879,3575866914,35
0,774,16404,3575866879,3575866915,36
0,774,16405,3575866879,3575866917,38
0,774,16406,3575866879,3575866918,39
0,774,16407,3575866879,3575866919,40
0,774,16408,3575866879,3575866921,42
0,774,16409,3575866879,3575866921,42
0,774,16410,3575866879,3575866921,42
0,774,16411,3575866879,3575866922,43
0,774,16412,3575866879,3575866922,43
0,774,16413,3575866879,3575866923,44
0,774,16414,3575866879,3575866923,44
0,774,16415,3575866879,3575866924,45
0,774,16416,3575866879,3575866924,45
0,774,16417,3575866879,3575866927,48
0,774,16418,3575866879,3575866927,48
0,774,16419,3575866879,3575866928,49
0,775,16420,3575866936,3575866936,0
0,775,16421,3575866936,3575866936,0
0,775,16422,3575866936,3575866936,0
0,775,16423,3575866936,3575866936,0
0,775,16424,3575866936,3575866936,0
0,775,16425,3575866936,3575866936,0
0,775,16426,3575866936,3575866936,0
0,775,16427,3575866936,3575866936,0
0,775,16428,3575866936,3575866936,0
0,775,16429,3575866936,3575866936,0
0,775,16430,3575866936,3575866937,1
0,775,16431,3575866936,3575866938,2
0,775,16432,3575866936,3575866938,2
0,775,16433,3575866936,3575866939,3
0,775,16434,3575866936,3575866940,4
0,775,16435,3575866936,3575866942,6
0,775,16436,3575866936,3575866942,6
0,775,16437,3575866936,3575866943,7
0,775,16438,3575866936,3575866944,8
0,775,16439,3575866936,3575866946,10
0,775,16440,3575866936,3575866946,10
0,775,16441,3575866936,3575866948,12
0,775,16442,3575866936,3575866948,12
0,775,16443,3575866936,3575866948,12
0,775,16444,3575866936,3575866949,13
0,775,16445,3575866936,3575866949,13
0,775,16446,3575866936,3575866950,14
0,775,16447,3575866936,3575866950,14
0,775,16448,3575866936,3575866953,17
0,775,16449,3575866936,3575866955,19
0,775,16450,3575866936,3575866955,19
0,775,16451,3575866936,3575866955,19
0,775,16452,3575866936,3575866959,23
0,775,16453,3575866936,3575866959,23
0,775,16454,3575866936,3575866960,24
0,775,16455,3575866936,3575866960,24
0,775,16456,3575866936,3575866964,28
0,775,16457,3575866936,3575866964,28
0,775,16458,3575866936,3575866964,28
0,775,16459,3575866936,3575866965,29
0,775,16460,3575866936,3575866966,30
0,775,16461,3575866936,3575866968,32
0,775,16462,3575866936,3575866971,35
0,775,16463,3575866936,3575866971,35
0,775,16464,3575866936,3575866973,37
0,775,16465,3575866936,3575866973,37
0,775,16466,3575866936,3575866973,37
0,775,16467,3575866936,3575866976,40
0,775,16468,3575866936,3575866976,40
0,775,16469,3575866936,3575866977,41
0,775,16470,3575866936,3575866978,42
0,775,16471,3575866936,3575866978,42
0,775,16472,3575866936,3575866978,42
0,775,16473,3575866936,3575866979,43
0,775,16474,3575866936,3575866981,45
0,775,16475,3575866936,3575866982,46
0,775,16476,3575866936,3575866983,47
0,776,16477,3575866993,3575866993,0
0,776,16478,3575866993,3575866993,0
0,776,16479,3575866993,3575866993,0
0,776,16480,3575866993,3575866994,1
0,776,16481,3575866993,3575866997,4
0,776,16482,3575866993,3575866998,5
0,776,16483,3575866993,3575866998,5
0,776,16484,3575866993,3575867001,8
0,776,16485,3575866993,3575867003,10
0,776,16486,3575866993,3575867004,11
0,776,16487,3575866993,3575867006,13
0,776,16488,3575866993,3575867008,15
0,776,16489,3575866993,3575867008,15
0,776,16490,3575866993,3575867011,18
0,776,16491,3575866993,3575867013,20
0,776,16492,3575866993,3575867014,21
0,776,16493,3575866993,3575867015,22
0,776,16494,3575866993,3575867019,26
0,776,16495,3575866993,3575867021,28
0,776,16496,3575866993,3575867022,29
0,776,16497,3575866993,3575867028,35
0,776,16498,3575866993,3575867028,35
0,776,16499,3575866993,3575867029,36
0,776,16500,3575866993,3575867031,38
0,776,16501,3575866993,3575867032,39
0,776,16502,3575866993,3575867032,39
0,776,16503,3575866993,3575867033,40
0,776,16504,3575866993,3575867036,43
0,776,16505,3575866993,3575867038,45
0,776,16506,3575866993,3575867039,46
0,776,16507,3575866993,3575867041,48
0,776,16508,3575866993,3575867041,48
0,776,16509,3575866993,3575867042,49
0,777,16510,3575867050,3575867050,0
0,777,16511,3575867050,3575867050,0
0,777,16512,3575867050,3575867050,0
0,777,16513,3575867050,3575867050,0
0,777,16514,3575867050,3575867050,0
0,777,16515,3575867050,3575867050,0
0,777,16516,3575867050,3575867050,0
0,777,16517,3575867050,3575867052,2
0,777,16518,3575867050,3575867052,2
0,777,16519,3575867050,3575867057,7
0,777,16520,3575867050,3575867057,7
0,777,16521,3575867050,3575867059,9
0,777,16522,3575867050,3575867059,9
0,777,16523,3575867050,3575867063,13
0,777,16524,3575867050,3575867066,16
0,777,16525,3575867050,3575867066,16
0,777,16526,3575867050,3575867068,18
0,777,16527,3575867050,3575867069,19
0,777,16528,3575867050,3575867069,19
0,777,16529,3575867050,3575867070,20
0,777,16530,3575867050,3575867074,24
0,777,16531,3575867050,3575867077,27
0,777,16532,3575867050,3575867077,27
0,777,16533,3575867050,3575867080,30
0,777,16534,3575867050,3575867080,30
0,777,16535,3575867050,3575867080,30
0,777,16536,3575867050,3575867080,30
0,777,16537,3575867050,3575867081,31
0,777,16538,3575867050,3575867083,33
0,777,16539,3575867050,3575867087,37
0,777,16540,3575867050,3575867089,39
0,777,16541,3575867050,3575867090,40
0,777,16542,3575867050,3575867091,41
0,777,16543,3575867050,3575867091,41
0,777,16544,3575867050,3575867092,42
0,777,16545,3575867050,3575867092,42
0,777,16546,3575867050,3575867092,42
0,777,16547,3575867050,3575867092,42
0,777,16548,3575867050,3575867092,42
0,777,16549,3575867050,3575867092,42
0,777,16550,3575867050,3575867093,43
0,777,16551,3575867050,3575867094,44
0,777,16552,3575867050,3575867094,44
0,777,16553,3575867050,3575867095,45
0,777,16554,3575867050,3575867095,45
0,777,16555,3575867050,3575867096,46
0,777,16556,3575867050,3575867096,46
0,777,16557,3575867050,3575867097,47
0,777,16558,3575867050,3575867098,48
0,778,16559,3575867111,3575867111,0
0,778,16560,3575867111,3575867111,0
0,778,16561,3575867111,3575867111,0
0,778,16562,3575867111,3575867111,0
0,778,16563,3575867111,3575867111,0
0,778,16564,3575867111,3575867111,0
0,778,16565,3575867111,3575867111,0
0,778,16566,3575867111,3575867111,0
0,778,16567,3575867111,3575867111,0
0,778,16568,3575867111,3575867111,0
0,778,16569,3575867111,3575867111,0
0,778,16570,3575867111,3575867111,0
0,778,16571,3575867111,3575867111,0
0,778,16572,3575867111,3575867111,0
0,778,16573,3575867111,3575867114,3
0,778,16574,3575867111,3575867114,3
0,778,16575,3575867111,3575867115,4
0,778,16576,3575867111,3575867117,6
0,778,16577,3575867111,3575867118,7
0,778,16578,3575867111,3575867118,7
0,778,16579,3575867111,3575867120,9
0,778,16580,3575867111,3575867120,9
0,778,16581,3575867111,3575867121,10
0,778,16582,3575867111,3575867122,11
0,778,16583,3575867111,3575867122,11
0,778,16584,3575867111,3575867122,11
0,778,16585,3575867111,3575867124,13
0,778,16586,3575867111,3575867124,13
0,778,16587,3575867111,3575867126,15
0,778,16588,3575867111,3575867126,15
0,778,16589,3575867111,3575867127,16
0,778,16590,3575867111,3575867127,16
0,778,16591,3575867111,3575867128,17
0,778,16592,3575867111,3575867129,18
0,778,16593,3575867111,3575867130,19
0,778,16594,3575867111,3575867131,20
0,778,16595,3575867111,3575867131,20
0,778,16596,3575867111,3575867133,22
0,778,16597,3575867111,3575867134,23
0,778,16598,3575867111,3575867135,24
0,778,16599,3575867111,3575867135,24
0,778,16600,3575867111,3575867135,24
0,778,16601,3575867111,3575867136,25
0,778,16602,3575867111,3575867137,26
0,778,16603,3575867111,3575867138,27
0,778,16604,3575867111,3575867138,27
0,778,16605,3575867111,3575867138,27
0,778,16606,3575867111,3575867140,29
0,778,16607,3575867111,3575867142,31
0,778,16608,3575867111,3575867142,31
0,778,16609,3575867111,3575867144,33
0,778,16610,3575867111,3575867145,34
0,778,16611,3575867111,3575867146,35
0,778,16612,3575867111,3575867146,35
0,778,16613,3575867111,3575867148,37
0,778,16614,3575867111,3575867148,37
0,778,16615,3575867111,3575867149,38
0,778,16616,3575867111,3575867149,38
0,778,16617,3575867111,3575867150,39
0,778,16618,3575867111,3575867150,39
0,778,16619,3575867111,3575867153,42
0,778,16620,3575867111,3575867154,43
0,778,16621,3575867111,3575867154,43
0,778,16622,3575867111,3575867155,44
0,778,16623,3575867111,3575867156,45
0,778,16624,3575867111,3575867159,48
0,778,16625,3575867111,3575867159,48
0,778,16626,3575867111,3575867160,49
0,778,16627,3575867111,3575867161,50
0,779,16628,3575867166,3575867167,1
0,779,16629,3575867166,3575867167,1
0,779,16630,3575867166,3575867167,1
0,779,16631,3575867166,3575867167,1
0,779,16632,3575867166,3575867167,1
0,779,16633,3575867166,3575867168,2
0,779,16634,3575867166,3575867171,5
0,779,16635,3575867166,3575867172,6
0,779,16636,3575867166,3575867173,7
0,779,16637,3575867166,3575867173,7
0,779,16638,3575867166,3575867175,9
0,779,16639,3575867166,3575867175,9
0,779,16640,3575867166,3575867176,10
0,779,16641,3575867166,3575867177,11
0,779,16642,3575867166,3575867178,12
0,779,16643,3575867166,3575867178,12
0,779,16644,3575867166,3575867178,12
0,779,16645,3575867166,3575867180,14
0,779,16646,3575867166,3575867182,16
0,779,16647,3575867166,3575867183,17
0,779,16648,3575867166,3575867186,20
0,779,16649,3575867166,3575867187,21
0,779,16650,3575867166,3575867189,23
0,779,16651,3575867166,3575867189,23
0,779,16652,3575867166,3575867194,28
0,779,16653,3575867166,3575867197,31
0,779,16654,3575867166,3575867198,32
0,779,16655,3575867166,3575867198,32
0,779,16656,3575867166,3575867202,36
0,779,16657,3575867166,3575867204,38
0,779,16658,3575867166,3575867204,38
0,779,16659,3575867166,3575867205,39
0,779,16660,3575867166,3575867206,40
0,779,16661,3575867166,3575867208,42
0,779,16662,3575867166,3575867209,43
0,779,16663,3575867166,3575867212,46
0,779,16664,3575867166,3575867214,48
0,779,16665,3575867166,3575867214,48
0,780,16666,3575867227,3575867227,0
0,780,16667,3575867227,3575867227,0
0,780,16668,3575867227,3575867227,0
0,780,16669,3575867227,3575867227,0
0,780,16670,3575867227,3575867228,1
0,780,16671,3575867227,3575867228,1
0,780,16672,3575867227,3575867229,2
0,780,16673,3575867227,3575867230,3
0,780,16674,3575867227,3575867232,5
0,780,16675,3575867227,3575867232,5
0,780,16676,3575867227,3575867233,6
0,780,16677,3575867227,3575867236,9
0,780,16678,3575867227,3575867238,11
0,780,16679,3575867227,3575867239,12
0,780,16680,3575867227,3575867242,15
0,780,16681,3575867227,3575867242,15
0,780,16682,3575867227,3575867242,15
0,780,16683,3575867227,3575867246,19
0,780,16684,3575867227,3575867246,19
0,780,16685,3575867227,3575867246,19
0,780,16686,3575867227,3575867248,21
0,780,16687,3575867227,3575867248,21
0,780,16688,3575867227,3575867249,22
0,780,16689,3575867227,3575867250,23
0,780,16690,3575867227,3575867252,25
0,780,16691,3575867227,3575867254,27
0,780,16692,3575867227,3575867256,29
0,780,16693,3575867227,3575867257,30
0,780,16694,3575867227,3575867257,30
0,780,16695,3575867227,3575867258,31
0,780,16696,3575867227,3575867259,32
0,780,16697,3575867227,3575867263,36
0,780,16698,3575867227,3575867266,39
0,780,16699,3575867227,3575867266,39
0,780,16700,3575867227,3575867269,42
0,780,16701,3575867227,3575867269,42
0,780,16702,3575867227,3575867269,42
0,780,16703,3575867227,3575867270,43
0,780,16704,3575867227,3575867276,49
0,780,16705,3575867227,3575867277,50
0,781,16706,3575867284,3575867284,0
0,781,16707,3575867284,3575867284,0
0,781,16708,3575867284,3575867284,0
0,781,16709,3575867284,3575867284,0
0,781,16710,3575867284,3575867284,0
0,781,16711,3575867284,3575867284,0
0,781,16712,3575867284,3575867287,3
0,781,16713,3575867284,3575867287,3
0,781,16714,3575867284,3575867288,4
0,781,16715,3575867284,3575867290,6
0,781,16716,3575867284,3575867291,7
0,781,16717,3575867284,3575867291,7
0,781,16718,3575867284,3575867291,7
0,781,16719,3575867284,3575867292,8
0,781,16720,3575867284,3575867292,8
0,781,16721,3575867284,3575867292,8
0,781,16722,3575867284,3575867292,8
0,781,16723,3575867284,3575867292,8
0,781,16724,3575867284,3575867293,9
0,781,16725,3575867284,3575867293,9
0,781,16726,3575867284,3575867294,10
0,781,16727,3575867284,3575867295,11
0,781,16728,3575867284,3575867295,11
0,781,16729,3575867284,3575867295,11
0,781,16730,3575867284,3575867296,12
0,781,16731,3575867284,3575867297,13
0,781,16732,3575867284,3575867298,14
0,781,16733,3575867284,3575867298,14
0,781,16734,3575867284,3575867301,17
0,781,16735,3575867284,3575867302,18
0,781,16736,3575867284,3575867305,21
0,781,16737,3575867284,3575867306,22
0,781,16738,3575867284,3575867306,22
0,781,16739,3575867284,3575867306,22
0,781,16740,3575867284,3575867308,24
0,781,16741,3575867284,3575867309,25
0,781,16742,3575867284,3575867309,25
0,781,16743,3575867284,3575867310,26
0,781,16744,3575867284,3575867310,26
0,781,16745,3575867284,3575867310,26
0,781,16746,3575867284,3575867312,28
0,781,16747,3575867284,3575867312,28
0,781,16748,3575867284,3575867314,30
0,781,16749,3575867284,3575867314,30
0,781,16750,3575867284,3575867315,31
0,781,16751,3575867284,3575867317,33
0,781,16752,3575867284,3575867318,34
0,781,16753,3575867284,3575867319,35
0,781,16754,3575867284,3575867322,38
0,781,16755,3575867284,3575867322,38
0,781,16756,3575867284,3575867322,38
0,781,16757,3575867284,3575867323,39
0,781,16758,3575867284,3575867323,39
0,781,16759,3575867284,3575867324,40
0,781,16760,3575867284,3575867325,41
0,781,16761,3575867284,3575867325,41
0,781,16762,3575867284,3575867326,42
0,781,16763,3575867284,3575867328,44
0,781,16764,3575867284,3575867329,45
0,781,16765,3575867284,3575867329,45
0,781,16766,3575867284,3575867329,45
0,781,16767,3575867284,3575867331,47
0,781,16768,3575867284,3575867331,47
0,781,16769,3575867284,3575867332,48
0,781,16770,3575867284,3575867333,49
0,781,16771,3575867284,3575867333,49
0,782,16772,3575867341,3575867341,0
0,782,16773,3575867341,3575867341,0
0,782,16774,3575867341,3575867341,0
0,782,16775,3575867341,3575867341,0
0,782,16776,3575867341,3575867341,0
0,782,16777,3575867341,3575867341,0
0,782,16778,3575867341,3575867341,0
0,782,16779,3575867341,3575867341,0
0,782,16780,3575867341,3575867341,0
0,782,16781,3575867341,3575867341,0
0,782,16782,3575867341,3575867342,1
0,782,16783,3575867341,3575867344,3
0,782,16784,3575867341,3575867346,5
0,782,16785,3575867341,3575867346,5
0,782,16786,3575867341,3575867346,5
0,782,16787,3575867341,3575867348,7
0,782,16788,3575867341,3575867348,7
0,782,16789,3575867341,3575867348,7
0,782,16790,3575867341,3575867350,9
0,782,16791,3575867341,3575867350,9
0,782,16792,3575867341,3575867350,9
0,782,16793,3575867341,3575867351,10
0,782,16794,3575867341,3575867352,11
0,782,16795,3575867341,3575867354,13
0,782,16796,3575867341,3575867357,16
0,782,16797,3575867341,3575867358,17
0,782,16798,3575867341,3575867359,18
0,782,16799,3575867341,3575867359,18
0,782,16800,3575867341,3575867360,19
0,782,16801,3575867341,3575867360,19
0,782,16802,3575867341,3575867362,21
0,782,16803,3575867341,3575867363,22
0,782,16804,3575867341,3575867364,23
0,782,16805,3575867341,3575867364,23
0,782,16806,3575867341,3575867366,25
0,782,16807,3575867341,3575867366,25
0,782,16808,3575867341,3575867368,27
0,782,16809,3575867341,3575867370,29
0,782,16810,3575867341,3575867372,31
0,782,16811,3575867341,3575867372,31
0,782,16812,3575867341,3575867373,32
0,782,16813,3575867341,3575867374,33
0,782,16814,3575867341,3575867374,33
0,782,16815,3575867341,3575867375,34
0,782,16816,3575867341,3575867376,35
0,782,16817,3575867341,3575867377,36
0,782,16818,3575867341,3575867377,36
0,782,16819,3575867341,3575867378,37
0,782,16820,3575867341,3575867378,37
0,782,16821,3575867341,3575867379,38
0,782,16822,3575867341,3575867382,41
0,782,16823,3575867341,3575867383,42
0,782,16824,3575867341,3575867384,43
0,782,16825,3575867341,3575867388,47
0,782,16826,3575867341,3575867389,48
0,783,16827,3575867400,3575867400,0
0,783,16828,3575867400,3575867400,0
0,783,16829,3575867400,3575867400,0
0,783,16830,3575867400,3575867400,0
0,783,16831,3575867400,3575867402,2
0,783,16832,3575867400,3575867403,3
0,783,16833,3575867400,3575867407,7
0,783,16834,3575867400,3575867408,8
0,783,16835,3575867400,3575867409,9
0,783,16836,3575867400,3575867409,9
0,783,16837,3575867400,3575867413,13
0,783,16838,3575867400,3575867414,14
0,783,16839,3575867400,3575867414,14
0,783,16840,3575867400,3575867416,16
0,783,16841,3575867400,3575867417,17
0,783,16842,3575867400,3575867419,19
0,783,16843,3575867400,3575867420,20
0,783,16844,3575867400,3575867421,21
0,783,16845,3575867400,3575867428,28
0,783,16846,3575867400,3575867428,28
0,783,16847,3575867400,3575867429,29
0,783,16848,3575867400,3575867430,30
0,783,16849,3575867400,3575867432,32
0,783,16850,3575867400,3575867432,32
0,783,16851,3575867400,3575867433,33
0,783,16852,3575867400,3575867436,36
0,783,16853,3575867400,3575867438,38
0,783,16854,3575867400,3575867440,40
0,783,16855,3575867400,3575867441,41
0,783,16856,3575867400,3575867442,42
0,783,16857,3575867400,3575867443,43
0,783,16858,3575867400,3575867445,45
0,783,16859,3575867400,3575867446,46
0,783,16860,3575867400,3575867447,47
0,783,16861,3575867400,3575867448,48
0,783,16862,3575867400,3575867449,49
0,784,16863,3575867458,3575867458,0
0,784,16864,3575867458,3575867458,0
0,784,16865,3575867458,3575867458,0
0,784,16866,3575867458,3575867458,0
0,784,16867,3575867458,3575867458,0
0,784,16868,3575867458,3575867459,1
0,784,16869,3575867458,3575867460,2
0,784,16870,3575867458,3575867460,2
0,784,16871,3575867458,3575867463,5
0,784,16872,3575867458,3575867467,9
0,784,16873,3575867458,3575867467,9
0,784,16874,3575867458,3575867468,10
0,784,16875,3575867458,3575867470,12
0,784,16876,3575867458,3575867471,13
0,784,16877,3575867458,3575867475,17
0,784,16878,3575867458,3575867477,19
0,784,16879,3575867458,3575867480,22
0,784,16880,3575867458,3575867480,22
0,784,16881,3575867458,3575867480,22
0,784,16882,3575867458,3575867481,23
0,784,16883,3575867458,3575867482,24
0,784,16884,3575867458,3575867483,25
0,784,16885,3575867458,3575867487,29
0,784,16886,3575867458,3575867487,29
0,784,16887,3575867458,3575867489,31
0,784,16888,3575867458,3575867490,32
0,784,16889,3575867458,3575867491,33
0,784,16890,3575867458,3575867491,33
0,784,16891,3575867458,3575867491,33
0,784,16892,3575867458,3575867491,33
0,784,16893,3575867458,3575867492,34
0,784,16894,3575867458,3575867492,34
0,784,16895,3575867458,3575867492,34
0,784,16896,3575867458,3575867492,34
0,784,16897,3575867458,3575867492,34
0,784,16898,3575867458,3575867493,35
0,784,16899,3575867458,3575867494,36
0,784,16900,3575867458,3575867494,36
0,784,16901,3575867458,3575867495,37
0,784,16902,3575867458,3575867495,37
0,784,16903,3575867458,3575867496,38
0,784,16904,3575867458,3575867496,38
0,784,16905,3575867458,3575867498,40
0,784,16906,3575867458,3575867501,43
0,784,16907,3575867458,3575867502,44
0,784,16908,3575867458,3575867504,46
0,784,16909,3575867458,3575867505,47
0,784,16910,3575867458,3575867506,48
0,784,16911,3575867458,3575867506,48
0,784,16912,3575867458,3575867507,49
0,784,16913,3575867458,3575867508,50
0,785,16914,3575867515,3575867515,0
0,785,16915,3575867515,3575867515,0
0,785,16916,3575867515,3575867515,0
0,785,16917,3575867515,3575867515,0
0,785,16918,3575867515,3575867515,0
0,785,16919,3575867515,3575867515,0
0,785,16920,3575867515,3575867515,0
0,785,16921,3575867515,3575867515,0
0,785,16922,3575867515,3575867515,0
0,785,16923,3575867515,3575867515,0
0,785,16924,3575867515,3575867516,1
0,785,16925,3575867515,3575867517,2
0,785,16926,3575867515,3575867519,4
0,785,16927,3575867515,3575867520,5
0,785,16928,3575867515,3575867520,5
0,785,16929,3575867515,3575867521,6
0,785,16930,3575867515,3575867521,6
0,785,16931,3575867515,3575867521,6
0,785,16932,3575867515,3575867522,7
0,785,16933,3575867515,3575867523,8
0,785,16934,3575867515,3575867523,8
0,785,16935,3575867515,3575867523,8
0,785,16936,3575867515,3575867524,9
0,785,16937,3575867515,3575867526,11
0,785,16938,3575867515,3575867526,11
0,785,16939,3575867515,3575867526,11
0,785,16940,3575867515,3575867527,12
0,785,16941,3575867515,3575867528,13
0,785,16942,3575867515,3575867528,13
0,785,16943,3575867515,3575867530,15
0,785,16944,3575867515,3575867530,15
0,785,16945,3575867515,3575867531,16
0,785,16946,3575867515,3575867532,17
0,785,16947,3575867515,3575867535,20
0,785,16948,3575867515,3575867536,21
0,785,16949,3575867515,3575867536,21
0,785,16950,3575867515,3575867537,22
0,785,16951,3575867515,3575867537,22
0,785,16952,3575867515,3575867538,23
0,785,16953,3575867515,3575867538,23
0,785,16954,3575867515,3575867538,23
0,785,16955,3575867515,3575867539,24
0,785,16956,3575867515,3575867540,25
0,785,16957,3575867515,3575867541,26
0,785,16958,3575867515,3575867545,30
0,785,16959,3575867515,3575867545,30
0,785,16960,3575867515,3575867545,30
0,785,16961,3575867515,3575867548,33
0,785,16962,3575867515,3575867548,33
0,785,16963,3575867515,3575867549,34
0,785,16964,3575867515,3575867549,34
0,785,16965,3575867515,3575867550,35
0,785,16966,3575867515,3575867550,35
0,785,16967,3575867515,3575867551,36
0,785,16968,3575867515,3575867554,39
0,785,16969,3575867515,3575867554,39
0,785,16970,3575867515,3575867556,41
0,785,16971,3575867515,3575867558,43
0,785,16972,3575867515,3575867558,43
0,785,16973,3575867515,3575867559,44
0,785,16974,3575867515,3575867560,45
0,785,16975,3575867515,3575867561,46
0,785,16976,3575867515,3575867562,47
0,785,16977,3575867515,3575867563,48
0,785,16978,3575867515,3575867564,49
0,785,16979,3575867515,3575867564,49
0,786,16980,3575867572,3575867572,0
0,786,16981,3575867572,3575867572,0
0,786,16982,3575867572,3575867572,0
0,786,16983,3575867572,3575867572,0
0,786,16984,3575867572,3575867572,0
0,786,16985,3575867572,3575867572,0
0,786,16986,3575867572,3575867574,2
0,786,16987,3575867572,3575867574,2
0,786,16988,3575867572,3575867574,2
0,786,16989,3575867572,3575867577,5
0,786,16990,3575867572,3575867579,7
0,786,16991,3575867572,3575867579,7
0,786,16992,3575867572,3575867582,10
0,786,16993,3575867572,3575867583,11
0,786,16994,3575867572,3575867586,14
0,786,16995,3575867572,3575867588,16
0,786,16996,3575867572,3575867589,17
0,786,16997,3575867572,3575867593,21
0,786,16998,3575867572,3575867597,25
0,786,16999,3575867572,3575867598,26
0,786,17000,3575867572,3575867598,26
0,786,17001,3575867572,3575867602,30
0,786,17002,3575867572,3575867602,30
0,786,17003,3575867572,3575867605,33
0,786,17004,3575867572,3575867606,34
0,786,17005,3575867572,3575867607,35
0,786,17006,3575867572,3575867608,36
0,786,17007,3575867572,3575867609,37
0,786,17008,3575867572,3575867612,40
0,786,17009,3575867572,3575867612,40
0,786,17010,3575867572,3575867613,41
0,786,17011,3575867572,3575867616,44
0,786,17012,3575867572,3575867617,45
0,786,17013,3575867572,3575867620,48
0,786,17014,3575867572,3575867620,48
0,787,17015,3575867631,3575867631,0
0,787,17016,3575867631,3575867631,0
0,787,17017,3575867631,3575867631,0
0,787,17018,3575867631,3575867631,0
0,787,17019,3575867631,3575867631,0
0,787,17020,3575867631,3575867632,1
0,787,17021,3575867631,3575867635,4
0,787,17022,3575867631,3575867638,7
0,787,17023,3575867631,3575867640,9
0,787,17024,3575867631,3575867640,9
0,787,17025,3575867631,3575867641,10
0,787,17026,3575867631,3575867642,11
0,787,17027,3575867631,3575867645,14
0,787,17028,3575867631,3575867646,15
0,787,17029,3575867631,3575867646,15
0,787,17030,3575867631,3575867647,16
0,787,17031,3575867631,3575867649,18
0,787,17032,3575867631,3575867651,20
0,787,17033,3575867631,3575867656,25
0,787,17034,3575867631,3575867660,29
0,787,17035,3575867631,3575867663,32
0,787,17036,3575867631,3575867663,32
0,787,17037,3575867631,3575867665,34
0,787,17038,3575867631,3575867666,35
0,787,17039,3575867631,3575867668,37
0,787,17040,3575867631,3575867668,37
0,787,17041,3575867631,3575867669,38
0,787,17042,3575867631,3575867670,39
0,787,17043,3575867631,3575867677,46
0,787,17044,3575867631,3575867678,47
0,787,17045,3575867631,3575867679,48
0,787,17046,3575867631,3575867680,49
0,787,17047,3575867631,3575867680,49
0,788,17048,3575867689,3575867689,0
0,788,17049,3575867689,3575867689,0
0,788,17050,3575867689,3575867689,0
0,788,17051,3575867689,3575867689,0
0,788,17052,3575867689,3575867690,1
0,788,17053,3575867689,3575867691,2
0,788,17054,3575867689,3575867691,2
0,788,17055,3575867689,3575867691,2
0,788,17056,3575867689,3575867691,2
0,788,17057,3575867689,3575867692,3
0,788,17058,3575867689,3575867692,3
0,788,17059,3575867689,3575867692,3
0,788,17060,3575867689,3575867692,3
0,788,17061,3575867689,3575867692,3
0,788,17062,3575867689,3575867693,4
0,788,17063,3575867689,3575867694,5
0,788,17064,3575867689,3575867695,6
0,788,17065,3575867689,3575867695,6
0,788,17066,3575867689,3575867696,7
0,788,17067,3575867689,3575867696,7
0,788,17068,3575867689,3575867697,8
0,788,17069,3575867689,3575867698,9
0,788,17070,3575867689,3575867699,10
0,788,17071,3575867689,3575867701,12
0,788,17072,3575867689,3575867701,12
0,788,17073,3575867689,3575867704,15
0,788,17074,3575867689,3575867706,17
0,788,17075,3575867689,3575867706,17
0,788,17076,3575867689,3575867708,19
0,788,17077,3575867689,3575867708,19
0,788,17078,3575867689,3575867709,20
0,788,17079,3575867689,3575867709,20
0,788,17080,3575867689,3575867710,21
0,788,17081,3575867689,3575867711,22
0,788,17082,3575867689,3575867712,23
0,788,17083,3575867689,3575867712,23
0,788,17084,3575867689,3575867712,23
0,788,17085,3575867689,3575867713,24
0,788,17086,3575867689,3575867714,25
0,788,17087,3575867689,3575867714,25
0,788,17088,3575867689,3575867716,27
0,788,17089,3575867689,3575867718,29
0,788,17090,3575867689,3575867719,30
0,788,17091,3575867689,3575867720,31
0,788,17092,3575867689,3575867721,32
0,788,17093,3575867689,3575867721,32
0,788,17094,3575867689,3575867722,33
0,788,17095,3575867689,3575867722,33
0,788,17096,3575867689,3575867722,33
0,788,17097,3575867689,3575867722,33
0,788,17098,3575867689,3575867723,34
0,788,17099,3575867689,3575867723,34
0,788,17100,3575867689,3575867724,35
0,788,17101,3575867689,3575867725,36
0,788,17102,3575867689,3575867725,36
0,788,17103,3575867689,3575867727,38
0,788,17104,3575867689,3575867729,40
0,788,17105,3575867689,3575867729,40
0,788,17106,3575867689,3575867729,40
0,788,17107,3575867689,3575867730,41
0,788,17108,3575867689,3575867730,41
0,788,17109,3575867689,3575867732,43
0,788,17110,3575867689,3575867732,43
0,788,17111,3575867689,3575867733,44
0,788,17112,3575867689,3575867735,46
0,788,17113,3575867689,3575867735,46
0,788,17114,3575867689,3575867736,47
0,788,17115,3575867689,3575867736,47
0,788,17116,3575867689,3575867738,49
0,788,17117,3575867689,3575867738,49
0,788,17118,3575867689,3575867738,49
0,788,17119,3575867689,3575867738,49
0,788,17120,3575867689,3575867739,50
0,789,17121,3575867745,3575867745,0
0,789,17122,3575867745,3575867745,0
0,789,17123,3575867745,3575867745,0
0,789,17124,3575867745,3575867746,1
0,789,17125,3575867745,3575867746,1
0,789,17126,3575867745,3575867748,3
0,789,17127,3575867745,3575867748,3
0,789,17128,3575867745,3575867748,3
0,789,17129,3575867745,3575867750,5
0,789,17130,3575867745,3575867750,5
0,789,17131,3575867745,3575867751,6
0,789,17132,3575867745,3575867753,8
0,789,17133,3575867745,3575867754,9
0,789,17134,3575867745,3575867755,10
0,789,17135,3575867745,3575867756,11
0,789,17136,3575867745,3575867758,13
0,789,17137,3575867745,3575867759,14
0,789,17138,3575867745,3575867759,14
0,789,17139,3575867745,3575867760,15
0,789,17140,3575867745,3575867762,17
0,789,17141,3575867745,3575867762,17
0,789,17142,3575867745,3575867763,18
0,789,17143,3575867745,3575867764,19
0,789,17144,3575867745,3575867765,20
0,789,17145,3575867745,3575867765,20
0,789,17146,3575867745,3575867766,21
0,789,17147,3575867745,3575867766,21
0,789,17148,3575867745,3575867767,22
0,789,17149,3575867745,3575867770,25
0,789,17150,3575867745,3575867770,25
0,789,17151,3575867745,3575867771,26
0,789,17152,3575867745,3575867771,26
0,789,17153,3575867745,3575867773,28
0,789,17154,3575867745,3575867775,30
0,789,17155,3575867745,3575867775,30
0,789,17156,3575867745,3575867775,30
0,789,17157,3575867745,3575867777,32
0,789,17158,3575867745,3575867778,33
0,789,17159,3575867745,3575867779,34
0,789,17160,3575867745,3575867780,35
0,789,17161,3575867745,3575867782,37
0,789,17162,3575867745,3575867782,37
0,789,17163,3575867745,3575867783,38
0,789,17164,3575867745,3575867789,44
0,789,17165,3575867745,3575867793,48
0,790,17166,3575867802,3575867802,0
0,790,17167,3575867802,3575867802,0
0,790,17168,3575867802,3575867802,0
0,790,17169,3575867802,3575867802,0
0,790,17170,3575867802,3575867803,1
0,790,17171,3575867802,3575867805,3
0,790,17172,3575867802,3575867807,5
0,790,17173,3575867802,3575867808,6
0,790,17174,3575867802,3575867809,7
0,790,17175,3575867802,3575867812,10
0,790,17176,3575867802,3575867813,11
0,790,17177,3575867802,3575867813,11
0,790,17178,3575867802,3575867815,13
0,790,17179,3575867802,3575867816,14
0,790,17180,3575867802,3575867817,15
0,790,17181,3575867802,3575867817,15
0,790,17182,3575867802,3575867819,17
0,790,17183,3575867802,3575867821,19
0,790,17184,3575867802,3575867822,20
0,790,17185,3575867802,3575867827,25
0,790,17186,3575867802,3575867827,25
0,790,17187,3575867802,3575867830,28
0,790,17188,3575867802,3575867831,29
0,790,17189,3575867802,3575867832,30
0,790,17190,3575867802,3575867833,31
0,790,17191,3575867802,3575867837,35
0,790,17192,3575867802,3575867840,38
0,790,17193,3575867802,3575867841,39
0,790,17194,3575867802,3575867841,39
0,790,17195,3575867802,3575867842,40
0,790,17196,3575867802,3575867845,43
0,790,17197,3575867802,3575867846,44
0,790,17198,3575867802,3575867847,45
0,790,17199,3575867802,3575867847,45
0,790,17200,3575867802,3575867848,46
0,790,17201,3575867802,3575867850,48
0,790,17202,3575867802,3575867851,49
0,791,17203,3575867859,3575867859,0
0,791,17204,3575867859,3575867859,0
0,791,17205,3575867859,3575867859,0
0,791,17206,3575867859,3575867859,0
0,791,17207,3575867859,3575867862,3
0,791,17208,3575867859,3575867866,7
0,791,17209,3575867859,3575867866,7
0,791,17210,3575867859,3575867868,9
0,791,17211,3575867859,3575867868,9
0,791,17212,3575867859,3575867869,10
0,791,17213,3575867859,3575867869,10
0,791,17214,3575867859,3575867869,10
0,791,17215,3575867859,3575867869,10
0,791,17216,3575867859,3575867875,16
0,791,17217,3575867859,3575867877,18
0,791,17218,3575867859,3575867878,19
0,791,17219,3575867859,3575867880,21
0,791,17220,3575867859,3575867880,21
0,791,17221,3575867859,3575867880,21
0,791,17222,3575867859,3575867880,21
0,791,17223,3575867859,3575867883,24
0,791,17224,3575867859,3575867884,25
0,791,17225,3575867859,3575867887,28
0,791,17226,3575867859,3575867888,29
0,791,17227,3575867859,3575867890,31
0,791,17228,3575867859,3575867891,32
0,791,17229,3575867859,3575867891,32
0,791,17230,3575867859,3575867891,32
0,791,17231,3575867859,3575867891,32
0,791,17232,3575867859,3575867892,33
0,791,17233,3575867859,3575867892,33
0,791,17234,3575867859,3575867892,33
0,791,17235,3575867859,3575867892,33
0,791,17236,3575867859,3575867892,33
0,791,17237,3575867859,3575867893,34
0,791,17238,3575867859,3575867894,35
0,791,17239,3575867859,3575867895,36
0,791,17240,3575867859,3575867895,36
0,791,17241,3575867859,3575867896,37
0,791,17242,3575867859,3575867896,37
0,791,17243,3575867859,3575867896,37
0,791,17244,3575867859,3575867897,38
0,791,17245,3575867859,3575867898,39
0,791,17246,3575867859,3575867898,39
0,791,17247,3575867859,3575867901,42
0,791,17248,3575867859,3575867902,43
0,791,17249,3575867859,3575867905,46
0,791,17250,3575867859,3575867905,46
0,791,17251,3575867859,3575867906,47
0,791,17252,3575867859,3575867907,48
0,791,17253,3575867859,3575867908,49
0,791,17254,3575867859,3575867909,50
0,792,17255,3575867916,3575867916,0
0,792,17256,3575867916,3575867916,0
0,792,17257,3575867916,3575867916,0
0,792,17258,3575867916,3575867916,0
0,792,17259,3575867916,3575867916,0
0,792,17260,3575867916,3575867916,0
0,792,17261,3575867916,3575867916,0
0,792,17262,3575867916,3575867916,0
0,792,17263,3575867916,3575867916,0
0,792,17264,3575867916,3575867916,0
0,792,17265,3575867916,3575867916,0
0,792,17266,3575867916,3575867918,2
0,792,17267,3575867916,3575867920,4
0,792,17268,3575867916,3575867920,4
0,792,17269,3575867916,3575867921,5
0,792,17270,3575867916,3575867921,5
0,792,17271,3575867916,3575867922,6
0,792,17272,3575867916,3575867922,6
0,792,17273,3575867916,3575867922,6
0,792,17274,3575867916,3575867923,7
0,792,17275,3575867916,3575867923,7
0,792,17276,3575867916,3575867924,8
0,792,17277,3575867916,3575867925,9
0,792,17278,3575867916,3575867926,10
0,792,17279,3575867916,3575867926,10
0,792,17280,3575867916,3575867927,11
0,792,17281,3575867916,3575867929,13
0,792,17282,3575867916,3575867930,14
0,792,17283,3575867916,3575867930,14
0,792,17284,3575867916,3575867931,15
0,792,17285,3575867916,3575867932,16
0,792,17286,3575867916,3575867933,17
0,792,17287,3575867916,3575867935,19
0,792,17288,3575867916,3575867936,20
0,792,17289,3575867916,3575867936,20
0,792,17290,3575867916,3575867937,21
0,792,17291,3575867916,3575867938,22
0,792,17292,3575867916,3575867939,23
0,792,17293,3575867916,3575867939,23
0,792,17294,3575867916,3575867939,23
0,792,17295,3575867916,3575867942,26
0,792,17296,3575867916,3575867944,28
0,792,17297,3575867916,3575867945,29
0,792,17298,3575867916,3575867946,30
0,792,17299,3575867916,3575867947,31
0,792,17300,3575867916,3575867947,31
0,792,17301,3575867916,3575867948,32
0,792,17302,3575867916,3575867948,32
0,792,17303,3575867916,3575867949,33
0,792,17304,3575867916,3575867950,34
0,792,17305,3575867916,3575867951,35
0,792,17306,3575867916,3575867953,37
0,792,17307,3575867916,3575867955,39
0,792,17308,3575867916,3575867955,39
0,792,17309,3575867916,3575867957,41
0,792,17310,3575867916,3575867958,42
0,792,17311,3575867916,3575867959,43
0,792,17312,3575867916,3575867959,43
0,792,17313,3575867916,3575867963,47
0,792,17314,3575867916,3575867963,47
0,792,17315,3575867916,3575867964,48
0,792,17316,3575867916,3575867964,48
0,792,17317,3575867916,3575867964,48
0,792,17318,3575867916,3575867966,50
0,793,17319,3575867976,3575867976,0
0,793,17320,3575867976,3575867976,0
0,793,17321,3575867976,3575867976,0
0,793,17322,3575867976,3575867976,0
0,793,17323,3575867976,3575867976,0
0,793,17324,3575867976,3575867976,0
0,793,17325,3575867976,3575867976,0
0,793,17326,3575867976,3575867976,0
0,793,17327,3575867976,3575867976,0
0,793,17328,3575867976,3575867976,0
0,793,17329,3575867976,3575867977,1
0,793,17330,3575867976,3575867977,1
0,793,17331,3575867976,3575867980,4
0,793,17332,3575867976,3575867982,6
0,793,17333,3575867976,3575867982,6
0,793,17334,3575867976,3575867984,8
0,793,17335,3575867976,3575867986,10
0,793,17336,3575867976,3575867989,13
0,793,17337,3575867976,3575867989,13
0,793,17338,3575867976,3575867994,18
0,793,17339,3575867976,3575867997,21
0,793,17340,3575867976,3575867997,21
0,793,17341,3575867976,3575867999,23
0,793,17342,3575867976,3575868003,27
0,793,17343,3575867976,3575868005,29
0,793,17344,3575867976,3575868006,30
0,793,17345,3575867976,3575868007,31
0,793,17346,3575867976,3575868008,32
0,793,17347,3575867976,3575868009,33
0,793,17348,3575867976,3575868012,36
0,793,17349,3575867976,3575868013,37
0,793,17350,3575867976,3575868014,38
0,793,17351,3575867976,3575868015,39
0,793,17352,3575867976,3575868016,40
0,793,17353,3575867976,3575868018,42
0,793,17354,3575867976,3575868021,45
0,793,17355,3575867976,3575868021,45
0,793,17356,3575867976,3575868021,45
0,794,17357,3575868034,3575868034,0
0,794,17358,3575868034,3575868034,0
0,794,17359,3575868034,3575868034,0
0,794,17360,3575868034,3575868034,0
0,794,17361,3575868034,3575868034,0
0,794,17362,3575868034,3575868034,0
0,794,17363,3575868034,3575868034,0
0,794,17364,3575868034,3575868035,1
0,794,17365,3575868034,3575868037,3
0,794,17366,3575868034,3575868041,7
0,794,17367,3575868034,3575868041,7
0,794,17368,3575868034,3575868041,7
0,794,17369,3575868034,3575868042,8
0,794,17370,3575868034,3575868046,12
0,794,17371,3575868034,3575868046,12
0,794,17372,3575868034,3575868047,13
0,794,17373,3575868034,3575868048,14
0,794,17374,3575868034,3575868050,16
0,794,17375,3575868034,3575868052,18
0,794,17376,3575868034,3575868056,22
0,794,17377,3575868034,3575868057,23
0,794,17378,3575868034,3575868058,24
0,794,17379,3575868034,3575868059,25
0,794,17380,3575868034,3575868063,29
0,794,17381,3575868034,3575868066,32
0,794,17382,3575868034,3575868067,33
0,794,17383,3575868034,3575868068,34
0,794,17384,3575868034,3575868069,35
0,794,17385,3575868034,3575868069,35
0,794,17386,3575868034,3575868072,38
0,794,17387,3575868034,3575868077,43
0,794,17388,3575868034,3575868078,44
0,794,17389,3575868034,3575868080,46
0,794,17390,3575868034,3575868080,46
0,794,17391,3575868034,3575868080,46
0,794,17392,3575868034,3575868080,46
0,794,17393,3575868034,3575868083,49
0,794,17394,3575868034,3575868083,49
0,795,17395,3575868094,3575868094,0
0,795,17396,3575868094,3575868094,0
0,795,17397,3575868094,3575868094,0
0,795,17398,3575868094,3575868094,0
0,795,17399,3575868094,3575868094,0
0,795,17400,3575868094,3575868094,0
0,795,17401,3575868094,3575868094,0
0,795,17402,3575868094,3575868094,0
0,795,17403,3575868094,3575868094,0
0,795,17404,3575868094,3575868094,0
0,795,17405,3575868094,3575868094,0
0,795,17406,3575868094,3575868094,0
0,795,17407,3575868094,3575868094,0
0,795,17408,3575868094,3575868094,0
0,795,17409,3575868094,3575868094,0
0,795,17410,3575868094,3575868094,0
0,795,17411,3575868094,3575868095,1
0,795,17412,3575868094,3575868096,2
0,795,17413,3575868094,3575868096,2
0,795,17414,3575868094,3575868096,2
0,795,17415,3575868094,3575868097,3
0,795,17416,3575868094,3575868097,3
0,795,17417,3575868094,3575868098,4
0,795,17418,3575868094,3575868099,5
0,795,17419,3575868094,3575868102,8
0,795,17420,3575868094,3575868102,8
0,795,17421,3575868094,3575868104,10
0,795,17422,3575868094,3575868106,12
0,795,17423,3575868094,3575868107,13
0,795,17424,3575868094,3575868109,15
0,795,17425,3575868094,3575868109,15
0,795,17426,3575868094,3575868109,15
0,795,17427,3575868094,3575868110,16
0,795,17428,3575868094,3575868111,17
0,795,17429,3575868094,3575868112,18
0,795,17430,3575868094,3575868112,18
0,795,17431,3575868094,3575868112,18
0,795,17432,3575868094,3575868113,19
0,795,17433,3575868094,3575868113,19
0,795,17434,3575868094,3575868113,19
0,795,17435,3575868094,3575868114,20
0,795,17436,3575868094,3575868116,22
0,795,17437,3575868094,3575868118,24
0,795,17438,3575868094,3575868119,25
0,795,17439,3575868094,3575868121,27
0,795,17440,3575868094,3575868121,27
0,795,17441,3575868094,3575868122,28
0,795,17442,3575868094,3575868123,29
0,795,17443,3575868094,3575868123,29
0,795,17444,3575868094,3575868123,29
0,795,17445,3575868094,3575868123,29
0,795,17446,3575868094,3575868124,30
0,795,17447,3575868094,3575868124,30
0,795,17448,3575868094,3575868125,31
0,795,17449,3575868094,3575868125,31
0,795,17450,3575868094,3575868126,32
0,795,17451,3575868094,3575868127,33
0,795,17452,3575868094,3575868129,35
0,795,17453,3575868094,3575868130,36
0,795,17454,3575868094,3575868131,37
0,795,17455,3575868094,3575868133,39
0,795,17456,3575868094,3575868134,40
0,795,17457,3575868094,3575868134,40
0,795,17458,3575868094,3575868134,40
0,795,17459,3575868094,3575868137,43
0,795,17460,3575868094,3575868137,43
0,795,17461,3575868094,3575868138,44
0,795,17462,3575868094,3575868139,45
0,795,17463,3575868094,3575868139,45
0,795,17464,3575868094,3575868139,45
0,795,17465,3575868094,3575868139,45
0,795,17466,3575868094,3575868142,48
0,795,17467,3575868094,3575868144,50
0,796,17468,3575868152,3575868152,0
0,796,17469,3575868152,3575868152,0
0,796,17470,3575868152,3575868152,0
0,796,17471,3575868152,3575868152,0
0,796,17472,3575868152,3575868152,0
0,796,17473,3575868152,3575868152,0
0,796,17474,3575868152,3575868152,0
0,796,17475,3575868152,3575868152,0
0,796,17476,3575868152,3575868152,0
0,796,17477,3575868152,3575868152,0
0,796,17478,3575868152,3575868152,0
0,796,17479,3575868152,3575868152,0
0,796,17480,3575868152,3575868152,0
0,796,17481,3575868152,3575868155,3
0,796,17482,3575868152,3575868155,3
0,796,17483,3575868152,3575868158,6
0,796,17484,3575868152,3575868158,6
0,796,17485,3575868152,3575868158,6
0,796,17486,3575868152,3575868159,7
0,796,17487,3575868152,3575868163,11
0,796,17488,3575868152,3575868164,12
0,796,17489,3575868152,3575868164,12
0,796,17490,3575868152,3575868164,12
0,796,17491,3575868152,3575868166,14
0,796,17492,3575868152,3575868166,14
0,796,17493,3575868152,3575868166,14
0,796,17494,3575868152,3575868172,20
0,796,17495,3575868152,3575868172,20
0,796,17496,3575868152,3575868172,20
0,796,17497,3575868152,3575868172,20
0,796,17498,3575868152,3575868172,20
0,796,17499,3575868152,3575868172,20
0,796,17500,3575868152,3575868175,23
0,796,17501,3575868152,3575868175,23
0,796,17502,3575868152,3575868176,24
0,796,17503,3575868152,3575868176,24
0,796,17504,3575868152,3575868176,24
0,796,17505,3575868152,3575868178,26
0,796,17506,3575868152,3575868178,26
0,796,17507,3575868152,3575868178,26
0,796,17508,3575868152,3575868179,27
0,796,17509,3575868152,3575868180,28
0,796,17510,3575868152,3575868182,30
0,796,17511,3575868152,3575868182,30
0,796,17512,3575868152,3575868184,32
0,796,17513,3575868152,3575868190,38
0,796,17514,3575868152,3575868197,45
0,796,17515,3575868152,3575868198,46
0,796,17516,3575868152,3575868199,47
0,796,17517,3575868152,3575868202,50
0,797,17518,3575868209,3575868209,0
0,797,17519,3575868209,3575868209,0
0,797,17520,3575868209,3575868209,0
0,797,17521,3575868209,3575868209,0
0,797,17522,3575868209,3575868213,4
0,797,17523,3575868209,3575868214,5
0,797,17524,3575868209,3575868214,5
0,797,17525,3575868209,3575868216,7
0,797,17526,3575868209,3575868217,8
0,797,17527,3575868209,3575868218,9
0,797,17528,3575868209,3575868219,10
0,797,17529,3575868209,3575868221,12
0,797,17530,3575868209,3575868221,12
0,797,17531,3575868209,3575868222,13
0,797,17532,3575868209,3575868227,18
0,797,17533,3575868209,3575868228,19
0,797,17534,3575868209,3575868229,20
0,797,17535,3575868209,3575868230,21
0,797,17536,3575868209,3575868232,23
0,797,17537,3575868209,3575868232,23
0,797,17538,3575868209,3575868233,24
0,797,17539,3575868209,3575868234,25
0,797,17540,3575868209,3575868237,28
0,797,17541,3575868209,3575868241,32
0,797,17542,3575868209,3575868241,32
0,797,17543,3575868209,3575868242,33
0,797,17544,3575868209,3575868242,33
0,797,17545,3575868209,3575868246,37
0,797,17546,3575868209,3575868247,38
0,797,17547,3575868209,3575868247,38
0,797,17548,3575868209,3575868247,38
0,797,17549,3575868209,3575868248,39
0,797,17550,3575868209,3575868250,41
0,797,17551,3575868209,3575868252,43
0,797,17552,3575868209,3575868253,44
0,797,17553,3575868209,3575868258,49
0,797,17554,3575868209,3575868259,50
0,798,17555,3575868266,3575868266,0
0,798,17556,3575868266,3575868266,0
0,798,17557,3575868266,3575868266,0
0,798,17558,3575868266,3575868268,2
0,798,17559,3575868266,3575868269,3
0,798,17560,3575868266,3575868270,4
0,798,17561,3575868266,3575868270,4
0,798,17562,3575868266,3575868275,9
0,798,17563,3575868266,3575868278,12
0,798,17564,3575868266,3575868278,12
0,798,17565,3575868266,3575868280,14
0,798,17566,3575868266,3575868280,14
0,798,17567,3575868266,3575868281,15
0,798,17568,3575868266,3575868283,17
0,798,17569,3575868266,3575868284,18
0,798,17570,3575868266,3575868287,21
0,798,17571,3575868266,3575868289,23
0,798,17572,3575868266,3575868291,25
0,798,17573,3575868266,3575868291,25
0,798,17574,3575868266,3575868292,26
0,798,17575,3575868266,3575868292,26
0,798,17576,3575868266,3575868292,26
0,798,17577,3575868266,3575868292,26
0,798,17578,3575868266,3575868292,26
0,798,17579,3575868266,3575868293,27
0,798,17580,3575868266,3575868294,28
0,798,17581,3575868266,3575868294,28
0,798,17582,3575868266,3575868296,30
0,798,17583,3575868266,3575868296,30
0,798,17584,3575868266,3575868297,31
0,798,17585,3575868266,3575868297,31
0,798,17586,3575868266,3575868298,32
0,798,17587,3575868266,3575868299,33
0,798,17588,3575868266,3575868301,35
0,798,17589,3575868266,3575868302,36
0,798,17590,3575868266,3575868304,38
0,798,17591,3575868266,3575868305,39
0,798,17592,3575868266,3575868306,40
0,798,17593,3575868266,3575868307,41
0,798,17594,3575868266,3575868309,43
0,798,17595,3575868266,3575868310,44
0,798,17596,3575868266,3575868310,44
0,798,17597,3575868266,3575868310,44
0,798,17598,3575868266,3575868312,46
0,798,17599,3575868266,3575868312,46
0,798,17600,3575868266,3575868313,47
0,798,17601,3575868266,3575868313,47
0,798,17602,3575868266,3575868313,47
0,798,17603,3575868266,3575868313,47
0,798,17604,3575868266,3575868315,49
0,799,17605,3575868323,3575868323,0
0,799,17606,3575868323,3575868323,0
0,799,17607,3575868323,3575868323,0
0,799,17608,3575868323,3575868323,0
0,799,17609,3575868323,3575868323,0
0,799,17610,3575868323,3575868323,0
0,799,17611,3575868323,3575868323,0
0,799,17612,3575868323,3575868323,0
0,799,17613,3575868323,3575868324,1
0,799,17614,3575868323,3575868324,1
0,799,17615,3575868323,3575868325,2
0,799,17616,3575868323,3575868325,2
0,799,17617,3575868323,3575868326,3
0,799,17618,3575868323,3575868326,3
0,799,17619,3575868323,3575868327,4
0,799,17620,3575868323,3575868329,6
0,799,17621,3575868323,3575868329,6
0,799,17622,3575868323,3575868330,7
0,799,17623,3575868323,3575868330,7
0,799,17624,3575868323,3575868332,9
0,799,17625,3575868323,3575868333,10
0,799,17626,3575868323,3575868335,12
0,799,17627,3575868323,3575868335,12
0,799,17628,3575868323,3575868336,13
0,799,17629,3575868323,3575868338,15
0,799,17630,3575868323,3575868339,16
0,799,17631,3575868323,3575868340,17
0,799,17632,3575868323,3575868340,17
0,799,17633,3575868323,3575868342,19
0,799,17634,3575868323,3575868345,22
0,799,17635,3575868323,3575868345,22
0,799,17636,3575868323,3575868346,23
0,799,17637,3575868323,3575868346,23
0,799,17638,3575868323,3575868348,25
0,799,17639,3575868323,3575868348,25
0,799,17640,3575868323,3575868348,25
0,799,17641,3575868323,3575868349,26
0,799,17642,3575868323,3575868349,26
0,799,17643,3575868323,3575868349,26
0,799,17644,3575868323,3575868351,28
0,799,17645,3575868323,3575868352,29
0,799,17646,3575868323,3575868352,29
0,799,17647,3575868323,3575868355,32
0,799,17648,3575868323,3575868356,33
0,799,17649,3575868323,3575868358,35
0,799,17650,3575868323,3575868359,36
0,799,17651,3575868323,3575868359,36
0,799,17652,3575868323,3575868363,40
0,799,17653,3575868323,3575868363,40
0,799,17654,3575868323,3575868364,41
0,799,17655,3575868323,3575868364,41
0,799,17656,3575868323,3575868365,42
0,799,17657,3575868323,3575868366,43
0,799,17658,3575868323,3575868371,48
0,799,17659,3575868323,3575868371,48
0,799,17660,3575868323,3575868372,49
0,799,17661,3575868323,3575868372,49
0,799,17662,3575868323,3575868372,49
0,799,17663,3575868323,3575868372,49
0,800,17664,3575868383,3575868383,0
0,800,17665,3575868383,3575868383,0
0,800,17666,3575868383,3575868383,0
0,800,17667,3575868383,3575868383,0
0,800,17668,3575868383,3575868383,0
0,800,17669,3575868383,3575868383,0
0,800,17670,3575868383,3575868383,0
0,800,17671,3575868383,3575868383,0
0,800,17672,3575868383,3575868383,0
0,800,17673,3575868383,3575868383,0
0,800,17674,3575868383,3575868383,0
0,800,17675,3575868383,3575868384,1
0,800,17676,3575868383,3575868389,6
0,800,17677,3575868383,3575868390,7
0,800,17678,3575868383,3575868398,15
0,800,17679,3575868383,3575868398,15
0,800,17680,3575868383,3575868398,15
0,800,17681,3575868383,3575868402,19
0,800,17682,3575868383,3575868403,20
0,800,17683,3575868383,3575868405,22
0,800,17684,3575868383,3575868406,23
0,800,17685,3575868383,3575868408,25
0,800,17686,3575868383,3575868408,25
0,800,17687,3575868383,3575868409,26
0,800,17688,3575868383,3575868412,29
0,800,17689,3575868383,3575868414,31
0,800,17690,3575868383,3575868415,32
0,800,17691,3575868383,3575868416,33
0,800,17692,3575868383,3575868419,36
0,800,17693,3575868383,3575868421,38
0,800,17694,3575868383,3575868421,38
0,800,17695,3575868383,3575868422,39
0,800,17696,3575868383,3575868427,44
0,800,17697,3575868383,3575868427,44
0,800,17698,3575868383,3575868428,45
0,800,17699,3575868383,3575868429,46
0,800,17700,3575868383,3575868431,48
0,800,17701,3575868383,3575868432,49
0,800,17702,3575868383,3575868432,49
0,800,17703,3575868383,3575868432,49
0,800,17704,3575868383,3575868433,50
0,801,17705,3575868442,3575868442,0
0,801,17706,3575868442,3575868442,0
0,801,17707,3575868442,3575868442,0
0,801,17708,3575868442,3575868442,0
0,801,17709,3575868442,3575868442,0
0,801,17710,3575868442,3575868443,1
0,801,17711,3575868442,3575868446,4
0,801,17712,3575868442,3575868446,4
0,801,17713,3575868442,3575868447,5
0,801,17714,3575868442,3575868448,6
0,801,17715,3575868442,3575868448,6
0,801,17716,3575868442,3575868450,8
0,801,17717,3575868442,3575868452,10
0,801,17718,3575868442,3575868456,14
0,801,17719,3575868442,3575868457,15
0,801,17720,3575868442,3575868459,17
0,801,17721,3575868442,3575868460,18
0,801,17722,3575868442,3575868462,20
0,801,17723,3575868442,3575868466,24
0,801,17724,3575868442,3575868466,24
0,801,17725,3575868442,3575868469,27
0,801,17726,3575868442,3575868469,27
0,801,17727,3575868442,3575868471,29
0,801,17728,3575868442,3575868477,35
0,801,17729,3575868442,3575868480,38
0,801,17730,3575868442,3575868480,38
0,801,17731,3575868442,3575868480,38
0,801,17732,3575868442,3575868481,39
0,801,17733,3575868442,3575868482,40
0,801,17734,3575868442,3575868483,41
0,801,17735,3575868442,3575868484,42
0,801,17736,3575868442,3575868487,45
0,801,17737,3575868442,3575868489,47
0,801,17738,3575868442,3575868490,48
0,801,17739,3575868442,3575868491,49
0,801,17740,3575868442,3575868492,50
0,802,17741,3575868500,3575868500,0
0,802,17742,3575868500,3575868500,0
0,802,17743,3575868500,3575868500,0
0,802,17744,3575868500,3575868500,0
0,802,17745,3575868500,3575868500,0
0,802,17746,3575868500,3575868500,0
0,802,17747,3575868500,3575868500,0
0,802,17748,3575868500,3575868500,0
0,802,17749,3575868500,3575868500,0
0,802,17750,3575868500,3575868500,0
0,802,17751,3575868500,3575868500,0
0,802,17752,3575868500,3575868500,0
0,802,17753,3575868500,3575868500,0
0,802,17754,3575868500,3575868500,0
0,802,17755,3575868500,3575868500,0
0,802,17756,3575868500,3575868500,0
0,802,17757,3575868500,3575868500,0
0,802,17758,3575868500,3575868500,0
0,802,17759,3575868500,3575868501,1
0,802,17760,3575868500,3575868504,4
0,802,17761,3575868500,3575868505,5
0,802,17762,3575868500,3575868505,5
0,802,17763,3575868500,3575868508,8
0,802,17764,3575868500,3575868509,9
0,802,17765,3575868500,3575868510,10
0,802,17766,3575868500,3575868510,10
0,802,17767,3575868500,3575868511,11
0,802,17768,3575868500,3575868512,12
0,802,17769,3575868500,3575868512,12
0,802,17770,3575868500,3575868512,12
0,802,17771,3575868500,3575868512,12
0,802,17772,3575868500,3575868513,13
0,802,17773,3575868500,3575868513,13
0,802,17774,3575868500,3575868514,14
0,802,17775,3575868500,3575868517,17
0,802,17776,3575868500,3575868519,19
0,802,17777,3575868500,3575868520,20
0,802,17778,3575868500,3575868521,21
0,802,17779,3575868500,3575868522,22
0,802,17780,3575868500,3575868522,22
0,802,17781,3575868500,3575868522,22
0,802,17782,3575868500,3575868524,24
0,802,17783,3575868500,3575868525,25
0,802,17784,3575868500,3575868525,25
0,802,17785,3575868500,3575868525,25
0,802,17786,3575868500,3575868526,26
0,802,17787,3575868500,3575868528,28
0,802,17788,3575868500,3575868529,29
0,802,17789,3575868500,3575868529,29
0,802,17790,3575868500,3575868530,30
0,802,17791,3575868500,3575868531,31
0,802,17792,3575868500,3575868532,32
0,802,17793,3575868500,3575868533,33
0,802,17794,3575868500,3575868533,33
0,802,17795,3575868500,3575868534,34
0,802,17796,3575868500,3575868535,35
0,802,17797,3575868500,3575868535,35
0,802,17798,3575868500,3575868536,36
0,802,17799,3575868500,3575868536,36
0,802,17800,3575868500,3575868539,39
0,802,17801,3575868500,3575868540,40
0,802,17802,3575868500,3575868540,40
0,802,17803,3575868500,3575868541,41
0,802,17804,3575868500,3575868543,43
0,802,17805,3575868500,3575868543,43
0,802,17806,3575868500,3575868544,44
0,802,17807,3575868500,3575868545,45
0,802,17808,3575868500,3575868545,45
0,802,17809,3575868500,3575868547,47
0,802,17810,3575868500,3575868547,47
0,802,17811,3575868500,3575868548,48
0,802,17812,3575868500,3575868549,49
0,802,17813,3575868500,3575868549,49
0,803,17814,3575868559,3575868559,0
0,803,17815,3575868559,3575868559,0
0,803,17816,3575868559,3575868559,0
0,803,17817,3575868559,3575868559,0
0,803,17818,3575868559,3575868559,0
0,803,17819,3575868559,3575868559,0
0,803,17820,3575868559,3575868559,0
0,803,17821,3575868559,3575868559,0
0,803,17822,3575868559,3575868559,0
0,803,17823,3575868559,3575868560,1
0,803,17824,3575868559,3575868560,1
0,803,17825,3575868559,3575868562,3
0,803,17826,3575868559,3575868563,4
0,803,17827,3575868559,3575868563,4
0,803,17828,3575868559,3575868564,5
0,803,17829,3575868559,3575868565,6
0,803,17830,3575868559,3575868565,6
0,803,17831,3575868559,3575868566,7
0,803,17832,3575868559,3575868570,11
0,803,17833,3575868559,3575868571,12
0,803,17834,3575868559,3575868571,12
0,803,17835,3575868559,3575868571,12
0,803,17836,3575868559,3575868571,12
0,803,17837,3575868559,3575868572,13
0,803,17838,3575868559,3575868575,16
0,803,17839,3575868559,3575868576,17
0,803,17840,3575868559,3575868576,17
0,803,17841,3575868559,3575868576,17
0,803,17842,3575868559,3575868577,18
0,803,17843,3575868559,3575868578,19
0,803,17844,3575868559,3575868578,19
0,803,17845,3575868559,3575868579,20
0,803,17846,3575868559,3575868579,20
0,803,17847,3575868559,3575868580,21
0,803,17848,3575868559,3575868581,22
0,803,17849,3575868559,3575868583,24
0,803,17850,3575868559,3575868587,28
0,803,17851,3575868559,3575868588,29
0,803,17852,3575868559,3575868589,30
0,803,17853,3575868559,3575868593,34
0,803,17854,3575868559,3575868597,38
0,803,17855,3575868559,3575868597,38
0,803,17856,3575868559,3575868601,42
0,803,17857,3575868559,3575868605,46
0,803,17858,3575868559,3575868607,48
0,803,17859,3575868559,3575868607,48
0,803,17860,3575868559,3575868609,50
0,804,17861,3575868616,3575868616,0
0,804,17862,3575868616,3575868616,0
0,804,17863,3575868616,3575868616,0
0,804,17864,3575868616,3575868616,0
0,804,17865,3575868616,3575868618,2
0,804,17866,3575868616,3575868618,2
0,804,17867,3575868616,3575868620,4
0,804,17868,3575868616,3575868620,4
0,804,17869,3575868616,3575868621,5
0,804,17870,3575868616,3575868626,10
0,804,17871,3575868616,3575868627,11
0,804,17872,3575868616,3575868628,12
0,804,17873,3575868616,3575868629,13
0,804,17874,3575868616,3575868629,13
0,804,17875,3575868616,3575868631,15
0,804,17876,3575868616,3575868632,16
0,804,17877,3575868616,3575868637,21
0,804,17878,3575868616,3575868641,25
0,804,17879,3575868616,3575868641,25
0,804,17880,3575868616,3575868642,26
0,804,17881,3575868616,3575868645,29
0,804,17882,3575868616,3575868645,29
0,804,17883,3575868616,3575868646,30
0,804,17884,3575868616,3575868646,30
0,804,17885,3575868616,3575868647,31
0,804,17886,3575868616,3575868648,32
0,804,17887,3575868616,3575868649,33
0,804,17888,3575868616,3575868651,35
0,804,17889,3575868616,3575868652,36
0,804,17890,3575868616,3575868656,40
0,804,17891,3575868616,3575868659,43
0,804,17892,3575868616,3575868661,45
0,804,17893,3575868616,3575868665,49
0,804,17894,3575868616,3575868665,49
0,805,17895,3575868675,3575868675,0
0,805,17896,3575868675,3575868675,0
0,805,17897,3575868675,3575868675,0
0,805,17898,3575868675,3575868675,0
0,805,17899,3575868675,3575868676,1
0,805,17900,3575868675,3575868677,2
0,805,17901,3575868675,3575868680,5
0,805,17902,3575868675,3575868680,5
0,805,17903,3575868675,3575868681,6
0,805,17904,3575868675,3575868681,6
0,805,17905,3575868675,3575868683,8
0,805,17906,3575868675,3575868687,12
0,805,17907,3575868675,3575868689,14
0,805,17908,3575868675,3575868690,15
0,805,17909,3575868675,3575868691,16
0,805,17910,3575868675,3575868692,17
0,805,17911,3575868675,3575868692,17
0,805,17912,3575868675,3575868692,17
0,805,17913,3575868675,3575868692,17
0,805,17914,3575868675,3575868693,18
0,805,17915,3575868675,3575868694,19
0,805,17916,3575868675,3575868694,19
0,805,17917,3575868675,3575868695,20
0,805,17918,3575868675,3575868696,21
0,805,17919,3575868675,3575868696,21
0,805,17920,3575868675,3575868696,21
0,805,17921,3575868675,3575868696,21
0,805,17922,3575868675,3575868696,21
0,805,17923,3575868675,3575868696,21
0,805,17924,3575868675,3575868697,22
0,805,17925,3575868675,3575868697,22
0,805,17926,3575868675,3575868698,23
0,805,17927,3575868675,3575868699,24
0,805,17928,3575868675,3575868701,26
0,805,17929,3575868675,3575868701,26
0,805,17930,3575868675,3575868704,29
0,805,17931,3575868675,3575868705,30
0,805,17932,3575868675,3575868705,30
0,805,17933,3575868675,3575868707,32
0,805,17934,3575868675,3575868708,33
0,805,17935,3575868675,3575868710,35
0,805,17936,3575868675,3575868710,35
0,805,17937,3575868675,3575868710,35
0,805,17938,3575868675,3575868712,37
0,805,17939,3575868675,3575868712,37
0,805,17940,3575868675,3575868712,37
0,805,17941,3575868675,3575868712,37
0,805,17942,3575868675,3575868713,38
0,805,17943,3575868675,3575868714,39
0,805,17944,3575868675,3575868715,40
0,805,17945,3575868675,3575868717,42
0,805,17946,3575868675,3575868720,45
0,805,17947,3575868675,3575868720,45
0,805,17948,3575868675,3575868721,46
0,805,17949,3575868675,3575868721,46
0,805,17950,3575868675,3575868723,48
0,805,17951,3575868675,3575868723,48
0,805,17952,3575868675,3575868724,49
0,806,17953,3575868732,3575868732,0
0,806,17954,3575868732,3575868732,0
0,806,17955,3575868732,3575868732,0
0,806,17956,3575868732,3575868732,0
0,806,17957,3575868732,3575868732,0
0,806,17958,3575868732,3575868732,0
0,806,17959,3575868732,3575868732,0
0,806,17960,3575868732,3575868732,0
0,806,17961,3575868732,3575868732,0
0,806,17962,3575868732,3575868732,0
0,806,17963,3575868732,3575868734,2
0,806,17964,3575868732,3575868735,3
0,806,17965,3575868732,3575868735,3
0,806,17966,3575868732,3575868736,4
0,806,17967,3575868732,3575868736,4
0,806,17968,3575868732,3575868738,6
0,806,17969,3575868732,3575868739,7
0,806,17970,3575868732,3575868740,8
0,806,17971,3575868732,3575868741,9
0,806,17972,3575868732,3575868742,10
0,806,17973,3575868732,3575868743,11
0,806,17974,3575868732,3575868744,12
0,806,17975,3575868732,3575868745,13
0,806,17976,3575868732,3575868745,13
0,806,17977,3575868732,3575868746,14
0,806,17978,3575868732,3575868747,15
0,806,17979,3575868732,3575868748,16
0,806,17980,3575868732,3575868748,16
0,806,17981,3575868732,3575868748,16
0,806,17982,3575868732,3575868749,17
0,806,17983,3575868732,3575868749,17
0,806,17984,3575868732,3575868751,19
0,806,17985,3575868732,3575868752,20
0,806,17986,3575868732,3575868752,20
0,806,17987,3575868732,3575868754,22
0,806,17988,3575868732,3575868754,22
0,806,17989,3575868732,3575868757,25
0,806,17990,3575868732,3575868757,25
0,806,17991,3575868732,3575868758,26
0,806,17992,3575868732,3575868761,29
0,806,17993,3575868732,3575868761,29
0,806,17994,3575868732,3575868761,29
0,806,17995,3575868732,3575868763,31
0,806,17996,3575868732,3575868763,31
0,806,17997,3575868732,3575868764,32
0,806,17998,3575868732,3575868764,32
0,806,17999,3575868732,3575868765,33
0,806,18000,3575868732,3575868766,34
0,806,18001,3575868732,3575868770,38
0,806,18002,3575868732,3575868770,38
0,806,18003,3575868732,3575868771,39
0,806,18004,3575868732,3575868771,39
0,806,18005,3575868732,3575868772,40
0,806,18006,3575868732,3575868773,41
0,806,18007,3575868732,3575868776,44
0,806,18008,3575868732,3575868776,44
0,806,18009,3575868732,3575868776,44
0,806,18010,3575868732,3575868777,45
0,806,18011,3575868732,3575868778,46
0,806,18012,3575868732,3575868779,47
0,806,18013,3575868732,3575868780,48
0,807,18014,3575868790,3575868790,0
0,807,18015,3575868790,3575868790,0
0,807,18016,3575868790,3575868790,0
0,807,18017,3575868790,3575868790,0
0,807,18018,3575868790,3575868793,3
0,807,18019,3575868790,3575868795,5
0,807,18020,3575868790,3575868797,7
0,807,18021,3575868790,3575868799,9
0,807,18022,3575868790,3575868799,9
0,807,18023,3575868790,3575868801,11
0,807,18024,3575868790,3575868805,15
0,807,18025,3575868790,3575868806,16
0,807,18026,3575868790,3575868807,17
0,807,18027,3575868790,3575868808,18
0,807,18028,3575868790,3575868810,20
0,807,18029,3575868790,3575868812,22
0,807,18030,3575868790,3575868813,23
0,807,18031,3575868790,3575868814,24
0,807,18032,3575868790,3575868815,25
0,807,18033,3575868790,3575868818,28
0,807,18034,3575868790,3575868819,29
0,807,18035,3575868790,3575868820,30
0,807,18036,3575868790,3575868821,31
0,807,18037,3575868790,3575868821,31
0,807,18038,3575868790,3575868826,36
0,807,18039,3575868790,3575868827,37
0,807,18040,3575868790,3575868829,39
0,807,18041,3575868790,3575868832,42
0,807,18042,3575868790,3575868832,42
0,807,18043,3575868790,3575868832,42
0,807,18044,3575868790,3575868834,44
0,807,18045,3575868790,3575868838,48
0,808,18046,3575868847,3575868847,0
0,808,18047,3575868847,3575868847,0
0,808,18048,3575868847,3575868847,0
0,808,18049,3575868847,3575868847,0
0,808,18050,3575868847,3575868847,0
0,808,18051,3575868847,3575868847,0
0,808,18052,3575868847,3575868847,0
0,808,18053,3575868847,3575868847,0
0,808,18054,3575868847,3575868847,0
0,808,18055,3575868847,3575868848,1
0,808,18056,3575868847,3575868848,1
0,808,18057,3575868847,3575868849,2
0,808,18058,3575868847,3575868850,3
0,808,18059,3575868847,3575868852,5
0,808,18060,3575868847,3575868856,9
0,808,18061,3575868847,3575868856,9
0,808,18062,3575868847,3575868858,11
0,808,18063,3575868847,3575868860,13
0,808,18064,3575868847,3575868865,18
0,808,18065,3575868847,3575868866,19
0,808,18066,3575868847,3575868868,21
0,808,18067,3575868847,3575868869,22
0,808,18068,3575868847,3575868869,22
0,808,18069,3575868847,3575868878,31
0,808,18070,3575868847,3575868878,31
0,808,18071,3575868847,3575868880,33
0,808,18072,3575868847,3575868880,33
0,808,18073,3575868847,3575868880,33
0,808,18074,3575868847,3575868881,34
0,808,18075,3575868847,3575868883,36
0,808,18076,3575868847,3575868885,38
0,808,18077,3575868847,3575868887,40
0,808,18078,3575868847,3575868891,44
0,808,18079,3575868847,3575868891,44
0,808,18080,3575868847,3575868891,44
0,808,18081,3575868847,3575868892,45
0,808,18082,3575868847,3575868892,45
0,808,18083,3575868847,3575868892,45
0,808,18084,3575868847,3575868893,46
0,808,18085,3575868847,3575868894,47
0,808,18086,3575868847,3575868894,47
0,808,18087,3575868847,3575868895,48
0,808,18088,3575868847,3575868896,49
0,808,18089,3575868847,3575868896,49
0,808,18090,3575868847,3575868896,49
0,808,18091,3575868847,3575868896,49
0,808,18092,3575868847,3575868896,49
0,808,18093,3575868847,3575868896,49
0,808,18094,3575868847,3575868896,49
0,808,18095,3575868847,3575868897,50
0,809,18096,3575868907,3575868907,0
0,809,18097,3575868907,3575868907,0
0,809,18098,3575868907,3575868907,0
0,809,18099,3575868907,3575868907,0
0,809,18100,3575868907,3575868907,0
0,809,18101,3575868907,3575868907,0
0,809,18102,3575868907,3575868907,0
0,809,18103,3575868907,3575868908,1
0,809,18104,3575868907,3575868908,1
0,809,18105,3575868907,3575868910,3
0,809,18106,3575868907,3575868910,3
0,809,18107,3575868907,3575868910,3
0,809,18108,3575868907,3575868912,5
0,809,18109,3575868907,3575868912,5
0,809,18110,3575868907,3575868912,5
0,809,18111,3575868907,3575868912,5
0,809,18112,3575868907,3575868913,6
0,809,18113,3575868907,3575868913,6
0,809,18114,3575868907,3575868914,7
0,809,18115,3575868907,3575868915,8
0,809,18116,3575868907,3575868917,10
0,809,18117,3575868907,3575868920,13
0,809,18118,3575868907,3575868920,13
0,809,18119,3575868907,3575868921,14
0,809,18120,3575868907,3575868921,14
0,809,18121,3575868907,3575868922,15
0,809,18122,3575868907,3575868923,16
0,809,18123,3575868907,3575868924,17
0,809,18124,3575868907,3575868924,17
0,809,18125,3575868907,3575868925,18
0,809,18126,3575868907,3575868926,19
0,809,18127,3575868907,3575868926,19
0,809,18128,3575868907,3575868927,20
0,809,18129,3575868907,3575868927,20
0,809,18130,3575868907,3575868928,21
0,809,18131,3575868907,3575868928,21
0,809,18132,3575868907,3575868930,23
0,809,18133,3575868907,3575868930,23
0,809,18134,3575868907,3575868932,25
0,809,18135,3575868907,3575868932,25
0,809,18136,3575868907,3575868933,26
0,809,18137,3575868907,3575868934,27
0,809,18138,3575868907,3575868934,27
0,809,18139,3575868907,3575868935,28
0,809,18140,3575868907,3575868936,29
0,809,18141,3575868907,3575868937,30
0,809,18142,3575868907,3575868938,31
0,809,18143,3575868907,3575868939,32
0,809,18144,3575868907,3575868940,33
0,809,18145,3575868907,3575868940,33
0,809,18146,3575868907,3575868942,35
0,809,18147,3575868907,3575868943,36
0,809,18148,3575868907,3575868943,36
0,809,18149,3575868907,3575868945,38
0,809,18150,3575868907,3575868945,38
0,809,18151,3575868907,3575868946,39
0,809,18152,3575868907,3575868947,40
0,809,18153,3575868907,3575868947,40
0,809,18154,3575868907,3575868948,41
0,809,18155,3575868907,3575868948,41
0,809,18156,3575868907,3575868948,41
0,809,18157,3575868907,3575868949,42
0,809,18158,3575868907,3575868950,43
0,809,18159,3575868907,3575868950,43
0,809,18160,3575868907,3575868952,45
0,809,18161,3575868907,3575868953,46
0,809,18162,3575868907,3575868955,48
0,809,18163,3575868907,3575868955,48
0,810,18164,3575868965,3575868965,0
0,810,18165,3575868965,3575868965,0
0,810,18166,3575868965,3575868965,0
0,810,18167,3575868965,3575868965,0
0,810,18168,3575868965,3575868965,0
0,810,18169,3575868965,3575868965,0
0,810,18170,3575868965,3575868965,0
0,810,18171,3575868965,3575868965,0
0,810,18172,3575868965,3575868965,0
0,810,18173,3575868965,3575868965,0
0,810,18174,3575868965,3575868965,0
0,810,18175,3575868965,3575868966,1
0,810,18176,3575868965,3575868966,1
0,810,18177,3575868965,3575868970,5
0,810,18178,3575868965,3575868971,6
0,810,18179,3575868965,3575868971,6
0,810,18180,3575868965,3575868971,6
0,810,18181,3575868965,3575868972,7
0,810,18182,3575868965,3575868973,8
0,810,18183,3575868965,3575868976,11
0,810,18184,3575868965,3575868976,11
0,810,18185,3575868965,3575868976,11
0,810,18186,3575868965,3575868976,11
0,810,18187,3575868965,3575868977,12
0,810,18188,3575868965,3575868978,13
0,810,18189,3575868965,3575868978,13
0,810,18190,3575868965,3575868979,14
0,810,18191,3575868965,3575868979,14
0,810,18192,3575868965,3575868981,16
0,810,18193,3575868965,3575868982,17
0,810,18194,3575868965,3575868983,18
0,810,18195,3575868965,3575868986,21
0,810,18196,3575868965,3575868988,23
0,810,18197,3575868965,3575868994,29
0,810,18198,3575868965,3575868995,30
0,810,18199,3575868965,3575868999,34
0,810,18200,3575868965,3575868999,34
0,810,18201,3575868965,3575869000,35
0,810,18202,3575868965,3575869001,36
0,810,18203,3575868965,3575869005,40
0,810,18204,3575868965,3575869005,40
0,810,18205,3575868965,3575869007,42
0,810,18206,3575868965,3575869008,43
0,810,18207,3575868965,3575869010,45
0,810,18208,3575868965,3575869013,48
0,810,18209,3575868965,3575869013,48
0,810,18210,3575868965,3575869014,49
0,811,18211,3575869025,3575869025,0
0,811,18212,3575869025,3575869025,0
0,811,18213,3575869025,3575869025,0
0,811,18214,3575869025,3575869025,0
0,811,18215,3575869025,3575869025,0
0,811,18216,3575869025,3575869026,1
0,811,18217,3575869025,3575869027,2
0,811,18218,3575869025,3575869028,3
0,811,18219,3575869025,3575869029,4
0,811,18220,3575869025,3575869030,5
0,811,18221,3575869025,3575869032,7
0,811,18222,3575869025,3575869033,8
0,811,18223,3575869025,3575869033,8
0,811,18224,3575869025,3575869034,9
0,811,18225,3575869025,3575869038,13
0,811,18226,3575869025,3575869042,17
0,811,18227,3575869025,3575869044,19
0,811,18228,3575869025,3575869045,20
0,811,18229,3575869025,3575869046,21
0,811,18230,3575869025,3575869046,21
0,811,18231,3575869025,3575869047,22
0,811,18232,3575869025,3575869048,23
0,811,18233,3575869025,3575869049,24
0,811,18234,3575869025,3575869050,25
0,811,18235,3575869025,3575869050,25
0,811,18236,3575869025,3575869051,26
0,811,18237,3575869025,3575869052,27
0,811,18238,3575869025,3575869052,27
0,811,18239,3575869025,3575869058,33
0,811,18240,3575869025,3575869059,34
0,811,18241,3575869025,3575869060,35
0,811,18242,3575869025,3575869061,36
0,811,18243,3575869025,3575869065,40
0,811,18244,3575869025,3575869067,42
0,811,18245,3575869025,3575869068,43
0,811,18246,3575869025,3575869069,44
0,811,18247,3575869025,3575869070,45
0,811,18248,3575869025,3575869071,46
0,812,18249,3575869084,3575869084,0
0,812,18250,3575869084,3575869084,0
0,812,18251,3575869084,3575869084,0
0,812,18252,3575869084,3575869084,0
0,812,18253,3575869084,3575869084,0
0,812,18254,3575869084,3575869085,1
0,812,18255,3575869084,3575869087,3
0,812,18256,3575869084,3575869091,7
0,812,18257,3575869084,3575869091,7
0,812,18258,3575869084,3575869092,8
0,812,18259,3575869084,3575869092,8
0,812,18260,3575869084,3575869092,8
0,812,18261,3575869084,3575869093,9
0,812,18262,3575869084,3575869093,9
0,812,18263,3575869084,3575869093,9
0,812,18264,3575869084,3575869094,10
0,812,18265,3575869084,3575869094,10
0,812,18266,3575869084,3575869095,11
0,812,18267,3575869084,3575869096,12
0,812,18268,3575869084,3575869096,12
0,812,18269,3575869084,3575869096,12
0,812,18270,3575869084,3575869096,12
0,812,18271,3575869084,3575869096,12
0,812,18272,3575869084,3575869097,13
0,812,18273,3575869084,3575869098,14
0,812,18274,3575869084,3575869099,15
0,812,18275,3575869084,3575869102,18
0,812,18276,3575869084,3575869103,19
0,812,18277,3575869084,3575869105,21
0,812,18278,3575869084,3575869105,21
0,812,18279,3575869084,3575869108,24
0,812,18280,3575869084,3575869109,25
0,812,18281,3575869084,3575869109,25
0,812,18282,3575869084,3575869109,25
0,812,18283,3575869084,3575869110,26
0,812,18284,3575869084,3575869111,27
0,812,18285,3575869084,3575869111,27
0,812,18286,3575869084,3575869112,28
0,812,18287,3575869084,3575869112,28
0,812,18288,3575869084,3575869112,28
0,812,18289,3575869084,3575869113,29
0,812,18290,3575869084,3575869113,29
0,812,18291,3575869084,3575869114,30
0,812,18292,3575869084,3575869114,30
0,812,18293,3575869084,3575869118,34
0,812,18294,3575869084,3575869119,35
0,812,18295,3575869084,3575869120,36
0,812,18296,3575869084,3575869121,37
0,812,18297,3575869084,3575869123,39
0,812,18298,3575869084,3575869123,39
0,812,18299,3575869084,3575869123,39
0,812,18300,3575869084,3575869124,40
0,812,18301,3575869084,3575869125,41
0,812,18302,3575869084,3575869125,41
0,812,18303,3575869084,3575869127,43
0,812,18304,3575869084,3575869128,44
0,812,18305,3575869084,3575869128,44
0,812,18306,3575869084,3575869129,45
0,812,18307,3575869084,3575869131,47
0,812,18308,3575869084,3575869132,48
0,812,18309,3575869084,3575869132,48
0,812,18310,3575869084,3575869133,49
0,812,18311,3575869084,3575869134,50
0,813,18312,3575869141,3575869141,0
0,813,18313,3575869141,3575869141,0
0,813,18314,3575869141,3575869141,0
0,813,18315,3575869141,3575869141,0
0,813,18316,3575869141,3575869141,0
0,813,18317,3575869141,3575869141,0
0,813,18318,3575869141,3575869141,0
0,813,18319,3575869141,3575869141,0
0,813,18320,3575869141,3575869142,1
0,813,18321,3575869141,3575869142,1
0,813,18322,3575869141,3575869143,2
0,813,18323,3575869141,3575869145,4
0,813,18324,3575869141,3575869145,4
0,813,18325,3575869141,3575869146,5
0,813,18326,3575869141,3575869147,6
0,813,18327,3575869141,3575869147,6
0,813,18328,3575869141,3575869148,7
0,813,18329,3575869141,3575869148,7
0,813,18330,3575869141,3575869150,9
0,813,18331,3575869141,3575869150,9
0,813,18332,3575869141,3575869152,11
0,813,18333,3575869141,3575869152,11
0,813,18334,3575869141,3575869154,13
0,813,18335,3575869141,3575869155,14
0,813,18336,3575869141,3575869155,14
0,813,18337,3575869141,3575869158,17
0,813,18338,3575869141,3575869158,17
0,813,18339,3575869141,3575869158,17
0,813,18340,3575869141,3575869159,18
0,813,18341,3575869141,3575869161,20
0,813,18342,3575869141,3575869163,22
0,813,18343,3575869141,3575869164,23
0,813,18344,3575869141,3575869164,23
0,813,18345,3575869141,3575869164,23
0,813,18346,3575869141,3575869164,23
0,813,18347,3575869141,3575869166,25
0,813,18348,3575869141,3575869170,29
0,813,18349,3575869141,3575869171,30
0,813,18350,3575869141,3575869172,31
0,813,18351,3575869141,3575869172,31
0,813,18352,3575869141,3575869173,32
0,813,18353,3575869141,3575869176,35
0,813,18354,3575869141,3575869176,35
0,813,18355,3575869141,3575869177,36
0,813,18356,3575869141,3575869177,36
0,813,18357,3575869141,3575869178,37
0,813,18358,3575869141,3575869178,37
0,813,18359,3575869141,3575869179,38
0,813,18360,3575869141,3575869180,39
0,813,18361,3575869141,3575869181,40
0,813,18362,3575869141,3575869182,41
0,813,18363,3575869141,3575869183,42
0,813,18364,3575869141,3575869186,45
0,813,18365,3575869141,3575869188,47
0,813,18366,3575869141,3575869190,49
0,814,18367,3575869200,3575869200,0
0,814,18368,3575869200,3575869200,0
0,814,18369,3575869200,3575869200,0
0,814,18370,3575869200,3575869200,0
0,814,18371,3575869200,3575869202,2
0,814,18372,3575869200,3575869205,5
0,814,18373,3575869200,3575869206,6
0,814,18374,3575869200,3575869207,7
0,814,18375,3575869200,3575869208,8
0,814,18376,3575869200,3575869209,9
0,814,18377,3575869200,3575869213,13
0,814,18378,3575869200,3575869213,13
0,814,18379,3575869200,3575869214,14
0,814,18380,3575869200,3575869215,15
0,814,18381,3575869200,3575869218,18
0,814,18382,3575869200,3575869220,20
0,814,18383,3575869200,3575869220,20
0,814,18384,3575869200,3575869222,22
0,814,18385,3575869200,3575869222,22
0,814,18386,3575869200,3575869226,26
0,814,18387,3575869200,3575869226,26
0,814,18388,3575869200,3575869228,28
0,814,18389,3575869200,3575869229,29
0,814,18390,3575869200,3575869232,32
0,814,18391,3575869200,3575869232,32
0,814,18392,3575869200,3575869233,33
0,814,18393,3575869200,3575869238,38
0,814,18394,3575869200,3575869242,42
0,814,18395,3575869200,3575869243,43
0,814,18396,3575869200,3575869245,45
0,814,18397,3575869200,3575869246,46
0,814,18398,3575869200,3575869246,46
0,814,18399,3575869200,3575869246,46
0,814,18400,3575869200,3575869247,47
0,814,18401,3575869200,3575869247,47
0,814,18402,3575869200,3575869248,48
0,814,18403,3575869200,3575869250,50
0,815,18404,3575869259,3575869259,0
0,815,18405,3575869259,3575869259,0
0,815,18406,3575869259,3575869259,0
0,815,18407,3575869259,3575869259,0
0,815,18408,3575869259,3575869259,0
0,815,18409,3575869259,3575869259,0
0,815,18410,3575869259,3575869259,0
0,815,18411,3575869259,3575869259,0
0,815,18412,3575869259,3575869259,0
0,815,18413,3575869259,3575869261,2
0,815,18414,3575869259,3575869265,6
0,815,18415,3575869259,3575869266,7
0,815,18416,3575869259,3575869268,9
0,815,18417,3575869259,3575869269,10
0,815,18418,3575869259,3575869270,11
0,815,18419,3575869259,3575869272,13
0,815,18420,3575869259,3575869281,22
0,815,18421,3575869259,3575869281,22
0,815,18422,3575869259,3575869281,22
0,815,18423,3575869259,3575869283,24
0,815,18424,3575869259,3575869285,26
0,815,18425,3575869259,3575869287,28
0,815,18426,3575869259,3575869289,30
0,815,18427,3575869259,3575869290,31
0,815,18428,3575869259,3575869291,32
0,815,18429,3575869259,3575869292,33
0,815,18430,3575869259,3575869292,33
0,815,18431,3575869259,3575869292,33
0,815,18432,3575869259,3575869293,34
0,815,18433,3575869259,3575869293,34
0,815,18434,3575869259,3575869294,35
0,815,18435,3575869259,3575869294,35
0,815,18436,3575869259,3575869295,36
0,815,18437,3575869259,3575869296,37
0,815,18438,3575869259,3575869296,37
0,815,18439,3575869259,3575869296,37
0,815,18440,3575869259,3575869296,37
0,815,18441,3575869259,3575869296,37
0,815,18442,3575869259,3575869296,37
0,815,18443,3575869259,3575869296,37
0,815,18444,3575869259,3575869297,38
0,815,18445,3575869259,3575869298,39
0,815,18446,3575869259,3575869299,40
0,815,18447,3575869259,3575869302,43
0,815,18448,3575869259,3575869302,43
0,815,18449,3575869259,3575869303,44
0,815,18450,3575869259,3575869305,46
0,815,18451,3575869259,3575869306,47
0,815,18452,3575869259,3575869306,47
0,815,18453,3575869259,3575869309,50
0,816,18454,3575869317,3575869317,0
0,816,18455,3575869317,3575869317,0
0,816,18456,3575869317,3575869317,0
0,816,18457,3575869317,3575869317,0
0,816,18458,3575869317,3575869317,0
0,816,18459,3575869317,3575869317,0
0,816,18460,3575869317,3575869317,0
0,816,18461,3575869317,3575869317,0
0,816,18462,3575869317,3575869317,0
0,816,18463,3575869317,3575869317,0
0,816,18464,3575869317,3575869317,0
0,816,18465,3575869317,3575869317,0
0,816,18466,3575869317,3575869318,1
0,816,18467,3575869317,3575869320,3
0,816,18468,3575869317,3575869321,4
0,816,18469,3575869317,3575869321,4
0,816,18470,3575869317,3575869322,5
0,816,18471,3575869317,3575869323,6
0,816,18472,3575869317,3575869323,6
0,816,18473,3575869317,3575869325,8
0,816,18474,3575869317,3575869325,8
0,816,18475,3575869317,3575869326,9
0,816,18476,3575869317,3575869326,9
0,816,18477,3575869317,3575869326,9
0,816,18478,3575869317,3575869328,11
0,816,18479,3575869317,3575869328,11
0,816,18480,3575869317,3575869329,12
0,816,18481,3575869317,3575869331,14
0,816,18482,3575869317,3575869332,15
0,816,18483,3575869317,3575869333,16
0,816,18484,3575869317,3575869333,16
0,816,18485,3575869317,3575869333,16
0,816,18486,3575869317,3575869335,18
0,816,18487,3575869317,3575869335,18
0,816,18488,3575869317,3575869336,19
0,816,18489,3575869317,3575869336,19
0,816,18490,3575869317,3575869337,20
0,816,18491,3575869317,3575869338,21
0,816,18492,3575869317,3575869340,23
0,816,18493,3575869317,3575869341,24
0,816,18494,3575869317,3575869341,24
0,816,18495,3575869317,3575869342,25
0,816,18496,3575869317,3575869343,26
0,816,18497,3575869317,3575869343,26
0,816,18498,3575869317,3575869345,28
0,816,18499,3575869317,3575869345,28
0,816,18500,3575869317,3575869346,29
0,816,18501,3575869317,3575869347,30
0,816,18502,3575869317,3575869348,31
0,816,18503,3575869317,3575869349,32
0,816,18504,3575869317,3575869349,32
0,816,18505,3575869317,3575869351,34
0,816,18506,3575869317,3575869351,34
0,816,18507,3575869317,3575869352,35
0,816,18508,3575869317,3575869352,35
0,816,18509,3575869317,3575869354,37
0,816,18510,3575869317,3575869355,38
0,816,18511,3575869317,3575869357,40
0,816,18512,3575869317,3575869357,40
0,816,18513,3575869317,3575869358,41
0,816,18514,3575869317,3575869359,42
0,816,18515,3575869317,3575869359,42
0,816,18516,3575869317,3575869361,44
0,816,18517,3575869317,3575869361,44
0,816,18518,3575869317,3575869362,45
0,816,18519,3575869317,3575869364,47
0,816,18520,3575869317,3575869364,47
0,816,18521,3575869317,3575869365,48
0,816,18522,3575869317,3575869365,48
0,816,18523,3575869317,3575869366,49
0,816,18524,3575869317,3575869366,49
0,816,18525,3575869317,3575869367,50
0,817,18526,3575869376,3575869376,0
0,817,18527,3575869376,3575869376,0
0,817,18528,3575869376,3575869376,0
0,817,18529,3575869376,3575869376,0
0,817,18530,3575869376,3575869376,0
0,817,18531,3575869376,3575869376,0
0,817,18532,3575869376,3575869376,0
0,817,18533,3575869376,3575869376,0
0,817,18534,3575869376,3575869377,1
0,817,18535,3575869376,3575869377,1
0,817,18536,3575869376,3575869378,2
0,817,18537,3575869376,3575869378,2
0,817,18538,3575869376,3575869379,3
0,817,18539,3575869376,3575869380,4
0,817,18540,3575869376,3575869381,5
0,817,18541,3575869376,3575869382,6
0,817,18542,3575869376,3575869383,7
0,817,18543,3575869376,3575869387,11
0,817,18544,3575869376,3575869390,14
0,817,18545,3575869376,3575869395,19
0,817,18546,3575869376,3575869396,20
0,817,18547,3575869376,3575869400,24
0,817,18548,3575869376,3575869400,24
0,817,18549,3575869376,3575869402,26
0,817,18550,3575869376,3575869406,30
0,817,18551,3575869376,3575869407,31
0,817,18552,3575869376,3575869408,32
0,817,18553,3575869376,3575869409,33
0,817,18554,3575869376,3575869410,34
0,817,18555,3575869376,3575869413,37
0,817,18556,3575869376,3575869414,38
0,817,18557,3575869376,3575869415,39
0,817,18558,3575869376,3575869416,40
0,817,18559,3575869376,3575869418,42
0,817,18560,3575869376,3575869420,44
0,817,18561,3575869376,3575869420,44
0,817,18562,3575869376,3575869422,46
0,817,18563,3575869376,3575869423,47
0,817,18564,3575869376,3575869426,50
0,818,18565,3575869435,3575869435,0
0,818,18566,3575869435,3575869435,0
0,818,18567,3575869435,3575869435,0
0,818,18568,3575869435,3575869435,0
0,818,18569,3575869435,3575869435,0
0,818,18570,3575869435,3575869435,0
0,818,18571,3575869435,3575869435,0
0,818,18572,3575869435,3575869438,3
0,818,18573,3575869435,3575869442,7
0,818,18574,3575869435,3575869443,8
0,818,18575,3575869435,3575869445,10
0,818,18576,3575869435,3575869446,11
0,818,18577,3575869435,3575869446,11
0,818,18578,3575869435,3575869446,11
0,818,18579,3575869435,3575869449,14
0,818,18580,3575869435,3575869449,14
0,818,18581,3575869435,3575869450,15
0,818,18582,3575869435,3575869450,15
0,818,18583,3575869435,3575869451,16
0,818,18584,3575869435,3575869451,16
0,818,18585,3575869435,3575869452,17
0,818,18586,3575869435,3575869453,18
0,818,18587,3575869435,3575869456,21
0,818,18588,3575869435,3575869457,22
0,818,18589,3575869435,3575869459,24
0,818,18590,3575869435,3575869461,26
0,818,18591,3575869435,3575869462,27
0,818,18592,3575869435,3575869462,27
0,818,18593,3575869435,3575869465,30
0,818,18594,3575869435,3575869467,32
0,818,18595,3575869435,3575869468,33
0,818,18596,3575869435,3575869469,34
0,818,18597,3575869435,3575869469,34
0,818,18598,3575869435,3575869471,36
0,818,18599,3575869435,3575869472,37
0,818,18600,3575869435,3575869476,41
0,818,18601,3575869435,3575869480,45
0,818,18602,3575869435,3575869480,45
0,818,18603,3575869435,3575869482,47
0,818,18604,3575869435,3575869483,48
0,818,18605,3575869435,3575869485,50
0,819,18606,3575869494,3575869494,0
0,819,18607,3575869494,3575869494,0
0,819,18608,3575869494,3575869494,0
0,819,18609,3575869494,3575869494,0
0,819,18610,3575869494,3575869494,0
0,819,18611,3575869494,3575869494,0
0,819,18612,3575869494,3575869494,0
0,819,18613,3575869494,3575869494,0
0,819,18614,3575869494,3575869494,0
0,819,18615,3575869494,3575869495,1
0,819,18616,3575869494,3575869495,1
0,819,18617,3575869494,3575869495,1
0,819,18618,3575869494,3575869495,1
0,819,18619,3575869494,3575869495,1
0,819,18620,3575869494,3575869496,2
0,819,18621,3575869494,3575869496,2
0,819,18622,3575869494,3575869496,2
0,819,18623,3575869494,3575869497,3
0,819,18624,3575869494,3575869501,7
0,819,18625,3575869494,3575869501,7
0,819,18626,3575869494,3575869503,9
0,819,18627,3575869494,3575869505,11
0,819,18628,3575869494,3575869508,14
0,819,18629,3575869494,3575869508,14
0,819,18630,3575869494,3575869509,15
0,819,18631,3575869494,3575869511,17
0,819,18632,3575869494,3575869511,17
0,819,18633,3575869494,3575869511,17
0,819,18634,3575869494,3575869512,18
0,819,18635,3575869494,3575869513,19
0,819,18636,3575869494,3575869513,19
0,819,18637,3575869494,3575869514,20
0,819,18638,3575869494,3575869515,21
0,819,18639,3575869494,3575869515,21
0,819,18640,3575869494,3575869517,23
0,819,18641,3575869494,3575869519,25
0,819,18642,3575869494,3575869519,25
0,819,18643,3575869494,3575869520,26
0,819,18644,3575869494,3575869520,26
0,819,18645,3575869494,3575869521,27
0,819,18646,3575869494,3575869522,28
0,819,18647,3575869494,3575869524,30
0,819,18648,3575869494,3575869525,31
0,819,18649,3575869494,3575869525,31
0,819,18650,3575869494,3575869525,31
0,819,18651,3575869494,3575869526,32
0,819,18652,3575869494,3575869527,33
0,819,18653,3575869494,3575869527,33
0,819,18654,3575869494,3575869527,33
0,819,18655,3575869494,3575869530,36
0,819,18656,3575869494,3575869531,37
0,819,18657,3575869494,3575869532,38
0,819,18658,3575869494,3575869532,38
0,819,18659,3575869494,3575869533,39
0,819,18660,3575869494,3575869534,40
0,819,18661,3575869494,3575869535,41
0,819,18662,3575869494,3575869535,41
0,819,18663,3575869494,3575869536,42
0,819,18664,3575869494,3575869536,42
0,819,18665,3575869494,3575869539,45
0,819,18666,3575869494,3575869541,47
0,819,18667,3575869494,3575869541,47
0,819,18668,3575869494,3575869541,47
0,819,18669,3575869494,3575869543,49
0,820,18670,3575869551,3575869551,0
0,820,18671,3575869551,3575869551,0
0,820,18672,3575869551,3575869551,0
0,820,18673,3575869551,3575869551,0
0,820,18674,3575869551,3575869551,0
0,820,18675,3575869551,3575869551,0
0,820,18676,3575869551,3575869551,0
0,820,18677,3575869551,3575869551,0
0,820,18678,3575869551,3575869551,0
0,820,18679,3575869551,3575869551,0
0,820,18680,3575869551,3575869552,1
0,820,18681,3575869551,3575869554,3
0,820,18682,3575869551,3575869556,5
0,820,18683,3575869551,3575869557,6
0,820,18684,3575869551,3575869558,7
0,820,18685,3575869551,3575869558,7
0,820,18686,3575869551,3575869559,8
0,820,18687,3575869551,3575869560,9
0,820,18688,3575869551,3575869560,9
0,820,18689,3575869551,3575869561,10
0,820,18690,3575869551,3575869563,12
0,820,18691,3575869551,3575869564,13
0,820,18692,3575869551,3575869564,13
0,820,18693,3575869551,3575869564,13
0,820,18694,3575869551,3575869564,13
0,820,18695,3575869551,3575869565,14
0,820,18696,3575869551,3575869566,15
0,820,18697,3575869551,3575869570,19
0,820,18698,3575869551,3575869570,19
0,820,18699,3575869551,3575869571,20
0,820,18700,3575869551,3575869571,20
0,820,18701,3575869551,3575869571,20
0,820,18702,3575869551,3575869574,23
0,820,18703,3575869551,3575869575,24
0,820,18704,3575869551,3575869576,25
0,820,18705,3575869551,3575869576,25
0,820,18706,3575869551,3575869577,26
0,820,18707,3575869551,3575869577,26
0,820,18708,3575869551,3575869578,27
0,820,18709,3575869551,3575869578,27
0,820,18710,3575869551,3575869578,27
0,820,18711,3575869551,3575869580,29
0,820,18712,3575869551,3575869581,30
0,820,18713,3575869551,3575869586,35
0,820,18714,3575869551,3575869589,38
0,820,18715,3575869551,3575869590,39
0,820,18716,3575869551,3575869594,43
0,820,18717,3575869551,3575869595,44
0,820,18718,3575869551,3575869597,46
0,820,18719,3575869551,3575869599,48
0,820,18720,3575869551,3575869599,48
0,821,18721,3575869608,3575869608,0
0,821,18722,3575869608,3575869608,0
0,821,18723,3575869608,3575869608,0
0,821,18724,3575869608,3575869613,5
0,821,18725,3575869608,3575869613,5
0,821,18726,3575869608,3575869614,6
0,821,18727,3575869608,3575869615,7
0,821,18728,3575869608,3575869615,7
0,821,18729,3575869608,3575869616,8
0,821,18730,3575869608,3575869619,11
0,821,18731,3575869608,3575869620,12
0,821,18732,3575869608,3575869621,13
0,821,18733,3575869608,3575869621,13
0,821,18734,3575869608,3575869625,17
0,821,18735,3575869608,3575869626,18
0,821,18736,3575869608,3575869629,21
0,821,18737,3575869608,3575869629,21
0,821,18738,3575869608,3575869631,23
0,821,18739,3575869608,3575869631,23
0,821,18740,3575869608,3575869633,25
0,821,18741,3575869608,3575869637,29
0,821,18742,3575869608,3575869642,34
0,821,18743,3575869608,3575869642,34
0,821,18744,3575869608,3575869644,36
0,821,18745,3575869608,3575869645,37
0,821,18746,3575869608,3575869645,37
0,821,18747,3575869608,3575869646,38
0,821,18748,3575869608,3575869646,38
0,821,18749,3575869608,3575869647,39
0,821,18750,3575869608,3575869647,39
0,821,18751,3575869608,3575869648,40
0,821,18752,3575869608,3575869649,41
0,821,18753,3575869608,3575869651,43
0,821,18754,3575869608,3575869651,43
0,821,18755,3575869608,3575869655,47
0,821,18756,3575869608,3575869656,48
0,821,18757,3575869608,3575869658,50
0,822,18758,3575869666,3575869666,0
0,822,18759,3575869666,3575869666,0
0,822,18760,3575869666,3575869666,0
0,822,18761,3575869666,3575869666,0
0,822,18762,3575869666,3575869666,0
0,822,18763,3575869666,3575869666,0
0,822,18764,3575869666,3575869666,0
0,822,18765,3575869666,3575869668,2
0,822,18766,3575869666,3575869671,5
0,822,18767,3575869666,3575869680,14
0,822,18768,3575869666,3575869681,15
0,822,18769,3575869666,3575869681,15
0,822,18770,3575869666,3575869681,15
0,822,18771,3575869666,3575869682,16
0,822,18772,3575869666,3575869682,16
0,822,18773,3575869666,3575869684,18
0,822,18774,3575869666,3575869685,19
0,822,18775,3575869666,3575869687,21
0,822,18776,3575869666,3575869688,22
0,822,18777,3575869666,3575869690,24
0,822,18778,3575869666,3575869691,25
0,822,18779,3575869666,3575869691,25
0,822,18780,3575869666,3575869691,25
0,822,18781,3575869666,3575869691,25
0,822,18782,3575869666,3575869692,26
0,822,18783,3575869666,3575869693,27
0,822,18784,3575869666,3575869694,28
0,822,18785,3575869666,3575869695,29
0,822,18786,3575869666,3575869695,29
0,822,18787,3575869666,3575869695,29
0,822,18788,3575869666,3575869695,29
0,822,18789,3575869666,3575869695,29
0,822,18790,3575869666,3575869696,30
0,822,18791,3575869666,3575869696,30
0,822,18792,3575869666,3575869696,30
0,822,18793,3575869666,3575869697,31
0,822,18794,3575869666,3575869697,31
0,822,18795,3575869666,3575869698,32
0,822,18796,3575869666,3575869701,35
0,822,18797,3575869666,3575869701,35
0,822,18798,3575869666,3575869704,38
0,822,18799,3575869666,3575869704,38
0,822,18800,3575869666,3575869705,39
0,822,18801,3575869666,3575869708,42
0,822,18802,3575869666,3575869708,42
0,822,18803,3575869666,3575869710,44
0,822,18804,3575869666,3575869711,45
0,822,18805,3575869666,3575869711,45
0,822,18806,3575869666,3575869712,46
0,822,18807,3575869666,3575869712,46
0,822,18808,3575869666,3575869712,46
0,822,18809,3575869666,3575869713,47
0,822,18810,3575869666,3575869714,48
0,822,18811,3575869666,3575869714,48
0,822,18812,3575869666,3575869715,49
0,823,18813,3575869726,3575869726,0
0,823,18814,3575869726,3575869726,0
0,823,18815,3575869726,3575869726,0
0,823,18816,3575869726,3575869726,0
0,823,18817,3575869726,3575869726,0
0,823,18818,3575869726,3575869726,0
0,823,18819,3575869726,3575869726,0
0,823,18820,3575869726,3575869726,0
0,823,18821,3575869726,3575869726,0
0,823,18822,3575869726,3575869726,0
0,823,18823,3575869726,3575869726,0
0,823,18824,3575869726,3575869726,0
0,823,18825,3575869726,3575869726,0
0,823,18826,3575869726,3575869727,1
0,823,18827,3575869726,3575869727,1
0,823,18828,3575869726,3575869727,1
0,823,18829,3575869726,3575869730,4
0,823,18830,3575869726,3575869732,6
0,823,18831,3575869726,3575869732,6
0,823,18832,3575869726,3575869733,7
0,823,18833,3575869726,3575869733,7
0,823,18834,3575869726,3575869733,7
0,823,18835,3575869726,3575869734,8
0,823,18836,3575869726,3575869735,9
0,823,18837,3575869726,3575869736,10
0,823,18838,3575869726,3575869736,10
0,823,18839,3575869726,3575869738,12
0,823,18840,3575869726,3575869738,12
0,823,18841,3575869726,3575869739,13
0,823,18842,3575869726,3575869741,15
0,823,18843,3575869726,3575869741,15
0,823,18844,3575869726,3575869741,15
0,823,18845,3575869726,3575869742,16
0,823,18846,3575869726,3575869742,16
0,823,18847,3575869726,3575869744,18
0,823,18848,3575869726,3575869744,18
0,823,18849,3575869726,3575869746,20
0,823,18850,3575869726,3575869747,21
0,823,18851,3575869726,3575869748,22
0,823,18852,3575869726,3575869749,23
0,823,18853,3575869726,3575869750,24
0,823,18854,3575869726,3575869750,24
0,823,18855,3575869726,3575869752,26
0,823,18856,3575869726,3575869752,26
0,823,18857,3575869726,3575869752,26
0,823,18858,3575869726,3575869754,28
0,823,18859,3575869726,3575869754,28
0,823,18860,3575869726,3575869756,30
0,823,18861,3575869726,3575869757,31
0,823,18862,3575869726,3575869758,32
0,823,18863,3575869726,3575869759,33
0,823,18864,3575869726,3575869760,34
0,823,18865,3575869726,3575869762,36
0,823,18866,3575869726,3575869763,37
0,823,18867,3575869726,3575869764,38
0,823,18868,3575869726,3575869764,38
0,823,18869,3575869726,3575869764,38
0,823,18870,3575869726,3575869764,38
0,823,18871,3575869726,3575869765,39
0,823,18872,3575869726,3575869765,39
0,823,18873,3575869726,3575869766,40
0,823,18874,3575869726,3575869768,42
0,823,18875,3575869726,3575869770,44
0,823,18876,3575869726,3575869771,45
0,823,18877,3575869726,3575869771,45
0,823,18878,3575869726,3575869771,45
0,823,18879,3575869726,3575869771,45
0,823,18880,3575869726,3575869774,48
0,823,18881,3575869726,3575869775,49
0,823,18882,3575869726,3575869775,49
0,823,18883,3575869726,3575869776,50
0,824,18884,3575869786,3575869786,0
0,824,18885,3575869786,3575869786,0
0,824,18886,3575869786,3575869786,0
0,824,18887,3575869786,3575869786,0
0,824,18888,3575869786,3575869786,0
0,824,18889,3575869786,3575869786,0
0,824,18890,3575869786,3575869786,0
0,824,18891,3575869786,3575869786,0
0,824,18892,3575869786,3575869786,0
0,824,18893,3575869786,3575869789,3
0,824,18894,3575869786,3575869789,3
0,824,18895,3575869786,3575869795,9
0,824,18896,3575869786,3575869798,12
0,824,18897,3575869786,3575869798,12
0,824,18898,3575869786,3575869799,13
0,824,18899,3575869786,3575869805,19
0,824,18900,3575869786,3575869807,21
0,824,18901,3575869786,3575869807,21
0,824,18902,3575869786,3575869808,22
0,824,18903,3575869786,3575869813,27
0,824,18904,3575869786,3575869814,28
0,824,18905,3575869786,3575869814,28
0,824,18906,3575869786,3575869815,29
0,824,18907,3575869786,3575869817,31
0,824,18908,3575869786,3575869819,33
0,824,18909,3575869786,3575869820,34
0,824,18910,3575869786,3575869821,35
0,824,18911,3575869786,3575869823,37
0,824,18912,3575869786,3575869825,39
0,824,18913,3575869786,3575869827,41
0,824,18914,3575869786,3575869829,43
0,824,18915,3575869786,3575869830,44
0,824,18916,3575869786,3575869831,45
0,824,18917,3575869786,3575869832,46
0,824,18918,3575869786,3575869833,47
0,824,18919,3575869786,3575869833,47
0,825,18920,3575869844,3575869844,0
0,825,18921,3575869844,3575869844,0
0,825,18922,3575869844,3575869844,0
0,825,18923,3575869844,3575869845,1
0,825,18924,3575869844,3575869845,1
0,825,18925,3575869844,3575869845,1
0,825,18926,3575869844,3575869846,2
0,825,18927,3575869844,3575869847,3
0,825,18928,3575869844,3575869847,3
0,825,18929,3575869844,3575869848,4
0,825,18930,3575869844,3575869849,5
0,825,18931,3575869844,3575869850,6
0,825,18932,3575869844,3575869850,6
0,825,18933,3575869844,3575869851,7
0,825,18934,3575869844,3575869853,9
0,825,18935,3575869844,3575869855,11
0,825,18936,3575869844,3575869856,12
0,825,18937,3575869844,3575869858,14
0,825,18938,3575869844,3575869859,15
0,825,18939,3575869844,3575869862,18
0,825,18940,3575869844,3575869863,19
0,825,18941,3575869844,3575869863,19
0,825,18942,3575869844,3575869865,21
0,825,18943,3575869844,3575869866,22
0,825,18944,3575869844,3575869866,22
0,825,18945,3575869844,3575869868,24
0,825,18946,3575869844,3575869869,25
0,825,18947,3575869844,3575869870,26
0,825,18948,3575869844,3575869870,26
0,825,18949,3575869844,3575869871,27
0,825,18950,3575869844,3575869877,33
0,825,18951,3575869844,3575869880,36
0,825,18952,3575869844,3575869882,38
0,825,18953,3575869844,3575869882,38
0,825,18954,3575869844,3575869883,39
0,825,18955,3575869844,3575869885,41
0,825,18956,3575869844,3575869888,44
0,825,18957,3575869844,3575869888,44
0,825,18958,3575869844,3575869890,46
0,825,18959,3575869844,3575869891,47
0,825,18960,3575869844,3575869891,47
0,825,18961,3575869844,3575869891,47
0,825,18962,3575869844,3575869892,48
0,825,18963,3575869844,3575869893,49
0,825,18964,3575869844,3575869893,49
0,826,18965,3575869904,3575869904,0
0,826,18966,3575869904,3575869904,0
0,826,18967,3575869904,3575869904,0
0,826,18968,3575869904,3575869904,0
0,826,18969,3575869904,3575869904,0
0,826,18970,3575869904,3575869904,0
0,826,18971,3575869904,3575869904,0
0,826,18972,3575869904,3575869904,0
0,826,18973,3575869904,3575869904,0
0,826,18974,3575869904,3575869904,0
0,826,18975,3575869904,3575869904,0
0,826,18976,3575869904,3575869905,1
0,826,18977,3575869904,3575869908,4
0,826,18978,3575869904,3575869909,5
0,826,18979,3575869904,3575869910,6
0,826,18980,3575869904,3575869911,7
0,826,18981,3575869904,3575869912,8
0,826,18982,3575869904,3575869912,8
0,826,18983,3575869904,3575869912,8
0,826,18984,3575869904,3575869912,8
0,826,18985,3575869904,3575869913,9
0,826,18986,3575869904,3575869914,10
0,826,18987,3575869904,3575869914,10
0,826,18988,3575869904,3575869914,10
0,826,18989,3575869904,3575869915,11
0,826,18990,3575869904,3575869919,15
0,826,18991,3575869904,3575869920,16
0,826,18992,3575869904,3575869920,16
0,826,18993,3575869904,3575869920,16
0,826,18994,3575869904,3575869920,16
0,826,18995,3575869904,3575869921,17
0,826,18996,3575869904,3575869923,19
0,826,18997,3575869904,3575869923,19
0,826,18998,3575869904,3575869923,19
0,826,18999,3575869904,3575869925,21
0,826,19000,3575869904,3575869925,21
0,826,19001,3575869904,3575869925,21
0,826,19002,3575869904,3575869926,22
0,826,19003,3575869904,3575869927,23
0,826,19004,3575869904,3575869927,23
0,826,19005,3575869904,3575869927,23
0,826,19006,3575869904,3575869928,24
0,826,19007,3575869904,3575869928,24
0,826,19008,3575869904,3575869931,27
0,826,19009,3575869904,3575869932,28
0,826,19010,3575869904,3575869932,28
0,826,19011,3575869904,3575869934,30
0,826,19012,3575869904,3575869934,30
0,826,19013,3575869904,3575869935,31
0,826,19014,3575869904,3575869935,31
0,826,19015,3575869904,3575869936,32
0,826,19016,3575869904,3575869938,34
0,826,19017,3575869904,3575869938,34
0,826,19018,3575869904,3575869939,35
0,826,19019,3575869904,3575869941,37
0,826,19020,3575869904,3575869941,37
0,826,19021,3575869904,3575869941,37
0,826,19022,3575869904,3575869943,39
0,826,19023,3575869904,3575869943,39
0,826,19024,3575869904,3575869944,40
0,826,19025,3575869904,3575869945,41
0,826,19026,3575869904,3575869945,41
0,826,19027,3575869904,3575869947,43
0,826,19028,3575869904,3575869948,44
0,826,19029,3575869904,3575869948,44
0,826,19030,3575869904,3575869950,46
0,826,19031,3575869904,3575869951,47
0,826,19032,3575869904,3575869951,47
0,826,19033,3575869904,3575869952,48
0,826,19034,3575869904,3575869952,48
0,826,19035,3575869904,3575869954,50
0,827,19036,3575869962,3575869962,0
0,827,19037,3575869962,3575869962,0
0,827,19038,3575869962,3575869962,0
0,827,19039,3575869962,3575869962,0
0,827,19040,3575869962,3575869962,0
0,827,19041,3575869962,3575869962,0
0,827,19042,3575869962,3575869962,0
0,827,19043,3575869962,3575869963,1
0,827,19044,3575869962,3575869964,2
0,827,19045,3575869962,3575869964,2
0,827,19046,3575869962,3575869964,2
0,827,19047,3575869962,3575869965,3
0,827,19048,3575869962,3575869965,3
0,827,19049,3575869962,3575869966,4
0,827,19050,3575869962,3575869970,8
0,827,19051,3575869962,3575869971,9
0,827,19052,3575869962,3575869971,9
0,827,19053,3575869962,3575869971,9
0,827,19054,3575869962,3575869972,10
0,827,19055,3575869962,3575869973,11
0,827,19056,3575869962,3575869975,13
0,827,19057,3575869962,3575869975,13
0,827,19058,3575869962,3575869976,14
0,827,19059,3575869962,3575869976,14
0,827,19060,3575869962,3575869977,15
0,827,19061,3575869962,3575869978,16
0,827,19062,3575869962,3575869978,16
0,827,19063,3575869962,3575869979,17
0,827,19064,3575869962,3575869980,18
0,827,19065,3575869962,3575869981,19
0,827,19066,3575869962,3575869982,20
0,827,19067,3575869962,3575869987,25
0,827,19068,3575869962,3575869989,27
0,827,19069,3575869962,3575869990,28
0,827,19070,3575869962,3575869994,32
0,827,19071,3575869962,3575869995,33
0,827,19072,3575869962,3575869999,37
0,827,19073,3575869962,3575869999,37
0,827,19074,3575869962,3575869999,37
0,827,19075,3575869962,3575870002,40
0,827,19076,3575869962,3575870005,43
0,827,19077,3575869962,3575870007,45
0,827,19078,3575869962,3575870007,45
0,828,19079,3575870020,3575870020,0
0,828,19080,3575870020,3575870020,0
0,828,19081,3575870020,3575870020,0
0,828,19082,3575870020,3575870020,0
0,828,19083,3575870020,3575870020,0
0,828,19084,3575870020,3575870020,0
0,828,19085,3575870020,3575870020,0
0,828,19086,3575870020,3575870020,0
0,828,19087,3575870020,3575870021,1
0,828,19088,3575870020,3575870022,2
0,828,19089,3575870020,3575870024,4
0,828,19090,3575870020,3575870024,4
0,828,19091,3575870020,3575870025,5
0,828,19092,3575870020,3575870027,7
0,828,19093,3575870020,3575870029,9
0,828,19094,3575870020,3575870030,10
0,828,19095,3575870020,3575870032,12
0,828,19096,3575870020,3575870039,19
0,828,19097,3575870020,3575870041,21
0,828,19098,3575870020,3575870042,22
0,828,19099,3575870020,3575870045,25
0,828,19100,3575870020,3575870046,26
0,828,19101,3575870020,3575870047,27
0,828,19102,3575870020,3575870047,27
0,828,19103,3575870020,3575870048,28
0,828,19104,3575870020,3575870049,29
0,828,19105,3575870020,3575870050,30
0,828,19106,3575870020,3575870051,31
0,828,19107,3575870020,3575870053,33
0,828,19108,3575870020,3575870055,35
0,828,19109,3575870020,3575870056,36
0,828,19110,3575870020,3575870058,38
0,828,19111,3575870020,3575870059,39
0,828,19112,3575870020,3575870062,42
0,828,19113,3575870020,3575870062,42
0,828,19114,3575870020,3575870064,44
0,828,19115,3575870020,3575870066,46
0,828,19116,3575870020,3575870066,46
0,828,19117,3575870020,3575870066,46
0,828,19118,3575870020,3575870068,48
0,828,19119,3575870020,3575870068,48
0,829,19120,3575870078,3575870078,0
0,829,19121,3575870078,3575870078,0
0,829,19122,3575870078,3575870078,0
0,829,19123,3575870078,3575870081,3
0,829,19124,3575870078,3575870081,3
0,829,19125,3575870078,3575870081,3
0,829,19126,3575870078,3575870081,3
0,829,19127,3575870078,3575870082,4
0,829,19128,3575870078,3575870082,4
0,829,19129,3575870078,3575870083,5
0,829,19130,3575870078,3575870088,10
0,829,19131,3575870078,3575870088,10
0,829,19132,3575870078,3575870089,11
0,829,19133,3575870078,3575870091,13
0,829,19134,3575870078,3575870092,14
0,829,19135,3575870078,3575870092,14
0,829,19136,3575870078,3575870092,14
0,829,19137,3575870078,3575870092,14
0,829,19138,3575870078,3575870093,15
0,829,19139,3575870078,3575870093,15
0,829,19140,3575870078,3575870093,15
0,829,19141,3575870078,3575870095,17
0,829,19142,3575870078,3575870095,17
0,829,19143,3575870078,3575870095,17
0,829,19144,3575870078,3575870095,17
0,829,19145,3575870078,3575870095,17
0,829,19146,3575870078,3575870095,17
0,829,19147,3575870078,3575870096,18
0,829,19148,3575870078,3575870097,19
0,829,19149,3575870078,3575870097,19
0,829,19150,3575870078,3575870099,21
0,829,19151,3575870078,3575870101,23
0,829,19152,3575870078,3575870102,24
0,829,19153,3575870078,3575870103,25
0,829,19154,3575870078,3575870105,27
0,829,19155,3575870078,3575870105,27
0,829,19156,3575870078,3575870109,31
0,829,19157,3575870078,3575870109,31
0,829,19158,3575870078,3575870110,32
0,829,19159,3575870078,3575870111,33
0,829,19160,3575870078,3575870111,33
0,829,19161,3575870078,3575870112,34
0,829,19162,3575870078,3575870112,34
0,829,19163,3575870078,3575870112,34
0,829,19164,3575870078,3575870113,35
0,829,19165,3575870078,3575870113,35
0,829,19166,3575870078,3575870114,36
0,829,19167,3575870078,3575870114,36
0,829,19168,3575870078,3575870115,37
0,829,19169,3575870078,3575870119,41
0,829,19170,3575870078,3575870120,42
0,829,19171,3575870078,3575870120,42
0,829,19172,3575870078,3575870120,42
0,829,19173,3575870078,3575870120,42
0,829,19174,3575870078,3575870122,44
0,829,19175,3575870078,3575870123,45
0,829,19176,3575870078,3575870123,45
0,829,19177,3575870078,3575870123,45
0,829,19178,3575870078,3575870124,46
0,829,19179,3575870078,3575870125,47
0,829,19180,3575870078,3575870125,47
0,829,19181,3575870078,3575870126,48
0,829,19182,3575870078,3575870126,48
0,829,19183,3575870078,3575870126,48
0,829,19184,3575870078,3575870126,48
0,829,19185,3575870078,3575870127,49
0,829,19186,3575870078,3575870128,50
0,830,19187,3575870136,3575870136,0
0,830,19188,3575870136,3575870136,0
0,830,19189,3575870136,3575870136,0
0,830,19190,3575870136,3575870136,0
0,830,19191,3575870136,3575870136,0
0,830,19192,3575870136,3575870136,0
0,830,19193,3575870136,3575870136,0
0,830,19194,3575870136,3575870136,0
0,830,19195,3575870136,3575870136,0
0,830,19196,3575870136,3575870137,1
0,830,19197,3575870136,3575870138,2
0,830,19198,3575870136,3575870138,2
0,830,19199,3575870136,3575870141,5
0,830,19200,3575870136,3575870141,5
0,830,19201,3575870136,3575870141,5
0,830,19202,3575870136,3575870142,6
0,830,19203,3575870136,3575870143,7
0,830,19204,3575870136,3575870145,9
0,830,19205,3575870136,3575870146,10
0,830,19206,3575870136,3575870146,10
0,830,19207,3575870136,3575870147,11
0,830,19208,3575870136,3575870148,12
0,830,19209,3575870136,3575870148,12
0,830,19210,3575870136,3575870149,13
0,830,19211,3575870136,3575870152,16
0,830,19212,3575870136,3575870152,16
0,830,19213,3575870136,3575870152,16
0,830,19214,3575870136,3575870152,16
0,830,19215,3575870136,3575870154,18
0,830,19216,3575870136,3575870155,19
0,830,19217,3575870136,3575870156,20
0,830,19218,3575870136,3575870158,22
0,830,19219,3575870136,3575870158,22
0,830,19220,3575870136,3575870160,24
0,830,19221,3575870136,3575870160,24
0,830,19222,3575870136,3575870160,24
0,830,19223,3575870136,3575870163,27
0,830,19224,3575870136,3575870164,28
0,830,19225,3575870136,3575870164,28
0,830,19226,3575870136,3575870164,28
0,830,19227,3575870136,3575870164,28
0,830,19228,3575870136,3575870165,29
0,830,19229,3575870136,3575870166,30
0,830,19230,3575870136,3575870166,30
0,830,19231,3575870136,3575870170,34
0,830,19232,3575870136,3575870170,34
0,830,19233,3575870136,3575870171,35
0,830,19234,3575870136,3575870172,36
0,830,19235,3575870136,3575870173,37
0,830,19236,3575870136,3575870175,39
0,830,19237,3575870136,3575870176,40
0,830,19238,3575870136,3575870176,40
0,830,19239,3575870136,3575870176,40
0,830,19240,3575870136,3575870177,41
0,830,19241,3575870136,3575870178,42
0,830,19242,3575870136,3575870178,42
0,830,19243,3575870136,3575870180,44
0,830,19244,3575870136,3575870181,45
0,830,19245,3575870136,3575870183,47
0,830,19246,3575870136,3575870183,47
0,831,19247,3575870198,3575870198,0
0,831,19248,3575870198,3575870198,0
0,831,19249,3575870198,3575870198,0
0,831,19250,3575870198,3575870198,0
0,831,19251,3575870198,3575870199,1
0,831,19252,3575870198,3575870199,1
0,831,19253,3575870198,3575870203,5
0,831,19254,3575870198,3575870205,7
0,831,19255,3575870198,3575870207,9
0,831,19256,3575870198,3575870207,9
0,831,19257,3575870198,3575870207,9
0,831,19258,3575870198,3575870209,11
0,831,19259,3575870198,3575870213,15
0,831,19260,3575870198,3575870213,15
0,831,19261,3575870198,3575870215,17
0,831,19262,3575870198,3575870215,17
0,831,19263,3575870198,3575870216,18
0,831,19264,3575870198,3575870218,20
0,831,19265,3575870198,3575870219,21
0,831,19266,3575870198,3575870220,22
0,831,19267,3575870198,3575870221,23
0,831,19268,3575870198,3575870222,24
0,831,19269,3575870198,3575870224,26
0,831,19270,3575870198,3575870226,28
0,831,19271,3575870198,3575870228,30
0,831,19272,3575870198,3575870229,31
0,831,19273,3575870198,3575870230,32
0,831,19274,3575870198,3575870232,34
0,831,19275,3575870198,3575870233,35
0,831,19276,3575870198,3575870234,36
0,831,19277,3575870198,3575870234,36
0,831,19278,3575870198,3575870238,40
0,831,19279,3575870198,3575870242,44
0,831,19280,3575870198,3575870242,44
0,831,19281,3575870198,3575870245,47
0,831,19282,3575870198,3575870246,48
0,831,19283,3575870198,3575870246,48
0,831,19284,3575870198,3575870247,49
0,831,19285,3575870198,3575870248,50
0,832,19286,3575870255,3575870255,0
0,832,19287,3575870255,3575870255,0
0,832,19288,3575870255,3575870255,0
0,832,19289,3575870255,3575870255,0
0,832,19290,3575870255,3575870255,0
0,832,19291,3575870255,3575870255,0
0,832,19292,3575870255,3575870255,0
0,832,19293,3575870255,3575870255,0
0,832,19294,3575870255,3575870256,1
0,832,19295,3575870255,3575870258,3
0,832,19296,3575870255,3575870259,4
0,832,19297,3575870255,3575870262,7
0,832,19298,3575870255,3575870264,9
0,832,19299,3575870255,3575870266,11
0,832,19300,3575870255,3575870266,11
0,832,19301,3575870255,3575870267,12
0,832,19302,3575870255,3575870268,13
0,832,19303,3575870255,3575870269,14
0,832,19304,3575870255,3575870270,15
0,832,19305,3575870255,3575870271,16
0,832,19306,3575870255,3575870273,18
0,832,19307,3575870255,3575870279,24
0,832,19308,3575870255,3575870280,25
0,832,19309,3575870255,3575870280,25
0,832,19310,3575870255,3575870281,26
0,832,19311,3575870255,3575870281,26
0,832,19312,3575870255,3575870282,27
0,832,19313,3575870255,3575870283,28
0,832,19314,3575870255,3575870288,33
0,832,19315,3575870255,3575870289,34
0,832,19316,3575870255,3575870290,35
0,832,19317,3575870255,3575870292,37
0,832,19318,3575870255,3575870292,37
0,832,19319,3575870255,3575870292,37
0,832,19320,3575870255,3575870293,38
0,832,19321,3575870255,3575870293,38
0,832,19322,3575870255,3575870294,39
0,832,19323,3575870255,3575870295,40
0,832,19324,3575870255,3575870295,40
0,832,19325,3575870255,3575870295,40
0,832,19326,3575870255,3575870295,40
0,832,19327,3575870255,3575870295,40
0,832,19328,3575870255,3575870296,41
0,832,19329,3575870255,3575870296,41
0,832,19330,3575870255,3575870298,43
0,832,19331,3575870255,3575870298,43
0,832,19332,3575870255,3575870301,46
0,832,19333,3575870255,3575870302,47
0,832,19334,3575870255,3575870303,48
0,833,19335,3575870317,3575870317,0
0,833,19336,3575870317,3575870317,0
0,833,19337,3575870317,3575870317,0
0,833,19338,3575870317,3575870317,0
0,833,19339,3575870317,3575870317,0
0,833,19340,3575870317,3575870317,0
0,833,19341,3575870317,3575870317,0
0,833,19342,3575870317,3575870317,0
0,833,19343,3575870317,3575870317,0
0,833,19344,3575870317,3575870317,0
0,833,19345,3575870317,3575870317,0
0,833,19346,3575870317,3575870317,0
0,833,19347,3575870317,3575870317,0
0,833,19348,3575870317,3575870317,0
0,833,19349,3575870317,3575870320,3
0,833,19350,3575870317,3575870321,4
0,833,19351,3575870317,3575870322,5
0,833,19352,3575870317,3575870323,6
0,833,19353,3575870317,3575870323,6
0,833,19354,3575870317,3575870324,7
0,833,19355,3575870317,3575870326,9
0,833,19356,3575870317,3575870326,9
0,833,19357,3575870317,3575870327,10
0,833,19358,3575870317,3575870328,11
0,833,19359,3575870317,3575870328,11
0,833,19360,3575870317,3575870328,11
0,833,19361,3575870317,3575870332,15
0,833,19362,3575870317,3575870333,16
0,833,19363,3575870317,3575870333,16
0,833,19364,3575870317,3575870334,17
0,833,19365,3575870317,3575870335,18
0,833,19366,3575870317,3575870335,18
0,833,19367,3575870317,3575870336,19
0,833,19368,3575870317,3575870336,19
0,833,19369,3575870317,3575870336,19
0,833,19370,3575870317,3575870337,20
0,833,19371,3575870317,3575870338,21
0,833,19372,3575870317,3575870338,21
0,833,19373,3575870317,3575870341,24
0,833,19374,3575870317,3575870341,24
0,833,19375,3575870317,3575870342,25
0,833,19376,3575870317,3575870343,26
0,833,19377,3575870317,3575870346,29
0,833,19378,3575870317,3575870346,29
0,833,19379,3575870317,3575870348,31
0,833,19380,3575870317,3575870348,31
0,833,19381,3575870317,3575870349,32
0,833,19382,3575870317,3575870351,34
0,833,19383,3575870317,3575870352,35
0,833,19384,3575870317,3575870352,35
0,833,19385,3575870317,3575870353,36
0,833,19386,3575870317,3575870354,37
0,833,19387,3575870317,3575870355,38
0,833,19388,3575870317,3575870356,39
0,833,19389,3575870317,3575870358,41
0,833,19390,3575870317,3575870358,41
0,833,19391,3575870317,3575870360,43
0,833,19392,3575870317,3575870361,44
0,833,19393,3575870317,3575870363,46
0,833,19394,3575870317,3575870364,47
0,833,19395,3575870317,3575870364,47
0,833,19396,3575870317,3575870365,48
0,833,19397,3575870317,3575870366,49
0,834,19398,3575870374,3575870374,0
0,834,19399,3575870374,3575870374,0
0,834,19400,3575870374,3575870374,0
0,834,19401,3575870374,3575870375,1
0,834,19402,3575870374,3575870375,1
0,834,19403,3575870374,3575870376,2
0,834,19404,3575870374,3575870376,2
0,834,19405,3575870374,3575870378,4
0,834,19406,3575870374,3575870378,4
0,834,19407,3575870374,3575870378,4
0,834,19408,3575870374,3575870378,4
0,834,19409,3575870374,3575870379,5
0,834,19410,3575870374,3575870381,7
0,834,19411,3575870374,3575870382,8
0,834,19412,3575870374,3575870382,8
0,834,19413,3575870374,3575870383,9
0,834,19414,3575870374,3575870388,14
0,834,19415,3575870374,3575870390,16
0,834,19416,3575870374,3575870391,17
0,834,19417,3575870374,3575870394,20
0,834,19418,3575870374,3575870395,21
0,834,19419,3575870374,3575870399,25
0,834,19420,3575870374,3575870400,26
0,834,19421,3575870374,3575870403,29
0,834,19422,3575870374,3575870405,31
0,834,19423,3575870374,3575870407,33
0,834,19424,3575870374,3575870407,33
0,834,19425,3575870374,3575870408,34
0,834,19426,3575870374,3575870408,34
0,834,19427,3575870374,3575870412,38
0,834,19428,3575870374,3575870413,39
0,834,19429,3575870374,3575870415,41
0,834,19430,3575870374,3575870415,41
0,834,19431,3575870374,3575870416,42
0,834,19432,3575870374,3575870418,44
0,834,19433,3575870374,3575870419,45
0,834,19434,3575870374,3575870420,46
0,834,19435,3575870374,3575870421,47
0,834,19436,3575870374,3575870422,48
0,834,19437,3575870374,3575870424,50
0,835,19438,3575870434,3575870434,0
0,835,19439,3575870434,3575870434,0
0,835,19440,3575870434,3575870434,0
0,835,19441,3575870434,3575870434,0
0,835,19442,3575870434,3575870434,0
0,835,19443,3575870434,3575870435,1
0,835,19444,3575870434,3575870435,1
0,835,19445,3575870434,3575870435,1
0,835,19446,3575870434,3575870435,1
0,835,19447,3575870434,3575870439,5
0,835,19448,3575870434,3575870443,9
0,835,19449,3575870434,3575870445,11
0,835,19450,3575870434,3575870447,13
0,835,19451,3575870434,3575870447,13
0,835,19452,3575870434,3575870448,14
0,835,19453,3575870434,3575870448,14
0,835,19454,3575870434,3575870449,15
0,835,19455,3575870434,3575870451,17
0,835,19456,3575870434,3575870452,18
0,835,19457,3575870434,3575870454,20
0,835,19458,3575870434,3575870454,20
0,835,19459,3575870434,3575870455,21
0,835,19460,3575870434,3575870456,22
0,835,19461,3575870434,3575870458,24
0,835,19462,3575870434,3575870459,25
0,835,19463,3575870434,3575870462,28
0,835,19464,3575870434,3575870463,29
0,835,19465,3575870434,3575870466,32
0,835,19466,3575870434,3575870466,32
0,835,19467,3575870434,3575870467,33
0,835,19468,3575870434,3575870469,35
0,835,19469,3575870434,3575870469,35
0,835,19470,3575870434,3575870472,38
0,835,19471,3575870434,3575870480,46
0,835,19472,3575870434,3575870481,47
0,835,19473,3575870434,3575870481,47
0,835,19474,3575870434,3575870482,48
0,835,19475,3575870434,3575870482,48
0,835,19476,3575870434,3575870483,49
0,835,19477,3575870434,3575870484,50
0,836,19478,3575870494,3575870494,0
0,836,19479,3575870494,3575870494,0
0,836,19480,3575870494,3575870494,0
0,836,19481,3575870494,3575870494,0
0,836,19482,3575870494,3575870494,0
0,836,19483,3575870494,3575870494,0
0,836,19484,3575870494,3575870494,0
0,836,19485,3575870494,3575870494,0
0,836,19486,3575870494,3575870494,0
0,836,19487,3575870494,3575870494,0
0,836,19488,3575870494,3575870494,0
0,836,19489,3575870494,3575870494,0
0,836,19490,3575870494,3575870494,0
0,836,19491,3575870494,3575870494,0
0,836,19492,3575870494,3575870495,1
0,836,19493,3575870494,3575870495,1
0,836,19494,3575870494,3575870495,1
0,836,19495,3575870494,3575870496,2
0,836,19496,3575870494,3575870496,2
0,836,19497,3575870494,3575870497,3
0,836,19498,3575870494,3575870497,3
0,836,19499,3575870494,3575870498,4
0,836,19500,3575870494,3575870500,6
0,836,19501,3575870494,3575870502,8
0,836,19502,3575870494,3575870503,9
0,836,19503,3575870494,3575870504,10
0,836,19504,3575870494,3575870505,11
0,836,19505,3575870494,3575870510,16
0,836,19506,3575870494,3575870510,16
0,836,19507,3575870494,3575870511,17
0,836,19508,3575870494,3575870511,17
0,836,19509,3575870494,3575870512,18
0,836,19510,3575870494,3575870513,19
0,836,19511,3575870494,3575870514,20
0,836,19512,3575870494,3575870514,20
0,836,19513,3575870494,3575870519,25
0,836,19514,3575870494,3575870519,25
0,836,19515,3575870494,3575870519,25
0,836,19516,3575870494,3575870519,25
0,836,19517,3575870494,3575870520,26
0,836,19518,3575870494,3575870522,28
0,836,19519,3575870494,3575870522,28
0,836,19520,3575870494,3575870522,28
0,836,19521,3575870494,3575870523,29
0,836,19522,3575870494,3575870525,31
0,836,19523,3575870494,3575870525,31
0,836,19524,3575870494,3575870525,31
0,836,19525,3575870494,3575870526,32
0,836,19526,3575870494,3575870526,32
0,836,19527,3575870494,3575870526,32
0,836,19528,3575870494,3575870526,32
0,836,19529,3575870494,3575870527,33
0,836,19530,3575870494,3575870527,33
0,836,19531,3575870494,3575870532,38
0,836,19532,3575870494,3575870532,38
0,836,19533,3575870494,3575870532,38
0,836,19534,3575870494,3575870532,38
0,836,19535,3575870494,3575870533,39
0,836,19536,3575870494,3575870533,39
0,836,19537,3575870494,3575870534,40
0,836,19538,3575870494,3575870535,41
0,836,19539,3575870494,3575870535,41
0,836,19540,3575870494,3575870535,41
0,836,19541,3575870494,3575870536,42
0,836,19542,3575870494,3575870538,44
0,836,19543,3575870494,3575870538,44
0,836,19544,3575870494,3575870540,46
0,836,19545,3575870494,3575870540,46
0,836,19546,3575870494,3575870541,47
0,836,19547,3575870494,3575870543,49
0,837,19548,3575870553,3575870553,0
0,837,19549,3575870553,3575870553,0
0,837,19550,3575870553,3575870553,0
0,837,19551,3575870553,3575870553,0
0,837,19552,3575870553,3575870553,0
0,837,19553,3575870553,3575870553,0
0,837,19554,3575870553,3575870553,0
0,837,19555,3575870553,3575870553,0
0,837,19556,3575870553,3575870553,0
0,837,19557,3575870553,3575870553,0
0,837,19558,3575870553,3575870554,1
0,837,19559,3575870553,3575870554,1
0,837,19560,3575870553,3575870555,2
0,837,19561,3575870553,3575870557,4
0,837,19562,3575870553,3575870557,4
0,837,19563,3575870553,3575870559,6
0,837,19564,3575870553,3575870561,8
0,837,19565,3575870553,3575870561,8
0,837,19566,3575870553,3575870562,9
0,837,19567,3575870553,3575870563,10
0,837,19568,3575870553,3575870563,10
0,837,19569,3575870553,3575870563,10
0,837,19570,3575870553,3575870564,11
0,837,19571,3575870553,3575870565,12
0,837,19572,3575870553,3575870566,13
0,837,19573,3575870553,3575870566,13
0,837,19574,3575870553,3575870569,16
0,837,19575,3575870553,3575870570,17
0,837,19576,3575870553,3575870571,18
0,837,19577,3575870553,3575870575,22
0,837,19578,3575870553,3575870575,22
0,837,19579,3575870553,3575870577,24
0,837,19580,3575870553,3575870577,24
0,837,19581,3575870553,3575870578,25
0,837,19582,3575870553,3575870578,25
0,837,19583,3575870553,3575870578,25
0,837,19584,3575870553,3575870579,26
0,837,19585,3575870553,3575870581,28
0,837,19586,3575870553,3575870581,28
0,837,19587,3575870553,3575870582,29
0,837,19588,3575870553,3575870586,33
0,837,19589,3575870553,3575870587,34
0,837,19590,3575870553,3575870589,36
0,837,19591,3575870553,3575870589,36
0,837,19592,3575870553,3575870594,41
0,837,19593,3575870553,3575870598,45
0,837,19594,3575870553,3575870600,47
0,837,19595,3575870553,3575870602,49
0,838,19596,3575870610,3575870610,0
0,838,19597,3575870610,3575870610,0
0,838,19598,3575870610,3575870610,0
0,838,19599,3575870610,3575870610,0
0,838,19600,3575870610,3575870611,1
0,838,19601,3575870610,3575870614,4
0,838,19602,3575870610,3575870616,6
0,838,19603,3575870610,3575870617,7
0,838,19604,3575870610,3575870618,8
0,838,19605,3575870610,3575870620,10
0,838,19606,3575870610,3575870621,11
0,838,19607,3575870610,3575870622,12
0,838,19608,3575870610,3575870624,14
0,838,19609,3575870610,3575870627,17
0,838,19610,3575870610,3575870627,17
0,838,19611,3575870610,3575870629,19
0,838,19612,3575870610,3575870629,19
0,838,19613,3575870610,3575870632,22
0,838,19614,3575870610,3575870633,23
0,838,19615,3575870610,3575870633,23
0,838,19616,3575870610,3575870633,23
0,838,19617,3575870610,3575870637,27
0,838,19618,3575870610,3575870639,29
0,838,19619,3575870610,3575870642,32
0,838,19620,3575870610,3575870643,33
0,838,19621,3575870610,3575870644,34
0,838,19622,3575870610,3575870645,35
0,838,19623,3575870610,3575870646,36
0,838,19624,3575870610,3575870646,36
0,838,19625,3575870610,3575870647,37
0,838,19626,3575870610,3575870647,37
0,838,19627,3575870610,3575870649,39
0,838,19628,3575870610,3575870649,39
0,838,19629,3575870610,3575870651,41
0,838,19630,3575870610,3575870652,42
0,838,19631,3575870610,3575870653,43
0,838,19632,3575870610,3575870654,44
0,838,19633,3575870610,3575870655,45
0,838,19634,3575870610,3575870655,45
0,838,19635,3575870610,3575870657,47
0,839,19636,3575870668,3575870668,0
0,839,19637,3575870668,3575870668,0
0,839,19638,3575870668,3575870668,0
0,839,19639,3575870668,3575870668,0
0,839,19640,3575870668,3575870668,0
0,839,19641,3575870668,3575870668,0
0,839,19642,3575870668,3575870672,4
0,839,19643,3575870668,3575870680,12
0,839,19644,3575870668,3575870680,12
0,839,19645,3575870668,3575870681,13
0,839,19646,3575870668,3575870681,13
0,839,19647,3575870668,3575870682,14
0,839,19648,3575870668,3575870684,16
0,839,19649,3575870668,3575870685,17
0,839,19650,3575870668,3575870688,20
0,839,19651,3575870668,3575870689,21
0,839,19652,3575870668,3575870690,22
0,839,19653,3575870668,3575870691,23
0,839,19654,3575870668,3575870692,24
0,839,19655,3575870668,3575870692,24
0,839,19656,3575870668,3575870692,24
0,839,19657,3575870668,3575870693,25
0,839,19658,3575870668,3575870693,25
0,839,19659,3575870668,3575870694,26
0,839,19660,3575870668,3575870694,26
0,839,19661,3575870668,3575870694,26
0,839,19662,3575870668,3575870694,26
0,839,19663,3575870668,3575870695,27
0,839,19664,3575870668,3575870695,27
0,839,19665,3575870668,3575870696,28
0,839,19666,3575870668,3575870696,28
0,839,19667,3575870668,3575870696,28
0,839,19668,3575870668,3575870697,29
0,839,19669,3575870668,3575870698,30
0,839,19670,3575870668,3575870699,31
0,839,19671,3575870668,3575870701,33
0,839,19672,3575870668,3575870704,36
0,839,19673,3575870668,3575870704,36
0,839,19674,3575870668,3575870705,37
0,839,19675,3575870668,3575870708,40
0,839,19676,3575870668,3575870710,42
0,839,19677,3575870668,3575870710,42
0,839,19678,3575870668,3575870711,43
0,839,19679,3575870668,3575870711,43
0,839,19680,3575870668,3575870711,43
0,839,19681,3575870668,3575870712,44
0,839,19682,3575870668,3575870713,45
0,839,19683,3575870668,3575870714,46
0,839,19684,3575870668,3575870714,46
0,839,19685,3575870668,3575870714,46
0,839,19686,3575870668,3575870714,46
0,839,19687,3575870668,3575870715,47
0,840,19688,3575870725,3575870725,0
0,840,19689,3575870725,3575870725,0
0,840,19690,3575870725,3575870725,0
0,840,19691,3575870725,3575870725,0
0,840,19692,3575870725,3575870725,0
0,840,19693,3575870725,3575870725,0
0,840,19694,3575870725,3575870725,0
0,840,19695,3575870725,3575870725,0
0,840,19696,3575870725,3575870725,0
0,840,19697,3575870725,3575870725,0
0,840,19698,3575870725,3575870725,0
0,840,19699,3575870725,3575870726,1
0,840,19700,3575870725,3575870726,1
0,840,19701,3575870725,3575870726,1
0,840,19702,3575870725,3575870726,1
0,840,19703,3575870725,3575870727,2
0,840,19704,3575870725,3575870727,2
0,840,19705,3575870725,3575870728,3
0,840,19706,3575870725,3575870731,6
0,840,19707,3575870725,3575870732,7
0,840,19708,3575870725,3575870732,7
0,840,19709,3575870725,3575870734,9
0,840,19710,3575870725,3575870734,9
0,840,19711,3575870725,3575870735,10
0,840,19712,3575870725,3575870736,11
0,840,19713,3575870725,3575870736,11
0,840,19714,3575870725,3575870737,12
0,840,19715,3575870725,3575870737,12
0,840,19716,3575870725,3575870738,13
0,840,19717,3575870725,3575870740,15
0,840,19718,3575870725,3575870740,15
0,840,19719,3575870725,3575870741,16
0,840,19720,3575870725,3575870743,18
0,840,19721,3575870725,3575870745,20
0,840,19722,3575870725,3575870745,20
0,840,19723,3575870725,3575870747,22
0,840,19724,3575870725,3575870748,23
0,840,19725,3575870725,3575870750,25
0,840,19726,3575870725,3575870750,25
0,840,19727,3575870725,3575870752,27
0,840,19728,3575870725,3575870753,28
0,840,19729,3575870725,3575870753,28
0,840,19730,3575870725,3575870754,29
0,840,19731,3575870725,3575870755,30
0,840,19732,3575870725,3575870755,30
0,840,19733,3575870725,3575870757,32
0,840,19734,3575870725,3575870758,33
0,840,19735,3575870725,3575870759,34
0,840,19736,3575870725,3575870760,35
0,840,19737,3575870725,3575870762,37
0,840,19738,3575870725,3575870763,38
0,840,19739,3575870725,3575870763,38
0,840,19740,3575870725,3575870763,38
0,840,19741,3575870725,3575870765,40
0,840,19742,3575870725,3575870766,41
0,840,19743,3575870725,3575870769,44
0,840,19744,3575870725,3575870770,45
0,840,19745,3575870725,3575870771,46
0,841,19746,3575870783,3575870783,0
0,841,19747,3575870783,3575870783,0
0,841,19748,3575870783,3575870783,0
0,841,19749,3575870783,3575870783,0
0,841,19750,3575870783,3575870783,0
0,841,19751,3575870783,3575870783,0
0,841,19752,3575870783,3575870783,0
0,841,19753,3575870783,3575870783,0
0,841,19754,3575870783,3575870783,0
0,841,19755,3575870783,3575870783,0
0,841,19756,3575870783,3575870787,4
0,841,19757,3575870783,3575870788,5
0,841,19758,3575870783,3575870789,6
0,841,19759,3575870783,3575870790,7
0,841,19760,3575870783,3575870794,11
0,841,19761,3575870783,3575870797,14
0,841,19762,3575870783,3575870799,16
0,841,19763,3575870783,3575870800,17
0,841,19764,3575870783,3575870803,20
0,841,19765,3575870783,3575870805,22
0,841,19766,3575870783,3575870806,23
0,841,19767,3575870783,3575870807,24
0,841,19768,3575870783,3575870808,25
0,841,19769,3575870783,3575870811,28
0,841,19770,3575870783,3575870812,29
0,841,19771,3575870783,3575870814,31
0,841,19772,3575870783,3575870814,31
0,841,19773,3575870783,3575870816,33
0,841,19774,3575870783,3575870818,35
0,841,19775,3575870783,3575870821,38
0,841,19776,3575870783,3575870826,43
0,841,19777,3575870783,3575870828,45
0,841,19778,3575870783,3575870829,46
0,841,19779,3575870783,3575870830,47
0,841,19780,3575870783,3575870832,49
0,841,19781,3575870783,3575870832,49
0,841,19782,3575870783,3575870833,50
0,842,19783,3575870842,3575870842,0
0,842,19784,3575870842,3575870842,0
0,842,19785,3575870842,3575870842,0
0,842,19786,3575870842,3575870842,0
0,842,19787,3575870842,3575870843,1
0,842,19788,3575870842,3575870844,2
0,842,19789,3575870842,3575870846,4
0,842,19790,3575870842,3575870847,5
0,842,19791,3575870842,3575870847,5
0,842,19792,3575870842,3575870848,6
0,842,19793,3575870842,3575870849,7
0,842,19794,3575870842,3575870851,9
0,842,19795,3575870842,3575870852,10
0,842,19796,3575870842,3575870854,12
0,842,19797,3575870842,3575870855,13
0,842,19798,3575870842,3575870855,13
0,842,19799,3575870842,3575870857,15
0,842,19800,3575870842,3575870858,16
0,842,19801,3575870842,3575870863,21
0,842,19802,3575870842,3575870863,21
0,842,19803,3575870842,3575870866,24
0,842,19804,3575870842,3575870867,25
0,842,19805,3575870842,3575870867,25
0,842,19806,3575870842,3575870868,26
0,842,19807,3575870842,3575870880,38
0,842,19808,3575870842,3575870881,39
0,842,19809,3575870842,3575870881,39
0,842,19810,3575870842,3575870881,39
0,842,19811,3575870842,3575870881,39
0,842,19812,3575870842,3575870882,40
0,842,19813,3575870842,3575870884,42
0,842,19814,3575870842,3575870885,43
0,842,19815,3575870842,3575870888,46
0,842,19816,3575870842,3575870889,47
0,842,19817,3575870842,3575870891,49
0,842,19818,3575870842,3575870892,50
0,843,19819,3575870902,3575870902,0
0,843,19820,3575870902,3575870902,0
0,843,19821,3575870902,3575870902,0
0,843,19822,3575870902,3575870902,0
0,843,19823,3575870902,3575870902,0
0,843,19824,3575870902,3575870902,0
0,843,19825,3575870902,3575870902,0
0,843,19826,3575870902,3575870902,0
0,843,19827,3575870902,3575870902,0
0,843,19828,3575870902,3575870902,0
0,843,19829,3575870902,3575870902,0
0,843,19830,3575870902,3575870902,0
0,843,19831,3575870902,3575870902,0
0,843,19832,3575870902,3575870902,0
0,843,19833,3575870902,3575870902,0
0,843,19834,3575870902,3575870902,0
0,843,19835,3575870902,3575870902,0
0,843,19836,3575870902,3575870902,0
0,843,19837,3575870902,3575870904,2
0,843,19838,3575870902,3575870905,3
0,843,19839,3575870902,3575870910,8
0,843,19840,3575870902,3575870911,9
0,843,19841,3575870902,3575870911,9
0,843,19842,3575870902,3575870912,10
0,843,19843,3575870902,3575870912,10
0,843,19844,3575870902,3575870912,10
0,843,19845,3575870902,3575870913,11
0,843,19846,3575870902,3575870914,12
0,843,19847,3575870902,3575870915,13
0,843,19848,3575870902,3575870915,13
0,843,19849,3575870902,3575870916,14
0,843,19850,3575870902,3575870919,17
0,843,19851,3575870902,3575870919,17
0,843,19852,3575870902,3575870920,18
0,843,19853,3575870902,3575870922,20
0,843,19854,3575870902,3575870923,21
0,843,19855,3575870902,3575870923,21
0,843,19856,3575870902,3575870923,21
0,843,19857,3575870902,3575870923,21
0,843,19858,3575870902,3575870924,22
0,843,19859,3575870902,3575870925,23
0,843,19860,3575870902,3575870925,23
0,843,19861,3575870902,3575870926,24
0,843,19862,3575870902,3575870926,24
0,843,19863,3575870902,3575870927,25
0,843,19864,3575870902,3575870927,25
0,843,19865,3575870902,3575870928,26
0,843,19866,3575870902,3575870929,27
0,843,19867,3575870902,3575870931,29
0,843,19868,3575870902,3575870931,29
0,843,19869,3575870902,3575870932,30
0,843,19870,3575870902,3575870934,32
0,843,19871,3575870902,3575870935,33
0,843,19872,3575870902,3575870935,33
0,843,19873,3575870902,3575870936,34
0,843,19874,3575870902,3575870936,34
0,843,19875,3575870902,3575870937,35
0,843,19876,3575870902,3575870937,35
0,843,19877,3575870902,3575870938,36
0,843,19878,3575870902,3575870940,38
0,843,19879,3575870902,3575870941,39
0,843,19880,3575870902,3575870941,39
0,843,19881,3575870902,3575870942,40
0,843,19882,3575870902,3575870943,41
0,843,19883,3575870902,3575870944,42
0,843,19884,3575870902,3575870945,43
0,843,19885,3575870902,3575870945,43
0,843,19886,3575870902,3575870946,44
0,843,19887,3575870902,3575870946,44
0,843,19888,3575870902,3575870948,46
0,843,19889,3575870902,3575870948,46
0,843,19890,3575870902,3575870950,48
0,843,19891,3575870902,3575870950,48
0,844,19892,3575870961,3575870961,0
0,844,19893,3575870961,3575870961,0
0,844,19894,3575870961,3575870961,0
0,844,19895,3575870961,3575870961,0
0,844,19896,3575870961,3575870961,0
0,844,19897,3575870961,3575870961,0
0,844,19898,3575870961,3575870961,0
0,844,19899,3575870961,3575870961,0
0,844,19900,3575870961,3575870962,1
0,844,19901,3575870961,3575870963,2
0,844,19902,3575870961,3575870963,2
0,844,19903,3575870961,3575870963,2
0,844,19904,3575870961,3575870964,3
0,844,19905,3575870961,3575870966,5
0,844,19906,3575870961,3575870966,5
0,844,19907,3575870961,3575870967,6
0,844,19908,3575870961,3575870969,8
0,844,19909,3575870961,3575870971,10
0,844,19910,3575870961,3575870971,10
0,844,19911,3575870961,3575870971,10
0,844,19912,3575870961,3575870975,14
0,844,19913,3575870961,3575870976,15
0,844,19914,3575870961,3575870976,15
0,844,19915,3575870961,3575870977,16
0,844,19916,3575870961,3575870978,17
0,844,19917,3575870961,3575870978,17
0,844,19918,3575870961,3575870979,18
0,844,19919,3575870961,3575870980,19
0,844,19920,3575870961,3575870981,20
0,844,19921,3575870961,3575870982,21
0,844,19922,3575870961,3575870988,27
0,844,19923,3575870961,3575870989,28
0,844,19924,3575870961,3575870990,29
0,844,19925,3575870961,3575870990,29
0,844,19926,3575870961,3575870994,33
0,844,19927,3575870961,3575870994,33
0,844,19928,3575870961,3575870998,37
0,844,19929,3575870961,3575870999,38
0,844,19930,3575870961,3575871000,39
0,844,19931,3575870961,3575871004,43
0,844,19932,3575870961,3575871005,44
0,844,19933,3575870961,3575871006,45
0,844,19934,3575870961,3575871007,46
0,845,19935,3575871021,3575871022,1
0,845,19936,3575871021,3575871022,1
0,845,19937,3575871021,3575871022,1
0,845,19938,3575871021,3575871022,1
0,845,19939,3575871021,3575871022,1
0,845,19940,3575871021,3575871022,1
0,845,19941,3575871021,3575871022,1
0,845,19942,3575871021,3575871022,1
0,845,19943,3575871021,3575871022,1
0,845,19944,3575871021,3575871028,7
0,845,19945,3575871021,3575871028,7
0,845,19946,3575871021,3575871030,9
0,845,19947,3575871021,3575871033,12
0,845,19948,3575871021,3575871033,12
0,845,19949,3575871021,3575871033,12
0,845,19950,3575871021,3575871037,16
0,845,19951,3575871021,3575871037,16
0,845,19952,3575871021,3575871041,20
0,845,19953,3575871021,3575871043,22
0,845,19954,3575871021,3575871044,23
0,845,19955,3575871021,3575871044,23
0,845,19956,3575871021,3575871045,24
0,845,19957,3575871021,3575871046,25
0,845,19958,3575871021,3575871046,25
0,845,19959,3575871021,3575871047,26
0,845,19960,3575871021,3575871047,26
0,845,19961,3575871021,3575871048,27
0,845,19962,3575871021,3575871049,28
0,845,19963,3575871021,3575871051,30
0,845,19964,3575871021,3575871052,31
0,845,19965,3575871021,3575871053,32
0,845,19966,3575871021,3575871054,33
0,845,19967,3575871021,3575871055,34
0,845,19968,3575871021,3575871055,34
0,845,19969,3575871021,3575871057,36
0,845,19970,3575871021,3575871059,38
0,845,19971,3575871021,3575871062,41
0,845,19972,3575871021,3575871062,41
0,845,19973,3575871021,3575871065,44
0,845,19974,3575871021,3575871065,44
0,845,19975,3575871021,3575871066,45
0,845,19976,3575871021,3575871067,46
0,845,19977,3575871021,3575871068,47
0,845,19978,3575871021,3575871070,49
0,846,19979,3575871079,3575871079,0
0,846,19980,3575871079,3575871080,1
0,846,19981,3575871079,3575871080,1
0,846,19982,3575871079,3575871081,2
0,846,19983,3575871079,3575871082,3
0,846,19984,3575871079,3575871082,3
0,846,19985,3575871079,3575871082,3
0,846,19986,3575871079,3575871084,5
0,846,19987,3575871079,3575871085,6
0,846,19988,3575871079,3575871089,10
0,846,19989,3575871079,3575871089,10
0,846,19990,3575871079,3575871090,11
0,846,19991,3575871079,3575871090,11
0,846,19992,3575871079,3575871092,13
0,846,19993,3575871079,3575871092,13
0,846,19994,3575871079,3575871093,14
0,846,19995,3575871079,3575871093,14
0,846,19996,3575871079,3575871093,14
0,846,19997,3575871079,3575871094,15
0,846,19998,3575871079,3575871094,15
0,846,19999,3575871079,3575871094,15
0,846,20000,3575871079,3575871095,16
0,846,20001,3575871079,3575871095,16
0,846,20002,3575871079,3575871095,16
0,846,20003,3575871079,3575871096,17
0,846,20004,3575871079,3575871096,17
0,846,20005,3575871079,3575871097,18
0,846,20006,3575871079,3575871099,20
0,846,20007,3575871079,3575871100,21
0,846,20008,3575871079,3575871101,22
0,846,20009,3575871079,3575871102,23
0,846,20010,3575871079,3575871104,25
0,846,20011,3575871079,3575871104,25
0,846,20012,3575871079,3575871109,30
0,846,20013,3575871079,3575871110,31
0,846,20014,3575871079,3575871111,32
0,846,20015,3575871079,3575871111,32
0,846,20016,3575871079,3575871112,33
0,846,20017,3575871079,3575871112,33
0,846,20018,3575871079,3575871113,34
0,846,20019,3575871079,3575871114,35
0,846,20020,3575871079,3575871115,36
0,846,20021,3575871079,3575871115,36
0,846,20022,3575871079,3575871116,37
0,846,20023,3575871079,3575871116,37
0,846,20024,3575871079,3575871119,40
0,846,20025,3575871079,3575871120,41
0,846,20026,3575871079,3575871121,42
0,846,20027,3575871079,3575871122,43
0,846,20028,3575871079,3575871123,44
0,846,20029,3575871079,3575871123,44
0,846,20030,3575871079,3575871123,44
0,846,20031,3575871079,3575871124,45
0,846,20032,3575871079,3575871124,45
0,846,20033,3575871079,3575871125,46
0,846,20034,3575871079,3575871126,47
0,846,20035,3575871079,3575871126,47
0,846,20036,3575871079,3575871126,47
0,846,20037,3575871079,3575871127,48
0,846,20038,3575871079,3575871128,49
0,846,20039,3575871079,3575871128,49
0,847,20040,3575871139,3575871139,0
0,847,20041,3575871139,3575871139,0
0,847,20042,3575871139,3575871139,0
0,847,20043,3575871139,3575871139,0
0,847,20044,3575871139,3575871139,0
0,847,20045,3575871139,3575871139,0
0,847,20046,3575871139,3575871139,0
0,847,20047,3575871139,3575871139,0
0,847,20048,3575871139,3575871139,0
0,847,20049,3575871139,3575871139,0
0,847,20050,3575871139,3575871139,0
0,847,20051,3575871139,3575871140,1
0,847,20052,3575871139,3575871141,2
0,847,20053,3575871139,3575871141,2
0,847,20054,3575871139,3575871143,4
0,847,20055,3575871139,3575871143,4
0,847,20056,3575871139,3575871144,5
0,847,20057,3575871139,3575871145,6
0,847,20058,3575871139,3575871146,7
0,847,20059,3575871139,3575871146,7
0,847,20060,3575871139,3575871147,8
0,847,20061,3575871139,3575871147,8
0,847,20062,3575871139,3575871148,9
0,847,20063,3575871139,3575871150,11
0,847,20064,3575871139,3575871150,11
0,847,20065,3575871139,3575871151,12
0,847,20066,3575871139,3575871153,14
0,847,20067,3575871139,3575871153,14
0,847,20068,3575871139,3575871154,15
0,847,20069,3575871139,3575871154,15
0,847,20070,3575871139,3575871155,16
0,847,20071,3575871139,3575871157,18
0,847,20072,3575871139,3575871157,18
0,847,20073,3575871139,3575871158,19
0,847,20074,3575871139,3575871160,21
0,847,20075,3575871139,3575871162,23
0,847,20076,3575871139,3575871163,24
0,847,20077,3575871139,3575871163,24
0,847,20078,3575871139,3575871166,27
0,847,20079,3575871139,3575871167,28
0,847,20080,3575871139,3575871170,31
0,847,20081,3575871139,3575871170,31
0,847,20082,3575871139,3575871172,33
0,847,20083,3575871139,3575871172,33
0,847,20084,3575871139,3575871176,37
0,847,20085,3575871139,3575871177,38
0,847,20086,3575871139,3575871177,38
0,847,20087,3575871139,3575871178,39
0,847,20088,3575871139,3575871178,39
0,847,20089,3575871139,3575871179,40
0,847,20090,3575871139,3575871179,40
0,847,20091,3575871139,3575871180,41
0,847,20092,3575871139,3575871180,41
0,847,20093,3575871139,3575871181,42
0,847,20094,3575871139,3575871183,44
0,847,20095,3575871139,3575871187,48
0,847,20096,3575871139,3575871189,50
0,848,20097,3575871198,3575871198,0
0,848,20098,3575871198,3575871198,0
0,848,20099,3575871198,3575871198,0
0,848,20100,3575871198,3575871198,0
0,848,20101,3575871198,3575871198,0
0,848,20102,3575871198,3575871198,0
0,848,20103,3575871198,3575871199,1
0,848,20104,3575871198,3575871199,1
0,848,20105,3575871198,3575871205,7
0,848,20106,3575871198,3575871206,8
0,848,20107,3575871198,3575871206,8
0,848,20108,3575871198,3575871207,9
0,848,20109,3575871198,3575871208,10
0,848,20110,3575871198,3575871211,13
0,848,20111,3575871198,3575871214,16
0,848,20112,3575871198,3575871216,18
0,848,20113,3575871198,3575871218,20
0,848,20114,3575871198,3575871218,20
0,848,20115,3575871198,3575871221,23
0,848,20116,3575871198,3575871224,26
0,848,20117,3575871198,3575871229,31
0,848,20118,3575871198,3575871230,32
0,848,20119,3575871198,3575871231,33
0,848,20120,3575871198,3575871232,34
0,848,20121,3575871198,3575871232,34
0,848,20122,3575871198,3575871233,35
0,848,20123,3575871198,3575871233,35
0,848,20124,3575871198,3575871238,40
0,848,20125,3575871198,3575871238,40
0,848,20126,3575871198,3575871241,43
0,848,20127,3575871198,3575871244,46
0,848,20128,3575871198,3575871244,46
0,848,20129,3575871198,3575871246,48
0,848,20130,3575871198,3575871247,49
0,848,20131,3575871198,3575871247,49
0,848,20132,3575871198,3575871247,49
0,848,20133,3575871198,3575871247,49
0,849,20134,3575871260,3575871261,1
0,849,20135,3575871260,3575871261,1
0,849,20136,3575871260,3575871261,1
0,849,20137,3575871260,3575871261,1
0,849,20138,3575871260,3575871261,1
0,849,20139,3575871260,3575871261,1
0,849,20140,3575871260,3575871261,1
0,849,20141,3575871260,3575871261,1
0,849,20142,3575871260,3575871262,2
0,849,20143,3575871260,3575871263,3
0,849,20144,3575871260,3575871265,5
0,849,20145,3575871260,3575871266,6
0,849,20146,3575871260,3575871266,6
0,849,20147,3575871260,3575871268,8
0,849,20148,3575871260,3575871268,8
0,849,20149,3575871260,3575871274,14
0,849,20150,3575871260,3575871281,21
0,849,20151,3575871260,3575871282,22
0,849,20152,3575871260,3575871282,22
0,849,20153,3575871260,3575871283,23
0,849,20154,3575871260,3575871284,24
0,849,20155,3575871260,3575871288,28
0,849,20156,3575871260,3575871291,31
0,849,20157,3575871260,3575871292,32
0,849,20158,3575871260,3575871292,32
0,849,20159,3575871260,3575871292,32
0,849,20160,3575871260,3575871293,33
0,849,20161,3575871260,3575871293,33
0,849,20162,3575871260,3575871294,34
0,849,20163,3575871260,3575871294,34
0,849,20164,3575871260,3575871294,34
0,849,20165,3575871260,3575871295,35
0,849,20166,3575871260,3575871295,35
0,849,20167,3575871260,3575871295,35
0,849,20168,3575871260,3575871295,35
0,849,20169,3575871260,3575871295,35
0,849,20170,3575871260,3575871296,36
0,849,20171,3575871260,3575871296,36
0,849,20172,3575871260,3575871297,37
0,849,20173,3575871260,3575871297,37
0,849,20174,3575871260,3575871298,38
0,849,20175,3575871260,3575871298,38
0,849,20176,3575871260,3575871300,40
0,849,20177,3575871260,3575871301,41
0,849,20178,3575871260,3575871301,41
0,849,20179,3575871260,3575871302,42
0,849,20180,3575871260,3575871304,44
0,849,20181,3575871260,3575871304,44
0,849,20182,3575871260,3575871309,49
0,849,20183,3575871260,3575871310,50
0,850,20184,3575871321,3575871321,0
0,850,20185,3575871321,3575871321,0
0,850,20186,3575871321,3575871321,0
0,850,20187,3575871321,3575871321,0
0,850,20188,3575871321,3575871321,0
0,850,20189,3575871321,3575871321,0
0,850,20190,3575871321,3575871321,0
0,850,20191,3575871321,3575871321,0
0,850,20192,3575871321,3575871321,0
0,850,20193,3575871321,3575871321,0
0,850,20194,3575871321,3575871321,0
0,850,20195,3575871321,3575871321,0
0,850,20196,3575871321,3575871321,0
0,850,20197,3575871321,3575871322,1
0,850,20198,3575871321,3575871323,2
0,850,20199,3575871321,3575871323,2
0,850,20200,3575871321,3575871324,3
0,850,20201,3575871321,3575871324,3
0,850,20202,3575871321,3575871325,4
0,850,20203,3575871321,3575871325,4
0,850,20204,3575871321,3575871326,5
0,850,20205,3575871321,3575871327,6
0,850,20206,3575871321,3575871327,6
0,850,20207,3575871321,3575871328,7
0,850,20208,3575871321,3575871328,7
0,850,20209,3575871321,3575871329,8
0,850,20210,3575871321,3575871332,11
0,850,20211,3575871321,3575871332,11
0,850,20212,3575871321,3575871333,12
0,850,20213,3575871321,3575871335,14
0,850,20214,3575871321,3575871336,15
0,850,20215,3575871321,3575871336,15
0,850,20216,3575871321,3575871337,16
0,850,20217,3575871321,3575871337,16
0,850,20218,3575871321,3575871337,16
0,850,20219,3575871321,3575871338,17
0,850,20220,3575871321,3575871339,18
0,850,20221,3575871321,3575871340,19
0,850,20222,3575871321,3575871341,20
0,850,20223,3575871321,3575871341,20
0,850,20224,3575871321,3575871343,22
0,850,20225,3575871321,3575871343,22
0,850,20226,3575871321,3575871343,22
0,850,20227,3575871321,3575871345,24
0,850,20228,3575871321,3575871345,24
0,850,20229,3575871321,3575871346,25
0,850,20230,3575871321,3575871348,27
0,850,20231,3575871321,3575871348,27
0,850,20232,3575871321,3575871348,27
0,850,20233,3575871321,3575871349,28
0,850,20234,3575871321,3575871350,29
0,850,20235,3575871321,3575871351,30
0,850,20236,3575871321,3575871351,30
0,850,20237,3575871321,3575871353,32
0,850,20238,3575871321,3575871353,32
0,850,20239,3575871321,3575871353,32
0,850,20240,3575871321,3575871355,34
0,850,20241,3575871321,3575871357,36
0,850,20242,3575871321,3575871357,36
0,850,20243,3575871321,3575871357,36
0,850,20244,3575871321,3575871357,36
0,850,20245,3575871321,3575871359,38
0,850,20246,3575871321,3575871360,39
0,850,20247,3575871321,3575871362,41
0,850,20248,3575871321,3575871362,41
0,850,20249,3575871321,3575871363,42
0,850,20250,3575871321,3575871363,42
0,850,20251,3575871321,3575871364,43
0,850,20252,3575871321,3575871365,44
0,850,20253,3575871321,3575871367,46
0,850,20254,3575871321,3575871367,46
0,850,20255,3575871321,3575871370,49
0,850,20256,3575871321,3575871371,50
0,851,20257,3575871380,3575871380,0
0,851,20258,3575871380,3575871380,0
0,851,20259,3575871380,3575871380,0
0,851,20260,3575871380,3575871380,0
0,851,20261,3575871380,3575871380,0
0,851,20262,3575871380,3575871380,0
0,851,20263,3575871380,3575871380,0
0,851,20264,3575871380,3575871380,0
0,851,20265,3575871380,3575871380,0
0,851,20266,3575871380,3575871380,0
0,851,20267,3575871380,3575871380,0
0,851,20268,3575871380,3575871381,1
0,851,20269,3575871380,3575871382,2
0,851,20270,3575871380,3575871382,2
0,851,20271,3575871380,3575871388,8
0,851,20272,3575871380,3575871389,9
0,851,20273,3575871380,3575871390,10
0,851,20274,3575871380,3575871390,10
0,851,20275,3575871380,3575871393,13
0,851,20276,3575871380,3575871394,14
0,851,20277,3575871380,3575871398,18
0,851,20278,3575871380,3575871399,19
0,851,20279,3575871380,3575871399,19
0,851,20280,3575871380,3575871403,23
0,851,20281,3575871380,3575871406,26
0,851,20282,3575871380,3575871406,26
0,851,20283,3575871380,3575871407,27
0,851,20284,3575871380,3575871408,28
0,851,20285,3575871380,3575871408,28
0,851,20286,3575871380,3575871411,31
0,851,20287,3575871380,3575871413,33
0,851,20288,3575871380,3575871414,34
0,851,20289,3575871380,3575871415,35
0,851,20290,3575871380,3575871418,38
0,851,20291,3575871380,3575871418,38
0,851,20292,3575871380,3575871418,38
0,851,20293,3575871380,3575871421,41
0,851,20294,3575871380,3575871421,41
0,851,20295,3575871380,3575871424,44
0,851,20296,3575871380,3575871428,48
0,851,20297,3575871380,3575871430,50
0,852,20298,3575871439,3575871439,0
0,852,20299,3575871439,3575871439,0
0,852,20300,3575871439,3575871439,0
0,852,20301,3575871439,3575871439,0
0,852,20302,3575871439,3575871439,0
0,852,20303,3575871439,3575871439,0
0,852,20304,3575871439,3575871439,0
0,852,20305,3575871439,3575871441,2
0,852,20306,3575871439,3575871443,4
0,852,20307,3575871439,3575871444,5
0,852,20308,3575871439,3575871445,6
0,852,20309,3575871439,3575871445,6
0,852,20310,3575871439,3575871446,7
0,852,20311,3575871439,3575871447,8
0,852,20312,3575871439,3575871448,9
0,852,20313,3575871439,3575871448,9
0,852,20314,3575871439,3575871449,10
0,852,20315,3575871439,3575871449,10
0,852,20316,3575871439,3575871450,11
0,852,20317,3575871439,3575871451,12
0,852,20318,3575871439,3575871452,13
0,852,20319,3575871439,3575871452,13
0,852,20320,3575871439,3575871455,16
0,852,20321,3575871439,3575871455,16
0,852,20322,3575871439,3575871456,17
0,852,20323,3575871439,3575871457,18
0,852,20324,3575871439,3575871458,19
0,852,20325,3575871439,3575871459,20
0,852,20326,3575871439,3575871463,24
0,852,20327,3575871439,3575871463,24
0,852,20328,3575871439,3575871466,27
0,852,20329,3575871439,3575871466,27
0,852,20330,3575871439,3575871467,28
0,852,20331,3575871439,3575871467,28
0,852,20332,3575871439,3575871468,29
0,852,20333,3575871439,3575871474,35
0,852,20334,3575871439,3575871480,41
0,852,20335,3575871439,3575871481,42
0,852,20336,3575871439,3575871482,43
0,852,20337,3575871439,3575871482,43
0,852,20338,3575871439,3575871482,43
0,852,20339,3575871439,3575871484,45
0,852,20340,3575871439,3575871488,49
0,853,20341,3575871498,3575871498,0
0,853,20342,3575871498,3575871498,0
0,853,20343,3575871498,3575871498,0
0,853,20344,3575871498,3575871498,0
0,853,20345,3575871498,3575871498,0
0,853,20346,3575871498,3575871498,0
0,853,20347,3575871498,3575871498,0
0,853,20348,3575871498,3575871498,0
0,853,20349,3575871498,3575871498,0
0,853,20350,3575871498,3575871498,0
0,853,20351,3575871498,3575871498,0
0,853,20352,3575871498,3575871498,0
0,853,20353,3575871498,3575871498,0
0,853,20354,3575871498,3575871498,0
0,853,20355,3575871498,3575871498,0
0,853,20356,3575871498,3575871498,0
0,853,20357,3575871498,3575871498,0
0,853,20358,3575871498,3575871498,0
0,853,20359,3575871498,3575871498,0
0,853,20360,3575871498,3575871498,0
0,853,20361,3575871498,3575871498,0
0,853,20362,3575871498,3575871500,2
0,853,20363,3575871498,3575871501,3
0,853,20364,3575871498,3575871501,3
0,853,20365,3575871498,3575871503,5
0,853,20366,3575871498,3575871504,6
0,853,20367,3575871498,3575871504,6
0,853,20368,3575871498,3575871510,12
0,853,20369,3575871498,3575871510,12
0,853,20370,3575871498,3575871511,13
0,853,20371,3575871498,3575871511,13
0,853,20372,3575871498,3575871511,13
0,853,20373,3575871498,3575871513,15
0,853,20374,3575871498,3575871514,16
0,853,20375,3575871498,3575871515,17
0,853,20376,3575871498,3575871515,17
0,853,20377,3575871498,3575871517,19
0,853,20378,3575871498,3575871518,20
0,853,20379,3575871498,3575871518,20
0,853,20380,3575871498,3575871519,21
0,853,20381,3575871498,3575871523,25
0,853,20382,3575871498,3575871523,25
0,853,20383,3575871498,3575871523,25
0,853,20384,3575871498,3575871524,26
0,853,20385,3575871498,3575871524,26
0,853,20386,3575871498,3575871525,27
0,853,20387,3575871498,3575871525,27
0,853,20388,3575871498,3575871525,27
0,853,20389,3575871498,3575871526,28
0,853,20390,3575871498,3575871526,28
0,853,20391,3575871498,3575871527,29
0,853,20392,3575871498,3575871527,29
0,853,20393,3575871498,3575871529,31
0,853,20394,3575871498,3575871531,33
0,853,20395,3575871498,3575871531,33
0,853,20396,3575871498,3575871533,35
0,853,20397,3575871498,3575871534,36
0,853,20398,3575871498,3575871535,37
0,853,20399,3575871498,3575871535,37
0,853,20400,3575871498,3575871536,38
0,853,20401,3575871498,3575871536,38
0,853,20402,3575871498,3575871536,38
0,853,20403,3575871498,3575871536,38
0,853,20404,3575871498,3575871537,39
0,853,20405,3575871498,3575871538,40
0,853,20406,3575871498,3575871539,41
0,853,20407,3575871498,3575871540,42
0,853,20408,3575871498,3575871541,43
0,853,20409,3575871498,3575871542,44
0,853,20410,3575871498,3575871543,45
0,853,20411,3575871498,3575871544,46
0,853,20412,3575871498,3575871544,46
0,853,20413,3575871498,3575871545,47
0,853,20414,3575871498,3575871545,47
0,853,20415,3575871498,3575871548,50
0,854,20416,3575871558,3575871558,0
0,854,20417,3575871558,3575871558,0
0,854,20418,3575871558,3575871558,0
0,854,20419,3575871558,3575871558,0
0,854,20420,3575871558,3575871558,0
0,854,20421,3575871558,3575871558,0
0,854,20422,3575871558,3575871558,0
0,854,20423,3575871558,3575871558,0
0,854,20424,3575871558,3575871558,0
0,854,20425,3575871558,3575871558,0
0,854,20426,3575871558,3575871558,0
0,854,20427,3575871558,3575871558,0
0,854,20428,3575871558,3575871558,0
0,854,20429,3575871558,3575871561,3
0,854,20430,3575871558,3575871561,3
0,854,20431,3575871558,3575871562,4
0,854,20432,3575871558,3575871562,4
0,854,20433,3575871558,3575871564,6
0,854,20434,3575871558,3575871564,6
0,854,20435,3575871558,3575871566,8
0,854,20436,3575871558,3575871566,8
0,854,20437,3575871558,3575871570,12
0,854,20438,3575871558,3575871573,15
0,854,20439,3575871558,3575871574,16
0,854,20440,3575871558,3575871577,19
0,854,20441,3575871558,3575871577,19
0,854,20442,3575871558,3575871577,19
0,854,20443,3575871558,3575871577,19
0,854,20444,3575871558,3575871578,20
0,854,20445,3575871558,3575871579,21
0,854,20446,3575871558,3575871579,21
0,854,20447,3575871558,3575871580,22
0,854,20448,3575871558,3575871582,24
0,854,20449,3575871558,3575871587,29
0,854,20450,3575871558,3575871589,31
0,854,20451,3575871558,3575871589,31
0,854,20452,3575871558,3575871589,31
0,854,20453,3575871558,3575871593,35
0,854,20454,3575871558,3575871593,35
0,854,20455,3575871558,3575871598,40
0,854,20456,3575871558,3575871598,40
0,854,20457,3575871558,3575871599,41
0,854,20458,3575871558,3575871603,45
0,854,20459,3575871558,3575871605,47
0,854,20460,3575871558,3575871606,48
0,854,20461,3575871558,3575871607,49
0,854,20462,3575871558,3575871607,49
0,854,20463,3575871558,3575871607,49
0,855,20464,3575871618,3575871618,0
0,855,20465,3575871618,3575871618,0
0,855,20466,3575871618,3575871618,0
0,855,20467,3575871618,3575871618,0
0,855,20468,3575871618,3575871618,0
0,855,20469,3575871618,3575871618,0
0,855,20470,3575871618,3575871620,2
0,855,20471,3575871618,3575871621,3
0,855,20472,3575871618,3575871622,4
0,855,20473,3575871618,3575871625,7
0,855,20474,3575871618,3575871629,11
0,855,20475,3575871618,3575871630,12
0,855,20476,3575871618,3575871631,13
0,855,20477,3575871618,3575871631,13
0,855,20478,3575871618,3575871632,14
0,855,20479,3575871618,3575871636,18
0,855,20480,3575871618,3575871637,19
0,855,20481,3575871618,3575871640,22
0,855,20482,3575871618,3575871642,24
0,855,20483,3575871618,3575871643,25
0,855,20484,3575871618,3575871644,26
0,855,20485,3575871618,3575871645,27
0,855,20486,3575871618,3575871645,27
0,855,20487,3575871618,3575871646,28
0,855,20488,3575871618,3575871647,29
0,855,20489,3575871618,3575871648,30
0,855,20490,3575871618,3575871648,30
0,855,20491,3575871618,3575871650,32
0,855,20492,3575871618,3575871650,32
0,855,20493,3575871618,3575871652,34
0,855,20494,3575871618,3575871654,36
0,855,20495,3575871618,3575871654,36
0,855,20496,3575871618,3575871655,37
0,855,20497,3575871618,3575871656,38
0,855,20498,3575871618,3575871656,38
0,855,20499,3575871618,3575871658,40
0,855,20500,3575871618,3575871658,40
0,855,20501,3575871618,3575871662,44
0,855,20502,3575871618,3575871664,46
0,855,20503,3575871618,3575871665,47
0,855,20504,3575871618,3575871665,47
0,855,20505,3575871618,3575871667,49
0,855,20506,3575871618,3575871667,49
0,855,20507,3575871618,3575871668,50
0,856,20508,3575871678,3575871678,0
0,856,20509,3575871678,3575871680,2
0,856,20510,3575871678,3575871680,2
0,856,20511,3575871678,3575871681,3
0,856,20512,3575871678,3575871682,4
0,856,20513,3575871678,3575871682,4
0,856,20514,3575871678,3575871684,6
0,856,20515,3575871678,3575871688,10
0,856,20516,3575871678,3575871689,11
0,856,20517,3575871678,3575871690,12
0,856,20518,3575871678,3575871691,13
0,856,20519,3575871678,3575871691,13
0,856,20520,3575871678,3575871692,14
0,856,20521,3575871678,3575871693,15
0,856,20522,3575871678,3575871693,15
0,856,20523,3575871678,3575871693,15
0,856,20524,3575871678,3575871693,15
0,856,20525,3575871678,3575871693,15
0,856,20526,3575871678,3575871693,15
0,856,20527,3575871678,3575871694,16
0,856,20528,3575871678,3575871694,16
0,856,20529,3575871678,3575871695,17
0,856,20530,3575871678,3575871695,17
0,856,20531,3575871678,3575871695,17
0,856,20532,3575871678,3575871695,17
0,856,20533,3575871678,3575871696,18
0,856,20534,3575871678,3575871697,19
0,856,20535,3575871678,3575871697,19
0,856,20536,3575871678,3575871697,19
0,856,20537,3575871678,3575871697,19
0,856,20538,3575871678,3575871700,22
0,856,20539,3575871678,3575871701,23
0,856,20540,3575871678,3575871702,24
0,856,20541,3575871678,3575871703,25
0,856,20542,3575871678,3575871704,26
0,856,20543,3575871678,3575871704,26
0,856,20544,3575871678,3575871708,30
0,856,20545,3575871678,3575871709,31
0,856,20546,3575871678,3575871710,32
0,856,20547,3575871678,3575871710,32
0,856,20548,3575871678,3575871712,34
0,856,20549,3575871678,3575871712,34
0,856,20550,3575871678,3575871713,35
0,856,20551,3575871678,3575871715,37
0,856,20552,3575871678,3575871715,37
0,856,20553,3575871678,3575871715,37
0,856,20554,3575871678,3575871715,37
0,856,20555,3575871678,3575871717,39
0,856,20556,3575871678,3575871717,39
0,856,20557,3575871678,3575871718,40
0,856,20558,3575871678,3575871720,42
0,856,20559,3575871678,3575871721,43
0,856,20560,3575871678,3575871722,44
0,856,20561,3575871678,3575871723,45
0,856,20562,3575871678,3575871723,45
0,856,20563,3575871678,3575871723,45
0,856,20564,3575871678,3575871724,46
0,856,20565,3575871678,3575871724,46
0,856,20566,3575871678,3575871725,47
0,856,20567,3575871678,3575871726,48
0,856,20568,3575871678,3575871726,48
0,856,20569,3575871678,3575871726,48
0,856,20570,3575871678,3575871726,48
0,856,20571,3575871678,3575871726,48
0,856,20572,3575871678,3575871727,49
0,857,20573,3575871738,3575871738,0
0,857,20574,3575871738,3575871738,0
0,857,20575,3575871738,3575871738,0
0,857,20576,3575871738,3575871738,0
0,857,20577,3575871738,3575871738,0
0,857,20578,3575871738,3575871738,0
0,857,20579,3575871738,3575871738,0
0,857,20580,3575871738,3575871738,0
0,857,20581,3575871738,3575871738,0
0,857,20582,3575871738,3575871738,0
0,857,20583,3575871738,3575871738,0
0,857,20584,3575871738,3575871738,0
0,857,20585,3575871738,3575871739,1
0,857,20586,3575871738,3575871740,2
0,857,20587,3575871738,3575871740,2
0,857,20588,3575871738,3575871742,4
0,857,20589,3575871738,3575871743,5
0,857,20590,3575871738,3575871743,5
0,857,20591,3575871738,3575871745,7
0,857,20592,3575871738,3575871745,7
0,857,20593,3575871738,3575871746,8
0,857,20594,3575871738,3575871746,8
0,857,20595,3575871738,3575871747,9
0,857,20596,3575871738,3575871748,10
0,857,20597,3575871738,3575871750,12
0,857,20598,3575871738,3575871753,15
0,857,20599,3575871738,3575871753,15
0,857,20600,3575871738,3575871753,15
0,857,20601,3575871738,3575871755,17
0,857,20602,3575871738,3575871756,18
0,857,20603,3575871738,3575871756,18
0,857,20604,3575871738,3575871756,18
0,857,20605,3575871738,3575871756,18
0,857,20606,3575871738,3575871757,19
0,857,20607,3575871738,3575871759,21
0,857,20608,3575871738,3575871761,23
0,857,20609,3575871738,3575871761,23
0,857,20610,3575871738,3575871762,24
0,857,20611,3575871738,3575871762,24
0,857,20612,3575871738,3575871762,24
0,857,20613,3575871738,3575871762,24
0,857,20614,3575871738,3575871764,26
0,857,20615,3575871738,3575871765,27
0,857,20616,3575871738,3575871766,28
0,857,20617,3575871738,3575871767,29
0,857,20618,3575871738,3575871770,32
0,857,20619,3575871738,3575871770,32
0,857,20620,3575871738,3575871771,33
0,857,20621,3575871738,3575871773,35
0,857,20622,3575871738,3575871774,36
0,857,20623,3575871738,3575871774,36
0,857,20624,3575871738,3575871776,38
0,857,20625,3575871738,3575871777,39
0,857,20626,3575871738,3575871777,39
0,857,20627,3575871738,3575871778,40
0,857,20628,3575871738,3575871780,42
0,857,20629,3575871738,3575871780,42
0,857,20630,3575871738,3575871782,44
0,857,20631,3575871738,3575871783,45
0,857,20632,3575871738,3575871786,48
0,858,20633,3575871799,3575871799,0
0,858,20634,3575871799,3575871799,0
0,858,20635,3575871799,3575871799,0
0,858,20636,3575871799,3575871799,0
0,858,20637,3575871799,3575871799,0
0,858,20638,3575871799,3575871799,0
0,858,20639,3575871799,3575871799,0
0,858,20640,3575871799,3575871804,5
0,858,20641,3575871799,3575871805,6
0,858,20642,3575871799,3575871805,6
0,858,20643,3575871799,3575871807,8
0,858,20644,3575871799,3575871807,8
0,858,20645,3575871799,3575871807,8
0,858,20646,3575871799,3575871811,12
0,858,20647,3575871799,3575871812,13
0,858,20648,3575871799,3575871814,15
0,858,20649,3575871799,3575871815,16
0,858,20650,3575871799,3575871817,18
0,858,20651,3575871799,3575871818,19
0,858,20652,3575871799,3575871820,21
0,858,20653,3575871799,3575871821,22
0,858,20654,3575871799,3575871822,23
0,858,20655,3575871799,3575871825,26
0,858,20656,3575871799,3575871828,29
0,858,20657,3575871799,3575871828,29
0,858,20658,3575871799,3575871831,32
0,858,20659,3575871799,3575871831,32
0,858,20660,3575871799,3575871832,33
0,858,20661,3575871799,3575871832,33
0,858,20662,3575871799,3575871836,37
0,858,20663,3575871799,3575871837,38
0,858,20664,3575871799,3575871840,41
0,858,20665,3575871799,3575871842,43
0,858,20666,3575871799,3575871844,45
0,858,20667,3575871799,3575871845,46
0,858,20668,3575871799,3575871846,47
0,858,20669,3575871799,3575871847,48
0,858,20670,3575871799,3575871847,48
0,858,20671,3575871799,3575871848,49
0,858,20672,3575871799,3575871848,49
0,859,20673,3575871857,3575871857,0
0,859,20674,3575871857,3575871857,0
0,859,20675,3575871857,3575871857,0
0,859,20676,3575871857,3575871857,0
0,859,20677,3575871857,3575871857,0
0,859,20678,3575871857,3575871857,0
0,859,20679,3575871857,3575871857,0
0,859,20680,3575871857,3575871857,0
0,859,20681,3575871857,3575871857,0
0,859,20682,3575871857,3575871858,1
0,859,20683,3575871857,3575871862,5
0,859,20684,3575871857,3575871862,5
0,859,20685,3575871857,3575871863,6
0,859,20686,3575871857,3575871864,7
0,859,20687,3575871857,3575871865,8
0,859,20688,3575871857,3575871866,9
0,859,20689,3575871857,3575871867,10
0,859,20690,3575871857,3575871867,10
0,859,20691,3575871857,3575871876,19
0,859,20692,3575871857,3575871881,24
0,859,20693,3575871857,3575871881,24
0,859,20694,3575871857,3575871882,25
0,859,20695,3575871857,3575871883,26
0,859,20696,3575871857,3575871883,26
0,859,20697,3575871857,3575871885,28
0,859,20698,3575871857,3575871885,28
0,859,20699,3575871857,3575871888,31
0,859,20700,3575871857,3575871890,33
0,859,20701,3575871857,3575871891,34
0,859,20702,3575871857,3575871891,34
0,859,20703,3575871857,3575871891,34
0,859,20704,3575871857,3575871892,35
0,859,20705,3575871857,3575871893,36
0,859,20706,3575871857,3575871893,36
0,859,20707,3575871857,3575871893,36
0,859,20708,3575871857,3575871894,37
0,859,20709,3575871857,3575871894,37
0,859,20710,3575871857,3575871894,37
0,859,20711,3575871857,3575871894,37
0,859,20712,3575871857,3575871895,38
0,859,20713,3575871857,3575871895,38
0,859,20714,3575871857,3575871895,38
0,859,20715,3575871857,3575871895,38
0,859,20716,3575871857,3575871895,38
0,859,20717,3575871857,3575871895,38
0,859,20718,3575871857,3575871896,39
0,859,20719,3575871857,3575871897,40
0,859,20720,3575871857,3575871897,40
0,859,20721,3575871857,3575871897,40
0,859,20722,3575871857,3575871898,41
0,859,20723,3575871857,3575871900,43
0,859,20724,3575871857,3575871901,44
0,859,20725,3575871857,3575871902,45
0,859,20726,3575871857,3575871903,46
0,859,20727,3575871857,3575871904,47
0,859,20728,3575871857,3575871905,48
0,860,20729,3575871917,3575871917,0
0,860,20730,3575871917,3575871917,0
0,860,20731,3575871917,3575871917,0
0,860,20732,3575871917,3575871917,0
0,860,20733,3575871917,3575871917,0
0,860,20734,3575871917,3575871917,0
0,860,20735,3575871917,3575871917,0
0,860,20736,3575871917,3575871917,0
0,860,20737,3575871917,3575871917,0
0,860,20738,3575871917,3575871918,1
0,860,20739,3575871917,3575871918,1
0,860,20740,3575871917,3575871918,1
0,860,20741,3575871917,3575871918,1
0,860,20742,3575871917,3575871918,1
0,860,20743,3575871917,3575871918,1
0,860,20744,3575871917,3575871919,2
0,860,20745,3575871917,3575871920,3
0,860,20746,3575871917,3575871922,5
0,860,20747,3575871917,3575871923,6
0,860,20748,3575871917,3575871923,6
0,860,20749,3575871917,3575871923,6
0,860,20750,3575871917,3575871923,6
0,860,20751,3575871917,3575871924,7
0,860,20752,3575871917,3575871926,9
0,860,20753,3575871917,3575871926,9
0,860,20754,3575871917,3575871927,10
0,860,20755,3575871917,3575871927,10
0,860,20756,3575871917,3575871927,10
0,860,20757,3575871917,3575871930,13
0,860,20758,3575871917,3575871931,14
0,860,20759,3575871917,3575871931,14
0,860,20760,3575871917,3575871933,16
0,860,20761,3575871917,3575871933,16
0,860,20762,3575871917,3575871935,18
0,860,20763,3575871917,3575871935,18
0,860,20764,3575871917,3575871935,18
0,860,20765,3575871917,3575871936,19
0,860,20766,3575871917,3575871937,20
0,860,20767,3575871917,3575871937,20
0,860,20768,3575871917,3575871938,21
0,860,20769,3575871917,3575871938,21
0,860,20770,3575871917,3575871938,21
0,860,20771,3575871917,3575871939,22
0,860,20772,3575871917,3575871940,23
0,860,20773,3575871917,3575871940,23
0,860,20774,3575871917,3575871942,25
0,860,20775,3575871917,3575871943,26
0,860,20776,3575871917,3575871943,26
0,860,20777,3575871917,3575871945,28
0,860,20778,3575871917,3575871945,28
0,860,20779,3575871917,3575871946,29
0,860,20780,3575871917,3575871947,30
0,860,20781,3575871917,3575871949,32
0,860,20782,3575871917,3575871949,32
0,860,20783,3575871917,3575871950,33
0,860,20784,3575871917,3575871951,34
0,860,20785,3575871917,3575871953,36
0,860,20786,3575871917,3575871953,36
0,860,20787,3575871917,3575871954,37
0,860,20788,3575871917,3575871955,38
0,860,20789,3575871917,3575871955,38
0,860,20790,3575871917,3575871955,38
0,860,20791,3575871917,3575871956,39
0,860,20792,3575871917,3575871958,41
0,860,20793,3575871917,3575871959,42
0,860,20794,3575871917,3575871961,44
0,860,20795,3575871917,3575871962,45
0,860,20796,3575871917,3575871962,45
0,860,20797,3575871917,3575871962,45
0,860,20798,3575871917,3575871962,45
0,860,20799,3575871917,3575871964,47
0,860,20800,3575871917,3575871965,48
0,860,20801,3575871917,3575871966,49
0,860,20802,3575871917,3575871967,50
0,861,20803,3575871977,3575871977,0
0,861,20804,3575871977,3575871977,0
0,861,20805,3575871977,3575871977,0
0,861,20806,3575871977,3575871977,0
0,861,20807,3575871977,3575871977,0
0,861,20808,3575871977,3575871977,0
0,861,20809,3575871977,3575871977,0
0,861,20810,3575871977,3575871979,2
0,861,20811,3575871977,3575871980,3
0,861,20812,3575871977,3575871980,3
0,861,20813,3575871977,3575871982,5
0,861,20814,3575871977,3575871987,10
0,861,20815,3575871977,3575871989,12
0,861,20816,3575871977,3575871989,12
0,861,20817,3575871977,3575871990,13
0,861,20818,3575871977,3575871996,19
0,861,20819,3575871977,3575871998,21
0,861,20820,3575871977,3575871999,22
0,861,20821,3575871977,3575872004,27
0,861,20822,3575871977,3575872006,29
0,861,20823,3575871977,3575872007,30
0,861,20824,3575871977,3575872007,30
0,861,20825,3575871977,3575872007,30
0,861,20826,3575871977,3575872012,35
0,861,20827,3575871977,3575872013,36
0,861,20828,3575871977,3575872014,37
0,861,20829,3575871977,3575872014,37
0,861,20830,3575871977,3575872015,38
0,861,20831,3575871977,3575872016,39
0,861,20832,3575871977,3575872018,41
0,861,20833,3575871977,3575872019,42
0,861,20834,3575871977,3575872021,44
0,861,20835,3575871977,3575872023,46
0,861,20836,3575871977,3575872025,48
0,861,20837,3575871977,3575872027,50
0,862,20838,3575872036,3575872036,0
0,862,20839,3575872036,3575872036,0
0,862,20840,3575872036,3575872036,0
0,862,20841,3575872036,3575872036,0
0,862,20842,3575872036,3575872038,2
0,862,20843,3575872036,3575872038,2
0,862,20844,3575872036,3575872040,4
0,862,20845,3575872036,3575872043,7
0,862,20846,3575872036,3575872044,8
0,862,20847,3575872036,3575872044,8
0,862,20848,3575872036,3575872045,9
0,862,20849,3575872036,3575872045,9
0,862,20850,3575872036,3575872046,10
0,862,20851,3575872036,3575872047,11
0,862,20852,3575872036,3575872048,12
0,862,20853,3575872036,3575872048,12
0,862,20854,3575872036,3575872049,13
0,862,20855,3575872036,3575872050,14
0,862,20856,3575872036,3575872051,15
0,862,20857,3575872036,3575872052,16
0,862,20858,3575872036,3575872054,18
0,862,20859,3575872036,3575872055,19
0,862,20860,3575872036,3575872056,20
0,862,20861,3575872036,3575872057,21
0,862,20862,3575872036,3575872057,21
0,862,20863,3575872036,3575872058,22
0,862,20864,3575872036,3575872061,25
0,862,20865,3575872036,3575872062,26
0,862,20866,3575872036,3575872063,27
0,862,20867,3575872036,3575872064,28
0,862,20868,3575872036,3575872065,29
0,862,20869,3575872036,3575872066,30
0,862,20870,3575872036,3575872067,31
0,862,20871,3575872036,3575872067,31
0,862,20872,3575872036,3575872068,32
0,862,20873,3575872036,3575872075,39
0,862,20874,3575872036,3575872080,44
0,862,20875,3575872036,3575872081,45
0,862,20876,3575872036,3575872081,45
0,862,20877,3575872036,3575872082,46
0,862,20878,3575872036,3575872083,47
0,862,20879,3575872036,3575872083,47
0,862,20880,3575872036,3575872083,47
0,862,20881,3575872036,3575872084,48
0,862,20882,3575872036,3575872085,49
0,863,20883,3575872095,3575872095,0
0,863,20884,3575872095,3575872095,0
0,863,20885,3575872095,3575872095,0
0,863,20886,3575872095,3575872095,0
0,863,20887,3575872095,3575872095,0
0,863,20888,3575872095,3575872095,0
0,863,20889,3575872095,3575872095,0
0,863,20890,3575872095,3575872095,0
0,863,20891,3575872095,3575872095,0
0,863,20892,3575872095,3575872095,0
0,863,20893,3575872095,3575872095,0
0,863,20894,3575872095,3575872095,0
0,863,20895,3575872095,3575872095,0
0,863,20896,3575872095,3575872095,0
0,863,20897,3575872095,3575872095,0
0,863,20898,3575872095,3575872095,0
0,863,20899,3575872095,3575872096,1
0,863,20900,3575872095,3575872096,1
0,863,20901,3575872095,3575872096,1
0,863,20902,3575872095,3575872096,1
0,863,20903,3575872095,3575872097,2
0,863,20904,3575872095,3575872098,3
0,863,20905,3575872095,3575872098,3
0,863,20906,3575872095,3575872098,3
0,863,20907,3575872095,3575872100,5
0,863,20908,3575872095,3575872101,6
0,863,20909,3575872095,3575872102,7
0,863,20910,3575872095,3575872103,8
0,863,20911,3575872095,3575872104,9
0,863,20912,3575872095,3575872105,10
0,863,20913,3575872095,3575872110,15
0,863,20914,3575872095,3575872110,15
0,863,20915,3575872095,3575872111,16
0,863,20916,3575872095,3575872111,16
0,863,20917,3575872095,3575872112,17
0,863,20918,3575872095,3575872112,17
0,863,20919,3575872095,3575872112,17
0,863,20920,3575872095,3575872114,19
0,863,20921,3575872095,3575872115,20
0,863,20922,3575872095,3575872116,21
0,863,20923,3575872095,3575872116,21
0,863,20924,3575872095,3575872116,21
0,863,20925,3575872095,3575872117,22
0,863,20926,3575872095,3575872118,23
0,863,20927,3575872095,3575872121,26
0,863,20928,3575872095,3575872121,26
0,863,20929,3575872095,3575872122,27
0,863,20930,3575872095,3575872123,28
0,863,20931,3575872095,3575872123,28
0,863,20932,3575872095,3575872123,28
0,863,20933,3575872095,3575872124,29
0,863,20934,3575872095,3575872124,29
0,863,20935,3575872095,3575872124,29
0,863,20936,3575872095,3575872125,30
0,863,20937,3575872095,3575872125,30
0,863,20938,3575872095,3575872126,31
0,863,20939,3575872095,3575872127,32
0,863,20940,3575872095,3575872127,32
0,863,20941,3575872095,3575872128,33
0,863,20942,3575872095,3575872130,35
0,863,20943,3575872095,3575872131,36
0,863,20944,3575872095,3575872131,36
0,863,20945,3575872095,3575872133,38
0,863,20946,3575872095,3575872134,39
0,863,20947,3575872095,3575872135,40
0,863,20948,3575872095,3575872135,40
0,863,20949,3575872095,3575872136,41
0,863,20950,3575872095,3575872136,41
0,863,20951,3575872095,3575872137,42
0,863,20952,3575872095,3575872137,42
0,863,20953,3575872095,3575872138,43
0,863,20954,3575872095,3575872138,43
0,863,20955,3575872095,3575872139,44
0,863,20956,3575872095,3575872140,45
0,863,20957,3575872095,3575872140,45
0,863,20958,3575872095,3575872141,46
0,863,20959,3575872095,3575872142,47
0,863,20960,3575872095,3575872144,49
0,864,20961,3575872155,3575872155,0
0,864,20962,3575872155,3575872155,0
0,864,20963,3575872155,3575872155,0
0,864,20964,3575872155,3575872155,0
0,864,20965,3575872155,3575872155,0
0,864,20966,3575872155,3575872155,0
0,864,20967,3575872155,3575872155,0
0,864,20968,3575872155,3575872155,0
0,864,20969,3575872155,3575872155,0
0,864,20970,3575872155,3575872155,0
0,864,20971,3575872155,3575872155,0
0,864,20972,3575872155,3575872155,0
0,864,20973,3575872155,3575872155,0
0,864,20974,3575872155,3575872155,0
0,864,20975,3575872155,3575872155,0
0,864,20976,3575872155,3575872156,1
0,864,20977,3575872155,3575872156,1
0,864,20978,3575872155,3575872159,4
0,864,20979,3575872155,3575872161,6
0,864,20980,3575872155,3575872162,7
0,864,20981,3575872155,3575872162,7
0,864,20982,3575872155,3575872162,7
0,864,20983,3575872155,3575872165,10
0,864,20984,3575872155,3575872165,10
0,864,20985,3575872155,3575872171,16
0,864,20986,3575872155,3575872171,16
0,864,20987,3575872155,3575872173,18
0,864,20988,3575872155,3575872174,19
0,864,20989,3575872155,3575872174,19
0,864,20990,3575872155,3575872175,20
0,864,20991,3575872155,3575872177,22
0,864,20992,3575872155,3575872177,22
0,864,20993,3575872155,3575872178,23
0,864,20994,3575872155,3575872178,23
0,864,20995,3575872155,3575872178,23
0,864,20996,3575872155,3575872179,24
0,864,20997,3575872155,3575872180,25
0,864,20998,3575872155,3575872182,27
0,864,20999,3575872155,3575872182,27
0,864,21000,3575872155,3575872182,27
0,864,21001,3575872155,3575872186,31
0,864,21002,3575872155,3575872189,34
0,864,21003,3575872155,3575872190,35
0,864,21004,3575872155,3575872190,35
0,864,21005,3575872155,3575872194,39
0,864,21006,3575872155,3575872196,41
0,864,21007,3575872155,3575872199,44
0,864,21008,3575872155,3575872199,44
0,865,21009,3575872214,3575872214,0
0,865,21010,3575872214,3575872214,0
0,865,21011,3575872214,3575872214,0
0,865,21012,3575872214,3575872214,0
0,865,21013,3575872214,3575872214,0
0,865,21014,3575872214,3575872214,0
0,865,21015,3575872214,3575872214,0
0,865,21016,3575872214,3575872214,0
0,865,21017,3575872214,3575872215,1
0,865,21018,3575872214,3575872216,2
0,865,21019,3575872214,3575872217,3
0,865,21020,3575872214,3575872218,4
0,865,21021,3575872214,3575872219,5
0,865,21022,3575872214,3575872221,7
0,865,21023,3575872214,3575872222,8
0,865,21024,3575872214,3575872223,9
0,865,21025,3575872214,3575872227,13
0,865,21026,3575872214,3575872228,14
0,865,21027,3575872214,3575872228,14
0,865,21028,3575872214,3575872230,16
0,865,21029,3575872214,3575872232,18
0,865,21030,3575872214,3575872232,18
0,865,21031,3575872214,3575872232,18
0,865,21032,3575872214,3575872232,18
0,865,21033,3575872214,3575872238,24
0,865,21034,3575872214,3575872238,24
0,865,21035,3575872214,3575872240,26
0,865,21036,3575872214,3575872243,29
0,865,21037,3575872214,3575872244,30
0,865,21038,3575872214,3575872246,32
0,865,21039,3575872214,3575872246,32
0,865,21040,3575872214,3575872246,32
0,865,21041,3575872214,3575872248,34
0,865,21042,3575872214,3575872248,34
0,865,21043,3575872214,3575872248,34
0,865,21044,3575872214,3575872249,35
0,865,21045,3575872214,3575872250,36
0,865,21046,3575872214,3575872251,37
0,865,21047,3575872214,3575872252,38
0,865,21048,3575872214,3575872253,39
0,865,21049,3575872214,3575872255,41
0,865,21050,3575872214,3575872256,42
0,865,21051,3575872214,3575872256,42
0,865,21052,3575872214,3575872256,42
0,865,21053,3575872214,3575872257,43
0,865,21054,3575872214,3575872258,44
0,865,21055,3575872214,3575872262,48
0,865,21056,3575872214,3575872262,48
0,865,21057,3575872214,3575872264,50
0,866,21058,3575872274,3575872274,0
0,866,21059,3575872274,3575872274,0
0,866,21060,3575872274,3575872274,0
0,866,21061,3575872274,3575872274,0
0,866,21062,3575872274,3575872274,0
0,866,21063,3575872274,3575872275,1
0,866,21064,3575872274,3575872279,5
0,866,21065,3575872274,3575872280,6
0,866,21066,3575872274,3575872282,8
0,866,21067,3575872274,3575872282,8
0,866,21068,3575872274,3575872283,9
0,866,21069,3575872274,3575872284,10
0,866,21070,3575872274,3575872285,11
0,866,21071,3575872274,3575872288,14
0,866,21072,3575872274,3575872290,16
0,866,21073,3575872274,3575872291,17
0,866,21074,3575872274,3575872291,17
0,866,21075,3575872274,3575872292,18
0,866,21076,3575872274,3575872293,19
0,866,21077,3575872274,3575872293,19
0,866,21078,3575872274,3575872295,21
0,866,21079,3575872274,3575872295,21
0,866,21080,3575872274,3575872295,21
0,866,21081,3575872274,3575872295,21
0,866,21082,3575872274,3575872295,21
0,866,21083,3575872274,3575872295,21
0,866,21084,3575872274,3575872295,21
0,866,21085,3575872274,3575872295,21
0,866,21086,3575872274,3575872295,21
0,866,21087,3575872274,3575872295,21
0,866,21088,3575872274,3575872296,22
0,866,21089,3575872274,3575872296,22
0,866,21090,3575872274,3575872297,23
0,866,21091,3575872274,3575872298,24
0,866,21092,3575872274,3575872298,24
0,866,21093,3575872274,3575872299,25
0,866,21094,3575872274,3575872300,26
0,866,21095,3575872274,3575872302,28
0,866,21096,3575872274,3575872303,29
0,866,21097,3575872274,3575872304,30
0,866,21098,3575872274,3575872304,30
0,866,21099,3575872274,3575872310,36
0,866,21100,3575872274,3575872311,37
0,866,21101,3575872274,3575872311,37
0,866,21102,3575872274,3575872312,38
0,866,21103,3575872274,3575872313,39
0,866,21104,3575872274,3575872315,41
0,866,21105,3575872274,3575872316,42
0,866,21106,3575872274,3575872316,42
0,866,21107,3575872274,3575872316,42
0,866,21108,3575872274,3575872318,44
0,866,21109,3575872274,3575872318,44
0,866,21110,3575872274,3575872320,46
0,866,21111,3575872274,3575872321,47
0,866,21112,3575872274,3575872322,48
0,866,21113,3575872274,3575872323,49
0,866,21114,3575872274,3575872323,49
0,866,21115,3575872274,3575872324,50
0,867,21116,3575872337,3575872337,0
0,867,21117,3575872337,3575872337,0
0,867,21118,3575872337,3575872337,0
0,867,21119,3575872337,3575872337,0
0,867,21120,3575872337,3575872337,0
0,867,21121,3575872337,3575872338,1
0,867,21122,3575872337,3575872338,1
0,867,21123,3575872337,3575872338,1
0,867,21124,3575872337,3575872338,1
0,867,21125,3575872337,3575872338,1
0,867,21126,3575872337,3575872338,1
0,867,21127,3575872337,3575872338,1
0,867,21128,3575872337,3575872338,1
0,867,21129,3575872337,3575872338,1
0,867,21130,3575872337,3575872338,1
0,867,21131,3575872337,3575872338,1
0,867,21132,3575872337,3575872338,1
0,867,21133,3575872337,3575872338,1
0,867,21134,3575872337,3575872338,1
0,867,21135,3575872337,3575872338,1
0,867,21136,3575872337,3575872338,1
0,867,21137,3575872337,3575872338,1
0,867,21138,3575872337,3575872338,1
0,867,21139,3575872337,3575872338,1
0,867,21140,3575872337,3575872340,3
0,867,21141,3575872337,3575872341,4
0,867,21142,3575872337,3575872343,6
0,867,21143,3575872337,3575872344,7
0,867,21144,3575872337,3575872344,7
0,867,21145,3575872337,3575872345,8
0,867,21146,3575872337,3575872345,8
0,867,21147,3575872337,3575872346,9
0,867,21148,3575872337,3575872349,12
0,867,21149,3575872337,3575872349,12
0,867,21150,3575872337,3575872349,12
0,867,21151,3575872337,3575872350,13
0,867,21152,3575872337,3575872351,14
0,867,21153,3575872337,3575872353,16
0,867,21154,3575872337,3575872354,17
0,867,21155,3575872337,3575872355,18
0,867,21156,3575872337,3575872356,19
0,867,21157,3575872337,3575872357,20
0,867,21158,3575872337,3575872357,20
0,867,21159,3575872337,3575872358,21
0,867,21160,3575872337,3575872359,22
0,867,21161,3575872337,3575872361,24
0,867,21162,3575872337,3575872362,25
0,867,21163,3575872337,3575872362,25
0,867,21164,3575872337,3575872362,25
0,867,21165,3575872337,3575872363,26
0,867,21166,3575872337,3575872365,28
0,867,21167,3575872337,3575872365,28
0,867,21168,3575872337,3575872366,29
0,867,21169,3575872337,3575872366,29
0,867,21170,3575872337,3575872370,33
0,867,21171,3575872337,3575872371,34
0,867,21172,3575872337,3575872371,34
0,867,21173,3575872337,3575872373,36
0,867,21174,3575872337,3575872374,37
0,867,21175,3575872337,3575872374,37
0,867,21176,3575872337,3575872376,39
0,867,21177,3575872337,3575872377,40
0,867,21178,3575872337,3575872377,40
0,867,21179,3575872337,3575872378,41
0,867,21180,3575872337,3575872378,41
0,867,21181,3575872337,3575872379,42
0,867,21182,3575872337,3575872380,43
0,867,21183,3575872337,3575872380,43
0,867,21184,3575872337,3575872380,43
0,867,21185,3575872337,3575872383,46
0,867,21186,3575872337,3575872383,46
0,868,21187,3575872398,3575872398,0
0,868,21188,3575872398,3575872398,0
0,868,21189,3575872398,3575872398,0
0,868,21190,3575872398,3575872398,0
0,868,21191,3575872398,3575872398,0
0,868,21192,3575872398,3575872398,0
0,868,21193,3575872398,3575872398,0
0,868,21194,3575872398,3575872399,1
0,868,21195,3575872398,3575872399,1
0,868,21196,3575872398,3575872406,8
0,868,21197,3575872398,3575872406,8
0,868,21198,3575872398,3575872408,10
0,868,21199,3575872398,3575872410,12
0,868,21200,3575872398,3575872411,13
0,868,21201,3575872398,3575872413,15
0,868,21202,3575872398,3575872414,16
0,868,21203,3575872398,3575872415,17
0,868,21204,3575872398,3575872416,18
0,868,21205,3575872398,3575872418,20
0,868,21206,3575872398,3575872419,21
0,868,21207,3575872398,3575872422,24
0,868,21208,3575872398,3575872422,24
0,868,21209,3575872398,3575872427,29
0,868,21210,3575872398,3575872429,31
0,868,21211,3575872398,3575872431,33
0,868,21212,3575872398,3575872431,33
0,868,21213,3575872398,3575872432,34
0,868,21214,3575872398,3575872432,34
0,868,21215,3575872398,3575872432,34
0,868,21216,3575872398,3575872437,39
0,868,21217,3575872398,3575872438,40
0,868,21218,3575872398,3575872440,42
0,868,21219,3575872398,3575872443,45
0,868,21220,3575872398,3575872443,45
0,868,21221,3575872398,3575872444,46
0,868,21222,3575872398,3575872446,48
0,868,21223,3575872398,3575872446,48
0,868,21224,3575872398,3575872446,48
0,868,21225,3575872398,3575872448,50
0,869,21226,3575872460,3575872460,0
0,869,21227,3575872460,3575872460,0
0,869,21228,3575872460,3575872460,0
0,869,21229,3575872460,3575872460,0
0,869,21230,3575872460,3575872460,0
0,869,21231,3575872460,3575872460,0
0,869,21232,3575872460,3575872460,0
0,869,21233,3575872460,3575872460,0
0,869,21234,3575872460,3575872460,0
0,869,21235,3575872460,3575872460,0
0,869,21236,3575872460,3575872460,0
0,869,21237,3575872460,3575872462,2
0,869,21238,3575872460,3575872462,2
0,869,21239,3575872460,3575872462,2
0,869,21240,3575872460,3575872464,4
0,869,21241,3575872460,3575872465,5
0,869,21242,3575872460,3575872467,7
0,869,21243,3575872460,3575872467,7
0,869,21244,3575872460,3575872469,9
0,869,21245,3575872460,3575872475,15
0,869,21246,3575872460,3575872481,21
0,869,21247,3575872460,3575872481,21
0,869,21248,3575872460,3575872481,21
0,869,21249,3575872460,3575872482,22
0,869,21250,3575872460,3575872482,22
0,869,21251,3575872460,3575872482,22
0,869,21252,3575872460,3575872483,23
0,869,21253,3575872460,3575872485,25
0,869,21254,3575872460,3575872489,29
0,869,21255,3575872460,3575872490,30
0,869,21256,3575872460,3575872490,30
0,869,21257,3575872460,3575872491,31
0,869,21258,3575872460,3575872491,31
0,869,21259,3575872460,3575872494,34
0,869,21260,3575872460,3575872494,34
0,869,21261,3575872460,3575872494,34
0,869,21262,3575872460,3575872494,34
0,869,21263,3575872460,3575872494,34
0,869,21264,3575872460,3575872495,35
0,869,21265,3575872460,3575872495,35
0,869,21266,3575872460,3575872495,35
0,869,21267,3575872460,3575872495,35
0,869,21268,3575872460,3575872495,35
0,869,21269,3575872460,3575872495,35
0,869,21270,3575872460,3575872495,35
0,869,21271,3575872460,3575872496,36
0,869,21272,3575872460,3575872496,36
0,869,21273,3575872460,3575872497,37
0,869,21274,3575872460,3575872498,38
0,869,21275,3575872460,3575872498,38
0,869,21276,3575872460,3575872498,38
0,869,21277,3575872460,3575872499,39
0,869,21278,3575872460,3575872501,41
0,869,21279,3575872460,3575872502,42
0,869,21280,3575872460,3575872502,42
0,869,21281,3575872460,3575872504,44
0,869,21282,3575872460,3575872510,50
0,870,21283,3575872519,3575872519,0
0,870,21284,3575872519,3575872520,1
0,870,21285,3575872519,3575872520,1
0,870,21286,3575872519,3575872520,1
0,870,21287,3575872519,3575872520,1
0,870,21288,3575872519,3575872520,1
0,870,21289,3575872519,3575872520,1
0,870,21290,3575872519,3575872520,1
0,870,21291,3575872519,3575872520,1
0,870,21292,3575872519,3575872520,1
0,870,21293,3575872519,3575872520,1
0,870,21294,3575872519,3575872520,1
0,870,21295,3575872519,3575872520,1
0,870,21296,3575872519,3575872521,2
0,870,21297,3575872519,3575872522,3
0,870,21298,3575872519,3575872523,4
0,870,21299,3575872519,3575872523,4
0,870,21300,3575872519,3575872523,4
0,870,21301,3575872519,3575872524,5
0,870,21302,3575872519,3575872524,5
0,870,21303,3575872519,3575872524,5
0,870,21304,3575872519,3575872526,7
0,870,21305,3575872519,3575872526,7
0,870,21306,3575872519,3575872526,7
0,870,21307,3575872519,3575872527,8
0,870,21308,3575872519,3575872527,8
0,870,21309,3575872519,3575872528,9
0,870,21310,3575872519,3575872529,10
0,870,21311,3575872519,3575872530,11
0,870,21312,3575872519,3575872531,12
0,870,21313,3575872519,3575872532,13
0,870,21314,3575872519,3575872533,14
0,870,21315,3575872519,3575872535,16
0,870,21316,3575872519,3575872536,17
0,870,21317,3575872519,3575872536,17
0,870,21318,3575872519,3575872537,18
0,870,21319,3575872519,3575872537,18
0,870,21320,3575872519,3575872537,18
0,870,21321,3575872519,3575872538,19
0,870,21322,3575872519,3575872538,19
0,870,21323,3575872519,3575872539,20
0,870,21324,3575872519,3575872539,20
0,870,21325,3575872519,3575872539,20
0,870,21326,3575872519,3575872540,21
0,870,21327,3575872519,3575872542,23
0,870,21328,3575872519,3575872542,23
0,870,21329,3575872519,3575872542,23
0,870,21330,3575872519,3575872544,25
0,870,21331,3575872519,3575872544,25
0,870,21332,3575872519,3575872545,26
0,870,21333,3575872519,3575872546,27
0,870,21334,3575872519,3575872547,28
0,870,21335,3575872519,3575872548,29
0,870,21336,3575872519,3575872549,30
0,870,21337,3575872519,3575872550,31
0,870,21338,3575872519,3575872551,32
0,870,21339,3575872519,3575872553,34
0,870,21340,3575872519,3575872554,35
0,870,21341,3575872519,3575872554,35
0,870,21342,3575872519,3575872554,35
0,870,21343,3575872519,3575872555,36
0,870,21344,3575872519,3575872555,36
0,870,21345,3575872519,3575872556,37
0,870,21346,3575872519,3575872556,37
0,870,21347,3575872519,3575872557,38
0,870,21348,3575872519,3575872558,39
0,870,21349,3575872519,3575872560,41
0,870,21350,3575872519,3575872561,42
0,870,21351,3575872519,3575872561,42
0,870,21352,3575872519,3575872562,43
0,870,21353,3575872519,3575872562,43
0,870,21354,3575872519,3575872564,45
0,870,21355,3575872519,3575872565,46
0,870,21356,3575872519,3575872565,46
0,870,21357,3575872519,3575872566,47
0,870,21358,3575872519,3575872568,49
0,871,21359,3575872581,3575872581,0
0,871,21360,3575872581,3575872581,0
0,871,21361,3575872581,3575872581,0
0,871,21362,3575872581,3575872581,0
0,871,21363,3575872581,3575872581,0
0,871,21364,3575872581,3575872581,0
0,871,21365,3575872581,3575872581,0
0,871,21366,3575872581,3575872581,0
0,871,21367,3575872581,3575872581,0
0,871,21368,3575872581,3575872581,0
0,871,21369,3575872581,3575872581,0
0,871,21370,3575872581,3575872581,0
0,871,21371,3575872581,3575872581,0
0,871,21372,3575872581,3575872582,1
0,871,21373,3575872581,3575872586,5
0,871,21374,3575872581,3575872588,7
0,871,21375,3575872581,3575872588,7
0,871,21376,3575872581,3575872588,7
0,871,21377,3575872581,3575872588,7
0,871,21378,3575872581,3575872594,13
0,871,21379,3575872581,3575872595,14
0,871,21380,3575872581,3575872597,16
0,871,21381,3575872581,3575872598,17
0,871,21382,3575872581,3575872603,22
0,871,21383,3575872581,3575872605,24
0,871,21384,3575872581,3575872605,24
0,871,21385,3575872581,3575872607,26
0,871,21386,3575872581,3575872607,26
0,871,21387,3575872581,3575872609,28
0,871,21388,3575872581,3575872610,29
0,871,21389,3575872581,3575872613,32
0,871,21390,3575872581,3575872613,32
0,871,21391,3575872581,3575872613,32
0,871,21392,3575872581,3575872615,34
0,871,21393,3575872581,3575872615,34
0,871,21394,3575872581,3575872617,36
0,871,21395,3575872581,3575872618,37
0,871,21396,3575872581,3575872621,40
0,871,21397,3575872581,3575872622,41
0,871,21398,3575872581,3575872622,41
0,871,21399,3575872581,3575872627,46
0,871,21400,3575872581,3575872630,49
0,871,21401,3575872581,3575872630,49
0,871,21402,3575872581,3575872631,50
0,872,21403,3575872641,3575872641,0
0,872,21404,3575872641,3575872641,0
0,872,21405,3575872641,3575872641,0
0,872,21406,3575872641,3575872641,0
0,872,21407,3575872641,3575872641,0
0,872,21408,3575872641,3575872641,0
0,872,21409,3575872641,3575872642,1
0,872,21410,3575872641,3575872645,4
0,872,21411,3575872641,3575872645,4
0,872,21412,3575872641,3575872646,5
0,872,21413,3575872641,3575872646,5
0,872,21414,3575872641,3575872647,6
0,872,21415,3575872641,3575872648,7
0,872,21416,3575872641,3575872649,8
0,872,21417,3575872641,3575872651,10
0,872,21418,3575872641,3575872651,10
0,872,21419,3575872641,3575872652,11
0,872,21420,3575872641,3575872652,11
0,872,21421,3575872641,3575872656,15
0,872,21422,3575872641,3575872657,16
0,872,21423,3575872641,3575872657,16
0,872,21424,3575872641,3575872658,17
0,872,21425,3575872641,3575872661,20
0,872,21426,3575872641,3575872662,21
0,872,21427,3575872641,3575872662,21
0,872,21428,3575872641,3575872664,23
0,872,21429,3575872641,3575872664,23
0,872,21430,3575872641,3575872665,24
0,872,21431,3575872641,3575872666,25
0,872,21432,3575872641,3575872668,27
0,872,21433,3575872641,3575872675,34
0,872,21434,3575872641,3575872680,39
0,872,21435,3575872641,3575872680,39
0,872,21436,3575872641,3575872682,41
0,872,21437,3575872641,3575872682,41
0,872,21438,3575872641,3575872683,42
0,872,21439,3575872641,3575872685,44
0,872,21440,3575872641,3575872686,45
0,872,21441,3575872641,3575872688,47
0,872,21442,3575872641,3575872689,48
0,872,21443,3575872641,3575872690,49
0,872,21444,3575872641,3575872691,50
0,873,21445,3575872704,3575872704,0
0,873,21446,3575872704,3575872704,0
0,873,21447,3575872704,3575872704,0
0,873,21448,3575872704,3575872704,0
0,873,21449,3575872704,3575872704,0
0,873,21450,3575872704,3575872704,0
0,873,21451,3575872704,3575872704,0
0,873,21452,3575872704,3575872704,0
0,873,21453,3575872704,3575872704,0
0,873,21454,3575872704,3575872704,0
0,873,21455,3575872704,3575872704,0
0,873,21456,3575872704,3575872704,0
0,873,21457,3575872704,3575872704,0
0,873,21458,3575872704,3575872704,0
0,873,21459,3575872704,3575872704,0
0,873,21460,3575872704,3575872704,0
0,873,21461,3575872704,3575872704,0
0,873,21462,3575872704,3575872704,0
0,873,21463,3575872704,3575872704,0
0,873,21464,3575872704,3575872704,0
0,873,21465,3575872704,3575872704,0
0,873,21466,3575872704,3575872704,0
0,873,21467,3575872704,3575872704,0
0,873,21468,3575872704,3575872704,0
0,873,21469,3575872704,3575872704,0
0,873,21470,3575872704,3575872710,6
0,873,21471,3575872704,3575872711,7
0,873,21472,3575872704,3575872711,7
0,873,21473,3575872704,3575872712,8
0,873,21474,3575872704,3575872712,8
0,873,21475,3575872704,3575872713,9
0,873,21476,3575872704,3575872714,10
0,873,21477,3575872704,3575872715,11
0,873,21478,3575872704,3575872715,11
0,873,21479,3575872704,3575872716,12
0,873,21480,3575872704,3575872718,14
0,873,21481,3575872704,3575872718,14
0,873,21482,3575872704,3575872720,16
0,873,21483,3575872704,3575872720,16
0,873,21484,3575872704,3575872720,16
0,873,21485,3575872704,3575872722,18
0,873,21486,3575872704,3575872722,18
0,873,21487,3575872704,3575872723,19
0,873,21488,3575872704,3575872723,19
0,873,21489,3575872704,3575872723,19
0,873,21490,3575872704,3575872723,19
0,873,21491,3575872704,3575872724,20
0,873,21492,3575872704,3575872725,21
0,873,21493,3575872704,3575872725,21
0,873,21494,3575872704,3575872726,22
0,873,21495,3575872704,3575872727,23
0,873,21496,3575872704,3575872727,23
0,873,21497,3575872704,3575872727,23
0,873,21498,3575872704,3575872729,25
0,873,21499,3575872704,3575872730,26
0,873,21500,3575872704,3575872731,27
0,873,21501,3575872704,3575872731,27
0,873,21502,3575872704,3575872732,28
0,873,21503,3575872704,3575872733,29
0,873,21504,3575872704,3575872735,31
0,873,21505,3575872704,3575872736,32
0,873,21506,3575872704,3575872736,32
0,873,21507,3575872704,3575872737,33
0,873,21508,3575872704,3575872737,33
0,873,21509,3575872704,3575872737,33
0,873,21510,3575872704,3575872738,34
0,873,21511,3575872704,3575872738,34
0,873,21512,3575872704,3575872738,34
0,873,21513,3575872704,3575872739,35
0,873,21514,3575872704,3575872739,35
0,873,21515,3575872704,3575872741,37
0,873,21516,3575872704,3575872742,38
0,873,21517,3575872704,3575872742,38
0,873,21518,3575872704,3575872743,39
0,873,21519,3575872704,3575872744,40
0,873,21520,3575872704,3575872744,40
0,873,21521,3575872704,3575872746,42
0,873,21522,3575872704,3575872747,43
0,873,21523,3575872704,3575872748,44
0,873,21524,3575872704,3575872748,44
0,873,21525,3575872704,3575872749,45
0,873,21526,3575872704,3575872750,46
0,873,21527,3575872704,3575872750,46
0,873,21528,3575872704,3575872752,48
0,873,21529,3575872704,3575872753,49
0,873,21530,3575872704,3575872754,50
0,873,21531,3575872704,3575872754,50
0,874,21532,3575872765,3575872765,0
0,874,21533,3575872765,3575872765,0
0,874,21534,3575872765,3575872765,0
0,874,21535,3575872765,3575872765,0
0,874,21536,3575872765,3575872765,0
0,874,21537,3575872765,3575872765,0
0,874,21538,3575872765,3575872765,0
0,874,21539,3575872765,3575872765,0
0,874,21540,3575872765,3575872765,0
0,874,21541,3575872765,3575872765,0
0,874,21542,3575872765,3575872765,0
0,874,21543,3575872765,3575872765,0
0,874,21544,3575872765,3575872765,0
0,874,21545,3575872765,3575872765,0
0,874,21546,3575872765,3575872766,1
0,874,21547,3575872765,3575872768,3
0,874,21548,3575872765,3575872770,5
0,874,21549,3575872765,3575872770,5
0,874,21550,3575872765,3575872773,8
0,874,21551,3575872765,3575872774,9
0,874,21552,3575872765,3575872776,11
0,874,21553,3575872765,3575872777,12
0,874,21554,3575872765,3575872777,12
0,874,21555,3575872765,3575872778,13
0,874,21556,3575872765,3575872779,14
0,874,21557,3575872765,3575872780,15
0,874,21558,3575872765,3575872780,15
0,874,21559,3575872765,3575872782,17
0,874,21560,3575872765,3575872787,22
0,874,21561,3575872765,3575872788,23
0,874,21562,3575872765,3575872789,24
0,874,21563,3575872765,3575872789,24
0,874,21564,3575872765,3575872789,24
0,874,21565,3575872765,3575872792,27
0,874,21566,3575872765,3575872794,29
0,874,21567,3575872765,3575872795,30
0,874,21568,3575872765,3575872798,33
0,874,21569,3575872765,3575872799,34
0,874,21570,3575872765,3575872804,39
0,874,21571,3575872765,3575872805,40
0,874,21572,3575872765,3575872805,40
0,874,21573,3575872765,3575872806,41
0,874,21574,3575872765,3575872807,42
0,874,21575,3575872765,3575872809,44
0,874,21576,3575872765,3575872811,46
0,874,21577,3575872765,3575872813,48
0,874,21578,3575872765,3575872813,48
0,874,21579,3575872765,3575872814,49
0,875,21580,3575872824,3575872824,0
0,875,21581,3575872824,3575872824,0
0,875,21582,3575872824,3575872824,0
0,875,21583,3575872824,3575872824,0
0,875,21584,3575872824,3575872824,0
0,875,21585,3575872824,3575872824,0
0,875,21586,3575872824,3575872825,1
0,875,21587,3575872824,3575872826,2
0,875,21588,3575872824,3575872830,6
0,875,21589,3575872824,3575872831,7
0,875,21590,3575872824,3575872832,8
0,875,21591,3575872824,3575872832,8
0,875,21592,3575872824,3575872832,8
0,875,21593,3575872824,3575872836,12
0,875,21594,3575872824,3575872838,14
0,875,21595,3575872824,3575872840,16
0,875,21596,3575872824,3575872842,18
0,875,21597,3575872824,3575872843,19
0,875,21598,3575872824,3575872844,20
0,875,21599,3575872824,3575872844,20
0,875,21600,3575872824,3575872845,21
0,875,21601,3575872824,3575872845,21
0,875,21602,3575872824,3575872845,21
0,875,21603,3575872824,3575872847,23
0,875,21604,3575872824,3575872847,23
0,875,21605,3575872824,3575872848,24
0,875,21606,3575872824,3575872850,26
0,875,21607,3575872824,3575872851,27
0,875,21608,3575872824,3575872851,27
0,875,21609,3575872824,3575872852,28
0,875,21610,3575872824,3575872855,31
0,875,21611,3575872824,3575872857,33
0,875,21612,3575872824,3575872858,34
0,875,21613,3575872824,3575872858,34
0,875,21614,3575872824,3575872861,37
0,875,21615,3575872824,3575872862,38
0,875,21616,3575872824,3575872862,38
0,875,21617,3575872824,3575872864,40
0,875,21618,3575872824,3575872864,40
0,875,21619,3575872824,3575872866,42
0,875,21620,3575872824,3575872867,43
0,875,21621,3575872824,3575872869,45
0,876,21622,3575872881,3575872881,0
0,876,21623,3575872881,3575872881,0
0,876,21624,3575872881,3575872882,1
0,876,21625,3575872881,3575872882,1
0,876,21626,3575872881,3575872882,1
0,876,21627,3575872881,3575872883,2
0,876,21628,3575872881,3575872884,3
0,876,21629,3575872881,3575872885,4
0,876,21630,3575872881,3575872885,4
0,876,21631,3575872881,3575872888,7
0,876,21632,3575872881,3575872889,8
0,876,21633,3575872881,3575872890,9
0,876,21634,3575872881,3575872891,10
0,876,21635,3575872881,3575872891,10
0,876,21636,3575872881,3575872891,10
0,876,21637,3575872881,3575872893,12
0,876,21638,3575872881,3575872894,13
0,876,21639,3575872881,3575872895,14
0,876,21640,3575872881,3575872895,14
0,876,21641,3575872881,3575872895,14
0,876,21642,3575872881,3575872895,14
0,876,21643,3575872881,3575872895,14
0,876,21644,3575872881,3575872895,14
0,876,21645,3575872881,3575872895,14
0,876,21646,3575872881,3575872895,14
0,876,21647,3575872881,3575872896,15
0,876,21648,3575872881,3575872897,16
0,876,21649,3575872881,3575872897,16
0,876,21650,3575872881,3575872897,16
0,876,21651,3575872881,3575872898,17
0,876,21652,3575872881,3575872898,17
0,876,21653,3575872881,3575872898,17
0,876,21654,3575872881,3575872899,18
0,876,21655,3575872881,3575872899,18
0,876,21656,3575872881,3575872902,21
0,876,21657,3575872881,3575872902,21
0,876,21658,3575872881,3575872903,22
0,876,21659,3575872881,3575872904,23
0,876,21660,3575872881,3575872910,29
0,876,21661,3575872881,3575872911,30
0,876,21662,3575872881,3575872912,31
0,876,21663,3575872881,3575872912,31
0,876,21664,3575872881,3575872913,32
0,876,21665,3575872881,3575872913,32
0,876,21666,3575872881,3575872914,33
0,876,21667,3575872881,3575872916,35
0,876,21668,3575872881,3575872916,35
0,876,21669,3575872881,3575872916,35
0,876,21670,3575872881,3575872918,37
0,876,21671,3575872881,3575872918,37
0,876,21672,3575872881,3575872920,39
0,876,21673,3575872881,3575872920,39
0,876,21674,3575872881,3575872920,39
0,876,21675,3575872881,3575872922,41
0,876,21676,3575872881,3575872922,41
0,876,21677,3575872881,3575872922,41
0,876,21678,3575872881,3575872923,42
0,876,21679,3575872881,3575872924,43
0,876,21680,3575872881,3575872924,43
0,876,21681,3575872881,3575872924,43
0,876,21682,3575872881,3575872925,44
0,876,21683,3575872881,3575872925,44
0,876,21684,3575872881,3575872927,46
0,876,21685,3575872881,3575872927,46
0,876,21686,3575872881,3575872927,46
0,876,21687,3575872881,3575872928,47
0,876,21688,3575872881,3575872928,47
0,876,21689,3575872881,3575872930,49
0,877,21690,3575872938,3575872938,0
0,877,21691,3575872938,3575872938,0
0,877,21692,3575872938,3575872938,0
0,877,21693,3575872938,3575872938,0
0,877,21694,3575872938,3575872938,0
0,877,21695,3575872938,3575872938,0
0,877,21696,3575872938,3575872938,0
0,877,21697,3575872938,3575872938,0
0,877,21698,3575872938,3575872938,0
0,877,21699,3575872938,3575872938,0
0,877,21700,3575872938,3575872938,0
0,877,21701,3575872938,3575872938,0
0,877,21702,3575872938,3575872939,1
0,877,21703,3575872938,3575872939,1
0,877,21704,3575872938,3575872940,2
0,877,21705,3575872938,3575872942,4
0,877,21706,3575872938,3575872943,5
0,877,21707,3575872938,3575872944,6
0,877,21708,3575872938,3575872944,6
0,877,21709,3575872938,3575872944,6
0,877,21710,3575872938,3575872945,7
0,877,21711,3575872938,3575872946,8
0,877,21712,3575872938,3575872946,8
0,877,21713,3575872938,3575872947,9
0,877,21714,3575872938,3575872948,10
0,877,21715,3575872938,3575872948,10
0,877,21716,3575872938,3575872950,12
0,877,21717,3575872938,3575872950,12
0,877,21718,3575872938,3575872950,12
0,877,21719,3575872938,3575872952,14
0,877,21720,3575872938,3575872954,16
0,877,21721,3575872938,3575872954,16
0,877,21722,3575872938,3575872955,17
0,877,21723,3575872938,3575872955,17
0,877,21724,3575872938,3575872955,17
0,877,21725,3575872938,3575872956,18
0,877,21726,3575872938,3575872958,20
0,877,21727,3575872938,3575872958,20
0,877,21728,3575872938,3575872959,21
0,877,21729,3575872938,3575872960,22
0,877,21730,3575872938,3575872962,24
0,877,21731,3575872938,3575872962,24
0,877,21732,3575872938,3575872962,24
0,877,21733,3575872938,3575872962,24
0,877,21734,3575872938,3575872964,26
0,877,21735,3575872938,3575872964,26
0,877,21736,3575872938,3575872964,26
0,877,21737,3575872938,3575872965,27
0,877,21738,3575872938,3575872966,28
0,877,21739,3575872938,3575872968,30
0,877,21740,3575872938,3575872970,32
0,877,21741,3575872938,3575872971,33
0,877,21742,3575872938,3575872973,35
0,877,21743,3575872938,3575872973,35
0,877,21744,3575872938,3575872974,36
0,877,21745,3575872938,3575872977,39
0,877,21746,3575872938,3575872977,39
0,877,21747,3575872938,3575872977,39
0,877,21748,3575872938,3575872978,40
0,877,21749,3575872938,3575872979,41
0,877,21750,3575872938,3575872979,41
0,877,21751,3575872938,3575872980,42
0,877,21752,3575872938,3575872981,43
0,877,21753,3575872938,3575872982,44
0,877,21754,3575872938,3575872982,44
0,877,21755,3575872938,3575872987,49
0,878,21756,3575872996,3575872996,0
0,878,21757,3575872996,3575872996,0
0,878,21758,3575872996,3575872996,0
0,878,21759,3575872996,3575872996,0
0,878,21760,3575872996,3575872996,0
0,878,21761,3575872996,3575872997,1
0,878,21762,3575872996,3575872998,2
0,878,21763,3575872996,3575872998,2
0,878,21764,3575872996,3575872999,3
0,878,21765,3575872996,3575873004,8
0,878,21766,3575872996,3575873004,8
0,878,21767,3575872996,3575873005,9
0,878,21768,3575872996,3575873006,10
0,878,21769,3575872996,3575873010,14
0,878,21770,3575872996,3575873011,15
0,878,21771,3575872996,3575873013,17
0,878,21772,3575872996,3575873013,17
0,878,21773,3575872996,3575873015,19
0,878,21774,3575872996,3575873015,19
0,878,21775,3575872996,3575873016,20
0,878,21776,3575872996,3575873018,22
0,878,21777,3575872996,3575873018,22
0,878,21778,3575872996,3575873020,24
0,878,21779,3575872996,3575873022,26
0,878,21780,3575872996,3575873023,27
0,878,21781,3575872996,3575873023,27
0,878,21782,3575872996,3575873025,29
0,878,21783,3575872996,3575873027,31
0,878,21784,3575872996,3575873030,34
0,878,21785,3575872996,3575873030,34
0,878,21786,3575872996,3575873032,36
0,878,21787,3575872996,3575873032,36
0,878,21788,3575872996,3575873033,37
0,878,21789,3575872996,3575873033,37
0,878,21790,3575872996,3575873038,42
0,878,21791,3575872996,3575873038,42
0,878,21792,3575872996,3575873040,44
0,878,21793,3575872996,3575873042,46
0,878,21794,3575872996,3575873044,48
0,878,21795,3575872996,3575873044,48
0,878,21796,3575872996,3575873046,50
0,879,21797,3575873058,3575873058,0
0,879,21798,3575873058,3575873058,0
0,879,21799,3575873058,3575873058,0
0,879,21800,3575873058,3575873058,0
0,879,21801,3575873058,3575873058,0
0,879,21802,3575873058,3575873058,0
0,879,21803,3575873058,3575873058,0
0,879,21804,3575873058,3575873058,0
0,879,21805,3575873058,3575873058,0
0,879,21806,3575873058,3575873058,0
0,879,21807,3575873058,3575873058,0
0,879,21808,3575873058,3575873058,0
0,879,21809,3575873058,3575873058,0
0,879,21810,3575873058,3575873058,0
0,879,21811,3575873058,3575873059,1
0,879,21812,3575873058,3575873059,1
0,879,21813,3575873058,3575873061,3
0,879,21814,3575873058,3575873061,3
0,879,21815,3575873058,3575873062,4
0,879,21816,3575873058,3575873064,6
0,879,21817,3575873058,3575873065,7
0,879,21818,3575873058,3575873066,8
0,879,21819,3575873058,3575873067,9
0,879,21820,3575873058,3575873069,11
0,879,21821,3575873058,3575873070,12
0,879,21822,3575873058,3575873077,19
0,879,21823,3575873058,3575873080,22
0,879,21824,3575873058,3575873080,22
0,879,21825,3575873058,3575873082,24
0,879,21826,3575873058,3575873083,25
0,879,21827,3575873058,3575873083,25
0,879,21828,3575873058,3575873084,26
0,879,21829,3575873058,3575873085,27
0,879,21830,3575873058,3575873086,28
0,879,21831,3575873058,3575873088,30
0,879,21832,3575873058,3575873089,31
0,879,21833,3575873058,3575873090,32
0,879,21834,3575873058,3575873091,33
0,879,21835,3575873058,3575873091,33
0,879,21836,3575873058,3575873092,34
0,879,21837,3575873058,3575873092,34
0,879,21838,3575873058,3575873094,36
0,879,21839,3575873058,3575873094,36
0,879,21840,3575873058,3575873095,37
0,879,21841,3575873058,3575873095,37
0,879,21842,3575873058,3575873095,37
0,879,21843,3575873058,3575873095,37
0,879,21844,3575873058,3575873095,37
0,879,21845,3575873058,3575873095,37
0,879,21846,3575873058,3575873096,38
0,879,21847,3575873058,3575873096,38
0,879,21848,3575873058,3575873096,38
0,879,21849,3575873058,3575873096,38
0,879,21850,3575873058,3575873097,39
0,879,21851,3575873058,3575873097,39
0,879,21852,3575873058,3575873097,39
0,879,21853,3575873058,3575873098,40
0,879,21854,3575873058,3575873098,40
0,879,21855,3575873058,3575873098,40
0,879,21856,3575873058,3575873099,41
0,879,21857,3575873058,3575873100,42
0,879,21858,3575873058,3575873102,44
0,879,21859,3575873058,3575873104,46
0,879,21860,3575873058,3575873105,47
0,880,21861,3575873121,3575873121,0
0,880,21862,3575873121,3575873121,0
0,880,21863,3575873121,3575873121,0
0,880,21864,3575873121,3575873121,0
0,880,21865,3575873121,3575873121,0
0,880,21866,3575873121,3575873121,0
0,880,21867,3575873121,3575873121,0
0,880,21868,3575873121,3575873121,0
0,880,21869,3575873121,3575873121,0
0,880,21870,3575873121,3575873121,0
0,880,21871,3575873121,3575873121,0
0,880,21872,3575873121,3575873121,0
0,880,21873,3575873121,3575873121,0
0,880,21874,3575873121,3575873121,0
0,880,21875,3575873121,3575873121,0
0,880,21876,3575873121,3575873122,1
0,880,21877,3575873121,3575873122,1
0,880,21878,3575873121,3575873123,2
0,880,21879,3575873121,3575873123,2
0,880,21880,3575873121,3575873124,3
0,880,21881,3575873121,3575873124,3
0,880,21882,3575873121,3575873124,3
0,880,21883,3575873121,3575873127,6
0,880,21884,3575873121,3575873127,6
0,880,21885,3575873121,3575873128,7
0,880,21886,3575873121,3575873129,8
0,880,21887,3575873121,3575873129,8
0,880,21888,3575873121,3575873130,9
0,880,21889,3575873121,3575873131,10
0,880,21890,3575873121,3575873133,12
0,880,21891,3575873121,3575873133,12
0,880,21892,3575873121,3575873135,14
0,880,21893,3575873121,3575873136,15
0,880,21894,3575873121,3575873136,15
0,880,21895,3575873121,3575873137,16
0,880,21896,3575873121,3575873137,16
0,880,21897,3575873121,3575873138,17
0,880,21898,3575873121,3575873138,17
0,880,21899,3575873121,3575873139,18
0,880,21900,3575873121,3575873139,18
0,880,21901,3575873121,3575873139,18
0,880,21902,3575873121,3575873141,20
0,880,21903,3575873121,3575873143,22
0,880,21904,3575873121,3575873144,23
0,880,21905,3575873121,3575873145,24
0,880,21906,3575873121,3575873145,24
0,880,21907,3575873121,3575873145,24
0,880,21908,3575873121,3575873146,25
0,880,21909,3575873121,3575873148,27
0,880,21910,3575873121,3575873148,27
0,880,21911,3575873121,3575873149,28
0,880,21912,3575873121,3575873150,29
0,880,21913,3575873121,3575873150,29
0,880,21914,3575873121,3575873151,30
0,880,21915,3575873121,3575873152,31
0,880,21916,3575873121,3575873154,33
0,880,21917,3575873121,3575873154,33
0,880,21918,3575873121,3575873155,34
0,880,21919,3575873121,3575873155,34
0,880,21920,3575873121,3575873155,34
0,880,21921,3575873121,3575873156,35
0,880,21922,3575873121,3575873158,37
0,880,21923,3575873121,3575873159,38
0,880,21924,3575873121,3575873159,38
0,880,21925,3575873121,3575873160,39
0,880,21926,3575873121,3575873161,40
0,880,21927,3575873121,3575873162,41
0,880,21928,3575873121,3575873162,41
0,880,21929,3575873121,3575873162,41
0,880,21930,3575873121,3575873163,42
0,880,21931,3575873121,3575873164,43
0,880,21932,3575873121,3575873165,44
0,880,21933,3575873121,3575873165,44
0,880,21934,3575873121,3575873166,45
0,880,21935,3575873121,3575873166,45
0,880,21936,3575873121,3575873168,47
0,880,21937,3575873121,3575873170,49
0,880,21938,3575873121,3575873171,50
0,881,21939,3575873180,3575873180,0
0,881,21940,3575873180,3575873180,0
0,881,21941,3575873180,3575873180,0
0,881,21942,3575873180,3575873180,0
0,881,21943,3575873180,3575873180,0
0,881,21944,3575873180,3575873180,0
0,881,21945,3575873180,3575873180,0
0,881,21946,3575873180,3575873180,0
0,881,21947,3575873180,3575873180,0
0,881,21948,3575873180,3575873181,1
0,881,21949,3575873180,3575873182,2
0,881,21950,3575873180,3575873182,2
0,881,21951,3575873180,3575873187,7
0,881,21952,3575873180,3575873189,9
0,881,21953,3575873180,3575873189,9
0,881,21954,3575873180,3575873189,9
0,881,21955,3575873180,3575873189,9
0,881,21956,3575873180,3575873194,14
0,881,21957,3575873180,3575873195,15
0,881,21958,3575873180,3575873198,18
0,881,21959,3575873180,3575873199,19
0,881,21960,3575873180,3575873199,19
0,881,21961,3575873180,3575873202,22
0,881,21962,3575873180,3575873204,24
0,881,21963,3575873180,3575873205,25
0,881,21964,3575873180,3575873205,25
0,881,21965,3575873180,3575873207,27
0,881,21966,3575873180,3575873208,28
0,881,21967,3575873180,3575873209,29
0,881,21968,3575873180,3575873211,31
0,881,21969,3575873180,3575873213,33
0,881,21970,3575873180,3575873213,33
0,881,21971,3575873180,3575873215,35
0,881,21972,3575873180,3575873215,35
0,881,21973,3575873180,3575873218,38
0,881,21974,3575873180,3575873218,38
0,881,21975,3575873180,3575873222,42
0,881,21976,3575873180,3575873223,43
0,881,21977,3575873180,3575873224,44
0,881,21978,3575873180,3575873226,46
0,881,21979,3575873180,3575873226,46
0,881,21980,3575873180,3575873228,48
0,881,21981,3575873180,3575873229,49
0,881,21982,3575873180,3575873229,49
0,882,21983,3575873241,3575873241,0
0,882,21984,3575873241,3575873241,0
0,882,21985,3575873241,3575873241,0
0,882,21986,3575873241,3575873241,0
0,882,21987,3575873241,3575873241,0
0,882,21988,3575873241,3575873241,0
0,882,21989,3575873241,3575873241,0
0,882,21990,3575873241,3575873241,0
0,882,21991,3575873241,3575873242,1
0,882,21992,3575873241,3575873243,2
0,882,21993,3575873241,3575873244,3
0,882,21994,3575873241,3575873245,4
0,882,21995,3575873241,3575873246,5
0,882,21996,3575873241,3575873246,5
0,882,21997,3575873241,3575873247,6
0,882,21998,3575873241,3575873248,7
0,882,21999,3575873241,3575873250,9
0,882,22000,3575873241,3575873251,10
0,882,22001,3575873241,3575873252,11
0,882,22002,3575873241,3575873253,12
0,882,22003,3575873241,3575873255,14
0,882,22004,3575873241,3575873256,15
0,882,22005,3575873241,3575873256,15
0,882,22006,3575873241,3575873257,16
0,882,22007,3575873241,3575873257,16
0,882,22008,3575873241,3575873257,16
0,882,22009,3575873241,3575873258,17
0,882,22010,3575873241,3575873258,17
0,882,22011,3575873241,3575873259,18
0,882,22012,3575873241,3575873261,20
0,882,22013,3575873241,3575873261,20
0,882,22014,3575873241,3575873261,20
0,882,22015,3575873241,3575873265,24
0,882,22016,3575873241,3575873266,25
0,882,22017,3575873241,3575873267,26
0,882,22018,3575873241,3575873269,28
0,882,22019,3575873241,3575873276,35
0,882,22020,3575873241,3575873280,39
0,882,22021,3575873241,3575873280,39
0,882,22022,3575873241,3575873282,41
0,882,22023,3575873241,3575873282,41
0,882,22024,3575873241,3575873282,41
0,882,22025,3575873241,3575873283,42
0,882,22026,3575873241,3575873284,43
0,882,22027,3575873241,3575873284,43
0,882,22028,3575873241,3575873285,44
0,882,22029,3575873241,3575873288,47
0,882,22030,3575873241,3575873290,49
0,882,22031,3575873241,3575873291,50
0,883,22032,3575873300,3575873300,0
0,883,22033,3575873300,3575873300,0
0,883,22034,3575873300,3575873300,0
0,883,22035,3575873300,3575873300,0
0,883,22036,3575873300,3575873300,0
0,883,22037,3575873300,3575873300,0
0,883,22038,3575873300,3575873300,0
0,883,22039,3575873300,3575873300,0
0,883,22040,3575873300,3575873300,0
0,883,22041,3575873300,3575873300,0
0,883,22042,3575873300,3575873300,0
0,883,22043,3575873300,3575873300,0
0,883,22044,3575873300,3575873300,0
0,883,22045,3575873300,3575873300,0
0,883,22046,3575873300,3575873300,0
0,883,22047,3575873300,3575873300,0
0,883,22048,3575873300,3575873300,0
0,883,22049,3575873300,3575873300,0
0,883,22050,3575873300,3575873300,0
0,883,22051,3575873300,3575873300,0
0,883,22052,3575873300,3575873301,1
0,883,22053,3575873300,3575873302,2
0,883,22054,3575873300,3575873302,2
0,883,22055,3575873300,3575873303,3
0,883,22056,3575873300,3575873303,3
0,883,22057,3575873300,3575873304,4
0,883,22058,3575873300,3575873310,10
0,883,22059,3575873300,3575873311,11
0,883,22060,3575873300,3575873313,13
0,883,22061,3575873300,3575873313,13
0,883,22062,3575873300,3575873313,13
0,883,22063,3575873300,3575873314,14
0,883,22064,3575873300,3575873315,15
0,883,22065,3575873300,3575873316,16
0,883,22066,3575873300,3575873317,17
0,883,22067,3575873300,3575873317,17
0,883,22068,3575873300,3575873317,17
0,883,22069,3575873300,3575873319,19
0,883,22070,3575873300,3575873319,19
0,883,22071,3575873300,3575873320,20
0,883,22072,3575873300,3575873320,20
0,883,22073,3575873300,3575873321,21
0,883,22074,3575873300,3575873323,23
0,883,22075,3575873300,3575873323,23
0,883,22076,3575873300,3575873323,23
0,883,22077,3575873300,3575873325,25
0,883,22078,3575873300,3575873327,27
0,883,22079,3575873300,3575873328,28
0,883,22080,3575873300,3575873329,29
0,883,22081,3575873300,3575873329,29
0,883,22082,3575873300,3575873329,29
0,883,22083,3575873300,3575873330,30
0,883,22084,3575873300,3575873331,31
0,883,22085,3575873300,3575873333,33
0,883,22086,3575873300,3575873334,34
0,883,22087,3575873300,3575873336,36
0,883,22088,3575873300,3575873336,36
0,883,22089,3575873300,3575873337,37
0,883,22090,3575873300,3575873338,38
0,883,22091,3575873300,3575873338,38
0,883,22092,3575873300,3575873338,38
0,883,22093,3575873300,3575873338,38
0,883,22094,3575873300,3575873339,39
0,883,22095,3575873300,3575873339,39
0,883,22096,3575873300,3575873339,39
0,883,22097,3575873300,3575873339,39
0,883,22098,3575873300,3575873342,42
0,883,22099,3575873300,3575873343,43
0,883,22100,3575873300,3575873344,44
0,883,22101,3575873300,3575873345,45
0,883,22102,3575873300,3575873345,45
0,883,22103,3575873300,3575873346,46
0,883,22104,3575873300,3575873348,48
0,883,22105,3575873300,3575873349,49
0,883,22106,3575873300,3575873349,49
0,883,22107,3575873300,3575873349,49
0,883,22108,3575873300,3575873350,50
0,884,22109,3575873361,3575873361,0
0,884,22110,3575873361,3575873361,0
0,884,22111,3575873361,3575873361,0
0,884,22112,3575873361,3575873361,0
0,884,22113,3575873361,3575873361,0
0,884,22114,3575873361,3575873361,0
0,884,22115,3575873361,3575873361,0
0,884,22116,3575873361,3575873361,0
0,884,22117,3575873361,3575873361,0
0,884,22118,3575873361,3575873361,0
0,884,22119,3575873361,3575873361,0
0,884,22120,3575873361,3575873361,0
0,884,22121,3575873361,3575873362,1
0,884,22122,3575873361,3575873363,2
0,884,22123,3575873361,3575873364,3
0,884,22124,3575873361,3575873365,4
0,884,22125,3575873361,3575873367,6
0,884,22126,3575873361,3575873368,7
0,884,22127,3575873361,3575873371,10
0,884,22128,3575873361,3575873371,10
0,884,22129,3575873361,3575873373,12
0,884,22130,3575873361,3575873373,12
0,884,22131,3575873361,3575873375,14
0,884,22132,3575873361,3575873376,15
0,884,22133,3575873361,3575873378,17
0,884,22134,3575873361,3575873379,18
0,884,22135,3575873361,3575873379,18
0,884,22136,3575873361,3575873379,18
0,884,22137,3575873361,3575873379,18
0,884,22138,3575873361,3575873380,19
0,884,22139,3575873361,3575873380,19
0,884,22140,3575873361,3575873383,22
0,884,22141,3575873361,3575873387,26
0,884,22142,3575873361,3575873389,28
0,884,22143,3575873361,3575873389,28
0,884,22144,3575873361,3575873390,29
0,884,22145,3575873361,3575873390,29
0,884,22146,3575873361,3575873394,33
0,884,22147,3575873361,3575873395,34
0,884,22148,3575873361,3575873398,37
0,884,22149,3575873361,3575873399,38
0,884,22150,3575873361,3575873400,39
0,884,22151,3575873361,3575873402,41
0,884,22152,3575873361,3575873404,43
0,884,22153,3575873361,3575873405,44
0,884,22154,3575873361,3575873406,45
0,884,22155,3575873361,3575873406,45
0,884,22156,3575873361,3575873407,46
0,884,22157,3575873361,3575873408,47
0,884,22158,3575873361,3575873410,49
0,884,22159,3575873361,3575873410,49
0,885,22160,3575873422,3575873422,0
0,885,22161,3575873422,3575873422,0
0,885,22162,3575873422,3575873422,0
0,885,22163,3575873422,3575873422,0
0,885,22164,3575873422,3575873422,0
0,885,22165,3575873422,3575873422,0
0,885,22166,3575873422,3575873422,0
0,885,22167,3575873422,3575873422,0
0,885,22168,3575873422,3575873424,2
0,885,22169,3575873422,3575873425,3
0,885,22170,3575873422,3575873426,4
0,885,22171,3575873422,3575873428,6
0,885,22172,3575873422,3575873430,8
0,885,22173,3575873422,3575873430,8
0,885,22174,3575873422,3575873432,10
0,885,22175,3575873422,3575873433,11
0,885,22176,3575873422,3575873433,11
0,885,22177,3575873422,3575873433,11
0,885,22178,3575873422,3575873434,12
0,885,22179,3575873422,3575873438,16
0,885,22180,3575873422,3575873439,17
0,885,22181,3575873422,3575873440,18
0,885,22182,3575873422,3575873442,20
0,885,22183,3575873422,3575873444,22
0,885,22184,3575873422,3575873444,22
0,885,22185,3575873422,3575873444,22
0,885,22186,3575873422,3575873446,24
0,885,22187,3575873422,3575873446,24
0,885,22188,3575873422,3575873447,25
0,885,22189,3575873422,3575873448,26
0,885,22190,3575873422,3575873448,26
0,885,22191,3575873422,3575873450,28
0,885,22192,3575873422,3575873451,29
0,885,22193,3575873422,3575873453,31
0,885,22194,3575873422,3575873453,31
0,885,22195,3575873422,3575873455,33
0,885,22196,3575873422,3575873455,33
0,885,22197,3575873422,3575873456,34
0,885,22198,3575873422,3575873457,35
0,885,22199,3575873422,3575873458,36
0,885,22200,3575873422,3575873458,36
0,885,22201,3575873422,3575873458,36
0,885,22202,3575873422,3575873459,37
0,885,22203,3575873422,3575873460,38
0,885,22204,3575873422,3575873461,39
0,885,22205,3575873422,3575873462,40
0,885,22206,3575873422,3575873462,40
0,885,22207,3575873422,3575873465,43
0,885,22208,3575873422,3575873465,43
0,885,22209,3575873422,3575873466,44
0,885,22210,3575873422,3575873467,45
0,885,22211,3575873422,3575873468,46
0,886,22212,3575873483,3575873483,0
0,886,22213,3575873483,3575873483,0
0,886,22214,3575873483,3575873483,0
0,886,22215,3575873483,3575873483,0
0,886,22216,3575873483,3575873483,0
0,886,22217,3575873483,3575873483,0
0,886,22218,3575873483,3575873483,0
0,886,22219,3575873483,3575873485,2
0,886,22220,3575873483,3575873487,4
0,886,22221,3575873483,3575873489,6
0,886,22222,3575873483,3575873490,7
0,886,22223,3575873483,3575873490,7
0,886,22224,3575873483,3575873491,8
0,886,22225,3575873483,3575873491,8
0,886,22226,3575873483,3575873493,10
0,886,22227,3575873483,3575873493,10
0,886,22228,3575873483,3575873494,11
0,886,22229,3575873483,3575873494,11
0,886,22230,3575873483,3575873494,11
0,886,22231,3575873483,3575873494,11
0,886,22232,3575873483,3575873495,12
0,886,22233,3575873483,3575873495,12
0,886,22234,3575873483,3575873495,12
0,886,22235,3575873483,3575873495,12
0,886,22236,3575873483,3575873496,13
0,886,22237,3575873483,3575873496,13
0,886,22238,3575873483,3575873496,13
0,886,22239,3575873483,3575873496,13
0,886,22240,3575873483,3575873497,14
0,886,22241,3575873483,3575873498,15
0,886,22242,3575873483,3575873498,15
0,886,22243,3575873483,3575873498,15
0,886,22244,3575873483,3575873499,16
0,886,22245,3575873483,3575873500,17
0,886,22246,3575873483,3575873500,17
0,886,22247,3575873483,3575873501,18
0,886,22248,3575873483,3575873502,19
0,886,22249,3575873483,3575873504,21
0,886,22250,3575873483,3575873506,23
0,886,22251,3575873483,3575873509,26
0,886,22252,3575873483,3575873510,27
0,886,22253,3575873483,3575873512,29
0,886,22254,3575873483,3575873512,29
0,886,22255,3575873483,3575873512,29
0,886,22256,3575873483,3575873515,32
0,886,22257,3575873483,3575873516,33
0,886,22258,3575873483,3575873517,34
0,886,22259,3575873483,3575873517,34
0,886,22260,3575873483,3575873517,34
0,886,22261,3575873483,3575873518,35
0,886,22262,3575873483,3575873518,35
0,886,22263,3575873483,3575873520,37
0,886,22264,3575873483,3575873522,39
0,886,22265,3575873483,3575873523,40
0,886,22266,3575873483,3575873525,42
0,886,22267,3575873483,3575873526,43
0,886,22268,3575873483,3575873527,44
0,886,22269,3575873483,3575873527,44
0,886,22270,3575873483,3575873529,46
0,886,22271,3575873483,3575873529,46
0,886,22272,3575873483,3575873530,47
0,886,22273,3575873483,3575873530,47
0,886,22274,3575873483,3575873532,49
0,887,22275,3575873544,3575873544,0
0,887,22276,3575873544,3575873544,0
0,887,22277,3575873544,3575873544,0
0,887,22278,3575873544,3575873544,0
0,887,22279,3575873544,3575873544,0
0,887,22280,3575873544,3575873544,0
0,887,22281,3575873544,3575873544,0
0,887,22282,3575873544,3575873544,0
0,887,22283,3575873544,3575873544,0
0,887,22284,3575873544,3575873544,0
0,887,22285,3575873544,3575873544,0
0,887,22286,3575873544,3575873544,0
0,887,22287,3575873544,3575873544,0
0,887,22288,3575873544,3575873544,0
0,887,22289,3575873544,3575873544,0
0,887,22290,3575873544,3575873544,0
0,887,22291,3575873544,3575873544,0
0,887,22292,3575873544,3575873544,0
0,887,22293,3575873544,3575873545,1
0,887,22294,3575873544,3575873547,3
0,887,22295,3575873544,3575873549,5
0,887,22296,3575873544,3575873549,5
0,887,22297,3575873544,3575873550,6
0,887,22298,3575873544,3575873550,6
0,887,22299,3575873544,3575873551,7
0,887,22300,3575873544,3575873553,9
0,887,22301,3575873544,3575873554,10
0,887,22302,3575873544,3575873554,10
0,887,22303,3575873544,3575873554,10
0,887,22304,3575873544,3575873555,11
0,887,22305,3575873544,3575873555,11
0,887,22306,3575873544,3575873555,11
0,887,22307,3575873544,3575873557,13
0,887,22308,3575873544,3575873558,14
0,887,22309,3575873544,3575873558,14
0,887,22310,3575873544,3575873560,16
0,887,22311,3575873544,3575873561,17
0,887,22312,3575873544,3575873561,17
0,887,22313,3575873544,3575873562,18
0,887,22314,3575873544,3575873564,20
0,887,22315,3575873544,3575873564,20
0,887,22316,3575873544,3575873564,20
0,887,22317,3575873544,3575873564,20
0,887,22318,3575873544,3575873564,20
0,887,22319,3575873544,3575873566,22
0,887,22320,3575873544,3575873566,22
0,887,22321,3575873544,3575873567,23
0,887,22322,3575873544,3575873569,25
0,887,22323,3575873544,3575873571,27
0,887,22324,3575873544,3575873572,28
0,887,22325,3575873544,3575873575,31
0,887,22326,3575873544,3575873577,33
0,887,22327,3575873544,3575873578,34
0,887,22328,3575873544,3575873579,35
0,887,22329,3575873544,3575873579,35
0,887,22330,3575873544,3575873579,35
0,887,22331,3575873544,3575873580,36
0,887,22332,3575873544,3575873581,37
0,887,22333,3575873544,3575873582,38
0,887,22334,3575873544,3575873585,41
0,887,22335,3575873544,3575873588,44
0,887,22336,3575873544,3575873588,44
0,887,22337,3575873544,3575873588,44
0,887,22338,3575873544,3575873589,45
0,887,22339,3575873544,3575873594,50
0,888,22340,3575873605,3575873605,0
0,888,22341,3575873605,3575873605,0
0,888,22342,3575873605,3575873605,0
0,888,22343,3575873605,3575873605,0
0,888,22344,3575873605,3575873605,0
0,888,22345,3575873605,3575873605,0
0,888,22346,3575873605,3575873605,0
0,888,22347,3575873605,3575873605,0
0,888,22348,3575873605,3575873606,1
0,888,22349,3575873605,3575873607,2
0,888,22350,3575873605,3575873608,3
0,888,22351,3575873605,3575873610,5
0,888,22352,3575873605,3575873613,8
0,888,22353,3575873605,3575873613,8
0,888,22354,3575873605,3575873614,9
0,888,22355,3575873605,3575873615,10
0,888,22356,3575873605,3575873615,10
0,888,22357,3575873605,3575873616,11
0,888,22358,3575873605,3575873617,12
0,888,22359,3575873605,3575873618,13
0,888,22360,3575873605,3575873621,16
0,888,22361,3575873605,3575873624,19
0,888,22362,3575873605,3575873624,19
0,888,22363,3575873605,3575873625,20
0,888,22364,3575873605,3575873629,24
0,888,22365,3575873605,3575873629,24
0,888,22366,3575873605,3575873630,25
0,888,22367,3575873605,3575873631,26
0,888,22368,3575873605,3575873632,27
0,888,22369,3575873605,3575873632,27
0,888,22370,3575873605,3575873632,27
0,888,22371,3575873605,3575873636,31
0,888,22372,3575873605,3575873637,32
0,888,22373,3575873605,3575873641,36
0,888,22374,3575873605,3575873644,39
0,888,22375,3575873605,3575873644,39
0,888,22376,3575873605,3575873644,39
0,888,22377,3575873605,3575873645,40
0,888,22378,3575873605,3575873645,40
0,888,22379,3575873605,3575873647,42
0,888,22380,3575873605,3575873647,42
0,888,22381,3575873605,3575873647,42
0,888,22382,3575873605,3575873649,44
0,888,22383,3575873605,3575873651,46
0,888,22384,3575873605,3575873652,47
0,888,22385,3575873605,3575873653,48
0,888,22386,3575873605,3575873654,49
0,888,22387,3575873605,3575873655,50
0,889,22388,3575873663,3575873663,0
0,889,22389,3575873663,3575873663,0
0,889,22390,3575873663,3575873663,0
0,889,22391,3575873663,3575873663,0
0,889,22392,3575873663,3575873663,0
0,889,22393,3575873663,3575873663,0
0,889,22394,3575873663,3575873663,0
0,889,22395,3575873663,3575873663,0
0,889,22396,3575873663,3575873663,0
0,889,22397,3575873663,3575873663,0
0,889,22398,3575873663,3575873664,1
0,889,22399,3575873663,3575873665,2
0,889,22400,3575873663,3575873665,2
0,889,22401,3575873663,3575873666,3
0,889,22402,3575873663,3575873667,4
0,889,22403,3575873663,3575873667,4
0,889,22404,3575873663,3575873676,13
0,889,22405,3575873663,3575873679,16
0,889,22406,3575873663,3575873679,16
0,889,22407,3575873663,3575873681,18
0,889,22408,3575873663,3575873681,18
0,889,22409,3575873663,3575873682,19
0,889,22410,3575873663,3575873683,20
0,889,22411,3575873663,3575873683,20
0,889,22412,3575873663,3575873684,21
0,889,22413,3575873663,3575873684,21
0,889,22414,3575873663,3575873687,24
0,889,22415,3575873663,3575873689,26
0,889,22416,3575873663,3575873690,27
0,889,22417,3575873663,3575873690,27
0,889,22418,3575873663,3575873691,28
0,889,22419,3575873663,3575873693,30
0,889,22420,3575873663,3575873693,30
0,889,22421,3575873663,3575873694,31
0,889,22422,3575873663,3575873694,31
0,889,22423,3575873663,3575873695,32
0,889,22424,3575873663,3575873695,32
0,889,22425,3575873663,3575873695,32
0,889,22426,3575873663,3575873696,33
0,889,22427,3575873663,3575873696,33
0,889,22428,3575873663,3575873696,33
0,889,22429,3575873663,3575873696,33
0,889,22430,3575873663,3575873696,33
0,889,22431,3575873663,3575873697,34
0,889,22432,3575873663,3575873697,34
0,889,22433,3575873663,3575873698,35
0,889,22434,3575873663,3575873698,35
0,889,22435,3575873663,3575873698,35
0,889,22436,3575873663,3575873699,36
0,889,22437,3575873663,3575873700,37
0,889,22438,3575873663,3575873701,38
0,889,22439,3575873663,3575873703,40
0,889,22440,3575873663,3575873704,41
0,889,22441,3575873663,3575873709,46
0,889,22442,3575873663,3575873710,47
0,889,22443,3575873663,3575873712,49
0,889,22444,3575873663,3575873712,49
0,889,22445,3575873663,3575873712,49
0,889,22446,3575873663,3575873713,50
0,890,22447,3575873723,3575873723,0
0,890,22448,3575873723,3575873723,0
0,890,22449,3575873723,3575873723,0
0,890,22450,3575873723,3575873723,0
0,890,22451,3575873723,3575873723,0
0,890,22452,3575873723,3575873723,0
0,890,22453,3575873723,3575873723,0
0,890,22454,3575873723,3575873723,0
0,890,22455,3575873723,3575873723,0
0,890,22456,3575873723,3575873723,0
0,890,22457,3575873723,3575873723,0
0,890,22458,3575873723,3575873723,0
0,890,22459,3575873723,3575873723,0
0,890,22460,3575873723,3575873723,0
0,890,22461,3575873723,3575873723,0
0,890,22462,3575873723,3575873723,0
0,890,22463,3575873723,3575873724,1
0,890,22464,3575873723,3575873726,3
0,890,22465,3575873723,3575873726,3
0,890,22466,3575873723,3575873727,4
0,890,22467,3575873723,3575873728,5
0,890,22468,3575873723,3575873729,6
0,890,22469,3575873723,3575873729,6
0,890,22470,3575873723,3575873730,7
0,890,22471,3575873723,3575873732,9
0,890,22472,3575873723,3575873734,11
0,890,22473,3575873723,3575873736,13
0,890,22474,3575873723,3575873736,13
0,890,22475,3575873723,3575873737,14
0,890,22476,3575873723,3575873737,14
0,890,22477,3575873723,3575873738,15
0,890,22478,3575873723,3575873738,15
0,890,22479,3575873723,3575873738,15
0,890,22480,3575873723,3575873739,16
0,890,22481,3575873723,3575873739,16
0,890,22482,3575873723,3575873739,16
0,890,22483,3575873723,3575873740,17
0,890,22484,3575873723,3575873741,18
0,890,22485,3575873723,3575873741,18
0,890,22486,3575873723,3575873741,18
0,890,22487,3575873723,3575873743,20
0,890,22488,3575873723,3575873744,21
0,890,22489,3575873723,3575873745,22
0,890,22490,3575873723,3575873746,23
0,890,22491,3575873723,3575873747,24
0,890,22492,3575873723,3575873747,24
0,890,22493,3575873723,3575873749,26
0,890,22494,3575873723,3575873749,26
0,890,22495,3575873723,3575873749,26
0,890,22496,3575873723,3575873750,27
0,890,22497,3575873723,3575873753,30
0,890,22498,3575873723,3575873753,30
0,890,22499,3575873723,3575873754,31
0,890,22500,3575873723,3575873754,31
0,890,22501,3575873723,3575873754,31
0,890,22502,3575873723,3575873755,32
0,890,22503,3575873723,3575873755,32
0,890,22504,3575873723,3575873758,35
0,890,22505,3575873723,3575873758,35
0,890,22506,3575873723,3575873759,36
0,890,22507,3575873723,3575873761,38
0,890,22508,3575873723,3575873761,38
0,890,22509,3575873723,3575873761,38
0,890,22510,3575873723,3575873761,38
0,890,22511,3575873723,3575873762,39
0,890,22512,3575873723,3575873764,41
0,890,22513,3575873723,3575873764,41
0,890,22514,3575873723,3575873765,42
0,890,22515,3575873723,3575873766,43
0,890,22516,3575873723,3575873770,47
0,890,22517,3575873723,3575873770,47
0,890,22518,3575873723,3575873770,47
0,890,22519,3575873723,3575873772,49
0,891,22520,3575873783,3575873783,0
0,891,22521,3575873783,3575873783,0
0,891,22522,3575873783,3575873783,0
0,891,22523,3575873783,3575873783,0
0,891,22524,3575873783,3575873783,0
0,891,22525,3575873783,3575873783,0
0,891,22526,3575873783,3575873783,0
0,891,22527,3575873783,3575873783,0
0,891,22528,3575873783,3575873783,0
0,891,22529,3575873783,3575873783,0
0,891,22530,3575873783,3575873783,0
0,891,22531,3575873783,3575873786,3
0,891,22532,3575873783,3575873788,5
0,891,22533,3575873783,3575873788,5
0,891,22534,3575873783,3575873788,5
0,891,22535,3575873783,3575873789,6
0,891,22536,3575873783,3575873794,11
0,891,22537,3575873783,3575873794,11
0,891,22538,3575873783,3575873797,14
0,891,22539,3575873783,3575873799,16
0,891,22540,3575873783,3575873801,18
0,891,22541,3575873783,3575873805,22
0,891,22542,3575873783,3575873805,22
0,891,22543,3575873783,3575873805,22
0,891,22544,3575873783,3575873806,23
0,891,22545,3575873783,3575873807,24
0,891,22546,3575873783,3575873810,27
0,891,22547,3575873783,3575873812,29
0,891,22548,3575873783,3575873813,30
0,891,22549,3575873783,3575873815,32
0,891,22550,3575873783,3575873815,32
0,891,22551,3575873783,3575873815,32
0,891,22552,3575873783,3575873816,33
0,891,22553,3575873783,3575873818,35
0,891,22554,3575873783,3575873818,35
0,891,22555,3575873783,3575873819,36
0,891,22556,3575873783,3575873821,38
0,891,22557,3575873783,3575873821,38
0,891,22558,3575873783,3575873825,42
0,891,22559,3575873783,3575873825,42
0,891,22560,3575873783,3575873826,43
0,891,22561,3575873783,3575873828,45
0,891,22562,3575873783,3575873828,45
0,891,22563,3575873783,3575873829,46
0,891,22564,3575873783,3575873829,46
0,891,22565,3575873783,3575873832,49
0,891,22566,3575873783,3575873832,49
0,891,22567,3575873783,3575873832,49
0,892,22568,3575873844,3575873844,0
0,892,22569,3575873844,3575873844,0
0,892,22570,3575873844,3575873844,0
0,892,22571,3575873844,3575873844,0
0,892,22572,3575873844,3575873844,0
0,892,22573,3575873844,3575873845,1
0,892,22574,3575873844,3575873845,1
0,892,22575,3575873844,3575873845,1
0,892,22576,3575873844,3575873847,3
0,892,22577,3575873844,3575873847,3
0,892,22578,3575873844,3575873847,3
0,892,22579,3575873844,3575873850,6
0,892,22580,3575873844,3575873851,7
0,892,22581,3575873844,3575873851,7
0,892,22582,3575873844,3575873853,9
0,892,22583,3575873844,3575873854,10
0,892,22584,3575873844,3575873855,11
0,892,22585,3575873844,3575873856,12
0,892,22586,3575873844,3575873857,13
0,892,22587,3575873844,3575873857,13
0,892,22588,3575873844,3575873858,14
0,892,22589,3575873844,3575873858,14
0,892,22590,3575873844,3575873860,16
0,892,22591,3575873844,3575873861,17
0,892,22592,3575873844,3575873861,17
0,892,22593,3575873844,3575873861,17
0,892,22594,3575873844,3575873861,17
0,892,22595,3575873844,3575873863,19
0,892,22596,3575873844,3575873864,20
0,892,22597,3575873844,3575873865,21
0,892,22598,3575873844,3575873865,21
0,892,22599,3575873844,3575873866,22
0,892,22600,3575873844,3575873867,23
0,892,22601,3575873844,3575873867,23
0,892,22602,3575873844,3575873868,24
0,892,22603,3575873844,3575873872,28
0,892,22604,3575873844,3575873876,32
0,892,22605,3575873844,3575873879,35
0,892,22606,3575873844,3575873879,35
0,892,22607,3575873844,3575873882,38
0,892,22608,3575873844,3575873882,38
0,892,22609,3575873844,3575873884,40
0,892,22610,3575873844,3575873884,40
0,892,22611,3575873844,3575873884,40
0,892,22612,3575873844,3575873884,40
0,892,22613,3575873844,3575873887,43
0,892,22614,3575873844,3575873888,44
0,892,22615,3575873844,3575873890,46
0,892,22616,3575873844,3575873890,46
0,892,22617,3575873844,3575873891,47
0,892,22618,3575873844,3575873892,48
0,892,22619,3575873844,3575873893,49
0,892,22620,3575873844,3575873893,49
0,892,22621,3575873844,3575873894,50
0,893,22622,3575873904,3575873905,1
0,893,22623,3575873904,3575873905,1
0,893,22624,3575873904,3575873905,1
0,893,22625,3575873904,3575873905,1
0,893,22626,3575873904,3575873905,1
0,893,22627,3575873904,3575873905,1
0,893,22628,3575873904,3575873905,1
0,893,22629,3575873904,3575873905,1
0,893,22630,3575873904,3575873905,1
0,893,22631,3575873904,3575873905,1
0,893,22632,3575873904,3575873905,1
0,893,22633,3575873904,3575873905,1
0,893,22634,3575873904,3575873905,1
0,893,22635,3575873904,3575873905,1
0,893,22636,3575873904,3575873905,1
0,893,22637,3575873904,3575873905,1
0,893,22638,3575873904,3575873905,1
0,893,22639,3575873904,3575873905,1
0,893,22640,3575873904,3575873909,5
0,893,22641,3575873904,3575873910,6
0,893,22642,3575873904,3575873912,8
0,893,22643,3575873904,3575873912,8
0,893,22644,3575873904,3575873912,8
0,893,22645,3575873904,3575873914,10
0,893,22646,3575873904,3575873917,13
0,893,22647,3575873904,3575873917,13
0,893,22648,3575873904,3575873918,14
0,893,22649,3575873904,3575873919,15
0,893,22650,3575873904,3575873919,15
0,893,22651,3575873904,3575873920,16
0,893,22652,3575873904,3575873920,16
0,893,22653,3575873904,3575873920,16
0,893,22654,3575873904,3575873921,17
0,893,22655,3575873904,3575873923,19
0,893,22656,3575873904,3575873923,19
0,893,22657,3575873904,3575873923,19
0,893,22658,3575873904,3575873924,20
0,893,22659,3575873904,3575873924,20
0,893,22660,3575873904,3575873924,20
0,893,22661,3575873904,3575873927,23
0,893,22662,3575873904,3575873927,23
0,893,22663,3575873904,3575873927,23
0,893,22664,3575873904,3575873928,24
0,893,22665,3575873904,3575873928,24
0,893,22666,3575873904,3575873929,25
0,893,22667,3575873904,3575873930,26
0,893,22668,3575873904,3575873930,26
0,893,22669,3575873904,3575873933,29
0,893,22670,3575873904,3575873936,32
0,893,22671,3575873904,3575873936,32
0,893,22672,3575873904,3575873936,32
0,893,22673,3575873904,3575873937,33
0,893,22674,3575873904,3575873938,34
0,893,22675,3575873904,3575873938,34
0,893,22676,3575873904,3575873938,34
0,893,22677,3575873904,3575873938,34
0,893,22678,3575873904,3575873940,36
0,893,22679,3575873904,3575873940,36
0,893,22680,3575873904,3575873940,36
0,893,22681,3575873904,3575873941,37
0,893,22682,3575873904,3575873942,38
0,893,22683,3575873904,3575873942,38
0,893,22684,3575873904,3575873943,39
0,893,22685,3575873904,3575873944,40
0,893,22686,3575873904,3575873944,40
0,893,22687,3575873904,3575873945,41
0,893,22688,3575873904,3575873946,42
0,893,22689,3575873904,3575873947,43
0,893,22690,3575873904,3575873948,44
0,893,22691,3575873904,3575873950,46
0,893,22692,3575873904,3575873950,46
0,893,22693,3575873904,3575873954,50
0,894,22694,3575873965,3575873965,0
0,894,22695,3575873965,3575873965,0
0,894,22696,3575873965,3575873965,0
0,894,22697,3575873965,3575873965,0
0,894,22698,3575873965,3575873965,0
0,894,22699,3575873965,3575873965,0
0,894,22700,3575873965,3575873965,0
0,894,22701,3575873965,3575873965,0
0,894,22702,3575873965,3575873965,0
0,894,22703,3575873965,3575873965,0
0,894,22704,3575873965,3575873965,0
0,894,22705,3575873965,3575873965,0
0,894,22706,3575873965,3575873965,0
0,894,22707,3575873965,3575873965,0
0,894,22708,3575873965,3575873965,0
0,894,22709,3575873965,3575873965,0
0,894,22710,3575873965,3575873966,1
0,894,22711,3575873965,3575873968,3
0,894,22712,3575873965,3575873970,5
0,894,22713,3575873965,3575873971,6
0,894,22714,3575873965,3575873972,7
0,894,22715,3575873965,3575873973,8
0,894,22716,3575873965,3575873975,10
0,894,22717,3575873965,3575873975,10
0,894,22718,3575873965,3575873977,12
0,894,22719,3575873965,3575873978,13
0,894,22720,3575873965,3575873978,13
0,894,22721,3575873965,3575873979,14
0,894,22722,3575873965,3575873980,15
0,894,22723,3575873965,3575873982,17
0,894,22724,3575873965,3575873982,17
0,894,22725,3575873965,3575873982,17
0,894,22726,3575873965,3575873985,20
0,894,22727,3575873965,3575873986,21
0,894,22728,3575873965,3575873988,23
0,894,22729,3575873965,3575873988,23
0,894,22730,3575873965,3575873989,24
0,894,22731,3575873965,3575873989,24
0,894,22732,3575873965,3575873995,30
0,894,22733,3575873965,3575873998,33
0,894,22734,3575873965,3575873999,34
0,894,22735,3575873965,3575873999,34
0,894,22736,3575873965,3575874002,37
0,894,22737,3575873965,3575874005,40
0,894,22738,3575873965,3575874005,40
0,894,22739,3575873965,3575874005,40
0,894,22740,3575873965,3575874007,42
0,894,22741,3575873965,3575874007,42
0,894,22742,3575873965,3575874008,43
0,894,22743,3575873965,3575874011,46
0,894,22744,3575873965,3575874013,48
0,894,22745,3575873965,3575874013,48
0,894,22746,3575873965,3575874015,50
0,895,22747,3575874027,3575874027,0
0,895,22748,3575874027,3575874027,0
0,895,22749,3575874027,3575874027,0
0,895,22750,3575874027,3575874027,0
0,895,22751,3575874027,3575874027,0
0,895,22752,3575874027,3575874027,0
0,895,22753,3575874027,3575874027,0
0,895,22754,3575874027,3575874027,0
0,895,22755,3575874027,3575874027,0
0,895,22756,3575874027,3575874029,2
0,895,22757,3575874027,3575874029,2
0,895,22758,3575874027,3575874029,2
0,895,22759,3575874027,3575874029,2
0,895,22760,3575874027,3575874032,5
0,895,22761,3575874027,3575874032,5
0,895,22762,3575874027,3575874032,5
0,895,22763,3575874027,3575874033,6
0,895,22764,3575874027,3575874037,10
0,895,22765,3575874027,3575874038,11
0,895,22766,3575874027,3575874040,13
0,895,22767,3575874027,3575874042,15
0,895,22768,3575874027,3575874044,17
0,895,22769,3575874027,3575874044,17
0,895,22770,3575874027,3575874045,18
0,895,22771,3575874027,3575874046,19
0,895,22772,3575874027,3575874046,19
0,895,22773,3575874027,3575874046,19
0,895,22774,3575874027,3575874047,20
0,895,22775,3575874027,3575874048,21
0,895,22776,3575874027,3575874050,23
0,895,22777,3575874027,3575874051,24
0,895,22778,3575874027,3575874051,24
0,895,22779,3575874027,3575874053,26
0,895,22780,3575874027,3575874053,26
0,895,22781,3575874027,3575874054,27
0,895,22782,3575874027,3575874055,28
0,895,22783,3575874027,3575874057,30
0,895,22784,3575874027,3575874057,30
0,895,22785,3575874027,3575874058,31
0,895,22786,3575874027,3575874058,31
0,895,22787,3575874027,3575874059,32
0,895,22788,3575874027,3575874060,33
0,895,22789,3575874027,3575874061,34
0,895,22790,3575874027,3575874061,34
0,895,22791,3575874027,3575874062,35
0,895,22792,3575874027,3575874064,37
0,895,22793,3575874027,3575874064,37
0,895,22794,3575874027,3575874065,38
0,895,22795,3575874027,3575874066,39
0,895,22796,3575874027,3575874066,39
0,895,22797,3575874027,3575874067,40
0,895,22798,3575874027,3575874068,41
0,895,22799,3575874027,3575874069,42
0,895,22800,3575874027,3575874076,49
0,896,22801,3575874088,3575874088,0
0,896,22802,3575874088,3575874088,0
0,896,22803,3575874088,3575874088,0
0,896,22804,3575874088,3575874088,0
0,896,22805,3575874088,3575874088,0
0,896,22806,3575874088,3575874088,0
0,896,22807,3575874088,3575874088,0
0,896,22808,3575874088,3575874088,0
0,896,22809,3575874088,3575874088,0
0,896,22810,3575874088,3575874088,0
0,896,22811,3575874088,3575874089,1
0,896,22812,3575874088,3575874090,2
0,896,22813,3575874088,3575874090,2
0,896,22814,3575874088,3575874091,3
0,896,22815,3575874088,3575874092,4
0,896,22816,3575874088,3575874093,5
0,896,22817,3575874088,3575874094,6
0,896,22818,3575874088,3575874095,7
0,896,22819,3575874088,3575874095,7
0,896,22820,3575874088,3575874095,7
0,896,22821,3575874088,3575874095,7
0,896,22822,3575874088,3575874096,8
0,896,22823,3575874088,3575874096,8
0,896,22824,3575874088,3575874097,9
0,896,22825,3575874088,3575874097,9
0,896,22826,3575874088,3575874097,9
0,896,22827,3575874088,3575874098,10
0,896,22828,3575874088,3575874098,10
0,896,22829,3575874088,3575874099,11
0,896,22830,3575874088,3575874099,11
0,896,22831,3575874088,3575874099,11
0,896,22832,3575874088,3575874099,11
0,896,22833,3575874088,3575874100,12
0,896,22834,3575874088,3575874100,12
0,896,22835,3575874088,3575874101,13
0,896,22836,3575874088,3575874101,13
0,896,22837,3575874088,3575874102,14
0,896,22838,3575874088,3575874104,16
0,896,22839,3575874088,3575874104,16
0,896,22840,3575874088,3575874105,17
0,896,22841,3575874088,3575874110,22
0,896,22842,3575874088,3575874112,24
0,896,22843,3575874088,3575874112,24
0,896,22844,3575874088,3575874113,25
0,896,22845,3575874088,3575874114,26
0,896,22846,3575874088,3575874116,28
0,896,22847,3575874088,3575874116,28
0,896,22848,3575874088,3575874117,29
0,896,22849,3575874088,3575874118,30
0,896,22850,3575874088,3575874119,31
0,896,22851,3575874088,3575874119,31
0,896,22852,3575874088,3575874120,32
0,896,22853,3575874088,3575874120,32
0,896,22854,3575874088,3575874120,32
0,896,22855,3575874088,3575874122,34
0,896,22856,3575874088,3575874123,35
0,896,22857,3575874088,3575874123,35
0,896,22858,3575874088,3575874124,36
0,896,22859,3575874088,3575874124,36
0,896,22860,3575874088,3575874125,37
0,896,22861,3575874088,3575874126,38
0,896,22862,3575874088,3575874126,38
0,896,22863,3575874088,3575874128,40
0,896,22864,3575874088,3575874128,40
0,896,22865,3575874088,3575874128,40
0,896,22866,3575874088,3575874129,41
0,896,22867,3575874088,3575874130,42
0,896,22868,3575874088,3575874130,42
0,896,22869,3575874088,3575874130,42
0,896,22870,3575874088,3575874133,45
0,896,22871,3575874088,3575874136,48
0,896,22872,3575874088,3575874136,48
0,896,22873,3575874088,3575874137,49
0,896,22874,3575874088,3575874137,49
0,896,22875,3575874088,3575874138,50
0,896,22876,3575874088,3575874138,50
0,897,22877,3575874152,3575874152,0
0,897,22878,3575874152,3575874152,0
0,897,22879,3575874152,3575874152,0
0,897,22880,3575874152,3575874152,0
0,897,22881,3575874152,3575874152,0
0,897,22882,3575874152,3575874152,0
0,897,22883,3575874152,3575874152,0
0,897,22884,3575874152,3575874152,0
0,897,22885,3575874152,3575874152,0
0,897,22886,3575874152,3575874152,0
0,897,22887,3575874152,3575874152,0
0,897,22888,3575874152,3575874152,0
0,897,22889,3575874152,3575874152,0
0,897,22890,3575874152,3575874152,0
0,897,22891,3575874152,3575874152,0
0,897,22892,3575874152,3575874152,0
0,897,22893,3575874152,3575874152,0
0,897,22894,3575874152,3575874152,0
0,897,22895,3575874152,3575874152,0
0,897,22896,3575874152,3575874153,1
0,897,22897,3575874152,3575874153,1
0,897,22898,3575874152,3575874154,2
0,897,22899,3575874152,3575874155,3
0,897,22900,3575874152,3575874156,4
0,897,22901,3575874152,3575874156,4
0,897,22902,3575874152,3575874156,4
0,897,22903,3575874152,3575874158,6
0,897,22904,3575874152,3575874159,7
0,897,22905,3575874152,3575874159,7
0,897,22906,3575874152,3575874162,10
0,897,22907,3575874152,3575874162,10
0,897,22908,3575874152,3575874164,12
0,897,22909,3575874152,3575874165,13
0,897,22910,3575874152,3575874165,13
0,897,22911,3575874152,3575874166,14
0,897,22912,3575874152,3575874166,14
0,897,22913,3575874152,3575874168,16
0,897,22914,3575874152,3575874170,18
0,897,22915,3575874152,3575874171,19
0,897,22916,3575874152,3575874172,20
0,897,22917,3575874152,3575874173,21
0,897,22918,3575874152,3575874175,23
0,897,22919,3575874152,3575874176,24
0,897,22920,3575874152,3575874178,26
0,897,22921,3575874152,3575874178,26
0,897,22922,3575874152,3575874178,26
0,897,22923,3575874152,3575874179,27
0,897,22924,3575874152,3575874180,28
0,897,22925,3575874152,3575874180,28
0,897,22926,3575874152,3575874180,28
0,897,22927,3575874152,3575874182,30
0,897,22928,3575874152,3575874183,31
0,897,22929,3575874152,3575874183,31
0,897,22930,3575874152,3575874188,36
0,897,22931,3575874152,3575874188,36
0,897,22932,3575874152,3575874189,37
0,897,22933,3575874152,3575874190,38
0,897,22934,3575874152,3575874194,42
0,897,22935,3575874152,3575874195,43
0,897,22936,3575874152,3575874198,46
0,897,22937,3575874152,3575874198,46
0,897,22938,3575874152,3575874199,47
0,897,22939,3575874152,3575874202,50
0,898,22940,3575874210,3575874210,0
0,898,22941,3575874210,3575874210,0
0,898,22942,3575874210,3575874210,0
0,898,22943,3575874210,3575874210,0
0,898,22944,3575874210,3575874210,0
0,898,22945,3575874210,3575874210,0
0,898,22946,3575874210,3575874211,1
0,898,22947,3575874210,3575874213,3
0,898,22948,3575874210,3575874214,4
0,898,22949,3575874210,3575874215,5
0,898,22950,3575874210,3575874215,5
0,898,22951,3575874210,3575874216,6
0,898,22952,3575874210,3575874218,8
0,898,22953,3575874210,3575874219,9
0,898,22954,3575874210,3575874219,9
0,898,22955,3575874210,3575874222,12
0,898,22956,3575874210,3575874222,12
0,898,22957,3575874210,3575874225,15
0,898,22958,3575874210,3575874226,16
0,898,22959,3575874210,3575874229,19
0,898,22960,3575874210,3575874229,19
0,898,22961,3575874210,3575874229,19
0,898,22962,3575874210,3575874230,20
0,898,22963,3575874210,3575874232,22
0,898,22964,3575874210,3575874232,22
0,898,22965,3575874210,3575874232,22
0,898,22966,3575874210,3575874232,22
0,898,22967,3575874210,3575874232,22
0,898,22968,3575874210,3575874237,27
0,898,22969,3575874210,3575874238,28
0,898,22970,3575874210,3575874240,30
0,898,22971,3575874210,3575874244,34
0,898,22972,3575874210,3575874244,34
0,898,22973,3575874210,3575874244,34
0,898,22974,3575874210,3575874246,36
0,898,22975,3575874210,3575874246,36
0,898,22976,3575874210,3575874247,37
0,898,22977,3575874210,3575874248,38
0,898,22978,3575874210,3575874250,40
0,898,22979,3575874210,3575874251,41
0,898,22980,3575874210,3575874253,43
0,898,22981,3575874210,3575874253,43
0,898,22982,3575874210,3575874254,44
0,898,22983,3575874210,3575874256,46
0,898,22984,3575874210,3575874257,47
0,898,22985,3575874210,3575874257,47
0,898,22986,3575874210,3575874258,48
0,898,22987,3575874210,3575874259,49
0,898,22988,3575874210,3575874259,49
0,899,22989,3575874269,3575874269,0
0,899,22990,3575874269,3575874269,0
0,899,22991,3575874269,3575874269,0
0,899,22992,3575874269,3575874269,0
0,899,22993,3575874269,3575874269,0
0,899,22994,3575874269,3575874269,0
0,899,22995,3575874269,3575874269,0
0,899,22996,3575874269,3575874269,0
0,899,22997,3575874269,3575874269,0
0,899,22998,3575874269,3575874276,7
0,899,22999,3575874269,3575874278,9
0,899,23000,3575874269,3575874279,10
0,899,23001,3575874269,3575874283,14
0,899,23002,3575874269,3575874283,14
0,899,23003,3575874269,3575874283,14
0,899,23004,3575874269,3575874284,15
0,899,23005,3575874269,3575874284,15
0,899,23006,3575874269,3575874285,16
0,899,23007,3575874269,3575874285,16
0,899,23008,3575874269,3575874290,21
0,899,23009,3575874269,3575874291,22
0,899,23010,3575874269,3575874291,22
0,899,23011,3575874269,3575874293,24
0,899,23012,3575874269,3575874294,25
0,899,23013,3575874269,3575874295,26
0,899,23014,3575874269,3575874295,26
0,899,23015,3575874269,3575874295,26
0,899,23016,3575874269,3575874296,27
0,899,23017,3575874269,3575874296,27
0,899,23018,3575874269,3575874296,27
0,899,23019,3575874269,3575874297,28
0,899,23020,3575874269,3575874297,28
0,899,23021,3575874269,3575874298,29
0,899,23022,3575874269,3575874298,29
0,899,23023,3575874269,3575874298,29
0,899,23024,3575874269,3575874299,30
0,899,23025,3575874269,3575874299,30
0,899,23026,3575874269,3575874300,31
0,899,23027,3575874269,3575874300,31
0,899,23028,3575874269,3575874301,32
0,899,23029,3575874269,3575874301,32
0,899,23030,3575874269,3575874301,32
0,899,23031,3575874269,3575874303,34
0,899,23032,3575874269,3575874304,35
0,899,23033,3575874269,3575874304,35
0,899,23034,3575874269,3575874312,43
0,899,23035,3575874269,3575874313,44
0,899,23036,3575874269,3575874313,44
0,899,23037,3575874269,3575874314,45
0,899,23038,3575874269,3575874316,47
0,899,23039,3575874269,3575874318,49
0,899,23040,3575874269,3575874318,49
0,899,23041,3575874269,3575874318,49
0,899,23042,3575874269,3575874319,50
0,900,23043,3575874328,3575874328,0
0,900,23044,3575874328,3575874328,0
0,900,23045,3575874328,3575874328,0
0,900,23046,3575874328,3575874328,0
0,900,23047,3575874328,3575874328,0
0,900,23048,3575874328,3575874328,0
0,900,23049,3575874328,3575874328,0
0,900,23050,3575874328,3575874328,0
0,900,23051,3575874328,3575874328,0
0,900,23052,3575874328,3575874328,0
0,900,23053,3575874328,3575874328,0
0,900,23054,3575874328,3575874328,0
0,900,23055,3575874328,3575874328,0
0,900,23056,3575874328,3575874328,0
0,900,23057,3575874328,3575874330,2
0,900,23058,3575874328,3575874330,2
0,900,23059,3575874328,3575874330,2
0,900,23060,3575874328,3575874331,3
0,900,23061,3575874328,3575874333,5
0,900,23062,3575874328,3575874333,5
0,900,23063,3575874328,3575874336,8
0,900,23064,3575874328,3575874337,9
0,900,23065,3575874328,3575874337,9
0,900,23066,3575874328,3575874337,9
0,900,23067,3575874328,3575874338,10
0,900,23068,3575874328,3575874338,10
0,900,23069,3575874328,3575874339,11
0,900,23070,3575874328,3575874340,12
0,900,23071,3575874328,3575874342,14
0,900,23072,3575874328,3575874342,14
0,900,23073,3575874328,3575874343,15
0,900,23074,3575874328,3575874343,15
0,900,23075,3575874328,3575874343,15
0,900,23076,3575874328,3575874344,16
0,900,23077,3575874328,3575874344,16
0,900,23078,3575874328,3575874344,16
0,900,23079,3575874328,3575874345,17
0,900,23080,3575874328,3575874346,18
0,900,23081,3575874328,3575874347,19
0,900,23082,3575874328,3575874347,19
0,900,23083,3575874328,3575874348,20
0,900,23084,3575874328,3575874350,22
0,900,23085,3575874328,3575874350,22
0,900,23086,3575874328,3575874350,22
0,900,23087,3575874328,3575874353,25
0,900,23088,3575874328,3575874354,26
0,900,23089,3575874328,3575874354,26
0,900,23090,3575874328,3575874355,27
0,900,23091,3575874328,3575874355,27
0,900,23092,3575874328,3575874356,28
0,900,23093,3575874328,3575874357,29
0,900,23094,3575874328,3575874358,30
0,900,23095,3575874328,3575874359,31
0,900,23096,3575874328,3575874359,31
0,900,23097,3575874328,3575874360,32
0,900,23098,3575874328,3575874362,34
0,900,23099,3575874328,3575874362,34
0,900,23100,3575874328,3575874363,35
0,900,23101,3575874328,3575874364,36
0,900,23102,3575874328,3575874365,37
0,900,23103,3575874328,3575874365,37
0,900,23104,3575874328,3575874366,38
0,900,23105,3575874328,3575874367,39
0,900,23106,3575874328,3575874370,42
0,900,23107,3575874328,3575874373,45
0,900,23108,3575874328,3575874375,47
0,900,23109,3575874328,3575874377,49
0,901,23110,3575874388,3575874388,0
0,901,23111,3575874388,3575874388,0
0,901,23112,3575874388,3575874388,0
0,901,23113,3575874388,3575874388,0
0,901,23114,3575874388,3575874388,0
0,901,23115,3575874388,3575874388,0
0,901,23116,3575874388,3575874388,0
0,901,23117,3575874388,3575874388,0
0,901,23118,3575874388,3575874388,0
0,901,23119,3575874388,3575874389,1
0,901,23120,3575874388,3575874389,1
0,901,23121,3575874388,3575874390,2
0,901,23122,3575874388,3575874394,6
0,901,23123,3575874388,3575874395,7
0,901,23124,3575874388,3575874399,11
0,901,23125,3575874388,3575874399,11
0,901,23126,3575874388,3575874402,14
0,901,23127,3575874388,3575874406,18
0,901,23128,3575874388,3575874407,19
0,901,23129,3575874388,3575874407,19
0,901,23130,3575874388,3575874408,20
0,901,23131,3575874388,3575874408,20
0,901,23132,3575874388,3575874409,21
0,901,23133,3575874388,3575874411,23
0,901,23134,3575874388,3575874413,25
0,901,23135,3575874388,3575874414,26
0,901,23136,3575874388,3575874415,27
0,901,23137,3575874388,3575874415,27
0,901,23138,3575874388,3575874415,27
0,901,23139,3575874388,3575874416,28
0,901,23140,3575874388,3575874418,30
0,901,23141,3575874388,3575874419,31
0,901,23142,3575874388,3575874420,32
0,901,23143,3575874388,3575874421,33
0,901,23144,3575874388,3575874422,34
0,901,23145,3575874388,3575874426,38
0,901,23146,3575874388,3575874427,39
0,901,23147,3575874388,3575874427,39
0,901,23148,3575874388,3575874429,41
0,901,23149,3575874388,3575874429,41
0,901,23150,3575874388,3575874430,42
0,901,23151,3575874388,3575874430,42
0,901,23152,3575874388,3575874432,44
0,901,23153,3575874388,3575874433,45
0,901,23154,3575874388,3575874433,45
0,901,23155,3575874388,3575874433,45
0,901,23156,3575874388,3575874433,45
0,901,23157,3575874388,3575874437,49
0,901,23158,3575874388,3575874437,49
0,902,23159,3575874450,3575874450,0
0,902,23160,3575874450,3575874450,0
0,902,23161,3575874450,3575874450,0
0,902,23162,3575874450,3575874450,0
0,902,23163,3575874450,3575874450,0
0,902,23164,3575874450,3575874450,0
0,902,23165,3575874450,3575874450,0
0,902,23166,3575874450,3575874450,0
0,902,23167,3575874450,3575874450,0
0,902,23168,3575874450,3575874450,0
0,902,23169,3575874450,3575874451,1
0,902,23170,3575874450,3575874454,4
0,902,23171,3575874450,3575874455,5
0,902,23172,3575874450,3575874456,6
0,902,23173,3575874450,3575874457,7
0,902,23174,3575874450,3575874457,7
0,902,23175,3575874450,3575874459,9
0,902,23176,3575874450,3575874459,9
0,902,23177,3575874450,3575874459,9
0,902,23178,3575874450,3575874459,9
0,902,23179,3575874450,3575874461,11
0,902,23180,3575874450,3575874463,13
0,902,23181,3575874450,3575874464,14
0,902,23182,3575874450,3575874464,14
0,902,23183,3575874450,3575874465,15
0,902,23184,3575874450,3575874466,16
0,902,23185,3575874450,3575874466,16
0,902,23186,3575874450,3575874467,17
0,902,23187,3575874450,3575874467,17
0,902,23188,3575874450,3575874468,18
0,902,23189,3575874450,3575874476,26
0,902,23190,3575874450,3575874478,28
0,902,23191,3575874450,3575874479,29
0,902,23192,3575874450,3575874481,31
0,902,23193,3575874450,3575874482,32
0,902,23194,3575874450,3575874482,32
0,902,23195,3575874450,3575874483,33
0,902,23196,3575874450,3575874484,34
0,902,23197,3575874450,3575874485,35
0,902,23198,3575874450,3575874486,36
0,902,23199,3575874450,3575874487,37
0,902,23200,3575874450,3575874487,37
0,902,23201,3575874450,3575874489,39
0,902,23202,3575874450,3575874490,40
0,902,23203,3575874450,3575874490,40
0,902,23204,3575874450,3575874491,41
0,902,23205,3575874450,3575874492,42
0,902,23206,3575874450,3575874493,43
0,902,23207,3575874450,3575874494,44
0,902,23208,3575874450,3575874495,45
0,902,23209,3575874450,3575874495,45
0,902,23210,3575874450,3575874495,45
0,902,23211,3575874450,3575874496,46
0,902,23212,3575874450,3575874497,47
0,902,23213,3575874450,3575874497,47
0,902,23214,3575874450,3575874497,47
0,902,23215,3575874450,3575874498,48
0,902,23216,3575874450,3575874498,48
0,902,23217,3575874450,3575874499,49
0,902,23218,3575874450,3575874499,49
0,902,23219,3575874450,3575874499,49
0,902,23220,3575874450,3575874500,50
0,903,23221,3575874509,3575874509,0
0,903,23222,3575874509,3575874509,0
0,903,23223,3575874509,3575874509,0
0,903,23224,3575874509,3575874509,0
0,903,23225,3575874509,3575874509,0
0,903,23226,3575874509,3575874509,0
0,903,23227,3575874509,3575874509,0
0,903,23228,3575874509,3575874512,3
0,903,23229,3575874509,3575874512,3
0,903,23230,3575874509,3575874512,3
0,903,23231,3575874509,3575874512,3
0,903,23232,3575874509,3575874514,5
0,903,23233,3575874509,3575874515,6
0,903,23234,3575874509,3575874516,7
0,903,23235,3575874509,3575874517,8
0,903,23236,3575874509,3575874517,8
0,903,23237,3575874509,3575874518,9
0,903,23238,3575874509,3575874519,10
0,903,23239,3575874509,3575874519,10
0,903,23240,3575874509,3575874519,10
0,903,23241,3575874509,3575874520,11
0,903,23242,3575874509,3575874521,12
0,903,23243,3575874509,3575874522,13
0,903,23244,3575874509,3575874523,14
0,903,23245,3575874509,3575874524,15
0,903,23246,3575874509,3575874524,15
0,903,23247,3575874509,3575874525,16
0,903,23248,3575874509,3575874526,17
0,903,23249,3575874509,3575874527,18
0,903,23250,3575874509,3575874527,18
0,903,23251,3575874509,3575874528,19
0,903,23252,3575874509,3575874529,20
0,903,23253,3575874509,3575874529,20
0,903,23254,3575874509,3575874529,20
0,903,23255,3575874509,3575874530,21
0,903,23256,3575874509,3575874532,23
0,903,23257,3575874509,3575874536,27
0,903,23258,3575874509,3575874536,27
0,903,23259,3575874509,3575874536,27
0,903,23260,3575874509,3575874536,27
0,903,23261,3575874509,3575874536,27
0,903,23262,3575874509,3575874537,28
0,903,23263,3575874509,3575874537,28
0,903,23264,3575874509,3575874538,29
0,903,23265,3575874509,3575874539,30
0,903,23266,3575874509,3575874540,31
0,903,23267,3575874509,3575874541,32
0,903,23268,3575874509,3575874541,32
0,903,23269,3575874509,3575874542,33
0,903,23270,3575874509,3575874542,33
0,903,23271,3575874509,3575874543,34
0,903,23272,3575874509,3575874543,34
0,903,23273,3575874509,3575874543,34
0,903,23274,3575874509,3575874543,34
0,903,23275,3575874509,3575874544,35
0,903,23276,3575874509,3575874545,36
0,903,23277,3575874509,3575874546,37
0,903,23278,3575874509,3575874547,38
0,903,23279,3575874509,3575874548,39
0,903,23280,3575874509,3575874549,40
0,903,23281,3575874509,3575874550,41
0,903,23282,3575874509,3575874550,41
0,903,23283,3575874509,3575874551,42
0,903,23284,3575874509,3575874552,43
0,903,23285,3575874509,3575874553,44
0,903,23286,3575874509,3575874554,45
0,903,23287,3575874509,3575874554,45
0,903,23288,3575874509,3575874556,47
0,903,23289,3575874509,3575874556,47
0,903,23290,3575874509,3575874556,47
0,903,23291,3575874509,3575874556,47
0,903,23292,3575874509,3575874558,49
0,903,23293,3575874509,3575874559,50
0,904,23294,3575874572,3575874572,0
0,904,23295,3575874572,3575874572,0
0,904,23296,3575874572,3575874572,0
0,904,23297,3575874572,3575874572,0
0,904,23298,3575874572,3575874572,0
0,904,23299,3575874572,3575874572,0
0,904,23300,3575874572,3575874572,0
0,904,23301,3575874572,3575874572,0
0,904,23302,3575874572,3575874572,0
0,904,23303,3575874572,3575874572,0
0,904,23304,3575874572,3575874572,0
0,904,23305,3575874572,3575874572,0
0,904,23306,3575874572,3575874572,0
0,904,23307,3575874572,3575874572,0
0,904,23308,3575874572,3575874574,2
0,904,23309,3575874572,3575874575,3
0,904,23310,3575874572,3575874577,5
0,904,23311,3575874572,3575874578,6
0,904,23312,3575874572,3575874579,7
0,904,23313,3575874572,3575874579,7
0,904,23314,3575874572,3575874580,8
0,904,23315,3575874572,3575874581,9
0,904,23316,3575874572,3575874581,9
0,904,23317,3575874572,3575874582,10
0,904,23318,3575874572,3575874586,14
0,904,23319,3575874572,3575874587,15
0,904,23320,3575874572,3575874588,16
0,904,23321,3575874572,3575874589,17
0,904,23322,3575874572,3575874589,17
0,904,23323,3575874572,3575874593,21
0,904,23324,3575874572,3575874593,21
0,904,23325,3575874572,3575874594,22
0,904,23326,3575874572,3575874598,26
0,904,23327,3575874572,3575874599,27
0,904,23328,3575874572,3575874601,29
0,904,23329,3575874572,3575874606,34
0,904,23330,3575874572,3575874607,35
0,904,23331,3575874572,3575874607,35
0,904,23332,3575874572,3575874609,37
0,904,23333,3575874572,3575874610,38
0,904,23334,3575874572,3575874613,41
0,904,23335,3575874572,3575874613,41
0,904,23336,3575874572,3575874614,42
0,904,23337,3575874572,3575874614,42
0,904,23338,3575874572,3575874615,43
0,904,23339,3575874572,3575874615,43
0,904,23340,3575874572,3575874618,46
0,904,23341,3575874572,3575874618,46
0,904,23342,3575874572,3575874619,47
0,904,23343,3575874572,3575874621,49
0,905,23344,3575874631,3575874631,0
0,905,23345,3575874631,3575874631,0
0,905,23346,3575874631,3575874631,0
0,905,23347,3575874631,3575874631,0
0,905,23348,3575874631,3575874631,0
0,905,23349,3575874631,3575874631,0
0,905,23350,3575874631,3575874631,0
0,905,23351,3575874631,3575874631,0
0,905,23352,3575874631,3575874631,0
0,905,23353,3575874631,3575874632,1
0,905,23354,3575874631,3575874632,1
0,905,23355,3575874631,3575874633,2
0,905,23356,3575874631,3575874635,4
0,905,23357,3575874631,3575874636,5
0,905,23358,3575874631,3575874637,6
0,905,23359,3575874631,3575874642,11
0,905,23360,3575874631,3575874642,11
0,905,23361,3575874631,3575874644,13
0,905,23362,3575874631,3575874644,13
0,905,23363,3575874631,3575874645,14
0,905,23364,3575874631,3575874645,14
0,905,23365,3575874631,3575874645,14
0,905,23366,3575874631,3575874646,15
0,905,23367,3575874631,3575874647,16
0,905,23368,3575874631,3575874647,16
0,905,23369,3575874631,3575874649,18
0,905,23370,3575874631,3575874650,19
0,905,23371,3575874631,3575874652,21
0,905,23372,3575874631,3575874652,21
0,905,23373,3575874631,3575874653,22
0,905,23374,3575874631,3575874654,23
0,905,23375,3575874631,3575874655,24
0,905,23376,3575874631,3575874656,25
0,905,23377,3575874631,3575874656,25
0,905,23378,3575874631,3575874657,26
0,905,23379,3575874631,3575874658,27
0,905,23380,3575874631,3575874658,27
0,905,23381,3575874631,3575874658,27
0,905,23382,3575874631,3575874660,29
0,905,23383,3575874631,3575874663,32
0,905,23384,3575874631,3575874663,32
0,905,23385,3575874631,3575874664,33
0,905,23386,3575874631,3575874665,34
0,905,23387,3575874631,3575874665,34
0,905,23388,3575874631,3575874665,34
0,905,23389,3575874631,3575874666,35
0,905,23390,3575874631,3575874667,36
0,905,23391,3575874631,3575874668,37
0,905,23392,3575874631,3575874668,37
0,905,23393,3575874631,3575874677,46
0,905,23394,3575874631,3575874679,48
0,905,23395,3575874631,3575874679,48
0,906,23396,3575874694,3575874694,0
0,906,23397,3575874694,3575874694,0
0,906,23398,3575874694,3575874694,0
0,906,23399,3575874694,3575874694,0
0,906,23400,3575874694,3575874694,0
0,906,23401,3575874694,3575874694,0
0,906,23402,3575874694,3575874694,0
0,906,23403,3575874694,3575874694,0
0,906,23404,3575874694,3575874694,0
0,906,23405,3575874694,3575874694,0
0,906,23406,3575874694,3575874694,0
0,906,23407,3575874694,3575874694,0
0,906,23408,3575874694,3575874694,0
0,906,23409,3575874694,3575874694,0
0,906,23410,3575874694,3575874694,0
0,906,23411,3575874694,3575874695,1
0,906,23412,3575874694,3575874696,2
0,906,23413,3575874694,3575874696,2
0,906,23414,3575874694,3575874696,2
0,906,23415,3575874694,3575874696,2
0,906,23416,3575874694,3575874696,2
0,906,23417,3575874694,3575874697,3
0,906,23418,3575874694,3575874697,3
0,906,23419,3575874694,3575874697,3
0,906,23420,3575874694,3575874698,4
0,906,23421,3575874694,3575874699,5
0,906,23422,3575874694,3575874700,6
0,906,23423,3575874694,3575874700,6
0,906,23424,3575874694,3575874700,6
0,906,23425,3575874694,3575874701,7
0,906,23426,3575874694,3575874703,9
0,906,23427,3575874694,3575874703,9
0,906,23428,3575874694,3575874703,9
0,906,23429,3575874694,3575874704,10
0,906,23430,3575874694,3575874705,11
0,906,23431,3575874694,3575874709,15
0,906,23432,3575874694,3575874709,15
0,906,23433,3575874694,3575874712,18
0,906,23434,3575874694,3575874712,18
0,906,23435,3575874694,3575874712,18
0,906,23436,3575874694,3575874713,19
0,906,23437,3575874694,3575874715,21
0,906,23438,3575874694,3575874716,22
0,906,23439,3575874694,3575874717,23
0,906,23440,3575874694,3575874718,24
0,906,23441,3575874694,3575874719,25
0,906,23442,3575874694,3575874719,25
0,906,23443,3575874694,3575874719,25
0,906,23444,3575874694,3575874720,26
0,906,23445,3575874694,3575874720,26
0,906,23446,3575874694,3575874722,28
0,906,23447,3575874694,3575874723,29
0,906,23448,3575874694,3575874723,29
0,906,23449,3575874694,3575874723,29
0,906,23450,3575874694,3575874725,31
0,906,23451,3575874694,3575874726,32
0,906,23452,3575874694,3575874727,33
0,906,23453,3575874694,3575874727,33
0,906,23454,3575874694,3575874728,34
0,906,23455,3575874694,3575874729,35
0,906,23456,3575874694,3575874729,35
0,906,23457,3575874694,3575874730,36
0,906,23458,3575874694,3575874730,36
0,906,23459,3575874694,3575874732,38
0,906,23460,3575874694,3575874736,42
0,906,23461,3575874694,3575874736,42
0,906,23462,3575874694,3575874737,43
0,906,23463,3575874694,3575874737,43
0,906,23464,3575874694,3575874737,43
0,906,23465,3575874694,3575874738,44
0,906,23466,3575874694,3575874738,44
0,906,23467,3575874694,3575874739,45
0,906,23468,3575874694,3575874740,46
0,906,23469,3575874694,3575874741,47
0,906,23470,3575874694,3575874741,47
0,906,23471,3575874694,3575874742,48
0,906,23472,3575874694,3575874742,48
0,906,23473,3575874694,3575874743,49
0,906,23474,3575874694,3575874743,49
0,906,23475,3575874694,3575874743,49
0,906,23476,3575874694,3575874744,50
0,907,23477,3575874754,3575874754,0
0,907,23478,3575874754,3575874754,0
0,907,23479,3575874754,3575874754,0
0,907,23480,3575874754,3575874754,0
0,907,23481,3575874754,3575874754,0
0,907,23482,3575874754,3575874754,0
0,907,23483,3575874754,3575874754,0
0,907,23484,3575874754,3575874754,0
0,907,23485,3575874754,3575874754,0
0,907,23486,3575874754,3575874754,0
0,907,23487,3575874754,3575874754,0
0,907,23488,3575874754,3575874754,0
0,907,23489,3575874754,3575874754,0
0,907,23490,3575874754,3575874754,0
0,907,23491,3575874754,3575874756,2
0,907,23492,3575874754,3575874757,3
0,907,23493,3575874754,3575874757,3
0,907,23494,3575874754,3575874759,5
0,907,23495,3575874754,3575874760,6
0,907,23496,3575874754,3575874760,6
0,907,23497,3575874754,3575874760,6
0,907,23498,3575874754,3575874761,7
0,907,23499,3575874754,3575874763,9
0,907,23500,3575874754,3575874764,10
0,907,23501,3575874754,3575874765,11
0,907,23502,3575874754,3575874765,11
0,907,23503,3575874754,3575874765,11
0,907,23504,3575874754,3575874766,12
0,907,23505,3575874754,3575874766,12
0,907,23506,3575874754,3575874767,13
0,907,23507,3575874754,3575874770,16
0,907,23508,3575874754,3575874770,16
0,907,23509,3575874754,3575874772,18
0,907,23510,3575874754,3575874772,18
0,907,23511,3575874754,3575874775,21
0,907,23512,3575874754,3575874775,21
0,907,23513,3575874754,3575874777,23
0,907,23514,3575874754,3575874779,25
0,907,23515,3575874754,3575874779,25
0,907,23516,3575874754,3575874780,26
0,907,23517,3575874754,3575874782,28
0,907,23518,3575874754,3575874782,28
0,907,23519,3575874754,3575874786,32
0,907,23520,3575874754,3575874789,35
0,907,23521,3575874754,3575874789,35
0,907,23522,3575874754,3575874790,36
0,907,23523,3575874754,3575874793,39
0,907,23524,3575874754,3575874793,39
0,907,23525,3575874754,3575874797,43
0,907,23526,3575874754,3575874798,44
0,907,23527,3575874754,3575874798,44
0,907,23528,3575874754,3575874800,46
0,908,23529,3575874817,3575874817,0
0,908,23530,3575874817,3575874817,0
0,908,23531,3575874817,3575874817,0
0,908,23532,3575874817,3575874817,0
0,908,23533,3575874817,3575874817,0
0,908,23534,3575874817,3575874817,0
0,908,23535,3575874817,3575874817,0
0,908,23536,3575874817,3575874817,0
0,908,23537,3575874817,3575874817,0
0,908,23538,3575874817,3575874817,0
0,908,23539,3575874817,3575874817,0
0,908,23540,3575874817,3575874818,1
0,908,23541,3575874817,3575874818,1
0,908,23542,3575874817,3575874819,2
0,908,23543,3575874817,3575874821,4
0,908,23544,3575874817,3575874822,5
0,908,23545,3575874817,3575874825,8
0,908,23546,3575874817,3575874827,10
0,908,23547,3575874817,3575874827,10
0,908,23548,3575874817,3575874829,12
0,908,23549,3575874817,3575874829,12
0,908,23550,3575874817,3575874829,12
0,908,23551,3575874817,3575874830,13
0,908,23552,3575874817,3575874832,15
0,908,23553,3575874817,3575874832,15
0,908,23554,3575874817,3575874832,15
0,908,23555,3575874817,3575874832,15
0,908,23556,3575874817,3575874833,16
0,908,23557,3575874817,3575874836,19
0,908,23558,3575874817,3575874836,19
0,908,23559,3575874817,3575874837,20
0,908,23560,3575874817,3575874842,25
0,908,23561,3575874817,3575874842,25
0,908,23562,3575874817,3575874845,28
0,908,23563,3575874817,3575874845,28
0,908,23564,3575874817,3575874846,29
0,908,23565,3575874817,3575874846,29
0,908,23566,3575874817,3575874848,31
0,908,23567,3575874817,3575874848,31
0,908,23568,3575874817,3575874849,32
0,908,23569,3575874817,3575874850,33
0,908,23570,3575874817,3575874850,33
0,908,23571,3575874817,3575874851,34
0,908,23572,3575874817,3575874852,35
0,908,23573,3575874817,3575874853,36
0,908,23574,3575874817,3575874855,38
0,908,23575,3575874817,3575874855,38
0,908,23576,3575874817,3575874856,39
0,908,23577,3575874817,3575874856,39
0,908,23578,3575874817,3575874858,41
0,908,23579,3575874817,3575874858,41
0,908,23580,3575874817,3575874859,42
0,908,23581,3575874817,3575874859,42
0,908,23582,3575874817,3575874863,46
0,908,23583,3575874817,3575874864,47
0,908,23584,3575874817,3575874864,47
0,908,23585,3575874817,3575874864,47
0,908,23586,3575874817,3575874864,47
0,908,23587,3575874817,3575874865,48
0,908,23588,3575874817,3575874865,48
0,908,23589,3575874817,3575874866,49
0,908,23590,3575874817,3575874867,50
0,909,23591,3575874877,3575874878,1
0,909,23592,3575874877,3575874878,1
0,909,23593,3575874877,3575874879,2
0,909,23594,3575874877,3575874881,4
0,909,23595,3575874877,3575874882,5
0,909,23596,3575874877,3575874882,5
0,909,23597,3575874877,3575874884,7
0,909,23598,3575874877,3575874885,8
0,909,23599,3575874877,3575874885,8
0,909,23600,3575874877,3575874887,10
0,909,23601,3575874877,3575874888,11
0,909,23602,3575874877,3575874890,13
0,909,23603,3575874877,3575874890,13
0,909,23604,3575874877,3575874890,13
0,909,23605,3575874877,3575874891,14
0,909,23606,3575874877,3575874891,14
0,909,23607,3575874877,3575874893,16
0,909,23608,3575874877,3575874893,16
0,909,23609,3575874877,3575874894,17
0,909,23610,3575874877,3575874894,17
0,909,23611,3575874877,3575874895,18
0,909,23612,3575874877,3575874895,18
0,909,23613,3575874877,3575874896,19
0,909,23614,3575874877,3575874896,19
0,909,23615,3575874877,3575874897,20
0,909,23616,3575874877,3575874897,20
0,909,23617,3575874877,3575874897,20
0,909,23618,3575874877,3575874898,21
0,909,23619,3575874877,3575874898,21
0,909,23620,3575874877,3575874899,22
0,909,23621,3575874877,3575874899,22
0,909,23622,3575874877,3575874899,22
0,909,23623,3575874877,3575874900,23
0,909,23624,3575874877,3575874900,23
0,909,23625,3575874877,3575874900,23
0,909,23626,3575874877,3575874902,25
0,909,23627,3575874877,3575874904,27
0,909,23628,3575874877,3575874904,27
0,909,23629,3575874877,3575874905,28
0,909,23630,3575874877,3575874905,28
0,909,23631,3575874877,3575874909,32
0,909,23632,3575874877,3575874912,35
0,909,23633,3575874877,3575874912,35
0,909,23634,3575874877,3575874912,35
0,909,23635,3575874877,3575874912,35
0,909,23636,3575874877,3575874913,36
0,909,23637,3575874877,3575874915,38
0,909,23638,3575874877,3575874917,40
0,909,23639,3575874877,3575874917,40
0,909,23640,3575874877,3575874918,41
0,909,23641,3575874877,3575874919,42
0,909,23642,3575874877,3575874919,42
0,909,23643,3575874877,3575874919,42
0,909,23644,3575874877,3575874919,42
0,909,23645,3575874877,3575874920,43
0,909,23646,3575874877,3575874923,46
0,909,23647,3575874877,3575874923,46
0,909,23648,3575874877,3575874924,47
0,909,23649,3575874877,3575874925,48
0,909,23650,3575874877,3575874925,48
0,909,23651,3575874877,3575874925,48
0,909,23652,3575874877,3575874926,49
0,910,23653,3575874939,3575874939,0
0,910,23654,3575874939,3575874939,0
0,910,23655,3575874939,3575874939,0
0,910,23656,3575874939,3575874939,0
0,910,23657,3575874939,3575874939,0
0,910,23658,3575874939,3575874939,0
0,910,23659,3575874939,3575874939,0
0,910,23660,3575874939,3575874939,0
0,910,23661,3575874939,3575874939,0
0,910,23662,3575874939,3575874939,0
0,910,23663,3575874939,3575874939,0
0,910,23664,3575874939,3575874939,0
0,910,23665,3575874939,3575874939,0
0,910,23666,3575874939,3575874939,0
0,910,23667,3575874939,3575874940,1
0,910,23668,3575874939,3575874941,2
0,910,23669,3575874939,3575874942,3
0,910,23670,3575874939,3575874942,3
0,910,23671,3575874939,3575874943,4
0,910,23672,3575874939,3575874943,4
0,910,23673,3575874939,3575874944,5
0,910,23674,3575874939,3575874948,9
0,910,23675,3575874939,3575874948,9
0,910,23676,3575874939,3575874948,9
0,910,23677,3575874939,3575874949,10
0,910,23678,3575874939,3575874949,10
0,910,23679,3575874939,3575874950,11
0,910,23680,3575874939,3575874950,11
0,910,23681,3575874939,3575874953,14
0,910,23682,3575874939,3575874953,14
0,910,23683,3575874939,3575874953,14
0,910,23684,3575874939,3575874954,15
0,910,23685,3575874939,3575874954,15
0,910,23686,3575874939,3575874955,16
0,910,23687,3575874939,3575874956,17
0,910,23688,3575874939,3575874956,17
0,910,23689,3575874939,3575874957,18
0,910,23690,3575874939,3575874958,19
0,910,23691,3575874939,3575874959,20
0,910,23692,3575874939,3575874960,21
0,910,23693,3575874939,3575874963,24
0,910,23694,3575874939,3575874964,25
0,910,23695,3575874939,3575874965,26
0,910,23696,3575874939,3575874965,26
0,910,23697,3575874939,3575874966,27
0,910,23698,3575874939,3575874966,27
0,910,23699,3575874939,3575874967,28
0,910,23700,3575874939,3575874970,31
0,910,23701,3575874939,3575874971,32
0,910,23702,3575874939,3575874972,33
0,910,23703,3575874939,3575874972,33
0,910,23704,3575874939,3575874975,36
0,910,23705,3575874939,3575874977,38
0,910,23706,3575874939,3575874978,39
0,910,23707,3575874939,3575874978,39
0,910,23708,3575874939,3575874979,40
0,910,23709,3575874939,3575874979,40
0,910,23710,3575874939,3575874980,41
0,910,23711,3575874939,3575874981,42
0,910,23712,3575874939,3575874982,43
0,910,23713,3575874939,3575874983,44
0,910,23714,3575874939,3575874986,47
0,910,23715,3575874939,3575874988,49
0,910,23716,3575874939,3575874988,49
0,910,23717,3575874939,3575874989,50
0,911,23718,3575875000,3575875000,0
0,911,23719,3575875000,3575875000,0
0,911,23720,3575875000,3575875000,0
0,911,23721,3575875000,3575875000,0
0,911,23722,3575875000,3575875000,0
0,911,23723,3575875000,3575875000,0
0,911,23724,3575875000,3575875000,0
0,911,23725,3575875000,3575875001,1
0,911,23726,3575875000,3575875005,5
0,911,23727,3575875000,3575875007,7
0,911,23728,3575875000,3575875007,7
0,911,23729,3575875000,3575875008,8
0,911,23730,3575875000,3575875008,8
0,911,23731,3575875000,3575875010,10
0,911,23732,3575875000,3575875013,13
0,911,23733,3575875000,3575875013,13
0,911,23734,3575875000,3575875014,14
0,911,23735,3575875000,3575875014,14
0,911,23736,3575875000,3575875015,15
0,911,23737,3575875000,3575875017,17
0,911,23738,3575875000,3575875018,18
0,911,23739,3575875000,3575875019,19
0,911,23740,3575875000,3575875022,22
0,911,23741,3575875000,3575875023,23
0,911,23742,3575875000,3575875025,25
0,911,23743,3575875000,3575875027,27
0,911,23744,3575875000,3575875028,28
0,911,23745,3575875000,3575875029,29
0,911,23746,3575875000,3575875029,29
0,911,23747,3575875000,3575875030,30
0,911,23748,3575875000,3575875032,32
0,911,23749,3575875000,3575875032,32
0,911,23750,3575875000,3575875032,32
0,911,23751,3575875000,3575875033,33
0,911,23752,3575875000,3575875034,34
0,911,23753,3575875000,3575875035,35
0,911,23754,3575875000,3575875037,37
0,911,23755,3575875000,3575875037,37
0,911,23756,3575875000,3575875042,42
0,911,23757,3575875000,3575875042,42
0,911,23758,3575875000,3575875044,44
0,911,23759,3575875000,3575875045,45
0,911,23760,3575875000,3575875045,45
0,911,23761,3575875000,3575875045,45
0,911,23762,3575875000,3575875046,46
0,911,23763,3575875000,3575875046,46
0,911,23764,3575875000,3575875047,47
0,911,23765,3575875000,3575875048,48
0,911,23766,3575875000,3575875050,50
0,912,23767,3575875065,3575875065,0
0,912,23768,3575875065,3575875065,0
0,912,23769,3575875065,3575875065,0
0,912,23770,3575875065,3575875065,0
0,912,23771,3575875065,3575875065,0
0,912,23772,3575875065,3575875065,0
0,912,23773,3575875065,3575875065,0
0,912,23774,3575875065,3575875065,0
0,912,23775,3575875065,3575875065,0
0,912,23776,3575875065,3575875065,0
0,912,23777,3575875065,3575875065,0
0,912,23778,3575875065,3575875065,0
0,912,23779,3575875065,3575875065,0
0,912,23780,3575875065,3575875065,0
0,912,23781,3575875065,3575875065,0
0,912,23782,3575875065,3575875065,0
0,912,23783,3575875065,3575875065,0
0,912,23784,3575875065,3575875065,0
0,912,23785,3575875065,3575875066,1
0,912,23786,3575875065,3575875067,2
0,912,23787,3575875065,3575875068,3
0,912,23788,3575875065,3575875068,3
0,912,23789,3575875065,3575875078,13
0,912,23790,3575875065,3575875078,13
0,912,23791,3575875065,3575875080,15
0,912,23792,3575875065,3575875082,17
0,912,23793,3575875065,3575875082,17
0,912,23794,3575875065,3575875084,19
0,912,23795,3575875065,3575875085,20
0,912,23796,3575875065,3575875086,21
0,912,23797,3575875065,3575875087,22
0,912,23798,3575875065,3575875087,22
0,912,23799,3575875065,3575875089,24
0,912,23800,3575875065,3575875090,25
0,912,23801,3575875065,3575875090,25
0,912,23802,3575875065,3575875091,26
0,912,23803,3575875065,3575875091,26
0,912,23804,3575875065,3575875093,28
0,912,23805,3575875065,3575875094,29
0,912,23806,3575875065,3575875094,29
0,912,23807,3575875065,3575875095,30
0,912,23808,3575875065,3575875095,30
0,912,23809,3575875065,3575875096,31
0,912,23810,3575875065,3575875097,32
0,912,23811,3575875065,3575875097,32
0,912,23812,3575875065,3575875097,32
0,912,23813,3575875065,3575875097,32
0,912,23814,3575875065,3575875098,33
0,912,23815,3575875065,3575875099,34
0,912,23816,3575875065,3575875100,35
0,912,23817,3575875065,3575875100,35
0,912,23818,3575875065,3575875100,35
0,912,23819,3575875065,3575875100,35
0,912,23820,3575875065,3575875100,35
0,912,23821,3575875065,3575875101,36
0,912,23822,3575875065,3575875103,38
0,912,23823,3575875065,3575875104,39
0,912,23824,3575875065,3575875104,39
0,912,23825,3575875065,3575875105,40
0,912,23826,3575875065,3575875105,40
0,912,23827,3575875065,3575875109,44
0,912,23828,3575875065,3575875109,44
0,912,23829,3575875065,3575875112,47
0,912,23830,3575875065,3575875112,47
0,912,23831,3575875065,3575875112,47
0,912,23832,3575875065,3575875112,47
0,912,23833,3575875065,3575875113,48
0,913,23834,3575875128,3575875128,0
0,913,23835,3575875128,3575875128,0
0,913,23836,3575875128,3575875128,0
0,913,23837,3575875128,3575875128,0
0,913,23838,3575875128,3575875128,0
0,913,23839,3575875128,3575875128,0
0,913,23840,3575875128,3575875128,0
0,913,23841,3575875128,3575875128,0
0,913,23842,3575875128,3575875128,0
0,913,23843,3575875128,3575875128,0
0,913,23844,3575875128,3575875128,0
0,913,23845,3575875128,3575875128,0
0,913,23846,3575875128,3575875128,0
0,913,23847,3575875128,3575875128,0
0,913,23848,3575875128,3575875128,0
0,913,23849,3575875128,3575875128,0
0,913,23850,3575875128,3575875130,2
0,913,23851,3575875128,3575875130,2
0,913,23852,3575875128,3575875130,2
0,913,23853,3575875128,3575875131,3
0,913,23854,3575875128,3575875133,5
0,913,23855,3575875128,3575875136,8
0,913,23856,3575875128,3575875136,8
0,913,23857,3575875128,3575875137,9
0,913,23858,3575875128,3575875137,9
0,913,23859,3575875128,3575875137,9
0,913,23860,3575875128,3575875138,10
0,913,23861,3575875128,3575875138,10
0,913,23862,3575875128,3575875139,11
0,913,23863,3575875128,3575875141,13
0,913,23864,3575875128,3575875142,14
0,913,23865,3575875128,3575875142,14
0,913,23866,3575875128,3575875142,14
0,913,23867,3575875128,3575875143,15
0,913,23868,3575875128,3575875144,16
0,913,23869,3575875128,3575875144,16
0,913,23870,3575875128,3575875144,16
0,913,23871,3575875128,3575875145,17
0,913,23872,3575875128,3575875148,20
0,913,23873,3575875128,3575875148,20
0,913,23874,3575875128,3575875148,20
0,913,23875,3575875128,3575875149,21
0,913,23876,3575875128,3575875149,21
0,913,23877,3575875128,3575875150,22
0,913,23878,3575875128,3575875152,24
0,913,23879,3575875128,3575875153,25
0,913,23880,3575875128,3575875154,26
0,913,23881,3575875128,3575875154,26
0,913,23882,3575875128,3575875154,26
0,913,23883,3575875128,3575875154,26
0,913,23884,3575875128,3575875154,26
0,913,23885,3575875128,3575875156,28
0,913,23886,3575875128,3575875157,29
0,913,23887,3575875128,3575875158,30
0,913,23888,3575875128,3575875159,31
0,913,23889,3575875128,3575875160,32
0,913,23890,3575875128,3575875161,33
0,913,23891,3575875128,3575875161,33
0,913,23892,3575875128,3575875161,33
0,913,23893,3575875128,3575875163,35
0,913,23894,3575875128,3575875164,36
0,913,23895,3575875128,3575875165,37
0,913,23896,3575875128,3575875165,37
0,913,23897,3575875128,3575875166,38
0,913,23898,3575875128,3575875167,39
0,913,23899,3575875128,3575875167,39
0,913,23900,3575875128,3575875170,42
0,913,23901,3575875128,3575875171,43
0,913,23902,3575875128,3575875172,44
0,913,23903,3575875128,3575875172,44
0,914,23904,3575875191,3575875191,0
0,914,23905,3575875191,3575875191,0
0,914,23906,3575875191,3575875191,0
0,914,23907,3575875191,3575875191,0
0,914,23908,3575875191,3575875191,0
0,914,23909,3575875191,3575875191,0
0,914,23910,3575875191,3575875191,0
0,914,23911,3575875191,3575875191,0
0,914,23912,3575875191,3575875191,0
0,914,23913,3575875191,3575875191,0
0,914,23914,3575875191,3575875191,0
0,914,23915,3575875191,3575875194,3
0,914,23916,3575875191,3575875194,3
0,914,23917,3575875191,3575875199,8
0,914,23918,3575875191,3575875200,9
0,914,23919,3575875191,3575875201,10
0,914,23920,3575875191,3575875205,14
0,914,23921,3575875191,3575875206,15
0,914,23922,3575875191,3575875207,16
0,914,23923,3575875191,3575875208,17
0,914,23924,3575875191,3575875208,17
0,914,23925,3575875191,3575875209,18
0,914,23926,3575875191,3575875210,19
0,914,23927,3575875191,3575875211,20
0,914,23928,3575875191,3575875213,22
0,914,23929,3575875191,3575875214,23
0,914,23930,3575875191,3575875214,23
0,914,23931,3575875191,3575875215,24
0,914,23932,3575875191,3575875215,24
0,914,23933,3575875191,3575875218,27
0,914,23934,3575875191,3575875219,28
0,914,23935,3575875191,3575875219,28
0,914,23936,3575875191,3575875222,31
0,914,23937,3575875191,3575875226,35
0,914,23938,3575875191,3575875227,36
0,914,23939,3575875191,3575875228,37
0,914,23940,3575875191,3575875228,37
0,914,23941,3575875191,3575875229,38
0,914,23942,3575875191,3575875229,38
0,914,23943,3575875191,3575875230,39
0,914,23944,3575875191,3575875232,41
0,914,23945,3575875191,3575875232,41
0,914,23946,3575875191,3575875233,42
0,914,23947,3575875191,3575875234,43
0,914,23948,3575875191,3575875235,44
0,914,23949,3575875191,3575875238,47
0,914,23950,3575875191,3575875238,47
0,915,23951,3575875250,3575875250,0
0,915,23952,3575875250,3575875250,0
0,915,23953,3575875250,3575875250,0
0,915,23954,3575875250,3575875250,0
0,915,23955,3575875250,3575875250,0
0,915,23956,3575875250,3575875250,0
0,915,23957,3575875250,3575875250,0
0,915,23958,3575875250,3575875250,0
0,915,23959,3575875250,3575875250,0
0,915,23960,3575875250,3575875250,0
0,915,23961,3575875250,3575875250,0
0,915,23962,3575875250,3575875254,4
0,915,23963,3575875250,3575875255,5
0,915,23964,3575875250,3575875257,7
0,915,23965,3575875250,3575875258,8
0,915,23966,3575875250,3575875258,8
0,915,23967,3575875250,3575875259,9
0,915,23968,3575875250,3575875259,9
0,915,23969,3575875250,3575875260,10
0,915,23970,3575875250,3575875260,10
0,915,23971,3575875250,3575875263,13
0,915,23972,3575875250,3575875264,14
0,915,23973,3575875250,3575875264,14
0,915,23974,3575875250,3575875264,14
0,915,23975,3575875250,3575875265,15
0,915,23976,3575875250,3575875265,15
0,915,23977,3575875250,3575875267,17
0,915,23978,3575875250,3575875267,17
0,915,23979,3575875250,3575875267,17
0,915,23980,3575875250,3575875268,18
0,915,23981,3575875250,3575875268,18
0,915,23982,3575875250,3575875279,29
0,915,23983,3575875250,3575875279,29
0,915,23984,3575875250,3575875281,31
0,915,23985,3575875250,3575875281,31
0,915,23986,3575875250,3575875284,34
0,915,23987,3575875250,3575875285,35
0,915,23988,3575875250,3575875287,37
0,915,23989,3575875250,3575875288,38
0,915,23990,3575875250,3575875290,40
0,915,23991,3575875250,3575875290,40
0,915,23992,3575875250,3575875291,41
0,915,23993,3575875250,3575875292,42
0,915,23994,3575875250,3575875293,43
0,915,23995,3575875250,3575875293,43
0,915,23996,3575875250,3575875294,44
0,915,23997,3575875250,3575875294,44
0,915,23998,3575875250,3575875295,45
0,915,23999,3575875250,3575875295,45
0,915,24000,3575875250,3575875296,46
0,915,24001,3575875250,3575875296,46
0,915,24002,3575875250,3575875297,47
0,915,24003,3575875250,3575875298,48
0,915,24004,3575875250,3575875298,48
0,915,24005,3575875250,3575875298,48
0,916,24006,3575875314,3575875314,0
0,916,24007,3575875314,3575875314,0
0,916,24008,3575875314,3575875314,0
0,916,24009,3575875314,3575875314,0
0,916,24010,3575875314,3575875314,0
0,916,24011,3575875314,3575875314,0
0,916,24012,3575875314,3575875314,0
0,916,24013,3575875314,3575875314,0
0,916,24014,3575875314,3575875314,0
0,916,24015,3575875314,3575875314,0
0,916,24016,3575875314,3575875314,0
0,916,24017,3575875314,3575875314,0
0,916,24018,3575875314,3575875314,0
0,916,24019,3575875314,3575875314,0
0,916,24020,3575875314,3575875314,0
0,916,24021,3575875314,3575875314,0
0,916,24022,3575875314,3575875314,0
0,916,24023,3575875314,3575875315,1
0,916,24024,3575875314,3575875317,3
0,916,24025,3575875314,3575875318,4
0,916,24026,3575875314,3575875319,5
0,916,24027,3575875314,3575875319,5
0,916,24028,3575875314,3575875320,6
0,916,24029,3575875314,3575875320,6
0,916,24030,3575875314,3575875320,6
0,916,24031,3575875314,3575875322,8
0,916,24032,3575875314,3575875323,9
0,916,24033,3575875314,3575875323,9
0,916,24034,3575875314,3575875325,11
0,916,24035,3575875314,3575875325,11
0,916,24036,3575875314,3575875326,12
0,916,24037,3575875314,3575875326,12
0,916,24038,3575875314,3575875326,12
0,916,24039,3575875314,3575875329,15
0,916,24040,3575875314,3575875329,15
0,916,24041,3575875314,3575875329,15
0,916,24042,3575875314,3575875329,15
0,916,24043,3575875314,3575875330,16
0,916,24044,3575875314,3575875331,17
0,916,24045,3575875314,3575875331,17
0,916,24046,3575875314,3575875334,20
0,916,24047,3575875314,3575875336,22
0,916,24048,3575875314,3575875336,22
0,916,24049,3575875314,3575875337,23
0,916,24050,3575875314,3575875338,24
0,916,24051,3575875314,3575875338,24
0,916,24052,3575875314,3575875339,25
0,916,24053,3575875314,3575875340,26
0,916,24054,3575875314,3575875340,26
0,916,24055,3575875314,3575875342,28
0,916,24056,3575875314,3575875342,28
0,916,24057,3575875314,3575875342,28
0,916,24058,3575875314,3575875342,28
0,916,24059,3575875314,3575875343,29
0,916,24060,3575875314,3575875344,30
0,916,24061,3575875314,3575875345,31
0,916,24062,3575875314,3575875345,31
0,916,24063,3575875314,3575875345,31
0,916,24064,3575875314,3575875348,34
0,916,24065,3575875314,3575875348,34
0,916,24066,3575875314,3575875348,34
0,916,24067,3575875314,3575875348,34
0,916,24068,3575875314,3575875349,35
0,916,24069,3575875314,3575875350,36
0,916,24070,3575875314,3575875351,37
0,916,24071,3575875314,3575875352,38
0,916,24072,3575875314,3575875353,39
0,916,24073,3575875314,3575875354,40
0,916,24074,3575875314,3575875355,41
0,916,24075,3575875314,3575875355,41
0,916,24076,3575875314,3575875355,41
0,916,24077,3575875314,3575875357,43
0,916,24078,3575875314,3575875358,44
0,916,24079,3575875314,3575875359,45
0,916,24080,3575875314,3575875361,47
0,916,24081,3575875314,3575875361,47
0,916,24082,3575875314,3575875362,48
0,916,24083,3575875314,3575875362,48
0,916,24084,3575875314,3575875363,49
0,916,24085,3575875314,3575875364,50
0,917,24086,3575875375,3575875375,0
0,917,24087,3575875375,3575875375,0
0,917,24088,3575875375,3575875375,0
0,917,24089,3575875375,3575875375,0
0,917,24090,3575875375,3575875375,0
0,917,24091,3575875375,3575875375,0
0,917,24092,3575875375,3575875375,0
0,917,24093,3575875375,3575875375,0
0,917,24094,3575875375,3575875375,0
0,917,24095,3575875375,3575875377,2
0,917,24096,3575875375,3575875378,3
0,917,24097,3575875375,3575875378,3
0,917,24098,3575875375,3575875378,3
0,917,24099,3575875375,3575875379,4
0,917,24100,3575875375,3575875379,4
0,917,24101,3575875375,3575875380,5
0,917,24102,3575875375,3575875382,7
0,917,24103,3575875375,3575875385,10
0,917,24104,3575875375,3575875387,12
0,917,24105,3575875375,3575875388,13
0,917,24106,3575875375,3575875389,14
0,917,24107,3575875375,3575875390,15
0,917,24108,3575875375,3575875394,19
0,917,24109,3575875375,3575875394,19
0,917,24110,3575875375,3575875400,25
0,917,24111,3575875375,3575875400,25
0,917,24112,3575875375,3575875400,25
0,917,24113,3575875375,3575875405,30
0,917,24114,3575875375,3575875406,31
0,917,24115,3575875375,3575875407,32
0,917,24116,3575875375,3575875408,33
0,917,24117,3575875375,3575875408,33
0,917,24118,3575875375,3575875410,35
0,917,24119,3575875375,3575875410,35
0,917,24120,3575875375,3575875410,35
0,917,24121,3575875375,3575875413,38
0,917,24122,3575875375,3575875413,38
0,917,24123,3575875375,3575875415,40
0,917,24124,3575875375,3575875415,40
0,917,24125,3575875375,3575875415,40
0,917,24126,3575875375,3575875416,41
0,917,24127,3575875375,3575875416,41
0,917,24128,3575875375,3575875419,44
0,917,24129,3575875375,3575875419,44
0,917,24130,3575875375,3575875422,47
0,917,24131,3575875375,3575875422,47
0,917,24132,3575875375,3575875425,50
0,918,24133,3575875439,3575875440,1
0,918,24134,3575875439,3575875440,1
0,918,24135,3575875439,3575875440,1
0,918,24136,3575875439,3575875440,1
0,918,24137,3575875439,3575875440,1
0,918,24138,3575875439,3575875440,1
0,918,24139,3575875439,3575875440,1
0,918,24140,3575875439,3575875440,1
0,918,24141,3575875439,3575875440,1
0,918,24142,3575875439,3575875440,1
0,918,24143,3575875439,3575875440,1
0,918,24144,3575875439,3575875440,1
0,918,24145,3575875439,3575875443,4
0,918,24146,3575875439,3575875444,5
0,918,24147,3575875439,3575875445,6
0,918,24148,3575875439,3575875445,6
0,918,24149,3575875439,3575875446,7
0,918,24150,3575875439,3575875446,7
0,918,24151,3575875439,3575875447,8
0,918,24152,3575875439,3575875448,9
0,918,24153,3575875439,3575875449,10
0,918,24154,3575875439,3575875450,11
0,918,24155,3575875439,3575875450,11
0,918,24156,3575875439,3575875455,16
0,918,24157,3575875439,3575875457,18
0,918,24158,3575875439,3575875457,18
0,918,24159,3575875439,3575875458,19
0,918,24160,3575875439,3575875458,19
0,918,24161,3575875439,3575875458,19
0,918,24162,3575875439,3575875459,20
0,918,24163,3575875439,3575875460,21
0,918,24164,3575875439,3575875460,21
0,918,24165,3575875439,3575875463,24
0,918,24166,3575875439,3575875465,26
0,918,24167,3575875439,3575875465,26
0,918,24168,3575875439,3575875465,26
0,918,24169,3575875439,3575875465,26
0,918,24170,3575875439,3575875465,26
0,918,24171,3575875439,3575875465,26
0,918,24172,3575875439,3575875467,28
0,918,24173,3575875439,3575875468,29
0,918,24174,3575875439,3575875468,29
0,918,24175,3575875439,3575875468,29
0,918,24176,3575875439,3575875477,38
0,918,24177,3575875439,3575875479,40
0,918,24178,3575875439,3575875479,40
0,918,24179,3575875439,3575875482,43
0,918,24180,3575875439,3575875484,45
0,918,24181,3575875439,3575875485,46
0,918,24182,3575875439,3575875485,46
0,918,24183,3575875439,3575875487,48
0,918,24184,3575875439,3575875487,48
0,919,24185,3575875499,3575875499,0
0,919,24186,3575875499,3575875499,0
0,919,24187,3575875499,3575875499,0
0,919,24188,3575875499,3575875499,0
0,919,24189,3575875499,3575875499,0
0,919,24190,3575875499,3575875499,0
0,919,24191,3575875499,3575875499,0
0,919,24192,3575875499,3575875499,0
0,919,24193,3575875499,3575875499,0
0,919,24194,3575875499,3575875499,0
0,919,24195,3575875499,3575875499,0
0,919,24196,3575875499,3575875499,0
0,919,24197,3575875499,3575875499,0
0,919,24198,3575875499,3575875499,0
0,919,24199,3575875499,3575875499,0
0,919,24200,3575875499,3575875499,0
0,919,24201,3575875499,3575875499,0
0,919,24202,3575875499,3575875499,0
0,919,24203,3575875499,3575875499,0
0,919,24204,3575875499,3575875499,0
0,919,24205,3575875499,3575875500,1
0,919,24206,3575875499,3575875501,2
0,919,24207,3575875499,3575875501,2
0,919,24208,3575875499,3575875501,2
0,919,24209,3575875499,3575875504,5
0,919,24210,3575875499,3575875504,5
0,919,24211,3575875499,3575875505,6
0,919,24212,3575875499,3575875505,6
0,919,24213,3575875499,3575875506,7
0,919,24214,3575875499,3575875509,10
0,919,24215,3575875499,3575875510,11
0,919,24216,3575875499,3575875512,13
0,919,24217,3575875499,3575875512,13
0,919,24218,3575875499,3575875512,13
0,919,24219,3575875499,3575875512,13
0,919,24220,3575875499,3575875512,13
0,919,24221,3575875499,3575875514,15
0,919,24222,3575875499,3575875515,16
0,919,24223,3575875499,3575875516,17
0,919,24224,3575875499,3575875517,18
0,919,24225,3575875499,3575875517,18
0,919,24226,3575875499,3575875517,18
0,919,24227,3575875499,3575875518,19
0,919,24228,3575875499,3575875518,19
0,919,24229,3575875499,3575875519,20
0,919,24230,3575875499,3575875519,20
0,919,24231,3575875499,3575875519,20
0,919,24232,3575875499,3575875522,23
0,919,24233,3575875499,3575875522,23
0,919,24234,3575875499,3575875523,24
0,919,24235,3575875499,3575875525,26
0,919,24236,3575875499,3575875525,26
0,919,24237,3575875499,3575875525,26
0,919,24238,3575875499,3575875529,30
0,919,24239,3575875499,3575875530,31
0,919,24240,3575875499,3575875530,31
0,919,24241,3575875499,3575875530,31
0,919,24242,3575875499,3575875534,35
0,919,24243,3575875499,3575875535,36
0,919,24244,3575875499,3575875535,36
0,919,24245,3575875499,3575875536,37
0,919,24246,3575875499,3575875536,37
0,919,24247,3575875499,3575875537,38
0,919,24248,3575875499,3575875538,39
0,919,24249,3575875499,3575875539,40
0,919,24250,3575875499,3575875539,40
0,919,24251,3575875499,3575875541,42
0,919,24252,3575875499,3575875541,42
0,919,24253,3575875499,3575875541,42
0,919,24254,3575875499,3575875542,43
0,919,24255,3575875499,3575875543,44
0,919,24256,3575875499,3575875543,44
0,919,24257,3575875499,3575875543,44
0,919,24258,3575875499,3575875544,45
0,919,24259,3575875499,3575875544,45
0,919,24260,3575875499,3575875547,48
0,919,24261,3575875499,3575875547,48
0,919,24262,3575875499,3575875548,49
0,919,24263,3575875499,3575875548,49
0,919,24264,3575875499,3575875548,49
0,919,24265,3575875499,3575875549,50
0,920,24266,3575875559,3575875559,0
0,920,24267,3575875559,3575875559,0
0,920,24268,3575875559,3575875559,0
0,920,24269,3575875559,3575875559,0
0,920,24270,3575875559,3575875559,0
0,920,24271,3575875559,3575875559,0
0,920,24272,3575875559,3575875559,0
0,920,24273,3575875559,3575875559,0
0,920,24274,3575875559,3575875559,0
0,920,24275,3575875559,3575875559,0
0,920,24276,3575875559,3575875559,0
0,920,24277,3575875559,3575875559,0
0,920,24278,3575875559,3575875559,0
0,920,24279,3575875559,3575875559,0
0,920,24280,3575875559,3575875560,1
0,920,24281,3575875559,3575875560,1
0,920,24282,3575875559,3575875561,2
0,920,24283,3575875559,3575875562,3
0,920,24284,3575875559,3575875564,5
0,920,24285,3575875559,3575875564,5
0,920,24286,3575875559,3575875565,6
0,920,24287,3575875559,3575875566,7
0,920,24288,3575875559,3575875566,7
0,920,24289,3575875559,3575875566,7
0,920,24290,3575875559,3575875568,9
0,920,24291,3575875559,3575875568,9
0,920,24292,3575875559,3575875569,10
0,920,24293,3575875559,3575875571,12
0,920,24294,3575875559,3575875571,12
0,920,24295,3575875559,3575875571,12
0,920,24296,3575875559,3575875574,15
0,920,24297,3575875559,3575875576,17
0,920,24298,3575875559,3575875577,18
0,920,24299,3575875559,3575875578,19
0,920,24300,3575875559,3575875578,19
0,920,24301,3575875559,3575875578,19
0,920,24302,3575875559,3575875580,21
0,920,24303,3575875559,3575875582,23
0,920,24304,3575875559,3575875584,25
0,920,24305,3575875559,3575875586,27
0,920,24306,3575875559,3575875588,29
0,920,24307,3575875559,3575875588,29
0,920,24308,3575875559,3575875589,30
0,920,24309,3575875559,3575875593,34
0,920,24310,3575875559,3575875593,34
0,920,24311,3575875559,3575875599,40
0,920,24312,3575875559,3575875599,40
0,920,24313,3575875559,3575875599,40
0,920,24314,3575875559,3575875605,46
0,920,24315,3575875559,3575875605,46
0,920,24316,3575875559,3575875606,47
0,920,24317,3575875559,3575875607,48
0,920,24318,3575875559,3575875607,48
0,920,24319,3575875559,3575875609,50
0,921,24320,3575875619,3575875619,0
0,921,24321,3575875619,3575875619,0
0,921,24322,3575875619,3575875619,0
0,921,24323,3575875619,3575875619,0
0,921,24324,3575875619,3575875619,0
0,921,24325,3575875619,3575875619,0
0,921,24326,3575875619,3575875619,0
0,921,24327,3575875619,3575875619,0
0,921,24328,3575875619,3575875619,0
0,921,24329,3575875619,3575875619,0
0,921,24330,3575875619,3575875619,0
0,921,24331,3575875619,3575875619,0
0,921,24332,3575875619,3575875619,0
0,921,24333,3575875619,3575875621,2
0,921,24334,3575875619,3575875626,7
0,921,24335,3575875619,3575875626,7
0,921,24336,3575875619,3575875626,7
0,921,24337,3575875619,3575875628,9
0,921,24338,3575875619,3575875629,10
0,921,24339,3575875619,3575875629,10
0,921,24340,3575875619,3575875629,10
0,921,24341,3575875619,3575875629,10
0,921,24342,3575875619,3575875630,11
0,921,24343,3575875619,3575875632,13
0,921,24344,3575875619,3575875632,13
0,921,24345,3575875619,3575875634,15
0,921,24346,3575875619,3575875636,17
0,921,24347,3575875619,3575875637,18
0,921,24348,3575875619,3575875637,18
0,921,24349,3575875619,3575875641,22
0,921,24350,3575875619,3575875642,23
0,921,24351,3575875619,3575875645,26
0,921,24352,3575875619,3575875645,26
0,921,24353,3575875619,3575875645,26
0,921,24354,3575875619,3575875645,26
0,921,24355,3575875619,3575875646,27
0,921,24356,3575875619,3575875648,29
0,921,24357,3575875619,3575875649,30
0,921,24358,3575875619,3575875649,30
0,921,24359,3575875619,3575875653,34
0,921,24360,3575875619,3575875654,35
0,921,24361,3575875619,3575875655,36
0,921,24362,3575875619,3575875656,37
0,921,24363,3575875619,3575875657,38
0,921,24364,3575875619,3575875657,38
0,921,24365,3575875619,3575875657,38
0,921,24366,3575875619,3575875658,39
0,921,24367,3575875619,3575875659,40
0,921,24368,3575875619,3575875660,41
0,921,24369,3575875619,3575875660,41
0,921,24370,3575875619,3575875663,44
0,921,24371,3575875619,3575875663,44
0,921,24372,3575875619,3575875664,45
0,921,24373,3575875619,3575875664,45
0,921,24374,3575875619,3575875664,45
0,921,24375,3575875619,3575875666,47
0,921,24376,3575875619,3575875666,47
0,921,24377,3575875619,3575875666,47
0,921,24378,3575875619,3575875667,48
0,921,24379,3575875619,3575875668,49
0,922,24380,3575875682,3575875682,0
0,922,24381,3575875682,3575875682,0
0,922,24382,3575875682,3575875682,0
0,922,24383,3575875682,3575875682,0
0,922,24384,3575875682,3575875682,0
0,922,24385,3575875682,3575875682,0
0,922,24386,3575875682,3575875684,2
0,922,24387,3575875682,3575875685,3
0,922,24388,3575875682,3575875686,4
0,922,24389,3575875682,3575875687,5
0,922,24390,3575875682,3575875688,6
0,922,24391,3575875682,3575875690,8
0,922,24392,3575875682,3575875691,9
0,922,24393,3575875682,3575875692,10
0,922,24394,3575875682,3575875693,11
0,922,24395,3575875682,3575875693,11
0,922,24396,3575875682,3575875694,12
0,922,24397,3575875682,3575875694,12
0,922,24398,3575875682,3575875694,12
0,922,24399,3575875682,3575875695,13
0,922,24400,3575875682,3575875695,13
0,922,24401,3575875682,3575875695,13
0,922,24402,3575875682,3575875696,14
0,922,24403,3575875682,3575875696,14
0,922,24404,3575875682,3575875696,14
0,922,24405,3575875682,3575875697,15
0,922,24406,3575875682,3575875697,15
0,922,24407,3575875682,3575875697,15
0,922,24408,3575875682,3575875699,17
0,922,24409,3575875682,3575875699,17
0,922,24410,3575875682,3575875700,18
0,922,24411,3575875682,3575875700,18
0,922,24412,3575875682,3575875700,18
0,922,24413,3575875682,3575875701,19
0,922,24414,3575875682,3575875701,19
0,922,24415,3575875682,3575875703,21
0,922,24416,3575875682,3575875703,21
0,922,24417,3575875682,3575875704,22
0,922,24418,3575875682,3575875704,22
0,922,24419,3575875682,3575875705,23
0,922,24420,3575875682,3575875705,23
0,922,24421,3575875682,3575875706,24
0,922,24422,3575875682,3575875708,26
0,922,24423,3575875682,3575875710,28
0,922,24424,3575875682,3575875711,29
0,922,24425,3575875682,3575875712,30
0,922,24426,3575875682,3575875713,31
0,922,24427,3575875682,3575875713,31
0,922,24428,3575875682,3575875714,32
0,922,24429,3575875682,3575875715,33
0,922,24430,3575875682,3575875715,33
0,922,24431,3575875682,3575875717,35
0,922,24432,3575875682,3575875717,35
0,922,24433,3575875682,3575875718,36
0,922,24434,3575875682,3575875718,36
0,922,24435,3575875682,3575875719,37
0,922,24436,3575875682,3575875719,37
0,922,24437,3575875682,3575875719,37
0,922,24438,3575875682,3575875720,38
0,922,24439,3575875682,3575875722,40
0,922,24440,3575875682,3575875722,40
0,922,24441,3575875682,3575875722,40
0,922,24442,3575875682,3575875723,41
0,922,24443,3575875682,3575875723,41
0,922,24444,3575875682,3575875725,43
0,922,24445,3575875682,3575875726,44
0,922,24446,3575875682,3575875727,45
0,922,24447,3575875682,3575875729,47
0,922,24448,3575875682,3575875730,48
0,922,24449,3575875682,3575875730,48
0,923,24450,3575875745,3575875745,0
0,923,24451,3575875745,3575875745,0
0,923,24452,3575875745,3575875745,0
0,923,24453,3575875745,3575875745,0
0,923,24454,3575875745,3575875745,0
0,923,24455,3575875745,3575875745,0
0,923,24456,3575875745,3575875745,0
0,923,24457,3575875745,3575875745,0
0,923,24458,3575875745,3575875745,0
0,923,24459,3575875745,3575875745,0
0,923,24460,3575875745,3575875745,0
0,923,24461,3575875745,3575875745,0
0,923,24462,3575875745,3575875745,0
0,923,24463,3575875745,3575875745,0
0,923,24464,3575875745,3575875745,0
0,923,24465,3575875745,3575875745,0
0,923,24466,3575875745,3575875745,0
0,923,24467,3575875745,3575875747,2
0,923,24468,3575875745,3575875747,2
0,923,24469,3575875745,3575875748,3
0,923,24470,3575875745,3575875748,3
0,923,24471,3575875745,3575875748,3
0,923,24472,3575875745,3575875749,4
0,923,24473,3575875745,3575875750,5
0,923,24474,3575875745,3575875750,5
0,923,24475,3575875745,3575875752,7
0,923,24476,3575875745,3575875752,7
0,923,24477,3575875745,3575875753,8
0,923,24478,3575875745,3575875753,8
0,923,24479,3575875745,3575875754,9
0,923,24480,3575875745,3575875754,9
0,923,24481,3575875745,3575875755,10
0,923,24482,3575875745,3575875755,10
0,923,24483,3575875745,3575875756,11
0,923,24484,3575875745,3575875758,13
0,923,24485,3575875745,3575875759,14
0,923,24486,3575875745,3575875760,15
0,923,24487,3575875745,3575875760,15
0,923,24488,3575875745,3575875761,16
0,923,24489,3575875745,3575875761,16
0,923,24490,3575875745,3575875761,16
0,923,24491,3575875745,3575875762,17
0,923,24492,3575875745,3575875764,19
0,923,24493,3575875745,3575875764,19
0,923,24494,3575875745,3575875766,21
0,923,24495,3575875745,3575875766,21
0,923,24496,3575875745,3575875766,21
0,923,24497,3575875745,3575875768,23
0,923,24498,3575875745,3575875770,25
0,923,24499,3575875745,3575875771,26
0,923,24500,3575875745,3575875771,26
0,923,24501,3575875745,3575875771,26
0,923,24502,3575875745,3575875772,27
0,923,24503,3575875745,3575875774,29
0,923,24504,3575875745,3575875776,31
0,923,24505,3575875745,3575875777,32
0,923,24506,3575875745,3575875777,32
0,923,24507,3575875745,3575875778,33
0,923,24508,3575875745,3575875778,33
0,923,24509,3575875745,3575875779,34
0,923,24510,3575875745,3575875780,35
0,923,24511,3575875745,3575875782,37
0,923,24512,3575875745,3575875785,40
0,923,24513,3575875745,3575875786,41
0,923,24514,3575875745,3575875788,43
0,923,24515,3575875745,3575875788,43
0,923,24516,3575875745,3575875789,44
0,923,24517,3575875745,3575875790,45
0,923,24518,3575875745,3575875793,48
0,923,24519,3575875745,3575875794,49
0,924,24520,3575875808,3575875808,0
0,924,24521,3575875808,3575875808,0
0,924,24522,3575875808,3575875808,0
0,924,24523,3575875808,3575875808,0
0,924,24524,3575875808,3575875808,0
0,924,24525,3575875808,3575875808,0
0,924,24526,3575875808,3575875808,0
0,924,24527,3575875808,3575875808,0
0,924,24528,3575875808,3575875808,0
0,924,24529,3575875808,3575875810,2
0,924,24530,3575875808,3575875810,2
0,924,24531,3575875808,3575875811,3
0,924,24532,3575875808,3575875813,5
0,924,24533,3575875808,3575875814,6
0,924,24534,3575875808,3575875814,6
0,924,24535,3575875808,3575875815,7
0,924,24536,3575875808,3575875815,7
0,924,24537,3575875808,3575875815,7
0,924,24538,3575875808,3575875816,8
0,924,24539,3575875808,3575875817,9
0,924,24540,3575875808,3575875817,9
0,924,24541,3575875808,3575875818,10
0,924,24542,3575875808,3575875818,10
0,924,24543,3575875808,3575875821,13
0,924,24544,3575875808,3575875822,14
0,924,24545,3575875808,3575875823,15
0,924,24546,3575875808,3575875826,18
0,924,24547,3575875808,3575875827,19
0,924,24548,3575875808,3575875827,19
0,924,24549,3575875808,3575875828,20
0,924,24550,3575875808,3575875828,20
0,924,24551,3575875808,3575875828,20
0,924,24552,3575875808,3575875829,21
0,924,24553,3575875808,3575875829,21
0,924,24554,3575875808,3575875830,22
0,924,24555,3575875808,3575875832,24
0,924,24556,3575875808,3575875832,24
0,924,24557,3575875808,3575875832,24
0,924,24558,3575875808,3575875832,24
0,924,24559,3575875808,3575875834,26
0,924,24560,3575875808,3575875835,27
0,924,24561,3575875808,3575875837,29
0,924,24562,3575875808,3575875837,29
0,924,24563,3575875808,3575875837,29
0,924,24564,3575875808,3575875841,33
0,924,24565,3575875808,3575875842,34
0,924,24566,3575875808,3575875844,36
0,924,24567,3575875808,3575875845,37
0,924,24568,3575875808,3575875845,37
0,924,24569,3575875808,3575875846,38
0,924,24570,3575875808,3575875848,40
0,924,24571,3575875808,3575875849,41
0,924,24572,3575875808,3575875850,42
0,924,24573,3575875808,3575875850,42
0,924,24574,3575875808,3575875853,45
0,924,24575,3575875808,3575875854,46
0,924,24576,3575875808,3575875855,47
0,924,24577,3575875808,3575875857,49
0,924,24578,3575875808,3575875857,49
0,924,24579,3575875808,3575875857,49
0,924,24580,3575875808,3575875858,50
0,925,24581,3575875868,3575875868,0
0,925,24582,3575875868,3575875868,0
0,925,24583,3575875868,3575875868,0
0,925,24584,3575875868,3575875868,0
0,925,24585,3575875868,3575875868,0
0,925,24586,3575875868,3575875868,0
0,925,24587,3575875868,3575875868,0
0,925,24588,3575875868,3575875868,0
0,925,24589,3575875868,3575875868,0
0,925,24590,3575875868,3575875868,0
0,925,24591,3575875868,3575875868,0
0,925,24592,3575875868,3575875868,0
0,925,24593,3575875868,3575875868,0
0,925,24594,3575875868,3575875869,1
0,925,24595,3575875868,3575875871,3
0,925,24596,3575875868,3575875872,4
0,925,24597,3575875868,3575875877,9
0,925,24598,3575875868,3575875879,11
0,925,24599,3575875868,3575875879,11
0,925,24600,3575875868,3575875880,12
0,925,24601,3575875868,3575875881,13
0,925,24602,3575875868,3575875882,14
0,925,24603,3575875868,3575875884,16
0,925,24604,3575875868,3575875884,16
0,925,24605,3575875868,3575875885,17
0,925,24606,3575875868,3575875887,19
0,925,24607,3575875868,3575875887,19
0,925,24608,3575875868,3575875887,19
0,925,24609,3575875868,3575875891,23
0,925,24610,3575875868,3575875893,25
0,925,24611,3575875868,3575875894,26
0,925,24612,3575875868,3575875894,26
0,925,24613,3575875868,3575875894,26
0,925,24614,3575875868,3575875895,27
0,925,24615,3575875868,3575875895,27
0,925,24616,3575875868,3575875896,28
0,925,24617,3575875868,3575875896,28
0,925,24618,3575875868,3575875896,28
0,925,24619,3575875868,3575875896,28
0,925,24620,3575875868,3575875896,28
0,925,24621,3575875868,3575875897,29
0,925,24622,3575875868,3575875897,29
0,925,24623,3575875868,3575875897,29
0,925,24624,3575875868,3575875899,31
0,925,24625,3575875868,3575875900,32
0,925,24626,3575875868,3575875900,32
0,925,24627,3575875868,3575875901,33
0,925,24628,3575875868,3575875901,33
0,925,24629,3575875868,3575875901,33
0,925,24630,3575875868,3575875901,33
0,925,24631,3575875868,3575875902,34
0,925,24632,3575875868,3575875903,35
0,925,24633,3575875868,3575875904,36
0,925,24634,3575875868,3575875905,37
0,925,24635,3575875868,3575875906,38
0,925,24636,3575875868,3575875906,38
0,925,24637,3575875868,3575875908,40
0,925,24638,3575875868,3575875909,41
0,925,24639,3575875868,3575875909,41
0,925,24640,3575875868,3575875912,44
0,925,24641,3575875868,3575875912,44
0,925,24642,3575875868,3575875912,44
0,925,24643,3575875868,3575875912,44
0,925,24644,3575875868,3575875913,45
0,925,24645,3575875868,3575875914,46
0,925,24646,3575875868,3575875914,46
0,925,24647,3575875868,3575875915,47
0,925,24648,3575875868,3575875916,48
0,925,24649,3575875868,3575875918,50
0,926,24650,3575875931,3575875931,0
0,926,24651,3575875931,3575875931,0
0,926,24652,3575875931,3575875931,0
0,926,24653,3575875931,3575875931,0
0,926,24654,3575875931,3575875931,0
0,926,24655,3575875931,3575875931,0
0,926,24656,3575875931,3575875931,0
0,926,24657,3575875931,3575875931,0
0,926,24658,3575875931,3575875931,0
0,926,24659,3575875931,3575875931,0
0,926,24660,3575875931,3575875931,0
0,926,24661,3575875931,3575875932,1
0,926,24662,3575875931,3575875932,1
0,926,24663,3575875931,3575875932,1
0,926,24664,3575875931,3575875932,1
0,926,24665,3575875931,3575875932,1
0,926,24666,3575875931,3575875932,1
0,926,24667,3575875931,3575875932,1
0,926,24668,3575875931,3575875934,3
0,926,24669,3575875931,3575875936,5
0,926,24670,3575875931,3575875936,5
0,926,24671,3575875931,3575875937,6
0,926,24672,3575875931,3575875937,6
0,926,24673,3575875931,3575875937,6
0,926,24674,3575875931,3575875938,7
0,926,24675,3575875931,3575875939,8
0,926,24676,3575875931,3575875941,10
0,926,24677,3575875931,3575875942,11
0,926,24678,3575875931,3575875942,11
0,926,24679,3575875931,3575875943,12
0,926,24680,3575875931,3575875943,12
0,926,24681,3575875931,3575875944,13
0,926,24682,3575875931,3575875945,14
0,926,24683,3575875931,3575875946,15
0,926,24684,3575875931,3575875946,15
0,926,24685,3575875931,3575875948,17
0,926,24686,3575875931,3575875948,17
0,926,24687,3575875931,3575875948,17
0,926,24688,3575875931,3575875948,17
0,926,24689,3575875931,3575875949,18
0,926,24690,3575875931,3575875950,19
0,926,24691,3575875931,3575875951,20
0,926,24692,3575875931,3575875953,22
0,926,24693,3575875931,3575875953,22
0,926,24694,3575875931,3575875953,22
0,926,24695,3575875931,3575875953,22
0,926,24696,3575875931,3575875954,23
0,926,24697,3575875931,3575875955,24
0,926,24698,3575875931,3575875955,24
0,926,24699,3575875931,3575875957,26
0,926,24700,3575875931,3575875958,27
0,926,24701,3575875931,3575875959,28
0,926,24702,3575875931,3575875960,29
0,926,24703,3575875931,3575875960,29
0,926,24704,3575875931,3575875961,30
0,926,24705,3575875931,3575875964,33
0,926,24706,3575875931,3575875964,33
0,926,24707,3575875931,3575875965,34
0,926,24708,3575875931,3575875966,35
0,926,24709,3575875931,3575875966,35
0,926,24710,3575875931,3575875968,37
0,926,24711,3575875931,3575875968,37
0,926,24712,3575875931,3575875970,39
0,926,24713,3575875931,3575875971,40
0,926,24714,3575875931,3575875971,40
0,926,24715,3575875931,3575875972,41
0,926,24716,3575875931,3575875974,43
0,926,24717,3575875931,3575875975,44
0,926,24718,3575875931,3575875977,46
0,926,24719,3575875931,3575875977,46
0,926,24720,3575875931,3575875977,46
0,926,24721,3575875931,3575875978,47
0,926,24722,3575875931,3575875980,49
0,926,24723,3575875931,3575875980,49
0,927,24724,3575875994,3575875994,0
0,927,24725,3575875994,3575875994,0
0,927,24726,3575875994,3575875994,0
0,927,24727,3575875994,3575875994,0
0,927,24728,3575875994,3575875994,0
0,927,24729,3575875994,3575875994,0
0,927,24730,3575875994,3575875994,0
0,927,24731,3575875994,3575875994,0
0,927,24732,3575875994,3575875994,0
0,927,24733,3575875994,3575875997,3
0,927,24734,3575875994,3575875999,5
0,927,24735,3575875994,3575875999,5
0,927,24736,3575875994,3575876000,6
0,927,24737,3575875994,3575876005,11
0,927,24738,3575875994,3575876006,12
0,927,24739,3575875994,3575876006,12
0,927,24740,3575875994,3575876008,14
0,927,24741,3575875994,3575876009,15
0,927,24742,3575875994,3575876010,16
0,927,24743,3575875994,3575876012,18
0,927,24744,3575875994,3575876013,19
0,927,24745,3575875994,3575876014,20
0,927,24746,3575875994,3575876014,20
0,927,24747,3575875994,3575876015,21
0,927,24748,3575875994,3575876015,21
0,927,24749,3575875994,3575876016,22
0,927,24750,3575875994,3575876017,23
0,927,24751,3575875994,3575876018,24
0,927,24752,3575875994,3575876018,24
0,927,24753,3575875994,3575876021,27
0,927,24754,3575875994,3575876021,27
0,927,24755,3575875994,3575876027,33
0,927,24756,3575875994,3575876027,33
0,927,24757,3575875994,3575876027,33
0,927,24758,3575875994,3575876028,34
0,927,24759,3575875994,3575876028,34
0,927,24760,3575875994,3575876028,34
0,927,24761,3575875994,3575876029,35
0,927,24762,3575875994,3575876030,36
0,927,24763,3575875994,3575876032,38
0,927,24764,3575875994,3575876032,38
0,927,24765,3575875994,3575876033,39
0,927,24766,3575875994,3575876033,39
0,927,24767,3575875994,3575876035,41
0,927,24768,3575875994,3575876036,42
0,927,24769,3575875994,3575876037,43
0,927,24770,3575875994,3575876037,43
0,927,24771,3575875994,3575876042,48
0,928,24772,3575876056,3575876056,0
0,928,24773,3575876056,3575876056,0
0,928,24774,3575876056,3575876056,0
0,928,24775,3575876056,3575876056,0
0,928,24776,3575876056,3575876056,0
0,928,24777,3575876056,3575876056,0
0,928,24778,3575876056,3575876056,0
0,928,24779,3575876056,3575876056,0
0,928,24780,3575876056,3575876056,0
0,928,24781,3575876056,3575876056,0
0,928,24782,3575876056,3575876057,1
0,928,24783,3575876056,3575876057,1
0,928,24784,3575876056,3575876058,2
0,928,24785,3575876056,3575876059,3
0,928,24786,3575876056,3575876060,4
0,928,24787,3575876056,3575876062,6
0,928,24788,3575876056,3575876063,7
0,928,24789,3575876056,3575876064,8
0,928,24790,3575876056,3575876064,8
0,928,24791,3575876056,3575876065,9
0,928,24792,3575876056,3575876065,9
0,928,24793,3575876056,3575876066,10
0,928,24794,3575876056,3575876066,10
0,928,24795,3575876056,3575876066,10
0,928,24796,3575876056,3575876067,11
0,928,24797,3575876056,3575876069,13
0,928,24798,3575876056,3575876071,15
0,928,24799,3575876056,3575876071,15
0,928,24800,3575876056,3575876077,21
0,928,24801,3575876056,3575876079,23
0,928,24802,3575876056,3575876080,24
0,928,24803,3575876056,3575876081,25
0,928,24804,3575876056,3575876081,25
0,928,24805,3575876056,3575876082,26
0,928,24806,3575876056,3575876082,26
0,928,24807,3575876056,3575876085,29
0,928,24808,3575876056,3575876085,29
0,928,24809,3575876056,3575876086,30
0,928,24810,3575876056,3575876087,31
0,928,24811,3575876056,3575876088,32
0,928,24812,3575876056,3575876088,32
0,928,24813,3575876056,3575876091,35
0,928,24814,3575876056,3575876092,36
0,928,24815,3575876056,3575876093,37
0,928,24816,3575876056,3575876094,38
0,928,24817,3575876056,3575876094,38
0,928,24818,3575876056,3575876095,39
0,928,24819,3575876056,3575876095,39
0,928,24820,3575876056,3575876095,39
0,928,24821,3575876056,3575876096,40
0,928,24822,3575876056,3575876096,40
0,928,24823,3575876056,3575876096,40
0,928,24824,3575876056,3575876096,40
0,928,24825,3575876056,3575876097,41
0,928,24826,3575876056,3575876097,41
0,928,24827,3575876056,3575876097,41
0,928,24828,3575876056,3575876098,42
0,928,24829,3575876056,3575876099,43
0,928,24830,3575876056,3575876100,44
0,928,24831,3575876056,3575876100,44
0,928,24832,3575876056,3575876100,44
0,928,24833,3575876056,3575876101,45
0,928,24834,3575876056,3575876102,46
0,928,24835,3575876056,3575876102,46
0,928,24836,3575876056,3575876104,48
0,928,24837,3575876056,3575876104,48
0,928,24838,3575876056,3575876105,49
0,928,24839,3575876056,3575876105,49
0,928,24840,3575876056,3575876106,50
0,929,24841,3575876117,3575876117,0
0,929,24842,3575876117,3575876118,1
0,929,24843,3575876117,3575876118,1
0,929,24844,3575876117,3575876118,1
0,929,24845,3575876117,3575876118,1
0,929,24846,3575876117,3575876118,1
0,929,24847,3575876117,3575876118,1
0,929,24848,3575876117,3575876118,1
0,929,24849,3575876117,3575876118,1
0,929,24850,3575876117,3575876118,1
0,929,24851,3575876117,3575876118,1
0,929,24852,3575876117,3575876118,1
0,929,24853,3575876117,3575876119,2
0,929,24854,3575876117,3575876120,3
0,929,24855,3575876117,3575876121,4
0,929,24856,3575876117,3575876121,4
0,929,24857,3575876117,3575876122,5
0,929,24858,3575876117,3575876124,7
0,929,24859,3575876117,3575876124,7
0,929,24860,3575876117,3575876124,7
0,929,24861,3575876117,3575876125,8
0,929,24862,3575876117,3575876127,10
0,929,24863,3575876117,3575876127,10
0,929,24864,3575876117,3575876127,10
0,929,24865,3575876117,3575876128,11
0,929,24866,3575876117,3575876129,12
0,929,24867,3575876117,3575876131,14
0,929,24868,3575876117,3575876131,14
0,929,24869,3575876117,3575876131,14
0,929,24870,3575876117,3575876134,17
0,929,24871,3575876117,3575876134,17
0,929,24872,3575876117,3575876136,19
0,929,24873,3575876117,3575876137,20
0,929,24874,3575876117,3575876137,20
0,929,24875,3575876117,3575876138,21
0,929,24876,3575876117,3575876138,21
0,929,24877,3575876117,3575876139,22
0,929,24878,3575876117,3575876139,22
0,929,24879,3575876117,3575876139,22
0,929,24880,3575876117,3575876141,24
0,929,24881,3575876117,3575876142,25
0,929,24882,3575876117,3575876142,25
0,929,24883,3575876117,3575876142,25
0,929,24884,3575876117,3575876144,27
0,929,24885,3575876117,3575876146,29
0,929,24886,3575876117,3575876148,31
0,929,24887,3575876117,3575876148,31
0,929,24888,3575876117,3575876150,33
0,929,24889,3575876117,3575876151,34
0,929,24890,3575876117,3575876153,36
0,929,24891,3575876117,3575876153,36
0,929,24892,3575876117,3575876154,37
0,929,24893,3575876117,3575876154,37
0,929,24894,3575876117,3575876154,37
0,929,24895,3575876117,3575876154,37
0,929,24896,3575876117,3575876155,38
0,929,24897,3575876117,3575876157,40
0,929,24898,3575876117,3575876158,41
0,929,24899,3575876117,3575876159,42
0,929,24900,3575876117,3575876160,43
0,929,24901,3575876117,3575876160,43
0,929,24902,3575876117,3575876161,44
0,929,24903,3575876117,3575876162,45
0,929,24904,3575876117,3575876163,46
0,929,24905,3575876117,3575876164,47
0,929,24906,3575876117,3575876166,49
0,929,24907,3575876117,3575876166,49
0,930,24908,3575876177,3575876177,0
0,930,24909,3575876177,3575876177,0
0,930,24910,3575876177,3575876177,0
0,930,24911,3575876177,3575876177,0
0,930,24912,3575876177,3575876177,0
0,930,24913,3575876177,3575876177,0
0,930,24914,3575876177,3575876178,1
0,930,24915,3575876177,3575876178,1
0,930,24916,3575876177,3575876178,1
0,930,24917,3575876177,3575876180,3
0,930,24918,3575876177,3575876180,3
0,930,24919,3575876177,3575876182,5
0,930,24920,3575876177,3575876182,5
0,930,24921,3575876177,3575876185,8
0,930,24922,3575876177,3575876188,11
0,930,24923,3575876177,3575876189,12
0,930,24924,3575876177,3575876189,12
0,930,24925,3575876177,3575876190,13
0,930,24926,3575876177,3575876190,13
0,930,24927,3575876177,3575876193,16
0,930,24928,3575876177,3575876195,18
0,930,24929,3575876177,3575876198,21
0,930,24930,3575876177,3575876199,22
0,930,24931,3575876177,3575876200,23
0,930,24932,3575876177,3575876201,24
0,930,24933,3575876177,3575876205,28
0,930,24934,3575876177,3575876205,28
0,930,24935,3575876177,3575876206,29
0,930,24936,3575876177,3575876207,30
0,930,24937,3575876177,3575876208,31
0,930,24938,3575876177,3575876210,33
0,930,24939,3575876177,3575876211,34
0,930,24940,3575876177,3575876213,36
0,930,24941,3575876177,3575876213,36
0,930,24942,3575876177,3575876214,37
0,930,24943,3575876177,3575876214,37
0,930,24944,3575876177,3575876214,37
0,930,24945,3575876177,3575876215,38
0,930,24946,3575876177,3575876215,38
0,930,24947,3575876177,3575876216,39
0,930,24948,3575876177,3575876218,41
0,930,24949,3575876177,3575876218,41
0,930,24950,3575876177,3575876218,41
0,930,24951,3575876177,3575876218,41
0,930,24952,3575876177,3575876221,44
0,930,24953,3575876177,3575876222,45
0,931,24954,3575876237,3575876237,0
0,931,24955,3575876237,3575876237,0
0,931,24956,3575876237,3575876237,0
0,931,24957,3575876237,3575876237,0
0,931,24958,3575876237,3575876237,0
0,931,24959,3575876237,3575876237,0
0,931,24960,3575876237,3575876237,0
0,931,24961,3575876237,3575876237,0
0,931,24962,3575876237,3575876237,0
0,931,24963,3575876237,3575876237,0
0,931,24964,3575876237,3575876237,0
0,931,24965,3575876237,3575876237,0
0,931,24966,3575876237,3575876237,0
0,931,24967,3575876237,3575876237,0
0,931,24968,3575876237,3575876237,0
0,931,24969,3575876237,3575876237,0
0,931,24970,3575876237,3575876238,1
0,931,24971,3575876237,3575876241,4
0,931,24972,3575876237,3575876242,5
0,931,24973,3575876237,3575876244,7
0,931,24974,3575876237,3575876245,8
0,931,24975,3575876237,3575876245,8
0,931,24976,3575876237,3575876246,9
0,931,24977,3575876237,3575876249,12
0,931,24978,3575876237,3575876250,13
0,931,24979,3575876237,3575876250,13
0,931,24980,3575876237,3575876251,14
0,931,24981,3575876237,3575876251,14
0,931,24982,3575876237,3575876253,16
0,931,24983,3575876237,3575876256,19
0,931,24984,3575876237,3575876257,20
0,931,24985,3575876237,3575876258,21
0,931,24986,3575876237,3575876259,22
0,931,24987,3575876237,3575876259,22
0,931,24988,3575876237,3575876260,23
0,931,24989,3575876237,3575876260,23
0,931,24990,3575876237,3575876260,23
0,931,24991,3575876237,3575876263,26
0,931,24992,3575876237,3575876264,27
0,931,24993,3575876237,3575876264,27
0,931,24994,3575876237,3575876265,28
0,931,24995,3575876237,3575876265,28
0,931,24996,3575876237,3575876266,29
0,931,24997,3575876237,3575876266,29
0,931,24998,3575876237,3575876267,30
0,931,24999,3575876237,3575876268,31
0,931,25000,3575876237,3575876269,32
0,931,25001,3575876237,3575876271,34
0,931,25002,3575876237,3575876271,34
0,931,25003,3575876237,3575876277,40
0,931,25004,3575876237,3575876278,41
0,931,25005,3575876237,3575876279,42
0,931,25006,3575876237,3575876281,44
0,931,25007,3575876237,3575876281,44
0,931,25008,3575876237,3575876282,45
0,931,25009,3575876237,3575876283,46
0,931,25010,3575876237,3575876285,48
0,931,25011,3575876237,3575876285,48
0,931,25012,3575876237,3575876286,49
0,931,25013,3575876237,3575876287,50
0,932,25014,3575876300,3575876300,0
0,932,25015,3575876300,3575876300,0
0,932,25016,3575876300,3575876300,0
0,932,25017,3575876300,3575876300,0
0,932,25018,3575876300,3575876300,0
0,932,25019,3575876300,3575876300,0
0,932,25020,3575876300,3575876300,0
0,932,25021,3575876300,3575876300,0
0,932,25022,3575876300,3575876300,0
0,932,25023,3575876300,3575876300,0
0,932,25024,3575876300,3575876300,0
0,932,25025,3575876300,3575876300,0
0,932,25026,3575876300,3575876300,0
0,932,25027,3575876300,3575876300,0
0,932,25028,3575876300,3575876300,0
0,932,25029,3575876300,3575876300,0
0,932,25030,3575876300,3575876300,0
0,932,25031,3575876300,3575876300,0
0,932,25032,3575876300,3575876300,0
0,932,25033,3575876300,3575876300,0
0,932,25034,3575876300,3575876300,0
0,932,25035,3575876300,3575876301,1
0,932,25036,3575876300,3575876301,1
0,932,25037,3575876300,3575876302,2
0,932,25038,3575876300,3575876302,2
0,932,25039,3575876300,3575876302,2
0,932,25040,3575876300,3575876303,3
0,932,25041,3575876300,3575876305,5
0,932,25042,3575876300,3575876305,5
0,932,25043,3575876300,3575876305,5
0,932,25044,3575876300,3575876305,5
0,932,25045,3575876300,3575876307,7
0,932,25046,3575876300,3575876307,7
0,932,25047,3575876300,3575876310,10
0,932,25048,3575876300,3575876310,10
0,932,25049,3575876300,3575876311,11
0,932,25050,3575876300,3575876313,13
0,932,25051,3575876300,3575876313,13
0,932,25052,3575876300,3575876313,13
0,932,25053,3575876300,3575876314,14
0,932,25054,3575876300,3575876314,14
0,932,25055,3575876300,3575876315,15
0,932,25056,3575876300,3575876315,15
0,932,25057,3575876300,3575876317,17
0,932,25058,3575876300,3575876318,18
0,932,25059,3575876300,3575876318,18
0,932,25060,3575876300,3575876319,19
0,932,25061,3575876300,3575876321,21
0,932,25062,3575876300,3575876321,21
0,932,25063,3575876300,3575876321,21
0,932,25064,3575876300,3575876322,22
0,932,25065,3575876300,3575876324,24
0,932,25066,3575876300,3575876324,24
0,932,25067,3575876300,3575876324,24
0,932,25068,3575876300,3575876326,26
0,932,25069,3575876300,3575876327,27
0,932,25070,3575876300,3575876327,27
0,932,25071,3575876300,3575876328,28
0,932,25072,3575876300,3575876329,29
0,932,25073,3575876300,3575876331,31
0,932,25074,3575876300,3575876332,32
0,932,25075,3575876300,3575876332,32
0,932,25076,3575876300,3575876335,35
0,932,25077,3575876300,3575876336,36
0,932,25078,3575876300,3575876337,37
0,932,25079,3575876300,3575876337,37
0,932,25080,3575876300,3575876337,37
0,932,25081,3575876300,3575876338,38
0,932,25082,3575876300,3575876340,40
0,932,25083,3575876300,3575876341,41
0,932,25084,3575876300,3575876342,42
0,932,25085,3575876300,3575876342,42
0,932,25086,3575876300,3575876343,43
0,932,25087,3575876300,3575876343,43
0,932,25088,3575876300,3575876344,44
0,932,25089,3575876300,3575876344,44
0,932,25090,3575876300,3575876345,45
0,932,25091,3575876300,3575876345,45
0,932,25092,3575876300,3575876348,48
0,932,25093,3575876300,3575876349,49
0,932,25094,3575876300,3575876349,49
0,933,25095,3575876362,3575876362,0
0,933,25096,3575876362,3575876362,0
0,933,25097,3575876362,3575876362,0
0,933,25098,3575876362,3575876362,0
0,933,25099,3575876362,3575876362,0
0,933,25100,3575876362,3575876362,0
0,933,25101,3575876362,3575876362,0
0,933,25102,3575876362,3575876362,0
0,933,25103,3575876362,3575876362,0
0,933,25104,3575876362,3575876362,0
0,933,25105,3575876362,3575876363,1
0,933,25106,3575876362,3575876363,1
0,933,25107,3575876362,3575876364,2
0,933,25108,3575876362,3575876365,3
0,933,25109,3575876362,3575876366,4
0,933,25110,3575876362,3575876366,4
0,933,25111,3575876362,3575876367,5
0,933,25112,3575876362,3575876368,6
0,933,25113,3575876362,3575876369,7
0,933,25114,3575876362,3575876370,8
0,933,25115,3575876362,3575876372,10
0,933,25116,3575876362,3575876372,10
0,933,25117,3575876362,3575876372,10
0,933,25118,3575876362,3575876374,12
0,933,25119,3575876362,3575876378,16
0,933,25120,3575876362,3575876379,17
0,933,25121,3575876362,3575876380,18
0,933,25122,3575876362,3575876381,19
0,933,25123,3575876362,3575876382,20
0,933,25124,3575876362,3575876382,20
0,933,25125,3575876362,3575876385,23
0,933,25126,3575876362,3575876386,24
0,933,25127,3575876362,3575876389,27
0,933,25128,3575876362,3575876389,27
0,933,25129,3575876362,3575876390,28
0,933,25130,3575876362,3575876394,32
0,933,25131,3575876362,3575876395,33
0,933,25132,3575876362,3575876398,36
0,933,25133,3575876362,3575876399,37
0,933,25134,3575876362,3575876401,39
0,933,25135,3575876362,3575876401,39
0,933,25136,3575876362,3575876406,44
0,933,25137,3575876362,3575876406,44
0,933,25138,3575876362,3575876406,44
0,933,25139,3575876362,3575876408,46
0,933,25140,3575876362,3575876410,48
0,933,25141,3575876362,3575876411,49
0,934,25142,3575876422,3575876422,0
0,934,25143,3575876422,3575876422,0
0,934,25144,3575876422,3575876422,0
0,934,25145,3575876422,3575876422,0
0,934,25146,3575876422,3575876422,0
0,934,25147,3575876422,3575876422,0
0,934,25148,3575876422,3575876422,0
0,934,25149,3575876422,3575876422,0
0,934,25150,3575876422,3575876422,0
0,934,25151,3575876422,3575876422,0
0,934,25152,3575876422,3575876422,0
0,934,25153,3575876422,3575876422,0
0,934,25154,3575876422,3575876422,0
0,934,25155,3575876422,3575876422,0
0,934,25156,3575876422,3575876427,5
0,934,25157,3575876422,3575876428,6
0,934,25158,3575876422,3575876428,6
0,934,25159,3575876422,3575876428,6
0,934,25160,3575876422,3575876429,7
0,934,25161,3575876422,3575876430,8
0,934,25162,3575876422,3575876432,10
0,934,25163,3575876422,3575876433,11
0,934,25164,3575876422,3575876433,11
0,934,25165,3575876422,3575876434,12
0,934,25166,3575876422,3575876435,13
0,934,25167,3575876422,3575876437,15
0,934,25168,3575876422,3575876438,16
0,934,25169,3575876422,3575876441,19
0,934,25170,3575876422,3575876442,20
0,934,25171,3575876422,3575876443,21
0,934,25172,3575876422,3575876445,23
0,934,25173,3575876422,3575876446,24
0,934,25174,3575876422,3575876446,24
0,934,25175,3575876422,3575876449,27
0,934,25176,3575876422,3575876449,27
0,934,25177,3575876422,3575876450,28
0,934,25178,3575876422,3575876450,28
0,934,25179,3575876422,3575876451,29
0,934,25180,3575876422,3575876452,30
0,934,25181,3575876422,3575876454,32
0,934,25182,3575876422,3575876456,34
0,934,25183,3575876422,3575876457,35
0,934,25184,3575876422,3575876459,37
0,934,25185,3575876422,3575876459,37
0,934,25186,3575876422,3575876459,37
0,934,25187,3575876422,3575876460,38
0,934,25188,3575876422,3575876461,39
0,934,25189,3575876422,3575876463,41
0,934,25190,3575876422,3575876464,42
0,934,25191,3575876422,3575876464,42
0,934,25192,3575876422,3575876464,42
0,934,25193,3575876422,3575876465,43
0,934,25194,3575876422,3575876465,43
0,934,25195,3575876422,3575876466,44
0,934,25196,3575876422,3575876466,44
0,934,25197,3575876422,3575876467,45
0,934,25198,3575876422,3575876468,46
0,934,25199,3575876422,3575876469,47
0,934,25200,3575876422,3575876471,49
0,935,25201,3575876482,3575876482,0
0,935,25202,3575876482,3575876482,0
0,935,25203,3575876482,3575876482,0
0,935,25204,3575876482,3575876482,0
0,935,25205,3575876482,3575876482,0
0,935,25206,3575876482,3575876482,0
0,935,25207,3575876482,3575876483,1
0,935,25208,3575876482,3575876484,2
0,935,25209,3575876482,3575876485,3
0,935,25210,3575876482,3575876486,4
0,935,25211,3575876482,3575876487,5
0,935,25212,3575876482,3575876489,7
0,935,25213,3575876482,3575876489,7
0,935,25214,3575876482,3575876489,7
0,935,25215,3575876482,3575876491,9
0,935,25216,3575876482,3575876491,9
0,935,25217,3575876482,3575876492,10
0,935,25218,3575876482,3575876492,10
0,935,25219,3575876482,3575876492,10
0,935,25220,3575876482,3575876493,11
0,935,25221,3575876482,3575876493,11
0,935,25222,3575876482,3575876493,11
0,935,25223,3575876482,3575876494,12
0,935,25224,3575876482,3575876495,13
0,935,25225,3575876482,3575876495,13
0,935,25226,3575876482,3575876495,13
0,935,25227,3575876482,3575876495,13
0,935,25228,3575876482,3575876496,14
0,935,25229,3575876482,3575876497,15
0,935,25230,3575876482,3575876497,15
0,935,25231,3575876482,3575876497,15
0,935,25232,3575876482,3575876499,17
0,935,25233,3575876482,3575876499,17
0,935,25234,3575876482,3575876500,18
0,935,25235,3575876482,3575876500,18
0,935,25236,3575876482,3575876501,19
0,935,25237,3575876482,3575876502,20
0,935,25238,3575876482,3575876502,20
0,935,25239,3575876482,3575876504,22
0,935,25240,3575876482,3575876505,23
0,935,25241,3575876482,3575876505,23
0,935,25242,3575876482,3575876506,24
0,935,25243,3575876482,3575876506,24
0,935,25244,3575876482,3575876506,24
0,935,25245,3575876482,3575876508,26
0,935,25246,3575876482,3575876509,27
0,935,25247,3575876482,3575876511,29
0,935,25248,3575876482,3575876511,29
0,935,25249,3575876482,3575876511,29
0,935,25250,3575876482,3575876512,30
0,935,25251,3575876482,3575876513,31
0,935,25252,3575876482,3575876513,31
0,935,25253,3575876482,3575876515,33
0,935,25254,3575876482,3575876515,33
0,935,25255,3575876482,3575876516,34
0,935,25256,3575876482,3575876516,34
0,935,25257,3575876482,3575876517,35
0,935,25258,3575876482,3575876518,36
0,935,25259,3575876482,3575876521,39
0,935,25260,3575876482,3575876521,39
0,935,25261,3575876482,3575876521,39
0,935,25262,3575876482,3575876522,40
0,935,25263,3575876482,3575876522,40
0,935,25264,3575876482,3575876523,41
0,935,25265,3575876482,3575876524,42
0,935,25266,3575876482,3575876524,42
0,935,25267,3575876482,3575876526,44
0,935,25268,3575876482,3575876527,45
0,935,25269,3575876482,3575876527,45
0,935,25270,3575876482,3575876527,45
0,935,25271,3575876482,3575876530,48
0,935,25272,3575876482,3575876530,48
0,935,25273,3575876482,3575876531,49
0,936,25274,3575876546,3575876546,0
0,936,25275,3575876546,3575876546,0
0,936,25276,3575876546,3575876546,0
0,936,25277,3575876546,3575876546,0
0,936,25278,3575876546,3575876546,0
0,936,25279,3575876546,3575876546,0
0,936,25280,3575876546,3575876546,0
0,936,25281,3575876546,3575876546,0
0,936,25282,3575876546,3575876546,0
0,936,25283,3575876546,3575876546,0
0,936,25284,3575876546,3575876546,0
0,936,25285,3575876546,3575876546,0
0,936,25286,3575876546,3575876546,0
0,936,25287,3575876546,3575876546,0
0,936,25288,3575876546,3575876546,0
0,936,25289,3575876546,3575876546,0
0,936,25290,3575876546,3575876546,0
0,936,25291,3575876546,3575876546,0
0,936,25292,3575876546,3575876546,0
0,936,25293,3575876546,3575876546,0
0,936,25294,3575876546,3575876546,0
0,936,25295,3575876546,3575876547,1
0,936,25296,3575876546,3575876548,2
0,936,25297,3575876546,3575876549,3
0,936,25298,3575876546,3575876549,3
0,936,25299,3575876546,3575876550,4
0,936,25300,3575876546,3575876553,7
0,936,25301,3575876546,3575876554,8
0,936,25302,3575876546,3575876555,9
0,936,25303,3575876546,3575876555,9
0,936,25304,3575876546,3575876556,10
0,936,25305,3575876546,3575876557,11
0,936,25306,3575876546,3575876558,12
0,936,25307,3575876546,3575876560,14
0,936,25308,3575876546,3575876561,15
0,936,25309,3575876546,3575876562,16
0,936,25310,3575876546,3575876562,16
0,936,25311,3575876546,3575876564,18
0,936,25312,3575876546,3575876564,18
0,936,25313,3575876546,3575876565,19
0,936,25314,3575876546,3575876565,19
0,936,25315,3575876546,3575876566,20
0,936,25316,3575876546,3575876566,20
0,936,25317,3575876546,3575876567,21
0,936,25318,3575876546,3575876568,22
0,936,25319,3575876546,3575876570,24
0,936,25320,3575876546,3575876571,25
0,936,25321,3575876546,3575876571,25
0,936,25322,3575876546,3575876571,25
0,936,25323,3575876546,3575876577,31
0,936,25324,3575876546,3575876577,31
0,936,25325,3575876546,3575876578,32
0,936,25326,3575876546,3575876578,32
0,936,25327,3575876546,3575876579,33
0,936,25328,3575876546,3575876579,33
0,936,25329,3575876546,3575876581,35
0,936,25330,3575876546,3575876581,35
0,936,25331,3575876546,3575876584,38
0,936,25332,3575876546,3575876585,39
0,936,25333,3575876546,3575876587,41
0,936,25334,3575876546,3575876588,42
0,936,25335,3575876546,3575876588,42
0,936,25336,3575876546,3575876588,42
0,936,25337,3575876546,3575876592,46
0,936,25338,3575876546,3575876593,47
0,936,25339,3575876546,3575876594,48
0,937,25340,3575876611,3575876611,0
0,937,25341,3575876611,3575876611,0
0,937,25342,3575876611,3575876611,0
0,937,25343,3575876611,3575876611,0
0,937,25344,3575876611,3575876611,0
0,937,25345,3575876611,3575876611,0
0,937,25346,3575876611,3575876611,0
0,937,25347,3575876611,3575876611,0
0,937,25348,3575876611,3575876611,0
0,937,25349,3575876611,3575876611,0
0,937,25350,3575876611,3575876611,0
0,937,25351,3575876611,3575876612,1
0,937,25352,3575876611,3575876613,2
0,937,25353,3575876611,3575876614,3
0,937,25354,3575876611,3575876614,3
0,937,25355,3575876611,3575876615,4
0,937,25356,3575876611,3575876615,4
0,937,25357,3575876611,3575876616,5
0,937,25358,3575876611,3575876617,6
0,937,25359,3575876611,3575876617,6
0,937,25360,3575876611,3575876618,7
0,937,25361,3575876611,3575876619,8
0,937,25362,3575876611,3575876620,9
0,937,25363,3575876611,3575876621,10
0,937,25364,3575876611,3575876627,16
0,937,25365,3575876611,3575876628,17
0,937,25366,3575876611,3575876628,17
0,937,25367,3575876611,3575876628,17
0,937,25368,3575876611,3575876629,18
0,937,25369,3575876611,3575876629,18
0,937,25370,3575876611,3575876631,20
0,937,25371,3575876611,3575876632,21
0,937,25372,3575876611,3575876632,21
0,937,25373,3575876611,3575876633,22
0,937,25374,3575876611,3575876633,22
0,937,25375,3575876611,3575876636,25
0,937,25376,3575876611,3575876637,26
0,937,25377,3575876611,3575876640,29
0,937,25378,3575876611,3575876641,30
0,937,25379,3575876611,3575876641,30
0,937,25380,3575876611,3575876642,31
0,937,25381,3575876611,3575876644,33
0,937,25382,3575876611,3575876644,33
0,937,25383,3575876611,3575876645,34
0,937,25384,3575876611,3575876649,38
0,937,25385,3575876611,3575876649,38
0,937,25386,3575876611,3575876649,38
0,937,25387,3575876611,3575876649,38
0,937,25388,3575876611,3575876650,39
0,937,25389,3575876611,3575876652,41
0,937,25390,3575876611,3575876655,44
0,937,25391,3575876611,3575876656,45
0,937,25392,3575876611,3575876656,45
0,937,25393,3575876611,3575876657,46
0,937,25394,3575876611,3575876658,47
0,937,25395,3575876611,3575876658,47
0,937,25396,3575876611,3575876659,48
0,937,25397,3575876611,3575876660,49
0,938,25398,3575876673,3575876673,0
0,938,25399,3575876673,3575876673,0
0,938,25400,3575876673,3575876673,0
0,938,25401,3575876673,3575876673,0
0,938,25402,3575876673,3575876673,0
0,938,25403,3575876673,3575876673,0
0,938,25404,3575876673,3575876673,0
0,938,25405,3575876673,3575876673,0
0,938,25406,3575876673,3575876673,0
0,938,25407,3575876673,3575876673,0
0,938,25408,3575876673,3575876673,0
0,938,25409,3575876673,3575876673,0
0,938,25410,3575876673,3575876676,3
0,938,25411,3575876673,3575876677,4
0,938,25412,3575876673,3575876679,6
0,938,25413,3575876673,3575876679,6
0,938,25414,3575876673,3575876681,8
0,938,25415,3575876673,3575876681,8
0,938,25416,3575876673,3575876681,8
0,938,25417,3575876673,3575876684,11
0,938,25418,3575876673,3575876685,12
0,938,25419,3575876673,3575876687,14
0,938,25420,3575876673,3575876687,14
0,938,25421,3575876673,3575876689,16
0,938,25422,3575876673,3575876690,17
0,938,25423,3575876673,3575876691,18
0,938,25424,3575876673,3575876692,19
0,938,25425,3575876673,3575876692,19
0,938,25426,3575876673,3575876692,19
0,938,25427,3575876673,3575876693,20
0,938,25428,3575876673,3575876693,20
0,938,25429,3575876673,3575876694,21
0,938,25430,3575876673,3575876694,21
0,938,25431,3575876673,3575876695,22
0,938,25432,3575876673,3575876695,22
0,938,25433,3575876673,3575876696,23
0,938,25434,3575876673,3575876696,23
0,938,25435,3575876673,3575876696,23
0,938,25436,3575876673,3575876696,23
0,938,25437,3575876673,3575876697,24
0,938,25438,3575876673,3575876697,24
0,938,25439,3575876673,3575876697,24
0,938,25440,3575876673,3575876699,26
0,938,25441,3575876673,3575876700,27
0,938,25442,3575876673,3575876700,27
0,938,25443,3575876673,3575876701,28
0,938,25444,3575876673,3575876701,28
0,938,25445,3575876673,3575876702,29
0,938,25446,3575876673,3575876702,29
0,938,25447,3575876673,3575876704,31
0,938,25448,3575876673,3575876705,32
0,938,25449,3575876673,3575876705,32
0,938,25450,3575876673,3575876706,33
0,938,25451,3575876673,3575876707,34
0,938,25452,3575876673,3575876708,35
0,938,25453,3575876673,3575876709,36
0,938,25454,3575876673,3575876709,36
0,938,25455,3575876673,3575876711,38
0,938,25456,3575876673,3575876711,38
0,938,25457,3575876673,3575876712,39
0,938,25458,3575876673,3575876712,39
0,938,25459,3575876673,3575876713,40
0,938,25460,3575876673,3575876713,40
0,938,25461,3575876673,3575876715,42
0,938,25462,3575876673,3575876716,43
0,938,25463,3575876673,3575876717,44
0,938,25464,3575876673,3575876718,45
0,938,25465,3575876673,3575876718,45
0,938,25466,3575876673,3575876721,48
0,938,25467,3575876673,3575876721,48
0,938,25468,3575876673,3575876722,49
0,938,25469,3575876673,3575876722,49
0,938,25470,3575876673,3575876722,49
0,938,25471,3575876673,3575876723,50
0,939,25472,3575876733,3575876733,0
0,939,25473,3575876733,3575876733,0
0,939,25474,3575876733,3575876733,0
0,939,25475,3575876733,3575876733,0
0,939,25476,3575876733,3575876733,0
0,939,25477,3575876733,3575876733,0
0,939,25478,3575876733,3575876733,0
0,939,25479,3575876733,3575876733,0
0,939,25480,3575876733,3575876733,0
0,939,25481,3575876733,3575876733,0
0,939,25482,3575876733,3575876736,3
0,939,25483,3575876733,3575876736,3
0,939,25484,3575876733,3575876736,3
0,939,25485,3575876733,3575876738,5
0,939,25486,3575876733,3575876738,5
0,939,25487,3575876733,3575876738,5
0,939,25488,3575876733,3575876740,7
0,939,25489,3575876733,3575876741,8
0,939,25490,3575876733,3575876741,8
0,939,25491,3575876733,3575876741,8
0,939,25492,3575876733,3575876742,9
0,939,25493,3575876733,3575876743,10
0,939,25494,3575876733,3575876743,10
0,939,25495,3575876733,3575876743,10
0,939,25496,3575876733,3575876744,11
0,939,25497,3575876733,3575876745,12
0,939,25498,3575876733,3575876745,12
0,939,25499,3575876733,3575876746,13
0,939,25500,3575876733,3575876746,13
0,939,25501,3575876733,3575876747,14
0,939,25502,3575876733,3575876749,16
0,939,25503,3575876733,3575876750,17
0,939,25504,3575876733,3575876751,18
0,939,25505,3575876733,3575876754,21
0,939,25506,3575876733,3575876754,21
0,939,25507,3575876733,3575876755,22
0,939,25508,3575876733,3575876755,22
0,939,25509,3575876733,3575876757,24
0,939,25510,3575876733,3575876758,25
0,939,25511,3575876733,3575876759,26
0,939,25512,3575876733,3575876760,27
0,939,25513,3575876733,3575876760,27
0,939,25514,3575876733,3575876761,28
0,939,25515,3575876733,3575876762,29
0,939,25516,3575876733,3575876762,29
0,939,25517,3575876733,3575876764,31
0,939,25518,3575876733,3575876765,32
0,939,25519,3575876733,3575876765,32
0,939,25520,3575876733,3575876766,33
0,939,25521,3575876733,3575876766,33
0,939,25522,3575876733,3575876767,34
0,939,25523,3575876733,3575876769,36
0,939,25524,3575876733,3575876770,37
0,939,25525,3575876733,3575876771,38
0,939,25526,3575876733,3575876771,38
0,939,25527,3575876733,3575876771,38
0,939,25528,3575876733,3575876775,42
0,939,25529,3575876733,3575876777,44
0,939,25530,3575876733,3575876777,44
0,939,25531,3575876733,3575876778,45
0,939,25532,3575876733,3575876778,45
0,939,25533,3575876733,3575876779,46
0,939,25534,3575876733,3575876781,48
0,939,25535,3575876733,3575876782,49
0,940,25536,3575876795,3575876795,0
0,940,25537,3575876795,3575876795,0
0,940,25538,3575876795,3575876795,0
0,940,25539,3575876795,3575876795,0
0,940,25540,3575876795,3575876795,0
0,940,25541,3575876795,3575876795,0
0,940,25542,3575876795,3575876795,0
0,940,25543,3575876795,3575876798,3
0,940,25544,3575876795,3575876799,4
0,940,25545,3575876795,3575876800,5
0,940,25546,3575876795,3575876800,5
0,940,25547,3575876795,3575876805,10
0,940,25548,3575876795,3575876805,10
0,940,25549,3575876795,3575876805,10
0,940,25550,3575876795,3575876807,12
0,940,25551,3575876795,3575876809,14
0,940,25552,3575876795,3575876810,15
0,940,25553,3575876795,3575876811,16
0,940,25554,3575876795,3575876813,18
0,940,25555,3575876795,3575876813,18
0,940,25556,3575876795,3575876814,19
0,940,25557,3575876795,3575876814,19
0,940,25558,3575876795,3575876815,20
0,940,25559,3575876795,3575876815,20
0,940,25560,3575876795,3575876816,21
0,940,25561,3575876795,3575876817,22
0,940,25562,3575876795,3575876818,23
0,940,25563,3575876795,3575876818,23
0,940,25564,3575876795,3575876818,23
0,940,25565,3575876795,3575876819,24
0,940,25566,3575876795,3575876821,26
0,940,25567,3575876795,3575876827,32
0,940,25568,3575876795,3575876829,34
0,940,25569,3575876795,3575876829,34
0,940,25570,3575876795,3575876830,35
0,940,25571,3575876795,3575876831,36
0,940,25572,3575876795,3575876832,37
0,940,25573,3575876795,3575876833,38
0,940,25574,3575876795,3575876833,38
0,940,25575,3575876795,3575876836,41
0,940,25576,3575876795,3575876836,41
0,940,25577,3575876795,3575876837,42
0,940,25578,3575876795,3575876837,42
0,940,25579,3575876795,3575876839,44
0,940,25580,3575876795,3575876841,46
0,940,25581,3575876795,3575876842,47
0,940,25582,3575876795,3575876842,47
0,940,25583,3575876795,3575876844,49
0,940,25584,3575876795,3575876845,50
0,941,25585,3575876859,3575876859,0
0,941,25586,3575876859,3575876859,0
0,941,25587,3575876859,3575876859,0
0,941,25588,3575876859,3575876859,0
0,941,25589,3575876859,3575876859,0
0,941,25590,3575876859,3575876859,0
0,941,25591,3575876859,3575876859,0
0,941,25592,3575876859,3575876859,0
0,941,25593,3575876859,3575876859,0
0,941,25594,3575876859,3575876859,0
0,941,25595,3575876859,3575876859,0
0,941,25596,3575876859,3575876859,0
0,941,25597,3575876859,3575876859,0
0,941,25598,3575876859,3575876859,0
0,941,25599,3575876859,3575876859,0
0,941,25600,3575876859,3575876859,0
0,941,25601,3575876859,3575876860,1
0,941,25602,3575876859,3575876863,4
0,941,25603,3575876859,3575876863,4
0,941,25604,3575876859,3575876864,5
0,941,25605,3575876859,3575876864,5
0,941,25606,3575876859,3575876866,7
0,941,25607,3575876859,3575876866,7
0,941,25608,3575876859,3575876867,8
0,941,25609,3575876859,3575876867,8
0,941,25610,3575876859,3575876867,8
0,941,25611,3575876859,3575876869,10
0,941,25612,3575876859,3575876870,11
0,941,25613,3575876859,3575876871,12
0,941,25614,3575876859,3575876877,18
0,941,25615,3575876859,3575876879,20
0,941,25616,3575876859,3575876879,20
0,941,25617,3575876859,3575876882,23
0,941,25618,3575876859,3575876882,23
0,941,25619,3575876859,3575876884,25
0,941,25620,3575876859,3575876885,26
0,941,25621,3575876859,3575876886,27
0,941,25622,3575876859,3575876886,27
0,941,25623,3575876859,3575876890,31
0,941,25624,3575876859,3575876890,31
0,941,25625,3575876859,3575876891,32
0,941,25626,3575876859,3575876892,33
0,941,25627,3575876859,3575876892,33
0,941,25628,3575876859,3575876892,33
0,941,25629,3575876859,3575876893,34
0,941,25630,3575876859,3575876893,34
0,941,25631,3575876859,3575876893,34
0,941,25632,3575876859,3575876894,35
0,941,25633,3575876859,3575876894,35
0,941,25634,3575876859,3575876895,36
0,941,25635,3575876859,3575876896,37
0,941,25636,3575876859,3575876896,37
0,941,25637,3575876859,3575876896,37
0,941,25638,3575876859,3575876896,37
0,941,25639,3575876859,3575876897,38
0,941,25640,3575876859,3575876897,38
0,941,25641,3575876859,3575876898,39
0,941,25642,3575876859,3575876899,40
0,941,25643,3575876859,3575876901,42
0,941,25644,3575876859,3575876901,42
0,941,25645,3575876859,3575876902,43
0,941,25646,3575876859,3575876902,43
0,941,25647,3575876859,3575876903,44
0,941,25648,3575876859,3575876903,44
0,941,25649,3575876859,3575876904,45
0,941,25650,3575876859,3575876905,46
0,941,25651,3575876859,3575876905,46
0,941,25652,3575876859,3575876905,46
0,941,25653,3575876859,3575876906,47
0,941,25654,3575876859,3575876908,49
0,942,25655,3575876923,3575876923,0
0,942,25656,3575876923,3575876923,0
0,942,25657,3575876923,3575876923,0
0,942,25658,3575876923,3575876923,0
0,942,25659,3575876923,3575876923,0
0,942,25660,3575876923,3575876923,0
0,942,25661,3575876923,3575876923,0
0,942,25662,3575876923,3575876923,0
0,942,25663,3575876923,3575876923,0
0,942,25664,3575876923,3575876923,0
0,942,25665,3575876923,3575876923,0
0,942,25666,3575876923,3575876923,0
0,942,25667,3575876923,3575876924,1
0,942,25668,3575876923,3575876924,1
0,942,25669,3575876923,3575876924,1
0,942,25670,3575876923,3575876924,1
0,942,25671,3575876923,3575876924,1
0,942,25672,3575876923,3575876924,1
0,942,25673,3575876923,3575876925,2
0,942,25674,3575876923,3575876925,2
0,942,25675,3575876923,3575876926,3
0,942,25676,3575876923,3575876927,4
0,942,25677,3575876923,3575876927,4
0,942,25678,3575876923,3575876928,5
0,942,25679,3575876923,3575876930,7
0,942,25680,3575876923,3575876930,7
0,942,25681,3575876923,3575876931,8
0,942,25682,3575876923,3575876933,10
0,942,25683,3575876923,3575876935,12
0,942,25684,3575876923,3575876936,13
0,942,25685,3575876923,3575876937,14
0,942,25686,3575876923,3575876938,15
0,942,25687,3575876923,3575876938,15
0,942,25688,3575876923,3575876940,17
0,942,25689,3575876923,3575876941,18
0,942,25690,3575876923,3575876941,18
0,942,25691,3575876923,3575876941,18
0,942,25692,3575876923,3575876942,19
0,942,25693,3575876923,3575876942,19
0,942,25694,3575876923,3575876942,19
0,942,25695,3575876923,3575876942,19
0,942,25696,3575876923,3575876944,21
0,942,25697,3575876923,3575876944,21
0,942,25698,3575876923,3575876945,22
0,942,25699,3575876923,3575876946,23
0,942,25700,3575876923,3575876946,23
0,942,25701,3575876923,3575876946,23
0,942,25702,3575876923,3575876947,24
0,942,25703,3575876923,3575876950,27
0,942,25704,3575876923,3575876950,27
0,942,25705,3575876923,3575876951,28
0,942,25706,3575876923,3575876953,30
0,942,25707,3575876923,3575876953,30
0,942,25708,3575876923,3575876953,30
0,942,25709,3575876923,3575876954,31
0,942,25710,3575876923,3575876954,31
0,942,25711,3575876923,3575876955,32
0,942,25712,3575876923,3575876956,33
0,942,25713,3575876923,3575876957,34
0,942,25714,3575876923,3575876958,35
0,942,25715,3575876923,3575876959,36
0,942,25716,3575876923,3575876960,37
0,942,25717,3575876923,3575876960,37
0,942,25718,3575876923,3575876961,38
0,942,25719,3575876923,3575876962,39
0,942,25720,3575876923,3575876963,40
0,942,25721,3575876923,3575876964,41
0,942,25722,3575876923,3575876965,42
0,942,25723,3575876923,3575876965,42
0,942,25724,3575876923,3575876965,42
0,942,25725,3575876923,3575876966,43
0,942,25726,3575876923,3575876969,46
0,942,25727,3575876923,3575876970,47
0,942,25728,3575876923,3575876971,48
0,942,25729,3575876923,3575876971,48
0,942,25730,3575876923,3575876972,49
0,943,25731,3575876984,3575876984,0
0,943,25732,3575876984,3575876984,0
0,943,25733,3575876984,3575876984,0
0,943,25734,3575876984,3575876984,0
0,943,25735,3575876984,3575876984,0
0,943,25736,3575876984,3575876984,0
0,943,25737,3575876984,3575876984,0
0,943,25738,3575876984,3575876984,0
0,943,25739,3575876984,3575876984,0
0,943,25740,3575876984,3575876984,0
0,943,25741,3575876984,3575876985,1
0,943,25742,3575876984,3575876986,2
0,943,25743,3575876984,3575876988,4
0,943,25744,3575876984,3575876989,5
0,943,25745,3575876984,3575876989,5
0,943,25746,3575876984,3575876994,10
0,943,25747,3575876984,3575876995,11
0,943,25748,3575876984,3575876998,14
0,943,25749,3575876984,3575876999,15
0,943,25750,3575876984,3575876999,15
0,943,25751,3575876984,3575877000,16
0,943,25752,3575876984,3575877004,20
0,943,25753,3575876984,3575877005,21
0,943,25754,3575876984,3575877005,21
0,943,25755,3575876984,3575877006,22
0,943,25756,3575876984,3575877008,24
0,943,25757,3575876984,3575877008,24
0,943,25758,3575876984,3575877010,26
0,943,25759,3575876984,3575877011,27
0,943,25760,3575876984,3575877013,29
0,943,25761,3575876984,3575877014,30
0,943,25762,3575876984,3575877015,31
0,943,25763,3575876984,3575877015,31
0,943,25764,3575876984,3575877016,32
0,943,25765,3575876984,3575877016,32
0,943,25766,3575876984,3575877016,32
0,943,25767,3575876984,3575877018,34
0,943,25768,3575876984,3575877018,34
0,943,25769,3575876984,3575877021,37
0,943,25770,3575876984,3575877021,37
0,943,25771,3575876984,3575877027,43
0,943,25772,3575876984,3575877028,44
0,943,25773,3575876984,3575877029,45
0,943,25774,3575876984,3575877029,45
0,943,25775,3575876984,3575877030,46
0,943,25776,3575876984,3575877031,47
0,943,25777,3575876984,3575877032,48
0,943,25778,3575876984,3575877033,49
0,943,25779,3575876984,3575877033,49
0,944,25780,3575877046,3575877046,0
0,944,25781,3575877046,3575877046,0
0,944,25782,3575877046,3575877046,0
0,944,25783,3575877046,3575877046,0
0,944,25784,3575877046,3575877046,0
0,944,25785,3575877046,3575877046,0
0,944,25786,3575877046,3575877046,0
0,944,25787,3575877046,3575877046,0
0,944,25788,3575877046,3575877046,0
0,944,25789,3575877046,3575877046,0
0,944,25790,3575877046,3575877046,0
0,944,25791,3575877046,3575877046,0
0,944,25792,3575877046,3575877046,0
0,944,25793,3575877046,3575877049,3
0,944,25794,3575877046,3575877050,4
0,944,25795,3575877046,3575877050,4
0,944,25796,3575877046,3575877051,5
0,944,25797,3575877046,3575877051,5
0,944,25798,3575877046,3575877052,6
0,944,25799,3575877046,3575877056,10
0,944,25800,3575877046,3575877057,11
0,944,25801,3575877046,3575877058,12
0,944,25802,3575877046,3575877058,12
0,944,25803,3575877046,3575877060,14
0,944,25804,3575877046,3575877060,14
0,944,25805,3575877046,3575877061,15
0,944,25806,3575877046,3575877061,15
0,944,25807,3575877046,3575877062,16
0,944,25808,3575877046,3575877063,17
0,944,25809,3575877046,3575877063,17
0,944,25810,3575877046,3575877065,19
0,944,25811,3575877046,3575877066,20
0,944,25812,3575877046,3575877066,20
0,944,25813,3575877046,3575877067,21
0,944,25814,3575877046,3575877067,21
0,944,25815,3575877046,3575877069,23
0,944,25816,3575877046,3575877070,24
0,944,25817,3575877046,3575877076,30
0,944,25818,3575877046,3575877077,31
0,944,25819,3575877046,3575877079,33
0,944,25820,3575877046,3575877080,34
0,944,25821,3575877046,3575877081,35
0,944,25822,3575877046,3575877081,35
0,944,25823,3575877046,3575877083,37
0,944,25824,3575877046,3575877084,38
0,944,25825,3575877046,3575877085,39
0,944,25826,3575877046,3575877086,40
0,944,25827,3575877046,3575877089,43
0,944,25828,3575877046,3575877091,45
0,944,25829,3575877046,3575877092,46
0,944,25830,3575877046,3575877092,46
0,944,25831,3575877046,3575877093,47
0,944,25832,3575877046,3575877093,47
0,944,25833,3575877046,3575877093,47
0,944,25834,3575877046,3575877094,48
0,944,25835,3575877046,3575877095,49
0,944,25836,3575877046,3575877095,49
0,944,25837,3575877046,3575877095,49
0,944,25838,3575877046,3575877096,50
0,945,25839,3575877104,3575877104,0
0,945,25840,3575877104,3575877104,0
0,945,25841,3575877104,3575877104,0
0,945,25842,3575877104,3575877104,0
0,945,25843,3575877104,3575877104,0
0,945,25844,3575877104,3575877104,0
0,945,25845,3575877104,3575877104,0
0,945,25846,3575877104,3575877104,0
0,945,25847,3575877104,3575877104,0
0,945,25848,3575877104,3575877104,0
0,945,25849,3575877104,3575877104,0
0,945,25850,3575877104,3575877105,1
0,945,25851,3575877104,3575877105,1
0,945,25852,3575877104,3575877106,2
0,945,25853,3575877104,3575877106,2
0,945,25854,3575877104,3575877108,4
0,945,25855,3575877104,3575877108,4
0,945,25856,3575877104,3575877110,6
0,945,25857,3575877104,3575877112,8
0,945,25858,3575877104,3575877112,8
0,945,25859,3575877104,3575877112,8
0,945,25860,3575877104,3575877112,8
0,945,25861,3575877104,3575877113,9
0,945,25862,3575877104,3575877114,10
0,945,25863,3575877104,3575877114,10
0,945,25864,3575877104,3575877115,11
0,945,25865,3575877104,3575877116,12
0,945,25866,3575877104,3575877117,13
0,945,25867,3575877104,3575877117,13
0,945,25868,3575877104,3575877118,14
0,945,25869,3575877104,3575877119,15
0,945,25870,3575877104,3575877120,16
0,945,25871,3575877104,3575877122,18
0,945,25872,3575877104,3575877122,18
0,945,25873,3575877104,3575877122,18
0,945,25874,3575877104,3575877122,18
0,945,25875,3575877104,3575877123,19
0,945,25876,3575877104,3575877124,20
0,945,25877,3575877104,3575877125,21
0,945,25878,3575877104,3575877125,21
0,945,25879,3575877104,3575877127,23
0,945,25880,3575877104,3575877127,23
0,945,25881,3575877104,3575877127,23
0,945,25882,3575877104,3575877129,25
0,945,25883,3575877104,3575877130,26
0,945,25884,3575877104,3575877130,26
0,945,25885,3575877104,3575877132,28
0,945,25886,3575877104,3575877134,30
0,945,25887,3575877104,3575877136,32
0,945,25888,3575877104,3575877136,32
0,945,25889,3575877104,3575877137,33
0,945,25890,3575877104,3575877138,34
0,945,25891,3575877104,3575877141,37
0,945,25892,3575877104,3575877141,37
0,945,25893,3575877104,3575877141,37
0,945,25894,3575877104,3575877142,38
0,945,25895,3575877104,3575877142,38
0,945,25896,3575877104,3575877142,38
0,945,25897,3575877104,3575877142,38
0,945,25898,3575877104,3575877143,39
0,945,25899,3575877104,3575877143,39
0,945,25900,3575877104,3575877144,40
0,945,25901,3575877104,3575877147,43
0,945,25902,3575877104,3575877147,43
0,945,25903,3575877104,3575877149,45
0,945,25904,3575877104,3575877150,46
0,945,25905,3575877104,3575877152,48
0,945,25906,3575877104,3575877153,49
0,945,25907,3575877104,3575877154,50
0,946,25908,3575877168,3575877168,0
0,946,25909,3575877168,3575877168,0
0,946,25910,3575877168,3575877168,0
0,946,25911,3575877168,3575877168,0
0,946,25912,3575877168,3575877168,0
0,946,25913,3575877168,3575877168,0
0,946,25914,3575877168,3575877168,0
0,946,25915,3575877168,3575877168,0
0,946,25916,3575877168,3575877168,0
0,946,25917,3575877168,3575877168,0
0,946,25918,3575877168,3575877168,0
0,946,25919,3575877168,3575877168,0
0,946,25920,3575877168,3575877168,0
0,946,25921,3575877168,3575877168,0
0,946,25922,3575877168,3575877168,0
0,946,25923,3575877168,3575877168,0
0,946,25924,3575877168,3575877168,0
0,946,25925,3575877168,3575877168,0
0,946,25926,3575877168,3575877168,0
0,946,25927,3575877168,3575877168,0
0,946,25928,3575877168,3575877168,0
0,946,25929,3575877168,3575877168,0
0,946,25930,3575877168,3575877170,2
0,946,25931,3575877168,3575877171,3
0,946,25932,3575877168,3575877171,3
0,946,25933,3575877168,3575877172,4
0,946,25934,3575877168,3575877172,4
0,946,25935,3575877168,3575877174,6
0,946,25936,3575877168,3575877176,8
0,946,25937,3575877168,3575877177,9
0,946,25938,3575877168,3575877177,9
0,946,25939,3575877168,3575877179,11
0,946,25940,3575877168,3575877179,11
0,946,25941,3575877168,3575877179,11
0,946,25942,3575877168,3575877180,12
0,946,25943,3575877168,3575877182,14
0,946,25944,3575877168,3575877184,16
0,946,25945,3575877168,3575877185,17
0,946,25946,3575877168,3575877191,23
0,946,25947,3575877168,3575877191,23
0,946,25948,3575877168,3575877194,26
0,946,25949,3575877168,3575877195,27
0,946,25950,3575877168,3575877199,31
0,946,25951,3575877168,3575877200,32
0,946,25952,3575877168,3575877201,33
0,946,25953,3575877168,3575877205,37
0,946,25954,3575877168,3575877205,37
0,946,25955,3575877168,3575877206,38
0,946,25956,3575877168,3575877209,41
0,946,25957,3575877168,3575877209,41
0,946,25958,3575877168,3575877210,42
0,946,25959,3575877168,3575877210,42
0,946,25960,3575877168,3575877213,45
0,946,25961,3575877168,3575877214,46
0,946,25962,3575877168,3575877215,47
0,946,25963,3575877168,3575877215,47
0,946,25964,3575877168,3575877215,47
0,946,25965,3575877168,3575877216,48
0,946,25966,3575877168,3575877216,48
0,946,25967,3575877168,3575877216,48
0,946,25968,3575877168,3575877218,50
0,947,25969,3575877232,3575877232,0
0,947,25970,3575877232,3575877232,0
0,947,25971,3575877232,3575877232,0
0,947,25972,3575877232,3575877232,0
0,947,25973,3575877232,3575877232,0
0,947,25974,3575877232,3575877232,0
0,947,25975,3575877232,3575877232,0
0,947,25976,3575877232,3575877232,0
0,947,25977,3575877232,3575877232,0
0,947,25978,3575877232,3575877232,0
0,947,25979,3575877232,3575877232,0
0,947,25980,3575877232,3575877233,1
0,947,25981,3575877232,3575877233,1
0,947,25982,3575877232,3575877236,4
0,947,25983,3575877232,3575877236,4
0,947,25984,3575877232,3575877237,5
0,947,25985,3575877232,3575877238,6
0,947,25986,3575877232,3575877239,7
0,947,25987,3575877232,3575877239,7
0,947,25988,3575877232,3575877241,9
0,947,25989,3575877232,3575877242,10
0,947,25990,3575877232,3575877244,12
0,947,25991,3575877232,3575877244,12
0,947,25992,3575877232,3575877246,14
0,947,25993,3575877232,3575877246,14
0,947,25994,3575877232,3575877247,15
0,947,25995,3575877232,3575877249,17
0,947,25996,3575877232,3575877249,17
0,947,25997,3575877232,3575877250,18
0,947,25998,3575877232,3575877251,19
0,947,25999,3575877232,3575877251,19
0,947,26000,3575877232,3575877251,19
0,947,26001,3575877232,3575877252,20
0,947,26002,3575877232,3575877256,24
0,947,26003,3575877232,3575877256,24
0,947,26004,3575877232,3575877257,25
0,947,26005,3575877232,3575877258,26
0,947,26006,3575877232,3575877258,26
0,947,26007,3575877232,3575877260,28
0,947,26008,3575877232,3575877260,28
0,947,26009,3575877232,3575877260,28
0,947,26010,3575877232,3575877261,29
0,947,26011,3575877232,3575877262,30
0,947,26012,3575877232,3575877263,31
0,947,26013,3575877232,3575877264,32
0,947,26014,3575877232,3575877265,33
0,947,26015,3575877232,3575877265,33
0,947,26016,3575877232,3575877266,34
0,947,26017,3575877232,3575877266,34
0,947,26018,3575877232,3575877266,34
0,947,26019,3575877232,3575877267,35
0,947,26020,3575877232,3575877269,37
0,947,26021,3575877232,3575877270,38
0,947,26022,3575877232,3575877273,41
0,947,26023,3575877232,3575877276,44
0,947,26024,3575877232,3575877277,45
0,947,26025,3575877232,3575877279,47
0,947,26026,3575877232,3575877279,47
0,947,26027,3575877232,3575877281,49
0,948,26028,3575877296,3575877296,0
0,948,26029,3575877296,3575877296,0
0,948,26030,3575877296,3575877296,0
0,948,26031,3575877296,3575877296,0
0,948,26032,3575877296,3575877296,0
0,948,26033,3575877296,3575877296,0
0,948,26034,3575877296,3575877296,0
0,948,26035,3575877296,3575877296,0
0,948,26036,3575877296,3575877296,0
0,948,26037,3575877296,3575877296,0
0,948,26038,3575877296,3575877296,0
0,948,26039,3575877296,3575877296,0
0,948,26040,3575877296,3575877296,0
0,948,26041,3575877296,3575877296,0
0,948,26042,3575877296,3575877296,0
0,948,26043,3575877296,3575877296,0
0,948,26044,3575877296,3575877296,0
0,948,26045,3575877296,3575877296,0
0,948,26046,3575877296,3575877296,0
0,948,26047,3575877296,3575877297,1
0,948,26048,3575877296,3575877297,1
0,948,26049,3575877296,3575877298,2
0,948,26050,3575877296,3575877298,2
0,948,26051,3575877296,3575877299,3
0,948,26052,3575877296,3575877300,4
0,948,26053,3575877296,3575877302,6
0,948,26054,3575877296,3575877302,6
0,948,26055,3575877296,3575877303,7
0,948,26056,3575877296,3575877304,8
0,948,26057,3575877296,3575877304,8
0,948,26058,3575877296,3575877305,9
0,948,26059,3575877296,3575877306,10
0,948,26060,3575877296,3575877306,10
0,948,26061,3575877296,3575877306,10
0,948,26062,3575877296,3575877308,12
0,948,26063,3575877296,3575877310,14
0,948,26064,3575877296,3575877310,14
0,948,26065,3575877296,3575877312,16
0,948,26066,3575877296,3575877312,16
0,948,26067,3575877296,3575877312,16
0,948,26068,3575877296,3575877313,17
0,948,26069,3575877296,3575877313,17
0,948,26070,3575877296,3575877313,17
0,948,26071,3575877296,3575877314,18
0,948,26072,3575877296,3575877315,19
0,948,26073,3575877296,3575877315,19
0,948,26074,3575877296,3575877316,20
0,948,26075,3575877296,3575877318,22
0,948,26076,3575877296,3575877318,22
0,948,26077,3575877296,3575877318,22
0,948,26078,3575877296,3575877320,24
0,948,26079,3575877296,3575877321,25
0,948,26080,3575877296,3575877322,26
0,948,26081,3575877296,3575877323,27
0,948,26082,3575877296,3575877323,27
0,948,26083,3575877296,3575877323,27
0,948,26084,3575877296,3575877324,28
0,948,26085,3575877296,3575877324,28
0,948,26086,3575877296,3575877326,30
0,948,26087,3575877296,3575877327,31
0,948,26088,3575877296,3575877327,31
0,948,26089,3575877296,3575877328,32
0,948,26090,3575877296,3575877330,34
0,948,26091,3575877296,3575877330,34
0,948,26092,3575877296,3575877331,35
0,948,26093,3575877296,3575877332,36
0,948,26094,3575877296,3575877333,37
0,948,26095,3575877296,3575877337,41
0,948,26096,3575877296,3575877338,42
0,948,26097,3575877296,3575877338,42
0,948,26098,3575877296,3575877340,44
0,948,26099,3575877296,3575877341,45
0,948,26100,3575877296,3575877341,45
0,948,26101,3575877296,3575877342,46
0,948,26102,3575877296,3575877342,46
0,948,26103,3575877296,3575877342,46
0,948,26104,3575877296,3575877343,47
0,948,26105,3575877296,3575877344,48
0,948,26106,3575877296,3575877345,49
0,948,26107,3575877296,3575877345,49
0,948,26108,3575877296,3575877346,50
0,949,26109,3575877356,3575877356,0
0,949,26110,3575877356,3575877356,0
0,949,26111,3575877356,3575877356,0
0,949,26112,3575877356,3575877356,0
0,949,26113,3575877356,3575877356,0
0,949,26114,3575877356,3575877356,0
0,949,26115,3575877356,3575877356,0
0,949,26116,3575877356,3575877356,0
0,949,26117,3575877356,3575877356,0
0,949,26118,3575877356,3575877356,0
0,949,26119,3575877356,3575877357,1
0,949,26120,3575877356,3575877358,2
0,949,26121,3575877356,3575877358,2
0,949,26122,3575877356,3575877358,2
0,949,26123,3575877356,3575877358,2
0,949,26124,3575877356,3575877359,3
0,949,26125,3575877356,3575877360,4
0,949,26126,3575877356,3575877361,5
0,949,26127,3575877356,3575877362,6
0,949,26128,3575877356,3575877362,6
0,949,26129,3575877356,3575877364,8
0,949,26130,3575877356,3575877364,8
0,949,26131,3575877356,3575877365,9
0,949,26132,3575877356,3575877365,9
0,949,26133,3575877356,3575877366,10
0,949,26134,3575877356,3575877366,10
0,949,26135,3575877356,3575877367,11
0,949,26136,3575877356,3575877367,11
0,949,26137,3575877356,3575877368,12
0,949,26138,3575877356,3575877370,14
0,949,26139,3575877356,3575877371,15
0,949,26140,3575877356,3575877371,15
0,949,26141,3575877356,3575877372,16
0,949,26142,3575877356,3575877377,21
0,949,26143,3575877356,3575877378,22
0,949,26144,3575877356,3575877378,22
0,949,26145,3575877356,3575877379,23
0,949,26146,3575877356,3575877379,23
0,949,26147,3575877356,3575877380,24
0,949,26148,3575877356,3575877380,24
0,949,26149,3575877356,3575877381,25
0,949,26150,3575877356,3575877382,26
0,949,26151,3575877356,3575877384,28
0,949,26152,3575877356,3575877386,30
0,949,26153,3575877356,3575877389,33
0,949,26154,3575877356,3575877389,33
0,949,26155,3575877356,3575877389,33
0,949,26156,3575877356,3575877394,38
0,949,26157,3575877356,3575877395,39
0,949,26158,3575877356,3575877398,42
0,949,26159,3575877356,3575877399,43
0,949,26160,3575877356,3575877401,45
0,949,26161,3575877356,3575877402,46
0,949,26162,3575877356,3575877405,49
0,949,26163,3575877356,3575877406,50
0,950,26164,3575877420,3575877420,0
0,950,26165,3575877420,3575877420,0
0,950,26166,3575877420,3575877420,0
0,950,26167,3575877420,3575877420,0
0,950,26168,3575877420,3575877420,0
0,950,26169,3575877420,3575877420,0
0,950,26170,3575877420,3575877420,0
0,950,26171,3575877420,3575877420,0
0,950,26172,3575877420,3575877420,0
0,950,26173,3575877420,3575877420,0
0,950,26174,3575877420,3575877420,0
0,950,26175,3575877420,3575877420,0
0,950,26176,3575877420,3575877421,1
0,950,26177,3575877420,3575877421,1
0,950,26178,3575877420,3575877424,4
0,950,26179,3575877420,3575877427,7
0,950,26180,3575877420,3575877428,8
0,950,26181,3575877420,3575877429,9
0,950,26182,3575877420,3575877429,9
0,950,26183,3575877420,3575877430,10
0,950,26184,3575877420,3575877430,10
0,950,26185,3575877420,3575877431,11
0,950,26186,3575877420,3575877432,12
0,950,26187,3575877420,3575877433,13
0,950,26188,3575877420,3575877433,13
0,950,26189,3575877420,3575877433,13
0,950,26190,3575877420,3575877435,15
0,950,26191,3575877420,3575877436,16
0,950,26192,3575877420,3575877438,18
0,950,26193,3575877420,3575877439,19
0,950,26194,3575877420,3575877439,19
0,950,26195,3575877420,3575877440,20
0,950,26196,3575877420,3575877442,22
0,950,26197,3575877420,3575877442,22
0,950,26198,3575877420,3575877443,23
0,950,26199,3575877420,3575877444,24
0,950,26200,3575877420,3575877446,26
0,950,26201,3575877420,3575877446,26
0,950,26202,3575877420,3575877447,27
0,950,26203,3575877420,3575877449,29
0,950,26204,3575877420,3575877449,29
0,950,26205,3575877420,3575877450,30
0,950,26206,3575877420,3575877450,30
0,950,26207,3575877420,3575877451,31
0,950,26208,3575877420,3575877452,32
0,950,26209,3575877420,3575877453,33
0,950,26210,3575877420,3575877454,34
0,950,26211,3575877420,3575877455,35
0,950,26212,3575877420,3575877456,36
0,950,26213,3575877420,3575877458,38
0,950,26214,3575877420,3575877458,38
0,950,26215,3575877420,3575877459,39
0,950,26216,3575877420,3575877460,40
0,950,26217,3575877420,3575877460,40
0,950,26218,3575877420,3575877461,41
0,950,26219,3575877420,3575877463,43
0,950,26220,3575877420,3575877464,44
0,950,26221,3575877420,3575877464,44
0,950,26222,3575877420,3575877465,45
0,950,26223,3575877420,3575877465,45
0,950,26224,3575877420,3575877467,47
0,950,26225,3575877420,3575877467,47
0,950,26226,3575877420,3575877467,47
0,950,26227,3575877420,3575877471,51
0,950,26228,3575877420,3575877471,51
0,951,26229,3575877482,3575877482,0
0,951,26230,3575877482,3575877482,0
0,951,26231,3575877482,3575877482,0
0,951,26232,3575877482,3575877482,0
0,951,26233,3575877482,3575877482,0
0,951,26234,3575877482,3575877482,0
0,951,26235,3575877482,3575877482,0
0,951,26236,3575877482,3575877482,0
0,951,26237,3575877482,3575877483,1
0,951,26238,3575877482,3575877485,3
0,951,26239,3575877482,3575877486,4
0,951,26240,3575877482,3575877488,6
0,951,26241,3575877482,3575877489,7
0,951,26242,3575877482,3575877491,9
0,951,26243,3575877482,3575877491,9
0,951,26244,3575877482,3575877491,9
0,951,26245,3575877482,3575877492,10
0,951,26246,3575877482,3575877492,10
0,951,26247,3575877482,3575877492,10
0,951,26248,3575877482,3575877493,11
0,951,26249,3575877482,3575877493,11
0,951,26250,3575877482,3575877494,12
0,951,26251,3575877482,3575877494,12
0,951,26252,3575877482,3575877495,13
0,951,26253,3575877482,3575877495,13
0,951,26254,3575877482,3575877496,14
0,951,26255,3575877482,3575877496,14
0,951,26256,3575877482,3575877497,15
0,951,26257,3575877482,3575877497,15
0,951,26258,3575877482,3575877499,17
0,951,26259,3575877482,3575877500,18
0,951,26260,3575877482,3575877501,19
0,951,26261,3575877482,3575877501,19
0,951,26262,3575877482,3575877501,19
0,951,26263,3575877482,3575877502,20
0,951,26264,3575877482,3575877503,21
0,951,26265,3575877482,3575877504,22
0,951,26266,3575877482,3575877505,23
0,951,26267,3575877482,3575877505,23
0,951,26268,3575877482,3575877506,24
0,951,26269,3575877482,3575877506,24
0,951,26270,3575877482,3575877508,26
0,951,26271,3575877482,3575877509,27
0,951,26272,3575877482,3575877509,27
0,951,26273,3575877482,3575877510,28
0,951,26274,3575877482,3575877511,29
0,951,26275,3575877482,3575877511,29
0,951,26276,3575877482,3575877512,30
0,951,26277,3575877482,3575877512,30
0,951,26278,3575877482,3575877514,32
0,951,26279,3575877482,3575877514,32
0,951,26280,3575877482,3575877514,32
0,951,26281,3575877482,3575877515,33
0,951,26282,3575877482,3575877517,35
0,951,26283,3575877482,3575877517,35
0,951,26284,3575877482,3575877518,36
0,951,26285,3575877482,3575877520,38
0,951,26286,3575877482,3575877522,40
0,951,26287,3575877482,3575877522,40
0,951,26288,3575877482,3575877522,40
0,951,26289,3575877482,3575877522,40
0,951,26290,3575877482,3575877523,41
0,951,26291,3575877482,3575877523,41
0,951,26292,3575877482,3575877524,42
0,951,26293,3575877482,3575877525,43
0,951,26294,3575877482,3575877526,44
0,951,26295,3575877482,3575877528,46
0,951,26296,3575877482,3575877529,47
0,951,26297,3575877482,3575877529,47
0,951,26298,3575877482,3575877531,49
0,951,26299,3575877482,3575877531,49
0,952,26300,3575877543,3575877543,0
0,952,26301,3575877543,3575877543,0
0,952,26302,3575877543,3575877543,0
0,952,26303,3575877543,3575877543,0
0,952,26304,3575877543,3575877543,0
0,952,26305,3575877543,3575877543,0
0,952,26306,3575877543,3575877543,0
0,952,26307,3575877543,3575877543,0
0,952,26308,3575877543,3575877543,0
0,952,26309,3575877543,3575877543,0
0,952,26310,3575877543,3575877543,0
0,952,26311,3575877543,3575877543,0
0,952,26312,3575877543,3575877543,0
0,952,26313,3575877543,3575877543,0
0,952,26314,3575877543,3575877544,1
0,952,26315,3575877543,3575877545,2
0,952,26316,3575877543,3575877545,2
0,952,26317,3575877543,3575877546,3
0,952,26318,3575877543,3575877546,3
0,952,26319,3575877543,3575877547,4
0,952,26320,3575877543,3575877547,4
0,952,26321,3575877543,3575877549,6
0,952,26322,3575877543,3575877550,7
0,952,26323,3575877543,3575877553,10
0,952,26324,3575877543,3575877554,11
0,952,26325,3575877543,3575877555,12
0,952,26326,3575877543,3575877556,13
0,952,26327,3575877543,3575877556,13
0,952,26328,3575877543,3575877557,14
0,952,26329,3575877543,3575877557,14
0,952,26330,3575877543,3575877558,15
0,952,26331,3575877543,3575877558,15
0,952,26332,3575877543,3575877560,17
0,952,26333,3575877543,3575877560,17
0,952,26334,3575877543,3575877561,18
0,952,26335,3575877543,3575877562,19
0,952,26336,3575877543,3575877563,20
0,952,26337,3575877543,3575877563,20
0,952,26338,3575877543,3575877564,21
0,952,26339,3575877543,3575877564,21
0,952,26340,3575877543,3575877565,22
0,952,26341,3575877543,3575877565,22
0,952,26342,3575877543,3575877566,23
0,952,26343,3575877543,3575877566,23
0,952,26344,3575877543,3575877570,27
0,952,26345,3575877543,3575877570,27
0,952,26346,3575877543,3575877570,27
0,952,26347,3575877543,3575877571,28
0,952,26348,3575877543,3575877572,29
0,952,26349,3575877543,3575877573,30
0,952,26350,3575877543,3575877574,31
0,952,26351,3575877543,3575877576,33
0,952,26352,3575877543,3575877578,35
0,952,26353,3575877543,3575877578,35
0,952,26354,3575877543,3575877578,35
0,952,26355,3575877543,3575877578,35
0,952,26356,3575877543,3575877579,36
0,952,26357,3575877543,3575877580,37
0,952,26358,3575877543,3575877581,38
0,952,26359,3575877543,3575877584,41
0,952,26360,3575877543,3575877585,42
0,952,26361,3575877543,3575877589,46
0,953,26362,3575877606,3575877606,0
0,953,26363,3575877606,3575877606,0
0,953,26364,3575877606,3575877606,0
0,953,26365,3575877606,3575877606,0
0,953,26366,3575877606,3575877606,0
0,953,26367,3575877606,3575877606,0
0,953,26368,3575877606,3575877606,0
0,953,26369,3575877606,3575877606,0
0,953,26370,3575877606,3575877607,1
0,953,26371,3575877606,3575877608,2
0,953,26372,3575877606,3575877609,3
0,953,26373,3575877606,3575877610,4
0,953,26374,3575877606,3575877612,6
0,953,26375,3575877606,3575877613,7
0,953,26376,3575877606,3575877614,8
0,953,26377,3575877606,3575877614,8
0,953,26378,3575877606,3575877614,8
0,953,26379,3575877606,3575877615,9
0,953,26380,3575877606,3575877616,10
0,953,26381,3575877606,3575877616,10
0,953,26382,3575877606,3575877617,11
0,953,26383,3575877606,3575877618,12
0,953,26384,3575877606,3575877620,14
0,953,26385,3575877606,3575877620,14
0,953,26386,3575877606,3575877624,18
0,953,26387,3575877606,3575877625,19
0,953,26388,3575877606,3575877626,20
0,953,26389,3575877606,3575877628,22
0,953,26390,3575877606,3575877628,22
0,953,26391,3575877606,3575877629,23
0,953,26392,3575877606,3575877629,23
0,953,26393,3575877606,3575877629,23
0,953,26394,3575877606,3575877630,24
0,953,26395,3575877606,3575877632,26
0,953,26396,3575877606,3575877632,26
0,953,26397,3575877606,3575877632,26
0,953,26398,3575877606,3575877633,27
0,953,26399,3575877606,3575877635,29
0,953,26400,3575877606,3575877636,30
0,953,26401,3575877606,3575877637,31
0,953,26402,3575877606,3575877638,32
0,953,26403,3575877606,3575877639,33
0,953,26404,3575877606,3575877641,35
0,953,26405,3575877606,3575877642,36
0,953,26406,3575877606,3575877644,38
0,953,26407,3575877606,3575877645,39
0,953,26408,3575877606,3575877645,39
0,953,26409,3575877606,3575877646,40
0,953,26410,3575877606,3575877649,43
0,953,26411,3575877606,3575877649,43
0,953,26412,3575877606,3575877650,44
0,953,26413,3575877606,3575877650,44
0,953,26414,3575877606,3575877651,45
0,953,26415,3575877606,3575877652,46
0,953,26416,3575877606,3575877653,47
0,953,26417,3575877606,3575877655,49
0,953,26418,3575877606,3575877656,50
0,954,26419,3575877666,3575877667,1
0,954,26420,3575877666,3575877667,1
0,954,26421,3575877666,3575877667,1
0,954,26422,3575877666,3575877667,1
0,954,26423,3575877666,3575877667,1
0,954,26424,3575877666,3575877667,1
0,954,26425,3575877666,3575877667,1
0,954,26426,3575877666,3575877667,1
0,954,26427,3575877666,3575877667,1
0,954,26428,3575877666,3575877667,1
0,954,26429,3575877666,3575877667,1
0,954,26430,3575877666,3575877667,1
0,954,26431,3575877666,3575877667,1
0,954,26432,3575877666,3575877667,1
0,954,26433,3575877666,3575877667,1
0,954,26434,3575877666,3575877667,1
0,954,26435,3575877666,3575877667,1
0,954,26436,3575877666,3575877669,3
0,954,26437,3575877666,3575877670,4
0,954,26438,3575877666,3575877672,6
0,954,26439,3575877666,3575877672,6
0,954,26440,3575877666,3575877675,9
0,954,26441,3575877666,3575877677,11
0,954,26442,3575877666,3575877678,12
0,954,26443,3575877666,3575877681,15
0,954,26444,3575877666,3575877681,15
0,954,26445,3575877666,3575877681,15
0,954,26446,3575877666,3575877684,18
0,954,26447,3575877666,3575877684,18
0,954,26448,3575877666,3575877686,20
0,954,26449,3575877666,3575877690,24
0,954,26450,3575877666,3575877691,25
0,954,26451,3575877666,3575877692,26
0,954,26452,3575877666,3575877692,26
0,954,26453,3575877666,3575877693,27
0,954,26454,3575877666,3575877693,27
0,954,26455,3575877666,3575877693,27
0,954,26456,3575877666,3575877694,28
0,954,26457,3575877666,3575877695,29
0,954,26458,3575877666,3575877695,29
0,954,26459,3575877666,3575877695,29
0,954,26460,3575877666,3575877695,29
0,954,26461,3575877666,3575877697,31
0,954,26462,3575877666,3575877697,31
0,954,26463,3575877666,3575877698,32
0,954,26464,3575877666,3575877698,32
0,954,26465,3575877666,3575877699,33
0,954,26466,3575877666,3575877699,33
0,954,26467,3575877666,3575877699,33
0,954,26468,3575877666,3575877701,35
0,954,26469,3575877666,3575877701,35
0,954,26470,3575877666,3575877701,35
0,954,26471,3575877666,3575877702,36
0,954,26472,3575877666,3575877702,36
0,954,26473,3575877666,3575877703,37
0,954,26474,3575877666,3575877705,39
0,954,26475,3575877666,3575877705,39
0,954,26476,3575877666,3575877705,39
0,954,26477,3575877666,3575877705,39
0,954,26478,3575877666,3575877706,40
0,954,26479,3575877666,3575877708,42
0,954,26480,3575877666,3575877709,43
0,954,26481,3575877666,3575877709,43
0,954,26482,3575877666,3575877710,44
0,954,26483,3575877666,3575877711,45
0,954,26484,3575877666,3575877712,46
0,954,26485,3575877666,3575877712,46
0,954,26486,3575877666,3575877712,46
0,954,26487,3575877666,3575877713,47
0,954,26488,3575877666,3575877714,48
0,954,26489,3575877666,3575877715,49
0,954,26490,3575877666,3575877715,49
0,954,26491,3575877666,3575877715,49
0,955,26492,3575877727,3575877727,0
0,955,26493,3575877727,3575877727,0
0,955,26494,3575877727,3575877727,0
0,955,26495,3575877727,3575877727,0
0,955,26496,3575877727,3575877727,0
0,955,26497,3575877727,3575877727,0
0,955,26498,3575877727,3575877727,0
0,955,26499,3575877727,3575877727,0
0,955,26500,3575877727,3575877727,0
0,955,26501,3575877727,3575877727,0
0,955,26502,3575877727,3575877727,0
0,955,26503,3575877727,3575877727,0
0,955,26504,3575877727,3575877727,0
0,955,26505,3575877727,3575877728,1
0,955,26506,3575877727,3575877728,1
0,955,26507,3575877727,3575877730,3
0,955,26508,3575877727,3575877730,3
0,955,26509,3575877727,3575877731,4
0,955,26510,3575877727,3575877731,4
0,955,26511,3575877727,3575877732,5
0,955,26512,3575877727,3575877734,7
0,955,26513,3575877727,3575877736,9
0,955,26514,3575877727,3575877736,9
0,955,26515,3575877727,3575877737,10
0,955,26516,3575877727,3575877737,10
0,955,26517,3575877727,3575877738,11
0,955,26518,3575877727,3575877738,11
0,955,26519,3575877727,3575877739,12
0,955,26520,3575877727,3575877741,14
0,955,26521,3575877727,3575877741,14
0,955,26522,3575877727,3575877741,14
0,955,26523,3575877727,3575877741,14
0,955,26524,3575877727,3575877741,14
0,955,26525,3575877727,3575877742,15
0,955,26526,3575877727,3575877742,15
0,955,26527,3575877727,3575877744,17
0,955,26528,3575877727,3575877745,18
0,955,26529,3575877727,3575877746,19
0,955,26530,3575877727,3575877746,19
0,955,26531,3575877727,3575877746,19
0,955,26532,3575877727,3575877746,19
0,955,26533,3575877727,3575877747,20
0,955,26534,3575877727,3575877748,21
0,955,26535,3575877727,3575877749,22
0,955,26536,3575877727,3575877749,22
0,955,26537,3575877727,3575877752,25
0,955,26538,3575877727,3575877753,26
0,955,26539,3575877727,3575877753,26
0,955,26540,3575877727,3575877754,27
0,955,26541,3575877727,3575877754,27
0,955,26542,3575877727,3575877755,28
0,955,26543,3575877727,3575877756,29
0,955,26544,3575877727,3575877757,30
0,955,26545,3575877727,3575877758,31
0,955,26546,3575877727,3575877759,32
0,955,26547,3575877727,3575877759,32
0,955,26548,3575877727,3575877760,33
0,955,26549,3575877727,3575877761,34
0,955,26550,3575877727,3575877762,35
0,955,26551,3575877727,3575877764,37
0,955,26552,3575877727,3575877764,37
0,955,26553,3575877727,3575877764,37
0,955,26554,3575877727,3575877765,38
0,955,26555,3575877727,3575877765,38
0,955,26556,3575877727,3575877766,39
0,955,26557,3575877727,3575877766,39
0,955,26558,3575877727,3575877766,39
0,955,26559,3575877727,3575877769,42
0,955,26560,3575877727,3575877770,43
0,955,26561,3575877727,3575877770,43
0,955,26562,3575877727,3575877771,44
0,955,26563,3575877727,3575877772,45
0,955,26564,3575877727,3575877774,47
0,955,26565,3575877727,3575877776,49
0,956,26566,3575877789,3575877789,0
0,956,26567,3575877789,3575877789,0
0,956,26568,3575877789,3575877789,0
0,956,26569,3575877789,3575877789,0
0,956,26570,3575877789,3575877789,0
0,956,26571,3575877789,3575877789,0
0,956,26572,3575877789,3575877789,0
0,956,26573,3575877789,3575877789,0
0,956,26574,3575877789,3575877789,0
0,956,26575,3575877789,3575877789,0
0,956,26576,3575877789,3575877789,0
0,956,26577,3575877789,3575877789,0
0,956,26578,3575877789,3575877789,0
0,956,26579,3575877789,3575877790,1
0,956,26580,3575877789,3575877794,5
0,956,26581,3575877789,3575877794,5
0,956,26582,3575877789,3575877798,9
0,956,26583,3575877789,3575877798,9
0,956,26584,3575877789,3575877799,10
0,956,26585,3575877789,3575877802,13
0,956,26586,3575877789,3575877804,15
0,956,26587,3575877789,3575877805,16
0,956,26588,3575877789,3575877806,17
0,956,26589,3575877789,3575877807,18
0,956,26590,3575877789,3575877808,19
0,956,26591,3575877789,3575877809,20
0,956,26592,3575877789,3575877810,21
0,956,26593,3575877789,3575877812,23
0,956,26594,3575877789,3575877814,25
0,956,26595,3575877789,3575877814,25
0,956,26596,3575877789,3575877814,25
0,956,26597,3575877789,3575877815,26
0,956,26598,3575877789,3575877815,26
0,956,26599,3575877789,3575877816,27
0,956,26600,3575877789,3575877816,27
0,956,26601,3575877789,3575877818,29
0,956,26602,3575877789,3575877819,30
0,956,26603,3575877789,3575877820,31
0,956,26604,3575877789,3575877821,32
0,956,26605,3575877789,3575877824,35
0,956,26606,3575877789,3575877825,36
0,956,26607,3575877789,3575877826,37
0,956,26608,3575877789,3575877828,39
0,956,26609,3575877789,3575877829,40
0,956,26610,3575877789,3575877829,40
0,956,26611,3575877789,3575877829,40
0,956,26612,3575877789,3575877829,40
0,956,26613,3575877789,3575877830,41
0,956,26614,3575877789,3575877830,41
0,956,26615,3575877789,3575877832,43
0,956,26616,3575877789,3575877832,43
0,956,26617,3575877789,3575877832,43
0,956,26618,3575877789,3575877833,44
0,956,26619,3575877789,3575877834,45
0,956,26620,3575877789,3575877836,47
0,956,26621,3575877789,3575877837,48
0,956,26622,3575877789,3575877837,48
0,956,26623,3575877789,3575877839,50
0,957,26624,3575877851,3575877851,0
0,957,26625,3575877851,3575877851,0
0,957,26626,3575877851,3575877851,0
0,957,26627,3575877851,3575877851,0
0,957,26628,3575877851,3575877851,0
0,957,26629,3575877851,3575877851,0
0,957,26630,3575877851,3575877851,0
0,957,26631,3575877851,3575877851,0
0,957,26632,3575877851,3575877851,0
0,957,26633,3575877851,3575877851,0
0,957,26634,3575877851,3575877851,0
0,957,26635,3575877851,3575877851,0
0,957,26636,3575877851,3575877852,1
0,957,26637,3575877851,3575877852,1
0,957,26638,3575877851,3575877853,2
0,957,26639,3575877851,3575877855,4
0,957,26640,3575877851,3575877856,5
0,957,26641,3575877851,3575877856,5
0,957,26642,3575877851,3575877857,6
0,957,26643,3575877851,3575877857,6
0,957,26644,3575877851,3575877857,6
0,957,26645,3575877851,3575877859,8
0,957,26646,3575877851,3575877859,8
0,957,26647,3575877851,3575877860,9
0,957,26648,3575877851,3575877862,11
0,957,26649,3575877851,3575877863,12
0,957,26650,3575877851,3575877863,12
0,957,26651,3575877851,3575877863,12
0,957,26652,3575877851,3575877864,13
0,957,26653,3575877851,3575877866,15
0,957,26654,3575877851,3575877866,15
0,957,26655,3575877851,3575877866,15
0,957,26656,3575877851,3575877867,16
0,957,26657,3575877851,3575877867,16
0,957,26658,3575877851,3575877869,18
0,957,26659,3575877851,3575877870,19
0,957,26660,3575877851,3575877872,21
0,957,26661,3575877851,3575877875,24
0,957,26662,3575877851,3575877877,26
0,957,26663,3575877851,3575877877,26
0,957,26664,3575877851,3575877878,27
0,957,26665,3575877851,3575877880,29
0,957,26666,3575877851,3575877881,30
0,957,26667,3575877851,3575877882,31
0,957,26668,3575877851,3575877882,31
0,957,26669,3575877851,3575877883,32
0,957,26670,3575877851,3575877884,33
0,957,26671,3575877851,3575877884,33
0,957,26672,3575877851,3575877887,36
0,957,26673,3575877851,3575877890,39
0,957,26674,3575877851,3575877891,40
0,957,26675,3575877851,3575877891,40
0,957,26676,3575877851,3575877892,41
0,957,26677,3575877851,3575877892,41
0,957,26678,3575877851,3575877892,41
0,957,26679,3575877851,3575877893,42
0,957,26680,3575877851,3575877893,42
0,957,26681,3575877851,3575877894,43
0,957,26682,3575877851,3575877894,43
0,957,26683,3575877851,3575877894,43
0,957,26684,3575877851,3575877895,44
0,957,26685,3575877851,3575877895,44
0,957,26686,3575877851,3575877896,45
0,957,26687,3575877851,3575877896,45
0,957,26688,3575877851,3575877897,46
0,957,26689,3575877851,3575877898,47
0,957,26690,3575877851,3575877898,47
0,957,26691,3575877851,3575877898,47
0,957,26692,3575877851,3575877898,47
0,957,26693,3575877851,3575877899,48
0,957,26694,3575877851,3575877900,49
0,957,26695,3575877851,3575877900,49
0,957,26696,3575877851,3575877901,50
0,957,26697,3575877851,3575877901,50
0,958,26698,3575877911,3575877911,0
0,958,26699,3575877911,3575877911,0
0,958,26700,3575877911,3575877911,0
0,958,26701,3575877911,3575877911,0
0,958,26702,3575877911,3575877911,0
0,958,26703,3575877911,3575877911,0
0,958,26704,3575877911,3575877911,0
0,958,26705,3575877911,3575877911,0
0,958,26706,3575877911,3575877911,0
0,958,26707,3575877911,3575877911,0
0,958,26708,3575877911,3575877911,0
0,958,26709,3575877911,3575877911,0
0,958,26710,3575877911,3575877911,0
0,958,26711,3575877911,3575877911,0
0,958,26712,3575877911,3575877912,1
0,958,26713,3575877911,3575877912,1
0,958,26714,3575877911,3575877912,1
0,958,26715,3575877911,3575877913,2
0,958,26716,3575877911,3575877914,3
0,958,26717,3575877911,3575877915,4
0,958,26718,3575877911,3575877915,4
0,958,26719,3575877911,3575877915,4
0,958,26720,3575877911,3575877917,6
0,958,26721,3575877911,3575877918,7
0,958,26722,3575877911,3575877919,8
0,958,26723,3575877911,3575877920,9
0,958,26724,3575877911,3575877920,9
0,958,26725,3575877911,3575877922,11
0,958,26726,3575877911,3575877922,11
0,958,26727,3575877911,3575877922,11
0,958,26728,3575877911,3575877922,11
0,958,26729,3575877911,3575877923,12
0,958,26730,3575877911,3575877923,12
0,958,26731,3575877911,3575877925,14
0,958,26732,3575877911,3575877925,14
0,958,26733,3575877911,3575877926,15
0,958,26734,3575877911,3575877927,16
0,958,26735,3575877911,3575877927,16
0,958,26736,3575877911,3575877927,16
0,958,26737,3575877911,3575877929,18
0,958,26738,3575877911,3575877931,20
0,958,26739,3575877911,3575877931,20
0,958,26740,3575877911,3575877933,22
0,958,26741,3575877911,3575877934,23
0,958,26742,3575877911,3575877935,24
0,958,26743,3575877911,3575877936,25
0,958,26744,3575877911,3575877937,26
0,958,26745,3575877911,3575877938,27
0,958,26746,3575877911,3575877938,27
0,958,26747,3575877911,3575877939,28
0,958,26748,3575877911,3575877940,29
0,958,26749,3575877911,3575877941,30
0,958,26750,3575877911,3575877941,30
0,958,26751,3575877911,3575877942,31
0,958,26752,3575877911,3575877942,31
0,958,26753,3575877911,3575877942,31
0,958,26754,3575877911,3575877942,31
0,958,26755,3575877911,3575877943,32
0,958,26756,3575877911,3575877943,32
0,958,26757,3575877911,3575877944,33
0,958,26758,3575877911,3575877945,34
0,958,26759,3575877911,3575877945,34
0,958,26760,3575877911,3575877948,37
0,958,26761,3575877911,3575877948,37
0,958,26762,3575877911,3575877949,38
0,958,26763,3575877911,3575877949,38
0,958,26764,3575877911,3575877954,43
0,958,26765,3575877911,3575877954,43
0,958,26766,3575877911,3575877955,44
0,958,26767,3575877911,3575877955,44
0,958,26768,3575877911,3575877955,44
0,958,26769,3575877911,3575877955,44
0,958,26770,3575877911,3575877957,46
0,958,26771,3575877911,3575877957,46
0,958,26772,3575877911,3575877957,46
0,958,26773,3575877911,3575877959,48
0,958,26774,3575877911,3575877959,48
0,958,26775,3575877911,3575877960,49
0,958,26776,3575877911,3575877961,50
0,959,26777,3575877971,3575877971,0
0,959,26778,3575877971,3575877971,0
0,959,26779,3575877971,3575877971,0
0,959,26780,3575877971,3575877971,0
0,959,26781,3575877971,3575877971,0
0,959,26782,3575877971,3575877971,0
0,959,26783,3575877971,3575877971,0
0,959,26784,3575877971,3575877971,0
0,959,26785,3575877971,3575877971,0
0,959,26786,3575877971,3575877971,0
0,959,26787,3575877971,3575877971,0
0,959,26788,3575877971,3575877971,0
0,959,26789,3575877971,3575877972,1
0,959,26790,3575877971,3575877974,3
0,959,26791,3575877971,3575877977,6
0,959,26792,3575877971,3575877977,6
0,959,26793,3575877971,3575877978,7
0,959,26794,3575877971,3575877980,9
0,959,26795,3575877971,3575877980,9
0,959,26796,3575877971,3575877980,9
0,959,26797,3575877971,3575877980,9
0,959,26798,3575877971,3575877985,14
0,959,26799,3575877971,3575877985,14
0,959,26800,3575877971,3575877986,15
0,959,26801,3575877971,3575877988,17
0,959,26802,3575877971,3575877989,18
0,959,26803,3575877971,3575877990,19
0,959,26804,3575877971,3575877990,19
0,959,26805,3575877971,3575877992,21
0,959,26806,3575877971,3575877994,23
0,959,26807,3575877971,3575877997,26
0,959,26808,3575877971,3575877999,28
0,959,26809,3575877971,3575878000,29
0,959,26810,3575877971,3575878003,32
0,959,26811,3575877971,3575878003,32
0,959,26812,3575877971,3575878005,34
0,959,26813,3575877971,3575878008,37
0,959,26814,3575877971,3575878008,37
0,959,26815,3575877971,3575878009,38
0,959,26816,3575877971,3575878009,38
0,959,26817,3575877971,3575878010,39
0,959,26818,3575877971,3575878013,42
0,959,26819,3575877971,3575878014,43
0,959,26820,3575877971,3575878014,43
0,959,26821,3575877971,3575878015,44
0,959,26822,3575877971,3575878015,44
0,959,26823,3575877971,3575878016,45
0,959,26824,3575877971,3575878016,45
0,959,26825,3575877971,3575878017,46
0,959,26826,3575877971,3575878018,47
0,959,26827,3575877971,3575878018,47
0,959,26828,3575877971,3575878020,49
0,960,26829,3575878033,3575878033,0
0,960,26830,3575878033,3575878033,0
0,960,26831,3575878033,3575878033,0
0,960,26832,3575878033,3575878033,0
0,960,26833,3575878033,3575878033,0
0,960,26834,3575878033,3575878033,0
0,960,26835,3575878033,3575878033,0
0,960,26836,3575878033,3575878033,0
0,960,26837,3575878033,3575878033,0
0,960,26838,3575878033,3575878033,0
0,960,26839,3575878033,3575878033,0
0,960,26840,3575878033,3575878033,0
0,960,26841,3575878033,3575878033,0
0,960,26842,3575878033,3575878035,2
0,960,26843,3575878033,3575878035,2
0,960,26844,3575878033,3575878035,2
0,960,26845,3575878033,3575878036,3
0,960,26846,3575878033,3575878036,3
0,960,26847,3575878033,3575878038,5
0,960,26848,3575878033,3575878039,6
0,960,26849,3575878033,3575878039,6
0,960,26850,3575878033,3575878042,9
0,960,26851,3575878033,3575878043,10
0,960,26852,3575878033,3575878045,12
0,960,26853,3575878033,3575878047,14
0,960,26854,3575878033,3575878048,15
0,960,26855,3575878033,3575878049,16
0,960,26856,3575878033,3575878049,16
0,960,26857,3575878033,3575878050,17
0,960,26858,3575878033,3575878050,17
0,960,26859,3575878033,3575878050,17
0,960,26860,3575878033,3575878051,18
0,960,26861,3575878033,3575878052,19
0,960,26862,3575878033,3575878052,19
0,960,26863,3575878033,3575878053,20
0,960,26864,3575878033,3575878055,22
0,960,26865,3575878033,3575878056,23
0,960,26866,3575878033,3575878057,24
0,960,26867,3575878033,3575878058,25
0,960,26868,3575878033,3575878058,25
0,960,26869,3575878033,3575878059,26
0,960,26870,3575878033,3575878059,26
0,960,26871,3575878033,3575878061,28
0,960,26872,3575878033,3575878062,29
0,960,26873,3575878033,3575878062,29
0,960,26874,3575878033,3575878063,30
0,960,26875,3575878033,3575878064,31
0,960,26876,3575878033,3575878065,32
0,960,26877,3575878033,3575878066,33
0,960,26878,3575878033,3575878066,33
0,960,26879,3575878033,3575878067,34
0,960,26880,3575878033,3575878067,34
0,960,26881,3575878033,3575878069,36
0,960,26882,3575878033,3575878070,37
0,960,26883,3575878033,3575878072,39
0,960,26884,3575878033,3575878075,42
0,960,26885,3575878033,3575878077,44
0,960,26886,3575878033,3575878077,44
0,960,26887,3575878033,3575878078,45
0,960,26888,3575878033,3575878081,48
0,960,26889,3575878033,3575878082,49
0,960,26890,3575878033,3575878082,49
0,961,26891,3575878096,3575878096,0
0,961,26892,3575878096,3575878096,0
0,961,26893,3575878096,3575878096,0
0,961,26894,3575878096,3575878096,0
0,961,26895,3575878096,3575878096,0
0,961,26896,3575878096,3575878096,0
0,961,26897,3575878096,3575878096,0
0,961,26898,3575878096,3575878096,0
0,961,26899,3575878096,3575878096,0
0,961,26900,3575878096,3575878096,0
0,961,26901,3575878096,3575878096,0
0,961,26902,3575878096,3575878096,0
0,961,26903,3575878096,3575878096,0
0,961,26904,3575878096,3575878096,0
0,961,26905,3575878096,3575878096,0
0,961,26906,3575878096,3575878096,0
0,961,26907,3575878096,3575878096,0
0,961,26908,3575878096,3575878096,0
0,961,26909,3575878096,3575878097,1
0,961,26910,3575878096,3575878097,1
0,961,26911,3575878096,3575878098,2
0,961,26912,3575878096,3575878098,2
0,961,26913,3575878096,3575878099,3
0,961,26914,3575878096,3575878099,3
0,961,26915,3575878096,3575878100,4
0,961,26916,3575878096,3575878100,4
0,961,26917,3575878096,3575878100,4
0,961,26918,3575878096,3575878101,5
0,961,26919,3575878096,3575878101,5
0,961,26920,3575878096,3575878102,6
0,961,26921,3575878096,3575878104,8
0,961,26922,3575878096,3575878105,9
0,961,26923,3575878096,3575878105,9
0,961,26924,3575878096,3575878106,10
0,961,26925,3575878096,3575878106,10
0,961,26926,3575878096,3575878106,10
0,961,26927,3575878096,3575878107,11
0,961,26928,3575878096,3575878109,13
0,961,26929,3575878096,3575878109,13
0,961,26930,3575878096,3575878110,14
0,961,26931,3575878096,3575878111,15
0,961,26932,3575878096,3575878112,16
0,961,26933,3575878096,3575878112,16
0,961,26934,3575878096,3575878113,17
0,961,26935,3575878096,3575878113,17
0,961,26936,3575878096,3575878114,18
0,961,26937,3575878096,3575878115,19
0,961,26938,3575878096,3575878117,21
0,961,26939,3575878096,3575878118,22
0,961,26940,3575878096,3575878119,23
0,961,26941,3575878096,3575878120,24
0,961,26942,3575878096,3575878121,25
0,961,26943,3575878096,3575878121,25
0,961,26944,3575878096,3575878122,26
0,961,26945,3575878096,3575878123,27
0,961,26946,3575878096,3575878123,27
0,961,26947,3575878096,3575878123,27
0,961,26948,3575878096,3575878123,27
0,961,26949,3575878096,3575878124,28
0,961,26950,3575878096,3575878126,30
0,961,26951,3575878096,3575878126,30
0,961,26952,3575878096,3575878126,30
0,961,26953,3575878096,3575878127,31
0,961,26954,3575878096,3575878127,31
0,961,26955,3575878096,3575878130,34
0,961,26956,3575878096,3575878130,34
0,961,26957,3575878096,3575878131,35
0,961,26958,3575878096,3575878131,35
0,961,26959,3575878096,3575878134,38
0,961,26960,3575878096,3575878137,41
0,961,26961,3575878096,3575878137,41
0,961,26962,3575878096,3575878137,41
0,961,26963,3575878096,3575878139,43
0,961,26964,3575878096,3575878139,43
0,961,26965,3575878096,3575878140,44
0,961,26966,3575878096,3575878141,45
0,961,26967,3575878096,3575878142,46
0,961,26968,3575878096,3575878142,46
0,961,26969,3575878096,3575878142,46
0,961,26970,3575878096,3575878142,46
0,961,26971,3575878096,3575878143,47
0,961,26972,3575878096,3575878143,47
0,961,26973,3575878096,3575878143,47
0,961,26974,3575878096,3575878144,48
0,961,26975,3575878096,3575878145,49
0,962,26976,3575878161,3575878161,0
0,962,26977,3575878161,3575878161,0
0,962,26978,3575878161,3575878161,0
0,962,26979,3575878161,3575878161,0
0,962,26980,3575878161,3575878161,0
0,962,26981,3575878161,3575878161,0
0,962,26982,3575878161,3575878161,0
0,962,26983,3575878161,3575878161,0
0,962,26984,3575878161,3575878161,0
0,962,26985,3575878161,3575878161,0
0,962,26986,3575878161,3575878161,0
0,962,26987,3575878161,3575878161,0
0,962,26988,3575878161,3575878161,0
0,962,26989,3575878161,3575878161,0
0,962,26990,3575878161,3575878161,0
0,962,26991,3575878161,3575878161,0
0,962,26992,3575878161,3575878161,0
0,962,26993,3575878161,3575878161,0
0,962,26994,3575878161,3575878162,1
0,962,26995,3575878161,3575878162,1
0,962,26996,3575878161,3575878164,3
0,962,26997,3575878161,3575878164,3
0,962,26998,3575878161,3575878165,4
0,962,26999,3575878161,3575878165,4
0,962,27000,3575878161,3575878165,4
0,962,27001,3575878161,3575878165,4
0,962,27002,3575878161,3575878166,5
0,962,27003,3575878161,3575878166,5
0,962,27004,3575878161,3575878167,6
0,962,27005,3575878161,3575878170,9
0,962,27006,3575878161,3575878170,9
0,962,27007,3575878161,3575878171,10
0,962,27008,3575878161,3575878172,11
0,962,27009,3575878161,3575878172,11
0,962,27010,3575878161,3575878174,13
0,962,27011,3575878161,3575878177,16
0,962,27012,3575878161,3575878178,17
0,962,27013,3575878161,3575878178,17
0,962,27014,3575878161,3575878179,18
0,962,27015,3575878161,3575878180,19
0,962,27016,3575878161,3575878180,19
0,962,27017,3575878161,3575878181,20
0,962,27018,3575878161,3575878181,20
0,962,27019,3575878161,3575878182,21
0,962,27020,3575878161,3575878185,24
0,962,27021,3575878161,3575878185,24
0,962,27022,3575878161,3575878186,25
0,962,27023,3575878161,3575878188,27
0,962,27024,3575878161,3575878189,28
0,962,27025,3575878161,3575878189,28
0,962,27026,3575878161,3575878189,28
0,962,27027,3575878161,3575878190,29
0,962,27028,3575878161,3575878192,31
0,962,27029,3575878161,3575878193,32
0,962,27030,3575878161,3575878195,34
0,962,27031,3575878161,3575878198,37
0,962,27032,3575878161,3575878201,40
0,962,27033,3575878161,3575878202,41
0,962,27034,3575878161,3575878205,44
0,962,27035,3575878161,3575878205,44
0,962,27036,3575878161,3575878207,46
0,962,27037,3575878161,3575878208,47
0,962,27038,3575878161,3575878210,49
0,962,27039,3575878161,3575878211,50
0,963,27040,3575878226,3575878226,0
0,963,27041,3575878226,3575878226,0
0,963,27042,3575878226,3575878226,0
0,963,27043,3575878226,3575878226,0
0,963,27044,3575878226,3575878226,0
0,963,27045,3575878226,3575878226,0
0,963,27046,3575878226,3575878226,0
0,963,27047,3575878226,3575878226,0
0,963,27048,3575878226,3575878226,0
0,963,27049,3575878226,3575878226,0
0,963,27050,3575878226,3575878226,0
0,963,27051,3575878226,3575878226,0
0,963,27052,3575878226,3575878226,0
0,963,27053,3575878226,3575878226,0
0,963,27054,3575878226,3575878226,0
0,963,27055,3575878226,3575878227,1
0,963,27056,3575878226,3575878228,2
0,963,27057,3575878226,3575878229,3
0,963,27058,3575878226,3575878229,3
0,963,27059,3575878226,3575878230,4
0,963,27060,3575878226,3575878230,4
0,963,27061,3575878226,3575878230,4
0,963,27062,3575878226,3575878232,6
0,963,27063,3575878226,3575878233,7
0,963,27064,3575878226,3575878234,8
0,963,27065,3575878226,3575878235,9
0,963,27066,3575878226,3575878237,11
0,963,27067,3575878226,3575878237,11
0,963,27068,3575878226,3575878237,11
0,963,27069,3575878226,3575878239,13
0,963,27070,3575878226,3575878239,13
0,963,27071,3575878226,3575878240,14
0,963,27072,3575878226,3575878240,14
0,963,27073,3575878226,3575878241,15
0,963,27074,3575878226,3575878242,16
0,963,27075,3575878226,3575878244,18
0,963,27076,3575878226,3575878246,20
0,963,27077,3575878226,3575878247,21
0,963,27078,3575878226,3575878248,22
0,963,27079,3575878226,3575878248,22
0,963,27080,3575878226,3575878249,23
0,963,27081,3575878226,3575878250,24
0,963,27082,3575878226,3575878250,24
0,963,27083,3575878226,3575878251,25
0,963,27084,3575878226,3575878251,25
0,963,27085,3575878226,3575878252,26
0,963,27086,3575878226,3575878252,26
0,963,27087,3575878226,3575878254,28
0,963,27088,3575878226,3575878255,29
0,963,27089,3575878226,3575878256,30
0,963,27090,3575878226,3575878258,32
0,963,27091,3575878226,3575878258,32
0,963,27092,3575878226,3575878258,32
0,963,27093,3575878226,3575878259,33
0,963,27094,3575878226,3575878260,34
0,963,27095,3575878226,3575878260,34
0,963,27096,3575878226,3575878262,36
0,963,27097,3575878226,3575878263,37
0,963,27098,3575878226,3575878264,38
0,963,27099,3575878226,3575878266,40
0,963,27100,3575878226,3575878266,40
0,963,27101,3575878226,3575878266,40
0,963,27102,3575878226,3575878267,41
0,963,27103,3575878226,3575878267,41
0,963,27104,3575878226,3575878270,44
0,963,27105,3575878226,3575878270,44
0,963,27106,3575878226,3575878272,46
0,963,27107,3575878226,3575878275,49
0,964,27108,3575878287,3575878287,0
0,964,27109,3575878287,3575878287,0
0,964,27110,3575878287,3575878287,0
0,964,27111,3575878287,3575878287,0
0,964,27112,3575878287,3575878287,0
0,964,27113,3575878287,3575878287,0
0,964,27114,3575878287,3575878287,0
0,964,27115,3575878287,3575878287,0
0,964,27116,3575878287,3575878287,0
0,964,27117,3575878287,3575878287,0
0,964,27118,3575878287,3575878288,1
0,964,27119,3575878287,3575878288,1
0,964,27120,3575878287,3575878291,4
0,964,27121,3575878287,3575878291,4
0,964,27122,3575878287,3575878291,4
0,964,27123,3575878287,3575878292,5
0,964,27124,3575878287,3575878292,5
0,964,27125,3575878287,3575878293,6
0,964,27126,3575878287,3575878294,7
0,964,27127,3575878287,3575878294,7
0,964,27128,3575878287,3575878295,8
0,964,27129,3575878287,3575878295,8
0,964,27130,3575878287,3575878296,9
0,964,27131,3575878287,3575878296,9
0,964,27132,3575878287,3575878296,9
0,964,27133,3575878287,3575878297,10
0,964,27134,3575878287,3575878297,10
0,964,27135,3575878287,3575878298,11
0,964,27136,3575878287,3575878298,11
0,964,27137,3575878287,3575878299,12
0,964,27138,3575878287,3575878299,12
0,964,27139,3575878287,3575878300,13
0,964,27140,3575878287,3575878300,13
0,964,27141,3575878287,3575878301,14
0,964,27142,3575878287,3575878301,14
0,964,27143,3575878287,3575878302,15
0,964,27144,3575878287,3575878302,15
0,964,27145,3575878287,3575878303,16
0,964,27146,3575878287,3575878306,19
0,964,27147,3575878287,3575878307,20
0,964,27148,3575878287,3575878307,20
0,964,27149,3575878287,3575878307,20
0,964,27150,3575878287,3575878307,20
0,964,27151,3575878287,3575878308,21
0,964,27152,3575878287,3575878309,22
0,964,27153,3575878287,3575878309,22
0,964,27154,3575878287,3575878310,23
0,964,27155,3575878287,3575878310,23
0,964,27156,3575878287,3575878312,25
0,964,27157,3575878287,3575878313,26
0,964,27158,3575878287,3575878313,26
0,964,27159,3575878287,3575878313,26
0,964,27160,3575878287,3575878313,26
0,964,27161,3575878287,3575878314,27
0,964,27162,3575878287,3575878315,28
0,964,27163,3575878287,3575878315,28
0,964,27164,3575878287,3575878316,29
0,964,27165,3575878287,3575878316,29
0,964,27166,3575878287,3575878318,31
0,964,27167,3575878287,3575878319,32
0,964,27168,3575878287,3575878320,33
0,964,27169,3575878287,3575878321,34
0,964,27170,3575878287,3575878322,35
0,964,27171,3575878287,3575878322,35
0,964,27172,3575878287,3575878322,35
0,964,27173,3575878287,3575878323,36
0,964,27174,3575878287,3575878323,36
0,964,27175,3575878287,3575878323,36
0,964,27176,3575878287,3575878325,38
0,964,27177,3575878287,3575878326,39
0,964,27178,3575878287,3575878326,39
0,964,27179,3575878287,3575878327,40
0,964,27180,3575878287,3575878327,40
0,964,27181,3575878287,3575878328,41
0,964,27182,3575878287,3575878329,42
0,964,27183,3575878287,3575878329,42
0,964,27184,3575878287,3575878331,44
0,964,27185,3575878287,3575878331,44
0,964,27186,3575878287,3575878333,46
0,964,27187,3575878287,3575878335,48
0,964,27188,3575878287,3575878336,49
0,964,27189,3575878287,3575878337,50
0,965,27190,3575878349,3575878350,1
0,965,27191,3575878349,3575878350,1
0,965,27192,3575878349,3575878350,1
0,965,27193,3575878349,3575878350,1
0,965,27194,3575878349,3575878350,1
0,965,27195,3575878349,3575878350,1
0,965,27196,3575878349,3575878350,1
0,965,27197,3575878349,3575878350,1
0,965,27198,3575878349,3575878350,1
0,965,27199,3575878349,3575878350,1
0,965,27200,3575878349,3575878350,1
0,965,27201,3575878349,3575878350,1
0,965,27202,3575878349,3575878350,1
0,965,27203,3575878349,3575878350,1
0,965,27204,3575878349,3575878350,1
0,965,27205,3575878349,3575878350,1
0,965,27206,3575878349,3575878350,1
0,965,27207,3575878349,3575878350,1
0,965,27208,3575878349,3575878350,1
0,965,27209,3575878349,3575878350,1
0,965,27210,3575878349,3575878350,1
0,965,27211,3575878349,3575878352,3
0,965,27212,3575878349,3575878353,4
0,965,27213,3575878349,3575878353,4
0,965,27214,3575878349,3575878355,6
0,965,27215,3575878349,3575878355,6
0,965,27216,3575878349,3575878355,6
0,965,27217,3575878349,3575878357,8
0,965,27218,3575878349,3575878357,8
0,965,27219,3575878349,3575878357,8
0,965,27220,3575878349,3575878357,8
0,965,27221,3575878349,3575878358,9
0,965,27222,3575878349,3575878359,10
0,965,27223,3575878349,3575878360,11
0,965,27224,3575878349,3575878360,11
0,965,27225,3575878349,3575878361,12
0,965,27226,3575878349,3575878361,12
0,965,27227,3575878349,3575878361,12
0,965,27228,3575878349,3575878362,13
0,965,27229,3575878349,3575878364,15
0,965,27230,3575878349,3575878364,15
0,965,27231,3575878349,3575878365,16
0,965,27232,3575878349,3575878365,16
0,965,27233,3575878349,3575878366,17
0,965,27234,3575878349,3575878367,18
0,965,27235,3575878349,3575878367,18
0,965,27236,3575878349,3575878370,21
0,965,27237,3575878349,3575878370,21
0,965,27238,3575878349,3575878371,22
0,965,27239,3575878349,3575878372,23
0,965,27240,3575878349,3575878372,23
0,965,27241,3575878349,3575878375,26
0,965,27242,3575878349,3575878377,28
0,965,27243,3575878349,3575878378,29
0,965,27244,3575878349,3575878378,29
0,965,27245,3575878349,3575878379,30
0,965,27246,3575878349,3575878379,30
0,965,27247,3575878349,3575878380,31
0,965,27248,3575878349,3575878380,31
0,965,27249,3575878349,3575878381,32
0,965,27250,3575878349,3575878381,32
0,965,27251,3575878349,3575878382,33
0,965,27252,3575878349,3575878385,36
0,965,27253,3575878349,3575878386,37
0,965,27254,3575878349,3575878387,38
0,965,27255,3575878349,3575878388,39
0,965,27256,3575878349,3575878389,40
0,965,27257,3575878349,3575878390,41
0,965,27258,3575878349,3575878390,41
0,965,27259,3575878349,3575878392,43
0,965,27260,3575878349,3575878393,44
0,965,27261,3575878349,3575878395,46
0,966,27262,3575878408,3575878408,0
0,966,27263,3575878408,3575878408,0
0,966,27264,3575878408,3575878408,0
0,966,27265,3575878408,3575878409,1
0,966,27266,3575878408,3575878409,1
0,966,27267,3575878408,3575878409,1
0,966,27268,3575878408,3575878409,1
0,966,27269,3575878408,3575878409,1
0,966,27270,3575878408,3575878410,2
0,966,27271,3575878408,3575878410,2
0,966,27272,3575878408,3575878413,5
0,966,27273,3575878408,3575878414,6
0,966,27274,3575878408,3575878415,7
0,966,27275,3575878408,3575878415,7
0,966,27276,3575878408,3575878415,7
0,966,27277,3575878408,3575878415,7
0,966,27278,3575878408,3575878415,7
0,966,27279,3575878408,3575878416,8
0,966,27280,3575878408,3575878418,10
0,966,27281,3575878408,3575878418,10
0,966,27282,3575878408,3575878418,10
0,966,27283,3575878408,3575878421,13
0,966,27284,3575878408,3575878421,13
0,966,27285,3575878408,3575878425,17
0,966,27286,3575878408,3575878426,18
0,966,27287,3575878408,3575878426,18
0,966,27288,3575878408,3575878428,20
0,966,27289,3575878408,3575878428,20
0,966,27290,3575878408,3575878429,21
0,966,27291,3575878408,3575878430,22
0,966,27292,3575878408,3575878430,22
0,966,27293,3575878408,3575878430,22
0,966,27294,3575878408,3575878432,24
0,966,27295,3575878408,3575878433,25
0,966,27296,3575878408,3575878434,26
0,966,27297,3575878408,3575878435,27
0,966,27298,3575878408,3575878437,29
0,966,27299,3575878408,3575878437,29
0,966,27300,3575878408,3575878437,29
0,966,27301,3575878408,3575878439,31
0,966,27302,3575878408,3575878440,32
0,966,27303,3575878408,3575878442,34
0,966,27304,3575878408,3575878444,36
0,966,27305,3575878408,3575878446,38
0,966,27306,3575878408,3575878448,40
0,966,27307,3575878408,3575878448,40
0,966,27308,3575878408,3575878449,41
0,966,27309,3575878408,3575878450,42
0,966,27310,3575878408,3575878450,42
0,966,27311,3575878408,3575878450,42
0,966,27312,3575878408,3575878451,43
0,966,27313,3575878408,3575878452,44
0,966,27314,3575878408,3575878453,45
0,966,27315,3575878408,3575878453,45
0,966,27316,3575878408,3575878455,47
0,966,27317,3575878408,3575878455,47
0,966,27318,3575878408,3575878457,49
0,966,27319,3575878408,3575878457,49
0,966,27320,3575878408,3575878458,50
0,967,27321,3575878469,3575878469,0
0,967,27322,3575878469,3575878469,0
0,967,27323,3575878469,3575878469,0
0,967,27324,3575878469,3575878469,0
0,967,27325,3575878469,3575878469,0
0,967,27326,3575878469,3575878469,0
0,967,27327,3575878469,3575878469,0
0,967,27328,3575878469,3575878469,0
0,967,27329,3575878469,3575878469,0
0,967,27330,3575878469,3575878469,0
0,967,27331,3575878469,3575878469,0
0,967,27332,3575878469,3575878469,0
0,967,27333,3575878469,3575878469,0
0,967,27334,3575878469,3575878470,1
0,967,27335,3575878469,3575878472,3
0,967,27336,3575878469,3575878472,3
0,967,27337,3575878469,3575878475,6
0,967,27338,3575878469,3575878477,8
0,967,27339,3575878469,3575878478,9
0,967,27340,3575878469,3575878478,9
0,967,27341,3575878469,3575878481,12
0,967,27342,3575878469,3575878482,13
0,967,27343,3575878469,3575878483,14
0,967,27344,3575878469,3575878484,15
0,967,27345,3575878469,3575878484,15
0,967,27346,3575878469,3575878487,18
0,967,27347,3575878469,3575878487,18
0,967,27348,3575878469,3575878488,19
0,967,27349,3575878469,3575878491,22
0,967,27350,3575878469,3575878491,22
0,967,27351,3575878469,3575878491,22
0,967,27352,3575878469,3575878492,23
0,967,27353,3575878469,3575878492,23
0,967,27354,3575878469,3575878493,24
0,967,27355,3575878469,3575878493,24
0,967,27356,3575878469,3575878494,25
0,967,27357,3575878469,3575878494,25
0,967,27358,3575878469,3575878494,25
0,967,27359,3575878469,3575878494,25
0,967,27360,3575878469,3575878495,26
0,967,27361,3575878469,3575878496,27
0,967,27362,3575878469,3575878497,28
0,967,27363,3575878469,3575878497,28
0,967,27364,3575878469,3575878498,29
0,967,27365,3575878469,3575878499,30
0,967,27366,3575878469,3575878499,30
0,967,27367,3575878469,3575878499,30
0,967,27368,3575878469,3575878500,31
0,967,27369,3575878469,3575878500,31
0,967,27370,3575878469,3575878501,32
0,967,27371,3575878469,3575878501,32
0,967,27372,3575878469,3575878502,33
0,967,27373,3575878469,3575878502,33
0,967,27374,3575878469,3575878505,36
0,967,27375,3575878469,3575878506,37
0,967,27376,3575878469,3575878506,37
0,967,27377,3575878469,3575878506,37
0,967,27378,3575878469,3575878506,37
0,967,27379,3575878469,3575878506,37
0,967,27380,3575878469,3575878506,37
0,967,27381,3575878469,3575878508,39
0,967,27382,3575878469,3575878509,40
0,967,27383,3575878469,3575878510,41
0,967,27384,3575878469,3575878510,41
0,967,27385,3575878469,3575878512,43
0,967,27386,3575878469,3575878512,43
0,967,27387,3575878469,3575878513,44
0,967,27388,3575878469,3575878513,44
0,967,27389,3575878469,3575878514,45
0,967,27390,3575878469,3575878514,45
0,967,27391,3575878469,3575878515,46
0,967,27392,3575878469,3575878515,46
0,967,27393,3575878469,3575878516,47
0,967,27394,3575878469,3575878516,47
0,967,27395,3575878469,3575878519,50
0,968,27396,3575878533,3575878533,0
0,968,27397,3575878533,3575878533,0
0,968,27398,3575878533,3575878533,0
0,968,27399,3575878533,3575878533,0
0,968,27400,3575878533,3575878533,0
0,968,27401,3575878533,3575878533,0
0,968,27402,3575878533,3575878533,0
0,968,27403,3575878533,3575878533,0
0,968,27404,3575878533,3575878533,0
0,968,27405,3575878533,3575878533,0
0,968,27406,3575878533,3575878533,0
0,968,27407,3575878533,3575878533,0
0,968,27408,3575878533,3575878533,0
0,968,27409,3575878533,3575878533,0
0,968,27410,3575878533,3575878533,0
0,968,27411,3575878533,3575878533,0
0,968,27412,3575878533,3575878533,0
0,968,27413,3575878533,3575878533,0
0,968,27414,3575878533,3575878533,0
0,968,27415,3575878533,3575878534,1
0,968,27416,3575878533,3575878535,2
0,968,27417,3575878533,3575878536,3
0,968,27418,3575878533,3575878536,3
0,968,27419,3575878533,3575878537,4
0,968,27420,3575878533,3575878538,5
0,968,27421,3575878533,3575878539,6
0,968,27422,3575878533,3575878539,6
0,968,27423,3575878533,3575878540,7
0,968,27424,3575878533,3575878540,7
0,968,27425,3575878533,3575878541,8
0,968,27426,3575878533,3575878542,9
0,968,27427,3575878533,3575878542,9
0,968,27428,3575878533,3575878542,9
0,968,27429,3575878533,3575878542,9
0,968,27430,3575878533,3575878543,10
0,968,27431,3575878533,3575878544,11
0,968,27432,3575878533,3575878545,12
0,968,27433,3575878533,3575878545,12
0,968,27434,3575878533,3575878546,13
0,968,27435,3575878533,3575878546,13
0,968,27436,3575878533,3575878549,16
0,968,27437,3575878533,3575878549,16
0,968,27438,3575878533,3575878550,17
0,968,27439,3575878533,3575878552,19
0,968,27440,3575878533,3575878553,20
0,968,27441,3575878533,3575878553,20
0,968,27442,3575878533,3575878553,20
0,968,27443,3575878533,3575878553,20
0,968,27444,3575878533,3575878554,21
0,968,27445,3575878533,3575878556,23
0,968,27446,3575878533,3575878556,23
0,968,27447,3575878533,3575878557,24
0,968,27448,3575878533,3575878557,24
0,968,27449,3575878533,3575878557,24
0,968,27450,3575878533,3575878557,24
0,968,27451,3575878533,3575878558,25
0,968,27452,3575878533,3575878559,26
0,968,27453,3575878533,3575878560,27
0,968,27454,3575878533,3575878560,27
0,968,27455,3575878533,3575878560,27
0,968,27456,3575878533,3575878560,27
0,968,27457,3575878533,3575878562,29
0,968,27458,3575878533,3575878563,30
0,968,27459,3575878533,3575878564,31
0,968,27460,3575878533,3575878564,31
0,968,27461,3575878533,3575878565,32
0,968,27462,3575878533,3575878565,32
0,968,27463,3575878533,3575878566,33
0,968,27464,3575878533,3575878566,33
0,968,27465,3575878533,3575878566,33
0,968,27466,3575878533,3575878568,35
0,968,27467,3575878533,3575878569,36
0,968,27468,3575878533,3575878570,37
0,968,27469,3575878533,3575878571,38
0,968,27470,3575878533,3575878571,38
0,968,27471,3575878533,3575878575,42
0,968,27472,3575878533,3575878577,44
0,968,27473,3575878533,3575878577,44
0,968,27474,3575878533,3575878577,44
0,968,27475,3575878533,3575878577,44
0,968,27476,3575878533,3575878578,45
0,968,27477,3575878533,3575878579,46
0,968,27478,3575878533,3575878579,46
0,968,27479,3575878533,3575878580,47
0,968,27480,3575878533,3575878580,47
0,968,27481,3575878533,3575878581,48
0,969,27482,3575878594,3575878594,0
0,969,27483,3575878594,3575878594,0
0,969,27484,3575878594,3575878594,0
0,969,27485,3575878594,3575878594,0
0,969,27486,3575878594,3575878594,0
0,969,27487,3575878594,3575878594,0
0,969,27488,3575878594,3575878594,0
0,969,27489,3575878594,3575878594,0
0,969,27490,3575878594,3575878598,4
0,969,27491,3575878594,3575878600,6
0,969,27492,3575878594,3575878601,7
0,969,27493,3575878594,3575878605,11
0,969,27494,3575878594,3575878605,11
0,969,27495,3575878594,3575878607,13
0,969,27496,3575878594,3575878607,13
0,969,27497,3575878594,3575878609,15
0,969,27498,3575878594,3575878610,16
0,969,27499,3575878594,3575878612,18
0,969,27500,3575878594,3575878613,19
0,969,27501,3575878594,3575878614,20
0,969,27502,3575878594,3575878614,20
0,969,27503,3575878594,3575878614,20
0,969,27504,3575878594,3575878614,20
0,969,27505,3575878594,3575878614,20
0,969,27506,3575878594,3575878615,21
0,969,27507,3575878594,3575878616,22
0,969,27508,3575878594,3575878617,23
0,969,27509,3575878594,3575878617,23
0,969,27510,3575878594,3575878618,24
0,969,27511,3575878594,3575878620,26
0,969,27512,3575878594,3575878620,26
0,969,27513,3575878594,3575878623,29
0,969,27514,3575878594,3575878625,31
0,969,27515,3575878594,3575878627,33
0,969,27516,3575878594,3575878627,33
0,969,27517,3575878594,3575878628,34
0,969,27518,3575878594,3575878629,35
0,969,27519,3575878594,3575878629,35
0,969,27520,3575878594,3575878629,35
0,969,27521,3575878594,3575878629,35
0,969,27522,3575878594,3575878631,37
0,969,27523,3575878594,3575878632,38
0,969,27524,3575878594,3575878632,38
0,969,27525,3575878594,3575878633,39
0,969,27526,3575878594,3575878634,40
0,969,27527,3575878594,3575878635,41
0,969,27528,3575878594,3575878635,41
0,969,27529,3575878594,3575878636,42
0,969,27530,3575878594,3575878638,44
0,969,27531,3575878594,3575878638,44
0,969,27532,3575878594,3575878640,46
0,969,27533,3575878594,3575878642,48
0,969,27534,3575878594,3575878642,48
0,970,27535,3575878656,3575878656,0
0,970,27536,3575878656,3575878656,0
0,970,27537,3575878656,3575878656,0
0,970,27538,3575878656,3575878656,0
0,970,27539,3575878656,3575878656,0
0,970,27540,3575878656,3575878656,0
0,970,27541,3575878656,3575878656,0
0,970,27542,3575878656,3575878656,0
0,970,27543,3575878656,3575878656,0
0,970,27544,3575878656,3575878656,0
0,970,27545,3575878656,3575878656,0
0,970,27546,3575878656,3575878656,0
0,970,27547,3575878656,3575878656,0
0,970,27548,3575878656,3575878656,0
0,970,27549,3575878656,3575878657,1
0,970,27550,3575878656,3575878657,1
0,970,27551,3575878656,3575878659,3
0,970,27552,3575878656,3575878659,3
0,970,27553,3575878656,3575878661,5
0,970,27554,3575878656,3575878661,5
0,970,27555,3575878656,3575878661,5
0,970,27556,3575878656,3575878663,7
0,970,27557,3575878656,3575878663,7
0,970,27558,3575878656,3575878665,9
0,970,27559,3575878656,3575878665,9
0,970,27560,3575878656,3575878665,9
0,970,27561,3575878656,3575878666,10
0,970,27562,3575878656,3575878666,10
0,970,27563,3575878656,3575878666,10
0,970,27564,3575878656,3575878668,12
0,970,27565,3575878656,3575878669,13
0,970,27566,3575878656,3575878672,16
0,970,27567,3575878656,3575878672,16
0,970,27568,3575878656,3575878675,19
0,970,27569,3575878656,3575878677,21
0,970,27570,3575878656,3575878678,22
0,970,27571,3575878656,3575878678,22
0,970,27572,3575878656,3575878681,25
0,970,27573,3575878656,3575878681,25
0,970,27574,3575878656,3575878684,28
0,970,27575,3575878656,3575878684,28
0,970,27576,3575878656,3575878684,28
0,970,27577,3575878656,3575878686,30
0,970,27578,3575878656,3575878687,31
0,970,27579,3575878656,3575878687,31
0,970,27580,3575878656,3575878691,35
0,970,27581,3575878656,3575878691,35
0,970,27582,3575878656,3575878692,36
0,970,27583,3575878656,3575878692,36
0,970,27584,3575878656,3575878693,37
0,970,27585,3575878656,3575878693,37
0,970,27586,3575878656,3575878694,38
0,970,27587,3575878656,3575878695,39
0,970,27588,3575878656,3575878695,39
0,970,27589,3575878656,3575878696,40
0,970,27590,3575878656,3575878697,41
0,970,27591,3575878656,3575878697,41
0,970,27592,3575878656,3575878697,41
0,970,27593,3575878656,3575878698,42
0,970,27594,3575878656,3575878700,44
0,970,27595,3575878656,3575878700,44
0,970,27596,3575878656,3575878700,44
0,970,27597,3575878656,3575878701,45
0,970,27598,3575878656,3575878701,45
0,970,27599,3575878656,3575878701,45
0,970,27600,3575878656,3575878702,46
0,970,27601,3575878656,3575878702,46
0,970,27602,3575878656,3575878704,48
0,970,27603,3575878656,3575878705,49
0,970,27604,3575878656,3575878706,50
0,971,27605,3575878718,3575878718,0
0,971,27606,3575878718,3575878718,0
0,971,27607,3575878718,3575878718,0
0,971,27608,3575878718,3575878718,0
0,971,27609,3575878718,3575878718,0
0,971,27610,3575878718,3575878718,0
0,971,27611,3575878718,3575878718,0
0,971,27612,3575878718,3575878718,0
0,971,27613,3575878718,3575878718,0
0,971,27614,3575878718,3575878718,0
0,971,27615,3575878718,3575878718,0
0,971,27616,3575878718,3575878718,0
0,971,27617,3575878718,3575878718,0
0,971,27618,3575878718,3575878718,0
0,971,27619,3575878718,3575878718,0
0,971,27620,3575878718,3575878718,0
0,971,27621,3575878718,3575878718,0
0,971,27622,3575878718,3575878718,0
0,971,27623,3575878718,3575878719,1
0,971,27624,3575878718,3575878721,3
0,971,27625,3575878718,3575878722,4
0,971,27626,3575878718,3575878723,5
0,971,27627,3575878718,3575878723,5
0,971,27628,3575878718,3575878724,6
0,971,27629,3575878718,3575878724,6
0,971,27630,3575878718,3575878725,7
0,971,27631,3575878718,3575878725,7
0,971,27632,3575878718,3575878726,8
0,971,27633,3575878718,3575878726,8
0,971,27634,3575878718,3575878727,9
0,971,27635,3575878718,3575878727,9
0,971,27636,3575878718,3575878728,10
0,971,27637,3575878718,3575878729,11
0,971,27638,3575878718,3575878729,11
0,971,27639,3575878718,3575878730,12
0,971,27640,3575878718,3575878733,15
0,971,27641,3575878718,3575878734,16
0,971,27642,3575878718,3575878735,17
0,971,27643,3575878718,3575878735,17
0,971,27644,3575878718,3575878737,19
0,971,27645,3575878718,3575878737,19
0,971,27646,3575878718,3575878738,20
0,971,27647,3575878718,3575878739,21
0,971,27648,3575878718,3575878740,22
0,971,27649,3575878718,3575878740,22
0,971,27650,3575878718,3575878740,22
0,971,27651,3575878718,3575878741,23
0,971,27652,3575878718,3575878742,24
0,971,27653,3575878718,3575878742,24
0,971,27654,3575878718,3575878742,24
0,971,27655,3575878718,3575878742,24
0,971,27656,3575878718,3575878744,26
0,971,27657,3575878718,3575878745,27
0,971,27658,3575878718,3575878745,27
0,971,27659,3575878718,3575878746,28
0,971,27660,3575878718,3575878746,28
0,971,27661,3575878718,3575878747,29
0,971,27662,3575878718,3575878748,30
0,971,27663,3575878718,3575878748,30
0,971,27664,3575878718,3575878749,31
0,971,27665,3575878718,3575878752,34
0,971,27666,3575878718,3575878752,34
0,971,27667,3575878718,3575878752,34
0,971,27668,3575878718,3575878753,35
0,971,27669,3575878718,3575878754,36
0,971,27670,3575878718,3575878756,38
0,971,27671,3575878718,3575878757,39
0,971,27672,3575878718,3575878757,39
0,971,27673,3575878718,3575878758,40
0,971,27674,3575878718,3575878758,40
0,971,27675,3575878718,3575878759,41
0,971,27676,3575878718,3575878759,41
0,971,27677,3575878718,3575878760,42
0,971,27678,3575878718,3575878760,42
0,971,27679,3575878718,3575878761,43
0,971,27680,3575878718,3575878762,44
0,971,27681,3575878718,3575878763,45
0,971,27682,3575878718,3575878764,46
0,971,27683,3575878718,3575878764,46
0,971,27684,3575878718,3575878764,46
0,971,27685,3575878718,3575878765,47
0,971,27686,3575878718,3575878765,47
0,971,27687,3575878718,3575878766,48
0,971,27688,3575878718,3575878766,48
0,971,27689,3575878718,3575878766,48
0,971,27690,3575878718,3575878766,48
0,972,27691,3575878778,3575878778,0
0,972,27692,3575878778,3575878778,0
0,972,27693,3575878778,3575878778,0
0,972,27694,3575878778,3575878778,0
0,972,27695,3575878778,3575878778,0
0,972,27696,3575878778,3575878778,0
0,972,27697,3575878778,3575878778,0
0,972,27698,3575878778,3575878778,0
0,972,27699,3575878778,3575878778,0
0,972,27700,3575878778,3575878778,0
0,972,27701,3575878778,3575878778,0
0,972,27702,3575878778,3575878779,1
0,972,27703,3575878778,3575878780,2
0,972,27704,3575878778,3575878780,2
0,972,27705,3575878778,3575878781,3
0,972,27706,3575878778,3575878782,4
0,972,27707,3575878778,3575878784,6
0,972,27708,3575878778,3575878785,7
0,972,27709,3575878778,3575878788,10
0,972,27710,3575878778,3575878788,10
0,972,27711,3575878778,3575878789,11
0,972,27712,3575878778,3575878790,12
0,972,27713,3575878778,3575878790,12
0,972,27714,3575878778,3575878794,16
0,972,27715,3575878778,3575878797,19
0,972,27716,3575878778,3575878799,21
0,972,27717,3575878778,3575878800,22
0,972,27718,3575878778,3575878801,23
0,972,27719,3575878778,3575878805,27
0,972,27720,3575878778,3575878805,27
0,972,27721,3575878778,3575878806,28
0,972,27722,3575878778,3575878808,30
0,972,27723,3575878778,3575878808,30
0,972,27724,3575878778,3575878810,32
0,972,27725,3575878778,3575878811,33
0,972,27726,3575878778,3575878813,35
0,972,27727,3575878778,3575878813,35
0,972,27728,3575878778,3575878813,35
0,972,27729,3575878778,3575878814,36
0,972,27730,3575878778,3575878814,36
0,972,27731,3575878778,3575878814,36
0,972,27732,3575878778,3575878814,36
0,972,27733,3575878778,3575878815,37
0,972,27734,3575878778,3575878815,37
0,972,27735,3575878778,3575878817,39
0,972,27736,3575878778,3575878818,40
0,972,27737,3575878778,3575878818,40
0,972,27738,3575878778,3575878819,41
0,972,27739,3575878778,3575878822,44
0,972,27740,3575878778,3575878824,46
0,972,27741,3575878778,3575878825,47
0,972,27742,3575878778,3575878827,49
0,972,27743,3575878778,3575878827,49
0,973,27744,3575878843,3575878843,0
0,973,27745,3575878843,3575878843,0
0,973,27746,3575878843,3575878843,0
0,973,27747,3575878843,3575878843,0
0,973,27748,3575878843,3575878843,0
0,973,27749,3575878843,3575878843,0
0,973,27750,3575878843,3575878843,0
0,973,27751,3575878843,3575878843,0
0,973,27752,3575878843,3575878843,0
0,973,27753,3575878843,3575878843,0
0,973,27754,3575878843,3575878843,0
0,973,27755,3575878843,3575878843,0
0,973,27756,3575878843,3575878843,0
0,973,27757,3575878843,3575878843,0
0,973,27758,3575878843,3575878843,0
0,973,27759,3575878843,3575878843,0
0,973,27760,3575878843,3575878845,2
0,973,27761,3575878843,3575878847,4
0,973,27762,3575878843,3575878847,4
0,973,27763,3575878843,3575878848,5
0,973,27764,3575878843,3575878850,7
0,973,27765,3575878843,3575878850,7
0,973,27766,3575878843,3575878850,7
0,973,27767,3575878843,3575878850,7
0,973,27768,3575878843,3575878852,9
0,973,27769,3575878843,3575878852,9
0,973,27770,3575878843,3575878852,9
0,973,27771,3575878843,3575878854,11
0,973,27772,3575878843,3575878856,13
0,973,27773,3575878843,3575878857,14
0,973,27774,3575878843,3575878857,14
0,973,27775,3575878843,3575878857,14
0,973,27776,3575878843,3575878859,16
0,973,27777,3575878843,3575878859,16
0,973,27778,3575878843,3575878861,18
0,973,27779,3575878843,3575878861,18
0,973,27780,3575878843,3575878862,19
0,973,27781,3575878843,3575878862,19
0,973,27782,3575878843,3575878863,20
0,973,27783,3575878843,3575878863,20
0,973,27784,3575878843,3575878864,21
0,973,27785,3575878843,3575878865,22
0,973,27786,3575878843,3575878866,23
0,973,27787,3575878843,3575878866,23
0,973,27788,3575878843,3575878867,24
0,973,27789,3575878843,3575878868,25
0,973,27790,3575878843,3575878869,26
0,973,27791,3575878843,3575878873,30
0,973,27792,3575878843,3575878873,30
0,973,27793,3575878843,3575878875,32
0,973,27794,3575878843,3575878878,35
0,973,27795,3575878843,3575878878,35
0,973,27796,3575878843,3575878878,35
0,973,27797,3575878843,3575878880,37
0,973,27798,3575878843,3575878882,39
0,973,27799,3575878843,3575878883,40
0,973,27800,3575878843,3575878884,41
0,973,27801,3575878843,3575878884,41
0,973,27802,3575878843,3575878885,42
0,973,27803,3575878843,3575878887,44
0,973,27804,3575878843,3575878887,44
0,973,27805,3575878843,3575878888,45
0,973,27806,3575878843,3575878891,48
0,973,27807,3575878843,3575878891,48
0,973,27808,3575878843,3575878892,49
0,973,27809,3575878843,3575878893,50
0,974,27810,3575878904,3575878904,0
0,974,27811,3575878904,3575878904,0
0,974,27812,3575878904,3575878904,0
0,974,27813,3575878904,3575878904,0
0,974,27814,3575878904,3575878904,0
0,974,27815,3575878904,3575878904,0
0,974,27816,3575878904,3575878904,0
0,974,27817,3575878904,3575878904,0
0,974,27818,3575878904,3575878904,0
0,974,27819,3575878904,3575878904,0
0,974,27820,3575878904,3575878904,0
0,974,27821,3575878904,3575878904,0
0,974,27822,3575878904,3575878904,0
0,974,27823,3575878904,3575878904,0
0,974,27824,3575878904,3575878904,0
0,974,27825,3575878904,3575878904,0
0,974,27826,3575878904,3575878904,0
0,974,27827,3575878904,3575878904,0
0,974,27828,3575878904,3575878904,0
0,974,27829,3575878904,3575878905,1
0,974,27830,3575878904,3575878906,2
0,974,27831,3575878904,3575878906,2
0,974,27832,3575878904,3575878906,2
0,974,27833,3575878904,3575878907,3
0,974,27834,3575878904,3575878907,3
0,974,27835,3575878904,3575878908,4
0,974,27836,3575878904,3575878910,6
0,974,27837,3575878904,3575878910,6
0,974,27838,3575878904,3575878912,8
0,974,27839,3575878904,3575878913,9
0,974,27840,3575878904,3575878913,9
0,974,27841,3575878904,3575878914,10
0,974,27842,3575878904,3575878914,10
0,974,27843,3575878904,3575878914,10
0,974,27844,3575878904,3575878915,11
0,974,27845,3575878904,3575878916,12
0,974,27846,3575878904,3575878916,12
0,974,27847,3575878904,3575878916,12
0,974,27848,3575878904,3575878920,16
0,974,27849,3575878904,3575878922,18
0,974,27850,3575878904,3575878922,18
0,974,27851,3575878904,3575878923,19
0,974,27852,3575878904,3575878923,19
0,974,27853,3575878904,3575878923,19
0,974,27854,3575878904,3575878924,20
0,974,27855,3575878904,3575878924,20
0,974,27856,3575878904,3575878925,21
0,974,27857,3575878904,3575878926,22
0,974,27858,3575878904,3575878926,22
0,974,27859,3575878904,3575878927,23
0,974,27860,3575878904,3575878927,23
0,974,27861,3575878904,3575878928,24
0,974,27862,3575878904,3575878929,25
0,974,27863,3575878904,3575878929,25
0,974,27864,3575878904,3575878930,26
0,974,27865,3575878904,3575878933,29
0,974,27866,3575878904,3575878934,30
0,974,27867,3575878904,3575878934,30
0,974,27868,3575878904,3575878936,32
0,974,27869,3575878904,3575878936,32
0,974,27870,3575878904,3575878937,33
0,974,27871,3575878904,3575878938,34
0,974,27872,3575878904,3575878939,35
0,974,27873,3575878904,3575878940,36
0,974,27874,3575878904,3575878940,36
0,974,27875,3575878904,3575878940,36
0,974,27876,3575878904,3575878940,36
0,974,27877,3575878904,3575878941,37
0,974,27878,3575878904,3575878942,38
0,974,27879,3575878904,3575878942,38
0,974,27880,3575878904,3575878943,39
0,974,27881,3575878904,3575878944,40
0,974,27882,3575878904,3575878944,40
0,974,27883,3575878904,3575878945,41
0,974,27884,3575878904,3575878945,41
0,974,27885,3575878904,3575878946,42
0,974,27886,3575878904,3575878946,42
0,974,27887,3575878904,3575878947,43
0,974,27888,3575878904,3575878948,44
0,974,27889,3575878904,3575878949,45
0,974,27890,3575878904,3575878949,45
0,974,27891,3575878904,3575878953,49
0,974,27892,3575878904,3575878953,49
0,974,27893,3575878904,3575878953,49
0,974,27894,3575878904,3575878953,49
0,974,27895,3575878904,3575878954,50
0,975,27896,3575878964,3575878964,0
0,975,27897,3575878964,3575878964,0
0,975,27898,3575878964,3575878964,0
0,975,27899,3575878964,3575878964,0
0,975,27900,3575878964,3575878964,0
0,975,27901,3575878964,3575878964,0
0,975,27902,3575878964,3575878964,0
0,975,27903,3575878964,3575878964,0
0,975,27904,3575878964,3575878964,0
0,975,27905,3575878964,3575878964,0
0,975,27906,3575878964,3575878964,0
0,975,27907,3575878964,3575878964,0
0,975,27908,3575878964,3575878964,0
0,975,27909,3575878964,3575878964,0
0,975,27910,3575878964,3575878964,0
0,975,27911,3575878964,3575878965,1
0,975,27912,3575878964,3575878965,1
0,975,27913,3575878964,3575878966,2
0,975,27914,3575878964,3575878966,2
0,975,27915,3575878964,3575878966,2
0,975,27916,3575878964,3575878966,2
0,975,27917,3575878964,3575878966,2
0,975,27918,3575878964,3575878969,5
0,975,27919,3575878964,3575878971,7
0,975,27920,3575878964,3575878971,7
0,975,27921,3575878964,3575878972,8
0,975,27922,3575878964,3575878972,8
0,975,27923,3575878964,3575878975,11
0,975,27924,3575878964,3575878976,12
0,975,27925,3575878964,3575878977,13
0,975,27926,3575878964,3575878977,13
0,975,27927,3575878964,3575878977,13
0,975,27928,3575878964,3575878978,14
0,975,27929,3575878964,3575878979,15
0,975,27930,3575878964,3575878979,15
0,975,27931,3575878964,3575878980,16
0,975,27932,3575878964,3575878980,16
0,975,27933,3575878964,3575878983,19
0,975,27934,3575878964,3575878984,20
0,975,27935,3575878964,3575878985,21
0,975,27936,3575878964,3575878988,24
0,975,27937,3575878964,3575878988,24
0,975,27938,3575878964,3575878989,25
0,975,27939,3575878964,3575878991,27
0,975,27940,3575878964,3575878994,30
0,975,27941,3575878964,3575878997,33
0,975,27942,3575878964,3575878999,35
0,975,27943,3575878964,3575879000,36
0,975,27944,3575878964,3575879001,37
0,975,27945,3575878964,3575879006,42
0,975,27946,3575878964,3575879007,43
0,975,27947,3575878964,3575879008,44
0,975,27948,3575878964,3575879008,44
0,975,27949,3575878964,3575879010,46
0,975,27950,3575878964,3575879010,46
0,975,27951,3575878964,3575879013,49
0,975,27952,3575878964,3575879013,49
0,975,27953,3575878964,3575879013,49
0,975,27954,3575878964,3575879014,50
0,976,27955,3575879026,3575879026,0
0,976,27956,3575879026,3575879026,0
0,976,27957,3575879026,3575879026,0
0,976,27958,3575879026,3575879026,0
0,976,27959,3575879026,3575879026,0
0,976,27960,3575879026,3575879026,0
0,976,27961,3575879026,3575879026,0
0,976,27962,3575879026,3575879026,0
0,976,27963,3575879026,3575879026,0
0,976,27964,3575879026,3575879026,0
0,976,27965,3575879026,3575879026,0
0,976,27966,3575879026,3575879026,0
0,976,27967,3575879026,3575879026,0
0,976,27968,3575879026,3575879026,0
0,976,27969,3575879026,3575879028,2
0,976,27970,3575879026,3575879028,2
0,976,27971,3575879026,3575879028,2
0,976,27972,3575879026,3575879029,3
0,976,27973,3575879026,3575879029,3
0,976,27974,3575879026,3575879032,6
0,976,27975,3575879026,3575879032,6
0,976,27976,3575879026,3575879032,6
0,976,27977,3575879026,3575879035,9
0,976,27978,3575879026,3575879036,10
0,976,27979,3575879026,3575879036,10
0,976,27980,3575879026,3575879036,10
0,976,27981,3575879026,3575879039,13
0,976,27982,3575879026,3575879040,14
0,976,27983,3575879026,3575879040,14
0,976,27984,3575879026,3575879040,14
0,976,27985,3575879026,3575879042,16
0,976,27986,3575879026,3575879043,17
0,976,27987,3575879026,3575879045,19
0,976,27988,3575879026,3575879047,21
0,976,27989,3575879026,3575879047,21
0,976,27990,3575879026,3575879048,22
0,976,27991,3575879026,3575879049,23
0,976,27992,3575879026,3575879050,24
0,976,27993,3575879026,3575879050,24
0,976,27994,3575879026,3575879051,25
0,976,27995,3575879026,3575879052,26
0,976,27996,3575879026,3575879052,26
0,976,27997,3575879026,3575879053,27
0,976,27998,3575879026,3575879054,28
0,976,27999,3575879026,3575879056,30
0,976,28000,3575879026,3575879056,30
0,976,28001,3575879026,3575879057,31
0,976,28002,3575879026,3575879057,31
0,976,28003,3575879026,3575879059,33
0,976,28004,3575879026,3575879060,34
0,976,28005,3575879026,3575879061,35
0,976,28006,3575879026,3575879062,36
0,976,28007,3575879026,3575879062,36
0,976,28008,3575879026,3575879064,38
0,976,28009,3575879026,3575879065,39
0,976,28010,3575879026,3575879065,39
0,976,28011,3575879026,3575879066,40
0,976,28012,3575879026,3575879066,40
0,976,28013,3575879026,3575879067,41
0,976,28014,3575879026,3575879068,42
0,976,28015,3575879026,3575879069,43
0,976,28016,3575879026,3575879071,45
0,976,28017,3575879026,3575879072,46
0,976,28018,3575879026,3575879072,46
0,976,28019,3575879026,3575879075,49
0,977,28020,3575879090,3575879090,0
0,977,28021,3575879090,3575879090,0
0,977,28022,3575879090,3575879090,0
0,977,28023,3575879090,3575879090,0
0,977,28024,3575879090,3575879090,0
0,977,28025,3575879090,3575879090,0
0,977,28026,3575879090,3575879090,0
0,977,28027,3575879090,3575879090,0
0,977,28028,3575879090,3575879090,0
0,977,28029,3575879090,3575879090,0
0,977,28030,3575879090,3575879090,0
0,977,28031,3575879090,3575879090,0
0,977,28032,3575879090,3575879091,1
0,977,28033,3575879090,3575879091,1
0,977,28034,3575879090,3575879093,3
0,977,28035,3575879090,3575879093,3
0,977,28036,3575879090,3575879093,3
0,977,28037,3575879090,3575879093,3
0,977,28038,3575879090,3575879094,4
0,977,28039,3575879090,3575879095,5
0,977,28040,3575879090,3575879095,5
0,977,28041,3575879090,3575879095,5
0,977,28042,3575879090,3575879095,5
0,977,28043,3575879090,3575879095,5
0,977,28044,3575879090,3575879096,6
0,977,28045,3575879090,3575879097,7
0,977,28046,3575879090,3575879097,7
0,977,28047,3575879090,3575879099,9
0,977,28048,3575879090,3575879100,10
0,977,28049,3575879090,3575879100,10
0,977,28050,3575879090,3575879100,10
0,977,28051,3575879090,3575879101,11
0,977,28052,3575879090,3575879101,11
0,977,28053,3575879090,3575879101,11
0,977,28054,3575879090,3575879102,12
0,977,28055,3575879090,3575879102,12
0,977,28056,3575879090,3575879103,13
0,977,28057,3575879090,3575879105,15
0,977,28058,3575879090,3575879106,16
0,977,28059,3575879090,3575879106,16
0,977,28060,3575879090,3575879107,17
0,977,28061,3575879090,3575879107,17
0,977,28062,3575879090,3575879108,18
0,977,28063,3575879090,3575879109,19
0,977,28064,3575879090,3575879110,20
0,977,28065,3575879090,3575879110,20
0,977,28066,3575879090,3575879111,21
0,977,28067,3575879090,3575879112,22
0,977,28068,3575879090,3575879113,23
0,977,28069,3575879090,3575879114,24
0,977,28070,3575879090,3575879114,24
0,977,28071,3575879090,3575879115,25
0,977,28072,3575879090,3575879115,25
0,977,28073,3575879090,3575879115,25
0,977,28074,3575879090,3575879116,26
0,977,28075,3575879090,3575879117,27
0,977,28076,3575879090,3575879119,29
0,977,28077,3575879090,3575879119,29
0,977,28078,3575879090,3575879122,32
0,977,28079,3575879090,3575879122,32
0,977,28080,3575879090,3575879122,32
0,977,28081,3575879090,3575879123,33
0,977,28082,3575879090,3575879123,33
0,977,28083,3575879090,3575879124,34
0,977,28084,3575879090,3575879124,34
0,977,28085,3575879090,3575879125,35
0,977,28086,3575879090,3575879126,36
0,977,28087,3575879090,3575879126,36
0,977,28088,3575879090,3575879127,37
0,977,28089,3575879090,3575879127,37
0,977,28090,3575879090,3575879129,39
0,977,28091,3575879090,3575879129,39
0,977,28092,3575879090,3575879130,40
0,977,28093,3575879090,3575879130,40
0,977,28094,3575879090,3575879133,43
0,977,28095,3575879090,3575879134,44
0,977,28096,3575879090,3575879134,44
0,977,28097,3575879090,3575879136,46
0,977,28098,3575879090,3575879136,46
0,977,28099,3575879090,3575879137,47
0,977,28100,3575879090,3575879138,48
0,977,28101,3575879090,3575879139,49
0,977,28102,3575879090,3575879140,50
0,978,28103,3575879154,3575879154,0
0,978,28104,3575879154,3575879154,0
0,978,28105,3575879154,3575879154,0
0,978,28106,3575879154,3575879154,0
0,978,28107,3575879154,3575879154,0
0,978,28108,3575879154,3575879154,0
0,978,28109,3575879154,3575879154,0
0,978,28110,3575879154,3575879154,0
0,978,28111,3575879154,3575879154,0
0,978,28112,3575879154,3575879154,0
0,978,28113,3575879154,3575879154,0
0,978,28114,3575879154,3575879154,0
0,978,28115,3575879154,3575879154,0
0,978,28116,3575879154,3575879154,0
0,978,28117,3575879154,3575879154,0
0,978,28118,3575879154,3575879154,0
0,978,28119,3575879154,3575879154,0
0,978,28120,3575879154,3575879154,0
0,978,28121,3575879154,3575879154,0
0,978,28122,3575879154,3575879154,0
0,978,28123,3575879154,3575879154,0
0,978,28124,3575879154,3575879154,0
0,978,28125,3575879154,3575879156,2
0,978,28126,3575879154,3575879157,3
0,978,28127,3575879154,3575879158,4
0,978,28128,3575879154,3575879158,4
0,978,28129,3575879154,3575879159,5
0,978,28130,3575879154,3575879159,5
0,978,28131,3575879154,3575879160,6
0,978,28132,3575879154,3575879160,6
0,978,28133,3575879154,3575879161,7
0,978,28134,3575879154,3575879161,7
0,978,28135,3575879154,3575879162,8
0,978,28136,3575879154,3575879164,10
0,978,28137,3575879154,3575879164,10
0,978,28138,3575879154,3575879165,11
0,978,28139,3575879154,3575879165,11
0,978,28140,3575879154,3575879166,12
0,978,28141,3575879154,3575879166,12
0,978,28142,3575879154,3575879166,12
0,978,28143,3575879154,3575879166,12
0,978,28144,3575879154,3575879167,13
0,978,28145,3575879154,3575879169,15
0,978,28146,3575879154,3575879171,17
0,978,28147,3575879154,3575879171,17
0,978,28148,3575879154,3575879173,19
0,978,28149,3575879154,3575879173,19
0,978,28150,3575879154,3575879174,20
0,978,28151,3575879154,3575879174,20
0,978,28152,3575879154,3575879176,22
0,978,28153,3575879154,3575879177,23
0,978,28154,3575879154,3575879178,24
0,978,28155,3575879154,3575879178,24
0,978,28156,3575879154,3575879179,25
0,978,28157,3575879154,3575879179,25
0,978,28158,3575879154,3575879179,25
0,978,28159,3575879154,3575879180,26
0,978,28160,3575879154,3575879180,26
0,978,28161,3575879154,3575879183,29
0,978,28162,3575879154,3575879184,30
0,978,28163,3575879154,3575879185,31
0,978,28164,3575879154,3575879189,35
0,978,28165,3575879154,3575879189,35
0,978,28166,3575879154,3575879189,35
0,978,28167,3575879154,3575879192,38
0,978,28168,3575879154,3575879194,40
0,978,28169,3575879154,3575879195,41
0,978,28170,3575879154,3575879197,43
0,978,28171,3575879154,3575879199,45
0,978,28172,3575879154,3575879200,46
0,978,28173,3575879154,3575879201,47
0,979,28174,3575879217,3575879217,0
0,979,28175,3575879217,3575879217,0
0,979,28176,3575879217,3575879217,0
0,979,28177,3575879217,3575879217,0
0,979,28178,3575879217,3575879217,0
0,979,28179,3575879217,3575879217,0
0,979,28180,3575879217,3575879217,0
0,979,28181,3575879217,3575879217,0
0,979,28182,3575879217,3575879217,0
0,979,28183,3575879217,3575879217,0
0,979,28184,3575879217,3575879217,0
0,979,28185,3575879217,3575879217,0
0,979,28186,3575879217,3575879217,0
0,979,28187,3575879217,3575879217,0
0,979,28188,3575879217,3575879218,1
0,979,28189,3575879217,3575879218,1
0,979,28190,3575879217,3575879219,2
0,979,28191,3575879217,3575879219,2
0,979,28192,3575879217,3575879220,3
0,979,28193,3575879217,3575879220,3
0,979,28194,3575879217,3575879222,5
0,979,28195,3575879217,3575879224,7
0,979,28196,3575879217,3575879226,9
0,979,28197,3575879217,3575879227,10
0,979,28198,3575879217,3575879229,12
0,979,28199,3575879217,3575879229,12
0,979,28200,3575879217,3575879229,12
0,979,28201,3575879217,3575879229,12
0,979,28202,3575879217,3575879230,13
0,979,28203,3575879217,3575879230,13
0,979,28204,3575879217,3575879232,15
0,979,28205,3575879217,3575879232,15
0,979,28206,3575879217,3575879234,17
0,979,28207,3575879217,3575879235,18
0,979,28208,3575879217,3575879235,18
0,979,28209,3575879217,3575879236,19
0,979,28210,3575879217,3575879239,22
0,979,28211,3575879217,3575879240,23
0,979,28212,3575879217,3575879240,23
0,979,28213,3575879217,3575879240,23
0,979,28214,3575879217,3575879242,25
0,979,28215,3575879217,3575879242,25
0,979,28216,3575879217,3575879245,28
0,979,28217,3575879217,3575879247,30
0,979,28218,3575879217,3575879248,31
0,979,28219,3575879217,3575879249,32
0,979,28220,3575879217,3575879250,33
0,979,28221,3575879217,3575879250,33
0,979,28222,3575879217,3575879251,34
0,979,28223,3575879217,3575879252,35
0,979,28224,3575879217,3575879254,37
0,979,28225,3575879217,3575879255,38
0,979,28226,3575879217,3575879256,39
0,979,28227,3575879217,3575879257,40
0,979,28228,3575879217,3575879257,40
0,979,28229,3575879217,3575879258,41
0,979,28230,3575879217,3575879260,43
0,979,28231,3575879217,3575879260,43
0,979,28232,3575879217,3575879260,43
0,979,28233,3575879217,3575879262,45
0,979,28234,3575879217,3575879263,46
0,979,28235,3575879217,3575879264,47
0,979,28236,3575879217,3575879265,48
0,979,28237,3575879217,3575879266,49
0,979,28238,3575879217,3575879266,49
0,979,28239,3575879217,3575879266,49
0,979,28240,3575879217,3575879267,50
0,980,28241,3575879277,3575879277,0
0,980,28242,3575879277,3575879277,0
0,980,28243,3575879277,3575879277,0
0,980,28244,3575879277,3575879277,0
0,980,28245,3575879277,3575879277,0
0,980,28246,3575879277,3575879277,0
0,980,28247,3575879277,3575879279,2
0,980,28248,3575879277,3575879281,4
0,980,28249,3575879277,3575879281,4
0,980,28250,3575879277,3575879282,5
0,980,28251,3575879277,3575879283,6
0,980,28252,3575879277,3575879284,7
0,980,28253,3575879277,3575879284,7
0,980,28254,3575879277,3575879286,9
0,980,28255,3575879277,3575879287,10
0,980,28256,3575879277,3575879287,10
0,980,28257,3575879277,3575879288,11
0,980,28258,3575879277,3575879288,11
0,980,28259,3575879277,3575879290,13
0,980,28260,3575879277,3575879291,14
0,980,28261,3575879277,3575879291,14
0,980,28262,3575879277,3575879292,15
0,980,28263,3575879277,3575879292,15
0,980,28264,3575879277,3575879293,16
0,980,28265,3575879277,3575879293,16
0,980,28266,3575879277,3575879294,17
0,980,28267,3575879277,3575879294,17
0,980,28268,3575879277,3575879295,18
0,980,28269,3575879277,3575879295,18
0,980,28270,3575879277,3575879295,18
0,980,28271,3575879277,3575879296,19
0,980,28272,3575879277,3575879297,20
0,980,28273,3575879277,3575879297,20
0,980,28274,3575879277,3575879297,20
0,980,28275,3575879277,3575879299,22
0,980,28276,3575879277,3575879299,22
0,980,28277,3575879277,3575879299,22
0,980,28278,3575879277,3575879299,22
0,980,28279,3575879277,3575879301,24
0,980,28280,3575879277,3575879301,24
0,980,28281,3575879277,3575879302,25
0,980,28282,3575879277,3575879302,25
0,980,28283,3575879277,3575879302,25
0,980,28284,3575879277,3575879303,26
0,980,28285,3575879277,3575879303,26
0,980,28286,3575879277,3575879305,28
0,980,28287,3575879277,3575879306,29
0,980,28288,3575879277,3575879307,30
0,980,28289,3575879277,3575879307,30
0,980,28290,3575879277,3575879307,30
0,980,28291,3575879277,3575879307,30
0,980,28292,3575879277,3575879308,31
0,980,28293,3575879277,3575879309,32
0,980,28294,3575879277,3575879309,32
0,980,28295,3575879277,3575879310,33
0,980,28296,3575879277,3575879312,35
0,980,28297,3575879277,3575879313,36
0,980,28298,3575879277,3575879313,36
0,980,28299,3575879277,3575879314,37
0,980,28300,3575879277,3575879314,37
0,980,28301,3575879277,3575879314,37
0,980,28302,3575879277,3575879315,38
0,980,28303,3575879277,3575879316,39
0,980,28304,3575879277,3575879316,39
0,980,28305,3575879277,3575879317,40
0,980,28306,3575879277,3575879319,42
0,980,28307,3575879277,3575879319,42
0,980,28308,3575879277,3575879321,44
0,980,28309,3575879277,3575879321,44
0,980,28310,3575879277,3575879322,45
0,980,28311,3575879277,3575879323,46
0,980,28312,3575879277,3575879324,47
0,980,28313,3575879277,3575879324,47
0,980,28314,3575879277,3575879325,48
0,980,28315,3575879277,3575879325,48
0,980,28316,3575879277,3575879326,49
0,980,28317,3575879277,3575879326,49
0,980,28318,3575879277,3575879327,50
0,981,28319,3575879341,3575879341,0
0,981,28320,3575879341,3575879341,0
0,981,28321,3575879341,3575879341,0
0,981,28322,3575879341,3575879342,1
0,981,28323,3575879341,3575879342,1
0,981,28324,3575879341,3575879342,1
0,981,28325,3575879341,3575879342,1
0,981,28326,3575879341,3575879342,1
0,981,28327,3575879341,3575879342,1
0,981,28328,3575879341,3575879342,1
0,981,28329,3575879341,3575879342,1
0,981,28330,3575879341,3575879342,1
0,981,28331,3575879341,3575879342,1
0,981,28332,3575879341,3575879342,1
0,981,28333,3575879341,3575879342,1
0,981,28334,3575879341,3575879342,1
0,981,28335,3575879341,3575879342,1
0,981,28336,3575879341,3575879342,1
0,981,28337,3575879341,3575879342,1
0,981,28338,3575879341,3575879342,1
0,981,28339,3575879341,3575879342,1
0,981,28340,3575879341,3575879342,1
0,981,28341,3575879341,3575879342,1
0,981,28342,3575879341,3575879342,1
0,981,28343,3575879341,3575879343,2
0,981,28344,3575879341,3575879343,2
0,981,28345,3575879341,3575879344,3
0,981,28346,3575879341,3575879345,4
0,981,28347,3575879341,3575879346,5
0,981,28348,3575879341,3575879346,5
0,981,28349,3575879341,3575879346,5
0,981,28350,3575879341,3575879347,6
0,981,28351,3575879341,3575879348,7
0,981,28352,3575879341,3575879348,7
0,981,28353,3575879341,3575879350,9
0,981,28354,3575879341,3575879353,12
0,981,28355,3575879341,3575879353,12
0,981,28356,3575879341,3575879353,12
0,981,28357,3575879341,3575879353,12
0,981,28358,3575879341,3575879354,13
0,981,28359,3575879341,3575879356,15
0,981,28360,3575879341,3575879357,16
0,981,28361,3575879341,3575879358,17
0,981,28362,3575879341,3575879358,17
0,981,28363,3575879341,3575879359,18
0,981,28364,3575879341,3575879359,18
0,981,28365,3575879341,3575879360,19
0,981,28366,3575879341,3575879360,19
0,981,28367,3575879341,3575879360,19
0,981,28368,3575879341,3575879361,20
0,981,28369,3575879341,3575879361,20
0,981,28370,3575879341,3575879362,21
0,981,28371,3575879341,3575879364,23
0,981,28372,3575879341,3575879364,23
0,981,28373,3575879341,3575879365,24
0,981,28374,3575879341,3575879365,24
0,981,28375,3575879341,3575879366,25
0,981,28376,3575879341,3575879366,25
0,981,28377,3575879341,3575879366,25
0,981,28378,3575879341,3575879367,26
0,981,28379,3575879341,3575879367,26
0,981,28380,3575879341,3575879369,28
0,981,28381,3575879341,3575879371,30
0,981,28382,3575879341,3575879372,31
0,981,28383,3575879341,3575879372,31
0,981,28384,3575879341,3575879373,32
0,981,28385,3575879341,3575879374,33
0,981,28386,3575879341,3575879377,36
0,981,28387,3575879341,3575879377,36
0,981,28388,3575879341,3575879378,37
0,981,28389,3575879341,3575879379,38
0,981,28390,3575879341,3575879379,38
0,981,28391,3575879341,3575879380,39
0,981,28392,3575879341,3575879381,40
0,981,28393,3575879341,3575879382,41
0,981,28394,3575879341,3575879383,42
0,981,28395,3575879341,3575879384,43
0,981,28396,3575879341,3575879385,44
0,981,28397,3575879341,3575879387,46
0,981,28398,3575879341,3575879389,48
0,981,28399,3575879341,3575879390,49
0,981,28400,3575879341,3575879390,49
0,981,28401,3575879341,3575879390,49
0,982,28402,3575879402,3575879402,0
0,982,28403,3575879402,3575879402,0
0,982,28404,3575879402,3575879402,0
0,982,28405,3575879402,3575879402,0
0,982,28406,3575879402,3575879402,0
0,982,28407,3575879402,3575879402,0
0,982,28408,3575879402,3575879402,0
0,982,28409,3575879402,3575879402,0
0,982,28410,3575879402,3575879404,2
0,982,28411,3575879402,3575879407,5
0,982,28412,3575879402,3575879407,5
0,982,28413,3575879402,3575879408,6
0,982,28414,3575879402,3575879408,6
0,982,28415,3575879402,3575879410,8
0,982,28416,3575879402,3575879411,9
0,982,28417,3575879402,3575879413,11
0,982,28418,3575879402,3575879414,12
0,982,28419,3575879402,3575879415,13
0,982,28420,3575879402,3575879415,13
0,982,28421,3575879402,3575879416,14
0,982,28422,3575879402,3575879416,14
0,982,28423,3575879402,3575879416,14
0,982,28424,3575879402,3575879418,16
0,982,28425,3575879402,3575879418,16
0,982,28426,3575879402,3575879419,17
0,982,28427,3575879402,3575879419,17
0,982,28428,3575879402,3575879420,18
0,982,28429,3575879402,3575879421,19
0,982,28430,3575879402,3575879422,20
0,982,28431,3575879402,3575879424,22
0,982,28432,3575879402,3575879427,25
0,982,28433,3575879402,3575879427,25
0,982,28434,3575879402,3575879428,26
0,982,28435,3575879402,3575879429,27
0,982,28436,3575879402,3575879429,27
0,982,28437,3575879402,3575879429,27
0,982,28438,3575879402,3575879429,27
0,982,28439,3575879402,3575879430,28
0,982,28440,3575879402,3575879432,30
0,982,28441,3575879402,3575879432,30
0,982,28442,3575879402,3575879433,31
0,982,28443,3575879402,3575879434,32
0,982,28444,3575879402,3575879435,33
0,982,28445,3575879402,3575879436,34
0,982,28446,3575879402,3575879436,34
0,982,28447,3575879402,3575879437,35
0,982,28448,3575879402,3575879440,38
0,982,28449,3575879402,3575879440,38
0,982,28450,3575879402,3575879440,38
0,982,28451,3575879402,3575879441,39
0,982,28452,3575879402,3575879442,40
0,982,28453,3575879402,3575879443,41
0,982,28454,3575879402,3575879445,43
0,982,28455,3575879402,3575879447,45
0,982,28456,3575879402,3575879448,46
0,982,28457,3575879402,3575879449,47
0,982,28458,3575879402,3575879449,47
0,982,28459,3575879402,3575879450,48
0,982,28460,3575879402,3575879450,48
0,982,28461,3575879402,3575879451,49
0,983,28462,3575879465,3575879465,0
0,983,28463,3575879465,3575879466,1
0,983,28464,3575879465,3575879466,1
0,983,28465,3575879465,3575879466,1
0,983,28466,3575879465,3575879466,1
0,983,28467,3575879465,3575879466,1
0,983,28468,3575879465,3575879466,1
0,983,28469,3575879465,3575879466,1
0,983,28470,3575879465,3575879466,1
0,983,28471,3575879465,3575879466,1
0,983,28472,3575879465,3575879466,1
0,983,28473,3575879465,3575879466,1
0,983,28474,3575879465,3575879466,1
0,983,28475,3575879465,3575879466,1
0,983,28476,3575879465,3575879466,1
0,983,28477,3575879465,3575879466,1
0,983,28478,3575879465,3575879466,1
0,983,28479,3575879465,3575879467,2
0,983,28480,3575879465,3575879467,2
0,983,28481,3575879465,3575879468,3
0,983,28482,3575879465,3575879469,4
0,983,28483,3575879465,3575879472,7
0,983,28484,3575879465,3575879473,8
0,983,28485,3575879465,3575879476,11
0,983,28486,3575879465,3575879477,12
0,983,28487,3575879465,3575879479,14
0,983,28488,3575879465,3575879481,16
0,983,28489,3575879465,3575879481,16
0,983,28490,3575879465,3575879484,19
0,983,28491,3575879465,3575879484,19
0,983,28492,3575879465,3575879484,19
0,983,28493,3575879465,3575879484,19
0,983,28494,3575879465,3575879486,21
0,983,28495,3575879465,3575879487,22
0,983,28496,3575879465,3575879487,22
0,983,28497,3575879465,3575879489,24
0,983,28498,3575879465,3575879491,26
0,983,28499,3575879465,3575879492,27
0,983,28500,3575879465,3575879492,27
0,983,28501,3575879465,3575879492,27
0,983,28502,3575879465,3575879492,27
0,983,28503,3575879465,3575879494,29
0,983,28504,3575879465,3575879494,29
0,983,28505,3575879465,3575879495,30
0,983,28506,3575879465,3575879495,30
0,983,28507,3575879465,3575879495,30
0,983,28508,3575879465,3575879497,32
0,983,28509,3575879465,3575879497,32
0,983,28510,3575879465,3575879498,33
0,983,28511,3575879465,3575879499,34
0,983,28512,3575879465,3575879502,37
0,983,28513,3575879465,3575879502,37
0,983,28514,3575879465,3575879502,37
0,983,28515,3575879465,3575879502,37
0,983,28516,3575879465,3575879502,37
0,983,28517,3575879465,3575879502,37
0,983,28518,3575879465,3575879502,37
0,983,28519,3575879465,3575879503,38
0,983,28520,3575879465,3575879504,39
0,983,28521,3575879465,3575879505,40
0,983,28522,3575879465,3575879506,41
0,983,28523,3575879465,3575879507,42
0,983,28524,3575879465,3575879507,42
0,983,28525,3575879465,3575879507,42
0,983,28526,3575879465,3575879508,43
0,983,28527,3575879465,3575879508,43
0,983,28528,3575879465,3575879509,44
0,983,28529,3575879465,3575879509,44
0,983,28530,3575879465,3575879510,45
0,983,28531,3575879465,3575879511,46
0,983,28532,3575879465,3575879513,48
0,983,28533,3575879465,3575879513,48
0,983,28534,3575879465,3575879514,49
0,983,28535,3575879465,3575879514,49
0,983,28536,3575879465,3575879514,49
0,983,28537,3575879465,3575879515,50
0,984,28538,3575879526,3575879526,0
0,984,28539,3575879526,3575879526,0
0,984,28540,3575879526,3575879526,0
0,984,28541,3575879526,3575879526,0
0,984,28542,3575879526,3575879526,0
0,984,28543,3575879526,3575879526,0
0,984,28544,3575879526,3575879526,0
0,984,28545,3575879526,3575879526,0
0,984,28546,3575879526,3575879526,0
0,984,28547,3575879526,3575879526,0
0,984,28548,3575879526,3575879526,0
0,984,28549,3575879526,3575879526,0
0,984,28550,3575879526,3575879526,0
0,984,28551,3575879526,3575879526,0
0,984,28552,3575879526,3575879526,0
0,984,28553,3575879526,3575879526,0
0,984,28554,3575879526,3575879527,1
0,984,28555,3575879526,3575879527,1
0,984,28556,3575879526,3575879528,2
0,984,28557,3575879526,3575879529,3
0,984,28558,3575879526,3575879529,3
0,984,28559,3575879526,3575879530,4
0,984,28560,3575879526,3575879533,7
0,984,28561,3575879526,3575879534,8
0,984,28562,3575879526,3575879534,8
0,984,28563,3575879526,3575879535,9
0,984,28564,3575879526,3575879536,10
0,984,28565,3575879526,3575879537,11
0,984,28566,3575879526,3575879538,12
0,984,28567,3575879526,3575879538,12
0,984,28568,3575879526,3575879539,13
0,984,28569,3575879526,3575879539,13
0,984,28570,3575879526,3575879539,13
0,984,28571,3575879526,3575879541,15
0,984,28572,3575879526,3575879541,15
0,984,28573,3575879526,3575879541,15
0,984,28574,3575879526,3575879541,15
0,984,28575,3575879526,3575879542,16
0,984,28576,3575879526,3575879542,16
0,984,28577,3575879526,3575879542,16
0,984,28578,3575879526,3575879543,17
0,984,28579,3575879526,3575879543,17
0,984,28580,3575879526,3575879544,18
0,984,28581,3575879526,3575879545,19
0,984,28582,3575879526,3575879545,19
0,984,28583,3575879526,3575879546,20
0,984,28584,3575879526,3575879546,20
0,984,28585,3575879526,3575879548,22
0,984,28586,3575879526,3575879548,22
0,984,28587,3575879526,3575879548,22
0,984,28588,3575879526,3575879550,24
0,984,28589,3575879526,3575879551,25
0,984,28590,3575879526,3575879551,25
0,984,28591,3575879526,3575879552,26
0,984,28592,3575879526,3575879552,26
0,984,28593,3575879526,3575879554,28
0,984,28594,3575879526,3575879557,31
0,984,28595,3575879526,3575879557,31
0,984,28596,3575879526,3575879557,31
0,984,28597,3575879526,3575879558,32
0,984,28598,3575879526,3575879559,33
0,984,28599,3575879526,3575879559,33
0,984,28600,3575879526,3575879559,33
0,984,28601,3575879526,3575879560,34
0,984,28602,3575879526,3575879560,34
0,984,28603,3575879526,3575879561,35
0,984,28604,3575879526,3575879562,36
0,984,28605,3575879526,3575879563,37
0,984,28606,3575879526,3575879563,37
0,984,28607,3575879526,3575879564,38
0,984,28608,3575879526,3575879564,38
0,984,28609,3575879526,3575879565,39
0,984,28610,3575879526,3575879565,39
0,984,28611,3575879526,3575879565,39
0,984,28612,3575879526,3575879566,40
0,984,28613,3575879526,3575879569,43
0,984,28614,3575879526,3575879571,45
0,984,28615,3575879526,3575879571,45
0,984,28616,3575879526,3575879572,46
0,984,28617,3575879526,3575879574,48
0,985,28618,3575879588,3575879588,0
0,985,28619,3575879588,3575879588,0
0,985,28620,3575879588,3575879588,0
0,985,28621,3575879588,3575879588,0
0,985,28622,3575879588,3575879588,0
0,985,28623,3575879588,3575879588,0
0,985,28624,3575879588,3575879588,0
0,985,28625,3575879588,3575879588,0
0,985,28626,3575879588,3575879588,0
0,985,28627,3575879588,3575879589,1
0,985,28628,3575879588,3575879589,1
0,985,28629,3575879588,3575879590,2
0,985,28630,3575879588,3575879593,5
0,985,28631,3575879588,3575879593,5
0,985,28632,3575879588,3575879594,6
0,985,28633,3575879588,3575879598,10
0,985,28634,3575879588,3575879599,11
0,985,28635,3575879588,3575879600,12
0,985,28636,3575879588,3575879601,13
0,985,28637,3575879588,3575879603,15
0,985,28638,3575879588,3575879604,16
0,985,28639,3575879588,3575879607,19
0,985,28640,3575879588,3575879607,19
0,985,28641,3575879588,3575879607,19
0,985,28642,3575879588,3575879608,20
0,985,28643,3575879588,3575879609,21
0,985,28644,3575879588,3575879610,22
0,985,28645,3575879588,3575879613,25
0,985,28646,3575879588,3575879613,25
0,985,28647,3575879588,3575879614,26
0,985,28648,3575879588,3575879615,27
0,985,28649,3575879588,3575879615,27
0,985,28650,3575879588,3575879615,27
0,985,28651,3575879588,3575879616,28
0,985,28652,3575879588,3575879617,29
0,985,28653,3575879588,3575879618,30
0,985,28654,3575879588,3575879618,30
0,985,28655,3575879588,3575879619,31
0,985,28656,3575879588,3575879620,32
0,985,28657,3575879588,3575879621,33
0,985,28658,3575879588,3575879622,34
0,985,28659,3575879588,3575879626,38
0,985,28660,3575879588,3575879627,39
0,985,28661,3575879588,3575879627,39
0,985,28662,3575879588,3575879628,40
0,985,28663,3575879588,3575879629,41
0,985,28664,3575879588,3575879629,41
0,985,28665,3575879588,3575879631,43
0,985,28666,3575879588,3575879632,44
0,985,28667,3575879588,3575879632,44
0,985,28668,3575879588,3575879633,45
0,985,28669,3575879588,3575879634,46
0,985,28670,3575879588,3575879634,46
0,985,28671,3575879588,3575879635,47
0,985,28672,3575879588,3575879635,47
0,986,28673,3575879649,3575879649,0
0,986,28674,3575879649,3575879649,0
0,986,28675,3575879649,3575879649,0
0,986,28676,3575879649,3575879649,0
0,986,28677,3575879649,3575879649,0
0,986,28678,3575879649,3575879649,0
0,986,28679,3575879649,3575879649,0
0,986,28680,3575879649,3575879649,0
0,986,28681,3575879649,3575879649,0
0,986,28682,3575879649,3575879649,0
0,986,28683,3575879649,3575879649,0
0,986,28684,3575879649,3575879649,0
0,986,28685,3575879649,3575879649,0
0,986,28686,3575879649,3575879649,0
0,986,28687,3575879649,3575879650,1
0,986,28688,3575879649,3575879651,2
0,986,28689,3575879649,3575879653,4
0,986,28690,3575879649,3575879655,6
0,986,28691,3575879649,3575879655,6
0,986,28692,3575879649,3575879655,6
0,986,28693,3575879649,3575879656,7
0,986,28694,3575879649,3575879656,7
0,986,28695,3575879649,3575879656,7
0,986,28696,3575879649,3575879660,11
0,986,28697,3575879649,3575879661,12
0,986,28698,3575879649,3575879661,12
0,986,28699,3575879649,3575879661,12
0,986,28700,3575879649,3575879662,13
0,986,28701,3575879649,3575879662,13
0,986,28702,3575879649,3575879663,14
0,986,28703,3575879649,3575879664,15
0,986,28704,3575879649,3575879664,15
0,986,28705,3575879649,3575879665,16
0,986,28706,3575879649,3575879666,17
0,986,28707,3575879649,3575879666,17
0,986,28708,3575879649,3575879666,17
0,986,28709,3575879649,3575879667,18
0,986,28710,3575879649,3575879668,19
0,986,28711,3575879649,3575879668,19
0,986,28712,3575879649,3575879672,23
0,986,28713,3575879649,3575879673,24
0,986,28714,3575879649,3575879677,28
0,986,28715,3575879649,3575879679,30
0,986,28716,3575879649,3575879681,32
0,986,28717,3575879649,3575879681,32
0,986,28718,3575879649,3575879684,35
0,986,28719,3575879649,3575879684,35
0,986,28720,3575879649,3575879684,35
0,986,28721,3575879649,3575879685,36
0,986,28722,3575879649,3575879686,37
0,986,28723,3575879649,3575879687,38
0,986,28724,3575879649,3575879688,39
0,986,28725,3575879649,3575879689,40
0,986,28726,3575879649,3575879690,41
0,986,28727,3575879649,3575879692,43
0,986,28728,3575879649,3575879693,44
0,986,28729,3575879649,3575879693,44
0,986,28730,3575879649,3575879693,44
0,986,28731,3575879649,3575879694,45
0,986,28732,3575879649,3575879694,45
0,986,28733,3575879649,3575879694,45
0,986,28734,3575879649,3575879695,46
0,986,28735,3575879649,3575879696,47
0,986,28736,3575879649,3575879696,47
0,986,28737,3575879649,3575879697,48
0,986,28738,3575879649,3575879697,48
0,986,28739,3575879649,3575879698,49
0,987,28740,3575879711,3575879711,0
0,987,28741,3575879711,3575879711,0
0,987,28742,3575879711,3575879711,0
0,987,28743,3575879711,3575879711,0
0,987,28744,3575879711,3575879712,1
0,987,28745,3575879711,3575879712,1
0,987,28746,3575879711,3575879712,1
0,987,28747,3575879711,3575879712,1
0,987,28748,3575879711,3575879712,1
0,987,28749,3575879711,3575879712,1
0,987,28750,3575879711,3575879712,1
0,987,28751,3575879711,3575879712,1
0,987,28752,3575879711,3575879712,1
0,987,28753,3575879711,3575879712,1
0,987,28754,3575879711,3575879712,1
0,987,28755,3575879711,3575879712,1
0,987,28756,3575879711,3575879712,1
0,987,28757,3575879711,3575879712,1
0,987,28758,3575879711,3575879712,1
0,987,28759,3575879711,3575879712,1
0,987,28760,3575879711,3575879712,1
0,987,28761,3575879711,3575879712,1
0,987,28762,3575879711,3575879713,2
0,987,28763,3575879711,3575879714,3
0,987,28764,3575879711,3575879714,3
0,987,28765,3575879711,3575879714,3
0,987,28766,3575879711,3575879715,4
0,987,28767,3575879711,3575879715,4
0,987,28768,3575879711,3575879716,5
0,987,28769,3575879711,3575879716,5
0,987,28770,3575879711,3575879717,6
0,987,28771,3575879711,3575879719,8
0,987,28772,3575879711,3575879719,8
0,987,28773,3575879711,3575879720,9
0,987,28774,3575879711,3575879721,10
0,987,28775,3575879711,3575879722,11
0,987,28776,3575879711,3575879722,11
0,987,28777,3575879711,3575879723,12
0,987,28778,3575879711,3575879723,12
0,987,28779,3575879711,3575879724,13
0,987,28780,3575879711,3575879725,14
0,987,28781,3575879711,3575879725,14
0,987,28782,3575879711,3575879725,14
0,987,28783,3575879711,3575879727,16
0,987,28784,3575879711,3575879727,16
0,987,28785,3575879711,3575879727,16
0,987,28786,3575879711,3575879729,18
0,987,28787,3575879711,3575879729,18
0,987,28788,3575879711,3575879729,18
0,987,28789,3575879711,3575879729,18
0,987,28790,3575879711,3575879729,18
0,987,28791,3575879711,3575879732,21
0,987,28792,3575879711,3575879734,23
0,987,28793,3575879711,3575879734,23
0,987,28794,3575879711,3575879735,24
0,987,28795,3575879711,3575879736,25
0,987,28796,3575879711,3575879736,25
0,987,28797,3575879711,3575879738,27
0,987,28798,3575879711,3575879738,27
0,987,28799,3575879711,3575879739,28
0,987,28800,3575879711,3575879739,28
0,987,28801,3575879711,3575879739,28
0,987,28802,3575879711,3575879739,28
0,987,28803,3575879711,3575879740,29
0,987,28804,3575879711,3575879741,30
0,987,28805,3575879711,3575879741,30
0,987,28806,3575879711,3575879741,30
0,987,28807,3575879711,3575879741,30
0,987,28808,3575879711,3575879741,30
0,987,28809,3575879711,3575879741,30
0,987,28810,3575879711,3575879743,32
0,987,28811,3575879711,3575879744,33
0,987,28812,3575879711,3575879744,33
0,987,28813,3575879711,3575879745,34
0,987,28814,3575879711,3575879745,34
0,987,28815,3575879711,3575879745,34
0,987,28816,3575879711,3575879748,37
0,987,28817,3575879711,3575879749,38
0,987,28818,3575879711,3575879749,38
0,987,28819,3575879711,3575879751,40
0,987,28820,3575879711,3575879752,41
0,987,28821,3575879711,3575879752,41
0,987,28822,3575879711,3575879752,41
0,987,28823,3575879711,3575879753,42
0,987,28824,3575879711,3575879754,43
0,987,28825,3575879711,3575879755,44
0,987,28826,3575879711,3575879756,45
0,987,28827,3575879711,3575879756,45
0,987,28828,3575879711,3575879757,46
0,987,28829,3575879711,3575879758,47
0,987,28830,3575879711,3575879758,47
0,987,28831,3575879711,3575879759,48
0,987,28832,3575879711,3575879759,48
0,987,28833,3575879711,3575879759,48
0,987,28834,3575879711,3575879759,48
0,987,28835,3575879711,3575879760,49
0,988,28836,3575879776,3575879776,0
0,988,28837,3575879776,3575879776,0
0,988,28838,3575879776,3575879776,0
0,988,28839,3575879776,3575879776,0
0,988,28840,3575879776,3575879776,0
0,988,28841,3575879776,3575879776,0
0,988,28842,3575879776,3575879776,0
0,988,28843,3575879776,3575879776,0
0,988,28844,3575879776,3575879776,0
0,988,28845,3575879776,3575879776,0
0,988,28846,3575879776,3575879776,0
0,988,28847,3575879776,3575879776,0
0,988,28848,3575879776,3575879776,0
0,988,28849,3575879776,3575879776,0
0,988,28850,3575879776,3575879776,0
0,988,28851,3575879776,3575879777,1
0,988,28852,3575879776,3575879778,2
0,988,28853,3575879776,3575879778,2
0,988,28854,3575879776,3575879778,2
0,988,28855,3575879776,3575879780,4
0,988,28856,3575879776,3575879780,4
0,988,28857,3575879776,3575879783,7
0,988,28858,3575879776,3575879784,8
0,988,28859,3575879776,3575879787,11
0,988,28860,3575879776,3575879788,12
0,988,28861,3575879776,3575879789,13
0,988,28862,3575879776,3575879789,13
0,988,28863,3575879776,3575879790,14
0,988,28864,3575879776,3575879793,17
0,988,28865,3575879776,3575879794,18
0,988,28866,3575879776,3575879798,22
0,988,28867,3575879776,3575879799,23
0,988,28868,3575879776,3575879799,23
0,988,28869,3575879776,3575879801,25
0,988,28870,3575879776,3575879801,25
0,988,28871,3575879776,3575879801,25
0,988,28872,3575879776,3575879804,28
0,988,28873,3575879776,3575879806,30
0,988,28874,3575879776,3575879807,31
0,988,28875,3575879776,3575879807,31
0,988,28876,3575879776,3575879808,32
0,988,28877,3575879776,3575879808,32
0,988,28878,3575879776,3575879810,34
0,988,28879,3575879776,3575879812,36
0,988,28880,3575879776,3575879813,37
0,988,28881,3575879776,3575879814,38
0,988,28882,3575879776,3575879815,39
0,988,28883,3575879776,3575879815,39
0,988,28884,3575879776,3575879815,39
0,988,28885,3575879776,3575879817,41
0,988,28886,3575879776,3575879817,41
0,988,28887,3575879776,3575879818,42
0,988,28888,3575879776,3575879818,42
0,988,28889,3575879776,3575879819,43
0,988,28890,3575879776,3575879820,44
0,988,28891,3575879776,3575879821,45
0,988,28892,3575879776,3575879822,46
0,988,28893,3575879776,3575879826,50
0,989,28894,3575879838,3575879838,0
0,989,28895,3575879838,3575879838,0
0,989,28896,3575879838,3575879838,0
0,989,28897,3575879838,3575879838,0
0,989,28898,3575879838,3575879838,0
0,989,28899,3575879838,3575879838,0
0,989,28900,3575879838,3575879838,0
0,989,28901,3575879838,3575879838,0
0,989,28902,3575879838,3575879838,0
0,989,28903,3575879838,3575879838,0
0,989,28904,3575879838,3575879838,0
0,989,28905,3575879838,3575879838,0
0,989,28906,3575879838,3575879838,0
0,989,28907,3575879838,3575879838,0
0,989,28908,3575879838,3575879838,0
0,989,28909,3575879838,3575879838,0
0,989,28910,3575879838,3575879839,1
0,989,28911,3575879838,3575879840,2
0,989,28912,3575879838,3575879840,2
0,989,28913,3575879838,3575879842,4
0,989,28914,3575879838,3575879842,4
0,989,28915,3575879838,3575879843,5
0,989,28916,3575879838,3575879844,6
0,989,28917,3575879838,3575879846,8
0,989,28918,3575879838,3575879847,9
0,989,28919,3575879838,3575879848,10
0,989,28920,3575879838,3575879849,11
0,989,28921,3575879838,3575879850,12
0,989,28922,3575879838,3575879850,12
0,989,28923,3575879838,3575879850,12
0,989,28924,3575879838,3575879851,13
0,989,28925,3575879838,3575879853,15
0,989,28926,3575879838,3575879855,17
0,989,28927,3575879838,3575879855,17
0,989,28928,3575879838,3575879855,17
0,989,28929,3575879838,3575879856,18
0,989,28930,3575879838,3575879856,18
0,989,28931,3575879838,3575879856,18
0,989,28932,3575879838,3575879857,19
0,989,28933,3575879838,3575879861,23
0,989,28934,3575879838,3575879861,23
0,989,28935,3575879838,3575879861,23
0,989,28936,3575879838,3575879861,23
0,989,28937,3575879838,3575879862,24
0,989,28938,3575879838,3575879862,24
0,989,28939,3575879838,3575879862,24
0,989,28940,3575879838,3575879864,26
0,989,28941,3575879838,3575879864,26
0,989,28942,3575879838,3575879865,27
0,989,28943,3575879838,3575879865,27
0,989,28944,3575879838,3575879865,27
0,989,28945,3575879838,3575879866,28
0,989,28946,3575879838,3575879866,28
0,989,28947,3575879838,3575879868,30
0,989,28948,3575879838,3575879868,30
0,989,28949,3575879838,3575879872,34
0,989,28950,3575879838,3575879876,38
0,989,28951,3575879838,3575879877,39
0,989,28952,3575879838,3575879881,43
0,989,28953,3575879838,3575879884,46
0,989,28954,3575879838,3575879884,46
0,989,28955,3575879838,3575879884,46
0,989,28956,3575879838,3575879884,46
0,989,28957,3575879838,3575879885,47
0,989,28958,3575879838,3575879886,48
0,989,28959,3575879838,3575879887,49
0,989,28960,3575879838,3575879888,50
0,990,28961,3575879900,3575879900,0
0,990,28962,3575879900,3575879900,0
0,990,28963,3575879900,3575879900,0
0,990,28964,3575879900,3575879900,0
0,990,28965,3575879900,3575879900,0
0,990,28966,3575879900,3575879900,0
0,990,28967,3575879900,3575879900,0
0,990,28968,3575879900,3575879900,0
0,990,28969,3575879900,3575879900,0
0,990,28970,3575879900,3575879900,0
0,990,28971,3575879900,3575879900,0
0,990,28972,3575879900,3575879900,0
0,990,28973,3575879900,3575879900,0
0,990,28974,3575879900,3575879900,0
0,990,28975,3575879900,3575879900,0
0,990,28976,3575879900,3575879900,0
0,990,28977,3575879900,3575879900,0
0,990,28978,3575879900,3575879900,0
0,990,28979,3575879900,3575879901,1
0,990,28980,3575879900,3575879902,2
0,990,28981,3575879900,3575879903,3
0,990,28982,3575879900,3575879903,3
0,990,28983,3575879900,3575879903,3
0,990,28984,3575879900,3575879903,3
0,990,28985,3575879900,3575879904,4
0,990,28986,3575879900,3575879906,6
0,990,28987,3575879900,3575879906,6
0,990,28988,3575879900,3575879907,7
0,990,28989,3575879900,3575879907,7
0,990,28990,3575879900,3575879907,7
0,990,28991,3575879900,3575879908,8
0,990,28992,3575879900,3575879908,8
0,990,28993,3575879900,3575879909,9
0,990,28994,3575879900,3575879910,10
0,990,28995,3575879900,3575879910,10
0,990,28996,3575879900,3575879911,11
0,990,28997,3575879900,3575879912,12
0,990,28998,3575879900,3575879912,12
0,990,28999,3575879900,3575879913,13
0,990,29000,3575879900,3575879914,14
0,990,29001,3575879900,3575879914,14
0,990,29002,3575879900,3575879914,14
0,990,29003,3575879900,3575879915,15
0,990,29004,3575879900,3575879916,16
0,990,29005,3575879900,3575879916,16
0,990,29006,3575879900,3575879916,16
0,990,29007,3575879900,3575879919,19
0,990,29008,3575879900,3575879919,19
0,990,29009,3575879900,3575879920,20
0,990,29010,3575879900,3575879922,22
0,990,29011,3575879900,3575879922,22
0,990,29012,3575879900,3575879923,23
0,990,29013,3575879900,3575879923,23
0,990,29014,3575879900,3575879924,24
0,990,29015,3575879900,3575879925,25
0,990,29016,3575879900,3575879925,25
0,990,29017,3575879900,3575879925,25
0,990,29018,3575879900,3575879925,25
0,990,29019,3575879900,3575879927,27
0,990,29020,3575879900,3575879927,27
0,990,29021,3575879900,3575879928,28
0,990,29022,3575879900,3575879929,29
0,990,29023,3575879900,3575879929,29
0,990,29024,3575879900,3575879929,29
0,990,29025,3575879900,3575879930,30
0,990,29026,3575879900,3575879930,30
0,990,29027,3575879900,3575879932,32
0,990,29028,3575879900,3575879933,33
0,990,29029,3575879900,3575879934,34
0,990,29030,3575879900,3575879935,35
0,990,29031,3575879900,3575879936,36
0,990,29032,3575879900,3575879937,37
0,990,29033,3575879900,3575879938,38
0,990,29034,3575879900,3575879938,38
0,990,29035,3575879900,3575879938,38
0,990,29036,3575879900,3575879939,39
0,990,29037,3575879900,3575879940,40
0,990,29038,3575879900,3575879940,40
0,990,29039,3575879900,3575879941,41
0,990,29040,3575879900,3575879941,41
0,990,29041,3575879900,3575879941,41
0,990,29042,3575879900,3575879941,41
0,990,29043,3575879900,3575879942,42
0,990,29044,3575879900,3575879943,43
0,990,29045,3575879900,3575879943,43
0,990,29046,3575879900,3575879944,44
0,990,29047,3575879900,3575879944,44
0,990,29048,3575879900,3575879945,45
0,990,29049,3575879900,3575879946,46
0,990,29050,3575879900,3575879946,46
0,990,29051,3575879900,3575879948,48
0,990,29052,3575879900,3575879949,49
0,990,29053,3575879900,3575879949,49
0,991,29054,3575879962,3575879962,0
0,991,29055,3575879962,3575879962,0
0,991,29056,3575879962,3575879962,0
0,991,29057,3575879962,3575879962,0
0,991,29058,3575879962,3575879962,0
0,991,29059,3575879962,3575879962,0
0,991,29060,3575879962,3575879962,0
0,991,29061,3575879962,3575879962,0
0,991,29062,3575879962,3575879962,0
0,991,29063,3575879962,3575879962,0
0,991,29064,3575879962,3575879962,0
0,991,29065,3575879962,3575879962,0
0,991,29066,3575879962,3575879962,0
0,991,29067,3575879962,3575879962,0
0,991,29068,3575879962,3575879962,0
0,991,29069,3575879962,3575879962,0
0,991,29070,3575879962,3575879962,0
0,991,29071,3575879962,3575879962,0
0,991,29072,3575879962,3575879963,1
0,991,29073,3575879962,3575879963,1
0,991,29074,3575879962,3575879964,2
0,991,29075,3575879962,3575879964,2
0,991,29076,3575879962,3575879965,3
0,991,29077,3575879962,3575879965,3
0,991,29078,3575879962,3575879965,3
0,991,29079,3575879962,3575879966,4
0,991,29080,3575879962,3575879966,4
0,991,29081,3575879962,3575879970,8
0,991,29082,3575879962,3575879971,9
0,991,29083,3575879962,3575879972,10
0,991,29084,3575879962,3575879975,13
0,991,29085,3575879962,3575879976,14
0,991,29086,3575879962,3575879977,15
0,991,29087,3575879962,3575879978,16
0,991,29088,3575879962,3575879978,16
0,991,29089,3575879962,3575879978,16
0,991,29090,3575879962,3575879978,16
0,991,29091,3575879962,3575879979,17
0,991,29092,3575879962,3575879980,18
0,991,29093,3575879962,3575879983,21
0,991,29094,3575879962,3575879984,22
0,991,29095,3575879962,3575879987,25
0,991,29096,3575879962,3575879988,26
0,991,29097,3575879962,3575879989,27
0,991,29098,3575879962,3575879990,28
0,991,29099,3575879962,3575879993,31
0,991,29100,3575879962,3575879994,32
0,991,29101,3575879962,3575879994,32
0,991,29102,3575879962,3575879998,36
0,991,29103,3575879962,3575879998,36
0,991,29104,3575879962,3575879999,37
0,991,29105,3575879962,3575880000,38
0,991,29106,3575879962,3575880001,39
0,991,29107,3575879962,3575880002,40
0,991,29108,3575879962,3575880003,41
0,991,29109,3575879962,3575880006,44
0,991,29110,3575879962,3575880006,44
0,991,29111,3575879962,3575880007,45
0,991,29112,3575879962,3575880007,45
0,991,29113,3575879962,3575880007,45
0,991,29114,3575879962,3575880008,46
0,991,29115,3575879962,3575880011,49
0,992,29116,3575880028,3575880028,0
0,992,29117,3575880028,3575880028,0
0,992,29118,3575880028,3575880028,0
0,992,29119,3575880028,3575880029,1
0,992,29120,3575880028,3575880029,1
0,992,29121,3575880028,3575880029,1
0,992,29122,3575880028,3575880029,1
0,992,29123,3575880028,3575880029,1
0,992,29124,3575880028,3575880029,1
0,992,29125,3575880028,3575880029,1
0,992,29126,3575880028,3575880029,1
0,992,29127,3575880028,3575880029,1
0,992,29128,3575880028,3575880029,1
0,992,29129,3575880028,3575880029,1
0,992,29130,3575880028,3575880029,1
0,992,29131,3575880028,3575880030,2
0,992,29132,3575880028,3575880030,2
0,992,29133,3575880028,3575880031,3
0,992,29134,3575880028,3575880031,3
0,992,29135,3575880028,3575880032,4
0,992,29136,3575880028,3575880032,4
0,992,29137,3575880028,3575880032,4
0,992,29138,3575880028,3575880033,5
0,992,29139,3575880028,3575880033,5
0,992,29140,3575880028,3575880034,6
0,992,29141,3575880028,3575880034,6
0,992,29142,3575880028,3575880034,6
0,992,29143,3575880028,3575880035,7
0,992,29144,3575880028,3575880035,7
0,992,29145,3575880028,3575880039,11
0,992,29146,3575880028,3575880040,12
0,992,29147,3575880028,3575880040,12
0,992,29148,3575880028,3575880043,15
0,992,29149,3575880028,3575880043,15
0,992,29150,3575880028,3575880043,15
0,992,29151,3575880028,3575880044,16
0,992,29152,3575880028,3575880046,18
0,992,29153,3575880028,3575880048,20
0,992,29154,3575880028,3575880048,20
0,992,29155,3575880028,3575880049,21
0,992,29156,3575880028,3575880049,21
0,992,29157,3575880028,3575880050,22
0,992,29158,3575880028,3575880050,22
0,992,29159,3575880028,3575880052,24
0,992,29160,3575880028,3575880053,25
0,992,29161,3575880028,3575880055,27
0,992,29162,3575880028,3575880056,28
0,992,29163,3575880028,3575880056,28
0,992,29164,3575880028,3575880056,28
0,992,29165,3575880028,3575880057,29
0,992,29166,3575880028,3575880057,29
0,992,29167,3575880028,3575880057,29
0,992,29168,3575880028,3575880060,32
0,992,29169,3575880028,3575880061,33
0,992,29170,3575880028,3575880061,33
0,992,29171,3575880028,3575880061,33
0,992,29172,3575880028,3575880062,34
0,992,29173,3575880028,3575880062,34
0,992,29174,3575880028,3575880062,34
0,992,29175,3575880028,3575880063,35
0,992,29176,3575880028,3575880064,36
0,992,29177,3575880028,3575880064,36
0,992,29178,3575880028,3575880066,38
0,992,29179,3575880028,3575880066,38
0,992,29180,3575880028,3575880066,38
0,992,29181,3575880028,3575880066,38
0,992,29182,3575880028,3575880067,39
0,992,29183,3575880028,3575880068,40
0,992,29184,3575880028,3575880068,40
0,992,29185,3575880028,3575880072,44
0,992,29186,3575880028,3575880076,48
0,992,29187,3575880028,3575880077,49
0,993,29188,3575880091,3575880091,0
0,993,29189,3575880091,3575880092,1
0,993,29190,3575880091,3575880092,1
0,993,29191,3575880091,3575880092,1
0,993,29192,3575880091,3575880092,1
0,993,29193,3575880091,3575880092,1
0,993,29194,3575880091,3575880092,1
0,993,29195,3575880091,3575880092,1
0,993,29196,3575880091,3575880092,1
0,993,29197,3575880091,3575880092,1
0,993,29198,3575880091,3575880092,1
0,993,29199,3575880091,3575880092,1
0,993,29200,3575880091,3575880092,1
0,993,29201,3575880091,3575880092,1
0,993,29202,3575880091,3575880092,1
0,993,29203,3575880091,3575880092,1
0,993,29204,3575880091,3575880093,2
0,993,29205,3575880091,3575880093,2
0,993,29206,3575880091,3575880094,3
0,993,29207,3575880091,3575880094,3
0,993,29208,3575880091,3575880095,4
0,993,29209,3575880091,3575880095,4
0,993,29210,3575880091,3575880095,4
0,993,29211,3575880091,3575880095,4
0,993,29212,3575880091,3575880096,5
0,993,29213,3575880091,3575880097,6
0,993,29214,3575880091,3575880097,6
0,993,29215,3575880091,3575880097,6
0,993,29216,3575880091,3575880099,8
0,993,29217,3575880091,3575880100,9
0,993,29218,3575880091,3575880100,9
0,993,29219,3575880091,3575880100,9
0,993,29220,3575880091,3575880101,10
0,993,29221,3575880091,3575880102,11
0,993,29222,3575880091,3575880103,12
0,993,29223,3575880091,3575880103,12
0,993,29224,3575880091,3575880103,12
0,993,29225,3575880091,3575880103,12
0,993,29226,3575880091,3575880105,14
0,993,29227,3575880091,3575880105,14
0,993,29228,3575880091,3575880106,15
0,993,29229,3575880091,3575880107,16
0,993,29230,3575880091,3575880107,16
0,993,29231,3575880091,3575880108,17
0,993,29232,3575880091,3575880108,17
0,993,29233,3575880091,3575880108,17
0,993,29234,3575880091,3575880108,17
0,993,29235,3575880091,3575880109,18
0,993,29236,3575880091,3575880109,18
0,993,29237,3575880091,3575880110,19
0,993,29238,3575880091,3575880111,20
0,993,29239,3575880091,3575880112,21
0,993,29240,3575880091,3575880113,22
0,993,29241,3575880091,3575880114,23
0,993,29242,3575880091,3575880114,23
0,993,29243,3575880091,3575880114,23
0,993,29244,3575880091,3575880115,24
0,993,29245,3575880091,3575880116,25
0,993,29246,3575880091,3575880116,25
0,993,29247,3575880091,3575880116,25
0,993,29248,3575880091,3575880119,28
0,993,29249,3575880091,3575880120,29
0,993,29250,3575880091,3575880120,29
0,993,29251,3575880091,3575880121,30
0,993,29252,3575880091,3575880124,33
0,993,29253,3575880091,3575880124,33
0,993,29254,3575880091,3575880124,33
0,993,29255,3575880091,3575880124,33
0,993,29256,3575880091,3575880124,33
0,993,29257,3575880091,3575880124,33
0,993,29258,3575880091,3575880125,34
0,993,29259,3575880091,3575880125,34
0,993,29260,3575880091,3575880125,34
0,993,29261,3575880091,3575880127,36
0,993,29262,3575880091,3575880127,36
0,993,29263,3575880091,3575880127,36
0,993,29264,3575880091,3575880129,38
0,993,29265,3575880091,3575880129,38
0,993,29266,3575880091,3575880129,38
0,993,29267,3575880091,3575880130,39
0,993,29268,3575880091,3575880130,39
0,993,29269,3575880091,3575880133,42
0,993,29270,3575880091,3575880134,43
0,993,29271,3575880091,3575880134,43
0,993,29272,3575880091,3575880135,44
0,993,29273,3575880091,3575880137,46
0,993,29274,3575880091,3575880137,46
0,993,29275,3575880091,3575880138,47
0,993,29276,3575880091,3575880139,48
0,993,29277,3575880091,3575880139,48
0,993,29278,3575880091,3575880140,49
0,993,29279,3575880091,3575880140,49
0,993,29280,3575880091,3575880141,50
0,994,29281,3575880155,3575880155,0
0,994,29282,3575880155,3575880155,0
0,994,29283,3575880155,3575880155,0
0,994,29284,3575880155,3575880155,0
0,994,29285,3575880155,3575880155,0
0,994,29286,3575880155,3575880155,0
0,994,29287,3575880155,3575880155,0
0,994,29288,3575880155,3575880155,0
0,994,29289,3575880155,3575880155,0
0,994,29290,3575880155,3575880155,0
0,994,29291,3575880155,3575880155,0
0,994,29292,3575880155,3575880155,0
0,994,29293,3575880155,3575880155,0
0,994,29294,3575880155,3575880155,0
0,994,29295,3575880155,3575880155,0
0,994,29296,3575880155,3575880155,0
0,994,29297,3575880155,3575880155,0
0,994,29298,3575880155,3575880155,0
0,994,29299,3575880155,3575880155,0
0,994,29300,3575880155,3575880155,0
0,994,29301,3575880155,3575880155,0
0,994,29302,3575880155,3575880155,0
0,994,29303,3575880155,3575880156,1
0,994,29304,3575880155,3575880157,2
0,994,29305,3575880155,3575880157,2
0,994,29306,3575880155,3575880157,2
0,994,29307,3575880155,3575880158,3
0,994,29308,3575880155,3575880159,4
0,994,29309,3575880155,3575880159,4
0,994,29310,3575880155,3575880160,5
0,994,29311,3575880155,3575880160,5
0,994,29312,3575880155,3575880161,6
0,994,29313,3575880155,3575880162,7
0,994,29314,3575880155,3575880163,8
0,994,29315,3575880155,3575880164,9
0,994,29316,3575880155,3575880165,10
0,994,29317,3575880155,3575880165,10
0,994,29318,3575880155,3575880165,10
0,994,29319,3575880155,3575880165,10
0,994,29320,3575880155,3575880166,11
0,994,29321,3575880155,3575880166,11
0,994,29322,3575880155,3575880166,11
0,994,29323,3575880155,3575880166,11
0,994,29324,3575880155,3575880170,15
0,994,29325,3575880155,3575880171,16
0,994,29326,3575880155,3575880171,16
0,994,29327,3575880155,3575880172,17
0,994,29328,3575880155,3575880173,18
0,994,29329,3575880155,3575880175,20
0,994,29330,3575880155,3575880177,22
0,994,29331,3575880155,3575880178,23
0,994,29332,3575880155,3575880178,23
0,994,29333,3575880155,3575880178,23
0,994,29334,3575880155,3575880178,23
0,994,29335,3575880155,3575880179,24
0,994,29336,3575880155,3575880179,24
0,994,29337,3575880155,3575880180,25
0,994,29338,3575880155,3575880183,28
0,994,29339,3575880155,3575880184,29
0,994,29340,3575880155,3575880185,30
0,994,29341,3575880155,3575880187,32
0,994,29342,3575880155,3575880188,33
0,994,29343,3575880155,3575880189,34
0,994,29344,3575880155,3575880189,34
0,994,29345,3575880155,3575880190,35
0,994,29346,3575880155,3575880193,38
0,994,29347,3575880155,3575880194,39
0,994,29348,3575880155,3575880195,40
0,994,29349,3575880155,3575880198,43
0,994,29350,3575880155,3575880199,44
0,994,29351,3575880155,3575880200,45
0,994,29352,3575880155,3575880201,46
0,994,29353,3575880155,3575880201,46
0,994,29354,3575880155,3575880203,48
0,994,29355,3575880155,3575880204,49
0,995,29356,3575880219,3575880219,0
0,995,29357,3575880219,3575880219,0
0,995,29358,3575880219,3575880219,0
0,995,29359,3575880219,3575880219,0
0,995,29360,3575880219,3575880219,0
0,995,29361,3575880219,3575880219,0
0,995,29362,3575880219,3575880219,0
0,995,29363,3575880219,3575880219,0
0,995,29364,3575880219,3575880219,0
0,995,29365,3575880219,3575880219,0
0,995,29366,3575880219,3575880219,0
0,995,29367,3575880219,3575880219,0
0,995,29368,3575880219,3575880219,0
0,995,29369,3575880219,3575880219,0
0,995,29370,3575880219,3575880219,0
0,995,29371,3575880219,3575880219,0
0,995,29372,3575880219,3575880219,0
0,995,29373,3575880219,3575880221,2
0,995,29374,3575880219,3575880221,2
0,995,29375,3575880219,3575880226,7
0,995,29376,3575880219,3575880226,7
0,995,29377,3575880219,3575880229,10
0,995,29378,3575880219,3575880229,10
0,995,29379,3575880219,3575880229,10
0,995,29380,3575880219,3575880229,10
0,995,29381,3575880219,3575880230,11
0,995,29382,3575880219,3575880231,12
0,995,29383,3575880219,3575880231,12
0,995,29384,3575880219,3575880232,13
0,995,29385,3575880219,3575880232,13
0,995,29386,3575880219,3575880232,13
0,995,29387,3575880219,3575880232,13
0,995,29388,3575880219,3575880233,14
0,995,29389,3575880219,3575880233,14
0,995,29390,3575880219,3575880234,15
0,995,29391,3575880219,3575880234,15
0,995,29392,3575880219,3575880235,16
0,995,29393,3575880219,3575880235,16
0,995,29394,3575880219,3575880235,16
0,995,29395,3575880219,3575880239,20
0,995,29396,3575880219,3575880240,21
0,995,29397,3575880219,3575880240,21
0,995,29398,3575880219,3575880243,24
0,995,29399,3575880219,3575880243,24
0,995,29400,3575880219,3575880243,24
0,995,29401,3575880219,3575880244,25
0,995,29402,3575880219,3575880247,28
0,995,29403,3575880219,3575880247,28
0,995,29404,3575880219,3575880248,29
0,995,29405,3575880219,3575880249,30
0,995,29406,3575880219,3575880249,30
0,995,29407,3575880219,3575880249,30
0,995,29408,3575880219,3575880250,31
0,995,29409,3575880219,3575880250,31
0,995,29410,3575880219,3575880252,33
0,995,29411,3575880219,3575880253,34
0,995,29412,3575880219,3575880255,36
0,995,29413,3575880219,3575880256,37
0,995,29414,3575880219,3575880256,37
0,995,29415,3575880219,3575880256,37
0,995,29416,3575880219,3575880256,37
0,995,29417,3575880219,3575880257,38
0,995,29418,3575880219,3575880260,41
0,995,29419,3575880219,3575880260,41
0,995,29420,3575880219,3575880260,41
0,995,29421,3575880219,3575880261,42
0,995,29422,3575880219,3575880262,43
0,995,29423,3575880219,3575880262,43
0,995,29424,3575880219,3575880262,43
0,995,29425,3575880219,3575880262,43
0,995,29426,3575880219,3575880263,44
0,995,29427,3575880219,3575880264,45
0,995,29428,3575880219,3575880265,46
0,995,29429,3575880219,3575880266,47
0,995,29430,3575880219,3575880266,47
0,995,29431,3575880219,3575880266,47
0,995,29432,3575880219,3575880267,48
0,995,29433,3575880219,3575880267,48
0,995,29434,3575880219,3575880268,49
0,996,29435,3575880279,3575880279,0
0,996,29436,3575880279,3575880279,0
0,996,29437,3575880279,3575880279,0
0,996,29438,3575880279,3575880279,0
0,996,29439,3575880279,3575880281,2
0,996,29440,3575880279,3575880281,2
0,996,29441,3575880279,3575880281,2
0,996,29442,3575880279,3575880283,4
0,996,29443,3575880279,3575880284,5
0,996,29444,3575880279,3575880285,6
0,996,29445,3575880279,3575880286,7
0,996,29446,3575880279,3575880287,8
0,996,29447,3575880279,3575880287,8
0,996,29448,3575880279,3575880287,8
0,996,29449,3575880279,3575880287,8
0,996,29450,3575880279,3575880288,9
0,996,29451,3575880279,3575880291,12
0,996,29452,3575880279,3575880291,12
0,996,29453,3575880279,3575880292,13
0,996,29454,3575880279,3575880292,13
0,996,29455,3575880279,3575880293,14
0,996,29456,3575880279,3575880293,14
0,996,29457,3575880279,3575880293,14
0,996,29458,3575880279,3575880294,15
0,996,29459,3575880279,3575880294,15
0,996,29460,3575880279,3575880295,16
0,996,29461,3575880279,3575880295,16
0,996,29462,3575880279,3575880296,17
0,996,29463,3575880279,3575880296,17
0,996,29464,3575880279,3575880296,17
0,996,29465,3575880279,3575880297,18
0,996,29466,3575880279,3575880298,19
0,996,29467,3575880279,3575880299,20
0,996,29468,3575880279,3575880299,20
0,996,29469,3575880279,3575880300,21
0,996,29470,3575880279,3575880300,21
0,996,29471,3575880279,3575880301,22
0,996,29472,3575880279,3575880301,22
0,996,29473,3575880279,3575880302,23
0,996,29474,3575880279,3575880303,24
0,996,29475,3575880279,3575880303,24
0,996,29476,3575880279,3575880305,26
0,996,29477,3575880279,3575880305,26
0,996,29478,3575880279,3575880306,27
0,996,29479,3575880279,3575880307,28
0,996,29480,3575880279,3575880307,28
0,996,29481,3575880279,3575880307,28
0,996,29482,3575880279,3575880307,28
0,996,29483,3575880279,3575880308,29
0,996,29484,3575880279,3575880309,30
0,996,29485,3575880279,3575880309,30
0,996,29486,3575880279,3575880310,31
0,996,29487,3575880279,3575880310,31
0,996,29488,3575880279,3575880312,33
0,996,29489,3575880279,3575880312,33
0,996,29490,3575880279,3575880313,34
0,996,29491,3575880279,3575880314,35
0,996,29492,3575880279,3575880314,35
0,996,29493,3575880279,3575880315,36
0,996,29494,3575880279,3575880316,37
0,996,29495,3575880279,3575880316,37
0,996,29496,3575880279,3575880316,37
0,996,29497,3575880279,3575880318,39
0,996,29498,3575880279,3575880320,41
0,996,29499,3575880279,3575880320,41
0,996,29500,3575880279,3575880321,42
0,996,29501,3575880279,3575880323,44
0,996,29502,3575880279,3575880323,44
0,996,29503,3575880279,3575880324,45
0,996,29504,3575880279,3575880324,45
0,996,29505,3575880279,3575880324,45
0,996,29506,3575880279,3575880325,46
0,996,29507,3575880279,3575880325,46
0,996,29508,3575880279,3575880326,47
0,996,29509,3575880279,3575880326,47
0,996,29510,3575880279,3575880326,47
0,996,29511,3575880279,3575880328,49
0,996,29512,3575880279,3575880329,50
0,997,29513,3575880348,3575880348,0
0,997,29514,3575880348,3575880348,0
0,997,29515,3575880348,3575880348,0
0,997,29516,3575880348,3575880348,0
0,997,29517,3575880348,3575880348,0
0,997,29518,3575880348,3575880348,0
0,997,29519,3575880348,3575880348,0
0,997,29520,3575880348,3575880348,0
0,997,29521,3575880348,3575880348,0
0,997,29522,3575880348,3575880348,0
0,997,29523,3575880348,3575880348,0
0,997,29524,3575880348,3575880348,0
0,997,29525,3575880348,3575880348,0
0,997,29526,3575880348,3575880348,0
0,997,29527,3575880348,3575880348,0
0,997,29528,3575880348,3575880348,0
0,997,29529,3575880348,3575880348,0
0,997,29530,3575880348,3575880348,0
0,997,29531,3575880348,3575880348,0
0,997,29532,3575880348,3575880348,0
0,997,29533,3575880348,3575880348,0
0,997,29534,3575880348,3575880348,0
0,997,29535,3575880348,3575880348,0
0,997,29536,3575880348,3575880348,0
0,997,29537,3575880348,3575880348,0
0,997,29538,3575880348,3575880348,0
0,997,29539,3575880348,3575880348,0
0,997,29540,3575880348,3575880348,0
0,997,29541,3575880348,3575880348,0
0,997,29542,3575880348,3575880348,0
0,997,29543,3575880348,3575880348,0
0,997,29544,3575880348,3575880348,0
0,997,29545,3575880348,3575880348,0
0,997,29546,3575880348,3575880348,0
0,997,29547,3575880348,3575880349,1
0,997,29548,3575880348,3575880349,1
0,997,29549,3575880348,3575880351,3
0,997,29550,3575880348,3575880352,4
0,997,29551,3575880348,3575880354,6
0,997,29552,3575880348,3575880355,7
0,997,29553,3575880348,3575880355,7
0,997,29554,3575880348,3575880357,9
0,997,29555,3575880348,3575880357,9
0,997,29556,3575880348,3575880359,11
0,997,29557,3575880348,3575880359,11
0,997,29558,3575880348,3575880359,11
0,997,29559,3575880348,3575880361,13
0,997,29560,3575880348,3575880361,13
0,997,29561,3575880348,3575880362,14
0,997,29562,3575880348,3575880363,15
0,997,29563,3575880348,3575880364,16
0,997,29564,3575880348,3575880365,17
0,997,29565,3575880348,3575880365,17
0,997,29566,3575880348,3575880365,17
0,997,29567,3575880348,3575880365,17
0,997,29568,3575880348,3575880366,18
0,997,29569,3575880348,3575880366,18
0,997,29570,3575880348,3575880366,18
0,997,29571,3575880348,3575880367,19
0,997,29572,3575880348,3575880369,21
0,997,29573,3575880348,3575880371,23
0,997,29574,3575880348,3575880372,24
0,997,29575,3575880348,3575880373,25
0,997,29576,3575880348,3575880373,25
0,997,29577,3575880348,3575880374,26
0,997,29578,3575880348,3575880377,29
0,997,29579,3575880348,3575880378,30
0,997,29580,3575880348,3575880378,30
0,997,29581,3575880348,3575880378,30
0,997,29582,3575880348,3575880378,30
0,997,29583,3575880348,3575880379,31
0,997,29584,3575880348,3575880379,31
0,997,29585,3575880348,3575880380,32
0,997,29586,3575880348,3575880383,35
0,997,29587,3575880348,3575880384,36
0,997,29588,3575880348,3575880385,37
0,997,29589,3575880348,3575880385,37
0,997,29590,3575880348,3575880387,39
0,997,29591,3575880348,3575880388,40
0,997,29592,3575880348,3575880389,41
0,997,29593,3575880348,3575880389,41
0,997,29594,3575880348,3575880391,43
0,997,29595,3575880348,3575880394,46
0,997,29596,3575880348,3575880394,46
0,997,29597,3575880348,3575880396,48
0,998,29598,3575880414,3575880414,0
0,998,29599,3575880414,3575880414,0
0,998,29600,3575880414,3575880414,0
0,998,29601,3575880414,3575880414,0
0,998,29602,3575880414,3575880414,0
0,998,29603,3575880414,3575880414,0
0,998,29604,3575880414,3575880414,0
0,998,29605,3575880414,3575880414,0
0,998,29606,3575880414,3575880414,0
0,998,29607,3575880414,3575880414,0
0,998,29608,3575880414,3575880414,0
0,998,29609,3575880414,3575880414,0
0,998,29610,3575880414,3575880414,0
0,998,29611,3575880414,3575880414,0
0,998,29612,3575880414,3575880415,1
0,998,29613,3575880414,3575880415,1
0,998,29614,3575880414,3575880415,1
0,998,29615,3575880414,3575880417,3
0,998,29616,3575880414,3575880417,3
0,998,29617,3575880414,3575880418,4
0,998,29618,3575880414,3575880419,5
0,998,29619,3575880414,3575880419,5
0,998,29620,3575880414,3575880421,7
0,998,29621,3575880414,3575880421,7
0,998,29622,3575880414,3575880426,12
0,998,29623,3575880414,3575880426,12
0,998,29624,3575880414,3575880428,14
0,998,29625,3575880414,3575880429,15
0,998,29626,3575880414,3575880430,16
0,998,29627,3575880414,3575880430,16
0,998,29628,3575880414,3575880431,17
0,998,29629,3575880414,3575880431,17
0,998,29630,3575880414,3575880431,17
0,998,29631,3575880414,3575880432,18
0,998,29632,3575880414,3575880432,18
0,998,29633,3575880414,3575880433,19
0,998,29634,3575880414,3575880433,19
0,998,29635,3575880414,3575880433,19
0,998,29636,3575880414,3575880434,20
0,998,29637,3575880414,3575880434,20
0,998,29638,3575880414,3575880435,21
0,998,29639,3575880414,3575880435,21
0,998,29640,3575880414,3575880435,21
0,998,29641,3575880414,3575880436,22
0,998,29642,3575880414,3575880440,26
0,998,29643,3575880414,3575880440,26
0,998,29644,3575880414,3575880440,26
0,998,29645,3575880414,3575880442,28
0,998,29646,3575880414,3575880442,28
0,998,29647,3575880414,3575880443,29
0,998,29648,3575880414,3575880444,30
0,998,29649,3575880414,3575880447,33
0,998,29650,3575880414,3575880447,33
0,998,29651,3575880414,3575880449,35
0,998,29652,3575880414,3575880449,35
0,998,29653,3575880414,3575880449,35
0,998,29654,3575880414,3575880449,35
0,998,29655,3575880414,3575880450,36
0,998,29656,3575880414,3575880450,36
0,998,29657,3575880414,3575880452,38
0,998,29658,3575880414,3575880453,39
0,998,29659,3575880414,3575880455,41
0,998,29660,3575880414,3575880456,42
0,998,29661,3575880414,3575880456,42
0,998,29662,3575880414,3575880457,43
0,998,29663,3575880414,3575880457,43
0,998,29664,3575880414,3575880457,43
0,998,29665,3575880414,3575880458,44
0,998,29666,3575880414,3575880459,45
0,998,29667,3575880414,3575880461,47
0,998,29668,3575880414,3575880461,47
0,998,29669,3575880414,3575880462,48
0,998,29670,3575880414,3575880462,48
0,998,29671,3575880414,3575880462,48
0,998,29672,3575880414,3575880462,48
0,998,29673,3575880414,3575880462,48
0,998,29674,3575880414,3575880463,49
0,999,29675,3575880477,3575880477,0
0,999,29676,3575880477,3575880477,0
0,999,29677,3575880477,3575880477,0
0,999,29678,3575880477,3575880477,0
0,999,29679,3575880477,3575880477,0
0,999,29680,3575880477,3575880477,0
0,999,29681,3575880477,3575880477,0
0,999,29682,3575880477,3575880477,0
0,999,29683,3575880477,3575880477,0
0,999,29684,3575880477,3575880477,0
0,999,29685,3575880477,3575880477,0
0,999,29686,3575880477,3575880477,0
0,999,29687,3575880477,3575880477,0
0,999,29688,3575880477,3575880479,2
0,999,29689,3575880477,3575880481,4
0,999,29690,3575880477,3575880481,4
0,999,29691,3575880477,3575880483,6
0,999,29692,3575880477,3575880483,6
0,999,29693,3575880477,3575880484,7
0,999,29694,3575880477,3575880485,8
0,999,29695,3575880477,3575880486,9
0,999,29696,3575880477,3575880486,9
0,999,29697,3575880477,3575880486,9
0,999,29698,3575880477,3575880487,10
0,999,29699,3575880477,3575880487,10
0,999,29700,3575880477,3575880490,13
0,999,29701,3575880477,3575880490,13
0,999,29702,3575880477,3575880491,14
0,999,29703,3575880477,3575880491,14
0,999,29704,3575880477,3575880492,15
0,999,29705,3575880477,3575880493,16
0,999,29706,3575880477,3575880493,16
0,999,29707,3575880477,3575880494,17
0,999,29708,3575880477,3575880495,18
0,999,29709,3575880477,3575880495,18
0,999,29710,3575880477,3575880495,18
0,999,29711,3575880477,3575880496,19
0,999,29712,3575880477,3575880496,19
0,999,29713,3575880477,3575880496,19
0,999,29714,3575880477,3575880497,20
0,999,29715,3575880477,3575880499,22
0,999,29716,3575880477,3575880499,22
0,999,29717,3575880477,3575880499,22
0,999,29718,3575880477,3575880500,23
0,999,29719,3575880477,3575880500,23
0,999,29720,3575880477,3575880501,24
0,999,29721,3575880477,3575880501,24
0,999,29722,3575880477,3575880502,25
0,999,29723,3575880477,3575880502,25
0,999,29724,3575880477,3575880505,28
0,999,29725,3575880477,3575880505,28
0,999,29726,3575880477,3575880505,28
0,999,29727,3575880477,3575880507,30
0,999,29728,3575880477,3575880507,30
0,999,29729,3575880477,3575880507,30
0,999,29730,3575880477,3575880507,30
0,999,29731,3575880477,3575880508,31
0,999,29732,3575880477,3575880508,31
0,999,29733,3575880477,3575880508,31
0,999,29734,3575880477,3575880509,32
0,999,29735,3575880477,3575880511,34
0,999,29736,3575880477,3575880512,35
0,999,29737,3575880477,3575880512,35
0,999,29738,3575880477,3575880514,37
0,999,29739,3575880477,3575880514,37
0,999,29740,3575880477,3575880514,37
0,999,29741,3575880477,3575880514,37
0,999,29742,3575880477,3575880515,38
0,999,29743,3575880477,3575880516,39
0,999,29744,3575880477,3575880516,39
0,999,29745,3575880477,3575880516,39
0,999,29746,3575880477,3575880518,41
0,999,29747,3575880477,3575880519,42
0,999,29748,3575880477,3575880520,43
0,999,29749,3575880477,3575880521,44
0,999,29750,3575880477,3575880522,45
0,999,29751,3575880477,3575880522,45
0,999,29752,3575880477,3575880523,46
0,999,29753,3575880477,3575880523,46
0,999,29754,3575880477,3575880524,47
0,999,29755,3575880477,3575880524,47
0,999,29756,3575880477,3575880525,48
0,999,29757,3575880477,3575880525,48
0,999,29758,3575880477,3575880525,48
0,999,29759,3575880477,3575880526,49
0,999,29760,3575880477,3575880526,49
0,1000,29761,3575880538,3575880538,0
0,1000,29762,3575880538,3575880538,0
0,1000,29763,3575880538,3575880538,0
0,1000,29764,3575880538,3575880538,0
0,1000,29765,3575880538,3575880538,0
0,1000,29766,3575880538,3575880538,0
0,1000,29767,3575880538,3575880538,0
0,1000,29768,3575880538,3575880538,0
0,1000,29769,3575880538,3575880538,0
0,1000,29770,3575880538,3575880538,0
0,1000,29771,3575880538,3575880538,0
0,1000,29772,3575880538,3575880538,0
0,1000,29773,3575880538,3575880538,0
0,1000,29774,3575880538,3575880538,0
0,1000,29775,3575880538,3575880539,1
0,1000,29776,3575880538,3575880539,1
0,1000,29777,3575880538,3575880539,1
0,1000,29778,3575880538,3575880539,1
0,1000,29779,3575880538,3575880539,1
0,1000,29780,3575880538,3575880540,2
0,1000,29781,3575880538,3575880540,2
0,1000,29782,3575880538,3575880540,2
0,1000,29783,3575880538,3575880540,2
0,1000,29784,3575880538,3575880540,2
0,1000,29785,3575880538,3575880541,3
0,1000,29786,3575880538,3575880542,4
0,1000,29787,3575880538,3575880542,4
0,1000,29788,3575880538,3575880542,4
0,1000,29789,3575880538,3575880544,6
0,1000,29790,3575880538,3575880544,6
0,1000,29791,3575880538,3575880545,7
0,1000,29792,3575880538,3575880545,7
0,1000,29793,3575880538,3575880545,7
0,1000,29794,3575880538,3575880545,7
0,1000,29795,3575880538,3575880548,10
0,1000,29796,3575880538,3575880548,10
0,1000,29797,3575880538,3575880548,10
0,1000,29798,3575880538,3575880549,11
0,1000,29799,3575880538,3575880549,11
0,1000,29800,3575880538,3575880550,12
0,1000,29801,3575880538,3575880551,13
0,1000,29802,3575880538,3575880552,14
0,1000,29803,3575880538,3575880554,16
0,1000,29804,3575880538,3575880554,16
0,1000,29805,3575880538,3575880556,18
0,1000,29806,3575880538,3575880556,18
0,1000,29807,3575880538,3575880556,18
0,1000,29808,3575880538,3575880558,20
0,1000,29809,3575880538,3575880559,21
0,1000,29810,3575880538,3575880559,21
0,1000,29811,3575880538,3575880559,21
0,1000,29812,3575880538,3575880559,21
0,1000,29813,3575880538,3575880560,22
0,1000,29814,3575880538,3575880562,24
0,1000,29815,3575880538,3575880562,24
0,1000,29816,3575880538,3575880564,26
0,1000,29817,3575880538,3575880564,26
0,1000,29818,3575880538,3575880564,26
0,1000,29819,3575880538,3575880564,26
0,1000,29820,3575880538,3575880564,26
0,1000,29821,3575880538,3575880565,27
0,1000,29822,3575880538,3575880565,27
0,1000,29823,3575880538,3575880566,28
0,1000,29824,3575880538,3575880568,30
0,1000,29825,3575880538,3575880570,32
0,1000,29826,3575880538,3575880570,32
0,1000,29827,3575880538,3575880571,33
0,1000,29828,3575880538,3575880572,34
0,1000,29829,3575880538,3575880575,37
0,1000,29830,3575880538,3575880576,38
0,1000,29831,3575880538,3575880577,39
0,1000,29832,3575880538,3575880577,39
0,1000,29833,3575880538,3575880577,39
0,1000,29834,3575880538,3575880578,40
0,1000,29835,3575880538,3575880578,40
0,1000,29836,3575880538,3575880579,41
0,1000,29837,3575880538,3575880579,41
0,1000,29838,3575880538,3575880582,44
0,1000,29839,3575880538,3575880583,45
0,1000,29840,3575880538,3575880584,46
0,1000,29841,3575880538,3575880587,49
0,1000,29842,3575880538,3575880587,49
0,1001,29843,3575880602,3575880602,0
0,1001,29844,3575880602,3575880602,0
0,1001,29845,3575880602,3575880602,0
0,1001,29846,3575880602,3575880602,0
0,1001,29847,3575880602,3575880602,0
0,1001,29848,3575880602,3575880602,0
0,1001,29849,3575880602,3575880602,0
0,1001,29850,3575880602,3575880602,0
0,1001,29851,3575880602,3575880602,0
0,1001,29852,3575880602,3575880602,0
0,1001,29853,3575880602,3575880602,0
0,1001,29854,3575880602,3575880602,0
0,1001,29855,3575880602,3575880602,0
0,1001,29856,3575880602,3575880604,2
0,1001,29857,3575880602,3575880605,3
0,1001,29858,3575880602,3575880606,4
0,1001,29859,3575880602,3575880607,5
0,1001,29860,3575880602,3575880608,6
0,1001,29861,3575880602,3575880609,7
0,1001,29862,3575880602,3575880611,9
0,1001,29863,3575880602,3575880612,10
0,1001,29864,3575880602,3575880613,11
0,1001,29865,3575880602,3575880613,11
0,1001,29866,3575880602,3575880614,12
0,1001,29867,3575880602,3575880614,12
0,1001,29868,3575880602,3575880615,13
0,1001,29869,3575880602,3575880616,14
0,1001,29870,3575880602,3575880616,14
0,1001,29871,3575880602,3575880617,15
0,1001,29872,3575880602,3575880618,16
0,1001,29873,3575880602,3575880618,16
0,1001,29874,3575880602,3575880620,18
0,1001,29875,3575880602,3575880620,18
0,1001,29876,3575880602,3575880620,18
0,1001,29877,3575880602,3575880623,21
0,1001,29878,3575880602,3575880625,23
0,1001,29879,3575880602,3575880626,24
0,1001,29880,3575880602,3575880627,25
0,1001,29881,3575880602,3575880629,27
0,1001,29882,3575880602,3575880629,27
0,1001,29883,3575880602,3575880629,27
0,1001,29884,3575880602,3575880629,27
0,1001,29885,3575880602,3575880630,28
0,1001,29886,3575880602,3575880631,29
0,1001,29887,3575880602,3575880631,29
0,1001,29888,3575880602,3575880632,30
0,1001,29889,3575880602,3575880632,30
0,1001,29890,3575880602,3575880632,30
0,1001,29891,3575880602,3575880632,30
0,1001,29892,3575880602,3575880633,31
0,1001,29893,3575880602,3575880633,31
0,1001,29894,3575880602,3575880633,31
0,1001,29895,3575880602,3575880635,33
0,1001,29896,3575880602,3575880635,33
0,1001,29897,3575880602,3575880639,37
0,1001,29898,3575880602,3575880639,37
0,1001,29899,3575880602,3575880640,38
0,1001,29900,3575880602,3575880642,40
0,1001,29901,3575880602,3575880642,40
0,1001,29902,3575880602,3575880642,40
0,1001,29903,3575880602,3575880644,42
0,1001,29904,3575880602,3575880645,43
0,1001,29905,3575880602,3575880646,44
0,1001,29906,3575880602,3575880647,45
0,1001,29907,3575880602,3575880648,46
0,1001,29908,3575880602,3575880648,46
0,1001,29909,3575880602,3575880648,46
0,1001,29910,3575880602,3575880648,46
0,1001,29911,3575880602,3575880649,47
0,1001,29912,3575880602,3575880650,48
0,1001,29913,3575880602,3575880651,49
0,1002,29914,3575880666,3575880666,0
0,1002,29915,3575880666,3575880666,0
0,1002,29916,3575880666,3575880666,0
0,1002,29917,3575880666,3575880666,0
0,1002,29918,3575880666,3575880666,0
0,1002,29919,3575880666,3575880666,0
0,1002,29920,3575880666,3575880666,0
0,1002,29921,3575880666,3575880666,0
0,1002,29922,3575880666,3575880666,0
0,1002,29923,3575880666,3575880666,0
0,1002,29924,3575880666,3575880666,0
0,1002,29925,3575880666,3575880666,0
0,1002,29926,3575880666,3575880666,0
0,1002,29927,3575880666,3575880666,0
0,1002,29928,3575880666,3575880666,0
0,1002,29929,3575880666,3575880666,0
0,1002,29930,3575880666,3575880666,0
0,1002,29931,3575880666,3575880666,0
0,1002,29932,3575880666,3575880666,0
0,1002,29933,3575880666,3575880666,0
0,1002,29934,3575880666,3575880666,0
0,1002,29935,3575880666,3575880666,0
0,1002,29936,3575880666,3575880667,1
0,1002,29937,3575880666,3575880667,1
0,1002,29938,3575880666,3575880668,2
0,1002,29939,3575880666,3575880673,7
0,1002,29940,3575880666,3575880675,9
0,1002,29941,3575880666,3575880677,11
0,1002,29942,3575880666,3575880678,12
0,1002,29943,3575880666,3575880681,15
0,1002,29944,3575880666,3575880682,16
0,1002,29945,3575880666,3575880682,16
0,1002,29946,3575880666,3575880683,17
0,1002,29947,3575880666,3575880685,19
0,1002,29948,3575880666,3575880685,19
0,1002,29949,3575880666,3575880686,20
0,1002,29950,3575880666,3575880687,21
0,1002,29951,3575880666,3575880687,21
0,1002,29952,3575880666,3575880687,21
0,1002,29953,3575880666,3575880690,24
0,1002,29954,3575880666,3575880691,25
0,1002,29955,3575880666,3575880691,25
0,1002,29956,3575880666,3575880692,26
0,1002,29957,3575880666,3575880692,26
0,1002,29958,3575880666,3575880693,27
0,1002,29959,3575880666,3575880693,27
0,1002,29960,3575880666,3575880694,28
0,1002,29961,3575880666,3575880695,29
0,1002,29962,3575880666,3575880695,29
0,1002,29963,3575880666,3575880696,30
0,1002,29964,3575880666,3575880696,30
0,1002,29965,3575880666,3575880696,30
0,1002,29966,3575880666,3575880696,30
0,1002,29967,3575880666,3575880697,31
0,1002,29968,3575880666,3575880698,32
0,1002,29969,3575880666,3575880698,32
0,1002,29970,3575880666,3575880699,33
0,1002,29971,3575880666,3575880699,33
0,1002,29972,3575880666,3575880700,34
0,1002,29973,3575880666,3575880700,34
0,1002,29974,3575880666,3575880701,35
0,1002,29975,3575880666,3575880701,35
0,1002,29976,3575880666,3575880701,35
0,1002,29977,3575880666,3575880702,36
0,1002,29978,3575880666,3575880704,38
0,1002,29979,3575880666,3575880705,39
0,1002,29980,3575880666,3575880705,39
0,1002,29981,3575880666,3575880706,40
0,1002,29982,3575880666,3575880707,41
0,1002,29983,3575880666,3575880707,41
0,1002,29984,3575880666,3575880707,41
0,1002,29985,3575880666,3575880708,42
0,1002,29986,3575880666,3575880709,43
0,1002,29987,3575880666,3575880709,43
0,1002,29988,3575880666,3575880709,43
0,1002,29989,3575880666,3575880710,44
0,1002,29990,3575880666,3575880711,45
0,1002,29991,3575880666,3575880712,46
0,1002,29992,3575880666,3575880713,47
0,1002,29993,3575880666,3575880713,47
0,1002,29994,3575880666,3575880714,48
0,1002,29995,3575880666,3575880715,49
0,1003,29996,3575880730,3575880730,0
0,1003,29997,3575880730,3575880730,0
0,1003,29998,3575880730,3575880730,0
0,1003,29999,3575880730,3575880730,0
0,1003,30000,3575880730,3575880730,0
0,1003,30001,3575880730,3575880730,0
0,1003,30002,3575880730,3575880730,0
0,1003,30003,3575880730,3575880730,0
0,1003,30004,3575880730,3575880730,0
0,1003,30005,3575880730,3575880730,0
0,1003,30006,3575880730,3575880730,0
0,1003,30007,3575880730,3575880730,0
0,1003,30008,3575880730,3575880730,0
0,1003,30009,3575880730,3575880730,0
0,1003,30010,3575880730,3575880730,0
0,1003,30011,3575880730,3575880730,0
0,1003,30012,3575880730,3575880730,0
0,1003,30013,3575880730,3575880730,0
0,1003,30014,3575880730,3575880730,0
0,1003,30015,3575880730,3575880730,0
0,1003,30016,3575880730,3575880730,0
0,1003,30017,3575880730,3575880730,0
0,1003,30018,3575880730,3575880730,0
0,1003,30019,3575880730,3575880730,0
0,1003,30020,3575880730,3575880731,1
0,1003,30021,3575880730,3575880732,2
0,1003,30022,3575880730,3575880733,3
0,1003,30023,3575880730,3575880734,4
0,1003,30024,3575880730,3575880735,5
0,1003,30025,3575880730,3575880737,7
0,1003,30026,3575880730,3575880737,7
0,1003,30027,3575880730,3575880737,7
0,1003,30028,3575880730,3575880738,8
0,1003,30029,3575880730,3575880739,9
0,1003,30030,3575880730,3575880739,9
0,1003,30031,3575880730,3575880739,9
0,1003,30032,3575880730,3575880739,9
0,1003,30033,3575880730,3575880740,10
0,1003,30034,3575880730,3575880740,10
0,1003,30035,3575880730,3575880740,10
0,1003,30036,3575880730,3575880740,10
0,1003,30037,3575880730,3575880741,11
0,1003,30038,3575880730,3575880741,11
0,1003,30039,3575880730,3575880742,12
0,1003,30040,3575880730,3575880742,12
0,1003,30041,3575880730,3575880742,12
0,1003,30042,3575880730,3575880744,14
0,1003,30043,3575880730,3575880744,14
0,1003,30044,3575880730,3575880745,15
0,1003,30045,3575880730,3575880745,15
0,1003,30046,3575880730,3575880746,16
0,1003,30047,3575880730,3575880746,16
0,1003,30048,3575880730,3575880748,18
0,1003,30049,3575880730,3575880748,18
0,1003,30050,3575880730,3575880748,18
0,1003,30051,3575880730,3575880748,18
0,1003,30052,3575880730,3575880749,19
0,1003,30053,3575880730,3575880751,21
0,1003,30054,3575880730,3575880752,22
0,1003,30055,3575880730,3575880753,23
0,1003,30056,3575880730,3575880754,24
0,1003,30057,3575880730,3575880755,25
0,1003,30058,3575880730,3575880755,25
0,1003,30059,3575880730,3575880756,26
0,1003,30060,3575880730,3575880757,27
0,1003,30061,3575880730,3575880758,28
0,1003,30062,3575880730,3575880758,28
0,1003,30063,3575880730,3575880759,29
0,1003,30064,3575880730,3575880759,29
0,1003,30065,3575880730,3575880759,29
0,1003,30066,3575880730,3575880760,30
0,1003,30067,3575880730,3575880760,30
0,1003,30068,3575880730,3575880762,32
0,1003,30069,3575880730,3575880762,32
0,1003,30070,3575880730,3575880764,34
0,1003,30071,3575880730,3575880764,34
0,1003,30072,3575880730,3575880764,34
0,1003,30073,3575880730,3575880764,34
0,1003,30074,3575880730,3575880765,35
0,1003,30075,3575880730,3575880765,35
0,1003,30076,3575880730,3575880766,36
0,1003,30077,3575880730,3575880766,36
0,1003,30078,3575880730,3575880768,38
0,1003,30079,3575880730,3575880770,40
0,1003,30080,3575880730,3575880770,40
0,1003,30081,3575880730,3575880771,41
0,1003,30082,3575880730,3575880773,43
0,1003,30083,3575880730,3575880774,44
0,1003,30084,3575880730,3575880776,46
0,1003,30085,3575880730,3575880776,46
0,1003,30086,3575880730,3575880777,47
0,1003,30087,3575880730,3575880777,47
0,1003,30088,3575880730,3575880777,47
0,1003,30089,3575880730,3575880778,48
0,1003,30090,3575880730,3575880778,48
0,1003,30091,3575880730,3575880779,49
0,1003,30092,3575880730,3575880779,49
0,1004,30093,3575880794,3575880794,0
0,1004,30094,3575880794,3575880794,0
0,1004,30095,3575880794,3575880794,0
0,1004,30096,3575880794,3575880794,0
0,1004,30097,3575880794,3575880794,0
0,1004,30098,3575880794,3575880794,0
0,1004,30099,3575880794,3575880794,0
0,1004,30100,3575880794,3575880794,0
0,1004,30101,3575880794,3575880794,0
0,1004,30102,3575880794,3575880794,0
0,1004,30103,3575880794,3575880795,1
0,1004,30104,3575880794,3575880797,3
0,1004,30105,3575880794,3575880798,4
0,1004,30106,3575880794,3575880800,6
0,1004,30107,3575880794,3575880801,7
0,1004,30108,3575880794,3575880802,8
0,1004,30109,3575880794,3575880802,8
0,1004,30110,3575880794,3575880804,10
0,1004,30111,3575880794,3575880805,11
0,1004,30112,3575880794,3575880805,11
0,1004,30113,3575880794,3575880807,13
0,1004,30114,3575880794,3575880808,14
0,1004,30115,3575880794,3575880809,15
0,1004,30116,3575880794,3575880809,15
0,1004,30117,3575880794,3575880811,17
0,1004,30118,3575880794,3575880813,19
0,1004,30119,3575880794,3575880814,20
0,1004,30120,3575880794,3575880814,20
0,1004,30121,3575880794,3575880814,20
0,1004,30122,3575880794,3575880814,20
0,1004,30123,3575880794,3575880815,21
0,1004,30124,3575880794,3575880816,22
0,1004,30125,3575880794,3575880816,22
0,1004,30126,3575880794,3575880818,24
0,1004,30127,3575880794,3575880818,24
0,1004,30128,3575880794,3575880819,25
0,1004,30129,3575880794,3575880820,26
0,1004,30130,3575880794,3575880821,27
0,1004,30131,3575880794,3575880822,28
0,1004,30132,3575880794,3575880825,31
0,1004,30133,3575880794,3575880825,31
0,1004,30134,3575880794,3575880827,33
0,1004,30135,3575880794,3575880827,33
0,1004,30136,3575880794,3575880828,34
0,1004,30137,3575880794,3575880829,35
0,1004,30138,3575880794,3575880829,35
0,1004,30139,3575880794,3575880830,36
0,1004,30140,3575880794,3575880830,36
0,1004,30141,3575880794,3575880831,37
0,1004,30142,3575880794,3575880832,38
0,1004,30143,3575880794,3575880832,38
0,1004,30144,3575880794,3575880832,38
0,1004,30145,3575880794,3575880832,38
0,1004,30146,3575880794,3575880832,38
0,1004,30147,3575880794,3575880833,39
0,1004,30148,3575880794,3575880833,39
0,1004,30149,3575880794,3575880834,40
0,1004,30150,3575880794,3575880835,41
0,1004,30151,3575880794,3575880839,45
0,1004,30152,3575880794,3575880840,46
0,1004,30153,3575880794,3575880841,47
0,1004,30154,3575880794,3575880842,48
0,1004,30155,3575880794,3575880842,48
0,1004,30156,3575880794,3575880843,49
0,1005,30157,3575880855,3575880855,0
0,1005,30158,3575880855,3575880855,0
0,1005,30159,3575880855,3575880855,0
0,1005,30160,3575880855,3575880855,0
0,1005,30161,3575880855,3575880855,0
0,1005,30162,3575880855,3575880855,0
0,1005,30163,3575880855,3575880856,1
0,1005,30164,3575880855,3575880856,1
0,1005,30165,3575880855,3575880856,1
0,1005,30166,3575880855,3575880856,1
0,1005,30167,3575880855,3575880856,1
0,1005,30168,3575880855,3575880856,1
0,1005,30169,3575880855,3575880856,1
0,1005,30170,3575880855,3575880856,1
0,1005,30171,3575880855,3575880856,1
0,1005,30172,3575880855,3575880857,2
0,1005,30173,3575880855,3575880857,2
0,1005,30174,3575880855,3575880859,4
0,1005,30175,3575880855,3575880860,5
0,1005,30176,3575880855,3575880861,6
0,1005,30177,3575880855,3575880861,6
0,1005,30178,3575880855,3575880862,7
0,1005,30179,3575880855,3575880862,7
0,1005,30180,3575880855,3575880863,8
0,1005,30181,3575880855,3575880864,9
0,1005,30182,3575880855,3575880864,9
0,1005,30183,3575880855,3575880865,10
0,1005,30184,3575880855,3575880865,10
0,1005,30185,3575880855,3575880866,11
0,1005,30186,3575880855,3575880867,12
0,1005,30187,3575880855,3575880867,12
0,1005,30188,3575880855,3575880867,12
0,1005,30189,3575880855,3575880867,12
0,1005,30190,3575880855,3575880869,14
0,1005,30191,3575880855,3575880869,14
0,1005,30192,3575880855,3575880874,19
0,1005,30193,3575880855,3575880875,20
0,1005,30194,3575880855,3575880876,21
0,1005,30195,3575880855,3575880878,23
0,1005,30196,3575880855,3575880881,26
0,1005,30197,3575880855,3575880882,27
0,1005,30198,3575880855,3575880883,28
0,1005,30199,3575880855,3575880884,29
0,1005,30200,3575880855,3575880885,30
0,1005,30201,3575880855,3575880885,30
0,1005,30202,3575880855,3575880887,32
0,1005,30203,3575880855,3575880887,32
0,1005,30204,3575880855,3575880887,32
0,1005,30205,3575880855,3575880887,32
0,1005,30206,3575880855,3575880887,32
0,1005,30207,3575880855,3575880890,35
0,1005,30208,3575880855,3575880891,36
0,1005,30209,3575880855,3575880891,36
0,1005,30210,3575880855,3575880891,36
0,1005,30211,3575880855,3575880892,37
0,1005,30212,3575880855,3575880893,38
0,1005,30213,3575880855,3575880893,38
0,1005,30214,3575880855,3575880894,39
0,1005,30215,3575880855,3575880895,40
0,1005,30216,3575880855,3575880895,40
0,1005,30217,3575880855,3575880895,40
0,1005,30218,3575880855,3575880896,41
0,1005,30219,3575880855,3575880896,41
0,1005,30220,3575880855,3575880897,42
0,1005,30221,3575880855,3575880897,42
0,1005,30222,3575880855,3575880897,42
0,1005,30223,3575880855,3575880898,43
0,1005,30224,3575880855,3575880899,44
0,1005,30225,3575880855,3575880899,44
0,1005,30226,3575880855,3575880900,45
0,1005,30227,3575880855,3575880900,45
0,1005,30228,3575880855,3575880900,45
0,1005,30229,3575880855,3575880901,46
0,1005,30230,3575880855,3575880902,47
0,1005,30231,3575880855,3575880902,47
0,1005,30232,3575880855,3575880903,48
0,1005,30233,3575880855,3575880903,48
0,1005,30234,3575880855,3575880904,49
0,1005,30235,3575880855,3575880905,50
0,1006,30236,3575880920,3575880920,0
0,1006,30237,3575880920,3575880920,0
0,1006,30238,3575880920,3575880920,0
0,1006,30239,3575880920,3575880920,0
0,1006,30240,3575880920,3575880920,0
0,1006,30241,3575880920,3575880920,0
0,1006,30242,3575880920,3575880920,0
0,1006,30243,3575880920,3575880920,0
0,1006,30244,3575880920,3575880920,0
0,1006,30245,3575880920,3575880920,0
0,1006,30246,3575880920,3575880920,0
0,1006,30247,3575880920,3575880920,0
0,1006,30248,3575880920,3575880920,0
0,1006,30249,3575880920,3575880920,0
0,1006,30250,3575880920,3575880920,0
0,1006,30251,3575880920,3575880920,0
0,1006,30252,3575880920,3575880920,0
0,1006,30253,3575880920,3575880920,0
0,1006,30254,3575880920,3575880920,0
0,1006,30255,3575880920,3575880920,0
0,1006,30256,3575880920,3575880920,0
0,1006,30257,3575880920,3575880920,0
0,1006,30258,3575880920,3575880921,1
0,1006,30259,3575880920,3575880922,2
0,1006,30260,3575880920,3575880922,2
0,1006,30261,3575880920,3575880923,3
0,1006,30262,3575880920,3575880923,3
0,1006,30263,3575880920,3575880924,4
0,1006,30264,3575880920,3575880924,4
0,1006,30265,3575880920,3575880924,4
0,1006,30266,3575880920,3575880925,5
0,1006,30267,3575880920,3575880925,5
0,1006,30268,3575880920,3575880926,6
0,1006,30269,3575880920,3575880926,6
0,1006,30270,3575880920,3575880927,7
0,1006,30271,3575880920,3575880928,8
0,1006,30272,3575880920,3575880929,9
0,1006,30273,3575880920,3575880929,9
0,1006,30274,3575880920,3575880929,9
0,1006,30275,3575880920,3575880930,10
0,1006,30276,3575880920,3575880931,11
0,1006,30277,3575880920,3575880932,12
0,1006,30278,3575880920,3575880932,12
0,1006,30279,3575880920,3575880935,15
0,1006,30280,3575880920,3575880936,16
0,1006,30281,3575880920,3575880937,17
0,1006,30282,3575880920,3575880937,17
0,1006,30283,3575880920,3575880938,18
0,1006,30284,3575880920,3575880939,19
0,1006,30285,3575880920,3575880939,19
0,1006,30286,3575880920,3575880939,19
0,1006,30287,3575880920,3575880940,20
0,1006,30288,3575880920,3575880940,20
0,1006,30289,3575880920,3575880940,20
0,1006,30290,3575880920,3575880940,20
0,1006,30291,3575880920,3575880940,20
0,1006,30292,3575880920,3575880940,20
0,1006,30293,3575880920,3575880942,22
0,1006,30294,3575880920,3575880942,22
0,1006,30295,3575880920,3575880944,24
0,1006,30296,3575880920,3575880944,24
0,1006,30297,3575880920,3575880945,25
0,1006,30298,3575880920,3575880945,25
0,1006,30299,3575880920,3575880946,26
0,1006,30300,3575880920,3575880946,26
0,1006,30301,3575880920,3575880946,26
0,1006,30302,3575880920,3575880947,27
0,1006,30303,3575880920,3575880948,28
0,1006,30304,3575880920,3575880948,28
0,1006,30305,3575880920,3575880949,29
0,1006,30306,3575880920,3575880950,30
0,1006,30307,3575880920,3575880952,32
0,1006,30308,3575880920,3575880953,33
0,1006,30309,3575880920,3575880954,34
0,1006,30310,3575880920,3575880954,34
0,1006,30311,3575880920,3575880955,35
0,1006,30312,3575880920,3575880955,35
0,1006,30313,3575880920,3575880956,36
0,1006,30314,3575880920,3575880957,37
0,1006,30315,3575880920,3575880957,37
0,1006,30316,3575880920,3575880958,38
0,1006,30317,3575880920,3575880958,38
0,1006,30318,3575880920,3575880959,39
0,1006,30319,3575880920,3575880959,39
0,1006,30320,3575880920,3575880960,40
0,1006,30321,3575880920,3575880960,40
0,1006,30322,3575880920,3575880962,42
0,1006,30323,3575880920,3575880962,42
0,1006,30324,3575880920,3575880964,44
0,1006,30325,3575880920,3575880964,44
0,1006,30326,3575880920,3575880964,44
0,1006,30327,3575880920,3575880964,44
0,1006,30328,3575880920,3575880965,45
0,1006,30329,3575880920,3575880965,45
0,1006,30330,3575880920,3575880965,45
0,1006,30331,3575880920,3575880966,46
0,1006,30332,3575880920,3575880966,46
0,1006,30333,3575880920,3575880969,49
0,1007,30334,3575880987,3575880987,0
0,1007,30335,3575880987,3575880987,0
0,1007,30336,3575880987,3575880987,0
0,1007,30337,3575880987,3575880987,0
0,1007,30338,3575880987,3575880987,0
0,1007,30339,3575880987,3575880987,0
0,1007,30340,3575880987,3575880987,0
0,1007,30341,3575880987,3575880987,0
0,1007,30342,3575880987,3575880987,0
0,1007,30343,3575880987,3575880988,1
0,1007,30344,3575880987,3575880988,1
0,1007,30345,3575880987,3575880988,1
0,1007,30346,3575880987,3575880988,1
0,1007,30347,3575880987,3575880988,1
0,1007,30348,3575880987,3575880988,1
0,1007,30349,3575880987,3575880988,1
0,1007,30350,3575880987,3575880988,1
0,1007,30351,3575880987,3575880988,1
0,1007,30352,3575880987,3575880988,1
0,1007,30353,3575880987,3575880988,1
0,1007,30354,3575880987,3575880988,1
0,1007,30355,3575880987,3575880990,3
0,1007,30356,3575880987,3575880994,7
0,1007,30357,3575880987,3575880995,8
0,1007,30358,3575880987,3575880995,8
0,1007,30359,3575880987,3575880998,11
0,1007,30360,3575880987,3575880999,12
0,1007,30361,3575880987,3575881001,14
0,1007,30362,3575880987,3575881001,14
0,1007,30363,3575880987,3575881001,14
0,1007,30364,3575880987,3575881002,15
0,1007,30365,3575880987,3575881004,17
0,1007,30366,3575880987,3575881005,18
0,1007,30367,3575880987,3575881006,19
0,1007,30368,3575880987,3575881006,19
0,1007,30369,3575880987,3575881006,19
0,1007,30370,3575880987,3575881007,20
0,1007,30371,3575880987,3575881009,22
0,1007,30372,3575880987,3575881010,23
0,1007,30373,3575880987,3575881010,23
0,1007,30374,3575880987,3575881012,25
0,1007,30375,3575880987,3575881013,26
0,1007,30376,3575880987,3575881013,26
0,1007,30377,3575880987,3575881014,27
0,1007,30378,3575880987,3575881014,27
0,1007,30379,3575880987,3575881014,27
0,1007,30380,3575880987,3575881015,28
0,1007,30381,3575880987,3575881016,29
0,1007,30382,3575880987,3575881017,30
0,1007,30383,3575880987,3575881018,31
0,1007,30384,3575880987,3575881018,31
0,1007,30385,3575880987,3575881018,31
0,1007,30386,3575880987,3575881020,33
0,1007,30387,3575880987,3575881021,34
0,1007,30388,3575880987,3575881022,35
0,1007,30389,3575880987,3575881025,38
0,1007,30390,3575880987,3575881027,40
0,1007,30391,3575880987,3575881028,41
0,1007,30392,3575880987,3575881029,42
0,1007,30393,3575880987,3575881029,42
0,1007,30394,3575880987,3575881029,42
0,1007,30395,3575880987,3575881029,42
0,1007,30396,3575880987,3575881030,43
0,1007,30397,3575880987,3575881031,44
0,1007,30398,3575880987,3575881032,45
0,1007,30399,3575880987,3575881032,45
0,1007,30400,3575880987,3575881032,45
0,1007,30401,3575880987,3575881033,46
0,1007,30402,3575880987,3575881033,46
0,1007,30403,3575880987,3575881033,46
0,1007,30404,3575880987,3575881033,46
0,1007,30405,3575880987,3575881034,47
0,1007,30406,3575880987,3575881035,48
0,1007,30407,3575880987,3575881035,48
0,1008,30408,3575881049,3575881049,0
0,1008,30409,3575881049,3575881049,0
0,1008,30410,3575881049,3575881049,0
0,1008,30411,3575881049,3575881049,0
0,1008,30412,3575881049,3575881049,0
0,1008,30413,3575881049,3575881049,0
0,1008,30414,3575881049,3575881049,0
0,1008,30415,3575881049,3575881049,0
0,1008,30416,3575881049,3575881049,0
0,1008,30417,3575881049,3575881049,0
0,1008,30418,3575881049,3575881049,0
0,1008,30419,3575881049,3575881049,0
0,1008,30420,3575881049,3575881051,2
0,1008,30421,3575881049,3575881051,2
0,1008,30422,3575881049,3575881052,3
0,1008,30423,3575881049,3575881052,3
0,1008,30424,3575881049,3575881054,5
0,1008,30425,3575881049,3575881055,6
0,1008,30426,3575881049,3575881056,7
0,1008,30427,3575881049,3575881056,7
0,1008,30428,3575881049,3575881057,8
0,1008,30429,3575881049,3575881058,9
0,1008,30430,3575881049,3575881058,9
0,1008,30431,3575881049,3575881060,11
0,1008,30432,3575881049,3575881060,11
0,1008,30433,3575881049,3575881061,12
0,1008,30434,3575881049,3575881061,12
0,1008,30435,3575881049,3575881061,12
0,1008,30436,3575881049,3575881061,12
0,1008,30437,3575881049,3575881062,13
0,1008,30438,3575881049,3575881064,15
0,1008,30439,3575881049,3575881064,15
0,1008,30440,3575881049,3575881064,15
0,1008,30441,3575881049,3575881065,16
0,1008,30442,3575881049,3575881065,16
0,1008,30443,3575881049,3575881066,17
0,1008,30444,3575881049,3575881066,17
0,1008,30445,3575881049,3575881066,17
0,1008,30446,3575881049,3575881066,17
0,1008,30447,3575881049,3575881067,18
0,1008,30448,3575881049,3575881068,19
0,1008,30449,3575881049,3575881068,19
0,1008,30450,3575881049,3575881075,26
0,1008,30451,3575881049,3575881075,26
0,1008,30452,3575881049,3575881076,27
0,1008,30453,3575881049,3575881078,29
0,1008,30454,3575881049,3575881081,32
0,1008,30455,3575881049,3575881083,34
0,1008,30456,3575881049,3575881084,35
0,1008,30457,3575881049,3575881085,36
0,1008,30458,3575881049,3575881085,36
0,1008,30459,3575881049,3575881086,37
0,1008,30460,3575881049,3575881086,37
0,1008,30461,3575881049,3575881086,37
0,1008,30462,3575881049,3575881087,38
0,1008,30463,3575881049,3575881087,38
0,1008,30464,3575881049,3575881090,41
0,1008,30465,3575881049,3575881091,42
0,1008,30466,3575881049,3575881091,42
0,1008,30467,3575881049,3575881091,42
0,1008,30468,3575881049,3575881092,43
0,1008,30469,3575881049,3575881093,44
0,1008,30470,3575881049,3575881093,44
0,1008,30471,3575881049,3575881094,45
0,1008,30472,3575881049,3575881095,46
0,1008,30473,3575881049,3575881095,46
0,1008,30474,3575881049,3575881095,46
0,1008,30475,3575881049,3575881095,46
0,1008,30476,3575881049,3575881096,47
0,1008,30477,3575881049,3575881096,47
0,1008,30478,3575881049,3575881096,47
0,1008,30479,3575881049,3575881096,47
0,1008,30480,3575881049,3575881097,48
0,1008,30481,3575881049,3575881099,50
0,1009,30482,3575881117,3575881117,0
0,1009,30483,3575881117,3575881117,0
0,1009,30484,3575881117,3575881117,0
0,1009,30485,3575881117,3575881117,0
0,1009,30486,3575881117,3575881117,0
0,1009,30487,3575881117,3575881117,0
0,1009,30488,3575881117,3575881117,0
0,1009,30489,3575881117,3575881117,0
0,1009,30490,3575881117,3575881117,0
0,1009,30491,3575881117,3575881117,0
0,1009,30492,3575881117,3575881117,0
0,1009,30493,3575881117,3575881117,0
0,1009,30494,3575881117,3575881117,0
0,1009,30495,3575881117,3575881117,0
0,1009,30496,3575881117,3575881117,0
0,1009,30497,3575881117,3575881117,0
0,1009,30498,3575881117,3575881117,0
0,1009,30499,3575881117,3575881117,0
0,1009,30500,3575881117,3575881117,0
0,1009,30501,3575881117,3575881117,0
0,1009,30502,3575881117,3575881117,0
0,1009,30503,3575881117,3575881117,0
0,1009,30504,3575881117,3575881117,0
0,1009,30505,3575881117,3575881117,0
0,1009,30506,3575881117,3575881117,0
0,1009,30507,3575881117,3575881117,0
0,1009,30508,3575881117,3575881117,0
0,1009,30509,3575881117,3575881117,0
0,1009,30510,3575881117,3575881117,0
0,1009,30511,3575881117,3575881117,0
0,1009,30512,3575881117,3575881118,1
0,1009,30513,3575881117,3575881119,2
0,1009,30514,3575881117,3575881120,3
0,1009,30515,3575881117,3575881121,4
0,1009,30516,3575881117,3575881122,5
0,1009,30517,3575881117,3575881122,5
0,1009,30518,3575881117,3575881123,6
0,1009,30519,3575881117,3575881123,6
0,1009,30520,3575881117,3575881124,7
0,1009,30521,3575881117,3575881124,7
0,1009,30522,3575881117,3575881124,7
0,1009,30523,3575881117,3575881125,8
0,1009,30524,3575881117,3575881125,8
0,1009,30525,3575881117,3575881125,8
0,1009,30526,3575881117,3575881126,9
0,1009,30527,3575881117,3575881126,9
0,1009,30528,3575881117,3575881128,11
0,1009,30529,3575881117,3575881128,11
0,1009,30530,3575881117,3575881129,12
0,1009,30531,3575881117,3575881129,12
0,1009,30532,3575881117,3575881129,12
0,1009,30533,3575881117,3575881130,13
0,1009,30534,3575881117,3575881130,13
0,1009,30535,3575881117,3575881133,16
0,1009,30536,3575881117,3575881135,18
0,1009,30537,3575881117,3575881136,19
0,1009,30538,3575881117,3575881136,19
0,1009,30539,3575881117,3575881136,19
0,1009,30540,3575881117,3575881137,20
0,1009,30541,3575881117,3575881139,22
0,1009,30542,3575881117,3575881139,22
0,1009,30543,3575881117,3575881139,22
0,1009,30544,3575881117,3575881139,22
0,1009,30545,3575881117,3575881139,22
0,1009,30546,3575881117,3575881140,23
0,1009,30547,3575881117,3575881140,23
0,1009,30548,3575881117,3575881140,23
0,1009,30549,3575881117,3575881140,23
0,1009,30550,3575881117,3575881140,23
0,1009,30551,3575881117,3575881142,25
0,1009,30552,3575881117,3575881142,25
0,1009,30553,3575881117,3575881142,25
0,1009,30554,3575881117,3575881144,27
0,1009,30555,3575881117,3575881144,27
0,1009,30556,3575881117,3575881145,28
0,1009,30557,3575881117,3575881146,29
0,1009,30558,3575881117,3575881146,29
0,1009,30559,3575881117,3575881146,29
0,1009,30560,3575881117,3575881146,29
0,1009,30561,3575881117,3575881147,30
0,1009,30562,3575881117,3575881148,31
0,1009,30563,3575881117,3575881149,32
0,1009,30564,3575881117,3575881149,32
0,1009,30565,3575881117,3575881149,32
0,1009,30566,3575881117,3575881150,33
0,1009,30567,3575881117,3575881152,35
0,1009,30568,3575881117,3575881153,36
0,1009,30569,3575881117,3575881154,37
0,1009,30570,3575881117,3575881154,37
0,1009,30571,3575881117,3575881154,37
0,1009,30572,3575881117,3575881155,38
0,1009,30573,3575881117,3575881157,40
0,1009,30574,3575881117,3575881158,41
0,1009,30575,3575881117,3575881158,41
0,1009,30576,3575881117,3575881158,41
0,1009,30577,3575881117,3575881160,43
0,1009,30578,3575881117,3575881160,43
0,1009,30579,3575881117,3575881160,43
0,1009,30580,3575881117,3575881161,44
0,1009,30581,3575881117,3575881162,45
0,1009,30582,3575881117,3575881162,45
0,1009,30583,3575881117,3575881162,45
0,1009,30584,3575881117,3575881164,47
0,1009,30585,3575881117,3575881164,47
0,1009,30586,3575881117,3575881164,47
0,1009,30587,3575881117,3575881164,47
0,1009,30588,3575881117,3575881165,48
0,1009,30589,3575881117,3575881165,48
0,1009,30590,3575881117,3575881166,49
0,1009,30591,3575881117,3575881166,49
0,1009,30592,3575881117,3575881166,49
0,1010,30593,3575881184,3575881184,0
0,1010,30594,3575881184,3575881184,0
0,1010,30595,3575881184,3575881184,0
0,1010,30596,3575881184,3575881184,0
0,1010,30597,3575881184,3575881184,0
0,1010,30598,3575881184,3575881184,0
0,1010,30599,3575881184,3575881184,0
0,1010,30600,3575881184,3575881184,0
0,1010,30601,3575881184,3575881184,0
0,1010,30602,3575881184,3575881184,0
0,1010,30603,3575881184,3575881184,0
0,1010,30604,3575881184,3575881184,0
0,1010,30605,3575881184,3575881184,0
0,1010,30606,3575881184,3575881184,0
0,1010,30607,3575881184,3575881184,0
0,1010,30608,3575881184,3575881184,0
0,1010,30609,3575881184,3575881184,0
0,1010,30610,3575881184,3575881184,0
0,1010,30611,3575881184,3575881187,3
0,1010,30612,3575881184,3575881187,3
0,1010,30613,3575881184,3575881187,3
0,1010,30614,3575881184,3575881189,5
0,1010,30615,3575881184,3575881189,5
0,1010,30616,3575881184,3575881194,10
0,1010,30617,3575881184,3575881195,11
0,1010,30618,3575881184,3575881196,12
0,1010,30619,3575881184,3575881198,14
0,1010,30620,3575881184,3575881198,14
0,1010,30621,3575881184,3575881200,16
0,1010,30622,3575881184,3575881201,17
0,1010,30623,3575881184,3575881201,17
0,1010,30624,3575881184,3575881202,18
0,1010,30625,3575881184,3575881205,21
0,1010,30626,3575881184,3575881205,21
0,1010,30627,3575881184,3575881205,21
0,1010,30628,3575881184,3575881206,22
0,1010,30629,3575881184,3575881207,23
0,1010,30630,3575881184,3575881209,25
0,1010,30631,3575881184,3575881210,26
0,1010,30632,3575881184,3575881210,26
0,1010,30633,3575881184,3575881212,28
0,1010,30634,3575881184,3575881214,30
0,1010,30635,3575881184,3575881214,30
0,1010,30636,3575881184,3575881214,30
0,1010,30637,3575881184,3575881215,31
0,1010,30638,3575881184,3575881216,32
0,1010,30639,3575881184,3575881218,34
0,1010,30640,3575881184,3575881218,34
0,1010,30641,3575881184,3575881218,34
0,1010,30642,3575881184,3575881219,35
0,1010,30643,3575881184,3575881221,37
0,1010,30644,3575881184,3575881221,37
0,1010,30645,3575881184,3575881222,38
0,1010,30646,3575881184,3575881225,41
0,1010,30647,3575881184,3575881228,44
0,1010,30648,3575881184,3575881228,44
0,1010,30649,3575881184,3575881229,45
0,1010,30650,3575881184,3575881229,45
0,1010,30651,3575881184,3575881230,46
0,1010,30652,3575881184,3575881230,46
0,1010,30653,3575881184,3575881231,47
0,1010,30654,3575881184,3575881232,48
0,1010,30655,3575881184,3575881232,48
0,1010,30656,3575881184,3575881232,48
0,1010,30657,3575881184,3575881232,48
0,1010,30658,3575881184,3575881234,50
0,1010,30659,3575881184,3575881234,50
0,1010,30660,3575881184,3575881234,50
0,1010,30661,3575881184,3575881234,50
0,1011,30662,3575881250,3575881250,0
0,1011,30663,3575881250,3575881250,0
0,1011,30664,3575881250,3575881250,0
0,1011,30665,3575881250,3575881250,0
0,1011,30666,3575881250,3575881250,0
0,1011,30667,3575881250,3575881250,0
0,1011,30668,3575881250,3575881250,0
0,1011,30669,3575881250,3575881250,0
0,1011,30670,3575881250,3575881250,0
0,1011,30671,3575881250,3575881250,0
0,1011,30672,3575881250,3575881250,0
0,1011,30673,3575881250,3575881250,0
0,1011,30674,3575881250,3575881250,0
0,1011,30675,3575881250,3575881251,1
0,1011,30676,3575881250,3575881252,2
0,1011,30677,3575881250,3575881252,2
0,1011,30678,3575881250,3575881255,5
0,1011,30679,3575881250,3575881255,5
0,1011,30680,3575881250,3575881256,6
0,1011,30681,3575881250,3575881257,7
0,1011,30682,3575881250,3575881257,7
0,1011,30683,3575881250,3575881258,8
0,1011,30684,3575881250,3575881260,10
0,1011,30685,3575881250,3575881260,10
0,1011,30686,3575881250,3575881260,10
0,1011,30687,3575881250,3575881261,11
0,1011,30688,3575881250,3575881261,11
0,1011,30689,3575881250,3575881261,11
0,1011,30690,3575881250,3575881262,12
0,1011,30691,3575881250,3575881264,14
0,1011,30692,3575881250,3575881264,14
0,1011,30693,3575881250,3575881264,14
0,1011,30694,3575881250,3575881265,15
0,1011,30695,3575881250,3575881265,15
0,1011,30696,3575881250,3575881265,15
0,1011,30697,3575881250,3575881266,16
0,1011,30698,3575881250,3575881266,16
0,1011,30699,3575881250,3575881267,17
0,1011,30700,3575881250,3575881267,17
0,1011,30701,3575881250,3575881267,17
0,1011,30702,3575881250,3575881269,19
0,1011,30703,3575881250,3575881269,19
0,1011,30704,3575881250,3575881275,25
0,1011,30705,3575881250,3575881275,25
0,1011,30706,3575881250,3575881278,28
0,1011,30707,3575881250,3575881281,31
0,1011,30708,3575881250,3575881283,33
0,1011,30709,3575881250,3575881284,34
0,1011,30710,3575881250,3575881285,35
0,1011,30711,3575881250,3575881286,36
0,1011,30712,3575881250,3575881287,37
0,1011,30713,3575881250,3575881287,37
0,1011,30714,3575881250,3575881287,37
0,1011,30715,3575881250,3575881287,37
0,1011,30716,3575881250,3575881291,41
0,1011,30717,3575881250,3575881291,41
0,1011,30718,3575881250,3575881291,41
0,1011,30719,3575881250,3575881291,41
0,1011,30720,3575881250,3575881292,42
0,1011,30721,3575881250,3575881293,43
0,1011,30722,3575881250,3575881293,43
0,1011,30723,3575881250,3575881294,44
0,1011,30724,3575881250,3575881295,45
0,1011,30725,3575881250,3575881295,45
0,1011,30726,3575881250,3575881295,45
0,1011,30727,3575881250,3575881295,45
0,1011,30728,3575881250,3575881295,45
0,1011,30729,3575881250,3575881296,46
0,1011,30730,3575881250,3575881297,47
0,1011,30731,3575881250,3575881298,48
0,1011,30732,3575881250,3575881299,49
0,1011,30733,3575881250,3575881299,49
0,1011,30734,3575881250,3575881299,49
0,1012,30735,3575881311,3575881311,0
0,1012,30736,3575881311,3575881311,0
0,1012,30737,3575881311,3575881311,0
0,1012,30738,3575881311,3575881311,0
0,1012,30739,3575881311,3575881311,0
0,1012,30740,3575881311,3575881311,0
0,1012,30741,3575881311,3575881311,0
0,1012,30742,3575881311,3575881311,0
0,1012,30743,3575881311,3575881311,0
0,1012,30744,3575881311,3575881311,0
0,1012,30745,3575881311,3575881311,0
0,1012,30746,3575881311,3575881311,0
0,1012,30747,3575881311,3575881311,0
0,1012,30748,3575881311,3575881311,0
0,1012,30749,3575881311,3575881311,0
0,1012,30750,3575881311,3575881311,0
0,1012,30751,3575881311,3575881311,0
0,1012,30752,3575881311,3575881311,0
0,1012,30753,3575881311,3575881311,0
0,1012,30754,3575881311,3575881311,0
0,1012,30755,3575881311,3575881313,2
0,1012,30756,3575881311,3575881313,2
0,1012,30757,3575881311,3575881314,3
0,1012,30758,3575881311,3575881314,3
0,1012,30759,3575881311,3575881315,4
0,1012,30760,3575881311,3575881315,4
0,1012,30761,3575881311,3575881316,5
0,1012,30762,3575881311,3575881317,6
0,1012,30763,3575881311,3575881318,7
0,1012,30764,3575881311,3575881318,7
0,1012,30765,3575881311,3575881320,9
0,1012,30766,3575881311,3575881320,9
0,1012,30767,3575881311,3575881320,9
0,1012,30768,3575881311,3575881321,10
0,1012,30769,3575881311,3575881322,11
0,1012,30770,3575881311,3575881323,12
0,1012,30771,3575881311,3575881323,12
0,1012,30772,3575881311,3575881323,12
0,1012,30773,3575881311,3575881324,13
0,1012,30774,3575881311,3575881324,13
0,1012,30775,3575881311,3575881324,13
0,1012,30776,3575881311,3575881325,14
0,1012,30777,3575881311,3575881326,15
0,1012,30778,3575881311,3575881326,15
0,1012,30779,3575881311,3575881326,15
0,1012,30780,3575881311,3575881328,17
0,1012,30781,3575881311,3575881328,17
0,1012,30782,3575881311,3575881328,17
0,1012,30783,3575881311,3575881329,18
0,1012,30784,3575881311,3575881329,18
0,1012,30785,3575881311,3575881330,19
0,1012,30786,3575881311,3575881331,20
0,1012,30787,3575881311,3575881333,22
0,1012,30788,3575881311,3575881334,23
0,1012,30789,3575881311,3575881335,24
0,1012,30790,3575881311,3575881336,25
0,1012,30791,3575881311,3575881336,25
0,1012,30792,3575881311,3575881337,26
0,1012,30793,3575881311,3575881337,26
0,1012,30794,3575881311,3575881339,28
0,1012,30795,3575881311,3575881340,29
0,1012,30796,3575881311,3575881340,29
0,1012,30797,3575881311,3575881340,29
0,1012,30798,3575881311,3575881340,29
0,1012,30799,3575881311,3575881340,29
0,1012,30800,3575881311,3575881340,29
0,1012,30801,3575881311,3575881340,29
0,1012,30802,3575881311,3575881342,31
0,1012,30803,3575881311,3575881342,31
0,1012,30804,3575881311,3575881345,34
0,1012,30805,3575881311,3575881345,34
0,1012,30806,3575881311,3575881345,34
0,1012,30807,3575881311,3575881346,35
0,1012,30808,3575881311,3575881346,35
0,1012,30809,3575881311,3575881346,35
0,1012,30810,3575881311,3575881347,36
0,1012,30811,3575881311,3575881348,37
0,1012,30812,3575881311,3575881348,37
0,1012,30813,3575881311,3575881348,37
0,1012,30814,3575881311,3575881349,38
0,1012,30815,3575881311,3575881350,39
0,1012,30816,3575881311,3575881353,42
0,1012,30817,3575881311,3575881353,42
0,1012,30818,3575881311,3575881353,42
0,1012,30819,3575881311,3575881354,43
0,1012,30820,3575881311,3575881355,44
0,1012,30821,3575881311,3575881355,44
0,1012,30822,3575881311,3575881357,46
0,1012,30823,3575881311,3575881358,47
0,1012,30824,3575881311,3575881358,47
0,1012,30825,3575881311,3575881358,47
0,1012,30826,3575881311,3575881360,49
0,1012,30827,3575881311,3575881360,49
0,1012,30828,3575881311,3575881360,49
0,1013,30829,3575881374,3575881374,0
0,1013,30830,3575881374,3575881374,0
0,1013,30831,3575881374,3575881374,0
0,1013,30832,3575881374,3575881374,0
0,1013,30833,3575881374,3575881374,0
0,1013,30834,3575881374,3575881374,0
0,1013,30835,3575881374,3575881374,0
0,1013,30836,3575881374,3575881374,0
0,1013,30837,3575881374,3575881374,0
0,1013,30838,3575881374,3575881374,0
0,1013,30839,3575881374,3575881374,0
0,1013,30840,3575881374,3575881374,0
0,1013,30841,3575881374,3575881374,0
0,1013,30842,3575881374,3575881374,0
0,1013,30843,3575881374,3575881374,0
0,1013,30844,3575881374,3575881374,0
0,1013,30845,3575881374,3575881374,0
0,1013,30846,3575881374,3575881375,1
0,1013,30847,3575881374,3575881376,2
0,1013,30848,3575881374,3575881376,2
0,1013,30849,3575881374,3575881377,3
0,1013,30850,3575881374,3575881377,3
0,1013,30851,3575881374,3575881378,4
0,1013,30852,3575881374,3575881378,4
0,1013,30853,3575881374,3575881378,4
0,1013,30854,3575881374,3575881378,4
0,1013,30855,3575881374,3575881379,5
0,1013,30856,3575881374,3575881380,6
0,1013,30857,3575881374,3575881382,8
0,1013,30858,3575881374,3575881383,9
0,1013,30859,3575881374,3575881385,11
0,1013,30860,3575881374,3575881387,13
0,1013,30861,3575881374,3575881387,13
0,1013,30862,3575881374,3575881387,13
0,1013,30863,3575881374,3575881390,16
0,1013,30864,3575881374,3575881390,16
0,1013,30865,3575881374,3575881394,20
0,1013,30866,3575881374,3575881395,21
0,1013,30867,3575881374,3575881396,22
0,1013,30868,3575881374,3575881398,24
0,1013,30869,3575881374,3575881399,25
0,1013,30870,3575881374,3575881401,27
0,1013,30871,3575881374,3575881401,27
0,1013,30872,3575881374,3575881402,28
0,1013,30873,3575881374,3575881402,28
0,1013,30874,3575881374,3575881405,31
0,1013,30875,3575881374,3575881405,31
0,1013,30876,3575881374,3575881406,32
0,1013,30877,3575881374,3575881407,33
0,1013,30878,3575881374,3575881410,36
0,1013,30879,3575881374,3575881410,36
0,1013,30880,3575881374,3575881411,37
0,1013,30881,3575881374,3575881412,38
0,1013,30882,3575881374,3575881412,38
0,1013,30883,3575881374,3575881414,40
0,1013,30884,3575881374,3575881414,40
0,1013,30885,3575881374,3575881415,41
0,1013,30886,3575881374,3575881416,42
0,1013,30887,3575881374,3575881418,44
0,1013,30888,3575881374,3575881418,44
0,1013,30889,3575881374,3575881418,44
0,1013,30890,3575881374,3575881421,47
0,1013,30891,3575881374,3575881422,48
0,1013,30892,3575881374,3575881422,48
0,1013,30893,3575881374,3575881423,49
0,1014,30894,3575881443,3575881443,0
0,1014,30895,3575881443,3575881443,0
0,1014,30896,3575881443,3575881443,0
0,1014,30897,3575881443,3575881443,0
0,1014,30898,3575881443,3575881443,0
0,1014,30899,3575881443,3575881443,0
0,1014,30900,3575881443,3575881443,0
0,1014,30901,3575881443,3575881443,0
0,1014,30902,3575881443,3575881443,0
0,1014,30903,3575881443,3575881443,0
0,1014,30904,3575881443,3575881443,0
0,1014,30905,3575881443,3575881443,0
0,1014,30906,3575881443,3575881443,0
0,1014,30907,3575881443,3575881443,0
0,1014,30908,3575881443,3575881443,0
0,1014,30909,3575881443,3575881443,0
0,1014,30910,3575881443,3575881443,0
0,1014,30911,3575881443,3575881443,0
0,1014,30912,3575881443,3575881444,1
0,1014,30913,3575881443,3575881444,1
0,1014,30914,3575881443,3575881444,1
0,1014,30915,3575881443,3575881444,1
0,1014,30916,3575881443,3575881444,1
0,1014,30917,3575881443,3575881444,1
0,1014,30918,3575881443,3575881447,4
0,1014,30919,3575881443,3575881448,5
0,1014,30920,3575881443,3575881449,6
0,1014,30921,3575881443,3575881449,6
0,1014,30922,3575881443,3575881449,6
0,1014,30923,3575881443,3575881451,8
0,1014,30924,3575881443,3575881452,9
0,1014,30925,3575881443,3575881452,9
0,1014,30926,3575881443,3575881455,12
0,1014,30927,3575881443,3575881456,13
0,1014,30928,3575881443,3575881457,14
0,1014,30929,3575881443,3575881457,14
0,1014,30930,3575881443,3575881457,14
0,1014,30931,3575881443,3575881457,14
0,1014,30932,3575881443,3575881460,17
0,1014,30933,3575881443,3575881461,18
0,1014,30934,3575881443,3575881461,18
0,1014,30935,3575881443,3575881461,18
0,1014,30936,3575881443,3575881461,18
0,1014,30937,3575881443,3575881461,18
0,1014,30938,3575881443,3575881463,20
0,1014,30939,3575881443,3575881464,21
0,1014,30940,3575881443,3575881464,21
0,1014,30941,3575881443,3575881464,21
0,1014,30942,3575881443,3575881465,22
0,1014,30943,3575881443,3575881466,23
0,1014,30944,3575881443,3575881466,23
0,1014,30945,3575881443,3575881466,23
0,1014,30946,3575881443,3575881466,23
0,1014,30947,3575881443,3575881467,24
0,1014,30948,3575881443,3575881468,25
0,1014,30949,3575881443,3575881468,25
0,1014,30950,3575881443,3575881473,30
0,1014,30951,3575881443,3575881475,32
0,1014,30952,3575881443,3575881476,33
0,1014,30953,3575881443,3575881478,35
0,1014,30954,3575881443,3575881479,36
0,1014,30955,3575881443,3575881481,38
0,1014,30956,3575881443,3575881483,40
0,1014,30957,3575881443,3575881485,42
0,1014,30958,3575881443,3575881489,46
0,1014,30959,3575881443,3575881489,46
0,1014,30960,3575881443,3575881489,46
0,1014,30961,3575881443,3575881489,46
0,1014,30962,3575881443,3575881489,46
0,1014,30963,3575881443,3575881489,46
0,1014,30964,3575881443,3575881491,48
0,1014,30965,3575881443,3575881491,48
0,1014,30966,3575881443,3575881492,49
0,1014,30967,3575881443,3575881492,49
0,1014,30968,3575881443,3575881492,49
0,1015,30969,3575881508,3575881508,0
0,1015,30970,3575881508,3575881508,0
0,1015,30971,3575881508,3575881508,0
0,1015,30972,3575881508,3575881508,0
0,1015,30973,3575881508,3575881508,0
0,1015,30974,3575881508,3575881508,0
0,1015,30975,3575881508,3575881508,0
0,1015,30976,3575881508,3575881508,0
0,1015,30977,3575881508,3575881508,0
0,1015,30978,3575881508,3575881508,0
0,1015,30979,3575881508,3575881508,0
0,1015,30980,3575881508,3575881508,0
0,1015,30981,3575881508,3575881508,0
0,1015,30982,3575881508,3575881508,0
0,1015,30983,3575881508,3575881508,0
0,1015,30984,3575881508,3575881508,0
0,1015,30985,3575881508,3575881508,0
0,1015,30986,3575881508,3575881508,0
0,1015,30987,3575881508,3575881508,0
0,1015,30988,3575881508,3575881508,0
0,1015,30989,3575881508,3575881508,0
0,1015,30990,3575881508,3575881508,0
0,1015,30991,3575881508,3575881509,1
0,1015,30992,3575881508,3575881509,1
0,1015,30993,3575881508,3575881509,1
0,1015,30994,3575881508,3575881509,1
0,1015,30995,3575881508,3575881509,1
0,1015,30996,3575881508,3575881509,1
0,1015,30997,3575881508,3575881509,1
0,1015,30998,3575881508,3575881510,2
0,1015,30999,3575881508,3575881510,2
0,1015,31000,3575881508,3575881511,3
0,1015,31001,3575881508,3575881512,4
0,1015,31002,3575881508,3575881512,4
0,1015,31003,3575881508,3575881513,5
0,1015,31004,3575881508,3575881513,5
0,1015,31005,3575881508,3575881514,6
0,1015,31006,3575881508,3575881514,6
0,1015,31007,3575881508,3575881515,7
0,1015,31008,3575881508,3575881516,8
0,1015,31009,3575881508,3575881517,9
0,1015,31010,3575881508,3575881518,10
0,1015,31011,3575881508,3575881519,11
0,1015,31012,3575881508,3575881520,12
0,1015,31013,3575881508,3575881520,12
0,1015,31014,3575881508,3575881521,13
0,1015,31015,3575881508,3575881522,14
0,1015,31016,3575881508,3575881522,14
0,1015,31017,3575881508,3575881523,15
0,1015,31018,3575881508,3575881523,15
0,1015,31019,3575881508,3575881524,16
0,1015,31020,3575881508,3575881524,16
0,1015,31021,3575881508,3575881525,17
0,1015,31022,3575881508,3575881525,17
0,1015,31023,3575881508,3575881525,17
0,1015,31024,3575881508,3575881526,18
0,1015,31025,3575881508,3575881526,18
0,1015,31026,3575881508,3575881527,19
0,1015,31027,3575881508,3575881527,19
0,1015,31028,3575881508,3575881527,19
0,1015,31029,3575881508,3575881528,20
0,1015,31030,3575881508,3575881528,20
0,1015,31031,3575881508,3575881529,21
0,1015,31032,3575881508,3575881530,22
0,1015,31033,3575881508,3575881533,25
0,1015,31034,3575881508,3575881534,26
0,1015,31035,3575881508,3575881535,27
0,1015,31036,3575881508,3575881536,28
0,1015,31037,3575881508,3575881536,28
0,1015,31038,3575881508,3575881536,28
0,1015,31039,3575881508,3575881538,30
0,1015,31040,3575881508,3575881538,30
0,1015,31041,3575881508,3575881538,30
0,1015,31042,3575881508,3575881539,31
0,1015,31043,3575881508,3575881539,31
0,1015,31044,3575881508,3575881539,31
0,1015,31045,3575881508,3575881539,31
0,1015,31046,3575881508,3575881539,31
0,1015,31047,3575881508,3575881540,32
0,1015,31048,3575881508,3575881540,32
0,1015,31049,3575881508,3575881541,33
0,1015,31050,3575881508,3575881541,33
0,1015,31051,3575881508,3575881542,34
0,1015,31052,3575881508,3575881544,36
0,1015,31053,3575881508,3575881544,36
0,1015,31054,3575881508,3575881544,36
0,1015,31055,3575881508,3575881545,37
0,1015,31056,3575881508,3575881545,37
0,1015,31057,3575881508,3575881545,37
0,1015,31058,3575881508,3575881546,38
0,1015,31059,3575881508,3575881547,39
0,1015,31060,3575881508,3575881547,39
0,1015,31061,3575881508,3575881548,40
0,1015,31062,3575881508,3575881551,43
0,1015,31063,3575881508,3575881551,43
0,1015,31064,3575881508,3575881552,44
0,1015,31065,3575881508,3575881552,44
0,1015,31066,3575881508,3575881554,46
0,1015,31067,3575881508,3575881554,46
0,1015,31068,3575881508,3575881554,46
0,1015,31069,3575881508,3575881556,48
0,1015,31070,3575881508,3575881557,49
0,1015,31071,3575881508,3575881557,49
0,1015,31072,3575881508,3575881558,50
0,1016,31073,3575881576,3575881576,0
0,1016,31074,3575881576,3575881576,0
0,1016,31075,3575881576,3575881576,0
0,1016,31076,3575881576,3575881576,0
0,1016,31077,3575881576,3575881576,0
0,1016,31078,3575881576,3575881576,0
0,1016,31079,3575881576,3575881576,0
0,1016,31080,3575881576,3575881576,0
0,1016,31081,3575881576,3575881576,0
0,1016,31082,3575881576,3575881576,0
0,1016,31083,3575881576,3575881576,0
0,1016,31084,3575881576,3575881576,0
0,1016,31085,3575881576,3575881576,0
0,1016,31086,3575881576,3575881576,0
0,1016,31087,3575881576,3575881576,0
0,1016,31088,3575881576,3575881576,0
0,1016,31089,3575881576,3575881576,0
0,1016,31090,3575881576,3575881576,0
0,1016,31091,3575881576,3575881576,0
0,1016,31092,3575881576,3575881576,0
0,1016,31093,3575881576,3575881576,0
0,1016,31094,3575881576,3575881576,0
0,1016,31095,3575881576,3575881576,0
0,1016,31096,3575881576,3575881576,0
0,1016,31097,3575881576,3575881577,1
0,1016,31098,3575881576,3575881577,1
0,1016,31099,3575881576,3575881577,1
0,1016,31100,3575881576,3575881578,2
0,1016,31101,3575881576,3575881578,2
0,1016,31102,3575881576,3575881578,2
0,1016,31103,3575881576,3575881578,2
0,1016,31104,3575881576,3575881581,5
0,1016,31105,3575881576,3575881582,6
0,1016,31106,3575881576,3575881584,8
0,1016,31107,3575881576,3575881586,10
0,1016,31108,3575881576,3575881586,10
0,1016,31109,3575881576,3575881586,10
0,1016,31110,3575881576,3575881588,12
0,1016,31111,3575881576,3575881589,13
0,1016,31112,3575881576,3575881593,17
0,1016,31113,3575881576,3575881594,18
0,1016,31114,3575881576,3575881595,19
0,1016,31115,3575881576,3575881598,22
0,1016,31116,3575881576,3575881598,22
0,1016,31117,3575881576,3575881600,24
0,1016,31118,3575881576,3575881600,24
0,1016,31119,3575881576,3575881600,24
0,1016,31120,3575881576,3575881601,25
0,1016,31121,3575881576,3575881604,28
0,1016,31122,3575881576,3575881605,29
0,1016,31123,3575881576,3575881605,29
0,1016,31124,3575881576,3575881606,30
0,1016,31125,3575881576,3575881607,31
0,1016,31126,3575881576,3575881609,33
0,1016,31127,3575881576,3575881609,33
0,1016,31128,3575881576,3575881611,35
0,1016,31129,3575881576,3575881612,36
0,1016,31130,3575881576,3575881613,37
0,1016,31131,3575881576,3575881613,37
0,1016,31132,3575881576,3575881614,38
0,1016,31133,3575881576,3575881615,39
0,1016,31134,3575881576,3575881616,40
0,1016,31135,3575881576,3575881617,41
0,1016,31136,3575881576,3575881617,41
0,1016,31137,3575881576,3575881620,44
0,1016,31138,3575881576,3575881620,44
0,1016,31139,3575881576,3575881621,45
0,1016,31140,3575881576,3575881622,46
0,1016,31141,3575881576,3575881624,48
0,1017,31142,3575881637,3575881637,0
0,1017,31143,3575881637,3575881637,0
0,1017,31144,3575881637,3575881637,0
0,1017,31145,3575881637,3575881637,0
0,1017,31146,3575881637,3575881637,0
0,1017,31147,3575881637,3575881637,0
0,1017,31148,3575881637,3575881637,0
0,1017,31149,3575881637,3575881637,0
0,1017,31150,3575881637,3575881637,0
0,1017,31151,3575881637,3575881637,0
0,1017,31152,3575881637,3575881637,0
0,1017,31153,3575881637,3575881637,0
0,1017,31154,3575881637,3575881637,0
0,1017,31155,3575881637,3575881637,0
0,1017,31156,3575881637,3575881637,0
0,1017,31157,3575881637,3575881637,0
0,1017,31158,3575881637,3575881639,2
0,1017,31159,3575881637,3575881640,3
0,1017,31160,3575881637,3575881641,4
0,1017,31161,3575881637,3575881641,4
0,1017,31162,3575881637,3575881641,4
0,1017,31163,3575881637,3575881642,5
0,1017,31164,3575881637,3575881643,6
0,1017,31165,3575881637,3575881644,7
0,1017,31166,3575881637,3575881645,8
0,1017,31167,3575881637,3575881646,9
0,1017,31168,3575881637,3575881647,10
0,1017,31169,3575881637,3575881648,11
0,1017,31170,3575881637,3575881648,11
0,1017,31171,3575881637,3575881648,11
0,1017,31172,3575881637,3575881649,12
0,1017,31173,3575881637,3575881651,14
0,1017,31174,3575881637,3575881651,14
0,1017,31175,3575881637,3575881654,17
0,1017,31176,3575881637,3575881655,18
0,1017,31177,3575881637,3575881656,19
0,1017,31178,3575881637,3575881656,19
0,1017,31179,3575881637,3575881657,20
0,1017,31180,3575881637,3575881658,21
0,1017,31181,3575881637,3575881658,21
0,1017,31182,3575881637,3575881659,22
0,1017,31183,3575881637,3575881660,23
0,1017,31184,3575881637,3575881660,23
0,1017,31185,3575881637,3575881660,23
0,1017,31186,3575881637,3575881661,24
0,1017,31187,3575881637,3575881662,25
0,1017,31188,3575881637,3575881662,25
0,1017,31189,3575881637,3575881663,26
0,1017,31190,3575881637,3575881663,26
0,1017,31191,3575881637,3575881664,27
0,1017,31192,3575881637,3575881664,27
0,1017,31193,3575881637,3575881665,28
0,1017,31194,3575881637,3575881665,28
0,1017,31195,3575881637,3575881666,29
0,1017,31196,3575881637,3575881666,29
0,1017,31197,3575881637,3575881667,30
0,1017,31198,3575881637,3575881667,30
0,1017,31199,3575881637,3575881669,32
0,1017,31200,3575881637,3575881675,38
0,1017,31201,3575881637,3575881675,38
0,1017,31202,3575881637,3575881675,38
0,1017,31203,3575881637,3575881677,40
0,1017,31204,3575881637,3575881678,41
0,1017,31205,3575881637,3575881681,44
0,1017,31206,3575881637,3575881683,46
0,1017,31207,3575881637,3575881684,47
0,1017,31208,3575881637,3575881685,48
0,1017,31209,3575881637,3575881685,48
0,1017,31210,3575881637,3575881687,50
0,1018,31211,3575881702,3575881702,0
0,1018,31212,3575881702,3575881702,0
0,1018,31213,3575881702,3575881702,0
0,1018,31214,3575881702,3575881702,0
0,1018,31215,3575881702,3575881702,0
0,1018,31216,3575881702,3575881702,0
0,1018,31217,3575881702,3575881702,0
0,1018,31218,3575881702,3575881702,0
0,1018,31219,3575881702,3575881702,0
0,1018,31220,3575881702,3575881702,0
0,1018,31221,3575881702,3575881702,0
0,1018,31222,3575881702,3575881702,0
0,1018,31223,3575881702,3575881702,0
0,1018,31224,3575881702,3575881703,1
0,1018,31225,3575881702,3575881703,1
0,1018,31226,3575881702,3575881703,1
0,1018,31227,3575881702,3575881703,1
0,1018,31228,3575881702,3575881703,1
0,1018,31229,3575881702,3575881703,1
0,1018,31230,3575881702,3575881703,1
0,1018,31231,3575881702,3575881703,1
0,1018,31232,3575881702,3575881703,1
0,1018,31233,3575881702,3575881703,1
0,1018,31234,3575881702,3575881703,1
0,1018,31235,3575881702,3575881703,1
0,1018,31236,3575881702,3575881703,1
0,1018,31237,3575881702,3575881703,1
0,1018,31238,3575881702,3575881703,1
0,1018,31239,3575881702,3575881703,1
0,1018,31240,3575881702,3575881705,3
0,1018,31241,3575881702,3575881705,3
0,1018,31242,3575881702,3575881706,4
0,1018,31243,3575881702,3575881706,4
0,1018,31244,3575881702,3575881707,5
0,1018,31245,3575881702,3575881708,6
0,1018,31246,3575881702,3575881708,6
0,1018,31247,3575881702,3575881709,7
0,1018,31248,3575881702,3575881709,7
0,1018,31249,3575881702,3575881710,8
0,1018,31250,3575881702,3575881710,8
0,1018,31251,3575881702,3575881710,8
0,1018,31252,3575881702,3575881712,10
0,1018,31253,3575881702,3575881712,10
0,1018,31254,3575881702,3575881712,10
0,1018,31255,3575881702,3575881713,11
0,1018,31256,3575881702,3575881713,11
0,1018,31257,3575881702,3575881714,12
0,1018,31258,3575881702,3575881715,13
0,1018,31259,3575881702,3575881716,14
0,1018,31260,3575881702,3575881717,15
0,1018,31261,3575881702,3575881718,16
0,1018,31262,3575881702,3575881718,16
0,1018,31263,3575881702,3575881719,17
0,1018,31264,3575881702,3575881719,17
0,1018,31265,3575881702,3575881719,17
0,1018,31266,3575881702,3575881721,19
0,1018,31267,3575881702,3575881722,20
0,1018,31268,3575881702,3575881722,20
0,1018,31269,3575881702,3575881723,21
0,1018,31270,3575881702,3575881724,22
0,1018,31271,3575881702,3575881724,22
0,1018,31272,3575881702,3575881724,22
0,1018,31273,3575881702,3575881724,22
0,1018,31274,3575881702,3575881725,23
0,1018,31275,3575881702,3575881726,24
0,1018,31276,3575881702,3575881726,24
0,1018,31277,3575881702,3575881727,25
0,1018,31278,3575881702,3575881727,25
0,1018,31279,3575881702,3575881727,25
0,1018,31280,3575881702,3575881728,26
0,1018,31281,3575881702,3575881728,26
0,1018,31282,3575881702,3575881730,28
0,1018,31283,3575881702,3575881730,28
0,1018,31284,3575881702,3575881732,30
0,1018,31285,3575881702,3575881734,32
0,1018,31286,3575881702,3575881734,32
0,1018,31287,3575881702,3575881735,33
0,1018,31288,3575881702,3575881736,34
0,1018,31289,3575881702,3575881737,35
0,1018,31290,3575881702,3575881737,35
0,1018,31291,3575881702,3575881738,36
0,1018,31292,3575881702,3575881739,37
0,1018,31293,3575881702,3575881739,37
0,1018,31294,3575881702,3575881739,37
0,1018,31295,3575881702,3575881739,37
0,1018,31296,3575881702,3575881739,37
0,1018,31297,3575881702,3575881740,38
0,1018,31298,3575881702,3575881740,38
0,1018,31299,3575881702,3575881741,39
0,1018,31300,3575881702,3575881741,39
0,1018,31301,3575881702,3575881741,39
0,1018,31302,3575881702,3575881744,42
0,1018,31303,3575881702,3575881744,42
0,1018,31304,3575881702,3575881745,43
0,1018,31305,3575881702,3575881745,43
0,1018,31306,3575881702,3575881745,43
0,1018,31307,3575881702,3575881746,44
0,1018,31308,3575881702,3575881747,45
0,1018,31309,3575881702,3575881747,45
0,1018,31310,3575881702,3575881748,46
0,1018,31311,3575881702,3575881748,46
0,1018,31312,3575881702,3575881752,50
0,1019,31313,3575881768,3575881768,0
0,1019,31314,3575881768,3575881768,0
0,1019,31315,3575881768,3575881768,0
0,1019,31316,3575881768,3575881768,0
0,1019,31317,3575881768,3575881768,0
0,1019,31318,3575881768,3575881768,0
0,1019,31319,3575881768,3575881768,0
0,1019,31320,3575881768,3575881768,0
0,1019,31321,3575881768,3575881768,0
0,1019,31322,3575881768,3575881768,0
0,1019,31323,3575881768,3575881768,0
0,1019,31324,3575881768,3575881768,0
0,1019,31325,3575881768,3575881768,0
0,1019,31326,3575881768,3575881768,0
0,1019,31327,3575881768,3575881768,0
0,1019,31328,3575881768,3575881768,0
0,1019,31329,3575881768,3575881768,0
0,1019,31330,3575881768,3575881768,0
0,1019,31331,3575881768,3575881768,0
0,1019,31332,3575881768,3575881768,0
0,1019,31333,3575881768,3575881768,0
0,1019,31334,3575881768,3575881768,0
0,1019,31335,3575881768,3575881768,0
0,1019,31336,3575881768,3575881768,0
0,1019,31337,3575881768,3575881768,0
0,1019,31338,3575881768,3575881768,0
0,1019,31339,3575881768,3575881768,0
0,1019,31340,3575881768,3575881770,2
0,1019,31341,3575881768,3575881770,2
0,1019,31342,3575881768,3575881771,3
0,1019,31343,3575881768,3575881772,4
0,1019,31344,3575881768,3575881775,7
0,1019,31345,3575881768,3575881775,7
0,1019,31346,3575881768,3575881775,7
0,1019,31347,3575881768,3575881776,8
0,1019,31348,3575881768,3575881777,9
0,1019,31349,3575881768,3575881777,9
0,1019,31350,3575881768,3575881777,9
0,1019,31351,3575881768,3575881778,10
0,1019,31352,3575881768,3575881778,10
0,1019,31353,3575881768,3575881779,11
0,1019,31354,3575881768,3575881780,12
0,1019,31355,3575881768,3575881782,14
0,1019,31356,3575881768,3575881782,14
0,1019,31357,3575881768,3575881784,16
0,1019,31358,3575881768,3575881786,18
0,1019,31359,3575881768,3575881786,18
0,1019,31360,3575881768,3575881787,19
0,1019,31361,3575881768,3575881788,20
0,1019,31362,3575881768,3575881789,21
0,1019,31363,3575881768,3575881793,25
0,1019,31364,3575881768,3575881794,26
0,1019,31365,3575881768,3575881795,27
0,1019,31366,3575881768,3575881797,29
0,1019,31367,3575881768,3575881799,31
0,1019,31368,3575881768,3575881799,31
0,1019,31369,3575881768,3575881800,32
0,1019,31370,3575881768,3575881800,32
0,1019,31371,3575881768,3575881801,33
0,1019,31372,3575881768,3575881802,34
0,1019,31373,3575881768,3575881805,37
0,1019,31374,3575881768,3575881805,37
0,1019,31375,3575881768,3575881805,37
0,1019,31376,3575881768,3575881806,38
0,1019,31377,3575881768,3575881808,40
0,1019,31378,3575881768,3575881810,42
0,1019,31379,3575881768,3575881812,44
0,1019,31380,3575881768,3575881812,44
0,1019,31381,3575881768,3575881813,45
0,1019,31382,3575881768,3575881813,45
0,1019,31383,3575881768,3575881813,45
0,1019,31384,3575881768,3575881814,46
0,1019,31385,3575881768,3575881815,47
0,1019,31386,3575881768,3575881815,47
0,1019,31387,3575881768,3575881816,48
0,1019,31388,3575881768,3575881816,48
0,1019,31389,3575881768,3575881818,50
0,1020,31390,3575881832,3575881832,0
0,1020,31391,3575881832,3575881832,0
0,1020,31392,3575881832,3575881832,0
0,1020,31393,3575881832,3575881832,0
0,1020,31394,3575881832,3575881832,0
0,1020,31395,3575881832,3575881832,0
0,1020,31396,3575881832,3575881832,0
0,1020,31397,3575881832,3575881832,0
0,1020,31398,3575881832,3575881832,0
0,1020,31399,3575881832,3575881832,0
0,1020,31400,3575881832,3575881832,0
0,1020,31401,3575881832,3575881832,0
0,1020,31402,3575881832,3575881832,0
0,1020,31403,3575881832,3575881832,0
0,1020,31404,3575881832,3575881832,0
0,1020,31405,3575881832,3575881832,0
0,1020,31406,3575881832,3575881832,0
0,1020,31407,3575881832,3575881832,0
0,1020,31408,3575881832,3575881832,0
0,1020,31409,3575881832,3575881833,1
0,1020,31410,3575881832,3575881834,2
0,1020,31411,3575881832,3575881834,2
0,1020,31412,3575881832,3575881834,2
0,1020,31413,3575881832,3575881839,7
0,1020,31414,3575881832,3575881840,8
0,1020,31415,3575881832,3575881840,8
0,1020,31416,3575881832,3575881842,10
0,1020,31417,3575881832,3575881843,11
0,1020,31418,3575881832,3575881843,11
0,1020,31419,3575881832,3575881844,12
0,1020,31420,3575881832,3575881846,14
0,1020,31421,3575881832,3575881847,15
0,1020,31422,3575881832,3575881847,15
0,1020,31423,3575881832,3575881848,16
0,1020,31424,3575881832,3575881848,16
0,1020,31425,3575881832,3575881848,16
0,1020,31426,3575881832,3575881849,17
0,1020,31427,3575881832,3575881850,18
0,1020,31428,3575881832,3575881850,18
0,1020,31429,3575881832,3575881851,19
0,1020,31430,3575881832,3575881851,19
0,1020,31431,3575881832,3575881854,22
0,1020,31432,3575881832,3575881855,23
0,1020,31433,3575881832,3575881855,23
0,1020,31434,3575881832,3575881856,24
0,1020,31435,3575881832,3575881856,24
0,1020,31436,3575881832,3575881857,25
0,1020,31437,3575881832,3575881859,27
0,1020,31438,3575881832,3575881859,27
0,1020,31439,3575881832,3575881859,27
0,1020,31440,3575881832,3575881860,28
0,1020,31441,3575881832,3575881861,29
0,1020,31442,3575881832,3575881861,29
0,1020,31443,3575881832,3575881862,30
0,1020,31444,3575881832,3575881862,30
0,1020,31445,3575881832,3575881863,31
0,1020,31446,3575881832,3575881863,31
0,1020,31447,3575881832,3575881864,32
0,1020,31448,3575881832,3575881865,33
0,1020,31449,3575881832,3575881865,33
0,1020,31450,3575881832,3575881866,34
0,1020,31451,3575881832,3575881866,34
0,1020,31452,3575881832,3575881866,34
0,1020,31453,3575881832,3575881867,35
0,1020,31454,3575881832,3575881868,36
0,1020,31455,3575881832,3575881869,37
0,1020,31456,3575881832,3575881875,43
0,1020,31457,3575881832,3575881875,43
0,1020,31458,3575881832,3575881875,43
0,1020,31459,3575881832,3575881878,46
0,1020,31460,3575881832,3575881878,46
0,1020,31461,3575881832,3575881881,49
0,1021,31462,3575881897,3575881897,0
0,1021,31463,3575881897,3575881897,0
0,1021,31464,3575881897,3575881897,0
0,1021,31465,3575881897,3575881897,0
0,1021,31466,3575881897,3575881897,0
0,1021,31467,3575881897,3575881897,0
0,1021,31468,3575881897,3575881897,0
0,1021,31469,3575881897,3575881897,0
0,1021,31470,3575881897,3575881897,0
0,1021,31471,3575881897,3575881897,0
0,1021,31472,3575881897,3575881897,0
0,1021,31473,3575881897,3575881897,0
0,1021,31474,3575881897,3575881897,0
0,1021,31475,3575881897,3575881897,0
0,1021,31476,3575881897,3575881897,0
0,1021,31477,3575881897,3575881897,0
0,1021,31478,3575881897,3575881897,0
0,1021,31479,3575881897,3575881897,0
0,1021,31480,3575881897,3575881897,0
0,1021,31481,3575881897,3575881897,0
0,1021,31482,3575881897,3575881897,0
0,1021,31483,3575881897,3575881897,0
0,1021,31484,3575881897,3575881897,0
0,1021,31485,3575881897,3575881897,0
0,1021,31486,3575881897,3575881899,2
0,1021,31487,3575881897,3575881899,2
0,1021,31488,3575881897,3575881900,3
0,1021,31489,3575881897,3575881900,3
0,1021,31490,3575881897,3575881901,4
0,1021,31491,3575881897,3575881901,4
0,1021,31492,3575881897,3575881901,4
0,1021,31493,3575881897,3575881902,5
0,1021,31494,3575881897,3575881903,6
0,1021,31495,3575881897,3575881904,7
0,1021,31496,3575881897,3575881904,7
0,1021,31497,3575881897,3575881905,8
0,1021,31498,3575881897,3575881905,8
0,1021,31499,3575881897,3575881906,9
0,1021,31500,3575881897,3575881906,9
0,1021,31501,3575881897,3575881907,10
0,1021,31502,3575881897,3575881907,10
0,1021,31503,3575881897,3575881908,11
0,1021,31504,3575881897,3575881908,11
0,1021,31505,3575881897,3575881908,11
0,1021,31506,3575881897,3575881909,12
0,1021,31507,3575881897,3575881910,13
0,1021,31508,3575881897,3575881910,13
0,1021,31509,3575881897,3575881911,14
0,1021,31510,3575881897,3575881911,14
0,1021,31511,3575881897,3575881912,15
0,1021,31512,3575881897,3575881912,15
0,1021,31513,3575881897,3575881913,16
0,1021,31514,3575881897,3575881914,17
0,1021,31515,3575881897,3575881914,17
0,1021,31516,3575881897,3575881914,17
0,1021,31517,3575881897,3575881916,19
0,1021,31518,3575881897,3575881917,20
0,1021,31519,3575881897,3575881917,20
0,1021,31520,3575881897,3575881919,22
0,1021,31521,3575881897,3575881920,23
0,1021,31522,3575881897,3575881920,23
0,1021,31523,3575881897,3575881921,24
0,1021,31524,3575881897,3575881922,25
0,1021,31525,3575881897,3575881923,26
0,1021,31526,3575881897,3575881923,26
0,1021,31527,3575881897,3575881924,27
0,1021,31528,3575881897,3575881924,27
0,1021,31529,3575881897,3575881924,27
0,1021,31530,3575881897,3575881924,27
0,1021,31531,3575881897,3575881926,29
0,1021,31532,3575881897,3575881926,29
0,1021,31533,3575881897,3575881926,29
0,1021,31534,3575881897,3575881927,30
0,1021,31535,3575881897,3575881928,31
0,1021,31536,3575881897,3575881928,31
0,1021,31537,3575881897,3575881928,31
0,1021,31538,3575881897,3575881930,33
0,1021,31539,3575881897,3575881931,34
0,1021,31540,3575881897,3575881932,35
0,1021,31541,3575881897,3575881934,37
0,1021,31542,3575881897,3575881934,37
0,1021,31543,3575881897,3575881935,38
0,1021,31544,3575881897,3575881937,40
0,1021,31545,3575881897,3575881937,40
0,1021,31546,3575881897,3575881937,40
0,1021,31547,3575881897,3575881938,41
0,1021,31548,3575881897,3575881938,41
0,1021,31549,3575881897,3575881939,42
0,1021,31550,3575881897,3575881939,42
0,1021,31551,3575881897,3575881939,42
0,1021,31552,3575881897,3575881939,42
0,1021,31553,3575881897,3575881940,43
0,1021,31554,3575881897,3575881940,43
0,1021,31555,3575881897,3575881940,43
0,1021,31556,3575881897,3575881940,43
0,1021,31557,3575881897,3575881941,44
0,1021,31558,3575881897,3575881942,45
0,1021,31559,3575881897,3575881943,46
0,1021,31560,3575881897,3575881944,47
0,1021,31561,3575881897,3575881945,48
0,1021,31562,3575881897,3575881945,48
0,1021,31563,3575881897,3575881946,49
0,1021,31564,3575881897,3575881946,49
0,1021,31565,3575881897,3575881947,50
0,1022,31566,3575881960,3575881960,0
0,1022,31567,3575881960,3575881960,0
0,1022,31568,3575881960,3575881960,0
0,1022,31569,3575881960,3575881960,0
0,1022,31570,3575881960,3575881960,0
0,1022,31571,3575881960,3575881960,0
0,1022,31572,3575881960,3575881960,0
0,1022,31573,3575881960,3575881960,0
0,1022,31574,3575881960,3575881961,1
0,1022,31575,3575881960,3575881961,1
0,1022,31576,3575881960,3575881961,1
0,1022,31577,3575881960,3575881961,1
0,1022,31578,3575881960,3575881961,1
0,1022,31579,3575881960,3575881961,1
0,1022,31580,3575881960,3575881961,1
0,1022,31581,3575881960,3575881961,1
0,1022,31582,3575881960,3575881961,1
0,1022,31583,3575881960,3575881961,1
0,1022,31584,3575881960,3575881962,2
0,1022,31585,3575881960,3575881963,3
0,1022,31586,3575881960,3575881963,3
0,1022,31587,3575881960,3575881964,4
0,1022,31588,3575881960,3575881964,4
0,1022,31589,3575881960,3575881964,4
0,1022,31590,3575881960,3575881964,4
0,1022,31591,3575881960,3575881965,5
0,1022,31592,3575881960,3575881965,5
0,1022,31593,3575881960,3575881966,6
0,1022,31594,3575881960,3575881966,6
0,1022,31595,3575881960,3575881967,7
0,1022,31596,3575881960,3575881968,8
0,1022,31597,3575881960,3575881970,10
0,1022,31598,3575881960,3575881971,11
0,1022,31599,3575881960,3575881971,11
0,1022,31600,3575881960,3575881973,13
0,1022,31601,3575881960,3575881977,17
0,1022,31602,3575881960,3575881977,17
0,1022,31603,3575881960,3575881977,17
0,1022,31604,3575881960,3575881977,17
0,1022,31605,3575881960,3575881977,17
0,1022,31606,3575881960,3575881977,17
0,1022,31607,3575881960,3575881977,17
0,1022,31608,3575881960,3575881978,18
0,1022,31609,3575881960,3575881979,19
0,1022,31610,3575881960,3575881980,20
0,1022,31611,3575881960,3575881982,22
0,1022,31612,3575881960,3575881982,22
0,1022,31613,3575881960,3575881984,24
0,1022,31614,3575881960,3575881985,25
0,1022,31615,3575881960,3575881986,26
0,1022,31616,3575881960,3575881986,26
0,1022,31617,3575881960,3575881989,29
0,1022,31618,3575881960,3575881989,29
0,1022,31619,3575881960,3575881994,34
0,1022,31620,3575881960,3575881994,34
0,1022,31621,3575881960,3575881995,35
0,1022,31622,3575881960,3575881997,37
0,1022,31623,3575881960,3575881999,39
0,1022,31624,3575881960,3575882000,40
0,1022,31625,3575881960,3575882000,40
0,1022,31626,3575881960,3575882001,41
0,1022,31627,3575881960,3575882002,42
0,1022,31628,3575881960,3575882004,44
0,1022,31629,3575881960,3575882005,45
0,1022,31630,3575881960,3575882005,45
0,1022,31631,3575881960,3575882007,47
0,1022,31632,3575881960,3575882007,47
0,1022,31633,3575881960,3575882008,48
0,1022,31634,3575881960,3575882010,50
0,1023,31635,3575882029,3575882029,0
0,1023,31636,3575882029,3575882029,0
0,1023,31637,3575882029,3575882029,0
0,1023,31638,3575882029,3575882029,0
0,1023,31639,3575882029,3575882029,0
0,1023,31640,3575882029,3575882029,0
0,1023,31641,3575882029,3575882029,0
0,1023,31642,3575882029,3575882029,0
0,1023,31643,3575882029,3575882029,0
0,1023,31644,3575882029,3575882029,0
0,1023,31645,3575882029,3575882029,0
0,1023,31646,3575882029,3575882029,0
0,1023,31647,3575882029,3575882029,0
0,1023,31648,3575882029,3575882029,0
0,1023,31649,3575882029,3575882029,0
0,1023,31650,3575882029,3575882029,0
0,1023,31651,3575882029,3575882029,0
0,1023,31652,3575882029,3575882029,0
0,1023,31653,3575882029,3575882029,0
0,1023,31654,3575882029,3575882029,0
0,1023,31655,3575882029,3575882029,0
0,1023,31656,3575882029,3575882029,0
0,1023,31657,3575882029,3575882029,0
0,1023,31658,3575882029,3575882030,1
0,1023,31659,3575882029,3575882030,1
0,1023,31660,3575882029,3575882030,1
0,1023,31661,3575882029,3575882031,2
0,1023,31662,3575882029,3575882032,3
0,1023,31663,3575882029,3575882032,3
0,1023,31664,3575882029,3575882032,3
0,1023,31665,3575882029,3575882032,3
0,1023,31666,3575882029,3575882032,3
0,1023,31667,3575882029,3575882032,3
0,1023,31668,3575882029,3575882033,4
0,1023,31669,3575882029,3575882034,5
0,1023,31670,3575882029,3575882034,5
0,1023,31671,3575882029,3575882034,5
0,1023,31672,3575882029,3575882039,10
0,1023,31673,3575882029,3575882040,11
0,1023,31674,3575882029,3575882040,11
0,1023,31675,3575882029,3575882042,13
0,1023,31676,3575882029,3575882043,14
0,1023,31677,3575882029,3575882044,15
0,1023,31678,3575882029,3575882044,15
0,1023,31679,3575882029,3575882045,16
0,1023,31680,3575882029,3575882046,17
0,1023,31681,3575882029,3575882047,18
0,1023,31682,3575882029,3575882048,19
0,1023,31683,3575882029,3575882049,20
0,1023,31684,3575882029,3575882050,21
0,1023,31685,3575882029,3575882051,22
0,1023,31686,3575882029,3575882051,22
0,1023,31687,3575882029,3575882053,24
0,1023,31688,3575882029,3575882054,25
0,1023,31689,3575882029,3575882055,26
0,1023,31690,3575882029,3575882055,26
0,1023,31691,3575882029,3575882057,28
0,1023,31692,3575882029,3575882057,28
0,1023,31693,3575882029,3575882057,28
0,1023,31694,3575882029,3575882059,30
0,1023,31695,3575882029,3575882059,30
0,1023,31696,3575882029,3575882059,30
0,1023,31697,3575882029,3575882060,31
0,1023,31698,3575882029,3575882060,31
0,1023,31699,3575882029,3575882061,32
0,1023,31700,3575882029,3575882061,32
0,1023,31701,3575882029,3575882062,33
0,1023,31702,3575882029,3575882062,33
0,1023,31703,3575882029,3575882063,34
0,1023,31704,3575882029,3575882063,34
0,1023,31705,3575882029,3575882064,35
0,1023,31706,3575882029,3575882065,36
0,1023,31707,3575882029,3575882065,36
0,1023,31708,3575882029,3575882065,36
0,1023,31709,3575882029,3575882066,37
0,1023,31710,3575882029,3575882067,38
0,1023,31711,3575882029,3575882068,39
0,1023,31712,3575882029,3575882068,39
0,1023,31713,3575882029,3575882075,46
0,1023,31714,3575882029,3575882075,46
0,1023,31715,3575882029,3575882078,49
0,1024,31716,3575882092,3575882092,0
0,1024,31717,3575882092,3575882092,0
0,1024,31718,3575882092,3575882092,0
0,1024,31719,3575882092,3575882092,0
0,1024,31720,3575882092,3575882092,0
0,1024,31721,3575882092,3575882092,0
0,1024,31722,3575882092,3575882092,0
0,1024,31723,3575882092,3575882092,0
0,1024,31724,3575882092,3575882092,0
0,1024,31725,3575882092,3575882092,0
0,1024,31726,3575882092,3575882092,0
0,1024,31727,3575882092,3575882092,0
0,1024,31728,3575882092,3575882092,0
0,1024,31729,3575882092,3575882092,0
0,1024,31730,3575882092,3575882093,1
0,1024,31731,3575882092,3575882093,1
0,1024,31732,3575882092,3575882094,2
0,1024,31733,3575882092,3575882094,2
0,1024,31734,3575882092,3575882095,3
0,1024,31735,3575882092,3575882095,3
0,1024,31736,3575882092,3575882095,3
0,1024,31737,3575882092,3575882096,4
0,1024,31738,3575882092,3575882096,4
0,1024,31739,3575882092,3575882096,4
0,1024,31740,3575882092,3575882097,5
0,1024,31741,3575882092,3575882097,5
0,1024,31742,3575882092,3575882099,7
0,1024,31743,3575882092,3575882100,8
0,1024,31744,3575882092,3575882100,8
0,1024,31745,3575882092,3575882100,8
0,1024,31746,3575882092,3575882100,8
0,1024,31747,3575882092,3575882101,9
0,1024,31748,3575882092,3575882102,10
0,1024,31749,3575882092,3575882102,10
0,1024,31750,3575882092,3575882102,10
0,1024,31751,3575882092,3575882103,11
0,1024,31752,3575882092,3575882104,12
0,1024,31753,3575882092,3575882104,12
0,1024,31754,3575882092,3575882105,13
0,1024,31755,3575882092,3575882105,13
0,1024,31756,3575882092,3575882106,14
0,1024,31757,3575882092,3575882106,14
0,1024,31758,3575882092,3575882107,15
0,1024,31759,3575882092,3575882108,16
0,1024,31760,3575882092,3575882108,16
0,1024,31761,3575882092,3575882108,16
0,1024,31762,3575882092,3575882109,17
0,1024,31763,3575882092,3575882110,18
0,1024,31764,3575882092,3575882110,18
0,1024,31765,3575882092,3575882110,18
0,1024,31766,3575882092,3575882110,18
0,1024,31767,3575882092,3575882112,20
0,1024,31768,3575882092,3575882113,21
0,1024,31769,3575882092,3575882113,21
0,1024,31770,3575882092,3575882113,21
0,1024,31771,3575882092,3575882114,22
0,1024,31772,3575882092,3575882114,22
0,1024,31773,3575882092,3575882114,22
0,1024,31774,3575882092,3575882115,23
0,1024,31775,3575882092,3575882116,24
0,1024,31776,3575882092,3575882117,25
0,1024,31777,3575882092,3575882118,26
0,1024,31778,3575882092,3575882119,27
0,1024,31779,3575882092,3575882120,28
0,1024,31780,3575882092,3575882122,30
0,1024,31781,3575882092,3575882122,30
0,1024,31782,3575882092,3575882123,31
0,1024,31783,3575882092,3575882123,31
0,1024,31784,3575882092,3575882124,32
0,1024,31785,3575882092,3575882124,32
0,1024,31786,3575882092,3575882124,32
0,1024,31787,3575882092,3575882125,33
0,1024,31788,3575882092,3575882125,33
0,1024,31789,3575882092,3575882126,34
0,1024,31790,3575882092,3575882127,35
0,1024,31791,3575882092,3575882127,35
0,1024,31792,3575882092,3575882128,36
0,1024,31793,3575882092,3575882128,36
0,1024,31794,3575882092,3575882128,36
0,1024,31795,3575882092,3575882129,37
0,1024,31796,3575882092,3575882130,38
0,1024,31797,3575882092,3575882133,41
0,1024,31798,3575882092,3575882134,42
0,1024,31799,3575882092,3575882134,42
0,1024,31800,3575882092,3575882135,43
0,1024,31801,3575882092,3575882137,45
0,1024,31802,3575882092,3575882137,45
0,1024,31803,3575882092,3575882137,45
0,1024,31804,3575882092,3575882138,46
0,1024,31805,3575882092,3575882138,46
0,1024,31806,3575882092,3575882139,47
0,1024,31807,3575882092,3575882139,47
0,1024,31808,3575882092,3575882139,47
0,1024,31809,3575882092,3575882139,47
0,1024,31810,3575882092,3575882139,47
0,1024,31811,3575882092,3575882140,48
0,1024,31812,3575882092,3575882140,48
0,1024,31813,3575882092,3575882140,48
0,1024,31814,3575882092,3575882141,49
0,1024,31815,3575882092,3575882142,50
0,1025,31816,3575882156,3575882156,0
0,1025,31817,3575882156,3575882156,0
0,1025,31818,3575882156,3575882156,0
0,1025,31819,3575882156,3575882156,0
0,1025,31820,3575882156,3575882156,0
0,1025,31821,3575882156,3575882156,0
0,1025,31822,3575882156,3575882156,0
0,1025,31823,3575882156,3575882156,0
0,1025,31824,3575882156,3575882156,0
0,1025,31825,3575882156,3575882156,0
0,1025,31826,3575882156,3575882156,0
0,1025,31827,3575882156,3575882156,0
0,1025,31828,3575882156,3575882156,0
0,1025,31829,3575882156,3575882157,1
0,1025,31830,3575882156,3575882157,1
0,1025,31831,3575882156,3575882157,1
0,1025,31832,3575882156,3575882157,1
0,1025,31833,3575882156,3575882157,1
0,1025,31834,3575882156,3575882157,1
0,1025,31835,3575882156,3575882157,1
0,1025,31836,3575882156,3575882157,1
0,1025,31837,3575882156,3575882158,2
0,1025,31838,3575882156,3575882159,3
0,1025,31839,3575882156,3575882161,5
0,1025,31840,3575882156,3575882161,5
0,1025,31841,3575882156,3575882162,6
0,1025,31842,3575882156,3575882163,7
0,1025,31843,3575882156,3575882163,7
0,1025,31844,3575882156,3575882163,7
0,1025,31845,3575882156,3575882164,8
0,1025,31846,3575882156,3575882164,8
0,1025,31847,3575882156,3575882165,9
0,1025,31848,3575882156,3575882165,9
0,1025,31849,3575882156,3575882165,9
0,1025,31850,3575882156,3575882165,9
0,1025,31851,3575882156,3575882166,10
0,1025,31852,3575882156,3575882167,11
0,1025,31853,3575882156,3575882168,12
0,1025,31854,3575882156,3575882168,12
0,1025,31855,3575882156,3575882170,14
0,1025,31856,3575882156,3575882172,16
0,1025,31857,3575882156,3575882172,16
0,1025,31858,3575882156,3575882172,16
0,1025,31859,3575882156,3575882176,20
0,1025,31860,3575882156,3575882176,20
0,1025,31861,3575882156,3575882177,21
0,1025,31862,3575882156,3575882177,21
0,1025,31863,3575882156,3575882177,21
0,1025,31864,3575882156,3575882178,22
0,1025,31865,3575882156,3575882178,22
0,1025,31866,3575882156,3575882178,22
0,1025,31867,3575882156,3575882179,23
0,1025,31868,3575882156,3575882180,24
0,1025,31869,3575882156,3575882182,26
0,1025,31870,3575882156,3575882182,26
0,1025,31871,3575882156,3575882184,28
0,1025,31872,3575882156,3575882186,30
0,1025,31873,3575882156,3575882186,30
0,1025,31874,3575882156,3575882189,33
0,1025,31875,3575882156,3575882194,38
0,1025,31876,3575882156,3575882194,38
0,1025,31877,3575882156,3575882194,38
0,1025,31878,3575882156,3575882199,43
0,1025,31879,3575882156,3575882200,44
0,1025,31880,3575882156,3575882200,44
0,1025,31881,3575882156,3575882201,45
0,1025,31882,3575882156,3575882201,45
0,1025,31883,3575882156,3575882204,48
0,1025,31884,3575882156,3575882205,49
0,1026,31885,3575882219,3575882219,0
0,1026,31886,3575882219,3575882219,0
0,1026,31887,3575882219,3575882219,0
0,1026,31888,3575882219,3575882219,0
0,1026,31889,3575882219,3575882219,0
0,1026,31890,3575882219,3575882219,0
0,1026,31891,3575882219,3575882220,1
0,1026,31892,3575882219,3575882220,1
0,1026,31893,3575882219,3575882220,1
0,1026,31894,3575882219,3575882220,1
0,1026,31895,3575882219,3575882220,1
0,1026,31896,3575882219,3575882220,1
0,1026,31897,3575882219,3575882220,1
0,1026,31898,3575882219,3575882220,1
0,1026,31899,3575882219,3575882220,1
0,1026,31900,3575882219,3575882220,1
0,1026,31901,3575882219,3575882220,1
0,1026,31902,3575882219,3575882221,2
0,1026,31903,3575882219,3575882221,2
0,1026,31904,3575882219,3575882222,3
0,1026,31905,3575882219,3575882222,3
0,1026,31906,3575882219,3575882224,5
0,1026,31907,3575882219,3575882226,7
0,1026,31908,3575882219,3575882227,8
0,1026,31909,3575882219,3575882229,10
0,1026,31910,3575882219,3575882229,10
0,1026,31911,3575882219,3575882229,10
0,1026,31912,3575882219,3575882230,11
0,1026,31913,3575882219,3575882230,11
0,1026,31914,3575882219,3575882230,11
0,1026,31915,3575882219,3575882231,12
0,1026,31916,3575882219,3575882232,13
0,1026,31917,3575882219,3575882232,13
0,1026,31918,3575882219,3575882232,13
0,1026,31919,3575882219,3575882233,14
0,1026,31920,3575882219,3575882233,14
0,1026,31921,3575882219,3575882233,14
0,1026,31922,3575882219,3575882233,14
0,1026,31923,3575882219,3575882233,14
0,1026,31924,3575882219,3575882234,15
0,1026,31925,3575882219,3575882234,15
0,1026,31926,3575882219,3575882234,15
0,1026,31927,3575882219,3575882240,21
0,1026,31928,3575882219,3575882240,21
0,1026,31929,3575882219,3575882240,21
0,1026,31930,3575882219,3575882241,22
0,1026,31931,3575882219,3575882242,23
0,1026,31932,3575882219,3575882243,24
0,1026,31933,3575882219,3575882244,25
0,1026,31934,3575882219,3575882245,26
0,1026,31935,3575882219,3575882247,28
0,1026,31936,3575882219,3575882247,28
0,1026,31937,3575882219,3575882248,29
0,1026,31938,3575882219,3575882249,30
0,1026,31939,3575882219,3575882250,31
0,1026,31940,3575882219,3575882250,31
0,1026,31941,3575882219,3575882251,32
0,1026,31942,3575882219,3575882253,34
0,1026,31943,3575882219,3575882255,36
0,1026,31944,3575882219,3575882255,36
0,1026,31945,3575882219,3575882256,37
0,1026,31946,3575882219,3575882257,38
0,1026,31947,3575882219,3575882257,38
0,1026,31948,3575882219,3575882258,39
0,1026,31949,3575882219,3575882259,40
0,1026,31950,3575882219,3575882259,40
0,1026,31951,3575882219,3575882259,40
0,1026,31952,3575882219,3575882259,40
0,1026,31953,3575882219,3575882260,41
0,1026,31954,3575882219,3575882260,41
0,1026,31955,3575882219,3575882261,42
0,1026,31956,3575882219,3575882262,43
0,1026,31957,3575882219,3575882263,44
0,1026,31958,3575882219,3575882263,44
0,1026,31959,3575882219,3575882263,44
0,1026,31960,3575882219,3575882265,46
0,1026,31961,3575882219,3575882265,46
0,1026,31962,3575882219,3575882266,47
0,1026,31963,3575882219,3575882267,48
0,1026,31964,3575882219,3575882267,48
0,1026,31965,3575882219,3575882268,49
0,1026,31966,3575882219,3575882268,49
0,1026,31967,3575882219,3575882268,49
0,1026,31968,3575882219,3575882268,49
0,1026,31969,3575882219,3575882269,50
0,1027,31970,3575882288,3575882288,0
0,1027,31971,3575882288,3575882288,0
0,1027,31972,3575882288,3575882289,1
0,1027,31973,3575882288,3575882289,1
0,1027,31974,3575882288,3575882289,1
0,1027,31975,3575882288,3575882289,1
0,1027,31976,3575882288,3575882289,1
0,1027,31977,3575882288,3575882289,1
0,1027,31978,3575882288,3575882289,1
0,1027,31979,3575882288,3575882289,1
0,1027,31980,3575882288,3575882289,1
0,1027,31981,3575882288,3575882289,1
0,1027,31982,3575882288,3575882289,1
0,1027,31983,3575882288,3575882289,1
0,1027,31984,3575882288,3575882291,3
0,1027,31985,3575882288,3575882291,3
0,1027,31986,3575882288,3575882292,4
0,1027,31987,3575882288,3575882292,4
0,1027,31988,3575882288,3575882293,5
0,1027,31989,3575882288,3575882293,5
0,1027,31990,3575882288,3575882293,5
0,1027,31991,3575882288,3575882294,6
0,1027,31992,3575882288,3575882295,7
0,1027,31993,3575882288,3575882295,7
0,1027,31994,3575882288,3575882295,7
0,1027,31995,3575882288,3575882296,8
0,1027,31996,3575882288,3575882296,8
0,1027,31997,3575882288,3575882296,8
0,1027,31998,3575882288,3575882297,9
0,1027,31999,3575882288,3575882297,9
0,1027,32000,3575882288,3575882299,11
0,1027,32001,3575882288,3575882299,11
0,1027,32002,3575882288,3575882300,12
0,1027,32003,3575882288,3575882301,13
0,1027,32004,3575882288,3575882302,14
0,1027,32005,3575882288,3575882302,14
0,1027,32006,3575882288,3575882302,14
0,1027,32007,3575882288,3575882303,15
0,1027,32008,3575882288,3575882303,15
0,1027,32009,3575882288,3575882304,16
0,1027,32010,3575882288,3575882304,16
0,1027,32011,3575882288,3575882305,17
0,1027,32012,3575882288,3575882306,18
0,1027,32013,3575882288,3575882306,18
0,1027,32014,3575882288,3575882307,19
0,1027,32015,3575882288,3575882308,20
0,1027,32016,3575882288,3575882309,21
0,1027,32017,3575882288,3575882309,21
0,1027,32018,3575882288,3575882309,21
0,1027,32019,3575882288,3575882310,22
0,1027,32020,3575882288,3575882310,22
0,1027,32021,3575882288,3575882311,23
0,1027,32022,3575882288,3575882312,24
0,1027,32023,3575882288,3575882313,25
0,1027,32024,3575882288,3575882313,25
0,1027,32025,3575882288,3575882313,25
0,1027,32026,3575882288,3575882314,26
0,1027,32027,3575882288,3575882314,26
0,1027,32028,3575882288,3575882315,27
0,1027,32029,3575882288,3575882316,28
0,1027,32030,3575882288,3575882316,28
0,1027,32031,3575882288,3575882317,29
0,1027,32032,3575882288,3575882317,29
0,1027,32033,3575882288,3575882319,31
0,1027,32034,3575882288,3575882319,31
0,1027,32035,3575882288,3575882320,32
0,1027,32036,3575882288,3575882322,34
0,1027,32037,3575882288,3575882322,34
0,1027,32038,3575882288,3575882323,35
0,1027,32039,3575882288,3575882323,35
0,1027,32040,3575882288,3575882324,36
0,1027,32041,3575882288,3575882324,36
0,1027,32042,3575882288,3575882324,36
0,1027,32043,3575882288,3575882325,37
0,1027,32044,3575882288,3575882325,37
0,1027,32045,3575882288,3575882326,38
0,1027,32046,3575882288,3575882326,38
0,1027,32047,3575882288,3575882327,39
0,1027,32048,3575882288,3575882328,40
0,1027,32049,3575882288,3575882328,40
0,1027,32050,3575882288,3575882328,40
0,1027,32051,3575882288,3575882328,40
0,1027,32052,3575882288,3575882329,41
0,1027,32053,3575882288,3575882330,42
0,1027,32054,3575882288,3575882333,45
0,1027,32055,3575882288,3575882334,46
0,1027,32056,3575882288,3575882336,48
0,1027,32057,3575882288,3575882336,48
0,1027,32058,3575882288,3575882337,49
0,1027,32059,3575882288,3575882337,49
0,1028,32060,3575882351,3575882351,0
0,1028,32061,3575882351,3575882352,1
0,1028,32062,3575882351,3575882352,1
0,1028,32063,3575882351,3575882353,2
0,1028,32064,3575882351,3575882353,2
0,1028,32065,3575882351,3575882353,2
0,1028,32066,3575882351,3575882353,2
0,1028,32067,3575882351,3575882353,2
0,1028,32068,3575882351,3575882353,2
0,1028,32069,3575882351,3575882353,2
0,1028,32070,3575882351,3575882353,2
0,1028,32071,3575882351,3575882353,2
0,1028,32072,3575882351,3575882353,2
0,1028,32073,3575882351,3575882353,2
0,1028,32074,3575882351,3575882353,2
0,1028,32075,3575882351,3575882353,2
0,1028,32076,3575882351,3575882353,2
0,1028,32077,3575882351,3575882353,2
0,1028,32078,3575882351,3575882353,2
0,1028,32079,3575882351,3575882353,2
0,1028,32080,3575882351,3575882353,2
0,1028,32081,3575882351,3575882353,2
0,1028,32082,3575882351,3575882353,2
0,1028,32083,3575882351,3575882354,3
0,1028,32084,3575882351,3575882355,4
0,1028,32085,3575882351,3575882355,4
0,1028,32086,3575882351,3575882355,4
0,1028,32087,3575882351,3575882357,6
0,1028,32088,3575882351,3575882357,6
0,1028,32089,3575882351,3575882358,7
0,1028,32090,3575882351,3575882358,7
0,1028,32091,3575882351,3575882360,9
0,1028,32092,3575882351,3575882360,9
0,1028,32093,3575882351,3575882361,10
0,1028,32094,3575882351,3575882362,11
0,1028,32095,3575882351,3575882363,12
0,1028,32096,3575882351,3575882363,12
0,1028,32097,3575882351,3575882364,13
0,1028,32098,3575882351,3575882364,13
0,1028,32099,3575882351,3575882364,13
0,1028,32100,3575882351,3575882366,15
0,1028,32101,3575882351,3575882366,15
0,1028,32102,3575882351,3575882366,15
0,1028,32103,3575882351,3575882366,15
0,1028,32104,3575882351,3575882367,16
0,1028,32105,3575882351,3575882367,16
0,1028,32106,3575882351,3575882367,16
0,1028,32107,3575882351,3575882369,18
0,1028,32108,3575882351,3575882371,20
0,1028,32109,3575882351,3575882371,20
0,1028,32110,3575882351,3575882372,21
0,1028,32111,3575882351,3575882373,22
0,1028,32112,3575882351,3575882376,25
0,1028,32113,3575882351,3575882376,25
0,1028,32114,3575882351,3575882377,26
0,1028,32115,3575882351,3575882377,26
0,1028,32116,3575882351,3575882378,27
0,1028,32117,3575882351,3575882378,27
0,1028,32118,3575882351,3575882378,27
0,1028,32119,3575882351,3575882380,29
0,1028,32120,3575882351,3575882380,29
0,1028,32121,3575882351,3575882382,31
0,1028,32122,3575882351,3575882382,31
0,1028,32123,3575882351,3575882385,34
0,1028,32124,3575882351,3575882386,35
0,1028,32125,3575882351,3575882386,35
0,1028,32126,3575882351,3575882387,36
0,1028,32127,3575882351,3575882388,37
0,1028,32128,3575882351,3575882389,38
0,1028,32129,3575882351,3575882394,43
0,1028,32130,3575882351,3575882394,43
0,1028,32131,3575882351,3575882396,45
0,1028,32132,3575882351,3575882398,47
0,1028,32133,3575882351,3575882398,47
0,1028,32134,3575882351,3575882400,49
0,1028,32135,3575882351,3575882401,50
0,1029,32136,3575882413,3575882413,0
0,1029,32137,3575882413,3575882413,0
0,1029,32138,3575882413,3575882413,0
0,1029,32139,3575882413,3575882413,0
0,1029,32140,3575882413,3575882413,0
0,1029,32141,3575882413,3575882413,0
0,1029,32142,3575882413,3575882413,0
0,1029,32143,3575882413,3575882413,0
0,1029,32144,3575882413,3575882413,0
0,1029,32145,3575882413,3575882413,0
0,1029,32146,3575882413,3575882413,0
0,1029,32147,3575882413,3575882413,0
0,1029,32148,3575882413,3575882414,1
0,1029,32149,3575882413,3575882415,2
0,1029,32150,3575882413,3575882415,2
0,1029,32151,3575882413,3575882415,2
0,1029,32152,3575882413,3575882415,2
0,1029,32153,3575882413,3575882415,2
0,1029,32154,3575882413,3575882416,3
0,1029,32155,3575882413,3575882418,5
0,1029,32156,3575882413,3575882419,6
0,1029,32157,3575882413,3575882419,6
0,1029,32158,3575882413,3575882421,8
0,1029,32159,3575882413,3575882421,8
0,1029,32160,3575882413,3575882421,8
0,1029,32161,3575882413,3575882423,10
0,1029,32162,3575882413,3575882424,11
0,1029,32163,3575882413,3575882426,13
0,1029,32164,3575882413,3575882427,14
0,1029,32165,3575882413,3575882427,14
0,1029,32166,3575882413,3575882429,16
0,1029,32167,3575882413,3575882430,17
0,1029,32168,3575882413,3575882430,17
0,1029,32169,3575882413,3575882430,17
0,1029,32170,3575882413,3575882431,18
0,1029,32171,3575882413,3575882431,18
0,1029,32172,3575882413,3575882432,19
0,1029,32173,3575882413,3575882432,19
0,1029,32174,3575882413,3575882432,19
0,1029,32175,3575882413,3575882432,19
0,1029,32176,3575882413,3575882433,20
0,1029,32177,3575882413,3575882433,20
0,1029,32178,3575882413,3575882433,20
0,1029,32179,3575882413,3575882433,20
0,1029,32180,3575882413,3575882434,21
0,1029,32181,3575882413,3575882434,21
0,1029,32182,3575882413,3575882435,22
0,1029,32183,3575882413,3575882440,27
0,1029,32184,3575882413,3575882440,27
0,1029,32185,3575882413,3575882441,28
0,1029,32186,3575882413,3575882443,30
0,1029,32187,3575882413,3575882443,30
0,1029,32188,3575882413,3575882444,31
0,1029,32189,3575882413,3575882445,32
0,1029,32190,3575882413,3575882448,35
0,1029,32191,3575882413,3575882448,35
0,1029,32192,3575882413,3575882448,35
0,1029,32193,3575882413,3575882449,36
0,1029,32194,3575882413,3575882450,37
0,1029,32195,3575882413,3575882451,38
0,1029,32196,3575882413,3575882452,39
0,1029,32197,3575882413,3575882453,40
0,1029,32198,3575882413,3575882455,42
0,1029,32199,3575882413,3575882456,43
0,1029,32200,3575882413,3575882456,43
0,1029,32201,3575882413,3575882457,44
0,1029,32202,3575882413,3575882458,45
0,1029,32203,3575882413,3575882458,45
0,1029,32204,3575882413,3575882459,46
0,1029,32205,3575882413,3575882460,47
0,1029,32206,3575882413,3575882460,47
0,1029,32207,3575882413,3575882460,47
0,1029,32208,3575882413,3575882461,48
0,1029,32209,3575882413,3575882461,48
0,1029,32210,3575882413,3575882462,49
0,1029,32211,3575882413,3575882463,50
0,1030,32212,3575882478,3575882478,0
0,1030,32213,3575882478,3575882478,0
0,1030,32214,3575882478,3575882478,0
0,1030,32215,3575882478,3575882478,0
0,1030,32216,3575882478,3575882478,0
0,1030,32217,3575882478,3575882478,0
0,1030,32218,3575882478,3575882478,0
0,1030,32219,3575882478,3575882478,0
0,1030,32220,3575882478,3575882478,0
0,1030,32221,3575882478,3575882478,0
0,1030,32222,3575882478,3575882478,0
0,1030,32223,3575882478,3575882478,0
0,1030,32224,3575882478,3575882478,0
0,1030,32225,3575882478,3575882478,0
0,1030,32226,3575882478,3575882478,0
0,1030,32227,3575882478,3575882478,0
0,1030,32228,3575882478,3575882479,1
0,1030,32229,3575882478,3575882483,5
0,1030,32230,3575882478,3575882486,8
0,1030,32231,3575882478,3575882486,8
0,1030,32232,3575882478,3575882486,8
0,1030,32233,3575882478,3575882486,8
0,1030,32234,3575882478,3575882487,9
0,1030,32235,3575882478,3575882487,9
0,1030,32236,3575882478,3575882487,9
0,1030,32237,3575882478,3575882488,10
0,1030,32238,3575882478,3575882488,10
0,1030,32239,3575882478,3575882490,12
0,1030,32240,3575882478,3575882491,13
0,1030,32241,3575882478,3575882492,14
0,1030,32242,3575882478,3575882492,14
0,1030,32243,3575882478,3575882493,15
0,1030,32244,3575882478,3575882493,15
0,1030,32245,3575882478,3575882494,16
0,1030,32246,3575882478,3575882494,16
0,1030,32247,3575882478,3575882495,17
0,1030,32248,3575882478,3575882495,17
0,1030,32249,3575882478,3575882495,17
0,1030,32250,3575882478,3575882495,17
0,1030,32251,3575882478,3575882496,18
0,1030,32252,3575882478,3575882496,18
0,1030,32253,3575882478,3575882496,18
0,1030,32254,3575882478,3575882497,19
0,1030,32255,3575882478,3575882497,19
0,1030,32256,3575882478,3575882499,21
0,1030,32257,3575882478,3575882499,21
0,1030,32258,3575882478,3575882500,22
0,1030,32259,3575882478,3575882501,23
0,1030,32260,3575882478,3575882502,24
0,1030,32261,3575882478,3575882502,24
0,1030,32262,3575882478,3575882502,24
0,1030,32263,3575882478,3575882502,24
0,1030,32264,3575882478,3575882503,25
0,1030,32265,3575882478,3575882504,26
0,1030,32266,3575882478,3575882505,27
0,1030,32267,3575882478,3575882506,28
0,1030,32268,3575882478,3575882506,28
0,1030,32269,3575882478,3575882506,28
0,1030,32270,3575882478,3575882507,29
0,1030,32271,3575882478,3575882507,29
0,1030,32272,3575882478,3575882508,30
0,1030,32273,3575882478,3575882509,31
0,1030,32274,3575882478,3575882509,31
0,1030,32275,3575882478,3575882510,32
0,1030,32276,3575882478,3575882511,33
0,1030,32277,3575882478,3575882511,33
0,1030,32278,3575882478,3575882511,33
0,1030,32279,3575882478,3575882512,34
0,1030,32280,3575882478,3575882513,35
0,1030,32281,3575882478,3575882513,35
0,1030,32282,3575882478,3575882515,37
0,1030,32283,3575882478,3575882515,37
0,1030,32284,3575882478,3575882516,38
0,1030,32285,3575882478,3575882517,39
0,1030,32286,3575882478,3575882519,41
0,1030,32287,3575882478,3575882519,41
0,1030,32288,3575882478,3575882520,42
0,1030,32289,3575882478,3575882522,44
0,1030,32290,3575882478,3575882522,44
0,1030,32291,3575882478,3575882523,45
0,1030,32292,3575882478,3575882523,45
0,1030,32293,3575882478,3575882524,46
0,1030,32294,3575882478,3575882524,46
0,1030,32295,3575882478,3575882524,46
0,1030,32296,3575882478,3575882525,47
0,1030,32297,3575882478,3575882526,48
0,1030,32298,3575882478,3575882526,48
0,1030,32299,3575882478,3575882526,48
0,1030,32300,3575882478,3575882527,49
0,1030,32301,3575882478,3575882528,50
0,1030,32302,3575882478,3575882528,50
0,1031,32303,3575882544,3575882544,0
0,1031,32304,3575882544,3575882544,0
0,1031,32305,3575882544,3575882544,0
0,1031,32306,3575882544,3575882544,0
0,1031,32307,3575882544,3575882544,0
0,1031,32308,3575882544,3575882544,0
0,1031,32309,3575882544,3575882544,0
0,1031,32310,3575882544,3575882544,0
0,1031,32311,3575882544,3575882544,0
0,1031,32312,3575882544,3575882544,0
0,1031,32313,3575882544,3575882544,0
0,1031,32314,3575882544,3575882544,0
0,1031,32315,3575882544,3575882544,0
0,1031,32316,3575882544,3575882544,0
0,1031,32317,3575882544,3575882544,0
0,1031,32318,3575882544,3575882544,0
0,1031,32319,3575882544,3575882544,0
0,1031,32320,3575882544,3575882544,0
0,1031,32321,3575882544,3575882544,0
0,1031,32322,3575882544,3575882544,0
0,1031,32323,3575882544,3575882544,0
0,1031,32324,3575882544,3575882544,0
0,1031,32325,3575882544,3575882544,0
0,1031,32326,3575882544,3575882544,0
0,1031,32327,3575882544,3575882544,0
0,1031,32328,3575882544,3575882544,0
0,1031,32329,3575882544,3575882545,1
0,1031,32330,3575882544,3575882545,1
0,1031,32331,3575882544,3575882545,1
0,1031,32332,3575882544,3575882546,2
0,1031,32333,3575882544,3575882547,3
0,1031,32334,3575882544,3575882547,3
0,1031,32335,3575882544,3575882548,4
0,1031,32336,3575882544,3575882548,4
0,1031,32337,3575882544,3575882548,4
0,1031,32338,3575882544,3575882552,8
0,1031,32339,3575882544,3575882552,8
0,1031,32340,3575882544,3575882552,8
0,1031,32341,3575882544,3575882552,8
0,1031,32342,3575882544,3575882554,10
0,1031,32343,3575882544,3575882554,10
0,1031,32344,3575882544,3575882555,11
0,1031,32345,3575882544,3575882555,11
0,1031,32346,3575882544,3575882556,12
0,1031,32347,3575882544,3575882557,13
0,1031,32348,3575882544,3575882557,13
0,1031,32349,3575882544,3575882558,14
0,1031,32350,3575882544,3575882559,15
0,1031,32351,3575882544,3575882560,16
0,1031,32352,3575882544,3575882560,16
0,1031,32353,3575882544,3575882561,17
0,1031,32354,3575882544,3575882561,17
0,1031,32355,3575882544,3575882561,17
0,1031,32356,3575882544,3575882562,18
0,1031,32357,3575882544,3575882563,19
0,1031,32358,3575882544,3575882564,20
0,1031,32359,3575882544,3575882564,20
0,1031,32360,3575882544,3575882565,21
0,1031,32361,3575882544,3575882565,21
0,1031,32362,3575882544,3575882565,21
0,1031,32363,3575882544,3575882565,21
0,1031,32364,3575882544,3575882566,22
0,1031,32365,3575882544,3575882566,22
0,1031,32366,3575882544,3575882568,24
0,1031,32367,3575882544,3575882570,26
0,1031,32368,3575882544,3575882570,26
0,1031,32369,3575882544,3575882571,27
0,1031,32370,3575882544,3575882571,27
0,1031,32371,3575882544,3575882575,31
0,1031,32372,3575882544,3575882576,32
0,1031,32373,3575882544,3575882576,32
0,1031,32374,3575882544,3575882576,32
0,1031,32375,3575882544,3575882576,32
0,1031,32376,3575882544,3575882577,33
0,1031,32377,3575882544,3575882577,33
0,1031,32378,3575882544,3575882577,33
0,1031,32379,3575882544,3575882578,34
0,1031,32380,3575882544,3575882579,35
0,1031,32381,3575882544,3575882580,36
0,1031,32382,3575882544,3575882581,37
0,1031,32383,3575882544,3575882584,40
0,1031,32384,3575882544,3575882584,40
0,1031,32385,3575882544,3575882586,42
0,1031,32386,3575882544,3575882586,42
0,1031,32387,3575882544,3575882586,42
0,1031,32388,3575882544,3575882588,44
0,1031,32389,3575882544,3575882589,45
0,1031,32390,3575882544,3575882593,49
0,1031,32391,3575882544,3575882593,49
0,1032,32392,3575882615,3575882615,0
0,1032,32393,3575882615,3575882615,0
0,1032,32394,3575882615,3575882615,0
0,1032,32395,3575882615,3575882615,0
0,1032,32396,3575882615,3575882615,0
0,1032,32397,3575882615,3575882615,0
0,1032,32398,3575882615,3575882615,0
0,1032,32399,3575882615,3575882615,0
0,1032,32400,3575882615,3575882615,0
0,1032,32401,3575882615,3575882615,0
0,1032,32402,3575882615,3575882615,0
0,1032,32403,3575882615,3575882615,0
0,1032,32404,3575882615,3575882615,0
0,1032,32405,3575882615,3575882615,0
0,1032,32406,3575882615,3575882615,0
0,1032,32407,3575882615,3575882615,0
0,1032,32408,3575882615,3575882615,0
0,1032,32409,3575882615,3575882615,0
0,1032,32410,3575882615,3575882615,0
0,1032,32411,3575882615,3575882615,0
0,1032,32412,3575882615,3575882615,0
0,1032,32413,3575882615,3575882615,0
0,1032,32414,3575882615,3575882617,2
0,1032,32415,3575882615,3575882618,3
0,1032,32416,3575882615,3575882619,4
0,1032,32417,3575882615,3575882620,5
0,1032,32418,3575882615,3575882620,5
0,1032,32419,3575882615,3575882620,5
0,1032,32420,3575882615,3575882622,7
0,1032,32421,3575882615,3575882623,8
0,1032,32422,3575882615,3575882626,11
0,1032,32423,3575882615,3575882628,13
0,1032,32424,3575882615,3575882629,14
0,1032,32425,3575882615,3575882629,14
0,1032,32426,3575882615,3575882629,14
0,1032,32427,3575882615,3575882630,15
0,1032,32428,3575882615,3575882630,15
0,1032,32429,3575882615,3575882631,16
0,1032,32430,3575882615,3575882631,16
0,1032,32431,3575882615,3575882631,16
0,1032,32432,3575882615,3575882631,16
0,1032,32433,3575882615,3575882631,16
0,1032,32434,3575882615,3575882631,16
0,1032,32435,3575882615,3575882632,17
0,1032,32436,3575882615,3575882632,17
0,1032,32437,3575882615,3575882633,18
0,1032,32438,3575882615,3575882633,18
0,1032,32439,3575882615,3575882633,18
0,1032,32440,3575882615,3575882634,19
0,1032,32441,3575882615,3575882634,19
0,1032,32442,3575882615,3575882639,24
0,1032,32443,3575882615,3575882639,24
0,1032,32444,3575882615,3575882640,25
0,1032,32445,3575882615,3575882641,26
0,1032,32446,3575882615,3575882642,27
0,1032,32447,3575882615,3575882642,27
0,1032,32448,3575882615,3575882644,29
0,1032,32449,3575882615,3575882644,29
0,1032,32450,3575882615,3575882647,32
0,1032,32451,3575882615,3575882647,32
0,1032,32452,3575882615,3575882647,32
0,1032,32453,3575882615,3575882648,33
0,1032,32454,3575882615,3575882649,34
0,1032,32455,3575882615,3575882649,34
0,1032,32456,3575882615,3575882650,35
0,1032,32457,3575882615,3575882651,36
0,1032,32458,3575882615,3575882652,37
0,1032,32459,3575882615,3575882654,39
0,1032,32460,3575882615,3575882655,40
0,1032,32461,3575882615,3575882655,40
0,1032,32462,3575882615,3575882656,41
0,1032,32463,3575882615,3575882657,42
0,1032,32464,3575882615,3575882657,42
0,1032,32465,3575882615,3575882658,43
0,1032,32466,3575882615,3575882659,44
0,1032,32467,3575882615,3575882659,44
0,1032,32468,3575882615,3575882659,44
0,1032,32469,3575882615,3575882660,45
0,1032,32470,3575882615,3575882661,46
0,1032,32471,3575882615,3575882661,46
0,1032,32472,3575882615,3575882662,47
0,1032,32473,3575882615,3575882662,47
0,1032,32474,3575882615,3575882664,49
0,1033,32475,3575882680,3575882680,0
0,1033,32476,3575882680,3575882680,0
0,1033,32477,3575882680,3575882680,0
0,1033,32478,3575882680,3575882680,0
0,1033,32479,3575882680,3575882680,0
0,1033,32480,3575882680,3575882680,0
0,1033,32481,3575882680,3575882680,0
0,1033,32482,3575882680,3575882680,0
0,1033,32483,3575882680,3575882680,0
0,1033,32484,3575882680,3575882680,0
0,1033,32485,3575882680,3575882680,0
0,1033,32486,3575882680,3575882680,0
0,1033,32487,3575882680,3575882680,0
0,1033,32488,3575882680,3575882680,0
0,1033,32489,3575882680,3575882681,1
0,1033,32490,3575882680,3575882683,3
0,1033,32491,3575882680,3575882684,4
0,1033,32492,3575882680,3575882686,6
0,1033,32493,3575882680,3575882686,6
0,1033,32494,3575882680,3575882686,6
0,1033,32495,3575882680,3575882686,6
0,1033,32496,3575882680,3575882687,7
0,1033,32497,3575882680,3575882687,7
0,1033,32498,3575882680,3575882688,8
0,1033,32499,3575882680,3575882688,8
0,1033,32500,3575882680,3575882689,9
0,1033,32501,3575882680,3575882690,10
0,1033,32502,3575882680,3575882691,11
0,1033,32503,3575882680,3575882692,12
0,1033,32504,3575882680,3575882692,12
0,1033,32505,3575882680,3575882693,13
0,1033,32506,3575882680,3575882693,13
0,1033,32507,3575882680,3575882694,14
0,1033,32508,3575882680,3575882694,14
0,1033,32509,3575882680,3575882695,15
0,1033,32510,3575882680,3575882695,15
0,1033,32511,3575882680,3575882695,15
0,1033,32512,3575882680,3575882695,15
0,1033,32513,3575882680,3575882695,15
0,1033,32514,3575882680,3575882696,16
0,1033,32515,3575882680,3575882697,17
0,1033,32516,3575882680,3575882697,17
0,1033,32517,3575882680,3575882697,17
0,1033,32518,3575882680,3575882699,19
0,1033,32519,3575882680,3575882700,20
0,1033,32520,3575882680,3575882700,20
0,1033,32521,3575882680,3575882701,21
0,1033,32522,3575882680,3575882702,22
0,1033,32523,3575882680,3575882702,22
0,1033,32524,3575882680,3575882702,22
0,1033,32525,3575882680,3575882702,22
0,1033,32526,3575882680,3575882704,24
0,1033,32527,3575882680,3575882704,24
0,1033,32528,3575882680,3575882704,24
0,1033,32529,3575882680,3575882705,25
0,1033,32530,3575882680,3575882705,25
0,1033,32531,3575882680,3575882706,26
0,1033,32532,3575882680,3575882707,27
0,1033,32533,3575882680,3575882707,27
0,1033,32534,3575882680,3575882707,27
0,1033,32535,3575882680,3575882708,28
0,1033,32536,3575882680,3575882708,28
0,1033,32537,3575882680,3575882709,29
0,1033,32538,3575882680,3575882710,30
0,1033,32539,3575882680,3575882710,30
0,1033,32540,3575882680,3575882711,31
0,1033,32541,3575882680,3575882711,31
0,1033,32542,3575882680,3575882712,32
0,1033,32543,3575882680,3575882712,32
0,1033,32544,3575882680,3575882713,33
0,1033,32545,3575882680,3575882714,34
0,1033,32546,3575882680,3575882716,36
0,1033,32547,3575882680,3575882717,37
0,1033,32548,3575882680,3575882717,37
0,1033,32549,3575882680,3575882719,39
0,1033,32550,3575882680,3575882719,39
0,1033,32551,3575882680,3575882719,39
0,1033,32552,3575882680,3575882720,40
0,1033,32553,3575882680,3575882722,42
0,1033,32554,3575882680,3575882723,43
0,1033,32555,3575882680,3575882723,43
0,1033,32556,3575882680,3575882723,43
0,1033,32557,3575882680,3575882724,44
0,1033,32558,3575882680,3575882724,44
0,1033,32559,3575882680,3575882724,44
0,1033,32560,3575882680,3575882725,45
0,1033,32561,3575882680,3575882726,46
0,1033,32562,3575882680,3575882728,48
0,1033,32563,3575882680,3575882728,48
0,1033,32564,3575882680,3575882728,48
0,1033,32565,3575882680,3575882728,48
0,1033,32566,3575882680,3575882729,49
0,1033,32567,3575882680,3575882729,49
0,1033,32568,3575882680,3575882730,50
0,1034,32569,3575882747,3575882747,0
0,1034,32570,3575882747,3575882747,0
0,1034,32571,3575882747,3575882747,0
0,1034,32572,3575882747,3575882747,0
0,1034,32573,3575882747,3575882747,0
0,1034,32574,3575882747,3575882747,0
0,1034,32575,3575882747,3575882747,0
0,1034,32576,3575882747,3575882747,0
0,1034,32577,3575882747,3575882747,0
0,1034,32578,3575882747,3575882747,0
0,1034,32579,3575882747,3575882747,0
0,1034,32580,3575882747,3575882747,0
0,1034,32581,3575882747,3575882747,0
0,1034,32582,3575882747,3575882747,0
0,1034,32583,3575882747,3575882747,0
0,1034,32584,3575882747,3575882747,0
0,1034,32585,3575882747,3575882747,0
0,1034,32586,3575882747,3575882747,0
0,1034,32587,3575882747,3575882747,0
0,1034,32588,3575882747,3575882748,1
0,1034,32589,3575882747,3575882748,1
0,1034,32590,3575882747,3575882748,1
0,1034,32591,3575882747,3575882748,1
0,1034,32592,3575882747,3575882748,1
0,1034,32593,3575882747,3575882748,1
0,1034,32594,3575882747,3575882748,1
0,1034,32595,3575882747,3575882748,1
0,1034,32596,3575882747,3575882748,1
0,1034,32597,3575882747,3575882748,1
0,1034,32598,3575882747,3575882748,1
0,1034,32599,3575882747,3575882748,1
0,1034,32600,3575882747,3575882752,5
0,1034,32601,3575882747,3575882752,5
0,1034,32602,3575882747,3575882753,6
0,1034,32603,3575882747,3575882753,6
0,1034,32604,3575882747,3575882754,7
0,1034,32605,3575882747,3575882754,7
0,1034,32606,3575882747,3575882755,8
0,1034,32607,3575882747,3575882755,8
0,1034,32608,3575882747,3575882756,9
0,1034,32609,3575882747,3575882756,9
0,1034,32610,3575882747,3575882758,11
0,1034,32611,3575882747,3575882758,11
0,1034,32612,3575882747,3575882759,12
0,1034,32613,3575882747,3575882761,14
0,1034,32614,3575882747,3575882761,14
0,1034,32615,3575882747,3575882761,14
0,1034,32616,3575882747,3575882762,15
0,1034,32617,3575882747,3575882762,15
0,1034,32618,3575882747,3575882763,16
0,1034,32619,3575882747,3575882764,17
0,1034,32620,3575882747,3575882765,18
0,1034,32621,3575882747,3575882765,18
0,1034,32622,3575882747,3575882765,18
0,1034,32623,3575882747,3575882765,18
0,1034,32624,3575882747,3575882765,18
0,1034,32625,3575882747,3575882766,19
0,1034,32626,3575882747,3575882767,20
0,1034,32627,3575882747,3575882768,21
0,1034,32628,3575882747,3575882770,23
0,1034,32629,3575882747,3575882771,24
0,1034,32630,3575882747,3575882772,25
0,1034,32631,3575882747,3575882775,28
0,1034,32632,3575882747,3575882776,29
0,1034,32633,3575882747,3575882776,29
0,1034,32634,3575882747,3575882776,29
0,1034,32635,3575882747,3575882776,29
0,1034,32636,3575882747,3575882777,30
0,1034,32637,3575882747,3575882777,30
0,1034,32638,3575882747,3575882777,30
0,1034,32639,3575882747,3575882777,30
0,1034,32640,3575882747,3575882780,33
0,1034,32641,3575882747,3575882781,34
0,1034,32642,3575882747,3575882782,35
0,1034,32643,3575882747,3575882783,36
0,1034,32644,3575882747,3575882784,37
0,1034,32645,3575882747,3575882785,38
0,1034,32646,3575882747,3575882786,39
0,1034,32647,3575882747,3575882786,39
0,1034,32648,3575882747,3575882788,41
0,1034,32649,3575882747,3575882789,42
0,1034,32650,3575882747,3575882789,42
0,1034,32651,3575882747,3575882793,46
0,1034,32652,3575882747,3575882794,47
0,1034,32653,3575882747,3575882795,48
0,1035,32654,3575882816,3575882816,0
0,1035,32655,3575882816,3575882816,0
0,1035,32656,3575882816,3575882816,0
0,1035,32657,3575882816,3575882816,0
0,1035,32658,3575882816,3575882816,0
0,1035,32659,3575882816,3575882816,0
0,1035,32660,3575882816,3575882816,0
0,1035,32661,3575882816,3575882816,0
0,1035,32662,3575882816,3575882816,0
0,1035,32663,3575882816,3575882816,0
0,1035,32664,3575882816,3575882816,0
0,1035,32665,3575882816,3575882816,0
0,1035,32666,3575882816,3575882816,0
0,1035,32667,3575882816,3575882816,0
0,1035,32668,3575882816,3575882816,0
0,1035,32669,3575882816,3575882816,0
0,1035,32670,3575882816,3575882816,0
0,1035,32671,3575882816,3575882816,0
0,1035,32672,3575882816,3575882816,0
0,1035,32673,3575882816,3575882816,0
0,1035,32674,3575882816,3575882816,0
0,1035,32675,3575882816,3575882816,0
0,1035,32676,3575882816,3575882818,2
0,1035,32677,3575882816,3575882818,2
0,1035,32678,3575882816,3575882819,3
0,1035,32679,3575882816,3575882820,4
0,1035,32680,3575882816,3575882821,5
0,1035,32681,3575882816,3575882821,5
0,1035,32682,3575882816,3575882822,6
0,1035,32683,3575882816,3575882823,7
0,1035,32684,3575882816,3575882826,10
0,1035,32685,3575882816,3575882828,12
0,1035,32686,3575882816,3575882829,13
0,1035,32687,3575882816,3575882829,13
0,1035,32688,3575882816,3575882829,13
0,1035,32689,3575882816,3575882831,15
0,1035,32690,3575882816,3575882831,15
0,1035,32691,3575882816,3575882831,15
0,1035,32692,3575882816,3575882831,15
0,1035,32693,3575882816,3575882831,15
0,1035,32694,3575882816,3575882831,15
0,1035,32695,3575882816,3575882832,16
0,1035,32696,3575882816,3575882832,16
0,1035,32697,3575882816,3575882832,16
0,1035,32698,3575882816,3575882832,16
0,1035,32699,3575882816,3575882833,17
0,1035,32700,3575882816,3575882833,17
0,1035,32701,3575882816,3575882833,17
0,1035,32702,3575882816,3575882834,18
0,1035,32703,3575882816,3575882841,25
0,1035,32704,3575882816,3575882841,25
0,1035,32705,3575882816,3575882842,26
0,1035,32706,3575882816,3575882842,26
0,1035,32707,3575882816,3575882842,26
0,1035,32708,3575882816,3575882843,27
0,1035,32709,3575882816,3575882843,27
0,1035,32710,3575882816,3575882844,28
0,1035,32711,3575882816,3575882845,29
0,1035,32712,3575882816,3575882847,31
0,1035,32713,3575882816,3575882847,31
0,1035,32714,3575882816,3575882848,32
0,1035,32715,3575882816,3575882848,32
0,1035,32716,3575882816,3575882849,33
0,1035,32717,3575882816,3575882851,35
0,1035,32718,3575882816,3575882851,35
0,1035,32719,3575882816,3575882854,38
0,1035,32720,3575882816,3575882855,39
0,1035,32721,3575882816,3575882855,39
0,1035,32722,3575882816,3575882856,40
0,1035,32723,3575882816,3575882857,41
0,1035,32724,3575882816,3575882857,41
0,1035,32725,3575882816,3575882859,43
0,1035,32726,3575882816,3575882860,44
0,1035,32727,3575882816,3575882860,44
0,1035,32728,3575882816,3575882861,45
0,1035,32729,3575882816,3575882861,45
0,1035,32730,3575882816,3575882862,46
0,1035,32731,3575882816,3575882863,47
0,1035,32732,3575882816,3575882865,49
0,1036,32733,3575882879,3575882879,0
0,1036,32734,3575882879,3575882879,0
0,1036,32735,3575882879,3575882879,0
0,1036,32736,3575882879,3575882879,0
0,1036,32737,3575882879,3575882879,0
0,1036,32738,3575882879,3575882879,0
0,1036,32739,3575882879,3575882879,0
0,1036,32740,3575882879,3575882879,0
0,1036,32741,3575882879,3575882879,0
0,1036,32742,3575882879,3575882879,0
0,1036,32743,3575882879,3575882879,0
0,1036,32744,3575882879,3575882879,0
0,1036,32745,3575882879,3575882879,0
0,1036,32746,3575882879,3575882879,0
0,1036,32747,3575882879,3575882883,4
0,1036,32748,3575882879,3575882886,7
0,1036,32749,3575882879,3575882886,7
0,1036,32750,3575882879,3575882886,7
0,1036,32751,3575882879,3575882887,8
0,1036,32752,3575882879,3575882887,8
0,1036,32753,3575882879,3575882887,8
0,1036,32754,3575882879,3575882888,9
0,1036,32755,3575882879,3575882888,9
0,1036,32756,3575882879,3575882889,10
0,1036,32757,3575882879,3575882890,11
0,1036,32758,3575882879,3575882892,13
0,1036,32759,3575882879,3575882892,13
0,1036,32760,3575882879,3575882893,14
0,1036,32761,3575882879,3575882893,14
0,1036,32762,3575882879,3575882893,14
0,1036,32763,3575882879,3575882894,15
0,1036,32764,3575882879,3575882895,16
0,1036,32765,3575882879,3575882895,16
0,1036,32766,3575882879,3575882895,16
0,1036,32767,3575882879,3575882896,17
0,1036,32768,3575882879,3575882896,17
0,1036,32769,3575882879,3575882896,17
0,1036,32770,3575882879,3575882897,18
0,1036,32771,3575882879,3575882898,19
0,1036,32772,3575882879,3575882898,19
0,1036,32773,3575882879,3575882899,20
0,1036,32774,3575882879,3575882899,20
0,1036,32775,3575882879,3575882900,21
0,1036,32776,3575882879,3575882901,22
0,1036,32777,3575882879,3575882901,22
0,1036,32778,3575882879,3575882902,23
0,1036,32779,3575882879,3575882902,23
0,1036,32780,3575882879,3575882903,24
0,1036,32781,3575882879,3575882903,24
0,1036,32782,3575882879,3575882904,25
0,1036,32783,3575882879,3575882905,26
0,1036,32784,3575882879,3575882905,26
0,1036,32785,3575882879,3575882907,28
0,1036,32786,3575882879,3575882908,29
0,1036,32787,3575882879,3575882908,29
0,1036,32788,3575882879,3575882908,29
0,1036,32789,3575882879,3575882908,29
0,1036,32790,3575882879,3575882910,31
0,1036,32791,3575882879,3575882910,31
0,1036,32792,3575882879,3575882910,31
0,1036,32793,3575882879,3575882911,32
0,1036,32794,3575882879,3575882912,33
0,1036,32795,3575882879,3575882912,33
0,1036,32796,3575882879,3575882913,34
0,1036,32797,3575882879,3575882913,34
0,1036,32798,3575882879,3575882914,35
0,1036,32799,3575882879,3575882915,36
0,1036,32800,3575882879,3575882916,37
0,1036,32801,3575882879,3575882917,38
0,1036,32802,3575882879,3575882917,38
0,1036,32803,3575882879,3575882919,40
0,1036,32804,3575882879,3575882919,40
0,1036,32805,3575882879,3575882922,43
0,1036,32806,3575882879,3575882922,43
0,1036,32807,3575882879,3575882922,43
0,1036,32808,3575882879,3575882923,44
0,1036,32809,3575882879,3575882923,44
0,1036,32810,3575882879,3575882924,45
0,1036,32811,3575882879,3575882924,45
0,1036,32812,3575882879,3575882924,45
0,1036,32813,3575882879,3575882925,46
0,1036,32814,3575882879,3575882925,46
0,1036,32815,3575882879,3575882926,47
0,1036,32816,3575882879,3575882926,47
0,1036,32817,3575882879,3575882929,50
0,1036,32818,3575882879,3575882929,50
0,1036,32819,3575882879,3575882929,50
0,1036,32820,3575882879,3575882929,50
0,1037,32821,3575882944,3575882944,0
0,1037,32822,3575882944,3575882944,0
0,1037,32823,3575882944,3575882944,0
0,1037,32824,3575882944,3575882944,0
0,1037,32825,3575882944,3575882944,0
0,1037,32826,3575882944,3575882944,0
0,1037,32827,3575882944,3575882944,0
0,1037,32828,3575882944,3575882944,0
0,1037,32829,3575882944,3575882944,0
0,1037,32830,3575882944,3575882944,0
0,1037,32831,3575882944,3575882944,0
0,1037,32832,3575882944,3575882944,0
0,1037,32833,3575882944,3575882944,0
0,1037,32834,3575882944,3575882944,0
0,1037,32835,3575882944,3575882944,0
0,1037,32836,3575882944,3575882944,0
0,1037,32837,3575882944,3575882944,0
0,1037,32838,3575882944,3575882944,0
0,1037,32839,3575882944,3575882944,0
0,1037,32840,3575882944,3575882944,0
0,1037,32841,3575882944,3575882944,0
0,1037,32842,3575882944,3575882944,0
0,1037,32843,3575882944,3575882944,0
0,1037,32844,3575882944,3575882944,0
0,1037,32845,3575882944,3575882944,0
0,1037,32846,3575882944,3575882945,1
0,1037,32847,3575882944,3575882945,1
0,1037,32848,3575882944,3575882945,1
0,1037,32849,3575882944,3575882946,2
0,1037,32850,3575882944,3575882947,3
0,1037,32851,3575882944,3575882947,3
0,1037,32852,3575882944,3575882948,4
0,1037,32853,3575882944,3575882948,4
0,1037,32854,3575882944,3575882948,4
0,1037,32855,3575882944,3575882949,5
0,1037,32856,3575882944,3575882951,7
0,1037,32857,3575882944,3575882952,8
0,1037,32858,3575882944,3575882953,9
0,1037,32859,3575882944,3575882953,9
0,1037,32860,3575882944,3575882953,9
0,1037,32861,3575882944,3575882954,10
0,1037,32862,3575882944,3575882954,10
0,1037,32863,3575882944,3575882955,11
0,1037,32864,3575882944,3575882956,12
0,1037,32865,3575882944,3575882956,12
0,1037,32866,3575882944,3575882957,13
0,1037,32867,3575882944,3575882958,14
0,1037,32868,3575882944,3575882959,15
0,1037,32869,3575882944,3575882960,16
0,1037,32870,3575882944,3575882961,17
0,1037,32871,3575882944,3575882962,18
0,1037,32872,3575882944,3575882962,18
0,1037,32873,3575882944,3575882962,18
0,1037,32874,3575882944,3575882963,19
0,1037,32875,3575882944,3575882963,19
0,1037,32876,3575882944,3575882963,19
0,1037,32877,3575882944,3575882964,20
0,1037,32878,3575882944,3575882965,21
0,1037,32879,3575882944,3575882965,21
0,1037,32880,3575882944,3575882965,21
0,1037,32881,3575882944,3575882966,22
0,1037,32882,3575882944,3575882966,22
0,1037,32883,3575882944,3575882967,23
0,1037,32884,3575882944,3575882967,23
0,1037,32885,3575882944,3575882970,26
0,1037,32886,3575882944,3575882971,27
0,1037,32887,3575882944,3575882971,27
0,1037,32888,3575882944,3575882971,27
0,1037,32889,3575882944,3575882975,31
0,1037,32890,3575882944,3575882976,32
0,1037,32891,3575882944,3575882976,32
0,1037,32892,3575882944,3575882976,32
0,1037,32893,3575882944,3575882976,32
0,1037,32894,3575882944,3575882977,33
0,1037,32895,3575882944,3575882977,33
0,1037,32896,3575882944,3575882978,34
0,1037,32897,3575882944,3575882980,36
0,1037,32898,3575882944,3575882981,37
0,1037,32899,3575882944,3575882982,38
0,1037,32900,3575882944,3575882984,40
0,1037,32901,3575882944,3575882984,40
0,1037,32902,3575882944,3575882986,42
0,1037,32903,3575882944,3575882986,42
0,1037,32904,3575882944,3575882986,42
0,1037,32905,3575882944,3575882989,45
0,1037,32906,3575882944,3575882989,45
0,1037,32907,3575882944,3575882990,46
0,1037,32908,3575882944,3575882994,50
0,1038,32909,3575883007,3575883007,0
0,1038,32910,3575883007,3575883007,0
0,1038,32911,3575883007,3575883007,0
0,1038,32912,3575883007,3575883007,0
0,1038,32913,3575883007,3575883007,0
0,1038,32914,3575883007,3575883007,0
0,1038,32915,3575883007,3575883007,0
0,1038,32916,3575883007,3575883007,0
0,1038,32917,3575883007,3575883007,0
0,1038,32918,3575883007,3575883007,0
0,1038,32919,3575883007,3575883007,0
0,1038,32920,3575883007,3575883007,0
0,1038,32921,3575883007,3575883007,0
0,1038,32922,3575883007,3575883008,1
0,1038,32923,3575883007,3575883010,3
0,1038,32924,3575883007,3575883012,5
0,1038,32925,3575883007,3575883012,5
0,1038,32926,3575883007,3575883012,5
0,1038,32927,3575883007,3575883014,7
0,1038,32928,3575883007,3575883014,7
0,1038,32929,3575883007,3575883014,7
0,1038,32930,3575883007,3575883014,7
0,1038,32931,3575883007,3575883015,8
0,1038,32932,3575883007,3575883015,8
0,1038,32933,3575883007,3575883015,8
0,1038,32934,3575883007,3575883018,11
0,1038,32935,3575883007,3575883018,11
0,1038,32936,3575883007,3575883019,12
0,1038,32937,3575883007,3575883021,14
0,1038,32938,3575883007,3575883021,14
0,1038,32939,3575883007,3575883021,14
0,1038,32940,3575883007,3575883022,15
0,1038,32941,3575883007,3575883023,16
0,1038,32942,3575883007,3575883026,19
0,1038,32943,3575883007,3575883027,20
0,1038,32944,3575883007,3575883028,21
0,1038,32945,3575883007,3575883029,22
0,1038,32946,3575883007,3575883029,22
0,1038,32947,3575883007,3575883030,23
0,1038,32948,3575883007,3575883031,24
0,1038,32949,3575883007,3575883031,24
0,1038,32950,3575883007,3575883031,24
0,1038,32951,3575883007,3575883031,24
0,1038,32952,3575883007,3575883032,25
0,1038,32953,3575883007,3575883032,25
0,1038,32954,3575883007,3575883032,25
0,1038,32955,3575883007,3575883032,25
0,1038,32956,3575883007,3575883033,26
0,1038,32957,3575883007,3575883033,26
0,1038,32958,3575883007,3575883033,26
0,1038,32959,3575883007,3575883034,27
0,1038,32960,3575883007,3575883034,27
0,1038,32961,3575883007,3575883034,27
0,1038,32962,3575883007,3575883038,31
0,1038,32963,3575883007,3575883040,33
0,1038,32964,3575883007,3575883040,33
0,1038,32965,3575883007,3575883041,34
0,1038,32966,3575883007,3575883042,35
0,1038,32967,3575883007,3575883042,35
0,1038,32968,3575883007,3575883044,37
0,1038,32969,3575883007,3575883044,37
0,1038,32970,3575883007,3575883047,40
0,1038,32971,3575883007,3575883047,40
0,1038,32972,3575883007,3575883047,40
0,1038,32973,3575883007,3575883048,41
0,1038,32974,3575883007,3575883049,42
0,1038,32975,3575883007,3575883050,43
0,1038,32976,3575883007,3575883051,44
0,1038,32977,3575883007,3575883051,44
0,1038,32978,3575883007,3575883052,45
0,1038,32979,3575883007,3575883054,47
0,1038,32980,3575883007,3575883054,47
0,1038,32981,3575883007,3575883055,48
0,1038,32982,3575883007,3575883057,50
0,1039,32983,3575883071,3575883071,0
0,1039,32984,3575883071,3575883071,0
0,1039,32985,3575883071,3575883071,0
0,1039,32986,3575883071,3575883071,0
0,1039,32987,3575883071,3575883071,0
0,1039,32988,3575883071,3575883071,0
0,1039,32989,3575883071,3575883071,0
0,1039,32990,3575883071,3575883071,0
0,1039,32991,3575883071,3575883071,0
0,1039,32992,3575883071,3575883071,0
0,1039,32993,3575883071,3575883071,0
0,1039,32994,3575883071,3575883071,0
0,1039,32995,3575883071,3575883071,0
0,1039,32996,3575883071,3575883071,0
0,1039,32997,3575883071,3575883071,0
0,1039,32998,3575883071,3575883071,0
0,1039,32999,3575883071,3575883071,0
0,1039,33000,3575883071,3575883071,0
0,1039,33001,3575883071,3575883071,0
0,1039,33002,3575883071,3575883071,0
0,1039,33003,3575883071,3575883071,0
0,1039,33004,3575883071,3575883071,0
0,1039,33005,3575883071,3575883075,4
0,1039,33006,3575883071,3575883077,6
0,1039,33007,3575883071,3575883077,6
0,1039,33008,3575883071,3575883078,7
0,1039,33009,3575883071,3575883083,12
0,1039,33010,3575883071,3575883086,15
0,1039,33011,3575883071,3575883086,15
0,1039,33012,3575883071,3575883086,15
0,1039,33013,3575883071,3575883087,16
0,1039,33014,3575883071,3575883087,16
0,1039,33015,3575883071,3575883088,17
0,1039,33016,3575883071,3575883088,17
0,1039,33017,3575883071,3575883088,17
0,1039,33018,3575883071,3575883089,18
0,1039,33019,3575883071,3575883089,18
0,1039,33020,3575883071,3575883091,20
0,1039,33021,3575883071,3575883092,21
0,1039,33022,3575883071,3575883092,21
0,1039,33023,3575883071,3575883093,22
0,1039,33024,3575883071,3575883093,22
0,1039,33025,3575883071,3575883093,22
0,1039,33026,3575883071,3575883093,22
0,1039,33027,3575883071,3575883094,23
0,1039,33028,3575883071,3575883095,24
0,1039,33029,3575883071,3575883095,24
0,1039,33030,3575883071,3575883095,24
0,1039,33031,3575883071,3575883096,25
0,1039,33032,3575883071,3575883096,25
0,1039,33033,3575883071,3575883097,26
0,1039,33034,3575883071,3575883097,26
0,1039,33035,3575883071,3575883098,27
0,1039,33036,3575883071,3575883099,28
0,1039,33037,3575883071,3575883100,29
0,1039,33038,3575883071,3575883101,30
0,1039,33039,3575883071,3575883102,31
0,1039,33040,3575883071,3575883102,31
0,1039,33041,3575883071,3575883103,32
0,1039,33042,3575883071,3575883103,32
0,1039,33043,3575883071,3575883104,33
0,1039,33044,3575883071,3575883104,33
0,1039,33045,3575883071,3575883105,34
0,1039,33046,3575883071,3575883105,34
0,1039,33047,3575883071,3575883105,34
0,1039,33048,3575883071,3575883107,36
0,1039,33049,3575883071,3575883108,37
0,1039,33050,3575883071,3575883108,37
0,1039,33051,3575883071,3575883109,38
0,1039,33052,3575883071,3575883110,39
0,1039,33053,3575883071,3575883110,39
0,1039,33054,3575883071,3575883110,39
0,1039,33055,3575883071,3575883111,40
0,1039,33056,3575883071,3575883112,41
0,1039,33057,3575883071,3575883112,41
0,1039,33058,3575883071,3575883113,42
0,1039,33059,3575883071,3575883113,42
0,1039,33060,3575883071,3575883114,43
0,1039,33061,3575883071,3575883114,43
0,1039,33062,3575883071,3575883116,45
0,1039,33063,3575883071,3575883116,45
0,1039,33064,3575883071,3575883117,46
0,1039,33065,3575883071,3575883117,46
0,1039,33066,3575883071,3575883119,48
0,1039,33067,3575883071,3575883120,49
0,1039,33068,3575883071,3575883120,49
0,1039,33069,3575883071,3575883121,50
0,1040,33070,3575883134,3575883134,0
0,1040,33071,3575883134,3575883135,1
0,1040,33072,3575883134,3575883135,1
0,1040,33073,3575883134,3575883135,1
0,1040,33074,3575883134,3575883135,1
0,1040,33075,3575883134,3575883135,1
0,1040,33076,3575883134,3575883135,1
0,1040,33077,3575883134,3575883135,1
0,1040,33078,3575883134,3575883135,1
0,1040,33079,3575883134,3575883135,1
0,1040,33080,3575883134,3575883135,1
0,1040,33081,3575883134,3575883135,1
0,1040,33082,3575883134,3575883135,1
0,1040,33083,3575883134,3575883135,1
0,1040,33084,3575883134,3575883135,1
0,1040,33085,3575883134,3575883135,1
0,1040,33086,3575883134,3575883135,1
0,1040,33087,3575883134,3575883135,1
0,1040,33088,3575883134,3575883135,1
0,1040,33089,3575883134,3575883135,1
0,1040,33090,3575883134,3575883135,1
0,1040,33091,3575883134,3575883136,2
0,1040,33092,3575883134,3575883137,3
0,1040,33093,3575883134,3575883137,3
0,1040,33094,3575883134,3575883138,4
0,1040,33095,3575883134,3575883139,5
0,1040,33096,3575883134,3575883139,5
0,1040,33097,3575883134,3575883140,6
0,1040,33098,3575883134,3575883140,6
0,1040,33099,3575883134,3575883140,6
0,1040,33100,3575883134,3575883141,7
0,1040,33101,3575883134,3575883142,8
0,1040,33102,3575883134,3575883142,8
0,1040,33103,3575883134,3575883143,9
0,1040,33104,3575883134,3575883143,9
0,1040,33105,3575883134,3575883143,9
0,1040,33106,3575883134,3575883143,9
0,1040,33107,3575883134,3575883144,10
0,1040,33108,3575883134,3575883145,11
0,1040,33109,3575883134,3575883145,11
0,1040,33110,3575883134,3575883146,12
0,1040,33111,3575883134,3575883146,12
0,1040,33112,3575883134,3575883147,13
0,1040,33113,3575883134,3575883147,13
0,1040,33114,3575883134,3575883149,15
0,1040,33115,3575883134,3575883149,15
0,1040,33116,3575883134,3575883152,18
0,1040,33117,3575883134,3575883153,19
0,1040,33118,3575883134,3575883153,19
0,1040,33119,3575883134,3575883153,19
0,1040,33120,3575883134,3575883154,20
0,1040,33121,3575883134,3575883154,20
0,1040,33122,3575883134,3575883155,21
0,1040,33123,3575883134,3575883156,22
0,1040,33124,3575883134,3575883157,23
0,1040,33125,3575883134,3575883157,23
0,1040,33126,3575883134,3575883157,23
0,1040,33127,3575883134,3575883158,24
0,1040,33128,3575883134,3575883161,27
0,1040,33129,3575883134,3575883161,27
0,1040,33130,3575883134,3575883162,28
0,1040,33131,3575883134,3575883162,28
0,1040,33132,3575883134,3575883163,29
0,1040,33133,3575883134,3575883163,29
0,1040,33134,3575883134,3575883163,29
0,1040,33135,3575883134,3575883164,30
0,1040,33136,3575883134,3575883164,30
0,1040,33137,3575883134,3575883165,31
0,1040,33138,3575883134,3575883165,31
0,1040,33139,3575883134,3575883166,32
0,1040,33140,3575883134,3575883166,32
0,1040,33141,3575883134,3575883167,33
0,1040,33142,3575883134,3575883167,33
0,1040,33143,3575883134,3575883168,34
0,1040,33144,3575883134,3575883170,36
0,1040,33145,3575883134,3575883171,37
0,1040,33146,3575883134,3575883172,38
0,1040,33147,3575883134,3575883173,39
0,1040,33148,3575883134,3575883175,41
0,1040,33149,3575883134,3575883176,42
0,1040,33150,3575883134,3575883176,42
0,1040,33151,3575883134,3575883176,42
0,1040,33152,3575883134,3575883176,42
0,1040,33153,3575883134,3575883177,43
0,1040,33154,3575883134,3575883178,44
0,1040,33155,3575883134,3575883178,44
0,1040,33156,3575883134,3575883178,44
0,1040,33157,3575883134,3575883180,46
0,1040,33158,3575883134,3575883181,47
0,1040,33159,3575883134,3575883182,48
0,1040,33160,3575883134,3575883184,50
0,1041,33161,3575883198,3575883198,0
0,1041,33162,3575883198,3575883198,0
0,1041,33163,3575883198,3575883198,0
0,1041,33164,3575883198,3575883198,0
0,1041,33165,3575883198,3575883198,0
0,1041,33166,3575883198,3575883198,0
0,1041,33167,3575883198,3575883198,0
0,1041,33168,3575883198,3575883198,0
0,1041,33169,3575883198,3575883198,0
0,1041,33170,3575883198,3575883198,0
0,1041,33171,3575883198,3575883198,0
0,1041,33172,3575883198,3575883198,0
0,1041,33173,3575883198,3575883200,2
0,1041,33174,3575883198,3575883200,2
0,1041,33175,3575883198,3575883201,3
0,1041,33176,3575883198,3575883201,3
0,1041,33177,3575883198,3575883204,6
0,1041,33178,3575883198,3575883205,7
0,1041,33179,3575883198,3575883206,8
0,1041,33180,3575883198,3575883206,8
0,1041,33181,3575883198,3575883207,9
0,1041,33182,3575883198,3575883208,10
0,1041,33183,3575883198,3575883208,10
0,1041,33184,3575883198,3575883210,12
0,1041,33185,3575883198,3575883212,14
0,1041,33186,3575883198,3575883212,14
0,1041,33187,3575883198,3575883213,15
0,1041,33188,3575883198,3575883214,16
0,1041,33189,3575883198,3575883214,16
0,1041,33190,3575883198,3575883214,16
0,1041,33191,3575883198,3575883215,17
0,1041,33192,3575883198,3575883215,17
0,1041,33193,3575883198,3575883215,17
0,1041,33194,3575883198,3575883216,18
0,1041,33195,3575883198,3575883218,20
0,1041,33196,3575883198,3575883219,21
0,1041,33197,3575883198,3575883219,21
0,1041,33198,3575883198,3575883221,23
0,1041,33199,3575883198,3575883221,23
0,1041,33200,3575883198,3575883221,23
0,1041,33201,3575883198,3575883222,24
0,1041,33202,3575883198,3575883223,25
0,1041,33203,3575883198,3575883227,29
0,1041,33204,3575883198,3575883227,29
0,1041,33205,3575883198,3575883228,30
0,1041,33206,3575883198,3575883229,31
0,1041,33207,3575883198,3575883229,31
0,1041,33208,3575883198,3575883230,32
0,1041,33209,3575883198,3575883231,33
0,1041,33210,3575883198,3575883231,33
0,1041,33211,3575883198,3575883231,33
0,1041,33212,3575883198,3575883231,33
0,1041,33213,3575883198,3575883232,34
0,1041,33214,3575883198,3575883232,34
0,1041,33215,3575883198,3575883232,34
0,1041,33216,3575883198,3575883232,34
0,1041,33217,3575883198,3575883233,35
0,1041,33218,3575883198,3575883233,35
0,1041,33219,3575883198,3575883233,35
0,1041,33220,3575883198,3575883233,35
0,1041,33221,3575883198,3575883234,36
0,1041,33222,3575883198,3575883234,36
0,1041,33223,3575883198,3575883238,40
0,1041,33224,3575883198,3575883240,42
0,1041,33225,3575883198,3575883240,42
0,1041,33226,3575883198,3575883241,43
0,1041,33227,3575883198,3575883242,44
0,1041,33228,3575883198,3575883243,45
0,1041,33229,3575883198,3575883244,46
0,1041,33230,3575883198,3575883244,46
0,1041,33231,3575883198,3575883247,49
0,1041,33232,3575883198,3575883247,49
0,1041,33233,3575883198,3575883247,49
0,1042,33234,3575883262,3575883262,0
0,1042,33235,3575883262,3575883262,0
0,1042,33236,3575883262,3575883262,0
0,1042,33237,3575883262,3575883262,0
0,1042,33238,3575883262,3575883262,0
0,1042,33239,3575883262,3575883262,0
0,1042,33240,3575883262,3575883262,0
0,1042,33241,3575883262,3575883262,0
0,1042,33242,3575883262,3575883262,0
0,1042,33243,3575883262,3575883262,0
0,1042,33244,3575883262,3575883262,0
0,1042,33245,3575883262,3575883262,0
0,1042,33246,3575883262,3575883262,0
0,1042,33247,3575883262,3575883262,0
0,1042,33248,3575883262,3575883262,0
0,1042,33249,3575883262,3575883262,0
0,1042,33250,3575883262,3575883262,0
0,1042,33251,3575883262,3575883262,0
0,1042,33252,3575883262,3575883262,0
0,1042,33253,3575883262,3575883262,0
0,1042,33254,3575883262,3575883263,1
0,1042,33255,3575883262,3575883265,3
0,1042,33256,3575883262,3575883266,4
0,1042,33257,3575883262,3575883267,5
0,1042,33258,3575883262,3575883267,5
0,1042,33259,3575883262,3575883267,5
0,1042,33260,3575883262,3575883268,6
0,1042,33261,3575883262,3575883268,6
0,1042,33262,3575883262,3575883269,7
0,1042,33263,3575883262,3575883269,7
0,1042,33264,3575883262,3575883270,8
0,1042,33265,3575883262,3575883275,13
0,1042,33266,3575883262,3575883276,14
0,1042,33267,3575883262,3575883277,15
0,1042,33268,3575883262,3575883277,15
0,1042,33269,3575883262,3575883278,16
0,1042,33270,3575883262,3575883284,22
0,1042,33271,3575883262,3575883286,24
0,1042,33272,3575883262,3575883287,25
0,1042,33273,3575883262,3575883287,25
0,1042,33274,3575883262,3575883287,25
0,1042,33275,3575883262,3575883287,25
0,1042,33276,3575883262,3575883288,26
0,1042,33277,3575883262,3575883288,26
0,1042,33278,3575883262,3575883289,27
0,1042,33279,3575883262,3575883290,28
0,1042,33280,3575883262,3575883291,29
0,1042,33281,3575883262,3575883292,30
0,1042,33282,3575883262,3575883293,31
0,1042,33283,3575883262,3575883293,31
0,1042,33284,3575883262,3575883294,32
0,1042,33285,3575883262,3575883294,32
0,1042,33286,3575883262,3575883295,33
0,1042,33287,3575883262,3575883295,33
0,1042,33288,3575883262,3575883295,33
0,1042,33289,3575883262,3575883295,33
0,1042,33290,3575883262,3575883296,34
0,1042,33291,3575883262,3575883296,34
0,1042,33292,3575883262,3575883297,35
0,1042,33293,3575883262,3575883297,35
0,1042,33294,3575883262,3575883297,35
0,1042,33295,3575883262,3575883299,37
0,1042,33296,3575883262,3575883299,37
0,1042,33297,3575883262,3575883300,38
0,1042,33298,3575883262,3575883302,40
0,1042,33299,3575883262,3575883303,41
0,1042,33300,3575883262,3575883303,41
0,1042,33301,3575883262,3575883303,41
0,1042,33302,3575883262,3575883303,41
0,1042,33303,3575883262,3575883304,42
0,1042,33304,3575883262,3575883304,42
0,1042,33305,3575883262,3575883305,43
0,1042,33306,3575883262,3575883305,43
0,1042,33307,3575883262,3575883306,44
0,1042,33308,3575883262,3575883307,45
0,1042,33309,3575883262,3575883307,45
0,1042,33310,3575883262,3575883308,46
0,1042,33311,3575883262,3575883308,46
0,1042,33312,3575883262,3575883309,47
0,1042,33313,3575883262,3575883309,47
0,1042,33314,3575883262,3575883310,48
0,1042,33315,3575883262,3575883311,49
0,1042,33316,3575883262,3575883311,49
0,1042,33317,3575883262,3575883312,50
0,1043,33318,3575883325,3575883325,0
0,1043,33319,3575883325,3575883325,0
0,1043,33320,3575883325,3575883325,0
0,1043,33321,3575883325,3575883325,0
0,1043,33322,3575883325,3575883325,0
0,1043,33323,3575883325,3575883325,0
0,1043,33324,3575883325,3575883325,0
0,1043,33325,3575883325,3575883325,0
0,1043,33326,3575883325,3575883325,0
0,1043,33327,3575883325,3575883325,0
0,1043,33328,3575883325,3575883325,0
0,1043,33329,3575883325,3575883325,0
0,1043,33330,3575883325,3575883325,0
0,1043,33331,3575883325,3575883325,0
0,1043,33332,3575883325,3575883325,0
0,1043,33333,3575883325,3575883325,0
0,1043,33334,3575883325,3575883325,0
0,1043,33335,3575883325,3575883325,0
0,1043,33336,3575883325,3575883325,0
0,1043,33337,3575883325,3575883326,1
0,1043,33338,3575883325,3575883326,1
0,1043,33339,3575883325,3575883327,2
0,1043,33340,3575883325,3575883328,3
0,1043,33341,3575883325,3575883328,3
0,1043,33342,3575883325,3575883328,3
0,1043,33343,3575883325,3575883329,4
0,1043,33344,3575883325,3575883329,4
0,1043,33345,3575883325,3575883329,4
0,1043,33346,3575883325,3575883330,5
0,1043,33347,3575883325,3575883331,6
0,1043,33348,3575883325,3575883334,9
0,1043,33349,3575883325,3575883335,10
0,1043,33350,3575883325,3575883335,10
0,1043,33351,3575883325,3575883336,11
0,1043,33352,3575883325,3575883336,11
0,1043,33353,3575883325,3575883337,12
0,1043,33354,3575883325,3575883337,12
0,1043,33355,3575883325,3575883338,13
0,1043,33356,3575883325,3575883338,13
0,1043,33357,3575883325,3575883338,13
0,1043,33358,3575883325,3575883340,15
0,1043,33359,3575883325,3575883340,15
0,1043,33360,3575883325,3575883340,15
0,1043,33361,3575883325,3575883340,15
0,1043,33362,3575883325,3575883342,17
0,1043,33363,3575883325,3575883342,17
0,1043,33364,3575883325,3575883342,17
0,1043,33365,3575883325,3575883343,18
0,1043,33366,3575883325,3575883343,18
0,1043,33367,3575883325,3575883344,19
0,1043,33368,3575883325,3575883345,20
0,1043,33369,3575883325,3575883345,20
0,1043,33370,3575883325,3575883346,21
0,1043,33371,3575883325,3575883346,21
0,1043,33372,3575883325,3575883346,21
0,1043,33373,3575883325,3575883347,22
0,1043,33374,3575883325,3575883348,23
0,1043,33375,3575883325,3575883349,24
0,1043,33376,3575883325,3575883349,24
0,1043,33377,3575883325,3575883349,24
0,1043,33378,3575883325,3575883351,26
0,1043,33379,3575883325,3575883352,27
0,1043,33380,3575883325,3575883352,27
0,1043,33381,3575883325,3575883353,28
0,1043,33382,3575883325,3575883353,28
0,1043,33383,3575883325,3575883354,29
0,1043,33384,3575883325,3575883354,29
0,1043,33385,3575883325,3575883356,31
0,1043,33386,3575883325,3575883357,32
0,1043,33387,3575883325,3575883358,33
0,1043,33388,3575883325,3575883358,33
0,1043,33389,3575883325,3575883358,33
0,1043,33390,3575883325,3575883360,35
0,1043,33391,3575883325,3575883361,36
0,1043,33392,3575883325,3575883362,37
0,1043,33393,3575883325,3575883362,37
0,1043,33394,3575883325,3575883363,38
0,1043,33395,3575883325,3575883363,38
0,1043,33396,3575883325,3575883364,39
0,1043,33397,3575883325,3575883365,40
0,1043,33398,3575883325,3575883365,40
0,1043,33399,3575883325,3575883366,41
0,1043,33400,3575883325,3575883366,41
0,1043,33401,3575883325,3575883366,41
0,1043,33402,3575883325,3575883367,42
0,1043,33403,3575883325,3575883368,43
0,1043,33404,3575883325,3575883368,43
0,1043,33405,3575883325,3575883371,46
0,1043,33406,3575883325,3575883371,46
0,1043,33407,3575883325,3575883372,47
0,1043,33408,3575883325,3575883373,48
0,1044,33409,3575883392,3575883392,0
0,1044,33410,3575883392,3575883392,0
0,1044,33411,3575883392,3575883392,0
0,1044,33412,3575883392,3575883392,0
0,1044,33413,3575883392,3575883392,0
0,1044,33414,3575883392,3575883392,0
0,1044,33415,3575883392,3575883392,0
0,1044,33416,3575883392,3575883392,0
0,1044,33417,3575883392,3575883392,0
0,1044,33418,3575883392,3575883392,0
0,1044,33419,3575883392,3575883392,0
0,1044,33420,3575883392,3575883392,0
0,1044,33421,3575883392,3575883392,0
0,1044,33422,3575883392,3575883392,0
0,1044,33423,3575883392,3575883392,0
0,1044,33424,3575883392,3575883392,0
0,1044,33425,3575883392,3575883392,0
0,1044,33426,3575883392,3575883392,0
0,1044,33427,3575883392,3575883392,0
0,1044,33428,3575883392,3575883392,0
0,1044,33429,3575883392,3575883394,2
0,1044,33430,3575883392,3575883394,2
0,1044,33431,3575883392,3575883395,3
0,1044,33432,3575883392,3575883399,7
0,1044,33433,3575883392,3575883400,8
0,1044,33434,3575883392,3575883400,8
0,1044,33435,3575883392,3575883400,8
0,1044,33436,3575883392,3575883401,9
0,1044,33437,3575883392,3575883401,9
0,1044,33438,3575883392,3575883405,13
0,1044,33439,3575883392,3575883405,13
0,1044,33440,3575883392,3575883406,14
0,1044,33441,3575883392,3575883406,14
0,1044,33442,3575883392,3575883406,14
0,1044,33443,3575883392,3575883409,17
0,1044,33444,3575883392,3575883410,18
0,1044,33445,3575883392,3575883412,20
0,1044,33446,3575883392,3575883412,20
0,1044,33447,3575883392,3575883412,20
0,1044,33448,3575883392,3575883414,22
0,1044,33449,3575883392,3575883414,22
0,1044,33450,3575883392,3575883415,23
0,1044,33451,3575883392,3575883415,23
0,1044,33452,3575883392,3575883415,23
0,1044,33453,3575883392,3575883416,24
0,1044,33454,3575883392,3575883416,24
0,1044,33455,3575883392,3575883418,26
0,1044,33456,3575883392,3575883419,27
0,1044,33457,3575883392,3575883419,27
0,1044,33458,3575883392,3575883421,29
0,1044,33459,3575883392,3575883422,30
0,1044,33460,3575883392,3575883422,30
0,1044,33461,3575883392,3575883423,31
0,1044,33462,3575883392,3575883423,31
0,1044,33463,3575883392,3575883427,35
0,1044,33464,3575883392,3575883427,35
0,1044,33465,3575883392,3575883428,36
0,1044,33466,3575883392,3575883429,37
0,1044,33467,3575883392,3575883430,38
0,1044,33468,3575883392,3575883431,39
0,1044,33469,3575883392,3575883431,39
0,1044,33470,3575883392,3575883431,39
0,1044,33471,3575883392,3575883432,40
0,1044,33472,3575883392,3575883432,40
0,1044,33473,3575883392,3575883432,40
0,1044,33474,3575883392,3575883432,40
0,1044,33475,3575883392,3575883433,41
0,1044,33476,3575883392,3575883433,41
0,1044,33477,3575883392,3575883433,41
0,1044,33478,3575883392,3575883433,41
0,1044,33479,3575883392,3575883433,41
0,1044,33480,3575883392,3575883434,42
0,1044,33481,3575883392,3575883434,42
0,1044,33482,3575883392,3575883435,43
0,1044,33483,3575883392,3575883439,47
0,1044,33484,3575883392,3575883440,48
0,1044,33485,3575883392,3575883440,48
0,1044,33486,3575883392,3575883441,49
0,1044,33487,3575883392,3575883442,50
0,1045,33488,3575883456,3575883456,0
0,1045,33489,3575883456,3575883456,0
0,1045,33490,3575883456,3575883456,0
0,1045,33491,3575883456,3575883456,0
0,1045,33492,3575883456,3575883456,0
0,1045,33493,3575883456,3575883456,0
0,1045,33494,3575883456,3575883456,0
0,1045,33495,3575883456,3575883456,0
0,1045,33496,3575883456,3575883456,0
0,1045,33497,3575883456,3575883456,0
0,1045,33498,3575883456,3575883456,0
0,1045,33499,3575883456,3575883456,0
0,1045,33500,3575883456,3575883456,0
0,1045,33501,3575883456,3575883457,1
0,1045,33502,3575883456,3575883457,1
0,1045,33503,3575883456,3575883457,1
0,1045,33504,3575883456,3575883458,2
0,1045,33505,3575883456,3575883458,2
0,1045,33506,3575883456,3575883460,4
0,1045,33507,3575883456,3575883460,4
0,1045,33508,3575883456,3575883461,5
0,1045,33509,3575883456,3575883461,5
0,1045,33510,3575883456,3575883461,5
0,1045,33511,3575883456,3575883462,6
0,1045,33512,3575883456,3575883462,6
0,1045,33513,3575883456,3575883463,7
0,1045,33514,3575883456,3575883464,8
0,1045,33515,3575883456,3575883465,9
0,1045,33516,3575883456,3575883466,10
0,1045,33517,3575883456,3575883467,11
0,1045,33518,3575883456,3575883467,11
0,1045,33519,3575883456,3575883467,11
0,1045,33520,3575883456,3575883468,12
0,1045,33521,3575883456,3575883468,12
0,1045,33522,3575883456,3575883468,12
0,1045,33523,3575883456,3575883469,13
0,1045,33524,3575883456,3575883469,13
0,1045,33525,3575883456,3575883469,13
0,1045,33526,3575883456,3575883475,19
0,1045,33527,3575883456,3575883477,21
0,1045,33528,3575883456,3575883477,21
0,1045,33529,3575883456,3575883477,21
0,1045,33530,3575883456,3575883478,22
0,1045,33531,3575883456,3575883482,26
0,1045,33532,3575883456,3575883483,27
0,1045,33533,3575883456,3575883486,30
0,1045,33534,3575883456,3575883487,31
0,1045,33535,3575883456,3575883487,31
0,1045,33536,3575883456,3575883487,31
0,1045,33537,3575883456,3575883487,31
0,1045,33538,3575883456,3575883488,32
0,1045,33539,3575883456,3575883489,33
0,1045,33540,3575883456,3575883491,35
0,1045,33541,3575883456,3575883491,35
0,1045,33542,3575883456,3575883492,36
0,1045,33543,3575883456,3575883494,38
0,1045,33544,3575883456,3575883494,38
0,1045,33545,3575883456,3575883495,39
0,1045,33546,3575883456,3575883495,39
0,1045,33547,3575883456,3575883495,39
0,1045,33548,3575883456,3575883495,39
0,1045,33549,3575883456,3575883496,40
0,1045,33550,3575883456,3575883497,41
0,1045,33551,3575883456,3575883497,41
0,1045,33552,3575883456,3575883497,41
0,1045,33553,3575883456,3575883498,42
0,1045,33554,3575883456,3575883498,42
0,1045,33555,3575883456,3575883499,43
0,1045,33556,3575883456,3575883500,44
0,1045,33557,3575883456,3575883501,45
0,1045,33558,3575883456,3575883501,45
0,1045,33559,3575883456,3575883503,47
0,1045,33560,3575883456,3575883503,47
0,1045,33561,3575883456,3575883503,47
0,1045,33562,3575883456,3575883504,48
0,1045,33563,3575883456,3575883504,48
0,1045,33564,3575883456,3575883505,49
0,1045,33565,3575883456,3575883505,49
0,1045,33566,3575883456,3575883505,49
0,1046,33567,3575883519,3575883519,0
0,1046,33568,3575883519,3575883519,0
0,1046,33569,3575883519,3575883519,0
0,1046,33570,3575883519,3575883519,0
0,1046,33571,3575883519,3575883519,0
0,1046,33572,3575883519,3575883519,0
0,1046,33573,3575883519,3575883519,0
0,1046,33574,3575883519,3575883519,0
0,1046,33575,3575883519,3575883519,0
0,1046,33576,3575883519,3575883519,0
0,1046,33577,3575883519,3575883519,0
0,1046,33578,3575883519,3575883519,0
0,1046,33579,3575883519,3575883519,0
0,1046,33580,3575883519,3575883519,0
0,1046,33581,3575883519,3575883519,0
0,1046,33582,3575883519,3575883519,0
0,1046,33583,3575883519,3575883519,0
0,1046,33584,3575883519,3575883519,0
0,1046,33585,3575883519,3575883520,1
0,1046,33586,3575883519,3575883520,1
0,1046,33587,3575883519,3575883520,1
0,1046,33588,3575883519,3575883521,2
0,1046,33589,3575883519,3575883521,2
0,1046,33590,3575883519,3575883522,3
0,1046,33591,3575883519,3575883523,4
0,1046,33592,3575883519,3575883523,4
0,1046,33593,3575883519,3575883524,5
0,1046,33594,3575883519,3575883525,6
0,1046,33595,3575883519,3575883525,6
0,1046,33596,3575883519,3575883526,7
0,1046,33597,3575883519,3575883526,7
0,1046,33598,3575883519,3575883527,8
0,1046,33599,3575883519,3575883527,8
0,1046,33600,3575883519,3575883527,8
0,1046,33601,3575883519,3575883529,10
0,1046,33602,3575883519,3575883529,10
0,1046,33603,3575883519,3575883529,10
0,1046,33604,3575883519,3575883530,11
0,1046,33605,3575883519,3575883530,11
0,1046,33606,3575883519,3575883533,14
0,1046,33607,3575883519,3575883533,14
0,1046,33608,3575883519,3575883534,15
0,1046,33609,3575883519,3575883534,15
0,1046,33610,3575883519,3575883536,17
0,1046,33611,3575883519,3575883536,17
0,1046,33612,3575883519,3575883537,18
0,1046,33613,3575883519,3575883537,18
0,1046,33614,3575883519,3575883537,18
0,1046,33615,3575883519,3575883537,18
0,1046,33616,3575883519,3575883539,20
0,1046,33617,3575883519,3575883539,20
0,1046,33618,3575883519,3575883539,20
0,1046,33619,3575883519,3575883540,21
0,1046,33620,3575883519,3575883540,21
0,1046,33621,3575883519,3575883540,21
0,1046,33622,3575883519,3575883540,21
0,1046,33623,3575883519,3575883541,22
0,1046,33624,3575883519,3575883541,22
0,1046,33625,3575883519,3575883542,23
0,1046,33626,3575883519,3575883544,25
0,1046,33627,3575883519,3575883544,25
0,1046,33628,3575883519,3575883544,25
0,1046,33629,3575883519,3575883544,25
0,1046,33630,3575883519,3575883545,26
0,1046,33631,3575883519,3575883545,26
0,1046,33632,3575883519,3575883545,26
0,1046,33633,3575883519,3575883546,27
0,1046,33634,3575883519,3575883547,28
0,1046,33635,3575883519,3575883547,28
0,1046,33636,3575883519,3575883547,28
0,1046,33637,3575883519,3575883548,29
0,1046,33638,3575883519,3575883550,31
0,1046,33639,3575883519,3575883551,32
0,1046,33640,3575883519,3575883552,33
0,1046,33641,3575883519,3575883552,33
0,1046,33642,3575883519,3575883553,34
0,1046,33643,3575883519,3575883553,34
0,1046,33644,3575883519,3575883554,35
0,1046,33645,3575883519,3575883554,35
0,1046,33646,3575883519,3575883555,36
0,1046,33647,3575883519,3575883556,37
0,1046,33648,3575883519,3575883556,37
0,1046,33649,3575883519,3575883557,38
0,1046,33650,3575883519,3575883560,41
0,1046,33651,3575883519,3575883560,41
0,1046,33652,3575883519,3575883561,42
0,1046,33653,3575883519,3575883562,43
0,1046,33654,3575883519,3575883562,43
0,1046,33655,3575883519,3575883562,43
0,1046,33656,3575883519,3575883564,45
0,1046,33657,3575883519,3575883564,45
0,1046,33658,3575883519,3575883564,45
0,1046,33659,3575883519,3575883565,46
0,1046,33660,3575883519,3575883565,46
0,1046,33661,3575883519,3575883565,46
0,1046,33662,3575883519,3575883566,47
0,1046,33663,3575883519,3575883567,48
0,1046,33664,3575883519,3575883567,48
0,1047,33665,3575883583,3575883583,0
0,1047,33666,3575883583,3575883583,0
0,1047,33667,3575883583,3575883584,1
0,1047,33668,3575883583,3575883584,1
0,1047,33669,3575883583,3575883584,1
0,1047,33670,3575883583,3575883584,1
0,1047,33671,3575883583,3575883584,1
0,1047,33672,3575883583,3575883584,1
0,1047,33673,3575883583,3575883584,1
0,1047,33674,3575883583,3575883584,1
0,1047,33675,3575883583,3575883584,1
0,1047,33676,3575883583,3575883584,1
0,1047,33677,3575883583,3575883584,1
0,1047,33678,3575883583,3575883584,1
0,1047,33679,3575883583,3575883584,1
0,1047,33680,3575883583,3575883584,1
0,1047,33681,3575883583,3575883584,1
0,1047,33682,3575883583,3575883584,1
0,1047,33683,3575883583,3575883585,2
0,1047,33684,3575883583,3575883586,3
0,1047,33685,3575883583,3575883586,3
0,1047,33686,3575883583,3575883587,4
0,1047,33687,3575883583,3575883588,5
0,1047,33688,3575883583,3575883589,6
0,1047,33689,3575883583,3575883593,10
0,1047,33690,3575883583,3575883594,11
0,1047,33691,3575883583,3575883594,11
0,1047,33692,3575883583,3575883598,15
0,1047,33693,3575883583,3575883599,16
0,1047,33694,3575883583,3575883599,16
0,1047,33695,3575883583,3575883599,16
0,1047,33696,3575883583,3575883601,18
0,1047,33697,3575883583,3575883603,20
0,1047,33698,3575883583,3575883604,21
0,1047,33699,3575883583,3575883605,22
0,1047,33700,3575883583,3575883605,22
0,1047,33701,3575883583,3575883606,23
0,1047,33702,3575883583,3575883607,24
0,1047,33703,3575883583,3575883607,24
0,1047,33704,3575883583,3575883608,25
0,1047,33705,3575883583,3575883611,28
0,1047,33706,3575883583,3575883612,29
0,1047,33707,3575883583,3575883612,29
0,1047,33708,3575883583,3575883613,30
0,1047,33709,3575883583,3575883613,30
0,1047,33710,3575883583,3575883614,31
0,1047,33711,3575883583,3575883614,31
0,1047,33712,3575883583,3575883615,32
0,1047,33713,3575883583,3575883615,32
0,1047,33714,3575883583,3575883615,32
0,1047,33715,3575883583,3575883617,34
0,1047,33716,3575883583,3575883618,35
0,1047,33717,3575883583,3575883618,35
0,1047,33718,3575883583,3575883621,38
0,1047,33719,3575883583,3575883622,39
0,1047,33720,3575883583,3575883622,39
0,1047,33721,3575883583,3575883622,39
0,1047,33722,3575883583,3575883625,42
0,1047,33723,3575883583,3575883626,43
0,1047,33724,3575883583,3575883628,45
0,1047,33725,3575883583,3575883628,45
0,1047,33726,3575883583,3575883629,46
0,1047,33727,3575883583,3575883629,46
0,1047,33728,3575883583,3575883630,47
0,1047,33729,3575883583,3575883631,48
0,1047,33730,3575883583,3575883631,48
0,1047,33731,3575883583,3575883631,48
0,1047,33732,3575883583,3575883631,48
0,1047,33733,3575883583,3575883632,49
0,1047,33734,3575883583,3575883632,49
0,1047,33735,3575883583,3575883632,49
0,1047,33736,3575883583,3575883632,49
0,1047,33737,3575883583,3575883632,49
0,1047,33738,3575883583,3575883632,49
0,1047,33739,3575883583,3575883633,50
0,1048,33740,3575883647,3575883647,0
0,1048,33741,3575883647,3575883647,0
0,1048,33742,3575883647,3575883647,0
0,1048,33743,3575883647,3575883647,0
0,1048,33744,3575883647,3575883647,0
0,1048,33745,3575883647,3575883647,0
0,1048,33746,3575883647,3575883647,0
0,1048,33747,3575883647,3575883647,0
0,1048,33748,3575883647,3575883647,0
0,1048,33749,3575883647,3575883647,0
0,1048,33750,3575883647,3575883647,0
0,1048,33751,3575883647,3575883647,0
0,1048,33752,3575883647,3575883648,1
0,1048,33753,3575883647,3575883650,3
0,1048,33754,3575883647,3575883652,5
0,1048,33755,3575883647,3575883652,5
0,1048,33756,3575883647,3575883653,6
0,1048,33757,3575883647,3575883654,7
0,1048,33758,3575883647,3575883656,9
0,1048,33759,3575883647,3575883657,10
0,1048,33760,3575883647,3575883657,10
0,1048,33761,3575883647,3575883657,10
0,1048,33762,3575883647,3575883659,12
0,1048,33763,3575883647,3575883659,12
0,1048,33764,3575883647,3575883660,13
0,1048,33765,3575883647,3575883660,13
0,1048,33766,3575883647,3575883660,13
0,1048,33767,3575883647,3575883660,13
0,1048,33768,3575883647,3575883661,14
0,1048,33769,3575883647,3575883662,15
0,1048,33770,3575883647,3575883662,15
0,1048,33771,3575883647,3575883662,15
0,1048,33772,3575883647,3575883664,17
0,1048,33773,3575883647,3575883665,18
0,1048,33774,3575883647,3575883666,19
0,1048,33775,3575883647,3575883666,19
0,1048,33776,3575883647,3575883667,20
0,1048,33777,3575883647,3575883667,20
0,1048,33778,3575883647,3575883667,20
0,1048,33779,3575883647,3575883668,21
0,1048,33780,3575883647,3575883668,21
0,1048,33781,3575883647,3575883668,21
0,1048,33782,3575883647,3575883669,22
0,1048,33783,3575883647,3575883677,30
0,1048,33784,3575883647,3575883678,31
0,1048,33785,3575883647,3575883678,31
0,1048,33786,3575883647,3575883678,31
0,1048,33787,3575883647,3575883682,35
0,1048,33788,3575883647,3575883683,36
0,1048,33789,3575883647,3575883687,40
0,1048,33790,3575883647,3575883687,40
0,1048,33791,3575883647,3575883687,40
0,1048,33792,3575883647,3575883687,40
0,1048,33793,3575883647,3575883688,41
0,1048,33794,3575883647,3575883688,41
0,1048,33795,3575883647,3575883690,43
0,1048,33796,3575883647,3575883691,44
0,1048,33797,3575883647,3575883692,45
0,1048,33798,3575883647,3575883692,45
0,1048,33799,3575883647,3575883693,46
0,1048,33800,3575883647,3575883693,46
0,1048,33801,3575883647,3575883694,47
0,1048,33802,3575883647,3575883694,47
0,1048,33803,3575883647,3575883694,47
0,1048,33804,3575883647,3575883695,48
0,1048,33805,3575883647,3575883695,48
0,1048,33806,3575883647,3575883696,49
0,1048,33807,3575883647,3575883696,49
0,1048,33808,3575883647,3575883697,50
0,1049,33809,3575883711,3575883711,0
0,1049,33810,3575883711,3575883711,0
0,1049,33811,3575883711,3575883711,0
0,1049,33812,3575883711,3575883711,0
0,1049,33813,3575883711,3575883711,0
0,1049,33814,3575883711,3575883711,0
0,1049,33815,3575883711,3575883711,0
0,1049,33816,3575883711,3575883711,0
0,1049,33817,3575883711,3575883711,0
0,1049,33818,3575883711,3575883711,0
0,1049,33819,3575883711,3575883711,0
0,1049,33820,3575883711,3575883711,0
0,1049,33821,3575883711,3575883711,0
0,1049,33822,3575883711,3575883711,0
0,1049,33823,3575883711,3575883711,0
0,1049,33824,3575883711,3575883711,0
0,1049,33825,3575883711,3575883711,0
0,1049,33826,3575883711,3575883711,0
0,1049,33827,3575883711,3575883711,0
0,1049,33828,3575883711,3575883711,0
0,1049,33829,3575883711,3575883711,0
0,1049,33830,3575883711,3575883711,0
0,1049,33831,3575883711,3575883711,0
0,1049,33832,3575883711,3575883711,0
0,1049,33833,3575883711,3575883711,0
0,1049,33834,3575883711,3575883713,2
0,1049,33835,3575883711,3575883713,2
0,1049,33836,3575883711,3575883714,3
0,1049,33837,3575883711,3575883715,4
0,1049,33838,3575883711,3575883715,4
0,1049,33839,3575883711,3575883716,5
0,1049,33840,3575883711,3575883717,6
0,1049,33841,3575883711,3575883717,6
0,1049,33842,3575883711,3575883719,8
0,1049,33843,3575883711,3575883720,9
0,1049,33844,3575883711,3575883720,9
0,1049,33845,3575883711,3575883721,10
0,1049,33846,3575883711,3575883722,11
0,1049,33847,3575883711,3575883723,12
0,1049,33848,3575883711,3575883723,12
0,1049,33849,3575883711,3575883723,12
0,1049,33850,3575883711,3575883725,14
0,1049,33851,3575883711,3575883725,14
0,1049,33852,3575883711,3575883725,14
0,1049,33853,3575883711,3575883726,15
0,1049,33854,3575883711,3575883726,15
0,1049,33855,3575883711,3575883727,16
0,1049,33856,3575883711,3575883727,16
0,1049,33857,3575883711,3575883728,17
0,1049,33858,3575883711,3575883728,17
0,1049,33859,3575883711,3575883729,18
0,1049,33860,3575883711,3575883730,19
0,1049,33861,3575883711,3575883731,20
0,1049,33862,3575883711,3575883733,22
0,1049,33863,3575883711,3575883734,23
0,1049,33864,3575883711,3575883734,23
0,1049,33865,3575883711,3575883736,25
0,1049,33866,3575883711,3575883736,25
0,1049,33867,3575883711,3575883736,25
0,1049,33868,3575883711,3575883737,26
0,1049,33869,3575883711,3575883737,26
0,1049,33870,3575883711,3575883739,28
0,1049,33871,3575883711,3575883739,28
0,1049,33872,3575883711,3575883740,29
0,1049,33873,3575883711,3575883740,29
0,1049,33874,3575883711,3575883740,29
0,1049,33875,3575883711,3575883740,29
0,1049,33876,3575883711,3575883740,29
0,1049,33877,3575883711,3575883741,30
0,1049,33878,3575883711,3575883742,31
0,1049,33879,3575883711,3575883742,31
0,1049,33880,3575883711,3575883743,32
0,1049,33881,3575883711,3575883744,33
0,1049,33882,3575883711,3575883745,34
0,1049,33883,3575883711,3575883745,34
0,1049,33884,3575883711,3575883745,34
0,1049,33885,3575883711,3575883746,35
0,1049,33886,3575883711,3575883747,36
0,1049,33887,3575883711,3575883747,36
0,1049,33888,3575883711,3575883748,37
0,1049,33889,3575883711,3575883748,37
0,1049,33890,3575883711,3575883748,37
0,1049,33891,3575883711,3575883750,39
0,1049,33892,3575883711,3575883751,40
0,1049,33893,3575883711,3575883753,42
0,1049,33894,3575883711,3575883753,42
0,1049,33895,3575883711,3575883753,42
0,1049,33896,3575883711,3575883754,43
0,1049,33897,3575883711,3575883754,43
0,1049,33898,3575883711,3575883754,43
0,1049,33899,3575883711,3575883755,44
0,1049,33900,3575883711,3575883756,45
0,1049,33901,3575883711,3575883756,45
0,1049,33902,3575883711,3575883757,46
0,1049,33903,3575883711,3575883757,46
0,1049,33904,3575883711,3575883760,49
0,1049,33905,3575883711,3575883761,50
0,1050,33906,3575883773,3575883773,0
0,1050,33907,3575883773,3575883773,0
0,1050,33908,3575883773,3575883773,0
0,1050,33909,3575883773,3575883773,0
0,1050,33910,3575883773,3575883773,0
0,1050,33911,3575883773,3575883773,0
0,1050,33912,3575883773,3575883773,0
0,1050,33913,3575883773,3575883773,0
0,1050,33914,3575883773,3575883773,0
0,1050,33915,3575883773,3575883773,0
0,1050,33916,3575883773,3575883773,0
0,1050,33917,3575883773,3575883773,0
0,1050,33918,3575883773,3575883773,0
0,1050,33919,3575883773,3575883773,0
0,1050,33920,3575883773,3575883773,0
0,1050,33921,3575883773,3575883775,2
0,1050,33922,3575883773,3575883775,2
0,1050,33923,3575883773,3575883776,3
0,1050,33924,3575883773,3575883777,4
0,1050,33925,3575883773,3575883777,4
0,1050,33926,3575883773,3575883777,4
0,1050,33927,3575883773,3575883777,4
0,1050,33928,3575883773,3575883778,5
0,1050,33929,3575883773,3575883779,6
0,1050,33930,3575883773,3575883780,7
0,1050,33931,3575883773,3575883780,7
0,1050,33932,3575883773,3575883783,10
0,1050,33933,3575883773,3575883784,11
0,1050,33934,3575883773,3575883785,12
0,1050,33935,3575883773,3575883785,12
0,1050,33936,3575883773,3575883786,13
0,1050,33937,3575883773,3575883787,14
0,1050,33938,3575883773,3575883789,16
0,1050,33939,3575883773,3575883789,16
0,1050,33940,3575883773,3575883793,20
0,1050,33941,3575883773,3575883794,21
0,1050,33942,3575883773,3575883794,21
0,1050,33943,3575883773,3575883798,25
0,1050,33944,3575883773,3575883799,26
0,1050,33945,3575883773,3575883800,27
0,1050,33946,3575883773,3575883800,27
0,1050,33947,3575883773,3575883801,28
0,1050,33948,3575883773,3575883804,31
0,1050,33949,3575883773,3575883804,31
0,1050,33950,3575883773,3575883805,32
0,1050,33951,3575883773,3575883805,32
0,1050,33952,3575883773,3575883807,34
0,1050,33953,3575883773,3575883809,36
0,1050,33954,3575883773,3575883811,38
0,1050,33955,3575883773,3575883812,39
0,1050,33956,3575883773,3575883812,39
0,1050,33957,3575883773,3575883813,40
0,1050,33958,3575883773,3575883813,40
0,1050,33959,3575883773,3575883814,41
0,1050,33960,3575883773,3575883815,42
0,1050,33961,3575883773,3575883815,42
0,1050,33962,3575883773,3575883815,42
0,1050,33963,3575883773,3575883817,44
0,1050,33964,3575883773,3575883817,44
0,1050,33965,3575883773,3575883818,45
0,1050,33966,3575883773,3575883820,47
0,1050,33967,3575883773,3575883822,49
0,1050,33968,3575883773,3575883822,49
0,1051,33969,3575883840,3575883840,0
0,1051,33970,3575883840,3575883840,0
0,1051,33971,3575883840,3575883840,0
0,1051,33972,3575883840,3575883840,0
0,1051,33973,3575883840,3575883840,0
0,1051,33974,3575883840,3575883840,0
0,1051,33975,3575883840,3575883840,0
0,1051,33976,3575883840,3575883840,0
0,1051,33977,3575883840,3575883840,0
0,1051,33978,3575883840,3575883840,0
0,1051,33979,3575883840,3575883840,0
0,1051,33980,3575883840,3575883840,0
0,1051,33981,3575883840,3575883840,0
0,1051,33982,3575883840,3575883840,0
0,1051,33983,3575883840,3575883840,0
0,1051,33984,3575883840,3575883840,0
0,1051,33985,3575883840,3575883840,0
0,1051,33986,3575883840,3575883840,0
0,1051,33987,3575883840,3575883840,0
0,1051,33988,3575883840,3575883840,0
0,1051,33989,3575883840,3575883840,0
0,1051,33990,3575883840,3575883841,1
0,1051,33991,3575883840,3575883842,2
0,1051,33992,3575883840,3575883842,2
0,1051,33993,3575883840,3575883842,2
0,1051,33994,3575883840,3575883844,4
0,1051,33995,3575883840,3575883844,4
0,1051,33996,3575883840,3575883847,7
0,1051,33997,3575883840,3575883847,7
0,1051,33998,3575883840,3575883847,7
0,1051,33999,3575883840,3575883848,8
0,1051,34000,3575883840,3575883850,10
0,1051,34001,3575883840,3575883852,12
0,1051,34002,3575883840,3575883852,12
0,1051,34003,3575883840,3575883853,13
0,1051,34004,3575883840,3575883854,14
0,1051,34005,3575883840,3575883856,16
0,1051,34006,3575883840,3575883856,16
0,1051,34007,3575883840,3575883857,17
0,1051,34008,3575883840,3575883857,17
0,1051,34009,3575883840,3575883859,19
0,1051,34010,3575883840,3575883860,20
0,1051,34011,3575883840,3575883860,20
0,1051,34012,3575883840,3575883860,20
0,1051,34013,3575883840,3575883861,21
0,1051,34014,3575883840,3575883862,22
0,1051,34015,3575883840,3575883862,22
0,1051,34016,3575883840,3575883862,22
0,1051,34017,3575883840,3575883863,23
0,1051,34018,3575883840,3575883864,24
0,1051,34019,3575883840,3575883866,26
0,1051,34020,3575883840,3575883866,26
0,1051,34021,3575883840,3575883867,27
0,1051,34022,3575883840,3575883867,27
0,1051,34023,3575883840,3575883867,27
0,1051,34024,3575883840,3575883867,27
0,1051,34025,3575883840,3575883868,28
0,1051,34026,3575883840,3575883868,28
0,1051,34027,3575883840,3575883868,28
0,1051,34028,3575883840,3575883868,28
0,1051,34029,3575883840,3575883877,37
0,1051,34030,3575883840,3575883878,38
0,1051,34031,3575883840,3575883878,38
0,1051,34032,3575883840,3575883878,38
0,1051,34033,3575883840,3575883882,42
0,1051,34034,3575883840,3575883883,43
0,1051,34035,3575883840,3575883886,46
0,1051,34036,3575883840,3575883887,47
0,1051,34037,3575883840,3575883887,47
0,1051,34038,3575883840,3575883887,47
0,1051,34039,3575883840,3575883888,48
0,1051,34040,3575883840,3575883889,49
0,1052,34041,3575883902,3575883902,0
0,1052,34042,3575883902,3575883902,0
0,1052,34043,3575883902,3575883902,0
0,1052,34044,3575883902,3575883902,0
0,1052,34045,3575883902,3575883902,0
0,1052,34046,3575883902,3575883902,0
0,1052,34047,3575883902,3575883902,0
0,1052,34048,3575883902,3575883902,0
0,1052,34049,3575883902,3575883902,0
0,1052,34050,3575883902,3575883902,0
0,1052,34051,3575883902,3575883902,0
0,1052,34052,3575883902,3575883902,0
0,1052,34053,3575883902,3575883902,0
0,1052,34054,3575883902,3575883902,0
0,1052,34055,3575883902,3575883902,0
0,1052,34056,3575883902,3575883902,0
0,1052,34057,3575883902,3575883902,0
0,1052,34058,3575883902,3575883902,0
0,1052,34059,3575883902,3575883902,0
0,1052,34060,3575883902,3575883903,1
0,1052,34061,3575883902,3575883903,1
0,1052,34062,3575883902,3575883903,1
0,1052,34063,3575883902,3575883904,2
0,1052,34064,3575883902,3575883904,2
0,1052,34065,3575883902,3575883905,3
0,1052,34066,3575883902,3575883906,4
0,1052,34067,3575883902,3575883906,4
0,1052,34068,3575883902,3575883907,5
0,1052,34069,3575883902,3575883908,6
0,1052,34070,3575883902,3575883908,6
0,1052,34071,3575883902,3575883908,6
0,1052,34072,3575883902,3575883910,8
0,1052,34073,3575883902,3575883910,8
0,1052,34074,3575883902,3575883910,8
0,1052,34075,3575883902,3575883911,9
0,1052,34076,3575883902,3575883911,9
0,1052,34077,3575883902,3575883912,10
0,1052,34078,3575883902,3575883913,11
0,1052,34079,3575883902,3575883913,11
0,1052,34080,3575883902,3575883914,12
0,1052,34081,3575883902,3575883915,13
0,1052,34082,3575883902,3575883916,14
0,1052,34083,3575883902,3575883916,14
0,1052,34084,3575883902,3575883917,15
0,1052,34085,3575883902,3575883917,15
0,1052,34086,3575883902,3575883919,17
0,1052,34087,3575883902,3575883919,17
0,1052,34088,3575883902,3575883920,18
0,1052,34089,3575883902,3575883921,19
0,1052,34090,3575883902,3575883921,19
0,1052,34091,3575883902,3575883923,21
0,1052,34092,3575883902,3575883923,21
0,1052,34093,3575883902,3575883925,23
0,1052,34094,3575883902,3575883925,23
0,1052,34095,3575883902,3575883926,24
0,1052,34096,3575883902,3575883926,24
0,1052,34097,3575883902,3575883926,24
0,1052,34098,3575883902,3575883927,25
0,1052,34099,3575883902,3575883927,25
0,1052,34100,3575883902,3575883927,25
0,1052,34101,3575883902,3575883928,26
0,1052,34102,3575883902,3575883929,27
0,1052,34103,3575883902,3575883929,27
0,1052,34104,3575883902,3575883930,28
0,1052,34105,3575883902,3575883931,29
0,1052,34106,3575883902,3575883933,31
0,1052,34107,3575883902,3575883934,32
0,1052,34108,3575883902,3575883934,32
0,1052,34109,3575883902,3575883935,33
0,1052,34110,3575883902,3575883936,34
0,1052,34111,3575883902,3575883937,35
0,1052,34112,3575883902,3575883937,35
0,1052,34113,3575883902,3575883937,35
0,1052,34114,3575883902,3575883938,36
0,1052,34115,3575883902,3575883939,37
0,1052,34116,3575883902,3575883939,37
0,1052,34117,3575883902,3575883939,37
0,1052,34118,3575883902,3575883940,38
0,1052,34119,3575883902,3575883940,38
0,1052,34120,3575883902,3575883941,39
0,1052,34121,3575883902,3575883942,40
0,1052,34122,3575883902,3575883942,40
0,1052,34123,3575883902,3575883942,40
0,1052,34124,3575883902,3575883943,41
0,1052,34125,3575883902,3575883944,42
0,1052,34126,3575883902,3575883944,42
0,1052,34127,3575883902,3575883945,43
0,1052,34128,3575883902,3575883945,43
0,1052,34129,3575883902,3575883946,44
0,1052,34130,3575883902,3575883947,45
0,1052,34131,3575883902,3575883947,45
0,1052,34132,3575883902,3575883948,46
0,1052,34133,3575883902,3575883948,46
0,1052,34134,3575883902,3575883950,48
0,1052,34135,3575883902,3575883953,51
0,1052,34136,3575883902,3575883953,51
0,1053,34137,3575883968,3575883968,0
0,1053,34138,3575883968,3575883968,0
0,1053,34139,3575883968,3575883968,0
0,1053,34140,3575883968,3575883968,0
0,1053,34141,3575883968,3575883968,0
0,1053,34142,3575883968,3575883968,0
0,1053,34143,3575883968,3575883968,0
0,1053,34144,3575883968,3575883968,0
0,1053,34145,3575883968,3575883968,0
0,1053,34146,3575883968,3575883968,0
0,1053,34147,3575883968,3575883968,0
0,1053,34148,3575883968,3575883968,0
0,1053,34149,3575883968,3575883968,0
0,1053,34150,3575883968,3575883968,0
0,1053,34151,3575883968,3575883968,0
0,1053,34152,3575883968,3575883968,0
0,1053,34153,3575883968,3575883968,0
0,1053,34154,3575883968,3575883968,0
0,1053,34155,3575883968,3575883968,0
0,1053,34156,3575883968,3575883968,0
0,1053,34157,3575883968,3575883968,0
0,1053,34158,3575883968,3575883968,0
0,1053,34159,3575883968,3575883971,3
0,1053,34160,3575883968,3575883971,3
0,1053,34161,3575883968,3575883972,4
0,1053,34162,3575883968,3575883974,6
0,1053,34163,3575883968,3575883975,7
0,1053,34164,3575883968,3575883975,7
0,1053,34165,3575883968,3575883976,8
0,1053,34166,3575883968,3575883976,8
0,1053,34167,3575883968,3575883977,9
0,1053,34168,3575883968,3575883977,9
0,1053,34169,3575883968,3575883977,9
0,1053,34170,3575883968,3575883977,9
0,1053,34171,3575883968,3575883978,10
0,1053,34172,3575883968,3575883979,11
0,1053,34173,3575883968,3575883980,12
0,1053,34174,3575883968,3575883981,13
0,1053,34175,3575883968,3575883982,14
0,1053,34176,3575883968,3575883984,16
0,1053,34177,3575883968,3575883985,17
0,1053,34178,3575883968,3575883985,17
0,1053,34179,3575883968,3575883986,18
0,1053,34180,3575883968,3575883986,18
0,1053,34181,3575883968,3575883987,19
0,1053,34182,3575883968,3575883988,20
0,1053,34183,3575883968,3575883994,26
0,1053,34184,3575883968,3575883994,26
0,1053,34185,3575883968,3575883994,26
0,1053,34186,3575883968,3575883998,30
0,1053,34187,3575883968,3575884000,32
0,1053,34188,3575883968,3575884000,32
0,1053,34189,3575883968,3575884000,32
0,1053,34190,3575883968,3575884000,32
0,1053,34191,3575883968,3575884001,33
0,1053,34192,3575883968,3575884005,37
0,1053,34193,3575883968,3575884005,37
0,1053,34194,3575883968,3575884005,37
0,1053,34195,3575883968,3575884006,38
0,1053,34196,3575883968,3575884006,38
0,1053,34197,3575883968,3575884007,39
0,1053,34198,3575883968,3575884009,41
0,1053,34199,3575883968,3575884011,43
0,1053,34200,3575883968,3575884012,44
0,1053,34201,3575883968,3575884012,44
0,1053,34202,3575883968,3575884013,45
0,1053,34203,3575883968,3575884014,46
0,1053,34204,3575883968,3575884014,46
0,1053,34205,3575883968,3575884014,46
0,1053,34206,3575883968,3575884015,47
0,1053,34207,3575883968,3575884015,47
0,1053,34208,3575883968,3575884016,48
0,1053,34209,3575883968,3575884017,49
0,1053,34210,3575883968,3575884018,50
0,1054,34211,3575884033,3575884033,0
0,1054,34212,3575884033,3575884033,0
0,1054,34213,3575884033,3575884033,0
0,1054,34214,3575884033,3575884033,0
0,1054,34215,3575884033,3575884033,0
0,1054,34216,3575884033,3575884033,0
0,1054,34217,3575884033,3575884033,0
0,1054,34218,3575884033,3575884033,0
0,1054,34219,3575884033,3575884033,0
0,1054,34220,3575884033,3575884033,0
0,1054,34221,3575884033,3575884033,0
0,1054,34222,3575884033,3575884033,0
0,1054,34223,3575884033,3575884033,0
0,1054,34224,3575884033,3575884033,0
0,1054,34225,3575884033,3575884033,0
0,1054,34226,3575884033,3575884033,0
0,1054,34227,3575884033,3575884033,0
0,1054,34228,3575884033,3575884033,0
0,1054,34229,3575884033,3575884033,0
0,1054,34230,3575884033,3575884033,0
0,1054,34231,3575884033,3575884033,0
0,1054,34232,3575884033,3575884033,0
0,1054,34233,3575884033,3575884033,0
0,1054,34234,3575884033,3575884034,1
0,1054,34235,3575884033,3575884035,2
0,1054,34236,3575884033,3575884035,2
0,1054,34237,3575884033,3575884040,7
0,1054,34238,3575884033,3575884040,7
0,1054,34239,3575884033,3575884041,8
0,1054,34240,3575884033,3575884042,9
0,1054,34241,3575884033,3575884042,9
0,1054,34242,3575884033,3575884044,11
0,1054,34243,3575884033,3575884045,12
0,1054,34244,3575884033,3575884047,14
0,1054,34245,3575884033,3575884047,14
0,1054,34246,3575884033,3575884048,15
0,1054,34247,3575884033,3575884048,15
0,1054,34248,3575884033,3575884049,16
0,1054,34249,3575884033,3575884050,17
0,1054,34250,3575884033,3575884050,17
0,1054,34251,3575884033,3575884052,19
0,1054,34252,3575884033,3575884053,20
0,1054,34253,3575884033,3575884053,20
0,1054,34254,3575884033,3575884054,21
0,1054,34255,3575884033,3575884056,23
0,1054,34256,3575884033,3575884056,23
0,1054,34257,3575884033,3575884057,24
0,1054,34258,3575884033,3575884057,24
0,1054,34259,3575884033,3575884058,25
0,1054,34260,3575884033,3575884059,26
0,1054,34261,3575884033,3575884060,27
0,1054,34262,3575884033,3575884060,27
0,1054,34263,3575884033,3575884061,28
0,1054,34264,3575884033,3575884061,28
0,1054,34265,3575884033,3575884062,29
0,1054,34266,3575884033,3575884062,29
0,1054,34267,3575884033,3575884063,30
0,1054,34268,3575884033,3575884063,30
0,1054,34269,3575884033,3575884064,31
0,1054,34270,3575884033,3575884066,33
0,1054,34271,3575884033,3575884066,33
0,1054,34272,3575884033,3575884067,34
0,1054,34273,3575884033,3575884067,34
0,1054,34274,3575884033,3575884067,34
0,1054,34275,3575884033,3575884068,35
0,1054,34276,3575884033,3575884068,35
0,1054,34277,3575884033,3575884068,35
0,1054,34278,3575884033,3575884068,35
0,1054,34279,3575884033,3575884077,44
0,1054,34280,3575884033,3575884077,44
0,1054,34281,3575884033,3575884078,45
0,1054,34282,3575884033,3575884078,45
0,1054,34283,3575884033,3575884082,49
0,1054,34284,3575884033,3575884083,50
0,1055,34285,3575884096,3575884096,0
0,1055,34286,3575884096,3575884096,0
0,1055,34287,3575884096,3575884096,0
0,1055,34288,3575884096,3575884096,0
0,1055,34289,3575884096,3575884096,0
0,1055,34290,3575884096,3575884096,0
0,1055,34291,3575884096,3575884096,0
0,1055,34292,3575884096,3575884096,0
0,1055,34293,3575884096,3575884096,0
0,1055,34294,3575884096,3575884096,0
0,1055,34295,3575884096,3575884096,0
0,1055,34296,3575884096,3575884096,0
0,1055,34297,3575884096,3575884096,0
0,1055,34298,3575884096,3575884096,0
0,1055,34299,3575884096,3575884096,0
0,1055,34300,3575884096,3575884096,0
0,1055,34301,3575884096,3575884096,0
0,1055,34302,3575884096,3575884096,0
0,1055,34303,3575884096,3575884096,0
0,1055,34304,3575884096,3575884096,0
0,1055,34305,3575884096,3575884097,1
0,1055,34306,3575884096,3575884097,1
0,1055,34307,3575884096,3575884097,1
0,1055,34308,3575884096,3575884097,1
0,1055,34309,3575884096,3575884098,2
0,1055,34310,3575884096,3575884098,2
0,1055,34311,3575884096,3575884099,3
0,1055,34312,3575884096,3575884100,4
0,1055,34313,3575884096,3575884102,6
0,1055,34314,3575884096,3575884102,6
0,1055,34315,3575884096,3575884102,6
0,1055,34316,3575884096,3575884103,7
0,1055,34317,3575884096,3575884104,8
0,1055,34318,3575884096,3575884104,8
0,1055,34319,3575884096,3575884105,9
0,1055,34320,3575884096,3575884105,9
0,1055,34321,3575884096,3575884105,9
0,1055,34322,3575884096,3575884105,9
0,1055,34323,3575884096,3575884106,10
0,1055,34324,3575884096,3575884107,11
0,1055,34325,3575884096,3575884108,12
0,1055,34326,3575884096,3575884108,12
0,1055,34327,3575884096,3575884109,13
0,1055,34328,3575884096,3575884109,13
0,1055,34329,3575884096,3575884110,14
0,1055,34330,3575884096,3575884111,15
0,1055,34331,3575884096,3575884111,15
0,1055,34332,3575884096,3575884111,15
0,1055,34333,3575884096,3575884111,15
0,1055,34334,3575884096,3575884113,17
0,1055,34335,3575884096,3575884113,17
0,1055,34336,3575884096,3575884114,18
0,1055,34337,3575884096,3575884115,19
0,1055,34338,3575884096,3575884115,19
0,1055,34339,3575884096,3575884116,20
0,1055,34340,3575884096,3575884117,21
0,1055,34341,3575884096,3575884117,21
0,1055,34342,3575884096,3575884119,23
0,1055,34343,3575884096,3575884120,24
0,1055,34344,3575884096,3575884121,25
0,1055,34345,3575884096,3575884122,26
0,1055,34346,3575884096,3575884123,27
0,1055,34347,3575884096,3575884123,27
0,1055,34348,3575884096,3575884124,28
0,1055,34349,3575884096,3575884125,29
0,1055,34350,3575884096,3575884126,30
0,1055,34351,3575884096,3575884126,30
0,1055,34352,3575884096,3575884126,30
0,1055,34353,3575884096,3575884126,30
0,1055,34354,3575884096,3575884127,31
0,1055,34355,3575884096,3575884127,31
0,1055,34356,3575884096,3575884128,32
0,1055,34357,3575884096,3575884129,33
0,1055,34358,3575884096,3575884130,34
0,1055,34359,3575884096,3575884130,34
0,1055,34360,3575884096,3575884131,35
0,1055,34361,3575884096,3575884133,37
0,1055,34362,3575884096,3575884134,38
0,1055,34363,3575884096,3575884134,38
0,1055,34364,3575884096,3575884136,40
0,1055,34365,3575884096,3575884136,40
0,1055,34366,3575884096,3575884137,41
0,1055,34367,3575884096,3575884137,41
0,1055,34368,3575884096,3575884138,42
0,1055,34369,3575884096,3575884139,43
0,1055,34370,3575884096,3575884139,43
0,1055,34371,3575884096,3575884139,43
0,1055,34372,3575884096,3575884140,44
0,1055,34373,3575884096,3575884140,44
0,1055,34374,3575884096,3575884140,44
0,1055,34375,3575884096,3575884140,44
0,1055,34376,3575884096,3575884141,45
0,1055,34377,3575884096,3575884141,45
0,1055,34378,3575884096,3575884142,46
0,1055,34379,3575884096,3575884142,46
0,1055,34380,3575884096,3575884142,46
0,1055,34381,3575884096,3575884143,47
0,1055,34382,3575884096,3575884143,47
0,1055,34383,3575884096,3575884145,49
0,1055,34384,3575884096,3575884145,49
0,1055,34385,3575884096,3575884146,50
0,1056,34386,3575884163,3575884163,0
0,1056,34387,3575884163,3575884163,0
0,1056,34388,3575884163,3575884163,0
0,1056,34389,3575884163,3575884163,0
0,1056,34390,3575884163,3575884163,0
0,1056,34391,3575884163,3575884163,0
0,1056,34392,3575884163,3575884163,0
0,1056,34393,3575884163,3575884163,0
0,1056,34394,3575884163,3575884163,0
0,1056,34395,3575884163,3575884163,0
0,1056,34396,3575884163,3575884163,0
0,1056,34397,3575884163,3575884163,0
0,1056,34398,3575884163,3575884163,0
0,1056,34399,3575884163,3575884163,0
0,1056,34400,3575884163,3575884163,0
0,1056,34401,3575884163,3575884163,0
0,1056,34402,3575884163,3575884163,0
0,1056,34403,3575884163,3575884163,0
0,1056,34404,3575884163,3575884163,0
0,1056,34405,3575884163,3575884163,0
0,1056,34406,3575884163,3575884163,0
0,1056,34407,3575884163,3575884163,0
0,1056,34408,3575884163,3575884163,0
0,1056,34409,3575884163,3575884164,1
0,1056,34410,3575884163,3575884165,2
0,1056,34411,3575884163,3575884165,2
0,1056,34412,3575884163,3575884165,2
0,1056,34413,3575884163,3575884166,3
0,1056,34414,3575884163,3575884166,3
0,1056,34415,3575884163,3575884170,7
0,1056,34416,3575884163,3575884171,8
0,1056,34417,3575884163,3575884172,9
0,1056,34418,3575884163,3575884172,9
0,1056,34419,3575884163,3575884174,11
0,1056,34420,3575884163,3575884174,11
0,1056,34421,3575884163,3575884175,12
0,1056,34422,3575884163,3575884176,13
0,1056,34423,3575884163,3575884176,13
0,1056,34424,3575884163,3575884177,14
0,1056,34425,3575884163,3575884177,14
0,1056,34426,3575884163,3575884177,14
0,1056,34427,3575884163,3575884178,15
0,1056,34428,3575884163,3575884178,15
0,1056,34429,3575884163,3575884179,16
0,1056,34430,3575884163,3575884180,17
0,1056,34431,3575884163,3575884181,18
0,1056,34432,3575884163,3575884182,19
0,1056,34433,3575884163,3575884183,20
0,1056,34434,3575884163,3575884184,21
0,1056,34435,3575884163,3575884185,22
0,1056,34436,3575884163,3575884185,22
0,1056,34437,3575884163,3575884185,22
0,1056,34438,3575884163,3575884186,23
0,1056,34439,3575884163,3575884186,23
0,1056,34440,3575884163,3575884189,26
0,1056,34441,3575884163,3575884189,26
0,1056,34442,3575884163,3575884193,30
0,1056,34443,3575884163,3575884194,31
0,1056,34444,3575884163,3575884194,31
0,1056,34445,3575884163,3575884198,35
0,1056,34446,3575884163,3575884200,37
0,1056,34447,3575884163,3575884200,37
0,1056,34448,3575884163,3575884200,37
0,1056,34449,3575884163,3575884201,38
0,1056,34450,3575884163,3575884205,42
0,1056,34451,3575884163,3575884205,42
0,1056,34452,3575884163,3575884205,42
0,1056,34453,3575884163,3575884206,43
0,1056,34454,3575884163,3575884206,43
0,1056,34455,3575884163,3575884206,43
0,1056,34456,3575884163,3575884207,44
0,1056,34457,3575884163,3575884210,47
0,1056,34458,3575884163,3575884211,48
0,1056,34459,3575884163,3575884211,48
0,1056,34460,3575884163,3575884212,49
0,1056,34461,3575884163,3575884213,50
0,1057,34462,3575884227,3575884227,0
0,1057,34463,3575884227,3575884227,0
0,1057,34464,3575884227,3575884227,0
0,1057,34465,3575884227,3575884227,0
0,1057,34466,3575884227,3575884227,0
0,1057,34467,3575884227,3575884227,0
0,1057,34468,3575884227,3575884227,0
0,1057,34469,3575884227,3575884227,0
0,1057,34470,3575884227,3575884227,0
0,1057,34471,3575884227,3575884227,0
0,1057,34472,3575884227,3575884227,0
0,1057,34473,3575884227,3575884227,0
0,1057,34474,3575884227,3575884227,0
0,1057,34475,3575884227,3575884227,0
0,1057,34476,3575884227,3575884228,1
0,1057,34477,3575884227,3575884229,2
0,1057,34478,3575884227,3575884229,2
0,1057,34479,3575884227,3575884231,4
0,1057,34480,3575884227,3575884231,4
0,1057,34481,3575884227,3575884231,4
0,1057,34482,3575884227,3575884231,4
0,1057,34483,3575884227,3575884231,4
0,1057,34484,3575884227,3575884231,4
0,1057,34485,3575884227,3575884232,5
0,1057,34486,3575884227,3575884232,5
0,1057,34487,3575884227,3575884232,5
0,1057,34488,3575884227,3575884233,6
0,1057,34489,3575884227,3575884233,6
0,1057,34490,3575884227,3575884233,6
0,1057,34491,3575884227,3575884233,6
0,1057,34492,3575884227,3575884234,7
0,1057,34493,3575884227,3575884235,8
0,1057,34494,3575884227,3575884236,9
0,1057,34495,3575884227,3575884239,12
0,1057,34496,3575884227,3575884240,13
0,1057,34497,3575884227,3575884241,14
0,1057,34498,3575884227,3575884242,15
0,1057,34499,3575884227,3575884243,16
0,1057,34500,3575884227,3575884243,16
0,1057,34501,3575884227,3575884245,18
0,1057,34502,3575884227,3575884246,19
0,1057,34503,3575884227,3575884247,20
0,1057,34504,3575884227,3575884248,21
0,1057,34505,3575884227,3575884248,21
0,1057,34506,3575884227,3575884250,23
0,1057,34507,3575884227,3575884250,23
0,1057,34508,3575884227,3575884253,26
0,1057,34509,3575884227,3575884253,26
0,1057,34510,3575884227,3575884255,28
0,1057,34511,3575884227,3575884256,29
0,1057,34512,3575884227,3575884256,29
0,1057,34513,3575884227,3575884257,30
0,1057,34514,3575884227,3575884257,30
0,1057,34515,3575884227,3575884257,30
0,1057,34516,3575884227,3575884259,32
0,1057,34517,3575884227,3575884260,33
0,1057,34518,3575884227,3575884261,34
0,1057,34519,3575884227,3575884261,34
0,1057,34520,3575884227,3575884261,34
0,1057,34521,3575884227,3575884261,34
0,1057,34522,3575884227,3575884262,35
0,1057,34523,3575884227,3575884263,36
0,1057,34524,3575884227,3575884263,36
0,1057,34525,3575884227,3575884265,38
0,1057,34526,3575884227,3575884265,38
0,1057,34527,3575884227,3575884267,40
0,1057,34528,3575884227,3575884267,40
0,1057,34529,3575884227,3575884267,40
0,1057,34530,3575884227,3575884267,40
0,1057,34531,3575884227,3575884268,41
0,1057,34532,3575884227,3575884268,41
0,1057,34533,3575884227,3575884268,41
0,1057,34534,3575884227,3575884268,41
0,1057,34535,3575884227,3575884268,41
0,1057,34536,3575884227,3575884275,48
0,1057,34537,3575884227,3575884277,50
0,1058,34538,3575884292,3575884292,0
0,1058,34539,3575884292,3575884292,0
0,1058,34540,3575884292,3575884292,0
0,1058,34541,3575884292,3575884292,0
0,1058,34542,3575884292,3575884292,0
0,1058,34543,3575884292,3575884292,0
0,1058,34544,3575884292,3575884292,0
0,1058,34545,3575884292,3575884292,0
0,1058,34546,3575884292,3575884293,1
0,1058,34547,3575884292,3575884293,1
0,1058,34548,3575884292,3575884293,1
0,1058,34549,3575884292,3575884293,1
0,1058,34550,3575884292,3575884293,1
0,1058,34551,3575884292,3575884293,1
0,1058,34552,3575884292,3575884293,1
0,1058,34553,3575884292,3575884294,2
0,1058,34554,3575884292,3575884294,2
0,1058,34555,3575884292,3575884294,2
0,1058,34556,3575884292,3575884294,2
0,1058,34557,3575884292,3575884295,3
0,1058,34558,3575884292,3575884295,3
0,1058,34559,3575884292,3575884296,4
0,1058,34560,3575884292,3575884296,4
0,1058,34561,3575884292,3575884297,5
0,1058,34562,3575884292,3575884297,5
0,1058,34563,3575884292,3575884298,6
0,1058,34564,3575884292,3575884298,6
0,1058,34565,3575884292,3575884299,7
0,1058,34566,3575884292,3575884299,7
0,1058,34567,3575884292,3575884300,8
0,1058,34568,3575884292,3575884301,9
0,1058,34569,3575884292,3575884302,10
0,1058,34570,3575884292,3575884303,11
0,1058,34571,3575884292,3575884304,12
0,1058,34572,3575884292,3575884304,12
0,1058,34573,3575884292,3575884304,12
0,1058,34574,3575884292,3575884305,13
0,1058,34575,3575884292,3575884305,13
0,1058,34576,3575884292,3575884305,13
0,1058,34577,3575884292,3575884306,14
0,1058,34578,3575884292,3575884308,16
0,1058,34579,3575884292,3575884308,16
0,1058,34580,3575884292,3575884309,17
0,1058,34581,3575884292,3575884309,17
0,1058,34582,3575884292,3575884309,17
0,1058,34583,3575884292,3575884310,18
0,1058,34584,3575884292,3575884310,18
0,1058,34585,3575884292,3575884311,19
0,1058,34586,3575884292,3575884311,19
0,1058,34587,3575884292,3575884312,20
0,1058,34588,3575884292,3575884313,21
0,1058,34589,3575884292,3575884314,22
0,1058,34590,3575884292,3575884314,22
0,1058,34591,3575884292,3575884315,23
0,1058,34592,3575884292,3575884316,24
0,1058,34593,3575884292,3575884317,25
0,1058,34594,3575884292,3575884317,25
0,1058,34595,3575884292,3575884319,27
0,1058,34596,3575884292,3575884320,28
0,1058,34597,3575884292,3575884321,29
0,1058,34598,3575884292,3575884322,30
0,1058,34599,3575884292,3575884322,30
0,1058,34600,3575884292,3575884322,30
0,1058,34601,3575884292,3575884323,31
0,1058,34602,3575884292,3575884324,32
0,1058,34603,3575884292,3575884325,33
0,1058,34604,3575884292,3575884325,33
0,1058,34605,3575884292,3575884325,33
0,1058,34606,3575884292,3575884326,34
0,1058,34607,3575884292,3575884326,34
0,1058,34608,3575884292,3575884327,35
0,1058,34609,3575884292,3575884328,36
0,1058,34610,3575884292,3575884328,36
0,1058,34611,3575884292,3575884329,37
0,1058,34612,3575884292,3575884330,38
0,1058,34613,3575884292,3575884331,39
0,1058,34614,3575884292,3575884332,40
0,1058,34615,3575884292,3575884333,41
0,1058,34616,3575884292,3575884334,42
0,1058,34617,3575884292,3575884335,43
0,1058,34618,3575884292,3575884335,43
0,1058,34619,3575884292,3575884336,44
0,1058,34620,3575884292,3575884336,44
0,1058,34621,3575884292,3575884337,45
0,1058,34622,3575884292,3575884337,45
0,1058,34623,3575884292,3575884338,46
0,1058,34624,3575884292,3575884339,47
0,1058,34625,3575884292,3575884339,47
0,1058,34626,3575884292,3575884339,47
0,1058,34627,3575884292,3575884340,48
0,1058,34628,3575884292,3575884340,48
0,1058,34629,3575884292,3575884340,48
0,1058,34630,3575884292,3575884340,48
0,1058,34631,3575884292,3575884341,49
0,1058,34632,3575884292,3575884341,49
0,1058,34633,3575884292,3575884341,49
0,1058,34634,3575884292,3575884342,50
0,1059,34635,3575884356,3575884356,0
0,1059,34636,3575884356,3575884356,0
0,1059,34637,3575884356,3575884356,0
0,1059,34638,3575884356,3575884356,0
0,1059,34639,3575884356,3575884356,0
0,1059,34640,3575884356,3575884356,0
0,1059,34641,3575884356,3575884356,0
0,1059,34642,3575884356,3575884356,0
0,1059,34643,3575884356,3575884356,0
0,1059,34644,3575884356,3575884356,0
0,1059,34645,3575884356,3575884356,0
0,1059,34646,3575884356,3575884356,0
0,1059,34647,3575884356,3575884356,0
0,1059,34648,3575884356,3575884356,0
0,1059,34649,3575884356,3575884356,0
0,1059,34650,3575884356,3575884356,0
0,1059,34651,3575884356,3575884356,0
0,1059,34652,3575884356,3575884356,0
0,1059,34653,3575884356,3575884356,0
0,1059,34654,3575884356,3575884356,0
0,1059,34655,3575884356,3575884357,1
0,1059,34656,3575884356,3575884357,1
0,1059,34657,3575884356,3575884358,2
0,1059,34658,3575884356,3575884358,2
0,1059,34659,3575884356,3575884360,4
0,1059,34660,3575884356,3575884361,5
0,1059,34661,3575884356,3575884362,6
0,1059,34662,3575884356,3575884362,6
0,1059,34663,3575884356,3575884362,6
0,1059,34664,3575884356,3575884363,7
0,1059,34665,3575884356,3575884363,7
0,1059,34666,3575884356,3575884364,8
0,1059,34667,3575884356,3575884365,9
0,1059,34668,3575884356,3575884365,9
0,1059,34669,3575884356,3575884366,10
0,1059,34670,3575884356,3575884366,10
0,1059,34671,3575884356,3575884367,11
0,1059,34672,3575884356,3575884367,11
0,1059,34673,3575884356,3575884368,12
0,1059,34674,3575884356,3575884371,15
0,1059,34675,3575884356,3575884371,15
0,1059,34676,3575884356,3575884372,16
0,1059,34677,3575884356,3575884373,17
0,1059,34678,3575884356,3575884374,18
0,1059,34679,3575884356,3575884375,19
0,1059,34680,3575884356,3575884375,19
0,1059,34681,3575884356,3575884376,20
0,1059,34682,3575884356,3575884376,20
0,1059,34683,3575884356,3575884377,21
0,1059,34684,3575884356,3575884377,21
0,1059,34685,3575884356,3575884378,22
0,1059,34686,3575884356,3575884379,23
0,1059,34687,3575884356,3575884380,24
0,1059,34688,3575884356,3575884381,25
0,1059,34689,3575884356,3575884382,26
0,1059,34690,3575884356,3575884384,28
0,1059,34691,3575884356,3575884385,29
0,1059,34692,3575884356,3575884386,30
0,1059,34693,3575884356,3575884387,31
0,1059,34694,3575884356,3575884389,33
0,1059,34695,3575884356,3575884390,34
0,1059,34696,3575884356,3575884393,37
0,1059,34697,3575884356,3575884393,37
0,1059,34698,3575884356,3575884398,42
0,1059,34699,3575884356,3575884400,44
0,1059,34700,3575884356,3575884400,44
0,1059,34701,3575884356,3575884400,44
0,1059,34702,3575884356,3575884400,44
0,1059,34703,3575884356,3575884405,49
0,1059,34704,3575884356,3575884405,49
0,1059,34705,3575884356,3575884406,50
0,1060,34706,3575884424,3575884424,0
0,1060,34707,3575884424,3575884424,0
0,1060,34708,3575884424,3575884424,0
0,1060,34709,3575884424,3575884424,0
0,1060,34710,3575884424,3575884424,0
0,1060,34711,3575884424,3575884424,0
0,1060,34712,3575884424,3575884424,0
0,1060,34713,3575884424,3575884424,0
0,1060,34714,3575884424,3575884424,0
0,1060,34715,3575884424,3575884424,0
0,1060,34716,3575884424,3575884424,0
0,1060,34717,3575884424,3575884424,0
0,1060,34718,3575884424,3575884424,0
0,1060,34719,3575884424,3575884424,0
0,1060,34720,3575884424,3575884424,0
0,1060,34721,3575884424,3575884424,0
0,1060,34722,3575884424,3575884424,0
0,1060,34723,3575884424,3575884424,0
0,1060,34724,3575884424,3575884424,0
0,1060,34725,3575884424,3575884424,0
0,1060,34726,3575884424,3575884427,3
0,1060,34727,3575884424,3575884427,3
0,1060,34728,3575884424,3575884430,6
0,1060,34729,3575884424,3575884431,7
0,1060,34730,3575884424,3575884431,7
0,1060,34731,3575884424,3575884431,7
0,1060,34732,3575884424,3575884431,7
0,1060,34733,3575884424,3575884431,7
0,1060,34734,3575884424,3575884432,8
0,1060,34735,3575884424,3575884432,8
0,1060,34736,3575884424,3575884432,8
0,1060,34737,3575884424,3575884432,8
0,1060,34738,3575884424,3575884432,8
0,1060,34739,3575884424,3575884433,9
0,1060,34740,3575884424,3575884433,9
0,1060,34741,3575884424,3575884433,9
0,1060,34742,3575884424,3575884434,10
0,1060,34743,3575884424,3575884434,10
0,1060,34744,3575884424,3575884436,12
0,1060,34745,3575884424,3575884436,12
0,1060,34746,3575884424,3575884440,16
0,1060,34747,3575884424,3575884440,16
0,1060,34748,3575884424,3575884441,17
0,1060,34749,3575884424,3575884442,18
0,1060,34750,3575884424,3575884443,19
0,1060,34751,3575884424,3575884443,19
0,1060,34752,3575884424,3575884445,21
0,1060,34753,3575884424,3575884446,22
0,1060,34754,3575884424,3575884448,24
0,1060,34755,3575884424,3575884448,24
0,1060,34756,3575884424,3575884448,24
0,1060,34757,3575884424,3575884450,26
0,1060,34758,3575884424,3575884450,26
0,1060,34759,3575884424,3575884451,27
0,1060,34760,3575884424,3575884452,28
0,1060,34761,3575884424,3575884452,28
0,1060,34762,3575884424,3575884454,30
0,1060,34763,3575884424,3575884455,31
0,1060,34764,3575884424,3575884456,32
0,1060,34765,3575884424,3575884457,33
0,1060,34766,3575884424,3575884457,33
0,1060,34767,3575884424,3575884457,33
0,1060,34768,3575884424,3575884457,33
0,1060,34769,3575884424,3575884459,35
0,1060,34770,3575884424,3575884461,37
0,1060,34771,3575884424,3575884461,37
0,1060,34772,3575884424,3575884461,37
0,1060,34773,3575884424,3575884461,37
0,1060,34774,3575884424,3575884461,37
0,1060,34775,3575884424,3575884461,37
0,1060,34776,3575884424,3575884461,37
0,1060,34777,3575884424,3575884463,39
0,1060,34778,3575884424,3575884463,39
0,1060,34779,3575884424,3575884464,40
0,1060,34780,3575884424,3575884466,42
0,1060,34781,3575884424,3575884467,43
0,1060,34782,3575884424,3575884467,43
0,1060,34783,3575884424,3575884467,43
0,1060,34784,3575884424,3575884467,43
0,1060,34785,3575884424,3575884468,44
0,1060,34786,3575884424,3575884468,44
0,1060,34787,3575884424,3575884468,44
0,1061,34788,3575884486,3575884486,0
0,1061,34789,3575884486,3575884486,0
0,1061,34790,3575884486,3575884486,0
0,1061,34791,3575884486,3575884486,0
0,1061,34792,3575884486,3575884486,0
0,1061,34793,3575884486,3575884486,0
0,1061,34794,3575884486,3575884486,0
0,1061,34795,3575884486,3575884486,0
0,1061,34796,3575884486,3575884486,0
0,1061,34797,3575884486,3575884487,1
0,1061,34798,3575884486,3575884487,1
0,1061,34799,3575884486,3575884487,1
0,1061,34800,3575884486,3575884488,2
0,1061,34801,3575884486,3575884488,2
0,1061,34802,3575884486,3575884489,3
0,1061,34803,3575884486,3575884490,4
0,1061,34804,3575884486,3575884490,4
0,1061,34805,3575884486,3575884492,6
0,1061,34806,3575884486,3575884493,7
0,1061,34807,3575884486,3575884493,7
0,1061,34808,3575884486,3575884493,7
0,1061,34809,3575884486,3575884493,7
0,1061,34810,3575884486,3575884494,8
0,1061,34811,3575884486,3575884494,8
0,1061,34812,3575884486,3575884494,8
0,1061,34813,3575884486,3575884496,10
0,1061,34814,3575884486,3575884496,10
0,1061,34815,3575884486,3575884496,10
0,1061,34816,3575884486,3575884497,11
0,1061,34817,3575884486,3575884498,12
0,1061,34818,3575884486,3575884498,12
0,1061,34819,3575884486,3575884498,12
0,1061,34820,3575884486,3575884500,14
0,1061,34821,3575884486,3575884501,15
0,1061,34822,3575884486,3575884501,15
0,1061,34823,3575884486,3575884502,16
0,1061,34824,3575884486,3575884502,16
0,1061,34825,3575884486,3575884503,17
0,1061,34826,3575884486,3575884504,18
0,1061,34827,3575884486,3575884504,18
0,1061,34828,3575884486,3575884505,19
0,1061,34829,3575884486,3575884505,19
0,1061,34830,3575884486,3575884505,19
0,1061,34831,3575884486,3575884506,20
0,1061,34832,3575884486,3575884507,21
0,1061,34833,3575884486,3575884507,21
0,1061,34834,3575884486,3575884507,21
0,1061,34835,3575884486,3575884508,22
0,1061,34836,3575884486,3575884508,22
0,1061,34837,3575884486,3575884509,23
0,1061,34838,3575884486,3575884510,24
0,1061,34839,3575884486,3575884510,24
0,1061,34840,3575884486,3575884510,24
0,1061,34841,3575884486,3575884511,25
0,1061,34842,3575884486,3575884512,26
0,1061,34843,3575884486,3575884512,26
0,1061,34844,3575884486,3575884513,27
0,1061,34845,3575884486,3575884514,28
0,1061,34846,3575884486,3575884515,29
0,1061,34847,3575884486,3575884515,29
0,1061,34848,3575884486,3575884515,29
0,1061,34849,3575884486,3575884516,30
0,1061,34850,3575884486,3575884518,32
0,1061,34851,3575884486,3575884518,32
0,1061,34852,3575884486,3575884520,34
0,1061,34853,3575884486,3575884521,35
0,1061,34854,3575884486,3575884522,36
0,1061,34855,3575884486,3575884522,36
0,1061,34856,3575884486,3575884522,36
0,1061,34857,3575884486,3575884524,38
0,1061,34858,3575884486,3575884524,38
0,1061,34859,3575884486,3575884524,38
0,1061,34860,3575884486,3575884525,39
0,1061,34861,3575884486,3575884525,39
0,1061,34862,3575884486,3575884526,40
0,1061,34863,3575884486,3575884526,40
0,1061,34864,3575884486,3575884526,40
0,1061,34865,3575884486,3575884527,41
0,1061,34866,3575884486,3575884527,41
0,1061,34867,3575884486,3575884528,42
0,1061,34868,3575884486,3575884529,43
0,1061,34869,3575884486,3575884530,44
0,1061,34870,3575884486,3575884530,44
0,1061,34871,3575884486,3575884532,46
0,1061,34872,3575884486,3575884532,46
0,1061,34873,3575884486,3575884534,48
0,1061,34874,3575884486,3575884535,49
0,1061,34875,3575884486,3575884535,49
0,1061,34876,3575884486,3575884536,50
0,1062,34877,3575884552,3575884552,0
0,1062,34878,3575884552,3575884552,0
0,1062,34879,3575884552,3575884552,0
0,1062,34880,3575884552,3575884552,0
0,1062,34881,3575884552,3575884552,0
0,1062,34882,3575884552,3575884552,0
0,1062,34883,3575884552,3575884552,0
0,1062,34884,3575884552,3575884552,0
0,1062,34885,3575884552,3575884552,0
0,1062,34886,3575884552,3575884552,0
0,1062,34887,3575884552,3575884552,0
0,1062,34888,3575884552,3575884552,0
0,1062,34889,3575884552,3575884552,0
0,1062,34890,3575884552,3575884552,0
0,1062,34891,3575884552,3575884552,0
0,1062,34892,3575884552,3575884552,0
0,1062,34893,3575884552,3575884552,0
0,1062,34894,3575884552,3575884552,0
0,1062,34895,3575884552,3575884552,0
0,1062,34896,3575884552,3575884552,0
0,1062,34897,3575884552,3575884552,0
0,1062,34898,3575884552,3575884552,0
0,1062,34899,3575884552,3575884552,0
0,1062,34900,3575884552,3575884552,0
0,1062,34901,3575884552,3575884553,1
0,1062,34902,3575884552,3575884553,1
0,1062,34903,3575884552,3575884553,1
0,1062,34904,3575884552,3575884554,2
0,1062,34905,3575884552,3575884554,2
0,1062,34906,3575884552,3575884555,3
0,1062,34907,3575884552,3575884556,4
0,1062,34908,3575884552,3575884556,4
0,1062,34909,3575884552,3575884557,5
0,1062,34910,3575884552,3575884558,6
0,1062,34911,3575884552,3575884559,7
0,1062,34912,3575884552,3575884560,8
0,1062,34913,3575884552,3575884561,9
0,1062,34914,3575884552,3575884561,9
0,1062,34915,3575884552,3575884562,10
0,1062,34916,3575884552,3575884562,10
0,1062,34917,3575884552,3575884564,12
0,1062,34918,3575884552,3575884564,12
0,1062,34919,3575884552,3575884564,12
0,1062,34920,3575884552,3575884565,13
0,1062,34921,3575884552,3575884566,14
0,1062,34922,3575884552,3575884566,14
0,1062,34923,3575884552,3575884566,14
0,1062,34924,3575884552,3575884568,16
0,1062,34925,3575884552,3575884570,18
0,1062,34926,3575884552,3575884570,18
0,1062,34927,3575884552,3575884571,19
0,1062,34928,3575884552,3575884572,20
0,1062,34929,3575884552,3575884572,20
0,1062,34930,3575884552,3575884573,21
0,1062,34931,3575884552,3575884575,23
0,1062,34932,3575884552,3575884575,23
0,1062,34933,3575884552,3575884575,23
0,1062,34934,3575884552,3575884576,24
0,1062,34935,3575884552,3575884577,25
0,1062,34936,3575884552,3575884577,25
0,1062,34937,3575884552,3575884578,26
0,1062,34938,3575884552,3575884578,26
0,1062,34939,3575884552,3575884579,27
0,1062,34940,3575884552,3575884580,28
0,1062,34941,3575884552,3575884581,29
0,1062,34942,3575884552,3575884582,30
0,1062,34943,3575884552,3575884582,30
0,1062,34944,3575884552,3575884584,32
0,1062,34945,3575884552,3575884585,33
0,1062,34946,3575884552,3575884586,34
0,1062,34947,3575884552,3575884586,34
0,1062,34948,3575884552,3575884589,37
0,1062,34949,3575884552,3575884589,37
0,1062,34950,3575884552,3575884593,41
0,1062,34951,3575884552,3575884598,46
0,1062,34952,3575884552,3575884599,47
0,1062,34953,3575884552,3575884599,47
0,1062,34954,3575884552,3575884599,47
0,1062,34955,3575884552,3575884600,48
0,1063,34956,3575884613,3575884613,0
0,1063,34957,3575884613,3575884613,0
0,1063,34958,3575884613,3575884613,0
0,1063,34959,3575884613,3575884613,0
0,1063,34960,3575884613,3575884613,0
0,1063,34961,3575884613,3575884613,0
0,1063,34962,3575884613,3575884613,0
0,1063,34963,3575884613,3575884613,0
0,1063,34964,3575884613,3575884613,0
0,1063,34965,3575884613,3575884613,0
0,1063,34966,3575884613,3575884613,0
0,1063,34967,3575884613,3575884613,0
0,1063,34968,3575884613,3575884614,1
0,1063,34969,3575884613,3575884614,1
0,1063,34970,3575884613,3575884614,1
0,1063,34971,3575884613,3575884615,2
0,1063,34972,3575884613,3575884616,3
0,1063,34973,3575884613,3575884616,3
0,1063,34974,3575884613,3575884617,4
0,1063,34975,3575884613,3575884618,5
0,1063,34976,3575884613,3575884620,7
0,1063,34977,3575884613,3575884621,8
0,1063,34978,3575884613,3575884622,9
0,1063,34979,3575884613,3575884622,9
0,1063,34980,3575884613,3575884622,9
0,1063,34981,3575884613,3575884625,12
0,1063,34982,3575884613,3575884627,14
0,1063,34983,3575884613,3575884629,16
0,1063,34984,3575884613,3575884629,16
0,1063,34985,3575884613,3575884629,16
0,1063,34986,3575884613,3575884630,17
0,1063,34987,3575884613,3575884630,17
0,1063,34988,3575884613,3575884630,17
0,1063,34989,3575884613,3575884631,18
0,1063,34990,3575884613,3575884631,18
0,1063,34991,3575884613,3575884631,18
0,1063,34992,3575884613,3575884632,19
0,1063,34993,3575884613,3575884632,19
0,1063,34994,3575884613,3575884632,19
0,1063,34995,3575884613,3575884632,19
0,1063,34996,3575884613,3575884632,19
0,1063,34997,3575884613,3575884632,19
0,1063,34998,3575884613,3575884632,19
0,1063,34999,3575884613,3575884633,20
0,1063,35000,3575884613,3575884634,21
0,1063,35001,3575884613,3575884635,22
0,1063,35002,3575884613,3575884639,26
0,1063,35003,3575884613,3575884639,26
0,1063,35004,3575884613,3575884640,27
0,1063,35005,3575884613,3575884641,28
0,1063,35006,3575884613,3575884642,29
0,1063,35007,3575884613,3575884644,31
0,1063,35008,3575884613,3575884645,32
0,1063,35009,3575884613,3575884646,33
0,1063,35010,3575884613,3575884647,34
0,1063,35011,3575884613,3575884649,36
0,1063,35012,3575884613,3575884649,36
0,1063,35013,3575884613,3575884650,37
0,1063,35014,3575884613,3575884652,39
0,1063,35015,3575884613,3575884652,39
0,1063,35016,3575884613,3575884655,42
0,1063,35017,3575884613,3575884656,43
0,1063,35018,3575884613,3575884656,43
0,1063,35019,3575884613,3575884656,43
0,1063,35020,3575884613,3575884657,44
0,1063,35021,3575884613,3575884659,46
0,1063,35022,3575884613,3575884659,46
0,1063,35023,3575884613,3575884659,46
0,1063,35024,3575884613,3575884660,47
0,1063,35025,3575884613,3575884660,47
0,1063,35026,3575884613,3575884660,47
0,1063,35027,3575884613,3575884661,48
0,1063,35028,3575884613,3575884661,48
0,1063,35029,3575884613,3575884662,49
0,1063,35030,3575884613,3575884662,49
0,1064,35031,3575884676,3575884676,0
0,1064,35032,3575884676,3575884676,0
0,1064,35033,3575884676,3575884676,0
0,1064,35034,3575884676,3575884676,0
0,1064,35035,3575884676,3575884676,0
0,1064,35036,3575884676,3575884676,0
0,1064,35037,3575884676,3575884676,0
0,1064,35038,3575884676,3575884676,0
0,1064,35039,3575884676,3575884676,0
0,1064,35040,3575884676,3575884676,0
0,1064,35041,3575884676,3575884676,0
0,1064,35042,3575884676,3575884677,1
0,1064,35043,3575884676,3575884678,2
0,1064,35044,3575884676,3575884678,2
0,1064,35045,3575884676,3575884679,3
0,1064,35046,3575884676,3575884681,5
0,1064,35047,3575884676,3575884684,8
0,1064,35048,3575884676,3575884687,11
0,1064,35049,3575884676,3575884687,11
0,1064,35050,3575884676,3575884687,11
0,1064,35051,3575884676,3575884687,11
0,1064,35052,3575884676,3575884687,11
0,1064,35053,3575884676,3575884688,12
0,1064,35054,3575884676,3575884688,12
0,1064,35055,3575884676,3575884688,12
0,1064,35056,3575884676,3575884689,13
0,1064,35057,3575884676,3575884690,14
0,1064,35058,3575884676,3575884691,15
0,1064,35059,3575884676,3575884691,15
0,1064,35060,3575884676,3575884692,16
0,1064,35061,3575884676,3575884693,17
0,1064,35062,3575884676,3575884693,17
0,1064,35063,3575884676,3575884694,18
0,1064,35064,3575884676,3575884694,18
0,1064,35065,3575884676,3575884695,19
0,1064,35066,3575884676,3575884696,20
0,1064,35067,3575884676,3575884696,20
0,1064,35068,3575884676,3575884697,21
0,1064,35069,3575884676,3575884697,21
0,1064,35070,3575884676,3575884698,22
0,1064,35071,3575884676,3575884698,22
0,1064,35072,3575884676,3575884699,23
0,1064,35073,3575884676,3575884700,24
0,1064,35074,3575884676,3575884701,25
0,1064,35075,3575884676,3575884702,26
0,1064,35076,3575884676,3575884702,26
0,1064,35077,3575884676,3575884703,27
0,1064,35078,3575884676,3575884703,27
0,1064,35079,3575884676,3575884703,27
0,1064,35080,3575884676,3575884704,28
0,1064,35081,3575884676,3575884704,28
0,1064,35082,3575884676,3575884705,29
0,1064,35083,3575884676,3575884706,30
0,1064,35084,3575884676,3575884707,31
0,1064,35085,3575884676,3575884707,31
0,1064,35086,3575884676,3575884708,32
0,1064,35087,3575884676,3575884709,33
0,1064,35088,3575884676,3575884709,33
0,1064,35089,3575884676,3575884709,33
0,1064,35090,3575884676,3575884710,34
0,1064,35091,3575884676,3575884710,34
0,1064,35092,3575884676,3575884710,34
0,1064,35093,3575884676,3575884713,37
0,1064,35094,3575884676,3575884713,37
0,1064,35095,3575884676,3575884713,37
0,1064,35096,3575884676,3575884714,38
0,1064,35097,3575884676,3575884715,39
0,1064,35098,3575884676,3575884715,39
0,1064,35099,3575884676,3575884718,42
0,1064,35100,3575884676,3575884720,44
0,1064,35101,3575884676,3575884721,45
0,1064,35102,3575884676,3575884722,46
0,1064,35103,3575884676,3575884722,46
0,1064,35104,3575884676,3575884723,47
0,1064,35105,3575884676,3575884724,48
0,1064,35106,3575884676,3575884724,48
0,1064,35107,3575884676,3575884725,49
0,1064,35108,3575884676,3575884725,49
0,1064,35109,3575884676,3575884725,49
0,1064,35110,3575884676,3575884726,50
0,1065,35111,3575884741,3575884741,0
0,1065,35112,3575884741,3575884741,0
0,1065,35113,3575884741,3575884741,0
0,1065,35114,3575884741,3575884741,0
0,1065,35115,3575884741,3575884741,0
0,1065,35116,3575884741,3575884741,0
0,1065,35117,3575884741,3575884741,0
0,1065,35118,3575884741,3575884741,0
0,1065,35119,3575884741,3575884741,0
0,1065,35120,3575884741,3575884741,0
0,1065,35121,3575884741,3575884741,0
0,1065,35122,3575884741,3575884741,0
0,1065,35123,3575884741,3575884741,0
0,1065,35124,3575884741,3575884741,0
0,1065,35125,3575884741,3575884741,0
0,1065,35126,3575884741,3575884741,0
0,1065,35127,3575884741,3575884741,0
0,1065,35128,3575884741,3575884741,0
0,1065,35129,3575884741,3575884741,0
0,1065,35130,3575884741,3575884741,0
0,1065,35131,3575884741,3575884741,0
0,1065,35132,3575884741,3575884741,0
0,1065,35133,3575884741,3575884741,0
0,1065,35134,3575884741,3575884741,0
0,1065,35135,3575884741,3575884741,0
0,1065,35136,3575884741,3575884741,0
0,1065,35137,3575884741,3575884741,0
0,1065,35138,3575884741,3575884743,2
0,1065,35139,3575884741,3575884744,3
0,1065,35140,3575884741,3575884744,3
0,1065,35141,3575884741,3575884745,4
0,1065,35142,3575884741,3575884746,5
0,1065,35143,3575884741,3575884746,5
0,1065,35144,3575884741,3575884747,6
0,1065,35145,3575884741,3575884747,6
0,1065,35146,3575884741,3575884748,7
0,1065,35147,3575884741,3575884748,7
0,1065,35148,3575884741,3575884748,7
0,1065,35149,3575884741,3575884750,9
0,1065,35150,3575884741,3575884752,11
0,1065,35151,3575884741,3575884753,12
0,1065,35152,3575884741,3575884753,12
0,1065,35153,3575884741,3575884754,13
0,1065,35154,3575884741,3575884754,13
0,1065,35155,3575884741,3575884754,13
0,1065,35156,3575884741,3575884756,15
0,1065,35157,3575884741,3575884756,15
0,1065,35158,3575884741,3575884757,16
0,1065,35159,3575884741,3575884758,17
0,1065,35160,3575884741,3575884759,18
0,1065,35161,3575884741,3575884760,19
0,1065,35162,3575884741,3575884761,20
0,1065,35163,3575884741,3575884761,20
0,1065,35164,3575884741,3575884762,21
0,1065,35165,3575884741,3575884762,21
0,1065,35166,3575884741,3575884764,23
0,1065,35167,3575884741,3575884765,24
0,1065,35168,3575884741,3575884765,24
0,1065,35169,3575884741,3575884765,24
0,1065,35170,3575884741,3575884766,25
0,1065,35171,3575884741,3575884766,25
0,1065,35172,3575884741,3575884767,26
0,1065,35173,3575884741,3575884769,28
0,1065,35174,3575884741,3575884770,29
0,1065,35175,3575884741,3575884771,30
0,1065,35176,3575884741,3575884771,30
0,1065,35177,3575884741,3575884772,31
0,1065,35178,3575884741,3575884773,32
0,1065,35179,3575884741,3575884774,33
0,1065,35180,3575884741,3575884774,33
0,1065,35181,3575884741,3575884776,35
0,1065,35182,3575884741,3575884776,35
0,1065,35183,3575884741,3575884776,35
0,1065,35184,3575884741,3575884776,35
0,1065,35185,3575884741,3575884777,36
0,1065,35186,3575884741,3575884778,37
0,1065,35187,3575884741,3575884779,38
0,1065,35188,3575884741,3575884779,38
0,1065,35189,3575884741,3575884779,38
0,1065,35190,3575884741,3575884780,39
0,1065,35191,3575884741,3575884780,39
0,1065,35192,3575884741,3575884782,41
0,1065,35193,3575884741,3575884783,42
0,1065,35194,3575884741,3575884783,42
0,1065,35195,3575884741,3575884786,45
0,1065,35196,3575884741,3575884786,45
0,1065,35197,3575884741,3575884786,45
0,1065,35198,3575884741,3575884789,48
0,1065,35199,3575884741,3575884789,48
0,1066,35200,3575884806,3575884806,0
0,1066,35201,3575884806,3575884806,0
0,1066,35202,3575884806,3575884806,0
0,1066,35203,3575884806,3575884806,0
0,1066,35204,3575884806,3575884806,0
0,1066,35205,3575884806,3575884806,0
0,1066,35206,3575884806,3575884806,0
0,1066,35207,3575884806,3575884806,0
0,1066,35208,3575884806,3575884806,0
0,1066,35209,3575884806,3575884806,0
0,1066,35210,3575884806,3575884806,0
0,1066,35211,3575884806,3575884806,0
0,1066,35212,3575884806,3575884807,1
0,1066,35213,3575884806,3575884809,3
0,1066,35214,3575884806,3575884810,4
0,1066,35215,3575884806,3575884812,6
0,1066,35216,3575884806,3575884812,6
0,1066,35217,3575884806,3575884813,7
0,1066,35218,3575884806,3575884814,8
0,1066,35219,3575884806,3575884814,8
0,1066,35220,3575884806,3575884814,8
0,1066,35221,3575884806,3575884815,9
0,1066,35222,3575884806,3575884816,10
0,1066,35223,3575884806,3575884816,10
0,1066,35224,3575884806,3575884818,12
0,1066,35225,3575884806,3575884818,12
0,1066,35226,3575884806,3575884820,14
0,1066,35227,3575884806,3575884822,16
0,1066,35228,3575884806,3575884822,16
0,1066,35229,3575884806,3575884822,16
0,1066,35230,3575884806,3575884822,16
0,1066,35231,3575884806,3575884824,18
0,1066,35232,3575884806,3575884827,21
0,1066,35233,3575884806,3575884828,22
0,1066,35234,3575884806,3575884828,22
0,1066,35235,3575884806,3575884828,22
0,1066,35236,3575884806,3575884830,24
0,1066,35237,3575884806,3575884830,24
0,1066,35238,3575884806,3575884830,24
0,1066,35239,3575884806,3575884831,25
0,1066,35240,3575884806,3575884831,25
0,1066,35241,3575884806,3575884831,25
0,1066,35242,3575884806,3575884832,26
0,1066,35243,3575884806,3575884832,26
0,1066,35244,3575884806,3575884832,26
0,1066,35245,3575884806,3575884832,26
0,1066,35246,3575884806,3575884832,26
0,1066,35247,3575884806,3575884832,26
0,1066,35248,3575884806,3575884832,26
0,1066,35249,3575884806,3575884833,27
0,1066,35250,3575884806,3575884835,29
0,1066,35251,3575884806,3575884836,30
0,1066,35252,3575884806,3575884839,33
0,1066,35253,3575884806,3575884840,34
0,1066,35254,3575884806,3575884840,34
0,1066,35255,3575884806,3575884841,35
0,1066,35256,3575884806,3575884842,36
0,1066,35257,3575884806,3575884842,36
0,1066,35258,3575884806,3575884844,38
0,1066,35259,3575884806,3575884846,40
0,1066,35260,3575884806,3575884846,40
0,1066,35261,3575884806,3575884847,41
0,1066,35262,3575884806,3575884847,41
0,1066,35263,3575884806,3575884848,42
0,1066,35264,3575884806,3575884850,44
0,1066,35265,3575884806,3575884850,44
0,1066,35266,3575884806,3575884851,45
0,1066,35267,3575884806,3575884851,45
0,1066,35268,3575884806,3575884851,45
0,1066,35269,3575884806,3575884853,47
0,1066,35270,3575884806,3575884855,49
0,1066,35271,3575884806,3575884856,50
0,1067,35272,3575884875,3575884875,0
0,1067,35273,3575884875,3575884876,1
0,1067,35274,3575884875,3575884876,1
0,1067,35275,3575884875,3575884876,1
0,1067,35276,3575884875,3575884876,1
0,1067,35277,3575884875,3575884876,1
0,1067,35278,3575884875,3575884876,1
0,1067,35279,3575884875,3575884876,1
0,1067,35280,3575884875,3575884876,1
0,1067,35281,3575884875,3575884876,1
0,1067,35282,3575884875,3575884876,1
0,1067,35283,3575884875,3575884876,1
0,1067,35284,3575884875,3575884876,1
0,1067,35285,3575884875,3575884876,1
0,1067,35286,3575884875,3575884876,1
0,1067,35287,3575884875,3575884876,1
0,1067,35288,3575884875,3575884876,1
0,1067,35289,3575884875,3575884876,1
0,1067,35290,3575884875,3575884876,1
0,1067,35291,3575884875,3575884877,2
0,1067,35292,3575884875,3575884878,3
0,1067,35293,3575884875,3575884879,4
0,1067,35294,3575884875,3575884879,4
0,1067,35295,3575884875,3575884881,6
0,1067,35296,3575884875,3575884883,8
0,1067,35297,3575884875,3575884887,12
0,1067,35298,3575884875,3575884887,12
0,1067,35299,3575884875,3575884887,12
0,1067,35300,3575884875,3575884887,12
0,1067,35301,3575884875,3575884888,13
0,1067,35302,3575884875,3575884888,13
0,1067,35303,3575884875,3575884888,13
0,1067,35304,3575884875,3575884888,13
0,1067,35305,3575884875,3575884889,14
0,1067,35306,3575884875,3575884890,15
0,1067,35307,3575884875,3575884891,16
0,1067,35308,3575884875,3575884892,17
0,1067,35309,3575884875,3575884892,17
0,1067,35310,3575884875,3575884893,18
0,1067,35311,3575884875,3575884893,18
0,1067,35312,3575884875,3575884893,18
0,1067,35313,3575884875,3575884894,19
0,1067,35314,3575884875,3575884894,19
0,1067,35315,3575884875,3575884895,20
0,1067,35316,3575884875,3575884896,21
0,1067,35317,3575884875,3575884896,21
0,1067,35318,3575884875,3575884897,22
0,1067,35319,3575884875,3575884897,22
0,1067,35320,3575884875,3575884898,23
0,1067,35321,3575884875,3575884899,24
0,1067,35322,3575884875,3575884899,24
0,1067,35323,3575884875,3575884901,26
0,1067,35324,3575884875,3575884902,27
0,1067,35325,3575884875,3575884902,27
0,1067,35326,3575884875,3575884903,28
0,1067,35327,3575884875,3575884904,29
0,1067,35328,3575884875,3575884905,30
0,1067,35329,3575884875,3575884905,30
0,1067,35330,3575884875,3575884906,31
0,1067,35331,3575884875,3575884907,32
0,1067,35332,3575884875,3575884907,32
0,1067,35333,3575884875,3575884907,32
0,1067,35334,3575884875,3575884909,34
0,1067,35335,3575884875,3575884909,34
0,1067,35336,3575884875,3575884909,34
0,1067,35337,3575884875,3575884910,35
0,1067,35338,3575884875,3575884910,35
0,1067,35339,3575884875,3575884911,36
0,1067,35340,3575884875,3575884911,36
0,1067,35341,3575884875,3575884913,38
0,1067,35342,3575884875,3575884913,38
0,1067,35343,3575884875,3575884913,38
0,1067,35344,3575884875,3575884914,39
0,1067,35345,3575884875,3575884915,40
0,1067,35346,3575884875,3575884916,41
0,1067,35347,3575884875,3575884920,45
0,1067,35348,3575884875,3575884920,45
0,1067,35349,3575884875,3575884922,47
0,1067,35350,3575884875,3575884922,47
0,1067,35351,3575884875,3575884924,49
0,1067,35352,3575884875,3575884924,49
0,1067,35353,3575884875,3575884925,50
0,1068,35354,3575884939,3575884939,0
0,1068,35355,3575884939,3575884939,0
0,1068,35356,3575884939,3575884939,0
0,1068,35357,3575884939,3575884939,0
0,1068,35358,3575884939,3575884939,0
0,1068,35359,3575884939,3575884939,0
0,1068,35360,3575884939,3575884939,0
0,1068,35361,3575884939,3575884939,0
0,1068,35362,3575884939,3575884939,0
0,1068,35363,3575884939,3575884939,0
0,1068,35364,3575884939,3575884939,0
0,1068,35365,3575884939,3575884939,0
0,1068,35366,3575884939,3575884939,0
0,1068,35367,3575884939,3575884939,0
0,1068,35368,3575884939,3575884939,0
0,1068,35369,3575884939,3575884939,0
0,1068,35370,3575884939,3575884939,0
0,1068,35371,3575884939,3575884939,0
0,1068,35372,3575884939,3575884939,0
0,1068,35373,3575884939,3575884939,0
0,1068,35374,3575884939,3575884939,0
0,1068,35375,3575884939,3575884939,0
0,1068,35376,3575884939,3575884940,1
0,1068,35377,3575884939,3575884940,1
0,1068,35378,3575884939,3575884940,1
0,1068,35379,3575884939,3575884940,1
0,1068,35380,3575884939,3575884940,1
0,1068,35381,3575884939,3575884941,2
0,1068,35382,3575884939,3575884942,3
0,1068,35383,3575884939,3575884943,4
0,1068,35384,3575884939,3575884943,4
0,1068,35385,3575884939,3575884943,4
0,1068,35386,3575884939,3575884944,5
0,1068,35387,3575884939,3575884946,7
0,1068,35388,3575884939,3575884946,7
0,1068,35389,3575884939,3575884946,7
0,1068,35390,3575884939,3575884947,8
0,1068,35391,3575884939,3575884948,9
0,1068,35392,3575884939,3575884948,9
0,1068,35393,3575884939,3575884948,9
0,1068,35394,3575884939,3575884949,10
0,1068,35395,3575884939,3575884950,11
0,1068,35396,3575884939,3575884952,13
0,1068,35397,3575884939,3575884953,14
0,1068,35398,3575884939,3575884953,14
0,1068,35399,3575884939,3575884953,14
0,1068,35400,3575884939,3575884954,15
0,1068,35401,3575884939,3575884955,16
0,1068,35402,3575884939,3575884955,16
0,1068,35403,3575884939,3575884956,17
0,1068,35404,3575884939,3575884956,17
0,1068,35405,3575884939,3575884957,18
0,1068,35406,3575884939,3575884959,20
0,1068,35407,3575884939,3575884960,21
0,1068,35408,3575884939,3575884961,22
0,1068,35409,3575884939,3575884961,22
0,1068,35410,3575884939,3575884962,23
0,1068,35411,3575884939,3575884962,23
0,1068,35412,3575884939,3575884964,25
0,1068,35413,3575884939,3575884964,25
0,1068,35414,3575884939,3575884964,25
0,1068,35415,3575884939,3575884965,26
0,1068,35416,3575884939,3575884965,26
0,1068,35417,3575884939,3575884966,27
0,1068,35418,3575884939,3575884967,28
0,1068,35419,3575884939,3575884969,30
0,1068,35420,3575884939,3575884970,31
0,1068,35421,3575884939,3575884971,32
0,1068,35422,3575884939,3575884971,32
0,1068,35423,3575884939,3575884972,33
0,1068,35424,3575884939,3575884973,34
0,1068,35425,3575884939,3575884974,35
0,1068,35426,3575884939,3575884975,36
0,1068,35427,3575884939,3575884975,36
0,1068,35428,3575884939,3575884976,37
0,1068,35429,3575884939,3575884977,38
0,1068,35430,3575884939,3575884977,38
0,1068,35431,3575884939,3575884977,38
0,1068,35432,3575884939,3575884977,38
0,1068,35433,3575884939,3575884978,39
0,1068,35434,3575884939,3575884979,40
0,1068,35435,3575884939,3575884979,40
0,1068,35436,3575884939,3575884980,41
0,1068,35437,3575884939,3575884983,44
0,1068,35438,3575884939,3575884983,44
0,1068,35439,3575884939,3575884983,44
0,1068,35440,3575884939,3575884983,44
0,1068,35441,3575884939,3575884984,45
0,1068,35442,3575884939,3575884986,47
0,1068,35443,3575884939,3575884986,47
0,1068,35444,3575884939,3575884986,47
0,1069,35445,3575885003,3575885003,0
0,1069,35446,3575885003,3575885003,0
0,1069,35447,3575885003,3575885003,0
0,1069,35448,3575885003,3575885003,0
0,1069,35449,3575885003,3575885003,0
0,1069,35450,3575885003,3575885003,0
0,1069,35451,3575885003,3575885003,0
0,1069,35452,3575885003,3575885003,0
0,1069,35453,3575885003,3575885003,0
0,1069,35454,3575885003,3575885003,0
0,1069,35455,3575885003,3575885004,1
0,1069,35456,3575885003,3575885005,2
0,1069,35457,3575885003,3575885005,2
0,1069,35458,3575885003,3575885005,2
0,1069,35459,3575885003,3575885006,3
0,1069,35460,3575885003,3575885007,4
0,1069,35461,3575885003,3575885007,4
0,1069,35462,3575885003,3575885009,6
0,1069,35463,3575885003,3575885010,7
0,1069,35464,3575885003,3575885012,9
0,1069,35465,3575885003,3575885013,10
0,1069,35466,3575885003,3575885013,10
0,1069,35467,3575885003,3575885013,10
0,1069,35468,3575885003,3575885014,11
0,1069,35469,3575885003,3575885014,11
0,1069,35470,3575885003,3575885015,12
0,1069,35471,3575885003,3575885015,12
0,1069,35472,3575885003,3575885016,13
0,1069,35473,3575885003,3575885017,14
0,1069,35474,3575885003,3575885019,16
0,1069,35475,3575885003,3575885021,18
0,1069,35476,3575885003,3575885022,19
0,1069,35477,3575885003,3575885022,19
0,1069,35478,3575885003,3575885022,19
0,1069,35479,3575885003,3575885022,19
0,1069,35480,3575885003,3575885025,22
0,1069,35481,3575885003,3575885026,23
0,1069,35482,3575885003,3575885028,25
0,1069,35483,3575885003,3575885028,25
0,1069,35484,3575885003,3575885030,27
0,1069,35485,3575885003,3575885030,27
0,1069,35486,3575885003,3575885030,27
0,1069,35487,3575885003,3575885030,27
0,1069,35488,3575885003,3575885031,28
0,1069,35489,3575885003,3575885032,29
0,1069,35490,3575885003,3575885032,29
0,1069,35491,3575885003,3575885032,29
0,1069,35492,3575885003,3575885032,29
0,1069,35493,3575885003,3575885032,29
0,1069,35494,3575885003,3575885033,30
0,1069,35495,3575885003,3575885033,30
0,1069,35496,3575885003,3575885033,30
0,1069,35497,3575885003,3575885035,32
0,1069,35498,3575885003,3575885035,32
0,1069,35499,3575885003,3575885039,36
0,1069,35500,3575885003,3575885040,37
0,1069,35501,3575885003,3575885042,39
0,1069,35502,3575885003,3575885043,40
0,1069,35503,3575885003,3575885044,41
0,1069,35504,3575885003,3575885046,43
0,1069,35505,3575885003,3575885047,44
0,1069,35506,3575885003,3575885047,44
0,1069,35507,3575885003,3575885048,45
0,1069,35508,3575885003,3575885049,46
0,1069,35509,3575885003,3575885050,47
0,1069,35510,3575885003,3575885050,47
0,1069,35511,3575885003,3575885051,48
0,1070,35512,3575885072,3575885072,0
0,1070,35513,3575885072,3575885072,0
0,1070,35514,3575885072,3575885072,0
0,1070,35515,3575885072,3575885072,0
0,1070,35516,3575885072,3575885072,0
0,1070,35517,3575885072,3575885072,0
0,1070,35518,3575885072,3575885072,0
0,1070,35519,3575885072,3575885072,0
0,1070,35520,3575885072,3575885072,0
0,1070,35521,3575885072,3575885072,0
0,1070,35522,3575885072,3575885072,0
0,1070,35523,3575885072,3575885072,0
0,1070,35524,3575885072,3575885072,0
0,1070,35525,3575885072,3575885072,0
0,1070,35526,3575885072,3575885072,0
0,1070,35527,3575885072,3575885072,0
0,1070,35528,3575885072,3575885072,0
0,1070,35529,3575885072,3575885072,0
0,1070,35530,3575885072,3575885072,0
0,1070,35531,3575885072,3575885072,0
0,1070,35532,3575885072,3575885072,0
0,1070,35533,3575885072,3575885072,0
0,1070,35534,3575885072,3575885072,0
0,1070,35535,3575885072,3575885072,0
0,1070,35536,3575885072,3575885072,0
0,1070,35537,3575885072,3575885075,3
0,1070,35538,3575885072,3575885077,5
0,1070,35539,3575885072,3575885077,5
0,1070,35540,3575885072,3575885078,6
0,1070,35541,3575885072,3575885078,6
0,1070,35542,3575885072,3575885080,8
0,1070,35543,3575885072,3575885084,12
0,1070,35544,3575885072,3575885086,14
0,1070,35545,3575885072,3575885087,15
0,1070,35546,3575885072,3575885087,15
0,1070,35547,3575885072,3575885087,15
0,1070,35548,3575885072,3575885087,15
0,1070,35549,3575885072,3575885088,16
0,1070,35550,3575885072,3575885088,16
0,1070,35551,3575885072,3575885088,16
0,1070,35552,3575885072,3575885089,17
0,1070,35553,3575885072,3575885089,17
0,1070,35554,3575885072,3575885090,18
0,1070,35555,3575885072,3575885090,18
0,1070,35556,3575885072,3575885091,19
0,1070,35557,3575885072,3575885092,20
0,1070,35558,3575885072,3575885093,21
0,1070,35559,3575885072,3575885093,21
0,1070,35560,3575885072,3575885093,21
0,1070,35561,3575885072,3575885093,21
0,1070,35562,3575885072,3575885094,22
0,1070,35563,3575885072,3575885094,22
0,1070,35564,3575885072,3575885094,22
0,1070,35565,3575885072,3575885096,24
0,1070,35566,3575885072,3575885096,24
0,1070,35567,3575885072,3575885097,25
0,1070,35568,3575885072,3575885097,25
0,1070,35569,3575885072,3575885097,25
0,1070,35570,3575885072,3575885098,26
0,1070,35571,3575885072,3575885098,26
0,1070,35572,3575885072,3575885099,27
0,1070,35573,3575885072,3575885099,27
0,1070,35574,3575885072,3575885101,29
0,1070,35575,3575885072,3575885101,29
0,1070,35576,3575885072,3575885102,30
0,1070,35577,3575885072,3575885102,30
0,1070,35578,3575885072,3575885102,30
0,1070,35579,3575885072,3575885103,31
0,1070,35580,3575885072,3575885104,32
0,1070,35581,3575885072,3575885104,32
0,1070,35582,3575885072,3575885104,32
0,1070,35583,3575885072,3575885104,32
0,1070,35584,3575885072,3575885105,33
0,1070,35585,3575885072,3575885107,35
0,1070,35586,3575885072,3575885107,35
0,1070,35587,3575885072,3575885108,36
0,1070,35588,3575885072,3575885108,36
0,1070,35589,3575885072,3575885109,37
0,1070,35590,3575885072,3575885109,37
0,1070,35591,3575885072,3575885109,37
0,1070,35592,3575885072,3575885110,38
0,1070,35593,3575885072,3575885110,38
0,1070,35594,3575885072,3575885110,38
0,1070,35595,3575885072,3575885110,38
0,1070,35596,3575885072,3575885112,40
0,1070,35597,3575885072,3575885113,41
0,1070,35598,3575885072,3575885113,41
0,1070,35599,3575885072,3575885114,42
0,1070,35600,3575885072,3575885115,43
0,1070,35601,3575885072,3575885116,44
0,1070,35602,3575885072,3575885119,47
0,1070,35603,3575885072,3575885119,47
0,1070,35604,3575885072,3575885120,48
0,1071,35605,3575885136,3575885136,0
0,1071,35606,3575885136,3575885136,0
0,1071,35607,3575885136,3575885136,0
0,1071,35608,3575885136,3575885136,0
0,1071,35609,3575885136,3575885136,0
0,1071,35610,3575885136,3575885136,0
0,1071,35611,3575885136,3575885136,0
0,1071,35612,3575885136,3575885136,0
0,1071,35613,3575885136,3575885136,0
0,1071,35614,3575885136,3575885136,0
0,1071,35615,3575885136,3575885136,0
0,1071,35616,3575885136,3575885136,0
0,1071,35617,3575885136,3575885136,0
0,1071,35618,3575885136,3575885136,0
0,1071,35619,3575885136,3575885136,0
0,1071,35620,3575885136,3575885136,0
0,1071,35621,3575885136,3575885136,0
0,1071,35622,3575885136,3575885136,0
0,1071,35623,3575885136,3575885136,0
0,1071,35624,3575885136,3575885136,0
0,1071,35625,3575885136,3575885136,0
0,1071,35626,3575885136,3575885136,0
0,1071,35627,3575885136,3575885136,0
0,1071,35628,3575885136,3575885136,0
0,1071,35629,3575885136,3575885136,0
0,1071,35630,3575885136,3575885136,0
0,1071,35631,3575885136,3575885138,2
0,1071,35632,3575885136,3575885139,3
0,1071,35633,3575885136,3575885139,3
0,1071,35634,3575885136,3575885139,3
0,1071,35635,3575885136,3575885139,3
0,1071,35636,3575885136,3575885140,4
0,1071,35637,3575885136,3575885140,4
0,1071,35638,3575885136,3575885140,4
0,1071,35639,3575885136,3575885140,4
0,1071,35640,3575885136,3575885141,5
0,1071,35641,3575885136,3575885141,5
0,1071,35642,3575885136,3575885141,5
0,1071,35643,3575885136,3575885142,6
0,1071,35644,3575885136,3575885142,6
0,1071,35645,3575885136,3575885143,7
0,1071,35646,3575885136,3575885143,7
0,1071,35647,3575885136,3575885145,9
0,1071,35648,3575885136,3575885146,10
0,1071,35649,3575885136,3575885146,10
0,1071,35650,3575885136,3575885146,10
0,1071,35651,3575885136,3575885147,11
0,1071,35652,3575885136,3575885148,12
0,1071,35653,3575885136,3575885148,12
0,1071,35654,3575885136,3575885149,13
0,1071,35655,3575885136,3575885149,13
0,1071,35656,3575885136,3575885150,14
0,1071,35657,3575885136,3575885152,16
0,1071,35658,3575885136,3575885153,17
0,1071,35659,3575885136,3575885154,18
0,1071,35660,3575885136,3575885154,18
0,1071,35661,3575885136,3575885154,18
0,1071,35662,3575885136,3575885155,19
0,1071,35663,3575885136,3575885155,19
0,1071,35664,3575885136,3575885156,20
0,1071,35665,3575885136,3575885157,21
0,1071,35666,3575885136,3575885158,22
0,1071,35667,3575885136,3575885159,23
0,1071,35668,3575885136,3575885161,25
0,1071,35669,3575885136,3575885161,25
0,1071,35670,3575885136,3575885162,26
0,1071,35671,3575885136,3575885162,26
0,1071,35672,3575885136,3575885162,26
0,1071,35673,3575885136,3575885164,28
0,1071,35674,3575885136,3575885165,29
0,1071,35675,3575885136,3575885165,29
0,1071,35676,3575885136,3575885165,29
0,1071,35677,3575885136,3575885166,30
0,1071,35678,3575885136,3575885167,31
0,1071,35679,3575885136,3575885167,31
0,1071,35680,3575885136,3575885168,32
0,1071,35681,3575885136,3575885170,34
0,1071,35682,3575885136,3575885171,35
0,1071,35683,3575885136,3575885172,36
0,1071,35684,3575885136,3575885173,37
0,1071,35685,3575885136,3575885174,38
0,1071,35686,3575885136,3575885175,39
0,1071,35687,3575885136,3575885176,40
0,1071,35688,3575885136,3575885176,40
0,1071,35689,3575885136,3575885177,41
0,1071,35690,3575885136,3575885177,41
0,1071,35691,3575885136,3575885178,42
0,1071,35692,3575885136,3575885178,42
0,1071,35693,3575885136,3575885180,44
0,1071,35694,3575885136,3575885180,44
0,1071,35695,3575885136,3575885181,45
0,1071,35696,3575885136,3575885183,47
0,1071,35697,3575885136,3575885183,47
0,1071,35698,3575885136,3575885183,47
0,1071,35699,3575885136,3575885184,48
0,1071,35700,3575885136,3575885184,48
0,1071,35701,3575885136,3575885185,49
0,1071,35702,3575885136,3575885186,50
0,1072,35703,3575885201,3575885201,0
0,1072,35704,3575885201,3575885201,0
0,1072,35705,3575885201,3575885201,0
0,1072,35706,3575885201,3575885201,0
0,1072,35707,3575885201,3575885201,0
0,1072,35708,3575885201,3575885201,0
0,1072,35709,3575885201,3575885201,0
0,1072,35710,3575885201,3575885201,0
0,1072,35711,3575885201,3575885201,0
0,1072,35712,3575885201,3575885201,0
0,1072,35713,3575885201,3575885201,0
0,1072,35714,3575885201,3575885201,0
0,1072,35715,3575885201,3575885203,2
0,1072,35716,3575885201,3575885205,4
0,1072,35717,3575885201,3575885205,4
0,1072,35718,3575885201,3575885205,4
0,1072,35719,3575885201,3575885206,5
0,1072,35720,3575885201,3575885207,6
0,1072,35721,3575885201,3575885208,7
0,1072,35722,3575885201,3575885209,8
0,1072,35723,3575885201,3575885210,9
0,1072,35724,3575885201,3575885211,10
0,1072,35725,3575885201,3575885212,11
0,1072,35726,3575885201,3575885212,11
0,1072,35727,3575885201,3575885213,12
0,1072,35728,3575885201,3575885214,13
0,1072,35729,3575885201,3575885214,13
0,1072,35730,3575885201,3575885215,14
0,1072,35731,3575885201,3575885215,14
0,1072,35732,3575885201,3575885216,15
0,1072,35733,3575885201,3575885217,16
0,1072,35734,3575885201,3575885218,17
0,1072,35735,3575885201,3575885219,18
0,1072,35736,3575885201,3575885221,20
0,1072,35737,3575885201,3575885221,20
0,1072,35738,3575885201,3575885221,20
0,1072,35739,3575885201,3575885222,21
0,1072,35740,3575885201,3575885222,21
0,1072,35741,3575885201,3575885225,24
0,1072,35742,3575885201,3575885228,27
0,1072,35743,3575885201,3575885229,28
0,1072,35744,3575885201,3575885229,28
0,1072,35745,3575885201,3575885229,28
0,1072,35746,3575885201,3575885230,29
0,1072,35747,3575885201,3575885230,29
0,1072,35748,3575885201,3575885230,29
0,1072,35749,3575885201,3575885231,30
0,1072,35750,3575885201,3575885232,31
0,1072,35751,3575885201,3575885232,31
0,1072,35752,3575885201,3575885232,31
0,1072,35753,3575885201,3575885232,31
0,1072,35754,3575885201,3575885232,31
0,1072,35755,3575885201,3575885233,32
0,1072,35756,3575885201,3575885233,32
0,1072,35757,3575885201,3575885234,33
0,1072,35758,3575885201,3575885235,34
0,1072,35759,3575885201,3575885235,34
0,1072,35760,3575885201,3575885239,38
0,1072,35761,3575885201,3575885240,39
0,1072,35762,3575885201,3575885241,40
0,1072,35763,3575885201,3575885241,40
0,1072,35764,3575885201,3575885242,41
0,1072,35765,3575885201,3575885244,43
0,1072,35766,3575885201,3575885245,44
0,1072,35767,3575885201,3575885247,46
0,1072,35768,3575885201,3575885248,47
0,1072,35769,3575885201,3575885248,47
0,1072,35770,3575885201,3575885249,48
0,1072,35771,3575885201,3575885250,49
0,1072,35772,3575885201,3575885251,50
0,1073,35773,3575885265,3575885265,0
0,1073,35774,3575885265,3575885265,0
0,1073,35775,3575885265,3575885265,0
0,1073,35776,3575885265,3575885265,0
0,1073,35777,3575885265,3575885265,0
0,1073,35778,3575885265,3575885265,0
0,1073,35779,3575885265,3575885265,0
0,1073,35780,3575885265,3575885265,0
0,1073,35781,3575885265,3575885265,0
0,1073,35782,3575885265,3575885265,0
0,1073,35783,3575885265,3575885265,0
0,1073,35784,3575885265,3575885265,0
0,1073,35785,3575885265,3575885265,0
0,1073,35786,3575885265,3575885265,0
0,1073,35787,3575885265,3575885265,0
0,1073,35788,3575885265,3575885265,0
0,1073,35789,3575885265,3575885265,0
0,1073,35790,3575885265,3575885265,0
0,1073,35791,3575885265,3575885265,0
0,1073,35792,3575885265,3575885266,1
0,1073,35793,3575885265,3575885266,1
0,1073,35794,3575885265,3575885266,1
0,1073,35795,3575885265,3575885267,2
0,1073,35796,3575885265,3575885267,2
0,1073,35797,3575885265,3575885268,3
0,1073,35798,3575885265,3575885268,3
0,1073,35799,3575885265,3575885268,3
0,1073,35800,3575885265,3575885275,10
0,1073,35801,3575885265,3575885277,12
0,1073,35802,3575885265,3575885278,13
0,1073,35803,3575885265,3575885279,14
0,1073,35804,3575885265,3575885281,16
0,1073,35805,3575885265,3575885284,19
0,1073,35806,3575885265,3575885287,22
0,1073,35807,3575885265,3575885287,22
0,1073,35808,3575885265,3575885287,22
0,1073,35809,3575885265,3575885287,22
0,1073,35810,3575885265,3575885287,22
0,1073,35811,3575885265,3575885287,22
0,1073,35812,3575885265,3575885288,23
0,1073,35813,3575885265,3575885288,23
0,1073,35814,3575885265,3575885289,24
0,1073,35815,3575885265,3575885289,24
0,1073,35816,3575885265,3575885290,25
0,1073,35817,3575885265,3575885290,25
0,1073,35818,3575885265,3575885291,26
0,1073,35819,3575885265,3575885292,27
0,1073,35820,3575885265,3575885292,27
0,1073,35821,3575885265,3575885293,28
0,1073,35822,3575885265,3575885293,28
0,1073,35823,3575885265,3575885293,28
0,1073,35824,3575885265,3575885294,29
0,1073,35825,3575885265,3575885295,30
0,1073,35826,3575885265,3575885296,31
0,1073,35827,3575885265,3575885297,32
0,1073,35828,3575885265,3575885297,32
0,1073,35829,3575885265,3575885298,33
0,1073,35830,3575885265,3575885298,33
0,1073,35831,3575885265,3575885298,33
0,1073,35832,3575885265,3575885298,33
0,1073,35833,3575885265,3575885299,34
0,1073,35834,3575885265,3575885301,36
0,1073,35835,3575885265,3575885302,37
0,1073,35836,3575885265,3575885302,37
0,1073,35837,3575885265,3575885302,37
0,1073,35838,3575885265,3575885304,39
0,1073,35839,3575885265,3575885304,39
0,1073,35840,3575885265,3575885304,39
0,1073,35841,3575885265,3575885305,40
0,1073,35842,3575885265,3575885305,40
0,1073,35843,3575885265,3575885306,41
0,1073,35844,3575885265,3575885307,42
0,1073,35845,3575885265,3575885308,43
0,1073,35846,3575885265,3575885309,44
0,1073,35847,3575885265,3575885309,44
0,1073,35848,3575885265,3575885310,45
0,1073,35849,3575885265,3575885310,45
0,1073,35850,3575885265,3575885310,45
0,1073,35851,3575885265,3575885310,45
0,1073,35852,3575885265,3575885310,45
0,1073,35853,3575885265,3575885311,46
0,1073,35854,3575885265,3575885313,48
0,1073,35855,3575885265,3575885313,48
0,1073,35856,3575885265,3575885313,48
0,1073,35857,3575885265,3575885315,50
0,1074,35858,3575885330,3575885330,0
0,1074,35859,3575885330,3575885330,0
0,1074,35860,3575885330,3575885330,0
0,1074,35861,3575885330,3575885330,0
0,1074,35862,3575885330,3575885330,0
0,1074,35863,3575885330,3575885330,0
0,1074,35864,3575885330,3575885330,0
0,1074,35865,3575885330,3575885330,0
0,1074,35866,3575885330,3575885330,0
0,1074,35867,3575885330,3575885330,0
0,1074,35868,3575885330,3575885330,0
0,1074,35869,3575885330,3575885330,0
0,1074,35870,3575885330,3575885330,0
0,1074,35871,3575885330,3575885330,0
0,1074,35872,3575885330,3575885330,0
0,1074,35873,3575885330,3575885330,0
0,1074,35874,3575885330,3575885330,0
0,1074,35875,3575885330,3575885330,0
0,1074,35876,3575885330,3575885330,0
0,1074,35877,3575885330,3575885330,0
0,1074,35878,3575885330,3575885330,0
0,1074,35879,3575885330,3575885330,0
0,1074,35880,3575885330,3575885330,0
0,1074,35881,3575885330,3575885330,0
0,1074,35882,3575885330,3575885331,1
0,1074,35883,3575885330,3575885332,2
0,1074,35884,3575885330,3575885332,2
0,1074,35885,3575885330,3575885333,3
0,1074,35886,3575885330,3575885334,4
0,1074,35887,3575885330,3575885335,5
0,1074,35888,3575885330,3575885335,5
0,1074,35889,3575885330,3575885336,6
0,1074,35890,3575885330,3575885338,8
0,1074,35891,3575885330,3575885339,9
0,1074,35892,3575885330,3575885339,9
0,1074,35893,3575885330,3575885339,9
0,1074,35894,3575885330,3575885339,9
0,1074,35895,3575885330,3575885340,10
0,1074,35896,3575885330,3575885340,10
0,1074,35897,3575885330,3575885340,10
0,1074,35898,3575885330,3575885340,10
0,1074,35899,3575885330,3575885340,10
0,1074,35900,3575885330,3575885341,11
0,1074,35901,3575885330,3575885342,12
0,1074,35902,3575885330,3575885342,12
0,1074,35903,3575885330,3575885343,13
0,1074,35904,3575885330,3575885343,13
0,1074,35905,3575885330,3575885343,13
0,1074,35906,3575885330,3575885345,15
0,1074,35907,3575885330,3575885345,15
0,1074,35908,3575885330,3575885346,16
0,1074,35909,3575885330,3575885346,16
0,1074,35910,3575885330,3575885346,16
0,1074,35911,3575885330,3575885348,18
0,1074,35912,3575885330,3575885348,18
0,1074,35913,3575885330,3575885348,18
0,1074,35914,3575885330,3575885349,19
0,1074,35915,3575885330,3575885349,19
0,1074,35916,3575885330,3575885352,22
0,1074,35917,3575885330,3575885353,23
0,1074,35918,3575885330,3575885354,24
0,1074,35919,3575885330,3575885354,24
0,1074,35920,3575885330,3575885354,24
0,1074,35921,3575885330,3575885355,25
0,1074,35922,3575885330,3575885355,25
0,1074,35923,3575885330,3575885356,26
0,1074,35924,3575885330,3575885357,27
0,1074,35925,3575885330,3575885359,29
0,1074,35926,3575885330,3575885360,30
0,1074,35927,3575885330,3575885361,31
0,1074,35928,3575885330,3575885361,31
0,1074,35929,3575885330,3575885362,32
0,1074,35930,3575885330,3575885362,32
0,1074,35931,3575885330,3575885362,32
0,1074,35932,3575885330,3575885363,33
0,1074,35933,3575885330,3575885364,34
0,1074,35934,3575885330,3575885365,35
0,1074,35935,3575885330,3575885365,35
0,1074,35936,3575885330,3575885365,35
0,1074,35937,3575885330,3575885366,36
0,1074,35938,3575885330,3575885367,37
0,1074,35939,3575885330,3575885367,37
0,1074,35940,3575885330,3575885368,38
0,1074,35941,3575885330,3575885368,38
0,1074,35942,3575885330,3575885371,41
0,1074,35943,3575885330,3575885371,41
0,1074,35944,3575885330,3575885372,42
0,1074,35945,3575885330,3575885372,42
0,1074,35946,3575885330,3575885374,44
0,1074,35947,3575885330,3575885374,44
0,1074,35948,3575885330,3575885375,45
0,1074,35949,3575885330,3575885376,46
0,1074,35950,3575885330,3575885376,46
0,1074,35951,3575885330,3575885376,46
0,1074,35952,3575885330,3575885376,46
0,1074,35953,3575885330,3575885377,47
0,1074,35954,3575885330,3575885378,48
0,1074,35955,3575885330,3575885378,48
0,1074,35956,3575885330,3575885379,49
0,1074,35957,3575885330,3575885380,50
0,1075,35958,3575885393,3575885393,0
0,1075,35959,3575885393,3575885393,0
0,1075,35960,3575885393,3575885393,0
0,1075,35961,3575885393,3575885393,0
0,1075,35962,3575885393,3575885393,0
0,1075,35963,3575885393,3575885393,0
0,1075,35964,3575885393,3575885393,0
0,1075,35965,3575885393,3575885393,0
0,1075,35966,3575885393,3575885393,0
0,1075,35967,3575885393,3575885393,0
0,1075,35968,3575885393,3575885393,0
0,1075,35969,3575885393,3575885393,0
0,1075,35970,3575885393,3575885393,0
0,1075,35971,3575885393,3575885394,1
0,1075,35972,3575885393,3575885399,6
0,1075,35973,3575885393,3575885399,6
0,1075,35974,3575885393,3575885400,7
0,1075,35975,3575885393,3575885400,7
0,1075,35976,3575885393,3575885401,8
0,1075,35977,3575885393,3575885401,8
0,1075,35978,3575885393,3575885403,10
0,1075,35979,3575885393,3575885405,12
0,1075,35980,3575885393,3575885406,13
0,1075,35981,3575885393,3575885406,13
0,1075,35982,3575885393,3575885406,13
0,1075,35983,3575885393,3575885409,16
0,1075,35984,3575885393,3575885409,16
0,1075,35985,3575885393,3575885410,17
0,1075,35986,3575885393,3575885411,18
0,1075,35987,3575885393,3575885413,20
0,1075,35988,3575885393,3575885413,20
0,1075,35989,3575885393,3575885413,20
0,1075,35990,3575885393,3575885414,21
0,1075,35991,3575885393,3575885415,22
0,1075,35992,3575885393,3575885415,22
0,1075,35993,3575885393,3575885415,22
0,1075,35994,3575885393,3575885416,23
0,1075,35995,3575885393,3575885417,24
0,1075,35996,3575885393,3575885418,25
0,1075,35997,3575885393,3575885419,26
0,1075,35998,3575885393,3575885421,28
0,1075,35999,3575885393,3575885421,28
0,1075,36000,3575885393,3575885422,29
0,1075,36001,3575885393,3575885422,29
0,1075,36002,3575885393,3575885423,30
0,1075,36003,3575885393,3575885425,32
0,1075,36004,3575885393,3575885428,35
0,1075,36005,3575885393,3575885429,36
0,1075,36006,3575885393,3575885429,36
0,1075,36007,3575885393,3575885430,37
0,1075,36008,3575885393,3575885430,37
0,1075,36009,3575885393,3575885430,37
0,1075,36010,3575885393,3575885430,37
0,1075,36011,3575885393,3575885432,39
0,1075,36012,3575885393,3575885432,39
0,1075,36013,3575885393,3575885432,39
0,1075,36014,3575885393,3575885432,39
0,1075,36015,3575885393,3575885433,40
0,1075,36016,3575885393,3575885433,40
0,1075,36017,3575885393,3575885433,40
0,1075,36018,3575885393,3575885433,40
0,1075,36019,3575885393,3575885433,40
0,1075,36020,3575885393,3575885434,41
0,1075,36021,3575885393,3575885435,42
0,1075,36022,3575885393,3575885435,42
0,1075,36023,3575885393,3575885440,47
0,1075,36024,3575885393,3575885441,48
0,1075,36025,3575885393,3575885441,48
0,1075,36026,3575885393,3575885442,49
0,1076,36027,3575885457,3575885457,0
0,1076,36028,3575885457,3575885457,0
0,1076,36029,3575885457,3575885458,1
0,1076,36030,3575885457,3575885458,1
0,1076,36031,3575885457,3575885458,1
0,1076,36032,3575885457,3575885458,1
0,1076,36033,3575885457,3575885458,1
0,1076,36034,3575885457,3575885458,1
0,1076,36035,3575885457,3575885458,1
0,1076,36036,3575885457,3575885458,1
0,1076,36037,3575885457,3575885458,1
0,1076,36038,3575885457,3575885458,1
0,1076,36039,3575885457,3575885458,1
0,1076,36040,3575885457,3575885458,1
0,1076,36041,3575885457,3575885459,2
0,1076,36042,3575885457,3575885459,2
0,1076,36043,3575885457,3575885460,3
0,1076,36044,3575885457,3575885461,4
0,1076,36045,3575885457,3575885461,4
0,1076,36046,3575885457,3575885461,4
0,1076,36047,3575885457,3575885462,5
0,1076,36048,3575885457,3575885462,5
0,1076,36049,3575885457,3575885462,5
0,1076,36050,3575885457,3575885463,6
0,1076,36051,3575885457,3575885463,6
0,1076,36052,3575885457,3575885464,7
0,1076,36053,3575885457,3575885466,9
0,1076,36054,3575885457,3575885466,9
0,1076,36055,3575885457,3575885466,9
0,1076,36056,3575885457,3575885467,10
0,1076,36057,3575885457,3575885467,10
0,1076,36058,3575885457,3575885467,10
0,1076,36059,3575885457,3575885467,10
0,1076,36060,3575885457,3575885477,20
0,1076,36061,3575885457,3575885479,22
0,1076,36062,3575885457,3575885479,22
0,1076,36063,3575885457,3575885481,24
0,1076,36064,3575885457,3575885485,28
0,1076,36065,3575885457,3575885487,30
0,1076,36066,3575885457,3575885487,30
0,1076,36067,3575885457,3575885487,30
0,1076,36068,3575885457,3575885487,30
0,1076,36069,3575885457,3575885487,30
0,1076,36070,3575885457,3575885488,31
0,1076,36071,3575885457,3575885488,31
0,1076,36072,3575885457,3575885488,31
0,1076,36073,3575885457,3575885489,32
0,1076,36074,3575885457,3575885489,32
0,1076,36075,3575885457,3575885489,32
0,1076,36076,3575885457,3575885490,33
0,1076,36077,3575885457,3575885491,34
0,1076,36078,3575885457,3575885491,34
0,1076,36079,3575885457,3575885492,35
0,1076,36080,3575885457,3575885493,36
0,1076,36081,3575885457,3575885493,36
0,1076,36082,3575885457,3575885493,36
0,1076,36083,3575885457,3575885493,36
0,1076,36084,3575885457,3575885496,39
0,1076,36085,3575885457,3575885497,40
0,1076,36086,3575885457,3575885497,40
0,1076,36087,3575885457,3575885497,40
0,1076,36088,3575885457,3575885498,41
0,1076,36089,3575885457,3575885498,41
0,1076,36090,3575885457,3575885499,42
0,1076,36091,3575885457,3575885499,42
0,1076,36092,3575885457,3575885500,43
0,1076,36093,3575885457,3575885501,44
0,1076,36094,3575885457,3575885502,45
0,1076,36095,3575885457,3575885503,46
0,1076,36096,3575885457,3575885504,47
0,1076,36097,3575885457,3575885504,47
0,1076,36098,3575885457,3575885504,47
0,1076,36099,3575885457,3575885505,48
0,1076,36100,3575885457,3575885506,49
0,1076,36101,3575885457,3575885507,50
0,1077,36102,3575885519,3575885519,0
0,1077,36103,3575885519,3575885519,0
0,1077,36104,3575885519,3575885519,0
0,1077,36105,3575885519,3575885519,0
0,1077,36106,3575885519,3575885519,0
0,1077,36107,3575885519,3575885519,0
0,1077,36108,3575885519,3575885519,0
0,1077,36109,3575885519,3575885519,0
0,1077,36110,3575885519,3575885519,0
0,1077,36111,3575885519,3575885519,0
0,1077,36112,3575885519,3575885519,0
0,1077,36113,3575885519,3575885519,0
0,1077,36114,3575885519,3575885519,0
0,1077,36115,3575885519,3575885519,0
0,1077,36116,3575885519,3575885519,0
0,1077,36117,3575885519,3575885519,0
0,1077,36118,3575885519,3575885519,0
0,1077,36119,3575885519,3575885521,2
0,1077,36120,3575885519,3575885521,2
0,1077,36121,3575885519,3575885521,2
0,1077,36122,3575885519,3575885521,2
0,1077,36123,3575885519,3575885522,3
0,1077,36124,3575885519,3575885523,4
0,1077,36125,3575885519,3575885524,5
0,1077,36126,3575885519,3575885524,5
0,1077,36127,3575885519,3575885524,5
0,1077,36128,3575885519,3575885524,5
0,1077,36129,3575885519,3575885524,5
0,1077,36130,3575885519,3575885524,5
0,1077,36131,3575885519,3575885526,7
0,1077,36132,3575885519,3575885526,7
0,1077,36133,3575885519,3575885526,7
0,1077,36134,3575885519,3575885527,8
0,1077,36135,3575885519,3575885528,9
0,1077,36136,3575885519,3575885528,9
0,1077,36137,3575885519,3575885530,11
0,1077,36138,3575885519,3575885530,11
0,1077,36139,3575885519,3575885530,11
0,1077,36140,3575885519,3575885530,11
0,1077,36141,3575885519,3575885532,13
0,1077,36142,3575885519,3575885532,13
0,1077,36143,3575885519,3575885533,14
0,1077,36144,3575885519,3575885533,14
0,1077,36145,3575885519,3575885535,16
0,1077,36146,3575885519,3575885536,17
0,1077,36147,3575885519,3575885538,19
0,1077,36148,3575885519,3575885538,19
0,1077,36149,3575885519,3575885538,19
0,1077,36150,3575885519,3575885538,19
0,1077,36151,3575885519,3575885539,20
0,1077,36152,3575885519,3575885539,20
0,1077,36153,3575885519,3575885539,20
0,1077,36154,3575885519,3575885540,21
0,1077,36155,3575885519,3575885540,21
0,1077,36156,3575885519,3575885541,22
0,1077,36157,3575885519,3575885541,22
0,1077,36158,3575885519,3575885543,24
0,1077,36159,3575885519,3575885543,24
0,1077,36160,3575885519,3575885544,25
0,1077,36161,3575885519,3575885545,26
0,1077,36162,3575885519,3575885545,26
0,1077,36163,3575885519,3575885545,26
0,1077,36164,3575885519,3575885546,27
0,1077,36165,3575885519,3575885547,28
0,1077,36166,3575885519,3575885547,28
0,1077,36167,3575885519,3575885547,28
0,1077,36168,3575885519,3575885550,31
0,1077,36169,3575885519,3575885551,32
0,1077,36170,3575885519,3575885552,33
0,1077,36171,3575885519,3575885552,33
0,1077,36172,3575885519,3575885553,34
0,1077,36173,3575885519,3575885554,35
0,1077,36174,3575885519,3575885554,35
0,1077,36175,3575885519,3575885555,36
0,1077,36176,3575885519,3575885555,36
0,1077,36177,3575885519,3575885558,39
0,1077,36178,3575885519,3575885560,41
0,1077,36179,3575885519,3575885560,41
0,1077,36180,3575885519,3575885560,41
0,1077,36181,3575885519,3575885561,42
0,1077,36182,3575885519,3575885562,43
0,1077,36183,3575885519,3575885562,43
0,1077,36184,3575885519,3575885564,45
0,1077,36185,3575885519,3575885564,45
0,1077,36186,3575885519,3575885565,46
0,1077,36187,3575885519,3575885565,46
0,1077,36188,3575885519,3575885565,46
0,1077,36189,3575885519,3575885566,47
0,1077,36190,3575885519,3575885566,47
0,1077,36191,3575885519,3575885568,49
0,1077,36192,3575885519,3575885569,50
0,1078,36193,3575885582,3575885582,0
0,1078,36194,3575885582,3575885582,0
0,1078,36195,3575885582,3575885582,0
0,1078,36196,3575885582,3575885582,0
0,1078,36197,3575885582,3575885582,0
0,1078,36198,3575885582,3575885582,0
0,1078,36199,3575885582,3575885582,0
0,1078,36200,3575885582,3575885582,0
0,1078,36201,3575885582,3575885582,0
0,1078,36202,3575885582,3575885582,0
0,1078,36203,3575885582,3575885582,0
0,1078,36204,3575885582,3575885582,0
0,1078,36205,3575885582,3575885582,0
0,1078,36206,3575885582,3575885582,0
0,1078,36207,3575885582,3575885582,0
0,1078,36208,3575885582,3575885582,0
0,1078,36209,3575885582,3575885582,0
0,1078,36210,3575885582,3575885583,1
0,1078,36211,3575885582,3575885583,1
0,1078,36212,3575885582,3575885583,1
0,1078,36213,3575885582,3575885585,3
0,1078,36214,3575885582,3575885585,3
0,1078,36215,3575885582,3575885586,4
0,1078,36216,3575885582,3575885588,6
0,1078,36217,3575885582,3575885592,10
0,1078,36218,3575885582,3575885593,11
0,1078,36219,3575885582,3575885593,11
0,1078,36220,3575885582,3575885598,16
0,1078,36221,3575885582,3575885599,17
0,1078,36222,3575885582,3575885599,17
0,1078,36223,3575885582,3575885600,18
0,1078,36224,3575885582,3575885600,18
0,1078,36225,3575885582,3575885600,18
0,1078,36226,3575885582,3575885603,21
0,1078,36227,3575885582,3575885604,22
0,1078,36228,3575885582,3575885605,23
0,1078,36229,3575885582,3575885607,25
0,1078,36230,3575885582,3575885607,25
0,1078,36231,3575885582,3575885608,26
0,1078,36232,3575885582,3575885609,27
0,1078,36233,3575885582,3575885612,30
0,1078,36234,3575885582,3575885612,30
0,1078,36235,3575885582,3575885613,31
0,1078,36236,3575885582,3575885613,31
0,1078,36237,3575885582,3575885613,31
0,1078,36238,3575885582,3575885614,32
0,1078,36239,3575885582,3575885615,33
0,1078,36240,3575885582,3575885616,34
0,1078,36241,3575885582,3575885618,36
0,1078,36242,3575885582,3575885618,36
0,1078,36243,3575885582,3575885620,38
0,1078,36244,3575885582,3575885620,38
0,1078,36245,3575885582,3575885621,39
0,1078,36246,3575885582,3575885621,39
0,1078,36247,3575885582,3575885622,40
0,1078,36248,3575885582,3575885624,42
0,1078,36249,3575885582,3575885627,45
0,1078,36250,3575885582,3575885627,45
0,1078,36251,3575885582,3575885628,46
0,1078,36252,3575885582,3575885628,46
0,1078,36253,3575885582,3575885629,47
0,1078,36254,3575885582,3575885629,47
0,1078,36255,3575885582,3575885630,48
0,1078,36256,3575885582,3575885631,49
0,1078,36257,3575885582,3575885631,49
0,1078,36258,3575885582,3575885631,49
0,1078,36259,3575885582,3575885632,50
0,1079,36260,3575885646,3575885646,0
0,1079,36261,3575885646,3575885646,0
0,1079,36262,3575885646,3575885646,0
0,1079,36263,3575885646,3575885646,0
0,1079,36264,3575885646,3575885646,0
0,1079,36265,3575885646,3575885646,0
0,1079,36266,3575885646,3575885646,0
0,1079,36267,3575885646,3575885646,0
0,1079,36268,3575885646,3575885646,0
0,1079,36269,3575885646,3575885647,1
0,1079,36270,3575885646,3575885647,1
0,1079,36271,3575885646,3575885647,1
0,1079,36272,3575885646,3575885647,1
0,1079,36273,3575885646,3575885647,1
0,1079,36274,3575885646,3575885647,1
0,1079,36275,3575885646,3575885647,1
0,1079,36276,3575885646,3575885647,1
0,1079,36277,3575885646,3575885647,1
0,1079,36278,3575885646,3575885649,3
0,1079,36279,3575885646,3575885650,4
0,1079,36280,3575885646,3575885653,7
0,1079,36281,3575885646,3575885654,8
0,1079,36282,3575885646,3575885654,8
0,1079,36283,3575885646,3575885655,9
0,1079,36284,3575885646,3575885656,10
0,1079,36285,3575885646,3575885657,11
0,1079,36286,3575885646,3575885658,12
0,1079,36287,3575885646,3575885659,13
0,1079,36288,3575885646,3575885659,13
0,1079,36289,3575885646,3575885660,14
0,1079,36290,3575885646,3575885660,14
0,1079,36291,3575885646,3575885660,14
0,1079,36292,3575885646,3575885661,15
0,1079,36293,3575885646,3575885662,16
0,1079,36294,3575885646,3575885662,16
0,1079,36295,3575885646,3575885662,16
0,1079,36296,3575885646,3575885664,18
0,1079,36297,3575885646,3575885664,18
0,1079,36298,3575885646,3575885665,19
0,1079,36299,3575885646,3575885665,19
0,1079,36300,3575885646,3575885666,20
0,1079,36301,3575885646,3575885666,20
0,1079,36302,3575885646,3575885666,20
0,1079,36303,3575885646,3575885666,20
0,1079,36304,3575885646,3575885667,21
0,1079,36305,3575885646,3575885667,21
0,1079,36306,3575885646,3575885677,31
0,1079,36307,3575885646,3575885678,32
0,1079,36308,3575885646,3575885678,32
0,1079,36309,3575885646,3575885679,33
0,1079,36310,3575885646,3575885681,35
0,1079,36311,3575885646,3575885686,40
0,1079,36312,3575885646,3575885687,41
0,1079,36313,3575885646,3575885687,41
0,1079,36314,3575885646,3575885687,41
0,1079,36315,3575885646,3575885688,42
0,1079,36316,3575885646,3575885688,42
0,1079,36317,3575885646,3575885688,42
0,1079,36318,3575885646,3575885689,43
0,1079,36319,3575885646,3575885689,43
0,1079,36320,3575885646,3575885689,43
0,1079,36321,3575885646,3575885691,45
0,1079,36322,3575885646,3575885691,45
0,1079,36323,3575885646,3575885692,46
0,1079,36324,3575885646,3575885692,46
0,1079,36325,3575885646,3575885693,47
0,1079,36326,3575885646,3575885693,47
0,1079,36327,3575885646,3575885693,47
0,1079,36328,3575885646,3575885696,50
0,1080,36329,3575885709,3575885709,0
0,1080,36330,3575885709,3575885709,0
0,1080,36331,3575885709,3575885709,0
0,1080,36332,3575885709,3575885709,0
0,1080,36333,3575885709,3575885709,0
0,1080,36334,3575885709,3575885709,0
0,1080,36335,3575885709,3575885709,0
0,1080,36336,3575885709,3575885709,0
0,1080,36337,3575885709,3575885709,0
0,1080,36338,3575885709,3575885709,0
0,1080,36339,3575885709,3575885709,0
0,1080,36340,3575885709,3575885709,0
0,1080,36341,3575885709,3575885709,0
0,1080,36342,3575885709,3575885709,0
0,1080,36343,3575885709,3575885709,0
0,1080,36344,3575885709,3575885709,0
0,1080,36345,3575885709,3575885709,0
0,1080,36346,3575885709,3575885709,0
0,1080,36347,3575885709,3575885709,0
0,1080,36348,3575885709,3575885709,0
0,1080,36349,3575885709,3575885710,1
0,1080,36350,3575885709,3575885710,1
0,1080,36351,3575885709,3575885710,1
0,1080,36352,3575885709,3575885710,1
0,1080,36353,3575885709,3575885710,1
0,1080,36354,3575885709,3575885711,2
0,1080,36355,3575885709,3575885712,3
0,1080,36356,3575885709,3575885713,4
0,1080,36357,3575885709,3575885714,5
0,1080,36358,3575885709,3575885715,6
0,1080,36359,3575885709,3575885715,6
0,1080,36360,3575885709,3575885716,7
0,1080,36361,3575885709,3575885716,7
0,1080,36362,3575885709,3575885718,9
0,1080,36363,3575885709,3575885719,10
0,1080,36364,3575885709,3575885721,12
0,1080,36365,3575885709,3575885721,12
0,1080,36366,3575885709,3575885722,13
0,1080,36367,3575885709,3575885722,13
0,1080,36368,3575885709,3575885723,14
0,1080,36369,3575885709,3575885723,14
0,1080,36370,3575885709,3575885723,14
0,1080,36371,3575885709,3575885724,15
0,1080,36372,3575885709,3575885724,15
0,1080,36373,3575885709,3575885724,15
0,1080,36374,3575885709,3575885725,16
0,1080,36375,3575885709,3575885725,16
0,1080,36376,3575885709,3575885725,16
0,1080,36377,3575885709,3575885726,17
0,1080,36378,3575885709,3575885727,18
0,1080,36379,3575885709,3575885728,19
0,1080,36380,3575885709,3575885729,20
0,1080,36381,3575885709,3575885730,21
0,1080,36382,3575885709,3575885730,21
0,1080,36383,3575885709,3575885730,21
0,1080,36384,3575885709,3575885732,23
0,1080,36385,3575885709,3575885733,24
0,1080,36386,3575885709,3575885734,25
0,1080,36387,3575885709,3575885736,27
0,1080,36388,3575885709,3575885738,29
0,1080,36389,3575885709,3575885738,29
0,1080,36390,3575885709,3575885738,29
0,1080,36391,3575885709,3575885738,29
0,1080,36392,3575885709,3575885739,30
0,1080,36393,3575885709,3575885739,30
0,1080,36394,3575885709,3575885739,30
0,1080,36395,3575885709,3575885740,31
0,1080,36396,3575885709,3575885741,32
0,1080,36397,3575885709,3575885741,32
0,1080,36398,3575885709,3575885741,32
0,1080,36399,3575885709,3575885741,32
0,1080,36400,3575885709,3575885742,33
0,1080,36401,3575885709,3575885742,33
0,1080,36402,3575885709,3575885743,34
0,1080,36403,3575885709,3575885745,36
0,1080,36404,3575885709,3575885745,36
0,1080,36405,3575885709,3575885745,36
0,1080,36406,3575885709,3575885746,37
0,1080,36407,3575885709,3575885747,38
0,1080,36408,3575885709,3575885747,38
0,1080,36409,3575885709,3575885748,39
0,1080,36410,3575885709,3575885748,39
0,1080,36411,3575885709,3575885748,39
0,1080,36412,3575885709,3575885751,42
0,1080,36413,3575885709,3575885752,43
0,1080,36414,3575885709,3575885752,43
0,1080,36415,3575885709,3575885753,44
0,1080,36416,3575885709,3575885753,44
0,1080,36417,3575885709,3575885753,44
0,1080,36418,3575885709,3575885755,46
0,1080,36419,3575885709,3575885755,46
0,1080,36420,3575885709,3575885755,46
0,1080,36421,3575885709,3575885756,47
0,1080,36422,3575885709,3575885756,47
0,1080,36423,3575885709,3575885758,49
0,1081,36424,3575885780,3575885780,0
0,1081,36425,3575885780,3575885780,0
0,1081,36426,3575885780,3575885780,0
0,1081,36427,3575885780,3575885780,0
0,1081,36428,3575885780,3575885780,0
0,1081,36429,3575885780,3575885780,0
0,1081,36430,3575885780,3575885780,0
0,1081,36431,3575885780,3575885780,0
0,1081,36432,3575885780,3575885780,0
0,1081,36433,3575885780,3575885780,0
0,1081,36434,3575885780,3575885780,0
0,1081,36435,3575885780,3575885780,0
0,1081,36436,3575885780,3575885780,0
0,1081,36437,3575885780,3575885780,0
0,1081,36438,3575885780,3575885780,0
0,1081,36439,3575885780,3575885780,0
0,1081,36440,3575885780,3575885780,0
0,1081,36441,3575885780,3575885780,0
0,1081,36442,3575885780,3575885780,0
0,1081,36443,3575885780,3575885780,0
0,1081,36444,3575885780,3575885780,0
0,1081,36445,3575885780,3575885780,0
0,1081,36446,3575885780,3575885780,0
0,1081,36447,3575885780,3575885780,0
0,1081,36448,3575885780,3575885780,0
0,1081,36449,3575885780,3575885780,0
0,1081,36450,3575885780,3575885780,0
0,1081,36451,3575885780,3575885780,0
0,1081,36452,3575885780,3575885780,0
0,1081,36453,3575885780,3575885780,0
0,1081,36454,3575885780,3575885780,0
0,1081,36455,3575885780,3575885780,0
0,1081,36456,3575885780,3575885780,0
0,1081,36457,3575885780,3575885782,2
0,1081,36458,3575885780,3575885782,2
0,1081,36459,3575885780,3575885783,3
0,1081,36460,3575885780,3575885784,4
0,1081,36461,3575885780,3575885785,5
0,1081,36462,3575885780,3575885785,5
0,1081,36463,3575885780,3575885786,6
0,1081,36464,3575885780,3575885789,9
0,1081,36465,3575885780,3575885791,11
0,1081,36466,3575885780,3575885793,13
0,1081,36467,3575885780,3575885794,14
0,1081,36468,3575885780,3575885798,18
0,1081,36469,3575885780,3575885799,19
0,1081,36470,3575885780,3575885800,20
0,1081,36471,3575885780,3575885800,20
0,1081,36472,3575885780,3575885800,20
0,1081,36473,3575885780,3575885801,21
0,1081,36474,3575885780,3575885803,23
0,1081,36475,3575885780,3575885805,25
0,1081,36476,3575885780,3575885805,25
0,1081,36477,3575885780,3575885806,26
0,1081,36478,3575885780,3575885807,27
0,1081,36479,3575885780,3575885808,28
0,1081,36480,3575885780,3575885809,29
0,1081,36481,3575885780,3575885812,32
0,1081,36482,3575885780,3575885812,32
0,1081,36483,3575885780,3575885812,32
0,1081,36484,3575885780,3575885812,32
0,1081,36485,3575885780,3575885813,33
0,1081,36486,3575885780,3575885815,35
0,1081,36487,3575885780,3575885815,35
0,1081,36488,3575885780,3575885815,35
0,1081,36489,3575885780,3575885816,36
0,1081,36490,3575885780,3575885818,38
0,1081,36491,3575885780,3575885821,41
0,1081,36492,3575885780,3575885821,41
0,1081,36493,3575885780,3575885821,41
0,1081,36494,3575885780,3575885822,42
0,1081,36495,3575885780,3575885822,42
0,1081,36496,3575885780,3575885824,44
0,1081,36497,3575885780,3575885826,46
0,1081,36498,3575885780,3575885827,47
0,1081,36499,3575885780,3575885829,49
0,1081,36500,3575885780,3575885829,49
0,1081,36501,3575885780,3575885829,49
0,1081,36502,3575885780,3575885829,49
0,1082,36503,3575885843,3575885843,0
0,1082,36504,3575885843,3575885843,0
0,1082,36505,3575885843,3575885843,0
0,1082,36506,3575885843,3575885843,0
0,1082,36507,3575885843,3575885843,0
0,1082,36508,3575885843,3575885843,0
0,1082,36509,3575885843,3575885843,0
0,1082,36510,3575885843,3575885843,0
0,1082,36511,3575885843,3575885843,0
0,1082,36512,3575885843,3575885843,0
0,1082,36513,3575885843,3575885843,0
0,1082,36514,3575885843,3575885843,0
0,1082,36515,3575885843,3575885843,0
0,1082,36516,3575885843,3575885843,0
0,1082,36517,3575885843,3575885843,0
0,1082,36518,3575885843,3575885843,0
0,1082,36519,3575885843,3575885843,0
0,1082,36520,3575885843,3575885844,1
0,1082,36521,3575885843,3575885846,3
0,1082,36522,3575885843,3575885846,3
0,1082,36523,3575885843,3575885847,4
0,1082,36524,3575885843,3575885847,4
0,1082,36525,3575885843,3575885847,4
0,1082,36526,3575885843,3575885849,6
0,1082,36527,3575885843,3575885849,6
0,1082,36528,3575885843,3575885850,7
0,1082,36529,3575885843,3575885851,8
0,1082,36530,3575885843,3575885853,10
0,1082,36531,3575885843,3575885853,10
0,1082,36532,3575885843,3575885854,11
0,1082,36533,3575885843,3575885854,11
0,1082,36534,3575885843,3575885856,13
0,1082,36535,3575885843,3575885856,13
0,1082,36536,3575885843,3575885858,15
0,1082,36537,3575885843,3575885859,16
0,1082,36538,3575885843,3575885860,17
0,1082,36539,3575885843,3575885861,18
0,1082,36540,3575885843,3575885861,18
0,1082,36541,3575885843,3575885861,18
0,1082,36542,3575885843,3575885862,19
0,1082,36543,3575885843,3575885863,20
0,1082,36544,3575885843,3575885864,21
0,1082,36545,3575885843,3575885864,21
0,1082,36546,3575885843,3575885865,22
0,1082,36547,3575885843,3575885865,22
0,1082,36548,3575885843,3575885866,23
0,1082,36549,3575885843,3575885866,23
0,1082,36550,3575885843,3575885867,24
0,1082,36551,3575885843,3575885867,24
0,1082,36552,3575885843,3575885867,24
0,1082,36553,3575885843,3575885867,24
0,1082,36554,3575885843,3575885878,35
0,1082,36555,3575885843,3575885878,35
0,1082,36556,3575885843,3575885881,38
0,1082,36557,3575885843,3575885885,42
0,1082,36558,3575885843,3575885887,44
0,1082,36559,3575885843,3575885887,44
0,1082,36560,3575885843,3575885887,44
0,1082,36561,3575885843,3575885888,45
0,1082,36562,3575885843,3575885888,45
0,1082,36563,3575885843,3575885888,45
0,1082,36564,3575885843,3575885889,46
0,1082,36565,3575885843,3575885889,46
0,1082,36566,3575885843,3575885890,47
0,1082,36567,3575885843,3575885890,47
0,1082,36568,3575885843,3575885892,49
0,1083,36569,3575885906,3575885906,0
0,1083,36570,3575885906,3575885906,0
0,1083,36571,3575885906,3575885906,0
0,1083,36572,3575885906,3575885906,0
0,1083,36573,3575885906,3575885906,0
0,1083,36574,3575885906,3575885906,0
0,1083,36575,3575885906,3575885906,0
0,1083,36576,3575885906,3575885906,0
0,1083,36577,3575885906,3575885906,0
0,1083,36578,3575885906,3575885906,0
0,1083,36579,3575885906,3575885906,0
0,1083,36580,3575885906,3575885906,0
0,1083,36581,3575885906,3575885906,0
0,1083,36582,3575885906,3575885906,0
0,1083,36583,3575885906,3575885906,0
0,1083,36584,3575885906,3575885906,0
0,1083,36585,3575885906,3575885906,0
0,1083,36586,3575885906,3575885906,0
0,1083,36587,3575885906,3575885906,0
0,1083,36588,3575885906,3575885906,0
0,1083,36589,3575885906,3575885906,0
0,1083,36590,3575885906,3575885907,1
0,1083,36591,3575885906,3575885907,1
0,1083,36592,3575885906,3575885909,3
0,1083,36593,3575885906,3575885909,3
0,1083,36594,3575885906,3575885909,3
0,1083,36595,3575885906,3575885910,4
0,1083,36596,3575885906,3575885910,4
0,1083,36597,3575885906,3575885910,4
0,1083,36598,3575885906,3575885911,5
0,1083,36599,3575885906,3575885913,7
0,1083,36600,3575885906,3575885913,7
0,1083,36601,3575885906,3575885915,9
0,1083,36602,3575885906,3575885915,9
0,1083,36603,3575885906,3575885915,9
0,1083,36604,3575885906,3575885916,10
0,1083,36605,3575885906,3575885916,10
0,1083,36606,3575885906,3575885917,11
0,1083,36607,3575885906,3575885920,14
0,1083,36608,3575885906,3575885920,14
0,1083,36609,3575885906,3575885921,15
0,1083,36610,3575885906,3575885922,16
0,1083,36611,3575885906,3575885922,16
0,1083,36612,3575885906,3575885923,17
0,1083,36613,3575885906,3575885923,17
0,1083,36614,3575885906,3575885924,18
0,1083,36615,3575885906,3575885924,18
0,1083,36616,3575885906,3575885924,18
0,1083,36617,3575885906,3575885925,19
0,1083,36618,3575885906,3575885925,19
0,1083,36619,3575885906,3575885926,20
0,1083,36620,3575885906,3575885926,20
0,1083,36621,3575885906,3575885926,20
0,1083,36622,3575885906,3575885927,21
0,1083,36623,3575885906,3575885927,21
0,1083,36624,3575885906,3575885928,22
0,1083,36625,3575885906,3575885930,24
0,1083,36626,3575885906,3575885931,25
0,1083,36627,3575885906,3575885932,26
0,1083,36628,3575885906,3575885932,26
0,1083,36629,3575885906,3575885933,27
0,1083,36630,3575885906,3575885934,28
0,1083,36631,3575885906,3575885934,28
0,1083,36632,3575885906,3575885935,29
0,1083,36633,3575885906,3575885936,30
0,1083,36634,3575885906,3575885937,31
0,1083,36635,3575885906,3575885938,32
0,1083,36636,3575885906,3575885939,33
0,1083,36637,3575885906,3575885939,33
0,1083,36638,3575885906,3575885939,33
0,1083,36639,3575885906,3575885939,33
0,1083,36640,3575885906,3575885939,33
0,1083,36641,3575885906,3575885940,34
0,1083,36642,3575885906,3575885940,34
0,1083,36643,3575885906,3575885941,35
0,1083,36644,3575885906,3575885941,35
0,1083,36645,3575885906,3575885942,36
0,1083,36646,3575885906,3575885942,36
0,1083,36647,3575885906,3575885943,37
0,1083,36648,3575885906,3575885943,37
0,1083,36649,3575885906,3575885945,39
0,1083,36650,3575885906,3575885945,39
0,1083,36651,3575885906,3575885945,39
0,1083,36652,3575885906,3575885945,39
0,1083,36653,3575885906,3575885947,41
0,1083,36654,3575885906,3575885947,41
0,1083,36655,3575885906,3575885947,41
0,1083,36656,3575885906,3575885948,42
0,1083,36657,3575885906,3575885948,42
0,1083,36658,3575885906,3575885952,46
0,1083,36659,3575885906,3575885953,47
0,1083,36660,3575885906,3575885953,47
0,1083,36661,3575885906,3575885953,47
0,1083,36662,3575885906,3575885953,47
0,1083,36663,3575885906,3575885954,48
0,1083,36664,3575885906,3575885954,48
0,1083,36665,3575885906,3575885955,49
0,1083,36666,3575885906,3575885955,49
0,1083,36667,3575885906,3575885956,50
0,1084,36668,3575885970,3575885970,0
0,1084,36669,3575885970,3575885970,0
0,1084,36670,3575885970,3575885970,0
0,1084,36671,3575885970,3575885970,0
0,1084,36672,3575885970,3575885970,0
0,1084,36673,3575885970,3575885970,0
0,1084,36674,3575885970,3575885970,0
0,1084,36675,3575885970,3575885970,0
0,1084,36676,3575885970,3575885970,0
0,1084,36677,3575885970,3575885970,0
0,1084,36678,3575885970,3575885970,0
0,1084,36679,3575885970,3575885970,0
0,1084,36680,3575885970,3575885970,0
0,1084,36681,3575885970,3575885970,0
0,1084,36682,3575885970,3575885970,0
0,1084,36683,3575885970,3575885970,0
0,1084,36684,3575885970,3575885970,0
0,1084,36685,3575885970,3575885970,0
0,1084,36686,3575885970,3575885971,1
0,1084,36687,3575885970,3575885971,1
0,1084,36688,3575885970,3575885972,2
0,1084,36689,3575885970,3575885973,3
0,1084,36690,3575885970,3575885973,3
0,1084,36691,3575885970,3575885974,4
0,1084,36692,3575885970,3575885976,6
0,1084,36693,3575885970,3575885976,6
0,1084,36694,3575885970,3575885976,6
0,1084,36695,3575885970,3575885977,7
0,1084,36696,3575885970,3575885979,9
0,1084,36697,3575885970,3575885979,9
0,1084,36698,3575885970,3575885979,9
0,1084,36699,3575885970,3575885979,9
0,1084,36700,3575885970,3575885981,11
0,1084,36701,3575885970,3575885982,12
0,1084,36702,3575885970,3575885983,13
0,1084,36703,3575885970,3575885983,13
0,1084,36704,3575885970,3575885984,14
0,1084,36705,3575885970,3575885984,14
0,1084,36706,3575885970,3575885985,15
0,1084,36707,3575885970,3575885986,16
0,1084,36708,3575885970,3575885986,16
0,1084,36709,3575885970,3575885990,20
0,1084,36710,3575885970,3575885991,21
0,1084,36711,3575885970,3575885994,24
0,1084,36712,3575885970,3575885994,24
0,1084,36713,3575885970,3575885998,28
0,1084,36714,3575885970,3575885999,29
0,1084,36715,3575885970,3575886000,30
0,1084,36716,3575885970,3575886000,30
0,1084,36717,3575885970,3575886000,30
0,1084,36718,3575885970,3575886001,31
0,1084,36719,3575885970,3575886003,33
0,1084,36720,3575885970,3575886005,35
0,1084,36721,3575885970,3575886005,35
0,1084,36722,3575885970,3575886007,37
0,1084,36723,3575885970,3575886008,38
0,1084,36724,3575885970,3575886008,38
0,1084,36725,3575885970,3575886011,41
0,1084,36726,3575885970,3575886012,42
0,1084,36727,3575885970,3575886013,43
0,1084,36728,3575885970,3575886013,43
0,1084,36729,3575885970,3575886013,43
0,1084,36730,3575885970,3575886015,45
0,1084,36731,3575885970,3575886015,45
0,1084,36732,3575885970,3575886016,46
0,1084,36733,3575885970,3575886018,48
0,1084,36734,3575885970,3575886018,48
0,1084,36735,3575885970,3575886019,49
0,1084,36736,3575885970,3575886020,50
0,1085,36737,3575886037,3575886037,0
0,1085,36738,3575886037,3575886037,0
0,1085,36739,3575886037,3575886037,0
0,1085,36740,3575886037,3575886037,0
0,1085,36741,3575886037,3575886037,0
0,1085,36742,3575886037,3575886037,0
0,1085,36743,3575886037,3575886037,0
0,1085,36744,3575886037,3575886037,0
0,1085,36745,3575886037,3575886037,0
0,1085,36746,3575886037,3575886037,0
0,1085,36747,3575886037,3575886037,0
0,1085,36748,3575886037,3575886037,0
0,1085,36749,3575886037,3575886037,0
0,1085,36750,3575886037,3575886037,0
0,1085,36751,3575886037,3575886037,0
0,1085,36752,3575886037,3575886037,0
0,1085,36753,3575886037,3575886037,0
0,1085,36754,3575886037,3575886037,0
0,1085,36755,3575886037,3575886037,0
0,1085,36756,3575886037,3575886037,0
0,1085,36757,3575886037,3575886037,0
0,1085,36758,3575886037,3575886037,0
0,1085,36759,3575886037,3575886037,0
0,1085,36760,3575886037,3575886037,0
0,1085,36761,3575886037,3575886039,2
0,1085,36762,3575886037,3575886040,3
0,1085,36763,3575886037,3575886041,4
0,1085,36764,3575886037,3575886041,4
0,1085,36765,3575886037,3575886044,7
0,1085,36766,3575886037,3575886046,9
0,1085,36767,3575886037,3575886046,9
0,1085,36768,3575886037,3575886047,10
0,1085,36769,3575886037,3575886047,10
0,1085,36770,3575886037,3575886047,10
0,1085,36771,3575886037,3575886048,11
0,1085,36772,3575886037,3575886051,14
0,1085,36773,3575886037,3575886051,14
0,1085,36774,3575886037,3575886052,15
0,1085,36775,3575886037,3575886052,15
0,1085,36776,3575886037,3575886053,16
0,1085,36777,3575886037,3575886054,17
0,1085,36778,3575886037,3575886055,18
0,1085,36779,3575886037,3575886056,19
0,1085,36780,3575886037,3575886058,21
0,1085,36781,3575886037,3575886060,23
0,1085,36782,3575886037,3575886061,24
0,1085,36783,3575886037,3575886061,24
0,1085,36784,3575886037,3575886062,25
0,1085,36785,3575886037,3575886062,25
0,1085,36786,3575886037,3575886063,26
0,1085,36787,3575886037,3575886065,28
0,1085,36788,3575886037,3575886065,28
0,1085,36789,3575886037,3575886065,28
0,1085,36790,3575886037,3575886065,28
0,1085,36791,3575886037,3575886066,29
0,1085,36792,3575886037,3575886066,29
0,1085,36793,3575886037,3575886066,29
0,1085,36794,3575886037,3575886067,30
0,1085,36795,3575886037,3575886067,30
0,1085,36796,3575886037,3575886067,30
0,1085,36797,3575886037,3575886069,32
0,1085,36798,3575886037,3575886075,38
0,1085,36799,3575886037,3575886078,41
0,1085,36800,3575886037,3575886078,41
0,1085,36801,3575886037,3575886078,41
0,1085,36802,3575886037,3575886085,48
0,1086,36803,3575886103,3575886103,0
0,1086,36804,3575886103,3575886103,0
0,1086,36805,3575886103,3575886103,0
0,1086,36806,3575886103,3575886103,0
0,1086,36807,3575886103,3575886103,0
0,1086,36808,3575886103,3575886103,0
0,1086,36809,3575886103,3575886103,0
0,1086,36810,3575886103,3575886103,0
0,1086,36811,3575886103,3575886103,0
0,1086,36812,3575886103,3575886103,0
0,1086,36813,3575886103,3575886103,0
0,1086,36814,3575886103,3575886103,0
0,1086,36815,3575886103,3575886103,0
0,1086,36816,3575886103,3575886103,0
0,1086,36817,3575886103,3575886103,0
0,1086,36818,3575886103,3575886103,0
0,1086,36819,3575886103,3575886103,0
0,1086,36820,3575886103,3575886103,0
0,1086,36821,3575886103,3575886103,0
0,1086,36822,3575886103,3575886103,0
0,1086,36823,3575886103,3575886103,0
0,1086,36824,3575886103,3575886103,0
0,1086,36825,3575886103,3575886103,0
0,1086,36826,3575886103,3575886103,0
0,1086,36827,3575886103,3575886103,0
0,1086,36828,3575886103,3575886103,0
0,1086,36829,3575886103,3575886103,0
0,1086,36830,3575886103,3575886103,0
0,1086,36831,3575886103,3575886104,1
0,1086,36832,3575886103,3575886104,1
0,1086,36833,3575886103,3575886104,1
0,1086,36834,3575886103,3575886105,2
0,1086,36835,3575886103,3575886107,4
0,1086,36836,3575886103,3575886107,4
0,1086,36837,3575886103,3575886107,4
0,1086,36838,3575886103,3575886108,5
0,1086,36839,3575886103,3575886110,7
0,1086,36840,3575886103,3575886110,7
0,1086,36841,3575886103,3575886110,7
0,1086,36842,3575886103,3575886110,7
0,1086,36843,3575886103,3575886111,8
0,1086,36844,3575886103,3575886111,8
0,1086,36845,3575886103,3575886111,8
0,1086,36846,3575886103,3575886113,10
0,1086,36847,3575886103,3575886113,10
0,1086,36848,3575886103,3575886115,12
0,1086,36849,3575886103,3575886115,12
0,1086,36850,3575886103,3575886115,12
0,1086,36851,3575886103,3575886115,12
0,1086,36852,3575886103,3575886116,13
0,1086,36853,3575886103,3575886117,14
0,1086,36854,3575886103,3575886120,17
0,1086,36855,3575886103,3575886121,18
0,1086,36856,3575886103,3575886122,19
0,1086,36857,3575886103,3575886122,19
0,1086,36858,3575886103,3575886123,20
0,1086,36859,3575886103,3575886123,20
0,1086,36860,3575886103,3575886124,21
0,1086,36861,3575886103,3575886124,21
0,1086,36862,3575886103,3575886124,21
0,1086,36863,3575886103,3575886125,22
0,1086,36864,3575886103,3575886125,22
0,1086,36865,3575886103,3575886125,22
0,1086,36866,3575886103,3575886126,23
0,1086,36867,3575886103,3575886126,23
0,1086,36868,3575886103,3575886127,24
0,1086,36869,3575886103,3575886127,24
0,1086,36870,3575886103,3575886127,24
0,1086,36871,3575886103,3575886129,26
0,1086,36872,3575886103,3575886130,27
0,1086,36873,3575886103,3575886130,27
0,1086,36874,3575886103,3575886132,29
0,1086,36875,3575886103,3575886132,29
0,1086,36876,3575886103,3575886133,30
0,1086,36877,3575886103,3575886133,30
0,1086,36878,3575886103,3575886134,31
0,1086,36879,3575886103,3575886135,32
0,1086,36880,3575886103,3575886135,32
0,1086,36881,3575886103,3575886137,34
0,1086,36882,3575886103,3575886138,35
0,1086,36883,3575886103,3575886139,36
0,1086,36884,3575886103,3575886139,36
0,1086,36885,3575886103,3575886139,36
0,1086,36886,3575886103,3575886139,36
0,1086,36887,3575886103,3575886139,36
0,1086,36888,3575886103,3575886140,37
0,1086,36889,3575886103,3575886140,37
0,1086,36890,3575886103,3575886140,37
0,1086,36891,3575886103,3575886141,38
0,1086,36892,3575886103,3575886142,39
0,1086,36893,3575886103,3575886142,39
0,1086,36894,3575886103,3575886143,40
0,1086,36895,3575886103,3575886143,40
0,1086,36896,3575886103,3575886144,41
0,1086,36897,3575886103,3575886145,42
0,1086,36898,3575886103,3575886146,43
0,1086,36899,3575886103,3575886146,43
0,1086,36900,3575886103,3575886146,43
0,1086,36901,3575886103,3575886147,44
0,1086,36902,3575886103,3575886147,44
0,1086,36903,3575886103,3575886147,44
0,1086,36904,3575886103,3575886148,45
0,1086,36905,3575886103,3575886148,45
0,1086,36906,3575886103,3575886152,49
0,1086,36907,3575886103,3575886153,50
0,1087,36908,3575886165,3575886165,0
0,1087,36909,3575886165,3575886165,0
0,1087,36910,3575886165,3575886165,0
0,1087,36911,3575886165,3575886165,0
0,1087,36912,3575886165,3575886165,0
0,1087,36913,3575886165,3575886165,0
0,1087,36914,3575886165,3575886165,0
0,1087,36915,3575886165,3575886165,0
0,1087,36916,3575886165,3575886165,0
0,1087,36917,3575886165,3575886165,0
0,1087,36918,3575886165,3575886165,0
0,1087,36919,3575886165,3575886165,0
0,1087,36920,3575886165,3575886165,0
0,1087,36921,3575886165,3575886165,0
0,1087,36922,3575886165,3575886165,0
0,1087,36923,3575886165,3575886165,0
0,1087,36924,3575886165,3575886165,0
0,1087,36925,3575886165,3575886165,0
0,1087,36926,3575886165,3575886165,0
0,1087,36927,3575886165,3575886165,0
0,1087,36928,3575886165,3575886166,1
0,1087,36929,3575886165,3575886166,1
0,1087,36930,3575886165,3575886166,1
0,1087,36931,3575886165,3575886168,3
0,1087,36932,3575886165,3575886171,6
0,1087,36933,3575886165,3575886171,6
0,1087,36934,3575886165,3575886172,7
0,1087,36935,3575886165,3575886172,7
0,1087,36936,3575886165,3575886173,8
0,1087,36937,3575886165,3575886173,8
0,1087,36938,3575886165,3575886174,9
0,1087,36939,3575886165,3575886175,10
0,1087,36940,3575886165,3575886176,11
0,1087,36941,3575886165,3575886176,11
0,1087,36942,3575886165,3575886176,11
0,1087,36943,3575886165,3575886176,11
0,1087,36944,3575886165,3575886178,13
0,1087,36945,3575886165,3575886179,14
0,1087,36946,3575886165,3575886179,14
0,1087,36947,3575886165,3575886179,14
0,1087,36948,3575886165,3575886180,15
0,1087,36949,3575886165,3575886181,16
0,1087,36950,3575886165,3575886182,17
0,1087,36951,3575886165,3575886182,17
0,1087,36952,3575886165,3575886183,18
0,1087,36953,3575886165,3575886184,19
0,1087,36954,3575886165,3575886184,19
0,1087,36955,3575886165,3575886185,20
0,1087,36956,3575886165,3575886186,21
0,1087,36957,3575886165,3575886186,21
0,1087,36958,3575886165,3575886189,24
0,1087,36959,3575886165,3575886191,26
0,1087,36960,3575886165,3575886194,29
0,1087,36961,3575886165,3575886195,30
0,1087,36962,3575886165,3575886198,33
0,1087,36963,3575886165,3575886200,35
0,1087,36964,3575886165,3575886200,35
0,1087,36965,3575886165,3575886200,35
0,1087,36966,3575886165,3575886201,36
0,1087,36967,3575886165,3575886203,38
0,1087,36968,3575886165,3575886205,40
0,1087,36969,3575886165,3575886205,40
0,1087,36970,3575886165,3575886207,42
0,1087,36971,3575886165,3575886207,42
0,1087,36972,3575886165,3575886207,42
0,1087,36973,3575886165,3575886208,43
0,1087,36974,3575886165,3575886209,44
0,1087,36975,3575886165,3575886212,47
0,1087,36976,3575886165,3575886212,47
0,1087,36977,3575886165,3575886213,48
0,1087,36978,3575886165,3575886213,48
0,1087,36979,3575886165,3575886214,49
0,1087,36980,3575886165,3575886214,49
0,1087,36981,3575886165,3575886215,50
0,1088,36982,3575886230,3575886230,0
0,1088,36983,3575886230,3575886230,0
0,1088,36984,3575886230,3575886230,0
0,1088,36985,3575886230,3575886231,1
0,1088,36986,3575886230,3575886231,1
0,1088,36987,3575886230,3575886231,1
0,1088,36988,3575886230,3575886231,1
0,1088,36989,3575886230,3575886231,1
0,1088,36990,3575886230,3575886231,1
0,1088,36991,3575886230,3575886231,1
0,1088,36992,3575886230,3575886231,1
0,1088,36993,3575886230,3575886231,1
0,1088,36994,3575886230,3575886231,1
0,1088,36995,3575886230,3575886231,1
0,1088,36996,3575886230,3575886231,1
0,1088,36997,3575886230,3575886231,1
0,1088,36998,3575886230,3575886231,1
0,1088,36999,3575886230,3575886231,1
0,1088,37000,3575886230,3575886231,1
0,1088,37001,3575886230,3575886231,1
0,1088,37002,3575886230,3575886231,1
0,1088,37003,3575886230,3575886231,1
0,1088,37004,3575886230,3575886231,1
0,1088,37005,3575886230,3575886232,2
0,1088,37006,3575886230,3575886232,2
0,1088,37007,3575886230,3575886232,2
0,1088,37008,3575886230,3575886232,2
0,1088,37009,3575886230,3575886233,3
0,1088,37010,3575886230,3575886233,3
0,1088,37011,3575886230,3575886233,3
0,1088,37012,3575886230,3575886233,3
0,1088,37013,3575886230,3575886234,4
0,1088,37014,3575886230,3575886234,4
0,1088,37015,3575886230,3575886235,5
0,1088,37016,3575886230,3575886236,6
0,1088,37017,3575886230,3575886240,10
0,1088,37018,3575886230,3575886240,10
0,1088,37019,3575886230,3575886241,11
0,1088,37020,3575886230,3575886242,12
0,1088,37021,3575886230,3575886244,14
0,1088,37022,3575886230,3575886246,16
0,1088,37023,3575886230,3575886247,17
0,1088,37024,3575886230,3575886247,17
0,1088,37025,3575886230,3575886247,17
0,1088,37026,3575886230,3575886248,18
0,1088,37027,3575886230,3575886249,19
0,1088,37028,3575886230,3575886250,20
0,1088,37029,3575886230,3575886251,21
0,1088,37030,3575886230,3575886251,21
0,1088,37031,3575886230,3575886253,23
0,1088,37032,3575886230,3575886255,25
0,1088,37033,3575886230,3575886255,25
0,1088,37034,3575886230,3575886256,26
0,1088,37035,3575886230,3575886256,26
0,1088,37036,3575886230,3575886256,26
0,1088,37037,3575886230,3575886257,27
0,1088,37038,3575886230,3575886258,28
0,1088,37039,3575886230,3575886260,30
0,1088,37040,3575886230,3575886261,31
0,1088,37041,3575886230,3575886261,31
0,1088,37042,3575886230,3575886261,31
0,1088,37043,3575886230,3575886262,32
0,1088,37044,3575886230,3575886262,32
0,1088,37045,3575886230,3575886263,33
0,1088,37046,3575886230,3575886265,35
0,1088,37047,3575886230,3575886265,35
0,1088,37048,3575886230,3575886265,35
0,1088,37049,3575886230,3575886266,36
0,1088,37050,3575886230,3575886266,36
0,1088,37051,3575886230,3575886267,37
0,1088,37052,3575886230,3575886267,37
0,1088,37053,3575886230,3575886267,37
0,1088,37054,3575886230,3575886267,37
0,1088,37055,3575886230,3575886267,37
0,1088,37056,3575886230,3575886269,39
0,1088,37057,3575886230,3575886275,45
0,1088,37058,3575886230,3575886277,47
0,1088,37059,3575886230,3575886278,48
0,1088,37060,3575886230,3575886278,48
0,1089,37061,3575886293,3575886293,0
0,1089,37062,3575886293,3575886293,0
0,1089,37063,3575886293,3575886293,0
0,1089,37064,3575886293,3575886293,0
0,1089,37065,3575886293,3575886293,0
0,1089,37066,3575886293,3575886293,0
0,1089,37067,3575886293,3575886293,0
0,1089,37068,3575886293,3575886293,0
0,1089,37069,3575886293,3575886293,0
0,1089,37070,3575886293,3575886293,0
0,1089,37071,3575886293,3575886293,0
0,1089,37072,3575886293,3575886293,0
0,1089,37073,3575886293,3575886293,0
0,1089,37074,3575886293,3575886293,0
0,1089,37075,3575886293,3575886293,0
0,1089,37076,3575886293,3575886293,0
0,1089,37077,3575886293,3575886293,0
0,1089,37078,3575886293,3575886294,1
0,1089,37079,3575886293,3575886295,2
0,1089,37080,3575886293,3575886296,3
0,1089,37081,3575886293,3575886296,3
0,1089,37082,3575886293,3575886297,4
0,1089,37083,3575886293,3575886297,4
0,1089,37084,3575886293,3575886298,5
0,1089,37085,3575886293,3575886298,5
0,1089,37086,3575886293,3575886299,6
0,1089,37087,3575886293,3575886299,6
0,1089,37088,3575886293,3575886299,6
0,1089,37089,3575886293,3575886301,8
0,1089,37090,3575886293,3575886301,8
0,1089,37091,3575886293,3575886301,8
0,1089,37092,3575886293,3575886303,10
0,1089,37093,3575886293,3575886303,10
0,1089,37094,3575886293,3575886305,12
0,1089,37095,3575886293,3575886305,12
0,1089,37096,3575886293,3575886306,13
0,1089,37097,3575886293,3575886306,13
0,1089,37098,3575886293,3575886306,13
0,1089,37099,3575886293,3575886307,14
0,1089,37100,3575886293,3575886307,14
0,1089,37101,3575886293,3575886309,16
0,1089,37102,3575886293,3575886309,16
0,1089,37103,3575886293,3575886310,17
0,1089,37104,3575886293,3575886311,18
0,1089,37105,3575886293,3575886311,18
0,1089,37106,3575886293,3575886311,18
0,1089,37107,3575886293,3575886311,18
0,1089,37108,3575886293,3575886312,19
0,1089,37109,3575886293,3575886313,20
0,1089,37110,3575886293,3575886315,22
0,1089,37111,3575886293,3575886315,22
0,1089,37112,3575886293,3575886316,23
0,1089,37113,3575886293,3575886316,23
0,1089,37114,3575886293,3575886316,23
0,1089,37115,3575886293,3575886316,23
0,1089,37116,3575886293,3575886320,27
0,1089,37117,3575886293,3575886322,29
0,1089,37118,3575886293,3575886323,30
0,1089,37119,3575886293,3575886324,31
0,1089,37120,3575886293,3575886324,31
0,1089,37121,3575886293,3575886324,31
0,1089,37122,3575886293,3575886325,32
0,1089,37123,3575886293,3575886325,32
0,1089,37124,3575886293,3575886325,32
0,1089,37125,3575886293,3575886326,33
0,1089,37126,3575886293,3575886326,33
0,1089,37127,3575886293,3575886326,33
0,1089,37128,3575886293,3575886326,33
0,1089,37129,3575886293,3575886327,34
0,1089,37130,3575886293,3575886327,34
0,1089,37131,3575886293,3575886328,35
0,1089,37132,3575886293,3575886330,37
0,1089,37133,3575886293,3575886331,38
0,1089,37134,3575886293,3575886333,40
0,1089,37135,3575886293,3575886333,40
0,1089,37136,3575886293,3575886333,40
0,1089,37137,3575886293,3575886335,42
0,1089,37138,3575886293,3575886337,44
0,1089,37139,3575886293,3575886338,45
0,1089,37140,3575886293,3575886338,45
0,1089,37141,3575886293,3575886339,46
0,1089,37142,3575886293,3575886339,46
0,1089,37143,3575886293,3575886339,46
0,1089,37144,3575886293,3575886340,47
0,1089,37145,3575886293,3575886340,47
0,1089,37146,3575886293,3575886340,47
0,1089,37147,3575886293,3575886340,47
0,1089,37148,3575886293,3575886340,47
0,1089,37149,3575886293,3575886341,48
0,1089,37150,3575886293,3575886342,49
0,1089,37151,3575886293,3575886343,50
0,1090,37152,3575886357,3575886357,0
0,1090,37153,3575886357,3575886357,0
0,1090,37154,3575886357,3575886357,0
0,1090,37155,3575886357,3575886357,0
0,1090,37156,3575886357,3575886357,0
0,1090,37157,3575886357,3575886357,0
0,1090,37158,3575886357,3575886357,0
0,1090,37159,3575886357,3575886357,0
0,1090,37160,3575886357,3575886357,0
0,1090,37161,3575886357,3575886357,0
0,1090,37162,3575886357,3575886357,0
0,1090,37163,3575886357,3575886357,0
0,1090,37164,3575886357,3575886357,0
0,1090,37165,3575886357,3575886357,0
0,1090,37166,3575886357,3575886357,0
0,1090,37167,3575886357,3575886357,0
0,1090,37168,3575886357,3575886357,0
0,1090,37169,3575886357,3575886357,0
0,1090,37170,3575886357,3575886357,0
0,1090,37171,3575886357,3575886357,0
0,1090,37172,3575886357,3575886357,0
0,1090,37173,3575886357,3575886357,0
0,1090,37174,3575886357,3575886358,1
0,1090,37175,3575886357,3575886360,3
0,1090,37176,3575886357,3575886360,3
0,1090,37177,3575886357,3575886362,5
0,1090,37178,3575886357,3575886362,5
0,1090,37179,3575886357,3575886363,6
0,1090,37180,3575886357,3575886363,6
0,1090,37181,3575886357,3575886364,7
0,1090,37182,3575886357,3575886364,7
0,1090,37183,3575886357,3575886365,8
0,1090,37184,3575886357,3575886365,8
0,1090,37185,3575886357,3575886365,8
0,1090,37186,3575886357,3575886366,9
0,1090,37187,3575886357,3575886366,9
0,1090,37188,3575886357,3575886366,9
0,1090,37189,3575886357,3575886367,10
0,1090,37190,3575886357,3575886367,10
0,1090,37191,3575886357,3575886371,14
0,1090,37192,3575886357,3575886372,15
0,1090,37193,3575886357,3575886372,15
0,1090,37194,3575886357,3575886372,15
0,1090,37195,3575886357,3575886373,16
0,1090,37196,3575886357,3575886374,17
0,1090,37197,3575886357,3575886376,19
0,1090,37198,3575886357,3575886376,19
0,1090,37199,3575886357,3575886376,19
0,1090,37200,3575886357,3575886376,19
0,1090,37201,3575886357,3575886377,20
0,1090,37202,3575886357,3575886378,21
0,1090,37203,3575886357,3575886378,21
0,1090,37204,3575886357,3575886379,22
0,1090,37205,3575886357,3575886379,22
0,1090,37206,3575886357,3575886379,22
0,1090,37207,3575886357,3575886381,24
0,1090,37208,3575886357,3575886382,25
0,1090,37209,3575886357,3575886383,26
0,1090,37210,3575886357,3575886385,28
0,1090,37211,3575886357,3575886385,28
0,1090,37212,3575886357,3575886386,29
0,1090,37213,3575886357,3575886386,29
0,1090,37214,3575886357,3575886387,30
0,1090,37215,3575886357,3575886390,33
0,1090,37216,3575886357,3575886391,34
0,1090,37217,3575886357,3575886394,37
0,1090,37218,3575886357,3575886394,37
0,1090,37219,3575886357,3575886399,42
0,1090,37220,3575886357,3575886399,42
0,1090,37221,3575886357,3575886400,43
0,1090,37222,3575886357,3575886400,43
0,1090,37223,3575886357,3575886400,43
0,1090,37224,3575886357,3575886401,44
0,1090,37225,3575886357,3575886403,46
0,1090,37226,3575886357,3575886405,48
0,1090,37227,3575886357,3575886406,49
0,1091,37228,3575886420,3575886420,0
0,1091,37229,3575886420,3575886420,0
0,1091,37230,3575886420,3575886420,0
0,1091,37231,3575886420,3575886420,0
0,1091,37232,3575886420,3575886420,0
0,1091,37233,3575886420,3575886420,0
0,1091,37234,3575886420,3575886420,0
0,1091,37235,3575886420,3575886420,0
0,1091,37236,3575886420,3575886420,0
0,1091,37237,3575886420,3575886420,0
0,1091,37238,3575886420,3575886420,0
0,1091,37239,3575886420,3575886420,0
0,1091,37240,3575886420,3575886420,0
0,1091,37241,3575886420,3575886420,0
0,1091,37242,3575886420,3575886420,0
0,1091,37243,3575886420,3575886420,0
0,1091,37244,3575886420,3575886420,0
0,1091,37245,3575886420,3575886421,1
0,1091,37246,3575886420,3575886421,1
0,1091,37247,3575886420,3575886422,2
0,1091,37248,3575886420,3575886423,3
0,1091,37249,3575886420,3575886423,3
0,1091,37250,3575886420,3575886424,4
0,1091,37251,3575886420,3575886427,7
0,1091,37252,3575886420,3575886427,7
0,1091,37253,3575886420,3575886428,8
0,1091,37254,3575886420,3575886428,8
0,1091,37255,3575886420,3575886430,10
0,1091,37256,3575886420,3575886430,10
0,1091,37257,3575886420,3575886431,11
0,1091,37258,3575886420,3575886431,11
0,1091,37259,3575886420,3575886431,11
0,1091,37260,3575886420,3575886431,11
0,1091,37261,3575886420,3575886432,12
0,1091,37262,3575886420,3575886432,12
0,1091,37263,3575886420,3575886432,12
0,1091,37264,3575886420,3575886432,12
0,1091,37265,3575886420,3575886432,12
0,1091,37266,3575886420,3575886433,13
0,1091,37267,3575886420,3575886433,13
0,1091,37268,3575886420,3575886433,13
0,1091,37269,3575886420,3575886434,14
0,1091,37270,3575886420,3575886434,14
0,1091,37271,3575886420,3575886435,15
0,1091,37272,3575886420,3575886436,16
0,1091,37273,3575886420,3575886440,20
0,1091,37274,3575886420,3575886441,21
0,1091,37275,3575886420,3575886441,21
0,1091,37276,3575886420,3575886441,21
0,1091,37277,3575886420,3575886442,22
0,1091,37278,3575886420,3575886444,24
0,1091,37279,3575886420,3575886446,26
0,1091,37280,3575886420,3575886447,27
0,1091,37281,3575886420,3575886447,27
0,1091,37282,3575886420,3575886448,28
0,1091,37283,3575886420,3575886448,28
0,1091,37284,3575886420,3575886450,30
0,1091,37285,3575886420,3575886450,30
0,1091,37286,3575886420,3575886451,31
0,1091,37287,3575886420,3575886451,31
0,1091,37288,3575886420,3575886453,33
0,1091,37289,3575886420,3575886455,35
0,1091,37290,3575886420,3575886455,35
0,1091,37291,3575886420,3575886456,36
0,1091,37292,3575886420,3575886457,37
0,1091,37293,3575886420,3575886459,39
0,1091,37294,3575886420,3575886460,40
0,1091,37295,3575886420,3575886460,40
0,1091,37296,3575886420,3575886460,40
0,1091,37297,3575886420,3575886461,41
0,1091,37298,3575886420,3575886461,41
0,1091,37299,3575886420,3575886461,41
0,1091,37300,3575886420,3575886462,42
0,1091,37301,3575886420,3575886463,43
0,1091,37302,3575886420,3575886463,43
0,1091,37303,3575886420,3575886464,44
0,1091,37304,3575886420,3575886465,45
0,1091,37305,3575886420,3575886465,45
0,1091,37306,3575886420,3575886465,45
0,1091,37307,3575886420,3575886466,46
0,1091,37308,3575886420,3575886467,47
0,1091,37309,3575886420,3575886467,47
0,1091,37310,3575886420,3575886468,48
0,1091,37311,3575886420,3575886469,49
0,1092,37312,3575886483,3575886483,0
0,1092,37313,3575886483,3575886483,0
0,1092,37314,3575886483,3575886483,0
0,1092,37315,3575886483,3575886483,0
0,1092,37316,3575886483,3575886483,0
0,1092,37317,3575886483,3575886483,0
0,1092,37318,3575886483,3575886484,1
0,1092,37319,3575886483,3575886487,4
0,1092,37320,3575886483,3575886487,4
0,1092,37321,3575886483,3575886487,4
0,1092,37322,3575886483,3575886487,4
0,1092,37323,3575886483,3575886487,4
0,1092,37324,3575886483,3575886488,5
0,1092,37325,3575886483,3575886488,5
0,1092,37326,3575886483,3575886488,5
0,1092,37327,3575886483,3575886489,6
0,1092,37328,3575886483,3575886489,6
0,1092,37329,3575886483,3575886490,7
0,1092,37330,3575886483,3575886490,7
0,1092,37331,3575886483,3575886490,7
0,1092,37332,3575886483,3575886491,8
0,1092,37333,3575886483,3575886492,9
0,1092,37334,3575886483,3575886494,11
0,1092,37335,3575886483,3575886494,11
0,1092,37336,3575886483,3575886495,12
0,1092,37337,3575886483,3575886496,13
0,1092,37338,3575886483,3575886496,13
0,1092,37339,3575886483,3575886497,14
0,1092,37340,3575886483,3575886497,14
0,1092,37341,3575886483,3575886498,15
0,1092,37342,3575886483,3575886498,15
0,1092,37343,3575886483,3575886498,15
0,1092,37344,3575886483,3575886498,15
0,1092,37345,3575886483,3575886500,17
0,1092,37346,3575886483,3575886501,18
0,1092,37347,3575886483,3575886501,18
0,1092,37348,3575886483,3575886502,19
0,1092,37349,3575886483,3575886503,20
0,1092,37350,3575886483,3575886504,21
0,1092,37351,3575886483,3575886504,21
0,1092,37352,3575886483,3575886505,22
0,1092,37353,3575886483,3575886505,22
0,1092,37354,3575886483,3575886505,22
0,1092,37355,3575886483,3575886505,22
0,1092,37356,3575886483,3575886506,23
0,1092,37357,3575886483,3575886506,23
0,1092,37358,3575886483,3575886507,24
0,1092,37359,3575886483,3575886509,26
0,1092,37360,3575886483,3575886509,26
0,1092,37361,3575886483,3575886509,26
0,1092,37362,3575886483,3575886510,27
0,1092,37363,3575886483,3575886510,27
0,1092,37364,3575886483,3575886512,29
0,1092,37365,3575886483,3575886512,29
0,1092,37366,3575886483,3575886514,31
0,1092,37367,3575886483,3575886514,31
0,1092,37368,3575886483,3575886515,32
0,1092,37369,3575886483,3575886515,32
0,1092,37370,3575886483,3575886515,32
0,1092,37371,3575886483,3575886518,35
0,1092,37372,3575886483,3575886520,37
0,1092,37373,3575886483,3575886521,38
0,1092,37374,3575886483,3575886522,39
0,1092,37375,3575886483,3575886522,39
0,1092,37376,3575886483,3575886522,39
0,1092,37377,3575886483,3575886523,40
0,1092,37378,3575886483,3575886523,40
0,1092,37379,3575886483,3575886524,41
0,1092,37380,3575886483,3575886524,41
0,1092,37381,3575886483,3575886525,42
0,1092,37382,3575886483,3575886525,42
0,1092,37383,3575886483,3575886525,42
0,1092,37384,3575886483,3575886526,43
0,1092,37385,3575886483,3575886527,44
0,1092,37386,3575886483,3575886528,45
0,1092,37387,3575886483,3575886529,46
0,1092,37388,3575886483,3575886529,46
0,1092,37389,3575886483,3575886531,48
0,1092,37390,3575886483,3575886532,49
0,1092,37391,3575886483,3575886532,49
0,1092,37392,3575886483,3575886533,50
0,1093,37393,3575886546,3575886546,0
0,1093,37394,3575886546,3575886546,0
0,1093,37395,3575886546,3575886546,0
0,1093,37396,3575886546,3575886546,0
0,1093,37397,3575886546,3575886546,0
0,1093,37398,3575886546,3575886546,0
0,1093,37399,3575886546,3575886546,0
0,1093,37400,3575886546,3575886546,0
0,1093,37401,3575886546,3575886546,0
0,1093,37402,3575886546,3575886546,0
0,1093,37403,3575886546,3575886546,0
0,1093,37404,3575886546,3575886546,0
0,1093,37405,3575886546,3575886546,0
0,1093,37406,3575886546,3575886546,0
0,1093,37407,3575886546,3575886546,0
0,1093,37408,3575886546,3575886546,0
0,1093,37409,3575886546,3575886546,0
0,1093,37410,3575886546,3575886546,0
0,1093,37411,3575886546,3575886546,0
0,1093,37412,3575886546,3575886546,0
0,1093,37413,3575886546,3575886546,0
0,1093,37414,3575886546,3575886546,0
0,1093,37415,3575886546,3575886546,0
0,1093,37416,3575886546,3575886547,1
0,1093,37417,3575886546,3575886547,1
0,1093,37418,3575886546,3575886549,3
0,1093,37419,3575886546,3575886549,3
0,1093,37420,3575886546,3575886551,5
0,1093,37421,3575886546,3575886552,6
0,1093,37422,3575886546,3575886553,7
0,1093,37423,3575886546,3575886554,8
0,1093,37424,3575886546,3575886554,8
0,1093,37425,3575886546,3575886554,8
0,1093,37426,3575886546,3575886555,9
0,1093,37427,3575886546,3575886556,10
0,1093,37428,3575886546,3575886556,10
0,1093,37429,3575886546,3575886561,15
0,1093,37430,3575886546,3575886561,15
0,1093,37431,3575886546,3575886561,15
0,1093,37432,3575886546,3575886562,16
0,1093,37433,3575886546,3575886563,17
0,1093,37434,3575886546,3575886563,17
0,1093,37435,3575886546,3575886563,17
0,1093,37436,3575886546,3575886564,18
0,1093,37437,3575886546,3575886564,18
0,1093,37438,3575886546,3575886565,19
0,1093,37439,3575886546,3575886566,20
0,1093,37440,3575886546,3575886567,21
0,1093,37441,3575886546,3575886570,24
0,1093,37442,3575886546,3575886571,25
0,1093,37443,3575886546,3575886571,25
0,1093,37444,3575886546,3575886571,25
0,1093,37445,3575886546,3575886571,25
0,1093,37446,3575886546,3575886575,29
0,1093,37447,3575886546,3575886575,29
0,1093,37448,3575886546,3575886575,29
0,1093,37449,3575886546,3575886575,29
0,1093,37450,3575886546,3575886576,30
0,1093,37451,3575886546,3575886576,30
0,1093,37452,3575886546,3575886577,31
0,1093,37453,3575886546,3575886577,31
0,1093,37454,3575886546,3575886578,32
0,1093,37455,3575886546,3575886578,32
0,1093,37456,3575886546,3575886578,32
0,1093,37457,3575886546,3575886579,33
0,1093,37458,3575886546,3575886581,35
0,1093,37459,3575886546,3575886581,35
0,1093,37460,3575886546,3575886581,35
0,1093,37461,3575886546,3575886583,37
0,1093,37462,3575886546,3575886584,38
0,1093,37463,3575886546,3575886586,40
0,1093,37464,3575886546,3575886586,40
0,1093,37465,3575886546,3575886589,43
0,1093,37466,3575886546,3575886591,45
0,1093,37467,3575886546,3575886593,47
0,1093,37468,3575886546,3575886594,48
0,1094,37469,3575886608,3575886608,0
0,1094,37470,3575886608,3575886608,0
0,1094,37471,3575886608,3575886608,0
0,1094,37472,3575886608,3575886608,0
0,1094,37473,3575886608,3575886608,0
0,1094,37474,3575886608,3575886608,0
0,1094,37475,3575886608,3575886608,0
0,1094,37476,3575886608,3575886608,0
0,1094,37477,3575886608,3575886608,0
0,1094,37478,3575886608,3575886608,0
0,1094,37479,3575886608,3575886608,0
0,1094,37480,3575886608,3575886608,0
0,1094,37481,3575886608,3575886608,0
0,1094,37482,3575886608,3575886611,3
0,1094,37483,3575886608,3575886612,4
0,1094,37484,3575886608,3575886612,4
0,1094,37485,3575886608,3575886613,5
0,1094,37486,3575886608,3575886614,6
0,1094,37487,3575886608,3575886614,6
0,1094,37488,3575886608,3575886614,6
0,1094,37489,3575886608,3575886615,7
0,1094,37490,3575886608,3575886615,7
0,1094,37491,3575886608,3575886616,8
0,1094,37492,3575886608,3575886616,8
0,1094,37493,3575886608,3575886617,9
0,1094,37494,3575886608,3575886618,10
0,1094,37495,3575886608,3575886619,11
0,1094,37496,3575886608,3575886620,12
0,1094,37497,3575886608,3575886620,12
0,1094,37498,3575886608,3575886621,13
0,1094,37499,3575886608,3575886622,14
0,1094,37500,3575886608,3575886623,15
0,1094,37501,3575886608,3575886623,15
0,1094,37502,3575886608,3575886626,18
0,1094,37503,3575886608,3575886626,18
0,1094,37504,3575886608,3575886629,21
0,1094,37505,3575886608,3575886629,21
0,1094,37506,3575886608,3575886629,21
0,1094,37507,3575886608,3575886630,22
0,1094,37508,3575886608,3575886630,22
0,1094,37509,3575886608,3575886630,22
0,1094,37510,3575886608,3575886631,23
0,1094,37511,3575886608,3575886631,23
0,1094,37512,3575886608,3575886631,23
0,1094,37513,3575886608,3575886631,23
0,1094,37514,3575886608,3575886631,23
0,1094,37515,3575886608,3575886632,24
0,1094,37516,3575886608,3575886632,24
0,1094,37517,3575886608,3575886633,25
0,1094,37518,3575886608,3575886633,25
0,1094,37519,3575886608,3575886633,25
0,1094,37520,3575886608,3575886635,27
0,1094,37521,3575886608,3575886639,31
0,1094,37522,3575886608,3575886640,32
0,1094,37523,3575886608,3575886640,32
0,1094,37524,3575886608,3575886640,32
0,1094,37525,3575886608,3575886641,33
0,1094,37526,3575886608,3575886641,33
0,1094,37527,3575886608,3575886645,37
0,1094,37528,3575886608,3575886646,38
0,1094,37529,3575886608,3575886646,38
0,1094,37530,3575886608,3575886646,38
0,1094,37531,3575886608,3575886647,39
0,1094,37532,3575886608,3575886648,40
0,1094,37533,3575886608,3575886649,41
0,1094,37534,3575886608,3575886650,42
0,1094,37535,3575886608,3575886653,45
0,1094,37536,3575886608,3575886654,46
0,1094,37537,3575886608,3575886654,46
0,1094,37538,3575886608,3575886655,47
0,1094,37539,3575886608,3575886655,47
0,1094,37540,3575886608,3575886655,47
0,1094,37541,3575886608,3575886658,50
0,1095,37542,3575886672,3575886672,0
0,1095,37543,3575886672,3575886672,0
0,1095,37544,3575886672,3575886672,0
0,1095,37545,3575886672,3575886672,0
0,1095,37546,3575886672,3575886672,0
0,1095,37547,3575886672,3575886672,0
0,1095,37548,3575886672,3575886672,0
0,1095,37549,3575886672,3575886672,0
0,1095,37550,3575886672,3575886672,0
0,1095,37551,3575886672,3575886672,0
0,1095,37552,3575886672,3575886672,0
0,1095,37553,3575886672,3575886672,0
0,1095,37554,3575886672,3575886672,0
0,1095,37555,3575886672,3575886672,0
0,1095,37556,3575886672,3575886672,0
0,1095,37557,3575886672,3575886672,0
0,1095,37558,3575886672,3575886672,0
0,1095,37559,3575886672,3575886672,0
0,1095,37560,3575886672,3575886672,0
0,1095,37561,3575886672,3575886672,0
0,1095,37562,3575886672,3575886676,4
0,1095,37563,3575886672,3575886676,4
0,1095,37564,3575886672,3575886677,5
0,1095,37565,3575886672,3575886679,7
0,1095,37566,3575886672,3575886680,8
0,1095,37567,3575886672,3575886680,8
0,1095,37568,3575886672,3575886685,13
0,1095,37569,3575886672,3575886686,14
0,1095,37570,3575886672,3575886687,15
0,1095,37571,3575886672,3575886687,15
0,1095,37572,3575886672,3575886687,15
0,1095,37573,3575886672,3575886687,15
0,1095,37574,3575886672,3575886688,16
0,1095,37575,3575886672,3575886688,16
0,1095,37576,3575886672,3575886688,16
0,1095,37577,3575886672,3575886688,16
0,1095,37578,3575886672,3575886688,16
0,1095,37579,3575886672,3575886690,18
0,1095,37580,3575886672,3575886690,18
0,1095,37581,3575886672,3575886690,18
0,1095,37582,3575886672,3575886690,18
0,1095,37583,3575886672,3575886692,20
0,1095,37584,3575886672,3575886693,21
0,1095,37585,3575886672,3575886693,21
0,1095,37586,3575886672,3575886693,21
0,1095,37587,3575886672,3575886695,23
0,1095,37588,3575886672,3575886695,23
0,1095,37589,3575886672,3575886696,24
0,1095,37590,3575886672,3575886696,24
0,1095,37591,3575886672,3575886697,25
0,1095,37592,3575886672,3575886697,25
0,1095,37593,3575886672,3575886697,25
0,1095,37594,3575886672,3575886697,25
0,1095,37595,3575886672,3575886698,26
0,1095,37596,3575886672,3575886698,26
0,1095,37597,3575886672,3575886701,29
0,1095,37598,3575886672,3575886701,29
0,1095,37599,3575886672,3575886702,30
0,1095,37600,3575886672,3575886702,30
0,1095,37601,3575886672,3575886703,31
0,1095,37602,3575886672,3575886704,32
0,1095,37603,3575886672,3575886704,32
0,1095,37604,3575886672,3575886705,33
0,1095,37605,3575886672,3575886705,33
0,1095,37606,3575886672,3575886705,33
0,1095,37607,3575886672,3575886706,34
0,1095,37608,3575886672,3575886706,34
0,1095,37609,3575886672,3575886707,35
0,1095,37610,3575886672,3575886709,37
0,1095,37611,3575886672,3575886709,37
0,1095,37612,3575886672,3575886710,38
0,1095,37613,3575886672,3575886710,38
0,1095,37614,3575886672,3575886710,38
0,1095,37615,3575886672,3575886713,41
0,1095,37616,3575886672,3575886713,41
0,1095,37617,3575886672,3575886714,42
0,1095,37618,3575886672,3575886714,42
0,1095,37619,3575886672,3575886715,43
0,1095,37620,3575886672,3575886715,43
0,1095,37621,3575886672,3575886718,46
0,1095,37622,3575886672,3575886720,48
0,1095,37623,3575886672,3575886721,49
0,1095,37624,3575886672,3575886721,49
0,1095,37625,3575886672,3575886722,50
0,1095,37626,3575886672,3575886722,50
0,1096,37627,3575886735,3575886735,0
0,1096,37628,3575886735,3575886735,0
0,1096,37629,3575886735,3575886735,0
0,1096,37630,3575886735,3575886735,0
0,1096,37631,3575886735,3575886735,0
0,1096,37632,3575886735,3575886735,0
0,1096,37633,3575886735,3575886735,0
0,1096,37634,3575886735,3575886735,0
0,1096,37635,3575886735,3575886735,0
0,1096,37636,3575886735,3575886735,0
0,1096,37637,3575886735,3575886735,0
0,1096,37638,3575886735,3575886735,0
0,1096,37639,3575886735,3575886735,0
0,1096,37640,3575886735,3575886735,0
0,1096,37641,3575886735,3575886735,0
0,1096,37642,3575886735,3575886735,0
0,1096,37643,3575886735,3575886735,0
0,1096,37644,3575886735,3575886735,0
0,1096,37645,3575886735,3575886735,0
0,1096,37646,3575886735,3575886735,0
0,1096,37647,3575886735,3575886735,0
0,1096,37648,3575886735,3575886735,0
0,1096,37649,3575886735,3575886736,1
0,1096,37650,3575886735,3575886738,3
0,1096,37651,3575886735,3575886738,3
0,1096,37652,3575886735,3575886738,3
0,1096,37653,3575886735,3575886739,4
0,1096,37654,3575886735,3575886739,4
0,1096,37655,3575886735,3575886739,4
0,1096,37656,3575886735,3575886739,4
0,1096,37657,3575886735,3575886740,5
0,1096,37658,3575886735,3575886740,5
0,1096,37659,3575886735,3575886742,7
0,1096,37660,3575886735,3575886742,7
0,1096,37661,3575886735,3575886742,7
0,1096,37662,3575886735,3575886744,9
0,1096,37663,3575886735,3575886744,9
0,1096,37664,3575886735,3575886745,10
0,1096,37665,3575886735,3575886745,10
0,1096,37666,3575886735,3575886746,11
0,1096,37667,3575886735,3575886746,11
0,1096,37668,3575886735,3575886746,11
0,1096,37669,3575886735,3575886747,12
0,1096,37670,3575886735,3575886747,12
0,1096,37671,3575886735,3575886748,13
0,1096,37672,3575886735,3575886749,14
0,1096,37673,3575886735,3575886750,15
0,1096,37674,3575886735,3575886752,17
0,1096,37675,3575886735,3575886753,18
0,1096,37676,3575886735,3575886753,18
0,1096,37677,3575886735,3575886753,18
0,1096,37678,3575886735,3575886754,19
0,1096,37679,3575886735,3575886754,19
0,1096,37680,3575886735,3575886755,20
0,1096,37681,3575886735,3575886755,20
0,1096,37682,3575886735,3575886755,20
0,1096,37683,3575886735,3575886758,23
0,1096,37684,3575886735,3575886761,26
0,1096,37685,3575886735,3575886761,26
0,1096,37686,3575886735,3575886761,26
0,1096,37687,3575886735,3575886762,27
0,1096,37688,3575886735,3575886762,27
0,1096,37689,3575886735,3575886763,28
0,1096,37690,3575886735,3575886764,29
0,1096,37691,3575886735,3575886764,29
0,1096,37692,3575886735,3575886765,30
0,1096,37693,3575886735,3575886765,30
0,1096,37694,3575886735,3575886765,30
0,1096,37695,3575886735,3575886766,31
0,1096,37696,3575886735,3575886767,32
0,1096,37697,3575886735,3575886770,35
0,1096,37698,3575886735,3575886771,36
0,1096,37699,3575886735,3575886771,36
0,1096,37700,3575886735,3575886772,37
0,1096,37701,3575886735,3575886772,37
0,1096,37702,3575886735,3575886775,40
0,1096,37703,3575886735,3575886775,40
0,1096,37704,3575886735,3575886775,40
0,1096,37705,3575886735,3575886775,40
0,1096,37706,3575886735,3575886775,40
0,1096,37707,3575886735,3575886776,41
0,1096,37708,3575886735,3575886777,42
0,1096,37709,3575886735,3575886777,42
0,1096,37710,3575886735,3575886778,43
0,1096,37711,3575886735,3575886778,43
0,1096,37712,3575886735,3575886778,43
0,1096,37713,3575886735,3575886780,45
0,1096,37714,3575886735,3575886781,46
0,1096,37715,3575886735,3575886781,46
0,1096,37716,3575886735,3575886782,47
0,1096,37717,3575886735,3575886783,48
0,1096,37718,3575886735,3575886784,49
0,1096,37719,3575886735,3575886785,50
0,1097,37720,3575886800,3575886800,0
0,1097,37721,3575886800,3575886800,0
0,1097,37722,3575886800,3575886800,0
0,1097,37723,3575886800,3575886800,0
0,1097,37724,3575886800,3575886800,0
0,1097,37725,3575886800,3575886800,0
0,1097,37726,3575886800,3575886800,0
0,1097,37727,3575886800,3575886800,0
0,1097,37728,3575886800,3575886800,0
0,1097,37729,3575886800,3575886800,0
0,1097,37730,3575886800,3575886800,0
0,1097,37731,3575886800,3575886800,0
0,1097,37732,3575886800,3575886800,0
0,1097,37733,3575886800,3575886801,1
0,1097,37734,3575886800,3575886801,1
0,1097,37735,3575886800,3575886802,2
0,1097,37736,3575886800,3575886804,4
0,1097,37737,3575886800,3575886805,5
0,1097,37738,3575886800,3575886805,5
0,1097,37739,3575886800,3575886806,6
0,1097,37740,3575886800,3575886807,7
0,1097,37741,3575886800,3575886808,8
0,1097,37742,3575886800,3575886808,8
0,1097,37743,3575886800,3575886809,9
0,1097,37744,3575886800,3575886812,12
0,1097,37745,3575886800,3575886813,13
0,1097,37746,3575886800,3575886813,13
0,1097,37747,3575886800,3575886813,13
0,1097,37748,3575886800,3575886814,14
0,1097,37749,3575886800,3575886814,14
0,1097,37750,3575886800,3575886816,16
0,1097,37751,3575886800,3575886816,16
0,1097,37752,3575886800,3575886816,16
0,1097,37753,3575886800,3575886818,18
0,1097,37754,3575886800,3575886818,18
0,1097,37755,3575886800,3575886819,19
0,1097,37756,3575886800,3575886820,20
0,1097,37757,3575886800,3575886821,21
0,1097,37758,3575886800,3575886822,22
0,1097,37759,3575886800,3575886822,22
0,1097,37760,3575886800,3575886823,23
0,1097,37761,3575886800,3575886826,26
0,1097,37762,3575886800,3575886827,27
0,1097,37763,3575886800,3575886829,29
0,1097,37764,3575886800,3575886829,29
0,1097,37765,3575886800,3575886829,29
0,1097,37766,3575886800,3575886830,30
0,1097,37767,3575886800,3575886830,30
0,1097,37768,3575886800,3575886830,30
0,1097,37769,3575886800,3575886830,30
0,1097,37770,3575886800,3575886830,30
0,1097,37771,3575886800,3575886831,31
0,1097,37772,3575886800,3575886831,31
0,1097,37773,3575886800,3575886832,32
0,1097,37774,3575886800,3575886832,32
0,1097,37775,3575886800,3575886832,32
0,1097,37776,3575886800,3575886833,33
0,1097,37777,3575886800,3575886833,33
0,1097,37778,3575886800,3575886833,33
0,1097,37779,3575886800,3575886834,34
0,1097,37780,3575886800,3575886834,34
0,1097,37781,3575886800,3575886836,36
0,1097,37782,3575886800,3575886839,39
0,1097,37783,3575886800,3575886840,40
0,1097,37784,3575886800,3575886840,40
0,1097,37785,3575886800,3575886840,40
0,1097,37786,3575886800,3575886841,41
0,1097,37787,3575886800,3575886842,42
0,1097,37788,3575886800,3575886846,46
0,1097,37789,3575886800,3575886846,46
0,1097,37790,3575886800,3575886846,46
0,1097,37791,3575886800,3575886846,46
0,1097,37792,3575886800,3575886846,46
0,1097,37793,3575886800,3575886847,47
0,1097,37794,3575886800,3575886848,48
0,1097,37795,3575886800,3575886850,50
0,1098,37796,3575886863,3575886863,0
0,1098,37797,3575886863,3575886863,0
0,1098,37798,3575886863,3575886863,0
0,1098,37799,3575886863,3575886863,0
0,1098,37800,3575886863,3575886863,0
0,1098,37801,3575886863,3575886863,0
0,1098,37802,3575886863,3575886863,0
0,1098,37803,3575886863,3575886863,0
0,1098,37804,3575886863,3575886863,0
0,1098,37805,3575886863,3575886863,0
0,1098,37806,3575886863,3575886863,0
0,1098,37807,3575886863,3575886863,0
0,1098,37808,3575886863,3575886863,0
0,1098,37809,3575886863,3575886863,0
0,1098,37810,3575886863,3575886863,0
0,1098,37811,3575886863,3575886863,0
0,1098,37812,3575886863,3575886864,1
0,1098,37813,3575886863,3575886864,1
0,1098,37814,3575886863,3575886865,2
0,1098,37815,3575886863,3575886866,3
0,1098,37816,3575886863,3575886866,3
0,1098,37817,3575886863,3575886866,3
0,1098,37818,3575886863,3575886866,3
0,1098,37819,3575886863,3575886866,3
0,1098,37820,3575886863,3575886866,3
0,1098,37821,3575886863,3575886868,5
0,1098,37822,3575886863,3575886876,13
0,1098,37823,3575886863,3575886876,13
0,1098,37824,3575886863,3575886877,14
0,1098,37825,3575886863,3575886879,16
0,1098,37826,3575886863,3575886880,17
0,1098,37827,3575886863,3575886880,17
0,1098,37828,3575886863,3575886884,21
0,1098,37829,3575886863,3575886886,23
0,1098,37830,3575886863,3575886887,24
0,1098,37831,3575886863,3575886887,24
0,1098,37832,3575886863,3575886887,24
0,1098,37833,3575886863,3575886888,25
0,1098,37834,3575886863,3575886888,25
0,1098,37835,3575886863,3575886888,25
0,1098,37836,3575886863,3575886888,25
0,1098,37837,3575886863,3575886888,25
0,1098,37838,3575886863,3575886889,26
0,1098,37839,3575886863,3575886891,28
0,1098,37840,3575886863,3575886891,28
0,1098,37841,3575886863,3575886892,29
0,1098,37842,3575886863,3575886893,30
0,1098,37843,3575886863,3575886893,30
0,1098,37844,3575886863,3575886893,30
0,1098,37845,3575886863,3575886895,32
0,1098,37846,3575886863,3575886895,32
0,1098,37847,3575886863,3575886896,33
0,1098,37848,3575886863,3575886897,34
0,1098,37849,3575886863,3575886897,34
0,1098,37850,3575886863,3575886897,34
0,1098,37851,3575886863,3575886898,35
0,1098,37852,3575886863,3575886898,35
0,1098,37853,3575886863,3575886898,35
0,1098,37854,3575886863,3575886900,37
0,1098,37855,3575886863,3575886900,37
0,1098,37856,3575886863,3575886901,38
0,1098,37857,3575886863,3575886902,39
0,1098,37858,3575886863,3575886902,39
0,1098,37859,3575886863,3575886903,40
0,1098,37860,3575886863,3575886904,41
0,1098,37861,3575886863,3575886905,42
0,1098,37862,3575886863,3575886905,42
0,1098,37863,3575886863,3575886905,42
0,1098,37864,3575886863,3575886905,42
0,1098,37865,3575886863,3575886905,42
0,1098,37866,3575886863,3575886906,43
0,1098,37867,3575886863,3575886907,44
0,1098,37868,3575886863,3575886907,44
0,1098,37869,3575886863,3575886909,46
0,1098,37870,3575886863,3575886909,46
0,1098,37871,3575886863,3575886910,47
0,1098,37872,3575886863,3575886910,47
0,1098,37873,3575886863,3575886910,47
0,1098,37874,3575886863,3575886910,47
0,1098,37875,3575886863,3575886911,48
0,1098,37876,3575886863,3575886912,49
0,1098,37877,3575886863,3575886913,50
0,1099,37878,3575886929,3575886929,0
0,1099,37879,3575886929,3575886929,0
0,1099,37880,3575886929,3575886929,0
0,1099,37881,3575886929,3575886929,0
0,1099,37882,3575886929,3575886929,0
0,1099,37883,3575886929,3575886929,0
0,1099,37884,3575886929,3575886929,0
0,1099,37885,3575886929,3575886929,0
0,1099,37886,3575886929,3575886929,0
0,1099,37887,3575886929,3575886929,0
0,1099,37888,3575886929,3575886929,0
0,1099,37889,3575886929,3575886929,0
0,1099,37890,3575886929,3575886929,0
0,1099,37891,3575886929,3575886929,0
0,1099,37892,3575886929,3575886929,0
0,1099,37893,3575886929,3575886929,0
0,1099,37894,3575886929,3575886929,0
0,1099,37895,3575886929,3575886929,0
0,1099,37896,3575886929,3575886929,0
0,1099,37897,3575886929,3575886929,0
0,1099,37898,3575886929,3575886929,0
0,1099,37899,3575886929,3575886929,0
0,1099,37900,3575886929,3575886929,0
0,1099,37901,3575886929,3575886929,0
0,1099,37902,3575886929,3575886929,0
0,1099,37903,3575886929,3575886929,0
0,1099,37904,3575886929,3575886930,1
0,1099,37905,3575886929,3575886931,2
0,1099,37906,3575886929,3575886932,3
0,1099,37907,3575886929,3575886932,3
0,1099,37908,3575886929,3575886932,3
0,1099,37909,3575886929,3575886934,5
0,1099,37910,3575886929,3575886934,5
0,1099,37911,3575886929,3575886935,6
0,1099,37912,3575886929,3575886936,7
0,1099,37913,3575886929,3575886937,8
0,1099,37914,3575886929,3575886938,9
0,1099,37915,3575886929,3575886938,9
0,1099,37916,3575886929,3575886938,9
0,1099,37917,3575886929,3575886938,9
0,1099,37918,3575886929,3575886939,10
0,1099,37919,3575886929,3575886939,10
0,1099,37920,3575886929,3575886940,11
0,1099,37921,3575886929,3575886940,11
0,1099,37922,3575886929,3575886940,11
0,1099,37923,3575886929,3575886942,13
0,1099,37924,3575886929,3575886943,14
0,1099,37925,3575886929,3575886944,15
0,1099,37926,3575886929,3575886945,16
0,1099,37927,3575886929,3575886945,16
0,1099,37928,3575886929,3575886945,16
0,1099,37929,3575886929,3575886945,16
0,1099,37930,3575886929,3575886946,17
0,1099,37931,3575886929,3575886946,17
0,1099,37932,3575886929,3575886947,18
0,1099,37933,3575886929,3575886949,20
0,1099,37934,3575886929,3575886951,22
0,1099,37935,3575886929,3575886952,23
0,1099,37936,3575886929,3575886952,23
0,1099,37937,3575886929,3575886953,24
0,1099,37938,3575886929,3575886953,24
0,1099,37939,3575886929,3575886953,24
0,1099,37940,3575886929,3575886954,25
0,1099,37941,3575886929,3575886954,25
0,1099,37942,3575886929,3575886955,26
0,1099,37943,3575886929,3575886956,27
0,1099,37944,3575886929,3575886957,28
0,1099,37945,3575886929,3575886958,29
0,1099,37946,3575886929,3575886959,30
0,1099,37947,3575886929,3575886961,32
0,1099,37948,3575886929,3575886961,32
0,1099,37949,3575886929,3575886961,32
0,1099,37950,3575886929,3575886963,34
0,1099,37951,3575886929,3575886963,34
0,1099,37952,3575886929,3575886963,34
0,1099,37953,3575886929,3575886964,35
0,1099,37954,3575886929,3575886965,36
0,1099,37955,3575886929,3575886965,36
0,1099,37956,3575886929,3575886966,37
0,1099,37957,3575886929,3575886966,37
0,1099,37958,3575886929,3575886966,37
0,1099,37959,3575886929,3575886967,38
0,1099,37960,3575886929,3575886967,38
0,1099,37961,3575886929,3575886970,41
0,1099,37962,3575886929,3575886971,42
0,1099,37963,3575886929,3575886971,42
0,1099,37964,3575886929,3575886972,43
0,1099,37965,3575886929,3575886972,43
0,1099,37966,3575886929,3575886972,43
0,1099,37967,3575886929,3575886974,45
0,1099,37968,3575886929,3575886974,45
0,1099,37969,3575886929,3575886975,46
0,1099,37970,3575886929,3575886976,47
0,1099,37971,3575886929,3575886976,47
0,1099,37972,3575886929,3575886976,47
0,1099,37973,3575886929,3575886977,48
0,1099,37974,3575886929,3575886977,48
0,1099,37975,3575886929,3575886978,49
0,1099,37976,3575886929,3575886978,49
0,1099,37977,3575886929,3575886978,49
0,1100,37978,3575886991,3575886991,0
0,1100,37979,3575886991,3575886991,0
0,1100,37980,3575886991,3575886991,0
0,1100,37981,3575886991,3575886991,0
0,1100,37982,3575886991,3575886991,0
0,1100,37983,3575886991,3575886991,0
0,1100,37984,3575886991,3575886991,0
0,1100,37985,3575886991,3575886991,0
0,1100,37986,3575886991,3575886991,0
0,1100,37987,3575886991,3575886991,0
0,1100,37988,3575886991,3575886991,0
0,1100,37989,3575886991,3575886991,0
0,1100,37990,3575886991,3575886991,0
0,1100,37991,3575886991,3575886991,0
0,1100,37992,3575886991,3575886994,3
0,1100,37993,3575886991,3575886994,3
0,1100,37994,3575886991,3575886998,7
0,1100,37995,3575886991,3575886999,8
0,1100,37996,3575886991,3575887000,9
0,1100,37997,3575886991,3575887000,9
0,1100,37998,3575886991,3575887001,10
0,1100,37999,3575886991,3575887002,11
0,1100,38000,3575886991,3575887002,11
0,1100,38001,3575886991,3575887003,12
0,1100,38002,3575886991,3575887005,14
0,1100,38003,3575886991,3575887005,14
0,1100,38004,3575886991,3575887006,15
0,1100,38005,3575886991,3575887008,17
0,1100,38006,3575886991,3575887008,17
0,1100,38007,3575886991,3575887008,17
0,1100,38008,3575886991,3575887009,18
0,1100,38009,3575886991,3575887012,21
0,1100,38010,3575886991,3575887013,22
0,1100,38011,3575886991,3575887013,22
0,1100,38012,3575886991,3575887014,23
0,1100,38013,3575886991,3575887014,23
0,1100,38014,3575886991,3575887015,24
0,1100,38015,3575886991,3575887015,24
0,1100,38016,3575886991,3575887016,25
0,1100,38017,3575886991,3575887016,25
0,1100,38018,3575886991,3575887018,27
0,1100,38019,3575886991,3575887020,29
0,1100,38020,3575886991,3575887022,31
0,1100,38021,3575886991,3575887027,36
0,1100,38022,3575886991,3575887027,36
0,1100,38023,3575886991,3575887027,36
0,1100,38024,3575886991,3575887027,36
0,1100,38025,3575886991,3575887027,36
0,1100,38026,3575886991,3575887027,36
0,1100,38027,3575886991,3575887028,37
0,1100,38028,3575886991,3575887029,38
0,1100,38029,3575886991,3575887029,38
0,1100,38030,3575886991,3575887030,39
0,1100,38031,3575886991,3575887030,39
0,1100,38032,3575886991,3575887030,39
0,1100,38033,3575886991,3575887031,40
0,1100,38034,3575886991,3575887031,40
0,1100,38035,3575886991,3575887031,40
0,1100,38036,3575886991,3575887031,40
0,1100,38037,3575886991,3575887032,41
0,1100,38038,3575886991,3575887032,41
0,1100,38039,3575886991,3575887032,41
0,1100,38040,3575886991,3575887032,41
0,1100,38041,3575886991,3575887033,42
0,1100,38042,3575886991,3575887033,42
0,1100,38043,3575886991,3575887033,42
0,1100,38044,3575886991,3575887034,43
0,1100,38045,3575886991,3575887035,44
0,1100,38046,3575886991,3575887035,44
0,1100,38047,3575886991,3575887036,45
0,1100,38048,3575886991,3575887040,49
0,1100,38049,3575886991,3575887040,49
0,1100,38050,3575886991,3575887040,49
0,1100,38051,3575886991,3575887041,50
0,1101,38052,3575887056,3575887056,0
0,1101,38053,3575887056,3575887056,0
0,1101,38054,3575887056,3575887056,0
0,1101,38055,3575887056,3575887056,0
0,1101,38056,3575887056,3575887056,0
0,1101,38057,3575887056,3575887056,0
0,1101,38058,3575887056,3575887056,0
0,1101,38059,3575887056,3575887056,0
0,1101,38060,3575887056,3575887056,0
0,1101,38061,3575887056,3575887056,0
0,1101,38062,3575887056,3575887056,0
0,1101,38063,3575887056,3575887056,0
0,1101,38064,3575887056,3575887056,0
0,1101,38065,3575887056,3575887056,0
0,1101,38066,3575887056,3575887056,0
0,1101,38067,3575887056,3575887056,0
0,1101,38068,3575887056,3575887057,1
0,1101,38069,3575887056,3575887058,2
0,1101,38070,3575887056,3575887058,2
0,1101,38071,3575887056,3575887059,3
0,1101,38072,3575887056,3575887059,3
0,1101,38073,3575887056,3575887060,4
0,1101,38074,3575887056,3575887061,5
0,1101,38075,3575887056,3575887061,5
0,1101,38076,3575887056,3575887061,5
0,1101,38077,3575887056,3575887062,6
0,1101,38078,3575887056,3575887063,7
0,1101,38079,3575887056,3575887064,8
0,1101,38080,3575887056,3575887064,8
0,1101,38081,3575887056,3575887065,9
0,1101,38082,3575887056,3575887066,10
0,1101,38083,3575887056,3575887066,10
0,1101,38084,3575887056,3575887066,10
0,1101,38085,3575887056,3575887066,10
0,1101,38086,3575887056,3575887067,11
0,1101,38087,3575887056,3575887067,11
0,1101,38088,3575887056,3575887068,12
0,1101,38089,3575887056,3575887068,12
0,1101,38090,3575887056,3575887076,20
0,1101,38091,3575887056,3575887077,21
0,1101,38092,3575887056,3575887078,22
0,1101,38093,3575887056,3575887080,24
0,1101,38094,3575887056,3575887081,25
0,1101,38095,3575887056,3575887085,29
0,1101,38096,3575887056,3575887086,30
0,1101,38097,3575887056,3575887086,30
0,1101,38098,3575887056,3575887087,31
0,1101,38099,3575887056,3575887087,31
0,1101,38100,3575887056,3575887087,31
0,1101,38101,3575887056,3575887087,31
0,1101,38102,3575887056,3575887088,32
0,1101,38103,3575887056,3575887088,32
0,1101,38104,3575887056,3575887088,32
0,1101,38105,3575887056,3575887088,32
0,1101,38106,3575887056,3575887089,33
0,1101,38107,3575887056,3575887089,33
0,1101,38108,3575887056,3575887090,34
0,1101,38109,3575887056,3575887091,35
0,1101,38110,3575887056,3575887091,35
0,1101,38111,3575887056,3575887092,36
0,1101,38112,3575887056,3575887093,37
0,1101,38113,3575887056,3575887093,37
0,1101,38114,3575887056,3575887094,38
0,1101,38115,3575887056,3575887095,39
0,1101,38116,3575887056,3575887095,39
0,1101,38117,3575887056,3575887098,42
0,1101,38118,3575887056,3575887098,42
0,1101,38119,3575887056,3575887098,42
0,1101,38120,3575887056,3575887098,42
0,1101,38121,3575887056,3575887098,42
0,1101,38122,3575887056,3575887098,42
0,1101,38123,3575887056,3575887100,44
0,1101,38124,3575887056,3575887100,44
0,1101,38125,3575887056,3575887101,45
0,1101,38126,3575887056,3575887101,45
0,1101,38127,3575887056,3575887102,46
0,1101,38128,3575887056,3575887103,47
0,1101,38129,3575887056,3575887104,48
0,1101,38130,3575887056,3575887104,48
0,1101,38131,3575887056,3575887105,49
0,1101,38132,3575887056,3575887105,49
0,1101,38133,3575887056,3575887106,50
0,1101,38134,3575887056,3575887106,50
0,1102,38135,3575887120,3575887120,0
0,1102,38136,3575887120,3575887120,0
0,1102,38137,3575887120,3575887120,0
0,1102,38138,3575887120,3575887120,0
0,1102,38139,3575887120,3575887120,0
0,1102,38140,3575887120,3575887120,0
0,1102,38141,3575887120,3575887120,0
0,1102,38142,3575887120,3575887120,0
0,1102,38143,3575887120,3575887120,0
0,1102,38144,3575887120,3575887120,0
0,1102,38145,3575887120,3575887120,0
0,1102,38146,3575887120,3575887120,0
0,1102,38147,3575887120,3575887120,0
0,1102,38148,3575887120,3575887120,0
0,1102,38149,3575887120,3575887120,0
0,1102,38150,3575887120,3575887120,0
0,1102,38151,3575887120,3575887120,0
0,1102,38152,3575887120,3575887120,0
0,1102,38153,3575887120,3575887120,0
0,1102,38154,3575887120,3575887120,0
0,1102,38155,3575887120,3575887120,0
0,1102,38156,3575887120,3575887121,1
0,1102,38157,3575887120,3575887121,1
0,1102,38158,3575887120,3575887122,2
0,1102,38159,3575887120,3575887123,3
0,1102,38160,3575887120,3575887123,3
0,1102,38161,3575887120,3575887124,4
0,1102,38162,3575887120,3575887124,4
0,1102,38163,3575887120,3575887124,4
0,1102,38164,3575887120,3575887124,4
0,1102,38165,3575887120,3575887125,5
0,1102,38166,3575887120,3575887125,5
0,1102,38167,3575887120,3575887125,5
0,1102,38168,3575887120,3575887126,6
0,1102,38169,3575887120,3575887127,7
0,1102,38170,3575887120,3575887127,7
0,1102,38171,3575887120,3575887127,7
0,1102,38172,3575887120,3575887128,8
0,1102,38173,3575887120,3575887129,9
0,1102,38174,3575887120,3575887130,10
0,1102,38175,3575887120,3575887131,11
0,1102,38176,3575887120,3575887132,12
0,1102,38177,3575887120,3575887133,13
0,1102,38178,3575887120,3575887133,13
0,1102,38179,3575887120,3575887134,14
0,1102,38180,3575887120,3575887134,14
0,1102,38181,3575887120,3575887135,15
0,1102,38182,3575887120,3575887136,16
0,1102,38183,3575887120,3575887138,18
0,1102,38184,3575887120,3575887138,18
0,1102,38185,3575887120,3575887138,18
0,1102,38186,3575887120,3575887139,19
0,1102,38187,3575887120,3575887139,19
0,1102,38188,3575887120,3575887139,19
0,1102,38189,3575887120,3575887139,19
0,1102,38190,3575887120,3575887139,19
0,1102,38191,3575887120,3575887140,20
0,1102,38192,3575887120,3575887140,20
0,1102,38193,3575887120,3575887140,20
0,1102,38194,3575887120,3575887142,22
0,1102,38195,3575887120,3575887143,23
0,1102,38196,3575887120,3575887144,24
0,1102,38197,3575887120,3575887144,24
0,1102,38198,3575887120,3575887145,25
0,1102,38199,3575887120,3575887145,25
0,1102,38200,3575887120,3575887145,25
0,1102,38201,3575887120,3575887146,26
0,1102,38202,3575887120,3575887146,26
0,1102,38203,3575887120,3575887146,26
0,1102,38204,3575887120,3575887147,27
0,1102,38205,3575887120,3575887147,27
0,1102,38206,3575887120,3575887150,30
0,1102,38207,3575887120,3575887152,32
0,1102,38208,3575887120,3575887153,33
0,1102,38209,3575887120,3575887153,33
0,1102,38210,3575887120,3575887153,33
0,1102,38211,3575887120,3575887153,33
0,1102,38212,3575887120,3575887155,35
0,1102,38213,3575887120,3575887155,35
0,1102,38214,3575887120,3575887155,35
0,1102,38215,3575887120,3575887156,36
0,1102,38216,3575887120,3575887156,36
0,1102,38217,3575887120,3575887158,38
0,1102,38218,3575887120,3575887159,39
0,1102,38219,3575887120,3575887161,41
0,1102,38220,3575887120,3575887161,41
0,1102,38221,3575887120,3575887161,41
0,1102,38222,3575887120,3575887162,42
0,1102,38223,3575887120,3575887163,43
0,1102,38224,3575887120,3575887164,44
0,1102,38225,3575887120,3575887164,44
0,1102,38226,3575887120,3575887164,44
0,1102,38227,3575887120,3575887165,45
0,1102,38228,3575887120,3575887166,46
0,1102,38229,3575887120,3575887166,46
0,1102,38230,3575887120,3575887167,47
0,1102,38231,3575887120,3575887167,47
0,1102,38232,3575887120,3575887167,47
0,1103,38233,3575887184,3575887184,0
0,1103,38234,3575887184,3575887184,0
0,1103,38235,3575887184,3575887184,0
0,1103,38236,3575887184,3575887184,0
0,1103,38237,3575887184,3575887184,0
0,1103,38238,3575887184,3575887184,0
0,1103,38239,3575887184,3575887184,0
0,1103,38240,3575887184,3575887184,0
0,1103,38241,3575887184,3575887184,0
0,1103,38242,3575887184,3575887184,0
0,1103,38243,3575887184,3575887184,0
0,1103,38244,3575887184,3575887184,0
0,1103,38245,3575887184,3575887184,0
0,1103,38246,3575887184,3575887184,0
0,1103,38247,3575887184,3575887184,0
0,1103,38248,3575887184,3575887184,0
0,1103,38249,3575887184,3575887184,0
0,1103,38250,3575887184,3575887184,0
0,1103,38251,3575887184,3575887184,0
0,1103,38252,3575887184,3575887184,0
0,1103,38253,3575887184,3575887184,0
0,1103,38254,3575887184,3575887184,0
0,1103,38255,3575887184,3575887186,2
0,1103,38256,3575887184,3575887186,2
0,1103,38257,3575887184,3575887186,2
0,1103,38258,3575887184,3575887187,3
0,1103,38259,3575887184,3575887190,6
0,1103,38260,3575887184,3575887190,6
0,1103,38261,3575887184,3575887194,10
0,1103,38262,3575887184,3575887194,10
0,1103,38263,3575887184,3575887197,13
0,1103,38264,3575887184,3575887200,16
0,1103,38265,3575887184,3575887200,16
0,1103,38266,3575887184,3575887200,16
0,1103,38267,3575887184,3575887201,17
0,1103,38268,3575887184,3575887202,18
0,1103,38269,3575887184,3575887202,18
0,1103,38270,3575887184,3575887205,21
0,1103,38271,3575887184,3575887205,21
0,1103,38272,3575887184,3575887206,22
0,1103,38273,3575887184,3575887206,22
0,1103,38274,3575887184,3575887208,24
0,1103,38275,3575887184,3575887208,24
0,1103,38276,3575887184,3575887210,26
0,1103,38277,3575887184,3575887212,28
0,1103,38278,3575887184,3575887213,29
0,1103,38279,3575887184,3575887214,30
0,1103,38280,3575887184,3575887214,30
0,1103,38281,3575887184,3575887214,30
0,1103,38282,3575887184,3575887215,31
0,1103,38283,3575887184,3575887215,31
0,1103,38284,3575887184,3575887216,32
0,1103,38285,3575887184,3575887216,32
0,1103,38286,3575887184,3575887219,35
0,1103,38287,3575887184,3575887221,37
0,1103,38288,3575887184,3575887221,37
0,1103,38289,3575887184,3575887221,37
0,1103,38290,3575887184,3575887221,37
0,1103,38291,3575887184,3575887222,38
0,1103,38292,3575887184,3575887222,38
0,1103,38293,3575887184,3575887223,39
0,1103,38294,3575887184,3575887226,42
0,1103,38295,3575887184,3575887226,42
0,1103,38296,3575887184,3575887229,45
0,1103,38297,3575887184,3575887230,46
0,1103,38298,3575887184,3575887230,46
0,1103,38299,3575887184,3575887230,46
0,1103,38300,3575887184,3575887231,47
0,1103,38301,3575887184,3575887231,47
0,1103,38302,3575887184,3575887231,47
0,1103,38303,3575887184,3575887231,47
0,1103,38304,3575887184,3575887232,48
0,1103,38305,3575887184,3575887232,48
0,1103,38306,3575887184,3575887232,48
0,1103,38307,3575887184,3575887232,48
0,1103,38308,3575887184,3575887233,49
0,1103,38309,3575887184,3575887233,49
0,1103,38310,3575887184,3575887233,49
0,1103,38311,3575887184,3575887233,49
0,1103,38312,3575887184,3575887234,50
0,1104,38313,3575887248,3575887248,0
0,1104,38314,3575887248,3575887248,0
0,1104,38315,3575887248,3575887248,0
0,1104,38316,3575887248,3575887248,0
0,1104,38317,3575887248,3575887248,0
0,1104,38318,3575887248,3575887248,0
0,1104,38319,3575887248,3575887248,0
0,1104,38320,3575887248,3575887248,0
0,1104,38321,3575887248,3575887248,0
0,1104,38322,3575887248,3575887248,0
0,1104,38323,3575887248,3575887248,0
0,1104,38324,3575887248,3575887248,0
0,1104,38325,3575887248,3575887248,0
0,1104,38326,3575887248,3575887248,0
0,1104,38327,3575887248,3575887250,2
0,1104,38328,3575887248,3575887250,2
0,1104,38329,3575887248,3575887252,4
0,1104,38330,3575887248,3575887255,7
0,1104,38331,3575887248,3575887255,7
0,1104,38332,3575887248,3575887256,8
0,1104,38333,3575887248,3575887256,8
0,1104,38334,3575887248,3575887256,8
0,1104,38335,3575887248,3575887256,8
0,1104,38336,3575887248,3575887258,10
0,1104,38337,3575887248,3575887259,11
0,1104,38338,3575887248,3575887259,11
0,1104,38339,3575887248,3575887260,12
0,1104,38340,3575887248,3575887260,12
0,1104,38341,3575887248,3575887260,12
0,1104,38342,3575887248,3575887261,13
0,1104,38343,3575887248,3575887261,13
0,1104,38344,3575887248,3575887262,14
0,1104,38345,3575887248,3575887263,15
0,1104,38346,3575887248,3575887263,15
0,1104,38347,3575887248,3575887264,16
0,1104,38348,3575887248,3575887265,17
0,1104,38349,3575887248,3575887266,18
0,1104,38350,3575887248,3575887266,18
0,1104,38351,3575887248,3575887266,18
0,1104,38352,3575887248,3575887266,18
0,1104,38353,3575887248,3575887267,19
0,1104,38354,3575887248,3575887267,19
0,1104,38355,3575887248,3575887267,19
0,1104,38356,3575887248,3575887268,20
0,1104,38357,3575887248,3575887268,20
0,1104,38358,3575887248,3575887276,28
0,1104,38359,3575887248,3575887278,30
0,1104,38360,3575887248,3575887278,30
0,1104,38361,3575887248,3575887280,32
0,1104,38362,3575887248,3575887280,32
0,1104,38363,3575887248,3575887285,37
0,1104,38364,3575887248,3575887285,37
0,1104,38365,3575887248,3575887286,38
0,1104,38366,3575887248,3575887287,39
0,1104,38367,3575887248,3575887287,39
0,1104,38368,3575887248,3575887287,39
0,1104,38369,3575887248,3575887288,40
0,1104,38370,3575887248,3575887288,40
0,1104,38371,3575887248,3575887288,40
0,1104,38372,3575887248,3575887288,40
0,1104,38373,3575887248,3575887289,41
0,1104,38374,3575887248,3575887289,41
0,1104,38375,3575887248,3575887290,42
0,1104,38376,3575887248,3575887290,42
0,1104,38377,3575887248,3575887291,43
0,1104,38378,3575887248,3575887292,44
0,1104,38379,3575887248,3575887293,45
0,1104,38380,3575887248,3575887293,45
0,1104,38381,3575887248,3575887294,46
0,1104,38382,3575887248,3575887295,47
0,1104,38383,3575887248,3575887296,48
0,1104,38384,3575887248,3575887297,49
0,1104,38385,3575887248,3575887297,49
0,1104,38386,3575887248,3575887297,49
0,1104,38387,3575887248,3575887297,49
0,1104,38388,3575887248,3575887298,50
0,1105,38389,3575887310,3575887310,0
0,1105,38390,3575887310,3575887310,0
0,1105,38391,3575887310,3575887310,0
0,1105,38392,3575887310,3575887310,0
0,1105,38393,3575887310,3575887310,0
0,1105,38394,3575887310,3575887310,0
0,1105,38395,3575887310,3575887310,0
0,1105,38396,3575887310,3575887310,0
0,1105,38397,3575887310,3575887310,0
0,1105,38398,3575887310,3575887310,0
0,1105,38399,3575887310,3575887310,0
0,1105,38400,3575887310,3575887310,0
0,1105,38401,3575887310,3575887310,0
0,1105,38402,3575887310,3575887310,0
0,1105,38403,3575887310,3575887310,0
0,1105,38404,3575887310,3575887310,0
0,1105,38405,3575887310,3575887310,0
0,1105,38406,3575887310,3575887310,0
0,1105,38407,3575887310,3575887311,1
0,1105,38408,3575887310,3575887311,1
0,1105,38409,3575887310,3575887311,1
0,1105,38410,3575887310,3575887312,2
0,1105,38411,3575887310,3575887312,2
0,1105,38412,3575887310,3575887312,2
0,1105,38413,3575887310,3575887313,3
0,1105,38414,3575887310,3575887314,4
0,1105,38415,3575887310,3575887315,5
0,1105,38416,3575887310,3575887315,5
0,1105,38417,3575887310,3575887315,5
0,1105,38418,3575887310,3575887315,5
0,1105,38419,3575887310,3575887316,6
0,1105,38420,3575887310,3575887316,6
0,1105,38421,3575887310,3575887318,8
0,1105,38422,3575887310,3575887319,9
0,1105,38423,3575887310,3575887320,10
0,1105,38424,3575887310,3575887320,10
0,1105,38425,3575887310,3575887322,12
0,1105,38426,3575887310,3575887322,12
0,1105,38427,3575887310,3575887323,13
0,1105,38428,3575887310,3575887323,13
0,1105,38429,3575887310,3575887323,13
0,1105,38430,3575887310,3575887323,13
0,1105,38431,3575887310,3575887324,14
0,1105,38432,3575887310,3575887325,15
0,1105,38433,3575887310,3575887325,15
0,1105,38434,3575887310,3575887325,15
0,1105,38435,3575887310,3575887326,16
0,1105,38436,3575887310,3575887326,16
0,1105,38437,3575887310,3575887327,17
0,1105,38438,3575887310,3575887327,17
0,1105,38439,3575887310,3575887328,18
0,1105,38440,3575887310,3575887329,19
0,1105,38441,3575887310,3575887330,20
0,1105,38442,3575887310,3575887331,21
0,1105,38443,3575887310,3575887332,22
0,1105,38444,3575887310,3575887333,23
0,1105,38445,3575887310,3575887333,23
0,1105,38446,3575887310,3575887334,24
0,1105,38447,3575887310,3575887335,25
0,1105,38448,3575887310,3575887335,25
0,1105,38449,3575887310,3575887336,26
0,1105,38450,3575887310,3575887338,28
0,1105,38451,3575887310,3575887339,29
0,1105,38452,3575887310,3575887339,29
0,1105,38453,3575887310,3575887339,29
0,1105,38454,3575887310,3575887339,29
0,1105,38455,3575887310,3575887339,29
0,1105,38456,3575887310,3575887339,29
0,1105,38457,3575887310,3575887339,29
0,1105,38458,3575887310,3575887340,30
0,1105,38459,3575887310,3575887340,30
0,1105,38460,3575887310,3575887342,32
0,1105,38461,3575887310,3575887342,32
0,1105,38462,3575887310,3575887344,34
0,1105,38463,3575887310,3575887345,35
0,1105,38464,3575887310,3575887345,35
0,1105,38465,3575887310,3575887345,35
0,1105,38466,3575887310,3575887345,35
0,1105,38467,3575887310,3575887346,36
0,1105,38468,3575887310,3575887346,36
0,1105,38469,3575887310,3575887347,37
0,1105,38470,3575887310,3575887348,38
0,1105,38471,3575887310,3575887348,38
0,1105,38472,3575887310,3575887349,39
0,1105,38473,3575887310,3575887350,40
0,1105,38474,3575887310,3575887352,42
0,1105,38475,3575887310,3575887353,43
0,1105,38476,3575887310,3575887354,44
0,1105,38477,3575887310,3575887354,44
0,1105,38478,3575887310,3575887354,44
0,1105,38479,3575887310,3575887354,44
0,1105,38480,3575887310,3575887355,45
0,1105,38481,3575887310,3575887356,46
0,1105,38482,3575887310,3575887356,46
0,1105,38483,3575887310,3575887356,46
0,1105,38484,3575887310,3575887357,47
0,1105,38485,3575887310,3575887359,49
0,1105,38486,3575887310,3575887359,49
0,1106,38487,3575887374,3575887374,0
0,1106,38488,3575887374,3575887374,0
0,1106,38489,3575887374,3575887374,0
0,1106,38490,3575887374,3575887374,0
0,1106,38491,3575887374,3575887374,0
0,1106,38492,3575887374,3575887374,0
0,1106,38493,3575887374,3575887374,0
0,1106,38494,3575887374,3575887374,0
0,1106,38495,3575887374,3575887374,0
0,1106,38496,3575887374,3575887374,0
0,1106,38497,3575887374,3575887374,0
0,1106,38498,3575887374,3575887374,0
0,1106,38499,3575887374,3575887374,0
0,1106,38500,3575887374,3575887374,0
0,1106,38501,3575887374,3575887374,0
0,1106,38502,3575887374,3575887374,0
0,1106,38503,3575887374,3575887374,0
0,1106,38504,3575887374,3575887374,0
0,1106,38505,3575887374,3575887374,0
0,1106,38506,3575887374,3575887374,0
0,1106,38507,3575887374,3575887374,0
0,1106,38508,3575887374,3575887375,1
0,1106,38509,3575887374,3575887376,2
0,1106,38510,3575887374,3575887377,3
0,1106,38511,3575887374,3575887377,3
0,1106,38512,3575887374,3575887377,3
0,1106,38513,3575887374,3575887378,4
0,1106,38514,3575887374,3575887379,5
0,1106,38515,3575887374,3575887379,5
0,1106,38516,3575887374,3575887379,5
0,1106,38517,3575887374,3575887381,7
0,1106,38518,3575887374,3575887381,7
0,1106,38519,3575887374,3575887382,8
0,1106,38520,3575887374,3575887384,10
0,1106,38521,3575887374,3575887384,10
0,1106,38522,3575887374,3575887386,12
0,1106,38523,3575887374,3575887386,12
0,1106,38524,3575887374,3575887387,13
0,1106,38525,3575887374,3575887387,13
0,1106,38526,3575887374,3575887391,17
0,1106,38527,3575887374,3575887391,17
0,1106,38528,3575887374,3575887393,19
0,1106,38529,3575887374,3575887394,20
0,1106,38530,3575887374,3575887399,25
0,1106,38531,3575887374,3575887399,25
0,1106,38532,3575887374,3575887400,26
0,1106,38533,3575887374,3575887400,26
0,1106,38534,3575887374,3575887402,28
0,1106,38535,3575887374,3575887402,28
0,1106,38536,3575887374,3575887404,30
0,1106,38537,3575887374,3575887404,30
0,1106,38538,3575887374,3575887405,31
0,1106,38539,3575887374,3575887405,31
0,1106,38540,3575887374,3575887406,32
0,1106,38541,3575887374,3575887407,33
0,1106,38542,3575887374,3575887408,34
0,1106,38543,3575887374,3575887408,34
0,1106,38544,3575887374,3575887409,35
0,1106,38545,3575887374,3575887411,37
0,1106,38546,3575887374,3575887412,38
0,1106,38547,3575887374,3575887413,39
0,1106,38548,3575887374,3575887413,39
0,1106,38549,3575887374,3575887414,40
0,1106,38550,3575887374,3575887414,40
0,1106,38551,3575887374,3575887415,41
0,1106,38552,3575887374,3575887415,41
0,1106,38553,3575887374,3575887415,41
0,1106,38554,3575887374,3575887416,42
0,1106,38555,3575887374,3575887416,42
0,1106,38556,3575887374,3575887418,44
0,1106,38557,3575887374,3575887419,45
0,1106,38558,3575887374,3575887421,47
0,1106,38559,3575887374,3575887421,47
0,1106,38560,3575887374,3575887421,47
0,1106,38561,3575887374,3575887421,47
0,1106,38562,3575887374,3575887422,48
0,1106,38563,3575887374,3575887423,49
0,1106,38564,3575887374,3575887423,49
0,1106,38565,3575887374,3575887423,49
0,1107,38566,3575887437,3575887437,0
0,1107,38567,3575887437,3575887437,0
0,1107,38568,3575887437,3575887437,0
0,1107,38569,3575887437,3575887437,0
0,1107,38570,3575887437,3575887437,0
0,1107,38571,3575887437,3575887437,0
0,1107,38572,3575887437,3575887437,0
0,1107,38573,3575887437,3575887437,0
0,1107,38574,3575887437,3575887437,0
0,1107,38575,3575887437,3575887437,0
0,1107,38576,3575887437,3575887437,0
0,1107,38577,3575887437,3575887437,0
0,1107,38578,3575887437,3575887437,0
0,1107,38579,3575887437,3575887437,0
0,1107,38580,3575887437,3575887437,0
0,1107,38581,3575887437,3575887437,0
0,1107,38582,3575887437,3575887437,0
0,1107,38583,3575887437,3575887437,0
0,1107,38584,3575887437,3575887437,0
0,1107,38585,3575887437,3575887437,0
0,1107,38586,3575887437,3575887440,3
0,1107,38587,3575887437,3575887440,3
0,1107,38588,3575887437,3575887440,3
0,1107,38589,3575887437,3575887441,4
0,1107,38590,3575887437,3575887441,4
0,1107,38591,3575887437,3575887442,5
0,1107,38592,3575887437,3575887444,7
0,1107,38593,3575887437,3575887445,8
0,1107,38594,3575887437,3575887446,9
0,1107,38595,3575887437,3575887446,9
0,1107,38596,3575887437,3575887447,10
0,1107,38597,3575887437,3575887448,11
0,1107,38598,3575887437,3575887448,11
0,1107,38599,3575887437,3575887450,13
0,1107,38600,3575887437,3575887450,13
0,1107,38601,3575887437,3575887452,15
0,1107,38602,3575887437,3575887455,18
0,1107,38603,3575887437,3575887455,18
0,1107,38604,3575887437,3575887456,19
0,1107,38605,3575887437,3575887456,19
0,1107,38606,3575887437,3575887456,19
0,1107,38607,3575887437,3575887457,20
0,1107,38608,3575887437,3575887458,21
0,1107,38609,3575887437,3575887459,22
0,1107,38610,3575887437,3575887460,23
0,1107,38611,3575887437,3575887460,23
0,1107,38612,3575887437,3575887461,24
0,1107,38613,3575887437,3575887461,24
0,1107,38614,3575887437,3575887461,24
0,1107,38615,3575887437,3575887462,25
0,1107,38616,3575887437,3575887463,26
0,1107,38617,3575887437,3575887463,26
0,1107,38618,3575887437,3575887465,28
0,1107,38619,3575887437,3575887465,28
0,1107,38620,3575887437,3575887465,28
0,1107,38621,3575887437,3575887466,29
0,1107,38622,3575887437,3575887466,29
0,1107,38623,3575887437,3575887466,29
0,1107,38624,3575887437,3575887467,30
0,1107,38625,3575887437,3575887467,30
0,1107,38626,3575887437,3575887468,31
0,1107,38627,3575887437,3575887468,31
0,1107,38628,3575887437,3575887469,32
0,1107,38629,3575887437,3575887476,39
0,1107,38630,3575887437,3575887477,40
0,1107,38631,3575887437,3575887478,41
0,1107,38632,3575887437,3575887480,43
0,1107,38633,3575887437,3575887486,49
0,1107,38634,3575887437,3575887486,49
0,1108,38635,3575887503,3575887503,0
0,1108,38636,3575887503,3575887503,0
0,1108,38637,3575887503,3575887503,0
0,1108,38638,3575887503,3575887503,0
0,1108,38639,3575887503,3575887503,0
0,1108,38640,3575887503,3575887503,0
0,1108,38641,3575887503,3575887503,0
0,1108,38642,3575887503,3575887503,0
0,1108,38643,3575887503,3575887503,0
0,1108,38644,3575887503,3575887503,0
0,1108,38645,3575887503,3575887503,0
0,1108,38646,3575887503,3575887503,0
0,1108,38647,3575887503,3575887503,0
0,1108,38648,3575887503,3575887503,0
0,1108,38649,3575887503,3575887503,0
0,1108,38650,3575887503,3575887503,0
0,1108,38651,3575887503,3575887503,0
0,1108,38652,3575887503,3575887503,0
0,1108,38653,3575887503,3575887503,0
0,1108,38654,3575887503,3575887503,0
0,1108,38655,3575887503,3575887503,0
0,1108,38656,3575887503,3575887503,0
0,1108,38657,3575887503,3575887503,0
0,1108,38658,3575887503,3575887503,0
0,1108,38659,3575887503,3575887503,0
0,1108,38660,3575887503,3575887503,0
0,1108,38661,3575887503,3575887503,0
0,1108,38662,3575887503,3575887503,0
0,1108,38663,3575887503,3575887504,1
0,1108,38664,3575887503,3575887504,1
0,1108,38665,3575887503,3575887505,2
0,1108,38666,3575887503,3575887505,2
0,1108,38667,3575887503,3575887505,2
0,1108,38668,3575887503,3575887506,3
0,1108,38669,3575887503,3575887506,3
0,1108,38670,3575887503,3575887506,3
0,1108,38671,3575887503,3575887509,6
0,1108,38672,3575887503,3575887509,6
0,1108,38673,3575887503,3575887509,6
0,1108,38674,3575887503,3575887509,6
0,1108,38675,3575887503,3575887510,7
0,1108,38676,3575887503,3575887510,7
0,1108,38677,3575887503,3575887512,9
0,1108,38678,3575887503,3575887512,9
0,1108,38679,3575887503,3575887513,10
0,1108,38680,3575887503,3575887513,10
0,1108,38681,3575887503,3575887514,11
0,1108,38682,3575887503,3575887514,11
0,1108,38683,3575887503,3575887515,12
0,1108,38684,3575887503,3575887515,12
0,1108,38685,3575887503,3575887515,12
0,1108,38686,3575887503,3575887517,14
0,1108,38687,3575887503,3575887518,15
0,1108,38688,3575887503,3575887519,16
0,1108,38689,3575887503,3575887520,17
0,1108,38690,3575887503,3575887520,17
0,1108,38691,3575887503,3575887521,18
0,1108,38692,3575887503,3575887521,18
0,1108,38693,3575887503,3575887522,19
0,1108,38694,3575887503,3575887523,20
0,1108,38695,3575887503,3575887523,20
0,1108,38696,3575887503,3575887523,20
0,1108,38697,3575887503,3575887523,20
0,1108,38698,3575887503,3575887524,21
0,1108,38699,3575887503,3575887525,22
0,1108,38700,3575887503,3575887525,22
0,1108,38701,3575887503,3575887525,22
0,1108,38702,3575887503,3575887526,23
0,1108,38703,3575887503,3575887526,23
0,1108,38704,3575887503,3575887526,23
0,1108,38705,3575887503,3575887527,24
0,1108,38706,3575887503,3575887527,24
0,1108,38707,3575887503,3575887528,25
0,1108,38708,3575887503,3575887529,26
0,1108,38709,3575887503,3575887530,27
0,1108,38710,3575887503,3575887530,27
0,1108,38711,3575887503,3575887531,28
0,1108,38712,3575887503,3575887532,29
0,1108,38713,3575887503,3575887533,30
0,1108,38714,3575887503,3575887533,30
0,1108,38715,3575887503,3575887533,30
0,1108,38716,3575887503,3575887535,32
0,1108,38717,3575887503,3575887536,33
0,1108,38718,3575887503,3575887537,34
0,1108,38719,3575887503,3575887538,35
0,1108,38720,3575887503,3575887538,35
0,1108,38721,3575887503,3575887538,35
0,1108,38722,3575887503,3575887538,35
0,1108,38723,3575887503,3575887539,36
0,1108,38724,3575887503,3575887539,36
0,1108,38725,3575887503,3575887539,36
0,1108,38726,3575887503,3575887539,36
0,1108,38727,3575887503,3575887540,37
0,1108,38728,3575887503,3575887541,38
0,1108,38729,3575887503,3575887541,38
0,1108,38730,3575887503,3575887542,39
0,1108,38731,3575887503,3575887543,40
0,1108,38732,3575887503,3575887544,41
0,1108,38733,3575887503,3575887544,41
0,1108,38734,3575887503,3575887545,42
0,1108,38735,3575887503,3575887545,42
0,1108,38736,3575887503,3575887546,43
0,1108,38737,3575887503,3575887546,43
0,1108,38738,3575887503,3575887547,44
0,1108,38739,3575887503,3575887548,45
0,1108,38740,3575887503,3575887548,45
0,1108,38741,3575887503,3575887549,46
0,1108,38742,3575887503,3575887551,48
0,1108,38743,3575887503,3575887552,49
0,1109,38744,3575887566,3575887566,0
0,1109,38745,3575887566,3575887566,0
0,1109,38746,3575887566,3575887566,0
0,1109,38747,3575887566,3575887566,0
0,1109,38748,3575887566,3575887566,0
0,1109,38749,3575887566,3575887566,0
0,1109,38750,3575887566,3575887566,0
0,1109,38751,3575887566,3575887566,0
0,1109,38752,3575887566,3575887566,0
0,1109,38753,3575887566,3575887566,0
0,1109,38754,3575887566,3575887566,0
0,1109,38755,3575887566,3575887566,0
0,1109,38756,3575887566,3575887566,0
0,1109,38757,3575887566,3575887566,0
0,1109,38758,3575887566,3575887566,0
0,1109,38759,3575887566,3575887566,0
0,1109,38760,3575887566,3575887566,0
0,1109,38761,3575887566,3575887566,0
0,1109,38762,3575887566,3575887566,0
0,1109,38763,3575887566,3575887566,0
0,1109,38764,3575887566,3575887566,0
0,1109,38765,3575887566,3575887566,0
0,1109,38766,3575887566,3575887566,0
0,1109,38767,3575887566,3575887567,1
0,1109,38768,3575887566,3575887570,4
0,1109,38769,3575887566,3575887571,5
0,1109,38770,3575887566,3575887572,6
0,1109,38771,3575887566,3575887574,8
0,1109,38772,3575887566,3575887574,8
0,1109,38773,3575887566,3575887575,9
0,1109,38774,3575887566,3575887575,9
0,1109,38775,3575887566,3575887576,10
0,1109,38776,3575887566,3575887576,10
0,1109,38777,3575887566,3575887576,10
0,1109,38778,3575887566,3575887577,11
0,1109,38779,3575887566,3575887577,11
0,1109,38780,3575887566,3575887578,12
0,1109,38781,3575887566,3575887579,13
0,1109,38782,3575887566,3575887580,14
0,1109,38783,3575887566,3575887581,15
0,1109,38784,3575887566,3575887581,15
0,1109,38785,3575887566,3575887583,17
0,1109,38786,3575887566,3575887584,18
0,1109,38787,3575887566,3575887584,18
0,1109,38788,3575887566,3575887585,19
0,1109,38789,3575887566,3575887586,20
0,1109,38790,3575887566,3575887586,20
0,1109,38791,3575887566,3575887586,20
0,1109,38792,3575887566,3575887589,23
0,1109,38793,3575887566,3575887590,24
0,1109,38794,3575887566,3575887592,26
0,1109,38795,3575887566,3575887593,27
0,1109,38796,3575887566,3575887598,32
0,1109,38797,3575887566,3575887598,32
0,1109,38798,3575887566,3575887599,33
0,1109,38799,3575887566,3575887600,34
0,1109,38800,3575887566,3575887601,35
0,1109,38801,3575887566,3575887601,35
0,1109,38802,3575887566,3575887603,37
0,1109,38803,3575887566,3575887604,38
0,1109,38804,3575887566,3575887605,39
0,1109,38805,3575887566,3575887605,39
0,1109,38806,3575887566,3575887606,40
0,1109,38807,3575887566,3575887607,41
0,1109,38808,3575887566,3575887607,41
0,1109,38809,3575887566,3575887609,43
0,1109,38810,3575887566,3575887610,44
0,1109,38811,3575887566,3575887611,45
0,1109,38812,3575887566,3575887612,46
0,1109,38813,3575887566,3575887613,47
0,1109,38814,3575887566,3575887613,47
0,1109,38815,3575887566,3575887614,48
0,1109,38816,3575887566,3575887614,48
0,1109,38817,3575887566,3575887614,48
0,1109,38818,3575887566,3575887615,49
0,1109,38819,3575887566,3575887615,49
0,1109,38820,3575887566,3575887616,50
0,1110,38821,3575887631,3575887631,0
0,1110,38822,3575887631,3575887631,0
0,1110,38823,3575887631,3575887631,0
0,1110,38824,3575887631,3575887631,0
0,1110,38825,3575887631,3575887631,0
0,1110,38826,3575887631,3575887631,0
0,1110,38827,3575887631,3575887631,0
0,1110,38828,3575887631,3575887631,0
0,1110,38829,3575887631,3575887631,0
0,1110,38830,3575887631,3575887631,0
0,1110,38831,3575887631,3575887631,0
0,1110,38832,3575887631,3575887631,0
0,1110,38833,3575887631,3575887631,0
0,1110,38834,3575887631,3575887631,0
0,1110,38835,3575887631,3575887631,0
0,1110,38836,3575887631,3575887631,0
0,1110,38837,3575887631,3575887631,0
0,1110,38838,3575887631,3575887631,0
0,1110,38839,3575887631,3575887631,0
0,1110,38840,3575887631,3575887631,0
0,1110,38841,3575887631,3575887631,0
0,1110,38842,3575887631,3575887631,0
0,1110,38843,3575887631,3575887631,0
0,1110,38844,3575887631,3575887632,1
0,1110,38845,3575887631,3575887632,1
0,1110,38846,3575887631,3575887632,1
0,1110,38847,3575887631,3575887632,1
0,1110,38848,3575887631,3575887632,1
0,1110,38849,3575887631,3575887632,1
0,1110,38850,3575887631,3575887633,2
0,1110,38851,3575887631,3575887635,4
0,1110,38852,3575887631,3575887635,4
0,1110,38853,3575887631,3575887639,8
0,1110,38854,3575887631,3575887639,8
0,1110,38855,3575887631,3575887641,10
0,1110,38856,3575887631,3575887641,10
0,1110,38857,3575887631,3575887641,10
0,1110,38858,3575887631,3575887644,13
0,1110,38859,3575887631,3575887645,14
0,1110,38860,3575887631,3575887645,14
0,1110,38861,3575887631,3575887646,15
0,1110,38862,3575887631,3575887646,15
0,1110,38863,3575887631,3575887648,17
0,1110,38864,3575887631,3575887648,17
0,1110,38865,3575887631,3575887649,18
0,1110,38866,3575887631,3575887650,19
0,1110,38867,3575887631,3575887652,21
0,1110,38868,3575887631,3575887654,23
0,1110,38869,3575887631,3575887655,24
0,1110,38870,3575887631,3575887655,24
0,1110,38871,3575887631,3575887655,24
0,1110,38872,3575887631,3575887655,24
0,1110,38873,3575887631,3575887656,25
0,1110,38874,3575887631,3575887658,27
0,1110,38875,3575887631,3575887658,27
0,1110,38876,3575887631,3575887659,28
0,1110,38877,3575887631,3575887659,28
0,1110,38878,3575887631,3575887660,29
0,1110,38879,3575887631,3575887660,29
0,1110,38880,3575887631,3575887660,29
0,1110,38881,3575887631,3575887661,30
0,1110,38882,3575887631,3575887662,31
0,1110,38883,3575887631,3575887663,32
0,1110,38884,3575887631,3575887664,33
0,1110,38885,3575887631,3575887664,33
0,1110,38886,3575887631,3575887664,33
0,1110,38887,3575887631,3575887665,34
0,1110,38888,3575887631,3575887665,34
0,1110,38889,3575887631,3575887665,34
0,1110,38890,3575887631,3575887666,35
0,1110,38891,3575887631,3575887667,36
0,1110,38892,3575887631,3575887667,36
0,1110,38893,3575887631,3575887668,37
0,1110,38894,3575887631,3575887668,37
0,1110,38895,3575887631,3575887677,46
0,1110,38896,3575887631,3575887677,46
0,1110,38897,3575887631,3575887677,46
0,1110,38898,3575887631,3575887679,48
0,1110,38899,3575887631,3575887680,49
0,1111,38900,3575887696,3575887696,0
0,1111,38901,3575887696,3575887696,0
0,1111,38902,3575887696,3575887696,0
0,1111,38903,3575887696,3575887696,0
0,1111,38904,3575887696,3575887696,0
0,1111,38905,3575887696,3575887696,0
0,1111,38906,3575887696,3575887696,0
0,1111,38907,3575887696,3575887696,0
0,1111,38908,3575887696,3575887696,0
0,1111,38909,3575887696,3575887696,0
0,1111,38910,3575887696,3575887696,0
0,1111,38911,3575887696,3575887696,0
0,1111,38912,3575887696,3575887696,0
0,1111,38913,3575887696,3575887696,0
0,1111,38914,3575887696,3575887696,0
0,1111,38915,3575887696,3575887696,0
0,1111,38916,3575887696,3575887696,0
0,1111,38917,3575887696,3575887696,0
0,1111,38918,3575887696,3575887696,0
0,1111,38919,3575887696,3575887696,0
0,1111,38920,3575887696,3575887697,1
0,1111,38921,3575887696,3575887697,1
0,1111,38922,3575887696,3575887697,1
0,1111,38923,3575887696,3575887698,2
0,1111,38924,3575887696,3575887698,2
0,1111,38925,3575887696,3575887698,2
0,1111,38926,3575887696,3575887699,3
0,1111,38927,3575887696,3575887701,5
0,1111,38928,3575887696,3575887701,5
0,1111,38929,3575887696,3575887702,6
0,1111,38930,3575887696,3575887703,7
0,1111,38931,3575887696,3575887704,8
0,1111,38932,3575887696,3575887704,8
0,1111,38933,3575887696,3575887705,9
0,1111,38934,3575887696,3575887705,9
0,1111,38935,3575887696,3575887705,9
0,1111,38936,3575887696,3575887705,9
0,1111,38937,3575887696,3575887705,9
0,1111,38938,3575887696,3575887706,10
0,1111,38939,3575887696,3575887706,10
0,1111,38940,3575887696,3575887706,10
0,1111,38941,3575887696,3575887709,13
0,1111,38942,3575887696,3575887709,13
0,1111,38943,3575887696,3575887709,13
0,1111,38944,3575887696,3575887710,14
0,1111,38945,3575887696,3575887710,14
0,1111,38946,3575887696,3575887711,15
0,1111,38947,3575887696,3575887712,16
0,1111,38948,3575887696,3575887713,17
0,1111,38949,3575887696,3575887713,17
0,1111,38950,3575887696,3575887713,17
0,1111,38951,3575887696,3575887714,18
0,1111,38952,3575887696,3575887714,18
0,1111,38953,3575887696,3575887714,18
0,1111,38954,3575887696,3575887715,19
0,1111,38955,3575887696,3575887715,19
0,1111,38956,3575887696,3575887717,21
0,1111,38957,3575887696,3575887718,22
0,1111,38958,3575887696,3575887719,23
0,1111,38959,3575887696,3575887720,24
0,1111,38960,3575887696,3575887721,25
0,1111,38961,3575887696,3575887722,26
0,1111,38962,3575887696,3575887722,26
0,1111,38963,3575887696,3575887723,27
0,1111,38964,3575887696,3575887723,27
0,1111,38965,3575887696,3575887723,27
0,1111,38966,3575887696,3575887724,28
0,1111,38967,3575887696,3575887725,29
0,1111,38968,3575887696,3575887725,29
0,1111,38969,3575887696,3575887725,29
0,1111,38970,3575887696,3575887726,30
0,1111,38971,3575887696,3575887726,30
0,1111,38972,3575887696,3575887726,30
0,1111,38973,3575887696,3575887728,32
0,1111,38974,3575887696,3575887728,32
0,1111,38975,3575887696,3575887729,33
0,1111,38976,3575887696,3575887730,34
0,1111,38977,3575887696,3575887732,36
0,1111,38978,3575887696,3575887732,36
0,1111,38979,3575887696,3575887734,38
0,1111,38980,3575887696,3575887734,38
0,1111,38981,3575887696,3575887734,38
0,1111,38982,3575887696,3575887735,39
0,1111,38983,3575887696,3575887736,40
0,1111,38984,3575887696,3575887736,40
0,1111,38985,3575887696,3575887738,42
0,1111,38986,3575887696,3575887738,42
0,1111,38987,3575887696,3575887738,42
0,1111,38988,3575887696,3575887738,42
0,1111,38989,3575887696,3575887738,42
0,1111,38990,3575887696,3575887739,43
0,1111,38991,3575887696,3575887739,43
0,1111,38992,3575887696,3575887739,43
0,1111,38993,3575887696,3575887740,44
0,1111,38994,3575887696,3575887740,44
0,1111,38995,3575887696,3575887740,44
0,1111,38996,3575887696,3575887741,45
0,1111,38997,3575887696,3575887741,45
0,1111,38998,3575887696,3575887743,47
0,1111,38999,3575887696,3575887744,48
0,1111,39000,3575887696,3575887744,48
0,1111,39001,3575887696,3575887745,49
0,1111,39002,3575887696,3575887745,49
0,1111,39003,3575887696,3575887745,49
0,1111,39004,3575887696,3575887746,50
0,1112,39005,3575887760,3575887760,0
0,1112,39006,3575887760,3575887760,0
0,1112,39007,3575887760,3575887760,0
0,1112,39008,3575887760,3575887760,0
0,1112,39009,3575887760,3575887761,1
0,1112,39010,3575887760,3575887761,1
0,1112,39011,3575887760,3575887761,1
0,1112,39012,3575887760,3575887761,1
0,1112,39013,3575887760,3575887761,1
0,1112,39014,3575887760,3575887761,1
0,1112,39015,3575887760,3575887761,1
0,1112,39016,3575887760,3575887761,1
0,1112,39017,3575887760,3575887761,1
0,1112,39018,3575887760,3575887761,1
0,1112,39019,3575887760,3575887761,1
0,1112,39020,3575887760,3575887761,1
0,1112,39021,3575887760,3575887761,1
0,1112,39022,3575887760,3575887761,1
0,1112,39023,3575887760,3575887761,1
0,1112,39024,3575887760,3575887761,1
0,1112,39025,3575887760,3575887762,2
0,1112,39026,3575887760,3575887762,2
0,1112,39027,3575887760,3575887763,3
0,1112,39028,3575887760,3575887764,4
0,1112,39029,3575887760,3575887764,4
0,1112,39030,3575887760,3575887764,4
0,1112,39031,3575887760,3575887765,5
0,1112,39032,3575887760,3575887765,5
0,1112,39033,3575887760,3575887766,6
0,1112,39034,3575887760,3575887766,6
0,1112,39035,3575887760,3575887767,7
0,1112,39036,3575887760,3575887770,10
0,1112,39037,3575887760,3575887771,11
0,1112,39038,3575887760,3575887771,11
0,1112,39039,3575887760,3575887772,12
0,1112,39040,3575887760,3575887772,12
0,1112,39041,3575887760,3575887773,13
0,1112,39042,3575887760,3575887775,15
0,1112,39043,3575887760,3575887775,15
0,1112,39044,3575887760,3575887775,15
0,1112,39045,3575887760,3575887776,16
0,1112,39046,3575887760,3575887776,16
0,1112,39047,3575887760,3575887777,17
0,1112,39048,3575887760,3575887777,17
0,1112,39049,3575887760,3575887777,17
0,1112,39050,3575887760,3575887777,17
0,1112,39051,3575887760,3575887778,18
0,1112,39052,3575887760,3575887779,19
0,1112,39053,3575887760,3575887780,20
0,1112,39054,3575887760,3575887780,20
0,1112,39055,3575887760,3575887782,22
0,1112,39056,3575887760,3575887782,22
0,1112,39057,3575887760,3575887782,22
0,1112,39058,3575887760,3575887783,23
0,1112,39059,3575887760,3575887784,24
0,1112,39060,3575887760,3575887785,25
0,1112,39061,3575887760,3575887785,25
0,1112,39062,3575887760,3575887786,26
0,1112,39063,3575887760,3575887786,26
0,1112,39064,3575887760,3575887790,30
0,1112,39065,3575887760,3575887790,30
0,1112,39066,3575887760,3575887792,32
0,1112,39067,3575887760,3575887793,33
0,1112,39068,3575887760,3575887794,34
0,1112,39069,3575887760,3575887798,38
0,1112,39070,3575887760,3575887799,39
0,1112,39071,3575887760,3575887800,40
0,1112,39072,3575887760,3575887800,40
0,1112,39073,3575887760,3575887800,40
0,1112,39074,3575887760,3575887801,41
0,1112,39075,3575887760,3575887802,42
0,1112,39076,3575887760,3575887803,43
0,1112,39077,3575887760,3575887804,44
0,1112,39078,3575887760,3575887805,45
0,1112,39079,3575887760,3575887805,45
0,1112,39080,3575887760,3575887806,46
0,1112,39081,3575887760,3575887807,47
0,1112,39082,3575887760,3575887807,47
0,1112,39083,3575887760,3575887809,49
0,1112,39084,3575887760,3575887809,49
0,1113,39085,3575887825,3575887825,0
0,1113,39086,3575887825,3575887825,0
0,1113,39087,3575887825,3575887825,0
0,1113,39088,3575887825,3575887825,0
0,1113,39089,3575887825,3575887825,0
0,1113,39090,3575887825,3575887825,0
0,1113,39091,3575887825,3575887825,0
0,1113,39092,3575887825,3575887825,0
0,1113,39093,3575887825,3575887825,0
0,1113,39094,3575887825,3575887825,0
0,1113,39095,3575887825,3575887825,0
0,1113,39096,3575887825,3575887825,0
0,1113,39097,3575887825,3575887825,0
0,1113,39098,3575887825,3575887825,0
0,1113,39099,3575887825,3575887825,0
0,1113,39100,3575887825,3575887825,0
0,1113,39101,3575887825,3575887825,0
0,1113,39102,3575887825,3575887825,0
0,1113,39103,3575887825,3575887825,0
0,1113,39104,3575887825,3575887825,0
0,1113,39105,3575887825,3575887826,1
0,1113,39106,3575887825,3575887828,3
0,1113,39107,3575887825,3575887829,4
0,1113,39108,3575887825,3575887829,4
0,1113,39109,3575887825,3575887829,4
0,1113,39110,3575887825,3575887829,4
0,1113,39111,3575887825,3575887830,5
0,1113,39112,3575887825,3575887830,5
0,1113,39113,3575887825,3575887830,5
0,1113,39114,3575887825,3575887830,5
0,1113,39115,3575887825,3575887831,6
0,1113,39116,3575887825,3575887831,6
0,1113,39117,3575887825,3575887832,7
0,1113,39118,3575887825,3575887832,7
0,1113,39119,3575887825,3575887833,8
0,1113,39120,3575887825,3575887833,8
0,1113,39121,3575887825,3575887834,9
0,1113,39122,3575887825,3575887835,10
0,1113,39123,3575887825,3575887836,11
0,1113,39124,3575887825,3575887839,14
0,1113,39125,3575887825,3575887840,15
0,1113,39126,3575887825,3575887840,15
0,1113,39127,3575887825,3575887841,16
0,1113,39128,3575887825,3575887842,17
0,1113,39129,3575887825,3575887843,18
0,1113,39130,3575887825,3575887844,19
0,1113,39131,3575887825,3575887845,20
0,1113,39132,3575887825,3575887845,20
0,1113,39133,3575887825,3575887846,21
0,1113,39134,3575887825,3575887847,22
0,1113,39135,3575887825,3575887848,23
0,1113,39136,3575887825,3575887848,23
0,1113,39137,3575887825,3575887849,24
0,1113,39138,3575887825,3575887849,24
0,1113,39139,3575887825,3575887851,26
0,1113,39140,3575887825,3575887852,27
0,1113,39141,3575887825,3575887854,29
0,1113,39142,3575887825,3575887854,29
0,1113,39143,3575887825,3575887855,30
0,1113,39144,3575887825,3575887856,31
0,1113,39145,3575887825,3575887856,31
0,1113,39146,3575887825,3575887857,32
0,1113,39147,3575887825,3575887858,33
0,1113,39148,3575887825,3575887858,33
0,1113,39149,3575887825,3575887859,34
0,1113,39150,3575887825,3575887859,34
0,1113,39151,3575887825,3575887861,36
0,1113,39152,3575887825,3575887861,36
0,1113,39153,3575887825,3575887862,37
0,1113,39154,3575887825,3575887862,37
0,1113,39155,3575887825,3575887863,38
0,1113,39156,3575887825,3575887863,38
0,1113,39157,3575887825,3575887863,38
0,1113,39158,3575887825,3575887864,39
0,1113,39159,3575887825,3575887864,39
0,1113,39160,3575887825,3575887865,40
0,1113,39161,3575887825,3575887865,40
0,1113,39162,3575887825,3575887866,41
0,1113,39163,3575887825,3575887866,41
0,1113,39164,3575887825,3575887866,41
0,1113,39165,3575887825,3575887867,42
0,1113,39166,3575887825,3575887868,43
0,1113,39167,3575887825,3575887868,43
0,1114,39168,3575887888,3575887888,0
0,1114,39169,3575887888,3575887888,0
0,1114,39170,3575887888,3575887888,0
0,1114,39171,3575887888,3575887888,0
0,1114,39172,3575887888,3575887888,0
0,1114,39173,3575887888,3575887888,0
0,1114,39174,3575887888,3575887888,0
0,1114,39175,3575887888,3575887888,0
0,1114,39176,3575887888,3575887888,0
0,1114,39177,3575887888,3575887889,1
0,1114,39178,3575887888,3575887889,1
0,1114,39179,3575887888,3575887889,1
0,1114,39180,3575887888,3575887890,2
0,1114,39181,3575887888,3575887890,2
0,1114,39182,3575887888,3575887891,3
0,1114,39183,3575887888,3575887892,4
0,1114,39184,3575887888,3575887893,5
0,1114,39185,3575887888,3575887894,6
0,1114,39186,3575887888,3575887894,6
0,1114,39187,3575887888,3575887895,7
0,1114,39188,3575887888,3575887895,7
0,1114,39189,3575887888,3575887895,7
0,1114,39190,3575887888,3575887896,8
0,1114,39191,3575887888,3575887896,8
0,1114,39192,3575887888,3575887897,9
0,1114,39193,3575887888,3575887897,9
0,1114,39194,3575887888,3575887897,9
0,1114,39195,3575887888,3575887897,9
0,1114,39196,3575887888,3575887898,10
0,1114,39197,3575887888,3575887898,10
0,1114,39198,3575887888,3575887900,12
0,1114,39199,3575887888,3575887901,13
0,1114,39200,3575887888,3575887901,13
0,1114,39201,3575887888,3575887903,15
0,1114,39202,3575887888,3575887903,15
0,1114,39203,3575887888,3575887904,16
0,1114,39204,3575887888,3575887904,16
0,1114,39205,3575887888,3575887904,16
0,1114,39206,3575887888,3575887905,17
0,1114,39207,3575887888,3575887906,18
0,1114,39208,3575887888,3575887906,18
0,1114,39209,3575887888,3575887906,18
0,1114,39210,3575887888,3575887906,18
0,1114,39211,3575887888,3575887907,19
0,1114,39212,3575887888,3575887907,19
0,1114,39213,3575887888,3575887909,21
0,1114,39214,3575887888,3575887909,21
0,1114,39215,3575887888,3575887910,22
0,1114,39216,3575887888,3575887910,22
0,1114,39217,3575887888,3575887910,22
0,1114,39218,3575887888,3575887911,23
0,1114,39219,3575887888,3575887912,24
0,1114,39220,3575887888,3575887913,25
0,1114,39221,3575887888,3575887914,26
0,1114,39222,3575887888,3575887915,27
0,1114,39223,3575887888,3575887915,27
0,1114,39224,3575887888,3575887915,27
0,1114,39225,3575887888,3575887915,27
0,1114,39226,3575887888,3575887916,28
0,1114,39227,3575887888,3575887917,29
0,1114,39228,3575887888,3575887918,30
0,1114,39229,3575887888,3575887920,32
0,1114,39230,3575887888,3575887920,32
0,1114,39231,3575887888,3575887921,33
0,1114,39232,3575887888,3575887922,34
0,1114,39233,3575887888,3575887922,34
0,1114,39234,3575887888,3575887923,35
0,1114,39235,3575887888,3575887923,35
0,1114,39236,3575887888,3575887923,35
0,1114,39237,3575887888,3575887924,36
0,1114,39238,3575887888,3575887924,36
0,1114,39239,3575887888,3575887925,37
0,1114,39240,3575887888,3575887925,37
0,1114,39241,3575887888,3575887926,38
0,1114,39242,3575887888,3575887926,38
0,1114,39243,3575887888,3575887926,38
0,1114,39244,3575887888,3575887927,39
0,1114,39245,3575887888,3575887928,40
0,1114,39246,3575887888,3575887929,41
0,1114,39247,3575887888,3575887930,42
0,1114,39248,3575887888,3575887930,42
0,1114,39249,3575887888,3575887932,44
0,1114,39250,3575887888,3575887933,45
0,1114,39251,3575887888,3575887934,46
0,1114,39252,3575887888,3575887934,46
0,1114,39253,3575887888,3575887934,46
0,1114,39254,3575887888,3575887935,47
0,1114,39255,3575887888,3575887936,48
0,1114,39256,3575887888,3575887936,48
0,1114,39257,3575887888,3575887938,50
0,1115,39258,3575887952,3575887952,0
0,1115,39259,3575887952,3575887952,0
0,1115,39260,3575887952,3575887952,0
0,1115,39261,3575887952,3575887952,0
0,1115,39262,3575887952,3575887952,0
0,1115,39263,3575887952,3575887952,0
0,1115,39264,3575887952,3575887952,0
0,1115,39265,3575887952,3575887952,0
0,1115,39266,3575887952,3575887952,0
0,1115,39267,3575887952,3575887952,0
0,1115,39268,3575887952,3575887952,0
0,1115,39269,3575887952,3575887952,0
0,1115,39270,3575887952,3575887952,0
0,1115,39271,3575887952,3575887952,0
0,1115,39272,3575887952,3575887952,0
0,1115,39273,3575887952,3575887952,0
0,1115,39274,3575887952,3575887952,0
0,1115,39275,3575887952,3575887952,0
0,1115,39276,3575887952,3575887952,0
0,1115,39277,3575887952,3575887952,0
0,1115,39278,3575887952,3575887952,0
0,1115,39279,3575887952,3575887952,0
0,1115,39280,3575887952,3575887952,0
0,1115,39281,3575887952,3575887952,0
0,1115,39282,3575887952,3575887953,1
0,1115,39283,3575887952,3575887953,1
0,1115,39284,3575887952,3575887953,1
0,1115,39285,3575887952,3575887953,1
0,1115,39286,3575887952,3575887954,2
0,1115,39287,3575887952,3575887955,3
0,1115,39288,3575887952,3575887955,3
0,1115,39289,3575887952,3575887956,4
0,1115,39290,3575887952,3575887956,4
0,1115,39291,3575887952,3575887958,6
0,1115,39292,3575887952,3575887959,7
0,1115,39293,3575887952,3575887961,9
0,1115,39294,3575887952,3575887961,9
0,1115,39295,3575887952,3575887961,9
0,1115,39296,3575887952,3575887961,9
0,1115,39297,3575887952,3575887962,10
0,1115,39298,3575887952,3575887963,11
0,1115,39299,3575887952,3575887964,12
0,1115,39300,3575887952,3575887964,12
0,1115,39301,3575887952,3575887965,13
0,1115,39302,3575887952,3575887965,13
0,1115,39303,3575887952,3575887966,14
0,1115,39304,3575887952,3575887967,15
0,1115,39305,3575887952,3575887968,16
0,1115,39306,3575887952,3575887971,19
0,1115,39307,3575887952,3575887971,19
0,1115,39308,3575887952,3575887971,19
0,1115,39309,3575887952,3575887972,20
0,1115,39310,3575887952,3575887972,20
0,1115,39311,3575887952,3575887972,20
0,1115,39312,3575887952,3575887973,21
0,1115,39313,3575887952,3575887974,22
0,1115,39314,3575887952,3575887975,23
0,1115,39315,3575887952,3575887976,24
0,1115,39316,3575887952,3575887976,24
0,1115,39317,3575887952,3575887977,25
0,1115,39318,3575887952,3575887977,25
0,1115,39319,3575887952,3575887977,25
0,1115,39320,3575887952,3575887977,25
0,1115,39321,3575887952,3575887977,25
0,1115,39322,3575887952,3575887977,25
0,1115,39323,3575887952,3575887979,27
0,1115,39324,3575887952,3575887980,28
0,1115,39325,3575887952,3575887981,29
0,1115,39326,3575887952,3575887982,30
0,1115,39327,3575887952,3575887982,30
0,1115,39328,3575887952,3575887983,31
0,1115,39329,3575887952,3575887984,32
0,1115,39330,3575887952,3575887985,33
0,1115,39331,3575887952,3575887985,33
0,1115,39332,3575887952,3575887986,34
0,1115,39333,3575887952,3575887986,34
0,1115,39334,3575887952,3575887986,34
0,1115,39335,3575887952,3575887990,38
0,1115,39336,3575887952,3575887990,38
0,1115,39337,3575887952,3575887992,40
0,1115,39338,3575887952,3575887994,42
0,1115,39339,3575887952,3575887994,42
0,1115,39340,3575887952,3575887998,46
0,1115,39341,3575887952,3575887998,46
0,1115,39342,3575887952,3575887999,47
0,1115,39343,3575887952,3575888000,48
0,1115,39344,3575887952,3575888000,48
0,1115,39345,3575887952,3575888001,49
0,1116,39346,3575888015,3575888015,0
0,1116,39347,3575888015,3575888015,0
0,1116,39348,3575888015,3575888015,0
0,1116,39349,3575888015,3575888015,0
0,1116,39350,3575888015,3575888015,0
0,1116,39351,3575888015,3575888015,0
0,1116,39352,3575888015,3575888015,0
0,1116,39353,3575888015,3575888015,0
0,1116,39354,3575888015,3575888015,0
0,1116,39355,3575888015,3575888015,0
0,1116,39356,3575888015,3575888015,0
0,1116,39357,3575888015,3575888015,0
0,1116,39358,3575888015,3575888015,0
0,1116,39359,3575888015,3575888015,0
0,1116,39360,3575888015,3575888015,0
0,1116,39361,3575888015,3575888015,0
0,1116,39362,3575888015,3575888016,1
0,1116,39363,3575888015,3575888016,1
0,1116,39364,3575888015,3575888017,2
0,1116,39365,3575888015,3575888018,3
0,1116,39366,3575888015,3575888019,4
0,1116,39367,3575888015,3575888020,5
0,1116,39368,3575888015,3575888022,7
0,1116,39369,3575888015,3575888022,7
0,1116,39370,3575888015,3575888022,7
0,1116,39371,3575888015,3575888022,7
0,1116,39372,3575888015,3575888023,8
0,1116,39373,3575888015,3575888023,8
0,1116,39374,3575888015,3575888026,11
0,1116,39375,3575888015,3575888026,11
0,1116,39376,3575888015,3575888028,13
0,1116,39377,3575888015,3575888029,14
0,1116,39378,3575888015,3575888029,14
0,1116,39379,3575888015,3575888029,14
0,1116,39380,3575888015,3575888029,14
0,1116,39381,3575888015,3575888030,15
0,1116,39382,3575888015,3575888031,16
0,1116,39383,3575888015,3575888031,16
0,1116,39384,3575888015,3575888031,16
0,1116,39385,3575888015,3575888032,17
0,1116,39386,3575888015,3575888032,17
0,1116,39387,3575888015,3575888032,17
0,1116,39388,3575888015,3575888033,18
0,1116,39389,3575888015,3575888033,18
0,1116,39390,3575888015,3575888034,19
0,1116,39391,3575888015,3575888034,19
0,1116,39392,3575888015,3575888035,20
0,1116,39393,3575888015,3575888036,21
0,1116,39394,3575888015,3575888039,24
0,1116,39395,3575888015,3575888040,25
0,1116,39396,3575888015,3575888040,25
0,1116,39397,3575888015,3575888041,26
0,1116,39398,3575888015,3575888041,26
0,1116,39399,3575888015,3575888042,27
0,1116,39400,3575888015,3575888044,29
0,1116,39401,3575888015,3575888045,30
0,1116,39402,3575888015,3575888046,31
0,1116,39403,3575888015,3575888046,31
0,1116,39404,3575888015,3575888046,31
0,1116,39405,3575888015,3575888048,33
0,1116,39406,3575888015,3575888049,34
0,1116,39407,3575888015,3575888051,36
0,1116,39408,3575888015,3575888051,36
0,1116,39409,3575888015,3575888052,37
0,1116,39410,3575888015,3575888054,39
0,1116,39411,3575888015,3575888055,40
0,1116,39412,3575888015,3575888055,40
0,1116,39413,3575888015,3575888055,40
0,1116,39414,3575888015,3575888055,40
0,1116,39415,3575888015,3575888056,41
0,1116,39416,3575888015,3575888057,42
0,1116,39417,3575888015,3575888058,43
0,1116,39418,3575888015,3575888058,43
0,1116,39419,3575888015,3575888059,44
0,1116,39420,3575888015,3575888060,45
0,1116,39421,3575888015,3575888060,45
0,1116,39422,3575888015,3575888063,48
0,1116,39423,3575888015,3575888063,48
0,1116,39424,3575888015,3575888063,48
0,1116,39425,3575888015,3575888064,49
0,1116,39426,3575888015,3575888064,49
0,1116,39427,3575888015,3575888064,49
0,1116,39428,3575888015,3575888064,49
0,1116,39429,3575888015,3575888065,50
0,1117,39430,3575888081,3575888081,0
0,1117,39431,3575888081,3575888081,0
0,1117,39432,3575888081,3575888081,0
0,1117,39433,3575888081,3575888081,0
0,1117,39434,3575888081,3575888081,0
0,1117,39435,3575888081,3575888081,0
0,1117,39436,3575888081,3575888081,0
0,1117,39437,3575888081,3575888081,0
0,1117,39438,3575888081,3575888081,0
0,1117,39439,3575888081,3575888081,0
0,1117,39440,3575888081,3575888081,0
0,1117,39441,3575888081,3575888082,1
0,1117,39442,3575888081,3575888086,5
0,1117,39443,3575888081,3575888086,5
0,1117,39444,3575888081,3575888087,6
0,1117,39445,3575888081,3575888088,7
0,1117,39446,3575888081,3575888088,7
0,1117,39447,3575888081,3575888088,7
0,1117,39448,3575888081,3575888088,7
0,1117,39449,3575888081,3575888089,8
0,1117,39450,3575888081,3575888089,8
0,1117,39451,3575888081,3575888089,8
0,1117,39452,3575888081,3575888089,8
0,1117,39453,3575888081,3575888090,9
0,1117,39454,3575888081,3575888091,10
0,1117,39455,3575888081,3575888091,10
0,1117,39456,3575888081,3575888091,10
0,1117,39457,3575888081,3575888091,10
0,1117,39458,3575888081,3575888093,12
0,1117,39459,3575888081,3575888094,13
0,1117,39460,3575888081,3575888094,13
0,1117,39461,3575888081,3575888095,14
0,1117,39462,3575888081,3575888095,14
0,1117,39463,3575888081,3575888095,14
0,1117,39464,3575888081,3575888096,15
0,1117,39465,3575888081,3575888096,15
0,1117,39466,3575888081,3575888097,16
0,1117,39467,3575888081,3575888097,16
0,1117,39468,3575888081,3575888098,17
0,1117,39469,3575888081,3575888098,17
0,1117,39470,3575888081,3575888099,18
0,1117,39471,3575888081,3575888099,18
0,1117,39472,3575888081,3575888102,21
0,1117,39473,3575888081,3575888102,21
0,1117,39474,3575888081,3575888103,22
0,1117,39475,3575888081,3575888103,22
0,1117,39476,3575888081,3575888104,23
0,1117,39477,3575888081,3575888104,23
0,1117,39478,3575888081,3575888105,24
0,1117,39479,3575888081,3575888106,25
0,1117,39480,3575888081,3575888106,25
0,1117,39481,3575888081,3575888107,26
0,1117,39482,3575888081,3575888109,28
0,1117,39483,3575888081,3575888109,28
0,1117,39484,3575888081,3575888109,28
0,1117,39485,3575888081,3575888109,28
0,1117,39486,3575888081,3575888109,28
0,1117,39487,3575888081,3575888110,29
0,1117,39488,3575888081,3575888110,29
0,1117,39489,3575888081,3575888111,30
0,1117,39490,3575888081,3575888112,31
0,1117,39491,3575888081,3575888112,31
0,1117,39492,3575888081,3575888113,32
0,1117,39493,3575888081,3575888115,34
0,1117,39494,3575888081,3575888115,34
0,1117,39495,3575888081,3575888115,34
0,1117,39496,3575888081,3575888115,34
0,1117,39497,3575888081,3575888115,34
0,1117,39498,3575888081,3575888116,35
0,1117,39499,3575888081,3575888118,37
0,1117,39500,3575888081,3575888119,38
0,1117,39501,3575888081,3575888120,39
0,1117,39502,3575888081,3575888122,41
0,1117,39503,3575888081,3575888122,41
0,1117,39504,3575888081,3575888122,41
0,1117,39505,3575888081,3575888122,41
0,1117,39506,3575888081,3575888123,42
0,1117,39507,3575888081,3575888123,42
0,1117,39508,3575888081,3575888124,43
0,1117,39509,3575888081,3575888124,43
0,1117,39510,3575888081,3575888125,44
0,1117,39511,3575888081,3575888125,44
0,1117,39512,3575888081,3575888126,45
0,1117,39513,3575888081,3575888126,45
0,1117,39514,3575888081,3575888127,46
0,1117,39515,3575888081,3575888127,46
0,1117,39516,3575888081,3575888128,47
0,1117,39517,3575888081,3575888128,47
0,1117,39518,3575888081,3575888130,49
0,1117,39519,3575888081,3575888130,49
0,1117,39520,3575888081,3575888130,49
0,1118,39521,3575888143,3575888143,0
0,1118,39522,3575888143,3575888143,0
0,1118,39523,3575888143,3575888143,0
0,1118,39524,3575888143,3575888143,0
0,1118,39525,3575888143,3575888143,0
0,1118,39526,3575888143,3575888143,0
0,1118,39527,3575888143,3575888143,0
0,1118,39528,3575888143,3575888143,0
0,1118,39529,3575888143,3575888143,0
0,1118,39530,3575888143,3575888143,0
0,1118,39531,3575888143,3575888143,0
0,1118,39532,3575888143,3575888143,0
0,1118,39533,3575888143,3575888143,0
0,1118,39534,3575888143,3575888143,0
0,1118,39535,3575888143,3575888143,0
0,1118,39536,3575888143,3575888143,0
0,1118,39537,3575888143,3575888143,0
0,1118,39538,3575888143,3575888143,0
0,1118,39539,3575888143,3575888143,0
0,1118,39540,3575888143,3575888143,0
0,1118,39541,3575888143,3575888144,1
0,1118,39542,3575888143,3575888145,2
0,1118,39543,3575888143,3575888146,3
0,1118,39544,3575888143,3575888146,3
0,1118,39545,3575888143,3575888146,3
0,1118,39546,3575888143,3575888147,4
0,1118,39547,3575888143,3575888148,5
0,1118,39548,3575888143,3575888148,5
0,1118,39549,3575888143,3575888149,6
0,1118,39550,3575888143,3575888151,8
0,1118,39551,3575888143,3575888152,9
0,1118,39552,3575888143,3575888153,10
0,1118,39553,3575888143,3575888153,10
0,1118,39554,3575888143,3575888153,10
0,1118,39555,3575888143,3575888154,11
0,1118,39556,3575888143,3575888155,12
0,1118,39557,3575888143,3575888155,12
0,1118,39558,3575888143,3575888155,12
0,1118,39559,3575888143,3575888156,13
0,1118,39560,3575888143,3575888157,14
0,1118,39561,3575888143,3575888157,14
0,1118,39562,3575888143,3575888158,15
0,1118,39563,3575888143,3575888160,17
0,1118,39564,3575888143,3575888161,18
0,1118,39565,3575888143,3575888161,18
0,1118,39566,3575888143,3575888161,18
0,1118,39567,3575888143,3575888162,19
0,1118,39568,3575888143,3575888163,20
0,1118,39569,3575888143,3575888163,20
0,1118,39570,3575888143,3575888164,21
0,1118,39571,3575888143,3575888165,22
0,1118,39572,3575888143,3575888165,22
0,1118,39573,3575888143,3575888165,22
0,1118,39574,3575888143,3575888166,23
0,1118,39575,3575888143,3575888167,24
0,1118,39576,3575888143,3575888168,25
0,1118,39577,3575888143,3575888171,28
0,1118,39578,3575888143,3575888171,28
0,1118,39579,3575888143,3575888172,29
0,1118,39580,3575888143,3575888172,29
0,1118,39581,3575888143,3575888173,30
0,1118,39582,3575888143,3575888174,31
0,1118,39583,3575888143,3575888174,31
0,1118,39584,3575888143,3575888175,32
0,1118,39585,3575888143,3575888176,33
0,1118,39586,3575888143,3575888176,33
0,1118,39587,3575888143,3575888176,33
0,1118,39588,3575888143,3575888177,34
0,1118,39589,3575888143,3575888177,34
0,1118,39590,3575888143,3575888178,35
0,1118,39591,3575888143,3575888178,35
0,1118,39592,3575888143,3575888180,37
0,1118,39593,3575888143,3575888180,37
0,1118,39594,3575888143,3575888181,38
0,1118,39595,3575888143,3575888182,39
0,1118,39596,3575888143,3575888182,39
0,1118,39597,3575888143,3575888182,39
0,1118,39598,3575888143,3575888183,40
0,1118,39599,3575888143,3575888185,42
0,1118,39600,3575888143,3575888185,42
0,1118,39601,3575888143,3575888186,43
0,1118,39602,3575888143,3575888186,43
0,1118,39603,3575888143,3575888187,44
0,1118,39604,3575888143,3575888189,46
0,1118,39605,3575888143,3575888191,48
0,1118,39606,3575888143,3575888192,49
0,1119,39607,3575888207,3575888207,0
0,1119,39608,3575888207,3575888207,0
0,1119,39609,3575888207,3575888207,0
0,1119,39610,3575888207,3575888207,0
0,1119,39611,3575888207,3575888207,0
0,1119,39612,3575888207,3575888207,0
0,1119,39613,3575888207,3575888207,0
0,1119,39614,3575888207,3575888207,0
0,1119,39615,3575888207,3575888207,0
0,1119,39616,3575888207,3575888207,0
0,1119,39617,3575888207,3575888207,0
0,1119,39618,3575888207,3575888207,0
0,1119,39619,3575888207,3575888207,0
0,1119,39620,3575888207,3575888208,1
0,1119,39621,3575888207,3575888208,1
0,1119,39622,3575888207,3575888209,2
0,1119,39623,3575888207,3575888211,4
0,1119,39624,3575888207,3575888213,6
0,1119,39625,3575888207,3575888213,6
0,1119,39626,3575888207,3575888213,6
0,1119,39627,3575888207,3575888213,6
0,1119,39628,3575888207,3575888215,8
0,1119,39629,3575888207,3575888215,8
0,1119,39630,3575888207,3575888215,8
0,1119,39631,3575888207,3575888215,8
0,1119,39632,3575888207,3575888216,9
0,1119,39633,3575888207,3575888218,11
0,1119,39634,3575888207,3575888218,11
0,1119,39635,3575888207,3575888220,13
0,1119,39636,3575888207,3575888221,14
0,1119,39637,3575888207,3575888222,15
0,1119,39638,3575888207,3575888222,15
0,1119,39639,3575888207,3575888222,15
0,1119,39640,3575888207,3575888222,15
0,1119,39641,3575888207,3575888223,16
0,1119,39642,3575888207,3575888223,16
0,1119,39643,3575888207,3575888227,20
0,1119,39644,3575888207,3575888227,20
0,1119,39645,3575888207,3575888228,21
0,1119,39646,3575888207,3575888229,22
0,1119,39647,3575888207,3575888230,23
0,1119,39648,3575888207,3575888230,23
0,1119,39649,3575888207,3575888230,23
0,1119,39650,3575888207,3575888231,24
0,1119,39651,3575888207,3575888231,24
0,1119,39652,3575888207,3575888231,24
0,1119,39653,3575888207,3575888232,25
0,1119,39654,3575888207,3575888232,25
0,1119,39655,3575888207,3575888232,25
0,1119,39656,3575888207,3575888233,26
0,1119,39657,3575888207,3575888233,26
0,1119,39658,3575888207,3575888233,26
0,1119,39659,3575888207,3575888234,27
0,1119,39660,3575888207,3575888234,27
0,1119,39661,3575888207,3575888236,29
0,1119,39662,3575888207,3575888236,29
0,1119,39663,3575888207,3575888238,31
0,1119,39664,3575888207,3575888240,33
0,1119,39665,3575888207,3575888241,34
0,1119,39666,3575888207,3575888242,35
0,1119,39667,3575888207,3575888242,35
0,1119,39668,3575888207,3575888244,37
0,1119,39669,3575888207,3575888246,39
0,1119,39670,3575888207,3575888246,39
0,1119,39671,3575888207,3575888247,40
0,1119,39672,3575888207,3575888248,41
0,1119,39673,3575888207,3575888249,42
0,1119,39674,3575888207,3575888249,42
0,1119,39675,3575888207,3575888251,44
0,1119,39676,3575888207,3575888252,45
0,1119,39677,3575888207,3575888253,46
0,1119,39678,3575888207,3575888255,48
0,1119,39679,3575888207,3575888255,48
0,1119,39680,3575888207,3575888256,49
0,1120,39681,3575888270,3575888270,0
0,1120,39682,3575888270,3575888270,0
0,1120,39683,3575888270,3575888270,0
0,1120,39684,3575888270,3575888270,0
0,1120,39685,3575888270,3575888270,0
0,1120,39686,3575888270,3575888270,0
0,1120,39687,3575888270,3575888270,0
0,1120,39688,3575888270,3575888270,0
0,1120,39689,3575888270,3575888270,0
0,1120,39690,3575888270,3575888270,0
0,1120,39691,3575888270,3575888270,0
0,1120,39692,3575888270,3575888270,0
0,1120,39693,3575888270,3575888270,0
0,1120,39694,3575888270,3575888270,0
0,1120,39695,3575888270,3575888270,0
0,1120,39696,3575888270,3575888270,0
0,1120,39697,3575888270,3575888270,0
0,1120,39698,3575888270,3575888270,0
0,1120,39699,3575888270,3575888270,0
0,1120,39700,3575888270,3575888270,0
0,1120,39701,3575888270,3575888277,7
0,1120,39702,3575888270,3575888277,7
0,1120,39703,3575888270,3575888278,8
0,1120,39704,3575888270,3575888279,9
0,1120,39705,3575888270,3575888280,10
0,1120,39706,3575888270,3575888281,11
0,1120,39707,3575888270,3575888286,16
0,1120,39708,3575888270,3575888287,17
0,1120,39709,3575888270,3575888287,17
0,1120,39710,3575888270,3575888288,18
0,1120,39711,3575888270,3575888288,18
0,1120,39712,3575888270,3575888288,18
0,1120,39713,3575888270,3575888289,19
0,1120,39714,3575888270,3575888289,19
0,1120,39715,3575888270,3575888289,19
0,1120,39716,3575888270,3575888290,20
0,1120,39717,3575888270,3575888290,20
0,1120,39718,3575888270,3575888291,21
0,1120,39719,3575888270,3575888291,21
0,1120,39720,3575888270,3575888291,21
0,1120,39721,3575888270,3575888291,21
0,1120,39722,3575888270,3575888293,23
0,1120,39723,3575888270,3575888294,24
0,1120,39724,3575888270,3575888294,24
0,1120,39725,3575888270,3575888295,25
0,1120,39726,3575888270,3575888295,25
0,1120,39727,3575888270,3575888296,26
0,1120,39728,3575888270,3575888296,26
0,1120,39729,3575888270,3575888297,27
0,1120,39730,3575888270,3575888297,27
0,1120,39731,3575888270,3575888297,27
0,1120,39732,3575888270,3575888298,28
0,1120,39733,3575888270,3575888298,28
0,1120,39734,3575888270,3575888298,28
0,1120,39735,3575888270,3575888299,29
0,1120,39736,3575888270,3575888300,30
0,1120,39737,3575888270,3575888300,30
0,1120,39738,3575888270,3575888301,31
0,1120,39739,3575888270,3575888302,32
0,1120,39740,3575888270,3575888304,34
0,1120,39741,3575888270,3575888304,34
0,1120,39742,3575888270,3575888304,34
0,1120,39743,3575888270,3575888304,34
0,1120,39744,3575888270,3575888304,34
0,1120,39745,3575888270,3575888305,35
0,1120,39746,3575888270,3575888305,35
0,1120,39747,3575888270,3575888306,36
0,1120,39748,3575888270,3575888306,36
0,1120,39749,3575888270,3575888308,38
0,1120,39750,3575888270,3575888308,38
0,1120,39751,3575888270,3575888309,39
0,1120,39752,3575888270,3575888309,39
0,1120,39753,3575888270,3575888310,40
0,1120,39754,3575888270,3575888310,40
0,1120,39755,3575888270,3575888311,41
0,1120,39756,3575888270,3575888312,42
0,1120,39757,3575888270,3575888313,43
0,1120,39758,3575888270,3575888313,43
0,1120,39759,3575888270,3575888315,45
0,1120,39760,3575888270,3575888315,45
0,1120,39761,3575888270,3575888315,45
0,1120,39762,3575888270,3575888315,45
0,1120,39763,3575888270,3575888316,46
0,1120,39764,3575888270,3575888317,47
0,1120,39765,3575888270,3575888318,48
0,1120,39766,3575888270,3575888319,49
0,1120,39767,3575888270,3575888320,50
0,1120,39768,3575888270,3575888320,50
0,1121,39769,3575888333,3575888333,0
0,1121,39770,3575888333,3575888333,0
0,1121,39771,3575888333,3575888333,0
0,1121,39772,3575888333,3575888333,0
0,1121,39773,3575888333,3575888333,0
0,1121,39774,3575888333,3575888333,0
0,1121,39775,3575888333,3575888333,0
0,1121,39776,3575888333,3575888333,0
0,1121,39777,3575888333,3575888333,0
0,1121,39778,3575888333,3575888333,0
0,1121,39779,3575888333,3575888333,0
0,1121,39780,3575888333,3575888333,0
0,1121,39781,3575888333,3575888333,0
0,1121,39782,3575888333,3575888333,0
0,1121,39783,3575888333,3575888333,0
0,1121,39784,3575888333,3575888333,0
0,1121,39785,3575888333,3575888333,0
0,1121,39786,3575888333,3575888333,0
0,1121,39787,3575888333,3575888333,0
0,1121,39788,3575888333,3575888334,1
0,1121,39789,3575888333,3575888334,1
0,1121,39790,3575888333,3575888335,2
0,1121,39791,3575888333,3575888335,2
0,1121,39792,3575888333,3575888336,3
0,1121,39793,3575888333,3575888336,3
0,1121,39794,3575888333,3575888337,4
0,1121,39795,3575888333,3575888339,6
0,1121,39796,3575888333,3575888339,6
0,1121,39797,3575888333,3575888339,6
0,1121,39798,3575888333,3575888340,7
0,1121,39799,3575888333,3575888340,7
0,1121,39800,3575888333,3575888340,7
0,1121,39801,3575888333,3575888340,7
0,1121,39802,3575888333,3575888340,7
0,1121,39803,3575888333,3575888341,8
0,1121,39804,3575888333,3575888343,10
0,1121,39805,3575888333,3575888343,10
0,1121,39806,3575888333,3575888344,11
0,1121,39807,3575888333,3575888346,13
0,1121,39808,3575888333,3575888346,13
0,1121,39809,3575888333,3575888346,13
0,1121,39810,3575888333,3575888347,14
0,1121,39811,3575888333,3575888347,14
0,1121,39812,3575888333,3575888348,15
0,1121,39813,3575888333,3575888349,16
0,1121,39814,3575888333,3575888349,16
0,1121,39815,3575888333,3575888350,17
0,1121,39816,3575888333,3575888353,20
0,1121,39817,3575888333,3575888353,20
0,1121,39818,3575888333,3575888354,21
0,1121,39819,3575888333,3575888354,21
0,1121,39820,3575888333,3575888354,21
0,1121,39821,3575888333,3575888355,22
0,1121,39822,3575888333,3575888355,22
0,1121,39823,3575888333,3575888357,24
0,1121,39824,3575888333,3575888357,24
0,1121,39825,3575888333,3575888357,24
0,1121,39826,3575888333,3575888358,25
0,1121,39827,3575888333,3575888358,25
0,1121,39828,3575888333,3575888361,28
0,1121,39829,3575888333,3575888361,28
0,1121,39830,3575888333,3575888361,28
0,1121,39831,3575888333,3575888362,29
0,1121,39832,3575888333,3575888363,30
0,1121,39833,3575888333,3575888363,30
0,1121,39834,3575888333,3575888364,31
0,1121,39835,3575888333,3575888364,31
0,1121,39836,3575888333,3575888366,33
0,1121,39837,3575888333,3575888366,33
0,1121,39838,3575888333,3575888366,33
0,1121,39839,3575888333,3575888368,35
0,1121,39840,3575888333,3575888371,38
0,1121,39841,3575888333,3575888372,39
0,1121,39842,3575888333,3575888372,39
0,1121,39843,3575888333,3575888373,40
0,1121,39844,3575888333,3575888373,40
0,1121,39845,3575888333,3575888374,41
0,1121,39846,3575888333,3575888375,42
0,1121,39847,3575888333,3575888375,42
0,1121,39848,3575888333,3575888376,43
0,1121,39849,3575888333,3575888376,43
0,1121,39850,3575888333,3575888376,43
0,1121,39851,3575888333,3575888377,44
0,1121,39852,3575888333,3575888378,45
0,1121,39853,3575888333,3575888378,45
0,1121,39854,3575888333,3575888379,46
0,1121,39855,3575888333,3575888380,47
0,1121,39856,3575888333,3575888381,48
0,1121,39857,3575888333,3575888382,49
0,1121,39858,3575888333,3575888382,49
0,1122,39859,3575888396,3575888396,0
0,1122,39860,3575888396,3575888396,0
0,1122,39861,3575888396,3575888396,0
0,1122,39862,3575888396,3575888396,0
0,1122,39863,3575888396,3575888396,0
0,1122,39864,3575888396,3575888396,0
0,1122,39865,3575888396,3575888396,0
0,1122,39866,3575888396,3575888396,0
0,1122,39867,3575888396,3575888396,0
0,1122,39868,3575888396,3575888396,0
0,1122,39869,3575888396,3575888396,0
0,1122,39870,3575888396,3575888396,0
0,1122,39871,3575888396,3575888399,3
0,1122,39872,3575888396,3575888400,4
0,1122,39873,3575888396,3575888400,4
0,1122,39874,3575888396,3575888401,5
0,1122,39875,3575888396,3575888402,6
0,1122,39876,3575888396,3575888403,7
0,1122,39877,3575888396,3575888404,8
0,1122,39878,3575888396,3575888405,9
0,1122,39879,3575888396,3575888406,10
0,1122,39880,3575888396,3575888407,11
0,1122,39881,3575888396,3575888408,12
0,1122,39882,3575888396,3575888409,13
0,1122,39883,3575888396,3575888410,14
0,1122,39884,3575888396,3575888411,15
0,1122,39885,3575888396,3575888413,17
0,1122,39886,3575888396,3575888413,17
0,1122,39887,3575888396,3575888414,18
0,1122,39888,3575888396,3575888414,18
0,1122,39889,3575888396,3575888414,18
0,1122,39890,3575888396,3575888416,20
0,1122,39891,3575888396,3575888416,20
0,1122,39892,3575888396,3575888417,21
0,1122,39893,3575888396,3575888418,22
0,1122,39894,3575888396,3575888420,24
0,1122,39895,3575888396,3575888422,26
0,1122,39896,3575888396,3575888422,26
0,1122,39897,3575888396,3575888422,26
0,1122,39898,3575888396,3575888422,26
0,1122,39899,3575888396,3575888422,26
0,1122,39900,3575888396,3575888422,26
0,1122,39901,3575888396,3575888423,27
0,1122,39902,3575888396,3575888426,30
0,1122,39903,3575888396,3575888427,31
0,1122,39904,3575888396,3575888428,32
0,1122,39905,3575888396,3575888429,33
0,1122,39906,3575888396,3575888430,34
0,1122,39907,3575888396,3575888430,34
0,1122,39908,3575888396,3575888431,35
0,1122,39909,3575888396,3575888431,35
0,1122,39910,3575888396,3575888431,35
0,1122,39911,3575888396,3575888432,36
0,1122,39912,3575888396,3575888432,36
0,1122,39913,3575888396,3575888432,36
0,1122,39914,3575888396,3575888432,36
0,1122,39915,3575888396,3575888432,36
0,1122,39916,3575888396,3575888432,36
0,1122,39917,3575888396,3575888433,37
0,1122,39918,3575888396,3575888434,38
0,1122,39919,3575888396,3575888434,38
0,1122,39920,3575888396,3575888434,38
0,1122,39921,3575888396,3575888435,39
0,1122,39922,3575888396,3575888436,40
0,1122,39923,3575888396,3575888440,44
0,1122,39924,3575888396,3575888440,44
0,1122,39925,3575888396,3575888441,45
0,1122,39926,3575888396,3575888441,45
0,1122,39927,3575888396,3575888442,46
0,1122,39928,3575888396,3575888444,48
0,1123,39929,3575888458,3575888458,0
0,1123,39930,3575888458,3575888458,0
0,1123,39931,3575888458,3575888458,0
0,1123,39932,3575888458,3575888458,0
0,1123,39933,3575888458,3575888458,0
0,1123,39934,3575888458,3575888458,0
0,1123,39935,3575888458,3575888458,0
0,1123,39936,3575888458,3575888458,0
0,1123,39937,3575888458,3575888458,0
0,1123,39938,3575888458,3575888458,0
0,1123,39939,3575888458,3575888458,0
0,1123,39940,3575888458,3575888458,0
0,1123,39941,3575888458,3575888458,0
0,1123,39942,3575888458,3575888458,0
0,1123,39943,3575888458,3575888459,1
0,1123,39944,3575888458,3575888459,1
0,1123,39945,3575888458,3575888460,2
0,1123,39946,3575888458,3575888461,3
0,1123,39947,3575888458,3575888462,4
0,1123,39948,3575888458,3575888463,5
0,1123,39949,3575888458,3575888463,5
0,1123,39950,3575888458,3575888463,5
0,1123,39951,3575888458,3575888464,6
0,1123,39952,3575888458,3575888465,7
0,1123,39953,3575888458,3575888465,7
0,1123,39954,3575888458,3575888465,7
0,1123,39955,3575888458,3575888466,8
0,1123,39956,3575888458,3575888466,8
0,1123,39957,3575888458,3575888467,9
0,1123,39958,3575888458,3575888467,9
0,1123,39959,3575888458,3575888468,10
0,1123,39960,3575888458,3575888468,10
0,1123,39961,3575888458,3575888468,10
0,1123,39962,3575888458,3575888469,11
0,1123,39963,3575888458,3575888476,18
0,1123,39964,3575888458,3575888477,19
0,1123,39965,3575888458,3575888478,20
0,1123,39966,3575888458,3575888479,21
0,1123,39967,3575888458,3575888480,22
0,1123,39968,3575888458,3575888485,27
0,1123,39969,3575888458,3575888486,28
0,1123,39970,3575888458,3575888488,30
0,1123,39971,3575888458,3575888488,30
0,1123,39972,3575888458,3575888488,30
0,1123,39973,3575888458,3575888488,30
0,1123,39974,3575888458,3575888488,30
0,1123,39975,3575888458,3575888489,31
0,1123,39976,3575888458,3575888489,31
0,1123,39977,3575888458,3575888490,32
0,1123,39978,3575888458,3575888490,32
0,1123,39979,3575888458,3575888490,32
0,1123,39980,3575888458,3575888490,32
0,1123,39981,3575888458,3575888491,33
0,1123,39982,3575888458,3575888491,33
0,1123,39983,3575888458,3575888491,33
0,1123,39984,3575888458,3575888493,35
0,1123,39985,3575888458,3575888494,36
0,1123,39986,3575888458,3575888495,37
0,1123,39987,3575888458,3575888495,37
0,1123,39988,3575888458,3575888495,37
0,1123,39989,3575888458,3575888495,37
0,1123,39990,3575888458,3575888496,38
0,1123,39991,3575888458,3575888496,38
0,1123,39992,3575888458,3575888497,39
0,1123,39993,3575888458,3575888497,39
0,1123,39994,3575888458,3575888498,40
0,1123,39995,3575888458,3575888498,40
0,1123,39996,3575888458,3575888499,41
0,1123,39997,3575888458,3575888500,42
0,1123,39998,3575888458,3575888501,43
0,1123,39999,3575888458,3575888502,44
0,1123,40000,3575888458,3575888504,46
0,1123,40001,3575888458,3575888504,46
0,1123,40002,3575888458,3575888504,46
0,1123,40003,3575888458,3575888504,46
0,1123,40004,3575888458,3575888505,47
0,1123,40005,3575888458,3575888505,47
0,1123,40006,3575888458,3575888506,48
0,1123,40007,3575888458,3575888506,48
0,1123,40008,3575888458,3575888507,49
0,1124,40009,3575888524,3575888524,0
0,1124,40010,3575888524,3575888524,0
0,1124,40011,3575888524,3575888524,0
0,1124,40012,3575888524,3575888524,0
0,1124,40013,3575888524,3575888524,0
0,1124,40014,3575888524,3575888524,0
0,1124,40015,3575888524,3575888524,0
0,1124,40016,3575888524,3575888524,0
0,1124,40017,3575888524,3575888524,0
0,1124,40018,3575888524,3575888524,0
0,1124,40019,3575888524,3575888524,0
0,1124,40020,3575888524,3575888524,0
0,1124,40021,3575888524,3575888524,0
0,1124,40022,3575888524,3575888524,0
0,1124,40023,3575888524,3575888524,0
0,1124,40024,3575888524,3575888524,0
0,1124,40025,3575888524,3575888524,0
0,1124,40026,3575888524,3575888524,0
0,1124,40027,3575888524,3575888524,0
0,1124,40028,3575888524,3575888524,0
0,1124,40029,3575888524,3575888524,0
0,1124,40030,3575888524,3575888524,0
0,1124,40031,3575888524,3575888524,0
0,1124,40032,3575888524,3575888524,0
0,1124,40033,3575888524,3575888524,0
0,1124,40034,3575888524,3575888524,0
0,1124,40035,3575888524,3575888524,0
0,1124,40036,3575888524,3575888524,0
0,1124,40037,3575888524,3575888524,0
0,1124,40038,3575888524,3575888524,0
0,1124,40039,3575888524,3575888525,1
0,1124,40040,3575888524,3575888525,1
0,1124,40041,3575888524,3575888525,1
0,1124,40042,3575888524,3575888526,2
0,1124,40043,3575888524,3575888526,2
0,1124,40044,3575888524,3575888527,3
0,1124,40045,3575888524,3575888528,4
0,1124,40046,3575888524,3575888529,5
0,1124,40047,3575888524,3575888530,6
0,1124,40048,3575888524,3575888532,8
0,1124,40049,3575888524,3575888532,8
0,1124,40050,3575888524,3575888533,9
0,1124,40051,3575888524,3575888534,10
0,1124,40052,3575888524,3575888534,10
0,1124,40053,3575888524,3575888535,11
0,1124,40054,3575888524,3575888535,11
0,1124,40055,3575888524,3575888536,12
0,1124,40056,3575888524,3575888538,14
0,1124,40057,3575888524,3575888538,14
0,1124,40058,3575888524,3575888538,14
0,1124,40059,3575888524,3575888539,15
0,1124,40060,3575888524,3575888539,15
0,1124,40061,3575888524,3575888539,15
0,1124,40062,3575888524,3575888539,15
0,1124,40063,3575888524,3575888540,16
0,1124,40064,3575888524,3575888540,16
0,1124,40065,3575888524,3575888542,18
0,1124,40066,3575888524,3575888542,18
0,1124,40067,3575888524,3575888542,18
0,1124,40068,3575888524,3575888545,21
0,1124,40069,3575888524,3575888545,21
0,1124,40070,3575888524,3575888545,21
0,1124,40071,3575888524,3575888546,22
0,1124,40072,3575888524,3575888546,22
0,1124,40073,3575888524,3575888547,23
0,1124,40074,3575888524,3575888548,24
0,1124,40075,3575888524,3575888548,24
0,1124,40076,3575888524,3575888549,25
0,1124,40077,3575888524,3575888552,28
0,1124,40078,3575888524,3575888552,28
0,1124,40079,3575888524,3575888553,29
0,1124,40080,3575888524,3575888553,29
0,1124,40081,3575888524,3575888553,29
0,1124,40082,3575888524,3575888554,30
0,1124,40083,3575888524,3575888554,30
0,1124,40084,3575888524,3575888555,31
0,1124,40085,3575888524,3575888556,32
0,1124,40086,3575888524,3575888556,32
0,1124,40087,3575888524,3575888557,33
0,1124,40088,3575888524,3575888557,33
0,1124,40089,3575888524,3575888560,36
0,1124,40090,3575888524,3575888560,36
0,1124,40091,3575888524,3575888561,37
0,1124,40092,3575888524,3575888561,37
0,1124,40093,3575888524,3575888561,37
0,1124,40094,3575888524,3575888562,38
0,1124,40095,3575888524,3575888562,38
0,1124,40096,3575888524,3575888563,39
0,1124,40097,3575888524,3575888564,40
0,1124,40098,3575888524,3575888565,41
0,1124,40099,3575888524,3575888565,41
0,1124,40100,3575888524,3575888565,41
0,1124,40101,3575888524,3575888567,43
0,1124,40102,3575888524,3575888569,45
0,1124,40103,3575888524,3575888570,46
0,1124,40104,3575888524,3575888571,47
0,1124,40105,3575888524,3575888572,48
0,1124,40106,3575888524,3575888572,48
0,1124,40107,3575888524,3575888573,49
0,1124,40108,3575888524,3575888574,50
0,1125,40109,3575888588,3575888588,0
0,1125,40110,3575888588,3575888588,0
0,1125,40111,3575888588,3575888588,0
0,1125,40112,3575888588,3575888588,0
0,1125,40113,3575888588,3575888588,0
0,1125,40114,3575888588,3575888588,0
0,1125,40115,3575888588,3575888588,0
0,1125,40116,3575888588,3575888588,0
0,1125,40117,3575888588,3575888588,0
0,1125,40118,3575888588,3575888588,0
0,1125,40119,3575888588,3575888588,0
0,1125,40120,3575888588,3575888588,0
0,1125,40121,3575888588,3575888588,0
0,1125,40122,3575888588,3575888588,0
0,1125,40123,3575888588,3575888588,0
0,1125,40124,3575888588,3575888588,0
0,1125,40125,3575888588,3575888588,0
0,1125,40126,3575888588,3575888588,0
0,1125,40127,3575888588,3575888588,0
0,1125,40128,3575888588,3575888589,1
0,1125,40129,3575888588,3575888589,1
0,1125,40130,3575888588,3575888591,3
0,1125,40131,3575888588,3575888594,6
0,1125,40132,3575888588,3575888594,6
0,1125,40133,3575888588,3575888597,9
0,1125,40134,3575888588,3575888598,10
0,1125,40135,3575888588,3575888599,11
0,1125,40136,3575888588,3575888600,12
0,1125,40137,3575888588,3575888600,12
0,1125,40138,3575888588,3575888600,12
0,1125,40139,3575888588,3575888601,13
0,1125,40140,3575888588,3575888604,16
0,1125,40141,3575888588,3575888605,17
0,1125,40142,3575888588,3575888605,17
0,1125,40143,3575888588,3575888606,18
0,1125,40144,3575888588,3575888607,19
0,1125,40145,3575888588,3575888609,21
0,1125,40146,3575888588,3575888610,22
0,1125,40147,3575888588,3575888612,24
0,1125,40148,3575888588,3575888612,24
0,1125,40149,3575888588,3575888613,25
0,1125,40150,3575888588,3575888613,25
0,1125,40151,3575888588,3575888613,25
0,1125,40152,3575888588,3575888615,27
0,1125,40153,3575888588,3575888615,27
0,1125,40154,3575888588,3575888616,28
0,1125,40155,3575888588,3575888617,29
0,1125,40156,3575888588,3575888617,29
0,1125,40157,3575888588,3575888619,31
0,1125,40158,3575888588,3575888621,33
0,1125,40159,3575888588,3575888621,33
0,1125,40160,3575888588,3575888621,33
0,1125,40161,3575888588,3575888621,33
0,1125,40162,3575888588,3575888621,33
0,1125,40163,3575888588,3575888621,33
0,1125,40164,3575888588,3575888625,37
0,1125,40165,3575888588,3575888626,38
0,1125,40166,3575888588,3575888629,41
0,1125,40167,3575888588,3575888629,41
0,1125,40168,3575888588,3575888629,41
0,1125,40169,3575888588,3575888630,42
0,1125,40170,3575888588,3575888630,42
0,1125,40171,3575888588,3575888630,42
0,1125,40172,3575888588,3575888630,42
0,1125,40173,3575888588,3575888631,43
0,1125,40174,3575888588,3575888631,43
0,1125,40175,3575888588,3575888632,44
0,1125,40176,3575888588,3575888632,44
0,1125,40177,3575888588,3575888632,44
0,1125,40178,3575888588,3575888632,44
0,1125,40179,3575888588,3575888632,44
0,1125,40180,3575888588,3575888632,44
0,1125,40181,3575888588,3575888633,45
0,1125,40182,3575888588,3575888635,47
0,1125,40183,3575888588,3575888635,47
0,1125,40184,3575888588,3575888638,50
0,1126,40185,3575888653,3575888653,0
0,1126,40186,3575888653,3575888653,0
0,1126,40187,3575888653,3575888653,0
0,1126,40188,3575888653,3575888653,0
0,1126,40189,3575888653,3575888653,0
0,1126,40190,3575888653,3575888653,0
0,1126,40191,3575888653,3575888653,0
0,1126,40192,3575888653,3575888653,0
0,1126,40193,3575888653,3575888653,0
0,1126,40194,3575888653,3575888653,0
0,1126,40195,3575888653,3575888653,0
0,1126,40196,3575888653,3575888653,0
0,1126,40197,3575888653,3575888653,0
0,1126,40198,3575888653,3575888653,0
0,1126,40199,3575888653,3575888653,0
0,1126,40200,3575888653,3575888653,0
0,1126,40201,3575888653,3575888653,0
0,1126,40202,3575888653,3575888655,2
0,1126,40203,3575888653,3575888655,2
0,1126,40204,3575888653,3575888655,2
0,1126,40205,3575888653,3575888656,3
0,1126,40206,3575888653,3575888656,3
0,1126,40207,3575888653,3575888657,4
0,1126,40208,3575888653,3575888657,4
0,1126,40209,3575888653,3575888658,5
0,1126,40210,3575888653,3575888659,6
0,1126,40211,3575888653,3575888660,7
0,1126,40212,3575888653,3575888660,7
0,1126,40213,3575888653,3575888660,7
0,1126,40214,3575888653,3575888661,8
0,1126,40215,3575888653,3575888662,9
0,1126,40216,3575888653,3575888662,9
0,1126,40217,3575888653,3575888662,9
0,1126,40218,3575888653,3575888663,10
0,1126,40219,3575888653,3575888664,11
0,1126,40220,3575888653,3575888664,11
0,1126,40221,3575888653,3575888664,11
0,1126,40222,3575888653,3575888665,12
0,1126,40223,3575888653,3575888665,12
0,1126,40224,3575888653,3575888666,13
0,1126,40225,3575888653,3575888666,13
0,1126,40226,3575888653,3575888667,14
0,1126,40227,3575888653,3575888667,14
0,1126,40228,3575888653,3575888668,15
0,1126,40229,3575888653,3575888669,16
0,1126,40230,3575888653,3575888676,23
0,1126,40231,3575888653,3575888677,24
0,1126,40232,3575888653,3575888677,24
0,1126,40233,3575888653,3575888678,25
0,1126,40234,3575888653,3575888680,27
0,1126,40235,3575888653,3575888685,32
0,1126,40236,3575888653,3575888686,33
0,1126,40237,3575888653,3575888688,35
0,1126,40238,3575888653,3575888688,35
0,1126,40239,3575888653,3575888688,35
0,1126,40240,3575888653,3575888689,36
0,1126,40241,3575888653,3575888689,36
0,1126,40242,3575888653,3575888690,37
0,1126,40243,3575888653,3575888690,37
0,1126,40244,3575888653,3575888690,37
0,1126,40245,3575888653,3575888691,38
0,1126,40246,3575888653,3575888691,38
0,1126,40247,3575888653,3575888691,38
0,1126,40248,3575888653,3575888691,38
0,1126,40249,3575888653,3575888692,39
0,1126,40250,3575888653,3575888694,41
0,1126,40251,3575888653,3575888694,41
0,1126,40252,3575888653,3575888695,42
0,1126,40253,3575888653,3575888695,42
0,1126,40254,3575888653,3575888695,42
0,1126,40255,3575888653,3575888696,43
0,1126,40256,3575888653,3575888696,43
0,1126,40257,3575888653,3575888697,44
0,1126,40258,3575888653,3575888698,45
0,1126,40259,3575888653,3575888698,45
0,1126,40260,3575888653,3575888698,45
0,1126,40261,3575888653,3575888699,46
0,1126,40262,3575888653,3575888700,47
0,1126,40263,3575888653,3575888700,47
0,1126,40264,3575888653,3575888701,48
0,1126,40265,3575888653,3575888702,49
0,1127,40266,3575888716,3575888716,0
0,1127,40267,3575888716,3575888716,0
0,1127,40268,3575888716,3575888716,0
0,1127,40269,3575888716,3575888716,0
0,1127,40270,3575888716,3575888716,0
0,1127,40271,3575888716,3575888716,0
0,1127,40272,3575888716,3575888716,0
0,1127,40273,3575888716,3575888716,0
0,1127,40274,3575888716,3575888716,0
0,1127,40275,3575888716,3575888716,0
0,1127,40276,3575888716,3575888716,0
0,1127,40277,3575888716,3575888716,0
0,1127,40278,3575888716,3575888716,0
0,1127,40279,3575888716,3575888716,0
0,1127,40280,3575888716,3575888716,0
0,1127,40281,3575888716,3575888716,0
0,1127,40282,3575888716,3575888716,0
0,1127,40283,3575888716,3575888716,0
0,1127,40284,3575888716,3575888716,0
0,1127,40285,3575888716,3575888716,0
0,1127,40286,3575888716,3575888716,0
0,1127,40287,3575888716,3575888716,0
0,1127,40288,3575888716,3575888716,0
0,1127,40289,3575888716,3575888716,0
0,1127,40290,3575888716,3575888716,0
0,1127,40291,3575888716,3575888716,0
0,1127,40292,3575888716,3575888718,2
0,1127,40293,3575888716,3575888718,2
0,1127,40294,3575888716,3575888719,3
0,1127,40295,3575888716,3575888720,4
0,1127,40296,3575888716,3575888721,5
0,1127,40297,3575888716,3575888722,6
0,1127,40298,3575888716,3575888722,6
0,1127,40299,3575888716,3575888723,7
0,1127,40300,3575888716,3575888723,7
0,1127,40301,3575888716,3575888724,8
0,1127,40302,3575888716,3575888724,8
0,1127,40303,3575888716,3575888725,9
0,1127,40304,3575888716,3575888725,9
0,1127,40305,3575888716,3575888725,9
0,1127,40306,3575888716,3575888726,10
0,1127,40307,3575888716,3575888726,10
0,1127,40308,3575888716,3575888726,10
0,1127,40309,3575888716,3575888727,11
0,1127,40310,3575888716,3575888727,11
0,1127,40311,3575888716,3575888728,12
0,1127,40312,3575888716,3575888729,13
0,1127,40313,3575888716,3575888731,15
0,1127,40314,3575888716,3575888732,16
0,1127,40315,3575888716,3575888732,16
0,1127,40316,3575888716,3575888733,17
0,1127,40317,3575888716,3575888734,18
0,1127,40318,3575888716,3575888735,19
0,1127,40319,3575888716,3575888736,20
0,1127,40320,3575888716,3575888737,21
0,1127,40321,3575888716,3575888738,22
0,1127,40322,3575888716,3575888739,23
0,1127,40323,3575888716,3575888739,23
0,1127,40324,3575888716,3575888739,23
0,1127,40325,3575888716,3575888739,23
0,1127,40326,3575888716,3575888739,23
0,1127,40327,3575888716,3575888739,23
0,1127,40328,3575888716,3575888740,24
0,1127,40329,3575888716,3575888740,24
0,1127,40330,3575888716,3575888741,25
0,1127,40331,3575888716,3575888741,25
0,1127,40332,3575888716,3575888742,26
0,1127,40333,3575888716,3575888742,26
0,1127,40334,3575888716,3575888745,29
0,1127,40335,3575888716,3575888745,29
0,1127,40336,3575888716,3575888746,30
0,1127,40337,3575888716,3575888746,30
0,1127,40338,3575888716,3575888746,30
0,1127,40339,3575888716,3575888747,31
0,1127,40340,3575888716,3575888748,32
0,1127,40341,3575888716,3575888748,32
0,1127,40342,3575888716,3575888748,32
0,1127,40343,3575888716,3575888750,34
0,1127,40344,3575888716,3575888752,36
0,1127,40345,3575888716,3575888753,37
0,1127,40346,3575888716,3575888753,37
0,1127,40347,3575888716,3575888753,37
0,1127,40348,3575888716,3575888754,38
0,1127,40349,3575888716,3575888754,38
0,1127,40350,3575888716,3575888755,39
0,1127,40351,3575888716,3575888755,39
0,1127,40352,3575888716,3575888755,39
0,1127,40353,3575888716,3575888756,40
0,1127,40354,3575888716,3575888756,40
0,1127,40355,3575888716,3575888757,41
0,1127,40356,3575888716,3575888758,42
0,1127,40357,3575888716,3575888760,44
0,1127,40358,3575888716,3575888760,44
0,1127,40359,3575888716,3575888761,45
0,1127,40360,3575888716,3575888761,45
0,1127,40361,3575888716,3575888762,46
0,1127,40362,3575888716,3575888762,46
0,1127,40363,3575888716,3575888764,48
0,1127,40364,3575888716,3575888765,49
0,1127,40365,3575888716,3575888765,49
0,1127,40366,3575888716,3575888765,49
0,1127,40367,3575888716,3575888765,49
0,1127,40368,3575888716,3575888765,49
0,1127,40369,3575888716,3575888765,49
0,1128,40370,3575888782,3575888782,0
0,1128,40371,3575888782,3575888782,0
0,1128,40372,3575888782,3575888782,0
0,1128,40373,3575888782,3575888782,0
0,1128,40374,3575888782,3575888782,0
0,1128,40375,3575888782,3575888782,0
0,1128,40376,3575888782,3575888782,0
0,1128,40377,3575888782,3575888782,0
0,1128,40378,3575888782,3575888782,0
0,1128,40379,3575888782,3575888782,0
0,1128,40380,3575888782,3575888782,0
0,1128,40381,3575888782,3575888782,0
0,1128,40382,3575888782,3575888782,0
0,1128,40383,3575888782,3575888782,0
0,1128,40384,3575888782,3575888782,0
0,1128,40385,3575888782,3575888782,0
0,1128,40386,3575888782,3575888782,0
0,1128,40387,3575888782,3575888782,0
0,1128,40388,3575888782,3575888782,0
0,1128,40389,3575888782,3575888782,0
0,1128,40390,3575888782,3575888782,0
0,1128,40391,3575888782,3575888782,0
0,1128,40392,3575888782,3575888783,1
0,1128,40393,3575888782,3575888784,2
0,1128,40394,3575888782,3575888784,2
0,1128,40395,3575888782,3575888786,4
0,1128,40396,3575888782,3575888786,4
0,1128,40397,3575888782,3575888786,4
0,1128,40398,3575888782,3575888789,7
0,1128,40399,3575888782,3575888789,7
0,1128,40400,3575888782,3575888791,9
0,1128,40401,3575888782,3575888794,12
0,1128,40402,3575888782,3575888795,13
0,1128,40403,3575888782,3575888797,15
0,1128,40404,3575888782,3575888798,16
0,1128,40405,3575888782,3575888799,17
0,1128,40406,3575888782,3575888799,17
0,1128,40407,3575888782,3575888800,18
0,1128,40408,3575888782,3575888800,18
0,1128,40409,3575888782,3575888802,20
0,1128,40410,3575888782,3575888802,20
0,1128,40411,3575888782,3575888804,22
0,1128,40412,3575888782,3575888804,22
0,1128,40413,3575888782,3575888805,23
0,1128,40414,3575888782,3575888806,24
0,1128,40415,3575888782,3575888807,25
0,1128,40416,3575888782,3575888809,27
0,1128,40417,3575888782,3575888809,27
0,1128,40418,3575888782,3575888811,29
0,1128,40419,3575888782,3575888812,30
0,1128,40420,3575888782,3575888813,31
0,1128,40421,3575888782,3575888813,31
0,1128,40422,3575888782,3575888813,31
0,1128,40423,3575888782,3575888814,32
0,1128,40424,3575888782,3575888815,33
0,1128,40425,3575888782,3575888816,34
0,1128,40426,3575888782,3575888816,34
0,1128,40427,3575888782,3575888818,36
0,1128,40428,3575888782,3575888818,36
0,1128,40429,3575888782,3575888821,39
0,1128,40430,3575888782,3575888821,39
0,1128,40431,3575888782,3575888821,39
0,1128,40432,3575888782,3575888821,39
0,1128,40433,3575888782,3575888821,39
0,1128,40434,3575888782,3575888822,40
0,1128,40435,3575888782,3575888825,43
0,1128,40436,3575888782,3575888826,44
0,1128,40437,3575888782,3575888826,44
0,1128,40438,3575888782,3575888829,47
0,1128,40439,3575888782,3575888829,47
0,1128,40440,3575888782,3575888829,47
0,1128,40441,3575888782,3575888830,48
0,1128,40442,3575888782,3575888830,48
0,1128,40443,3575888782,3575888830,48
0,1128,40444,3575888782,3575888830,48
0,1128,40445,3575888782,3575888831,49
0,1128,40446,3575888782,3575888831,49
0,1128,40447,3575888782,3575888831,49
0,1128,40448,3575888782,3575888831,49
0,1128,40449,3575888782,3575888832,50
0,1129,40450,3575888844,3575888844,0
0,1129,40451,3575888844,3575888844,0
0,1129,40452,3575888844,3575888844,0
0,1129,40453,3575888844,3575888844,0
0,1129,40454,3575888844,3575888844,0
0,1129,40455,3575888844,3575888844,0
0,1129,40456,3575888844,3575888844,0
0,1129,40457,3575888844,3575888844,0
0,1129,40458,3575888844,3575888844,0
0,1129,40459,3575888844,3575888844,0
0,1129,40460,3575888844,3575888844,0
0,1129,40461,3575888844,3575888844,0
0,1129,40462,3575888844,3575888844,0
0,1129,40463,3575888844,3575888844,0
0,1129,40464,3575888844,3575888845,1
0,1129,40465,3575888844,3575888845,1
0,1129,40466,3575888844,3575888845,1
0,1129,40467,3575888844,3575888847,3
0,1129,40468,3575888844,3575888847,3
0,1129,40469,3575888844,3575888848,4
0,1129,40470,3575888844,3575888848,4
0,1129,40471,3575888844,3575888852,8
0,1129,40472,3575888844,3575888852,8
0,1129,40473,3575888844,3575888854,10
0,1129,40474,3575888844,3575888855,11
0,1129,40475,3575888844,3575888855,11
0,1129,40476,3575888844,3575888856,12
0,1129,40477,3575888844,3575888856,12
0,1129,40478,3575888844,3575888858,14
0,1129,40479,3575888844,3575888859,15
0,1129,40480,3575888844,3575888859,15
0,1129,40481,3575888844,3575888859,15
0,1129,40482,3575888844,3575888860,16
0,1129,40483,3575888844,3575888860,16
0,1129,40484,3575888844,3575888862,18
0,1129,40485,3575888844,3575888862,18
0,1129,40486,3575888844,3575888863,19
0,1129,40487,3575888844,3575888863,19
0,1129,40488,3575888844,3575888864,20
0,1129,40489,3575888844,3575888864,20
0,1129,40490,3575888844,3575888864,20
0,1129,40491,3575888844,3575888864,20
0,1129,40492,3575888844,3575888865,21
0,1129,40493,3575888844,3575888866,22
0,1129,40494,3575888844,3575888866,22
0,1129,40495,3575888844,3575888866,22
0,1129,40496,3575888844,3575888867,23
0,1129,40497,3575888844,3575888868,24
0,1129,40498,3575888844,3575888869,25
0,1129,40499,3575888844,3575888876,32
0,1129,40500,3575888844,3575888877,33
0,1129,40501,3575888844,3575888878,34
0,1129,40502,3575888844,3575888878,34
0,1129,40503,3575888844,3575888880,36
0,1129,40504,3575888844,3575888886,42
0,1129,40505,3575888844,3575888886,42
0,1129,40506,3575888844,3575888888,44
0,1129,40507,3575888844,3575888888,44
0,1129,40508,3575888844,3575888888,44
0,1129,40509,3575888844,3575888888,44
0,1129,40510,3575888844,3575888888,44
0,1129,40511,3575888844,3575888890,46
0,1129,40512,3575888844,3575888890,46
0,1129,40513,3575888844,3575888890,46
0,1129,40514,3575888844,3575888891,47
0,1129,40515,3575888844,3575888891,47
0,1129,40516,3575888844,3575888891,47
0,1129,40517,3575888844,3575888892,48
0,1129,40518,3575888844,3575888892,48
0,1129,40519,3575888844,3575888893,49
0,1129,40520,3575888844,3575888894,50
0,1130,40521,3575888908,3575888908,0
0,1130,40522,3575888908,3575888908,0
0,1130,40523,3575888908,3575888908,0
0,1130,40524,3575888908,3575888908,0
0,1130,40525,3575888908,3575888908,0
0,1130,40526,3575888908,3575888908,0
0,1130,40527,3575888908,3575888908,0
0,1130,40528,3575888908,3575888908,0
0,1130,40529,3575888908,3575888908,0
0,1130,40530,3575888908,3575888908,0
0,1130,40531,3575888908,3575888908,0
0,1130,40532,3575888908,3575888908,0
0,1130,40533,3575888908,3575888908,0
0,1130,40534,3575888908,3575888908,0
0,1130,40535,3575888908,3575888908,0
0,1130,40536,3575888908,3575888908,0
0,1130,40537,3575888908,3575888908,0
0,1130,40538,3575888908,3575888908,0
0,1130,40539,3575888908,3575888908,0
0,1130,40540,3575888908,3575888908,0
0,1130,40541,3575888908,3575888908,0
0,1130,40542,3575888908,3575888908,0
0,1130,40543,3575888908,3575888908,0
0,1130,40544,3575888908,3575888908,0
0,1130,40545,3575888908,3575888908,0
0,1130,40546,3575888908,3575888908,0
0,1130,40547,3575888908,3575888908,0
0,1130,40548,3575888908,3575888909,1
0,1130,40549,3575888908,3575888909,1
0,1130,40550,3575888908,3575888909,1
0,1130,40551,3575888908,3575888910,2
0,1130,40552,3575888908,3575888910,2
0,1130,40553,3575888908,3575888910,2
0,1130,40554,3575888908,3575888910,2
0,1130,40555,3575888908,3575888912,4
0,1130,40556,3575888908,3575888912,4
0,1130,40557,3575888908,3575888913,5
0,1130,40558,3575888908,3575888913,5
0,1130,40559,3575888908,3575888914,6
0,1130,40560,3575888908,3575888915,7
0,1130,40561,3575888908,3575888915,7
0,1130,40562,3575888908,3575888915,7
0,1130,40563,3575888908,3575888915,7
0,1130,40564,3575888908,3575888916,8
0,1130,40565,3575888908,3575888917,9
0,1130,40566,3575888908,3575888918,10
0,1130,40567,3575888908,3575888919,11
0,1130,40568,3575888908,3575888920,12
0,1130,40569,3575888908,3575888921,13
0,1130,40570,3575888908,3575888922,14
0,1130,40571,3575888908,3575888922,14
0,1130,40572,3575888908,3575888922,14
0,1130,40573,3575888908,3575888922,14
0,1130,40574,3575888908,3575888923,15
0,1130,40575,3575888908,3575888924,16
0,1130,40576,3575888908,3575888924,16
0,1130,40577,3575888908,3575888924,16
0,1130,40578,3575888908,3575888925,17
0,1130,40579,3575888908,3575888925,17
0,1130,40580,3575888908,3575888925,17
0,1130,40581,3575888908,3575888925,17
0,1130,40582,3575888908,3575888925,17
0,1130,40583,3575888908,3575888925,17
0,1130,40584,3575888908,3575888927,19
0,1130,40585,3575888908,3575888927,19
0,1130,40586,3575888908,3575888929,21
0,1130,40587,3575888908,3575888931,23
0,1130,40588,3575888908,3575888931,23
0,1130,40589,3575888908,3575888932,24
0,1130,40590,3575888908,3575888933,25
0,1130,40591,3575888908,3575888934,26
0,1130,40592,3575888908,3575888934,26
0,1130,40593,3575888908,3575888935,27
0,1130,40594,3575888908,3575888936,28
0,1130,40595,3575888908,3575888937,29
0,1130,40596,3575888908,3575888938,30
0,1130,40597,3575888908,3575888938,30
0,1130,40598,3575888908,3575888938,30
0,1130,40599,3575888908,3575888938,30
0,1130,40600,3575888908,3575888939,31
0,1130,40601,3575888908,3575888939,31
0,1130,40602,3575888908,3575888939,31
0,1130,40603,3575888908,3575888939,31
0,1130,40604,3575888908,3575888940,32
0,1130,40605,3575888908,3575888940,32
0,1130,40606,3575888908,3575888941,33
0,1130,40607,3575888908,3575888942,34
0,1130,40608,3575888908,3575888942,34
0,1130,40609,3575888908,3575888943,35
0,1130,40610,3575888908,3575888944,36
0,1130,40611,3575888908,3575888945,37
0,1130,40612,3575888908,3575888945,37
0,1130,40613,3575888908,3575888946,38
0,1130,40614,3575888908,3575888946,38
0,1130,40615,3575888908,3575888946,38
0,1130,40616,3575888908,3575888947,39
0,1130,40617,3575888908,3575888948,40
0,1130,40618,3575888908,3575888950,42
0,1130,40619,3575888908,3575888952,44
0,1130,40620,3575888908,3575888953,45
0,1130,40621,3575888908,3575888953,45
0,1130,40622,3575888908,3575888953,45
0,1130,40623,3575888908,3575888954,46
0,1130,40624,3575888908,3575888954,46
0,1130,40625,3575888908,3575888954,46
0,1130,40626,3575888908,3575888955,47
0,1130,40627,3575888908,3575888955,47
0,1130,40628,3575888908,3575888955,47
0,1130,40629,3575888908,3575888955,47
0,1130,40630,3575888908,3575888956,48
0,1130,40631,3575888908,3575888957,49
0,1131,40632,3575888972,3575888972,0
0,1131,40633,3575888972,3575888972,0
0,1131,40634,3575888972,3575888972,0
0,1131,40635,3575888972,3575888972,0
0,1131,40636,3575888972,3575888972,0
0,1131,40637,3575888972,3575888972,0
0,1131,40638,3575888972,3575888972,0
0,1131,40639,3575888972,3575888972,0
0,1131,40640,3575888972,3575888972,0
0,1131,40641,3575888972,3575888972,0
0,1131,40642,3575888972,3575888972,0
0,1131,40643,3575888972,3575888972,0
0,1131,40644,3575888972,3575888972,0
0,1131,40645,3575888972,3575888972,0
0,1131,40646,3575888972,3575888972,0
0,1131,40647,3575888972,3575888972,0
0,1131,40648,3575888972,3575888972,0
0,1131,40649,3575888972,3575888972,0
0,1131,40650,3575888972,3575888972,0
0,1131,40651,3575888972,3575888973,1
0,1131,40652,3575888972,3575888974,2
0,1131,40653,3575888972,3575888974,2
0,1131,40654,3575888972,3575888976,4
0,1131,40655,3575888972,3575888976,4
0,1131,40656,3575888972,3575888977,5
0,1131,40657,3575888972,3575888977,5
0,1131,40658,3575888972,3575888977,5
0,1131,40659,3575888972,3575888977,5
0,1131,40660,3575888972,3575888977,5
0,1131,40661,3575888972,3575888978,6
0,1131,40662,3575888972,3575888979,7
0,1131,40663,3575888972,3575888980,8
0,1131,40664,3575888972,3575888981,9
0,1131,40665,3575888972,3575888982,10
0,1131,40666,3575888972,3575888982,10
0,1131,40667,3575888972,3575888982,10
0,1131,40668,3575888972,3575888984,12
0,1131,40669,3575888972,3575888984,12
0,1131,40670,3575888972,3575888985,13
0,1131,40671,3575888972,3575888985,13
0,1131,40672,3575888972,3575888986,14
0,1131,40673,3575888972,3575888986,14
0,1131,40674,3575888972,3575888989,17
0,1131,40675,3575888972,3575888991,19
0,1131,40676,3575888972,3575888991,19
0,1131,40677,3575888972,3575888994,22
0,1131,40678,3575888972,3575888995,23
0,1131,40679,3575888972,3575888998,26
0,1131,40680,3575888972,3575888998,26
0,1131,40681,3575888972,3575888999,27
0,1131,40682,3575888972,3575889000,28
0,1131,40683,3575888972,3575889000,28
0,1131,40684,3575888972,3575889000,28
0,1131,40685,3575888972,3575889002,30
0,1131,40686,3575888972,3575889002,30
0,1131,40687,3575888972,3575889004,32
0,1131,40688,3575888972,3575889006,34
0,1131,40689,3575888972,3575889006,34
0,1131,40690,3575888972,3575889007,35
0,1131,40691,3575888972,3575889009,37
0,1131,40692,3575888972,3575889009,37
0,1131,40693,3575888972,3575889011,39
0,1131,40694,3575888972,3575889012,40
0,1131,40695,3575888972,3575889013,41
0,1131,40696,3575888972,3575889013,41
0,1131,40697,3575888972,3575889013,41
0,1131,40698,3575888972,3575889013,41
0,1131,40699,3575888972,3575889014,42
0,1131,40700,3575888972,3575889015,43
0,1131,40701,3575888972,3575889016,44
0,1131,40702,3575888972,3575889018,46
0,1131,40703,3575888972,3575889019,47
0,1131,40704,3575888972,3575889021,49
0,1131,40705,3575888972,3575889021,49
0,1131,40706,3575888972,3575889021,49
0,1131,40707,3575888972,3575889022,50
0,1132,40708,3575889034,3575889034,0
0,1132,40709,3575889034,3575889034,0
0,1132,40710,3575889034,3575889034,0
0,1132,40711,3575889034,3575889034,0
0,1132,40712,3575889034,3575889034,0
0,1132,40713,3575889034,3575889034,0
0,1132,40714,3575889034,3575889034,0
0,1132,40715,3575889034,3575889034,0
0,1132,40716,3575889034,3575889034,0
0,1132,40717,3575889034,3575889034,0
0,1132,40718,3575889034,3575889034,0
0,1132,40719,3575889034,3575889034,0
0,1132,40720,3575889034,3575889034,0
0,1132,40721,3575889034,3575889034,0
0,1132,40722,3575889034,3575889034,0
0,1132,40723,3575889034,3575889034,0
0,1132,40724,3575889034,3575889034,0
0,1132,40725,3575889034,3575889034,0
0,1132,40726,3575889034,3575889034,0
0,1132,40727,3575889034,3575889035,1
0,1132,40728,3575889034,3575889035,1
0,1132,40729,3575889034,3575889039,5
0,1132,40730,3575889034,3575889040,6
0,1132,40731,3575889034,3575889040,6
0,1132,40732,3575889034,3575889041,7
0,1132,40733,3575889034,3575889041,7
0,1132,40734,3575889034,3575889042,8
0,1132,40735,3575889034,3575889044,10
0,1132,40736,3575889034,3575889045,11
0,1132,40737,3575889034,3575889045,11
0,1132,40738,3575889034,3575889046,12
0,1132,40739,3575889034,3575889048,14
0,1132,40740,3575889034,3575889048,14
0,1132,40741,3575889034,3575889049,15
0,1132,40742,3575889034,3575889051,17
0,1132,40743,3575889034,3575889052,18
0,1132,40744,3575889034,3575889052,18
0,1132,40745,3575889034,3575889054,20
0,1132,40746,3575889034,3575889055,21
0,1132,40747,3575889034,3575889055,21
0,1132,40748,3575889034,3575889056,22
0,1132,40749,3575889034,3575889056,22
0,1132,40750,3575889034,3575889057,23
0,1132,40751,3575889034,3575889057,23
0,1132,40752,3575889034,3575889059,25
0,1132,40753,3575889034,3575889059,25
0,1132,40754,3575889034,3575889060,26
0,1132,40755,3575889034,3575889060,26
0,1132,40756,3575889034,3575889061,27
0,1132,40757,3575889034,3575889061,27
0,1132,40758,3575889034,3575889062,28
0,1132,40759,3575889034,3575889062,28
0,1132,40760,3575889034,3575889063,29
0,1132,40761,3575889034,3575889064,30
0,1132,40762,3575889034,3575889064,30
0,1132,40763,3575889034,3575889064,30
0,1132,40764,3575889034,3575889064,30
0,1132,40765,3575889034,3575889065,31
0,1132,40766,3575889034,3575889065,31
0,1132,40767,3575889034,3575889066,32
0,1132,40768,3575889034,3575889067,33
0,1132,40769,3575889034,3575889067,33
0,1132,40770,3575889034,3575889067,33
0,1132,40771,3575889034,3575889069,35
0,1132,40772,3575889034,3575889070,36
0,1132,40773,3575889034,3575889076,42
0,1132,40774,3575889034,3575889077,43
0,1132,40775,3575889034,3575889077,43
0,1132,40776,3575889034,3575889079,45
0,1132,40777,3575889034,3575889079,45
0,1132,40778,3575889034,3575889082,48
0,1133,40779,3575889098,3575889098,0
0,1133,40780,3575889098,3575889098,0
0,1133,40781,3575889098,3575889098,0
0,1133,40782,3575889098,3575889098,0
0,1133,40783,3575889098,3575889098,0
0,1133,40784,3575889098,3575889098,0
0,1133,40785,3575889098,3575889098,0
0,1133,40786,3575889098,3575889098,0
0,1133,40787,3575889098,3575889098,0
0,1133,40788,3575889098,3575889098,0
0,1133,40789,3575889098,3575889098,0
0,1133,40790,3575889098,3575889098,0
0,1133,40791,3575889098,3575889098,0
0,1133,40792,3575889098,3575889098,0
0,1133,40793,3575889098,3575889098,0
0,1133,40794,3575889098,3575889098,0
0,1133,40795,3575889098,3575889098,0
0,1133,40796,3575889098,3575889098,0
0,1133,40797,3575889098,3575889098,0
0,1133,40798,3575889098,3575889098,0
0,1133,40799,3575889098,3575889098,0
0,1133,40800,3575889098,3575889098,0
0,1133,40801,3575889098,3575889098,0
0,1133,40802,3575889098,3575889098,0
0,1133,40803,3575889098,3575889098,0
0,1133,40804,3575889098,3575889098,0
0,1133,40805,3575889098,3575889098,0
0,1133,40806,3575889098,3575889099,1
0,1133,40807,3575889098,3575889099,1
0,1133,40808,3575889098,3575889101,3
0,1133,40809,3575889098,3575889102,4
0,1133,40810,3575889098,3575889103,5
0,1133,40811,3575889098,3575889104,6
0,1133,40812,3575889098,3575889105,7
0,1133,40813,3575889098,3575889105,7
0,1133,40814,3575889098,3575889105,7
0,1133,40815,3575889098,3575889105,7
0,1133,40816,3575889098,3575889106,8
0,1133,40817,3575889098,3575889106,8
0,1133,40818,3575889098,3575889106,8
0,1133,40819,3575889098,3575889106,8
0,1133,40820,3575889098,3575889107,9
0,1133,40821,3575889098,3575889107,9
0,1133,40822,3575889098,3575889108,10
0,1133,40823,3575889098,3575889109,11
0,1133,40824,3575889098,3575889109,11
0,1133,40825,3575889098,3575889109,11
0,1133,40826,3575889098,3575889110,12
0,1133,40827,3575889098,3575889110,12
0,1133,40828,3575889098,3575889111,13
0,1133,40829,3575889098,3575889111,13
0,1133,40830,3575889098,3575889112,14
0,1133,40831,3575889098,3575889114,16
0,1133,40832,3575889098,3575889115,17
0,1133,40833,3575889098,3575889115,17
0,1133,40834,3575889098,3575889115,17
0,1133,40835,3575889098,3575889116,18
0,1133,40836,3575889098,3575889116,18
0,1133,40837,3575889098,3575889117,19
0,1133,40838,3575889098,3575889118,20
0,1133,40839,3575889098,3575889119,21
0,1133,40840,3575889098,3575889121,23
0,1133,40841,3575889098,3575889122,24
0,1133,40842,3575889098,3575889122,24
0,1133,40843,3575889098,3575889122,24
0,1133,40844,3575889098,3575889123,25
0,1133,40845,3575889098,3575889123,25
0,1133,40846,3575889098,3575889124,26
0,1133,40847,3575889098,3575889124,26
0,1133,40848,3575889098,3575889124,26
0,1133,40849,3575889098,3575889125,27
0,1133,40850,3575889098,3575889125,27
0,1133,40851,3575889098,3575889125,27
0,1133,40852,3575889098,3575889125,27
0,1133,40853,3575889098,3575889126,28
0,1133,40854,3575889098,3575889128,30
0,1133,40855,3575889098,3575889128,30
0,1133,40856,3575889098,3575889129,31
0,1133,40857,3575889098,3575889130,32
0,1133,40858,3575889098,3575889131,33
0,1133,40859,3575889098,3575889133,35
0,1133,40860,3575889098,3575889133,35
0,1133,40861,3575889098,3575889133,35
0,1133,40862,3575889098,3575889134,36
0,1133,40863,3575889098,3575889135,37
0,1133,40864,3575889098,3575889136,38
0,1133,40865,3575889098,3575889136,38
0,1133,40866,3575889098,3575889138,40
0,1133,40867,3575889098,3575889138,40
0,1133,40868,3575889098,3575889138,40
0,1133,40869,3575889098,3575889138,40
0,1133,40870,3575889098,3575889138,40
0,1133,40871,3575889098,3575889139,41
0,1133,40872,3575889098,3575889139,41
0,1133,40873,3575889098,3575889139,41
0,1133,40874,3575889098,3575889139,41
0,1133,40875,3575889098,3575889139,41
0,1133,40876,3575889098,3575889140,42
0,1133,40877,3575889098,3575889141,43
0,1133,40878,3575889098,3575889141,43
0,1133,40879,3575889098,3575889142,44
0,1133,40880,3575889098,3575889142,44
0,1133,40881,3575889098,3575889144,46
0,1133,40882,3575889098,3575889144,46
0,1133,40883,3575889098,3575889145,47
0,1133,40884,3575889098,3575889146,48
0,1133,40885,3575889098,3575889146,48
0,1133,40886,3575889098,3575889146,48
0,1133,40887,3575889098,3575889146,48
0,1133,40888,3575889098,3575889147,49
0,1133,40889,3575889098,3575889147,49
0,1134,40890,3575889162,3575889162,0
0,1134,40891,3575889162,3575889162,0
0,1134,40892,3575889162,3575889162,0
0,1134,40893,3575889162,3575889162,0
0,1134,40894,3575889162,3575889162,0
0,1134,40895,3575889162,3575889162,0
0,1134,40896,3575889162,3575889162,0
0,1134,40897,3575889162,3575889162,0
0,1134,40898,3575889162,3575889162,0
0,1134,40899,3575889162,3575889162,0
0,1134,40900,3575889162,3575889162,0
0,1134,40901,3575889162,3575889162,0
0,1134,40902,3575889162,3575889162,0
0,1134,40903,3575889162,3575889162,0
0,1134,40904,3575889162,3575889162,0
0,1134,40905,3575889162,3575889162,0
0,1134,40906,3575889162,3575889162,0
0,1134,40907,3575889162,3575889162,0
0,1134,40908,3575889162,3575889162,0
0,1134,40909,3575889162,3575889162,0
0,1134,40910,3575889162,3575889164,2
0,1134,40911,3575889162,3575889164,2
0,1134,40912,3575889162,3575889164,2
0,1134,40913,3575889162,3575889164,2
0,1134,40914,3575889162,3575889164,2
0,1134,40915,3575889162,3575889165,3
0,1134,40916,3575889162,3575889166,4
0,1134,40917,3575889162,3575889166,4
0,1134,40918,3575889162,3575889167,5
0,1134,40919,3575889162,3575889169,7
0,1134,40920,3575889162,3575889171,9
0,1134,40921,3575889162,3575889172,10
0,1134,40922,3575889162,3575889172,10
0,1134,40923,3575889162,3575889172,10
0,1134,40924,3575889162,3575889172,10
0,1134,40925,3575889162,3575889173,11
0,1134,40926,3575889162,3575889174,12
0,1134,40927,3575889162,3575889176,14
0,1134,40928,3575889162,3575889177,15
0,1134,40929,3575889162,3575889177,15
0,1134,40930,3575889162,3575889177,15
0,1134,40931,3575889162,3575889177,15
0,1134,40932,3575889162,3575889177,15
0,1134,40933,3575889162,3575889178,16
0,1134,40934,3575889162,3575889178,16
0,1134,40935,3575889162,3575889180,18
0,1134,40936,3575889162,3575889180,18
0,1134,40937,3575889162,3575889181,19
0,1134,40938,3575889162,3575889182,20
0,1134,40939,3575889162,3575889182,20
0,1134,40940,3575889162,3575889183,21
0,1134,40941,3575889162,3575889184,22
0,1134,40942,3575889162,3575889184,22
0,1134,40943,3575889162,3575889184,22
0,1134,40944,3575889162,3575889186,24
0,1134,40945,3575889162,3575889186,24
0,1134,40946,3575889162,3575889187,25
0,1134,40947,3575889162,3575889188,26
0,1134,40948,3575889162,3575889191,29
0,1134,40949,3575889162,3575889191,29
0,1134,40950,3575889162,3575889194,32
0,1134,40951,3575889162,3575889195,33
0,1134,40952,3575889162,3575889197,35
0,1134,40953,3575889162,3575889197,35
0,1134,40954,3575889162,3575889200,38
0,1134,40955,3575889162,3575889200,38
0,1134,40956,3575889162,3575889200,38
0,1134,40957,3575889162,3575889200,38
0,1134,40958,3575889162,3575889201,39
0,1134,40959,3575889162,3575889202,40
0,1134,40960,3575889162,3575889204,42
0,1134,40961,3575889162,3575889204,42
0,1134,40962,3575889162,3575889205,43
0,1134,40963,3575889162,3575889205,43
0,1134,40964,3575889162,3575889207,45
0,1134,40965,3575889162,3575889208,46
0,1134,40966,3575889162,3575889209,47
0,1134,40967,3575889162,3575889210,48
0,1134,40968,3575889162,3575889211,49
0,1135,40969,3575889227,3575889227,0
0,1135,40970,3575889227,3575889227,0
0,1135,40971,3575889227,3575889227,0
0,1135,40972,3575889227,3575889227,0
0,1135,40973,3575889227,3575889227,0
0,1135,40974,3575889227,3575889227,0
0,1135,40975,3575889227,3575889227,0
0,1135,40976,3575889227,3575889227,0
0,1135,40977,3575889227,3575889227,0
0,1135,40978,3575889227,3575889227,0
0,1135,40979,3575889227,3575889227,0
0,1135,40980,3575889227,3575889227,0
0,1135,40981,3575889227,3575889227,0
0,1135,40982,3575889227,3575889227,0
0,1135,40983,3575889227,3575889227,0
0,1135,40984,3575889227,3575889227,0
0,1135,40985,3575889227,3575889228,1
0,1135,40986,3575889227,3575889228,1
0,1135,40987,3575889227,3575889228,1
0,1135,40988,3575889227,3575889229,2
0,1135,40989,3575889227,3575889230,3
0,1135,40990,3575889227,3575889230,3
0,1135,40991,3575889227,3575889230,3
0,1135,40992,3575889227,3575889230,3
0,1135,40993,3575889227,3575889230,3
0,1135,40994,3575889227,3575889232,5
0,1135,40995,3575889227,3575889232,5
0,1135,40996,3575889227,3575889232,5
0,1135,40997,3575889227,3575889232,5
0,1135,40998,3575889227,3575889233,6
0,1135,40999,3575889227,3575889233,6
0,1135,41000,3575889227,3575889233,6
0,1135,41001,3575889227,3575889233,6
0,1135,41002,3575889227,3575889234,7
0,1135,41003,3575889227,3575889234,7
0,1135,41004,3575889227,3575889235,8
0,1135,41005,3575889227,3575889235,8
0,1135,41006,3575889227,3575889239,12
0,1135,41007,3575889227,3575889240,13
0,1135,41008,3575889227,3575889240,13
0,1135,41009,3575889227,3575889241,14
0,1135,41010,3575889227,3575889241,14
0,1135,41011,3575889227,3575889242,15
0,1135,41012,3575889227,3575889244,17
0,1135,41013,3575889227,3575889246,19
0,1135,41014,3575889227,3575889246,19
0,1135,41015,3575889227,3575889247,20
0,1135,41016,3575889227,3575889248,21
0,1135,41017,3575889227,3575889248,21
0,1135,41018,3575889227,3575889248,21
0,1135,41019,3575889227,3575889251,24
0,1135,41020,3575889227,3575889252,25
0,1135,41021,3575889227,3575889253,26
0,1135,41022,3575889227,3575889255,28
0,1135,41023,3575889227,3575889255,28
0,1135,41024,3575889227,3575889255,28
0,1135,41025,3575889227,3575889256,29
0,1135,41026,3575889227,3575889256,29
0,1135,41027,3575889227,3575889257,30
0,1135,41028,3575889227,3575889257,30
0,1135,41029,3575889227,3575889259,32
0,1135,41030,3575889227,3575889260,33
0,1135,41031,3575889227,3575889261,34
0,1135,41032,3575889227,3575889261,34
0,1135,41033,3575889227,3575889262,35
0,1135,41034,3575889227,3575889262,35
0,1135,41035,3575889227,3575889263,36
0,1135,41036,3575889227,3575889263,36
0,1135,41037,3575889227,3575889263,36
0,1135,41038,3575889227,3575889264,37
0,1135,41039,3575889227,3575889264,37
0,1135,41040,3575889227,3575889265,38
0,1135,41041,3575889227,3575889266,39
0,1135,41042,3575889227,3575889266,39
0,1135,41043,3575889227,3575889267,40
0,1135,41044,3575889227,3575889267,40
0,1135,41045,3575889227,3575889267,40
0,1135,41046,3575889227,3575889269,42
0,1135,41047,3575889227,3575889270,43
0,1135,41048,3575889227,3575889277,50
0,1136,41049,3575889289,3575889289,0
0,1136,41050,3575889289,3575889289,0
0,1136,41051,3575889289,3575889289,0
0,1136,41052,3575889289,3575889289,0
0,1136,41053,3575889289,3575889289,0
0,1136,41054,3575889289,3575889289,0
0,1136,41055,3575889289,3575889289,0
0,1136,41056,3575889289,3575889289,0
0,1136,41057,3575889289,3575889289,0
0,1136,41058,3575889289,3575889289,0
0,1136,41059,3575889289,3575889290,1
0,1136,41060,3575889289,3575889290,1
0,1136,41061,3575889289,3575889290,1
0,1136,41062,3575889289,3575889290,1
0,1136,41063,3575889289,3575889290,1
0,1136,41064,3575889289,3575889291,2
0,1136,41065,3575889289,3575889292,3
0,1136,41066,3575889289,3575889292,3
0,1136,41067,3575889289,3575889292,3
0,1136,41068,3575889289,3575889292,3
0,1136,41069,3575889289,3575889293,4
0,1136,41070,3575889289,3575889294,5
0,1136,41071,3575889289,3575889295,6
0,1136,41072,3575889289,3575889295,6
0,1136,41073,3575889289,3575889295,6
0,1136,41074,3575889289,3575889296,7
0,1136,41075,3575889289,3575889296,7
0,1136,41076,3575889289,3575889297,8
0,1136,41077,3575889289,3575889298,9
0,1136,41078,3575889289,3575889298,9
0,1136,41079,3575889289,3575889298,9
0,1136,41080,3575889289,3575889299,10
0,1136,41081,3575889289,3575889299,10
0,1136,41082,3575889289,3575889299,10
0,1136,41083,3575889289,3575889301,12
0,1136,41084,3575889289,3575889302,13
0,1136,41085,3575889289,3575889302,13
0,1136,41086,3575889289,3575889303,14
0,1136,41087,3575889289,3575889304,15
0,1136,41088,3575889289,3575889305,16
0,1136,41089,3575889289,3575889306,17
0,1136,41090,3575889289,3575889306,17
0,1136,41091,3575889289,3575889306,17
0,1136,41092,3575889289,3575889306,17
0,1136,41093,3575889289,3575889306,17
0,1136,41094,3575889289,3575889307,18
0,1136,41095,3575889289,3575889307,18
0,1136,41096,3575889289,3575889308,19
0,1136,41097,3575889289,3575889308,19
0,1136,41098,3575889289,3575889309,20
0,1136,41099,3575889289,3575889309,20
0,1136,41100,3575889289,3575889309,20
0,1136,41101,3575889289,3575889310,21
0,1136,41102,3575889289,3575889310,21
0,1136,41103,3575889289,3575889311,22
0,1136,41104,3575889289,3575889312,23
0,1136,41105,3575889289,3575889313,24
0,1136,41106,3575889289,3575889313,24
0,1136,41107,3575889289,3575889314,25
0,1136,41108,3575889289,3575889315,26
0,1136,41109,3575889289,3575889315,26
0,1136,41110,3575889289,3575889315,26
0,1136,41111,3575889289,3575889316,27
0,1136,41112,3575889289,3575889317,28
0,1136,41113,3575889289,3575889319,30
0,1136,41114,3575889289,3575889320,31
0,1136,41115,3575889289,3575889320,31
0,1136,41116,3575889289,3575889320,31
0,1136,41117,3575889289,3575889322,33
0,1136,41118,3575889289,3575889322,33
0,1136,41119,3575889289,3575889322,33
0,1136,41120,3575889289,3575889323,34
0,1136,41121,3575889289,3575889323,34
0,1136,41122,3575889289,3575889324,35
0,1136,41123,3575889289,3575889324,35
0,1136,41124,3575889289,3575889325,36
0,1136,41125,3575889289,3575889325,36
0,1136,41126,3575889289,3575889325,36
0,1136,41127,3575889289,3575889325,36
0,1136,41128,3575889289,3575889326,37
0,1136,41129,3575889289,3575889326,37
0,1136,41130,3575889289,3575889326,37
0,1136,41131,3575889289,3575889327,38
0,1136,41132,3575889289,3575889328,39
0,1136,41133,3575889289,3575889329,40
0,1136,41134,3575889289,3575889329,40
0,1136,41135,3575889289,3575889331,42
0,1136,41136,3575889289,3575889333,44
0,1136,41137,3575889289,3575889333,44
0,1136,41138,3575889289,3575889333,44
0,1136,41139,3575889289,3575889334,45
0,1136,41140,3575889289,3575889335,46
0,1136,41141,3575889289,3575889336,47
0,1136,41142,3575889289,3575889336,47
0,1136,41143,3575889289,3575889338,49
0,1136,41144,3575889289,3575889338,49
0,1136,41145,3575889289,3575889338,49
0,1136,41146,3575889289,3575889338,49
0,1136,41147,3575889289,3575889339,50
0,1137,41148,3575889352,3575889352,0
0,1137,41149,3575889352,3575889352,0
0,1137,41150,3575889352,3575889352,0
0,1137,41151,3575889352,3575889352,0
0,1137,41152,3575889352,3575889352,0
0,1137,41153,3575889352,3575889352,0
0,1137,41154,3575889352,3575889352,0
0,1137,41155,3575889352,3575889352,0
0,1137,41156,3575889352,3575889352,0
0,1137,41157,3575889352,3575889352,0
0,1137,41158,3575889352,3575889352,0
0,1137,41159,3575889352,3575889352,0
0,1137,41160,3575889352,3575889352,0
0,1137,41161,3575889352,3575889352,0
0,1137,41162,3575889352,3575889352,0
0,1137,41163,3575889352,3575889352,0
0,1137,41164,3575889352,3575889352,0
0,1137,41165,3575889352,3575889353,1
0,1137,41166,3575889352,3575889353,1
0,1137,41167,3575889352,3575889354,2
0,1137,41168,3575889352,3575889354,2
0,1137,41169,3575889352,3575889354,2
0,1137,41170,3575889352,3575889355,3
0,1137,41171,3575889352,3575889356,4
0,1137,41172,3575889352,3575889357,5
0,1137,41173,3575889352,3575889357,5
0,1137,41174,3575889352,3575889358,6
0,1137,41175,3575889352,3575889358,6
0,1137,41176,3575889352,3575889361,9
0,1137,41177,3575889352,3575889361,9
0,1137,41178,3575889352,3575889361,9
0,1137,41179,3575889352,3575889362,10
0,1137,41180,3575889352,3575889363,11
0,1137,41181,3575889352,3575889364,12
0,1137,41182,3575889352,3575889364,12
0,1137,41183,3575889352,3575889364,12
0,1137,41184,3575889352,3575889365,13
0,1137,41185,3575889352,3575889365,13
0,1137,41186,3575889352,3575889366,14
0,1137,41187,3575889352,3575889366,14
0,1137,41188,3575889352,3575889367,15
0,1137,41189,3575889352,3575889368,16
0,1137,41190,3575889352,3575889371,19
0,1137,41191,3575889352,3575889372,20
0,1137,41192,3575889352,3575889372,20
0,1137,41193,3575889352,3575889373,21
0,1137,41194,3575889352,3575889374,22
0,1137,41195,3575889352,3575889374,22
0,1137,41196,3575889352,3575889377,25
0,1137,41197,3575889352,3575889377,25
0,1137,41198,3575889352,3575889377,25
0,1137,41199,3575889352,3575889377,25
0,1137,41200,3575889352,3575889377,25
0,1137,41201,3575889352,3575889377,25
0,1137,41202,3575889352,3575889378,26
0,1137,41203,3575889352,3575889378,26
0,1137,41204,3575889352,3575889380,28
0,1137,41205,3575889352,3575889380,28
0,1137,41206,3575889352,3575889381,29
0,1137,41207,3575889352,3575889383,31
0,1137,41208,3575889352,3575889383,31
0,1137,41209,3575889352,3575889384,32
0,1137,41210,3575889352,3575889384,32
0,1137,41211,3575889352,3575889384,32
0,1137,41212,3575889352,3575889385,33
0,1137,41213,3575889352,3575889386,34
0,1137,41214,3575889352,3575889386,34
0,1137,41215,3575889352,3575889386,34
0,1137,41216,3575889352,3575889388,36
0,1137,41217,3575889352,3575889390,38
0,1137,41218,3575889352,3575889391,39
0,1137,41219,3575889352,3575889394,42
0,1137,41220,3575889352,3575889395,43
0,1137,41221,3575889352,3575889397,45
0,1137,41222,3575889352,3575889399,47
0,1137,41223,3575889352,3575889400,48
0,1137,41224,3575889352,3575889400,48
0,1137,41225,3575889352,3575889400,48
0,1137,41226,3575889352,3575889401,49
0,1137,41227,3575889352,3575889402,50
0,1138,41228,3575889415,3575889415,0
0,1138,41229,3575889415,3575889415,0
0,1138,41230,3575889415,3575889415,0
0,1138,41231,3575889415,3575889415,0
0,1138,41232,3575889415,3575889415,0
0,1138,41233,3575889415,3575889415,0
0,1138,41234,3575889415,3575889415,0
0,1138,41235,3575889415,3575889415,0
0,1138,41236,3575889415,3575889415,0
0,1138,41237,3575889415,3575889415,0
0,1138,41238,3575889415,3575889415,0
0,1138,41239,3575889415,3575889415,0
0,1138,41240,3575889415,3575889416,1
0,1138,41241,3575889415,3575889416,1
0,1138,41242,3575889415,3575889417,2
0,1138,41243,3575889415,3575889419,4
0,1138,41244,3575889415,3575889420,5
0,1138,41245,3575889415,3575889421,6
0,1138,41246,3575889415,3575889421,6
0,1138,41247,3575889415,3575889422,7
0,1138,41248,3575889415,3575889422,7
0,1138,41249,3575889415,3575889422,7
0,1138,41250,3575889415,3575889423,8
0,1138,41251,3575889415,3575889423,8
0,1138,41252,3575889415,3575889425,10
0,1138,41253,3575889415,3575889429,14
0,1138,41254,3575889415,3575889429,14
0,1138,41255,3575889415,3575889429,14
0,1138,41256,3575889415,3575889429,14
0,1138,41257,3575889415,3575889430,15
0,1138,41258,3575889415,3575889430,15
0,1138,41259,3575889415,3575889430,15
0,1138,41260,3575889415,3575889432,17
0,1138,41261,3575889415,3575889432,17
0,1138,41262,3575889415,3575889432,17
0,1138,41263,3575889415,3575889432,17
0,1138,41264,3575889415,3575889432,17
0,1138,41265,3575889415,3575889433,18
0,1138,41266,3575889415,3575889433,18
0,1138,41267,3575889415,3575889433,18
0,1138,41268,3575889415,3575889433,18
0,1138,41269,3575889415,3575889434,19
0,1138,41270,3575889415,3575889434,19
0,1138,41271,3575889415,3575889434,19
0,1138,41272,3575889415,3575889434,19
0,1138,41273,3575889415,3575889436,21
0,1138,41274,3575889415,3575889439,24
0,1138,41275,3575889415,3575889440,25
0,1138,41276,3575889415,3575889441,26
0,1138,41277,3575889415,3575889441,26
0,1138,41278,3575889415,3575889442,27
0,1138,41279,3575889415,3575889442,27
0,1138,41280,3575889415,3575889444,29
0,1138,41281,3575889415,3575889446,31
0,1138,41282,3575889415,3575889446,31
0,1138,41283,3575889415,3575889448,33
0,1138,41284,3575889415,3575889448,33
0,1138,41285,3575889415,3575889448,33
0,1138,41286,3575889415,3575889449,34
0,1138,41287,3575889415,3575889452,37
0,1138,41288,3575889415,3575889452,37
0,1138,41289,3575889415,3575889453,38
0,1138,41290,3575889415,3575889455,40
0,1138,41291,3575889415,3575889456,41
0,1138,41292,3575889415,3575889456,41
0,1138,41293,3575889415,3575889456,41
0,1138,41294,3575889415,3575889457,42
0,1138,41295,3575889415,3575889458,43
0,1138,41296,3575889415,3575889460,45
0,1138,41297,3575889415,3575889461,46
0,1138,41298,3575889415,3575889461,46
0,1138,41299,3575889415,3575889461,46
0,1138,41300,3575889415,3575889462,47
0,1138,41301,3575889415,3575889464,49
0,1138,41302,3575889415,3575889465,50
0,1139,41303,3575889478,3575889478,0
0,1139,41304,3575889478,3575889478,0
0,1139,41305,3575889478,3575889478,0
0,1139,41306,3575889478,3575889478,0
0,1139,41307,3575889478,3575889478,0
0,1139,41308,3575889478,3575889478,0
0,1139,41309,3575889478,3575889478,0
0,1139,41310,3575889478,3575889478,0
0,1139,41311,3575889478,3575889478,0
0,1139,41312,3575889478,3575889478,0
0,1139,41313,3575889478,3575889478,0
0,1139,41314,3575889478,3575889479,1
0,1139,41315,3575889478,3575889480,2
0,1139,41316,3575889478,3575889482,4
0,1139,41317,3575889478,3575889487,9
0,1139,41318,3575889478,3575889487,9
0,1139,41319,3575889478,3575889488,10
0,1139,41320,3575889478,3575889488,10
0,1139,41321,3575889478,3575889489,11
0,1139,41322,3575889478,3575889489,11
0,1139,41323,3575889478,3575889489,11
0,1139,41324,3575889478,3575889489,11
0,1139,41325,3575889478,3575889490,12
0,1139,41326,3575889478,3575889491,13
0,1139,41327,3575889478,3575889491,13
0,1139,41328,3575889478,3575889491,13
0,1139,41329,3575889478,3575889491,13
0,1139,41330,3575889478,3575889492,14
0,1139,41331,3575889478,3575889493,15
0,1139,41332,3575889478,3575889494,16
0,1139,41333,3575889478,3575889494,16
0,1139,41334,3575889478,3575889494,16
0,1139,41335,3575889478,3575889495,17
0,1139,41336,3575889478,3575889497,19
0,1139,41337,3575889478,3575889498,20
0,1139,41338,3575889478,3575889498,20
0,1139,41339,3575889478,3575889498,20
0,1139,41340,3575889478,3575889498,20
0,1139,41341,3575889478,3575889498,20
0,1139,41342,3575889478,3575889501,23
0,1139,41343,3575889478,3575889501,23
0,1139,41344,3575889478,3575889501,23
0,1139,41345,3575889478,3575889503,25
0,1139,41346,3575889478,3575889503,25
0,1139,41347,3575889478,3575889504,26
0,1139,41348,3575889478,3575889505,27
0,1139,41349,3575889478,3575889505,27
0,1139,41350,3575889478,3575889506,28
0,1139,41351,3575889478,3575889506,28
0,1139,41352,3575889478,3575889506,28
0,1139,41353,3575889478,3575889507,29
0,1139,41354,3575889478,3575889507,29
0,1139,41355,3575889478,3575889508,30
0,1139,41356,3575889478,3575889508,30
0,1139,41357,3575889478,3575889508,30
0,1139,41358,3575889478,3575889508,30
0,1139,41359,3575889478,3575889509,31
0,1139,41360,3575889478,3575889511,33
0,1139,41361,3575889478,3575889511,33
0,1139,41362,3575889478,3575889511,33
0,1139,41363,3575889478,3575889511,33
0,1139,41364,3575889478,3575889512,34
0,1139,41365,3575889478,3575889512,34
0,1139,41366,3575889478,3575889514,36
0,1139,41367,3575889478,3575889515,37
0,1139,41368,3575889478,3575889515,37
0,1139,41369,3575889478,3575889515,37
0,1139,41370,3575889478,3575889515,37
0,1139,41371,3575889478,3575889516,38
0,1139,41372,3575889478,3575889516,38
0,1139,41373,3575889478,3575889517,39
0,1139,41374,3575889478,3575889519,41
0,1139,41375,3575889478,3575889519,41
0,1139,41376,3575889478,3575889519,41
0,1139,41377,3575889478,3575889520,42
0,1139,41378,3575889478,3575889521,43
0,1139,41379,3575889478,3575889521,43
0,1139,41380,3575889478,3575889521,43
0,1139,41381,3575889478,3575889522,44
0,1139,41382,3575889478,3575889522,44
0,1139,41383,3575889478,3575889524,46
0,1139,41384,3575889478,3575889524,46
0,1139,41385,3575889478,3575889524,46
0,1139,41386,3575889478,3575889524,46
0,1139,41387,3575889478,3575889525,47
0,1139,41388,3575889478,3575889525,47
0,1139,41389,3575889478,3575889525,47
0,1139,41390,3575889478,3575889525,47
0,1139,41391,3575889478,3575889525,47
0,1139,41392,3575889478,3575889525,47
0,1139,41393,3575889478,3575889527,49
0,1139,41394,3575889478,3575889528,50
0,1140,41395,3575889640,3575889640,0
0,1140,41396,3575889640,3575889640,0
0,1140,41397,3575889640,3575889640,0
0,1140,41398,3575889640,3575889640,0
0,1140,41399,3575889640,3575889640,0
0,1140,41400,3575889640,3575889640,0
0,1140,41401,3575889640,3575889640,0
0,1140,41402,3575889640,3575889640,0
0,1140,41403,3575889640,3575889640,0
0,1140,41404,3575889640,3575889640,0
0,1140,41405,3575889640,3575889640,0
0,1140,41406,3575889640,3575889640,0
0,1140,41407,3575889640,3575889640,0
0,1140,41408,3575889640,3575889640,0
0,1140,41409,3575889640,3575889640,0
0,1140,41410,3575889640,3575889641,1
0,1140,41411,3575889640,3575889641,1
0,1140,41412,3575889640,3575889641,1
0,1140,41413,3575889640,3575889641,1
0,1140,41414,3575889640,3575889641,1
0,1140,41415,3575889640,3575889641,1
0,1140,41416,3575889640,3575889641,1
0,1140,41417,3575889640,3575889641,1
0,1140,41418,3575889640,3575889641,1
0,1140,41419,3575889640,3575889641,1
0,1140,41420,3575889640,3575889641,1
0,1140,41421,3575889640,3575889641,1
0,1140,41422,3575889640,3575889641,1
0,1140,41423,3575889640,3575889641,1
0,1140,41424,3575889640,3575889641,1
0,1140,41425,3575889640,3575889641,1
0,1140,41426,3575889640,3575889641,1
0,1140,41427,3575889640,3575889641,1
0,1140,41428,3575889640,3575889641,1
0,1140,41429,3575889640,3575889641,1
0,1140,41430,3575889640,3575889641,1
0,1140,41431,3575889640,3575889641,1
0,1140,41432,3575889640,3575889641,1
0,1140,41433,3575889640,3575889641,1
0,1140,41434,3575889640,3575889641,1
0,1140,41435,3575889640,3575889641,1
0,1140,41436,3575889640,3575889641,1
0,1140,41437,3575889640,3575889641,1
0,1140,41438,3575889640,3575889641,1
0,1140,41439,3575889640,3575889641,1
0,1140,41440,3575889640,3575889641,1
0,1140,41441,3575889640,3575889641,1
0,1140,41442,3575889640,3575889641,1
0,1140,41443,3575889640,3575889641,1
0,1140,41444,3575889640,3575889641,1
0,1140,41445,3575889640,3575889641,1
0,1140,41446,3575889640,3575889641,1
0,1140,41447,3575889640,3575889641,1
0,1140,41448,3575889640,3575889641,1
0,1140,41449,3575889640,3575889641,1
0,1140,41450,3575889640,3575889641,1
0,1140,41451,3575889640,3575889641,1
0,1140,41452,3575889640,3575889641,1
0,1140,41453,3575889640,3575889641,1
0,1140,41454,3575889640,3575889641,1
0,1140,41455,3575889640,3575889641,1
0,1140,41456,3575889640,3575889641,1
0,1140,41457,3575889640,3575889641,1
0,1140,41458,3575889640,3575889641,1
0,1140,41459,3575889640,3575889641,1
0,1140,41460,3575889640,3575889641,1
0,1140,41461,3575889640,3575889641,1
0,1140,41462,3575889640,3575889641,1
0,1140,41463,3575889640,3575889641,1
0,1140,41464,3575889640,3575889641,1
0,1140,41465,3575889640,3575889641,1
0,1140,41466,3575889640,3575889641,1
0,1140,41467,3575889640,3575889641,1
0,1140,41468,3575889640,3575889641,1
0,1140,41469,3575889640,3575889641,1
0,1140,41470,3575889640,3575889641,1
0,1140,41471,3575889640,3575889641,1
0,1140,41472,3575889640,3575889641,1
0,1140,41473,3575889640,3575889641,1
0,1140,41474,3575889640,3575889641,1
0,1140,41475,3575889640,3575889641,1
0,1140,41476,3575889640,3575889641,1
0,1140,41477,3575889640,3575889641,1
0,1140,41478,3575889640,3575889641,1
0,1140,41479,3575889640,3575889641,1
0,1140,41480,3575889640,3575889641,1
0,1140,41481,3575889640,3575889641,1
0,1140,41482,3575889640,3575889641,1
0,1140,41483,3575889640,3575889641,1
0,1140,41484,3575889640,3575889641,1
0,1140,41485,3575889640,3575889641,1
0,1140,41486,3575889640,3575889641,1
0,1140,41487,3575889640,3575889641,1
0,1140,41488,3575889640,3575889641,1
0,1140,41489,3575889640,3575889641,1
0,1140,41490,3575889640,3575889641,1
0,1140,41491,3575889640,3575889641,1
0,1140,41492,3575889640,3575889641,1
0,1140,41493,3575889640,3575889641,1
0,1140,41494,3575889640,3575889641,1
0,1140,41495,3575889640,3575889641,1
0,1140,41496,3575889640,3575889641,1
0,1140,41497,3575889640,3575889641,1
0,1140,41498,3575889640,3575889641,1
0,1140,41499,3575889640,3575889641,1
0,1140,41500,3575889640,3575889641,1
0,1140,41501,3575889640,3575889641,1
0,1140,41502,3575889640,3575889641,1
0,1140,41503,3575889640,3575889641,1
0,1140,41504,3575889640,3575889641,1
0,1140,41505,3575889640,3575889641,1
0,1140,41506,3575889640,3575889641,1
0,1140,41507,3575889640,3575889641,1
0,1140,41508,3575889640,3575889642,2
0,1140,41509,3575889640,3575889642,2
0,1140,41510,3575889640,3575889642,2
0,1140,41511,3575889640,3575889642,2
0,1140,41512,3575889640,3575889642,2
0,1140,41513,3575889640,3575889642,2
0,1140,41514,3575889640,3575889642,2
0,1140,41515,3575889640,3575889642,2
0,1140,41516,3575889640,3575889642,2
0,1140,41517,3575889640,3575889642,2
0,1140,41518,3575889640,3575889642,2
0,1140,41519,3575889640,3575889642,2
0,1140,41520,3575889640,3575889642,2
0,1140,41521,3575889640,3575889642,2
0,1140,41522,3575889640,3575889642,2
0,1140,41523,3575889640,3575889642,2
0,1140,41524,3575889640,3575889642,2
0,1140,41525,3575889640,3575889642,2
0,1140,41526,3575889640,3575889642,2
0,1140,41527,3575889640,3575889642,2
0,1140,41528,3575889640,3575889642,2
0,1140,41529,3575889640,3575889642,2
0,1140,41530,3575889640,3575889642,2
0,1140,41531,3575889640,3575889642,2
0,1140,41532,3575889640,3575889642,2
0,1140,41533,3575889640,3575889642,2
0,1140,41534,3575889640,3575889642,2
0,1140,41535,3575889640,3575889644,4
0,1140,41536,3575889640,3575889645,5
0,1140,41537,3575889640,3575889645,5
0,1140,41538,3575889640,3575889647,7
0,1140,41539,3575889640,3575889647,7
0,1140,41540,3575889640,3575889647,7
0,1140,41541,3575889640,3575889651,11
0,1140,41542,3575889640,3575889651,11
0,1140,41543,3575889640,3575889654,14
0,1140,41544,3575889640,3575889654,14
0,1140,41545,3575889640,3575889655,15
0,1140,41546,3575889640,3575889655,15
0,1140,41547,3575889640,3575889655,15
0,1140,41548,3575889640,3575889655,15
0,1140,41549,3575889640,3575889656,16
0,1140,41550,3575889640,3575889658,18
0,1140,41551,3575889640,3575889660,20
0,1140,41552,3575889640,3575889660,20
0,1140,41553,3575889640,3575889660,20
0,1140,41554,3575889640,3575889660,20
0,1140,41555,3575889640,3575889661,21
0,1140,41556,3575889640,3575889661,21
0,1140,41557,3575889640,3575889662,22
0,1140,41558,3575889640,3575889664,24
0,1140,41559,3575889640,3575889664,24
0,1140,41560,3575889640,3575889664,24
0,1140,41561,3575889640,3575889664,24
0,1140,41562,3575889640,3575889665,25
0,1140,41563,3575889640,3575889665,25
0,1140,41564,3575889640,3575889666,26
0,1140,41565,3575889640,3575889666,26
0,1140,41566,3575889640,3575889666,26
0,1140,41567,3575889640,3575889668,28
0,1140,41568,3575889640,3575889669,29
0,1140,41569,3575889640,3575889677,37
0,1140,41570,3575889640,3575889677,37
0,1140,41571,3575889640,3575889679,39
0,1140,41572,3575889640,3575889680,40
0,1140,41573,3575889640,3575889683,43
0,1140,41574,3575889640,3575889687,47
0,1140,41575,3575889640,3575889687,47
0,1140,41576,3575889640,3575889688,48
0,1140,41577,3575889640,3575889688,48
0,1140,41578,3575889640,3575889689,49
0,1140,41579,3575889640,3575889689,49
0,1140,41580,3575889640,3575889689,49
0,1140,41581,3575889640,3575889690,50
0,1141,41582,3575889702,3575889702,0
0,1141,41583,3575889702,3575889702,0
0,1141,41584,3575889702,3575889702,0
0,1141,41585,3575889702,3575889702,0
0,1141,41586,3575889702,3575889702,0
0,1141,41587,3575889702,3575889702,0
0,1141,41588,3575889702,3575889702,0
0,1141,41589,3575889702,3575889702,0
0,1141,41590,3575889702,3575889702,0
0,1141,41591,3575889702,3575889702,0
0,1141,41592,3575889702,3575889702,0
0,1141,41593,3575889702,3575889702,0
0,1141,41594,3575889702,3575889702,0
0,1141,41595,3575889702,3575889702,0
0,1141,41596,3575889702,3575889702,0
0,1141,41597,3575889702,3575889702,0
0,1141,41598,3575889702,3575889702,0
0,1141,41599,3575889702,3575889702,0
0,1141,41600,3575889702,3575889702,0
0,1141,41601,3575889702,3575889702,0
0,1141,41602,3575889702,3575889702,0
0,1141,41603,3575889702,3575889702,0
0,1141,41604,3575889702,3575889703,1
0,1141,41605,3575889702,3575889704,2
0,1141,41606,3575889702,3575889704,2
0,1141,41607,3575889702,3575889704,2
0,1141,41608,3575889702,3575889705,3
0,1141,41609,3575889702,3575889706,4
0,1141,41610,3575889702,3575889706,4
0,1141,41611,3575889702,3575889707,5
0,1141,41612,3575889702,3575889707,5
0,1141,41613,3575889702,3575889707,5
0,1141,41614,3575889702,3575889708,6
0,1141,41615,3575889702,3575889708,6
0,1141,41616,3575889702,3575889708,6
0,1141,41617,3575889702,3575889708,6
0,1141,41618,3575889702,3575889708,6
0,1141,41619,3575889702,3575889710,8
0,1141,41620,3575889702,3575889710,8
0,1141,41621,3575889702,3575889710,8
0,1141,41622,3575889702,3575889710,8
0,1141,41623,3575889702,3575889710,8
0,1141,41624,3575889702,3575889712,10
0,1141,41625,3575889702,3575889712,10
0,1141,41626,3575889702,3575889714,12
0,1141,41627,3575889702,3575889714,12
0,1141,41628,3575889702,3575889715,13
0,1141,41629,3575889702,3575889715,13
0,1141,41630,3575889702,3575889715,13
0,1141,41631,3575889702,3575889715,13
0,1141,41632,3575889702,3575889716,14
0,1141,41633,3575889702,3575889717,15
0,1141,41634,3575889702,3575889719,17
0,1141,41635,3575889702,3575889720,18
0,1141,41636,3575889702,3575889720,18
0,1141,41637,3575889702,3575889721,19
0,1141,41638,3575889702,3575889721,19
0,1141,41639,3575889702,3575889721,19
0,1141,41640,3575889702,3575889723,21
0,1141,41641,3575889702,3575889724,22
0,1141,41642,3575889702,3575889724,22
0,1141,41643,3575889702,3575889724,22
0,1141,41644,3575889702,3575889725,23
0,1141,41645,3575889702,3575889725,23
0,1141,41646,3575889702,3575889725,23
0,1141,41647,3575889702,3575889725,23
0,1141,41648,3575889702,3575889725,23
0,1141,41649,3575889702,3575889725,23
0,1141,41650,3575889702,3575889726,24
0,1141,41651,3575889702,3575889727,25
0,1141,41652,3575889702,3575889729,27
0,1141,41653,3575889702,3575889730,28
0,1141,41654,3575889702,3575889732,30
0,1141,41655,3575889702,3575889732,30
0,1141,41656,3575889702,3575889733,31
0,1141,41657,3575889702,3575889734,32
0,1141,41658,3575889702,3575889734,32
0,1141,41659,3575889702,3575889736,34
0,1141,41660,3575889702,3575889738,36
0,1141,41661,3575889702,3575889738,36
0,1141,41662,3575889702,3575889738,36
0,1141,41663,3575889702,3575889739,37
0,1141,41664,3575889702,3575889739,37
0,1141,41665,3575889702,3575889739,37
0,1141,41666,3575889702,3575889739,37
0,1141,41667,3575889702,3575889740,38
0,1141,41668,3575889702,3575889741,39
0,1141,41669,3575889702,3575889741,39
0,1141,41670,3575889702,3575889741,39
0,1141,41671,3575889702,3575889742,40
0,1141,41672,3575889702,3575889743,41
0,1141,41673,3575889702,3575889745,43
0,1141,41674,3575889702,3575889745,43
0,1141,41675,3575889702,3575889746,44
0,1141,41676,3575889702,3575889746,44
0,1141,41677,3575889702,3575889746,44
0,1141,41678,3575889702,3575889747,45
0,1141,41679,3575889702,3575889747,45
0,1141,41680,3575889702,3575889748,46
0,1141,41681,3575889702,3575889748,46
0,1141,41682,3575889702,3575889751,49
0,1141,41683,3575889702,3575889752,50
0,1141,41684,3575889702,3575889752,50
0,1142,41685,3575889769,3575889769,0
0,1142,41686,3575889769,3575889769,0
0,1142,41687,3575889769,3575889769,0
0,1142,41688,3575889769,3575889769,0
0,1142,41689,3575889769,3575889769,0
0,1142,41690,3575889769,3575889769,0
0,1142,41691,3575889769,3575889769,0
0,1142,41692,3575889769,3575889769,0
0,1142,41693,3575889769,3575889769,0
0,1142,41694,3575889769,3575889769,0
0,1142,41695,3575889769,3575889769,0
0,1142,41696,3575889769,3575889769,0
0,1142,41697,3575889769,3575889769,0
0,1142,41698,3575889769,3575889769,0
0,1142,41699,3575889769,3575889769,0
0,1142,41700,3575889769,3575889769,0
0,1142,41701,3575889769,3575889769,0
0,1142,41702,3575889769,3575889769,0
0,1142,41703,3575889769,3575889769,0
0,1142,41704,3575889769,3575889769,0
0,1142,41705,3575889769,3575889769,0
0,1142,41706,3575889769,3575889770,1
0,1142,41707,3575889769,3575889771,2
0,1142,41708,3575889769,3575889771,2
0,1142,41709,3575889769,3575889771,2
0,1142,41710,3575889769,3575889772,3
0,1142,41711,3575889769,3575889772,3
0,1142,41712,3575889769,3575889772,3
0,1142,41713,3575889769,3575889773,4
0,1142,41714,3575889769,3575889775,6
0,1142,41715,3575889769,3575889776,7
0,1142,41716,3575889769,3575889776,7
0,1142,41717,3575889769,3575889776,7
0,1142,41718,3575889769,3575889776,7
0,1142,41719,3575889769,3575889777,8
0,1142,41720,3575889769,3575889777,8
0,1142,41721,3575889769,3575889777,8
0,1142,41722,3575889769,3575889778,9
0,1142,41723,3575889769,3575889779,10
0,1142,41724,3575889769,3575889780,11
0,1142,41725,3575889769,3575889780,11
0,1142,41726,3575889769,3575889782,13
0,1142,41727,3575889769,3575889782,13
0,1142,41728,3575889769,3575889783,14
0,1142,41729,3575889769,3575889784,15
0,1142,41730,3575889769,3575889784,15
0,1142,41731,3575889769,3575889784,15
0,1142,41732,3575889769,3575889786,17
0,1142,41733,3575889769,3575889786,17
0,1142,41734,3575889769,3575889786,17
0,1142,41735,3575889769,3575889788,19
0,1142,41736,3575889769,3575889790,21
0,1142,41737,3575889769,3575889790,21
0,1142,41738,3575889769,3575889793,24
0,1142,41739,3575889769,3575889794,25
0,1142,41740,3575889769,3575889797,28
0,1142,41741,3575889769,3575889798,29
0,1142,41742,3575889769,3575889800,31
0,1142,41743,3575889769,3575889800,31
0,1142,41744,3575889769,3575889801,32
0,1142,41745,3575889769,3575889801,32
0,1142,41746,3575889769,3575889801,32
0,1142,41747,3575889769,3575889803,34
0,1142,41748,3575889769,3575889804,35
0,1142,41749,3575889769,3575889804,35
0,1142,41750,3575889769,3575889806,37
0,1142,41751,3575889769,3575889810,41
0,1142,41752,3575889769,3575889812,43
0,1142,41753,3575889769,3575889812,43
0,1142,41754,3575889769,3575889813,44
0,1142,41755,3575889769,3575889813,44
0,1142,41756,3575889769,3575889814,45
0,1142,41757,3575889769,3575889814,45
0,1142,41758,3575889769,3575889815,46
0,1142,41759,3575889769,3575889816,47
0,1142,41760,3575889769,3575889818,49
0,1142,41761,3575889769,3575889818,49
0,1142,41762,3575889769,3575889819,50
0,1143,41763,3575889831,3575889831,0
0,1143,41764,3575889831,3575889831,0
0,1143,41765,3575889831,3575889831,0
0,1143,41766,3575889831,3575889831,0
0,1143,41767,3575889831,3575889831,0
0,1143,41768,3575889831,3575889831,0
0,1143,41769,3575889831,3575889831,0
0,1143,41770,3575889831,3575889831,0
0,1143,41771,3575889831,3575889831,0
0,1143,41772,3575889831,3575889831,0
0,1143,41773,3575889831,3575889831,0
0,1143,41774,3575889831,3575889831,0
0,1143,41775,3575889831,3575889831,0
0,1143,41776,3575889831,3575889831,0
0,1143,41777,3575889831,3575889831,0
0,1143,41778,3575889831,3575889831,0
0,1143,41779,3575889831,3575889831,0
0,1143,41780,3575889831,3575889831,0
0,1143,41781,3575889831,3575889832,1
0,1143,41782,3575889831,3575889832,1
0,1143,41783,3575889831,3575889832,1
0,1143,41784,3575889831,3575889832,1
0,1143,41785,3575889831,3575889832,1
0,1143,41786,3575889831,3575889833,2
0,1143,41787,3575889831,3575889833,2
0,1143,41788,3575889831,3575889833,2
0,1143,41789,3575889831,3575889834,3
0,1143,41790,3575889831,3575889834,3
0,1143,41791,3575889831,3575889834,3
0,1143,41792,3575889831,3575889839,8
0,1143,41793,3575889831,3575889839,8
0,1143,41794,3575889831,3575889840,9
0,1143,41795,3575889831,3575889840,9
0,1143,41796,3575889831,3575889840,9
0,1143,41797,3575889831,3575889840,9
0,1143,41798,3575889831,3575889842,11
0,1143,41799,3575889831,3575889843,12
0,1143,41800,3575889831,3575889844,13
0,1143,41801,3575889831,3575889845,14
0,1143,41802,3575889831,3575889845,14
0,1143,41803,3575889831,3575889846,15
0,1143,41804,3575889831,3575889846,15
0,1143,41805,3575889831,3575889847,16
0,1143,41806,3575889831,3575889847,16
0,1143,41807,3575889831,3575889847,16
0,1143,41808,3575889831,3575889850,19
0,1143,41809,3575889831,3575889851,20
0,1143,41810,3575889831,3575889854,23
0,1143,41811,3575889831,3575889855,24
0,1143,41812,3575889831,3575889855,24
0,1143,41813,3575889831,3575889856,25
0,1143,41814,3575889831,3575889856,25
0,1143,41815,3575889831,3575889857,26
0,1143,41816,3575889831,3575889859,28
0,1143,41817,3575889831,3575889859,28
0,1143,41818,3575889831,3575889860,29
0,1143,41819,3575889831,3575889860,29
0,1143,41820,3575889831,3575889860,29
0,1143,41821,3575889831,3575889861,30
0,1143,41822,3575889831,3575889862,31
0,1143,41823,3575889831,3575889863,32
0,1143,41824,3575889831,3575889864,33
0,1143,41825,3575889831,3575889864,33
0,1143,41826,3575889831,3575889864,33
0,1143,41827,3575889831,3575889864,33
0,1143,41828,3575889831,3575889865,34
0,1143,41829,3575889831,3575889865,34
0,1143,41830,3575889831,3575889866,35
0,1143,41831,3575889831,3575889867,36
0,1143,41832,3575889831,3575889868,37
0,1143,41833,3575889831,3575889869,38
0,1143,41834,3575889831,3575889877,46
0,1143,41835,3575889831,3575889877,46
0,1143,41836,3575889831,3575889878,47
0,1143,41837,3575889831,3575889880,49
0,1143,41838,3575889831,3575889880,49
0,1144,41839,3575889898,3575889898,0
0,1144,41840,3575889898,3575889898,0
0,1144,41841,3575889898,3575889898,0
0,1144,41842,3575889898,3575889898,0
0,1144,41843,3575889898,3575889898,0
0,1144,41844,3575889898,3575889898,0
0,1144,41845,3575889898,3575889898,0
0,1144,41846,3575889898,3575889898,0
0,1144,41847,3575889898,3575889898,0
0,1144,41848,3575889898,3575889898,0
0,1144,41849,3575889898,3575889898,0
0,1144,41850,3575889898,3575889898,0
0,1144,41851,3575889898,3575889898,0
0,1144,41852,3575889898,3575889898,0
0,1144,41853,3575889898,3575889898,0
0,1144,41854,3575889898,3575889898,0
0,1144,41855,3575889898,3575889898,0
0,1144,41856,3575889898,3575889898,0
0,1144,41857,3575889898,3575889898,0
0,1144,41858,3575889898,3575889898,0
0,1144,41859,3575889898,3575889898,0
0,1144,41860,3575889898,3575889898,0
0,1144,41861,3575889898,3575889898,0
0,1144,41862,3575889898,3575889898,0
0,1144,41863,3575889898,3575889898,0
0,1144,41864,3575889898,3575889898,0
0,1144,41865,3575889898,3575889898,0
0,1144,41866,3575889898,3575889899,1
0,1144,41867,3575889898,3575889900,2
0,1144,41868,3575889898,3575889901,3
0,1144,41869,3575889898,3575889901,3
0,1144,41870,3575889898,3575889901,3
0,1144,41871,3575889898,3575889903,5
0,1144,41872,3575889898,3575889904,6
0,1144,41873,3575889898,3575889905,7
0,1144,41874,3575889898,3575889905,7
0,1144,41875,3575889898,3575889905,7
0,1144,41876,3575889898,3575889905,7
0,1144,41877,3575889898,3575889906,8
0,1144,41878,3575889898,3575889906,8
0,1144,41879,3575889898,3575889907,9
0,1144,41880,3575889898,3575889907,9
0,1144,41881,3575889898,3575889908,10
0,1144,41882,3575889898,3575889908,10
0,1144,41883,3575889898,3575889908,10
0,1144,41884,3575889898,3575889909,11
0,1144,41885,3575889898,3575889909,11
0,1144,41886,3575889898,3575889909,11
0,1144,41887,3575889898,3575889910,12
0,1144,41888,3575889898,3575889910,12
0,1144,41889,3575889898,3575889911,13
0,1144,41890,3575889898,3575889911,13
0,1144,41891,3575889898,3575889912,14
0,1144,41892,3575889898,3575889912,14
0,1144,41893,3575889898,3575889914,16
0,1144,41894,3575889898,3575889915,17
0,1144,41895,3575889898,3575889915,17
0,1144,41896,3575889898,3575889915,17
0,1144,41897,3575889898,3575889916,18
0,1144,41898,3575889898,3575889916,18
0,1144,41899,3575889898,3575889916,18
0,1144,41900,3575889898,3575889919,21
0,1144,41901,3575889898,3575889919,21
0,1144,41902,3575889898,3575889921,23
0,1144,41903,3575889898,3575889921,23
0,1144,41904,3575889898,3575889921,23
0,1144,41905,3575889898,3575889921,23
0,1144,41906,3575889898,3575889922,24
0,1144,41907,3575889898,3575889924,26
0,1144,41908,3575889898,3575889924,26
0,1144,41909,3575889898,3575889924,26
0,1144,41910,3575889898,3575889924,26
0,1144,41911,3575889898,3575889925,27
0,1144,41912,3575889898,3575889925,27
0,1144,41913,3575889898,3575889925,27
0,1144,41914,3575889898,3575889925,27
0,1144,41915,3575889898,3575889925,27
0,1144,41916,3575889898,3575889925,27
0,1144,41917,3575889898,3575889925,27
0,1144,41918,3575889898,3575889927,29
0,1144,41919,3575889898,3575889929,31
0,1144,41920,3575889898,3575889930,32
0,1144,41921,3575889898,3575889930,32
0,1144,41922,3575889898,3575889933,35
0,1144,41923,3575889898,3575889933,35
0,1144,41924,3575889898,3575889933,35
0,1144,41925,3575889898,3575889933,35
0,1144,41926,3575889898,3575889935,37
0,1144,41927,3575889898,3575889936,38
0,1144,41928,3575889898,3575889937,39
0,1144,41929,3575889898,3575889938,40
0,1144,41930,3575889898,3575889938,40
0,1144,41931,3575889898,3575889938,40
0,1144,41932,3575889898,3575889938,40
0,1144,41933,3575889898,3575889939,41
0,1144,41934,3575889898,3575889939,41
0,1144,41935,3575889898,3575889939,41
0,1144,41936,3575889898,3575889940,42
0,1144,41937,3575889898,3575889941,43
0,1144,41938,3575889898,3575889941,43
0,1144,41939,3575889898,3575889941,43
0,1144,41940,3575889898,3575889942,44
0,1144,41941,3575889898,3575889943,45
0,1144,41942,3575889898,3575889943,45
0,1144,41943,3575889898,3575889945,47
0,1144,41944,3575889898,3575889946,48
0,1144,41945,3575889898,3575889946,48
0,1144,41946,3575889898,3575889946,48
0,1144,41947,3575889898,3575889947,49
0,1144,41948,3575889898,3575889947,49
0,1144,41949,3575889898,3575889948,50
0,1144,41950,3575889898,3575889948,50
0,1145,41951,3575889961,3575889961,0
0,1145,41952,3575889961,3575889961,0
0,1145,41953,3575889961,3575889961,0
0,1145,41954,3575889961,3575889961,0
0,1145,41955,3575889961,3575889961,0
0,1145,41956,3575889961,3575889961,0
0,1145,41957,3575889961,3575889961,0
0,1145,41958,3575889961,3575889961,0
0,1145,41959,3575889961,3575889961,0
0,1145,41960,3575889961,3575889961,0
0,1145,41961,3575889961,3575889961,0
0,1145,41962,3575889961,3575889961,0
0,1145,41963,3575889961,3575889961,0
0,1145,41964,3575889961,3575889961,0
0,1145,41965,3575889961,3575889961,0
0,1145,41966,3575889961,3575889962,1
0,1145,41967,3575889961,3575889962,1
0,1145,41968,3575889961,3575889962,1
0,1145,41969,3575889961,3575889964,3
0,1145,41970,3575889961,3575889965,4
0,1145,41971,3575889961,3575889965,4
0,1145,41972,3575889961,3575889965,4
0,1145,41973,3575889961,3575889965,4
0,1145,41974,3575889961,3575889967,6
0,1145,41975,3575889961,3575889969,8
0,1145,41976,3575889961,3575889971,10
0,1145,41977,3575889961,3575889971,10
0,1145,41978,3575889961,3575889971,10
0,1145,41979,3575889961,3575889972,11
0,1145,41980,3575889961,3575889972,11
0,1145,41981,3575889961,3575889973,12
0,1145,41982,3575889961,3575889973,12
0,1145,41983,3575889961,3575889974,13
0,1145,41984,3575889961,3575889975,14
0,1145,41985,3575889961,3575889976,15
0,1145,41986,3575889961,3575889976,15
0,1145,41987,3575889961,3575889976,15
0,1145,41988,3575889961,3575889977,16
0,1145,41989,3575889961,3575889977,16
0,1145,41990,3575889961,3575889977,16
0,1145,41991,3575889961,3575889977,16
0,1145,41992,3575889961,3575889978,17
0,1145,41993,3575889961,3575889979,18
0,1145,41994,3575889961,3575889980,19
0,1145,41995,3575889961,3575889980,19
0,1145,41996,3575889961,3575889982,21
0,1145,41997,3575889961,3575889982,21
0,1145,41998,3575889961,3575889982,21
0,1145,41999,3575889961,3575889983,22
0,1145,42000,3575889961,3575889984,23
0,1145,42001,3575889961,3575889985,24
0,1145,42002,3575889961,3575889985,24
0,1145,42003,3575889961,3575889986,25
0,1145,42004,3575889961,3575889986,25
0,1145,42005,3575889961,3575889989,28
0,1145,42006,3575889961,3575889990,29
0,1145,42007,3575889961,3575889991,30
0,1145,42008,3575889961,3575889994,33
0,1145,42009,3575889961,3575889995,34
0,1145,42010,3575889961,3575889998,37
0,1145,42011,3575889961,3575889998,37
0,1145,42012,3575889961,3575889999,38
0,1145,42013,3575889961,3575890000,39
0,1145,42014,3575889961,3575890001,40
0,1145,42015,3575889961,3575890001,40
0,1145,42016,3575889961,3575890002,41
0,1145,42017,3575889961,3575890002,41
0,1145,42018,3575889961,3575890004,43
0,1145,42019,3575889961,3575890006,45
0,1145,42020,3575889961,3575890008,47
0,1145,42021,3575889961,3575890010,49
0,1145,42022,3575889961,3575890010,49
0,1145,42023,3575889961,3575890011,50
0,1146,42024,3575890025,3575890025,0
0,1146,42025,3575890025,3575890025,0
0,1146,42026,3575890025,3575890025,0
0,1146,42027,3575890025,3575890025,0
0,1146,42028,3575890025,3575890025,0
0,1146,42029,3575890025,3575890025,0
0,1146,42030,3575890025,3575890025,0
0,1146,42031,3575890025,3575890025,0
0,1146,42032,3575890025,3575890025,0
0,1146,42033,3575890025,3575890025,0
0,1146,42034,3575890025,3575890025,0
0,1146,42035,3575890025,3575890025,0
0,1146,42036,3575890025,3575890025,0
0,1146,42037,3575890025,3575890025,0
0,1146,42038,3575890025,3575890025,0
0,1146,42039,3575890025,3575890025,0
0,1146,42040,3575890025,3575890025,0
0,1146,42041,3575890025,3575890025,0
0,1146,42042,3575890025,3575890028,3
0,1146,42043,3575890025,3575890028,3
0,1146,42044,3575890025,3575890028,3
0,1146,42045,3575890025,3575890028,3
0,1146,42046,3575890025,3575890029,4
0,1146,42047,3575890025,3575890029,4
0,1146,42048,3575890025,3575890029,4
0,1146,42049,3575890025,3575890031,6
0,1146,42050,3575890025,3575890031,6
0,1146,42051,3575890025,3575890031,6
0,1146,42052,3575890025,3575890032,7
0,1146,42053,3575890025,3575890032,7
0,1146,42054,3575890025,3575890032,7
0,1146,42055,3575890025,3575890032,7
0,1146,42056,3575890025,3575890033,8
0,1146,42057,3575890025,3575890033,8
0,1146,42058,3575890025,3575890034,9
0,1146,42059,3575890025,3575890034,9
0,1146,42060,3575890025,3575890034,9
0,1146,42061,3575890025,3575890035,10
0,1146,42062,3575890025,3575890039,14
0,1146,42063,3575890025,3575890039,14
0,1146,42064,3575890025,3575890040,15
0,1146,42065,3575890025,3575890040,15
0,1146,42066,3575890025,3575890040,15
0,1146,42067,3575890025,3575890041,16
0,1146,42068,3575890025,3575890041,16
0,1146,42069,3575890025,3575890043,18
0,1146,42070,3575890025,3575890045,20
0,1146,42071,3575890025,3575890046,21
0,1146,42072,3575890025,3575890046,21
0,1146,42073,3575890025,3575890046,21
0,1146,42074,3575890025,3575890047,22
0,1146,42075,3575890025,3575890047,22
0,1146,42076,3575890025,3575890048,23
0,1146,42077,3575890025,3575890051,26
0,1146,42078,3575890025,3575890051,26
0,1146,42079,3575890025,3575890054,29
0,1146,42080,3575890025,3575890054,29
0,1146,42081,3575890025,3575890055,30
0,1146,42082,3575890025,3575890056,31
0,1146,42083,3575890025,3575890056,31
0,1146,42084,3575890025,3575890056,31
0,1146,42085,3575890025,3575890056,31
0,1146,42086,3575890025,3575890057,32
0,1146,42087,3575890025,3575890058,33
0,1146,42088,3575890025,3575890060,35
0,1146,42089,3575890025,3575890060,35
0,1146,42090,3575890025,3575890060,35
0,1146,42091,3575890025,3575890060,35
0,1146,42092,3575890025,3575890061,36
0,1146,42093,3575890025,3575890062,37
0,1146,42094,3575890025,3575890063,38
0,1146,42095,3575890025,3575890063,38
0,1146,42096,3575890025,3575890064,39
0,1146,42097,3575890025,3575890064,39
0,1146,42098,3575890025,3575890064,39
0,1146,42099,3575890025,3575890064,39
0,1146,42100,3575890025,3575890065,40
0,1146,42101,3575890025,3575890065,40
0,1146,42102,3575890025,3575890066,41
0,1146,42103,3575890025,3575890069,44
0,1146,42104,3575890025,3575890069,44
0,1147,42105,3575890089,3575890089,0
0,1147,42106,3575890089,3575890089,0
0,1147,42107,3575890089,3575890089,0
0,1147,42108,3575890089,3575890089,0
0,1147,42109,3575890089,3575890089,0
0,1147,42110,3575890089,3575890089,0
0,1147,42111,3575890089,3575890089,0
0,1147,42112,3575890089,3575890089,0
0,1147,42113,3575890089,3575890089,0
0,1147,42114,3575890089,3575890089,0
0,1147,42115,3575890089,3575890089,0
0,1147,42116,3575890089,3575890089,0
0,1147,42117,3575890089,3575890089,0
0,1147,42118,3575890089,3575890089,0
0,1147,42119,3575890089,3575890089,0
0,1147,42120,3575890089,3575890090,1
0,1147,42121,3575890089,3575890090,1
0,1147,42122,3575890089,3575890091,2
0,1147,42123,3575890089,3575890091,2
0,1147,42124,3575890089,3575890092,3
0,1147,42125,3575890089,3575890092,3
0,1147,42126,3575890089,3575890093,4
0,1147,42127,3575890089,3575890094,5
0,1147,42128,3575890089,3575890094,5
0,1147,42129,3575890089,3575890094,5
0,1147,42130,3575890089,3575890094,5
0,1147,42131,3575890089,3575890095,6
0,1147,42132,3575890089,3575890097,8
0,1147,42133,3575890089,3575890097,8
0,1147,42134,3575890089,3575890098,9
0,1147,42135,3575890089,3575890098,9
0,1147,42136,3575890089,3575890098,9
0,1147,42137,3575890089,3575890100,11
0,1147,42138,3575890089,3575890101,12
0,1147,42139,3575890089,3575890101,12
0,1147,42140,3575890089,3575890101,12
0,1147,42141,3575890089,3575890103,14
0,1147,42142,3575890089,3575890104,15
0,1147,42143,3575890089,3575890105,16
0,1147,42144,3575890089,3575890105,16
0,1147,42145,3575890089,3575890105,16
0,1147,42146,3575890089,3575890105,16
0,1147,42147,3575890089,3575890106,17
0,1147,42148,3575890089,3575890106,17
0,1147,42149,3575890089,3575890107,18
0,1147,42150,3575890089,3575890107,18
0,1147,42151,3575890089,3575890107,18
0,1147,42152,3575890089,3575890108,19
0,1147,42153,3575890089,3575890108,19
0,1147,42154,3575890089,3575890108,19
0,1147,42155,3575890089,3575890109,20
0,1147,42156,3575890089,3575890110,21
0,1147,42157,3575890089,3575890110,21
0,1147,42158,3575890089,3575890110,21
0,1147,42159,3575890089,3575890110,21
0,1147,42160,3575890089,3575890111,22
0,1147,42161,3575890089,3575890112,23
0,1147,42162,3575890089,3575890112,23
0,1147,42163,3575890089,3575890112,23
0,1147,42164,3575890089,3575890114,25
0,1147,42165,3575890089,3575890114,25
0,1147,42166,3575890089,3575890115,26
0,1147,42167,3575890089,3575890115,26
0,1147,42168,3575890089,3575890116,27
0,1147,42169,3575890089,3575890116,27
0,1147,42170,3575890089,3575890118,29
0,1147,42171,3575890089,3575890119,30
0,1147,42172,3575890089,3575890120,31
0,1147,42173,3575890089,3575890120,31
0,1147,42174,3575890089,3575890121,32
0,1147,42175,3575890089,3575890122,33
0,1147,42176,3575890089,3575890124,35
0,1147,42177,3575890089,3575890124,35
0,1147,42178,3575890089,3575890124,35
0,1147,42179,3575890089,3575890124,35
0,1147,42180,3575890089,3575890125,36
0,1147,42181,3575890089,3575890125,36
0,1147,42182,3575890089,3575890125,36
0,1147,42183,3575890089,3575890125,36
0,1147,42184,3575890089,3575890125,36
0,1147,42185,3575890089,3575890127,38
0,1147,42186,3575890089,3575890129,40
0,1147,42187,3575890089,3575890129,40
0,1147,42188,3575890089,3575890131,42
0,1147,42189,3575890089,3575890133,44
0,1147,42190,3575890089,3575890133,44
0,1147,42191,3575890089,3575890133,44
0,1147,42192,3575890089,3575890134,45
0,1147,42193,3575890089,3575890134,45
0,1147,42194,3575890089,3575890135,46
0,1147,42195,3575890089,3575890135,46
0,1147,42196,3575890089,3575890137,48
0,1147,42197,3575890089,3575890138,49
0,1147,42198,3575890089,3575890138,49
0,1147,42199,3575890089,3575890139,50
0,1148,42200,3575890151,3575890151,0
0,1148,42201,3575890151,3575890151,0
0,1148,42202,3575890151,3575890151,0
0,1148,42203,3575890151,3575890151,0
0,1148,42204,3575890151,3575890151,0
0,1148,42205,3575890151,3575890151,0
0,1148,42206,3575890151,3575890151,0
0,1148,42207,3575890151,3575890151,0
0,1148,42208,3575890151,3575890151,0
0,1148,42209,3575890151,3575890151,0
0,1148,42210,3575890151,3575890151,0
0,1148,42211,3575890151,3575890151,0
0,1148,42212,3575890151,3575890151,0
0,1148,42213,3575890151,3575890151,0
0,1148,42214,3575890151,3575890151,0
0,1148,42215,3575890151,3575890151,0
0,1148,42216,3575890151,3575890151,0
0,1148,42217,3575890151,3575890153,2
0,1148,42218,3575890151,3575890153,2
0,1148,42219,3575890151,3575890153,2
0,1148,42220,3575890151,3575890154,3
0,1148,42221,3575890151,3575890154,3
0,1148,42222,3575890151,3575890154,3
0,1148,42223,3575890151,3575890154,3
0,1148,42224,3575890151,3575890155,4
0,1148,42225,3575890151,3575890157,6
0,1148,42226,3575890151,3575890158,7
0,1148,42227,3575890151,3575890160,9
0,1148,42228,3575890151,3575890161,10
0,1148,42229,3575890151,3575890161,10
0,1148,42230,3575890151,3575890161,10
0,1148,42231,3575890151,3575890162,11
0,1148,42232,3575890151,3575890162,11
0,1148,42233,3575890151,3575890164,13
0,1148,42234,3575890151,3575890164,13
0,1148,42235,3575890151,3575890164,13
0,1148,42236,3575890151,3575890165,14
0,1148,42237,3575890151,3575890166,15
0,1148,42238,3575890151,3575890167,16
0,1148,42239,3575890151,3575890169,18
0,1148,42240,3575890151,3575890171,20
0,1148,42241,3575890151,3575890172,21
0,1148,42242,3575890151,3575890172,21
0,1148,42243,3575890151,3575890173,22
0,1148,42244,3575890151,3575890173,22
0,1148,42245,3575890151,3575890174,23
0,1148,42246,3575890151,3575890174,23
0,1148,42247,3575890151,3575890175,24
0,1148,42248,3575890151,3575890176,25
0,1148,42249,3575890151,3575890176,25
0,1148,42250,3575890151,3575890177,26
0,1148,42251,3575890151,3575890177,26
0,1148,42252,3575890151,3575890177,26
0,1148,42253,3575890151,3575890178,27
0,1148,42254,3575890151,3575890178,27
0,1148,42255,3575890151,3575890179,28
0,1148,42256,3575890151,3575890179,28
0,1148,42257,3575890151,3575890180,29
0,1148,42258,3575890151,3575890182,31
0,1148,42259,3575890151,3575890182,31
0,1148,42260,3575890151,3575890184,33
0,1148,42261,3575890151,3575890184,33
0,1148,42262,3575890151,3575890185,34
0,1148,42263,3575890151,3575890186,35
0,1148,42264,3575890151,3575890187,36
0,1148,42265,3575890151,3575890187,36
0,1148,42266,3575890151,3575890189,38
0,1148,42267,3575890151,3575890190,39
0,1148,42268,3575890151,3575890194,43
0,1148,42269,3575890151,3575890195,44
0,1148,42270,3575890151,3575890197,46
0,1148,42271,3575890151,3575890197,46
0,1148,42272,3575890151,3575890199,48
0,1148,42273,3575890151,3575890200,49
0,1148,42274,3575890151,3575890200,49
0,1148,42275,3575890151,3575890201,50
0,1149,42276,3575890215,3575890215,0
0,1149,42277,3575890215,3575890215,0
0,1149,42278,3575890215,3575890215,0
0,1149,42279,3575890215,3575890215,0
0,1149,42280,3575890215,3575890215,0
0,1149,42281,3575890215,3575890215,0
0,1149,42282,3575890215,3575890216,1
0,1149,42283,3575890215,3575890216,1
0,1149,42284,3575890215,3575890216,1
0,1149,42285,3575890215,3575890216,1
0,1149,42286,3575890215,3575890216,1
0,1149,42287,3575890215,3575890216,1
0,1149,42288,3575890215,3575890216,1
0,1149,42289,3575890215,3575890216,1
0,1149,42290,3575890215,3575890216,1
0,1149,42291,3575890215,3575890216,1
0,1149,42292,3575890215,3575890216,1
0,1149,42293,3575890215,3575890216,1
0,1149,42294,3575890215,3575890216,1
0,1149,42295,3575890215,3575890217,2
0,1149,42296,3575890215,3575890218,3
0,1149,42297,3575890215,3575890219,4
0,1149,42298,3575890215,3575890219,4
0,1149,42299,3575890215,3575890221,6
0,1149,42300,3575890215,3575890221,6
0,1149,42301,3575890215,3575890222,7
0,1149,42302,3575890215,3575890223,8
0,1149,42303,3575890215,3575890223,8
0,1149,42304,3575890215,3575890223,8
0,1149,42305,3575890215,3575890227,12
0,1149,42306,3575890215,3575890228,13
0,1149,42307,3575890215,3575890229,14
0,1149,42308,3575890215,3575890229,14
0,1149,42309,3575890215,3575890229,14
0,1149,42310,3575890215,3575890229,14
0,1149,42311,3575890215,3575890230,15
0,1149,42312,3575890215,3575890231,16
0,1149,42313,3575890215,3575890231,16
0,1149,42314,3575890215,3575890231,16
0,1149,42315,3575890215,3575890232,17
0,1149,42316,3575890215,3575890232,17
0,1149,42317,3575890215,3575890232,17
0,1149,42318,3575890215,3575890233,18
0,1149,42319,3575890215,3575890233,18
0,1149,42320,3575890215,3575890234,19
0,1149,42321,3575890215,3575890234,19
0,1149,42322,3575890215,3575890234,19
0,1149,42323,3575890215,3575890234,19
0,1149,42324,3575890215,3575890236,21
0,1149,42325,3575890215,3575890239,24
0,1149,42326,3575890215,3575890240,25
0,1149,42327,3575890215,3575890240,25
0,1149,42328,3575890215,3575890240,25
0,1149,42329,3575890215,3575890241,26
0,1149,42330,3575890215,3575890241,26
0,1149,42331,3575890215,3575890242,27
0,1149,42332,3575890215,3575890243,28
0,1149,42333,3575890215,3575890245,30
0,1149,42334,3575890215,3575890246,31
0,1149,42335,3575890215,3575890246,31
0,1149,42336,3575890215,3575890246,31
0,1149,42337,3575890215,3575890247,32
0,1149,42338,3575890215,3575890247,32
0,1149,42339,3575890215,3575890247,32
0,1149,42340,3575890215,3575890248,33
0,1149,42341,3575890215,3575890250,35
0,1149,42342,3575890215,3575890251,36
0,1149,42343,3575890215,3575890252,37
0,1149,42344,3575890215,3575890255,40
0,1149,42345,3575890215,3575890256,41
0,1149,42346,3575890215,3575890256,41
0,1149,42347,3575890215,3575890256,41
0,1149,42348,3575890215,3575890256,41
0,1149,42349,3575890215,3575890256,41
0,1149,42350,3575890215,3575890257,42
0,1149,42351,3575890215,3575890258,43
0,1149,42352,3575890215,3575890260,45
0,1149,42353,3575890215,3575890260,45
0,1149,42354,3575890215,3575890260,45
0,1149,42355,3575890215,3575890260,45
0,1149,42356,3575890215,3575890260,45
0,1149,42357,3575890215,3575890261,46
0,1149,42358,3575890215,3575890261,46
0,1149,42359,3575890215,3575890262,47
0,1149,42360,3575890215,3575890263,48
0,1149,42361,3575890215,3575890264,49
0,1149,42362,3575890215,3575890264,49
0,1149,42363,3575890215,3575890264,49
0,1149,42364,3575890215,3575890264,49
0,1149,42365,3575890215,3575890265,50
0,1150,42366,3575890277,3575890277,0
0,1150,42367,3575890277,3575890277,0
0,1150,42368,3575890277,3575890277,0
0,1150,42369,3575890277,3575890277,0
0,1150,42370,3575890277,3575890278,1
0,1150,42371,3575890277,3575890279,2
0,1150,42372,3575890277,3575890279,2
0,1150,42373,3575890277,3575890283,6
0,1150,42374,3575890277,3575890287,10
0,1150,42375,3575890277,3575890288,11
0,1150,42376,3575890277,3575890288,11
0,1150,42377,3575890277,3575890288,11
0,1150,42378,3575890277,3575890289,12
0,1150,42379,3575890277,3575890289,12
0,1150,42380,3575890277,3575890289,12
0,1150,42381,3575890277,3575890290,13
0,1150,42382,3575890277,3575890290,13
0,1150,42383,3575890277,3575890291,14
0,1150,42384,3575890277,3575890291,14
0,1150,42385,3575890277,3575890291,14
0,1150,42386,3575890277,3575890291,14
0,1150,42387,3575890277,3575890292,15
0,1150,42388,3575890277,3575890292,15
0,1150,42389,3575890277,3575890292,15
0,1150,42390,3575890277,3575890293,16
0,1150,42391,3575890277,3575890294,17
0,1150,42392,3575890277,3575890294,17
0,1150,42393,3575890277,3575890294,17
0,1150,42394,3575890277,3575890295,18
0,1150,42395,3575890277,3575890295,18
0,1150,42396,3575890277,3575890297,20
0,1150,42397,3575890277,3575890298,21
0,1150,42398,3575890277,3575890298,21
0,1150,42399,3575890277,3575890298,21
0,1150,42400,3575890277,3575890298,21
0,1150,42401,3575890277,3575890299,22
0,1150,42402,3575890277,3575890300,23
0,1150,42403,3575890277,3575890301,24
0,1150,42404,3575890277,3575890301,24
0,1150,42405,3575890277,3575890301,24
0,1150,42406,3575890277,3575890301,24
0,1150,42407,3575890277,3575890302,25
0,1150,42408,3575890277,3575890303,26
0,1150,42409,3575890277,3575890304,27
0,1150,42410,3575890277,3575890305,28
0,1150,42411,3575890277,3575890305,28
0,1150,42412,3575890277,3575890305,28
0,1150,42413,3575890277,3575890305,28
0,1150,42414,3575890277,3575890306,29
0,1150,42415,3575890277,3575890307,30
0,1150,42416,3575890277,3575890308,31
0,1150,42417,3575890277,3575890308,31
0,1150,42418,3575890277,3575890308,31
0,1150,42419,3575890277,3575890308,31
0,1150,42420,3575890277,3575890308,31
0,1150,42421,3575890277,3575890309,32
0,1150,42422,3575890277,3575890309,32
0,1150,42423,3575890277,3575890310,33
0,1150,42424,3575890277,3575890310,33
0,1150,42425,3575890277,3575890310,33
0,1150,42426,3575890277,3575890311,34
0,1150,42427,3575890277,3575890311,34
0,1150,42428,3575890277,3575890312,35
0,1150,42429,3575890277,3575890314,37
0,1150,42430,3575890277,3575890314,37
0,1150,42431,3575890277,3575890315,38
0,1150,42432,3575890277,3575890315,38
0,1150,42433,3575890277,3575890316,39
0,1150,42434,3575890277,3575890316,39
0,1150,42435,3575890277,3575890318,41
0,1150,42436,3575890277,3575890319,42
0,1150,42437,3575890277,3575890319,42
0,1150,42438,3575890277,3575890320,43
0,1150,42439,3575890277,3575890321,44
0,1150,42440,3575890277,3575890321,44
0,1150,42441,3575890277,3575890322,45
0,1150,42442,3575890277,3575890324,47
0,1150,42443,3575890277,3575890324,47
0,1150,42444,3575890277,3575890324,47
0,1150,42445,3575890277,3575890325,48
0,1150,42446,3575890277,3575890325,48
0,1150,42447,3575890277,3575890325,48
0,1150,42448,3575890277,3575890326,49
0,1150,42449,3575890277,3575890326,49
0,1150,42450,3575890277,3575890326,49
0,1150,42451,3575890277,3575890327,50
0,1151,42452,3575890342,3575890342,0
0,1151,42453,3575890342,3575890342,0
0,1151,42454,3575890342,3575890342,0
0,1151,42455,3575890342,3575890342,0
0,1151,42456,3575890342,3575890342,0
0,1151,42457,3575890342,3575890342,0
0,1151,42458,3575890342,3575890342,0
0,1151,42459,3575890342,3575890342,0
0,1151,42460,3575890342,3575890342,0
0,1151,42461,3575890342,3575890342,0
0,1151,42462,3575890342,3575890342,0
0,1151,42463,3575890342,3575890342,0
0,1151,42464,3575890342,3575890342,0
0,1151,42465,3575890342,3575890342,0
0,1151,42466,3575890342,3575890342,0
0,1151,42467,3575890342,3575890342,0
0,1151,42468,3575890342,3575890342,0
0,1151,42469,3575890342,3575890342,0
0,1151,42470,3575890342,3575890342,0
0,1151,42471,3575890342,3575890342,0
0,1151,42472,3575890342,3575890342,0
0,1151,42473,3575890342,3575890342,0
0,1151,42474,3575890342,3575890345,3
0,1151,42475,3575890342,3575890346,4
0,1151,42476,3575890342,3575890346,4
0,1151,42477,3575890342,3575890347,5
0,1151,42478,3575890342,3575890347,5
0,1151,42479,3575890342,3575890347,5
0,1151,42480,3575890342,3575890348,6
0,1151,42481,3575890342,3575890348,6
0,1151,42482,3575890342,3575890349,7
0,1151,42483,3575890342,3575890352,10
0,1151,42484,3575890342,3575890352,10
0,1151,42485,3575890342,3575890353,11
0,1151,42486,3575890342,3575890353,11
0,1151,42487,3575890342,3575890354,12
0,1151,42488,3575890342,3575890354,12
0,1151,42489,3575890342,3575890354,12
0,1151,42490,3575890342,3575890354,12
0,1151,42491,3575890342,3575890355,13
0,1151,42492,3575890342,3575890356,14
0,1151,42493,3575890342,3575890358,16
0,1151,42494,3575890342,3575890359,17
0,1151,42495,3575890342,3575890360,18
0,1151,42496,3575890342,3575890361,19
0,1151,42497,3575890342,3575890361,19
0,1151,42498,3575890342,3575890362,20
0,1151,42499,3575890342,3575890362,20
0,1151,42500,3575890342,3575890363,21
0,1151,42501,3575890342,3575890364,22
0,1151,42502,3575890342,3575890365,23
0,1151,42503,3575890342,3575890366,24
0,1151,42504,3575890342,3575890366,24
0,1151,42505,3575890342,3575890367,25
0,1151,42506,3575890342,3575890367,25
0,1151,42507,3575890342,3575890370,28
0,1151,42508,3575890342,3575890371,29
0,1151,42509,3575890342,3575890371,29
0,1151,42510,3575890342,3575890372,30
0,1151,42511,3575890342,3575890372,30
0,1151,42512,3575890342,3575890373,31
0,1151,42513,3575890342,3575890373,31
0,1151,42514,3575890342,3575890373,31
0,1151,42515,3575890342,3575890375,33
0,1151,42516,3575890342,3575890376,34
0,1151,42517,3575890342,3575890376,34
0,1151,42518,3575890342,3575890376,34
0,1151,42519,3575890342,3575890376,34
0,1151,42520,3575890342,3575890377,35
0,1151,42521,3575890342,3575890377,35
0,1151,42522,3575890342,3575890377,35
0,1151,42523,3575890342,3575890379,37
0,1151,42524,3575890342,3575890379,37
0,1151,42525,3575890342,3575890379,37
0,1151,42526,3575890342,3575890380,38
0,1151,42527,3575890342,3575890382,40
0,1151,42528,3575890342,3575890382,40
0,1151,42529,3575890342,3575890383,41
0,1151,42530,3575890342,3575890384,42
0,1151,42531,3575890342,3575890385,43
0,1151,42532,3575890342,3575890386,44
0,1151,42533,3575890342,3575890387,45
0,1151,42534,3575890342,3575890387,45
0,1151,42535,3575890342,3575890389,47
0,1151,42536,3575890342,3575890390,48
0,1151,42537,3575890342,3575890391,49
0,1152,42538,3575890405,3575890405,0
0,1152,42539,3575890405,3575890405,0
0,1152,42540,3575890405,3575890405,0
0,1152,42541,3575890405,3575890405,0
0,1152,42542,3575890405,3575890405,0
0,1152,42543,3575890405,3575890405,0
0,1152,42544,3575890405,3575890405,0
0,1152,42545,3575890405,3575890405,0
0,1152,42546,3575890405,3575890405,0
0,1152,42547,3575890405,3575890405,0
0,1152,42548,3575890405,3575890405,0
0,1152,42549,3575890405,3575890405,0
0,1152,42550,3575890405,3575890405,0
0,1152,42551,3575890405,3575890406,1
0,1152,42552,3575890405,3575890408,3
0,1152,42553,3575890405,3575890408,3
0,1152,42554,3575890405,3575890410,5
0,1152,42555,3575890405,3575890411,6
0,1152,42556,3575890405,3575890411,6
0,1152,42557,3575890405,3575890413,8
0,1152,42558,3575890405,3575890413,8
0,1152,42559,3575890405,3575890414,9
0,1152,42560,3575890405,3575890415,10
0,1152,42561,3575890405,3575890415,10
0,1152,42562,3575890405,3575890415,10
0,1152,42563,3575890405,3575890415,10
0,1152,42564,3575890405,3575890416,11
0,1152,42565,3575890405,3575890418,13
0,1152,42566,3575890405,3575890418,13
0,1152,42567,3575890405,3575890418,13
0,1152,42568,3575890405,3575890420,15
0,1152,42569,3575890405,3575890421,16
0,1152,42570,3575890405,3575890421,16
0,1152,42571,3575890405,3575890422,17
0,1152,42572,3575890405,3575890423,18
0,1152,42573,3575890405,3575890423,18
0,1152,42574,3575890405,3575890424,19
0,1152,42575,3575890405,3575890425,20
0,1152,42576,3575890405,3575890428,23
0,1152,42577,3575890405,3575890428,23
0,1152,42578,3575890405,3575890429,24
0,1152,42579,3575890405,3575890430,25
0,1152,42580,3575890405,3575890430,25
0,1152,42581,3575890405,3575890431,26
0,1152,42582,3575890405,3575890431,26
0,1152,42583,3575890405,3575890432,27
0,1152,42584,3575890405,3575890432,27
0,1152,42585,3575890405,3575890432,27
0,1152,42586,3575890405,3575890433,28
0,1152,42587,3575890405,3575890433,28
0,1152,42588,3575890405,3575890433,28
0,1152,42589,3575890405,3575890433,28
0,1152,42590,3575890405,3575890433,28
0,1152,42591,3575890405,3575890434,29
0,1152,42592,3575890405,3575890435,30
0,1152,42593,3575890405,3575890436,31
0,1152,42594,3575890405,3575890440,35
0,1152,42595,3575890405,3575890440,35
0,1152,42596,3575890405,3575890440,35
0,1152,42597,3575890405,3575890440,35
0,1152,42598,3575890405,3575890441,36
0,1152,42599,3575890405,3575890442,37
0,1152,42600,3575890405,3575890442,37
0,1152,42601,3575890405,3575890443,38
0,1152,42602,3575890405,3575890445,40
0,1152,42603,3575890405,3575890446,41
0,1152,42604,3575890405,3575890446,41
0,1152,42605,3575890405,3575890446,41
0,1152,42606,3575890405,3575890446,41
0,1152,42607,3575890405,3575890447,42
0,1152,42608,3575890405,3575890448,43
0,1152,42609,3575890405,3575890451,46
0,1152,42610,3575890405,3575890452,47
0,1152,42611,3575890405,3575890452,47
0,1153,42612,3575890473,3575890473,0
0,1153,42613,3575890473,3575890473,0
0,1153,42614,3575890473,3575890473,0
0,1153,42615,3575890473,3575890473,0
0,1153,42616,3575890473,3575890473,0
0,1153,42617,3575890473,3575890473,0
0,1153,42618,3575890473,3575890473,0
0,1153,42619,3575890473,3575890473,0
0,1153,42620,3575890473,3575890473,0
0,1153,42621,3575890473,3575890473,0
0,1153,42622,3575890473,3575890473,0
0,1153,42623,3575890473,3575890473,0
0,1153,42624,3575890473,3575890473,0
0,1153,42625,3575890473,3575890473,0
0,1153,42626,3575890473,3575890473,0
0,1153,42627,3575890473,3575890473,0
0,1153,42628,3575890473,3575890473,0
0,1153,42629,3575890473,3575890473,0
0,1153,42630,3575890473,3575890473,0
0,1153,42631,3575890473,3575890473,0
0,1153,42632,3575890473,3575890473,0
0,1153,42633,3575890473,3575890473,0
0,1153,42634,3575890473,3575890473,0
0,1153,42635,3575890473,3575890473,0
0,1153,42636,3575890473,3575890473,0
0,1153,42637,3575890473,3575890473,0
0,1153,42638,3575890473,3575890473,0
0,1153,42639,3575890473,3575890477,4
0,1153,42640,3575890473,3575890478,5
0,1153,42641,3575890473,3575890479,6
0,1153,42642,3575890473,3575890479,6
0,1153,42643,3575890473,3575890480,7
0,1153,42644,3575890473,3575890484,11
0,1153,42645,3575890473,3575890487,14
0,1153,42646,3575890473,3575890488,15
0,1153,42647,3575890473,3575890489,16
0,1153,42648,3575890473,3575890489,16
0,1153,42649,3575890473,3575890489,16
0,1153,42650,3575890473,3575890489,16
0,1153,42651,3575890473,3575890489,16
0,1153,42652,3575890473,3575890489,16
0,1153,42653,3575890473,3575890491,18
0,1153,42654,3575890473,3575890491,18
0,1153,42655,3575890473,3575890491,18
0,1153,42656,3575890473,3575890491,18
0,1153,42657,3575890473,3575890492,19
0,1153,42658,3575890473,3575890492,19
0,1153,42659,3575890473,3575890493,20
0,1153,42660,3575890473,3575890493,20
0,1153,42661,3575890473,3575890494,21
0,1153,42662,3575890473,3575890494,21
0,1153,42663,3575890473,3575890494,21
0,1153,42664,3575890473,3575890495,22
0,1153,42665,3575890473,3575890495,22
0,1153,42666,3575890473,3575890497,24
0,1153,42667,3575890473,3575890498,25
0,1153,42668,3575890473,3575890498,25
0,1153,42669,3575890473,3575890498,25
0,1153,42670,3575890473,3575890498,25
0,1153,42671,3575890473,3575890498,25
0,1153,42672,3575890473,3575890500,27
0,1153,42673,3575890473,3575890501,28
0,1153,42674,3575890473,3575890501,28
0,1153,42675,3575890473,3575890501,28
0,1153,42676,3575890473,3575890503,30
0,1153,42677,3575890473,3575890504,31
0,1153,42678,3575890473,3575890504,31
0,1153,42679,3575890473,3575890505,32
0,1153,42680,3575890473,3575890505,32
0,1153,42681,3575890473,3575890505,32
0,1153,42682,3575890473,3575890506,33
0,1153,42683,3575890473,3575890507,34
0,1153,42684,3575890473,3575890507,34
0,1153,42685,3575890473,3575890507,34
0,1153,42686,3575890473,3575890508,35
0,1153,42687,3575890473,3575890508,35
0,1153,42688,3575890473,3575890508,35
0,1153,42689,3575890473,3575890509,36
0,1153,42690,3575890473,3575890510,37
0,1153,42691,3575890473,3575890510,37
0,1153,42692,3575890473,3575890510,37
0,1153,42693,3575890473,3575890510,37
0,1153,42694,3575890473,3575890511,38
0,1153,42695,3575890473,3575890511,38
0,1153,42696,3575890473,3575890513,40
0,1153,42697,3575890473,3575890514,41
0,1153,42698,3575890473,3575890514,41
0,1153,42699,3575890473,3575890515,42
0,1153,42700,3575890473,3575890516,43
0,1153,42701,3575890473,3575890517,44
0,1153,42702,3575890473,3575890517,44
0,1153,42703,3575890473,3575890519,46
0,1153,42704,3575890473,3575890519,46
0,1153,42705,3575890473,3575890520,47
0,1153,42706,3575890473,3575890520,47
0,1153,42707,3575890473,3575890521,48
0,1153,42708,3575890473,3575890522,49
0,1153,42709,3575890473,3575890522,49
0,1153,42710,3575890473,3575890522,49
0,1154,42711,3575890535,3575890535,0
0,1154,42712,3575890535,3575890535,0
0,1154,42713,3575890535,3575890535,0
0,1154,42714,3575890535,3575890535,0
0,1154,42715,3575890535,3575890535,0
0,1154,42716,3575890535,3575890535,0
0,1154,42717,3575890535,3575890535,0
0,1154,42718,3575890535,3575890535,0
0,1154,42719,3575890535,3575890535,0
0,1154,42720,3575890535,3575890535,0
0,1154,42721,3575890535,3575890535,0
0,1154,42722,3575890535,3575890535,0
0,1154,42723,3575890535,3575890535,0
0,1154,42724,3575890535,3575890535,0
0,1154,42725,3575890535,3575890535,0
0,1154,42726,3575890535,3575890535,0
0,1154,42727,3575890535,3575890535,0
0,1154,42728,3575890535,3575890535,0
0,1154,42729,3575890535,3575890535,0
0,1154,42730,3575890535,3575890536,1
0,1154,42731,3575890535,3575890538,3
0,1154,42732,3575890535,3575890538,3
0,1154,42733,3575890535,3575890538,3
0,1154,42734,3575890535,3575890538,3
0,1154,42735,3575890535,3575890538,3
0,1154,42736,3575890535,3575890538,3
0,1154,42737,3575890535,3575890538,3
0,1154,42738,3575890535,3575890539,4
0,1154,42739,3575890535,3575890539,4
0,1154,42740,3575890535,3575890540,5
0,1154,42741,3575890535,3575890541,6
0,1154,42742,3575890535,3575890541,6
0,1154,42743,3575890535,3575890543,8
0,1154,42744,3575890535,3575890543,8
0,1154,42745,3575890535,3575890545,10
0,1154,42746,3575890535,3575890546,11
0,1154,42747,3575890535,3575890546,11
0,1154,42748,3575890535,3575890547,12
0,1154,42749,3575890535,3575890547,12
0,1154,42750,3575890535,3575890548,13
0,1154,42751,3575890535,3575890548,13
0,1154,42752,3575890535,3575890549,14
0,1154,42753,3575890535,3575890551,16
0,1154,42754,3575890535,3575890552,17
0,1154,42755,3575890535,3575890552,17
0,1154,42756,3575890535,3575890553,18
0,1154,42757,3575890535,3575890553,18
0,1154,42758,3575890535,3575890553,18
0,1154,42759,3575890535,3575890554,19
0,1154,42760,3575890535,3575890554,19
0,1154,42761,3575890535,3575890555,20
0,1154,42762,3575890535,3575890556,21
0,1154,42763,3575890535,3575890557,22
0,1154,42764,3575890535,3575890558,23
0,1154,42765,3575890535,3575890560,25
0,1154,42766,3575890535,3575890560,25
0,1154,42767,3575890535,3575890561,26
0,1154,42768,3575890535,3575890561,26
0,1154,42769,3575890535,3575890563,28
0,1154,42770,3575890535,3575890564,29
0,1154,42771,3575890535,3575890564,29
0,1154,42772,3575890535,3575890564,29
0,1154,42773,3575890535,3575890566,31
0,1154,42774,3575890535,3575890569,34
0,1154,42775,3575890535,3575890570,35
0,1154,42776,3575890535,3575890571,36
0,1154,42777,3575890535,3575890571,36
0,1154,42778,3575890535,3575890572,37
0,1154,42779,3575890535,3575890572,37
0,1154,42780,3575890535,3575890574,39
0,1154,42781,3575890535,3575890575,40
0,1154,42782,3575890535,3575890575,40
0,1154,42783,3575890535,3575890576,41
0,1154,42784,3575890535,3575890576,41
0,1154,42785,3575890535,3575890576,41
0,1154,42786,3575890535,3575890577,42
0,1154,42787,3575890535,3575890578,43
0,1154,42788,3575890535,3575890578,43
0,1154,42789,3575890535,3575890578,43
0,1154,42790,3575890535,3575890578,43
0,1154,42791,3575890535,3575890580,45
0,1154,42792,3575890535,3575890582,47
0,1154,42793,3575890535,3575890582,47
0,1154,42794,3575890535,3575890583,48
0,1154,42795,3575890535,3575890584,49
0,1155,42796,3575890597,3575890597,0
0,1155,42797,3575890597,3575890597,0
0,1155,42798,3575890597,3575890597,0
0,1155,42799,3575890597,3575890597,0
0,1155,42800,3575890597,3575890597,0
0,1155,42801,3575890597,3575890597,0
0,1155,42802,3575890597,3575890597,0
0,1155,42803,3575890597,3575890597,0
0,1155,42804,3575890597,3575890597,0
0,1155,42805,3575890597,3575890599,2
0,1155,42806,3575890597,3575890599,2
0,1155,42807,3575890597,3575890600,3
0,1155,42808,3575890597,3575890600,3
0,1155,42809,3575890597,3575890600,3
0,1155,42810,3575890597,3575890601,4
0,1155,42811,3575890597,3575890601,4
0,1155,42812,3575890597,3575890603,6
0,1155,42813,3575890597,3575890604,7
0,1155,42814,3575890597,3575890606,9
0,1155,42815,3575890597,3575890606,9
0,1155,42816,3575890597,3575890607,10
0,1155,42817,3575890597,3575890609,12
0,1155,42818,3575890597,3575890610,13
0,1155,42819,3575890597,3575890611,14
0,1155,42820,3575890597,3575890612,15
0,1155,42821,3575890597,3575890613,16
0,1155,42822,3575890597,3575890613,16
0,1155,42823,3575890597,3575890613,16
0,1155,42824,3575890597,3575890613,16
0,1155,42825,3575890597,3575890614,17
0,1155,42826,3575890597,3575890614,17
0,1155,42827,3575890597,3575890615,18
0,1155,42828,3575890597,3575890615,18
0,1155,42829,3575890597,3575890616,19
0,1155,42830,3575890597,3575890617,20
0,1155,42831,3575890597,3575890618,21
0,1155,42832,3575890597,3575890619,22
0,1155,42833,3575890597,3575890620,23
0,1155,42834,3575890597,3575890620,23
0,1155,42835,3575890597,3575890621,24
0,1155,42836,3575890597,3575890623,26
0,1155,42837,3575890597,3575890623,26
0,1155,42838,3575890597,3575890623,26
0,1155,42839,3575890597,3575890626,29
0,1155,42840,3575890597,3575890627,30
0,1155,42841,3575890597,3575890627,30
0,1155,42842,3575890597,3575890628,31
0,1155,42843,3575890597,3575890629,32
0,1155,42844,3575890597,3575890629,32
0,1155,42845,3575890597,3575890629,32
0,1155,42846,3575890597,3575890629,32
0,1155,42847,3575890597,3575890631,34
0,1155,42848,3575890597,3575890631,34
0,1155,42849,3575890597,3575890631,34
0,1155,42850,3575890597,3575890631,34
0,1155,42851,3575890597,3575890632,35
0,1155,42852,3575890597,3575890632,35
0,1155,42853,3575890597,3575890632,35
0,1155,42854,3575890597,3575890632,35
0,1155,42855,3575890597,3575890633,36
0,1155,42856,3575890597,3575890633,36
0,1155,42857,3575890597,3575890634,37
0,1155,42858,3575890597,3575890634,37
0,1155,42859,3575890597,3575890634,37
0,1155,42860,3575890597,3575890639,42
0,1155,42861,3575890597,3575890639,42
0,1155,42862,3575890597,3575890639,42
0,1155,42863,3575890597,3575890640,43
0,1155,42864,3575890597,3575890640,43
0,1155,42865,3575890597,3575890641,44
0,1155,42866,3575890597,3575890642,45
0,1155,42867,3575890597,3575890642,45
0,1155,42868,3575890597,3575890644,47
0,1155,42869,3575890597,3575890645,48
0,1155,42870,3575890597,3575890645,48
0,1155,42871,3575890597,3575890646,49
0,1155,42872,3575890597,3575890646,49
0,1155,42873,3575890597,3575890646,49
0,1156,42874,3575890661,3575890661,0
0,1156,42875,3575890661,3575890661,0
0,1156,42876,3575890661,3575890661,0
0,1156,42877,3575890661,3575890661,0
0,1156,42878,3575890661,3575890661,0
0,1156,42879,3575890661,3575890661,0
0,1156,42880,3575890661,3575890661,0
0,1156,42881,3575890661,3575890661,0
0,1156,42882,3575890661,3575890661,0
0,1156,42883,3575890661,3575890661,0
0,1156,42884,3575890661,3575890661,0
0,1156,42885,3575890661,3575890661,0
0,1156,42886,3575890661,3575890661,0
0,1156,42887,3575890661,3575890661,0
0,1156,42888,3575890661,3575890661,0
0,1156,42889,3575890661,3575890661,0
0,1156,42890,3575890661,3575890663,2
0,1156,42891,3575890661,3575890663,2
0,1156,42892,3575890661,3575890663,2
0,1156,42893,3575890661,3575890663,2
0,1156,42894,3575890661,3575890664,3
0,1156,42895,3575890661,3575890665,4
0,1156,42896,3575890661,3575890665,4
0,1156,42897,3575890661,3575890666,5
0,1156,42898,3575890661,3575890666,5
0,1156,42899,3575890661,3575890667,6
0,1156,42900,3575890661,3575890667,6
0,1156,42901,3575890661,3575890668,7
0,1156,42902,3575890661,3575890669,8
0,1156,42903,3575890661,3575890677,16
0,1156,42904,3575890661,3575890678,17
0,1156,42905,3575890661,3575890679,18
0,1156,42906,3575890661,3575890679,18
0,1156,42907,3575890661,3575890679,18
0,1156,42908,3575890661,3575890684,23
0,1156,42909,3575890661,3575890687,26
0,1156,42910,3575890661,3575890688,27
0,1156,42911,3575890661,3575890688,27
0,1156,42912,3575890661,3575890689,28
0,1156,42913,3575890661,3575890689,28
0,1156,42914,3575890661,3575890689,28
0,1156,42915,3575890661,3575890689,28
0,1156,42916,3575890661,3575890689,28
0,1156,42917,3575890661,3575890690,29
0,1156,42918,3575890661,3575890690,29
0,1156,42919,3575890661,3575890691,30
0,1156,42920,3575890661,3575890691,30
0,1156,42921,3575890661,3575890691,30
0,1156,42922,3575890661,3575890692,31
0,1156,42923,3575890661,3575890693,32
0,1156,42924,3575890661,3575890693,32
0,1156,42925,3575890661,3575890694,33
0,1156,42926,3575890661,3575890694,33
0,1156,42927,3575890661,3575890694,33
0,1156,42928,3575890661,3575890695,34
0,1156,42929,3575890661,3575890695,34
0,1156,42930,3575890661,3575890697,36
0,1156,42931,3575890661,3575890698,37
0,1156,42932,3575890661,3575890698,37
0,1156,42933,3575890661,3575890698,37
0,1156,42934,3575890661,3575890698,37
0,1156,42935,3575890661,3575890700,39
0,1156,42936,3575890661,3575890700,39
0,1156,42937,3575890661,3575890700,39
0,1156,42938,3575890661,3575890701,40
0,1156,42939,3575890661,3575890702,41
0,1156,42940,3575890661,3575890703,42
0,1156,42941,3575890661,3575890704,43
0,1156,42942,3575890661,3575890705,44
0,1156,42943,3575890661,3575890705,44
0,1156,42944,3575890661,3575890706,45
0,1156,42945,3575890661,3575890706,45
0,1156,42946,3575890661,3575890707,46
0,1156,42947,3575890661,3575890707,46
0,1156,42948,3575890661,3575890707,46
0,1156,42949,3575890661,3575890707,46
0,1156,42950,3575890661,3575890708,47
0,1156,42951,3575890661,3575890708,47
0,1156,42952,3575890661,3575890709,48
0,1156,42953,3575890661,3575890709,48
0,1156,42954,3575890661,3575890710,49
0,1156,42955,3575890661,3575890710,49
0,1156,42956,3575890661,3575890711,50
0,1157,42957,3575890724,3575890724,0
0,1157,42958,3575890724,3575890724,0
0,1157,42959,3575890724,3575890724,0
0,1157,42960,3575890724,3575890724,0
0,1157,42961,3575890724,3575890724,0
0,1157,42962,3575890724,3575890724,0
0,1157,42963,3575890724,3575890724,0
0,1157,42964,3575890724,3575890724,0
0,1157,42965,3575890724,3575890724,0
0,1157,42966,3575890724,3575890724,0
0,1157,42967,3575890724,3575890724,0
0,1157,42968,3575890724,3575890724,0
0,1157,42969,3575890724,3575890724,0
0,1157,42970,3575890724,3575890724,0
0,1157,42971,3575890724,3575890724,0
0,1157,42972,3575890724,3575890724,0
0,1157,42973,3575890724,3575890724,0
0,1157,42974,3575890724,3575890724,0
0,1157,42975,3575890724,3575890724,0
0,1157,42976,3575890724,3575890725,1
0,1157,42977,3575890724,3575890725,1
0,1157,42978,3575890724,3575890725,1
0,1157,42979,3575890724,3575890726,2
0,1157,42980,3575890724,3575890726,2
0,1157,42981,3575890724,3575890726,2
0,1157,42982,3575890724,3575890726,2
0,1157,42983,3575890724,3575890726,2
0,1157,42984,3575890724,3575890728,4
0,1157,42985,3575890724,3575890729,5
0,1157,42986,3575890724,3575890730,6
0,1157,42987,3575890724,3575890730,6
0,1157,42988,3575890724,3575890731,7
0,1157,42989,3575890724,3575890732,8
0,1157,42990,3575890724,3575890734,10
0,1157,42991,3575890724,3575890734,10
0,1157,42992,3575890724,3575890735,11
0,1157,42993,3575890724,3575890735,11
0,1157,42994,3575890724,3575890737,13
0,1157,42995,3575890724,3575890737,13
0,1157,42996,3575890724,3575890738,14
0,1157,42997,3575890724,3575890738,14
0,1157,42998,3575890724,3575890738,14
0,1157,42999,3575890724,3575890738,14
0,1157,43000,3575890724,3575890739,15
0,1157,43001,3575890724,3575890739,15
0,1157,43002,3575890724,3575890739,15
0,1157,43003,3575890724,3575890739,15
0,1157,43004,3575890724,3575890740,16
0,1157,43005,3575890724,3575890741,17
0,1157,43006,3575890724,3575890742,18
0,1157,43007,3575890724,3575890742,18
0,1157,43008,3575890724,3575890743,19
0,1157,43009,3575890724,3575890746,22
0,1157,43010,3575890724,3575890746,22
0,1157,43011,3575890724,3575890746,22
0,1157,43012,3575890724,3575890747,23
0,1157,43013,3575890724,3575890747,23
0,1157,43014,3575890724,3575890748,24
0,1157,43015,3575890724,3575890748,24
0,1157,43016,3575890724,3575890748,24
0,1157,43017,3575890724,3575890749,25
0,1157,43018,3575890724,3575890751,27
0,1157,43019,3575890724,3575890752,28
0,1157,43020,3575890724,3575890753,29
0,1157,43021,3575890724,3575890753,29
0,1157,43022,3575890724,3575890753,29
0,1157,43023,3575890724,3575890753,29
0,1157,43024,3575890724,3575890753,29
0,1157,43025,3575890724,3575890754,30
0,1157,43026,3575890724,3575890754,30
0,1157,43027,3575890724,3575890754,30
0,1157,43028,3575890724,3575890755,31
0,1157,43029,3575890724,3575890756,32
0,1157,43030,3575890724,3575890757,33
0,1157,43031,3575890724,3575890758,34
0,1157,43032,3575890724,3575890758,34
0,1157,43033,3575890724,3575890760,36
0,1157,43034,3575890724,3575890761,37
0,1157,43035,3575890724,3575890763,39
0,1157,43036,3575890724,3575890763,39
0,1157,43037,3575890724,3575890764,40
0,1157,43038,3575890724,3575890765,41
0,1157,43039,3575890724,3575890765,41
0,1157,43040,3575890724,3575890766,42
0,1157,43041,3575890724,3575890769,45
0,1157,43042,3575890724,3575890770,46
0,1157,43043,3575890724,3575890771,47
0,1157,43044,3575890724,3575890771,47
0,1157,43045,3575890724,3575890772,48
0,1157,43046,3575890724,3575890773,49
0,1157,43047,3575890724,3575890773,49
0,1158,43048,3575890786,3575890786,0
0,1158,43049,3575890786,3575890786,0
0,1158,43050,3575890786,3575890786,0
0,1158,43051,3575890786,3575890786,0
0,1158,43052,3575890786,3575890786,0
0,1158,43053,3575890786,3575890786,0
0,1158,43054,3575890786,3575890786,0
0,1158,43055,3575890786,3575890786,0
0,1158,43056,3575890786,3575890786,0
0,1158,43057,3575890786,3575890786,0
0,1158,43058,3575890786,3575890786,0
0,1158,43059,3575890786,3575890786,0
0,1158,43060,3575890786,3575890786,0
0,1158,43061,3575890786,3575890786,0
0,1158,43062,3575890786,3575890786,0
0,1158,43063,3575890786,3575890786,0
0,1158,43064,3575890786,3575890786,0
0,1158,43065,3575890786,3575890786,0
0,1158,43066,3575890786,3575890786,0
0,1158,43067,3575890786,3575890789,3
0,1158,43068,3575890786,3575890793,7
0,1158,43069,3575890786,3575890794,8
0,1158,43070,3575890786,3575890798,12
0,1158,43071,3575890786,3575890798,12
0,1158,43072,3575890786,3575890800,14
0,1158,43073,3575890786,3575890800,14
0,1158,43074,3575890786,3575890800,14
0,1158,43075,3575890786,3575890801,15
0,1158,43076,3575890786,3575890801,15
0,1158,43077,3575890786,3575890801,15
0,1158,43078,3575890786,3575890803,17
0,1158,43079,3575890786,3575890805,19
0,1158,43080,3575890786,3575890806,20
0,1158,43081,3575890786,3575890806,20
0,1158,43082,3575890786,3575890807,21
0,1158,43083,3575890786,3575890810,24
0,1158,43084,3575890786,3575890810,24
0,1158,43085,3575890786,3575890810,24
0,1158,43086,3575890786,3575890812,26
0,1158,43087,3575890786,3575890812,26
0,1158,43088,3575890786,3575890812,26
0,1158,43089,3575890786,3575890813,27
0,1158,43090,3575890786,3575890814,28
0,1158,43091,3575890786,3575890814,28
0,1158,43092,3575890786,3575890815,29
0,1158,43093,3575890786,3575890815,29
0,1158,43094,3575890786,3575890816,30
0,1158,43095,3575890786,3575890817,31
0,1158,43096,3575890786,3575890818,32
0,1158,43097,3575890786,3575890819,33
0,1158,43098,3575890786,3575890821,35
0,1158,43099,3575890786,3575890821,35
0,1158,43100,3575890786,3575890821,35
0,1158,43101,3575890786,3575890823,37
0,1158,43102,3575890786,3575890823,37
0,1158,43103,3575890786,3575890826,40
0,1158,43104,3575890786,3575890826,40
0,1158,43105,3575890786,3575890828,42
0,1158,43106,3575890786,3575890829,43
0,1158,43107,3575890786,3575890829,43
0,1158,43108,3575890786,3575890829,43
0,1158,43109,3575890786,3575890829,43
0,1158,43110,3575890786,3575890829,43
0,1158,43111,3575890786,3575890831,45
0,1158,43112,3575890786,3575890831,45
0,1158,43113,3575890786,3575890832,46
0,1158,43114,3575890786,3575890832,46
0,1158,43115,3575890786,3575890833,47
0,1158,43116,3575890786,3575890833,47
0,1158,43117,3575890786,3575890833,47
0,1158,43118,3575890786,3575890833,47
0,1158,43119,3575890786,3575890833,47
0,1158,43120,3575890786,3575890834,48
0,1158,43121,3575890786,3575890835,49
0,1159,43122,3575890850,3575890850,0
0,1159,43123,3575890850,3575890850,0
0,1159,43124,3575890850,3575890850,0
0,1159,43125,3575890850,3575890850,0
0,1159,43126,3575890850,3575890850,0
0,1159,43127,3575890850,3575890850,0
0,1159,43128,3575890850,3575890850,0
0,1159,43129,3575890850,3575890850,0
0,1159,43130,3575890850,3575890850,0
0,1159,43131,3575890850,3575890850,0
0,1159,43132,3575890850,3575890850,0
0,1159,43133,3575890850,3575890850,0
0,1159,43134,3575890850,3575890850,0
0,1159,43135,3575890850,3575890850,0
0,1159,43136,3575890850,3575890850,0
0,1159,43137,3575890850,3575890851,1
0,1159,43138,3575890850,3575890853,3
0,1159,43139,3575890850,3575890855,5
0,1159,43140,3575890850,3575890855,5
0,1159,43141,3575890850,3575890855,5
0,1159,43142,3575890850,3575890855,5
0,1159,43143,3575890850,3575890855,5
0,1159,43144,3575890850,3575890856,6
0,1159,43145,3575890850,3575890860,10
0,1159,43146,3575890850,3575890860,10
0,1159,43147,3575890850,3575890860,10
0,1159,43148,3575890850,3575890860,10
0,1159,43149,3575890850,3575890861,11
0,1159,43150,3575890850,3575890861,11
0,1159,43151,3575890850,3575890863,13
0,1159,43152,3575890850,3575890863,13
0,1159,43153,3575890850,3575890863,13
0,1159,43154,3575890850,3575890864,14
0,1159,43155,3575890850,3575890864,14
0,1159,43156,3575890850,3575890864,14
0,1159,43157,3575890850,3575890866,16
0,1159,43158,3575890850,3575890866,16
0,1159,43159,3575890850,3575890866,16
0,1159,43160,3575890850,3575890866,16
0,1159,43161,3575890850,3575890866,16
0,1159,43162,3575890850,3575890868,18
0,1159,43163,3575890850,3575890870,20
0,1159,43164,3575890850,3575890877,27
0,1159,43165,3575890850,3575890878,28
0,1159,43166,3575890850,3575890879,29
0,1159,43167,3575890850,3575890880,30
0,1159,43168,3575890850,3575890880,30
0,1159,43169,3575890850,3575890884,34
0,1159,43170,3575890850,3575890887,37
0,1159,43171,3575890850,3575890889,39
0,1159,43172,3575890850,3575890889,39
0,1159,43173,3575890850,3575890889,39
0,1159,43174,3575890850,3575890889,39
0,1159,43175,3575890850,3575890890,40
0,1159,43176,3575890850,3575890890,40
0,1159,43177,3575890850,3575890890,40
0,1159,43178,3575890850,3575890891,41
0,1159,43179,3575890850,3575890891,41
0,1159,43180,3575890850,3575890891,41
0,1159,43181,3575890850,3575890891,41
0,1159,43182,3575890850,3575890892,42
0,1159,43183,3575890850,3575890892,42
0,1159,43184,3575890850,3575890893,43
0,1159,43185,3575890850,3575890893,43
0,1159,43186,3575890850,3575890894,44
0,1159,43187,3575890850,3575890894,44
0,1159,43188,3575890850,3575890894,44
0,1159,43189,3575890850,3575890895,45
0,1159,43190,3575890850,3575890897,47
0,1159,43191,3575890850,3575890897,47
0,1159,43192,3575890850,3575890898,48
0,1159,43193,3575890850,3575890898,48
0,1159,43194,3575890850,3575890898,48
0,1159,43195,3575890850,3575890899,49
0,1160,43196,3575890914,3575890914,0
0,1160,43197,3575890914,3575890914,0
0,1160,43198,3575890914,3575890914,0
0,1160,43199,3575890914,3575890914,0
0,1160,43200,3575890914,3575890914,0
0,1160,43201,3575890914,3575890914,0
0,1160,43202,3575890914,3575890914,0
0,1160,43203,3575890914,3575890914,0
0,1160,43204,3575890914,3575890914,0
0,1160,43205,3575890914,3575890914,0
0,1160,43206,3575890914,3575890914,0
0,1160,43207,3575890914,3575890914,0
0,1160,43208,3575890914,3575890914,0
0,1160,43209,3575890914,3575890914,0
0,1160,43210,3575890914,3575890914,0
0,1160,43211,3575890914,3575890914,0
0,1160,43212,3575890914,3575890914,0
0,1160,43213,3575890914,3575890914,0
0,1160,43214,3575890914,3575890914,0
0,1160,43215,3575890914,3575890914,0
0,1160,43216,3575890914,3575890914,0
0,1160,43217,3575890914,3575890914,0
0,1160,43218,3575890914,3575890914,0
0,1160,43219,3575890914,3575890914,0
0,1160,43220,3575890914,3575890914,0
0,1160,43221,3575890914,3575890914,0
0,1160,43222,3575890914,3575890914,0
0,1160,43223,3575890914,3575890914,0
0,1160,43224,3575890914,3575890915,1
0,1160,43225,3575890914,3575890915,1
0,1160,43226,3575890914,3575890916,2
0,1160,43227,3575890914,3575890917,3
0,1160,43228,3575890914,3575890917,3
0,1160,43229,3575890914,3575890920,6
0,1160,43230,3575890914,3575890920,6
0,1160,43231,3575890914,3575890920,6
0,1160,43232,3575890914,3575890921,7
0,1160,43233,3575890914,3575890921,7
0,1160,43234,3575890914,3575890922,8
0,1160,43235,3575890914,3575890923,9
0,1160,43236,3575890914,3575890924,10
0,1160,43237,3575890914,3575890924,10
0,1160,43238,3575890914,3575890925,11
0,1160,43239,3575890914,3575890925,11
0,1160,43240,3575890914,3575890925,11
0,1160,43241,3575890914,3575890925,11
0,1160,43242,3575890914,3575890926,12
0,1160,43243,3575890914,3575890926,12
0,1160,43244,3575890914,3575890927,13
0,1160,43245,3575890914,3575890927,13
0,1160,43246,3575890914,3575890928,14
0,1160,43247,3575890914,3575890928,14
0,1160,43248,3575890914,3575890929,15
0,1160,43249,3575890914,3575890929,15
0,1160,43250,3575890914,3575890930,16
0,1160,43251,3575890914,3575890931,17
0,1160,43252,3575890914,3575890932,18
0,1160,43253,3575890914,3575890933,19
0,1160,43254,3575890914,3575890933,19
0,1160,43255,3575890914,3575890934,20
0,1160,43256,3575890914,3575890935,21
0,1160,43257,3575890914,3575890936,22
0,1160,43258,3575890914,3575890938,24
0,1160,43259,3575890914,3575890938,24
0,1160,43260,3575890914,3575890938,24
0,1160,43261,3575890914,3575890938,24
0,1160,43262,3575890914,3575890938,24
0,1160,43263,3575890914,3575890938,24
0,1160,43264,3575890914,3575890938,24
0,1160,43265,3575890914,3575890939,25
0,1160,43266,3575890914,3575890940,26
0,1160,43267,3575890914,3575890941,27
0,1160,43268,3575890914,3575890942,28
0,1160,43269,3575890914,3575890942,28
0,1160,43270,3575890914,3575890942,28
0,1160,43271,3575890914,3575890943,29
0,1160,43272,3575890914,3575890944,30
0,1160,43273,3575890914,3575890946,32
0,1160,43274,3575890914,3575890946,32
0,1160,43275,3575890914,3575890947,33
0,1160,43276,3575890914,3575890947,33
0,1160,43277,3575890914,3575890947,33
0,1160,43278,3575890914,3575890947,33
0,1160,43279,3575890914,3575890947,33
0,1160,43280,3575890914,3575890949,35
0,1160,43281,3575890914,3575890951,37
0,1160,43282,3575890914,3575890952,38
0,1160,43283,3575890914,3575890953,39
0,1160,43284,3575890914,3575890953,39
0,1160,43285,3575890914,3575890953,39
0,1160,43286,3575890914,3575890953,39
0,1160,43287,3575890914,3575890954,40
0,1160,43288,3575890914,3575890954,40
0,1160,43289,3575890914,3575890955,41
0,1160,43290,3575890914,3575890956,42
0,1160,43291,3575890914,3575890957,43
0,1160,43292,3575890914,3575890958,44
0,1160,43293,3575890914,3575890958,44
0,1160,43294,3575890914,3575890960,46
0,1160,43295,3575890914,3575890961,47
0,1160,43296,3575890914,3575890962,48
0,1160,43297,3575890914,3575890962,48
0,1160,43298,3575890914,3575890963,49
0,1160,43299,3575890914,3575890963,49
0,1160,43300,3575890914,3575890964,50
0,1161,43301,3575890977,3575890977,0
0,1161,43302,3575890977,3575890977,0
0,1161,43303,3575890977,3575890977,0
0,1161,43304,3575890977,3575890977,0
0,1161,43305,3575890977,3575890977,0
0,1161,43306,3575890977,3575890977,0
0,1161,43307,3575890977,3575890977,0
0,1161,43308,3575890977,3575890977,0
0,1161,43309,3575890977,3575890977,0
0,1161,43310,3575890977,3575890977,0
0,1161,43311,3575890977,3575890977,0
0,1161,43312,3575890977,3575890977,0
0,1161,43313,3575890977,3575890977,0
0,1161,43314,3575890977,3575890977,0
0,1161,43315,3575890977,3575890977,0
0,1161,43316,3575890977,3575890977,0
0,1161,43317,3575890977,3575890977,0
0,1161,43318,3575890977,3575890977,0
0,1161,43319,3575890977,3575890977,0
0,1161,43320,3575890977,3575890978,1
0,1161,43321,3575890977,3575890979,2
0,1161,43322,3575890977,3575890979,2
0,1161,43323,3575890977,3575890980,3
0,1161,43324,3575890977,3575890982,5
0,1161,43325,3575890977,3575890983,6
0,1161,43326,3575890977,3575890983,6
0,1161,43327,3575890977,3575890984,7
0,1161,43328,3575890977,3575890984,7
0,1161,43329,3575890977,3575890984,7
0,1161,43330,3575890977,3575890986,9
0,1161,43331,3575890977,3575890986,9
0,1161,43332,3575890977,3575890986,9
0,1161,43333,3575890977,3575890989,12
0,1161,43334,3575890977,3575890993,16
0,1161,43335,3575890977,3575890994,17
0,1161,43336,3575890977,3575890997,20
0,1161,43337,3575890977,3575890998,21
0,1161,43338,3575890977,3575891000,23
0,1161,43339,3575890977,3575891000,23
0,1161,43340,3575890977,3575891000,23
0,1161,43341,3575890977,3575891001,24
0,1161,43342,3575890977,3575891001,24
0,1161,43343,3575890977,3575891001,24
0,1161,43344,3575890977,3575891005,28
0,1161,43345,3575890977,3575891006,29
0,1161,43346,3575890977,3575891006,29
0,1161,43347,3575890977,3575891007,30
0,1161,43348,3575890977,3575891010,33
0,1161,43349,3575890977,3575891011,34
0,1161,43350,3575890977,3575891012,35
0,1161,43351,3575890977,3575891012,35
0,1161,43352,3575890977,3575891013,36
0,1161,43353,3575890977,3575891013,36
0,1161,43354,3575890977,3575891013,36
0,1161,43355,3575890977,3575891014,37
0,1161,43356,3575890977,3575891015,38
0,1161,43357,3575890977,3575891015,38
0,1161,43358,3575890977,3575891016,39
0,1161,43359,3575890977,3575891017,40
0,1161,43360,3575890977,3575891017,40
0,1161,43361,3575890977,3575891019,42
0,1161,43362,3575890977,3575891021,44
0,1161,43363,3575890977,3575891021,44
0,1161,43364,3575890977,3575891022,45
0,1161,43365,3575890977,3575891023,46
0,1161,43366,3575890977,3575891023,46
0,1161,43367,3575890977,3575891023,46
0,1161,43368,3575890977,3575891027,50
0,1162,43369,3575891041,3575891041,0
0,1162,43370,3575891041,3575891041,0
0,1162,43371,3575891041,3575891041,0
0,1162,43372,3575891041,3575891041,0
0,1162,43373,3575891041,3575891041,0
0,1162,43374,3575891041,3575891041,0
0,1162,43375,3575891041,3575891041,0
0,1162,43376,3575891041,3575891041,0
0,1162,43377,3575891041,3575891041,0
0,1162,43378,3575891041,3575891041,0
0,1162,43379,3575891041,3575891041,0
0,1162,43380,3575891041,3575891041,0
0,1162,43381,3575891041,3575891041,0
0,1162,43382,3575891041,3575891041,0
0,1162,43383,3575891041,3575891041,0
0,1162,43384,3575891041,3575891041,0
0,1162,43385,3575891041,3575891041,0
0,1162,43386,3575891041,3575891041,0
0,1162,43387,3575891041,3575891041,0
0,1162,43388,3575891041,3575891041,0
0,1162,43389,3575891041,3575891041,0
0,1162,43390,3575891041,3575891041,0
0,1162,43391,3575891041,3575891041,0
0,1162,43392,3575891041,3575891041,0
0,1162,43393,3575891041,3575891042,1
0,1162,43394,3575891041,3575891042,1
0,1162,43395,3575891041,3575891044,3
0,1162,43396,3575891041,3575891045,4
0,1162,43397,3575891041,3575891045,4
0,1162,43398,3575891041,3575891046,5
0,1162,43399,3575891041,3575891046,5
0,1162,43400,3575891041,3575891046,5
0,1162,43401,3575891041,3575891047,6
0,1162,43402,3575891041,3575891047,6
0,1162,43403,3575891041,3575891048,7
0,1162,43404,3575891041,3575891050,9
0,1162,43405,3575891041,3575891052,11
0,1162,43406,3575891041,3575891055,14
0,1162,43407,3575891041,3575891055,14
0,1162,43408,3575891041,3575891055,14
0,1162,43409,3575891041,3575891056,15
0,1162,43410,3575891041,3575891056,15
0,1162,43411,3575891041,3575891059,18
0,1162,43412,3575891041,3575891060,19
0,1162,43413,3575891041,3575891060,19
0,1162,43414,3575891041,3575891060,19
0,1162,43415,3575891041,3575891061,20
0,1162,43416,3575891041,3575891061,20
0,1162,43417,3575891041,3575891063,22
0,1162,43418,3575891041,3575891063,22
0,1162,43419,3575891041,3575891064,23
0,1162,43420,3575891041,3575891064,23
0,1162,43421,3575891041,3575891064,23
0,1162,43422,3575891041,3575891066,25
0,1162,43423,3575891041,3575891067,26
0,1162,43424,3575891041,3575891067,26
0,1162,43425,3575891041,3575891067,26
0,1162,43426,3575891041,3575891067,26
0,1162,43427,3575891041,3575891068,27
0,1162,43428,3575891041,3575891069,28
0,1162,43429,3575891041,3575891077,36
0,1162,43430,3575891041,3575891078,37
0,1162,43431,3575891041,3575891079,38
0,1162,43432,3575891041,3575891079,38
0,1162,43433,3575891041,3575891080,39
0,1162,43434,3575891041,3575891083,42
0,1162,43435,3575891041,3575891087,46
0,1162,43436,3575891041,3575891088,47
0,1162,43437,3575891041,3575891089,48
0,1162,43438,3575891041,3575891089,48
0,1162,43439,3575891041,3575891089,48
0,1162,43440,3575891041,3575891090,49
0,1162,43441,3575891041,3575891091,50
0,1162,43442,3575891041,3575891091,50
0,1162,43443,3575891041,3575891091,50
0,1163,43444,3575891103,3575891103,0
0,1163,43445,3575891103,3575891103,0
0,1163,43446,3575891103,3575891103,0
0,1163,43447,3575891103,3575891103,0
0,1163,43448,3575891103,3575891103,0
0,1163,43449,3575891103,3575891103,0
0,1163,43450,3575891103,3575891103,0
0,1163,43451,3575891103,3575891103,0
0,1163,43452,3575891103,3575891103,0
0,1163,43453,3575891103,3575891103,0
0,1163,43454,3575891103,3575891103,0
0,1163,43455,3575891103,3575891103,0
0,1163,43456,3575891103,3575891103,0
0,1163,43457,3575891103,3575891103,0
0,1163,43458,3575891103,3575891103,0
0,1163,43459,3575891103,3575891103,0
0,1163,43460,3575891103,3575891103,0
0,1163,43461,3575891103,3575891103,0
0,1163,43462,3575891103,3575891103,0
0,1163,43463,3575891103,3575891103,0
0,1163,43464,3575891103,3575891104,1
0,1163,43465,3575891103,3575891105,2
0,1163,43466,3575891103,3575891105,2
0,1163,43467,3575891103,3575891105,2
0,1163,43468,3575891103,3575891106,3
0,1163,43469,3575891103,3575891107,4
0,1163,43470,3575891103,3575891107,4
0,1163,43471,3575891103,3575891107,4
0,1163,43472,3575891103,3575891108,5
0,1163,43473,3575891103,3575891108,5
0,1163,43474,3575891103,3575891108,5
0,1163,43475,3575891103,3575891108,5
0,1163,43476,3575891103,3575891108,5
0,1163,43477,3575891103,3575891109,6
0,1163,43478,3575891103,3575891110,7
0,1163,43479,3575891103,3575891110,7
0,1163,43480,3575891103,3575891111,8
0,1163,43481,3575891103,3575891112,9
0,1163,43482,3575891103,3575891112,9
0,1163,43483,3575891103,3575891113,10
0,1163,43484,3575891103,3575891114,11
0,1163,43485,3575891103,3575891114,11
0,1163,43486,3575891103,3575891114,11
0,1163,43487,3575891103,3575891116,13
0,1163,43488,3575891103,3575891116,13
0,1163,43489,3575891103,3575891116,13
0,1163,43490,3575891103,3575891117,14
0,1163,43491,3575891103,3575891118,15
0,1163,43492,3575891103,3575891119,16
0,1163,43493,3575891103,3575891120,17
0,1163,43494,3575891103,3575891120,17
0,1163,43495,3575891103,3575891121,18
0,1163,43496,3575891103,3575891121,18
0,1163,43497,3575891103,3575891122,19
0,1163,43498,3575891103,3575891122,19
0,1163,43499,3575891103,3575891123,20
0,1163,43500,3575891103,3575891124,21
0,1163,43501,3575891103,3575891124,21
0,1163,43502,3575891103,3575891125,22
0,1163,43503,3575891103,3575891125,22
0,1163,43504,3575891103,3575891126,23
0,1163,43505,3575891103,3575891126,23
0,1163,43506,3575891103,3575891126,23
0,1163,43507,3575891103,3575891127,24
0,1163,43508,3575891103,3575891127,24
0,1163,43509,3575891103,3575891127,24
0,1163,43510,3575891103,3575891128,25
0,1163,43511,3575891103,3575891129,26
0,1163,43512,3575891103,3575891130,27
0,1163,43513,3575891103,3575891130,27
0,1163,43514,3575891103,3575891132,29
0,1163,43515,3575891103,3575891132,29
0,1163,43516,3575891103,3575891133,30
0,1163,43517,3575891103,3575891133,30
0,1163,43518,3575891103,3575891135,32
0,1163,43519,3575891103,3575891135,32
0,1163,43520,3575891103,3575891136,33
0,1163,43521,3575891103,3575891138,35
0,1163,43522,3575891103,3575891138,35
0,1163,43523,3575891103,3575891138,35
0,1163,43524,3575891103,3575891138,35
0,1163,43525,3575891103,3575891138,35
0,1163,43526,3575891103,3575891138,35
0,1163,43527,3575891103,3575891139,36
0,1163,43528,3575891103,3575891139,36
0,1163,43529,3575891103,3575891140,37
0,1163,43530,3575891103,3575891141,38
0,1163,43531,3575891103,3575891142,39
0,1163,43532,3575891103,3575891143,40
0,1163,43533,3575891103,3575891144,41
0,1163,43534,3575891103,3575891145,42
0,1163,43535,3575891103,3575891146,43
0,1163,43536,3575891103,3575891147,44
0,1163,43537,3575891103,3575891147,44
0,1163,43538,3575891103,3575891147,44
0,1163,43539,3575891103,3575891148,45
0,1163,43540,3575891103,3575891148,45
0,1163,43541,3575891103,3575891148,45
0,1163,43542,3575891103,3575891149,46
0,1163,43543,3575891103,3575891151,48
0,1163,43544,3575891103,3575891152,49
0,1163,43545,3575891103,3575891153,50
0,1164,43546,3575891169,3575891169,0
0,1164,43547,3575891169,3575891169,0
0,1164,43548,3575891169,3575891169,0
0,1164,43549,3575891169,3575891169,0
0,1164,43550,3575891169,3575891169,0
0,1164,43551,3575891169,3575891169,0
0,1164,43552,3575891169,3575891169,0
0,1164,43553,3575891169,3575891169,0
0,1164,43554,3575891169,3575891169,0
0,1164,43555,3575891169,3575891169,0
0,1164,43556,3575891169,3575891169,0
0,1164,43557,3575891169,3575891169,0
0,1164,43558,3575891169,3575891170,1
0,1164,43559,3575891169,3575891170,1
0,1164,43560,3575891169,3575891170,1
0,1164,43561,3575891169,3575891170,1
0,1164,43562,3575891169,3575891170,1
0,1164,43563,3575891169,3575891170,1
0,1164,43564,3575891169,3575891170,1
0,1164,43565,3575891169,3575891170,1
0,1164,43566,3575891169,3575891170,1
0,1164,43567,3575891169,3575891170,1
0,1164,43568,3575891169,3575891170,1
0,1164,43569,3575891169,3575891170,1
0,1164,43570,3575891169,3575891170,1
0,1164,43571,3575891169,3575891170,1
0,1164,43572,3575891169,3575891170,1
0,1164,43573,3575891169,3575891171,2
0,1164,43574,3575891169,3575891171,2
0,1164,43575,3575891169,3575891171,2
0,1164,43576,3575891169,3575891172,3
0,1164,43577,3575891169,3575891172,3
0,1164,43578,3575891169,3575891173,4
0,1164,43579,3575891169,3575891173,4
0,1164,43580,3575891169,3575891174,5
0,1164,43581,3575891169,3575891175,6
0,1164,43582,3575891169,3575891176,7
0,1164,43583,3575891169,3575891176,7
0,1164,43584,3575891169,3575891176,7
0,1164,43585,3575891169,3575891176,7
0,1164,43586,3575891169,3575891176,7
0,1164,43587,3575891169,3575891178,9
0,1164,43588,3575891169,3575891178,9
0,1164,43589,3575891169,3575891179,10
0,1164,43590,3575891169,3575891181,12
0,1164,43591,3575891169,3575891182,13
0,1164,43592,3575891169,3575891183,14
0,1164,43593,3575891169,3575891183,14
0,1164,43594,3575891169,3575891184,15
0,1164,43595,3575891169,3575891185,16
0,1164,43596,3575891169,3575891185,16
0,1164,43597,3575891169,3575891186,17
0,1164,43598,3575891169,3575891187,18
0,1164,43599,3575891169,3575891187,18
0,1164,43600,3575891169,3575891188,19
0,1164,43601,3575891169,3575891193,24
0,1164,43602,3575891169,3575891194,25
0,1164,43603,3575891169,3575891197,28
0,1164,43604,3575891169,3575891199,30
0,1164,43605,3575891169,3575891200,31
0,1164,43606,3575891169,3575891201,32
0,1164,43607,3575891169,3575891201,32
0,1164,43608,3575891169,3575891201,32
0,1164,43609,3575891169,3575891201,32
0,1164,43610,3575891169,3575891202,33
0,1164,43611,3575891169,3575891204,35
0,1164,43612,3575891169,3575891205,36
0,1164,43613,3575891169,3575891206,37
0,1164,43614,3575891169,3575891206,37
0,1164,43615,3575891169,3575891207,38
0,1164,43616,3575891169,3575891210,41
0,1164,43617,3575891169,3575891212,43
0,1164,43618,3575891169,3575891213,44
0,1164,43619,3575891169,3575891213,44
0,1164,43620,3575891169,3575891213,44
0,1164,43621,3575891169,3575891213,44
0,1164,43622,3575891169,3575891214,45
0,1164,43623,3575891169,3575891215,46
0,1164,43624,3575891169,3575891215,46
0,1164,43625,3575891169,3575891216,47
0,1164,43626,3575891169,3575891218,49
0,1164,43627,3575891169,3575891218,49
0,1164,43628,3575891169,3575891219,50
0,1165,43629,3575891233,3575891234,1
0,1165,43630,3575891233,3575891234,1
0,1165,43631,3575891233,3575891234,1
0,1165,43632,3575891233,3575891234,1
0,1165,43633,3575891233,3575891234,1
0,1165,43634,3575891233,3575891234,1
0,1165,43635,3575891233,3575891234,1
0,1165,43636,3575891233,3575891234,1
0,1165,43637,3575891233,3575891234,1
0,1165,43638,3575891233,3575891234,1
0,1165,43639,3575891233,3575891234,1
0,1165,43640,3575891233,3575891234,1
0,1165,43641,3575891233,3575891234,1
0,1165,43642,3575891233,3575891234,1
0,1165,43643,3575891233,3575891234,1
0,1165,43644,3575891233,3575891234,1
0,1165,43645,3575891233,3575891234,1
0,1165,43646,3575891233,3575891234,1
0,1165,43647,3575891233,3575891234,1
0,1165,43648,3575891233,3575891234,1
0,1165,43649,3575891233,3575891234,1
0,1165,43650,3575891233,3575891234,1
0,1165,43651,3575891233,3575891234,1
0,1165,43652,3575891233,3575891234,1
0,1165,43653,3575891233,3575891234,1
0,1165,43654,3575891233,3575891234,1
0,1165,43655,3575891233,3575891235,2
0,1165,43656,3575891233,3575891235,2
0,1165,43657,3575891233,3575891239,6
0,1165,43658,3575891233,3575891240,7
0,1165,43659,3575891233,3575891240,7
0,1165,43660,3575891233,3575891241,8
0,1165,43661,3575891233,3575891241,8
0,1165,43662,3575891233,3575891241,8
0,1165,43663,3575891233,3575891242,9
0,1165,43664,3575891233,3575891243,10
0,1165,43665,3575891233,3575891244,11
0,1165,43666,3575891233,3575891245,12
0,1165,43667,3575891233,3575891246,13
0,1165,43668,3575891233,3575891246,13
0,1165,43669,3575891233,3575891246,13
0,1165,43670,3575891233,3575891246,13
0,1165,43671,3575891233,3575891247,14
0,1165,43672,3575891233,3575891248,15
0,1165,43673,3575891233,3575891251,18
0,1165,43674,3575891233,3575891252,19
0,1165,43675,3575891233,3575891252,19
0,1165,43676,3575891233,3575891255,22
0,1165,43677,3575891233,3575891255,22
0,1165,43678,3575891233,3575891256,23
0,1165,43679,3575891233,3575891256,23
0,1165,43680,3575891233,3575891256,23
0,1165,43681,3575891233,3575891256,23
0,1165,43682,3575891233,3575891257,24
0,1165,43683,3575891233,3575891259,26
0,1165,43684,3575891233,3575891260,27
0,1165,43685,3575891233,3575891260,27
0,1165,43686,3575891233,3575891260,27
0,1165,43687,3575891233,3575891260,27
0,1165,43688,3575891233,3575891261,28
0,1165,43689,3575891233,3575891262,29
0,1165,43690,3575891233,3575891263,30
0,1165,43691,3575891233,3575891263,30
0,1165,43692,3575891233,3575891263,30
0,1165,43693,3575891233,3575891264,31
0,1165,43694,3575891233,3575891264,31
0,1165,43695,3575891233,3575891266,33
0,1165,43696,3575891233,3575891266,33
0,1165,43697,3575891233,3575891267,34
0,1165,43698,3575891233,3575891267,34
0,1165,43699,3575891233,3575891268,35
0,1165,43700,3575891233,3575891269,36
0,1165,43701,3575891233,3575891277,44
0,1165,43702,3575891233,3575891278,45
0,1165,43703,3575891233,3575891279,46
0,1165,43704,3575891233,3575891280,47
0,1166,43705,3575891295,3575891295,0
0,1166,43706,3575891295,3575891296,1
0,1166,43707,3575891295,3575891296,1
0,1166,43708,3575891295,3575891296,1
0,1166,43709,3575891295,3575891296,1
0,1166,43710,3575891295,3575891296,1
0,1166,43711,3575891295,3575891296,1
0,1166,43712,3575891295,3575891296,1
0,1166,43713,3575891295,3575891296,1
0,1166,43714,3575891295,3575891296,1
0,1166,43715,3575891295,3575891296,1
0,1166,43716,3575891295,3575891296,1
0,1166,43717,3575891295,3575891296,1
0,1166,43718,3575891295,3575891296,1
0,1166,43719,3575891295,3575891296,1
0,1166,43720,3575891295,3575891296,1
0,1166,43721,3575891295,3575891297,2
0,1166,43722,3575891295,3575891298,3
0,1166,43723,3575891295,3575891298,3
0,1166,43724,3575891295,3575891298,3
0,1166,43725,3575891295,3575891299,4
0,1166,43726,3575891295,3575891299,4
0,1166,43727,3575891295,3575891300,5
0,1166,43728,3575891295,3575891301,6
0,1166,43729,3575891295,3575891301,6
0,1166,43730,3575891295,3575891303,8
0,1166,43731,3575891295,3575891305,10
0,1166,43732,3575891295,3575891305,10
0,1166,43733,3575891295,3575891305,10
0,1166,43734,3575891295,3575891306,11
0,1166,43735,3575891295,3575891307,12
0,1166,43736,3575891295,3575891307,12
0,1166,43737,3575891295,3575891307,12
0,1166,43738,3575891295,3575891307,12
0,1166,43739,3575891295,3575891308,13
0,1166,43740,3575891295,3575891308,13
0,1166,43741,3575891295,3575891308,13
0,1166,43742,3575891295,3575891309,14
0,1166,43743,3575891295,3575891310,15
0,1166,43744,3575891295,3575891311,16
0,1166,43745,3575891295,3575891311,16
0,1166,43746,3575891295,3575891312,17
0,1166,43747,3575891295,3575891312,17
0,1166,43748,3575891295,3575891312,17
0,1166,43749,3575891295,3575891314,19
0,1166,43750,3575891295,3575891314,19
0,1166,43751,3575891295,3575891315,20
0,1166,43752,3575891295,3575891315,20
0,1166,43753,3575891295,3575891317,22
0,1166,43754,3575891295,3575891317,22
0,1166,43755,3575891295,3575891318,23
0,1166,43756,3575891295,3575891319,24
0,1166,43757,3575891295,3575891320,25
0,1166,43758,3575891295,3575891320,25
0,1166,43759,3575891295,3575891321,26
0,1166,43760,3575891295,3575891321,26
0,1166,43761,3575891295,3575891322,27
0,1166,43762,3575891295,3575891323,28
0,1166,43763,3575891295,3575891324,29
0,1166,43764,3575891295,3575891324,29
0,1166,43765,3575891295,3575891325,30
0,1166,43766,3575891295,3575891325,30
0,1166,43767,3575891295,3575891326,31
0,1166,43768,3575891295,3575891326,31
0,1166,43769,3575891295,3575891326,31
0,1166,43770,3575891295,3575891326,31
0,1166,43771,3575891295,3575891327,32
0,1166,43772,3575891295,3575891327,32
0,1166,43773,3575891295,3575891328,33
0,1166,43774,3575891295,3575891329,34
0,1166,43775,3575891295,3575891329,34
0,1166,43776,3575891295,3575891330,35
0,1166,43777,3575891295,3575891330,35
0,1166,43778,3575891295,3575891331,36
0,1166,43779,3575891295,3575891333,38
0,1166,43780,3575891295,3575891334,39
0,1166,43781,3575891295,3575891335,40
0,1166,43782,3575891295,3575891335,40
0,1166,43783,3575891295,3575891337,42
0,1166,43784,3575891295,3575891338,43
0,1166,43785,3575891295,3575891338,43
0,1166,43786,3575891295,3575891338,43
0,1166,43787,3575891295,3575891339,44
0,1166,43788,3575891295,3575891339,44
0,1166,43789,3575891295,3575891339,44
0,1166,43790,3575891295,3575891339,44
0,1166,43791,3575891295,3575891340,45
0,1166,43792,3575891295,3575891341,46
0,1166,43793,3575891295,3575891341,46
0,1166,43794,3575891295,3575891342,47
0,1166,43795,3575891295,3575891343,48
0,1166,43796,3575891295,3575891343,48
0,1166,43797,3575891295,3575891343,48
0,1166,43798,3575891295,3575891345,50
0,1167,43799,3575891357,3575891357,0
0,1167,43800,3575891357,3575891357,0
0,1167,43801,3575891357,3575891357,0
0,1167,43802,3575891357,3575891357,0
0,1167,43803,3575891357,3575891357,0
0,1167,43804,3575891357,3575891357,0
0,1167,43805,3575891357,3575891357,0
0,1167,43806,3575891357,3575891357,0
0,1167,43807,3575891357,3575891357,0
0,1167,43808,3575891357,3575891357,0
0,1167,43809,3575891357,3575891357,0
0,1167,43810,3575891357,3575891357,0
0,1167,43811,3575891357,3575891357,0
0,1167,43812,3575891357,3575891357,0
0,1167,43813,3575891357,3575891357,0
0,1167,43814,3575891357,3575891357,0
0,1167,43815,3575891357,3575891357,0
0,1167,43816,3575891357,3575891357,0
0,1167,43817,3575891357,3575891357,0
0,1167,43818,3575891357,3575891357,0
0,1167,43819,3575891357,3575891357,0
0,1167,43820,3575891357,3575891357,0
0,1167,43821,3575891357,3575891358,1
0,1167,43822,3575891357,3575891359,2
0,1167,43823,3575891357,3575891360,3
0,1167,43824,3575891357,3575891361,4
0,1167,43825,3575891357,3575891361,4
0,1167,43826,3575891357,3575891361,4
0,1167,43827,3575891357,3575891362,5
0,1167,43828,3575891357,3575891363,6
0,1167,43829,3575891357,3575891363,6
0,1167,43830,3575891357,3575891364,7
0,1167,43831,3575891357,3575891364,7
0,1167,43832,3575891357,3575891364,7
0,1167,43833,3575891357,3575891366,9
0,1167,43834,3575891357,3575891367,10
0,1167,43835,3575891357,3575891367,10
0,1167,43836,3575891357,3575891367,10
0,1167,43837,3575891357,3575891369,12
0,1167,43838,3575891357,3575891371,14
0,1167,43839,3575891357,3575891372,15
0,1167,43840,3575891357,3575891373,16
0,1167,43841,3575891357,3575891373,16
0,1167,43842,3575891357,3575891373,16
0,1167,43843,3575891357,3575891374,17
0,1167,43844,3575891357,3575891375,18
0,1167,43845,3575891357,3575891376,19
0,1167,43846,3575891357,3575891376,19
0,1167,43847,3575891357,3575891376,19
0,1167,43848,3575891357,3575891376,19
0,1167,43849,3575891357,3575891376,19
0,1167,43850,3575891357,3575891377,20
0,1167,43851,3575891357,3575891378,21
0,1167,43852,3575891357,3575891378,21
0,1167,43853,3575891357,3575891379,22
0,1167,43854,3575891357,3575891379,22
0,1167,43855,3575891357,3575891381,24
0,1167,43856,3575891357,3575891383,26
0,1167,43857,3575891357,3575891383,26
0,1167,43858,3575891357,3575891383,26
0,1167,43859,3575891357,3575891384,27
0,1167,43860,3575891357,3575891385,28
0,1167,43861,3575891357,3575891386,29
0,1167,43862,3575891357,3575891387,30
0,1167,43863,3575891357,3575891387,30
0,1167,43864,3575891357,3575891388,31
0,1167,43865,3575891357,3575891390,33
0,1167,43866,3575891357,3575891394,37
0,1167,43867,3575891357,3575891395,38
0,1167,43868,3575891357,3575891397,40
0,1167,43869,3575891357,3575891399,42
0,1167,43870,3575891357,3575891400,43
0,1167,43871,3575891357,3575891400,43
0,1167,43872,3575891357,3575891401,44
0,1167,43873,3575891357,3575891401,44
0,1167,43874,3575891357,3575891402,45
0,1167,43875,3575891357,3575891402,45
0,1167,43876,3575891357,3575891402,45
0,1167,43877,3575891357,3575891406,49
0,1167,43878,3575891357,3575891407,50
0,1168,43879,3575891421,3575891421,0
0,1168,43880,3575891421,3575891421,0
0,1168,43881,3575891421,3575891421,0
0,1168,43882,3575891421,3575891421,0
0,1168,43883,3575891421,3575891421,0
0,1168,43884,3575891421,3575891421,0
0,1168,43885,3575891421,3575891421,0
0,1168,43886,3575891421,3575891421,0
0,1168,43887,3575891421,3575891421,0
0,1168,43888,3575891421,3575891421,0
0,1168,43889,3575891421,3575891421,0
0,1168,43890,3575891421,3575891421,0
0,1168,43891,3575891421,3575891421,0
0,1168,43892,3575891421,3575891421,0
0,1168,43893,3575891421,3575891421,0
0,1168,43894,3575891421,3575891421,0
0,1168,43895,3575891421,3575891421,0
0,1168,43896,3575891421,3575891422,1
0,1168,43897,3575891421,3575891422,1
0,1168,43898,3575891421,3575891423,2
0,1168,43899,3575891421,3575891423,2
0,1168,43900,3575891421,3575891423,2
0,1168,43901,3575891421,3575891426,5
0,1168,43902,3575891421,3575891428,7
0,1168,43903,3575891421,3575891429,8
0,1168,43904,3575891421,3575891430,9
0,1168,43905,3575891421,3575891430,9
0,1168,43906,3575891421,3575891430,9
0,1168,43907,3575891421,3575891431,10
0,1168,43908,3575891421,3575891431,10
0,1168,43909,3575891421,3575891431,10
0,1168,43910,3575891421,3575891432,11
0,1168,43911,3575891421,3575891432,11
0,1168,43912,3575891421,3575891432,11
0,1168,43913,3575891421,3575891433,12
0,1168,43914,3575891421,3575891433,12
0,1168,43915,3575891421,3575891433,12
0,1168,43916,3575891421,3575891433,12
0,1168,43917,3575891421,3575891433,12
0,1168,43918,3575891421,3575891434,13
0,1168,43919,3575891421,3575891434,13
0,1168,43920,3575891421,3575891434,13
0,1168,43921,3575891421,3575891434,13
0,1168,43922,3575891421,3575891436,15
0,1168,43923,3575891421,3575891436,15
0,1168,43924,3575891421,3575891439,18
0,1168,43925,3575891421,3575891440,19
0,1168,43926,3575891421,3575891440,19
0,1168,43927,3575891421,3575891441,20
0,1168,43928,3575891421,3575891442,21
0,1168,43929,3575891421,3575891442,21
0,1168,43930,3575891421,3575891443,22
0,1168,43931,3575891421,3575891444,23
0,1168,43932,3575891421,3575891444,23
0,1168,43933,3575891421,3575891445,24
0,1168,43934,3575891421,3575891446,25
0,1168,43935,3575891421,3575891446,25
0,1168,43936,3575891421,3575891446,25
0,1168,43937,3575891421,3575891447,26
0,1168,43938,3575891421,3575891447,26
0,1168,43939,3575891421,3575891448,27
0,1168,43940,3575891421,3575891448,27
0,1168,43941,3575891421,3575891451,30
0,1168,43942,3575891421,3575891452,31
0,1168,43943,3575891421,3575891452,31
0,1168,43944,3575891421,3575891455,34
0,1168,43945,3575891421,3575891455,34
0,1168,43946,3575891421,3575891456,35
0,1168,43947,3575891421,3575891456,35
0,1168,43948,3575891421,3575891458,37
0,1168,43949,3575891421,3575891460,39
0,1168,43950,3575891421,3575891460,39
0,1168,43951,3575891421,3575891460,39
0,1168,43952,3575891421,3575891460,39
0,1168,43953,3575891421,3575891461,40
0,1168,43954,3575891421,3575891461,40
0,1168,43955,3575891421,3575891461,40
0,1168,43956,3575891421,3575891461,40
0,1168,43957,3575891421,3575891463,42
0,1168,43958,3575891421,3575891463,42
0,1168,43959,3575891421,3575891463,42
0,1168,43960,3575891421,3575891464,43
0,1168,43961,3575891421,3575891465,44
0,1168,43962,3575891421,3575891466,45
0,1168,43963,3575891421,3575891466,45
0,1168,43964,3575891421,3575891466,45
0,1168,43965,3575891421,3575891467,46
0,1168,43966,3575891421,3575891468,47
0,1168,43967,3575891421,3575891469,48
0,1169,43968,3575891484,3575891484,0
0,1169,43969,3575891484,3575891484,0
0,1169,43970,3575891484,3575891484,0
0,1169,43971,3575891484,3575891484,0
0,1169,43972,3575891484,3575891484,0
0,1169,43973,3575891484,3575891487,3
0,1169,43974,3575891484,3575891487,3
0,1169,43975,3575891484,3575891488,4
0,1169,43976,3575891484,3575891488,4
0,1169,43977,3575891484,3575891488,4
0,1169,43978,3575891484,3575891488,4
0,1169,43979,3575891484,3575891489,5
0,1169,43980,3575891484,3575891489,5
0,1169,43981,3575891484,3575891490,6
0,1169,43982,3575891484,3575891490,6
0,1169,43983,3575891484,3575891491,7
0,1169,43984,3575891484,3575891491,7
0,1169,43985,3575891484,3575891491,7
0,1169,43986,3575891484,3575891491,7
0,1169,43987,3575891484,3575891492,8
0,1169,43988,3575891484,3575891493,9
0,1169,43989,3575891484,3575891494,10
0,1169,43990,3575891484,3575891494,10
0,1169,43991,3575891484,3575891495,11
0,1169,43992,3575891484,3575891496,12
0,1169,43993,3575891484,3575891497,13
0,1169,43994,3575891484,3575891497,13
0,1169,43995,3575891484,3575891497,13
0,1169,43996,3575891484,3575891497,13
0,1169,43997,3575891484,3575891497,13
0,1169,43998,3575891484,3575891497,13
0,1169,43999,3575891484,3575891498,14
0,1169,44000,3575891484,3575891499,15
0,1169,44001,3575891484,3575891500,16
0,1169,44002,3575891484,3575891500,16
0,1169,44003,3575891484,3575891501,17
0,1169,44004,3575891484,3575891502,18
0,1169,44005,3575891484,3575891502,18
0,1169,44006,3575891484,3575891503,19
0,1169,44007,3575891484,3575891504,20
0,1169,44008,3575891484,3575891504,20
0,1169,44009,3575891484,3575891505,21
0,1169,44010,3575891484,3575891505,21
0,1169,44011,3575891484,3575891506,22
0,1169,44012,3575891484,3575891506,22
0,1169,44013,3575891484,3575891507,23
0,1169,44014,3575891484,3575891507,23
0,1169,44015,3575891484,3575891507,23
0,1169,44016,3575891484,3575891507,23
0,1169,44017,3575891484,3575891507,23
0,1169,44018,3575891484,3575891508,24
0,1169,44019,3575891484,3575891509,25
0,1169,44020,3575891484,3575891510,26
0,1169,44021,3575891484,3575891510,26
0,1169,44022,3575891484,3575891511,27
0,1169,44023,3575891484,3575891511,27
0,1169,44024,3575891484,3575891514,30
0,1169,44025,3575891484,3575891514,30
0,1169,44026,3575891484,3575891514,30
0,1169,44027,3575891484,3575891514,30
0,1169,44028,3575891484,3575891515,31
0,1169,44029,3575891484,3575891516,32
0,1169,44030,3575891484,3575891516,32
0,1169,44031,3575891484,3575891517,33
0,1169,44032,3575891484,3575891519,35
0,1169,44033,3575891484,3575891519,35
0,1169,44034,3575891484,3575891520,36
0,1169,44035,3575891484,3575891520,36
0,1169,44036,3575891484,3575891522,38
0,1169,44037,3575891484,3575891522,38
0,1169,44038,3575891484,3575891523,39
0,1169,44039,3575891484,3575891523,39
0,1169,44040,3575891484,3575891524,40
0,1169,44041,3575891484,3575891524,40
0,1169,44042,3575891484,3575891525,41
0,1169,44043,3575891484,3575891525,41
0,1169,44044,3575891484,3575891525,41
0,1169,44045,3575891484,3575891526,42
0,1169,44046,3575891484,3575891526,42
0,1169,44047,3575891484,3575891526,42
0,1169,44048,3575891484,3575891527,43
0,1169,44049,3575891484,3575891528,44
0,1169,44050,3575891484,3575891529,45
0,1169,44051,3575891484,3575891530,46
0,1169,44052,3575891484,3575891531,47
0,1169,44053,3575891484,3575891532,48
0,1169,44054,3575891484,3575891533,49
0,1169,44055,3575891484,3575891534,50
0,1170,44056,3575891547,3575891547,0
0,1170,44057,3575891547,3575891547,0
0,1170,44058,3575891547,3575891547,0
0,1170,44059,3575891547,3575891547,0
0,1170,44060,3575891547,3575891547,0
0,1170,44061,3575891547,3575891547,0
0,1170,44062,3575891547,3575891547,0
0,1170,44063,3575891547,3575891547,0
0,1170,44064,3575891547,3575891547,0
0,1170,44065,3575891547,3575891547,0
0,1170,44066,3575891547,3575891547,0
0,1170,44067,3575891547,3575891547,0
0,1170,44068,3575891547,3575891547,0
0,1170,44069,3575891547,3575891547,0
0,1170,44070,3575891547,3575891547,0
0,1170,44071,3575891547,3575891547,0
0,1170,44072,3575891547,3575891547,0
0,1170,44073,3575891547,3575891547,0
0,1170,44074,3575891547,3575891547,0
0,1170,44075,3575891547,3575891547,0
0,1170,44076,3575891547,3575891547,0
0,1170,44077,3575891547,3575891547,0
0,1170,44078,3575891547,3575891547,0
0,1170,44079,3575891547,3575891547,0
0,1170,44080,3575891547,3575891547,0
0,1170,44081,3575891547,3575891547,0
0,1170,44082,3575891547,3575891548,1
0,1170,44083,3575891547,3575891548,1
0,1170,44084,3575891547,3575891549,2
0,1170,44085,3575891547,3575891550,3
0,1170,44086,3575891547,3575891551,4
0,1170,44087,3575891547,3575891552,5
0,1170,44088,3575891547,3575891552,5
0,1170,44089,3575891547,3575891552,5
0,1170,44090,3575891547,3575891552,5
0,1170,44091,3575891547,3575891553,6
0,1170,44092,3575891547,3575891553,6
0,1170,44093,3575891547,3575891555,8
0,1170,44094,3575891547,3575891555,8
0,1170,44095,3575891547,3575891555,8
0,1170,44096,3575891547,3575891556,9
0,1170,44097,3575891547,3575891557,10
0,1170,44098,3575891547,3575891557,10
0,1170,44099,3575891547,3575891558,11
0,1170,44100,3575891547,3575891560,13
0,1170,44101,3575891547,3575891560,13
0,1170,44102,3575891547,3575891561,14
0,1170,44103,3575891547,3575891562,15
0,1170,44104,3575891547,3575891562,15
0,1170,44105,3575891547,3575891563,16
0,1170,44106,3575891547,3575891564,17
0,1170,44107,3575891547,3575891565,18
0,1170,44108,3575891547,3575891565,18
0,1170,44109,3575891547,3575891566,19
0,1170,44110,3575891547,3575891566,19
0,1170,44111,3575891547,3575891566,19
0,1170,44112,3575891547,3575891569,22
0,1170,44113,3575891547,3575891570,23
0,1170,44114,3575891547,3575891571,24
0,1170,44115,3575891547,3575891571,24
0,1170,44116,3575891547,3575891571,24
0,1170,44117,3575891547,3575891571,24
0,1170,44118,3575891547,3575891572,25
0,1170,44119,3575891547,3575891573,26
0,1170,44120,3575891547,3575891574,27
0,1170,44121,3575891547,3575891575,28
0,1170,44122,3575891547,3575891575,28
0,1170,44123,3575891547,3575891576,29
0,1170,44124,3575891547,3575891576,29
0,1170,44125,3575891547,3575891577,30
0,1170,44126,3575891547,3575891578,31
0,1170,44127,3575891547,3575891578,31
0,1170,44128,3575891547,3575891578,31
0,1170,44129,3575891547,3575891580,33
0,1170,44130,3575891547,3575891582,35
0,1170,44131,3575891547,3575891582,35
0,1170,44132,3575891547,3575891583,36
0,1170,44133,3575891547,3575891583,36
0,1170,44134,3575891547,3575891584,37
0,1170,44135,3575891547,3575891584,37
0,1170,44136,3575891547,3575891585,38
0,1170,44137,3575891547,3575891586,39
0,1170,44138,3575891547,3575891586,39
0,1170,44139,3575891547,3575891589,42
0,1170,44140,3575891547,3575891589,42
0,1170,44141,3575891547,3575891594,47
0,1170,44142,3575891547,3575891594,47
0,1170,44143,3575891547,3575891597,50
0,1171,44144,3575891612,3575891612,0
0,1171,44145,3575891612,3575891612,0
0,1171,44146,3575891612,3575891612,0
0,1171,44147,3575891612,3575891612,0
0,1171,44148,3575891612,3575891612,0
0,1171,44149,3575891612,3575891612,0
0,1171,44150,3575891612,3575891612,0
0,1171,44151,3575891612,3575891612,0
0,1171,44152,3575891612,3575891612,0
0,1171,44153,3575891612,3575891612,0
0,1171,44154,3575891612,3575891612,0
0,1171,44155,3575891612,3575891612,0
0,1171,44156,3575891612,3575891612,0
0,1171,44157,3575891612,3575891612,0
0,1171,44158,3575891612,3575891612,0
0,1171,44159,3575891612,3575891612,0
0,1171,44160,3575891612,3575891612,0
0,1171,44161,3575891612,3575891612,0
0,1171,44162,3575891612,3575891613,1
0,1171,44163,3575891612,3575891613,1
0,1171,44164,3575891612,3575891614,2
0,1171,44165,3575891612,3575891614,2
0,1171,44166,3575891612,3575891615,3
0,1171,44167,3575891612,3575891615,3
0,1171,44168,3575891612,3575891617,5
0,1171,44169,3575891612,3575891618,6
0,1171,44170,3575891612,3575891618,6
0,1171,44171,3575891612,3575891619,7
0,1171,44172,3575891612,3575891620,8
0,1171,44173,3575891612,3575891620,8
0,1171,44174,3575891612,3575891621,9
0,1171,44175,3575891612,3575891622,10
0,1171,44176,3575891612,3575891622,10
0,1171,44177,3575891612,3575891622,10
0,1171,44178,3575891612,3575891623,11
0,1171,44179,3575891612,3575891626,14
0,1171,44180,3575891612,3575891626,14
0,1171,44181,3575891612,3575891627,15
0,1171,44182,3575891612,3575891628,16
0,1171,44183,3575891612,3575891628,16
0,1171,44184,3575891612,3575891629,17
0,1171,44185,3575891612,3575891630,18
0,1171,44186,3575891612,3575891630,18
0,1171,44187,3575891612,3575891630,18
0,1171,44188,3575891612,3575891631,19
0,1171,44189,3575891612,3575891631,19
0,1171,44190,3575891612,3575891632,20
0,1171,44191,3575891612,3575891632,20
0,1171,44192,3575891612,3575891632,20
0,1171,44193,3575891612,3575891632,20
0,1171,44194,3575891612,3575891632,20
0,1171,44195,3575891612,3575891633,21
0,1171,44196,3575891612,3575891633,21
0,1171,44197,3575891612,3575891633,21
0,1171,44198,3575891612,3575891633,21
0,1171,44199,3575891612,3575891634,22
0,1171,44200,3575891612,3575891634,22
0,1171,44201,3575891612,3575891635,23
0,1171,44202,3575891612,3575891636,24
0,1171,44203,3575891612,3575891639,27
0,1171,44204,3575891612,3575891639,27
0,1171,44205,3575891612,3575891639,27
0,1171,44206,3575891612,3575891640,28
0,1171,44207,3575891612,3575891640,28
0,1171,44208,3575891612,3575891641,29
0,1171,44209,3575891612,3575891642,30
0,1171,44210,3575891612,3575891642,30
0,1171,44211,3575891612,3575891644,32
0,1171,44212,3575891612,3575891644,32
0,1171,44213,3575891612,3575891645,33
0,1171,44214,3575891612,3575891645,33
0,1171,44215,3575891612,3575891645,33
0,1171,44216,3575891612,3575891646,34
0,1171,44217,3575891612,3575891646,34
0,1171,44218,3575891612,3575891647,35
0,1171,44219,3575891612,3575891647,35
0,1171,44220,3575891612,3575891651,39
0,1171,44221,3575891612,3575891651,39
0,1171,44222,3575891612,3575891654,42
0,1171,44223,3575891612,3575891654,42
0,1171,44224,3575891612,3575891655,43
0,1171,44225,3575891612,3575891655,43
0,1171,44226,3575891612,3575891655,43
0,1171,44227,3575891612,3575891655,43
0,1171,44228,3575891612,3575891656,44
0,1171,44229,3575891612,3575891656,44
0,1171,44230,3575891612,3575891657,45
0,1171,44231,3575891612,3575891659,47
0,1171,44232,3575891612,3575891659,47
0,1171,44233,3575891612,3575891659,47
0,1171,44234,3575891612,3575891659,47
0,1171,44235,3575891612,3575891660,48
0,1171,44236,3575891612,3575891660,48
0,1171,44237,3575891612,3575891660,48
0,1171,44238,3575891612,3575891661,49
0,1171,44239,3575891612,3575891661,49
0,1171,44240,3575891612,3575891662,50
0,1172,44241,3575891674,3575891674,0
0,1172,44242,3575891674,3575891674,0
0,1172,44243,3575891674,3575891674,0
0,1172,44244,3575891674,3575891674,0
0,1172,44245,3575891674,3575891674,0
0,1172,44246,3575891674,3575891674,0
0,1172,44247,3575891674,3575891674,0
0,1172,44248,3575891674,3575891674,0
0,1172,44249,3575891674,3575891674,0
0,1172,44250,3575891674,3575891674,0
0,1172,44251,3575891674,3575891677,3
0,1172,44252,3575891674,3575891677,3
0,1172,44253,3575891674,3575891679,5
0,1172,44254,3575891674,3575891680,6
0,1172,44255,3575891674,3575891683,9
0,1172,44256,3575891674,3575891687,13
0,1172,44257,3575891674,3575891687,13
0,1172,44258,3575891674,3575891688,14
0,1172,44259,3575891674,3575891688,14
0,1172,44260,3575891674,3575891688,14
0,1172,44261,3575891674,3575891688,14
0,1172,44262,3575891674,3575891689,15
0,1172,44263,3575891674,3575891689,15
0,1172,44264,3575891674,3575891690,16
0,1172,44265,3575891674,3575891690,16
0,1172,44266,3575891674,3575891690,16
0,1172,44267,3575891674,3575891691,17
0,1172,44268,3575891674,3575891691,17
0,1172,44269,3575891674,3575891692,18
0,1172,44270,3575891674,3575891692,18
0,1172,44271,3575891674,3575891692,18
0,1172,44272,3575891674,3575891692,18
0,1172,44273,3575891674,3575891693,19
0,1172,44274,3575891674,3575891693,19
0,1172,44275,3575891674,3575891693,19
0,1172,44276,3575891674,3575891695,21
0,1172,44277,3575891674,3575891696,22
0,1172,44278,3575891674,3575891696,22
0,1172,44279,3575891674,3575891697,23
0,1172,44280,3575891674,3575891697,23
0,1172,44281,3575891674,3575891698,24
0,1172,44282,3575891674,3575891698,24
0,1172,44283,3575891674,3575891698,24
0,1172,44284,3575891674,3575891699,25
0,1172,44285,3575891674,3575891700,26
0,1172,44286,3575891674,3575891700,26
0,1172,44287,3575891674,3575891702,28
0,1172,44288,3575891674,3575891703,29
0,1172,44289,3575891674,3575891703,29
0,1172,44290,3575891674,3575891704,30
0,1172,44291,3575891674,3575891704,30
0,1172,44292,3575891674,3575891705,31
0,1172,44293,3575891674,3575891705,31
0,1172,44294,3575891674,3575891706,32
0,1172,44295,3575891674,3575891706,32
0,1172,44296,3575891674,3575891707,33
0,1172,44297,3575891674,3575891707,33
0,1172,44298,3575891674,3575891707,33
0,1172,44299,3575891674,3575891707,33
0,1172,44300,3575891674,3575891707,33
0,1172,44301,3575891674,3575891707,33
0,1172,44302,3575891674,3575891709,35
0,1172,44303,3575891674,3575891709,35
0,1172,44304,3575891674,3575891710,36
0,1172,44305,3575891674,3575891711,37
0,1172,44306,3575891674,3575891711,37
0,1172,44307,3575891674,3575891711,37
0,1172,44308,3575891674,3575891712,38
0,1172,44309,3575891674,3575891713,39
0,1172,44310,3575891674,3575891714,40
0,1172,44311,3575891674,3575891714,40
0,1172,44312,3575891674,3575891715,41
0,1172,44313,3575891674,3575891716,42
0,1172,44314,3575891674,3575891716,42
0,1172,44315,3575891674,3575891717,43
0,1172,44316,3575891674,3575891719,45
0,1172,44317,3575891674,3575891720,46
0,1172,44318,3575891674,3575891720,46
0,1172,44319,3575891674,3575891720,46
0,1172,44320,3575891674,3575891723,49
0,1172,44321,3575891674,3575891723,49
0,1172,44322,3575891674,3575891723,49
0,1172,44323,3575891674,3575891724,50
0,1173,44324,3575891751,3575891751,0
0,1173,44325,3575891751,3575891751,0
0,1173,44326,3575891751,3575891751,0
0,1173,44327,3575891751,3575891751,0
0,1173,44328,3575891751,3575891751,0
0,1173,44329,3575891751,3575891751,0
0,1173,44330,3575891751,3575891751,0
0,1173,44331,3575891751,3575891751,0
0,1173,44332,3575891751,3575891751,0
0,1173,44333,3575891751,3575891751,0
0,1173,44334,3575891751,3575891751,0
0,1173,44335,3575891751,3575891751,0
0,1173,44336,3575891751,3575891751,0
0,1173,44337,3575891751,3575891751,0
0,1173,44338,3575891751,3575891751,0
0,1173,44339,3575891751,3575891751,0
0,1173,44340,3575891751,3575891751,0
0,1173,44341,3575891751,3575891751,0
0,1173,44342,3575891751,3575891751,0
0,1173,44343,3575891751,3575891751,0
0,1173,44344,3575891751,3575891751,0
0,1173,44345,3575891751,3575891751,0
0,1173,44346,3575891751,3575891751,0
0,1173,44347,3575891751,3575891751,0
0,1173,44348,3575891751,3575891751,0
0,1173,44349,3575891751,3575891751,0
0,1173,44350,3575891751,3575891751,0
0,1173,44351,3575891751,3575891751,0
0,1173,44352,3575891751,3575891751,0
0,1173,44353,3575891751,3575891751,0
0,1173,44354,3575891751,3575891751,0
0,1173,44355,3575891751,3575891751,0
0,1173,44356,3575891751,3575891751,0
0,1173,44357,3575891751,3575891751,0
0,1173,44358,3575891751,3575891751,0
0,1173,44359,3575891751,3575891751,0
0,1173,44360,3575891751,3575891751,0
0,1173,44361,3575891751,3575891751,0
0,1173,44362,3575891751,3575891751,0
0,1173,44363,3575891751,3575891751,0
0,1173,44364,3575891751,3575891751,0
0,1173,44365,3575891751,3575891751,0
0,1173,44366,3575891751,3575891752,1
0,1173,44367,3575891751,3575891752,1
0,1173,44368,3575891751,3575891752,1
0,1173,44369,3575891751,3575891753,2
0,1173,44370,3575891751,3575891753,2
0,1173,44371,3575891751,3575891754,3
0,1173,44372,3575891751,3575891754,3
0,1173,44373,3575891751,3575891754,3
0,1173,44374,3575891751,3575891755,4
0,1173,44375,3575891751,3575891755,4
0,1173,44376,3575891751,3575891757,6
0,1173,44377,3575891751,3575891757,6
0,1173,44378,3575891751,3575891757,6
0,1173,44379,3575891751,3575891759,8
0,1173,44380,3575891751,3575891760,9
0,1173,44381,3575891751,3575891760,9
0,1173,44382,3575891751,3575891761,10
0,1173,44383,3575891751,3575891762,11
0,1173,44384,3575891751,3575891762,11
0,1173,44385,3575891751,3575891763,12
0,1173,44386,3575891751,3575891764,13
0,1173,44387,3575891751,3575891765,14
0,1173,44388,3575891751,3575891765,14
0,1173,44389,3575891751,3575891766,15
0,1173,44390,3575891751,3575891766,15
0,1173,44391,3575891751,3575891766,15
0,1173,44392,3575891751,3575891769,18
0,1173,44393,3575891751,3575891770,19
0,1173,44394,3575891751,3575891771,20
0,1173,44395,3575891751,3575891771,20
0,1173,44396,3575891751,3575891772,21
0,1173,44397,3575891751,3575891773,22
0,1173,44398,3575891751,3575891774,23
0,1173,44399,3575891751,3575891774,23
0,1173,44400,3575891751,3575891775,24
0,1173,44401,3575891751,3575891775,24
0,1173,44402,3575891751,3575891775,24
0,1173,44403,3575891751,3575891776,25
0,1173,44404,3575891751,3575891776,25
0,1173,44405,3575891751,3575891776,25
0,1173,44406,3575891751,3575891778,27
0,1173,44407,3575891751,3575891778,27
0,1173,44408,3575891751,3575891779,28
0,1173,44409,3575891751,3575891780,29
0,1173,44410,3575891751,3575891782,31
0,1173,44411,3575891751,3575891782,31
0,1173,44412,3575891751,3575891782,31
0,1173,44413,3575891751,3575891783,32
0,1173,44414,3575891751,3575891784,33
0,1173,44415,3575891751,3575891785,34
0,1173,44416,3575891751,3575891786,35
0,1173,44417,3575891751,3575891786,35
0,1173,44418,3575891751,3575891789,38
0,1173,44419,3575891751,3575891789,38
0,1173,44420,3575891751,3575891794,43
0,1173,44421,3575891751,3575891794,43
0,1173,44422,3575891751,3575891797,46
0,1173,44423,3575891751,3575891798,47
0,1173,44424,3575891751,3575891799,48
0,1173,44425,3575891751,3575891799,48
0,1173,44426,3575891751,3575891800,49
0,1173,44427,3575891751,3575891800,49
0,1173,44428,3575891751,3575891800,49
0,1173,44429,3575891751,3575891801,50
0,1174,44430,3575891815,3575891815,0
0,1174,44431,3575891815,3575891815,0
0,1174,44432,3575891815,3575891815,0
0,1174,44433,3575891815,3575891815,0
0,1174,44434,3575891815,3575891815,0
0,1174,44435,3575891815,3575891815,0
0,1174,44436,3575891815,3575891815,0
0,1174,44437,3575891815,3575891815,0
0,1174,44438,3575891815,3575891815,0
0,1174,44439,3575891815,3575891815,0
0,1174,44440,3575891815,3575891815,0
0,1174,44441,3575891815,3575891815,0
0,1174,44442,3575891815,3575891815,0
0,1174,44443,3575891815,3575891815,0
0,1174,44444,3575891815,3575891815,0
0,1174,44445,3575891815,3575891816,1
0,1174,44446,3575891815,3575891816,1
0,1174,44447,3575891815,3575891817,2
0,1174,44448,3575891815,3575891818,3
0,1174,44449,3575891815,3575891818,3
0,1174,44450,3575891815,3575891819,4
0,1174,44451,3575891815,3575891820,5
0,1174,44452,3575891815,3575891820,5
0,1174,44453,3575891815,3575891822,7
0,1174,44454,3575891815,3575891822,7
0,1174,44455,3575891815,3575891822,7
0,1174,44456,3575891815,3575891823,8
0,1174,44457,3575891815,3575891823,8
0,1174,44458,3575891815,3575891826,11
0,1174,44459,3575891815,3575891827,12
0,1174,44460,3575891815,3575891827,12
0,1174,44461,3575891815,3575891828,13
0,1174,44462,3575891815,3575891828,13
0,1174,44463,3575891815,3575891829,14
0,1174,44464,3575891815,3575891829,14
0,1174,44465,3575891815,3575891830,15
0,1174,44466,3575891815,3575891831,16
0,1174,44467,3575891815,3575891831,16
0,1174,44468,3575891815,3575891832,17
0,1174,44469,3575891815,3575891832,17
0,1174,44470,3575891815,3575891832,17
0,1174,44471,3575891815,3575891832,17
0,1174,44472,3575891815,3575891832,17
0,1174,44473,3575891815,3575891833,18
0,1174,44474,3575891815,3575891833,18
0,1174,44475,3575891815,3575891833,18
0,1174,44476,3575891815,3575891833,18
0,1174,44477,3575891815,3575891834,19
0,1174,44478,3575891815,3575891834,19
0,1174,44479,3575891815,3575891835,20
0,1174,44480,3575891815,3575891837,22
0,1174,44481,3575891815,3575891839,24
0,1174,44482,3575891815,3575891839,24
0,1174,44483,3575891815,3575891840,25
0,1174,44484,3575891815,3575891840,25
0,1174,44485,3575891815,3575891841,26
0,1174,44486,3575891815,3575891842,27
0,1174,44487,3575891815,3575891842,27
0,1174,44488,3575891815,3575891842,27
0,1174,44489,3575891815,3575891844,29
0,1174,44490,3575891815,3575891845,30
0,1174,44491,3575891815,3575891845,30
0,1174,44492,3575891815,3575891845,30
0,1174,44493,3575891815,3575891845,30
0,1174,44494,3575891815,3575891846,31
0,1174,44495,3575891815,3575891847,32
0,1174,44496,3575891815,3575891849,34
0,1174,44497,3575891815,3575891851,36
0,1174,44498,3575891815,3575891851,36
0,1174,44499,3575891815,3575891854,39
0,1174,44500,3575891815,3575891855,40
0,1174,44501,3575891815,3575891855,40
0,1174,44502,3575891815,3575891855,40
0,1174,44503,3575891815,3575891856,41
0,1174,44504,3575891815,3575891857,42
0,1174,44505,3575891815,3575891857,42
0,1174,44506,3575891815,3575891858,43
0,1174,44507,3575891815,3575891858,43
0,1174,44508,3575891815,3575891859,44
0,1174,44509,3575891815,3575891859,44
0,1174,44510,3575891815,3575891860,45
0,1174,44511,3575891815,3575891860,45
0,1174,44512,3575891815,3575891860,45
0,1174,44513,3575891815,3575891861,46
0,1174,44514,3575891815,3575891861,46
0,1174,44515,3575891815,3575891862,47
0,1174,44516,3575891815,3575891863,48
0,1174,44517,3575891815,3575891863,48
0,1174,44518,3575891815,3575891864,49
0,1174,44519,3575891815,3575891864,49
0,1174,44520,3575891815,3575891864,49
0,1174,44521,3575891815,3575891865,50
0,1175,44522,3575891878,3575891878,0
0,1175,44523,3575891878,3575891878,0
0,1175,44524,3575891878,3575891878,0
0,1175,44525,3575891878,3575891878,0
0,1175,44526,3575891878,3575891878,0
0,1175,44527,3575891878,3575891878,0
0,1175,44528,3575891878,3575891878,0
0,1175,44529,3575891878,3575891878,0
0,1175,44530,3575891878,3575891879,1
0,1175,44531,3575891878,3575891880,2
0,1175,44532,3575891878,3575891880,2
0,1175,44533,3575891878,3575891882,4
0,1175,44534,3575891878,3575891887,9
0,1175,44535,3575891878,3575891887,9
0,1175,44536,3575891878,3575891888,10
0,1175,44537,3575891878,3575891888,10
0,1175,44538,3575891878,3575891888,10
0,1175,44539,3575891878,3575891889,11
0,1175,44540,3575891878,3575891889,11
0,1175,44541,3575891878,3575891890,12
0,1175,44542,3575891878,3575891890,12
0,1175,44543,3575891878,3575891891,13
0,1175,44544,3575891878,3575891891,13
0,1175,44545,3575891878,3575891891,13
0,1175,44546,3575891878,3575891892,14
0,1175,44547,3575891878,3575891892,14
0,1175,44548,3575891878,3575891892,14
0,1175,44549,3575891878,3575891892,14
0,1175,44550,3575891878,3575891893,15
0,1175,44551,3575891878,3575891894,16
0,1175,44552,3575891878,3575891894,16
0,1175,44553,3575891878,3575891896,18
0,1175,44554,3575891878,3575891896,18
0,1175,44555,3575891878,3575891897,19
0,1175,44556,3575891878,3575891897,19
0,1175,44557,3575891878,3575891897,19
0,1175,44558,3575891878,3575891897,19
0,1175,44559,3575891878,3575891897,19
0,1175,44560,3575891878,3575891898,20
0,1175,44561,3575891878,3575891899,21
0,1175,44562,3575891878,3575891899,21
0,1175,44563,3575891878,3575891899,21
0,1175,44564,3575891878,3575891900,22
0,1175,44565,3575891878,3575891901,23
0,1175,44566,3575891878,3575891903,25
0,1175,44567,3575891878,3575891904,26
0,1175,44568,3575891878,3575891904,26
0,1175,44569,3575891878,3575891905,27
0,1175,44570,3575891878,3575891905,27
0,1175,44571,3575891878,3575891906,28
0,1175,44572,3575891878,3575891907,29
0,1175,44573,3575891878,3575891907,29
0,1175,44574,3575891878,3575891907,29
0,1175,44575,3575891878,3575891907,29
0,1175,44576,3575891878,3575891908,30
0,1175,44577,3575891878,3575891908,30
0,1175,44578,3575891878,3575891909,31
0,1175,44579,3575891878,3575891909,31
0,1175,44580,3575891878,3575891911,33
0,1175,44581,3575891878,3575891911,33
0,1175,44582,3575891878,3575891911,33
0,1175,44583,3575891878,3575891911,33
0,1175,44584,3575891878,3575891913,35
0,1175,44585,3575891878,3575891913,35
0,1175,44586,3575891878,3575891913,35
0,1175,44587,3575891878,3575891914,36
0,1175,44588,3575891878,3575891915,37
0,1175,44589,3575891878,3575891915,37
0,1175,44590,3575891878,3575891916,38
0,1175,44591,3575891878,3575891917,39
0,1175,44592,3575891878,3575891917,39
0,1175,44593,3575891878,3575891919,41
0,1175,44594,3575891878,3575891920,42
0,1175,44595,3575891878,3575891920,42
0,1175,44596,3575891878,3575891921,43
0,1175,44597,3575891878,3575891921,43
0,1175,44598,3575891878,3575891922,44
0,1175,44599,3575891878,3575891922,44
0,1175,44600,3575891878,3575891924,46
0,1175,44601,3575891878,3575891924,46
0,1175,44602,3575891878,3575891924,46
0,1175,44603,3575891878,3575891925,47
0,1175,44604,3575891878,3575891925,47
0,1175,44605,3575891878,3575891925,47
0,1175,44606,3575891878,3575891926,48
0,1175,44607,3575891878,3575891926,48
0,1175,44608,3575891878,3575891927,49
0,1175,44609,3575891878,3575891927,49
0,1175,44610,3575891878,3575891928,50
0,1176,44611,3575891944,3575891944,0
0,1176,44612,3575891944,3575891944,0
0,1176,44613,3575891944,3575891944,0
0,1176,44614,3575891944,3575891944,0
0,1176,44615,3575891944,3575891944,0
0,1176,44616,3575891944,3575891944,0
0,1176,44617,3575891944,3575891944,0
0,1176,44618,3575891944,3575891944,0
0,1176,44619,3575891944,3575891944,0
0,1176,44620,3575891944,3575891944,0
0,1176,44621,3575891944,3575891944,0
0,1176,44622,3575891944,3575891944,0
0,1176,44623,3575891944,3575891944,0
0,1176,44624,3575891944,3575891944,0
0,1176,44625,3575891944,3575891944,0
0,1176,44626,3575891944,3575891944,0
0,1176,44627,3575891944,3575891944,0
0,1176,44628,3575891944,3575891944,0
0,1176,44629,3575891944,3575891944,0
0,1176,44630,3575891944,3575891944,0
0,1176,44631,3575891944,3575891944,0
0,1176,44632,3575891944,3575891944,0
0,1176,44633,3575891944,3575891944,0
0,1176,44634,3575891944,3575891946,2
0,1176,44635,3575891944,3575891946,2
0,1176,44636,3575891944,3575891946,2
0,1176,44637,3575891944,3575891947,3
0,1176,44638,3575891944,3575891948,4
0,1176,44639,3575891944,3575891948,4
0,1176,44640,3575891944,3575891948,4
0,1176,44641,3575891944,3575891949,5
0,1176,44642,3575891944,3575891949,5
0,1176,44643,3575891944,3575891951,7
0,1176,44644,3575891944,3575891952,8
0,1176,44645,3575891944,3575891952,8
0,1176,44646,3575891944,3575891952,8
0,1176,44647,3575891944,3575891953,9
0,1176,44648,3575891944,3575891953,9
0,1176,44649,3575891944,3575891953,9
0,1176,44650,3575891944,3575891954,10
0,1176,44651,3575891944,3575891954,10
0,1176,44652,3575891944,3575891955,11
0,1176,44653,3575891944,3575891955,11
0,1176,44654,3575891944,3575891955,11
0,1176,44655,3575891944,3575891957,13
0,1176,44656,3575891944,3575891957,13
0,1176,44657,3575891944,3575891958,14
0,1176,44658,3575891944,3575891959,15
0,1176,44659,3575891944,3575891960,16
0,1176,44660,3575891944,3575891961,17
0,1176,44661,3575891944,3575891962,18
0,1176,44662,3575891944,3575891962,18
0,1176,44663,3575891944,3575891964,20
0,1176,44664,3575891944,3575891964,20
0,1176,44665,3575891944,3575891964,20
0,1176,44666,3575891944,3575891964,20
0,1176,44667,3575891944,3575891965,21
0,1176,44668,3575891944,3575891966,22
0,1176,44669,3575891944,3575891966,22
0,1176,44670,3575891944,3575891967,23
0,1176,44671,3575891944,3575891969,25
0,1176,44672,3575891944,3575891970,26
0,1176,44673,3575891944,3575891971,27
0,1176,44674,3575891944,3575891971,27
0,1176,44675,3575891944,3575891971,27
0,1176,44676,3575891944,3575891971,27
0,1176,44677,3575891944,3575891973,29
0,1176,44678,3575891944,3575891974,30
0,1176,44679,3575891944,3575891974,30
0,1176,44680,3575891944,3575891975,31
0,1176,44681,3575891944,3575891975,31
0,1176,44682,3575891944,3575891976,32
0,1176,44683,3575891944,3575891976,32
0,1176,44684,3575891944,3575891977,33
0,1176,44685,3575891944,3575891977,33
0,1176,44686,3575891944,3575891978,34
0,1176,44687,3575891944,3575891979,35
0,1176,44688,3575891944,3575891980,36
0,1176,44689,3575891944,3575891982,38
0,1176,44690,3575891944,3575891982,38
0,1176,44691,3575891944,3575891982,38
0,1176,44692,3575891944,3575891984,40
0,1176,44693,3575891944,3575891985,41
0,1176,44694,3575891944,3575891985,41
0,1176,44695,3575891944,3575891986,42
0,1176,44696,3575891944,3575891986,42
0,1176,44697,3575891944,3575891986,42
0,1176,44698,3575891944,3575891989,45
0,1176,44699,3575891944,3575891989,45
0,1176,44700,3575891944,3575891994,50
0,1177,44701,3575892008,3575892008,0
0,1177,44702,3575892008,3575892008,0
0,1177,44703,3575892008,3575892008,0
0,1177,44704,3575892008,3575892008,0
0,1177,44705,3575892008,3575892008,0
0,1177,44706,3575892008,3575892008,0
0,1177,44707,3575892008,3575892008,0
0,1177,44708,3575892008,3575892008,0
0,1177,44709,3575892008,3575892008,0
0,1177,44710,3575892008,3575892008,0
0,1177,44711,3575892008,3575892008,0
0,1177,44712,3575892008,3575892008,0
0,1177,44713,3575892008,3575892008,0
0,1177,44714,3575892008,3575892008,0
0,1177,44715,3575892008,3575892010,2
0,1177,44716,3575892008,3575892011,3
0,1177,44717,3575892008,3575892012,4
0,1177,44718,3575892008,3575892012,4
0,1177,44719,3575892008,3575892013,5
0,1177,44720,3575892008,3575892013,5
0,1177,44721,3575892008,3575892014,6
0,1177,44722,3575892008,3575892014,6
0,1177,44723,3575892008,3575892015,7
0,1177,44724,3575892008,3575892015,7
0,1177,44725,3575892008,3575892016,8
0,1177,44726,3575892008,3575892017,9
0,1177,44727,3575892008,3575892018,10
0,1177,44728,3575892008,3575892018,10
0,1177,44729,3575892008,3575892020,12
0,1177,44730,3575892008,3575892020,12
0,1177,44731,3575892008,3575892020,12
0,1177,44732,3575892008,3575892021,13
0,1177,44733,3575892008,3575892022,14
0,1177,44734,3575892008,3575892022,14
0,1177,44735,3575892008,3575892022,14
0,1177,44736,3575892008,3575892023,15
0,1177,44737,3575892008,3575892026,18
0,1177,44738,3575892008,3575892027,19
0,1177,44739,3575892008,3575892029,21
0,1177,44740,3575892008,3575892029,21
0,1177,44741,3575892008,3575892030,22
0,1177,44742,3575892008,3575892030,22
0,1177,44743,3575892008,3575892030,22
0,1177,44744,3575892008,3575892031,23
0,1177,44745,3575892008,3575892032,24
0,1177,44746,3575892008,3575892032,24
0,1177,44747,3575892008,3575892033,25
0,1177,44748,3575892008,3575892033,25
0,1177,44749,3575892008,3575892033,25
0,1177,44750,3575892008,3575892033,25
0,1177,44751,3575892008,3575892033,25
0,1177,44752,3575892008,3575892034,26
0,1177,44753,3575892008,3575892034,26
0,1177,44754,3575892008,3575892035,27
0,1177,44755,3575892008,3575892036,28
0,1177,44756,3575892008,3575892039,31
0,1177,44757,3575892008,3575892039,31
0,1177,44758,3575892008,3575892040,32
0,1177,44759,3575892008,3575892040,32
0,1177,44760,3575892008,3575892041,33
0,1177,44761,3575892008,3575892041,33
0,1177,44762,3575892008,3575892042,34
0,1177,44763,3575892008,3575892042,34
0,1177,44764,3575892008,3575892043,35
0,1177,44765,3575892008,3575892044,36
0,1177,44766,3575892008,3575892044,36
0,1177,44767,3575892008,3575892045,37
0,1177,44768,3575892008,3575892045,37
0,1177,44769,3575892008,3575892046,38
0,1177,44770,3575892008,3575892046,38
0,1177,44771,3575892008,3575892046,38
0,1177,44772,3575892008,3575892047,39
0,1177,44773,3575892008,3575892048,40
0,1177,44774,3575892008,3575892050,42
0,1177,44775,3575892008,3575892050,42
0,1177,44776,3575892008,3575892051,43
0,1177,44777,3575892008,3575892052,44
0,1177,44778,3575892008,3575892054,46
0,1177,44779,3575892008,3575892055,47
0,1177,44780,3575892008,3575892055,47
0,1177,44781,3575892008,3575892055,47
0,1177,44782,3575892008,3575892057,49
0,1177,44783,3575892008,3575892058,50
0,1178,44784,3575892080,3575892080,0
0,1178,44785,3575892080,3575892080,0
0,1178,44786,3575892080,3575892080,0
0,1178,44787,3575892080,3575892080,0
0,1178,44788,3575892080,3575892080,0
0,1178,44789,3575892080,3575892080,0
0,1178,44790,3575892080,3575892080,0
0,1178,44791,3575892080,3575892080,0
0,1178,44792,3575892080,3575892080,0
0,1178,44793,3575892080,3575892080,0
0,1178,44794,3575892080,3575892080,0
0,1178,44795,3575892080,3575892080,0
0,1178,44796,3575892080,3575892080,0
0,1178,44797,3575892080,3575892080,0
0,1178,44798,3575892080,3575892080,0
0,1178,44799,3575892080,3575892080,0
0,1178,44800,3575892080,3575892080,0
0,1178,44801,3575892080,3575892080,0
0,1178,44802,3575892080,3575892080,0
0,1178,44803,3575892080,3575892080,0
0,1178,44804,3575892080,3575892080,0
0,1178,44805,3575892080,3575892080,0
0,1178,44806,3575892080,3575892080,0
0,1178,44807,3575892080,3575892080,0
0,1178,44808,3575892080,3575892083,3
0,1178,44809,3575892080,3575892087,7
0,1178,44810,3575892080,3575892088,8
0,1178,44811,3575892080,3575892088,8
0,1178,44812,3575892080,3575892088,8
0,1178,44813,3575892080,3575892088,8
0,1178,44814,3575892080,3575892089,9
0,1178,44815,3575892080,3575892089,9
0,1178,44816,3575892080,3575892090,10
0,1178,44817,3575892080,3575892090,10
0,1178,44818,3575892080,3575892090,10
0,1178,44819,3575892080,3575892091,11
0,1178,44820,3575892080,3575892091,11
0,1178,44821,3575892080,3575892091,11
0,1178,44822,3575892080,3575892092,12
0,1178,44823,3575892080,3575892093,13
0,1178,44824,3575892080,3575892093,13
0,1178,44825,3575892080,3575892094,14
0,1178,44826,3575892080,3575892094,14
0,1178,44827,3575892080,3575892096,16
0,1178,44828,3575892080,3575892096,16
0,1178,44829,3575892080,3575892096,16
0,1178,44830,3575892080,3575892096,16
0,1178,44831,3575892080,3575892097,17
0,1178,44832,3575892080,3575892097,17
0,1178,44833,3575892080,3575892098,18
0,1178,44834,3575892080,3575892098,18
0,1178,44835,3575892080,3575892099,19
0,1178,44836,3575892080,3575892100,20
0,1178,44837,3575892080,3575892100,20
0,1178,44838,3575892080,3575892101,21
0,1178,44839,3575892080,3575892102,22
0,1178,44840,3575892080,3575892102,22
0,1178,44841,3575892080,3575892103,23
0,1178,44842,3575892080,3575892105,25
0,1178,44843,3575892080,3575892105,25
0,1178,44844,3575892080,3575892105,25
0,1178,44845,3575892080,3575892105,25
0,1178,44846,3575892080,3575892107,27
0,1178,44847,3575892080,3575892107,27
0,1178,44848,3575892080,3575892107,27
0,1178,44849,3575892080,3575892108,28
0,1178,44850,3575892080,3575892108,28
0,1178,44851,3575892080,3575892109,29
0,1178,44852,3575892080,3575892109,29
0,1178,44853,3575892080,3575892110,30
0,1178,44854,3575892080,3575892111,31
0,1178,44855,3575892080,3575892111,31
0,1178,44856,3575892080,3575892111,31
0,1178,44857,3575892080,3575892112,32
0,1178,44858,3575892080,3575892113,33
0,1178,44859,3575892080,3575892113,33
0,1178,44860,3575892080,3575892114,34
0,1178,44861,3575892080,3575892115,35
0,1178,44862,3575892080,3575892115,35
0,1178,44863,3575892080,3575892115,35
0,1178,44864,3575892080,3575892116,36
0,1178,44865,3575892080,3575892116,36
0,1178,44866,3575892080,3575892118,38
0,1178,44867,3575892080,3575892118,38
0,1178,44868,3575892080,3575892119,39
0,1178,44869,3575892080,3575892120,40
0,1178,44870,3575892080,3575892120,40
0,1178,44871,3575892080,3575892121,41
0,1178,44872,3575892080,3575892122,42
0,1178,44873,3575892080,3575892122,42
0,1178,44874,3575892080,3575892123,43
0,1178,44875,3575892080,3575892124,44
0,1178,44876,3575892080,3575892124,44
0,1178,44877,3575892080,3575892124,44
0,1178,44878,3575892080,3575892125,45
0,1178,44879,3575892080,3575892125,45
0,1178,44880,3575892080,3575892125,45
0,1178,44881,3575892080,3575892125,45
0,1178,44882,3575892080,3575892126,46
0,1178,44883,3575892080,3575892127,47
0,1178,44884,3575892080,3575892127,47
0,1178,44885,3575892080,3575892128,48
0,1178,44886,3575892080,3575892128,48
0,1179,44887,3575892145,3575892145,0
0,1179,44888,3575892145,3575892145,0
0,1179,44889,3575892145,3575892145,0
0,1179,44890,3575892145,3575892145,0
0,1179,44891,3575892145,3575892145,0
0,1179,44892,3575892145,3575892145,0
0,1179,44893,3575892145,3575892145,0
0,1179,44894,3575892145,3575892145,0
0,1179,44895,3575892145,3575892145,0
0,1179,44896,3575892145,3575892145,0
0,1179,44897,3575892145,3575892145,0
0,1179,44898,3575892145,3575892145,0
0,1179,44899,3575892145,3575892145,0
0,1179,44900,3575892145,3575892145,0
0,1179,44901,3575892145,3575892145,0
0,1179,44902,3575892145,3575892145,0
0,1179,44903,3575892145,3575892145,0
0,1179,44904,3575892145,3575892145,0
0,1179,44905,3575892145,3575892145,0
0,1179,44906,3575892145,3575892145,0
0,1179,44907,3575892145,3575892145,0
0,1179,44908,3575892145,3575892145,0
0,1179,44909,3575892145,3575892145,0
0,1179,44910,3575892145,3575892146,1
0,1179,44911,3575892145,3575892146,1
0,1179,44912,3575892145,3575892146,1
0,1179,44913,3575892145,3575892147,2
0,1179,44914,3575892145,3575892147,2
0,1179,44915,3575892145,3575892147,2
0,1179,44916,3575892145,3575892147,2
0,1179,44917,3575892145,3575892148,3
0,1179,44918,3575892145,3575892148,3
0,1179,44919,3575892145,3575892149,4
0,1179,44920,3575892145,3575892151,6
0,1179,44921,3575892145,3575892152,7
0,1179,44922,3575892145,3575892152,7
0,1179,44923,3575892145,3575892152,7
0,1179,44924,3575892145,3575892153,8
0,1179,44925,3575892145,3575892153,8
0,1179,44926,3575892145,3575892154,9
0,1179,44927,3575892145,3575892154,9
0,1179,44928,3575892145,3575892154,9
0,1179,44929,3575892145,3575892155,10
0,1179,44930,3575892145,3575892156,11
0,1179,44931,3575892145,3575892157,12
0,1179,44932,3575892145,3575892157,12
0,1179,44933,3575892145,3575892158,13
0,1179,44934,3575892145,3575892159,14
0,1179,44935,3575892145,3575892161,16
0,1179,44936,3575892145,3575892161,16
0,1179,44937,3575892145,3575892162,17
0,1179,44938,3575892145,3575892162,17
0,1179,44939,3575892145,3575892162,17
0,1179,44940,3575892145,3575892164,19
0,1179,44941,3575892145,3575892164,19
0,1179,44942,3575892145,3575892164,19
0,1179,44943,3575892145,3575892164,19
0,1179,44944,3575892145,3575892165,20
0,1179,44945,3575892145,3575892166,21
0,1179,44946,3575892145,3575892166,21
0,1179,44947,3575892145,3575892166,21
0,1179,44948,3575892145,3575892167,22
0,1179,44949,3575892145,3575892169,24
0,1179,44950,3575892145,3575892171,26
0,1179,44951,3575892145,3575892171,26
0,1179,44952,3575892145,3575892171,26
0,1179,44953,3575892145,3575892171,26
0,1179,44954,3575892145,3575892172,27
0,1179,44955,3575892145,3575892174,29
0,1179,44956,3575892145,3575892174,29
0,1179,44957,3575892145,3575892174,29
0,1179,44958,3575892145,3575892175,30
0,1179,44959,3575892145,3575892175,30
0,1179,44960,3575892145,3575892176,31
0,1179,44961,3575892145,3575892176,31
0,1179,44962,3575892145,3575892177,32
0,1179,44963,3575892145,3575892178,33
0,1179,44964,3575892145,3575892179,34
0,1179,44965,3575892145,3575892179,34
0,1179,44966,3575892145,3575892180,35
0,1179,44967,3575892145,3575892183,38
0,1179,44968,3575892145,3575892183,38
0,1179,44969,3575892145,3575892183,38
0,1179,44970,3575892145,3575892184,39
0,1179,44971,3575892145,3575892185,40
0,1179,44972,3575892145,3575892185,40
0,1179,44973,3575892145,3575892186,41
0,1179,44974,3575892145,3575892187,42
0,1179,44975,3575892145,3575892187,42
0,1179,44976,3575892145,3575892188,43
0,1179,44977,3575892145,3575892189,44
0,1179,44978,3575892145,3575892193,48
0,1179,44979,3575892145,3575892195,50
0,1180,44980,3575892209,3575892209,0
0,1180,44981,3575892209,3575892209,0
0,1180,44982,3575892209,3575892209,0
0,1180,44983,3575892209,3575892209,0
0,1180,44984,3575892209,3575892209,0
0,1180,44985,3575892209,3575892209,0
0,1180,44986,3575892209,3575892209,0
0,1180,44987,3575892209,3575892209,0
0,1180,44988,3575892209,3575892209,0
0,1180,44989,3575892209,3575892209,0
0,1180,44990,3575892209,3575892209,0
0,1180,44991,3575892209,3575892209,0
0,1180,44992,3575892209,3575892210,1
0,1180,44993,3575892209,3575892210,1
0,1180,44994,3575892209,3575892210,1
0,1180,44995,3575892209,3575892212,3
0,1180,44996,3575892209,3575892212,3
0,1180,44997,3575892209,3575892213,4
0,1180,44998,3575892209,3575892214,5
0,1180,44999,3575892209,3575892214,5
0,1180,45000,3575892209,3575892215,6
0,1180,45001,3575892209,3575892215,6
0,1180,45002,3575892209,3575892216,7
0,1180,45003,3575892209,3575892216,7
0,1180,45004,3575892209,3575892217,8
0,1180,45005,3575892209,3575892218,9
0,1180,45006,3575892209,3575892219,10
0,1180,45007,3575892209,3575892220,11
0,1180,45008,3575892209,3575892220,11
0,1180,45009,3575892209,3575892220,11
0,1180,45010,3575892209,3575892221,12
0,1180,45011,3575892209,3575892222,13
0,1180,45012,3575892209,3575892222,13
0,1180,45013,3575892209,3575892222,13
0,1180,45014,3575892209,3575892223,14
0,1180,45015,3575892209,3575892227,18
0,1180,45016,3575892209,3575892227,18
0,1180,45017,3575892209,3575892229,20
0,1180,45018,3575892209,3575892230,21
0,1180,45019,3575892209,3575892230,21
0,1180,45020,3575892209,3575892230,21
0,1180,45021,3575892209,3575892231,22
0,1180,45022,3575892209,3575892231,22
0,1180,45023,3575892209,3575892231,22
0,1180,45024,3575892209,3575892232,23
0,1180,45025,3575892209,3575892232,23
0,1180,45026,3575892209,3575892232,23
0,1180,45027,3575892209,3575892233,24
0,1180,45028,3575892209,3575892233,24
0,1180,45029,3575892209,3575892233,24
0,1180,45030,3575892209,3575892234,25
0,1180,45031,3575892209,3575892234,25
0,1180,45032,3575892209,3575892235,26
0,1180,45033,3575892209,3575892235,26
0,1180,45034,3575892209,3575892237,28
0,1180,45035,3575892209,3575892239,30
0,1180,45036,3575892209,3575892240,31
0,1180,45037,3575892209,3575892240,31
0,1180,45038,3575892209,3575892240,31
0,1180,45039,3575892209,3575892240,31
0,1180,45040,3575892209,3575892241,32
0,1180,45041,3575892209,3575892242,33
0,1180,45042,3575892209,3575892242,33
0,1180,45043,3575892209,3575892244,35
0,1180,45044,3575892209,3575892244,35
0,1180,45045,3575892209,3575892245,36
0,1180,45046,3575892209,3575892246,37
0,1180,45047,3575892209,3575892246,37
0,1180,45048,3575892209,3575892246,37
0,1180,45049,3575892209,3575892246,37
0,1180,45050,3575892209,3575892247,38
0,1180,45051,3575892209,3575892248,39
0,1180,45052,3575892209,3575892250,41
0,1180,45053,3575892209,3575892250,41
0,1180,45054,3575892209,3575892251,42
0,1180,45055,3575892209,3575892252,43
0,1180,45056,3575892209,3575892255,46
0,1180,45057,3575892209,3575892255,46
0,1180,45058,3575892209,3575892256,47
0,1180,45059,3575892209,3575892256,47
0,1180,45060,3575892209,3575892256,47
0,1180,45061,3575892209,3575892258,49
0,1180,45062,3575892209,3575892258,49
0,1181,45063,3575892273,3575892273,0
0,1181,45064,3575892273,3575892273,0
0,1181,45065,3575892273,3575892273,0
0,1181,45066,3575892273,3575892273,0
0,1181,45067,3575892273,3575892273,0
0,1181,45068,3575892273,3575892273,0
0,1181,45069,3575892273,3575892273,0
0,1181,45070,3575892273,3575892273,0
0,1181,45071,3575892273,3575892273,0
0,1181,45072,3575892273,3575892273,0
0,1181,45073,3575892273,3575892273,0
0,1181,45074,3575892273,3575892273,0
0,1181,45075,3575892273,3575892273,0
0,1181,45076,3575892273,3575892273,0
0,1181,45077,3575892273,3575892273,0
0,1181,45078,3575892273,3575892273,0
0,1181,45079,3575892273,3575892273,0
0,1181,45080,3575892273,3575892273,0
0,1181,45081,3575892273,3575892273,0
0,1181,45082,3575892273,3575892273,0
0,1181,45083,3575892273,3575892276,3
0,1181,45084,3575892273,3575892278,5
0,1181,45085,3575892273,3575892279,6
0,1181,45086,3575892273,3575892280,7
0,1181,45087,3575892273,3575892280,7
0,1181,45088,3575892273,3575892283,10
0,1181,45089,3575892273,3575892287,14
0,1181,45090,3575892273,3575892287,14
0,1181,45091,3575892273,3575892288,15
0,1181,45092,3575892273,3575892288,15
0,1181,45093,3575892273,3575892289,16
0,1181,45094,3575892273,3575892289,16
0,1181,45095,3575892273,3575892290,17
0,1181,45096,3575892273,3575892290,17
0,1181,45097,3575892273,3575892291,18
0,1181,45098,3575892273,3575892291,18
0,1181,45099,3575892273,3575892291,18
0,1181,45100,3575892273,3575892291,18
0,1181,45101,3575892273,3575892292,19
0,1181,45102,3575892273,3575892293,20
0,1181,45103,3575892273,3575892293,20
0,1181,45104,3575892273,3575892293,20
0,1181,45105,3575892273,3575892293,20
0,1181,45106,3575892273,3575892294,21
0,1181,45107,3575892273,3575892297,24
0,1181,45108,3575892273,3575892297,24
0,1181,45109,3575892273,3575892297,24
0,1181,45110,3575892273,3575892298,25
0,1181,45111,3575892273,3575892298,25
0,1181,45112,3575892273,3575892298,25
0,1181,45113,3575892273,3575892298,25
0,1181,45114,3575892273,3575892300,27
0,1181,45115,3575892273,3575892300,27
0,1181,45116,3575892273,3575892300,27
0,1181,45117,3575892273,3575892300,27
0,1181,45118,3575892273,3575892301,28
0,1181,45119,3575892273,3575892302,29
0,1181,45120,3575892273,3575892303,30
0,1181,45121,3575892273,3575892304,31
0,1181,45122,3575892273,3575892304,31
0,1181,45123,3575892273,3575892305,32
0,1181,45124,3575892273,3575892305,32
0,1181,45125,3575892273,3575892306,33
0,1181,45126,3575892273,3575892307,34
0,1181,45127,3575892273,3575892308,35
0,1181,45128,3575892273,3575892308,35
0,1181,45129,3575892273,3575892308,35
0,1181,45130,3575892273,3575892308,35
0,1181,45131,3575892273,3575892309,36
0,1181,45132,3575892273,3575892309,36
0,1181,45133,3575892273,3575892309,36
0,1181,45134,3575892273,3575892311,38
0,1181,45135,3575892273,3575892311,38
0,1181,45136,3575892273,3575892311,38
0,1181,45137,3575892273,3575892312,39
0,1181,45138,3575892273,3575892312,39
0,1181,45139,3575892273,3575892313,40
0,1181,45140,3575892273,3575892313,40
0,1181,45141,3575892273,3575892313,40
0,1181,45142,3575892273,3575892315,42
0,1181,45143,3575892273,3575892315,42
0,1181,45144,3575892273,3575892316,43
0,1181,45145,3575892273,3575892316,43
0,1181,45146,3575892273,3575892317,44
0,1181,45147,3575892273,3575892319,46
0,1181,45148,3575892273,3575892319,46
0,1181,45149,3575892273,3575892320,47
0,1181,45150,3575892273,3575892321,48
0,1181,45151,3575892273,3575892321,48
0,1181,45152,3575892273,3575892322,49
0,1181,45153,3575892273,3575892323,50
0,1182,45154,3575892337,3575892337,0
0,1182,45155,3575892337,3575892337,0
0,1182,45156,3575892337,3575892337,0
0,1182,45157,3575892337,3575892337,0
0,1182,45158,3575892337,3575892337,0
0,1182,45159,3575892337,3575892337,0
0,1182,45160,3575892337,3575892337,0
0,1182,45161,3575892337,3575892337,0
0,1182,45162,3575892337,3575892337,0
0,1182,45163,3575892337,3575892337,0
0,1182,45164,3575892337,3575892337,0
0,1182,45165,3575892337,3575892337,0
0,1182,45166,3575892337,3575892337,0
0,1182,45167,3575892337,3575892337,0
0,1182,45168,3575892337,3575892337,0
0,1182,45169,3575892337,3575892337,0
0,1182,45170,3575892337,3575892337,0
0,1182,45171,3575892337,3575892337,0
0,1182,45172,3575892337,3575892337,0
0,1182,45173,3575892337,3575892338,1
0,1182,45174,3575892337,3575892338,1
0,1182,45175,3575892337,3575892338,1
0,1182,45176,3575892337,3575892338,1
0,1182,45177,3575892337,3575892338,1
0,1182,45178,3575892337,3575892338,1
0,1182,45179,3575892337,3575892338,1
0,1182,45180,3575892337,3575892338,1
0,1182,45181,3575892337,3575892339,2
0,1182,45182,3575892337,3575892339,2
0,1182,45183,3575892337,3575892339,2
0,1182,45184,3575892337,3575892340,3
0,1182,45185,3575892337,3575892340,3
0,1182,45186,3575892337,3575892340,3
0,1182,45187,3575892337,3575892342,5
0,1182,45188,3575892337,3575892342,5
0,1182,45189,3575892337,3575892344,7
0,1182,45190,3575892337,3575892344,7
0,1182,45191,3575892337,3575892344,7
0,1182,45192,3575892337,3575892346,9
0,1182,45193,3575892337,3575892346,9
0,1182,45194,3575892337,3575892347,10
0,1182,45195,3575892337,3575892347,10
0,1182,45196,3575892337,3575892348,11
0,1182,45197,3575892337,3575892348,11
0,1182,45198,3575892337,3575892348,11
0,1182,45199,3575892337,3575892349,12
0,1182,45200,3575892337,3575892349,12
0,1182,45201,3575892337,3575892350,13
0,1182,45202,3575892337,3575892351,14
0,1182,45203,3575892337,3575892352,15
0,1182,45204,3575892337,3575892353,16
0,1182,45205,3575892337,3575892353,16
0,1182,45206,3575892337,3575892354,17
0,1182,45207,3575892337,3575892354,17
0,1182,45208,3575892337,3575892354,17
0,1182,45209,3575892337,3575892354,17
0,1182,45210,3575892337,3575892355,18
0,1182,45211,3575892337,3575892355,18
0,1182,45212,3575892337,3575892356,19
0,1182,45213,3575892337,3575892357,20
0,1182,45214,3575892337,3575892357,20
0,1182,45215,3575892337,3575892358,21
0,1182,45216,3575892337,3575892359,22
0,1182,45217,3575892337,3575892361,24
0,1182,45218,3575892337,3575892362,25
0,1182,45219,3575892337,3575892362,25
0,1182,45220,3575892337,3575892363,26
0,1182,45221,3575892337,3575892363,26
0,1182,45222,3575892337,3575892363,26
0,1182,45223,3575892337,3575892364,27
0,1182,45224,3575892337,3575892364,27
0,1182,45225,3575892337,3575892365,28
0,1182,45226,3575892337,3575892366,29
0,1182,45227,3575892337,3575892366,29
0,1182,45228,3575892337,3575892367,30
0,1182,45229,3575892337,3575892368,31
0,1182,45230,3575892337,3575892369,32
0,1182,45231,3575892337,3575892370,33
0,1182,45232,3575892337,3575892371,34
0,1182,45233,3575892337,3575892372,35
0,1182,45234,3575892337,3575892372,35
0,1182,45235,3575892337,3575892372,35
0,1182,45236,3575892337,3575892373,36
0,1182,45237,3575892337,3575892373,36
0,1182,45238,3575892337,3575892374,37
0,1182,45239,3575892337,3575892375,38
0,1182,45240,3575892337,3575892375,38
0,1182,45241,3575892337,3575892376,39
0,1182,45242,3575892337,3575892376,39
0,1182,45243,3575892337,3575892377,40
0,1182,45244,3575892337,3575892377,40
0,1182,45245,3575892337,3575892378,41
0,1182,45246,3575892337,3575892378,41
0,1182,45247,3575892337,3575892379,42
0,1182,45248,3575892337,3575892380,43
0,1182,45249,3575892337,3575892382,45
0,1182,45250,3575892337,3575892383,46
0,1182,45251,3575892337,3575892383,46
0,1182,45252,3575892337,3575892384,47
0,1182,45253,3575892337,3575892385,48
0,1182,45254,3575892337,3575892385,48
0,1182,45255,3575892337,3575892386,49
0,1183,45256,3575892405,3575892405,0
0,1183,45257,3575892405,3575892405,0
0,1183,45258,3575892405,3575892405,0
0,1183,45259,3575892405,3575892405,0
0,1183,45260,3575892405,3575892405,0
0,1183,45261,3575892405,3575892405,0
0,1183,45262,3575892405,3575892405,0
0,1183,45263,3575892405,3575892405,0
0,1183,45264,3575892405,3575892405,0
0,1183,45265,3575892405,3575892405,0
0,1183,45266,3575892405,3575892405,0
0,1183,45267,3575892405,3575892405,0
0,1183,45268,3575892405,3575892405,0
0,1183,45269,3575892405,3575892405,0
0,1183,45270,3575892405,3575892405,0
0,1183,45271,3575892405,3575892406,1
0,1183,45272,3575892405,3575892406,1
0,1183,45273,3575892405,3575892409,4
0,1183,45274,3575892405,3575892410,5
0,1183,45275,3575892405,3575892410,5
0,1183,45276,3575892405,3575892410,5
0,1183,45277,3575892405,3575892411,6
0,1183,45278,3575892405,3575892412,7
0,1183,45279,3575892405,3575892413,8
0,1183,45280,3575892405,3575892414,9
0,1183,45281,3575892405,3575892414,9
0,1183,45282,3575892405,3575892415,10
0,1183,45283,3575892405,3575892415,10
0,1183,45284,3575892405,3575892416,11
0,1183,45285,3575892405,3575892416,11
0,1183,45286,3575892405,3575892418,13
0,1183,45287,3575892405,3575892419,14
0,1183,45288,3575892405,3575892419,14
0,1183,45289,3575892405,3575892420,15
0,1183,45290,3575892405,3575892421,16
0,1183,45291,3575892405,3575892421,16
0,1183,45292,3575892405,3575892422,17
0,1183,45293,3575892405,3575892422,17
0,1183,45294,3575892405,3575892422,17
0,1183,45295,3575892405,3575892422,17
0,1183,45296,3575892405,3575892423,18
0,1183,45297,3575892405,3575892427,22
0,1183,45298,3575892405,3575892427,22
0,1183,45299,3575892405,3575892429,24
0,1183,45300,3575892405,3575892430,25
0,1183,45301,3575892405,3575892430,25
0,1183,45302,3575892405,3575892431,26
0,1183,45303,3575892405,3575892431,26
0,1183,45304,3575892405,3575892432,27
0,1183,45305,3575892405,3575892432,27
0,1183,45306,3575892405,3575892432,27
0,1183,45307,3575892405,3575892432,27
0,1183,45308,3575892405,3575892433,28
0,1183,45309,3575892405,3575892433,28
0,1183,45310,3575892405,3575892433,28
0,1183,45311,3575892405,3575892433,28
0,1183,45312,3575892405,3575892434,29
0,1183,45313,3575892405,3575892434,29
0,1183,45314,3575892405,3575892434,29
0,1183,45315,3575892405,3575892435,30
0,1183,45316,3575892405,3575892435,30
0,1183,45317,3575892405,3575892438,33
0,1183,45318,3575892405,3575892440,35
0,1183,45319,3575892405,3575892440,35
0,1183,45320,3575892405,3575892440,35
0,1183,45321,3575892405,3575892440,35
0,1183,45322,3575892405,3575892441,36
0,1183,45323,3575892405,3575892442,37
0,1183,45324,3575892405,3575892442,37
0,1183,45325,3575892405,3575892443,38
0,1183,45326,3575892405,3575892443,38
0,1183,45327,3575892405,3575892444,39
0,1183,45328,3575892405,3575892445,40
0,1183,45329,3575892405,3575892445,40
0,1183,45330,3575892405,3575892445,40
0,1183,45331,3575892405,3575892446,41
0,1183,45332,3575892405,3575892446,41
0,1183,45333,3575892405,3575892446,41
0,1183,45334,3575892405,3575892446,41
0,1183,45335,3575892405,3575892448,43
0,1183,45336,3575892405,3575892448,43
0,1183,45337,3575892405,3575892450,45
0,1183,45338,3575892405,3575892451,46
0,1183,45339,3575892405,3575892451,46
0,1183,45340,3575892405,3575892452,47
0,1183,45341,3575892405,3575892453,48
0,1183,45342,3575892405,3575892455,50
0,1184,45343,3575892469,3575892469,0
0,1184,45344,3575892469,3575892469,0
0,1184,45345,3575892469,3575892469,0
0,1184,45346,3575892469,3575892469,0
0,1184,45347,3575892469,3575892469,0
0,1184,45348,3575892469,3575892469,0
0,1184,45349,3575892469,3575892469,0
0,1184,45350,3575892469,3575892469,0
0,1184,45351,3575892469,3575892469,0
0,1184,45352,3575892469,3575892469,0
0,1184,45353,3575892469,3575892469,0
0,1184,45354,3575892469,3575892469,0
0,1184,45355,3575892469,3575892469,0
0,1184,45356,3575892469,3575892469,0
0,1184,45357,3575892469,3575892469,0
0,1184,45358,3575892469,3575892469,0
0,1184,45359,3575892469,3575892469,0
0,1184,45360,3575892469,3575892469,0
0,1184,45361,3575892469,3575892469,0
0,1184,45362,3575892469,3575892469,0
0,1184,45363,3575892469,3575892469,0
0,1184,45364,3575892469,3575892469,0
0,1184,45365,3575892469,3575892469,0
0,1184,45366,3575892469,3575892469,0
0,1184,45367,3575892469,3575892470,1
0,1184,45368,3575892469,3575892470,1
0,1184,45369,3575892469,3575892470,1
0,1184,45370,3575892469,3575892478,9
0,1184,45371,3575892469,3575892480,11
0,1184,45372,3575892469,3575892480,11
0,1184,45373,3575892469,3575892480,11
0,1184,45374,3575892469,3575892483,14
0,1184,45375,3575892469,3575892487,18
0,1184,45376,3575892469,3575892488,19
0,1184,45377,3575892469,3575892488,19
0,1184,45378,3575892469,3575892489,20
0,1184,45379,3575892469,3575892489,20
0,1184,45380,3575892469,3575892489,20
0,1184,45381,3575892469,3575892489,20
0,1184,45382,3575892469,3575892490,21
0,1184,45383,3575892469,3575892491,22
0,1184,45384,3575892469,3575892491,22
0,1184,45385,3575892469,3575892491,22
0,1184,45386,3575892469,3575892491,22
0,1184,45387,3575892469,3575892492,23
0,1184,45388,3575892469,3575892493,24
0,1184,45389,3575892469,3575892493,24
0,1184,45390,3575892469,3575892494,25
0,1184,45391,3575892469,3575892494,25
0,1184,45392,3575892469,3575892495,26
0,1184,45393,3575892469,3575892496,27
0,1184,45394,3575892469,3575892496,27
0,1184,45395,3575892469,3575892497,28
0,1184,45396,3575892469,3575892498,29
0,1184,45397,3575892469,3575892498,29
0,1184,45398,3575892469,3575892498,29
0,1184,45399,3575892469,3575892498,29
0,1184,45400,3575892469,3575892500,31
0,1184,45401,3575892469,3575892500,31
0,1184,45402,3575892469,3575892500,31
0,1184,45403,3575892469,3575892502,33
0,1184,45404,3575892469,3575892503,34
0,1184,45405,3575892469,3575892504,35
0,1184,45406,3575892469,3575892506,37
0,1184,45407,3575892469,3575892507,38
0,1184,45408,3575892469,3575892507,38
0,1184,45409,3575892469,3575892507,38
0,1184,45410,3575892469,3575892508,39
0,1184,45411,3575892469,3575892508,39
0,1184,45412,3575892469,3575892508,39
0,1184,45413,3575892469,3575892509,40
0,1184,45414,3575892469,3575892509,40
0,1184,45415,3575892469,3575892510,41
0,1184,45416,3575892469,3575892511,42
0,1184,45417,3575892469,3575892511,42
0,1184,45418,3575892469,3575892512,43
0,1184,45419,3575892469,3575892512,43
0,1184,45420,3575892469,3575892514,45
0,1184,45421,3575892469,3575892514,45
0,1184,45422,3575892469,3575892515,46
0,1184,45423,3575892469,3575892515,46
0,1184,45424,3575892469,3575892516,47
0,1184,45425,3575892469,3575892516,47
0,1184,45426,3575892469,3575892517,48
0,1184,45427,3575892469,3575892519,50
0,1185,45428,3575892531,3575892531,0
0,1185,45429,3575892531,3575892531,0
0,1185,45430,3575892531,3575892531,0
0,1185,45431,3575892531,3575892531,0
0,1185,45432,3575892531,3575892531,0
0,1185,45433,3575892531,3575892531,0
0,1185,45434,3575892531,3575892531,0
0,1185,45435,3575892531,3575892531,0
0,1185,45436,3575892531,3575892531,0
0,1185,45437,3575892531,3575892531,0
0,1185,45438,3575892531,3575892531,0
0,1185,45439,3575892531,3575892531,0
0,1185,45440,3575892531,3575892531,0
0,1185,45441,3575892531,3575892531,0
0,1185,45442,3575892531,3575892531,0
0,1185,45443,3575892531,3575892531,0
0,1185,45444,3575892531,3575892531,0
0,1185,45445,3575892531,3575892531,0
0,1185,45446,3575892531,3575892531,0
0,1185,45447,3575892531,3575892531,0
0,1185,45448,3575892531,3575892531,0
0,1185,45449,3575892531,3575892531,0
0,1185,45450,3575892531,3575892531,0
0,1185,45451,3575892531,3575892532,1
0,1185,45452,3575892531,3575892533,2
0,1185,45453,3575892531,3575892533,2
0,1185,45454,3575892531,3575892534,3
0,1185,45455,3575892531,3575892535,4
0,1185,45456,3575892531,3575892535,4
0,1185,45457,3575892531,3575892536,5
0,1185,45458,3575892531,3575892536,5
0,1185,45459,3575892531,3575892537,6
0,1185,45460,3575892531,3575892538,7
0,1185,45461,3575892531,3575892538,7
0,1185,45462,3575892531,3575892538,7
0,1185,45463,3575892531,3575892538,7
0,1185,45464,3575892531,3575892539,8
0,1185,45465,3575892531,3575892540,9
0,1185,45466,3575892531,3575892540,9
0,1185,45467,3575892531,3575892541,10
0,1185,45468,3575892531,3575892541,10
0,1185,45469,3575892531,3575892543,12
0,1185,45470,3575892531,3575892544,13
0,1185,45471,3575892531,3575892544,13
0,1185,45472,3575892531,3575892544,13
0,1185,45473,3575892531,3575892545,14
0,1185,45474,3575892531,3575892545,14
0,1185,45475,3575892531,3575892546,15
0,1185,45476,3575892531,3575892546,15
0,1185,45477,3575892531,3575892547,16
0,1185,45478,3575892531,3575892547,16
0,1185,45479,3575892531,3575892548,17
0,1185,45480,3575892531,3575892548,17
0,1185,45481,3575892531,3575892549,18
0,1185,45482,3575892531,3575892550,19
0,1185,45483,3575892531,3575892551,20
0,1185,45484,3575892531,3575892551,20
0,1185,45485,3575892531,3575892552,21
0,1185,45486,3575892531,3575892552,21
0,1185,45487,3575892531,3575892552,21
0,1185,45488,3575892531,3575892553,22
0,1185,45489,3575892531,3575892553,22
0,1185,45490,3575892531,3575892554,23
0,1185,45491,3575892531,3575892554,23
0,1185,45492,3575892531,3575892554,23
0,1185,45493,3575892531,3575892556,25
0,1185,45494,3575892531,3575892556,25
0,1185,45495,3575892531,3575892556,25
0,1185,45496,3575892531,3575892557,26
0,1185,45497,3575892531,3575892557,26
0,1185,45498,3575892531,3575892560,29
0,1185,45499,3575892531,3575892561,30
0,1185,45500,3575892531,3575892561,30
0,1185,45501,3575892531,3575892562,31
0,1185,45502,3575892531,3575892562,31
0,1185,45503,3575892531,3575892562,31
0,1185,45504,3575892531,3575892563,32
0,1185,45505,3575892531,3575892563,32
0,1185,45506,3575892531,3575892564,33
0,1185,45507,3575892531,3575892564,33
0,1185,45508,3575892531,3575892565,34
0,1185,45509,3575892531,3575892565,34
0,1185,45510,3575892531,3575892566,35
0,1185,45511,3575892531,3575892568,37
0,1185,45512,3575892531,3575892568,37
0,1185,45513,3575892531,3575892569,38
0,1185,45514,3575892531,3575892570,39
0,1185,45515,3575892531,3575892571,40
0,1185,45516,3575892531,3575892572,41
0,1185,45517,3575892531,3575892573,42
0,1185,45518,3575892531,3575892573,42
0,1185,45519,3575892531,3575892573,42
0,1185,45520,3575892531,3575892574,43
0,1185,45521,3575892531,3575892574,43
0,1185,45522,3575892531,3575892574,43
0,1185,45523,3575892531,3575892575,44
0,1185,45524,3575892531,3575892575,44
0,1185,45525,3575892531,3575892575,44
0,1185,45526,3575892531,3575892576,45
0,1185,45527,3575892531,3575892577,46
0,1185,45528,3575892531,3575892578,47
0,1185,45529,3575892531,3575892578,47
0,1185,45530,3575892531,3575892581,50
0,1186,45531,3575892595,3575892595,0
0,1186,45532,3575892595,3575892595,0
0,1186,45533,3575892595,3575892595,0
0,1186,45534,3575892595,3575892595,0
0,1186,45535,3575892595,3575892595,0
0,1186,45536,3575892595,3575892595,0
0,1186,45537,3575892595,3575892595,0
0,1186,45538,3575892595,3575892595,0
0,1186,45539,3575892595,3575892595,0
0,1186,45540,3575892595,3575892595,0
0,1186,45541,3575892595,3575892596,1
0,1186,45542,3575892595,3575892598,3
0,1186,45543,3575892595,3575892600,5
0,1186,45544,3575892595,3575892600,5
0,1186,45545,3575892595,3575892600,5
0,1186,45546,3575892595,3575892600,5
0,1186,45547,3575892595,3575892600,5
0,1186,45548,3575892595,3575892601,6
0,1186,45549,3575892595,3575892603,8
0,1186,45550,3575892595,3575892603,8
0,1186,45551,3575892595,3575892604,9
0,1186,45552,3575892595,3575892605,10
0,1186,45553,3575892595,3575892605,10
0,1186,45554,3575892595,3575892609,14
0,1186,45555,3575892595,3575892610,15
0,1186,45556,3575892595,3575892611,16
0,1186,45557,3575892595,3575892612,17
0,1186,45558,3575892595,3575892613,18
0,1186,45559,3575892595,3575892615,20
0,1186,45560,3575892595,3575892615,20
0,1186,45561,3575892595,3575892615,20
0,1186,45562,3575892595,3575892616,21
0,1186,45563,3575892595,3575892617,22
0,1186,45564,3575892595,3575892618,23
0,1186,45565,3575892595,3575892618,23
0,1186,45566,3575892595,3575892619,24
0,1186,45567,3575892595,3575892620,25
0,1186,45568,3575892595,3575892621,26
0,1186,45569,3575892595,3575892621,26
0,1186,45570,3575892595,3575892622,27
0,1186,45571,3575892595,3575892622,27
0,1186,45572,3575892595,3575892623,28
0,1186,45573,3575892595,3575892626,31
0,1186,45574,3575892595,3575892626,31
0,1186,45575,3575892595,3575892626,31
0,1186,45576,3575892595,3575892629,34
0,1186,45577,3575892595,3575892629,34
0,1186,45578,3575892595,3575892629,34
0,1186,45579,3575892595,3575892630,35
0,1186,45580,3575892595,3575892630,35
0,1186,45581,3575892595,3575892631,36
0,1186,45582,3575892595,3575892631,36
0,1186,45583,3575892595,3575892631,36
0,1186,45584,3575892595,3575892631,36
0,1186,45585,3575892595,3575892631,36
0,1186,45586,3575892595,3575892632,37
0,1186,45587,3575892595,3575892632,37
0,1186,45588,3575892595,3575892633,38
0,1186,45589,3575892595,3575892633,38
0,1186,45590,3575892595,3575892633,38
0,1186,45591,3575892595,3575892634,39
0,1186,45592,3575892595,3575892634,39
0,1186,45593,3575892595,3575892635,40
0,1186,45594,3575892595,3575892637,42
0,1186,45595,3575892595,3575892639,44
0,1186,45596,3575892595,3575892639,44
0,1186,45597,3575892595,3575892640,45
0,1186,45598,3575892595,3575892641,46
0,1186,45599,3575892595,3575892642,47
0,1186,45600,3575892595,3575892642,47
0,1186,45601,3575892595,3575892644,49
0,1186,45602,3575892595,3575892645,50
0,1187,45603,3575892658,3575892658,0
0,1187,45604,3575892658,3575892658,0
0,1187,45605,3575892658,3575892658,0
0,1187,45606,3575892658,3575892658,0
0,1187,45607,3575892658,3575892658,0
0,1187,45608,3575892658,3575892658,0
0,1187,45609,3575892658,3575892658,0
0,1187,45610,3575892658,3575892658,0
0,1187,45611,3575892658,3575892658,0
0,1187,45612,3575892658,3575892658,0
0,1187,45613,3575892658,3575892658,0
0,1187,45614,3575892658,3575892658,0
0,1187,45615,3575892658,3575892658,0
0,1187,45616,3575892658,3575892658,0
0,1187,45617,3575892658,3575892658,0
0,1187,45618,3575892658,3575892659,1
0,1187,45619,3575892658,3575892660,2
0,1187,45620,3575892658,3575892660,2
0,1187,45621,3575892658,3575892660,2
0,1187,45622,3575892658,3575892661,3
0,1187,45623,3575892658,3575892661,3
0,1187,45624,3575892658,3575892662,4
0,1187,45625,3575892658,3575892662,4
0,1187,45626,3575892658,3575892662,4
0,1187,45627,3575892658,3575892662,4
0,1187,45628,3575892658,3575892663,5
0,1187,45629,3575892658,3575892664,6
0,1187,45630,3575892658,3575892665,7
0,1187,45631,3575892658,3575892665,7
0,1187,45632,3575892658,3575892665,7
0,1187,45633,3575892658,3575892665,7
0,1187,45634,3575892658,3575892666,8
0,1187,45635,3575892658,3575892667,9
0,1187,45636,3575892658,3575892669,11
0,1187,45637,3575892658,3575892676,18
0,1187,45638,3575892658,3575892677,19
0,1187,45639,3575892658,3575892679,21
0,1187,45640,3575892658,3575892680,22
0,1187,45641,3575892658,3575892682,24
0,1187,45642,3575892658,3575892688,30
0,1187,45643,3575892658,3575892688,30
0,1187,45644,3575892658,3575892688,30
0,1187,45645,3575892658,3575892688,30
0,1187,45646,3575892658,3575892689,31
0,1187,45647,3575892658,3575892689,31
0,1187,45648,3575892658,3575892690,32
0,1187,45649,3575892658,3575892690,32
0,1187,45650,3575892658,3575892690,32
0,1187,45651,3575892658,3575892691,33
0,1187,45652,3575892658,3575892691,33
0,1187,45653,3575892658,3575892692,34
0,1187,45654,3575892658,3575892693,35
0,1187,45655,3575892658,3575892693,35
0,1187,45656,3575892658,3575892693,35
0,1187,45657,3575892658,3575892694,36
0,1187,45658,3575892658,3575892695,37
0,1187,45659,3575892658,3575892695,37
0,1187,45660,3575892658,3575892696,38
0,1187,45661,3575892658,3575892696,38
0,1187,45662,3575892658,3575892696,38
0,1187,45663,3575892658,3575892697,39
0,1187,45664,3575892658,3575892697,39
0,1187,45665,3575892658,3575892697,39
0,1187,45666,3575892658,3575892698,40
0,1187,45667,3575892658,3575892698,40
0,1187,45668,3575892658,3575892700,42
0,1187,45669,3575892658,3575892700,42
0,1187,45670,3575892658,3575892700,42
0,1187,45671,3575892658,3575892700,42
0,1187,45672,3575892658,3575892701,43
0,1187,45673,3575892658,3575892703,45
0,1187,45674,3575892658,3575892703,45
0,1187,45675,3575892658,3575892704,46
0,1187,45676,3575892658,3575892705,47
0,1187,45677,3575892658,3575892706,48
0,1187,45678,3575892658,3575892706,48
0,1187,45679,3575892658,3575892707,49
0,1187,45680,3575892658,3575892707,49
0,1187,45681,3575892658,3575892708,50
0,1188,45682,3575892726,3575892726,0
0,1188,45683,3575892726,3575892726,0
0,1188,45684,3575892726,3575892726,0
0,1188,45685,3575892726,3575892726,0
0,1188,45686,3575892726,3575892726,0
0,1188,45687,3575892726,3575892726,0
0,1188,45688,3575892726,3575892726,0
0,1188,45689,3575892726,3575892726,0
0,1188,45690,3575892726,3575892726,0
0,1188,45691,3575892726,3575892726,0
0,1188,45692,3575892726,3575892726,0
0,1188,45693,3575892726,3575892726,0
0,1188,45694,3575892726,3575892726,0
0,1188,45695,3575892726,3575892726,0
0,1188,45696,3575892726,3575892726,0
0,1188,45697,3575892726,3575892726,0
0,1188,45698,3575892726,3575892726,0
0,1188,45699,3575892726,3575892726,0
0,1188,45700,3575892726,3575892726,0
0,1188,45701,3575892726,3575892726,0
0,1188,45702,3575892726,3575892726,0
0,1188,45703,3575892726,3575892726,0
0,1188,45704,3575892726,3575892726,0
0,1188,45705,3575892726,3575892726,0
0,1188,45706,3575892726,3575892726,0
0,1188,45707,3575892726,3575892726,0
0,1188,45708,3575892726,3575892726,0
0,1188,45709,3575892726,3575892726,0
0,1188,45710,3575892726,3575892727,1
0,1188,45711,3575892726,3575892727,1
0,1188,45712,3575892726,3575892727,1
0,1188,45713,3575892726,3575892727,1
0,1188,45714,3575892726,3575892727,1
0,1188,45715,3575892726,3575892730,4
0,1188,45716,3575892726,3575892730,4
0,1188,45717,3575892726,3575892730,4
0,1188,45718,3575892726,3575892731,5
0,1188,45719,3575892726,3575892732,6
0,1188,45720,3575892726,3575892733,7
0,1188,45721,3575892726,3575892733,7
0,1188,45722,3575892726,3575892736,10
0,1188,45723,3575892726,3575892736,10
0,1188,45724,3575892726,3575892736,10
0,1188,45725,3575892726,3575892737,11
0,1188,45726,3575892726,3575892738,12
0,1188,45727,3575892726,3575892738,12
0,1188,45728,3575892726,3575892738,12
0,1188,45729,3575892726,3575892739,13
0,1188,45730,3575892726,3575892740,14
0,1188,45731,3575892726,3575892740,14
0,1188,45732,3575892726,3575892742,16
0,1188,45733,3575892726,3575892743,17
0,1188,45734,3575892726,3575892744,18
0,1188,45735,3575892726,3575892744,18
0,1188,45736,3575892726,3575892745,19
0,1188,45737,3575892726,3575892746,20
0,1188,45738,3575892726,3575892747,21
0,1188,45739,3575892726,3575892747,21
0,1188,45740,3575892726,3575892747,21
0,1188,45741,3575892726,3575892747,21
0,1188,45742,3575892726,3575892747,21
0,1188,45743,3575892726,3575892748,22
0,1188,45744,3575892726,3575892749,23
0,1188,45745,3575892726,3575892749,23
0,1188,45746,3575892726,3575892750,24
0,1188,45747,3575892726,3575892751,25
0,1188,45748,3575892726,3575892751,25
0,1188,45749,3575892726,3575892752,26
0,1188,45750,3575892726,3575892753,27
0,1188,45751,3575892726,3575892753,27
0,1188,45752,3575892726,3575892753,27
0,1188,45753,3575892726,3575892753,27
0,1188,45754,3575892726,3575892753,27
0,1188,45755,3575892726,3575892754,28
0,1188,45756,3575892726,3575892755,29
0,1188,45757,3575892726,3575892756,30
0,1188,45758,3575892726,3575892756,30
0,1188,45759,3575892726,3575892759,33
0,1188,45760,3575892726,3575892759,33
0,1188,45761,3575892726,3575892759,33
0,1188,45762,3575892726,3575892760,34
0,1188,45763,3575892726,3575892760,34
0,1188,45764,3575892726,3575892761,35
0,1188,45765,3575892726,3575892762,36
0,1188,45766,3575892726,3575892763,37
0,1188,45767,3575892726,3575892763,37
0,1188,45768,3575892726,3575892763,37
0,1188,45769,3575892726,3575892764,38
0,1188,45770,3575892726,3575892764,38
0,1188,45771,3575892726,3575892765,39
0,1188,45772,3575892726,3575892765,39
0,1188,45773,3575892726,3575892767,41
0,1188,45774,3575892726,3575892768,42
0,1188,45775,3575892726,3575892769,43
0,1188,45776,3575892726,3575892770,44
0,1188,45777,3575892726,3575892771,45
0,1188,45778,3575892726,3575892771,45
0,1188,45779,3575892726,3575892771,45
0,1188,45780,3575892726,3575892772,46
0,1188,45781,3575892726,3575892772,46
0,1188,45782,3575892726,3575892773,47
0,1188,45783,3575892726,3575892773,47
0,1188,45784,3575892726,3575892774,48
0,1188,45785,3575892726,3575892774,48
0,1188,45786,3575892726,3575892775,49
0,1188,45787,3575892726,3575892775,49
0,1188,45788,3575892726,3575892776,50
0,1189,45789,3575892790,3575892791,1
0,1189,45790,3575892790,3575892791,1
0,1189,45791,3575892790,3575892791,1
0,1189,45792,3575892790,3575892791,1
0,1189,45793,3575892790,3575892791,1
0,1189,45794,3575892790,3575892791,1
0,1189,45795,3575892790,3575892791,1
0,1189,45796,3575892790,3575892791,1
0,1189,45797,3575892790,3575892791,1
0,1189,45798,3575892790,3575892791,1
0,1189,45799,3575892790,3575892791,1
0,1189,45800,3575892790,3575892791,1
0,1189,45801,3575892790,3575892791,1
0,1189,45802,3575892790,3575892791,1
0,1189,45803,3575892790,3575892794,4
0,1189,45804,3575892790,3575892794,4
0,1189,45805,3575892790,3575892796,6
0,1189,45806,3575892790,3575892798,8
0,1189,45807,3575892790,3575892800,10
0,1189,45808,3575892790,3575892800,10
0,1189,45809,3575892790,3575892800,10
0,1189,45810,3575892790,3575892801,11
0,1189,45811,3575892790,3575892802,12
0,1189,45812,3575892790,3575892804,14
0,1189,45813,3575892790,3575892804,14
0,1189,45814,3575892790,3575892805,15
0,1189,45815,3575892790,3575892809,19
0,1189,45816,3575892790,3575892810,20
0,1189,45817,3575892790,3575892810,20
0,1189,45818,3575892790,3575892811,21
0,1189,45819,3575892790,3575892811,21
0,1189,45820,3575892790,3575892813,23
0,1189,45821,3575892790,3575892813,23
0,1189,45822,3575892790,3575892813,23
0,1189,45823,3575892790,3575892815,25
0,1189,45824,3575892790,3575892815,25
0,1189,45825,3575892790,3575892816,26
0,1189,45826,3575892790,3575892817,27
0,1189,45827,3575892790,3575892817,27
0,1189,45828,3575892790,3575892818,28
0,1189,45829,3575892790,3575892819,29
0,1189,45830,3575892790,3575892820,30
0,1189,45831,3575892790,3575892821,31
0,1189,45832,3575892790,3575892821,31
0,1189,45833,3575892790,3575892822,32
0,1189,45834,3575892790,3575892822,32
0,1189,45835,3575892790,3575892822,32
0,1189,45836,3575892790,3575892823,33
0,1189,45837,3575892790,3575892827,37
0,1189,45838,3575892790,3575892827,37
0,1189,45839,3575892790,3575892829,39
0,1189,45840,3575892790,3575892829,39
0,1189,45841,3575892790,3575892830,40
0,1189,45842,3575892790,3575892830,40
0,1189,45843,3575892790,3575892831,41
0,1189,45844,3575892790,3575892831,41
0,1189,45845,3575892790,3575892832,42
0,1189,45846,3575892790,3575892832,42
0,1189,45847,3575892790,3575892832,42
0,1189,45848,3575892790,3575892832,42
0,1189,45849,3575892790,3575892833,43
0,1189,45850,3575892790,3575892833,43
0,1189,45851,3575892790,3575892833,43
0,1189,45852,3575892790,3575892833,43
0,1189,45853,3575892790,3575892833,43
0,1189,45854,3575892790,3575892834,44
0,1189,45855,3575892790,3575892835,45
0,1189,45856,3575892790,3575892837,47
0,1189,45857,3575892790,3575892839,49
0,1189,45858,3575892790,3575892839,49
0,1189,45859,3575892790,3575892840,50
0,1190,45860,3575892860,3575892860,0
0,1190,45861,3575892860,3575892860,0
0,1190,45862,3575892860,3575892860,0
0,1190,45863,3575892860,3575892860,0
0,1190,45864,3575892860,3575892860,0
0,1190,45865,3575892860,3575892860,0
0,1190,45866,3575892860,3575892860,0
0,1190,45867,3575892860,3575892860,0
0,1190,45868,3575892860,3575892860,0
0,1190,45869,3575892860,3575892860,0
0,1190,45870,3575892860,3575892860,0
0,1190,45871,3575892860,3575892860,0
0,1190,45872,3575892860,3575892860,0
0,1190,45873,3575892860,3575892860,0
0,1190,45874,3575892860,3575892860,0
0,1190,45875,3575892860,3575892860,0
0,1190,45876,3575892860,3575892860,0
0,1190,45877,3575892860,3575892860,0
0,1190,45878,3575892860,3575892860,0
0,1190,45879,3575892860,3575892860,0
0,1190,45880,3575892860,3575892860,0
0,1190,45881,3575892860,3575892860,0
0,1190,45882,3575892860,3575892860,0
0,1190,45883,3575892860,3575892860,0
0,1190,45884,3575892860,3575892860,0
0,1190,45885,3575892860,3575892860,0
0,1190,45886,3575892860,3575892861,1
0,1190,45887,3575892860,3575892862,2
0,1190,45888,3575892860,3575892862,2
0,1190,45889,3575892860,3575892863,3
0,1190,45890,3575892860,3575892864,4
0,1190,45891,3575892860,3575892864,4
0,1190,45892,3575892860,3575892865,5
0,1190,45893,3575892860,3575892865,5
0,1190,45894,3575892860,3575892866,6
0,1190,45895,3575892860,3575892866,6
0,1190,45896,3575892860,3575892866,6
0,1190,45897,3575892860,3575892868,8
0,1190,45898,3575892860,3575892869,9
0,1190,45899,3575892860,3575892876,16
0,1190,45900,3575892860,3575892878,18
0,1190,45901,3575892860,3575892880,20
0,1190,45902,3575892860,3575892880,20
0,1190,45903,3575892860,3575892880,20
0,1190,45904,3575892860,3575892884,24
0,1190,45905,3575892860,3575892888,28
0,1190,45906,3575892860,3575892888,28
0,1190,45907,3575892860,3575892888,28
0,1190,45908,3575892860,3575892888,28
0,1190,45909,3575892860,3575892889,29
0,1190,45910,3575892860,3575892890,30
0,1190,45911,3575892860,3575892890,30
0,1190,45912,3575892860,3575892891,31
0,1190,45913,3575892860,3575892891,31
0,1190,45914,3575892860,3575892891,31
0,1190,45915,3575892860,3575892891,31
0,1190,45916,3575892860,3575892892,32
0,1190,45917,3575892860,3575892893,33
0,1190,45918,3575892860,3575892893,33
0,1190,45919,3575892860,3575892894,34
0,1190,45920,3575892860,3575892894,34
0,1190,45921,3575892860,3575892895,35
0,1190,45922,3575892860,3575892896,36
0,1190,45923,3575892860,3575892896,36
0,1190,45924,3575892860,3575892897,37
0,1190,45925,3575892860,3575892897,37
0,1190,45926,3575892860,3575892898,38
0,1190,45927,3575892860,3575892898,38
0,1190,45928,3575892860,3575892898,38
0,1190,45929,3575892860,3575892899,39
0,1190,45930,3575892860,3575892900,40
0,1190,45931,3575892860,3575892900,40
0,1190,45932,3575892860,3575892901,41
0,1190,45933,3575892860,3575892903,43
0,1190,45934,3575892860,3575892903,43
0,1190,45935,3575892860,3575892904,44
0,1190,45936,3575892860,3575892905,45
0,1190,45937,3575892860,3575892906,46
0,1190,45938,3575892860,3575892906,46
0,1190,45939,3575892860,3575892907,47
0,1190,45940,3575892860,3575892907,47
0,1190,45941,3575892860,3575892908,48
0,1190,45942,3575892860,3575892908,48
0,1190,45943,3575892860,3575892909,49
0,1190,45944,3575892860,3575892909,49
0,1191,45945,3575892926,3575892926,0
0,1191,45946,3575892926,3575892926,0
0,1191,45947,3575892926,3575892926,0
0,1191,45948,3575892926,3575892926,0
0,1191,45949,3575892926,3575892926,0
0,1191,45950,3575892926,3575892926,0
0,1191,45951,3575892926,3575892926,0
0,1191,45952,3575892926,3575892926,0
0,1191,45953,3575892926,3575892926,0
0,1191,45954,3575892926,3575892926,0
0,1191,45955,3575892926,3575892926,0
0,1191,45956,3575892926,3575892926,0
0,1191,45957,3575892926,3575892926,0
0,1191,45958,3575892926,3575892926,0
0,1191,45959,3575892926,3575892926,0
0,1191,45960,3575892926,3575892926,0
0,1191,45961,3575892926,3575892926,0
0,1191,45962,3575892926,3575892926,0
0,1191,45963,3575892926,3575892926,0
0,1191,45964,3575892926,3575892926,0
0,1191,45965,3575892926,3575892926,0
0,1191,45966,3575892926,3575892926,0
0,1191,45967,3575892926,3575892926,0
0,1191,45968,3575892926,3575892926,0
0,1191,45969,3575892926,3575892926,0
0,1191,45970,3575892926,3575892926,0
0,1191,45971,3575892926,3575892926,0
0,1191,45972,3575892926,3575892926,0
0,1191,45973,3575892926,3575892926,0
0,1191,45974,3575892926,3575892927,1
0,1191,45975,3575892926,3575892927,1
0,1191,45976,3575892926,3575892927,1
0,1191,45977,3575892926,3575892928,2
0,1191,45978,3575892926,3575892930,4
0,1191,45979,3575892926,3575892931,5
0,1191,45980,3575892926,3575892931,5
0,1191,45981,3575892926,3575892932,6
0,1191,45982,3575892926,3575892933,7
0,1191,45983,3575892926,3575892934,8
0,1191,45984,3575892926,3575892934,8
0,1191,45985,3575892926,3575892936,10
0,1191,45986,3575892926,3575892937,11
0,1191,45987,3575892926,3575892937,11
0,1191,45988,3575892926,3575892937,11
0,1191,45989,3575892926,3575892937,11
0,1191,45990,3575892926,3575892938,12
0,1191,45991,3575892926,3575892938,12
0,1191,45992,3575892926,3575892938,12
0,1191,45993,3575892926,3575892939,13
0,1191,45994,3575892926,3575892939,13
0,1191,45995,3575892926,3575892939,13
0,1191,45996,3575892926,3575892940,14
0,1191,45997,3575892926,3575892941,15
0,1191,45998,3575892926,3575892942,16
0,1191,45999,3575892926,3575892943,17
0,1191,46000,3575892926,3575892943,17
0,1191,46001,3575892926,3575892945,19
0,1191,46002,3575892926,3575892945,19
0,1191,46003,3575892926,3575892945,19
0,1191,46004,3575892926,3575892947,21
0,1191,46005,3575892926,3575892947,21
0,1191,46006,3575892926,3575892947,21
0,1191,46007,3575892926,3575892947,21
0,1191,46008,3575892926,3575892948,22
0,1191,46009,3575892926,3575892949,23
0,1191,46010,3575892926,3575892950,24
0,1191,46011,3575892926,3575892951,25
0,1191,46012,3575892926,3575892952,26
0,1191,46013,3575892926,3575892952,26
0,1191,46014,3575892926,3575892953,27
0,1191,46015,3575892926,3575892954,28
0,1191,46016,3575892926,3575892954,28
0,1191,46017,3575892926,3575892954,28
0,1191,46018,3575892926,3575892955,29
0,1191,46019,3575892926,3575892955,29
0,1191,46020,3575892926,3575892956,30
0,1191,46021,3575892926,3575892956,30
0,1191,46022,3575892926,3575892958,32
0,1191,46023,3575892926,3575892958,32
0,1191,46024,3575892926,3575892959,33
0,1191,46025,3575892926,3575892960,34
0,1191,46026,3575892926,3575892960,34
0,1191,46027,3575892926,3575892961,35
0,1191,46028,3575892926,3575892962,36
0,1191,46029,3575892926,3575892962,36
0,1191,46030,3575892926,3575892962,36
0,1191,46031,3575892926,3575892963,37
0,1191,46032,3575892926,3575892964,38
0,1191,46033,3575892926,3575892964,38
0,1191,46034,3575892926,3575892964,38
0,1191,46035,3575892926,3575892965,39
0,1191,46036,3575892926,3575892965,39
0,1191,46037,3575892926,3575892966,40
0,1191,46038,3575892926,3575892966,40
0,1191,46039,3575892926,3575892969,43
0,1191,46040,3575892926,3575892969,43
0,1191,46041,3575892926,3575892971,45
0,1191,46042,3575892926,3575892971,45
0,1191,46043,3575892926,3575892971,45
0,1191,46044,3575892926,3575892973,47
0,1191,46045,3575892926,3575892973,47
0,1191,46046,3575892926,3575892974,48
0,1191,46047,3575892926,3575892974,48
0,1191,46048,3575892926,3575892974,48
0,1191,46049,3575892926,3575892975,49
0,1191,46050,3575892926,3575892976,50
0,1192,46051,3575892997,3575892997,0
0,1192,46052,3575892997,3575892997,0
0,1192,46053,3575892997,3575892997,0
0,1192,46054,3575892997,3575892997,0
0,1192,46055,3575892997,3575892997,0
0,1192,46056,3575892997,3575892997,0
0,1192,46057,3575892997,3575892997,0
0,1192,46058,3575892997,3575892997,0
0,1192,46059,3575892997,3575892997,0
0,1192,46060,3575892997,3575892997,0
0,1192,46061,3575892997,3575892997,0
0,1192,46062,3575892997,3575892997,0
0,1192,46063,3575892997,3575892997,0
0,1192,46064,3575892997,3575892997,0
0,1192,46065,3575892997,3575892997,0
0,1192,46066,3575892997,3575892997,0
0,1192,46067,3575892997,3575892997,0
0,1192,46068,3575892997,3575892999,2
0,1192,46069,3575892997,3575892999,2
0,1192,46070,3575892997,3575893000,3
0,1192,46071,3575892997,3575893000,3
0,1192,46072,3575892997,3575893000,3
0,1192,46073,3575892997,3575893001,4
0,1192,46074,3575892997,3575893002,5
0,1192,46075,3575892997,3575893004,7
0,1192,46076,3575892997,3575893004,7
0,1192,46077,3575892997,3575893004,7
0,1192,46078,3575892997,3575893004,7
0,1192,46079,3575892997,3575893005,8
0,1192,46080,3575892997,3575893009,12
0,1192,46081,3575892997,3575893010,13
0,1192,46082,3575892997,3575893010,13
0,1192,46083,3575892997,3575893010,13
0,1192,46084,3575892997,3575893012,15
0,1192,46085,3575892997,3575893012,15
0,1192,46086,3575892997,3575893013,16
0,1192,46087,3575892997,3575893013,16
0,1192,46088,3575892997,3575893015,18
0,1192,46089,3575892997,3575893015,18
0,1192,46090,3575892997,3575893016,19
0,1192,46091,3575892997,3575893017,20
0,1192,46092,3575892997,3575893018,21
0,1192,46093,3575892997,3575893019,22
0,1192,46094,3575892997,3575893020,23
0,1192,46095,3575892997,3575893021,24
0,1192,46096,3575892997,3575893021,24
0,1192,46097,3575892997,3575893022,25
0,1192,46098,3575892997,3575893023,26
0,1192,46099,3575892997,3575893026,29
0,1192,46100,3575892997,3575893027,30
0,1192,46101,3575892997,3575893028,31
0,1192,46102,3575892997,3575893029,32
0,1192,46103,3575892997,3575893029,32
0,1192,46104,3575892997,3575893030,33
0,1192,46105,3575892997,3575893030,33
0,1192,46106,3575892997,3575893032,35
0,1192,46107,3575892997,3575893032,35
0,1192,46108,3575892997,3575893032,35
0,1192,46109,3575892997,3575893033,36
0,1192,46110,3575892997,3575893033,36
0,1192,46111,3575892997,3575893033,36
0,1192,46112,3575892997,3575893033,36
0,1192,46113,3575892997,3575893033,36
0,1192,46114,3575892997,3575893034,37
0,1192,46115,3575892997,3575893034,37
0,1192,46116,3575892997,3575893034,37
0,1192,46117,3575892997,3575893035,38
0,1192,46118,3575892997,3575893037,40
0,1192,46119,3575892997,3575893040,43
0,1192,46120,3575892997,3575893041,44
0,1192,46121,3575892997,3575893042,45
0,1192,46122,3575892997,3575893043,46
0,1192,46123,3575892997,3575893044,47
0,1192,46124,3575892997,3575893045,48
0,1192,46125,3575892997,3575893045,48
0,1192,46126,3575892997,3575893046,49
0,1192,46127,3575892997,3575893046,49
0,1192,46128,3575892997,3575893046,49
0,1192,46129,3575892997,3575893047,50
0,1193,46130,3575893065,3575893065,0
0,1193,46131,3575893065,3575893065,0
0,1193,46132,3575893065,3575893065,0
0,1193,46133,3575893065,3575893065,0
0,1193,46134,3575893065,3575893065,0
0,1193,46135,3575893065,3575893065,0
0,1193,46136,3575893065,3575893065,0
0,1193,46137,3575893065,3575893065,0
0,1193,46138,3575893065,3575893065,0
0,1193,46139,3575893065,3575893065,0
0,1193,46140,3575893065,3575893065,0
0,1193,46141,3575893065,3575893065,0
0,1193,46142,3575893065,3575893065,0
0,1193,46143,3575893065,3575893065,0
0,1193,46144,3575893065,3575893065,0
0,1193,46145,3575893065,3575893065,0
0,1193,46146,3575893065,3575893065,0
0,1193,46147,3575893065,3575893065,0
0,1193,46148,3575893065,3575893065,0
0,1193,46149,3575893065,3575893065,0
0,1193,46150,3575893065,3575893065,0
0,1193,46151,3575893065,3575893066,1
0,1193,46152,3575893065,3575893066,1
0,1193,46153,3575893065,3575893066,1
0,1193,46154,3575893065,3575893068,3
0,1193,46155,3575893065,3575893069,4
0,1193,46156,3575893065,3575893077,12
0,1193,46157,3575893065,3575893078,13
0,1193,46158,3575893065,3575893080,15
0,1193,46159,3575893065,3575893084,19
0,1193,46160,3575893065,3575893087,22
0,1193,46161,3575893065,3575893088,23
0,1193,46162,3575893065,3575893088,23
0,1193,46163,3575893065,3575893089,24
0,1193,46164,3575893065,3575893089,24
0,1193,46165,3575893065,3575893090,25
0,1193,46166,3575893065,3575893091,26
0,1193,46167,3575893065,3575893091,26
0,1193,46168,3575893065,3575893091,26
0,1193,46169,3575893065,3575893091,26
0,1193,46170,3575893065,3575893092,27
0,1193,46171,3575893065,3575893092,27
0,1193,46172,3575893065,3575893093,28
0,1193,46173,3575893065,3575893094,29
0,1193,46174,3575893065,3575893094,29
0,1193,46175,3575893065,3575893096,31
0,1193,46176,3575893065,3575893096,31
0,1193,46177,3575893065,3575893097,32
0,1193,46178,3575893065,3575893097,32
0,1193,46179,3575893065,3575893097,32
0,1193,46180,3575893065,3575893097,32
0,1193,46181,3575893065,3575893098,33
0,1193,46182,3575893065,3575893098,33
0,1193,46183,3575893065,3575893100,35
0,1193,46184,3575893065,3575893100,35
0,1193,46185,3575893065,3575893100,35
0,1193,46186,3575893065,3575893100,35
0,1193,46187,3575893065,3575893101,36
0,1193,46188,3575893065,3575893103,38
0,1193,46189,3575893065,3575893103,38
0,1193,46190,3575893065,3575893104,39
0,1193,46191,3575893065,3575893105,40
0,1193,46192,3575893065,3575893105,40
0,1193,46193,3575893065,3575893106,41
0,1193,46194,3575893065,3575893107,42
0,1193,46195,3575893065,3575893107,42
0,1193,46196,3575893065,3575893108,43
0,1193,46197,3575893065,3575893108,43
0,1193,46198,3575893065,3575893109,44
0,1193,46199,3575893065,3575893109,44
0,1193,46200,3575893065,3575893111,46
0,1193,46201,3575893065,3575893112,47
0,1193,46202,3575893065,3575893112,47
0,1193,46203,3575893065,3575893112,47
0,1193,46204,3575893065,3575893113,48
0,1193,46205,3575893065,3575893113,48
0,1193,46206,3575893065,3575893114,49
0,1193,46207,3575893065,3575893114,49
0,1193,46208,3575893065,3575893114,49
0,1194,46209,3575893129,3575893129,0
0,1194,46210,3575893129,3575893129,0
0,1194,46211,3575893129,3575893129,0
0,1194,46212,3575893129,3575893129,0
0,1194,46213,3575893129,3575893129,0
0,1194,46214,3575893129,3575893129,0
0,1194,46215,3575893129,3575893129,0
0,1194,46216,3575893129,3575893129,0
0,1194,46217,3575893129,3575893129,0
0,1194,46218,3575893129,3575893129,0
0,1194,46219,3575893129,3575893129,0
0,1194,46220,3575893129,3575893129,0
0,1194,46221,3575893129,3575893129,0
0,1194,46222,3575893129,3575893129,0
0,1194,46223,3575893129,3575893129,0
0,1194,46224,3575893129,3575893129,0
0,1194,46225,3575893129,3575893129,0
0,1194,46226,3575893129,3575893129,0
0,1194,46227,3575893129,3575893129,0
0,1194,46228,3575893129,3575893129,0
0,1194,46229,3575893129,3575893129,0
0,1194,46230,3575893129,3575893129,0
0,1194,46231,3575893129,3575893130,1
0,1194,46232,3575893129,3575893131,2
0,1194,46233,3575893129,3575893131,2
0,1194,46234,3575893129,3575893132,3
0,1194,46235,3575893129,3575893132,3
0,1194,46236,3575893129,3575893133,4
0,1194,46237,3575893129,3575893135,6
0,1194,46238,3575893129,3575893136,7
0,1194,46239,3575893129,3575893137,8
0,1194,46240,3575893129,3575893137,8
0,1194,46241,3575893129,3575893138,9
0,1194,46242,3575893129,3575893138,9
0,1194,46243,3575893129,3575893138,9
0,1194,46244,3575893129,3575893139,10
0,1194,46245,3575893129,3575893139,10
0,1194,46246,3575893129,3575893139,10
0,1194,46247,3575893129,3575893140,11
0,1194,46248,3575893129,3575893140,11
0,1194,46249,3575893129,3575893141,12
0,1194,46250,3575893129,3575893141,12
0,1194,46251,3575893129,3575893142,13
0,1194,46252,3575893129,3575893143,14
0,1194,46253,3575893129,3575893144,15
0,1194,46254,3575893129,3575893144,15
0,1194,46255,3575893129,3575893144,15
0,1194,46256,3575893129,3575893147,18
0,1194,46257,3575893129,3575893147,18
0,1194,46258,3575893129,3575893147,18
0,1194,46259,3575893129,3575893147,18
0,1194,46260,3575893129,3575893148,19
0,1194,46261,3575893129,3575893149,20
0,1194,46262,3575893129,3575893150,21
0,1194,46263,3575893129,3575893150,21
0,1194,46264,3575893129,3575893152,23
0,1194,46265,3575893129,3575893152,23
0,1194,46266,3575893129,3575893153,24
0,1194,46267,3575893129,3575893153,24
0,1194,46268,3575893129,3575893154,25
0,1194,46269,3575893129,3575893154,25
0,1194,46270,3575893129,3575893155,26
0,1194,46271,3575893129,3575893155,26
0,1194,46272,3575893129,3575893156,27
0,1194,46273,3575893129,3575893158,29
0,1194,46274,3575893129,3575893158,29
0,1194,46275,3575893129,3575893159,30
0,1194,46276,3575893129,3575893160,31
0,1194,46277,3575893129,3575893161,32
0,1194,46278,3575893129,3575893162,33
0,1194,46279,3575893129,3575893162,33
0,1194,46280,3575893129,3575893162,33
0,1194,46281,3575893129,3575893163,34
0,1194,46282,3575893129,3575893164,35
0,1194,46283,3575893129,3575893164,35
0,1194,46284,3575893129,3575893165,36
0,1194,46285,3575893129,3575893165,36
0,1194,46286,3575893129,3575893166,37
0,1194,46287,3575893129,3575893168,39
0,1194,46288,3575893129,3575893169,40
0,1194,46289,3575893129,3575893171,42
0,1194,46290,3575893129,3575893171,42
0,1194,46291,3575893129,3575893171,42
0,1194,46292,3575893129,3575893172,43
0,1194,46293,3575893129,3575893173,44
0,1194,46294,3575893129,3575893174,45
0,1194,46295,3575893129,3575893175,46
0,1194,46296,3575893129,3575893175,46
0,1194,46297,3575893129,3575893176,47
0,1194,46298,3575893129,3575893177,48
0,1194,46299,3575893129,3575893177,48
0,1194,46300,3575893129,3575893178,49
0,1194,46301,3575893129,3575893178,49
0,1194,46302,3575893129,3575893179,50
0,1195,46303,3575893192,3575893192,0
0,1195,46304,3575893192,3575893192,0
0,1195,46305,3575893192,3575893192,0
0,1195,46306,3575893192,3575893192,0
0,1195,46307,3575893192,3575893192,0
0,1195,46308,3575893192,3575893192,0
0,1195,46309,3575893192,3575893192,0
0,1195,46310,3575893192,3575893192,0
0,1195,46311,3575893192,3575893192,0
0,1195,46312,3575893192,3575893192,0
0,1195,46313,3575893192,3575893197,5
0,1195,46314,3575893192,3575893199,7
0,1195,46315,3575893192,3575893200,8
0,1195,46316,3575893192,3575893200,8
0,1195,46317,3575893192,3575893200,8
0,1195,46318,3575893192,3575893200,8
0,1195,46319,3575893192,3575893201,9
0,1195,46320,3575893192,3575893202,10
0,1195,46321,3575893192,3575893204,12
0,1195,46322,3575893192,3575893204,12
0,1195,46323,3575893192,3575893204,12
0,1195,46324,3575893192,3575893205,13
0,1195,46325,3575893192,3575893205,13
0,1195,46326,3575893192,3575893210,18
0,1195,46327,3575893192,3575893211,19
0,1195,46328,3575893192,3575893212,20
0,1195,46329,3575893192,3575893213,21
0,1195,46330,3575893192,3575893213,21
0,1195,46331,3575893192,3575893214,22
0,1195,46332,3575893192,3575893215,23
0,1195,46333,3575893192,3575893215,23
0,1195,46334,3575893192,3575893216,24
0,1195,46335,3575893192,3575893216,24
0,1195,46336,3575893192,3575893218,26
0,1195,46337,3575893192,3575893219,27
0,1195,46338,3575893192,3575893219,27
0,1195,46339,3575893192,3575893220,28
0,1195,46340,3575893192,3575893221,29
0,1195,46341,3575893192,3575893221,29
0,1195,46342,3575893192,3575893222,30
0,1195,46343,3575893192,3575893222,30
0,1195,46344,3575893192,3575893223,31
0,1195,46345,3575893192,3575893224,32
0,1195,46346,3575893192,3575893228,36
0,1195,46347,3575893192,3575893229,37
0,1195,46348,3575893192,3575893230,38
0,1195,46349,3575893192,3575893230,38
0,1195,46350,3575893192,3575893232,40
0,1195,46351,3575893192,3575893232,40
0,1195,46352,3575893192,3575893232,40
0,1195,46353,3575893192,3575893233,41
0,1195,46354,3575893192,3575893233,41
0,1195,46355,3575893192,3575893233,41
0,1195,46356,3575893192,3575893233,41
0,1195,46357,3575893192,3575893234,42
0,1195,46358,3575893192,3575893234,42
0,1195,46359,3575893192,3575893234,42
0,1195,46360,3575893192,3575893235,43
0,1195,46361,3575893192,3575893237,45
0,1195,46362,3575893192,3575893240,48
0,1195,46363,3575893192,3575893240,48
0,1195,46364,3575893192,3575893240,48
0,1195,46365,3575893192,3575893241,49
0,1195,46366,3575893192,3575893242,50
0,1196,46367,3575893258,3575893258,0
0,1196,46368,3575893258,3575893258,0
0,1196,46369,3575893258,3575893258,0
0,1196,46370,3575893258,3575893258,0
0,1196,46371,3575893258,3575893258,0
0,1196,46372,3575893258,3575893258,0
0,1196,46373,3575893258,3575893258,0
0,1196,46374,3575893258,3575893258,0
0,1196,46375,3575893258,3575893258,0
0,1196,46376,3575893258,3575893258,0
0,1196,46377,3575893258,3575893258,0
0,1196,46378,3575893258,3575893258,0
0,1196,46379,3575893258,3575893258,0
0,1196,46380,3575893258,3575893258,0
0,1196,46381,3575893258,3575893258,0
0,1196,46382,3575893258,3575893258,0
0,1196,46383,3575893258,3575893258,0
0,1196,46384,3575893258,3575893258,0
0,1196,46385,3575893258,3575893258,0
0,1196,46386,3575893258,3575893258,0
0,1196,46387,3575893258,3575893258,0
0,1196,46388,3575893258,3575893258,0
0,1196,46389,3575893258,3575893258,0
0,1196,46390,3575893258,3575893259,1
0,1196,46391,3575893258,3575893259,1
0,1196,46392,3575893258,3575893259,1
0,1196,46393,3575893258,3575893260,2
0,1196,46394,3575893258,3575893261,3
0,1196,46395,3575893258,3575893261,3
0,1196,46396,3575893258,3575893261,3
0,1196,46397,3575893258,3575893262,4
0,1196,46398,3575893258,3575893263,5
0,1196,46399,3575893258,3575893263,5
0,1196,46400,3575893258,3575893264,6
0,1196,46401,3575893258,3575893265,7
0,1196,46402,3575893258,3575893265,7
0,1196,46403,3575893258,3575893266,8
0,1196,46404,3575893258,3575893266,8
0,1196,46405,3575893258,3575893267,9
0,1196,46406,3575893258,3575893267,9
0,1196,46407,3575893258,3575893268,10
0,1196,46408,3575893258,3575893276,18
0,1196,46409,3575893258,3575893278,20
0,1196,46410,3575893258,3575893279,21
0,1196,46411,3575893258,3575893280,22
0,1196,46412,3575893258,3575893280,22
0,1196,46413,3575893258,3575893284,26
0,1196,46414,3575893258,3575893287,29
0,1196,46415,3575893258,3575893288,30
0,1196,46416,3575893258,3575893288,30
0,1196,46417,3575893258,3575893288,30
0,1196,46418,3575893258,3575893290,32
0,1196,46419,3575893258,3575893290,32
0,1196,46420,3575893258,3575893291,33
0,1196,46421,3575893258,3575893291,33
0,1196,46422,3575893258,3575893291,33
0,1196,46423,3575893258,3575893291,33
0,1196,46424,3575893258,3575893292,34
0,1196,46425,3575893258,3575893293,35
0,1196,46426,3575893258,3575893293,35
0,1196,46427,3575893258,3575893293,35
0,1196,46428,3575893258,3575893294,36
0,1196,46429,3575893258,3575893296,38
0,1196,46430,3575893258,3575893296,38
0,1196,46431,3575893258,3575893296,38
0,1196,46432,3575893258,3575893296,38
0,1196,46433,3575893258,3575893297,39
0,1196,46434,3575893258,3575893297,39
0,1196,46435,3575893258,3575893298,40
0,1196,46436,3575893258,3575893298,40
0,1196,46437,3575893258,3575893298,40
0,1196,46438,3575893258,3575893298,40
0,1196,46439,3575893258,3575893299,41
0,1196,46440,3575893258,3575893300,42
0,1196,46441,3575893258,3575893300,42
0,1196,46442,3575893258,3575893300,42
0,1196,46443,3575893258,3575893302,44
0,1196,46444,3575893258,3575893305,47
0,1196,46445,3575893258,3575893305,47
0,1196,46446,3575893258,3575893305,47
0,1196,46447,3575893258,3575893305,47
0,1196,46448,3575893258,3575893306,48
0,1196,46449,3575893258,3575893307,49
0,1196,46450,3575893258,3575893307,49
0,1196,46451,3575893258,3575893308,50
0,1197,46452,3575893321,3575893321,0
0,1197,46453,3575893321,3575893321,0
0,1197,46454,3575893321,3575893321,0
0,1197,46455,3575893321,3575893321,0
0,1197,46456,3575893321,3575893321,0
0,1197,46457,3575893321,3575893321,0
0,1197,46458,3575893321,3575893321,0
0,1197,46459,3575893321,3575893321,0
0,1197,46460,3575893321,3575893321,0
0,1197,46461,3575893321,3575893321,0
0,1197,46462,3575893321,3575893321,0
0,1197,46463,3575893321,3575893321,0
0,1197,46464,3575893321,3575893321,0
0,1197,46465,3575893321,3575893321,0
0,1197,46466,3575893321,3575893321,0
0,1197,46467,3575893321,3575893321,0
0,1197,46468,3575893321,3575893321,0
0,1197,46469,3575893321,3575893321,0
0,1197,46470,3575893321,3575893321,0
0,1197,46471,3575893321,3575893321,0
0,1197,46472,3575893321,3575893322,1
0,1197,46473,3575893321,3575893322,1
0,1197,46474,3575893321,3575893322,1
0,1197,46475,3575893321,3575893324,3
0,1197,46476,3575893321,3575893324,3
0,1197,46477,3575893321,3575893325,4
0,1197,46478,3575893321,3575893325,4
0,1197,46479,3575893321,3575893326,5
0,1197,46480,3575893321,3575893326,5
0,1197,46481,3575893321,3575893326,5
0,1197,46482,3575893321,3575893327,6
0,1197,46483,3575893321,3575893327,6
0,1197,46484,3575893321,3575893328,7
0,1197,46485,3575893321,3575893328,7
0,1197,46486,3575893321,3575893328,7
0,1197,46487,3575893321,3575893331,10
0,1197,46488,3575893321,3575893332,11
0,1197,46489,3575893321,3575893332,11
0,1197,46490,3575893321,3575893332,11
0,1197,46491,3575893321,3575893333,12
0,1197,46492,3575893321,3575893334,13
0,1197,46493,3575893321,3575893334,13
0,1197,46494,3575893321,3575893334,13
0,1197,46495,3575893321,3575893337,16
0,1197,46496,3575893321,3575893337,16
0,1197,46497,3575893321,3575893337,16
0,1197,46498,3575893321,3575893338,17
0,1197,46499,3575893321,3575893338,17
0,1197,46500,3575893321,3575893338,17
0,1197,46501,3575893321,3575893339,18
0,1197,46502,3575893321,3575893339,18
0,1197,46503,3575893321,3575893340,19
0,1197,46504,3575893321,3575893341,20
0,1197,46505,3575893321,3575893341,20
0,1197,46506,3575893321,3575893341,20
0,1197,46507,3575893321,3575893342,21
0,1197,46508,3575893321,3575893343,22
0,1197,46509,3575893321,3575893345,24
0,1197,46510,3575893321,3575893347,26
0,1197,46511,3575893321,3575893347,26
0,1197,46512,3575893321,3575893348,27
0,1197,46513,3575893321,3575893348,27
0,1197,46514,3575893321,3575893349,28
0,1197,46515,3575893321,3575893350,29
0,1197,46516,3575893321,3575893350,29
0,1197,46517,3575893321,3575893351,30
0,1197,46518,3575893321,3575893353,32
0,1197,46519,3575893321,3575893353,32
0,1197,46520,3575893321,3575893353,32
0,1197,46521,3575893321,3575893354,33
0,1197,46522,3575893321,3575893354,33
0,1197,46523,3575893321,3575893354,33
0,1197,46524,3575893321,3575893354,33
0,1197,46525,3575893321,3575893355,34
0,1197,46526,3575893321,3575893355,34
0,1197,46527,3575893321,3575893358,37
0,1197,46528,3575893321,3575893358,37
0,1197,46529,3575893321,3575893360,39
0,1197,46530,3575893321,3575893361,40
0,1197,46531,3575893321,3575893362,41
0,1197,46532,3575893321,3575893363,42
0,1197,46533,3575893321,3575893363,42
0,1197,46534,3575893321,3575893363,42
0,1197,46535,3575893321,3575893363,42
0,1197,46536,3575893321,3575893364,43
0,1197,46537,3575893321,3575893366,45
0,1197,46538,3575893321,3575893366,45
0,1197,46539,3575893321,3575893366,45
0,1197,46540,3575893321,3575893367,46
0,1197,46541,3575893321,3575893369,48
0,1197,46542,3575893321,3575893370,49
0,1197,46543,3575893321,3575893371,50
0,1198,46544,3575893388,3575893388,0
0,1198,46545,3575893388,3575893388,0
0,1198,46546,3575893388,3575893388,0
0,1198,46547,3575893388,3575893388,0
0,1198,46548,3575893388,3575893388,0
0,1198,46549,3575893388,3575893388,0
0,1198,46550,3575893388,3575893388,0
0,1198,46551,3575893388,3575893388,0
0,1198,46552,3575893388,3575893388,0
0,1198,46553,3575893388,3575893388,0
0,1198,46554,3575893388,3575893388,0
0,1198,46555,3575893388,3575893388,0
0,1198,46556,3575893388,3575893388,0
0,1198,46557,3575893388,3575893388,0
0,1198,46558,3575893388,3575893388,0
0,1198,46559,3575893388,3575893388,0
0,1198,46560,3575893388,3575893388,0
0,1198,46561,3575893388,3575893388,0
0,1198,46562,3575893388,3575893388,0
0,1198,46563,3575893388,3575893388,0
0,1198,46564,3575893388,3575893388,0
0,1198,46565,3575893388,3575893388,0
0,1198,46566,3575893388,3575893394,6
0,1198,46567,3575893388,3575893397,9
0,1198,46568,3575893388,3575893399,11
0,1198,46569,3575893388,3575893399,11
0,1198,46570,3575893388,3575893400,12
0,1198,46571,3575893388,3575893400,12
0,1198,46572,3575893388,3575893401,13
0,1198,46573,3575893388,3575893403,15
0,1198,46574,3575893388,3575893405,17
0,1198,46575,3575893388,3575893405,17
0,1198,46576,3575893388,3575893405,17
0,1198,46577,3575893388,3575893405,17
0,1198,46578,3575893388,3575893409,21
0,1198,46579,3575893388,3575893411,23
0,1198,46580,3575893388,3575893411,23
0,1198,46581,3575893388,3575893412,24
0,1198,46582,3575893388,3575893412,24
0,1198,46583,3575893388,3575893413,25
0,1198,46584,3575893388,3575893413,25
0,1198,46585,3575893388,3575893415,27
0,1198,46586,3575893388,3575893417,29
0,1198,46587,3575893388,3575893418,30
0,1198,46588,3575893388,3575893419,31
0,1198,46589,3575893388,3575893420,32
0,1198,46590,3575893388,3575893420,32
0,1198,46591,3575893388,3575893422,34
0,1198,46592,3575893388,3575893423,35
0,1198,46593,3575893388,3575893423,35
0,1198,46594,3575893388,3575893424,36
0,1198,46595,3575893388,3575893426,38
0,1198,46596,3575893388,3575893428,40
0,1198,46597,3575893388,3575893429,41
0,1198,46598,3575893388,3575893429,41
0,1198,46599,3575893388,3575893429,41
0,1198,46600,3575893388,3575893430,42
0,1198,46601,3575893388,3575893432,44
0,1198,46602,3575893388,3575893432,44
0,1198,46603,3575893388,3575893432,44
0,1198,46604,3575893388,3575893433,45
0,1198,46605,3575893388,3575893433,45
0,1198,46606,3575893388,3575893433,45
0,1198,46607,3575893388,3575893433,45
0,1198,46608,3575893388,3575893434,46
0,1198,46609,3575893388,3575893434,46
0,1198,46610,3575893388,3575893435,47
0,1198,46611,3575893388,3575893435,47
0,1198,46612,3575893388,3575893435,47
0,1199,46613,3575893451,3575893451,0
0,1199,46614,3575893451,3575893451,0
0,1199,46615,3575893451,3575893451,0
0,1199,46616,3575893451,3575893452,1
0,1199,46617,3575893451,3575893452,1
0,1199,46618,3575893451,3575893452,1
0,1199,46619,3575893451,3575893452,1
0,1199,46620,3575893451,3575893452,1
0,1199,46621,3575893451,3575893452,1
0,1199,46622,3575893451,3575893452,1
0,1199,46623,3575893451,3575893452,1
0,1199,46624,3575893451,3575893452,1
0,1199,46625,3575893451,3575893452,1
0,1199,46626,3575893451,3575893452,1
0,1199,46627,3575893451,3575893452,1
0,1199,46628,3575893451,3575893452,1
0,1199,46629,3575893451,3575893452,1
0,1199,46630,3575893451,3575893453,2
0,1199,46631,3575893451,3575893454,3
0,1199,46632,3575893451,3575893456,5
0,1199,46633,3575893451,3575893457,6
0,1199,46634,3575893451,3575893458,7
0,1199,46635,3575893451,3575893458,7
0,1199,46636,3575893451,3575893460,9
0,1199,46637,3575893451,3575893461,10
0,1199,46638,3575893451,3575893461,10
0,1199,46639,3575893451,3575893461,10
0,1199,46640,3575893451,3575893462,11
0,1199,46641,3575893451,3575893462,11
0,1199,46642,3575893451,3575893462,11
0,1199,46643,3575893451,3575893462,11
0,1199,46644,3575893451,3575893463,12
0,1199,46645,3575893451,3575893464,13
0,1199,46646,3575893451,3575893465,14
0,1199,46647,3575893451,3575893465,14
0,1199,46648,3575893451,3575893465,14
0,1199,46649,3575893451,3575893466,15
0,1199,46650,3575893451,3575893466,15
0,1199,46651,3575893451,3575893466,15
0,1199,46652,3575893451,3575893467,16
0,1199,46653,3575893451,3575893467,16
0,1199,46654,3575893451,3575893469,18
0,1199,46655,3575893451,3575893469,18
0,1199,46656,3575893451,3575893477,26
0,1199,46657,3575893451,3575893477,26
0,1199,46658,3575893451,3575893479,28
0,1199,46659,3575893451,3575893480,29
0,1199,46660,3575893451,3575893480,29
0,1199,46661,3575893451,3575893484,33
0,1199,46662,3575893451,3575893488,37
0,1199,46663,3575893451,3575893488,37
0,1199,46664,3575893451,3575893488,37
0,1199,46665,3575893451,3575893488,37
0,1199,46666,3575893451,3575893489,38
0,1199,46667,3575893451,3575893490,39
0,1199,46668,3575893451,3575893490,39
0,1199,46669,3575893451,3575893491,40
0,1199,46670,3575893451,3575893491,40
0,1199,46671,3575893451,3575893492,41
0,1199,46672,3575893451,3575893492,41
0,1199,46673,3575893451,3575893492,41
0,1199,46674,3575893451,3575893493,42
0,1199,46675,3575893451,3575893493,42
0,1199,46676,3575893451,3575893493,42
0,1199,46677,3575893451,3575893494,43
0,1199,46678,3575893451,3575893494,43
0,1199,46679,3575893451,3575893496,45
0,1199,46680,3575893451,3575893496,45
0,1199,46681,3575893451,3575893496,45
0,1199,46682,3575893451,3575893497,46
0,1199,46683,3575893451,3575893498,47
0,1199,46684,3575893451,3575893498,47
0,1199,46685,3575893451,3575893498,47
0,1199,46686,3575893451,3575893499,48
0,1199,46687,3575893451,3575893500,49
0,1199,46688,3575893451,3575893500,49
0,1199,46689,3575893451,3575893501,50
0,1200,46690,3575893518,3575893518,0
0,1200,46691,3575893518,3575893518,0
0,1200,46692,3575893518,3575893518,0
0,1200,46693,3575893518,3575893518,0
0,1200,46694,3575893518,3575893518,0
0,1200,46695,3575893518,3575893518,0
0,1200,46696,3575893518,3575893518,0
0,1200,46697,3575893518,3575893518,0
0,1200,46698,3575893518,3575893518,0
0,1200,46699,3575893518,3575893518,0
0,1200,46700,3575893518,3575893518,0
0,1200,46701,3575893518,3575893518,0
0,1200,46702,3575893518,3575893518,0
0,1200,46703,3575893518,3575893518,0
0,1200,46704,3575893518,3575893518,0
0,1200,46705,3575893518,3575893518,0
0,1200,46706,3575893518,3575893518,0
0,1200,46707,3575893518,3575893518,0
0,1200,46708,3575893518,3575893518,0
0,1200,46709,3575893518,3575893518,0
0,1200,46710,3575893518,3575893518,0
0,1200,46711,3575893518,3575893518,0
0,1200,46712,3575893518,3575893518,0
0,1200,46713,3575893518,3575893518,0
0,1200,46714,3575893518,3575893518,0
0,1200,46715,3575893518,3575893519,1
0,1200,46716,3575893518,3575893520,2
0,1200,46717,3575893518,3575893521,3
0,1200,46718,3575893518,3575893521,3
0,1200,46719,3575893518,3575893522,4
0,1200,46720,3575893518,3575893524,6
0,1200,46721,3575893518,3575893524,6
0,1200,46722,3575893518,3575893525,7
0,1200,46723,3575893518,3575893526,8
0,1200,46724,3575893518,3575893526,8
0,1200,46725,3575893518,3575893526,8
0,1200,46726,3575893518,3575893527,9
0,1200,46727,3575893518,3575893527,9
0,1200,46728,3575893518,3575893527,9
0,1200,46729,3575893518,3575893530,12
0,1200,46730,3575893518,3575893530,12
0,1200,46731,3575893518,3575893531,13
0,1200,46732,3575893518,3575893531,13
0,1200,46733,3575893518,3575893532,14
0,1200,46734,3575893518,3575893533,15
0,1200,46735,3575893518,3575893533,15
0,1200,46736,3575893518,3575893536,18
0,1200,46737,3575893518,3575893536,18
0,1200,46738,3575893518,3575893537,19
0,1200,46739,3575893518,3575893537,19
0,1200,46740,3575893518,3575893537,19
0,1200,46741,3575893518,3575893538,20
0,1200,46742,3575893518,3575893538,20
0,1200,46743,3575893518,3575893538,20
0,1200,46744,3575893518,3575893538,20
0,1200,46745,3575893518,3575893539,21
0,1200,46746,3575893518,3575893539,21
0,1200,46747,3575893518,3575893540,22
0,1200,46748,3575893518,3575893541,23
0,1200,46749,3575893518,3575893541,23
0,1200,46750,3575893518,3575893542,24
0,1200,46751,3575893518,3575893543,25
0,1200,46752,3575893518,3575893543,25
0,1200,46753,3575893518,3575893544,26
0,1200,46754,3575893518,3575893546,28
0,1200,46755,3575893518,3575893546,28
0,1200,46756,3575893518,3575893546,28
0,1200,46757,3575893518,3575893546,28
0,1200,46758,3575893518,3575893547,29
0,1200,46759,3575893518,3575893548,30
0,1200,46760,3575893518,3575893549,31
0,1200,46761,3575893518,3575893549,31
0,1200,46762,3575893518,3575893550,32
0,1200,46763,3575893518,3575893552,34
0,1200,46764,3575893518,3575893552,34
0,1200,46765,3575893518,3575893553,35
0,1200,46766,3575893518,3575893553,35
0,1200,46767,3575893518,3575893554,36
0,1200,46768,3575893518,3575893554,36
0,1200,46769,3575893518,3575893554,36
0,1200,46770,3575893518,3575893556,38
0,1200,46771,3575893518,3575893556,38
0,1200,46772,3575893518,3575893556,38
0,1200,46773,3575893518,3575893557,39
0,1200,46774,3575893518,3575893558,40
0,1200,46775,3575893518,3575893560,42
0,1200,46776,3575893518,3575893560,42
0,1200,46777,3575893518,3575893562,44
0,1200,46778,3575893518,3575893562,44
0,1200,46779,3575893518,3575893562,44
0,1200,46780,3575893518,3575893563,45
0,1200,46781,3575893518,3575893564,46
0,1200,46782,3575893518,3575893565,47
0,1200,46783,3575893518,3575893565,47
0,1200,46784,3575893518,3575893566,48
0,1200,46785,3575893518,3575893567,49
0,1201,46786,3575893581,3575893581,0
0,1201,46787,3575893581,3575893581,0
0,1201,46788,3575893581,3575893581,0
0,1201,46789,3575893581,3575893581,0
0,1201,46790,3575893581,3575893581,0
0,1201,46791,3575893581,3575893581,0
0,1201,46792,3575893581,3575893581,0
0,1201,46793,3575893581,3575893581,0
0,1201,46794,3575893581,3575893581,0
0,1201,46795,3575893581,3575893581,0
0,1201,46796,3575893581,3575893581,0
0,1201,46797,3575893581,3575893581,0
0,1201,46798,3575893581,3575893581,0
0,1201,46799,3575893581,3575893581,0
0,1201,46800,3575893581,3575893581,0
0,1201,46801,3575893581,3575893581,0
0,1201,46802,3575893581,3575893581,0
0,1201,46803,3575893581,3575893581,0
0,1201,46804,3575893581,3575893582,1
0,1201,46805,3575893581,3575893583,2
0,1201,46806,3575893581,3575893583,2
0,1201,46807,3575893581,3575893583,2
0,1201,46808,3575893581,3575893584,3
0,1201,46809,3575893581,3575893584,3
0,1201,46810,3575893581,3575893586,5
0,1201,46811,3575893581,3575893586,5
0,1201,46812,3575893581,3575893586,5
0,1201,46813,3575893581,3575893588,7
0,1201,46814,3575893581,3575893592,11
0,1201,46815,3575893581,3575893595,14
0,1201,46816,3575893581,3575893598,17
0,1201,46817,3575893581,3575893599,18
0,1201,46818,3575893581,3575893599,18
0,1201,46819,3575893581,3575893600,19
0,1201,46820,3575893581,3575893601,20
0,1201,46821,3575893581,3575893602,21
0,1201,46822,3575893581,3575893604,23
0,1201,46823,3575893581,3575893605,24
0,1201,46824,3575893581,3575893606,25
0,1201,46825,3575893581,3575893606,25
0,1201,46826,3575893581,3575893608,27
0,1201,46827,3575893581,3575893610,29
0,1201,46828,3575893581,3575893610,29
0,1201,46829,3575893581,3575893610,29
0,1201,46830,3575893581,3575893612,31
0,1201,46831,3575893581,3575893612,31
0,1201,46832,3575893581,3575893612,31
0,1201,46833,3575893581,3575893613,32
0,1201,46834,3575893581,3575893614,33
0,1201,46835,3575893581,3575893615,34
0,1201,46836,3575893581,3575893616,35
0,1201,46837,3575893581,3575893616,35
0,1201,46838,3575893581,3575893617,36
0,1201,46839,3575893581,3575893617,36
0,1201,46840,3575893581,3575893618,37
0,1201,46841,3575893581,3575893619,38
0,1201,46842,3575893581,3575893619,38
0,1201,46843,3575893581,3575893620,39
0,1201,46844,3575893581,3575893621,40
0,1201,46845,3575893581,3575893621,40
0,1201,46846,3575893581,3575893622,41
0,1201,46847,3575893581,3575893623,42
0,1201,46848,3575893581,3575893623,42
0,1201,46849,3575893581,3575893626,45
0,1201,46850,3575893581,3575893627,46
0,1201,46851,3575893581,3575893627,46
0,1201,46852,3575893581,3575893629,48
0,1201,46853,3575893581,3575893629,48
0,1201,46854,3575893581,3575893629,48
0,1201,46855,3575893581,3575893629,48
0,1201,46856,3575893581,3575893630,49
0,1202,46857,3575893646,3575893646,0
0,1202,46858,3575893646,3575893646,0
0,1202,46859,3575893646,3575893646,0
0,1202,46860,3575893646,3575893646,0
0,1202,46861,3575893646,3575893646,0
0,1202,46862,3575893646,3575893646,0
0,1202,46863,3575893646,3575893646,0
0,1202,46864,3575893646,3575893646,0
0,1202,46865,3575893646,3575893646,0
0,1202,46866,3575893646,3575893646,0
0,1202,46867,3575893646,3575893646,0
0,1202,46868,3575893646,3575893646,0
0,1202,46869,3575893646,3575893646,0
0,1202,46870,3575893646,3575893646,0
0,1202,46871,3575893646,3575893646,0
0,1202,46872,3575893646,3575893646,0
0,1202,46873,3575893646,3575893646,0
0,1202,46874,3575893646,3575893646,0
0,1202,46875,3575893646,3575893646,0
0,1202,46876,3575893646,3575893646,0
0,1202,46877,3575893646,3575893646,0
0,1202,46878,3575893646,3575893646,0
0,1202,46879,3575893646,3575893646,0
0,1202,46880,3575893646,3575893646,0
0,1202,46881,3575893646,3575893646,0
0,1202,46882,3575893646,3575893646,0
0,1202,46883,3575893646,3575893647,1
0,1202,46884,3575893646,3575893649,3
0,1202,46885,3575893646,3575893649,3
0,1202,46886,3575893646,3575893651,5
0,1202,46887,3575893646,3575893652,6
0,1202,46888,3575893646,3575893653,7
0,1202,46889,3575893646,3575893654,8
0,1202,46890,3575893646,3575893656,10
0,1202,46891,3575893646,3575893656,10
0,1202,46892,3575893646,3575893658,12
0,1202,46893,3575893646,3575893658,12
0,1202,46894,3575893646,3575893658,12
0,1202,46895,3575893646,3575893659,13
0,1202,46896,3575893646,3575893660,14
0,1202,46897,3575893646,3575893660,14
0,1202,46898,3575893646,3575893661,15
0,1202,46899,3575893646,3575893661,15
0,1202,46900,3575893646,3575893662,16
0,1202,46901,3575893646,3575893663,17
0,1202,46902,3575893646,3575893663,17
0,1202,46903,3575893646,3575893664,18
0,1202,46904,3575893646,3575893664,18
0,1202,46905,3575893646,3575893665,19
0,1202,46906,3575893646,3575893666,20
0,1202,46907,3575893646,3575893667,21
0,1202,46908,3575893646,3575893667,21
0,1202,46909,3575893646,3575893678,32
0,1202,46910,3575893646,3575893680,34
0,1202,46911,3575893646,3575893684,38
0,1202,46912,3575893646,3575893688,42
0,1202,46913,3575893646,3575893688,42
0,1202,46914,3575893646,3575893688,42
0,1202,46915,3575893646,3575893688,42
0,1202,46916,3575893646,3575893688,42
0,1202,46917,3575893646,3575893690,44
0,1202,46918,3575893646,3575893690,44
0,1202,46919,3575893646,3575893691,45
0,1202,46920,3575893646,3575893691,45
0,1202,46921,3575893646,3575893692,46
0,1202,46922,3575893646,3575893692,46
0,1202,46923,3575893646,3575893692,46
0,1202,46924,3575893646,3575893693,47
0,1202,46925,3575893646,3575893693,47
0,1202,46926,3575893646,3575893693,47
0,1202,46927,3575893646,3575893693,47
0,1202,46928,3575893646,3575893695,49
0,1202,46929,3575893646,3575893695,49
0,1202,46930,3575893646,3575893696,50
0,1203,46931,3575893711,3575893711,0
0,1203,46932,3575893711,3575893711,0
0,1203,46933,3575893711,3575893711,0
0,1203,46934,3575893711,3575893711,0
0,1203,46935,3575893711,3575893711,0
0,1203,46936,3575893711,3575893711,0
0,1203,46937,3575893711,3575893711,0
0,1203,46938,3575893711,3575893711,0
0,1203,46939,3575893711,3575893711,0
0,1203,46940,3575893711,3575893711,0
0,1203,46941,3575893711,3575893711,0
0,1203,46942,3575893711,3575893711,0
0,1203,46943,3575893711,3575893711,0
0,1203,46944,3575893711,3575893711,0
0,1203,46945,3575893711,3575893711,0
0,1203,46946,3575893711,3575893711,0
0,1203,46947,3575893711,3575893711,0
0,1203,46948,3575893711,3575893711,0
0,1203,46949,3575893711,3575893711,0
0,1203,46950,3575893711,3575893711,0
0,1203,46951,3575893711,3575893711,0
0,1203,46952,3575893711,3575893711,0
0,1203,46953,3575893711,3575893711,0
0,1203,46954,3575893711,3575893711,0
0,1203,46955,3575893711,3575893711,0
0,1203,46956,3575893711,3575893712,1
0,1203,46957,3575893711,3575893713,2
0,1203,46958,3575893711,3575893713,2
0,1203,46959,3575893711,3575893714,3
0,1203,46960,3575893711,3575893714,3
0,1203,46961,3575893711,3575893715,4
0,1203,46962,3575893711,3575893715,4
0,1203,46963,3575893711,3575893716,5
0,1203,46964,3575893711,3575893716,5
0,1203,46965,3575893711,3575893716,5
0,1203,46966,3575893711,3575893718,7
0,1203,46967,3575893711,3575893718,7
0,1203,46968,3575893711,3575893720,9
0,1203,46969,3575893711,3575893721,10
0,1203,46970,3575893711,3575893721,10
0,1203,46971,3575893711,3575893721,10
0,1203,46972,3575893711,3575893722,11
0,1203,46973,3575893711,3575893722,11
0,1203,46974,3575893711,3575893723,12
0,1203,46975,3575893711,3575893723,12
0,1203,46976,3575893711,3575893724,13
0,1203,46977,3575893711,3575893725,14
0,1203,46978,3575893711,3575893726,15
0,1203,46979,3575893711,3575893726,15
0,1203,46980,3575893711,3575893726,15
0,1203,46981,3575893711,3575893726,15
0,1203,46982,3575893711,3575893727,16
0,1203,46983,3575893711,3575893727,16
0,1203,46984,3575893711,3575893727,16
0,1203,46985,3575893711,3575893728,17
0,1203,46986,3575893711,3575893730,19
0,1203,46987,3575893711,3575893731,20
0,1203,46988,3575893711,3575893731,20
0,1203,46989,3575893711,3575893732,21
0,1203,46990,3575893711,3575893733,22
0,1203,46991,3575893711,3575893734,23
0,1203,46992,3575893711,3575893735,24
0,1203,46993,3575893711,3575893735,24
0,1203,46994,3575893711,3575893737,26
0,1203,46995,3575893711,3575893737,26
0,1203,46996,3575893711,3575893737,26
0,1203,46997,3575893711,3575893738,27
0,1203,46998,3575893711,3575893738,27
0,1203,46999,3575893711,3575893738,27
0,1203,47000,3575893711,3575893739,28
0,1203,47001,3575893711,3575893739,28
0,1203,47002,3575893711,3575893740,29
0,1203,47003,3575893711,3575893741,30
0,1203,47004,3575893711,3575893742,31
0,1203,47005,3575893711,3575893744,33
0,1203,47006,3575893711,3575893744,33
0,1203,47007,3575893711,3575893745,34
0,1203,47008,3575893711,3575893746,35
0,1203,47009,3575893711,3575893746,35
0,1203,47010,3575893711,3575893747,36
0,1203,47011,3575893711,3575893747,36
0,1203,47012,3575893711,3575893748,37
0,1203,47013,3575893711,3575893750,39
0,1203,47014,3575893711,3575893750,39
0,1203,47015,3575893711,3575893750,39
0,1203,47016,3575893711,3575893753,42
0,1203,47017,3575893711,3575893753,42
0,1203,47018,3575893711,3575893753,42
0,1203,47019,3575893711,3575893753,42
0,1203,47020,3575893711,3575893754,43
0,1203,47021,3575893711,3575893754,43
0,1203,47022,3575893711,3575893755,44
0,1203,47023,3575893711,3575893756,45
0,1203,47024,3575893711,3575893757,46
0,1203,47025,3575893711,3575893758,47
0,1203,47026,3575893711,3575893758,47
0,1203,47027,3575893711,3575893759,48
0,1203,47028,3575893711,3575893759,48
0,1204,47029,3575893775,3575893775,0
0,1204,47030,3575893775,3575893775,0
0,1204,47031,3575893775,3575893775,0
0,1204,47032,3575893775,3575893775,0
0,1204,47033,3575893775,3575893775,0
0,1204,47034,3575893775,3575893775,0
0,1204,47035,3575893775,3575893775,0
0,1204,47036,3575893775,3575893775,0
0,1204,47037,3575893775,3575893775,0
0,1204,47038,3575893775,3575893775,0
0,1204,47039,3575893775,3575893775,0
0,1204,47040,3575893775,3575893775,0
0,1204,47041,3575893775,3575893775,0
0,1204,47042,3575893775,3575893775,0
0,1204,47043,3575893775,3575893775,0
0,1204,47044,3575893775,3575893775,0
0,1204,47045,3575893775,3575893775,0
0,1204,47046,3575893775,3575893775,0
0,1204,47047,3575893775,3575893776,1
0,1204,47048,3575893775,3575893776,1
0,1204,47049,3575893775,3575893777,2
0,1204,47050,3575893775,3575893777,2
0,1204,47051,3575893775,3575893778,3
0,1204,47052,3575893775,3575893779,4
0,1204,47053,3575893775,3575893780,5
0,1204,47054,3575893775,3575893782,7
0,1204,47055,3575893775,3575893783,8
0,1204,47056,3575893775,3575893783,8
0,1204,47057,3575893775,3575893783,8
0,1204,47058,3575893775,3575893783,8
0,1204,47059,3575893775,3575893785,10
0,1204,47060,3575893775,3575893786,11
0,1204,47061,3575893775,3575893786,11
0,1204,47062,3575893775,3575893789,14
0,1204,47063,3575893775,3575893793,18
0,1204,47064,3575893775,3575893795,20
0,1204,47065,3575893775,3575893798,23
0,1204,47066,3575893775,3575893799,24
0,1204,47067,3575893775,3575893799,24
0,1204,47068,3575893775,3575893800,25
0,1204,47069,3575893775,3575893800,25
0,1204,47070,3575893775,3575893800,25
0,1204,47071,3575893775,3575893803,28
0,1204,47072,3575893775,3575893804,29
0,1204,47073,3575893775,3575893806,31
0,1204,47074,3575893775,3575893807,32
0,1204,47075,3575893775,3575893808,33
0,1204,47076,3575893775,3575893811,36
0,1204,47077,3575893775,3575893812,37
0,1204,47078,3575893775,3575893812,37
0,1204,47079,3575893775,3575893813,38
0,1204,47080,3575893775,3575893813,38
0,1204,47081,3575893775,3575893814,39
0,1204,47082,3575893775,3575893815,40
0,1204,47083,3575893775,3575893816,41
0,1204,47084,3575893775,3575893816,41
0,1204,47085,3575893775,3575893818,43
0,1204,47086,3575893775,3575893818,43
0,1204,47087,3575893775,3575893820,45
0,1204,47088,3575893775,3575893822,47
0,1204,47089,3575893775,3575893822,47
0,1204,47090,3575893775,3575893822,47
0,1204,47091,3575893775,3575893823,48
0,1204,47092,3575893775,3575893823,48
0,1205,47093,3575893842,3575893842,0
0,1205,47094,3575893842,3575893842,0
0,1205,47095,3575893842,3575893842,0
0,1205,47096,3575893842,3575893842,0
0,1205,47097,3575893842,3575893842,0
0,1205,47098,3575893842,3575893842,0
0,1205,47099,3575893842,3575893842,0
0,1205,47100,3575893842,3575893842,0
0,1205,47101,3575893842,3575893842,0
0,1205,47102,3575893842,3575893842,0
0,1205,47103,3575893842,3575893842,0
0,1205,47104,3575893842,3575893842,0
0,1205,47105,3575893842,3575893842,0
0,1205,47106,3575893842,3575893842,0
0,1205,47107,3575893842,3575893842,0
0,1205,47108,3575893842,3575893842,0
0,1205,47109,3575893842,3575893842,0
0,1205,47110,3575893842,3575893842,0
0,1205,47111,3575893842,3575893842,0
0,1205,47112,3575893842,3575893842,0
0,1205,47113,3575893842,3575893842,0
0,1205,47114,3575893842,3575893842,0
0,1205,47115,3575893842,3575893842,0
0,1205,47116,3575893842,3575893842,0
0,1205,47117,3575893842,3575893845,3
0,1205,47118,3575893842,3575893845,3
0,1205,47119,3575893842,3575893846,4
0,1205,47120,3575893842,3575893846,4
0,1205,47121,3575893842,3575893846,4
0,1205,47122,3575893842,3575893847,5
0,1205,47123,3575893842,3575893847,5
0,1205,47124,3575893842,3575893850,8
0,1205,47125,3575893842,3575893851,9
0,1205,47126,3575893842,3575893852,10
0,1205,47127,3575893842,3575893852,10
0,1205,47128,3575893842,3575893853,11
0,1205,47129,3575893842,3575893855,13
0,1205,47130,3575893842,3575893856,14
0,1205,47131,3575893842,3575893858,16
0,1205,47132,3575893842,3575893858,16
0,1205,47133,3575893842,3575893859,17
0,1205,47134,3575893842,3575893859,17
0,1205,47135,3575893842,3575893860,18
0,1205,47136,3575893842,3575893860,18
0,1205,47137,3575893842,3575893861,19
0,1205,47138,3575893842,3575893861,19
0,1205,47139,3575893842,3575893861,19
0,1205,47140,3575893842,3575893862,20
0,1205,47141,3575893842,3575893862,20
0,1205,47142,3575893842,3575893863,21
0,1205,47143,3575893842,3575893864,22
0,1205,47144,3575893842,3575893865,23
0,1205,47145,3575893842,3575893866,24
0,1205,47146,3575893842,3575893866,24
0,1205,47147,3575893842,3575893867,25
0,1205,47148,3575893842,3575893867,25
0,1205,47149,3575893842,3575893867,25
0,1205,47150,3575893842,3575893869,27
0,1205,47151,3575893842,3575893877,35
0,1205,47152,3575893842,3575893878,36
0,1205,47153,3575893842,3575893880,38
0,1205,47154,3575893842,3575893880,38
0,1205,47155,3575893842,3575893880,38
0,1205,47156,3575893842,3575893884,42
0,1205,47157,3575893842,3575893888,46
0,1205,47158,3575893842,3575893888,46
0,1205,47159,3575893842,3575893888,46
0,1205,47160,3575893842,3575893889,47
0,1205,47161,3575893842,3575893889,47
0,1205,47162,3575893842,3575893890,48
0,1205,47163,3575893842,3575893890,48
0,1205,47164,3575893842,3575893890,48
0,1205,47165,3575893842,3575893891,49
0,1205,47166,3575893842,3575893892,50
0,1206,47167,3575893904,3575893904,0
0,1206,47168,3575893904,3575893904,0
0,1206,47169,3575893904,3575893904,0
0,1206,47170,3575893904,3575893904,0
0,1206,47171,3575893904,3575893904,0
0,1206,47172,3575893904,3575893904,0
0,1206,47173,3575893904,3575893904,0
0,1206,47174,3575893904,3575893904,0
0,1206,47175,3575893904,3575893905,1
0,1206,47176,3575893904,3575893905,1
0,1206,47177,3575893904,3575893905,1
0,1206,47178,3575893904,3575893905,1
0,1206,47179,3575893904,3575893905,1
0,1206,47180,3575893904,3575893905,1
0,1206,47181,3575893904,3575893905,1
0,1206,47182,3575893904,3575893905,1
0,1206,47183,3575893904,3575893905,1
0,1206,47184,3575893904,3575893905,1
0,1206,47185,3575893904,3575893905,1
0,1206,47186,3575893904,3575893905,1
0,1206,47187,3575893904,3575893906,2
0,1206,47188,3575893904,3575893907,3
0,1206,47189,3575893904,3575893907,3
0,1206,47190,3575893904,3575893909,5
0,1206,47191,3575893904,3575893909,5
0,1206,47192,3575893904,3575893909,5
0,1206,47193,3575893904,3575893910,6
0,1206,47194,3575893904,3575893911,7
0,1206,47195,3575893904,3575893912,8
0,1206,47196,3575893904,3575893913,9
0,1206,47197,3575893904,3575893913,9
0,1206,47198,3575893904,3575893913,9
0,1206,47199,3575893904,3575893914,10
0,1206,47200,3575893904,3575893915,11
0,1206,47201,3575893904,3575893915,11
0,1206,47202,3575893904,3575893915,11
0,1206,47203,3575893904,3575893916,12
0,1206,47204,3575893904,3575893917,13
0,1206,47205,3575893904,3575893917,13
0,1206,47206,3575893904,3575893917,13
0,1206,47207,3575893904,3575893920,16
0,1206,47208,3575893904,3575893921,17
0,1206,47209,3575893904,3575893921,17
0,1206,47210,3575893904,3575893921,17
0,1206,47211,3575893904,3575893922,18
0,1206,47212,3575893904,3575893923,19
0,1206,47213,3575893904,3575893924,20
0,1206,47214,3575893904,3575893924,20
0,1206,47215,3575893904,3575893925,21
0,1206,47216,3575893904,3575893925,21
0,1206,47217,3575893904,3575893925,21
0,1206,47218,3575893904,3575893925,21
0,1206,47219,3575893904,3575893926,22
0,1206,47220,3575893904,3575893927,23
0,1206,47221,3575893904,3575893927,23
0,1206,47222,3575893904,3575893927,23
0,1206,47223,3575893904,3575893929,25
0,1206,47224,3575893904,3575893930,26
0,1206,47225,3575893904,3575893931,27
0,1206,47226,3575893904,3575893931,27
0,1206,47227,3575893904,3575893932,28
0,1206,47228,3575893904,3575893933,29
0,1206,47229,3575893904,3575893935,31
0,1206,47230,3575893904,3575893935,31
0,1206,47231,3575893904,3575893937,33
0,1206,47232,3575893904,3575893937,33
0,1206,47233,3575893904,3575893938,34
0,1206,47234,3575893904,3575893939,35
0,1206,47235,3575893904,3575893939,35
0,1206,47236,3575893904,3575893940,36
0,1206,47237,3575893904,3575893943,39
0,1206,47238,3575893904,3575893944,40
0,1206,47239,3575893904,3575893945,41
0,1206,47240,3575893904,3575893946,42
0,1206,47241,3575893904,3575893947,43
0,1206,47242,3575893904,3575893947,43
0,1206,47243,3575893904,3575893947,43
0,1206,47244,3575893904,3575893949,45
0,1206,47245,3575893904,3575893950,46
0,1206,47246,3575893904,3575893951,47
0,1206,47247,3575893904,3575893953,49
0,1206,47248,3575893904,3575893953,49
0,1206,47249,3575893904,3575893953,49
0,1206,47250,3575893904,3575893954,50
0,1207,47251,3575893970,3575893970,0
0,1207,47252,3575893970,3575893970,0
0,1207,47253,3575893970,3575893970,0
0,1207,47254,3575893970,3575893970,0
0,1207,47255,3575893970,3575893970,0
0,1207,47256,3575893970,3575893970,0
0,1207,47257,3575893970,3575893970,0
0,1207,47258,3575893970,3575893970,0
0,1207,47259,3575893970,3575893970,0
0,1207,47260,3575893970,3575893970,0
0,1207,47261,3575893970,3575893970,0
0,1207,47262,3575893970,3575893970,0
0,1207,47263,3575893970,3575893970,0
0,1207,47264,3575893970,3575893970,0
0,1207,47265,3575893970,3575893970,0
0,1207,47266,3575893970,3575893970,0
0,1207,47267,3575893970,3575893970,0
0,1207,47268,3575893970,3575893970,0
0,1207,47269,3575893970,3575893970,0
0,1207,47270,3575893970,3575893970,0
0,1207,47271,3575893970,3575893970,0
0,1207,47272,3575893970,3575893970,0
0,1207,47273,3575893970,3575893970,0
0,1207,47274,3575893970,3575893970,0
0,1207,47275,3575893970,3575893971,1
0,1207,47276,3575893970,3575893971,1
0,1207,47277,3575893970,3575893971,1
0,1207,47278,3575893970,3575893972,2
0,1207,47279,3575893970,3575893972,2
0,1207,47280,3575893970,3575893974,4
0,1207,47281,3575893970,3575893974,4
0,1207,47282,3575893970,3575893975,5
0,1207,47283,3575893970,3575893975,5
0,1207,47284,3575893970,3575893976,6
0,1207,47285,3575893970,3575893976,6
0,1207,47286,3575893970,3575893976,6
0,1207,47287,3575893970,3575893976,6
0,1207,47288,3575893970,3575893977,7
0,1207,47289,3575893970,3575893978,8
0,1207,47290,3575893970,3575893980,10
0,1207,47291,3575893970,3575893980,10
0,1207,47292,3575893970,3575893982,12
0,1207,47293,3575893970,3575893983,13
0,1207,47294,3575893970,3575893983,13
0,1207,47295,3575893970,3575893983,13
0,1207,47296,3575893970,3575893984,14
0,1207,47297,3575893970,3575893985,15
0,1207,47298,3575893970,3575893986,16
0,1207,47299,3575893970,3575893986,16
0,1207,47300,3575893970,3575893986,16
0,1207,47301,3575893970,3575893989,19
0,1207,47302,3575893970,3575893994,24
0,1207,47303,3575893970,3575893996,26
0,1207,47304,3575893970,3575893998,28
0,1207,47305,3575893970,3575893999,29
0,1207,47306,3575893970,3575894000,30
0,1207,47307,3575893970,3575894000,30
0,1207,47308,3575893970,3575894000,30
0,1207,47309,3575893970,3575894001,31
0,1207,47310,3575893970,3575894004,34
0,1207,47311,3575893970,3575894004,34
0,1207,47312,3575893970,3575894006,36
0,1207,47313,3575893970,3575894006,36
0,1207,47314,3575893970,3575894010,40
0,1207,47315,3575893970,3575894011,41
0,1207,47316,3575893970,3575894011,41
0,1207,47317,3575893970,3575894012,42
0,1207,47318,3575893970,3575894013,43
0,1207,47319,3575893970,3575894014,44
0,1207,47320,3575893970,3575894015,45
0,1207,47321,3575893970,3575894015,45
0,1207,47322,3575893970,3575894016,46
0,1207,47323,3575893970,3575894016,46
0,1207,47324,3575893970,3575894018,48
0,1207,47325,3575893970,3575894018,48
0,1207,47326,3575893970,3575894019,49
0,1208,47327,3575894033,3575894033,0
0,1208,47328,3575894033,3575894033,0
0,1208,47329,3575894033,3575894033,0
0,1208,47330,3575894033,3575894033,0
0,1208,47331,3575894033,3575894033,0
0,1208,47332,3575894033,3575894033,0
0,1208,47333,3575894033,3575894033,0
0,1208,47334,3575894033,3575894033,0
0,1208,47335,3575894033,3575894033,0
0,1208,47336,3575894033,3575894033,0
0,1208,47337,3575894033,3575894033,0
0,1208,47338,3575894033,3575894033,0
0,1208,47339,3575894033,3575894033,0
0,1208,47340,3575894033,3575894033,0
0,1208,47341,3575894033,3575894033,0
0,1208,47342,3575894033,3575894033,0
0,1208,47343,3575894033,3575894033,0
0,1208,47344,3575894033,3575894033,0
0,1208,47345,3575894033,3575894034,1
0,1208,47346,3575894033,3575894034,1
0,1208,47347,3575894033,3575894034,1
0,1208,47348,3575894033,3575894035,2
0,1208,47349,3575894033,3575894036,3
0,1208,47350,3575894033,3575894036,3
0,1208,47351,3575894033,3575894038,5
0,1208,47352,3575894033,3575894039,6
0,1208,47353,3575894033,3575894040,7
0,1208,47354,3575894033,3575894040,7
0,1208,47355,3575894033,3575894042,9
0,1208,47356,3575894033,3575894042,9
0,1208,47357,3575894033,3575894042,9
0,1208,47358,3575894033,3575894042,9
0,1208,47359,3575894033,3575894044,11
0,1208,47360,3575894033,3575894044,11
0,1208,47361,3575894033,3575894045,12
0,1208,47362,3575894033,3575894045,12
0,1208,47363,3575894033,3575894046,13
0,1208,47364,3575894033,3575894046,13
0,1208,47365,3575894033,3575894047,14
0,1208,47366,3575894033,3575894048,15
0,1208,47367,3575894033,3575894048,15
0,1208,47368,3575894033,3575894050,17
0,1208,47369,3575894033,3575894050,17
0,1208,47370,3575894033,3575894052,19
0,1208,47371,3575894033,3575894052,19
0,1208,47372,3575894033,3575894054,21
0,1208,47373,3575894033,3575894054,21
0,1208,47374,3575894033,3575894054,21
0,1208,47375,3575894033,3575894056,23
0,1208,47376,3575894033,3575894057,24
0,1208,47377,3575894033,3575894058,25
0,1208,47378,3575894033,3575894059,26
0,1208,47379,3575894033,3575894059,26
0,1208,47380,3575894033,3575894059,26
0,1208,47381,3575894033,3575894060,27
0,1208,47382,3575894033,3575894061,28
0,1208,47383,3575894033,3575894061,28
0,1208,47384,3575894033,3575894062,29
0,1208,47385,3575894033,3575894062,29
0,1208,47386,3575894033,3575894063,30
0,1208,47387,3575894033,3575894064,31
0,1208,47388,3575894033,3575894064,31
0,1208,47389,3575894033,3575894065,32
0,1208,47390,3575894033,3575894065,32
0,1208,47391,3575894033,3575894066,33
0,1208,47392,3575894033,3575894066,33
0,1208,47393,3575894033,3575894066,33
0,1208,47394,3575894033,3575894067,34
0,1208,47395,3575894033,3575894068,35
0,1208,47396,3575894033,3575894077,44
0,1208,47397,3575894033,3575894078,45
0,1208,47398,3575894033,3575894079,46
0,1208,47399,3575894033,3575894080,47
0,1209,47400,3575894097,3575894097,0
0,1209,47401,3575894097,3575894097,0
0,1209,47402,3575894097,3575894097,0
0,1209,47403,3575894097,3575894097,0
0,1209,47404,3575894097,3575894097,0
0,1209,47405,3575894097,3575894097,0
0,1209,47406,3575894097,3575894097,0
0,1209,47407,3575894097,3575894097,0
0,1209,47408,3575894097,3575894097,0
0,1209,47409,3575894097,3575894097,0
0,1209,47410,3575894097,3575894097,0
0,1209,47411,3575894097,3575894097,0
0,1209,47412,3575894097,3575894097,0
0,1209,47413,3575894097,3575894097,0
0,1209,47414,3575894097,3575894097,0
0,1209,47415,3575894097,3575894097,0
0,1209,47416,3575894097,3575894097,0
0,1209,47417,3575894097,3575894097,0
0,1209,47418,3575894097,3575894097,0
0,1209,47419,3575894097,3575894098,1
0,1209,47420,3575894097,3575894098,1
0,1209,47421,3575894097,3575894098,1
0,1209,47422,3575894097,3575894098,1
0,1209,47423,3575894097,3575894100,3
0,1209,47424,3575894097,3575894101,4
0,1209,47425,3575894097,3575894101,4
0,1209,47426,3575894097,3575894101,4
0,1209,47427,3575894097,3575894102,5
0,1209,47428,3575894097,3575894103,6
0,1209,47429,3575894097,3575894104,7
0,1209,47430,3575894097,3575894105,8
0,1209,47431,3575894097,3575894106,9
0,1209,47432,3575894097,3575894106,9
0,1209,47433,3575894097,3575894106,9
0,1209,47434,3575894097,3575894106,9
0,1209,47435,3575894097,3575894108,11
0,1209,47436,3575894097,3575894108,11
0,1209,47437,3575894097,3575894108,11
0,1209,47438,3575894097,3575894109,12
0,1209,47439,3575894097,3575894110,13
0,1209,47440,3575894097,3575894110,13
0,1209,47441,3575894097,3575894111,14
0,1209,47442,3575894097,3575894112,15
0,1209,47443,3575894097,3575894113,16
0,1209,47444,3575894097,3575894114,17
0,1209,47445,3575894097,3575894114,17
0,1209,47446,3575894097,3575894115,18
0,1209,47447,3575894097,3575894115,18
0,1209,47448,3575894097,3575894116,19
0,1209,47449,3575894097,3575894116,19
0,1209,47450,3575894097,3575894117,20
0,1209,47451,3575894097,3575894117,20
0,1209,47452,3575894097,3575894118,21
0,1209,47453,3575894097,3575894118,21
0,1209,47454,3575894097,3575894119,22
0,1209,47455,3575894097,3575894119,22
0,1209,47456,3575894097,3575894120,23
0,1209,47457,3575894097,3575894121,24
0,1209,47458,3575894097,3575894121,24
0,1209,47459,3575894097,3575894122,25
0,1209,47460,3575894097,3575894122,25
0,1209,47461,3575894097,3575894123,26
0,1209,47462,3575894097,3575894123,26
0,1209,47463,3575894097,3575894124,27
0,1209,47464,3575894097,3575894124,27
0,1209,47465,3575894097,3575894125,28
0,1209,47466,3575894097,3575894125,28
0,1209,47467,3575894097,3575894126,29
0,1209,47468,3575894097,3575894126,29
0,1209,47469,3575894097,3575894126,29
0,1209,47470,3575894097,3575894127,30
0,1209,47471,3575894097,3575894127,30
0,1209,47472,3575894097,3575894128,31
0,1209,47473,3575894097,3575894128,31
0,1209,47474,3575894097,3575894128,31
0,1209,47475,3575894097,3575894129,32
0,1209,47476,3575894097,3575894131,34
0,1209,47477,3575894097,3575894131,34
0,1209,47478,3575894097,3575894131,34
0,1209,47479,3575894097,3575894132,35
0,1209,47480,3575894097,3575894134,37
0,1209,47481,3575894097,3575894134,37
0,1209,47482,3575894097,3575894135,38
0,1209,47483,3575894097,3575894136,39
0,1209,47484,3575894097,3575894136,39
0,1209,47485,3575894097,3575894137,40
0,1209,47486,3575894097,3575894137,40
0,1209,47487,3575894097,3575894138,41
0,1209,47488,3575894097,3575894138,41
0,1209,47489,3575894097,3575894139,42
0,1209,47490,3575894097,3575894139,42
0,1209,47491,3575894097,3575894139,42
0,1209,47492,3575894097,3575894140,43
0,1209,47493,3575894097,3575894141,44
0,1209,47494,3575894097,3575894141,44
0,1209,47495,3575894097,3575894142,45
0,1209,47496,3575894097,3575894144,47
0,1209,47497,3575894097,3575894145,48
0,1209,47498,3575894097,3575894145,48
0,1209,47499,3575894097,3575894146,49
0,1209,47500,3575894097,3575894146,49
0,1209,47501,3575894097,3575894147,50
0,1210,47502,3575894160,3575894160,0
0,1210,47503,3575894160,3575894160,0
0,1210,47504,3575894160,3575894160,0
0,1210,47505,3575894160,3575894160,0
0,1210,47506,3575894160,3575894160,0
0,1210,47507,3575894160,3575894160,0
0,1210,47508,3575894160,3575894160,0
0,1210,47509,3575894160,3575894160,0
0,1210,47510,3575894160,3575894160,0
0,1210,47511,3575894160,3575894160,0
0,1210,47512,3575894160,3575894160,0
0,1210,47513,3575894160,3575894160,0
0,1210,47514,3575894160,3575894160,0
0,1210,47515,3575894160,3575894160,0
0,1210,47516,3575894160,3575894160,0
0,1210,47517,3575894160,3575894160,0
0,1210,47518,3575894160,3575894160,0
0,1210,47519,3575894160,3575894161,1
0,1210,47520,3575894160,3575894161,1
0,1210,47521,3575894160,3575894163,3
0,1210,47522,3575894160,3575894163,3
0,1210,47523,3575894160,3575894164,4
0,1210,47524,3575894160,3575894165,5
0,1210,47525,3575894160,3575894166,6
0,1210,47526,3575894160,3575894166,6
0,1210,47527,3575894160,3575894166,6
0,1210,47528,3575894160,3575894169,9
0,1210,47529,3575894160,3575894171,11
0,1210,47530,3575894160,3575894171,11
0,1210,47531,3575894160,3575894172,12
0,1210,47532,3575894160,3575894172,12
0,1210,47533,3575894160,3575894172,12
0,1210,47534,3575894160,3575894172,12
0,1210,47535,3575894160,3575894174,14
0,1210,47536,3575894160,3575894174,14
0,1210,47537,3575894160,3575894174,14
0,1210,47538,3575894160,3575894175,15
0,1210,47539,3575894160,3575894176,16
0,1210,47540,3575894160,3575894177,17
0,1210,47541,3575894160,3575894177,17
0,1210,47542,3575894160,3575894177,17
0,1210,47543,3575894160,3575894178,18
0,1210,47544,3575894160,3575894178,18
0,1210,47545,3575894160,3575894179,19
0,1210,47546,3575894160,3575894180,20
0,1210,47547,3575894160,3575894181,21
0,1210,47548,3575894160,3575894183,23
0,1210,47549,3575894160,3575894183,23
0,1210,47550,3575894160,3575894183,23
0,1210,47551,3575894160,3575894184,24
0,1210,47552,3575894160,3575894186,26
0,1210,47553,3575894160,3575894189,29
0,1210,47554,3575894160,3575894194,34
0,1210,47555,3575894160,3575894199,39
0,1210,47556,3575894160,3575894199,39
0,1210,47557,3575894160,3575894199,39
0,1210,47558,3575894160,3575894200,40
0,1210,47559,3575894160,3575894201,41
0,1210,47560,3575894160,3575894201,41
0,1210,47561,3575894160,3575894202,42
0,1210,47562,3575894160,3575894204,44
0,1210,47563,3575894160,3575894205,45
0,1210,47564,3575894160,3575894206,46
0,1210,47565,3575894160,3575894206,46
0,1210,47566,3575894160,3575894208,48
0,1210,47567,3575894160,3575894209,49
0,1210,47568,3575894160,3575894210,50
0,1211,47569,3575894224,3575894224,0
0,1211,47570,3575894224,3575894224,0
0,1211,47571,3575894224,3575894224,0
0,1211,47572,3575894224,3575894224,0
0,1211,47573,3575894224,3575894224,0
0,1211,47574,3575894224,3575894224,0
0,1211,47575,3575894224,3575894224,0
0,1211,47576,3575894224,3575894224,0
0,1211,47577,3575894224,3575894224,0
0,1211,47578,3575894224,3575894224,0
0,1211,47579,3575894224,3575894224,0
0,1211,47580,3575894224,3575894224,0
0,1211,47581,3575894224,3575894224,0
0,1211,47582,3575894224,3575894224,0
0,1211,47583,3575894224,3575894224,0
0,1211,47584,3575894224,3575894224,0
0,1211,47585,3575894224,3575894224,0
0,1211,47586,3575894224,3575894225,1
0,1211,47587,3575894224,3575894226,2
0,1211,47588,3575894224,3575894228,4
0,1211,47589,3575894224,3575894230,6
0,1211,47590,3575894224,3575894230,6
0,1211,47591,3575894224,3575894230,6
0,1211,47592,3575894224,3575894230,6
0,1211,47593,3575894224,3575894232,8
0,1211,47594,3575894224,3575894232,8
0,1211,47595,3575894224,3575894233,9
0,1211,47596,3575894224,3575894233,9
0,1211,47597,3575894224,3575894234,10
0,1211,47598,3575894224,3575894234,10
0,1211,47599,3575894224,3575894234,10
0,1211,47600,3575894224,3575894234,10
0,1211,47601,3575894224,3575894235,11
0,1211,47602,3575894224,3575894235,11
0,1211,47603,3575894224,3575894236,12
0,1211,47604,3575894224,3575894236,12
0,1211,47605,3575894224,3575894238,14
0,1211,47606,3575894224,3575894240,16
0,1211,47607,3575894224,3575894240,16
0,1211,47608,3575894224,3575894241,17
0,1211,47609,3575894224,3575894242,18
0,1211,47610,3575894224,3575894242,18
0,1211,47611,3575894224,3575894242,18
0,1211,47612,3575894224,3575894243,19
0,1211,47613,3575894224,3575894245,21
0,1211,47614,3575894224,3575894245,21
0,1211,47615,3575894224,3575894246,22
0,1211,47616,3575894224,3575894247,23
0,1211,47617,3575894224,3575894247,23
0,1211,47618,3575894224,3575894248,24
0,1211,47619,3575894224,3575894249,25
0,1211,47620,3575894224,3575894250,26
0,1211,47621,3575894224,3575894250,26
0,1211,47622,3575894224,3575894252,28
0,1211,47623,3575894224,3575894253,29
0,1211,47624,3575894224,3575894253,29
0,1211,47625,3575894224,3575894256,32
0,1211,47626,3575894224,3575894256,32
0,1211,47627,3575894224,3575894259,35
0,1211,47628,3575894224,3575894259,35
0,1211,47629,3575894224,3575894260,36
0,1211,47630,3575894224,3575894261,37
0,1211,47631,3575894224,3575894261,37
0,1211,47632,3575894224,3575894261,37
0,1211,47633,3575894224,3575894261,37
0,1211,47634,3575894224,3575894261,37
0,1211,47635,3575894224,3575894263,39
0,1211,47636,3575894224,3575894263,39
0,1211,47637,3575894224,3575894264,40
0,1211,47638,3575894224,3575894264,40
0,1211,47639,3575894224,3575894265,41
0,1211,47640,3575894224,3575894266,42
0,1211,47641,3575894224,3575894266,42
0,1211,47642,3575894224,3575894266,42
0,1211,47643,3575894224,3575894266,42
0,1211,47644,3575894224,3575894266,42
0,1211,47645,3575894224,3575894268,44
0,1211,47646,3575894224,3575894268,44
0,1212,47647,3575894290,3575894290,0
0,1212,47648,3575894290,3575894290,0
0,1212,47649,3575894290,3575894290,0
0,1212,47650,3575894290,3575894290,0
0,1212,47651,3575894290,3575894290,0
0,1212,47652,3575894290,3575894290,0
0,1212,47653,3575894290,3575894290,0
0,1212,47654,3575894290,3575894290,0
0,1212,47655,3575894290,3575894290,0
0,1212,47656,3575894290,3575894290,0
0,1212,47657,3575894290,3575894290,0
0,1212,47658,3575894290,3575894291,1
0,1212,47659,3575894290,3575894291,1
0,1212,47660,3575894290,3575894291,1
0,1212,47661,3575894290,3575894293,3
0,1212,47662,3575894290,3575894293,3
0,1212,47663,3575894290,3575894293,3
0,1212,47664,3575894290,3575894293,3
0,1212,47665,3575894290,3575894293,3
0,1212,47666,3575894290,3575894294,4
0,1212,47667,3575894290,3575894296,6
0,1212,47668,3575894290,3575894296,6
0,1212,47669,3575894290,3575894297,7
0,1212,47670,3575894290,3575894297,7
0,1212,47671,3575894290,3575894297,7
0,1212,47672,3575894290,3575894298,8
0,1212,47673,3575894290,3575894298,8
0,1212,47674,3575894290,3575894298,8
0,1212,47675,3575894290,3575894299,9
0,1212,47676,3575894290,3575894299,9
0,1212,47677,3575894290,3575894300,10
0,1212,47678,3575894290,3575894301,11
0,1212,47679,3575894290,3575894301,11
0,1212,47680,3575894290,3575894301,11
0,1212,47681,3575894290,3575894302,12
0,1212,47682,3575894290,3575894302,12
0,1212,47683,3575894290,3575894304,14
0,1212,47684,3575894290,3575894305,15
0,1212,47685,3575894290,3575894306,16
0,1212,47686,3575894290,3575894306,16
0,1212,47687,3575894290,3575894306,16
0,1212,47688,3575894290,3575894306,16
0,1212,47689,3575894290,3575894309,19
0,1212,47690,3575894290,3575894309,19
0,1212,47691,3575894290,3575894310,20
0,1212,47692,3575894290,3575894310,20
0,1212,47693,3575894290,3575894311,21
0,1212,47694,3575894290,3575894312,22
0,1212,47695,3575894290,3575894313,23
0,1212,47696,3575894290,3575894313,23
0,1212,47697,3575894290,3575894314,24
0,1212,47698,3575894290,3575894314,24
0,1212,47699,3575894290,3575894315,25
0,1212,47700,3575894290,3575894315,25
0,1212,47701,3575894290,3575894315,25
0,1212,47702,3575894290,3575894316,26
0,1212,47703,3575894290,3575894318,28
0,1212,47704,3575894290,3575894318,28
0,1212,47705,3575894290,3575894318,28
0,1212,47706,3575894290,3575894319,29
0,1212,47707,3575894290,3575894319,29
0,1212,47708,3575894290,3575894320,30
0,1212,47709,3575894290,3575894321,31
0,1212,47710,3575894290,3575894321,31
0,1212,47711,3575894290,3575894322,32
0,1212,47712,3575894290,3575894322,32
0,1212,47713,3575894290,3575894322,32
0,1212,47714,3575894290,3575894323,33
0,1212,47715,3575894290,3575894324,34
0,1212,47716,3575894290,3575894325,35
0,1212,47717,3575894290,3575894325,35
0,1212,47718,3575894290,3575894325,35
0,1212,47719,3575894290,3575894325,35
0,1212,47720,3575894290,3575894326,36
0,1212,47721,3575894290,3575894327,37
0,1212,47722,3575894290,3575894327,37
0,1212,47723,3575894290,3575894328,38
0,1212,47724,3575894290,3575894328,38
0,1212,47725,3575894290,3575894329,39
0,1212,47726,3575894290,3575894331,41
0,1212,47727,3575894290,3575894331,41
0,1212,47728,3575894290,3575894331,41
0,1212,47729,3575894290,3575894335,45
0,1212,47730,3575894290,3575894335,45
0,1212,47731,3575894290,3575894336,46
0,1212,47732,3575894290,3575894336,46
0,1212,47733,3575894290,3575894338,48
0,1212,47734,3575894290,3575894338,48
0,1212,47735,3575894290,3575894339,49
0,1212,47736,3575894290,3575894339,49
0,1212,47737,3575894290,3575894339,49
0,1212,47738,3575894290,3575894340,50
0,1213,47739,3575894353,3575894353,0
0,1213,47740,3575894353,3575894353,0
0,1213,47741,3575894353,3575894353,0
0,1213,47742,3575894353,3575894353,0
0,1213,47743,3575894353,3575894353,0
0,1213,47744,3575894353,3575894353,0
0,1213,47745,3575894353,3575894353,0
0,1213,47746,3575894353,3575894353,0
0,1213,47747,3575894353,3575894353,0
0,1213,47748,3575894353,3575894353,0
0,1213,47749,3575894353,3575894353,0
0,1213,47750,3575894353,3575894353,0
0,1213,47751,3575894353,3575894353,0
0,1213,47752,3575894353,3575894353,0
0,1213,47753,3575894353,3575894353,0
0,1213,47754,3575894353,3575894353,0
0,1213,47755,3575894353,3575894353,0
0,1213,47756,3575894353,3575894353,0
0,1213,47757,3575894353,3575894354,1
0,1213,47758,3575894353,3575894355,2
0,1213,47759,3575894353,3575894355,2
0,1213,47760,3575894353,3575894355,2
0,1213,47761,3575894353,3575894355,2
0,1213,47762,3575894353,3575894356,3
0,1213,47763,3575894353,3575894357,4
0,1213,47764,3575894353,3575894357,4
0,1213,47765,3575894353,3575894357,4
0,1213,47766,3575894353,3575894357,4
0,1213,47767,3575894353,3575894360,7
0,1213,47768,3575894353,3575894360,7
0,1213,47769,3575894353,3575894361,8
0,1213,47770,3575894353,3575894362,9
0,1213,47771,3575894353,3575894362,9
0,1213,47772,3575894353,3575894362,9
0,1213,47773,3575894353,3575894363,10
0,1213,47774,3575894353,3575894364,11
0,1213,47775,3575894353,3575894364,11
0,1213,47776,3575894353,3575894365,12
0,1213,47777,3575894353,3575894367,14
0,1213,47778,3575894353,3575894367,14
0,1213,47779,3575894353,3575894370,17
0,1213,47780,3575894353,3575894372,19
0,1213,47781,3575894353,3575894373,20
0,1213,47782,3575894353,3575894373,20
0,1213,47783,3575894353,3575894374,21
0,1213,47784,3575894353,3575894375,22
0,1213,47785,3575894353,3575894375,22
0,1213,47786,3575894353,3575894376,23
0,1213,47787,3575894353,3575894376,23
0,1213,47788,3575894353,3575894376,23
0,1213,47789,3575894353,3575894377,24
0,1213,47790,3575894353,3575894377,24
0,1213,47791,3575894353,3575894378,25
0,1213,47792,3575894353,3575894381,28
0,1213,47793,3575894353,3575894381,28
0,1213,47794,3575894353,3575894383,30
0,1213,47795,3575894353,3575894383,30
0,1213,47796,3575894353,3575894383,30
0,1213,47797,3575894353,3575894384,31
0,1213,47798,3575894353,3575894385,32
0,1213,47799,3575894353,3575894386,33
0,1213,47800,3575894353,3575894387,34
0,1213,47801,3575894353,3575894387,34
0,1213,47802,3575894353,3575894389,36
0,1213,47803,3575894353,3575894389,36
0,1213,47804,3575894353,3575894394,41
0,1213,47805,3575894353,3575894394,41
0,1213,47806,3575894353,3575894396,43
0,1213,47807,3575894353,3575894399,46
0,1213,47808,3575894353,3575894400,47
0,1213,47809,3575894353,3575894400,47
0,1213,47810,3575894353,3575894400,47
0,1213,47811,3575894353,3575894401,48
0,1213,47812,3575894353,3575894403,50
0,1214,47813,3575894418,3575894418,0
0,1214,47814,3575894418,3575894418,0
0,1214,47815,3575894418,3575894418,0
0,1214,47816,3575894418,3575894418,0
0,1214,47817,3575894418,3575894418,0
0,1214,47818,3575894418,3575894418,0
0,1214,47819,3575894418,3575894418,0
0,1214,47820,3575894418,3575894418,0
0,1214,47821,3575894418,3575894418,0
0,1214,47822,3575894418,3575894418,0
0,1214,47823,3575894418,3575894418,0
0,1214,47824,3575894418,3575894418,0
0,1214,47825,3575894418,3575894418,0
0,1214,47826,3575894418,3575894418,0
0,1214,47827,3575894418,3575894418,0
0,1214,47828,3575894418,3575894418,0
0,1214,47829,3575894418,3575894418,0
0,1214,47830,3575894418,3575894420,2
0,1214,47831,3575894418,3575894420,2
0,1214,47832,3575894418,3575894421,3
0,1214,47833,3575894418,3575894422,4
0,1214,47834,3575894418,3575894423,5
0,1214,47835,3575894418,3575894423,5
0,1214,47836,3575894418,3575894426,8
0,1214,47837,3575894418,3575894426,8
0,1214,47838,3575894418,3575894427,9
0,1214,47839,3575894418,3575894429,11
0,1214,47840,3575894418,3575894430,12
0,1214,47841,3575894418,3575894430,12
0,1214,47842,3575894418,3575894430,12
0,1214,47843,3575894418,3575894430,12
0,1214,47844,3575894418,3575894431,13
0,1214,47845,3575894418,3575894432,14
0,1214,47846,3575894418,3575894433,15
0,1214,47847,3575894418,3575894433,15
0,1214,47848,3575894418,3575894433,15
0,1214,47849,3575894418,3575894433,15
0,1214,47850,3575894418,3575894434,16
0,1214,47851,3575894418,3575894434,16
0,1214,47852,3575894418,3575894434,16
0,1214,47853,3575894418,3575894435,17
0,1214,47854,3575894418,3575894435,17
0,1214,47855,3575894418,3575894435,17
0,1214,47856,3575894418,3575894436,18
0,1214,47857,3575894418,3575894438,20
0,1214,47858,3575894418,3575894440,22
0,1214,47859,3575894418,3575894441,23
0,1214,47860,3575894418,3575894442,24
0,1214,47861,3575894418,3575894442,24
0,1214,47862,3575894418,3575894442,24
0,1214,47863,3575894418,3575894444,26
0,1214,47864,3575894418,3575894445,27
0,1214,47865,3575894418,3575894445,27
0,1214,47866,3575894418,3575894446,28
0,1214,47867,3575894418,3575894447,29
0,1214,47868,3575894418,3575894447,29
0,1214,47869,3575894418,3575894447,29
0,1214,47870,3575894418,3575894449,31
0,1214,47871,3575894418,3575894450,32
0,1214,47872,3575894418,3575894450,32
0,1214,47873,3575894418,3575894452,34
0,1214,47874,3575894418,3575894452,34
0,1214,47875,3575894418,3575894453,35
0,1214,47876,3575894418,3575894453,35
0,1214,47877,3575894418,3575894455,37
0,1214,47878,3575894418,3575894456,38
0,1214,47879,3575894418,3575894456,38
0,1214,47880,3575894418,3575894458,40
0,1214,47881,3575894418,3575894459,41
0,1214,47882,3575894418,3575894459,41
0,1214,47883,3575894418,3575894459,41
0,1214,47884,3575894418,3575894460,42
0,1214,47885,3575894418,3575894461,43
0,1214,47886,3575894418,3575894463,45
0,1214,47887,3575894418,3575894463,45
0,1214,47888,3575894418,3575894464,46
0,1214,47889,3575894418,3575894464,46
0,1214,47890,3575894418,3575894465,47
0,1214,47891,3575894418,3575894466,48
0,1214,47892,3575894418,3575894466,48
0,1214,47893,3575894418,3575894467,49
0,1214,47894,3575894418,3575894468,50
0,1215,47895,3575894480,3575894481,1
0,1215,47896,3575894480,3575894481,1
0,1215,47897,3575894480,3575894481,1
0,1215,47898,3575894480,3575894481,1
0,1215,47899,3575894480,3575894481,1
0,1215,47900,3575894480,3575894484,4
0,1215,47901,3575894480,3575894488,8
0,1215,47902,3575894480,3575894488,8
0,1215,47903,3575894480,3575894488,8
0,1215,47904,3575894480,3575894489,9
0,1215,47905,3575894480,3575894490,10
0,1215,47906,3575894480,3575894491,11
0,1215,47907,3575894480,3575894492,12
0,1215,47908,3575894480,3575894492,12
0,1215,47909,3575894480,3575894492,12
0,1215,47910,3575894480,3575894494,14
0,1215,47911,3575894480,3575894494,14
0,1215,47912,3575894480,3575894494,14
0,1215,47913,3575894480,3575894495,15
0,1215,47914,3575894480,3575894495,15
0,1215,47915,3575894480,3575894496,16
0,1215,47916,3575894480,3575894496,16
0,1215,47917,3575894480,3575894496,16
0,1215,47918,3575894480,3575894497,17
0,1215,47919,3575894480,3575894497,17
0,1215,47920,3575894480,3575894497,17
0,1215,47921,3575894480,3575894497,17
0,1215,47922,3575894480,3575894498,18
0,1215,47923,3575894480,3575894499,19
0,1215,47924,3575894480,3575894500,20
0,1215,47925,3575894480,3575894500,20
0,1215,47926,3575894480,3575894501,21
0,1215,47927,3575894480,3575894502,22
0,1215,47928,3575894480,3575894502,22
0,1215,47929,3575894480,3575894503,23
0,1215,47930,3575894480,3575894503,23
0,1215,47931,3575894480,3575894504,24
0,1215,47932,3575894480,3575894505,25
0,1215,47933,3575894480,3575894506,26
0,1215,47934,3575894480,3575894507,27
0,1215,47935,3575894480,3575894508,28
0,1215,47936,3575894480,3575894508,28
0,1215,47937,3575894480,3575894509,29
0,1215,47938,3575894480,3575894510,30
0,1215,47939,3575894480,3575894510,30
0,1215,47940,3575894480,3575894510,30
0,1215,47941,3575894480,3575894510,30
0,1215,47942,3575894480,3575894512,32
0,1215,47943,3575894480,3575894512,32
0,1215,47944,3575894480,3575894513,33
0,1215,47945,3575894480,3575894513,33
0,1215,47946,3575894480,3575894513,33
0,1215,47947,3575894480,3575894514,34
0,1215,47948,3575894480,3575894515,35
0,1215,47949,3575894480,3575894517,37
0,1215,47950,3575894480,3575894517,37
0,1215,47951,3575894480,3575894517,37
0,1215,47952,3575894480,3575894517,37
0,1215,47953,3575894480,3575894520,40
0,1215,47954,3575894480,3575894521,41
0,1215,47955,3575894480,3575894521,41
0,1215,47956,3575894480,3575894521,41
0,1215,47957,3575894480,3575894522,42
0,1215,47958,3575894480,3575894524,44
0,1215,47959,3575894480,3575894524,44
0,1215,47960,3575894480,3575894525,45
0,1215,47961,3575894480,3575894526,46
0,1215,47962,3575894480,3575894526,46
0,1215,47963,3575894480,3575894526,46
0,1215,47964,3575894480,3575894526,46
0,1215,47965,3575894480,3575894527,47
0,1215,47966,3575894480,3575894527,47
0,1215,47967,3575894480,3575894527,47
0,1215,47968,3575894480,3575894528,48
0,1215,47969,3575894480,3575894529,49
0,1215,47970,3575894480,3575894530,50
0,1216,47971,3575894550,3575894550,0
0,1216,47972,3575894550,3575894550,0
0,1216,47973,3575894550,3575894550,0
0,1216,47974,3575894550,3575894550,0
0,1216,47975,3575894550,3575894550,0
0,1216,47976,3575894550,3575894550,0
0,1216,47977,3575894550,3575894550,0
0,1216,47978,3575894550,3575894550,0
0,1216,47979,3575894550,3575894550,0
0,1216,47980,3575894550,3575894550,0
0,1216,47981,3575894550,3575894550,0
0,1216,47982,3575894550,3575894550,0
0,1216,47983,3575894550,3575894550,0
0,1216,47984,3575894550,3575894550,0
0,1216,47985,3575894550,3575894550,0
0,1216,47986,3575894550,3575894550,0
0,1216,47987,3575894550,3575894550,0
0,1216,47988,3575894550,3575894550,0
0,1216,47989,3575894550,3575894550,0
0,1216,47990,3575894550,3575894550,0
0,1216,47991,3575894550,3575894550,0
0,1216,47992,3575894550,3575894550,0
0,1216,47993,3575894550,3575894550,0
0,1216,47994,3575894550,3575894550,0
0,1216,47995,3575894550,3575894550,0
0,1216,47996,3575894550,3575894550,0
0,1216,47997,3575894550,3575894550,0
0,1216,47998,3575894550,3575894550,0
0,1216,47999,3575894550,3575894550,0
0,1216,48000,3575894550,3575894552,2
0,1216,48001,3575894550,3575894552,2
0,1216,48002,3575894550,3575894553,3
0,1216,48003,3575894550,3575894553,3
0,1216,48004,3575894550,3575894554,4
0,1216,48005,3575894550,3575894555,5
0,1216,48006,3575894550,3575894556,6
0,1216,48007,3575894550,3575894556,6
0,1216,48008,3575894550,3575894557,7
0,1216,48009,3575894550,3575894558,8
0,1216,48010,3575894550,3575894559,9
0,1216,48011,3575894550,3575894559,9
0,1216,48012,3575894550,3575894560,10
0,1216,48013,3575894550,3575894561,11
0,1216,48014,3575894550,3575894562,12
0,1216,48015,3575894550,3575894563,13
0,1216,48016,3575894550,3575894563,13
0,1216,48017,3575894550,3575894563,13
0,1216,48018,3575894550,3575894564,14
0,1216,48019,3575894550,3575894564,14
0,1216,48020,3575894550,3575894565,15
0,1216,48021,3575894550,3575894565,15
0,1216,48022,3575894550,3575894565,15
0,1216,48023,3575894550,3575894566,16
0,1216,48024,3575894550,3575894566,16
0,1216,48025,3575894550,3575894569,19
0,1216,48026,3575894550,3575894571,21
0,1216,48027,3575894550,3575894572,22
0,1216,48028,3575894550,3575894572,22
0,1216,48029,3575894550,3575894572,22
0,1216,48030,3575894550,3575894573,23
0,1216,48031,3575894550,3575894574,24
0,1216,48032,3575894550,3575894575,25
0,1216,48033,3575894550,3575894575,25
0,1216,48034,3575894550,3575894575,25
0,1216,48035,3575894550,3575894575,25
0,1216,48036,3575894550,3575894576,26
0,1216,48037,3575894550,3575894576,26
0,1216,48038,3575894550,3575894577,27
0,1216,48039,3575894550,3575894577,27
0,1216,48040,3575894550,3575894578,28
0,1216,48041,3575894550,3575894580,30
0,1216,48042,3575894550,3575894581,31
0,1216,48043,3575894550,3575894582,32
0,1216,48044,3575894550,3575894582,32
0,1216,48045,3575894550,3575894582,32
0,1216,48046,3575894550,3575894584,34
0,1216,48047,3575894550,3575894586,36
0,1216,48048,3575894550,3575894586,36
0,1216,48049,3575894550,3575894588,38
0,1216,48050,3575894550,3575894593,43
0,1216,48051,3575894550,3575894595,45
0,1216,48052,3575894550,3575894597,47
0,1216,48053,3575894550,3575894599,49
0,1216,48054,3575894550,3575894599,49
0,1216,48055,3575894550,3575894599,49
0,1216,48056,3575894550,3575894600,50
0,1217,48057,3575894613,3575894613,0
0,1217,48058,3575894613,3575894613,0
0,1217,48059,3575894613,3575894613,0
0,1217,48060,3575894613,3575894613,0
0,1217,48061,3575894613,3575894613,0
0,1217,48062,3575894613,3575894613,0
0,1217,48063,3575894613,3575894613,0
0,1217,48064,3575894613,3575894613,0
0,1217,48065,3575894613,3575894613,0
0,1217,48066,3575894613,3575894613,0
0,1217,48067,3575894613,3575894613,0
0,1217,48068,3575894613,3575894613,0
0,1217,48069,3575894613,3575894613,0
0,1217,48070,3575894613,3575894613,0
0,1217,48071,3575894613,3575894615,2
0,1217,48072,3575894613,3575894615,2
0,1217,48073,3575894613,3575894615,2
0,1217,48074,3575894613,3575894616,3
0,1217,48075,3575894613,3575894617,4
0,1217,48076,3575894613,3575894617,4
0,1217,48077,3575894613,3575894620,7
0,1217,48078,3575894613,3575894621,8
0,1217,48079,3575894613,3575894621,8
0,1217,48080,3575894613,3575894622,9
0,1217,48081,3575894613,3575894622,9
0,1217,48082,3575894613,3575894625,12
0,1217,48083,3575894613,3575894625,12
0,1217,48084,3575894613,3575894627,14
0,1217,48085,3575894613,3575894629,16
0,1217,48086,3575894613,3575894630,17
0,1217,48087,3575894613,3575894630,17
0,1217,48088,3575894613,3575894632,19
0,1217,48089,3575894613,3575894632,19
0,1217,48090,3575894613,3575894632,19
0,1217,48091,3575894613,3575894632,19
0,1217,48092,3575894613,3575894632,19
0,1217,48093,3575894613,3575894633,20
0,1217,48094,3575894613,3575894634,21
0,1217,48095,3575894613,3575894634,21
0,1217,48096,3575894613,3575894634,21
0,1217,48097,3575894613,3575894634,21
0,1217,48098,3575894613,3575894635,22
0,1217,48099,3575894613,3575894635,22
0,1217,48100,3575894613,3575894636,23
0,1217,48101,3575894613,3575894639,26
0,1217,48102,3575894613,3575894639,26
0,1217,48103,3575894613,3575894642,29
0,1217,48104,3575894613,3575894642,29
0,1217,48105,3575894613,3575894644,31
0,1217,48106,3575894613,3575894645,32
0,1217,48107,3575894613,3575894645,32
0,1217,48108,3575894613,3575894646,33
0,1217,48109,3575894613,3575894646,33
0,1217,48110,3575894613,3575894646,33
0,1217,48111,3575894613,3575894647,34
0,1217,48112,3575894613,3575894648,35
0,1217,48113,3575894613,3575894649,36
0,1217,48114,3575894613,3575894651,38
0,1217,48115,3575894613,3575894651,38
0,1217,48116,3575894613,3575894655,42
0,1217,48117,3575894613,3575894655,42
0,1217,48118,3575894613,3575894658,45
0,1217,48119,3575894613,3575894659,46
0,1217,48120,3575894613,3575894659,46
0,1217,48121,3575894613,3575894660,47
0,1217,48122,3575894613,3575894660,47
0,1217,48123,3575894613,3575894660,47
0,1217,48124,3575894613,3575894660,47
0,1217,48125,3575894613,3575894661,48
0,1217,48126,3575894613,3575894662,49
0,1217,48127,3575894613,3575894662,49
0,1218,48128,3575894678,3575894678,0
0,1218,48129,3575894678,3575894678,0
0,1218,48130,3575894678,3575894678,0
0,1218,48131,3575894678,3575894678,0
0,1218,48132,3575894678,3575894678,0
0,1218,48133,3575894678,3575894678,0
0,1218,48134,3575894678,3575894678,0
0,1218,48135,3575894678,3575894678,0
0,1218,48136,3575894678,3575894678,0
0,1218,48137,3575894678,3575894678,0
0,1218,48138,3575894678,3575894678,0
0,1218,48139,3575894678,3575894678,0
0,1218,48140,3575894678,3575894680,2
0,1218,48141,3575894678,3575894680,2
0,1218,48142,3575894678,3575894680,2
0,1218,48143,3575894678,3575894683,5
0,1218,48144,3575894678,3575894687,9
0,1218,48145,3575894678,3575894688,10
0,1218,48146,3575894678,3575894688,10
0,1218,48147,3575894678,3575894688,10
0,1218,48148,3575894678,3575894689,11
0,1218,48149,3575894678,3575894691,13
0,1218,48150,3575894678,3575894691,13
0,1218,48151,3575894678,3575894691,13
0,1218,48152,3575894678,3575894692,14
0,1218,48153,3575894678,3575894692,14
0,1218,48154,3575894678,3575894693,15
0,1218,48155,3575894678,3575894694,16
0,1218,48156,3575894678,3575894696,18
0,1218,48157,3575894678,3575894696,18
0,1218,48158,3575894678,3575894696,18
0,1218,48159,3575894678,3575894696,18
0,1218,48160,3575894678,3575894696,18
0,1218,48161,3575894678,3575894697,19
0,1218,48162,3575894678,3575894697,19
0,1218,48163,3575894678,3575894697,19
0,1218,48164,3575894678,3575894700,22
0,1218,48165,3575894678,3575894700,22
0,1218,48166,3575894678,3575894700,22
0,1218,48167,3575894678,3575894702,24
0,1218,48168,3575894678,3575894703,25
0,1218,48169,3575894678,3575894704,26
0,1218,48170,3575894678,3575894705,27
0,1218,48171,3575894678,3575894705,27
0,1218,48172,3575894678,3575894705,27
0,1218,48173,3575894678,3575894706,28
0,1218,48174,3575894678,3575894707,29
0,1218,48175,3575894678,3575894707,29
0,1218,48176,3575894678,3575894708,30
0,1218,48177,3575894678,3575894710,32
0,1218,48178,3575894678,3575894710,32
0,1218,48179,3575894678,3575894710,32
0,1218,48180,3575894678,3575894710,32
0,1218,48181,3575894678,3575894712,34
0,1218,48182,3575894678,3575894712,34
0,1218,48183,3575894678,3575894713,35
0,1218,48184,3575894678,3575894715,37
0,1218,48185,3575894678,3575894715,37
0,1218,48186,3575894678,3575894716,38
0,1218,48187,3575894678,3575894716,38
0,1218,48188,3575894678,3575894717,39
0,1218,48189,3575894678,3575894717,39
0,1218,48190,3575894678,3575894718,40
0,1218,48191,3575894678,3575894718,40
0,1218,48192,3575894678,3575894718,40
0,1218,48193,3575894678,3575894720,42
0,1218,48194,3575894678,3575894721,43
0,1218,48195,3575894678,3575894721,43
0,1218,48196,3575894678,3575894722,44
0,1218,48197,3575894678,3575894722,44
0,1218,48198,3575894678,3575894723,45
0,1218,48199,3575894678,3575894724,46
0,1218,48200,3575894678,3575894725,47
0,1218,48201,3575894678,3575894725,47
0,1218,48202,3575894678,3575894726,48
0,1218,48203,3575894678,3575894726,48
0,1218,48204,3575894678,3575894727,49
0,1218,48205,3575894678,3575894728,50
0,1219,48206,3575894745,3575894745,0
0,1219,48207,3575894745,3575894745,0
0,1219,48208,3575894745,3575894745,0
0,1219,48209,3575894745,3575894745,0
0,1219,48210,3575894745,3575894745,0
0,1219,48211,3575894745,3575894745,0
0,1219,48212,3575894745,3575894745,0
0,1219,48213,3575894745,3575894745,0
0,1219,48214,3575894745,3575894745,0
0,1219,48215,3575894745,3575894745,0
0,1219,48216,3575894745,3575894745,0
0,1219,48217,3575894745,3575894745,0
0,1219,48218,3575894745,3575894745,0
0,1219,48219,3575894745,3575894745,0
0,1219,48220,3575894745,3575894745,0
0,1219,48221,3575894745,3575894745,0
0,1219,48222,3575894745,3575894745,0
0,1219,48223,3575894745,3575894745,0
0,1219,48224,3575894745,3575894745,0
0,1219,48225,3575894745,3575894745,0
0,1219,48226,3575894745,3575894745,0
0,1219,48227,3575894745,3575894745,0
0,1219,48228,3575894745,3575894745,0
0,1219,48229,3575894745,3575894745,0
0,1219,48230,3575894745,3575894745,0
0,1219,48231,3575894745,3575894746,1
0,1219,48232,3575894745,3575894746,1
0,1219,48233,3575894745,3575894747,2
0,1219,48234,3575894745,3575894747,2
0,1219,48235,3575894745,3575894747,2
0,1219,48236,3575894745,3575894748,3
0,1219,48237,3575894745,3575894748,3
0,1219,48238,3575894745,3575894750,5
0,1219,48239,3575894745,3575894750,5
0,1219,48240,3575894745,3575894751,6
0,1219,48241,3575894745,3575894752,7
0,1219,48242,3575894745,3575894752,7
0,1219,48243,3575894745,3575894753,8
0,1219,48244,3575894745,3575894754,9
0,1219,48245,3575894745,3575894754,9
0,1219,48246,3575894745,3575894754,9
0,1219,48247,3575894745,3575894754,9
0,1219,48248,3575894745,3575894754,9
0,1219,48249,3575894745,3575894755,10
0,1219,48250,3575894745,3575894755,10
0,1219,48251,3575894745,3575894756,11
0,1219,48252,3575894745,3575894756,11
0,1219,48253,3575894745,3575894759,14
0,1219,48254,3575894745,3575894760,15
0,1219,48255,3575894745,3575894760,15
0,1219,48256,3575894745,3575894761,16
0,1219,48257,3575894745,3575894762,17
0,1219,48258,3575894745,3575894763,18
0,1219,48259,3575894745,3575894764,19
0,1219,48260,3575894745,3575894764,19
0,1219,48261,3575894745,3575894765,20
0,1219,48262,3575894745,3575894765,20
0,1219,48263,3575894745,3575894765,20
0,1219,48264,3575894745,3575894765,20
0,1219,48265,3575894745,3575894766,21
0,1219,48266,3575894745,3575894767,22
0,1219,48267,3575894745,3575894769,24
0,1219,48268,3575894745,3575894771,26
0,1219,48269,3575894745,3575894772,27
0,1219,48270,3575894745,3575894772,27
0,1219,48271,3575894745,3575894774,29
0,1219,48272,3575894745,3575894775,30
0,1219,48273,3575894745,3575894775,30
0,1219,48274,3575894745,3575894775,30
0,1219,48275,3575894745,3575894775,30
0,1219,48276,3575894745,3575894775,30
0,1219,48277,3575894745,3575894777,32
0,1219,48278,3575894745,3575894778,33
0,1219,48279,3575894745,3575894780,35
0,1219,48280,3575894745,3575894780,35
0,1219,48281,3575894745,3575894782,37
0,1219,48282,3575894745,3575894782,37
0,1219,48283,3575894745,3575894784,39
0,1219,48284,3575894745,3575894785,40
0,1219,48285,3575894745,3575894786,41
0,1219,48286,3575894745,3575894786,41
0,1219,48287,3575894745,3575894787,42
0,1219,48288,3575894745,3575894788,43
0,1219,48289,3575894745,3575894789,44
0,1219,48290,3575894745,3575894794,49
0,1219,48291,3575894745,3575894795,50
0,1220,48292,3575894809,3575894809,0
0,1220,48293,3575894809,3575894809,0
0,1220,48294,3575894809,3575894809,0
0,1220,48295,3575894809,3575894809,0
0,1220,48296,3575894809,3575894809,0
0,1220,48297,3575894809,3575894809,0
0,1220,48298,3575894809,3575894809,0
0,1220,48299,3575894809,3575894809,0
0,1220,48300,3575894809,3575894809,0
0,1220,48301,3575894809,3575894809,0
0,1220,48302,3575894809,3575894809,0
0,1220,48303,3575894809,3575894809,0
0,1220,48304,3575894809,3575894810,1
0,1220,48305,3575894809,3575894812,3
0,1220,48306,3575894809,3575894812,3
0,1220,48307,3575894809,3575894812,3
0,1220,48308,3575894809,3575894813,4
0,1220,48309,3575894809,3575894813,4
0,1220,48310,3575894809,3575894815,6
0,1220,48311,3575894809,3575894816,7
0,1220,48312,3575894809,3575894817,8
0,1220,48313,3575894809,3575894817,8
0,1220,48314,3575894809,3575894818,9
0,1220,48315,3575894809,3575894819,10
0,1220,48316,3575894809,3575894820,11
0,1220,48317,3575894809,3575894821,12
0,1220,48318,3575894809,3575894822,13
0,1220,48319,3575894809,3575894822,13
0,1220,48320,3575894809,3575894822,13
0,1220,48321,3575894809,3575894825,16
0,1220,48322,3575894809,3575894826,17
0,1220,48323,3575894809,3575894829,20
0,1220,48324,3575894809,3575894829,20
0,1220,48325,3575894809,3575894829,20
0,1220,48326,3575894809,3575894829,20
0,1220,48327,3575894809,3575894830,21
0,1220,48328,3575894809,3575894830,21
0,1220,48329,3575894809,3575894831,22
0,1220,48330,3575894809,3575894832,23
0,1220,48331,3575894809,3575894832,23
0,1220,48332,3575894809,3575894833,24
0,1220,48333,3575894809,3575894833,24
0,1220,48334,3575894809,3575894834,25
0,1220,48335,3575894809,3575894835,26
0,1220,48336,3575894809,3575894835,26
0,1220,48337,3575894809,3575894835,26
0,1220,48338,3575894809,3575894835,26
0,1220,48339,3575894809,3575894835,26
0,1220,48340,3575894809,3575894836,27
0,1220,48341,3575894809,3575894838,29
0,1220,48342,3575894809,3575894838,29
0,1220,48343,3575894809,3575894840,31
0,1220,48344,3575894809,3575894840,31
0,1220,48345,3575894809,3575894842,33
0,1220,48346,3575894809,3575894842,33
0,1220,48347,3575894809,3575894842,33
0,1220,48348,3575894809,3575894844,35
0,1220,48349,3575894809,3575894845,36
0,1220,48350,3575894809,3575894846,37
0,1220,48351,3575894809,3575894846,37
0,1220,48352,3575894809,3575894846,37
0,1220,48353,3575894809,3575894846,37
0,1220,48354,3575894809,3575894848,39
0,1220,48355,3575894809,3575894848,39
0,1220,48356,3575894809,3575894850,41
0,1220,48357,3575894809,3575894850,41
0,1220,48358,3575894809,3575894851,42
0,1220,48359,3575894809,3575894852,43
0,1220,48360,3575894809,3575894855,46
0,1220,48361,3575894809,3575894855,46
0,1220,48362,3575894809,3575894856,47
0,1220,48363,3575894809,3575894856,47
0,1220,48364,3575894809,3575894857,48
0,1220,48365,3575894809,3575894858,49
0,1220,48366,3575894809,3575894859,50
0,1221,48367,3575894874,3575894874,0
0,1221,48368,3575894874,3575894874,0
0,1221,48369,3575894874,3575894874,0
0,1221,48370,3575894874,3575894874,0
0,1221,48371,3575894874,3575894874,0
0,1221,48372,3575894874,3575894874,0
0,1221,48373,3575894874,3575894874,0
0,1221,48374,3575894874,3575894874,0
0,1221,48375,3575894874,3575894874,0
0,1221,48376,3575894874,3575894874,0
0,1221,48377,3575894874,3575894874,0
0,1221,48378,3575894874,3575894874,0
0,1221,48379,3575894874,3575894874,0
0,1221,48380,3575894874,3575894874,0
0,1221,48381,3575894874,3575894874,0
0,1221,48382,3575894874,3575894874,0
0,1221,48383,3575894874,3575894878,4
0,1221,48384,3575894874,3575894880,6
0,1221,48385,3575894874,3575894880,6
0,1221,48386,3575894874,3575894882,8
0,1221,48387,3575894874,3575894883,9
0,1221,48388,3575894874,3575894887,13
0,1221,48389,3575894874,3575894889,15
0,1221,48390,3575894874,3575894890,16
0,1221,48391,3575894874,3575894891,17
0,1221,48392,3575894874,3575894892,18
0,1221,48393,3575894874,3575894892,18
0,1221,48394,3575894874,3575894892,18
0,1221,48395,3575894874,3575894893,19
0,1221,48396,3575894874,3575894893,19
0,1221,48397,3575894874,3575894895,21
0,1221,48398,3575894874,3575894896,22
0,1221,48399,3575894874,3575894896,22
0,1221,48400,3575894874,3575894896,22
0,1221,48401,3575894874,3575894897,23
0,1221,48402,3575894874,3575894897,23
0,1221,48403,3575894874,3575894897,23
0,1221,48404,3575894874,3575894898,24
0,1221,48405,3575894874,3575894898,24
0,1221,48406,3575894874,3575894900,26
0,1221,48407,3575894874,3575894900,26
0,1221,48408,3575894874,3575894901,27
0,1221,48409,3575894874,3575894902,28
0,1221,48410,3575894874,3575894903,29
0,1221,48411,3575894874,3575894904,30
0,1221,48412,3575894874,3575894904,30
0,1221,48413,3575894874,3575894905,31
0,1221,48414,3575894874,3575894905,31
0,1221,48415,3575894874,3575894905,31
0,1221,48416,3575894874,3575894906,32
0,1221,48417,3575894874,3575894906,32
0,1221,48418,3575894874,3575894907,33
0,1221,48419,3575894874,3575894908,34
0,1221,48420,3575894874,3575894908,34
0,1221,48421,3575894874,3575894910,36
0,1221,48422,3575894874,3575894910,36
0,1221,48423,3575894874,3575894911,37
0,1221,48424,3575894874,3575894911,37
0,1221,48425,3575894874,3575894911,37
0,1221,48426,3575894874,3575894912,38
0,1221,48427,3575894874,3575894913,39
0,1221,48428,3575894874,3575894913,39
0,1221,48429,3575894874,3575894913,39
0,1221,48430,3575894874,3575894913,39
0,1221,48431,3575894874,3575894915,41
0,1221,48432,3575894874,3575894916,42
0,1221,48433,3575894874,3575894916,42
0,1221,48434,3575894874,3575894916,42
0,1221,48435,3575894874,3575894916,42
0,1221,48436,3575894874,3575894917,43
0,1221,48437,3575894874,3575894917,43
0,1221,48438,3575894874,3575894918,44
0,1221,48439,3575894874,3575894919,45
0,1221,48440,3575894874,3575894921,47
0,1221,48441,3575894874,3575894921,47
0,1221,48442,3575894874,3575894921,47
0,1221,48443,3575894874,3575894921,47
0,1221,48444,3575894874,3575894922,48
0,1221,48445,3575894874,3575894922,48
0,1221,48446,3575894874,3575894923,49
0,1221,48447,3575894874,3575894924,50
0,1222,48448,3575894937,3575894937,0
0,1222,48449,3575894937,3575894937,0
0,1222,48450,3575894937,3575894937,0
0,1222,48451,3575894937,3575894937,0
0,1222,48452,3575894937,3575894937,0
0,1222,48453,3575894937,3575894937,0
0,1222,48454,3575894937,3575894937,0
0,1222,48455,3575894937,3575894937,0
0,1222,48456,3575894937,3575894937,0
0,1222,48457,3575894937,3575894937,0
0,1222,48458,3575894937,3575894937,0
0,1222,48459,3575894937,3575894937,0
0,1222,48460,3575894937,3575894937,0
0,1222,48461,3575894937,3575894937,0
0,1222,48462,3575894937,3575894937,0
0,1222,48463,3575894937,3575894937,0
0,1222,48464,3575894937,3575894937,0
0,1222,48465,3575894937,3575894937,0
0,1222,48466,3575894937,3575894937,0
0,1222,48467,3575894937,3575894937,0
0,1222,48468,3575894937,3575894937,0
0,1222,48469,3575894937,3575894938,1
0,1222,48470,3575894937,3575894938,1
0,1222,48471,3575894937,3575894939,2
0,1222,48472,3575894937,3575894939,2
0,1222,48473,3575894937,3575894939,2
0,1222,48474,3575894937,3575894939,2
0,1222,48475,3575894937,3575894940,3
0,1222,48476,3575894937,3575894941,4
0,1222,48477,3575894937,3575894941,4
0,1222,48478,3575894937,3575894942,5
0,1222,48479,3575894937,3575894943,6
0,1222,48480,3575894937,3575894943,6
0,1222,48481,3575894937,3575894944,7
0,1222,48482,3575894937,3575894945,8
0,1222,48483,3575894937,3575894945,8
0,1222,48484,3575894937,3575894946,9
0,1222,48485,3575894937,3575894946,9
0,1222,48486,3575894937,3575894947,10
0,1222,48487,3575894937,3575894948,11
0,1222,48488,3575894937,3575894948,11
0,1222,48489,3575894937,3575894948,11
0,1222,48490,3575894937,3575894950,13
0,1222,48491,3575894937,3575894950,13
0,1222,48492,3575894937,3575894951,14
0,1222,48493,3575894937,3575894953,16
0,1222,48494,3575894937,3575894954,17
0,1222,48495,3575894937,3575894954,17
0,1222,48496,3575894937,3575894954,17
0,1222,48497,3575894937,3575894955,18
0,1222,48498,3575894937,3575894955,18
0,1222,48499,3575894937,3575894955,18
0,1222,48500,3575894937,3575894956,19
0,1222,48501,3575894937,3575894956,19
0,1222,48502,3575894937,3575894958,21
0,1222,48503,3575894937,3575894959,22
0,1222,48504,3575894937,3575894959,22
0,1222,48505,3575894937,3575894960,23
0,1222,48506,3575894937,3575894961,24
0,1222,48507,3575894937,3575894962,25
0,1222,48508,3575894937,3575894963,26
0,1222,48509,3575894937,3575894964,27
0,1222,48510,3575894937,3575894964,27
0,1222,48511,3575894937,3575894964,27
0,1222,48512,3575894937,3575894965,28
0,1222,48513,3575894937,3575894965,28
0,1222,48514,3575894937,3575894966,29
0,1222,48515,3575894937,3575894966,29
0,1222,48516,3575894937,3575894967,30
0,1222,48517,3575894937,3575894969,32
0,1222,48518,3575894937,3575894971,34
0,1222,48519,3575894937,3575894971,34
0,1222,48520,3575894937,3575894972,35
0,1222,48521,3575894937,3575894973,36
0,1222,48522,3575894937,3575894973,36
0,1222,48523,3575894937,3575894974,37
0,1222,48524,3575894937,3575894975,38
0,1222,48525,3575894937,3575894975,38
0,1222,48526,3575894937,3575894976,39
0,1222,48527,3575894937,3575894976,39
0,1222,48528,3575894937,3575894976,39
0,1222,48529,3575894937,3575894977,40
0,1222,48530,3575894937,3575894977,40
0,1222,48531,3575894937,3575894978,41
0,1222,48532,3575894937,3575894980,43
0,1222,48533,3575894937,3575894981,44
0,1222,48534,3575894937,3575894982,45
0,1222,48535,3575894937,3575894982,45
0,1222,48536,3575894937,3575894984,47
0,1222,48537,3575894937,3575894985,48
0,1222,48538,3575894937,3575894986,49
0,1223,48539,3575895001,3575895001,0
0,1223,48540,3575895001,3575895001,0
0,1223,48541,3575895001,3575895001,0
0,1223,48542,3575895001,3575895001,0
0,1223,48543,3575895001,3575895001,0
0,1223,48544,3575895001,3575895001,0
0,1223,48545,3575895001,3575895001,0
0,1223,48546,3575895001,3575895001,0
0,1223,48547,3575895001,3575895001,0
0,1223,48548,3575895001,3575895001,0
0,1223,48549,3575895001,3575895004,3
0,1223,48550,3575895001,3575895004,3
0,1223,48551,3575895001,3575895006,5
0,1223,48552,3575895001,3575895007,6
0,1223,48553,3575895001,3575895007,6
0,1223,48554,3575895001,3575895009,8
0,1223,48555,3575895001,3575895010,9
0,1223,48556,3575895001,3575895010,9
0,1223,48557,3575895001,3575895013,12
0,1223,48558,3575895001,3575895013,12
0,1223,48559,3575895001,3575895015,14
0,1223,48560,3575895001,3575895016,15
0,1223,48561,3575895001,3575895016,15
0,1223,48562,3575895001,3575895016,15
0,1223,48563,3575895001,3575895017,16
0,1223,48564,3575895001,3575895018,17
0,1223,48565,3575895001,3575895021,20
0,1223,48566,3575895001,3575895022,21
0,1223,48567,3575895001,3575895022,21
0,1223,48568,3575895001,3575895022,21
0,1223,48569,3575895001,3575895025,24
0,1223,48570,3575895001,3575895026,25
0,1223,48571,3575895001,3575895026,25
0,1223,48572,3575895001,3575895029,28
0,1223,48573,3575895001,3575895029,28
0,1223,48574,3575895001,3575895029,28
0,1223,48575,3575895001,3575895029,28
0,1223,48576,3575895001,3575895029,28
0,1223,48577,3575895001,3575895031,30
0,1223,48578,3575895001,3575895032,31
0,1223,48579,3575895001,3575895033,32
0,1223,48580,3575895001,3575895033,32
0,1223,48581,3575895001,3575895033,32
0,1223,48582,3575895001,3575895033,32
0,1223,48583,3575895001,3575895033,32
0,1223,48584,3575895001,3575895034,33
0,1223,48585,3575895001,3575895035,34
0,1223,48586,3575895001,3575895035,34
0,1223,48587,3575895001,3575895035,34
0,1223,48588,3575895001,3575895036,35
0,1223,48589,3575895001,3575895036,35
0,1223,48590,3575895001,3575895037,36
0,1223,48591,3575895001,3575895037,36
0,1223,48592,3575895001,3575895038,37
0,1223,48593,3575895001,3575895040,39
0,1223,48594,3575895001,3575895041,40
0,1223,48595,3575895001,3575895042,41
0,1223,48596,3575895001,3575895042,41
0,1223,48597,3575895001,3575895042,41
0,1223,48598,3575895001,3575895044,43
0,1223,48599,3575895001,3575895044,43
0,1223,48600,3575895001,3575895045,44
0,1223,48601,3575895001,3575895045,44
0,1223,48602,3575895001,3575895046,45
0,1223,48603,3575895001,3575895047,46
0,1223,48604,3575895001,3575895047,46
0,1223,48605,3575895001,3575895048,47
0,1223,48606,3575895001,3575895048,47
0,1223,48607,3575895001,3575895050,49
0,1223,48608,3575895001,3575895050,49
0,1223,48609,3575895001,3575895050,49
0,1224,48610,3575895066,3575895066,0
0,1224,48611,3575895066,3575895066,0
0,1224,48612,3575895066,3575895066,0
0,1224,48613,3575895066,3575895066,0
0,1224,48614,3575895066,3575895066,0
0,1224,48615,3575895066,3575895066,0
0,1224,48616,3575895066,3575895066,0
0,1224,48617,3575895066,3575895066,0
0,1224,48618,3575895066,3575895066,0
0,1224,48619,3575895066,3575895066,0
0,1224,48620,3575895066,3575895066,0
0,1224,48621,3575895066,3575895066,0
0,1224,48622,3575895066,3575895066,0
0,1224,48623,3575895066,3575895066,0
0,1224,48624,3575895066,3575895066,0
0,1224,48625,3575895066,3575895066,0
0,1224,48626,3575895066,3575895066,0
0,1224,48627,3575895066,3575895066,0
0,1224,48628,3575895066,3575895066,0
0,1224,48629,3575895066,3575895066,0
0,1224,48630,3575895066,3575895066,0
0,1224,48631,3575895066,3575895066,0
0,1224,48632,3575895066,3575895067,1
0,1224,48633,3575895066,3575895067,1
0,1224,48634,3575895066,3575895068,2
0,1224,48635,3575895066,3575895068,2
0,1224,48636,3575895066,3575895077,11
0,1224,48637,3575895066,3575895078,12
0,1224,48638,3575895066,3575895080,14
0,1224,48639,3575895066,3575895080,14
0,1224,48640,3575895066,3575895083,17
0,1224,48641,3575895066,3575895087,21
0,1224,48642,3575895066,3575895087,21
0,1224,48643,3575895066,3575895088,22
0,1224,48644,3575895066,3575895088,22
0,1224,48645,3575895066,3575895089,23
0,1224,48646,3575895066,3575895089,23
0,1224,48647,3575895066,3575895090,24
0,1224,48648,3575895066,3575895091,25
0,1224,48649,3575895066,3575895091,25
0,1224,48650,3575895066,3575895092,26
0,1224,48651,3575895066,3575895092,26
0,1224,48652,3575895066,3575895092,26
0,1224,48653,3575895066,3575895092,26
0,1224,48654,3575895066,3575895093,27
0,1224,48655,3575895066,3575895094,28
0,1224,48656,3575895066,3575895096,30
0,1224,48657,3575895066,3575895096,30
0,1224,48658,3575895066,3575895096,30
0,1224,48659,3575895066,3575895097,31
0,1224,48660,3575895066,3575895097,31
0,1224,48661,3575895066,3575895097,31
0,1224,48662,3575895066,3575895098,32
0,1224,48663,3575895066,3575895098,32
0,1224,48664,3575895066,3575895099,33
0,1224,48665,3575895066,3575895100,34
0,1224,48666,3575895066,3575895100,34
0,1224,48667,3575895066,3575895101,35
0,1224,48668,3575895066,3575895102,36
0,1224,48669,3575895066,3575895102,36
0,1224,48670,3575895066,3575895102,36
0,1224,48671,3575895066,3575895103,37
0,1224,48672,3575895066,3575895104,38
0,1224,48673,3575895066,3575895105,39
0,1224,48674,3575895066,3575895105,39
0,1224,48675,3575895066,3575895106,40
0,1224,48676,3575895066,3575895106,40
0,1224,48677,3575895066,3575895108,42
0,1224,48678,3575895066,3575895110,44
0,1224,48679,3575895066,3575895110,44
0,1224,48680,3575895066,3575895110,44
0,1224,48681,3575895066,3575895111,45
0,1224,48682,3575895066,3575895112,46
0,1224,48683,3575895066,3575895112,46
0,1224,48684,3575895066,3575895112,46
0,1224,48685,3575895066,3575895113,47
0,1224,48686,3575895066,3575895114,48
0,1224,48687,3575895066,3575895115,49
0,1224,48688,3575895066,3575895116,50
0,1225,48689,3575895132,3575895132,0
0,1225,48690,3575895132,3575895132,0
0,1225,48691,3575895132,3575895132,0
0,1225,48692,3575895132,3575895132,0
0,1225,48693,3575895132,3575895132,0
0,1225,48694,3575895132,3575895132,0
0,1225,48695,3575895132,3575895132,0
0,1225,48696,3575895132,3575895132,0
0,1225,48697,3575895132,3575895132,0
0,1225,48698,3575895132,3575895132,0
0,1225,48699,3575895132,3575895132,0
0,1225,48700,3575895132,3575895132,0
0,1225,48701,3575895132,3575895132,0
0,1225,48702,3575895132,3575895132,0
0,1225,48703,3575895132,3575895132,0
0,1225,48704,3575895132,3575895132,0
0,1225,48705,3575895132,3575895132,0
0,1225,48706,3575895132,3575895132,0
0,1225,48707,3575895132,3575895132,0
0,1225,48708,3575895132,3575895132,0
0,1225,48709,3575895132,3575895132,0
0,1225,48710,3575895132,3575895132,0
0,1225,48711,3575895132,3575895132,0
0,1225,48712,3575895132,3575895132,0
0,1225,48713,3575895132,3575895132,0
0,1225,48714,3575895132,3575895133,1
0,1225,48715,3575895132,3575895133,1
0,1225,48716,3575895132,3575895134,2
0,1225,48717,3575895132,3575895134,2
0,1225,48718,3575895132,3575895135,3
0,1225,48719,3575895132,3575895137,5
0,1225,48720,3575895132,3575895137,5
0,1225,48721,3575895132,3575895138,6
0,1225,48722,3575895132,3575895139,7
0,1225,48723,3575895132,3575895140,8
0,1225,48724,3575895132,3575895140,8
0,1225,48725,3575895132,3575895140,8
0,1225,48726,3575895132,3575895140,8
0,1225,48727,3575895132,3575895142,10
0,1225,48728,3575895132,3575895142,10
0,1225,48729,3575895132,3575895142,10
0,1225,48730,3575895132,3575895142,10
0,1225,48731,3575895132,3575895143,11
0,1225,48732,3575895132,3575895145,13
0,1225,48733,3575895132,3575895146,14
0,1225,48734,3575895132,3575895146,14
0,1225,48735,3575895132,3575895147,15
0,1225,48736,3575895132,3575895147,15
0,1225,48737,3575895132,3575895148,16
0,1225,48738,3575895132,3575895148,16
0,1225,48739,3575895132,3575895152,20
0,1225,48740,3575895132,3575895152,20
0,1225,48741,3575895132,3575895153,21
0,1225,48742,3575895132,3575895153,21
0,1225,48743,3575895132,3575895154,22
0,1225,48744,3575895132,3575895154,22
0,1225,48745,3575895132,3575895154,22
0,1225,48746,3575895132,3575895154,22
0,1225,48747,3575895132,3575895155,23
0,1225,48748,3575895132,3575895155,23
0,1225,48749,3575895132,3575895155,23
0,1225,48750,3575895132,3575895156,24
0,1225,48751,3575895132,3575895157,25
0,1225,48752,3575895132,3575895158,26
0,1225,48753,3575895132,3575895158,26
0,1225,48754,3575895132,3575895159,27
0,1225,48755,3575895132,3575895159,27
0,1225,48756,3575895132,3575895160,28
0,1225,48757,3575895132,3575895160,28
0,1225,48758,3575895132,3575895161,29
0,1225,48759,3575895132,3575895162,30
0,1225,48760,3575895132,3575895164,32
0,1225,48761,3575895132,3575895164,32
0,1225,48762,3575895132,3575895165,33
0,1225,48763,3575895132,3575895165,33
0,1225,48764,3575895132,3575895166,34
0,1225,48765,3575895132,3575895166,34
0,1225,48766,3575895132,3575895167,35
0,1225,48767,3575895132,3575895168,36
0,1225,48768,3575895132,3575895170,38
0,1225,48769,3575895132,3575895171,39
0,1225,48770,3575895132,3575895172,40
0,1225,48771,3575895132,3575895172,40
0,1225,48772,3575895132,3575895174,42
0,1225,48773,3575895132,3575895174,42
0,1225,48774,3575895132,3575895175,43
0,1225,48775,3575895132,3575895175,43
0,1225,48776,3575895132,3575895175,43
0,1225,48777,3575895132,3575895176,44
0,1225,48778,3575895132,3575895176,44
0,1225,48779,3575895132,3575895178,46
0,1225,48780,3575895132,3575895180,48
0,1225,48781,3575895132,3575895181,49
0,1225,48782,3575895132,3575895182,50
0,1226,48783,3575895195,3575895195,0
0,1226,48784,3575895195,3575895195,0
0,1226,48785,3575895195,3575895195,0
0,1226,48786,3575895195,3575895195,0
0,1226,48787,3575895195,3575895195,0
0,1226,48788,3575895195,3575895195,0
0,1226,48789,3575895195,3575895195,0
0,1226,48790,3575895195,3575895195,0
0,1226,48791,3575895195,3575895195,0
0,1226,48792,3575895195,3575895195,0
0,1226,48793,3575895195,3575895195,0
0,1226,48794,3575895195,3575895196,1
0,1226,48795,3575895195,3575895199,4
0,1226,48796,3575895195,3575895199,4
0,1226,48797,3575895195,3575895200,5
0,1226,48798,3575895195,3575895201,6
0,1226,48799,3575895195,3575895204,9
0,1226,48800,3575895195,3575895205,10
0,1226,48801,3575895195,3575895207,12
0,1226,48802,3575895195,3575895207,12
0,1226,48803,3575895195,3575895208,13
0,1226,48804,3575895195,3575895209,14
0,1226,48805,3575895195,3575895211,16
0,1226,48806,3575895195,3575895212,17
0,1226,48807,3575895195,3575895213,18
0,1226,48808,3575895195,3575895213,18
0,1226,48809,3575895195,3575895213,18
0,1226,48810,3575895195,3575895215,20
0,1226,48811,3575895195,3575895216,21
0,1226,48812,3575895195,3575895216,21
0,1226,48813,3575895195,3575895218,23
0,1226,48814,3575895195,3575895218,23
0,1226,48815,3575895195,3575895221,26
0,1226,48816,3575895195,3575895221,26
0,1226,48817,3575895195,3575895222,27
0,1226,48818,3575895195,3575895222,27
0,1226,48819,3575895195,3575895223,28
0,1226,48820,3575895195,3575895225,30
0,1226,48821,3575895195,3575895225,30
0,1226,48822,3575895195,3575895226,31
0,1226,48823,3575895195,3575895229,34
0,1226,48824,3575895195,3575895229,34
0,1226,48825,3575895195,3575895229,34
0,1226,48826,3575895195,3575895230,35
0,1226,48827,3575895195,3575895231,36
0,1226,48828,3575895195,3575895232,37
0,1226,48829,3575895195,3575895233,38
0,1226,48830,3575895195,3575895233,38
0,1226,48831,3575895195,3575895233,38
0,1226,48832,3575895195,3575895235,40
0,1226,48833,3575895195,3575895235,40
0,1226,48834,3575895195,3575895235,40
0,1226,48835,3575895195,3575895235,40
0,1226,48836,3575895195,3575895236,41
0,1226,48837,3575895195,3575895237,42
0,1226,48838,3575895195,3575895237,42
0,1226,48839,3575895195,3575895238,43
0,1226,48840,3575895195,3575895239,44
0,1226,48841,3575895195,3575895240,45
0,1226,48842,3575895195,3575895242,47
0,1226,48843,3575895195,3575895242,47
0,1226,48844,3575895195,3575895243,48
0,1226,48845,3575895195,3575895244,49
0,1226,48846,3575895195,3575895244,49
0,1226,48847,3575895195,3575895244,49
0,1226,48848,3575895195,3575895245,50
0,1227,48849,3575895258,3575895258,0
0,1227,48850,3575895258,3575895258,0
0,1227,48851,3575895258,3575895258,0
0,1227,48852,3575895258,3575895258,0
0,1227,48853,3575895258,3575895258,0
0,1227,48854,3575895258,3575895258,0
0,1227,48855,3575895258,3575895258,0
0,1227,48856,3575895258,3575895258,0
0,1227,48857,3575895258,3575895258,0
0,1227,48858,3575895258,3575895258,0
0,1227,48859,3575895258,3575895258,0
0,1227,48860,3575895258,3575895258,0
0,1227,48861,3575895258,3575895258,0
0,1227,48862,3575895258,3575895259,1
0,1227,48863,3575895258,3575895260,2
0,1227,48864,3575895258,3575895260,2
0,1227,48865,3575895258,3575895260,2
0,1227,48866,3575895258,3575895260,2
0,1227,48867,3575895258,3575895261,3
0,1227,48868,3575895258,3575895262,4
0,1227,48869,3575895258,3575895264,6
0,1227,48870,3575895258,3575895264,6
0,1227,48871,3575895258,3575895265,7
0,1227,48872,3575895258,3575895265,7
0,1227,48873,3575895258,3575895266,8
0,1227,48874,3575895258,3575895266,8
0,1227,48875,3575895258,3575895266,8
0,1227,48876,3575895258,3575895267,9
0,1227,48877,3575895258,3575895267,9
0,1227,48878,3575895258,3575895268,10
0,1227,48879,3575895258,3575895269,11
0,1227,48880,3575895258,3575895277,19
0,1227,48881,3575895258,3575895278,20
0,1227,48882,3575895258,3575895280,22
0,1227,48883,3575895258,3575895281,23
0,1227,48884,3575895258,3575895283,25
0,1227,48885,3575895258,3575895287,29
0,1227,48886,3575895258,3575895289,31
0,1227,48887,3575895258,3575895289,31
0,1227,48888,3575895258,3575895289,31
0,1227,48889,3575895258,3575895290,32
0,1227,48890,3575895258,3575895291,33
0,1227,48891,3575895258,3575895291,33
0,1227,48892,3575895258,3575895292,34
0,1227,48893,3575895258,3575895292,34
0,1227,48894,3575895258,3575895292,34
0,1227,48895,3575895258,3575895293,35
0,1227,48896,3575895258,3575895294,36
0,1227,48897,3575895258,3575895295,37
0,1227,48898,3575895258,3575895296,38
0,1227,48899,3575895258,3575895296,38
0,1227,48900,3575895258,3575895296,38
0,1227,48901,3575895258,3575895297,39
0,1227,48902,3575895258,3575895297,39
0,1227,48903,3575895258,3575895298,40
0,1227,48904,3575895258,3575895298,40
0,1227,48905,3575895258,3575895300,42
0,1227,48906,3575895258,3575895301,43
0,1227,48907,3575895258,3575895301,43
0,1227,48908,3575895258,3575895302,44
0,1227,48909,3575895258,3575895303,45
0,1227,48910,3575895258,3575895304,46
0,1227,48911,3575895258,3575895304,46
0,1227,48912,3575895258,3575895304,46
0,1227,48913,3575895258,3575895305,47
0,1227,48914,3575895258,3575895307,49
0,1227,48915,3575895258,3575895308,50
0,1228,48916,3575895327,3575895327,0
0,1228,48917,3575895327,3575895327,0
0,1228,48918,3575895327,3575895327,0
0,1228,48919,3575895327,3575895327,0
0,1228,48920,3575895327,3575895327,0
0,1228,48921,3575895327,3575895327,0
0,1228,48922,3575895327,3575895327,0
0,1228,48923,3575895327,3575895327,0
0,1228,48924,3575895327,3575895327,0
0,1228,48925,3575895327,3575895327,0
0,1228,48926,3575895327,3575895327,0
0,1228,48927,3575895327,3575895327,0
0,1228,48928,3575895327,3575895327,0
0,1228,48929,3575895327,3575895327,0
0,1228,48930,3575895327,3575895327,0
0,1228,48931,3575895327,3575895327,0
0,1228,48932,3575895327,3575895327,0
0,1228,48933,3575895327,3575895327,0
0,1228,48934,3575895327,3575895327,0
0,1228,48935,3575895327,3575895327,0
0,1228,48936,3575895327,3575895327,0
0,1228,48937,3575895327,3575895327,0
0,1228,48938,3575895327,3575895327,0
0,1228,48939,3575895327,3575895327,0
0,1228,48940,3575895327,3575895327,0
0,1228,48941,3575895327,3575895327,0
0,1228,48942,3575895327,3575895327,0
0,1228,48943,3575895327,3575895327,0
0,1228,48944,3575895327,3575895327,0
0,1228,48945,3575895327,3575895327,0
0,1228,48946,3575895327,3575895328,1
0,1228,48947,3575895327,3575895328,1
0,1228,48948,3575895327,3575895329,2
0,1228,48949,3575895327,3575895329,2
0,1228,48950,3575895327,3575895329,2
0,1228,48951,3575895327,3575895329,2
0,1228,48952,3575895327,3575895330,3
0,1228,48953,3575895327,3575895331,4
0,1228,48954,3575895327,3575895332,5
0,1228,48955,3575895327,3575895332,5
0,1228,48956,3575895327,3575895333,6
0,1228,48957,3575895327,3575895334,7
0,1228,48958,3575895327,3575895334,7
0,1228,48959,3575895327,3575895336,9
0,1228,48960,3575895327,3575895337,10
0,1228,48961,3575895327,3575895338,11
0,1228,48962,3575895327,3575895339,12
0,1228,48963,3575895327,3575895339,12
0,1228,48964,3575895327,3575895340,13
0,1228,48965,3575895327,3575895341,14
0,1228,48966,3575895327,3575895342,15
0,1228,48967,3575895327,3575895342,15
0,1228,48968,3575895327,3575895342,15
0,1228,48969,3575895327,3575895343,16
0,1228,48970,3575895327,3575895343,16
0,1228,48971,3575895327,3575895345,18
0,1228,48972,3575895327,3575895346,19
0,1228,48973,3575895327,3575895346,19
0,1228,48974,3575895327,3575895346,19
0,1228,48975,3575895327,3575895347,20
0,1228,48976,3575895327,3575895348,21
0,1228,48977,3575895327,3575895348,21
0,1228,48978,3575895327,3575895348,21
0,1228,48979,3575895327,3575895350,23
0,1228,48980,3575895327,3575895353,26
0,1228,48981,3575895327,3575895354,27
0,1228,48982,3575895327,3575895354,27
0,1228,48983,3575895327,3575895354,27
0,1228,48984,3575895327,3575895355,28
0,1228,48985,3575895327,3575895356,29
0,1228,48986,3575895327,3575895356,29
0,1228,48987,3575895327,3575895356,29
0,1228,48988,3575895327,3575895357,30
0,1228,48989,3575895327,3575895358,31
0,1228,48990,3575895327,3575895358,31
0,1228,48991,3575895327,3575895359,32
0,1228,48992,3575895327,3575895359,32
0,1228,48993,3575895327,3575895360,33
0,1228,48994,3575895327,3575895361,34
0,1228,48995,3575895327,3575895361,34
0,1228,48996,3575895327,3575895362,35
0,1228,48997,3575895327,3575895364,37
0,1228,48998,3575895327,3575895364,37
0,1228,48999,3575895327,3575895365,38
0,1228,49000,3575895327,3575895365,38
0,1228,49001,3575895327,3575895365,38
0,1228,49002,3575895327,3575895366,39
0,1228,49003,3575895327,3575895367,40
0,1228,49004,3575895327,3575895367,40
0,1228,49005,3575895327,3575895370,43
0,1228,49006,3575895327,3575895371,44
0,1228,49007,3575895327,3575895372,45
0,1228,49008,3575895327,3575895372,45
0,1228,49009,3575895327,3575895372,45
0,1228,49010,3575895327,3575895373,46
0,1228,49011,3575895327,3575895373,46
0,1228,49012,3575895327,3575895375,48
0,1228,49013,3575895327,3575895375,48
0,1228,49014,3575895327,3575895375,48
0,1228,49015,3575895327,3575895376,49
0,1228,49016,3575895327,3575895376,49
0,1228,49017,3575895327,3575895377,50
0,1229,49018,3575895390,3575895390,0
0,1229,49019,3575895390,3575895390,0
0,1229,49020,3575895390,3575895390,0
0,1229,49021,3575895390,3575895390,0
0,1229,49022,3575895390,3575895390,0
0,1229,49023,3575895390,3575895390,0
0,1229,49024,3575895390,3575895390,0
0,1229,49025,3575895390,3575895390,0
0,1229,49026,3575895390,3575895390,0
0,1229,49027,3575895390,3575895390,0
0,1229,49028,3575895390,3575895390,0
0,1229,49029,3575895390,3575895390,0
0,1229,49030,3575895390,3575895394,4
0,1229,49031,3575895390,3575895394,4
0,1229,49032,3575895390,3575895397,7
0,1229,49033,3575895390,3575895399,9
0,1229,49034,3575895390,3575895400,10
0,1229,49035,3575895390,3575895401,11
0,1229,49036,3575895390,3575895402,12
0,1229,49037,3575895390,3575895402,12
0,1229,49038,3575895390,3575895403,13
0,1229,49039,3575895390,3575895405,15
0,1229,49040,3575895390,3575895405,15
0,1229,49041,3575895390,3575895407,17
0,1229,49042,3575895390,3575895408,18
0,1229,49043,3575895390,3575895408,18
0,1229,49044,3575895390,3575895410,20
0,1229,49045,3575895390,3575895410,20
0,1229,49046,3575895390,3575895410,20
0,1229,49047,3575895390,3575895411,21
0,1229,49048,3575895390,3575895413,23
0,1229,49049,3575895390,3575895413,23
0,1229,49050,3575895390,3575895413,23
0,1229,49051,3575895390,3575895413,23
0,1229,49052,3575895390,3575895415,25
0,1229,49053,3575895390,3575895416,26
0,1229,49054,3575895390,3575895416,26
0,1229,49055,3575895390,3575895416,26
0,1229,49056,3575895390,3575895418,28
0,1229,49057,3575895390,3575895418,28
0,1229,49058,3575895390,3575895419,29
0,1229,49059,3575895390,3575895420,30
0,1229,49060,3575895390,3575895420,30
0,1229,49061,3575895390,3575895422,32
0,1229,49062,3575895390,3575895422,32
0,1229,49063,3575895390,3575895423,33
0,1229,49064,3575895390,3575895426,36
0,1229,49065,3575895390,3575895426,36
0,1229,49066,3575895390,3575895427,37
0,1229,49067,3575895390,3575895428,38
0,1229,49068,3575895390,3575895429,39
0,1229,49069,3575895390,3575895430,40
0,1229,49070,3575895390,3575895430,40
0,1229,49071,3575895390,3575895432,42
0,1229,49072,3575895390,3575895432,42
0,1229,49073,3575895390,3575895432,42
0,1229,49074,3575895390,3575895433,43
0,1229,49075,3575895390,3575895433,43
0,1229,49076,3575895390,3575895433,43
0,1229,49077,3575895390,3575895433,43
0,1229,49078,3575895390,3575895434,44
0,1229,49079,3575895390,3575895434,44
0,1229,49080,3575895390,3575895435,45
0,1229,49081,3575895390,3575895436,46
0,1229,49082,3575895390,3575895436,46
0,1229,49083,3575895390,3575895437,47
0,1229,49084,3575895390,3575895438,48
0,1229,49085,3575895390,3575895438,48
0,1229,49086,3575895390,3575895439,49
0,1230,49087,3575895457,3575895457,0
0,1230,49088,3575895457,3575895457,0
0,1230,49089,3575895457,3575895457,0
0,1230,49090,3575895457,3575895457,0
0,1230,49091,3575895457,3575895457,0
0,1230,49092,3575895457,3575895457,0
0,1230,49093,3575895457,3575895457,0
0,1230,49094,3575895457,3575895457,0
0,1230,49095,3575895457,3575895457,0
0,1230,49096,3575895457,3575895457,0
0,1230,49097,3575895457,3575895457,0
0,1230,49098,3575895457,3575895457,0
0,1230,49099,3575895457,3575895457,0
0,1230,49100,3575895457,3575895457,0
0,1230,49101,3575895457,3575895457,0
0,1230,49102,3575895457,3575895457,0
0,1230,49103,3575895457,3575895457,0
0,1230,49104,3575895457,3575895457,0
0,1230,49105,3575895457,3575895457,0
0,1230,49106,3575895457,3575895457,0
0,1230,49107,3575895457,3575895457,0
0,1230,49108,3575895457,3575895457,0
0,1230,49109,3575895457,3575895457,0
0,1230,49110,3575895457,3575895457,0
0,1230,49111,3575895457,3575895457,0
0,1230,49112,3575895457,3575895459,2
0,1230,49113,3575895457,3575895460,3
0,1230,49114,3575895457,3575895460,3
0,1230,49115,3575895457,3575895460,3
0,1230,49116,3575895457,3575895461,4
0,1230,49117,3575895457,3575895461,4
0,1230,49118,3575895457,3575895462,5
0,1230,49119,3575895457,3575895464,7
0,1230,49120,3575895457,3575895464,7
0,1230,49121,3575895457,3575895465,8
0,1230,49122,3575895457,3575895465,8
0,1230,49123,3575895457,3575895466,9
0,1230,49124,3575895457,3575895467,10
0,1230,49125,3575895457,3575895467,10
0,1230,49126,3575895457,3575895467,10
0,1230,49127,3575895457,3575895467,10
0,1230,49128,3575895457,3575895468,11
0,1230,49129,3575895457,3575895469,12
0,1230,49130,3575895457,3575895476,19
0,1230,49131,3575895457,3575895480,23
0,1230,49132,3575895457,3575895481,24
0,1230,49133,3575895457,3575895481,24
0,1230,49134,3575895457,3575895483,26
0,1230,49135,3575895457,3575895487,30
0,1230,49136,3575895457,3575895488,31
0,1230,49137,3575895457,3575895489,32
0,1230,49138,3575895457,3575895489,32
0,1230,49139,3575895457,3575895490,33
0,1230,49140,3575895457,3575895490,33
0,1230,49141,3575895457,3575895491,34
0,1230,49142,3575895457,3575895491,34
0,1230,49143,3575895457,3575895492,35
0,1230,49144,3575895457,3575895492,35
0,1230,49145,3575895457,3575895493,36
0,1230,49146,3575895457,3575895493,36
0,1230,49147,3575895457,3575895493,36
0,1230,49148,3575895457,3575895493,36
0,1230,49149,3575895457,3575895495,38
0,1230,49150,3575895457,3575895495,38
0,1230,49151,3575895457,3575895496,39
0,1230,49152,3575895457,3575895497,40
0,1230,49153,3575895457,3575895497,40
0,1230,49154,3575895457,3575895497,40
0,1230,49155,3575895457,3575895497,40
0,1230,49156,3575895457,3575895498,41
0,1230,49157,3575895457,3575895498,41
0,1230,49158,3575895457,3575895498,41
0,1230,49159,3575895457,3575895500,43
0,1230,49160,3575895457,3575895501,44
0,1230,49161,3575895457,3575895502,45
0,1230,49162,3575895457,3575895502,45
0,1230,49163,3575895457,3575895502,45
0,1230,49164,3575895457,3575895503,46
0,1230,49165,3575895457,3575895503,46
0,1230,49166,3575895457,3575895505,48
0,1230,49167,3575895457,3575895505,48
0,1230,49168,3575895457,3575895507,50
0,1231,49169,3575895520,3575895520,0
0,1231,49170,3575895520,3575895520,0
0,1231,49171,3575895520,3575895521,1
0,1231,49172,3575895520,3575895521,1
0,1231,49173,3575895520,3575895521,1
0,1231,49174,3575895520,3575895521,1
0,1231,49175,3575895520,3575895521,1
0,1231,49176,3575895520,3575895521,1
0,1231,49177,3575895520,3575895521,1
0,1231,49178,3575895520,3575895521,1
0,1231,49179,3575895520,3575895521,1
0,1231,49180,3575895520,3575895521,1
0,1231,49181,3575895520,3575895521,1
0,1231,49182,3575895520,3575895521,1
0,1231,49183,3575895520,3575895521,1
0,1231,49184,3575895520,3575895521,1
0,1231,49185,3575895520,3575895521,1
0,1231,49186,3575895520,3575895521,1
0,1231,49187,3575895520,3575895521,1
0,1231,49188,3575895520,3575895521,1
0,1231,49189,3575895520,3575895522,2
0,1231,49190,3575895520,3575895523,3
0,1231,49191,3575895520,3575895523,3
0,1231,49192,3575895520,3575895523,3
0,1231,49193,3575895520,3575895524,4
0,1231,49194,3575895520,3575895525,5
0,1231,49195,3575895520,3575895526,6
0,1231,49196,3575895520,3575895527,7
0,1231,49197,3575895520,3575895527,7
0,1231,49198,3575895520,3575895528,8
0,1231,49199,3575895520,3575895528,8
0,1231,49200,3575895520,3575895528,8
0,1231,49201,3575895520,3575895528,8
0,1231,49202,3575895520,3575895529,9
0,1231,49203,3575895520,3575895530,10
0,1231,49204,3575895520,3575895531,11
0,1231,49205,3575895520,3575895531,11
0,1231,49206,3575895520,3575895531,11
0,1231,49207,3575895520,3575895532,12
0,1231,49208,3575895520,3575895533,13
0,1231,49209,3575895520,3575895533,13
0,1231,49210,3575895520,3575895533,13
0,1231,49211,3575895520,3575895535,15
0,1231,49212,3575895520,3575895535,15
0,1231,49213,3575895520,3575895536,16
0,1231,49214,3575895520,3575895537,17
0,1231,49215,3575895520,3575895537,17
0,1231,49216,3575895520,3575895538,18
0,1231,49217,3575895520,3575895538,18
0,1231,49218,3575895520,3575895539,19
0,1231,49219,3575895520,3575895540,20
0,1231,49220,3575895520,3575895540,20
0,1231,49221,3575895520,3575895540,20
0,1231,49222,3575895520,3575895541,21
0,1231,49223,3575895520,3575895542,22
0,1231,49224,3575895520,3575895544,24
0,1231,49225,3575895520,3575895545,25
0,1231,49226,3575895520,3575895546,26
0,1231,49227,3575895520,3575895546,26
0,1231,49228,3575895520,3575895547,27
0,1231,49229,3575895520,3575895547,27
0,1231,49230,3575895520,3575895547,27
0,1231,49231,3575895520,3575895548,28
0,1231,49232,3575895520,3575895548,28
0,1231,49233,3575895520,3575895550,30
0,1231,49234,3575895520,3575895551,31
0,1231,49235,3575895520,3575895552,32
0,1231,49236,3575895520,3575895553,33
0,1231,49237,3575895520,3575895554,34
0,1231,49238,3575895520,3575895554,34
0,1231,49239,3575895520,3575895554,34
0,1231,49240,3575895520,3575895554,34
0,1231,49241,3575895520,3575895555,35
0,1231,49242,3575895520,3575895555,35
0,1231,49243,3575895520,3575895556,36
0,1231,49244,3575895520,3575895556,36
0,1231,49245,3575895520,3575895558,38
0,1231,49246,3575895520,3575895558,38
0,1231,49247,3575895520,3575895558,38
0,1231,49248,3575895520,3575895559,39
0,1231,49249,3575895520,3575895560,40
0,1231,49250,3575895520,3575895561,41
0,1231,49251,3575895520,3575895563,43
0,1231,49252,3575895520,3575895563,43
0,1231,49253,3575895520,3575895564,44
0,1231,49254,3575895520,3575895564,44
0,1231,49255,3575895520,3575895564,44
0,1231,49256,3575895520,3575895565,45
0,1231,49257,3575895520,3575895566,46
0,1231,49258,3575895520,3575895566,46
0,1231,49259,3575895520,3575895570,50
0,1232,49260,3575895584,3575895584,0
0,1232,49261,3575895584,3575895584,0
0,1232,49262,3575895584,3575895584,0
0,1232,49263,3575895584,3575895584,0
0,1232,49264,3575895584,3575895584,0
0,1232,49265,3575895584,3575895584,0
0,1232,49266,3575895584,3575895584,0
0,1232,49267,3575895584,3575895584,0
0,1232,49268,3575895584,3575895584,0
0,1232,49269,3575895584,3575895584,0
0,1232,49270,3575895584,3575895584,0
0,1232,49271,3575895584,3575895584,0
0,1232,49272,3575895584,3575895584,0
0,1232,49273,3575895584,3575895584,0
0,1232,49274,3575895584,3575895584,0
0,1232,49275,3575895584,3575895584,0
0,1232,49276,3575895584,3575895584,0
0,1232,49277,3575895584,3575895584,0
0,1232,49278,3575895584,3575895584,0
0,1232,49279,3575895584,3575895584,0
0,1232,49280,3575895584,3575895584,0
0,1232,49281,3575895584,3575895586,2
0,1232,49282,3575895584,3575895587,3
0,1232,49283,3575895584,3575895588,4
0,1232,49284,3575895584,3575895588,4
0,1232,49285,3575895584,3575895589,5
0,1232,49286,3575895584,3575895593,9
0,1232,49287,3575895584,3575895596,12
0,1232,49288,3575895584,3575895598,14
0,1232,49289,3575895584,3575895598,14
0,1232,49290,3575895584,3575895599,15
0,1232,49291,3575895584,3575895600,16
0,1232,49292,3575895584,3575895601,17
0,1232,49293,3575895584,3575895601,17
0,1232,49294,3575895584,3575895601,17
0,1232,49295,3575895584,3575895604,20
0,1232,49296,3575895584,3575895605,21
0,1232,49297,3575895584,3575895606,22
0,1232,49298,3575895584,3575895607,23
0,1232,49299,3575895584,3575895607,23
0,1232,49300,3575895584,3575895609,25
0,1232,49301,3575895584,3575895610,26
0,1232,49302,3575895584,3575895610,26
0,1232,49303,3575895584,3575895611,27
0,1232,49304,3575895584,3575895612,28
0,1232,49305,3575895584,3575895613,29
0,1232,49306,3575895584,3575895615,31
0,1232,49307,3575895584,3575895615,31
0,1232,49308,3575895584,3575895617,33
0,1232,49309,3575895584,3575895619,35
0,1232,49310,3575895584,3575895620,36
0,1232,49311,3575895584,3575895620,36
0,1232,49312,3575895584,3575895621,37
0,1232,49313,3575895584,3575895623,39
0,1232,49314,3575895584,3575895625,41
0,1232,49315,3575895584,3575895625,41
0,1232,49316,3575895584,3575895628,44
0,1232,49317,3575895584,3575895629,45
0,1232,49318,3575895584,3575895629,45
0,1232,49319,3575895584,3575895629,45
0,1232,49320,3575895584,3575895629,45
0,1232,49321,3575895584,3575895630,46
0,1232,49322,3575895584,3575895632,48
0,1232,49323,3575895584,3575895632,48
0,1232,49324,3575895584,3575895632,48
0,1232,49325,3575895584,3575895633,49
0,1232,49326,3575895584,3575895633,49
0,1232,49327,3575895584,3575895633,49
0,1232,49328,3575895584,3575895633,49
0,1232,49329,3575895584,3575895633,49
0,1232,49330,3575895584,3575895634,50
0,1233,49331,3575895650,3575895650,0
0,1233,49332,3575895650,3575895650,0
0,1233,49333,3575895650,3575895650,0
0,1233,49334,3575895650,3575895650,0
0,1233,49335,3575895650,3575895650,0
0,1233,49336,3575895650,3575895650,0
0,1233,49337,3575895650,3575895650,0
0,1233,49338,3575895650,3575895650,0
0,1233,49339,3575895650,3575895650,0
0,1233,49340,3575895650,3575895650,0
0,1233,49341,3575895650,3575895650,0
0,1233,49342,3575895650,3575895650,0
0,1233,49343,3575895650,3575895650,0
0,1233,49344,3575895650,3575895650,0
0,1233,49345,3575895650,3575895650,0
0,1233,49346,3575895650,3575895650,0
0,1233,49347,3575895650,3575895650,0
0,1233,49348,3575895650,3575895650,0
0,1233,49349,3575895650,3575895650,0
0,1233,49350,3575895650,3575895650,0
0,1233,49351,3575895650,3575895650,0
0,1233,49352,3575895650,3575895653,3
0,1233,49353,3575895650,3575895653,3
0,1233,49354,3575895650,3575895654,4
0,1233,49355,3575895650,3575895656,6
0,1233,49356,3575895650,3575895657,7
0,1233,49357,3575895650,3575895657,7
0,1233,49358,3575895650,3575895659,9
0,1233,49359,3575895650,3575895659,9
0,1233,49360,3575895650,3575895659,9
0,1233,49361,3575895650,3575895659,9
0,1233,49362,3575895650,3575895660,10
0,1233,49363,3575895650,3575895660,10
0,1233,49364,3575895650,3575895661,11
0,1233,49365,3575895650,3575895662,12
0,1233,49366,3575895650,3575895664,14
0,1233,49367,3575895650,3575895664,14
0,1233,49368,3575895650,3575895665,15
0,1233,49369,3575895650,3575895665,15
0,1233,49370,3575895650,3575895665,15
0,1233,49371,3575895650,3575895666,16
0,1233,49372,3575895650,3575895667,17
0,1233,49373,3575895650,3575895668,18
0,1233,49374,3575895650,3575895669,19
0,1233,49375,3575895650,3575895669,19
0,1233,49376,3575895650,3575895676,26
0,1233,49377,3575895650,3575895678,28
0,1233,49378,3575895650,3575895680,30
0,1233,49379,3575895650,3575895682,32
0,1233,49380,3575895650,3575895684,34
0,1233,49381,3575895650,3575895687,37
0,1233,49382,3575895650,3575895689,39
0,1233,49383,3575895650,3575895689,39
0,1233,49384,3575895650,3575895692,42
0,1233,49385,3575895650,3575895692,42
0,1233,49386,3575895650,3575895692,42
0,1233,49387,3575895650,3575895693,43
0,1233,49388,3575895650,3575895693,43
0,1233,49389,3575895650,3575895694,44
0,1233,49390,3575895650,3575895694,44
0,1233,49391,3575895650,3575895696,46
0,1233,49392,3575895650,3575895697,47
0,1233,49393,3575895650,3575895698,48
0,1233,49394,3575895650,3575895698,48
0,1233,49395,3575895650,3575895698,48
0,1233,49396,3575895650,3575895699,49
0,1233,49397,3575895650,3575895700,50
0,1233,49398,3575895650,3575895700,50
0,1234,49399,3575895713,3575895713,0
0,1234,49400,3575895713,3575895713,0
0,1234,49401,3575895713,3575895713,0
0,1234,49402,3575895713,3575895713,0
0,1234,49403,3575895713,3575895713,0
0,1234,49404,3575895713,3575895713,0
0,1234,49405,3575895713,3575895713,0
0,1234,49406,3575895713,3575895713,0
0,1234,49407,3575895713,3575895713,0
0,1234,49408,3575895713,3575895713,0
0,1234,49409,3575895713,3575895713,0
0,1234,49410,3575895713,3575895713,0
0,1234,49411,3575895713,3575895713,0
0,1234,49412,3575895713,3575895713,0
0,1234,49413,3575895713,3575895713,0
0,1234,49414,3575895713,3575895713,0
0,1234,49415,3575895713,3575895713,0
0,1234,49416,3575895713,3575895713,0
0,1234,49417,3575895713,3575895713,0
0,1234,49418,3575895713,3575895713,0
0,1234,49419,3575895713,3575895714,1
0,1234,49420,3575895713,3575895714,1
0,1234,49421,3575895713,3575895714,1
0,1234,49422,3575895713,3575895715,2
0,1234,49423,3575895713,3575895715,2
0,1234,49424,3575895713,3575895715,2
0,1234,49425,3575895713,3575895716,3
0,1234,49426,3575895713,3575895717,4
0,1234,49427,3575895713,3575895717,4
0,1234,49428,3575895713,3575895718,5
0,1234,49429,3575895713,3575895718,5
0,1234,49430,3575895713,3575895718,5
0,1234,49431,3575895713,3575895719,6
0,1234,49432,3575895713,3575895720,7
0,1234,49433,3575895713,3575895720,7
0,1234,49434,3575895713,3575895720,7
0,1234,49435,3575895713,3575895721,8
0,1234,49436,3575895713,3575895721,8
0,1234,49437,3575895713,3575895721,8
0,1234,49438,3575895713,3575895722,9
0,1234,49439,3575895713,3575895722,9
0,1234,49440,3575895713,3575895723,10
0,1234,49441,3575895713,3575895724,11
0,1234,49442,3575895713,3575895726,13
0,1234,49443,3575895713,3575895727,14
0,1234,49444,3575895713,3575895727,14
0,1234,49445,3575895713,3575895727,14
0,1234,49446,3575895713,3575895727,14
0,1234,49447,3575895713,3575895728,15
0,1234,49448,3575895713,3575895728,15
0,1234,49449,3575895713,3575895728,15
0,1234,49450,3575895713,3575895728,15
0,1234,49451,3575895713,3575895729,16
0,1234,49452,3575895713,3575895730,17
0,1234,49453,3575895713,3575895731,18
0,1234,49454,3575895713,3575895731,18
0,1234,49455,3575895713,3575895732,19
0,1234,49456,3575895713,3575895732,19
0,1234,49457,3575895713,3575895733,20
0,1234,49458,3575895713,3575895734,21
0,1234,49459,3575895713,3575895734,21
0,1234,49460,3575895713,3575895736,23
0,1234,49461,3575895713,3575895736,23
0,1234,49462,3575895713,3575895737,24
0,1234,49463,3575895713,3575895737,24
0,1234,49464,3575895713,3575895738,25
0,1234,49465,3575895713,3575895738,25
0,1234,49466,3575895713,3575895740,27
0,1234,49467,3575895713,3575895740,27
0,1234,49468,3575895713,3575895740,27
0,1234,49469,3575895713,3575895740,27
0,1234,49470,3575895713,3575895741,28
0,1234,49471,3575895713,3575895741,28
0,1234,49472,3575895713,3575895742,29
0,1234,49473,3575895713,3575895742,29
0,1234,49474,3575895713,3575895743,30
0,1234,49475,3575895713,3575895744,31
0,1234,49476,3575895713,3575895745,32
0,1234,49477,3575895713,3575895746,33
0,1234,49478,3575895713,3575895746,33
0,1234,49479,3575895713,3575895746,33
0,1234,49480,3575895713,3575895747,34
0,1234,49481,3575895713,3575895748,35
0,1234,49482,3575895713,3575895748,35
0,1234,49483,3575895713,3575895748,35
0,1234,49484,3575895713,3575895749,36
0,1234,49485,3575895713,3575895753,40
0,1234,49486,3575895713,3575895754,41
0,1234,49487,3575895713,3575895755,42
0,1234,49488,3575895713,3575895755,42
0,1234,49489,3575895713,3575895755,42
0,1234,49490,3575895713,3575895755,42
0,1234,49491,3575895713,3575895756,43
0,1234,49492,3575895713,3575895757,44
0,1234,49493,3575895713,3575895757,44
0,1234,49494,3575895713,3575895758,45
0,1234,49495,3575895713,3575895758,45
0,1234,49496,3575895713,3575895760,47
0,1234,49497,3575895713,3575895761,48
0,1234,49498,3575895713,3575895761,48
0,1234,49499,3575895713,3575895761,48
0,1234,49500,3575895713,3575895763,50
0,1235,49501,3575895780,3575895780,0
0,1235,49502,3575895780,3575895780,0
0,1235,49503,3575895780,3575895780,0
0,1235,49504,3575895780,3575895780,0
0,1235,49505,3575895780,3575895780,0
0,1235,49506,3575895780,3575895780,0
0,1235,49507,3575895780,3575895780,0
0,1235,49508,3575895780,3575895780,0
0,1235,49509,3575895780,3575895780,0
0,1235,49510,3575895780,3575895780,0
0,1235,49511,3575895780,3575895780,0
0,1235,49512,3575895780,3575895780,0
0,1235,49513,3575895780,3575895780,0
0,1235,49514,3575895780,3575895780,0
0,1235,49515,3575895780,3575895780,0
0,1235,49516,3575895780,3575895780,0
0,1235,49517,3575895780,3575895780,0
0,1235,49518,3575895780,3575895780,0
0,1235,49519,3575895780,3575895780,0
0,1235,49520,3575895780,3575895780,0
0,1235,49521,3575895780,3575895780,0
0,1235,49522,3575895780,3575895780,0
0,1235,49523,3575895780,3575895780,0
0,1235,49524,3575895780,3575895782,2
0,1235,49525,3575895780,3575895782,2
0,1235,49526,3575895780,3575895784,4
0,1235,49527,3575895780,3575895784,4
0,1235,49528,3575895780,3575895786,6
0,1235,49529,3575895780,3575895788,8
0,1235,49530,3575895780,3575895788,8
0,1235,49531,3575895780,3575895789,9
0,1235,49532,3575895780,3575895789,9
0,1235,49533,3575895780,3575895793,13
0,1235,49534,3575895780,3575895794,14
0,1235,49535,3575895780,3575895796,16
0,1235,49536,3575895780,3575895798,18
0,1235,49537,3575895780,3575895799,19
0,1235,49538,3575895780,3575895800,20
0,1235,49539,3575895780,3575895801,21
0,1235,49540,3575895780,3575895801,21
0,1235,49541,3575895780,3575895802,22
0,1235,49542,3575895780,3575895803,23
0,1235,49543,3575895780,3575895804,24
0,1235,49544,3575895780,3575895807,27
0,1235,49545,3575895780,3575895807,27
0,1235,49546,3575895780,3575895808,28
0,1235,49547,3575895780,3575895809,29
0,1235,49548,3575895780,3575895810,30
0,1235,49549,3575895780,3575895810,30
0,1235,49550,3575895780,3575895811,31
0,1235,49551,3575895780,3575895812,32
0,1235,49552,3575895780,3575895812,32
0,1235,49553,3575895780,3575895813,33
0,1235,49554,3575895780,3575895813,33
0,1235,49555,3575895780,3575895815,35
0,1235,49556,3575895780,3575895815,35
0,1235,49557,3575895780,3575895816,36
0,1235,49558,3575895780,3575895817,37
0,1235,49559,3575895780,3575895817,37
0,1235,49560,3575895780,3575895819,39
0,1235,49561,3575895780,3575895819,39
0,1235,49562,3575895780,3575895820,40
0,1235,49563,3575895780,3575895821,41
0,1235,49564,3575895780,3575895821,41
0,1235,49565,3575895780,3575895822,42
0,1235,49566,3575895780,3575895823,43
0,1235,49567,3575895780,3575895825,45
0,1235,49568,3575895780,3575895825,45
0,1235,49569,3575895780,3575895827,47
0,1235,49570,3575895780,3575895828,48
0,1235,49571,3575895780,3575895829,49
0,1235,49572,3575895780,3575895829,49
0,1235,49573,3575895780,3575895829,49
0,1235,49574,3575895780,3575895829,49
0,1236,49575,3575895843,3575895843,0
0,1236,49576,3575895843,3575895843,0
0,1236,49577,3575895843,3575895843,0
0,1236,49578,3575895843,3575895843,0
0,1236,49579,3575895843,3575895843,0
0,1236,49580,3575895843,3575895843,0
0,1236,49581,3575895843,3575895843,0
0,1236,49582,3575895843,3575895843,0
0,1236,49583,3575895843,3575895843,0
0,1236,49584,3575895843,3575895843,0
0,1236,49585,3575895843,3575895843,0
0,1236,49586,3575895843,3575895843,0
0,1236,49587,3575895843,3575895843,0
0,1236,49588,3575895843,3575895843,0
0,1236,49589,3575895843,3575895843,0
0,1236,49590,3575895843,3575895843,0
0,1236,49591,3575895843,3575895843,0
0,1236,49592,3575895843,3575895843,0
0,1236,49593,3575895843,3575895843,0
0,1236,49594,3575895843,3575895844,1
0,1236,49595,3575895843,3575895844,1
0,1236,49596,3575895843,3575895845,2
0,1236,49597,3575895843,3575895845,2
0,1236,49598,3575895843,3575895846,3
0,1236,49599,3575895843,3575895846,3
0,1236,49600,3575895843,3575895846,3
0,1236,49601,3575895843,3575895847,4
0,1236,49602,3575895843,3575895847,4
0,1236,49603,3575895843,3575895848,5
0,1236,49604,3575895843,3575895849,6
0,1236,49605,3575895843,3575895850,7
0,1236,49606,3575895843,3575895852,9
0,1236,49607,3575895843,3575895855,12
0,1236,49608,3575895843,3575895855,12
0,1236,49609,3575895843,3575895855,12
0,1236,49610,3575895843,3575895856,13
0,1236,49611,3575895843,3575895856,13
0,1236,49612,3575895843,3575895859,16
0,1236,49613,3575895843,3575895859,16
0,1236,49614,3575895843,3575895859,16
0,1236,49615,3575895843,3575895860,17
0,1236,49616,3575895843,3575895860,17
0,1236,49617,3575895843,3575895862,19
0,1236,49618,3575895843,3575895862,19
0,1236,49619,3575895843,3575895862,19
0,1236,49620,3575895843,3575895863,20
0,1236,49621,3575895843,3575895864,21
0,1236,49622,3575895843,3575895865,22
0,1236,49623,3575895843,3575895866,23
0,1236,49624,3575895843,3575895866,23
0,1236,49625,3575895843,3575895866,23
0,1236,49626,3575895843,3575895867,24
0,1236,49627,3575895843,3575895867,24
0,1236,49628,3575895843,3575895868,25
0,1236,49629,3575895843,3575895869,26
0,1236,49630,3575895843,3575895870,27
0,1236,49631,3575895843,3575895876,33
0,1236,49632,3575895843,3575895878,35
0,1236,49633,3575895843,3575895880,37
0,1236,49634,3575895843,3575895880,37
0,1236,49635,3575895843,3575895883,40
0,1236,49636,3575895843,3575895887,44
0,1236,49637,3575895843,3575895887,44
0,1236,49638,3575895843,3575895889,46
0,1236,49639,3575895843,3575895889,46
0,1236,49640,3575895843,3575895890,47
0,1236,49641,3575895843,3575895890,47
0,1236,49642,3575895843,3575895891,48
0,1236,49643,3575895843,3575895891,48
0,1236,49644,3575895843,3575895892,49
0,1236,49645,3575895843,3575895893,50
0,1237,49646,3575895909,3575895909,0
0,1237,49647,3575895909,3575895909,0
0,1237,49648,3575895909,3575895909,0
0,1237,49649,3575895909,3575895909,0
0,1237,49650,3575895909,3575895909,0
0,1237,49651,3575895909,3575895909,0
0,1237,49652,3575895909,3575895909,0
0,1237,49653,3575895909,3575895909,0
0,1237,49654,3575895909,3575895909,0
0,1237,49655,3575895909,3575895909,0
0,1237,49656,3575895909,3575895909,0
0,1237,49657,3575895909,3575895909,0
0,1237,49658,3575895909,3575895909,0
0,1237,49659,3575895909,3575895909,0
0,1237,49660,3575895909,3575895909,0
0,1237,49661,3575895909,3575895909,0
0,1237,49662,3575895909,3575895909,0
0,1237,49663,3575895909,3575895909,0
0,1237,49664,3575895909,3575895909,0
0,1237,49665,3575895909,3575895909,0
0,1237,49666,3575895909,3575895909,0
0,1237,49667,3575895909,3575895909,0
0,1237,49668,3575895909,3575895909,0
0,1237,49669,3575895909,3575895909,0
0,1237,49670,3575895909,3575895910,1
0,1237,49671,3575895909,3575895911,2
0,1237,49672,3575895909,3575895911,2
0,1237,49673,3575895909,3575895912,3
0,1237,49674,3575895909,3575895913,4
0,1237,49675,3575895909,3575895913,4
0,1237,49676,3575895909,3575895913,4
0,1237,49677,3575895909,3575895914,5
0,1237,49678,3575895909,3575895914,5
0,1237,49679,3575895909,3575895915,6
0,1237,49680,3575895909,3575895916,7
0,1237,49681,3575895909,3575895916,7
0,1237,49682,3575895909,3575895917,8
0,1237,49683,3575895909,3575895917,8
0,1237,49684,3575895909,3575895917,8
0,1237,49685,3575895909,3575895918,9
0,1237,49686,3575895909,3575895918,9
0,1237,49687,3575895909,3575895918,9
0,1237,49688,3575895909,3575895919,10
0,1237,49689,3575895909,3575895919,10
0,1237,49690,3575895909,3575895921,12
0,1237,49691,3575895909,3575895923,14
0,1237,49692,3575895909,3575895923,14
0,1237,49693,3575895909,3575895923,14
0,1237,49694,3575895909,3575895924,15
0,1237,49695,3575895909,3575895924,15
0,1237,49696,3575895909,3575895926,17
0,1237,49697,3575895909,3575895927,18
0,1237,49698,3575895909,3575895928,19
0,1237,49699,3575895909,3575895928,19
0,1237,49700,3575895909,3575895928,19
0,1237,49701,3575895909,3575895928,19
0,1237,49702,3575895909,3575895928,19
0,1237,49703,3575895909,3575895929,20
0,1237,49704,3575895909,3575895929,20
0,1237,49705,3575895909,3575895932,23
0,1237,49706,3575895909,3575895933,24
0,1237,49707,3575895909,3575895933,24
0,1237,49708,3575895909,3575895933,24
0,1237,49709,3575895909,3575895934,25
0,1237,49710,3575895909,3575895937,28
0,1237,49711,3575895909,3575895937,28
0,1237,49712,3575895909,3575895937,28
0,1237,49713,3575895909,3575895938,29
0,1237,49714,3575895909,3575895938,29
0,1237,49715,3575895909,3575895938,29
0,1237,49716,3575895909,3575895939,30
0,1237,49717,3575895909,3575895940,31
0,1237,49718,3575895909,3575895940,31
0,1237,49719,3575895909,3575895940,31
0,1237,49720,3575895909,3575895940,31
0,1237,49721,3575895909,3575895941,32
0,1237,49722,3575895909,3575895942,33
0,1237,49723,3575895909,3575895942,33
0,1237,49724,3575895909,3575895943,34
0,1237,49725,3575895909,3575895945,36
0,1237,49726,3575895909,3575895946,37
0,1237,49727,3575895909,3575895946,37
0,1237,49728,3575895909,3575895946,37
0,1237,49729,3575895909,3575895946,37
0,1237,49730,3575895909,3575895948,39
0,1237,49731,3575895909,3575895948,39
0,1237,49732,3575895909,3575895951,42
0,1237,49733,3575895909,3575895952,43
0,1237,49734,3575895909,3575895952,43
0,1237,49735,3575895909,3575895952,43
0,1237,49736,3575895909,3575895954,45
0,1237,49737,3575895909,3575895954,45
0,1237,49738,3575895909,3575895955,46
0,1237,49739,3575895909,3575895955,46
0,1237,49740,3575895909,3575895955,46
0,1237,49741,3575895909,3575895955,46
0,1237,49742,3575895909,3575895956,47
0,1237,49743,3575895909,3575895957,48
0,1237,49744,3575895909,3575895957,48
0,1237,49745,3575895909,3575895958,49
0,1237,49746,3575895909,3575895959,50
0,1238,49747,3575895974,3575895974,0
0,1238,49748,3575895974,3575895974,0
0,1238,49749,3575895974,3575895974,0
0,1238,49750,3575895974,3575895974,0
0,1238,49751,3575895974,3575895974,0
0,1238,49752,3575895974,3575895974,0
0,1238,49753,3575895974,3575895974,0
0,1238,49754,3575895974,3575895974,0
0,1238,49755,3575895974,3575895974,0
0,1238,49756,3575895974,3575895974,0
0,1238,49757,3575895974,3575895974,0
0,1238,49758,3575895974,3575895974,0
0,1238,49759,3575895974,3575895974,0
0,1238,49760,3575895974,3575895974,0
0,1238,49761,3575895974,3575895974,0
0,1238,49762,3575895974,3575895974,0
0,1238,49763,3575895974,3575895974,0
0,1238,49764,3575895974,3575895974,0
0,1238,49765,3575895974,3575895974,0
0,1238,49766,3575895974,3575895974,0
0,1238,49767,3575895974,3575895974,0
0,1238,49768,3575895974,3575895974,0
0,1238,49769,3575895974,3575895974,0
0,1238,49770,3575895974,3575895975,1
0,1238,49771,3575895974,3575895976,2
0,1238,49772,3575895974,3575895977,3
0,1238,49773,3575895974,3575895977,3
0,1238,49774,3575895974,3575895977,3
0,1238,49775,3575895974,3575895977,3
0,1238,49776,3575895974,3575895977,3
0,1238,49777,3575895974,3575895977,3
0,1238,49778,3575895974,3575895980,6
0,1238,49779,3575895974,3575895982,8
0,1238,49780,3575895974,3575895982,8
0,1238,49781,3575895974,3575895982,8
0,1238,49782,3575895974,3575895983,9
0,1238,49783,3575895974,3575895985,11
0,1238,49784,3575895974,3575895988,14
0,1238,49785,3575895974,3575895988,14
0,1238,49786,3575895974,3575895989,15
0,1238,49787,3575895974,3575895989,15
0,1238,49788,3575895974,3575895994,20
0,1238,49789,3575895974,3575895997,23
0,1238,49790,3575895974,3575895999,25
0,1238,49791,3575895974,3575895999,25
0,1238,49792,3575895974,3575896000,26
0,1238,49793,3575895974,3575896001,27
0,1238,49794,3575895974,3575896002,28
0,1238,49795,3575895974,3575896002,28
0,1238,49796,3575895974,3575896002,28
0,1238,49797,3575895974,3575896005,31
0,1238,49798,3575895974,3575896005,31
0,1238,49799,3575895974,3575896007,33
0,1238,49800,3575895974,3575896008,34
0,1238,49801,3575895974,3575896009,35
0,1238,49802,3575895974,3575896010,36
0,1238,49803,3575895974,3575896011,37
0,1238,49804,3575895974,3575896011,37
0,1238,49805,3575895974,3575896012,38
0,1238,49806,3575895974,3575896013,39
0,1238,49807,3575895974,3575896014,40
0,1238,49808,3575895974,3575896015,41
0,1238,49809,3575895974,3575896016,42
0,1238,49810,3575895974,3575896018,44
0,1238,49811,3575895974,3575896019,45
0,1238,49812,3575895974,3575896020,46
0,1238,49813,3575895974,3575896020,46
0,1238,49814,3575895974,3575896021,47
0,1238,49815,3575895974,3575896022,48
0,1238,49816,3575895974,3575896023,49
0,1238,49817,3575895974,3575896023,49
0,1239,49818,3575896040,3575896040,0
0,1239,49819,3575896040,3575896040,0
0,1239,49820,3575896040,3575896040,0
0,1239,49821,3575896040,3575896040,0
0,1239,49822,3575896040,3575896040,0
0,1239,49823,3575896040,3575896040,0
0,1239,49824,3575896040,3575896040,0
0,1239,49825,3575896040,3575896040,0
0,1239,49826,3575896040,3575896040,0
0,1239,49827,3575896040,3575896040,0
0,1239,49828,3575896040,3575896040,0
0,1239,49829,3575896040,3575896040,0
0,1239,49830,3575896040,3575896040,0
0,1239,49831,3575896040,3575896040,0
0,1239,49832,3575896040,3575896040,0
0,1239,49833,3575896040,3575896040,0
0,1239,49834,3575896040,3575896040,0
0,1239,49835,3575896040,3575896040,0
0,1239,49836,3575896040,3575896040,0
0,1239,49837,3575896040,3575896040,0
0,1239,49838,3575896040,3575896040,0
0,1239,49839,3575896040,3575896040,0
0,1239,49840,3575896040,3575896040,0
0,1239,49841,3575896040,3575896042,2
0,1239,49842,3575896040,3575896043,3
0,1239,49843,3575896040,3575896044,4
0,1239,49844,3575896040,3575896045,5
0,1239,49845,3575896040,3575896046,6
0,1239,49846,3575896040,3575896047,7
0,1239,49847,3575896040,3575896047,7
0,1239,49848,3575896040,3575896047,7
0,1239,49849,3575896040,3575896048,8
0,1239,49850,3575896040,3575896050,10
0,1239,49851,3575896040,3575896050,10
0,1239,49852,3575896040,3575896051,11
0,1239,49853,3575896040,3575896052,12
0,1239,49854,3575896040,3575896052,12
0,1239,49855,3575896040,3575896053,13
0,1239,49856,3575896040,3575896055,15
0,1239,49857,3575896040,3575896055,15
0,1239,49858,3575896040,3575896055,15
0,1239,49859,3575896040,3575896057,17
0,1239,49860,3575896040,3575896057,17
0,1239,49861,3575896040,3575896059,19
0,1239,49862,3575896040,3575896059,19
0,1239,49863,3575896040,3575896060,20
0,1239,49864,3575896040,3575896060,20
0,1239,49865,3575896040,3575896060,20
0,1239,49866,3575896040,3575896061,21
0,1239,49867,3575896040,3575896062,22
0,1239,49868,3575896040,3575896064,24
0,1239,49869,3575896040,3575896066,26
0,1239,49870,3575896040,3575896066,26
0,1239,49871,3575896040,3575896067,27
0,1239,49872,3575896040,3575896067,27
0,1239,49873,3575896040,3575896067,27
0,1239,49874,3575896040,3575896067,27
0,1239,49875,3575896040,3575896068,28
0,1239,49876,3575896040,3575896071,31
0,1239,49877,3575896040,3575896077,37
0,1239,49878,3575896040,3575896078,38
0,1239,49879,3575896040,3575896080,40
0,1239,49880,3575896040,3575896080,40
0,1239,49881,3575896040,3575896081,41
0,1239,49882,3575896040,3575896084,44
0,1239,49883,3575896040,3575896088,48
0,1239,49884,3575896040,3575896089,49
0,1239,49885,3575896040,3575896089,49
0,1240,49886,3575896106,3575896106,0
0,1240,49887,3575896106,3575896106,0
0,1240,49888,3575896106,3575896106,0
0,1240,49889,3575896106,3575896106,0
0,1240,49890,3575896106,3575896106,0
0,1240,49891,3575896106,3575896106,0
0,1240,49892,3575896106,3575896106,0
0,1240,49893,3575896106,3575896106,0
0,1240,49894,3575896106,3575896106,0
0,1240,49895,3575896106,3575896106,0
0,1240,49896,3575896106,3575896106,0
0,1240,49897,3575896106,3575896106,0
0,1240,49898,3575896106,3575896106,0
0,1240,49899,3575896106,3575896106,0
0,1240,49900,3575896106,3575896106,0
0,1240,49901,3575896106,3575896106,0
0,1240,49902,3575896106,3575896106,0
0,1240,49903,3575896106,3575896106,0
0,1240,49904,3575896106,3575896106,0
0,1240,49905,3575896106,3575896106,0
0,1240,49906,3575896106,3575896106,0
0,1240,49907,3575896106,3575896106,0
0,1240,49908,3575896106,3575896106,0
0,1240,49909,3575896106,3575896107,1
0,1240,49910,3575896106,3575896107,1
0,1240,49911,3575896106,3575896107,1
0,1240,49912,3575896106,3575896109,3
0,1240,49913,3575896106,3575896110,4
0,1240,49914,3575896106,3575896111,5
0,1240,49915,3575896106,3575896111,5
0,1240,49916,3575896106,3575896112,6
0,1240,49917,3575896106,3575896112,6
0,1240,49918,3575896106,3575896113,7
0,1240,49919,3575896106,3575896113,7
0,1240,49920,3575896106,3575896114,8
0,1240,49921,3575896106,3575896114,8
0,1240,49922,3575896106,3575896115,9
0,1240,49923,3575896106,3575896115,9
0,1240,49924,3575896106,3575896115,9
0,1240,49925,3575896106,3575896116,10
0,1240,49926,3575896106,3575896116,10
0,1240,49927,3575896106,3575896117,11
0,1240,49928,3575896106,3575896117,11
0,1240,49929,3575896106,3575896118,12
0,1240,49930,3575896106,3575896119,13
0,1240,49931,3575896106,3575896120,14
0,1240,49932,3575896106,3575896120,14
0,1240,49933,3575896106,3575896121,15
0,1240,49934,3575896106,3575896122,16
0,1240,49935,3575896106,3575896122,16
0,1240,49936,3575896106,3575896122,16
0,1240,49937,3575896106,3575896123,17
0,1240,49938,3575896106,3575896123,17
0,1240,49939,3575896106,3575896125,19
0,1240,49940,3575896106,3575896125,19
0,1240,49941,3575896106,3575896126,20
0,1240,49942,3575896106,3575896126,20
0,1240,49943,3575896106,3575896127,21
0,1240,49944,3575896106,3575896128,22
0,1240,49945,3575896106,3575896128,22
0,1240,49946,3575896106,3575896128,22
0,1240,49947,3575896106,3575896128,22
0,1240,49948,3575896106,3575896128,22
0,1240,49949,3575896106,3575896128,22
0,1240,49950,3575896106,3575896129,23
0,1240,49951,3575896106,3575896130,24
0,1240,49952,3575896106,3575896131,25
0,1240,49953,3575896106,3575896131,25
0,1240,49954,3575896106,3575896131,25
0,1240,49955,3575896106,3575896134,28
0,1240,49956,3575896106,3575896134,28
0,1240,49957,3575896106,3575896136,30
0,1240,49958,3575896106,3575896137,31
0,1240,49959,3575896106,3575896137,31
0,1240,49960,3575896106,3575896137,31
0,1240,49961,3575896106,3575896138,32
0,1240,49962,3575896106,3575896138,32
0,1240,49963,3575896106,3575896139,33
0,1240,49964,3575896106,3575896140,34
0,1240,49965,3575896106,3575896141,35
0,1240,49966,3575896106,3575896141,35
0,1240,49967,3575896106,3575896142,36
0,1240,49968,3575896106,3575896142,36
0,1240,49969,3575896106,3575896142,36
0,1240,49970,3575896106,3575896143,37
0,1240,49971,3575896106,3575896143,37
0,1240,49972,3575896106,3575896145,39
0,1240,49973,3575896106,3575896146,40
0,1240,49974,3575896106,3575896146,40
0,1240,49975,3575896106,3575896146,40
0,1240,49976,3575896106,3575896146,40
0,1240,49977,3575896106,3575896146,40
0,1240,49978,3575896106,3575896148,42
0,1240,49979,3575896106,3575896148,42
0,1240,49980,3575896106,3575896149,43
0,1240,49981,3575896106,3575896149,43
0,1240,49982,3575896106,3575896151,45
0,1240,49983,3575896106,3575896152,46
0,1240,49984,3575896106,3575896152,46
0,1240,49985,3575896106,3575896154,48
0,1240,49986,3575896106,3575896154,48
0,1240,49987,3575896106,3575896155,49
0,1240,49988,3575896106,3575896155,49
0,1240,49989,3575896106,3575896155,49
0,1240,49990,3575896106,3575896156,50
0,1241,49991,3575896173,3575896173,0
0,1241,49992,3575896173,3575896173,0
0,1241,49993,3575896173,3575896173,0
0,1241,49994,3575896173,3575896173,0
0,1241,49995,3575896173,3575896173,0
0,1241,49996,3575896173,3575896173,0
0,1241,49997,3575896173,3575896173,0
0,1241,49998,3575896173,3575896173,0
0,1241,49999,3575896173,3575896173,0
0,1241,50000,3575896173,3575896173,0
0,1241,50001,3575896173,3575896173,0
0,1241,50002,3575896173,3575896173,0
0,1241,50003,3575896173,3575896173,0
0,1241,50004,3575896173,3575896173,0
0,1241,50005,3575896173,3575896173,0
0,1241,50006,3575896173,3575896173,0
0,1241,50007,3575896173,3575896173,0
0,1241,50008,3575896173,3575896173,0
0,1241,50009,3575896173,3575896174,1
0,1241,50010,3575896173,3575896174,1
0,1241,50011,3575896173,3575896176,3
0,1241,50012,3575896173,3575896176,3
0,1241,50013,3575896173,3575896177,4
0,1241,50014,3575896173,3575896178,5
0,1241,50015,3575896173,3575896178,5
0,1241,50016,3575896173,3575896179,6
0,1241,50017,3575896173,3575896179,6
0,1241,50018,3575896173,3575896180,7
0,1241,50019,3575896173,3575896182,9
0,1241,50020,3575896173,3575896183,10
0,1241,50021,3575896173,3575896184,11
0,1241,50022,3575896173,3575896184,11
0,1241,50023,3575896173,3575896185,12
0,1241,50024,3575896173,3575896187,14
0,1241,50025,3575896173,3575896188,15
0,1241,50026,3575896173,3575896188,15
0,1241,50027,3575896173,3575896189,16
0,1241,50028,3575896173,3575896194,21
0,1241,50029,3575896173,3575896198,25
0,1241,50030,3575896173,3575896201,28
0,1241,50031,3575896173,3575896201,28
0,1241,50032,3575896173,3575896203,30
0,1241,50033,3575896173,3575896205,32
0,1241,50034,3575896173,3575896205,32
0,1241,50035,3575896173,3575896207,34
0,1241,50036,3575896173,3575896207,34
0,1241,50037,3575896173,3575896209,36
0,1241,50038,3575896173,3575896209,36
0,1241,50039,3575896173,3575896210,37
0,1241,50040,3575896173,3575896213,40
0,1241,50041,3575896173,3575896213,40
0,1241,50042,3575896173,3575896213,40
0,1241,50043,3575896173,3575896215,42
0,1241,50044,3575896173,3575896215,42
0,1241,50045,3575896173,3575896215,42
0,1241,50046,3575896173,3575896216,43
0,1241,50047,3575896173,3575896218,45
0,1241,50048,3575896173,3575896218,45
0,1241,50049,3575896173,3575896220,47
0,1241,50050,3575896173,3575896221,48
0,1241,50051,3575896173,3575896221,48
0,1241,50052,3575896173,3575896221,48
0,1241,50053,3575896173,3575896223,50
0,1242,50054,3575896239,3575896239,0
0,1242,50055,3575896239,3575896239,0
0,1242,50056,3575896239,3575896239,0
0,1242,50057,3575896239,3575896239,0
0,1242,50058,3575896239,3575896239,0
0,1242,50059,3575896239,3575896239,0
0,1242,50060,3575896239,3575896239,0
0,1242,50061,3575896239,3575896239,0
0,1242,50062,3575896239,3575896239,0
0,1242,50063,3575896239,3575896239,0
0,1242,50064,3575896239,3575896239,0
0,1242,50065,3575896239,3575896239,0
0,1242,50066,3575896239,3575896239,0
0,1242,50067,3575896239,3575896239,0
0,1242,50068,3575896239,3575896239,0
0,1242,50069,3575896239,3575896239,0
0,1242,50070,3575896239,3575896239,0
0,1242,50071,3575896239,3575896239,0
0,1242,50072,3575896239,3575896239,0
0,1242,50073,3575896239,3575896239,0
0,1242,50074,3575896239,3575896239,0
0,1242,50075,3575896239,3575896239,0
0,1242,50076,3575896239,3575896239,0
0,1242,50077,3575896239,3575896241,2
0,1242,50078,3575896239,3575896242,3
0,1242,50079,3575896239,3575896243,4
0,1242,50080,3575896239,3575896244,5
0,1242,50081,3575896239,3575896244,5
0,1242,50082,3575896239,3575896244,5
0,1242,50083,3575896239,3575896246,7
0,1242,50084,3575896239,3575896246,7
0,1242,50085,3575896239,3575896247,8
0,1242,50086,3575896239,3575896248,9
0,1242,50087,3575896239,3575896248,9
0,1242,50088,3575896239,3575896248,9
0,1242,50089,3575896239,3575896249,10
0,1242,50090,3575896239,3575896250,11
0,1242,50091,3575896239,3575896250,11
0,1242,50092,3575896239,3575896252,13
0,1242,50093,3575896239,3575896252,13
0,1242,50094,3575896239,3575896254,15
0,1242,50095,3575896239,3575896255,16
0,1242,50096,3575896239,3575896256,17
0,1242,50097,3575896239,3575896256,17
0,1242,50098,3575896239,3575896259,20
0,1242,50099,3575896239,3575896260,21
0,1242,50100,3575896239,3575896260,21
0,1242,50101,3575896239,3575896261,22
0,1242,50102,3575896239,3575896261,22
0,1242,50103,3575896239,3575896262,23
0,1242,50104,3575896239,3575896262,23
0,1242,50105,3575896239,3575896263,24
0,1242,50106,3575896239,3575896264,25
0,1242,50107,3575896239,3575896264,25
0,1242,50108,3575896239,3575896264,25
0,1242,50109,3575896239,3575896265,26
0,1242,50110,3575896239,3575896266,27
0,1242,50111,3575896239,3575896267,28
0,1242,50112,3575896239,3575896267,28
0,1242,50113,3575896239,3575896267,28
0,1242,50114,3575896239,3575896268,29
0,1242,50115,3575896239,3575896268,29
0,1242,50116,3575896239,3575896271,32
0,1242,50117,3575896239,3575896276,37
0,1242,50118,3575896239,3575896278,39
0,1242,50119,3575896239,3575896280,41
0,1242,50120,3575896239,3575896280,41
0,1242,50121,3575896239,3575896281,42
0,1242,50122,3575896239,3575896287,48
0,1242,50123,3575896239,3575896287,48
0,1242,50124,3575896239,3575896288,49
0,1242,50125,3575896239,3575896289,50
0,1243,50126,3575896302,3575896302,0
0,1243,50127,3575896302,3575896302,0
0,1243,50128,3575896302,3575896302,0
0,1243,50129,3575896302,3575896302,0
0,1243,50130,3575896302,3575896302,0
0,1243,50131,3575896302,3575896302,0
0,1243,50132,3575896302,3575896302,0
0,1243,50133,3575896302,3575896302,0
0,1243,50134,3575896302,3575896302,0
0,1243,50135,3575896302,3575896302,0
0,1243,50136,3575896302,3575896302,0
0,1243,50137,3575896302,3575896302,0
0,1243,50138,3575896302,3575896302,0
0,1243,50139,3575896302,3575896302,0
0,1243,50140,3575896302,3575896302,0
0,1243,50141,3575896302,3575896302,0
0,1243,50142,3575896302,3575896302,0
0,1243,50143,3575896302,3575896302,0
0,1243,50144,3575896302,3575896302,0
0,1243,50145,3575896302,3575896302,0
0,1243,50146,3575896302,3575896302,0
0,1243,50147,3575896302,3575896302,0
0,1243,50148,3575896302,3575896302,0
0,1243,50149,3575896302,3575896302,0
0,1243,50150,3575896302,3575896303,1
0,1243,50151,3575896302,3575896303,1
0,1243,50152,3575896302,3575896303,1
0,1243,50153,3575896302,3575896303,1
0,1243,50154,3575896302,3575896304,2
0,1243,50155,3575896302,3575896305,3
0,1243,50156,3575896302,3575896305,3
0,1243,50157,3575896302,3575896306,4
0,1243,50158,3575896302,3575896306,4
0,1243,50159,3575896302,3575896307,5
0,1243,50160,3575896302,3575896308,6
0,1243,50161,3575896302,3575896309,7
0,1243,50162,3575896302,3575896310,8
0,1243,50163,3575896302,3575896311,9
0,1243,50164,3575896302,3575896311,9
0,1243,50165,3575896302,3575896311,9
0,1243,50166,3575896302,3575896313,11
0,1243,50167,3575896302,3575896314,12
0,1243,50168,3575896302,3575896314,12
0,1243,50169,3575896302,3575896315,13
0,1243,50170,3575896302,3575896315,13
0,1243,50171,3575896302,3575896316,14
0,1243,50172,3575896302,3575896316,14
0,1243,50173,3575896302,3575896318,16
0,1243,50174,3575896302,3575896318,16
0,1243,50175,3575896302,3575896318,16
0,1243,50176,3575896302,3575896319,17
0,1243,50177,3575896302,3575896319,17
0,1243,50178,3575896302,3575896320,18
0,1243,50179,3575896302,3575896321,19
0,1243,50180,3575896302,3575896322,20
0,1243,50181,3575896302,3575896323,21
0,1243,50182,3575896302,3575896323,21
0,1243,50183,3575896302,3575896324,22
0,1243,50184,3575896302,3575896324,22
0,1243,50185,3575896302,3575896325,23
0,1243,50186,3575896302,3575896327,25
0,1243,50187,3575896302,3575896327,25
0,1243,50188,3575896302,3575896328,26
0,1243,50189,3575896302,3575896328,26
0,1243,50190,3575896302,3575896328,26
0,1243,50191,3575896302,3575896328,26
0,1243,50192,3575896302,3575896328,26
0,1243,50193,3575896302,3575896329,27
0,1243,50194,3575896302,3575896329,27
0,1243,50195,3575896302,3575896330,28
0,1243,50196,3575896302,3575896331,29
0,1243,50197,3575896302,3575896332,30
0,1243,50198,3575896302,3575896332,30
0,1243,50199,3575896302,3575896332,30
0,1243,50200,3575896302,3575896333,31
0,1243,50201,3575896302,3575896334,32
0,1243,50202,3575896302,3575896334,32
0,1243,50203,3575896302,3575896337,35
0,1243,50204,3575896302,3575896337,35
0,1243,50205,3575896302,3575896338,36
0,1243,50206,3575896302,3575896338,36
0,1243,50207,3575896302,3575896338,36
0,1243,50208,3575896302,3575896339,37
0,1243,50209,3575896302,3575896340,38
0,1243,50210,3575896302,3575896340,38
0,1243,50211,3575896302,3575896340,38
0,1243,50212,3575896302,3575896341,39
0,1243,50213,3575896302,3575896342,40
0,1243,50214,3575896302,3575896342,40
0,1243,50215,3575896302,3575896342,40
0,1243,50216,3575896302,3575896342,40
0,1243,50217,3575896302,3575896344,42
0,1243,50218,3575896302,3575896345,43
0,1243,50219,3575896302,3575896346,44
0,1243,50220,3575896302,3575896347,45
0,1243,50221,3575896302,3575896347,45
0,1243,50222,3575896302,3575896347,45
0,1243,50223,3575896302,3575896348,46
0,1243,50224,3575896302,3575896348,46
0,1243,50225,3575896302,3575896349,47
0,1243,50226,3575896302,3575896352,50
0,1244,50227,3575896366,3575896366,0
0,1244,50228,3575896366,3575896366,0
0,1244,50229,3575896366,3575896366,0
0,1244,50230,3575896366,3575896366,0
0,1244,50231,3575896366,3575896366,0
0,1244,50232,3575896366,3575896366,0
0,1244,50233,3575896366,3575896366,0
0,1244,50234,3575896366,3575896366,0
0,1244,50235,3575896366,3575896366,0
0,1244,50236,3575896366,3575896367,1
0,1244,50237,3575896366,3575896367,1
0,1244,50238,3575896366,3575896367,1
0,1244,50239,3575896366,3575896367,1
0,1244,50240,3575896366,3575896367,1
0,1244,50241,3575896366,3575896367,1
0,1244,50242,3575896366,3575896367,1
0,1244,50243,3575896366,3575896367,1
0,1244,50244,3575896366,3575896367,1
0,1244,50245,3575896366,3575896367,1
0,1244,50246,3575896366,3575896367,1
0,1244,50247,3575896366,3575896367,1
0,1244,50248,3575896366,3575896367,1
0,1244,50249,3575896366,3575896367,1
0,1244,50250,3575896366,3575896367,1
0,1244,50251,3575896366,3575896367,1
0,1244,50252,3575896366,3575896367,1
0,1244,50253,3575896366,3575896367,1
0,1244,50254,3575896366,3575896368,2
0,1244,50255,3575896366,3575896372,6
0,1244,50256,3575896366,3575896372,6
0,1244,50257,3575896366,3575896372,6
0,1244,50258,3575896366,3575896373,7
0,1244,50259,3575896366,3575896374,8
0,1244,50260,3575896366,3575896374,8
0,1244,50261,3575896366,3575896375,9
0,1244,50262,3575896366,3575896377,11
0,1244,50263,3575896366,3575896377,11
0,1244,50264,3575896366,3575896377,11
0,1244,50265,3575896366,3575896378,12
0,1244,50266,3575896366,3575896378,12
0,1244,50267,3575896366,3575896379,13
0,1244,50268,3575896366,3575896380,14
0,1244,50269,3575896366,3575896382,16
0,1244,50270,3575896366,3575896384,18
0,1244,50271,3575896366,3575896385,19
0,1244,50272,3575896366,3575896385,19
0,1244,50273,3575896366,3575896385,19
0,1244,50274,3575896366,3575896389,23
0,1244,50275,3575896366,3575896389,23
0,1244,50276,3575896366,3575896389,23
0,1244,50277,3575896366,3575896390,24
0,1244,50278,3575896366,3575896395,29
0,1244,50279,3575896366,3575896399,33
0,1244,50280,3575896366,3575896399,33
0,1244,50281,3575896366,3575896399,33
0,1244,50282,3575896366,3575896400,34
0,1244,50283,3575896366,3575896401,35
0,1244,50284,3575896366,3575896402,36
0,1244,50285,3575896366,3575896403,37
0,1244,50286,3575896366,3575896405,39
0,1244,50287,3575896366,3575896405,39
0,1244,50288,3575896366,3575896406,40
0,1244,50289,3575896366,3575896408,42
0,1244,50290,3575896366,3575896408,42
0,1244,50291,3575896366,3575896408,42
0,1244,50292,3575896366,3575896410,44
0,1244,50293,3575896366,3575896411,45
0,1244,50294,3575896366,3575896412,46
0,1244,50295,3575896366,3575896413,47
0,1244,50296,3575896366,3575896413,47
0,1244,50297,3575896366,3575896415,49
0,1244,50298,3575896366,3575896416,50
0,1245,50299,3575896431,3575896431,0
0,1245,50300,3575896431,3575896431,0
0,1245,50301,3575896431,3575896431,0
0,1245,50302,3575896431,3575896431,0
0,1245,50303,3575896431,3575896431,0
0,1245,50304,3575896431,3575896431,0
0,1245,50305,3575896431,3575896431,0
0,1245,50306,3575896431,3575896431,0
0,1245,50307,3575896431,3575896431,0
0,1245,50308,3575896431,3575896431,0
0,1245,50309,3575896431,3575896431,0
0,1245,50310,3575896431,3575896431,0
0,1245,50311,3575896431,3575896431,0
0,1245,50312,3575896431,3575896431,0
0,1245,50313,3575896431,3575896431,0
0,1245,50314,3575896431,3575896432,1
0,1245,50315,3575896431,3575896432,1
0,1245,50316,3575896431,3575896432,1
0,1245,50317,3575896431,3575896433,2
0,1245,50318,3575896431,3575896433,2
0,1245,50319,3575896431,3575896433,2
0,1245,50320,3575896431,3575896434,3
0,1245,50321,3575896431,3575896434,3
0,1245,50322,3575896431,3575896434,3
0,1245,50323,3575896431,3575896434,3
0,1245,50324,3575896431,3575896435,4
0,1245,50325,3575896431,3575896435,4
0,1245,50326,3575896431,3575896436,5
0,1245,50327,3575896431,3575896436,5
0,1245,50328,3575896431,3575896439,8
0,1245,50329,3575896431,3575896440,9
0,1245,50330,3575896431,3575896443,12
0,1245,50331,3575896431,3575896444,13
0,1245,50332,3575896431,3575896444,13
0,1245,50333,3575896431,3575896444,13
0,1245,50334,3575896431,3575896445,14
0,1245,50335,3575896431,3575896446,15
0,1245,50336,3575896431,3575896446,15
0,1245,50337,3575896431,3575896447,16
0,1245,50338,3575896431,3575896447,16
0,1245,50339,3575896431,3575896448,17
0,1245,50340,3575896431,3575896448,17
0,1245,50341,3575896431,3575896450,19
0,1245,50342,3575896431,3575896450,19
0,1245,50343,3575896431,3575896451,20
0,1245,50344,3575896431,3575896452,21
0,1245,50345,3575896431,3575896453,22
0,1245,50346,3575896431,3575896456,25
0,1245,50347,3575896431,3575896456,25
0,1245,50348,3575896431,3575896456,25
0,1245,50349,3575896431,3575896457,26
0,1245,50350,3575896431,3575896457,26
0,1245,50351,3575896431,3575896460,29
0,1245,50352,3575896431,3575896460,29
0,1245,50353,3575896431,3575896460,29
0,1245,50354,3575896431,3575896460,29
0,1245,50355,3575896431,3575896461,30
0,1245,50356,3575896431,3575896462,31
0,1245,50357,3575896431,3575896463,32
0,1245,50358,3575896431,3575896464,33
0,1245,50359,3575896431,3575896464,33
0,1245,50360,3575896431,3575896465,34
0,1245,50361,3575896431,3575896466,35
0,1245,50362,3575896431,3575896466,35
0,1245,50363,3575896431,3575896466,35
0,1245,50364,3575896431,3575896467,36
0,1245,50365,3575896431,3575896467,36
0,1245,50366,3575896431,3575896467,36
0,1245,50367,3575896431,3575896468,37
0,1245,50368,3575896431,3575896468,37
0,1245,50369,3575896431,3575896472,41
0,1245,50370,3575896431,3575896477,46
0,1245,50371,3575896431,3575896478,47
0,1245,50372,3575896431,3575896480,49
0,1245,50373,3575896431,3575896481,50
0,1246,50374,3575896494,3575896494,0
0,1246,50375,3575896494,3575896494,0
0,1246,50376,3575896494,3575896494,0
0,1246,50377,3575896494,3575896494,0
0,1246,50378,3575896494,3575896494,0
0,1246,50379,3575896494,3575896494,0
0,1246,50380,3575896494,3575896494,0
0,1246,50381,3575896494,3575896494,0
0,1246,50382,3575896494,3575896494,0
0,1246,50383,3575896494,3575896494,0
0,1246,50384,3575896494,3575896496,2
0,1246,50385,3575896494,3575896496,2
0,1246,50386,3575896494,3575896496,2
0,1246,50387,3575896494,3575896496,2
0,1246,50388,3575896494,3575896496,2
0,1246,50389,3575896494,3575896497,3
0,1246,50390,3575896494,3575896497,3
0,1246,50391,3575896494,3575896498,4
0,1246,50392,3575896494,3575896498,4
0,1246,50393,3575896494,3575896499,5
0,1246,50394,3575896494,3575896500,6
0,1246,50395,3575896494,3575896501,7
0,1246,50396,3575896494,3575896501,7
0,1246,50397,3575896494,3575896502,8
0,1246,50398,3575896494,3575896502,8
0,1246,50399,3575896494,3575896502,8
0,1246,50400,3575896494,3575896502,8
0,1246,50401,3575896494,3575896503,9
0,1246,50402,3575896494,3575896503,9
0,1246,50403,3575896494,3575896504,10
0,1246,50404,3575896494,3575896505,11
0,1246,50405,3575896494,3575896505,11
0,1246,50406,3575896494,3575896505,11
0,1246,50407,3575896494,3575896506,12
0,1246,50408,3575896494,3575896506,12
0,1246,50409,3575896494,3575896508,14
0,1246,50410,3575896494,3575896510,16
0,1246,50411,3575896494,3575896510,16
0,1246,50412,3575896494,3575896510,16
0,1246,50413,3575896494,3575896511,17
0,1246,50414,3575896494,3575896513,19
0,1246,50415,3575896494,3575896513,19
0,1246,50416,3575896494,3575896513,19
0,1246,50417,3575896494,3575896513,19
0,1246,50418,3575896494,3575896515,21
0,1246,50419,3575896494,3575896515,21
0,1246,50420,3575896494,3575896516,22
0,1246,50421,3575896494,3575896516,22
0,1246,50422,3575896494,3575896516,22
0,1246,50423,3575896494,3575896517,23
0,1246,50424,3575896494,3575896517,23
0,1246,50425,3575896494,3575896518,24
0,1246,50426,3575896494,3575896518,24
0,1246,50427,3575896494,3575896518,24
0,1246,50428,3575896494,3575896519,25
0,1246,50429,3575896494,3575896519,25
0,1246,50430,3575896494,3575896520,26
0,1246,50431,3575896494,3575896520,26
0,1246,50432,3575896494,3575896522,28
0,1246,50433,3575896494,3575896522,28
0,1246,50434,3575896494,3575896522,28
0,1246,50435,3575896494,3575896522,28
0,1246,50436,3575896494,3575896523,29
0,1246,50437,3575896494,3575896523,29
0,1246,50438,3575896494,3575896524,30
0,1246,50439,3575896494,3575896525,31
0,1246,50440,3575896494,3575896526,32
0,1246,50441,3575896494,3575896527,33
0,1246,50442,3575896494,3575896527,33
0,1246,50443,3575896494,3575896527,33
0,1246,50444,3575896494,3575896527,33
0,1246,50445,3575896494,3575896527,33
0,1246,50446,3575896494,3575896528,34
0,1246,50447,3575896494,3575896528,34
0,1246,50448,3575896494,3575896530,36
0,1246,50449,3575896494,3575896530,36
0,1246,50450,3575896494,3575896530,36
0,1246,50451,3575896494,3575896531,37
0,1246,50452,3575896494,3575896531,37
0,1246,50453,3575896494,3575896532,38
0,1246,50454,3575896494,3575896533,39
0,1246,50455,3575896494,3575896534,40
0,1246,50456,3575896494,3575896536,42
0,1246,50457,3575896494,3575896536,42
0,1246,50458,3575896494,3575896537,43
0,1246,50459,3575896494,3575896537,43
0,1246,50460,3575896494,3575896538,44
0,1246,50461,3575896494,3575896538,44
0,1246,50462,3575896494,3575896538,44
0,1246,50463,3575896494,3575896540,46
0,1246,50464,3575896494,3575896540,46
0,1246,50465,3575896494,3575896541,47
0,1246,50466,3575896494,3575896541,47
0,1246,50467,3575896494,3575896541,47
0,1246,50468,3575896494,3575896541,47
0,1246,50469,3575896494,3575896542,48
0,1246,50470,3575896494,3575896544,50
0,1247,50471,3575896562,3575896562,0
0,1247,50472,3575896562,3575896562,0
0,1247,50473,3575896562,3575896562,0
0,1247,50474,3575896562,3575896562,0
0,1247,50475,3575896562,3575896562,0
0,1247,50476,3575896562,3575896562,0
0,1247,50477,3575896562,3575896562,0
0,1247,50478,3575896562,3575896562,0
0,1247,50479,3575896562,3575896562,0
0,1247,50480,3575896562,3575896562,0
0,1247,50481,3575896562,3575896562,0
0,1247,50482,3575896562,3575896562,0
0,1247,50483,3575896562,3575896562,0
0,1247,50484,3575896562,3575896562,0
0,1247,50485,3575896562,3575896562,0
0,1247,50486,3575896562,3575896562,0
0,1247,50487,3575896562,3575896562,0
0,1247,50488,3575896562,3575896562,0
0,1247,50489,3575896562,3575896562,0
0,1247,50490,3575896562,3575896562,0
0,1247,50491,3575896562,3575896562,0
0,1247,50492,3575896562,3575896562,0
0,1247,50493,3575896562,3575896562,0
0,1247,50494,3575896562,3575896562,0
0,1247,50495,3575896562,3575896563,1
0,1247,50496,3575896562,3575896564,2
0,1247,50497,3575896562,3575896565,3
0,1247,50498,3575896562,3575896565,3
0,1247,50499,3575896562,3575896566,4
0,1247,50500,3575896562,3575896568,6
0,1247,50501,3575896562,3575896569,7
0,1247,50502,3575896562,3575896570,8
0,1247,50503,3575896562,3575896571,9
0,1247,50504,3575896562,3575896571,9
0,1247,50505,3575896562,3575896571,9
0,1247,50506,3575896562,3575896572,10
0,1247,50507,3575896562,3575896573,11
0,1247,50508,3575896562,3575896573,11
0,1247,50509,3575896562,3575896574,12
0,1247,50510,3575896562,3575896574,12
0,1247,50511,3575896562,3575896575,13
0,1247,50512,3575896562,3575896576,14
0,1247,50513,3575896562,3575896577,15
0,1247,50514,3575896562,3575896577,15
0,1247,50515,3575896562,3575896577,15
0,1247,50516,3575896562,3575896578,16
0,1247,50517,3575896562,3575896578,16
0,1247,50518,3575896562,3575896578,16
0,1247,50519,3575896562,3575896580,18
0,1247,50520,3575896562,3575896581,19
0,1247,50521,3575896562,3575896582,20
0,1247,50522,3575896562,3575896583,21
0,1247,50523,3575896562,3575896584,22
0,1247,50524,3575896562,3575896585,23
0,1247,50525,3575896562,3575896586,24
0,1247,50526,3575896562,3575896586,24
0,1247,50527,3575896562,3575896588,26
0,1247,50528,3575896562,3575896589,27
0,1247,50529,3575896562,3575896589,27
0,1247,50530,3575896562,3575896593,31
0,1247,50531,3575896562,3575896594,32
0,1247,50532,3575896562,3575896597,35
0,1247,50533,3575896562,3575896598,36
0,1247,50534,3575896562,3575896599,37
0,1247,50535,3575896562,3575896600,38
0,1247,50536,3575896562,3575896602,40
0,1247,50537,3575896562,3575896602,40
0,1247,50538,3575896562,3575896605,43
0,1247,50539,3575896562,3575896605,43
0,1247,50540,3575896562,3575896607,45
0,1247,50541,3575896562,3575896608,46
0,1247,50542,3575896562,3575896608,46
0,1247,50543,3575896562,3575896608,46
0,1247,50544,3575896562,3575896610,48
0,1247,50545,3575896562,3575896610,48
0,1247,50546,3575896562,3575896612,50
0,1248,50547,3575896626,3575896626,0
0,1248,50548,3575896626,3575896626,0
0,1248,50549,3575896626,3575896626,0
0,1248,50550,3575896626,3575896626,0
0,1248,50551,3575896626,3575896626,0
0,1248,50552,3575896626,3575896626,0
0,1248,50553,3575896626,3575896626,0
0,1248,50554,3575896626,3575896626,0
0,1248,50555,3575896626,3575896626,0
0,1248,50556,3575896626,3575896626,0
0,1248,50557,3575896626,3575896626,0
0,1248,50558,3575896626,3575896626,0
0,1248,50559,3575896626,3575896626,0
0,1248,50560,3575896626,3575896627,1
0,1248,50561,3575896626,3575896629,3
0,1248,50562,3575896626,3575896629,3
0,1248,50563,3575896626,3575896629,3
0,1248,50564,3575896626,3575896630,4
0,1248,50565,3575896626,3575896630,4
0,1248,50566,3575896626,3575896631,5
0,1248,50567,3575896626,3575896631,5
0,1248,50568,3575896626,3575896632,6
0,1248,50569,3575896626,3575896632,6
0,1248,50570,3575896626,3575896632,6
0,1248,50571,3575896626,3575896632,6
0,1248,50572,3575896626,3575896633,7
0,1248,50573,3575896626,3575896633,7
0,1248,50574,3575896626,3575896634,8
0,1248,50575,3575896626,3575896634,8
0,1248,50576,3575896626,3575896635,9
0,1248,50577,3575896626,3575896635,9
0,1248,50578,3575896626,3575896635,9
0,1248,50579,3575896626,3575896637,11
0,1248,50580,3575896626,3575896639,13
0,1248,50581,3575896626,3575896640,14
0,1248,50582,3575896626,3575896642,16
0,1248,50583,3575896626,3575896642,16
0,1248,50584,3575896626,3575896643,17
0,1248,50585,3575896626,3575896643,17
0,1248,50586,3575896626,3575896644,18
0,1248,50587,3575896626,3575896645,19
0,1248,50588,3575896626,3575896645,19
0,1248,50589,3575896626,3575896647,21
0,1248,50590,3575896626,3575896647,21
0,1248,50591,3575896626,3575896647,21
0,1248,50592,3575896626,3575896647,21
0,1248,50593,3575896626,3575896647,21
0,1248,50594,3575896626,3575896649,23
0,1248,50595,3575896626,3575896651,25
0,1248,50596,3575896626,3575896651,25
0,1248,50597,3575896626,3575896653,27
0,1248,50598,3575896626,3575896654,28
0,1248,50599,3575896626,3575896654,28
0,1248,50600,3575896626,3575896655,29
0,1248,50601,3575896626,3575896656,30
0,1248,50602,3575896626,3575896658,32
0,1248,50603,3575896626,3575896659,33
0,1248,50604,3575896626,3575896659,33
0,1248,50605,3575896626,3575896659,33
0,1248,50606,3575896626,3575896660,34
0,1248,50607,3575896626,3575896661,35
0,1248,50608,3575896626,3575896662,36
0,1248,50609,3575896626,3575896662,36
0,1248,50610,3575896626,3575896663,37
0,1248,50611,3575896626,3575896663,37
0,1248,50612,3575896626,3575896663,37
0,1248,50613,3575896626,3575896664,38
0,1248,50614,3575896626,3575896665,39
0,1248,50615,3575896626,3575896665,39
0,1248,50616,3575896626,3575896666,40
0,1248,50617,3575896626,3575896666,40
0,1248,50618,3575896626,3575896667,41
0,1248,50619,3575896626,3575896668,42
0,1248,50620,3575896626,3575896668,42
0,1248,50621,3575896626,3575896672,46
0,1249,50622,3575896690,3575896690,0
0,1249,50623,3575896690,3575896690,0
0,1249,50624,3575896690,3575896690,0
0,1249,50625,3575896690,3575896690,0
0,1249,50626,3575896690,3575896690,0
0,1249,50627,3575896690,3575896690,0
0,1249,50628,3575896690,3575896690,0
0,1249,50629,3575896690,3575896690,0
0,1249,50630,3575896690,3575896690,0
0,1249,50631,3575896690,3575896691,1
0,1249,50632,3575896690,3575896691,1
0,1249,50633,3575896690,3575896692,2
0,1249,50634,3575896690,3575896693,3
0,1249,50635,3575896690,3575896693,3
0,1249,50636,3575896690,3575896693,3
0,1249,50637,3575896690,3575896696,6
0,1249,50638,3575896690,3575896696,6
0,1249,50639,3575896690,3575896696,6
0,1249,50640,3575896690,3575896696,6
0,1249,50641,3575896690,3575896696,6
0,1249,50642,3575896690,3575896697,7
0,1249,50643,3575896690,3575896697,7
0,1249,50644,3575896690,3575896698,8
0,1249,50645,3575896690,3575896698,8
0,1249,50646,3575896690,3575896698,8
0,1249,50647,3575896690,3575896700,10
0,1249,50648,3575896690,3575896701,11
0,1249,50649,3575896690,3575896701,11
0,1249,50650,3575896690,3575896702,12
0,1249,50651,3575896690,3575896702,12
0,1249,50652,3575896690,3575896702,12
0,1249,50653,3575896690,3575896703,13
0,1249,50654,3575896690,3575896703,13
0,1249,50655,3575896690,3575896703,13
0,1249,50656,3575896690,3575896704,14
0,1249,50657,3575896690,3575896704,14
0,1249,50658,3575896690,3575896705,15
0,1249,50659,3575896690,3575896705,15
0,1249,50660,3575896690,3575896705,15
0,1249,50661,3575896690,3575896707,17
0,1249,50662,3575896690,3575896708,18
0,1249,50663,3575896690,3575896710,20
0,1249,50664,3575896690,3575896710,20
0,1249,50665,3575896690,3575896710,20
0,1249,50666,3575896690,3575896710,20
0,1249,50667,3575896690,3575896711,21
0,1249,50668,3575896690,3575896713,23
0,1249,50669,3575896690,3575896714,24
0,1249,50670,3575896690,3575896714,24
0,1249,50671,3575896690,3575896715,25
0,1249,50672,3575896690,3575896715,25
0,1249,50673,3575896690,3575896716,26
0,1249,50674,3575896690,3575896716,26
0,1249,50675,3575896690,3575896716,26
0,1249,50676,3575896690,3575896716,26
0,1249,50677,3575896690,3575896716,26
0,1249,50678,3575896690,3575896718,28
0,1249,50679,3575896690,3575896718,28
0,1249,50680,3575896690,3575896719,29
0,1249,50681,3575896690,3575896719,29
0,1249,50682,3575896690,3575896720,30
0,1249,50683,3575896690,3575896720,30
0,1249,50684,3575896690,3575896721,31
0,1249,50685,3575896690,3575896721,31
0,1249,50686,3575896690,3575896722,32
0,1249,50687,3575896690,3575896722,32
0,1249,50688,3575896690,3575896722,32
0,1249,50689,3575896690,3575896723,33
0,1249,50690,3575896690,3575896724,34
0,1249,50691,3575896690,3575896724,34
0,1249,50692,3575896690,3575896725,35
0,1249,50693,3575896690,3575896725,35
0,1249,50694,3575896690,3575896727,37
0,1249,50695,3575896690,3575896727,37
0,1249,50696,3575896690,3575896727,37
0,1249,50697,3575896690,3575896728,38
0,1249,50698,3575896690,3575896728,38
0,1249,50699,3575896690,3575896728,38
0,1249,50700,3575896690,3575896730,40
0,1249,50701,3575896690,3575896730,40
0,1249,50702,3575896690,3575896731,41
0,1249,50703,3575896690,3575896732,42
0,1249,50704,3575896690,3575896732,42
0,1249,50705,3575896690,3575896733,43
0,1249,50706,3575896690,3575896734,44
0,1249,50707,3575896690,3575896735,45
0,1249,50708,3575896690,3575896736,46
0,1249,50709,3575896690,3575896737,47
0,1249,50710,3575896690,3575896738,48
0,1249,50711,3575896690,3575896738,48
0,1249,50712,3575896690,3575896739,49
0,1249,50713,3575896690,3575896740,50
0,1250,50714,3575896755,3575896755,0
0,1250,50715,3575896755,3575896755,0
0,1250,50716,3575896755,3575896755,0
0,1250,50717,3575896755,3575896755,0
0,1250,50718,3575896755,3575896755,0
0,1250,50719,3575896755,3575896755,0
0,1250,50720,3575896755,3575896755,0
0,1250,50721,3575896755,3575896755,0
0,1250,50722,3575896755,3575896755,0
0,1250,50723,3575896755,3575896755,0
0,1250,50724,3575896755,3575896755,0
0,1250,50725,3575896755,3575896755,0
0,1250,50726,3575896755,3575896755,0
0,1250,50727,3575896755,3575896755,0
0,1250,50728,3575896755,3575896755,0
0,1250,50729,3575896755,3575896755,0
0,1250,50730,3575896755,3575896755,0
0,1250,50731,3575896755,3575896755,0
0,1250,50732,3575896755,3575896755,0
0,1250,50733,3575896755,3575896755,0
0,1250,50734,3575896755,3575896755,0
0,1250,50735,3575896755,3575896755,0
0,1250,50736,3575896755,3575896755,0
0,1250,50737,3575896755,3575896756,1
0,1250,50738,3575896755,3575896756,1
0,1250,50739,3575896755,3575896756,1
0,1250,50740,3575896755,3575896757,2
0,1250,50741,3575896755,3575896758,3
0,1250,50742,3575896755,3575896759,4
0,1250,50743,3575896755,3575896760,5
0,1250,50744,3575896755,3575896760,5
0,1250,50745,3575896755,3575896761,6
0,1250,50746,3575896755,3575896762,7
0,1250,50747,3575896755,3575896762,7
0,1250,50748,3575896755,3575896763,8
0,1250,50749,3575896755,3575896764,9
0,1250,50750,3575896755,3575896764,9
0,1250,50751,3575896755,3575896764,9
0,1250,50752,3575896755,3575896765,10
0,1250,50753,3575896755,3575896765,10
0,1250,50754,3575896755,3575896765,10
0,1250,50755,3575896755,3575896766,11
0,1250,50756,3575896755,3575896769,14
0,1250,50757,3575896755,3575896770,15
0,1250,50758,3575896755,3575896771,16
0,1250,50759,3575896755,3575896771,16
0,1250,50760,3575896755,3575896772,17
0,1250,50761,3575896755,3575896772,17
0,1250,50762,3575896755,3575896773,18
0,1250,50763,3575896755,3575896775,20
0,1250,50764,3575896755,3575896775,20
0,1250,50765,3575896755,3575896776,21
0,1250,50766,3575896755,3575896776,21
0,1250,50767,3575896755,3575896776,21
0,1250,50768,3575896755,3575896777,22
0,1250,50769,3575896755,3575896777,22
0,1250,50770,3575896755,3575896778,23
0,1250,50771,3575896755,3575896778,23
0,1250,50772,3575896755,3575896778,23
0,1250,50773,3575896755,3575896780,25
0,1250,50774,3575896755,3575896780,25
0,1250,50775,3575896755,3575896783,28
0,1250,50776,3575896755,3575896784,29
0,1250,50777,3575896755,3575896785,30
0,1250,50778,3575896755,3575896787,32
0,1250,50779,3575896755,3575896789,34
0,1250,50780,3575896755,3575896789,34
0,1250,50781,3575896755,3575896794,39
0,1250,50782,3575896755,3575896794,39
0,1250,50783,3575896755,3575896798,43
0,1250,50784,3575896755,3575896798,43
0,1250,50785,3575896755,3575896799,44
0,1250,50786,3575896755,3575896800,45
0,1250,50787,3575896755,3575896800,45
0,1250,50788,3575896755,3575896801,46
0,1250,50789,3575896755,3575896802,47
0,1250,50790,3575896755,3575896803,48
0,1250,50791,3575896755,3575896804,49
0,1251,50792,3575896818,3575896818,0
0,1251,50793,3575896818,3575896818,0
0,1251,50794,3575896818,3575896818,0
0,1251,50795,3575896818,3575896818,0
0,1251,50796,3575896818,3575896818,0
0,1251,50797,3575896818,3575896818,0
0,1251,50798,3575896818,3575896818,0
0,1251,50799,3575896818,3575896818,0
0,1251,50800,3575896818,3575896818,0
0,1251,50801,3575896818,3575896818,0
0,1251,50802,3575896818,3575896818,0
0,1251,50803,3575896818,3575896818,0
0,1251,50804,3575896818,3575896818,0
0,1251,50805,3575896818,3575896818,0
0,1251,50806,3575896818,3575896818,0
0,1251,50807,3575896818,3575896818,0
0,1251,50808,3575896818,3575896820,2
0,1251,50809,3575896818,3575896820,2
0,1251,50810,3575896818,3575896820,2
0,1251,50811,3575896818,3575896821,3
0,1251,50812,3575896818,3575896821,3
0,1251,50813,3575896818,3575896822,4
0,1251,50814,3575896818,3575896823,5
0,1251,50815,3575896818,3575896825,7
0,1251,50816,3575896818,3575896827,9
0,1251,50817,3575896818,3575896827,9
0,1251,50818,3575896818,3575896829,11
0,1251,50819,3575896818,3575896829,11
0,1251,50820,3575896818,3575896829,11
0,1251,50821,3575896818,3575896830,12
0,1251,50822,3575896818,3575896831,13
0,1251,50823,3575896818,3575896832,14
0,1251,50824,3575896818,3575896832,14
0,1251,50825,3575896818,3575896832,14
0,1251,50826,3575896818,3575896833,15
0,1251,50827,3575896818,3575896833,15
0,1251,50828,3575896818,3575896833,15
0,1251,50829,3575896818,3575896834,16
0,1251,50830,3575896818,3575896834,16
0,1251,50831,3575896818,3575896835,17
0,1251,50832,3575896818,3575896835,17
0,1251,50833,3575896818,3575896835,17
0,1251,50834,3575896818,3575896837,19
0,1251,50835,3575896818,3575896839,21
0,1251,50836,3575896818,3575896839,21
0,1251,50837,3575896818,3575896840,22
0,1251,50838,3575896818,3575896843,25
0,1251,50839,3575896818,3575896843,25
0,1251,50840,3575896818,3575896843,25
0,1251,50841,3575896818,3575896844,26
0,1251,50842,3575896818,3575896845,27
0,1251,50843,3575896818,3575896846,28
0,1251,50844,3575896818,3575896846,28
0,1251,50845,3575896818,3575896846,28
0,1251,50846,3575896818,3575896848,30
0,1251,50847,3575896818,3575896848,30
0,1251,50848,3575896818,3575896849,31
0,1251,50849,3575896818,3575896850,32
0,1251,50850,3575896818,3575896850,32
0,1251,50851,3575896818,3575896851,33
0,1251,50852,3575896818,3575896851,33
0,1251,50853,3575896818,3575896852,34
0,1251,50854,3575896818,3575896854,36
0,1251,50855,3575896818,3575896855,37
0,1251,50856,3575896818,3575896856,38
0,1251,50857,3575896818,3575896856,38
0,1251,50858,3575896818,3575896856,38
0,1251,50859,3575896818,3575896856,38
0,1251,50860,3575896818,3575896858,40
0,1251,50861,3575896818,3575896859,41
0,1251,50862,3575896818,3575896859,41
0,1251,50863,3575896818,3575896860,42
0,1251,50864,3575896818,3575896861,43
0,1251,50865,3575896818,3575896862,44
0,1251,50866,3575896818,3575896862,44
0,1251,50867,3575896818,3575896863,45
0,1251,50868,3575896818,3575896863,45
0,1251,50869,3575896818,3575896865,47
0,1251,50870,3575896818,3575896865,47
0,1251,50871,3575896818,3575896866,48
0,1251,50872,3575896818,3575896866,48
0,1251,50873,3575896818,3575896866,48
0,1251,50874,3575896818,3575896867,49
0,1252,50875,3575896884,3575896884,0
0,1252,50876,3575896884,3575896884,0
0,1252,50877,3575896884,3575896884,0
0,1252,50878,3575896884,3575896884,0
0,1252,50879,3575896884,3575896884,0
0,1252,50880,3575896884,3575896884,0
0,1252,50881,3575896884,3575896884,0
0,1252,50882,3575896884,3575896884,0
0,1252,50883,3575896884,3575896887,3
0,1252,50884,3575896884,3575896888,4
0,1252,50885,3575896884,3575896889,5
0,1252,50886,3575896884,3575896889,5
0,1252,50887,3575896884,3575896889,5
0,1252,50888,3575896884,3575896889,5
0,1252,50889,3575896884,3575896890,6
0,1252,50890,3575896884,3575896891,7
0,1252,50891,3575896884,3575896891,7
0,1252,50892,3575896884,3575896892,8
0,1252,50893,3575896884,3575896893,9
0,1252,50894,3575896884,3575896896,12
0,1252,50895,3575896884,3575896896,12
0,1252,50896,3575896884,3575896896,12
0,1252,50897,3575896884,3575896896,12
0,1252,50898,3575896884,3575896896,12
0,1252,50899,3575896884,3575896897,13
0,1252,50900,3575896884,3575896899,15
0,1252,50901,3575896884,3575896899,15
0,1252,50902,3575896884,3575896899,15
0,1252,50903,3575896884,3575896900,16
0,1252,50904,3575896884,3575896901,17
0,1252,50905,3575896884,3575896901,17
0,1252,50906,3575896884,3575896902,18
0,1252,50907,3575896884,3575896902,18
0,1252,50908,3575896884,3575896903,19
0,1252,50909,3575896884,3575896903,19
0,1252,50910,3575896884,3575896903,19
0,1252,50911,3575896884,3575896904,20
0,1252,50912,3575896884,3575896905,21
0,1252,50913,3575896884,3575896906,22
0,1252,50914,3575896884,3575896907,23
0,1252,50915,3575896884,3575896908,24
0,1252,50916,3575896884,3575896908,24
0,1252,50917,3575896884,3575896910,26
0,1252,50918,3575896884,3575896910,26
0,1252,50919,3575896884,3575896910,26
0,1252,50920,3575896884,3575896911,27
0,1252,50921,3575896884,3575896913,29
0,1252,50922,3575896884,3575896914,30
0,1252,50923,3575896884,3575896914,30
0,1252,50924,3575896884,3575896914,30
0,1252,50925,3575896884,3575896916,32
0,1252,50926,3575896884,3575896916,32
0,1252,50927,3575896884,3575896916,32
0,1252,50928,3575896884,3575896917,33
0,1252,50929,3575896884,3575896917,33
0,1252,50930,3575896884,3575896917,33
0,1252,50931,3575896884,3575896918,34
0,1252,50932,3575896884,3575896918,34
0,1252,50933,3575896884,3575896918,34
0,1252,50934,3575896884,3575896919,35
0,1252,50935,3575896884,3575896919,35
0,1252,50936,3575896884,3575896920,36
0,1252,50937,3575896884,3575896921,37
0,1252,50938,3575896884,3575896921,37
0,1252,50939,3575896884,3575896922,38
0,1252,50940,3575896884,3575896923,39
0,1252,50941,3575896884,3575896923,39
0,1252,50942,3575896884,3575896924,40
0,1252,50943,3575896884,3575896924,40
0,1252,50944,3575896884,3575896925,41
0,1252,50945,3575896884,3575896925,41
0,1252,50946,3575896884,3575896925,41
0,1252,50947,3575896884,3575896926,42
0,1252,50948,3575896884,3575896927,43
0,1252,50949,3575896884,3575896927,43
0,1252,50950,3575896884,3575896927,43
0,1252,50951,3575896884,3575896928,44
0,1252,50952,3575896884,3575896928,44
0,1252,50953,3575896884,3575896929,45
0,1252,50954,3575896884,3575896929,45
0,1252,50955,3575896884,3575896930,46
0,1252,50956,3575896884,3575896931,47
0,1252,50957,3575896884,3575896931,47
0,1252,50958,3575896884,3575896931,47
0,1252,50959,3575896884,3575896933,49
0,1252,50960,3575896884,3575896933,49
0,1252,50961,3575896884,3575896934,50
0,1253,50962,3575896946,3575896946,0
0,1253,50963,3575896946,3575896946,0
0,1253,50964,3575896946,3575896946,0
0,1253,50965,3575896946,3575896946,0
0,1253,50966,3575896946,3575896946,0
0,1253,50967,3575896946,3575896946,0
0,1253,50968,3575896946,3575896946,0
0,1253,50969,3575896946,3575896946,0
0,1253,50970,3575896946,3575896946,0
0,1253,50971,3575896946,3575896946,0
0,1253,50972,3575896946,3575896947,1
0,1253,50973,3575896946,3575896947,1
0,1253,50974,3575896946,3575896947,1
0,1253,50975,3575896946,3575896947,1
0,1253,50976,3575896946,3575896947,1
0,1253,50977,3575896946,3575896947,1
0,1253,50978,3575896946,3575896947,1
0,1253,50979,3575896946,3575896947,1
0,1253,50980,3575896946,3575896947,1
0,1253,50981,3575896946,3575896948,2
0,1253,50982,3575896946,3575896948,2
0,1253,50983,3575896946,3575896948,2
0,1253,50984,3575896946,3575896948,2
0,1253,50985,3575896946,3575896948,2
0,1253,50986,3575896946,3575896952,6
0,1253,50987,3575896946,3575896953,7
0,1253,50988,3575896946,3575896953,7
0,1253,50989,3575896946,3575896953,7
0,1253,50990,3575896946,3575896954,8
0,1253,50991,3575896946,3575896955,9
0,1253,50992,3575896946,3575896955,9
0,1253,50993,3575896946,3575896956,10
0,1253,50994,3575896946,3575896956,10
0,1253,50995,3575896946,3575896957,11
0,1253,50996,3575896946,3575896957,11
0,1253,50997,3575896946,3575896958,12
0,1253,50998,3575896946,3575896959,13
0,1253,50999,3575896946,3575896960,14
0,1253,51000,3575896946,3575896961,15
0,1253,51001,3575896946,3575896961,15
0,1253,51002,3575896946,3575896962,16
0,1253,51003,3575896946,3575896962,16
0,1253,51004,3575896946,3575896963,17
0,1253,51005,3575896946,3575896964,18
0,1253,51006,3575896946,3575896965,19
0,1253,51007,3575896946,3575896966,20
0,1253,51008,3575896946,3575896966,20
0,1253,51009,3575896946,3575896966,20
0,1253,51010,3575896946,3575896966,20
0,1253,51011,3575896946,3575896970,24
0,1253,51012,3575896946,3575896970,24
0,1253,51013,3575896946,3575896971,25
0,1253,51014,3575896946,3575896971,25
0,1253,51015,3575896946,3575896972,26
0,1253,51016,3575896946,3575896972,26
0,1253,51017,3575896946,3575896973,27
0,1253,51018,3575896946,3575896973,27
0,1253,51019,3575896946,3575896976,30
0,1253,51020,3575896946,3575896976,30
0,1253,51021,3575896946,3575896976,30
0,1253,51022,3575896946,3575896977,31
0,1253,51023,3575896946,3575896977,31
0,1253,51024,3575896946,3575896977,31
0,1253,51025,3575896946,3575896977,31
0,1253,51026,3575896946,3575896978,32
0,1253,51027,3575896946,3575896978,32
0,1253,51028,3575896946,3575896980,34
0,1253,51029,3575896946,3575896982,36
0,1253,51030,3575896946,3575896984,38
0,1253,51031,3575896946,3575896984,38
0,1253,51032,3575896946,3575896984,38
0,1253,51033,3575896946,3575896985,39
0,1253,51034,3575896946,3575896986,40
0,1253,51035,3575896946,3575896987,41
0,1253,51036,3575896946,3575896989,43
0,1253,51037,3575896946,3575896990,44
0,1253,51038,3575896946,3575896990,44
0,1253,51039,3575896946,3575896994,48
0,1253,51040,3575896946,3575896994,48
0,1254,51041,3575897014,3575897014,0
0,1254,51042,3575897014,3575897014,0
0,1254,51043,3575897014,3575897014,0
0,1254,51044,3575897014,3575897014,0
0,1254,51045,3575897014,3575897014,0
0,1254,51046,3575897014,3575897014,0
0,1254,51047,3575897014,3575897014,0
0,1254,51048,3575897014,3575897014,0
0,1254,51049,3575897014,3575897014,0
0,1254,51050,3575897014,3575897014,0
0,1254,51051,3575897014,3575897014,0
0,1254,51052,3575897014,3575897014,0
0,1254,51053,3575897014,3575897014,0
0,1254,51054,3575897014,3575897014,0
0,1254,51055,3575897014,3575897014,0
0,1254,51056,3575897014,3575897014,0
0,1254,51057,3575897014,3575897014,0
0,1254,51058,3575897014,3575897014,0
0,1254,51059,3575897014,3575897014,0
0,1254,51060,3575897014,3575897014,0
0,1254,51061,3575897014,3575897014,0
0,1254,51062,3575897014,3575897014,0
0,1254,51063,3575897014,3575897015,1
0,1254,51064,3575897014,3575897015,1
0,1254,51065,3575897014,3575897016,2
0,1254,51066,3575897014,3575897017,3
0,1254,51067,3575897014,3575897017,3
0,1254,51068,3575897014,3575897018,4
0,1254,51069,3575897014,3575897020,6
0,1254,51070,3575897014,3575897021,7
0,1254,51071,3575897014,3575897021,7
0,1254,51072,3575897014,3575897023,9
0,1254,51073,3575897014,3575897023,9
0,1254,51074,3575897014,3575897025,11
0,1254,51075,3575897014,3575897027,13
0,1254,51076,3575897014,3575897028,14
0,1254,51077,3575897014,3575897028,14
0,1254,51078,3575897014,3575897029,15
0,1254,51079,3575897014,3575897029,15
0,1254,51080,3575897014,3575897031,17
0,1254,51081,3575897014,3575897032,18
0,1254,51082,3575897014,3575897032,18
0,1254,51083,3575897014,3575897032,18
0,1254,51084,3575897014,3575897032,18
0,1254,51085,3575897014,3575897032,18
0,1254,51086,3575897014,3575897032,18
0,1254,51087,3575897014,3575897033,19
0,1254,51088,3575897014,3575897034,20
0,1254,51089,3575897014,3575897034,20
0,1254,51090,3575897014,3575897034,20
0,1254,51091,3575897014,3575897035,21
0,1254,51092,3575897014,3575897035,21
0,1254,51093,3575897014,3575897036,22
0,1254,51094,3575897014,3575897036,22
0,1254,51095,3575897014,3575897037,23
0,1254,51096,3575897014,3575897039,25
0,1254,51097,3575897014,3575897039,25
0,1254,51098,3575897014,3575897040,26
0,1254,51099,3575897014,3575897041,27
0,1254,51100,3575897014,3575897042,28
0,1254,51101,3575897014,3575897043,29
0,1254,51102,3575897014,3575897046,32
0,1254,51103,3575897014,3575897046,32
0,1254,51104,3575897014,3575897046,32
0,1254,51105,3575897014,3575897047,33
0,1254,51106,3575897014,3575897047,33
0,1254,51107,3575897014,3575897048,34
0,1254,51108,3575897014,3575897048,34
0,1254,51109,3575897014,3575897050,36
0,1254,51110,3575897014,3575897052,38
0,1254,51111,3575897014,3575897053,39
0,1254,51112,3575897014,3575897053,39
0,1254,51113,3575897014,3575897054,40
0,1254,51114,3575897014,3575897054,40
0,1254,51115,3575897014,3575897055,41
0,1254,51116,3575897014,3575897056,42
0,1254,51117,3575897014,3575897057,43
0,1254,51118,3575897014,3575897058,44
0,1254,51119,3575897014,3575897059,45
0,1254,51120,3575897014,3575897060,46
0,1254,51121,3575897014,3575897060,46
0,1254,51122,3575897014,3575897061,47
0,1254,51123,3575897014,3575897061,47
0,1254,51124,3575897014,3575897061,47
0,1254,51125,3575897014,3575897061,47
0,1254,51126,3575897014,3575897062,48
0,1254,51127,3575897014,3575897063,49
0,1254,51128,3575897014,3575897063,49
0,1255,51129,3575897078,3575897078,0
0,1255,51130,3575897078,3575897078,0
0,1255,51131,3575897078,3575897078,0
0,1255,51132,3575897078,3575897078,0
0,1255,51133,3575897078,3575897078,0
0,1255,51134,3575897078,3575897078,0
0,1255,51135,3575897078,3575897078,0
0,1255,51136,3575897078,3575897078,0
0,1255,51137,3575897078,3575897078,0
0,1255,51138,3575897078,3575897078,0
0,1255,51139,3575897078,3575897078,0
0,1255,51140,3575897078,3575897080,2
0,1255,51141,3575897078,3575897082,4
0,1255,51142,3575897078,3575897089,11
0,1255,51143,3575897078,3575897089,11
0,1255,51144,3575897078,3575897090,12
0,1255,51145,3575897078,3575897091,13
0,1255,51146,3575897078,3575897091,13
0,1255,51147,3575897078,3575897091,13
0,1255,51148,3575897078,3575897092,14
0,1255,51149,3575897078,3575897092,14
0,1255,51150,3575897078,3575897093,15
0,1255,51151,3575897078,3575897093,15
0,1255,51152,3575897078,3575897095,17
0,1255,51153,3575897078,3575897095,17
0,1255,51154,3575897078,3575897096,18
0,1255,51155,3575897078,3575897096,18
0,1255,51156,3575897078,3575897096,18
0,1255,51157,3575897078,3575897097,19
0,1255,51158,3575897078,3575897097,19
0,1255,51159,3575897078,3575897097,19
0,1255,51160,3575897078,3575897098,20
0,1255,51161,3575897078,3575897098,20
0,1255,51162,3575897078,3575897099,21
0,1255,51163,3575897078,3575897101,23
0,1255,51164,3575897078,3575897102,24
0,1255,51165,3575897078,3575897102,24
0,1255,51166,3575897078,3575897102,24
0,1255,51167,3575897078,3575897102,24
0,1255,51168,3575897078,3575897103,25
0,1255,51169,3575897078,3575897104,26
0,1255,51170,3575897078,3575897104,26
0,1255,51171,3575897078,3575897104,26
0,1255,51172,3575897078,3575897105,27
0,1255,51173,3575897078,3575897105,27
0,1255,51174,3575897078,3575897107,29
0,1255,51175,3575897078,3575897108,30
0,1255,51176,3575897078,3575897108,30
0,1255,51177,3575897078,3575897109,31
0,1255,51178,3575897078,3575897110,32
0,1255,51179,3575897078,3575897110,32
0,1255,51180,3575897078,3575897110,32
0,1255,51181,3575897078,3575897110,32
0,1255,51182,3575897078,3575897111,33
0,1255,51183,3575897078,3575897113,35
0,1255,51184,3575897078,3575897114,36
0,1255,51185,3575897078,3575897115,37
0,1255,51186,3575897078,3575897115,37
0,1255,51187,3575897078,3575897115,37
0,1255,51188,3575897078,3575897116,38
0,1255,51189,3575897078,3575897117,39
0,1255,51190,3575897078,3575897117,39
0,1255,51191,3575897078,3575897118,40
0,1255,51192,3575897078,3575897118,40
0,1255,51193,3575897078,3575897118,40
0,1255,51194,3575897078,3575897118,40
0,1255,51195,3575897078,3575897119,41
0,1255,51196,3575897078,3575897120,42
0,1255,51197,3575897078,3575897120,42
0,1255,51198,3575897078,3575897122,44
0,1255,51199,3575897078,3575897122,44
0,1255,51200,3575897078,3575897122,44
0,1255,51201,3575897078,3575897122,44
0,1255,51202,3575897078,3575897122,44
0,1255,51203,3575897078,3575897123,45
0,1255,51204,3575897078,3575897124,46
0,1255,51205,3575897078,3575897125,47
0,1255,51206,3575897078,3575897125,47
0,1255,51207,3575897078,3575897126,48
0,1255,51208,3575897078,3575897126,48
0,1255,51209,3575897078,3575897126,48
0,1255,51210,3575897078,3575897128,50
0,1256,51211,3575897142,3575897142,0
0,1256,51212,3575897142,3575897142,0
0,1256,51213,3575897142,3575897142,0
0,1256,51214,3575897142,3575897142,0
0,1256,51215,3575897142,3575897142,0
0,1256,51216,3575897142,3575897142,0
0,1256,51217,3575897142,3575897142,0
0,1256,51218,3575897142,3575897142,0
0,1256,51219,3575897142,3575897142,0
0,1256,51220,3575897142,3575897142,0
0,1256,51221,3575897142,3575897142,0
0,1256,51222,3575897142,3575897142,0
0,1256,51223,3575897142,3575897142,0
0,1256,51224,3575897142,3575897142,0
0,1256,51225,3575897142,3575897142,0
0,1256,51226,3575897142,3575897142,0
0,1256,51227,3575897142,3575897142,0
0,1256,51228,3575897142,3575897142,0
0,1256,51229,3575897142,3575897142,0
0,1256,51230,3575897142,3575897142,0
0,1256,51231,3575897142,3575897142,0
0,1256,51232,3575897142,3575897142,0
0,1256,51233,3575897142,3575897142,0
0,1256,51234,3575897142,3575897142,0
0,1256,51235,3575897142,3575897142,0
0,1256,51236,3575897142,3575897143,1
0,1256,51237,3575897142,3575897146,4
0,1256,51238,3575897142,3575897146,4
0,1256,51239,3575897142,3575897146,4
0,1256,51240,3575897142,3575897147,5
0,1256,51241,3575897142,3575897148,6
0,1256,51242,3575897142,3575897148,6
0,1256,51243,3575897142,3575897148,6
0,1256,51244,3575897142,3575897148,6
0,1256,51245,3575897142,3575897152,10
0,1256,51246,3575897142,3575897152,10
0,1256,51247,3575897142,3575897153,11
0,1256,51248,3575897142,3575897153,11
0,1256,51249,3575897142,3575897154,12
0,1256,51250,3575897142,3575897154,12
0,1256,51251,3575897142,3575897155,13
0,1256,51252,3575897142,3575897155,13
0,1256,51253,3575897142,3575897156,14
0,1256,51254,3575897142,3575897157,15
0,1256,51255,3575897142,3575897157,15
0,1256,51256,3575897142,3575897157,15
0,1256,51257,3575897142,3575897157,15
0,1256,51258,3575897142,3575897159,17
0,1256,51259,3575897142,3575897161,19
0,1256,51260,3575897142,3575897161,19
0,1256,51261,3575897142,3575897162,20
0,1256,51262,3575897142,3575897162,20
0,1256,51263,3575897142,3575897163,21
0,1256,51264,3575897142,3575897164,22
0,1256,51265,3575897142,3575897164,22
0,1256,51266,3575897142,3575897165,23
0,1256,51267,3575897142,3575897166,24
0,1256,51268,3575897142,3575897167,25
0,1256,51269,3575897142,3575897167,25
0,1256,51270,3575897142,3575897170,28
0,1256,51271,3575897142,3575897170,28
0,1256,51272,3575897142,3575897171,29
0,1256,51273,3575897142,3575897172,30
0,1256,51274,3575897142,3575897172,30
0,1256,51275,3575897142,3575897173,31
0,1256,51276,3575897142,3575897174,32
0,1256,51277,3575897142,3575897174,32
0,1256,51278,3575897142,3575897176,34
0,1256,51279,3575897142,3575897176,34
0,1256,51280,3575897142,3575897177,35
0,1256,51281,3575897142,3575897177,35
0,1256,51282,3575897142,3575897177,35
0,1256,51283,3575897142,3575897178,36
0,1256,51284,3575897142,3575897178,36
0,1256,51285,3575897142,3575897178,36
0,1256,51286,3575897142,3575897178,36
0,1256,51287,3575897142,3575897180,38
0,1256,51288,3575897142,3575897183,41
0,1256,51289,3575897142,3575897183,41
0,1256,51290,3575897142,3575897184,42
0,1256,51291,3575897142,3575897185,43
0,1256,51292,3575897142,3575897186,44
0,1256,51293,3575897142,3575897188,46
0,1256,51294,3575897142,3575897189,47
0,1256,51295,3575897142,3575897189,47
0,1257,51296,3575897209,3575897209,0
0,1257,51297,3575897209,3575897210,1
0,1257,51298,3575897209,3575897210,1
0,1257,51299,3575897209,3575897210,1
0,1257,51300,3575897209,3575897210,1
0,1257,51301,3575897209,3575897210,1
0,1257,51302,3575897209,3575897210,1
0,1257,51303,3575897209,3575897210,1
0,1257,51304,3575897209,3575897210,1
0,1257,51305,3575897209,3575897210,1
0,1257,51306,3575897209,3575897210,1
0,1257,51307,3575897209,3575897210,1
0,1257,51308,3575897209,3575897211,2
0,1257,51309,3575897209,3575897211,2
0,1257,51310,3575897209,3575897211,2
0,1257,51311,3575897209,3575897212,3
0,1257,51312,3575897209,3575897213,4
0,1257,51313,3575897209,3575897213,4
0,1257,51314,3575897209,3575897215,6
0,1257,51315,3575897209,3575897216,7
0,1257,51316,3575897209,3575897216,7
0,1257,51317,3575897209,3575897216,7
0,1257,51318,3575897209,3575897218,9
0,1257,51319,3575897209,3575897218,9
0,1257,51320,3575897209,3575897221,12
0,1257,51321,3575897209,3575897221,12
0,1257,51322,3575897209,3575897221,12
0,1257,51323,3575897209,3575897222,13
0,1257,51324,3575897209,3575897223,14
0,1257,51325,3575897209,3575897223,14
0,1257,51326,3575897209,3575897226,17
0,1257,51327,3575897209,3575897227,18
0,1257,51328,3575897209,3575897228,19
0,1257,51329,3575897209,3575897228,19
0,1257,51330,3575897209,3575897229,20
0,1257,51331,3575897209,3575897229,20
0,1257,51332,3575897209,3575897230,21
0,1257,51333,3575897209,3575897231,22
0,1257,51334,3575897209,3575897232,23
0,1257,51335,3575897209,3575897233,24
0,1257,51336,3575897209,3575897233,24
0,1257,51337,3575897209,3575897233,24
0,1257,51338,3575897209,3575897233,24
0,1257,51339,3575897209,3575897233,24
0,1257,51340,3575897209,3575897234,25
0,1257,51341,3575897209,3575897234,25
0,1257,51342,3575897209,3575897234,25
0,1257,51343,3575897209,3575897234,25
0,1257,51344,3575897209,3575897235,26
0,1257,51345,3575897209,3575897235,26
0,1257,51346,3575897209,3575897236,27
0,1257,51347,3575897209,3575897237,28
0,1257,51348,3575897209,3575897240,31
0,1257,51349,3575897209,3575897242,33
0,1257,51350,3575897209,3575897243,34
0,1257,51351,3575897209,3575897243,34
0,1257,51352,3575897209,3575897245,36
0,1257,51353,3575897209,3575897246,37
0,1257,51354,3575897209,3575897247,38
0,1257,51355,3575897209,3575897247,38
0,1257,51356,3575897209,3575897247,38
0,1257,51357,3575897209,3575897248,39
0,1257,51358,3575897209,3575897250,41
0,1257,51359,3575897209,3575897250,41
0,1257,51360,3575897209,3575897251,42
0,1257,51361,3575897209,3575897252,43
0,1257,51362,3575897209,3575897252,43
0,1257,51363,3575897209,3575897253,44
0,1257,51364,3575897209,3575897255,46
0,1257,51365,3575897209,3575897256,47
0,1257,51366,3575897209,3575897257,48
0,1257,51367,3575897209,3575897257,48
0,1257,51368,3575897209,3575897257,48
0,1257,51369,3575897209,3575897259,50
0,1258,51370,3575897271,3575897271,0
0,1258,51371,3575897271,3575897271,0
0,1258,51372,3575897271,3575897271,0
0,1258,51373,3575897271,3575897271,0
0,1258,51374,3575897271,3575897271,0
0,1258,51375,3575897271,3575897271,0
0,1258,51376,3575897271,3575897271,0
0,1258,51377,3575897271,3575897272,1
0,1258,51378,3575897271,3575897272,1
0,1258,51379,3575897271,3575897272,1
0,1258,51380,3575897271,3575897272,1
0,1258,51381,3575897271,3575897272,1
0,1258,51382,3575897271,3575897272,1
0,1258,51383,3575897271,3575897278,7
0,1258,51384,3575897271,3575897278,7
0,1258,51385,3575897271,3575897280,9
0,1258,51386,3575897271,3575897282,11
0,1258,51387,3575897271,3575897282,11
0,1258,51388,3575897271,3575897283,12
0,1258,51389,3575897271,3575897287,16
0,1258,51390,3575897271,3575897289,18
0,1258,51391,3575897271,3575897289,18
0,1258,51392,3575897271,3575897289,18
0,1258,51393,3575897271,3575897289,18
0,1258,51394,3575897271,3575897291,20
0,1258,51395,3575897271,3575897291,20
0,1258,51396,3575897271,3575897292,21
0,1258,51397,3575897271,3575897292,21
0,1258,51398,3575897271,3575897293,22
0,1258,51399,3575897271,3575897293,22
0,1258,51400,3575897271,3575897295,24
0,1258,51401,3575897271,3575897296,25
0,1258,51402,3575897271,3575897296,25
0,1258,51403,3575897271,3575897297,26
0,1258,51404,3575897271,3575897298,27
0,1258,51405,3575897271,3575897298,27
0,1258,51406,3575897271,3575897298,27
0,1258,51407,3575897271,3575897301,30
0,1258,51408,3575897271,3575897301,30
0,1258,51409,3575897271,3575897302,31
0,1258,51410,3575897271,3575897302,31
0,1258,51411,3575897271,3575897303,32
0,1258,51412,3575897271,3575897303,32
0,1258,51413,3575897271,3575897303,32
0,1258,51414,3575897271,3575897304,33
0,1258,51415,3575897271,3575897304,33
0,1258,51416,3575897271,3575897305,34
0,1258,51417,3575897271,3575897305,34
0,1258,51418,3575897271,3575897306,35
0,1258,51419,3575897271,3575897307,36
0,1258,51420,3575897271,3575897308,37
0,1258,51421,3575897271,3575897308,37
0,1258,51422,3575897271,3575897309,38
0,1258,51423,3575897271,3575897310,39
0,1258,51424,3575897271,3575897310,39
0,1258,51425,3575897271,3575897310,39
0,1258,51426,3575897271,3575897313,42
0,1258,51427,3575897271,3575897314,43
0,1258,51428,3575897271,3575897314,43
0,1258,51429,3575897271,3575897315,44
0,1258,51430,3575897271,3575897315,44
0,1258,51431,3575897271,3575897315,44
0,1258,51432,3575897271,3575897316,45
0,1258,51433,3575897271,3575897317,46
0,1258,51434,3575897271,3575897317,46
0,1258,51435,3575897271,3575897318,47
0,1258,51436,3575897271,3575897318,47
0,1258,51437,3575897271,3575897319,48
0,1258,51438,3575897271,3575897319,48
0,1258,51439,3575897271,3575897319,48
0,1258,51440,3575897271,3575897320,49
0,1258,51441,3575897271,3575897321,50
0,1258,51442,3575897271,3575897321,50
0,1259,51443,3575897337,3575897337,0
0,1259,51444,3575897337,3575897337,0
0,1259,51445,3575897337,3575897337,0
0,1259,51446,3575897337,3575897337,0
0,1259,51447,3575897337,3575897337,0
0,1259,51448,3575897337,3575897337,0
0,1259,51449,3575897337,3575897337,0
0,1259,51450,3575897337,3575897337,0
0,1259,51451,3575897337,3575897337,0
0,1259,51452,3575897337,3575897337,0
0,1259,51453,3575897337,3575897337,0
0,1259,51454,3575897337,3575897337,0
0,1259,51455,3575897337,3575897337,0
0,1259,51456,3575897337,3575897337,0
0,1259,51457,3575897337,3575897337,0
0,1259,51458,3575897337,3575897337,0
0,1259,51459,3575897337,3575897337,0
0,1259,51460,3575897337,3575897337,0
0,1259,51461,3575897337,3575897337,0
0,1259,51462,3575897337,3575897337,0
0,1259,51463,3575897337,3575897337,0
0,1259,51464,3575897337,3575897337,0
0,1259,51465,3575897337,3575897337,0
0,1259,51466,3575897337,3575897337,0
0,1259,51467,3575897337,3575897337,0
0,1259,51468,3575897337,3575897337,0
0,1259,51469,3575897337,3575897338,1
0,1259,51470,3575897337,3575897338,1
0,1259,51471,3575897337,3575897338,1
0,1259,51472,3575897337,3575897339,2
0,1259,51473,3575897337,3575897339,2
0,1259,51474,3575897337,3575897339,2
0,1259,51475,3575897337,3575897340,3
0,1259,51476,3575897337,3575897341,4
0,1259,51477,3575897337,3575897341,4
0,1259,51478,3575897337,3575897341,4
0,1259,51479,3575897337,3575897342,5
0,1259,51480,3575897337,3575897342,5
0,1259,51481,3575897337,3575897343,6
0,1259,51482,3575897337,3575897343,6
0,1259,51483,3575897337,3575897343,6
0,1259,51484,3575897337,3575897346,9
0,1259,51485,3575897337,3575897346,9
0,1259,51486,3575897337,3575897346,9
0,1259,51487,3575897337,3575897346,9
0,1259,51488,3575897337,3575897348,11
0,1259,51489,3575897337,3575897348,11
0,1259,51490,3575897337,3575897348,11
0,1259,51491,3575897337,3575897348,11
0,1259,51492,3575897337,3575897348,11
0,1259,51493,3575897337,3575897352,15
0,1259,51494,3575897337,3575897352,15
0,1259,51495,3575897337,3575897353,16
0,1259,51496,3575897337,3575897353,16
0,1259,51497,3575897337,3575897354,17
0,1259,51498,3575897337,3575897354,17
0,1259,51499,3575897337,3575897355,18
0,1259,51500,3575897337,3575897355,18
0,1259,51501,3575897337,3575897356,19
0,1259,51502,3575897337,3575897356,19
0,1259,51503,3575897337,3575897356,19
0,1259,51504,3575897337,3575897357,20
0,1259,51505,3575897337,3575897357,20
0,1259,51506,3575897337,3575897358,21
0,1259,51507,3575897337,3575897359,22
0,1259,51508,3575897337,3575897360,23
0,1259,51509,3575897337,3575897360,23
0,1259,51510,3575897337,3575897361,24
0,1259,51511,3575897337,3575897361,24
0,1259,51512,3575897337,3575897362,25
0,1259,51513,3575897337,3575897362,25
0,1259,51514,3575897337,3575897364,27
0,1259,51515,3575897337,3575897365,28
0,1259,51516,3575897337,3575897366,29
0,1259,51517,3575897337,3575897366,29
0,1259,51518,3575897337,3575897367,30
0,1259,51519,3575897337,3575897367,30
0,1259,51520,3575897337,3575897367,30
0,1259,51521,3575897337,3575897370,33
0,1259,51522,3575897337,3575897370,33
0,1259,51523,3575897337,3575897372,35
0,1259,51524,3575897337,3575897372,35
0,1259,51525,3575897337,3575897372,35
0,1259,51526,3575897337,3575897373,36
0,1259,51527,3575897337,3575897374,37
0,1259,51528,3575897337,3575897374,37
0,1259,51529,3575897337,3575897376,39
0,1259,51530,3575897337,3575897376,39
0,1259,51531,3575897337,3575897376,39
0,1259,51532,3575897337,3575897377,40
0,1259,51533,3575897337,3575897377,40
0,1259,51534,3575897337,3575897378,41
0,1259,51535,3575897337,3575897378,41
0,1259,51536,3575897337,3575897378,41
0,1259,51537,3575897337,3575897380,43
0,1259,51538,3575897337,3575897384,47
0,1259,51539,3575897337,3575897384,47
0,1259,51540,3575897337,3575897385,48
0,1259,51541,3575897337,3575897385,48
0,1259,51542,3575897337,3575897386,49
0,1260,51543,3575897402,3575897402,0
0,1260,51544,3575897402,3575897402,0
0,1260,51545,3575897402,3575897402,0
0,1260,51546,3575897402,3575897402,0
0,1260,51547,3575897402,3575897402,0
0,1260,51548,3575897402,3575897402,0
0,1260,51549,3575897402,3575897402,0
0,1260,51550,3575897402,3575897402,0
0,1260,51551,3575897402,3575897402,0
0,1260,51552,3575897402,3575897402,0
0,1260,51553,3575897402,3575897402,0
0,1260,51554,3575897402,3575897404,2
0,1260,51555,3575897402,3575897405,3
0,1260,51556,3575897402,3575897406,4
0,1260,51557,3575897402,3575897407,5
0,1260,51558,3575897402,3575897408,6
0,1260,51559,3575897402,3575897409,7
0,1260,51560,3575897402,3575897409,7
0,1260,51561,3575897402,3575897409,7
0,1260,51562,3575897402,3575897410,8
0,1260,51563,3575897402,3575897410,8
0,1260,51564,3575897402,3575897410,8
0,1260,51565,3575897402,3575897412,10
0,1260,51566,3575897402,3575897413,11
0,1260,51567,3575897402,3575897413,11
0,1260,51568,3575897402,3575897416,14
0,1260,51569,3575897402,3575897416,14
0,1260,51570,3575897402,3575897418,16
0,1260,51571,3575897402,3575897419,17
0,1260,51572,3575897402,3575897420,18
0,1260,51573,3575897402,3575897421,19
0,1260,51574,3575897402,3575897421,19
0,1260,51575,3575897402,3575897422,20
0,1260,51576,3575897402,3575897424,22
0,1260,51577,3575897402,3575897428,26
0,1260,51578,3575897402,3575897428,26
0,1260,51579,3575897402,3575897428,26
0,1260,51580,3575897402,3575897429,27
0,1260,51581,3575897402,3575897430,28
0,1260,51582,3575897402,3575897431,29
0,1260,51583,3575897402,3575897432,30
0,1260,51584,3575897402,3575897432,30
0,1260,51585,3575897402,3575897433,31
0,1260,51586,3575897402,3575897433,31
0,1260,51587,3575897402,3575897433,31
0,1260,51588,3575897402,3575897433,31
0,1260,51589,3575897402,3575897434,32
0,1260,51590,3575897402,3575897434,32
0,1260,51591,3575897402,3575897435,33
0,1260,51592,3575897402,3575897435,33
0,1260,51593,3575897402,3575897436,34
0,1260,51594,3575897402,3575897436,34
0,1260,51595,3575897402,3575897437,35
0,1260,51596,3575897402,3575897439,37
0,1260,51597,3575897402,3575897441,39
0,1260,51598,3575897402,3575897442,40
0,1260,51599,3575897402,3575897442,40
0,1260,51600,3575897402,3575897443,41
0,1260,51601,3575897402,3575897443,41
0,1260,51602,3575897402,3575897444,42
0,1260,51603,3575897402,3575897444,42
0,1260,51604,3575897402,3575897446,44
0,1260,51605,3575897402,3575897446,44
0,1260,51606,3575897402,3575897446,44
0,1260,51607,3575897402,3575897447,45
0,1260,51608,3575897402,3575897447,45
0,1260,51609,3575897402,3575897448,46
0,1260,51610,3575897402,3575897448,46
0,1260,51611,3575897402,3575897448,46
0,1260,51612,3575897402,3575897450,48
0,1260,51613,3575897402,3575897451,49
0,1260,51614,3575897402,3575897451,49
0,1261,51615,3575897468,3575897468,0
0,1261,51616,3575897468,3575897468,0
0,1261,51617,3575897468,3575897468,0
0,1261,51618,3575897468,3575897468,0
0,1261,51619,3575897468,3575897468,0
0,1261,51620,3575897468,3575897468,0
0,1261,51621,3575897468,3575897468,0
0,1261,51622,3575897468,3575897468,0
0,1261,51623,3575897468,3575897468,0
0,1261,51624,3575897468,3575897468,0
0,1261,51625,3575897468,3575897468,0
0,1261,51626,3575897468,3575897468,0
0,1261,51627,3575897468,3575897468,0
0,1261,51628,3575897468,3575897468,0
0,1261,51629,3575897468,3575897468,0
0,1261,51630,3575897468,3575897468,0
0,1261,51631,3575897468,3575897468,0
0,1261,51632,3575897468,3575897468,0
0,1261,51633,3575897468,3575897468,0
0,1261,51634,3575897468,3575897468,0
0,1261,51635,3575897468,3575897468,0
0,1261,51636,3575897468,3575897468,0
0,1261,51637,3575897468,3575897470,2
0,1261,51638,3575897468,3575897473,5
0,1261,51639,3575897468,3575897477,9
0,1261,51640,3575897468,3575897478,10
0,1261,51641,3575897468,3575897482,14
0,1261,51642,3575897468,3575897483,15
0,1261,51643,3575897468,3575897483,15
0,1261,51644,3575897468,3575897486,18
0,1261,51645,3575897468,3575897488,20
0,1261,51646,3575897468,3575897489,21
0,1261,51647,3575897468,3575897490,22
0,1261,51648,3575897468,3575897491,23
0,1261,51649,3575897468,3575897491,23
0,1261,51650,3575897468,3575897493,25
0,1261,51651,3575897468,3575897493,25
0,1261,51652,3575897468,3575897493,25
0,1261,51653,3575897468,3575897496,28
0,1261,51654,3575897468,3575897496,28
0,1261,51655,3575897468,3575897496,28
0,1261,51656,3575897468,3575897496,28
0,1261,51657,3575897468,3575897497,29
0,1261,51658,3575897468,3575897497,29
0,1261,51659,3575897468,3575897498,30
0,1261,51660,3575897468,3575897498,30
0,1261,51661,3575897468,3575897499,31
0,1261,51662,3575897468,3575897499,31
0,1261,51663,3575897468,3575897501,33
0,1261,51664,3575897468,3575897502,34
0,1261,51665,3575897468,3575897502,34
0,1261,51666,3575897468,3575897503,35
0,1261,51667,3575897468,3575897503,35
0,1261,51668,3575897468,3575897504,36
0,1261,51669,3575897468,3575897504,36
0,1261,51670,3575897468,3575897504,36
0,1261,51671,3575897468,3575897505,37
0,1261,51672,3575897468,3575897505,37
0,1261,51673,3575897468,3575897507,39
0,1261,51674,3575897468,3575897507,39
0,1261,51675,3575897468,3575897507,39
0,1261,51676,3575897468,3575897508,40
0,1261,51677,3575897468,3575897509,41
0,1261,51678,3575897468,3575897509,41
0,1261,51679,3575897468,3575897510,42
0,1261,51680,3575897468,3575897510,42
0,1261,51681,3575897468,3575897510,42
0,1261,51682,3575897468,3575897511,43
0,1261,51683,3575897468,3575897513,45
0,1261,51684,3575897468,3575897514,46
0,1261,51685,3575897468,3575897514,46
0,1261,51686,3575897468,3575897515,47
0,1261,51687,3575897468,3575897515,47
0,1261,51688,3575897468,3575897515,47
0,1261,51689,3575897468,3575897516,48
0,1261,51690,3575897468,3575897517,49
0,1261,51691,3575897468,3575897517,49
0,1261,51692,3575897468,3575897517,49
0,1261,51693,3575897468,3575897518,50
0,1261,51694,3575897468,3575897518,50
0,1262,51695,3575897531,3575897531,0
0,1262,51696,3575897531,3575897531,0
0,1262,51697,3575897531,3575897531,0
0,1262,51698,3575897531,3575897531,0
0,1262,51699,3575897531,3575897531,0
0,1262,51700,3575897531,3575897531,0
0,1262,51701,3575897531,3575897531,0
0,1262,51702,3575897531,3575897531,0
0,1262,51703,3575897531,3575897531,0
0,1262,51704,3575897531,3575897531,0
0,1262,51705,3575897531,3575897531,0
0,1262,51706,3575897531,3575897531,0
0,1262,51707,3575897531,3575897531,0
0,1262,51708,3575897531,3575897531,0
0,1262,51709,3575897531,3575897531,0
0,1262,51710,3575897531,3575897531,0
0,1262,51711,3575897531,3575897531,0
0,1262,51712,3575897531,3575897531,0
0,1262,51713,3575897531,3575897531,0
0,1262,51714,3575897531,3575897531,0
0,1262,51715,3575897531,3575897531,0
0,1262,51716,3575897531,3575897531,0
0,1262,51717,3575897531,3575897531,0
0,1262,51718,3575897531,3575897532,1
0,1262,51719,3575897531,3575897532,1
0,1262,51720,3575897531,3575897532,1
0,1262,51721,3575897531,3575897532,1
0,1262,51722,3575897531,3575897532,1
0,1262,51723,3575897531,3575897533,2
0,1262,51724,3575897531,3575897533,2
0,1262,51725,3575897531,3575897534,3
0,1262,51726,3575897531,3575897535,4
0,1262,51727,3575897531,3575897536,5
0,1262,51728,3575897531,3575897536,5
0,1262,51729,3575897531,3575897536,5
0,1262,51730,3575897531,3575897537,6
0,1262,51731,3575897531,3575897538,7
0,1262,51732,3575897531,3575897538,7
0,1262,51733,3575897531,3575897538,7
0,1262,51734,3575897531,3575897540,9
0,1262,51735,3575897531,3575897540,9
0,1262,51736,3575897531,3575897540,9
0,1262,51737,3575897531,3575897540,9
0,1262,51738,3575897531,3575897540,9
0,1262,51739,3575897531,3575897541,10
0,1262,51740,3575897531,3575897542,11
0,1262,51741,3575897531,3575897542,11
0,1262,51742,3575897531,3575897543,12
0,1262,51743,3575897531,3575897544,13
0,1262,51744,3575897531,3575897545,14
0,1262,51745,3575897531,3575897545,14
0,1262,51746,3575897531,3575897545,14
0,1262,51747,3575897531,3575897546,15
0,1262,51748,3575897531,3575897547,16
0,1262,51749,3575897531,3575897548,17
0,1262,51750,3575897531,3575897548,17
0,1262,51751,3575897531,3575897552,21
0,1262,51752,3575897531,3575897552,21
0,1262,51753,3575897531,3575897552,21
0,1262,51754,3575897531,3575897553,22
0,1262,51755,3575897531,3575897554,23
0,1262,51756,3575897531,3575897554,23
0,1262,51757,3575897531,3575897555,24
0,1262,51758,3575897531,3575897555,24
0,1262,51759,3575897531,3575897555,24
0,1262,51760,3575897531,3575897556,25
0,1262,51761,3575897531,3575897556,25
0,1262,51762,3575897531,3575897557,26
0,1262,51763,3575897531,3575897558,27
0,1262,51764,3575897531,3575897559,28
0,1262,51765,3575897531,3575897559,28
0,1262,51766,3575897531,3575897560,29
0,1262,51767,3575897531,3575897560,29
0,1262,51768,3575897531,3575897562,31
0,1262,51769,3575897531,3575897562,31
0,1262,51770,3575897531,3575897563,32
0,1262,51771,3575897531,3575897564,33
0,1262,51772,3575897531,3575897565,34
0,1262,51773,3575897531,3575897565,34
0,1262,51774,3575897531,3575897565,34
0,1262,51775,3575897531,3575897565,34
0,1262,51776,3575897531,3575897566,35
0,1262,51777,3575897531,3575897566,35
0,1262,51778,3575897531,3575897570,39
0,1262,51779,3575897531,3575897570,39
0,1262,51780,3575897531,3575897571,40
0,1262,51781,3575897531,3575897571,40
0,1262,51782,3575897531,3575897571,40
0,1262,51783,3575897531,3575897572,41
0,1262,51784,3575897531,3575897572,41
0,1262,51785,3575897531,3575897574,43
0,1262,51786,3575897531,3575897575,44
0,1262,51787,3575897531,3575897575,44
0,1262,51788,3575897531,3575897576,45
0,1262,51789,3575897531,3575897577,46
0,1262,51790,3575897531,3575897577,46
0,1262,51791,3575897531,3575897577,46
0,1262,51792,3575897531,3575897578,47
0,1262,51793,3575897531,3575897580,49
0,1262,51794,3575897531,3575897580,49
0,1263,51795,3575897597,3575897597,0
0,1263,51796,3575897597,3575897597,0
0,1263,51797,3575897597,3575897597,0
0,1263,51798,3575897597,3575897597,0
0,1263,51799,3575897597,3575897597,0
0,1263,51800,3575897597,3575897597,0
0,1263,51801,3575897597,3575897597,0
0,1263,51802,3575897597,3575897597,0
0,1263,51803,3575897597,3575897597,0
0,1263,51804,3575897597,3575897598,1
0,1263,51805,3575897597,3575897598,1
0,1263,51806,3575897597,3575897598,1
0,1263,51807,3575897597,3575897599,2
0,1263,51808,3575897597,3575897600,3
0,1263,51809,3575897597,3575897601,4
0,1263,51810,3575897597,3575897601,4
0,1263,51811,3575897597,3575897603,6
0,1263,51812,3575897597,3575897604,7
0,1263,51813,3575897597,3575897605,8
0,1263,51814,3575897597,3575897605,8
0,1263,51815,3575897597,3575897608,11
0,1263,51816,3575897597,3575897608,11
0,1263,51817,3575897597,3575897608,11
0,1263,51818,3575897597,3575897608,11
0,1263,51819,3575897597,3575897609,12
0,1263,51820,3575897597,3575897610,13
0,1263,51821,3575897597,3575897611,14
0,1263,51822,3575897597,3575897612,15
0,1263,51823,3575897597,3575897613,16
0,1263,51824,3575897597,3575897614,17
0,1263,51825,3575897597,3575897615,18
0,1263,51826,3575897597,3575897615,18
0,1263,51827,3575897597,3575897615,18
0,1263,51828,3575897597,3575897617,20
0,1263,51829,3575897597,3575897618,21
0,1263,51830,3575897597,3575897618,21
0,1263,51831,3575897597,3575897619,22
0,1263,51832,3575897597,3575897620,23
0,1263,51833,3575897597,3575897620,23
0,1263,51834,3575897597,3575897620,23
0,1263,51835,3575897597,3575897620,23
0,1263,51836,3575897597,3575897622,25
0,1263,51837,3575897597,3575897624,27
0,1263,51838,3575897597,3575897626,29
0,1263,51839,3575897597,3575897627,30
0,1263,51840,3575897597,3575897627,30
0,1263,51841,3575897597,3575897628,31
0,1263,51842,3575897597,3575897628,31
0,1263,51843,3575897597,3575897629,32
0,1263,51844,3575897597,3575897629,32
0,1263,51845,3575897597,3575897630,33
0,1263,51846,3575897597,3575897631,34
0,1263,51847,3575897597,3575897631,34
0,1263,51848,3575897597,3575897632,35
0,1263,51849,3575897597,3575897632,35
0,1263,51850,3575897597,3575897632,35
0,1263,51851,3575897597,3575897632,35
0,1263,51852,3575897597,3575897633,36
0,1263,51853,3575897597,3575897633,36
0,1263,51854,3575897597,3575897633,36
0,1263,51855,3575897597,3575897634,37
0,1263,51856,3575897597,3575897635,38
0,1263,51857,3575897597,3575897636,39
0,1263,51858,3575897597,3575897637,40
0,1263,51859,3575897597,3575897639,42
0,1263,51860,3575897597,3575897640,43
0,1263,51861,3575897597,3575897641,44
0,1263,51862,3575897597,3575897641,44
0,1263,51863,3575897597,3575897642,45
0,1263,51864,3575897597,3575897643,46
0,1263,51865,3575897597,3575897644,47
0,1263,51866,3575897597,3575897645,48
0,1263,51867,3575897597,3575897645,48
0,1263,51868,3575897597,3575897645,48
0,1263,51869,3575897597,3575897646,49
0,1263,51870,3575897597,3575897647,50
0,1264,51871,3575897661,3575897661,0
0,1264,51872,3575897661,3575897661,0
0,1264,51873,3575897661,3575897661,0
0,1264,51874,3575897661,3575897661,0
0,1264,51875,3575897661,3575897661,0
0,1264,51876,3575897661,3575897661,0
0,1264,51877,3575897661,3575897661,0
0,1264,51878,3575897661,3575897661,0
0,1264,51879,3575897661,3575897661,0
0,1264,51880,3575897661,3575897661,0
0,1264,51881,3575897661,3575897661,0
0,1264,51882,3575897661,3575897661,0
0,1264,51883,3575897661,3575897661,0
0,1264,51884,3575897661,3575897661,0
0,1264,51885,3575897661,3575897661,0
0,1264,51886,3575897661,3575897661,0
0,1264,51887,3575897661,3575897661,0
0,1264,51888,3575897661,3575897662,1
0,1264,51889,3575897661,3575897662,1
0,1264,51890,3575897661,3575897664,3
0,1264,51891,3575897661,3575897665,4
0,1264,51892,3575897661,3575897665,4
0,1264,51893,3575897661,3575897666,5
0,1264,51894,3575897661,3575897668,7
0,1264,51895,3575897661,3575897670,9
0,1264,51896,3575897661,3575897674,13
0,1264,51897,3575897661,3575897678,17
0,1264,51898,3575897661,3575897680,19
0,1264,51899,3575897661,3575897682,21
0,1264,51900,3575897661,3575897682,21
0,1264,51901,3575897661,3575897686,25
0,1264,51902,3575897661,3575897687,26
0,1264,51903,3575897661,3575897688,27
0,1264,51904,3575897661,3575897689,28
0,1264,51905,3575897661,3575897690,29
0,1264,51906,3575897661,3575897690,29
0,1264,51907,3575897661,3575897690,29
0,1264,51908,3575897661,3575897691,30
0,1264,51909,3575897661,3575897691,30
0,1264,51910,3575897661,3575897692,31
0,1264,51911,3575897661,3575897692,31
0,1264,51912,3575897661,3575897692,31
0,1264,51913,3575897661,3575897692,31
0,1264,51914,3575897661,3575897693,32
0,1264,51915,3575897661,3575897695,34
0,1264,51916,3575897661,3575897696,35
0,1264,51917,3575897661,3575897696,35
0,1264,51918,3575897661,3575897696,35
0,1264,51919,3575897661,3575897697,36
0,1264,51920,3575897661,3575897697,36
0,1264,51921,3575897661,3575897697,36
0,1264,51922,3575897661,3575897698,37
0,1264,51923,3575897661,3575897698,37
0,1264,51924,3575897661,3575897700,39
0,1264,51925,3575897661,3575897701,40
0,1264,51926,3575897661,3575897702,41
0,1264,51927,3575897661,3575897702,41
0,1264,51928,3575897661,3575897704,43
0,1264,51929,3575897661,3575897704,43
0,1264,51930,3575897661,3575897704,43
0,1264,51931,3575897661,3575897704,43
0,1264,51932,3575897661,3575897704,43
0,1264,51933,3575897661,3575897704,43
0,1264,51934,3575897661,3575897704,43
0,1264,51935,3575897661,3575897705,44
0,1264,51936,3575897661,3575897706,45
0,1264,51937,3575897661,3575897707,46
0,1264,51938,3575897661,3575897708,47
0,1264,51939,3575897661,3575897708,47
0,1264,51940,3575897661,3575897709,48
0,1264,51941,3575897661,3575897710,49
0,1264,51942,3575897661,3575897710,49
0,1264,51943,3575897661,3575897710,49
0,1264,51944,3575897661,3575897711,50
0,1265,51945,3575897725,3575897725,0
0,1265,51946,3575897725,3575897725,0
0,1265,51947,3575897725,3575897725,0
0,1265,51948,3575897725,3575897725,0
0,1265,51949,3575897725,3575897725,0
0,1265,51950,3575897725,3575897725,0
0,1265,51951,3575897725,3575897725,0
0,1265,51952,3575897725,3575897725,0
0,1265,51953,3575897725,3575897725,0
0,1265,51954,3575897725,3575897725,0
0,1265,51955,3575897725,3575897725,0
0,1265,51956,3575897725,3575897725,0
0,1265,51957,3575897725,3575897725,0
0,1265,51958,3575897725,3575897725,0
0,1265,51959,3575897725,3575897725,0
0,1265,51960,3575897725,3575897725,0
0,1265,51961,3575897725,3575897725,0
0,1265,51962,3575897725,3575897725,0
0,1265,51963,3575897725,3575897725,0
0,1265,51964,3575897725,3575897725,0
0,1265,51965,3575897725,3575897725,0
0,1265,51966,3575897725,3575897725,0
0,1265,51967,3575897725,3575897725,0
0,1265,51968,3575897725,3575897725,0
0,1265,51969,3575897725,3575897725,0
0,1265,51970,3575897725,3575897725,0
0,1265,51971,3575897725,3575897725,0
0,1265,51972,3575897725,3575897726,1
0,1265,51973,3575897725,3575897726,1
0,1265,51974,3575897725,3575897726,1
0,1265,51975,3575897725,3575897727,2
0,1265,51976,3575897725,3575897727,2
0,1265,51977,3575897725,3575897728,3
0,1265,51978,3575897725,3575897729,4
0,1265,51979,3575897725,3575897729,4
0,1265,51980,3575897725,3575897729,4
0,1265,51981,3575897725,3575897730,5
0,1265,51982,3575897725,3575897730,5
0,1265,51983,3575897725,3575897730,5
0,1265,51984,3575897725,3575897730,5
0,1265,51985,3575897725,3575897732,7
0,1265,51986,3575897725,3575897733,8
0,1265,51987,3575897725,3575897734,9
0,1265,51988,3575897725,3575897735,10
0,1265,51989,3575897725,3575897735,10
0,1265,51990,3575897725,3575897736,11
0,1265,51991,3575897725,3575897736,11
0,1265,51992,3575897725,3575897737,12
0,1265,51993,3575897725,3575897737,12
0,1265,51994,3575897725,3575897737,12
0,1265,51995,3575897725,3575897738,13
0,1265,51996,3575897725,3575897738,13
0,1265,51997,3575897725,3575897738,13
0,1265,51998,3575897725,3575897738,13
0,1265,51999,3575897725,3575897740,15
0,1265,52000,3575897725,3575897740,15
0,1265,52001,3575897725,3575897740,15
0,1265,52002,3575897725,3575897741,16
0,1265,52003,3575897725,3575897741,16
0,1265,52004,3575897725,3575897742,17
0,1265,52005,3575897725,3575897744,19
0,1265,52006,3575897725,3575897744,19
0,1265,52007,3575897725,3575897744,19
0,1265,52008,3575897725,3575897746,21
0,1265,52009,3575897725,3575897746,21
0,1265,52010,3575897725,3575897747,22
0,1265,52011,3575897725,3575897747,22
0,1265,52012,3575897725,3575897747,22
0,1265,52013,3575897725,3575897747,22
0,1265,52014,3575897725,3575897749,24
0,1265,52015,3575897725,3575897752,27
0,1265,52016,3575897725,3575897752,27
0,1265,52017,3575897725,3575897752,27
0,1265,52018,3575897725,3575897752,27
0,1265,52019,3575897725,3575897753,28
0,1265,52020,3575897725,3575897754,29
0,1265,52021,3575897725,3575897754,29
0,1265,52022,3575897725,3575897755,30
0,1265,52023,3575897725,3575897756,31
0,1265,52024,3575897725,3575897756,31
0,1265,52025,3575897725,3575897756,31
0,1265,52026,3575897725,3575897756,31
0,1265,52027,3575897725,3575897759,34
0,1265,52028,3575897725,3575897759,34
0,1265,52029,3575897725,3575897759,34
0,1265,52030,3575897725,3575897759,34
0,1265,52031,3575897725,3575897761,36
0,1265,52032,3575897725,3575897762,37
0,1265,52033,3575897725,3575897762,37
0,1265,52034,3575897725,3575897762,37
0,1265,52035,3575897725,3575897765,40
0,1265,52036,3575897725,3575897765,40
0,1265,52037,3575897725,3575897765,40
0,1265,52038,3575897725,3575897766,41
0,1265,52039,3575897725,3575897766,41
0,1265,52040,3575897725,3575897771,46
0,1265,52041,3575897725,3575897771,46
0,1265,52042,3575897725,3575897771,46
0,1265,52043,3575897725,3575897771,46
0,1265,52044,3575897725,3575897773,48
0,1265,52045,3575897725,3575897774,49
0,1266,52046,3575897791,3575897791,0
0,1266,52047,3575897791,3575897791,0
0,1266,52048,3575897791,3575897791,0
0,1266,52049,3575897791,3575897791,0
0,1266,52050,3575897791,3575897791,0
0,1266,52051,3575897791,3575897791,0
0,1266,52052,3575897791,3575897791,0
0,1266,52053,3575897791,3575897791,0
0,1266,52054,3575897791,3575897791,0
0,1266,52055,3575897791,3575897791,0
0,1266,52056,3575897791,3575897791,0
0,1266,52057,3575897791,3575897791,0
0,1266,52058,3575897791,3575897791,0
0,1266,52059,3575897791,3575897791,0
0,1266,52060,3575897791,3575897791,0
0,1266,52061,3575897791,3575897791,0
0,1266,52062,3575897791,3575897791,0
0,1266,52063,3575897791,3575897792,1
0,1266,52064,3575897791,3575897793,2
0,1266,52065,3575897791,3575897798,7
0,1266,52066,3575897791,3575897799,8
0,1266,52067,3575897791,3575897799,8
0,1266,52068,3575897791,3575897800,9
0,1266,52069,3575897791,3575897800,9
0,1266,52070,3575897791,3575897801,10
0,1266,52071,3575897791,3575897804,13
0,1266,52072,3575897791,3575897805,14
0,1266,52073,3575897791,3575897805,14
0,1266,52074,3575897791,3575897808,17
0,1266,52075,3575897791,3575897808,17
0,1266,52076,3575897791,3575897808,17
0,1266,52077,3575897791,3575897809,18
0,1266,52078,3575897791,3575897810,19
0,1266,52079,3575897791,3575897811,20
0,1266,52080,3575897791,3575897812,21
0,1266,52081,3575897791,3575897813,22
0,1266,52082,3575897791,3575897814,23
0,1266,52083,3575897791,3575897815,24
0,1266,52084,3575897791,3575897816,25
0,1266,52085,3575897791,3575897816,25
0,1266,52086,3575897791,3575897818,27
0,1266,52087,3575897791,3575897818,27
0,1266,52088,3575897791,3575897818,27
0,1266,52089,3575897791,3575897820,29
0,1266,52090,3575897791,3575897820,29
0,1266,52091,3575897791,3575897821,30
0,1266,52092,3575897791,3575897821,30
0,1266,52093,3575897791,3575897821,30
0,1266,52094,3575897791,3575897824,33
0,1266,52095,3575897791,3575897826,35
0,1266,52096,3575897791,3575897826,35
0,1266,52097,3575897791,3575897828,37
0,1266,52098,3575897791,3575897828,37
0,1266,52099,3575897791,3575897828,37
0,1266,52100,3575897791,3575897829,38
0,1266,52101,3575897791,3575897829,38
0,1266,52102,3575897791,3575897832,41
0,1266,52103,3575897791,3575897832,41
0,1266,52104,3575897791,3575897832,41
0,1266,52105,3575897791,3575897832,41
0,1266,52106,3575897791,3575897832,41
0,1266,52107,3575897791,3575897833,42
0,1266,52108,3575897791,3575897833,42
0,1266,52109,3575897791,3575897833,42
0,1266,52110,3575897791,3575897834,43
0,1266,52111,3575897791,3575897834,43
0,1266,52112,3575897791,3575897835,44
0,1266,52113,3575897791,3575897836,45
0,1266,52114,3575897791,3575897837,46
0,1266,52115,3575897791,3575897838,47
0,1266,52116,3575897791,3575897839,48
0,1266,52117,3575897791,3575897839,48
0,1266,52118,3575897791,3575897841,50
0,1267,52119,3575897855,3575897855,0
0,1267,52120,3575897855,3575897855,0
0,1267,52121,3575897855,3575897855,0
0,1267,52122,3575897855,3575897855,0
0,1267,52123,3575897855,3575897855,0
0,1267,52124,3575897855,3575897855,0
0,1267,52125,3575897855,3575897855,0
0,1267,52126,3575897855,3575897855,0
0,1267,52127,3575897855,3575897855,0
0,1267,52128,3575897855,3575897855,0
0,1267,52129,3575897855,3575897855,0
0,1267,52130,3575897855,3575897855,0
0,1267,52131,3575897855,3575897856,1
0,1267,52132,3575897855,3575897856,1
0,1267,52133,3575897855,3575897856,1
0,1267,52134,3575897855,3575897856,1
0,1267,52135,3575897855,3575897856,1
0,1267,52136,3575897855,3575897856,1
0,1267,52137,3575897855,3575897856,1
0,1267,52138,3575897855,3575897856,1
0,1267,52139,3575897855,3575897856,1
0,1267,52140,3575897855,3575897856,1
0,1267,52141,3575897855,3575897859,4
0,1267,52142,3575897855,3575897859,4
0,1267,52143,3575897855,3575897860,5
0,1267,52144,3575897855,3575897861,6
0,1267,52145,3575897855,3575897861,6
0,1267,52146,3575897855,3575897862,7
0,1267,52147,3575897855,3575897863,8
0,1267,52148,3575897855,3575897863,8
0,1267,52149,3575897855,3575897863,8
0,1267,52150,3575897855,3575897864,9
0,1267,52151,3575897855,3575897865,10
0,1267,52152,3575897855,3575897865,10
0,1267,52153,3575897855,3575897865,10
0,1267,52154,3575897855,3575897867,12
0,1267,52155,3575897855,3575897867,12
0,1267,52156,3575897855,3575897867,12
0,1267,52157,3575897855,3575897869,14
0,1267,52158,3575897855,3575897871,16
0,1267,52159,3575897855,3575897874,19
0,1267,52160,3575897855,3575897878,23
0,1267,52161,3575897855,3575897882,27
0,1267,52162,3575897855,3575897882,27
0,1267,52163,3575897855,3575897883,28
0,1267,52164,3575897855,3575897887,32
0,1267,52165,3575897855,3575897887,32
0,1267,52166,3575897855,3575897888,33
0,1267,52167,3575897855,3575897889,34
0,1267,52168,3575897855,3575897890,35
0,1267,52169,3575897855,3575897890,35
0,1267,52170,3575897855,3575897890,35
0,1267,52171,3575897855,3575897891,36
0,1267,52172,3575897855,3575897891,36
0,1267,52173,3575897855,3575897891,36
0,1267,52174,3575897855,3575897892,37
0,1267,52175,3575897855,3575897892,37
0,1267,52176,3575897855,3575897893,38
0,1267,52177,3575897855,3575897893,38
0,1267,52178,3575897855,3575897895,40
0,1267,52179,3575897855,3575897896,41
0,1267,52180,3575897855,3575897896,41
0,1267,52181,3575897855,3575897896,41
0,1267,52182,3575897855,3575897896,41
0,1267,52183,3575897855,3575897897,42
0,1267,52184,3575897855,3575897898,43
0,1267,52185,3575897855,3575897898,43
0,1267,52186,3575897855,3575897898,43
0,1267,52187,3575897855,3575897900,45
0,1267,52188,3575897855,3575897900,45
0,1267,52189,3575897855,3575897901,46
0,1267,52190,3575897855,3575897902,47
0,1267,52191,3575897855,3575897903,48
0,1267,52192,3575897855,3575897903,48
0,1267,52193,3575897855,3575897903,48
0,1267,52194,3575897855,3575897903,48
0,1267,52195,3575897855,3575897904,49
0,1267,52196,3575897855,3575897904,49
0,1267,52197,3575897855,3575897905,50
0,1267,52198,3575897855,3575897905,50
0,1268,52199,3575897922,3575897922,0
0,1268,52200,3575897922,3575897922,0
0,1268,52201,3575897922,3575897922,0
0,1268,52202,3575897922,3575897922,0
0,1268,52203,3575897922,3575897922,0
0,1268,52204,3575897922,3575897922,0
0,1268,52205,3575897922,3575897922,0
0,1268,52206,3575897922,3575897922,0
0,1268,52207,3575897922,3575897922,0
0,1268,52208,3575897922,3575897922,0
0,1268,52209,3575897922,3575897922,0
0,1268,52210,3575897922,3575897922,0
0,1268,52211,3575897922,3575897922,0
0,1268,52212,3575897922,3575897922,0
0,1268,52213,3575897922,3575897922,0
0,1268,52214,3575897922,3575897922,0
0,1268,52215,3575897922,3575897922,0
0,1268,52216,3575897922,3575897922,0
0,1268,52217,3575897922,3575897922,0
0,1268,52218,3575897922,3575897922,0
0,1268,52219,3575897922,3575897922,0
0,1268,52220,3575897922,3575897922,0
0,1268,52221,3575897922,3575897922,0
0,1268,52222,3575897922,3575897922,0
0,1268,52223,3575897922,3575897922,0
0,1268,52224,3575897922,3575897922,0
0,1268,52225,3575897922,3575897922,0
0,1268,52226,3575897922,3575897923,1
0,1268,52227,3575897922,3575897923,1
0,1268,52228,3575897922,3575897923,1
0,1268,52229,3575897922,3575897923,1
0,1268,52230,3575897922,3575897924,2
0,1268,52231,3575897922,3575897924,2
0,1268,52232,3575897922,3575897924,2
0,1268,52233,3575897922,3575897925,3
0,1268,52234,3575897922,3575897925,3
0,1268,52235,3575897922,3575897926,4
0,1268,52236,3575897922,3575897926,4
0,1268,52237,3575897922,3575897927,5
0,1268,52238,3575897922,3575897928,6
0,1268,52239,3575897922,3575897929,7
0,1268,52240,3575897922,3575897929,7
0,1268,52241,3575897922,3575897929,7
0,1268,52242,3575897922,3575897930,8
0,1268,52243,3575897922,3575897931,9
0,1268,52244,3575897922,3575897931,9
0,1268,52245,3575897922,3575897933,11
0,1268,52246,3575897922,3575897934,12
0,1268,52247,3575897922,3575897935,13
0,1268,52248,3575897922,3575897936,14
0,1268,52249,3575897922,3575897936,14
0,1268,52250,3575897922,3575897937,15
0,1268,52251,3575897922,3575897937,15
0,1268,52252,3575897922,3575897938,16
0,1268,52253,3575897922,3575897938,16
0,1268,52254,3575897922,3575897938,16
0,1268,52255,3575897922,3575897939,17
0,1268,52256,3575897922,3575897939,17
0,1268,52257,3575897922,3575897939,17
0,1268,52258,3575897922,3575897940,18
0,1268,52259,3575897922,3575897941,19
0,1268,52260,3575897922,3575897941,19
0,1268,52261,3575897922,3575897942,20
0,1268,52262,3575897922,3575897943,21
0,1268,52263,3575897922,3575897943,21
0,1268,52264,3575897922,3575897944,22
0,1268,52265,3575897922,3575897944,22
0,1268,52266,3575897922,3575897945,23
0,1268,52267,3575897922,3575897946,24
0,1268,52268,3575897922,3575897946,24
0,1268,52269,3575897922,3575897947,25
0,1268,52270,3575897922,3575897947,25
0,1268,52271,3575897922,3575897947,25
0,1268,52272,3575897922,3575897949,27
0,1268,52273,3575897922,3575897952,30
0,1268,52274,3575897922,3575897952,30
0,1268,52275,3575897922,3575897953,31
0,1268,52276,3575897922,3575897953,31
0,1268,52277,3575897922,3575897953,31
0,1268,52278,3575897922,3575897954,32
0,1268,52279,3575897922,3575897955,33
0,1268,52280,3575897922,3575897955,33
0,1268,52281,3575897922,3575897956,34
0,1268,52282,3575897922,3575897956,34
0,1268,52283,3575897922,3575897956,34
0,1268,52284,3575897922,3575897958,36
0,1268,52285,3575897922,3575897959,37
0,1268,52286,3575897922,3575897960,38
0,1268,52287,3575897922,3575897961,39
0,1268,52288,3575897922,3575897961,39
0,1268,52289,3575897922,3575897962,40
0,1268,52290,3575897922,3575897962,40
0,1268,52291,3575897922,3575897962,40
0,1268,52292,3575897922,3575897964,42
0,1268,52293,3575897922,3575897964,42
0,1268,52294,3575897922,3575897965,43
0,1268,52295,3575897922,3575897966,44
0,1268,52296,3575897922,3575897966,44
0,1268,52297,3575897922,3575897966,44
0,1268,52298,3575897922,3575897966,44
0,1268,52299,3575897922,3575897971,49
0,1268,52300,3575897922,3575897971,49
0,1268,52301,3575897922,3575897971,49
0,1268,52302,3575897922,3575897972,50
0,1269,52303,3575897986,3575897986,0
0,1269,52304,3575897986,3575897986,0
0,1269,52305,3575897986,3575897986,0
0,1269,52306,3575897986,3575897986,0
0,1269,52307,3575897986,3575897986,0
0,1269,52308,3575897986,3575897986,0
0,1269,52309,3575897986,3575897986,0
0,1269,52310,3575897986,3575897986,0
0,1269,52311,3575897986,3575897986,0
0,1269,52312,3575897986,3575897986,0
0,1269,52313,3575897986,3575897986,0
0,1269,52314,3575897986,3575897986,0
0,1269,52315,3575897986,3575897986,0
0,1269,52316,3575897986,3575897986,0
0,1269,52317,3575897986,3575897986,0
0,1269,52318,3575897986,3575897986,0
0,1269,52319,3575897986,3575897986,0
0,1269,52320,3575897986,3575897986,0
0,1269,52321,3575897986,3575897986,0
0,1269,52322,3575897986,3575897986,0
0,1269,52323,3575897986,3575897988,2
0,1269,52324,3575897986,3575897990,4
0,1269,52325,3575897986,3575897992,6
0,1269,52326,3575897986,3575897995,9
0,1269,52327,3575897986,3575897998,12
0,1269,52328,3575897986,3575897998,12
0,1269,52329,3575897986,3575897999,13
0,1269,52330,3575897986,3575898000,14
0,1269,52331,3575897986,3575898000,14
0,1269,52332,3575897986,3575898001,15
0,1269,52333,3575897986,3575898001,15
0,1269,52334,3575897986,3575898003,17
0,1269,52335,3575897986,3575898004,18
0,1269,52336,3575897986,3575898004,18
0,1269,52337,3575897986,3575898005,19
0,1269,52338,3575897986,3575898008,22
0,1269,52339,3575897986,3575898008,22
0,1269,52340,3575897986,3575898009,23
0,1269,52341,3575897986,3575898009,23
0,1269,52342,3575897986,3575898009,23
0,1269,52343,3575897986,3575898009,23
0,1269,52344,3575897986,3575898010,24
0,1269,52345,3575897986,3575898011,25
0,1269,52346,3575897986,3575898012,26
0,1269,52347,3575897986,3575898013,27
0,1269,52348,3575897986,3575898014,28
0,1269,52349,3575897986,3575898015,29
0,1269,52350,3575897986,3575898016,30
0,1269,52351,3575897986,3575898017,31
0,1269,52352,3575897986,3575898018,32
0,1269,52353,3575897986,3575898018,32
0,1269,52354,3575897986,3575898020,34
0,1269,52355,3575897986,3575898021,35
0,1269,52356,3575897986,3575898021,35
0,1269,52357,3575897986,3575898022,36
0,1269,52358,3575897986,3575898022,36
0,1269,52359,3575897986,3575898022,36
0,1269,52360,3575897986,3575898024,38
0,1269,52361,3575897986,3575898026,40
0,1269,52362,3575897986,3575898026,40
0,1269,52363,3575897986,3575898029,43
0,1269,52364,3575897986,3575898029,43
0,1269,52365,3575897986,3575898029,43
0,1269,52366,3575897986,3575898029,43
0,1269,52367,3575897986,3575898031,45
0,1269,52368,3575897986,3575898032,46
0,1269,52369,3575897986,3575898032,46
0,1269,52370,3575897986,3575898032,46
0,1269,52371,3575897986,3575898032,46
0,1269,52372,3575897986,3575898033,47
0,1269,52373,3575897986,3575898033,47
0,1269,52374,3575897986,3575898033,47
0,1269,52375,3575897986,3575898035,49
0,1270,52376,3575898052,3575898052,0
0,1270,52377,3575898052,3575898052,0
0,1270,52378,3575898052,3575898052,0
0,1270,52379,3575898052,3575898052,0
0,1270,52380,3575898052,3575898052,0
0,1270,52381,3575898052,3575898052,0
0,1270,52382,3575898052,3575898052,0
0,1270,52383,3575898052,3575898052,0
0,1270,52384,3575898052,3575898052,0
0,1270,52385,3575898052,3575898052,0
0,1270,52386,3575898052,3575898052,0
0,1270,52387,3575898052,3575898052,0
0,1270,52388,3575898052,3575898052,0
0,1270,52389,3575898052,3575898052,0
0,1270,52390,3575898052,3575898052,0
0,1270,52391,3575898052,3575898052,0
0,1270,52392,3575898052,3575898052,0
0,1270,52393,3575898052,3575898052,0
0,1270,52394,3575898052,3575898052,0
0,1270,52395,3575898052,3575898052,0
0,1270,52396,3575898052,3575898052,0
0,1270,52397,3575898052,3575898052,0
0,1270,52398,3575898052,3575898054,2
0,1270,52399,3575898052,3575898054,2
0,1270,52400,3575898052,3575898056,4
0,1270,52401,3575898052,3575898057,5
0,1270,52402,3575898052,3575898059,7
0,1270,52403,3575898052,3575898060,8
0,1270,52404,3575898052,3575898060,8
0,1270,52405,3575898052,3575898061,9
0,1270,52406,3575898052,3575898061,9
0,1270,52407,3575898052,3575898062,10
0,1270,52408,3575898052,3575898062,10
0,1270,52409,3575898052,3575898063,11
0,1270,52410,3575898052,3575898063,11
0,1270,52411,3575898052,3575898064,12
0,1270,52412,3575898052,3575898065,13
0,1270,52413,3575898052,3575898066,14
0,1270,52414,3575898052,3575898066,14
0,1270,52415,3575898052,3575898067,15
0,1270,52416,3575898052,3575898068,16
0,1270,52417,3575898052,3575898071,19
0,1270,52418,3575898052,3575898074,22
0,1270,52419,3575898052,3575898078,26
0,1270,52420,3575898052,3575898080,28
0,1270,52421,3575898052,3575898082,30
0,1270,52422,3575898052,3575898082,30
0,1270,52423,3575898052,3575898083,31
0,1270,52424,3575898052,3575898087,35
0,1270,52425,3575898052,3575898087,35
0,1270,52426,3575898052,3575898088,36
0,1270,52427,3575898052,3575898090,38
0,1270,52428,3575898052,3575898090,38
0,1270,52429,3575898052,3575898091,39
0,1270,52430,3575898052,3575898091,39
0,1270,52431,3575898052,3575898092,40
0,1270,52432,3575898052,3575898092,40
0,1270,52433,3575898052,3575898092,40
0,1270,52434,3575898052,3575898094,42
0,1270,52435,3575898052,3575898095,43
0,1270,52436,3575898052,3575898096,44
0,1270,52437,3575898052,3575898096,44
0,1270,52438,3575898052,3575898097,45
0,1270,52439,3575898052,3575898097,45
0,1270,52440,3575898052,3575898098,46
0,1270,52441,3575898052,3575898102,50
0,1271,52442,3575898115,3575898115,0
0,1271,52443,3575898115,3575898115,0
0,1271,52444,3575898115,3575898115,0
0,1271,52445,3575898115,3575898115,0
0,1271,52446,3575898115,3575898115,0
0,1271,52447,3575898115,3575898115,0
0,1271,52448,3575898115,3575898115,0
0,1271,52449,3575898115,3575898115,0
0,1271,52450,3575898115,3575898115,0
0,1271,52451,3575898115,3575898115,0
0,1271,52452,3575898115,3575898115,0
0,1271,52453,3575898115,3575898115,0
0,1271,52454,3575898115,3575898115,0
0,1271,52455,3575898115,3575898115,0
0,1271,52456,3575898115,3575898115,0
0,1271,52457,3575898115,3575898115,0
0,1271,52458,3575898115,3575898115,0
0,1271,52459,3575898115,3575898115,0
0,1271,52460,3575898115,3575898115,0
0,1271,52461,3575898115,3575898115,0
0,1271,52462,3575898115,3575898115,0
0,1271,52463,3575898115,3575898115,0
0,1271,52464,3575898115,3575898115,0
0,1271,52465,3575898115,3575898115,0
0,1271,52466,3575898115,3575898115,0
0,1271,52467,3575898115,3575898115,0
0,1271,52468,3575898115,3575898116,1
0,1271,52469,3575898115,3575898116,1
0,1271,52470,3575898115,3575898117,2
0,1271,52471,3575898115,3575898117,2
0,1271,52472,3575898115,3575898118,3
0,1271,52473,3575898115,3575898119,4
0,1271,52474,3575898115,3575898119,4
0,1271,52475,3575898115,3575898119,4
0,1271,52476,3575898115,3575898120,5
0,1271,52477,3575898115,3575898121,6
0,1271,52478,3575898115,3575898121,6
0,1271,52479,3575898115,3575898122,7
0,1271,52480,3575898115,3575898122,7
0,1271,52481,3575898115,3575898123,8
0,1271,52482,3575898115,3575898123,8
0,1271,52483,3575898115,3575898123,8
0,1271,52484,3575898115,3575898123,8
0,1271,52485,3575898115,3575898124,9
0,1271,52486,3575898115,3575898124,9
0,1271,52487,3575898115,3575898124,9
0,1271,52488,3575898115,3575898124,9
0,1271,52489,3575898115,3575898125,10
0,1271,52490,3575898115,3575898126,11
0,1271,52491,3575898115,3575898126,11
0,1271,52492,3575898115,3575898127,12
0,1271,52493,3575898115,3575898129,14
0,1271,52494,3575898115,3575898129,14
0,1271,52495,3575898115,3575898129,14
0,1271,52496,3575898115,3575898130,15
0,1271,52497,3575898115,3575898130,15
0,1271,52498,3575898115,3575898130,15
0,1271,52499,3575898115,3575898131,16
0,1271,52500,3575898115,3575898132,17
0,1271,52501,3575898115,3575898133,18
0,1271,52502,3575898115,3575898134,19
0,1271,52503,3575898115,3575898134,19
0,1271,52504,3575898115,3575898135,20
0,1271,52505,3575898115,3575898136,21
0,1271,52506,3575898115,3575898136,21
0,1271,52507,3575898115,3575898137,22
0,1271,52508,3575898115,3575898137,22
0,1271,52509,3575898115,3575898137,22
0,1271,52510,3575898115,3575898138,23
0,1271,52511,3575898115,3575898138,23
0,1271,52512,3575898115,3575898139,24
0,1271,52513,3575898115,3575898139,24
0,1271,52514,3575898115,3575898140,25
0,1271,52515,3575898115,3575898141,26
0,1271,52516,3575898115,3575898141,26
0,1271,52517,3575898115,3575898142,27
0,1271,52518,3575898115,3575898144,29
0,1271,52519,3575898115,3575898144,29
0,1271,52520,3575898115,3575898144,29
0,1271,52521,3575898115,3575898145,30
0,1271,52522,3575898115,3575898146,31
0,1271,52523,3575898115,3575898146,31
0,1271,52524,3575898115,3575898147,32
0,1271,52525,3575898115,3575898147,32
0,1271,52526,3575898115,3575898147,32
0,1271,52527,3575898115,3575898148,33
0,1271,52528,3575898115,3575898148,33
0,1271,52529,3575898115,3575898151,36
0,1271,52530,3575898115,3575898152,37
0,1271,52531,3575898115,3575898153,38
0,1271,52532,3575898115,3575898153,38
0,1271,52533,3575898115,3575898153,38
0,1271,52534,3575898115,3575898153,38
0,1271,52535,3575898115,3575898155,40
0,1271,52536,3575898115,3575898156,41
0,1271,52537,3575898115,3575898156,41
0,1271,52538,3575898115,3575898156,41
0,1271,52539,3575898115,3575898156,41
0,1271,52540,3575898115,3575898157,42
0,1271,52541,3575898115,3575898159,44
0,1271,52542,3575898115,3575898160,45
0,1271,52543,3575898115,3575898161,46
0,1271,52544,3575898115,3575898161,46
0,1271,52545,3575898115,3575898161,46
0,1271,52546,3575898115,3575898162,47
0,1271,52547,3575898115,3575898162,47
0,1271,52548,3575898115,3575898163,48
0,1271,52549,3575898115,3575898164,49
0,1271,52550,3575898115,3575898165,50
0,1272,52551,3575898178,3575898178,0
0,1272,52552,3575898178,3575898178,0
0,1272,52553,3575898178,3575898178,0
0,1272,52554,3575898178,3575898178,0
0,1272,52555,3575898178,3575898178,0
0,1272,52556,3575898178,3575898178,0
0,1272,52557,3575898178,3575898178,0
0,1272,52558,3575898178,3575898178,0
0,1272,52559,3575898178,3575898178,0
0,1272,52560,3575898178,3575898178,0
0,1272,52561,3575898178,3575898178,0
0,1272,52562,3575898178,3575898178,0
0,1272,52563,3575898178,3575898179,1
0,1272,52564,3575898178,3575898179,1
0,1272,52565,3575898178,3575898179,1
0,1272,52566,3575898178,3575898179,1
0,1272,52567,3575898178,3575898179,1
0,1272,52568,3575898178,3575898179,1
0,1272,52569,3575898178,3575898179,1
0,1272,52570,3575898178,3575898179,1
0,1272,52571,3575898178,3575898179,1
0,1272,52572,3575898178,3575898179,1
0,1272,52573,3575898178,3575898179,1
0,1272,52574,3575898178,3575898180,2
0,1272,52575,3575898178,3575898180,2
0,1272,52576,3575898178,3575898183,5
0,1272,52577,3575898178,3575898183,5
0,1272,52578,3575898178,3575898183,5
0,1272,52579,3575898178,3575898184,6
0,1272,52580,3575898178,3575898186,8
0,1272,52581,3575898178,3575898188,10
0,1272,52582,3575898178,3575898189,11
0,1272,52583,3575898178,3575898190,12
0,1272,52584,3575898178,3575898192,14
0,1272,52585,3575898178,3575898195,17
0,1272,52586,3575898178,3575898198,20
0,1272,52587,3575898178,3575898199,21
0,1272,52588,3575898178,3575898199,21
0,1272,52589,3575898178,3575898200,22
0,1272,52590,3575898178,3575898201,23
0,1272,52591,3575898178,3575898201,23
0,1272,52592,3575898178,3575898204,26
0,1272,52593,3575898178,3575898205,27
0,1272,52594,3575898178,3575898208,30
0,1272,52595,3575898178,3575898208,30
0,1272,52596,3575898178,3575898208,30
0,1272,52597,3575898178,3575898209,31
0,1272,52598,3575898178,3575898210,32
0,1272,52599,3575898178,3575898210,32
0,1272,52600,3575898178,3575898211,33
0,1272,52601,3575898178,3575898211,33
0,1272,52602,3575898178,3575898213,35
0,1272,52603,3575898178,3575898214,36
0,1272,52604,3575898178,3575898215,37
0,1272,52605,3575898178,3575898216,38
0,1272,52606,3575898178,3575898216,38
0,1272,52607,3575898178,3575898217,39
0,1272,52608,3575898178,3575898218,40
0,1272,52609,3575898178,3575898218,40
0,1272,52610,3575898178,3575898219,41
0,1272,52611,3575898178,3575898220,42
0,1272,52612,3575898178,3575898221,43
0,1272,52613,3575898178,3575898221,43
0,1272,52614,3575898178,3575898222,44
0,1272,52615,3575898178,3575898225,47
0,1272,52616,3575898178,3575898226,48
0,1272,52617,3575898178,3575898227,49
0,1273,52618,3575898243,3575898243,0
0,1273,52619,3575898243,3575898243,0
0,1273,52620,3575898243,3575898243,0
0,1273,52621,3575898243,3575898243,0
0,1273,52622,3575898243,3575898243,0
0,1273,52623,3575898243,3575898243,0
0,1273,52624,3575898243,3575898243,0
0,1273,52625,3575898243,3575898243,0
0,1273,52626,3575898243,3575898243,0
0,1273,52627,3575898243,3575898243,0
0,1273,52628,3575898243,3575898243,0
0,1273,52629,3575898243,3575898243,0
0,1273,52630,3575898243,3575898243,0
0,1273,52631,3575898243,3575898243,0
0,1273,52632,3575898243,3575898244,1
0,1273,52633,3575898243,3575898244,1
0,1273,52634,3575898243,3575898244,1
0,1273,52635,3575898243,3575898244,1
0,1273,52636,3575898243,3575898244,1
0,1273,52637,3575898243,3575898244,1
0,1273,52638,3575898243,3575898244,1
0,1273,52639,3575898243,3575898244,1
0,1273,52640,3575898243,3575898244,1
0,1273,52641,3575898243,3575898244,1
0,1273,52642,3575898243,3575898244,1
0,1273,52643,3575898243,3575898244,1
0,1273,52644,3575898243,3575898245,2
0,1273,52645,3575898243,3575898246,3
0,1273,52646,3575898243,3575898246,3
0,1273,52647,3575898243,3575898247,4
0,1273,52648,3575898243,3575898247,4
0,1273,52649,3575898243,3575898247,4
0,1273,52650,3575898243,3575898248,5
0,1273,52651,3575898243,3575898248,5
0,1273,52652,3575898243,3575898250,7
0,1273,52653,3575898243,3575898251,8
0,1273,52654,3575898243,3575898251,8
0,1273,52655,3575898243,3575898251,8
0,1273,52656,3575898243,3575898253,10
0,1273,52657,3575898243,3575898254,11
0,1273,52658,3575898243,3575898256,13
0,1273,52659,3575898243,3575898256,13
0,1273,52660,3575898243,3575898256,13
0,1273,52661,3575898243,3575898256,13
0,1273,52662,3575898243,3575898259,16
0,1273,52663,3575898243,3575898259,16
0,1273,52664,3575898243,3575898261,18
0,1273,52665,3575898243,3575898261,18
0,1273,52666,3575898243,3575898261,18
0,1273,52667,3575898243,3575898261,18
0,1273,52668,3575898243,3575898262,19
0,1273,52669,3575898243,3575898263,20
0,1273,52670,3575898243,3575898264,21
0,1273,52671,3575898243,3575898265,22
0,1273,52672,3575898243,3575898266,23
0,1273,52673,3575898243,3575898267,24
0,1273,52674,3575898243,3575898267,24
0,1273,52675,3575898243,3575898267,24
0,1273,52676,3575898243,3575898268,25
0,1273,52677,3575898243,3575898271,28
0,1273,52678,3575898243,3575898275,32
0,1273,52679,3575898243,3575898279,36
0,1273,52680,3575898243,3575898282,39
0,1273,52681,3575898243,3575898283,40
0,1273,52682,3575898243,3575898284,41
0,1273,52683,3575898243,3575898287,44
0,1273,52684,3575898243,3575898287,44
0,1273,52685,3575898243,3575898288,45
0,1273,52686,3575898243,3575898290,47
0,1273,52687,3575898243,3575898290,47
0,1273,52688,3575898243,3575898290,47
0,1273,52689,3575898243,3575898291,48
0,1273,52690,3575898243,3575898291,48
0,1273,52691,3575898243,3575898292,49
0,1273,52692,3575898243,3575898292,49
0,1273,52693,3575898243,3575898293,50
0,1274,52694,3575898306,3575898306,0
0,1274,52695,3575898306,3575898306,0
0,1274,52696,3575898306,3575898306,0
0,1274,52697,3575898306,3575898306,0
0,1274,52698,3575898306,3575898306,0
0,1274,52699,3575898306,3575898306,0
0,1274,52700,3575898306,3575898306,0
0,1274,52701,3575898306,3575898306,0
0,1274,52702,3575898306,3575898306,0
0,1274,52703,3575898306,3575898306,0
0,1274,52704,3575898306,3575898306,0
0,1274,52705,3575898306,3575898306,0
0,1274,52706,3575898306,3575898306,0
0,1274,52707,3575898306,3575898306,0
0,1274,52708,3575898306,3575898306,0
0,1274,52709,3575898306,3575898306,0
0,1274,52710,3575898306,3575898306,0
0,1274,52711,3575898306,3575898306,0
0,1274,52712,3575898306,3575898306,0
0,1274,52713,3575898306,3575898306,0
0,1274,52714,3575898306,3575898306,0
0,1274,52715,3575898306,3575898308,2
0,1274,52716,3575898306,3575898309,3
0,1274,52717,3575898306,3575898309,3
0,1274,52718,3575898306,3575898310,4
0,1274,52719,3575898306,3575898310,4
0,1274,52720,3575898306,3575898310,4
0,1274,52721,3575898306,3575898310,4
0,1274,52722,3575898306,3575898311,5
0,1274,52723,3575898306,3575898313,7
0,1274,52724,3575898306,3575898314,8
0,1274,52725,3575898306,3575898315,9
0,1274,52726,3575898306,3575898316,10
0,1274,52727,3575898306,3575898317,11
0,1274,52728,3575898306,3575898317,11
0,1274,52729,3575898306,3575898318,12
0,1274,52730,3575898306,3575898318,12
0,1274,52731,3575898306,3575898318,12
0,1274,52732,3575898306,3575898319,13
0,1274,52733,3575898306,3575898319,13
0,1274,52734,3575898306,3575898320,14
0,1274,52735,3575898306,3575898321,15
0,1274,52736,3575898306,3575898322,16
0,1274,52737,3575898306,3575898322,16
0,1274,52738,3575898306,3575898322,16
0,1274,52739,3575898306,3575898322,16
0,1274,52740,3575898306,3575898323,17
0,1274,52741,3575898306,3575898323,17
0,1274,52742,3575898306,3575898324,18
0,1274,52743,3575898306,3575898325,19
0,1274,52744,3575898306,3575898325,19
0,1274,52745,3575898306,3575898325,19
0,1274,52746,3575898306,3575898325,19
0,1274,52747,3575898306,3575898326,20
0,1274,52748,3575898306,3575898326,20
0,1274,52749,3575898306,3575898326,20
0,1274,52750,3575898306,3575898327,21
0,1274,52751,3575898306,3575898329,23
0,1274,52752,3575898306,3575898330,24
0,1274,52753,3575898306,3575898330,24
0,1274,52754,3575898306,3575898331,25
0,1274,52755,3575898306,3575898331,25
0,1274,52756,3575898306,3575898331,25
0,1274,52757,3575898306,3575898332,26
0,1274,52758,3575898306,3575898333,27
0,1274,52759,3575898306,3575898334,28
0,1274,52760,3575898306,3575898335,29
0,1274,52761,3575898306,3575898335,29
0,1274,52762,3575898306,3575898336,30
0,1274,52763,3575898306,3575898337,31
0,1274,52764,3575898306,3575898337,31
0,1274,52765,3575898306,3575898338,32
0,1274,52766,3575898306,3575898338,32
0,1274,52767,3575898306,3575898338,32
0,1274,52768,3575898306,3575898338,32
0,1274,52769,3575898306,3575898339,33
0,1274,52770,3575898306,3575898339,33
0,1274,52771,3575898306,3575898340,34
0,1274,52772,3575898306,3575898341,35
0,1274,52773,3575898306,3575898343,37
0,1274,52774,3575898306,3575898344,38
0,1274,52775,3575898306,3575898345,39
0,1274,52776,3575898306,3575898345,39
0,1274,52777,3575898306,3575898345,39
0,1274,52778,3575898306,3575898346,40
0,1274,52779,3575898306,3575898346,40
0,1274,52780,3575898306,3575898347,41
0,1274,52781,3575898306,3575898347,41
0,1274,52782,3575898306,3575898349,43
0,1274,52783,3575898306,3575898351,45
0,1274,52784,3575898306,3575898352,46
0,1274,52785,3575898306,3575898353,47
0,1274,52786,3575898306,3575898354,48
0,1274,52787,3575898306,3575898355,49
0,1274,52788,3575898306,3575898355,49
0,1274,52789,3575898306,3575898356,50
0,1275,52790,3575898374,3575898374,0
0,1275,52791,3575898374,3575898374,0
0,1275,52792,3575898374,3575898374,0
0,1275,52793,3575898374,3575898374,0
0,1275,52794,3575898374,3575898374,0
0,1275,52795,3575898374,3575898374,0
0,1275,52796,3575898374,3575898374,0
0,1275,52797,3575898374,3575898374,0
0,1275,52798,3575898374,3575898374,0
0,1275,52799,3575898374,3575898374,0
0,1275,52800,3575898374,3575898374,0
0,1275,52801,3575898374,3575898374,0
0,1275,52802,3575898374,3575898374,0
0,1275,52803,3575898374,3575898374,0
0,1275,52804,3575898374,3575898374,0
0,1275,52805,3575898374,3575898374,0
0,1275,52806,3575898374,3575898374,0
0,1275,52807,3575898374,3575898374,0
0,1275,52808,3575898374,3575898374,0
0,1275,52809,3575898374,3575898374,0
0,1275,52810,3575898374,3575898374,0
0,1275,52811,3575898374,3575898374,0
0,1275,52812,3575898374,3575898374,0
0,1275,52813,3575898374,3575898374,0
0,1275,52814,3575898374,3575898374,0
0,1275,52815,3575898374,3575898375,1
0,1275,52816,3575898374,3575898375,1
0,1275,52817,3575898374,3575898377,3
0,1275,52818,3575898374,3575898377,3
0,1275,52819,3575898374,3575898377,3
0,1275,52820,3575898374,3575898377,3
0,1275,52821,3575898374,3575898378,4
0,1275,52822,3575898374,3575898378,4
0,1275,52823,3575898374,3575898379,5
0,1275,52824,3575898374,3575898380,6
0,1275,52825,3575898374,3575898380,6
0,1275,52826,3575898374,3575898383,9
0,1275,52827,3575898374,3575898383,9
0,1275,52828,3575898374,3575898383,9
0,1275,52829,3575898374,3575898385,11
0,1275,52830,3575898374,3575898386,12
0,1275,52831,3575898374,3575898388,14
0,1275,52832,3575898374,3575898389,15
0,1275,52833,3575898374,3575898389,15
0,1275,52834,3575898374,3575898393,19
0,1275,52835,3575898374,3575898395,21
0,1275,52836,3575898374,3575898395,21
0,1275,52837,3575898374,3575898399,25
0,1275,52838,3575898374,3575898399,25
0,1275,52839,3575898374,3575898399,25
0,1275,52840,3575898374,3575898400,26
0,1275,52841,3575898374,3575898401,27
0,1275,52842,3575898374,3575898402,28
0,1275,52843,3575898374,3575898403,29
0,1275,52844,3575898374,3575898404,30
0,1275,52845,3575898374,3575898405,31
0,1275,52846,3575898374,3575898406,32
0,1275,52847,3575898374,3575898409,35
0,1275,52848,3575898374,3575898409,35
0,1275,52849