t_id, iteration_count, request_count, request_start_time, request_end_time, request_processing_time
1,130,1,3575832527,3575832573,46
1,134,2,3575832729,3575832772,43
1,134,3,3575832729,3575832776,47
1,135,4,3575832780,3575832827,47
1,138,5,3575832931,3575832972,41
1,138,6,3575832931,3575832976,45
1,138,7,3575832931,3575832979,48
1,139,8,3575832981,3575833027,46
1,139,9,3575832981,3575833029,48
1,142,10,3575833133,3575833173,40
1,142,11,3575833133,3575833176,43
1,142,12,3575833133,3575833180,47
1,143,13,3575833184,3575833227,43
1,143,14,3575833184,3575833229,45
1,143,15,3575833184,3575833232,48
1,144,16,3575833235,3575833283,48
1,146,17,3575833336,3575833376,40
1,146,18,3575833336,3575833380,44
1,147,19,3575833386,3575833426,40
1,147,20,3575833386,3575833429,43
1,147,21,3575833386,3575833432,46
1,148,22,3575833437,3575833483,46
1,150,23,3575833538,3575833575,37
1,150,24,3575833538,3575833579,41
1,151,25,3575833588,3575833626,38
1,151,26,3575833588,3575833628,40
1,151,27,3575833588,3575833631,43
1,152,28,3575833639,3575833683,44
1,154,29,3575833740,3575833775,35
1,154,30,3575833740,3575833779,39
1,155,31,3575833791,3575833827,36
1,155,32,3575833791,3575833829,38
1,155,33,3575833791,3575833831,40
1,156,34,3575833842,3575833883,41
1,158,35,3575833943,3575833975,32
1,158,36,3575833943,3575833978,35
1,159,37,3575833994,3575834027,33
1,159,38,3575833994,3575834030,36
1,159,39,3575833994,3575834031,37
1,160,40,3575834044,3575834084,40
1,162,41,3575834145,3575834175,30
1,162,42,3575834145,3575834178,33
1,163,43,3575834196,3575834227,31
1,163,44,3575834196,3575834230,34
1,163,45,3575834196,3575834231,35
1,164,46,3575834246,3575834284,38
1,166,47,3575834347,3575834375,28
1,166,48,3575834347,3575834378,31
1,167,49,3575834398,3575834426,28
1,167,50,3575834398,3575834430,32
1,167,51,3575834398,3575834431,33
1,168,52,3575834449,3575834484,35
1,170,53,3575834551,3575834574,23
1,170,54,3575834551,3575834578,27
1,171,55,3575834602,3575834625,23
1,171,56,3575834602,3575834628,26
1,171,57,3575834602,3575834630,28
1,171,58,3575834602,3575834650,48
1,172,59,3575834653,3575834684,31
1,174,60,3575834755,3575834774,19
1,174,61,3575834755,3575834778,23
1,174,62,3575834755,3575834803,48
1,175,63,3575834805,3575834825,20
1,175,64,3575834805,3575834828,23
1,175,65,3575834805,3575834830,25
1,175,66,3575834805,3575834849,44
1,176,67,3575834856,3575834884,28
1,178,68,3575834957,3575834974,17
1,178,69,3575834957,3575834978,21
1,178,70,3575834957,3575835003,46
1,179,71,3575835008,3575835025,17
1,179,72,3575835008,3575835028,20
1,179,73,3575835008,3575835031,23
1,179,74,3575835008,3575835049,41
1,180,75,3575835059,3575835084,25
1,182,76,3575835160,3575835174,14
1,182,77,3575835160,3575835178,18
1,182,78,3575835160,3575835203,43
1,183,79,3575835211,3575835226,15
1,183,80,3575835211,3575835229,18
1,183,81,3575835211,3575835232,21
1,183,82,3575835211,3575835249,38
1,184,83,3575835262,3575835284,22
1,186,84,3575835363,3575835374,11
1,186,85,3575835363,3575835377,14
1,186,86,3575835363,3575835402,39
1,186,87,3575835363,3575835411,48
1,187,88,3575835414,3575835426,12
1,187,89,3575835414,3575835428,14
1,187,90,3575835414,3575835431,17
1,187,91,3575835414,3575835450,36
1,187,92,3575835414,3575835462,48
1,188,93,3575835465,3575835484,19
1,190,94,3575835567,3575835574,7
1,190,95,3575835567,3575835576,9
1,190,96,3575835567,3575835602,35
1,190,97,3575835567,3575835610,43
1,190,98,3575835567,3575835612,45
1,191,99,3575835618,3575835625,7
1,191,100,3575835618,3575835627,9
1,191,101,3575835618,3575835630,12
1,191,102,3575835618,3575835649,31
1,191,103,3575835618,3575835661,43
1,191,104,3575835618,3575835664,46
1,192,105,3575835669,3575835684,15
1,192,106,3575835669,3575835716,47
1,194,107,3575835770,3575835774,4
1,194,108,3575835770,3575835778,8
1,194,109,3575835770,3575835803,33
1,194,110,3575835770,3575835810,40
1,194,111,3575835770,3575835813,43
1,195,112,3575835821,3575835825,4
1,195,113,3575835821,3575835829,8
1,195,114,3575835821,3575835830,9
1,195,115,3575835821,3575835849,28
1,195,116,3575835821,3575835861,40
1,195,117,3575835821,3575835864,43
1,196,118,3575835872,3575835884,12
1,196,119,3575835872,3575835915,43
1,197,120,3575835922,3575835969,47
1,198,121,3575835973,3575835974,1
1,198,122,3575835973,3575835978,5
1,198,123,3575835973,3575836003,30
1,198,124,3575835973,3575836010,37
1,198,125,3575835973,3575836013,40
1,199,126,3575836024,3575836025,1
1,199,127,3575836024,3575836028,4
1,199,128,3575836024,3575836031,7
1,199,129,3575836024,3575836049,25
1,199,130,3575836024,3575836060,36
1,199,131,3575836024,3575836064,40
1,199,132,3575836024,3575836070,46
1,200,133,3575836075,3575836084,9
1,200,134,3575836075,3575836115,40
1,200,135,3575836075,3575836120,45
1,201,136,3575836126,3575836168,42
1,201,137,3575836126,3575836170,44
1,201,138,3575836126,3575836174,48
1,202,139,3575836177,3575836178,1
1,202,140,3575836177,3575836203,26
1,202,141,3575836177,3575836210,33
1,202,142,3575836177,3575836213,36
1,202,143,3575836177,3575836225,48
1,203,144,3575836228,3575836228,0
1,203,145,3575836228,3575836231,3
1,203,146,3575836228,3575836249,21
1,203,147,3575836228,3575836260,32
1,203,148,3575836228,3575836263,35
1,203,149,3575836228,3575836270,42
1,204,150,3575836279,3575836284,5
1,204,151,3575836279,3575836315,36
1,204,152,3575836279,3575836320,41
1,205,153,3575836330,3575836369,39
1,205,154,3575836330,3575836371,41
1,205,155,3575836330,3575836374,44
1,205,156,3575836330,3575836378,48
1,206,157,3575836381,3575836402,21
1,206,158,3575836381,3575836410,29
1,206,159,3575836381,3575836412,31
1,206,160,3575836381,3575836425,44
1,206,161,3575836381,3575836427,46
1,206,162,3575836381,3575836429,48
1,207,163,3575836432,3575836432,0
1,207,164,3575836432,3575836449,17
1,207,165,3575836432,3575836461,29
1,207,166,3575836432,3575836464,32
1,207,167,3575836432,3575836471,39
1,207,168,3575836432,3575836476,44
1,208,169,3575836483,3575836483,0
1,208,170,3575836483,3575836514,31
1,208,171,3575836483,3575836519,36
1,209,172,3575836534,3575836567,33
1,209,173,3575836534,3575836570,36
1,209,174,3575836534,3575836574,40
1,209,175,3575836534,3575836575,41
1,209,176,3575836534,3575836577,43
1,210,177,3575836585,3575836601,16
1,210,178,3575836585,3575836609,24
1,210,179,3575836585,3575836612,27
1,210,180,3575836585,3575836624,39
1,210,181,3575836585,3575836625,40
1,210,182,3575836585,3575836626,41
1,210,183,3575836585,3575836628,43
1,210,184,3575836585,3575836631,46
1,211,185,3575836636,3575836649,13
1,211,186,3575836636,3575836660,24
1,211,187,3575836636,3575836663,27
1,211,188,3575836636,3575836670,34
1,211,189,3575836636,3575836675,39
1,211,190,3575836636,3575836677,41
1,211,191,3575836636,3575836683,47
1,212,192,3575836687,3575836714,27
1,212,193,3575836687,3575836719,32
1,213,194,3575836738,3575836767,29
1,213,195,3575836738,3575836770,32
1,213,196,3575836738,3575836774,36
1,213,197,3575836738,3575836775,37
1,213,198,3575836738,3575836778,40
1,214,199,3575836789,3575836802,13
1,214,200,3575836789,3575836809,20
1,214,201,3575836789,3575836812,23
1,214,202,3575836789,3575836825,36
1,214,203,3575836789,3575836826,37
1,214,204,3575836789,3575836827,38
1,214,205,3575836789,3575836829,40
1,214,206,3575836789,3575836831,42
1,215,207,3575836840,3575836849,9
1,215,208,3575836840,3575836860,20
1,215,209,3575836840,3575836864,24
1,215,210,3575836840,3575836869,29
1,215,211,3575836840,3575836876,36
1,215,212,3575836840,3575836876,36
1,215,213,3575836840,3575836882,42
1,216,214,3575836891,3575836914,23
1,216,215,3575836891,3575836920,29
1,216,216,3575836891,3575836930,39
1,217,217,3575836942,3575836967,25
1,217,218,3575836942,3575836970,28
1,217,219,3575836942,3575836974,32
1,217,220,3575836942,3575836975,33
1,217,221,3575836942,3575836977,35
1,218,222,3575836993,3575837003,10
1,218,223,3575836993,3575837009,16
1,218,224,3575836993,3575837012,19
1,218,225,3575836993,3575837025,32
1,218,226,3575836993,3575837025,32
1,218,227,3575836993,3575837026,33
1,218,228,3575836993,3575837029,36
1,218,229,3575836993,3575837031,38
1,218,230,3575836993,3575837031,38
1,219,231,3575837044,3575837049,5
1,219,232,3575837044,3575837061,17
1,219,233,3575837044,3575837064,20
1,219,234,3575837044,3575837070,26
1,219,235,3575837044,3575837075,31
1,219,236,3575837044,3575837077,33
1,219,237,3575837044,3575837083,39
1,220,238,3575837095,3575837114,19
1,220,239,3575837095,3575837120,25
1,220,240,3575837095,3575837129,34
1,220,241,3575837095,3575837132,37
1,221,242,3575837146,3575837167,21
1,221,243,3575837146,3575837170,24
1,221,244,3575837146,3575837174,28
1,221,245,3575837146,3575837175,29
1,221,246,3575837146,3575837178,32
1,222,247,3575837197,3575837203,6
1,222,248,3575837197,3575837209,12
1,222,249,3575837197,3575837212,15
1,222,250,3575837197,3575837225,28
1,222,251,3575837197,3575837226,29
1,222,252,3575837197,3575837226,29
1,222,253,3575837197,3575837228,31
1,222,254,3575837197,3575837231,34
1,222,255,3575837197,3575837231,34
1,223,256,3575837248,3575837249,1
1,223,257,3575837248,3575837261,13
1,223,258,3575837248,3575837264,16
1,223,259,3575837248,3575837270,22
1,223,260,3575837248,3575837275,27
1,223,261,3575837248,3575837277,29
1,223,262,3575837248,3575837283,35
1,224,263,3575837299,3575837314,15
1,224,264,3575837299,3575837321,22
1,224,265,3575837299,3575837330,31
1,224,266,3575837299,3575837333,34
1,225,267,3575837350,3575837367,17
1,225,268,3575837350,3575837370,20
1,225,269,3575837350,3575837374,24
1,225,270,3575837350,3575837374,24
1,225,271,3575837350,3575837377,27
1,226,272,3575837401,3575837403,2
1,226,273,3575837401,3575837410,9
1,226,274,3575837401,3575837413,12
1,226,275,3575837401,3575837425,24
1,226,276,3575837401,3575837426,25
1,226,277,3575837401,3575837426,25
1,226,278,3575837401,3575837429,28
1,226,279,3575837401,3575837431,30
1,226,280,3575837401,3575837431,30
1,226,281,3575837401,3575837450,49
1,227,282,3575837452,3575837460,8
1,227,283,3575837452,3575837465,13
1,227,284,3575837452,3575837471,19
1,227,285,3575837452,3575837475,23
1,227,286,3575837452,3575837477,25
1,227,287,3575837452,3575837483,31
1,227,288,3575837452,3575837487,35
1,228,289,3575837503,3575837513,10
1,228,290,3575837503,3575837520,17
1,228,291,3575837503,3575837529,26
1,228,292,3575837503,3575837532,29
1,229,293,3575837554,3575837567,13
1,229,294,3575837554,3575837570,16
1,229,295,3575837554,3575837574,20
1,229,296,3575837554,3575837574,20
1,229,297,3575837554,3575837577,23
1,229,298,3575837554,3575837602,48
1,230,299,3575837605,3575837609,4
1,230,300,3575837605,3575837611,6
1,230,301,3575837605,3575837624,19
1,230,302,3575837605,3575837624,19
1,230,303,3575837605,3575837625,20
1,230,304,3575837605,3575837627,22
1,230,305,3575837605,3575837630,25
1,230,306,3575837605,3575837630,25
1,230,307,3575837605,3575837637,32
1,230,308,3575837605,3575837648,43
1,231,309,3575837656,3575837660,4
1,231,310,3575837656,3575837665,9
1,231,311,3575837656,3575837670,14
1,231,312,3575837656,3575837675,19
1,231,313,3575837656,3575837677,21
1,231,314,3575837656,3575837683,27
1,231,315,3575837656,3575837687,31
1,232,316,3575837707,3575837713,6
1,232,317,3575837707,3575837720,13
1,232,318,3575837707,3575837729,22
1,232,319,3575837707,3575837731,24
1,233,320,3575837758,3575837767,9
1,233,321,3575837758,3575837770,12
1,233,322,3575837758,3575837774,16
1,233,323,3575837758,3575837774,16
1,233,324,3575837758,3575837777,19
1,233,325,3575837758,3575837802,44
1,234,326,3575837809,3575837809,0
1,234,327,3575837809,3575837812,3
1,234,328,3575837809,3575837824,15
1,234,329,3575837809,3575837825,16
1,234,330,3575837809,3575837825,16
1,234,331,3575837809,3575837829,20
1,234,332,3575837809,3575837830,21
1,234,333,3575837809,3575837830,21
1,234,334,3575837809,3575837837,28
1,234,335,3575837809,3575837841,32
1,234,336,3575837809,3575837849,40
1,235,337,3575837860,3575837860,0
1,235,338,3575837860,3575837865,5
1,235,339,3575837860,3575837870,10
1,235,340,3575837860,3575837875,15
1,235,341,3575837860,3575837877,17
1,235,342,3575837860,3575837882,22
1,235,343,3575837860,3575837887,27
1,236,344,3575837911,3575837914,3
1,236,345,3575837911,3575837920,9
1,236,346,3575837911,3575837929,18
1,236,347,3575837911,3575837931,20
1,236,348,3575837911,3575837943,32
1,237,349,3575837962,3575837967,5
1,237,350,3575837962,3575837969,7
1,237,351,3575837962,3575837974,12
1,237,352,3575837962,3575837974,12
1,237,353,3575837962,3575837977,15
1,237,354,3575837962,3575838002,40
1,237,355,3575837962,3575838009,47
1,238,356,3575838013,3575838013,0
1,238,357,3575838013,3575838025,12
1,238,358,3575838013,3575838025,12
1,238,359,3575838013,3575838025,12
1,238,360,3575838013,3575838029,16
1,238,361,3575838013,3575838030,17
1,238,362,3575838013,3575838031,18
1,238,363,3575838013,3575838037,24
1,238,364,3575838013,3575838041,28
1,238,365,3575838013,3575838049,36
1,238,366,3575838013,3575838059,46
1,239,367,3575838064,3575838065,1
1,239,368,3575838064,3575838071,7
1,239,369,3575838064,3575838075,11
1,239,370,3575838064,3575838077,13
1,239,371,3575838064,3575838083,19
1,239,372,3575838064,3575838087,23
1,239,373,3575838064,3575838094,30
1,239,374,3575838064,3575838113,49
1,240,375,3575838115,3575838120,5
1,240,376,3575838115,3575838130,15
1,240,377,3575838115,3575838131,16
1,240,378,3575838115,3575838143,28
1,241,379,3575838166,3575838167,1
1,241,380,3575838166,3575838170,4
1,241,381,3575838166,3575838173,7
1,241,382,3575838166,3575838174,8
1,241,383,3575838166,3575838177,11
1,241,384,3575838166,3575838201,35
1,241,385,3575838166,3575838210,44
1,241,386,3575838166,3575838212,46
1,242,387,3575838217,3575838225,8
1,242,388,3575838217,3575838225,8
1,242,389,3575838217,3575838227,10
1,242,390,3575838217,3575838229,12
1,242,391,3575838217,3575838231,14
1,242,392,3575838217,3575838231,14
1,242,393,3575838217,3575838238,21
1,242,394,3575838217,3575838241,24
1,242,395,3575838217,3575838246,29
1,242,396,3575838217,3575838249,32
1,242,397,3575838217,3575838261,44
1,242,398,3575838217,3575838265,48
1,243,399,3575838268,3575838272,4
1,243,400,3575838268,3575838276,8
1,243,401,3575838268,3575838276,8
1,243,402,3575838268,3575838283,15
1,243,403,3575838268,3575838287,19
1,243,404,3575838268,3575838294,26
1,243,405,3575838268,3575838313,45
1,244,406,3575838319,3575838320,1
1,244,407,3575838319,3575838330,11
1,244,408,3575838319,3575838331,12
1,244,409,3575838319,3575838343,24
1,244,410,3575838319,3575838368,49
1,245,411,3575838370,3575838370,0
1,245,412,3575838370,3575838374,4
1,245,413,3575838370,3575838378,8
1,245,414,3575838370,3575838402,32
1,245,415,3575838370,3575838410,40
1,245,416,3575838370,3575838413,43
1,246,417,3575838421,3575838426,5
1,246,418,3575838421,3575838426,5
1,246,419,3575838421,3575838426,5
1,246,420,3575838421,3575838429,8
1,246,421,3575838421,3575838431,10
1,246,422,3575838421,3575838431,10
1,246,423,3575838421,3575838437,16
1,246,424,3575838421,3575838441,20
1,246,425,3575838421,3575838445,24
1,246,426,3575838421,3575838449,28
1,246,427,3575838421,3575838461,40
1,246,428,3575838421,3575838465,44
1,247,429,3575838472,3575838472,0
1,247,430,3575838472,3575838476,4
1,247,431,3575838472,3575838477,5
1,247,432,3575838472,3575838482,10
1,247,433,3575838472,3575838486,14
1,247,434,3575838472,3575838494,22
1,247,435,3575838472,3575838514,42
1,247,436,3575838472,3575838520,48
1,248,437,3575838523,3575838529,6
1,248,438,3575838523,3575838531,8
1,248,439,3575838523,3575838542,19
1,248,440,3575838523,3575838566,43
1,248,441,3575838523,3575838569,46
1,249,442,3575838574,3575838574,0
1,249,443,3575838574,3575838577,3
1,249,444,3575838574,3575838601,27
1,249,445,3575838574,3575838608,34
1,249,446,3575838574,3575838612,38
1,250,447,3575838625,3575838625,0
1,250,448,3575838625,3575838625,0
1,250,449,3575838625,3575838625,0
1,250,450,3575838625,3575838628,3
1,250,451,3575838625,3575838630,5
1,250,452,3575838625,3575838630,5
1,250,453,3575838625,3575838636,11
1,250,454,3575838625,3575838639,14
1,250,455,3575838625,3575838645,20
1,250,456,3575838625,3575838649,24
1,250,457,3575838625,3575838659,34
1,250,458,3575838625,3575838664,39
1,250,459,3575838625,3575838670,45
1,251,460,3575838677,3575838677,0
1,251,461,3575838677,3575838677,0
1,251,462,3575838677,3575838683,6
1,251,463,3575838677,3575838685,8
1,251,464,3575838677,3575838694,17
1,251,465,3575838677,3575838715,38
1,251,466,3575838677,3575838720,43
1,252,467,3575838729,3575838729,0
1,252,468,3575838729,3575838731,2
1,252,469,3575838729,3575838741,12
1,252,470,3575838729,3575838751,22
1,252,471,3575838729,3575838767,38
1,252,472,3575838729,3575838769,40
1,252,473,3575838729,3575838774,45
1,252,474,3575838729,3575838774,45
1,252,475,3575838729,3575838778,49
1,253,476,3575838780,3575838801,21
1,253,477,3575838780,3575838809,29
1,253,478,3575838780,3575838812,32
1,253,479,3575838780,3575838825,45
1,253,480,3575838780,3575838826,46
1,253,481,3575838780,3575838826,46
1,253,482,3575838780,3575838829,49
1,254,483,3575838831,3575838831,0
1,254,484,3575838831,3575838831,0
1,254,485,3575838831,3575838836,5
1,254,486,3575838831,3575838840,9
1,254,487,3575838831,3575838844,13
1,254,488,3575838831,3575838849,18
1,254,489,3575838831,3575838853,22
1,254,490,3575838831,3575838860,29
1,254,491,3575838831,3575838864,33
1,254,492,3575838831,3575838871,40
1,254,493,3575838831,3575838876,45
1,254,494,3575838831,3575838876,45
1,255,495,3575838882,3575838884,2
1,255,496,3575838882,3575838886,4
1,255,497,3575838882,3575838894,12
1,255,498,3575838882,3575838914,32
1,255,499,3575838882,3575838920,38
1,255,500,3575838882,3575838929,47
1,255,501,3575838882,3575838932,50
1,256,502,3575838933,3575838941,8
1,256,503,3575838933,3575838952,19
1,256,504,3575838933,3575838954,21
1,256,505,3575838933,3575838967,34
1,256,506,3575838933,3575838970,37
1,256,507,3575838933,3575838972,39
1,256,508,3575838933,3575838974,41
1,256,509,3575838933,3575838975,42
1,256,510,3575838933,3575838979,46
1,257,511,3575838984,3575839001,17
1,257,512,3575838984,3575839008,24
1,257,513,3575838984,3575839012,28
1,257,514,3575838984,3575839025,41
1,257,515,3575838984,3575839025,41
1,257,516,3575838984,3575839026,42
1,257,517,3575838984,3575839029,45
1,257,518,3575838984,3575839030,46
1,257,519,3575838984,3575839032,48
1,258,520,3575839035,3575839036,1
1,258,521,3575839035,3575839040,5
1,258,522,3575839035,3575839044,9
1,258,523,3575839035,3575839049,14
1,258,524,3575839035,3575839053,18
1,258,525,3575839035,3575839060,25
1,258,526,3575839035,3575839064,29
1,258,527,3575839035,3575839071,36
1,258,528,3575839035,3575839077,42
1,258,529,3575839035,3575839077,42
1,258,530,3575839035,3575839084,49
1,259,531,3575839087,3575839087,0
1,259,532,3575839087,3575839094,7
1,259,533,3575839087,3575839106,19
1,259,534,3575839087,3575839114,27
1,259,535,3575839087,3575839120,33
1,259,536,3575839087,3575839129,42
1,259,537,3575839087,3575839132,45
1,260,538,3575839138,3575839141,3
1,260,539,3575839138,3575839152,14
1,260,540,3575839138,3575839154,16
1,260,541,3575839138,3575839168,30
1,260,542,3575839138,3575839171,33
1,260,543,3575839138,3575839172,34
1,260,544,3575839138,3575839174,36
1,260,545,3575839138,3575839175,37
1,260,546,3575839138,3575839178,40
1,261,547,3575839190,3575839200,10
1,261,548,3575839190,3575839207,17
1,261,549,3575839190,3575839210,20
1,261,550,3575839190,3575839211,21
1,261,551,3575839190,3575839225,35
1,261,552,3575839190,3575839226,36
1,261,553,3575839190,3575839226,36
1,261,554,3575839190,3575839229,39
1,261,555,3575839190,3575839230,40
1,261,556,3575839190,3575839232,42
1,261,557,3575839190,3575839236,46
1,261,558,3575839190,3575839240,50
1,262,559,3575839241,3575839245,4
1,262,560,3575839241,3575839248,7
1,262,561,3575839241,3575839253,12
1,262,562,3575839241,3575839261,20
1,262,563,3575839241,3575839263,22
1,262,564,3575839241,3575839271,30
1,262,565,3575839241,3575839276,35
1,262,566,3575839241,3575839277,36
1,262,567,3575839241,3575839284,43
1,262,568,3575839241,3575839286,45
1,263,569,3575839292,3575839294,2
1,263,570,3575839292,3575839306,14
1,263,571,3575839292,3575839314,22
1,263,572,3575839292,3575839320,28
1,263,573,3575839292,3575839330,38
1,263,574,3575839292,3575839333,41
1,264,575,3575839343,3575839343,0
1,264,576,3575839343,3575839351,8
1,264,577,3575839343,3575839354,11
1,264,578,3575839343,3575839368,25
1,264,579,3575839343,3575839372,29
1,264,580,3575839343,3575839373,30
1,264,581,3575839343,3575839374,31
1,264,582,3575839343,3575839379,36
1,265,583,3575839394,3575839401,7
1,265,584,3575839394,3575839407,13
1,265,585,3575839394,3575839409,15
1,265,586,3575839394,3575839410,16
1,265,587,3575839394,3575839413,19
1,265,588,3575839394,3575839425,31
1,265,589,3575839394,3575839426,32
1,265,590,3575839394,3575839427,33
1,265,591,3575839394,3575839428,34
1,265,592,3575839394,3575839430,36
1,265,593,3575839394,3575839432,38
1,265,594,3575839394,3575839437,43
1,265,595,3575839394,3575839440,46
1,266,596,3575839445,3575839445,0
1,266,597,3575839445,3575839450,5
1,266,598,3575839445,3575839453,8
1,266,599,3575839445,3575839460,15
1,266,600,3575839445,3575839464,19
1,266,601,3575839445,3575839471,26
1,266,602,3575839445,3575839477,32
1,266,603,3575839445,3575839477,32
1,266,604,3575839445,3575839483,38
1,266,605,3575839445,3575839485,40
1,266,606,3575839445,3575839494,49
1,267,607,3575839496,3575839505,9
1,267,608,3575839496,3575839510,14
1,267,609,3575839496,3575839513,17
1,267,610,3575839496,3575839519,23
1,267,611,3575839496,3575839529,33
1,267,612,3575839496,3575839532,36
1,267,613,3575839496,3575839540,44
1,268,614,3575839547,3575839551,4
1,268,615,3575839547,3575839553,6
1,268,616,3575839547,3575839561,14
1,268,617,3575839547,3575839567,20
1,268,618,3575839547,3575839571,24
1,268,619,3575839547,3575839571,24
1,268,620,3575839547,3575839574,27
1,268,621,3575839547,3575839574,27
1,268,622,3575839547,3575839578,31
1,269,623,3575839598,3575839607,9
1,269,624,3575839598,3575839608,10
1,269,625,3575839598,3575839609,11
1,269,626,3575839598,3575839611,13
1,269,627,3575839598,3575839611,13
1,269,628,3575839598,3575839624,26
1,269,629,3575839598,3575839625,27
1,269,630,3575839598,3575839626,28
1,269,631,3575839598,3575839628,30
1,269,632,3575839598,3575839629,31
1,269,633,3575839598,3575839631,33
1,269,634,3575839598,3575839637,39
1,269,635,3575839598,3575839639,41
1,269,636,3575839598,3575839644,46
1,270,637,3575839649,3575839649,0
1,270,638,3575839649,3575839652,3
1,270,639,3575839649,3575839659,10
1,270,640,3575839649,3575839663,14
1,270,641,3575839649,3575839670,21
1,270,642,3575839649,3575839677,28
1,270,643,3575839649,3575839678,29
1,270,644,3575839649,3575839683,34
1,270,645,3575839649,3575839685,36
1,270,646,3575839649,3575839695,46
1,271,647,3575839701,3575839705,4
1,271,648,3575839701,3575839711,10
1,271,649,3575839701,3575839713,12
1,271,650,3575839701,3575839713,12
1,271,651,3575839701,3575839719,18
1,271,652,3575839701,3575839730,29
1,271,653,3575839701,3575839732,31
1,271,654,3575839701,3575839741,40
1,271,655,3575839701,3575839751,50
1,272,656,3575839753,3575839753,0
1,272,657,3575839753,3575839760,7
1,272,658,3575839753,3575839767,14
1,272,659,3575839753,3575839770,17
1,272,660,3575839753,3575839771,18
1,272,661,3575839753,3575839773,20
1,272,662,3575839753,3575839774,21
1,272,663,3575839753,3575839777,24
1,273,664,3575839804,3575839808,4
1,273,665,3575839804,3575839808,4
1,273,666,3575839804,3575839809,5
1,273,667,3575839804,3575839811,7
1,273,668,3575839804,3575839811,7
1,273,669,3575839804,3575839814,10
1,273,670,3575839804,3575839824,20
1,273,671,3575839804,3575839824,20
1,273,672,3575839804,3575839826,22
1,273,673,3575839804,3575839828,24
1,273,674,3575839804,3575839830,26
1,273,675,3575839804,3575839831,27
1,273,676,3575839804,3575839837,33
1,273,677,3575839804,3575839840,36
1,273,678,3575839804,3575839843,39
1,273,679,3575839804,3575839848,44
1,273,680,3575839804,3575839852,48
1,274,681,3575839855,3575839860,5
1,274,682,3575839855,3575839862,7
1,274,683,3575839855,3575839865,10
1,274,684,3575839855,3575839870,15
1,274,685,3575839855,3575839877,22
1,274,686,3575839855,3575839878,23
1,274,687,3575839855,3575839884,29
1,274,688,3575839855,3575839886,31
1,274,689,3575839855,3575839896,41
1,275,690,3575839906,3575839906,0
1,275,691,3575839906,3575839911,5
1,275,692,3575839906,3575839913,7
1,275,693,3575839906,3575839913,7
1,275,694,3575839906,3575839919,13
1,275,695,3575839906,3575839930,24
1,275,696,3575839906,3575839932,26
1,275,697,3575839906,3575839941,35
1,275,698,3575839906,3575839951,45
1,275,699,3575839906,3575839953,47
1,276,700,3575839957,3575839960,3
1,276,701,3575839957,3575839967,10
1,276,702,3575839957,3575839970,13
1,276,703,3575839957,3575839971,14
1,276,704,3575839957,3575839973,16
1,276,705,3575839957,3575839974,17
1,276,706,3575839957,3575839977,20
1,277,707,3575840009,3575840009,0
1,277,708,3575840009,3575840009,0
1,277,709,3575840009,3575840009,0
1,277,710,3575840009,3575840011,2
1,277,711,3575840009,3575840012,3
1,277,712,3575840009,3575840015,6
1,277,713,3575840009,3575840017,8
1,277,714,3575840009,3575840024,15
1,277,715,3575840009,3575840025,16
1,277,716,3575840009,3575840026,17
1,277,717,3575840009,3575840028,19
1,277,718,3575840009,3575840030,21
1,277,719,3575840009,3575840031,22
1,277,720,3575840009,3575840036,27
1,277,721,3575840009,3575840040,31
1,277,722,3575840009,3575840044,35
1,277,723,3575840009,3575840049,40
1,277,724,3575840009,3575840052,43
1,278,725,3575840061,3575840061,0
1,278,726,3575840061,3575840062,1
1,278,727,3575840061,3575840065,4
1,278,728,3575840061,3575840070,9
1,278,729,3575840061,3575840076,15
1,278,730,3575840061,3575840079,18
1,278,731,3575840061,3575840084,23
1,278,732,3575840061,3575840086,25
1,278,733,3575840061,3575840096,35
1,278,734,3575840061,3575840105,44
1,278,735,3575840061,3575840111,50
1,279,736,3575840112,3575840113,1
1,279,737,3575840112,3575840113,1
1,279,738,3575840112,3575840120,8
1,279,739,3575840112,3575840131,19
1,279,740,3575840112,3575840132,20
1,279,741,3575840112,3575840141,29
1,279,742,3575840112,3575840151,39
1,279,743,3575840112,3575840153,41
1,279,744,3575840112,3575840160,48
1,280,745,3575840163,3575840167,4
1,280,746,3575840163,3575840170,7
1,280,747,3575840163,3575840171,8
1,280,748,3575840163,3575840173,10
1,280,749,3575840163,3575840174,11
1,280,750,3575840163,3575840177,14
1,280,751,3575840163,3575840208,45
1,280,752,3575840163,3575840208,45
1,280,753,3575840163,3575840210,47
1,280,754,3575840163,3575840211,48
1,280,755,3575840163,3575840211,48
1,281,756,3575840215,3575840215,0
1,281,757,3575840215,3575840217,2
1,281,758,3575840215,3575840220,5
1,281,759,3575840215,3575840224,9
1,281,760,3575840215,3575840225,10
1,281,761,3575840215,3575840226,11
1,281,762,3575840215,3575840229,14
1,281,763,3575840215,3575840231,16
1,281,764,3575840215,3575840232,17
1,281,765,3575840215,3575840236,21
1,281,766,3575840215,3575840240,25
1,281,767,3575840215,3575840245,30
1,281,768,3575840215,3575840248,33
1,281,769,3575840215,3575840252,37
1,281,770,3575840215,3575840261,46
1,281,771,3575840215,3575840263,48
1,282,772,3575840266,3575840270,4
1,282,773,3575840266,3575840277,11
1,282,774,3575840266,3575840279,13
1,282,775,3575840266,3575840283,17
1,282,776,3575840266,3575840285,19
1,282,777,3575840266,3575840295,29
1,282,778,3575840266,3575840305,39
1,282,779,3575840266,3575840311,45
1,282,780,3575840266,3575840313,47
1,282,781,3575840266,3575840314,48
1,283,782,3575840317,3575840320,3
1,283,783,3575840317,3575840331,14
1,283,784,3575840317,3575840332,15
1,283,785,3575840317,3575840341,24
1,283,786,3575840317,3575840351,34
1,283,787,3575840317,3575840353,36
1,283,788,3575840317,3575840360,43
1,284,789,3575840368,3575840368,0
1,284,790,3575840368,3575840370,2
1,284,791,3575840368,3575840372,4
1,284,792,3575840368,3575840374,6
1,284,793,3575840368,3575840375,7
1,284,794,3575840368,3575840378,10
1,284,795,3575840368,3575840408,40
1,284,796,3575840368,3575840408,40
1,284,797,3575840368,3575840410,42
1,284,798,3575840368,3575840411,43
1,284,799,3575840368,3575840413,45
1,284,800,3575840368,3575840415,47
1,284,801,3575840368,3575840417,49
1,285,802,3575840420,3575840420,0
1,285,803,3575840420,3575840425,5
1,285,804,3575840420,3575840426,6
1,285,805,3575840420,3575840427,7
1,285,806,3575840420,3575840429,9
1,285,807,3575840420,3575840431,11
1,285,808,3575840420,3575840432,12
1,285,809,3575840420,3575840437,17
1,285,810,3575840420,3575840440,20
1,285,811,3575840420,3575840444,24
1,285,812,3575840420,3575840449,29
1,285,813,3575840420,3575840452,32
1,285,814,3575840420,3575840461,41
1,285,815,3575840420,3575840464,44
1,286,816,3575840471,3575840471,0
1,286,817,3575840471,3575840477,6
1,286,818,3575840471,3575840479,8
1,286,819,3575840471,3575840484,13
1,286,820,3575840471,3575840486,15
1,286,821,3575840471,3575840496,25
1,286,822,3575840471,3575840505,34
1,286,823,3575840471,3575840511,40
1,286,824,3575840471,3575840513,42
1,286,825,3575840471,3575840514,43
1,286,826,3575840471,3575840520,49
1,287,827,3575840522,3575840522,0
1,287,828,3575840522,3575840530,8
1,287,829,3575840522,3575840531,9
1,287,830,3575840522,3575840541,19
1,287,831,3575840522,3575840550,28
1,287,832,3575840522,3575840552,30
1,287,833,3575840522,3575840559,37
1,287,834,3575840522,3575840566,44
1,287,835,3575840522,3575840569,47
1,287,836,3575840522,3575840571,49
1,288,837,3575840573,3575840573,0
1,288,838,3575840573,3575840573,0
1,288,839,3575840573,3575840574,1
1,288,840,3575840573,3575840576,3
1,288,841,3575840573,3575840607,34
1,288,842,3575840573,3575840608,35
1,288,843,3575840573,3575840609,36
1,288,844,3575840573,3575840610,37
1,288,845,3575840573,3575840611,38
1,288,846,3575840573,3575840616,43
1,288,847,3575840573,3575840619,46
1,289,848,3575840625,3575840625,0
1,289,849,3575840625,3575840625,0
1,289,850,3575840625,3575840627,2
1,289,851,3575840625,3575840628,3
1,289,852,3575840625,3575840630,5
1,289,853,3575840625,3575840632,7
1,289,854,3575840625,3575840636,11
1,289,855,3575840625,3575840639,14
1,289,856,3575840625,3575840644,19
1,289,857,3575840625,3575840648,23
1,289,858,3575840625,3575840651,26
1,289,859,3575840625,3575840660,35
1,289,860,3575840625,3575840663,38
1,289,861,3575840625,3575840670,45
1,290,862,3575840677,3575840677,0
1,290,863,3575840677,3575840677,0
1,290,864,3575840677,3575840679,2
1,290,865,3575840677,3575840684,7
1,290,866,3575840677,3575840686,9
1,290,867,3575840677,3575840696,19
1,290,868,3575840677,3575840705,28
1,290,869,3575840677,3575840710,33
1,290,870,3575840677,3575840713,36
1,290,871,3575840677,3575840715,38
1,290,872,3575840677,3575840720,43
1,290,873,3575840677,3575840723,46
1,291,874,3575840729,3575840730,1
1,291,875,3575840729,3575840731,2
1,291,876,3575840729,3575840742,13
1,291,877,3575840729,3575840745,16
1,291,878,3575840729,3575840750,21
1,291,879,3575840729,3575840753,24
1,291,880,3575840729,3575840760,31
1,291,881,3575840729,3575840767,38
1,291,882,3575840729,3575840770,41
1,291,883,3575840729,3575840771,42
1,291,884,3575840729,3575840772,43
1,291,885,3575840729,3575840774,45
1,291,886,3575840729,3575840775,46
1,291,887,3575840729,3575840777,48
1,291,888,3575840729,3575840777,48
1,292,889,3575840781,3575840807,26
1,292,890,3575840781,3575840807,26
1,292,891,3575840781,3575840809,28
1,292,892,3575840781,3575840810,29
1,292,893,3575840781,3575840812,31
1,292,894,3575840781,3575840816,35
1,292,895,3575840781,3575840818,37
1,292,896,3575840781,3575840824,43
1,292,897,3575840781,3575840825,44
1,292,898,3575840781,3575840826,45
1,292,899,3575840781,3575840829,48
1,292,900,3575840781,3575840830,49
1,293,901,3575840832,3575840834,2
1,293,902,3575840832,3575840836,4
1,293,903,3575840832,3575840839,7
1,293,904,3575840832,3575840843,11
1,293,905,3575840832,3575840848,16
1,293,906,3575840832,3575840851,19
1,293,907,3575840832,3575840859,27
1,293,908,3575840832,3575840863,31
1,293,909,3575840832,3575840870,38
1,293,910,3575840832,3575840875,43
1,293,911,3575840832,3575840876,44
1,293,912,3575840832,3575840878,46
1,294,913,3575840883,3575840884,1
1,294,914,3575840883,3575840886,3
1,294,915,3575840883,3575840895,12
1,294,916,3575840883,3575840905,22
1,294,917,3575840883,3575840911,28
1,294,918,3575840883,3575840914,31
1,294,919,3575840883,3575840915,32
1,294,920,3575840883,3575840920,37
1,294,921,3575840883,3575840923,40
1,294,922,3575840883,3575840931,48
1,294,923,3575840883,3575840931,48
1,295,924,3575840935,3575840941,6
1,295,925,3575840935,3575840944,9
1,295,926,3575840935,3575840950,15
1,295,927,3575840935,3575840953,18
1,295,928,3575840935,3575840959,24
1,295,929,3575840935,3575840967,32
1,295,930,3575840935,3575840969,34
1,295,931,3575840935,3575840971,36
1,295,932,3575840935,3575840973,38
1,295,933,3575840935,3575840973,38
1,295,934,3575840935,3575840974,39
1,295,935,3575840935,3575840976,41
1,295,936,3575840935,3575840977,42
1,296,937,3575840987,3575841007,20
1,296,938,3575840987,3575841008,21
1,296,939,3575840987,3575841010,23
1,296,940,3575840987,3575841010,23
1,296,941,3575840987,3575841013,26
1,296,942,3575840987,3575841014,27
1,296,943,3575840987,3575841016,29
1,296,944,3575840987,3575841019,32
1,296,945,3575840987,3575841024,37
1,296,946,3575840987,3575841025,38
1,296,947,3575840987,3575841027,40
1,296,948,3575840987,3575841029,42
1,296,949,3575840987,3575841030,43
1,296,950,3575840987,3575841035,48
1,296,951,3575840987,3575841036,49
1,297,952,3575841039,3575841039,0
1,297,953,3575841039,3575841045,6
1,297,954,3575841039,3575841051,12
1,297,955,3575841039,3575841059,20
1,297,956,3575841039,3575841063,24
1,297,957,3575841039,3575841070,31
1,297,958,3575841039,3575841075,36
1,297,959,3575841039,3575841077,38
1,297,960,3575841039,3575841079,40
1,297,961,3575841039,3575841081,42
1,297,962,3575841039,3575841085,46
1,297,963,3575841039,3575841086,47
1,298,964,3575841090,3575841095,5
1,298,965,3575841090,3575841106,16
1,298,966,3575841090,3575841110,20
1,298,967,3575841090,3575841114,24
1,298,968,3575841090,3575841115,25
1,298,969,3575841090,3575841120,30
1,298,970,3575841090,3575841123,33
1,298,971,3575841090,3575841130,40
1,298,972,3575841090,3575841132,42
1,298,973,3575841090,3575841132,42
1,299,974,3575841142,3575841142,0
1,299,975,3575841142,3575841146,4
1,299,976,3575841142,3575841150,8
1,299,977,3575841142,3575841154,12
1,299,978,3575841142,3575841159,17
1,299,979,3575841142,3575841168,26
1,299,980,3575841142,3575841170,28
1,299,981,3575841142,3575841172,30
1,299,982,3575841142,3575841173,31
1,299,983,3575841142,3575841174,32
1,299,984,3575841142,3575841174,32
1,299,985,3575841142,3575841176,34
1,299,986,3575841142,3575841177,35
1,299,987,3575841142,3575841178,36
1,300,988,3575841194,3575841197,3
1,300,989,3575841194,3575841201,7
1,300,990,3575841194,3575841207,13
1,300,991,3575841194,3575841208,14
1,300,992,3575841194,3575841210,16
1,300,993,3575841194,3575841211,17
1,300,994,3575841194,3575841214,20
1,300,995,3575841194,3575841215,21
1,300,996,3575841194,3575841216,22
1,300,997,3575841194,3575841219,25
1,300,998,3575841194,3575841224,30
1,300,999,3575841194,3575841225,31
1,300,1000,3575841194,3575841226,32
1,300,1001,3575841194,3575841229,35
1,300,1002,3575841194,3575841230,36
1,300,1003,3575841194,3575841233,39
1,300,1004,3575841194,3575841235,41
1,300,1005,3575841194,3575841237,43
1,300,1006,3575841194,3575841238,44
1,301,1007,3575841246,3575841246,0
1,301,1008,3575841246,3575841251,5
1,301,1009,3575841246,3575841260,14
1,301,1010,3575841246,3575841262,16
1,301,1011,3575841246,3575841269,23
1,301,1012,3575841246,3575841275,29
1,301,1013,3575841246,3575841277,31
1,301,1014,3575841246,3575841279,33
1,301,1015,3575841246,3575841281,35
1,301,1016,3575841246,3575841285,39
1,301,1017,3575841246,3575841286,40
1,301,1018,3575841246,3575841295,49
1,302,1019,3575841298,3575841306,8
1,302,1020,3575841298,3575841311,13
1,302,1021,3575841298,3575841315,17
1,302,1022,3575841298,3575841315,17
1,302,1023,3575841298,3575841319,21
1,302,1024,3575841298,3575841323,25
1,302,1025,3575841298,3575841331,33
1,302,1026,3575841298,3575841331,33
1,302,1027,3575841298,3575841332,34
1,302,1028,3575841298,3575841334,36
1,302,1029,3575841298,3575841342,44
1,302,1030,3575841298,3575841346,48
1,303,1031,3575841350,3575841351,1
1,303,1032,3575841350,3575841354,4
1,303,1033,3575841350,3575841360,10
1,303,1034,3575841350,3575841367,17
1,303,1035,3575841350,3575841369,19
1,303,1036,3575841350,3575841372,22
1,303,1037,3575841350,3575841372,22
1,303,1038,3575841350,3575841374,24
1,303,1039,3575841350,3575841376,26
1,303,1040,3575841350,3575841377,27
1,303,1041,3575841350,3575841378,28
1,303,1042,3575841350,3575841384,34
1,303,1043,3575841350,3575841396,46
1,303,1044,3575841350,3575841400,50
1,304,1045,3575841402,3575841407,5
1,304,1046,3575841402,3575841408,6
1,304,1047,3575841402,3575841409,7
1,304,1048,3575841402,3575841411,9
1,304,1049,3575841402,3575841413,11
1,304,1050,3575841402,3575841414,12
1,304,1051,3575841402,3575841416,14
1,304,1052,3575841402,3575841420,18
1,304,1053,3575841402,3575841424,22
1,304,1054,3575841402,3575841426,24
1,304,1055,3575841402,3575841427,25
1,304,1056,3575841402,3575841430,28
1,304,1057,3575841402,3575841430,28
1,304,1058,3575841402,3575841433,31
1,304,1059,3575841402,3575841435,33
1,304,1060,3575841402,3575841435,33
1,304,1061,3575841402,3575841437,35
1,304,1062,3575841402,3575841439,37
1,304,1063,3575841402,3575841444,42
1,304,1064,3575841402,3575841449,47
1,304,1065,3575841402,3575841451,49
1,305,1066,3575841454,3575841460,6
1,305,1067,3575841454,3575841464,10
1,305,1068,3575841454,3575841469,15
1,305,1069,3575841454,3575841475,21
1,305,1070,3575841454,3575841477,23
1,305,1071,3575841454,3575841479,25
1,305,1072,3575841454,3575841481,27
1,305,1073,3575841454,3575841484,30
1,305,1074,3575841454,3575841485,31
1,305,1075,3575841454,3575841486,32
1,305,1076,3575841454,3575841496,42
1,306,1077,3575841506,3575841506,0
1,306,1078,3575841506,3575841510,4
1,306,1079,3575841506,3575841513,7
1,306,1080,3575841506,3575841515,9
1,306,1081,3575841506,3575841519,13
1,306,1082,3575841506,3575841522,16
1,306,1083,3575841506,3575841530,24
1,306,1084,3575841506,3575841530,24
1,306,1085,3575841506,3575841531,25
1,306,1086,3575841506,3575841532,26
1,306,1087,3575841506,3575841540,34
1,306,1088,3575841506,3575841545,39
1,306,1089,3575841506,3575841549,43
1,306,1090,3575841506,3575841554,48
1,307,1091,3575841558,3575841559,1
1,307,1092,3575841558,3575841567,9
1,307,1093,3575841558,3575841568,10
1,307,1094,3575841558,3575841571,13
1,307,1095,3575841558,3575841572,14
1,307,1096,3575841558,3575841574,16
1,307,1097,3575841558,3575841575,17
1,307,1098,3575841558,3575841576,18
1,307,1099,3575841558,3575841577,19
1,307,1100,3575841558,3575841583,25
1,307,1101,3575841558,3575841596,38
1,307,1102,3575841558,3575841601,43
1,307,1103,3575841558,3575841606,48
1,307,1104,3575841558,3575841607,49
1,308,1105,3575841611,3575841611,0
1,308,1106,3575841611,3575841611,0
1,308,1107,3575841611,3575841613,2
1,308,1108,3575841611,3575841614,3
1,308,1109,3575841611,3575841615,4
1,308,1110,3575841611,3575841618,7
1,308,1111,3575841611,3575841625,14
1,308,1112,3575841611,3575841625,14
1,308,1113,3575841611,3575841625,14
1,308,1114,3575841611,3575841629,18
1,308,1115,3575841611,3575841629,18
1,308,1116,3575841611,3575841632,21
1,308,1117,3575841611,3575841633,22
1,308,1118,3575841611,3575841634,23
1,308,1119,3575841611,3575841636,25
1,308,1120,3575841611,3575841639,28
1,308,1121,3575841611,3575841644,33
1,308,1122,3575841611,3575841648,37
1,308,1123,3575841611,3575841651,40
1,308,1124,3575841611,3575841659,48
1,309,1125,3575841663,3575841663,0
1,309,1126,3575841663,3575841668,5
1,309,1127,3575841663,3575841675,12
1,309,1128,3575841663,3575841677,14
1,309,1129,3575841663,3575841679,16
1,309,1130,3575841663,3575841681,18
1,309,1131,3575841663,3575841684,21
1,309,1132,3575841663,3575841685,22
1,309,1133,3575841663,3575841686,23
1,309,1134,3575841663,3575841696,33
1,309,1135,3575841663,3575841705,42
1,309,1136,3575841663,3575841710,47
1,310,1137,3575841715,3575841715,0
1,310,1138,3575841715,3575841715,0
1,310,1139,3575841715,3575841720,5
1,310,1140,3575841715,3575841722,7
1,310,1141,3575841715,3575841730,15
1,310,1142,3575841715,3575841731,16
1,310,1143,3575841715,3575841731,16
1,310,1144,3575841715,3575841733,18
1,310,1145,3575841715,3575841742,27
1,310,1146,3575841715,3575841745,30
1,310,1147,3575841715,3575841749,34
1,310,1148,3575841715,3575841754,39
1,310,1149,3575841715,3575841759,44
1,311,1150,3575841767,3575841767,0
1,311,1151,3575841767,3575841769,2
1,311,1152,3575841767,3575841772,5
1,311,1153,3575841767,3575841772,5
1,311,1154,3575841767,3575841774,7
1,311,1155,3575841767,3575841774,7
1,311,1156,3575841767,3575841777,10
1,311,1157,3575841767,3575841778,11
1,311,1158,3575841767,3575841783,16
1,311,1159,3575841767,3575841789,22
1,311,1160,3575841767,3575841796,29
1,311,1161,3575841767,3575841801,34
1,311,1162,3575841767,3575841806,39
1,311,1163,3575841767,3575841808,41
1,311,1164,3575841767,3575841810,43
1,311,1165,3575841767,3575841811,44
1,311,1166,3575841767,3575841813,46
1,311,1167,3575841767,3575841814,47
1,311,1168,3575841767,3575841816,49
1,312,1169,3575841819,3575841819,0
1,312,1170,3575841819,3575841824,5
1,312,1171,3575841819,3575841824,5
1,312,1172,3575841819,3575841825,6
1,312,1173,3575841819,3575841828,9
1,312,1174,3575841819,3575841830,11
1,312,1175,3575841819,3575841832,13
1,312,1176,3575841819,3575841834,15
1,312,1177,3575841819,3575841834,15
1,312,1178,3575841819,3575841836,17
1,312,1179,3575841819,3575841839,20
1,312,1180,3575841819,3575841845,26
1,312,1181,3575841819,3575841848,29
1,312,1182,3575841819,3575841860,41
1,312,1183,3575841819,3575841863,44
1,312,1184,3575841819,3575841868,49
1,313,1185,3575841871,3575841874,3
1,313,1186,3575841871,3575841877,6
1,313,1187,3575841871,3575841879,8
1,313,1188,3575841871,3575841880,9
1,313,1189,3575841871,3575841885,14
1,313,1190,3575841871,3575841885,14
1,313,1191,3575841871,3575841886,15
1,313,1192,3575841871,3575841896,25
1,313,1193,3575841871,3575841905,34
1,313,1194,3575841871,3575841910,39
1,313,1195,3575841871,3575841913,42
1,313,1196,3575841871,3575841915,44
1,313,1197,3575841871,3575841921,50
1,314,1198,3575841922,3575841922,0
1,314,1199,3575841922,3575841930,8
1,314,1200,3575841922,3575841930,8
1,314,1201,3575841922,3575841932,10
1,314,1202,3575841922,3575841932,10
1,314,1203,3575841922,3575841941,19
1,314,1204,3575841922,3575841942,20
1,314,1205,3575841922,3575841945,23
1,314,1206,3575841922,3575841949,27
1,314,1207,3575841922,3575841954,32
1,314,1208,3575841922,3575841960,38
1,314,1209,3575841922,3575841967,45
1,314,1210,3575841922,3575841970,48
1,314,1211,3575841922,3575841972,50
1,315,1212,3575841974,3575841974,0
1,315,1213,3575841974,3575841974,0
1,315,1214,3575841974,3575841978,4
1,315,1215,3575841974,3575841978,4
1,315,1216,3575841974,3575841983,9
1,315,1217,3575841974,3575841989,15
1,315,1218,3575841974,3575841995,21
1,315,1219,3575841974,3575842001,27
1,315,1220,3575841974,3575842006,32
1,315,1221,3575841974,3575842007,33
1,315,1222,3575841974,3575842010,36
1,315,1223,3575841974,3575842011,37
1,315,1224,3575841974,3575842013,39
1,315,1225,3575841974,3575842014,40
1,315,1226,3575841974,3575842016,42
1,315,1227,3575841974,3575842018,44
1,316,1228,3575842026,3575842026,0
1,316,1229,3575842026,3575842026,0
1,316,1230,3575842026,3575842026,0
1,316,1231,3575842026,3575842028,2
1,316,1232,3575842026,3575842030,4
1,316,1233,3575842026,3575842033,7
1,316,1234,3575842026,3575842034,8
1,316,1235,3575842026,3575842034,8
1,316,1236,3575842026,3575842036,10
1,316,1237,3575842026,3575842037,11
1,316,1238,3575842026,3575842039,13
1,316,1239,3575842026,3575842045,19
1,316,1240,3575842026,3575842049,23
1,316,1241,3575842026,3575842061,35
1,316,1242,3575842026,3575842063,37
1,316,1243,3575842026,3575842068,42
1,316,1244,3575842026,3575842075,49
1,317,1245,3575842077,3575842077,0
1,317,1246,3575842077,3575842079,2
1,317,1247,3575842077,3575842081,4
1,317,1248,3575842077,3575842085,8
1,317,1249,3575842077,3575842086,9
1,317,1250,3575842077,3575842087,10
1,317,1251,3575842077,3575842096,19
1,317,1252,3575842077,3575842105,28
1,317,1253,3575842077,3575842110,33
1,317,1254,3575842077,3575842114,37
1,317,1255,3575842077,3575842114,37
1,317,1256,3575842077,3575842121,44
1,317,1257,3575842077,3575842122,45
1,318,1258,3575842129,3575842130,1
1,318,1259,3575842129,3575842131,2
1,318,1260,3575842129,3575842132,3
1,318,1261,3575842129,3575842132,3
1,318,1262,3575842129,3575842141,12
1,318,1263,3575842129,3575842142,13
1,318,1264,3575842129,3575842146,17
1,318,1265,3575842129,3575842149,20
1,318,1266,3575842129,3575842154,25
1,318,1267,3575842129,3575842159,30
1,318,1268,3575842129,3575842168,39
1,318,1269,3575842129,3575842170,41
1,318,1270,3575842129,3575842172,43
1,318,1271,3575842129,3575842172,43
1,318,1272,3575842129,3575842174,45
1,318,1273,3575842129,3575842174,45
1,318,1274,3575842129,3575842175,46
1,318,1275,3575842129,3575842177,48
1,318,1276,3575842129,3575842178,49
1,319,1277,3575842180,3575842183,3
1,319,1278,3575842180,3575842189,9
1,319,1279,3575842180,3575842194,14
1,319,1280,3575842180,3575842196,16
1,319,1281,3575842180,3575842202,22
1,319,1282,3575842180,3575842206,26
1,319,1283,3575842180,3575842208,28
1,319,1284,3575842180,3575842210,30
1,319,1285,3575842180,3575842211,31
1,319,1286,3575842180,3575842213,33
1,319,1287,3575842180,3575842215,35
1,319,1288,3575842180,3575842216,36
1,319,1289,3575842180,3575842218,38
1,319,1290,3575842180,3575842225,45
1,319,1291,3575842180,3575842226,46
1,319,1292,3575842180,3575842226,46
1,319,1293,3575842180,3575842229,49
1,320,1294,3575842231,3575842231,0
1,320,1295,3575842231,3575842232,1
1,320,1296,3575842231,3575842234,3
1,320,1297,3575842231,3575842235,4
1,320,1298,3575842231,3575842236,5
1,320,1299,3575842231,3575842236,5
1,320,1300,3575842231,3575842240,9
1,320,1301,3575842231,3575842244,13
1,320,1302,3575842231,3575842248,17
1,320,1303,3575842231,3575842251,20
1,320,1304,3575842231,3575842261,30
1,320,1305,3575842231,3575842264,33
1,320,1306,3575842231,3575842269,38
1,320,1307,3575842231,3575842275,44
1,320,1308,3575842231,3575842277,46
1,320,1309,3575842231,3575842279,48
1,320,1310,3575842231,3575842281,50
1,321,1311,3575842283,3575842285,2
1,321,1312,3575842283,3575842286,3
1,321,1313,3575842283,3575842287,4
1,321,1314,3575842283,3575842296,13
1,321,1315,3575842283,3575842306,23
1,321,1316,3575842283,3575842310,27
1,321,1317,3575842283,3575842313,30
1,321,1318,3575842283,3575842314,31
1,321,1319,3575842283,3575842321,38
1,321,1320,3575842283,3575842322,39
1,321,1321,3575842283,3575842329,46
1,321,1322,3575842283,3575842331,48
1,321,1323,3575842283,3575842332,49
1,321,1324,3575842283,3575842333,50
1,322,1325,3575842334,3575842341,7
1,322,1326,3575842334,3575842346,12
1,322,1327,3575842334,3575842350,16
1,322,1328,3575842334,3575842354,20
1,322,1329,3575842334,3575842361,27
1,322,1330,3575842334,3575842368,34
1,322,1331,3575842334,3575842370,36
1,322,1332,3575842334,3575842372,38
1,322,1333,3575842334,3575842373,39
1,322,1334,3575842334,3575842374,40
1,322,1335,3575842334,3575842375,41
1,322,1336,3575842334,3575842378,44
1,322,1337,3575842334,3575842378,44
1,322,1338,3575842334,3575842383,49
1,323,1339,3575842386,3575842389,3
1,323,1340,3575842386,3575842394,8
1,323,1341,3575842386,3575842397,11
1,323,1342,3575842386,3575842401,15
1,323,1343,3575842386,3575842406,20
1,323,1344,3575842386,3575842408,22
1,323,1345,3575842386,3575842410,24
1,323,1346,3575842386,3575842411,25
1,323,1347,3575842386,3575842413,27
1,323,1348,3575842386,3575842414,28
1,323,1349,3575842386,3575842417,31
1,323,1350,3575842386,3575842419,33
1,323,1351,3575842386,3575842426,40
1,323,1352,3575842386,3575842426,40
1,323,1353,3575842386,3575842427,41
1,323,1354,3575842386,3575842429,43
1,323,1355,3575842386,3575842430,44
1,323,1356,3575842386,3575842432,46
1,323,1357,3575842386,3575842434,48
1,323,1358,3575842386,3575842435,49
1,324,1359,3575842438,3575842438,0
1,324,1360,3575842438,3575842438,0
1,324,1361,3575842438,3575842440,2
1,324,1362,3575842438,3575842445,7
1,324,1363,3575842438,3575842449,11
1,324,1364,3575842438,3575842451,13
1,324,1365,3575842438,3575842461,23
1,324,1366,3575842438,3575842463,25
1,324,1367,3575842438,3575842469,31
1,324,1368,3575842438,3575842475,37
1,324,1369,3575842438,3575842477,39
1,324,1370,3575842438,3575842479,41
1,324,1371,3575842438,3575842481,43
1,324,1372,3575842438,3575842486,48
1,324,1373,3575842438,3575842486,48
1,324,1374,3575842438,3575842487,49
1,325,1375,3575842489,3575842495,6
1,325,1376,3575842489,3575842497,8
1,325,1377,3575842489,3575842505,16
1,325,1378,3575842489,3575842509,20
1,325,1379,3575842489,3575842513,24
1,325,1380,3575842489,3575842513,24
1,325,1381,3575842489,3575842520,31
1,325,1382,3575842489,3575842521,32
1,325,1383,3575842489,3575842529,40
1,325,1384,3575842489,3575842530,41
1,325,1385,3575842489,3575842531,42
1,325,1386,3575842489,3575842531,42
1,326,1387,3575842541,3575842541,0
1,326,1388,3575842541,3575842541,0
1,326,1389,3575842541,3575842545,4
1,326,1390,3575842541,3575842550,9
1,326,1391,3575842541,3575842553,12
1,326,1392,3575842541,3575842560,19
1,326,1393,3575842541,3575842568,27
1,326,1394,3575842541,3575842569,28
1,326,1395,3575842541,3575842572,31
1,326,1396,3575842541,3575842572,31
1,326,1397,3575842541,3575842573,32
1,326,1398,3575842541,3575842574,33
1,326,1399,3575842541,3575842574,33
1,326,1400,3575842541,3575842576,35
1,326,1401,3575842541,3575842576,35
1,326,1402,3575842541,3575842582,41
1,326,1403,3575842541,3575842588,47
1,327,1404,3575842593,3575842593,0
1,327,1405,3575842593,3575842596,3
1,327,1406,3575842593,3575842600,7
1,327,1407,3575842593,3575842600,7
1,327,1408,3575842593,3575842605,12
1,327,1409,3575842593,3575842607,14
1,327,1410,3575842593,3575842609,16
1,327,1411,3575842593,3575842610,17
1,327,1412,3575842593,3575842612,19
1,327,1413,3575842593,3575842614,21
1,327,1414,3575842593,3575842616,23
1,327,1415,3575842593,3575842617,24
1,327,1416,3575842593,3575842625,32
1,327,1417,3575842593,3575842625,32
1,327,1418,3575842593,3575842626,33
1,327,1419,3575842593,3575842629,36
1,327,1420,3575842593,3575842632,39
1,327,1421,3575842593,3575842633,40
1,327,1422,3575842593,3575842634,41
1,327,1423,3575842593,3575842635,42
1,327,1424,3575842593,3575842637,44
1,327,1425,3575842593,3575842639,46
1,328,1426,3575842645,3575842645,0
1,328,1427,3575842645,3575842649,4
1,328,1428,3575842645,3575842651,6
1,328,1429,3575842645,3575842660,15
1,328,1430,3575842645,3575842662,17
1,328,1431,3575842645,3575842667,22
1,328,1432,3575842645,3575842675,30
1,328,1433,3575842645,3575842676,31
1,328,1434,3575842645,3575842680,35
1,328,1435,3575842645,3575842680,35
1,328,1436,3575842645,3575842686,41
1,328,1437,3575842645,3575842686,41
1,328,1438,3575842645,3575842687,42
1,329,1439,3575842697,3575842697,0
1,329,1440,3575842697,3575842697,0
1,329,1441,3575842697,3575842705,8
1,329,1442,3575842697,3575842708,11
1,329,1443,3575842697,3575842713,16
1,329,1444,3575842697,3575842713,16
1,329,1445,3575842697,3575842720,23
1,329,1446,3575842697,3575842721,24
1,329,1447,3575842697,3575842729,32
1,329,1448,3575842697,3575842730,33
1,329,1449,3575842697,3575842732,35
1,329,1450,3575842697,3575842732,35
1,329,1451,3575842697,3575842740,43
1,329,1452,3575842697,3575842741,44
1,329,1453,3575842697,3575842745,48
1,330,1454,3575842749,3575842750,1
1,330,1455,3575842749,3575842751,2
1,330,1456,3575842749,3575842754,5
1,330,1457,3575842749,3575842760,11
1,330,1458,3575842749,3575842768,19
1,330,1459,3575842749,3575842769,20
1,330,1460,3575842749,3575842771,22
1,330,1461,3575842749,3575842772,23
1,330,1462,3575842749,3575842774,25
1,330,1463,3575842749,3575842774,25
1,330,1464,3575842749,3575842777,28
1,330,1465,3575842749,3575842777,28
1,330,1466,3575842749,3575842782,33
1,330,1467,3575842749,3575842788,39
1,330,1468,3575842749,3575842794,45
1,330,1469,3575842749,3575842796,47
1,331,1470,3575842802,3575842802,0
1,331,1471,3575842802,3575842802,0
1,331,1472,3575842802,3575842805,3
1,331,1473,3575842802,3575842807,5
1,331,1474,3575842802,3575842809,7
1,331,1475,3575842802,3575842810,8
1,331,1476,3575842802,3575842812,10
1,331,1477,3575842802,3575842813,11
1,331,1478,3575842802,3575842816,14
1,331,1479,3575842802,3575842818,16
1,331,1480,3575842802,3575842825,23
1,331,1481,3575842802,3575842825,23
1,331,1482,3575842802,3575842826,24
1,331,1483,3575842802,3575842830,28
1,331,1484,3575842802,3575842832,30
1,331,1485,3575842802,3575842833,31
1,331,1486,3575842802,3575842834,32
1,331,1487,3575842802,3575842835,33
1,331,1488,3575842802,3575842837,35
1,331,1489,3575842802,3575842839,37
1,331,1490,3575842802,3575842844,42
1,331,1491,3575842802,3575842849,47
1,331,1492,3575842802,3575842851,49
1,332,1493,3575842854,3575842859,5
1,332,1494,3575842854,3575842862,8
1,332,1495,3575842854,3575842868,14
1,332,1496,3575842854,3575842877,23
1,332,1497,3575842854,3575842880,26
1,332,1498,3575842854,3575842880,26
1,332,1499,3575842854,3575842885,31
1,332,1500,3575842854,3575842886,32
1,332,1501,3575842854,3575842887,33
1,332,1502,3575842854,3575842897,43
1,332,1503,3575842854,3575842897,43
1,333,1504,3575842906,3575842906,0
1,333,1505,3575842906,3575842909,3
1,333,1506,3575842906,3575842913,7
1,333,1507,3575842906,3575842913,7
1,333,1508,3575842906,3575842920,14
1,333,1509,3575842906,3575842921,15
1,333,1510,3575842906,3575842929,23
1,333,1511,3575842906,3575842931,25
1,333,1512,3575842906,3575842931,25
1,333,1513,3575842906,3575842932,26
1,333,1514,3575842906,3575842940,34
1,333,1515,3575842906,3575842941,35
1,333,1516,3575842906,3575842946,40
1,333,1517,3575842906,3575842950,44
1,333,1518,3575842906,3575842952,46
1,333,1519,3575842906,3575842953,47
1,333,1520,3575842906,3575842954,48
1,334,1521,3575842958,3575842960,2
1,334,1522,3575842958,3575842967,9
1,334,1523,3575842958,3575842970,12
1,334,1524,3575842958,3575842972,14
1,334,1525,3575842958,3575842972,14
1,334,1526,3575842958,3575842974,16
1,334,1527,3575842958,3575842974,16
1,334,1528,3575842958,3575842974,16
1,334,1529,3575842958,3575842977,19
1,334,1530,3575842958,3575842977,19
1,334,1531,3575842958,3575842982,24
1,334,1532,3575842958,3575842989,31
1,334,1533,3575842958,3575842995,37
1,334,1534,3575842958,3575842996,38
1,334,1535,3575842958,3575843000,42
1,334,1536,3575842958,3575843001,43
1,334,1537,3575842958,3575843006,48
1,334,1538,3575842958,3575843008,50
1,335,1539,3575843011,3575843011,0
1,335,1540,3575843011,3575843011,0
1,335,1541,3575843011,3575843012,1
1,335,1542,3575843011,3575843014,3
1,335,1543,3575843011,3575843016,5
1,335,1544,3575843011,3575843019,8
1,335,1545,3575843011,3575843025,14
1,335,1546,3575843011,3575843025,14
1,335,1547,3575843011,3575843026,15
1,335,1548,3575843011,3575843028,17
1,335,1549,3575843011,3575843030,19
1,335,1550,3575843011,3575843031,20
1,335,1551,3575843011,3575843033,22
1,335,1552,3575843011,3575843034,23
1,335,1553,3575843011,3575843035,24
1,335,1554,3575843011,3575843037,26
1,335,1555,3575843011,3575843038,27
1,335,1556,3575843011,3575843045,34
1,335,1557,3575843011,3575843049,38
1,335,1558,3575843011,3575843052,41
1,335,1559,3575843011,3575843055,44
1,335,1560,3575843011,3575843059,48
1,336,1561,3575843063,3575843063,0
1,336,1562,3575843063,3575843068,5
1,336,1563,3575843063,3575843076,13
1,336,1564,3575843063,3575843080,17
1,336,1565,3575843063,3575843081,18
1,336,1566,3575843063,3575843085,22
1,336,1567,3575843063,3575843086,23
1,336,1568,3575843063,3575843087,24
1,336,1569,3575843063,3575843097,34
1,336,1570,3575843063,3575843097,34
1,336,1571,3575843063,3575843105,42
1,336,1572,3575843063,3575843109,46
1,336,1573,3575843063,3575843113,50
1,337,1574,3575843115,3575843115,0
1,337,1575,3575843115,3575843120,5
1,337,1576,3575843115,3575843121,6
1,337,1577,3575843115,3575843129,14
1,337,1578,3575843115,3575843131,16
1,337,1579,3575843115,3575843131,16
1,337,1580,3575843115,3575843132,17
1,337,1581,3575843115,3575843141,26
1,337,1582,3575843115,3575843151,36
1,337,1583,3575843115,3575843152,37
1,337,1584,3575843115,3575843153,38
1,337,1585,3575843115,3575843153,38
1,337,1586,3575843115,3575843160,45
1,338,1587,3575843167,3575843167,0
1,338,1588,3575843167,3575843170,3
1,338,1589,3575843167,3575843172,5
1,338,1590,3575843167,3575843172,5
1,338,1591,3575843167,3575843174,7
1,338,1592,3575843167,3575843174,7
1,338,1593,3575843167,3575843177,10
1,338,1594,3575843167,3575843177,10
1,338,1595,3575843167,3575843183,16
1,338,1596,3575843167,3575843189,22
1,338,1597,3575843167,3575843195,28
1,338,1598,3575843167,3575843197,30
1,338,1599,3575843167,3575843201,34
1,338,1600,3575843167,3575843201,34
1,338,1601,3575843167,3575843206,39
1,338,1602,3575843167,3575843209,42
1,338,1603,3575843167,3575843210,43
1,338,1604,3575843167,3575843210,43
1,338,1605,3575843167,3575843212,45
1,338,1606,3575843167,3575843213,46
1,338,1607,3575843167,3575843216,49
1,339,1608,3575843219,3575843219,0
1,339,1609,3575843219,3575843225,6
1,339,1610,3575843219,3575843225,6
1,339,1611,3575843219,3575843226,7
1,339,1612,3575843219,3575843229,10
1,339,1613,3575843219,3575843230,11
1,339,1614,3575843219,3575843231,12
1,339,1615,3575843219,3575843234,15
1,339,1616,3575843219,3575843235,16
1,339,1617,3575843219,3575843235,16
1,339,1618,3575843219,3575843237,18
1,339,1619,3575843219,3575843239,20
1,339,1620,3575843219,3575843245,26
1,339,1621,3575843219,3575843249,30
1,339,1622,3575843219,3575843252,33
1,339,1623,3575843219,3575843255,36
1,339,1624,3575843219,3575843260,41
1,339,1625,3575843219,3575843262,43
1,339,1626,3575843219,3575843268,49
1,340,1627,3575843271,3575843274,3
1,340,1628,3575843271,3575843276,5
1,340,1629,3575843271,3575843280,9
1,340,1630,3575843271,3575843281,10
1,340,1631,3575843271,3575843285,14
1,340,1632,3575843271,3575843286,15
1,340,1633,3575843271,3575843288,17
1,340,1634,3575843271,3575843297,26
1,340,1635,3575843271,3575843297,26
1,340,1636,3575843271,3575843305,34
1,340,1637,3575843271,3575843310,39
1,340,1638,3575843271,3575843312,41
1,340,1639,3575843271,3575843314,43
1,340,1640,3575843271,3575843320,49
1,341,1641,3575843323,3575843323,0
1,341,1642,3575843323,3575843330,7
1,341,1643,3575843323,3575843331,8
1,341,1644,3575843323,3575843331,8
1,341,1645,3575843323,3575843342,19
1,341,1646,3575843323,3575843351,28
1,341,1647,3575843323,3575843351,28
1,341,1648,3575843323,3575843353,30
1,341,1649,3575843323,3575843353,30
1,341,1650,3575843323,3575843361,38
1,341,1651,3575843323,3575843367,44
1,341,1652,3575843323,3575843370,47
1,341,1653,3575843323,3575843373,50
1,342,1654,3575843375,3575843375,0
1,342,1655,3575843375,3575843375,0
1,342,1656,3575843375,3575843375,0
1,342,1657,3575843375,3575843375,0
1,342,1658,3575843375,3575843377,2
1,342,1659,3575843375,3575843383,8
1,342,1660,3575843375,3575843389,14
1,342,1661,3575843375,3575843395,20
1,342,1662,3575843375,3575843397,22
1,342,1663,3575843375,3575843401,26
1,342,1664,3575843375,3575843402,27
1,342,1665,3575843375,3575843406,31
1,342,1666,3575843375,3575843408,33
1,342,1667,3575843375,3575843409,34
1,342,1668,3575843375,3575843411,36
1,342,1669,3575843375,3575843412,37
1,342,1670,3575843375,3575843413,38
1,342,1671,3575843375,3575843416,41
1,342,1672,3575843375,3575843420,45
1,342,1673,3575843375,3575843424,49
1,342,1674,3575843375,3575843425,50
1,343,1675,3575843428,3575843428,0
1,343,1676,3575843428,3575843429,1
1,343,1677,3575843428,3575843430,2
1,343,1678,3575843428,3575843432,4
1,343,1679,3575843428,3575843434,6
1,343,1680,3575843428,3575843435,7
1,343,1681,3575843428,3575843436,8
1,343,1682,3575843428,3575843437,9
1,343,1683,3575843428,3575843439,11
1,343,1684,3575843428,3575843445,17
1,343,1685,3575843428,3575843449,21
1,343,1686,3575843428,3575843452,24
1,343,1687,3575843428,3575843455,27
1,343,1688,3575843428,3575843460,32
1,343,1689,3575843428,3575843464,36
1,343,1690,3575843428,3575843468,40
1,343,1691,3575843428,3575843475,47
1,343,1692,3575843428,3575843476,48
1,344,1693,3575843481,3575843481,0
1,344,1694,3575843481,3575843481,0
1,344,1695,3575843481,3575843484,3
1,344,1696,3575843481,3575843485,4
1,344,1697,3575843481,3575843487,6
1,344,1698,3575843481,3575843496,15
1,344,1699,3575843481,3575843496,15
1,344,1700,3575843481,3575843504,23
1,344,1701,3575843481,3575843509,28
1,344,1702,3575843481,3575843511,30
1,344,1703,3575843481,3575843513,32
1,344,1704,3575843481,3575843519,38
1,344,1705,3575843481,3575843521,40
1,344,1706,3575843481,3575843528,47
1,344,1707,3575843481,3575843530,49
1,344,1708,3575843481,3575843530,49
1,345,1709,3575843533,3575843539,6
1,345,1710,3575843533,3575843541,8
1,345,1711,3575843533,3575843550,17
1,345,1712,3575843533,3575843551,18
1,345,1713,3575843533,3575843552,19
1,345,1714,3575843533,3575843552,19
1,345,1715,3575843533,3575843560,27
1,345,1716,3575843533,3575843566,33
1,345,1717,3575843533,3575843569,36
1,345,1718,3575843533,3575843572,39
1,345,1719,3575843533,3575843572,39
1,345,1720,3575843533,3575843574,41
1,345,1721,3575843533,3575843575,42
1,345,1722,3575843533,3575843577,44
1,345,1723,3575843533,3575843582,49
1,346,1724,3575843585,3575843588,3
1,346,1725,3575843585,3575843594,9
1,346,1726,3575843585,3575843595,10
1,346,1727,3575843585,3575843601,16
1,346,1728,3575843585,3575843601,16
1,346,1729,3575843585,3575843605,20
1,346,1730,3575843585,3575843607,22
1,346,1731,3575843585,3575843609,24
1,346,1732,3575843585,3575843611,26
1,346,1733,3575843585,3575843612,27
1,346,1734,3575843585,3575843614,29
1,346,1735,3575843585,3575843615,30
1,346,1736,3575843585,3575843618,33
1,346,1737,3575843585,3575843625,40
1,346,1738,3575843585,3575843625,40
1,346,1739,3575843585,3575843625,40
1,346,1740,3575843585,3575843628,43
1,346,1741,3575843585,3575843629,44
1,346,1742,3575843585,3575843631,46
1,346,1743,3575843585,3575843634,49
1,346,1744,3575843585,3575843634,49
1,346,1745,3575843585,3575843635,50
1,347,1746,3575843637,3575843637,0
1,347,1747,3575843637,3575843639,2
1,347,1748,3575843637,3575843644,7
1,347,1749,3575843637,3575843648,11
1,347,1750,3575843637,3575843651,14
1,347,1751,3575843637,3575843653,16
1,347,1752,3575843637,3575843660,23
1,347,1753,3575843637,3575843663,26
1,347,1754,3575843637,3575843665,28
1,347,1755,3575843637,3575843668,31
1,347,1756,3575843637,3575843675,38
1,347,1757,3575843637,3575843677,40
1,347,1758,3575843637,3575843680,43
1,347,1759,3575843637,3575843680,43
1,347,1760,3575843637,3575843685,48
1,347,1761,3575843637,3575843686,49
1,348,1762,3575843689,3575843692,3
1,348,1763,3575843689,3575843696,7
1,348,1764,3575843689,3575843696,7
1,348,1765,3575843689,3575843704,15
1,348,1766,3575843689,3575843709,20
1,348,1767,3575843689,3575843712,23
1,348,1768,3575843689,3575843713,24
1,348,1769,3575843689,3575843719,30
1,348,1770,3575843689,3575843721,32
1,348,1771,3575843689,3575843729,40
1,348,1772,3575843689,3575843730,41
1,348,1773,3575843689,3575843730,41
1,348,1774,3575843689,3575843733,44
1,349,1775,3575843741,3575843741,0
1,349,1776,3575843741,3575843741,0
1,349,1777,3575843741,3575843750,9
1,349,1778,3575843741,3575843751,10
1,349,1779,3575843741,3575843753,12
1,349,1780,3575843741,3575843754,13
1,349,1781,3575843741,3575843759,18
1,349,1782,3575843741,3575843767,26
1,349,1783,3575843741,3575843768,27
1,349,1784,3575843741,3575843769,28
1,349,1785,3575843741,3575843772,31
1,349,1786,3575843741,3575843774,33
1,349,1787,3575843741,3575843774,33
1,349,1788,3575843741,3575843774,33
1,349,1789,3575843741,3575843777,36
1,349,1790,3575843741,3575843782,41
1,349,1791,3575843741,3575843788,47
1,350,1792,3575843793,3575843795,2
1,350,1793,3575843793,3575843796,3
1,350,1794,3575843793,3575843800,7
1,350,1795,3575843793,3575843801,8
1,350,1796,3575843793,3575843805,12
1,350,1797,3575843793,3575843808,15
1,350,1798,3575843793,3575843809,16
1,350,1799,3575843793,3575843811,18
1,350,1800,3575843793,3575843812,19
1,350,1801,3575843793,3575843813,20
1,350,1802,3575843793,3575843816,23
1,350,1803,3575843793,3575843819,26
1,350,1804,3575843793,3575843824,31
1,350,1805,3575843793,3575843825,32
1,350,1806,3575843793,3575843826,33
1,350,1807,3575843793,3575843828,35
1,350,1808,3575843793,3575843830,37
1,350,1809,3575843793,3575843830,37
1,350,1810,3575843793,3575843834,41
1,350,1811,3575843793,3575843834,41
1,350,1812,3575843793,3575843836,43
1,350,1813,3575843793,3575843837,44
1,350,1814,3575843793,3575843838,45
1,351,1815,3575843845,3575843845,0
1,351,1816,3575843845,3575843849,4
1,351,1817,3575843845,3575843851,6
1,351,1818,3575843845,3575843854,9
1,351,1819,3575843845,3575843859,14
1,351,1820,3575843845,3575843862,17
1,351,1821,3575843845,3575843865,20
1,351,1822,3575843845,3575843868,23
1,351,1823,3575843845,3575843877,32
1,351,1824,3575843845,3575843880,35
1,351,1825,3575843845,3575843880,35
1,351,1826,3575843845,3575843884,39
1,351,1827,3575843845,3575843886,41
1,351,1828,3575843845,3575843892,47
1,352,1829,3575843897,3575843897,0
1,352,1830,3575843897,3575843897,0
1,352,1831,3575843897,3575843905,8
1,352,1832,3575843897,3575843909,12
1,352,1833,3575843897,3575843911,14
1,352,1834,3575843897,3575843913,16
1,352,1835,3575843897,3575843919,22
1,352,1836,3575843897,3575843921,24
1,352,1837,3575843897,3575843929,32
1,352,1838,3575843897,3575843931,34
1,352,1839,3575843897,3575843932,35
1,352,1840,3575843897,3575843939,42
1,352,1841,3575843897,3575843941,44
1,353,1842,3575843949,3575843950,1
1,353,1843,3575843949,3575843950,1
1,353,1844,3575843949,3575843952,3
1,353,1845,3575843949,3575843953,4
1,353,1846,3575843949,3575843960,11
1,353,1847,3575843949,3575843967,18
1,353,1848,3575843949,3575843967,18
1,353,1849,3575843949,3575843970,21
1,353,1850,3575843949,3575843971,22
1,353,1851,3575843949,3575843974,25
1,353,1852,3575843949,3575843975,26
1,353,1853,3575843949,3575843978,29
1,353,1854,3575843949,3575843982,33
1,353,1855,3575843949,3575843988,39
1,353,1856,3575843949,3575843995,46
1,353,1857,3575843949,3575843995,46
1,354,1858,3575844001,3575844001,0
1,354,1859,3575844001,3575844001,0
1,354,1860,3575844001,3575844006,5
1,354,1861,3575844001,3575844008,7
1,354,1862,3575844001,3575844009,8
1,354,1863,3575844001,3575844011,10
1,354,1864,3575844001,3575844012,11
1,354,1865,3575844001,3575844013,12
1,354,1866,3575844001,3575844016,15
1,354,1867,3575844001,3575844019,18
1,354,1868,3575844001,3575844024,23
1,354,1869,3575844001,3575844025,24
1,354,1870,3575844001,3575844026,25
1,354,1871,3575844001,3575844029,28
1,354,1872,3575844001,3575844030,29
1,354,1873,3575844001,3575844032,31
1,354,1874,3575844001,3575844034,33
1,354,1875,3575844001,3575844034,33
1,354,1876,3575844001,3575844036,35
1,354,1877,3575844001,3575844037,36
1,354,1878,3575844001,3575844038,37
1,354,1879,3575844001,3575844049,48
1,354,1880,3575844001,3575844051,50
1,355,1881,3575844054,3575844054,0
1,355,1882,3575844054,3575844059,5
1,355,1883,3575844054,3575844063,9
1,355,1884,3575844054,3575844064,10
1,355,1885,3575844054,3575844068,14
1,355,1886,3575844054,3575844076,22
1,355,1887,3575844054,3575844080,26
1,355,1888,3575844054,3575844080,26
1,355,1889,3575844054,3575844084,30
1,355,1890,3575844054,3575844085,31
1,355,1891,3575844054,3575844086,32
1,355,1892,3575844054,3575844092,38
1,355,1893,3575844054,3575844096,42
1,355,1894,3575844054,3575844096,42
1,356,1895,3575844106,3575844106,0
1,356,1896,3575844106,3575844109,3
1,356,1897,3575844106,3575844111,5
1,356,1898,3575844106,3575844113,7
1,356,1899,3575844106,3575844119,13
1,356,1900,3575844106,3575844121,15
1,356,1901,3575844106,3575844129,23
1,356,1902,3575844106,3575844132,26
1,356,1903,3575844106,3575844133,27
1,356,1904,3575844106,3575844139,33
1,356,1905,3575844106,3575844141,35
1,356,1906,3575844106,3575844150,44
1,356,1907,3575844106,3575844151,45
1,356,1908,3575844106,3575844153,47
1,356,1909,3575844106,3575844153,47
1,357,1910,3575844158,3575844160,2
1,357,1911,3575844158,3575844167,9
1,357,1912,3575844158,3575844167,9
1,357,1913,3575844158,3575844170,12
1,357,1914,3575844158,3575844172,14
1,357,1915,3575844158,3575844174,16
1,357,1916,3575844158,3575844174,16
1,357,1917,3575844158,3575844175,17
1,357,1918,3575844158,3575844178,20
1,357,1919,3575844158,3575844183,25
1,357,1920,3575844158,3575844188,30
1,357,1921,3575844158,3575844195,37
1,357,1922,3575844158,3575844196,38
1,357,1923,3575844158,3575844201,43
1,357,1924,3575844158,3575844201,43
1,357,1925,3575844158,3575844206,48
1,358,1926,3575844210,3575844210,0
1,358,1927,3575844210,3575844210,0
1,358,1928,3575844210,3575844211,1
1,358,1929,3575844210,3575844212,2
1,358,1930,3575844210,3575844214,4
1,358,1931,3575844210,3575844216,6
1,358,1932,3575844210,3575844219,9
1,358,1933,3575844210,3575844224,14
1,358,1934,3575844210,3575844225,15
1,358,1935,3575844210,3575844226,16
1,358,1936,3575844210,3575844229,19
1,358,1937,3575844210,3575844230,20
1,358,1938,3575844210,3575844231,21
1,358,1939,3575844210,3575844234,24
1,358,1940,3575844210,3575844234,24
1,358,1941,3575844210,3575844236,26
1,358,1942,3575844210,3575844236,26
1,358,1943,3575844210,3575844239,29
1,358,1944,3575844210,3575844248,38
1,358,1945,3575844210,3575844251,41
1,358,1946,3575844210,3575844253,43
1,359,1947,3575844262,3575844262,0
1,359,1948,3575844262,3575844263,1
1,359,1949,3575844262,3575844265,3
1,359,1950,3575844262,3575844269,7
1,359,1951,3575844262,3575844275,13
1,359,1952,3575844262,3575844276,14
1,359,1953,3575844262,3575844280,18
1,359,1954,3575844262,3575844280,18
1,359,1955,3575844262,3575844285,23
1,359,1956,3575844262,3575844285,23
1,359,1957,3575844262,3575844286,24
1,359,1958,3575844262,3575844292,30
1,359,1959,3575844262,3575844295,33
1,359,1960,3575844262,3575844297,35
1,359,1961,3575844262,3575844305,43
1,359,1962,3575844262,3575844310,48
1,359,1963,3575844262,3575844311,49
1,360,1964,3575844314,3575844314,0
1,360,1965,3575844314,3575844319,5
1,360,1966,3575844314,3575844322,8
1,360,1967,3575844314,3575844329,15
1,360,1968,3575844314,3575844330,16
1,360,1969,3575844314,3575844331,17
1,360,1970,3575844314,3575844332,18
1,360,1971,3575844314,3575844340,26
1,360,1972,3575844314,3575844341,27
1,360,1973,3575844314,3575844350,36
1,360,1974,3575844314,3575844351,37
1,360,1975,3575844314,3575844352,38
1,360,1976,3575844314,3575844353,39
1,360,1977,3575844314,3575844361,47
1,361,1978,3575844366,3575844367,1
1,361,1979,3575844366,3575844368,2
1,361,1980,3575844366,3575844370,4
1,361,1981,3575844366,3575844373,7
1,361,1982,3575844366,3575844374,8
1,361,1983,3575844366,3575844374,8
1,361,1984,3575844366,3575844378,12
1,361,1985,3575844366,3575844383,17
1,361,1986,3575844366,3575844388,22
1,361,1987,3575844366,3575844395,29
1,361,1988,3575844366,3575844396,30
1,361,1989,3575844366,3575844400,34
1,361,1990,3575844366,3575844401,35
1,361,1991,3575844366,3575844407,41
1,361,1992,3575844366,3575844408,42
1,361,1993,3575844366,3575844410,44
1,361,1994,3575844366,3575844411,45
1,361,1995,3575844366,3575844412,46
1,361,1996,3575844366,3575844413,47
1,361,1997,3575844366,3575844416,50
1,362,1998,3575844418,3575844419,1
1,362,1999,3575844418,3575844425,7
1,362,2000,3575844418,3575844425,7
1,362,2001,3575844418,3575844426,8
1,362,2002,3575844418,3575844426,8
1,362,2003,3575844418,3575844429,11
1,362,2004,3575844418,3575844430,12
1,362,2005,3575844418,3575844432,14
1,362,2006,3575844418,3575844434,16
1,362,2007,3575844418,3575844434,16
1,362,2008,3575844418,3575844436,18
1,362,2009,3575844418,3575844437,19
1,362,2010,3575844418,3575844439,21
1,362,2011,3575844418,3575844445,27
1,362,2012,3575844418,3575844449,31
1,362,2013,3575844418,3575844451,33
1,362,2014,3575844418,3575844453,35
1,362,2015,3575844418,3575844462,44
1,362,2016,3575844418,3575844465,47
1,363,2017,3575844470,3575844470,0
1,363,2018,3575844470,3575844475,5
1,363,2019,3575844470,3575844476,6
1,363,2020,3575844470,3575844477,7
1,363,2021,3575844470,3575844480,10
1,363,2022,3575844470,3575844480,10
1,363,2023,3575844470,3575844485,15
1,363,2024,3575844470,3575844485,15
1,363,2025,3575844470,3575844487,17
1,363,2026,3575844470,3575844492,22
1,363,2027,3575844470,3575844496,26
1,363,2028,3575844470,3575844496,26
1,363,2029,3575844470,3575844505,35
1,363,2030,3575844470,3575844510,40
1,363,2031,3575844470,3575844512,42
1,363,2032,3575844470,3575844514,44
1,363,2033,3575844470,3575844519,49
1,364,2034,3575844522,3575844522,0
1,364,2035,3575844522,3575844529,7
1,364,2036,3575844522,3575844531,9
1,364,2037,3575844522,3575844531,9
1,364,2038,3575844522,3575844539,17
1,364,2039,3575844522,3575844541,19
1,364,2040,3575844522,3575844549,27
1,364,2041,3575844522,3575844549,27
1,364,2042,3575844522,3575844552,30
1,364,2043,3575844522,3575844552,30
1,364,2044,3575844522,3575844559,37
1,364,2045,3575844522,3575844566,44
1,364,2046,3575844522,3575844567,45
1,364,2047,3575844522,3575844570,48
1,364,2048,3575844522,3575844571,49
1,365,2049,3575844574,3575844574,0
1,365,2050,3575844574,3575844574,0
1,365,2051,3575844574,3575844575,1
1,365,2052,3575844574,3575844577,3
1,365,2053,3575844574,3575844578,4
1,365,2054,3575844574,3575844582,8
1,365,2055,3575844574,3575844587,13
1,365,2056,3575844574,3575844594,20
1,365,2057,3575844574,3575844596,22
1,365,2058,3575844574,3575844599,25
1,365,2059,3575844574,3575844600,26
1,365,2060,3575844574,3575844605,31
1,365,2061,3575844574,3575844608,34
1,365,2062,3575844574,3575844609,35
1,365,2063,3575844574,3575844610,36
1,365,2064,3575844574,3575844612,38
1,365,2065,3575844574,3575844613,39
1,365,2066,3575844574,3575844615,41
1,365,2067,3575844574,3575844618,44
1,366,2068,3575844626,3575844626,0
1,366,2069,3575844626,3575844626,0
1,366,2070,3575844626,3575844626,0
1,366,2071,3575844626,3575844626,0
1,366,2072,3575844626,3575844628,2
1,366,2073,3575844626,3575844629,3
1,366,2074,3575844626,3575844631,5
1,366,2075,3575844626,3575844633,7
1,366,2076,3575844626,3575844634,8
1,366,2077,3575844626,3575844635,9
1,366,2078,3575844626,3575844636,10
1,366,2079,3575844626,3575844639,13
1,366,2080,3575844626,3575844644,18
1,366,2081,3575844626,3575844648,22
1,366,2082,3575844626,3575844651,25
1,366,2083,3575844626,3575844653,27
1,366,2084,3575844626,3575844661,35
1,366,2085,3575844626,3575844664,38
1,366,2086,3575844626,3575844669,43
1,366,2087,3575844626,3575844675,49
1,367,2088,3575844678,3575844678,0
1,367,2089,3575844678,3575844678,0
1,367,2090,3575844678,3575844680,2
1,367,2091,3575844678,3575844681,3
1,367,2092,3575844678,3575844685,7
1,367,2093,3575844678,3575844685,7
1,367,2094,3575844678,3575844687,9
1,367,2095,3575844678,3575844692,14
1,367,2096,3575844678,3575844695,17
1,367,2097,3575844678,3575844697,19
1,367,2098,3575844678,3575844705,27
1,367,2099,3575844678,3575844709,31
1,367,2100,3575844678,3575844712,34
1,367,2101,3575844678,3575844714,36
1,367,2102,3575844678,3575844719,41
1,367,2103,3575844678,3575844722,44
1,367,2104,3575844678,3575844728,50
1,368,2105,3575844730,3575844730,0
1,368,2106,3575844730,3575844732,2
1,368,2107,3575844730,3575844741,11
1,368,2108,3575844730,3575844749,19
1,368,2109,3575844730,3575844750,20
1,368,2110,3575844730,3575844752,22
1,368,2111,3575844730,3575844753,23
1,368,2112,3575844730,3575844759,29
1,368,2113,3575844730,3575844767,37
1,368,2114,3575844730,3575844768,38
1,368,2115,3575844730,3575844769,39
1,368,2116,3575844730,3575844772,42
1,368,2117,3575844730,3575844774,44
1,368,2118,3575844730,3575844774,44
1,368,2119,3575844730,3575844774,44
1,368,2120,3575844730,3575844776,46
1,368,2121,3575844730,3575844777,47
1,369,2122,3575844782,3575844782,0
1,369,2123,3575844782,3575844787,5
1,369,2124,3575844782,3575844794,12
1,369,2125,3575844782,3575844797,15
1,369,2126,3575844782,3575844800,18
1,369,2127,3575844782,3575844800,18
1,369,2128,3575844782,3575844805,23
1,369,2129,3575844782,3575844808,26
1,369,2130,3575844782,3575844809,27
1,369,2131,3575844782,3575844810,28
1,369,2132,3575844782,3575844812,30
1,369,2133,3575844782,3575844812,30
1,369,2134,3575844782,3575844816,34
1,369,2135,3575844782,3575844818,36
1,369,2136,3575844782,3575844824,42
1,369,2137,3575844782,3575844825,43
1,369,2138,3575844782,3575844826,44
1,369,2139,3575844782,3575844826,44
1,369,2140,3575844782,3575844829,47
1,369,2141,3575844782,3575844830,48
1,369,2142,3575844782,3575844830,48
1,370,2143,3575844835,3575844835,0
1,370,2144,3575844835,3575844835,0
1,370,2145,3575844835,3575844836,1
1,370,2146,3575844835,3575844837,2
1,370,2147,3575844835,3575844838,3
1,370,2148,3575844835,3575844844,9
1,370,2149,3575844835,3575844849,14
1,370,2150,3575844835,3575844851,16
1,370,2151,3575844835,3575844854,19
1,370,2152,3575844835,3575844860,25
1,370,2153,3575844835,3575844862,27
1,370,2154,3575844835,3575844863,28
1,370,2155,3575844835,3575844868,33
1,370,2156,3575844835,3575844875,40
1,370,2157,3575844835,3575844876,41
1,370,2158,3575844835,3575844877,42
1,370,2159,3575844835,3575844880,45
1,370,2160,3575844835,3575844881,46
1,370,2161,3575844835,3575844885,50
1,371,2162,3575844888,3575844888,0
1,371,2163,3575844888,3575844888,0
1,371,2164,3575844888,3575844893,5
1,371,2165,3575844888,3575844896,8
1,371,2166,3575844888,3575844897,9
1,371,2167,3575844888,3575844905,17
1,371,2168,3575844888,3575844910,22
1,371,2169,3575844888,3575844912,24
1,371,2170,3575844888,3575844915,27
1,371,2171,3575844888,3575844919,31
1,371,2172,3575844888,3575844922,34
1,371,2173,3575844888,3575844928,40
1,371,2174,3575844888,3575844931,43
1,371,2175,3575844888,3575844931,43
1,371,2176,3575844888,3575844932,44
1,372,2177,3575844941,3575844941,0
1,372,2178,3575844941,3575844949,8
1,372,2179,3575844941,3575844949,8
1,372,2180,3575844941,3575844952,11
1,372,2181,3575844941,3575844953,12
1,372,2182,3575844941,3575844959,18
1,372,2183,3575844941,3575844967,26
1,372,2184,3575844941,3575844968,27
1,372,2185,3575844941,3575844970,29
1,372,2186,3575844941,3575844972,31
1,372,2187,3575844941,3575844974,33
1,372,2188,3575844941,3575844974,33
1,372,2189,3575844941,3575844975,34
1,372,2190,3575844941,3575844976,35
1,372,2191,3575844941,3575844977,36
1,372,2192,3575844941,3575844983,42
1,372,2193,3575844941,3575844987,46
1,373,2194,3575844993,3575844994,1
1,373,2195,3575844993,3575844997,4
1,373,2196,3575844993,3575845000,7
1,373,2197,3575844993,3575845000,7
1,373,2198,3575844993,3575845006,13
1,373,2199,3575844993,3575845008,15
1,373,2200,3575844993,3575845009,16
1,373,2201,3575844993,3575845010,17
1,373,2202,3575844993,3575845012,19
1,373,2203,3575844993,3575845012,19
1,373,2204,3575844993,3575845016,23
1,373,2205,3575844993,3575845018,25
1,373,2206,3575844993,3575845025,32
1,373,2207,3575844993,3575845025,32
1,373,2208,3575844993,3575845026,33
1,373,2209,3575844993,3575845026,33
1,373,2210,3575844993,3575845028,35
1,373,2211,3575844993,3575845030,37
1,373,2212,3575844993,3575845032,39
1,373,2213,3575844993,3575845033,40
1,373,2214,3575844993,3575845035,42
1,373,2215,3575844993,3575845036,43
1,373,2216,3575844993,3575845038,45
1,373,2217,3575844993,3575845039,46
1,374,2218,3575845045,3575845045,0
1,374,2219,3575845045,3575845048,3
1,374,2220,3575845045,3575845053,8
1,374,2221,3575845045,3575845060,15
1,374,2222,3575845045,3575845063,18
1,374,2223,3575845045,3575845064,19
1,374,2224,3575845045,3575845068,23
1,374,2225,3575845045,3575845075,30
1,374,2226,3575845045,3575845077,32
1,374,2227,3575845045,3575845077,32
1,374,2228,3575845045,3575845080,35
1,374,2229,3575845045,3575845081,36
1,374,2230,3575845045,3575845084,39
1,374,2231,3575845045,3575845085,40
1,374,2232,3575845045,3575845086,41
1,374,2233,3575845045,3575845087,42
1,374,2234,3575845045,3575845092,47
1,375,2235,3575845097,3575845097,0
1,375,2236,3575845097,3575845098,1
1,375,2237,3575845097,3575845105,8
1,375,2238,3575845097,3575845109,12
1,375,2239,3575845097,3575845112,15
1,375,2240,3575845097,3575845114,17
1,375,2241,3575845097,3575845120,23
1,375,2242,3575845097,3575845122,25
1,375,2243,3575845097,3575845128,31
1,375,2244,3575845097,3575845131,34
1,375,2245,3575845097,3575845132,35
1,375,2246,3575845097,3575845132,35
1,375,2247,3575845097,3575845141,44
1,376,2248,3575845150,3575845150,0
1,376,2249,3575845150,3575845150,0
1,376,2250,3575845150,3575845153,3
1,376,2251,3575845150,3575845153,3
1,376,2252,3575845150,3575845159,9
1,376,2253,3575845150,3575845167,17
1,376,2254,3575845150,3575845168,18
1,376,2255,3575845150,3575845170,20
1,376,2256,3575845150,3575845172,22
1,376,2257,3575845150,3575845174,24
1,376,2258,3575845150,3575845174,24
1,376,2259,3575845150,3575845175,25
1,376,2260,3575845150,3575845177,27
1,376,2261,3575845150,3575845178,28
1,376,2262,3575845150,3575845183,33
1,376,2263,3575845150,3575845187,37
1,376,2264,3575845150,3575845194,44
1,376,2265,3575845150,3575845197,47
1,376,2266,3575845150,3575845199,49
1,376,2267,3575845150,3575845200,50
1,377,2268,3575845203,3575845206,3
1,377,2269,3575845203,3575845209,6
1,377,2270,3575845203,3575845210,7
1,377,2271,3575845203,3575845210,7
1,377,2272,3575845203,3575845212,9
1,377,2273,3575845203,3575845212,9
1,377,2274,3575845203,3575845218,15
1,377,2275,3575845203,3575845224,21
1,377,2276,3575845203,3575845226,23
1,377,2277,3575845203,3575845226,23
1,377,2278,3575845203,3575845226,23
1,377,2279,3575845203,3575845228,25
1,377,2280,3575845203,3575845230,27
1,377,2281,3575845203,3575845231,28
1,377,2282,3575845203,3575845234,31
1,377,2283,3575845203,3575845235,32
1,377,2284,3575845203,3575845236,33
1,377,2285,3575845203,3575845238,35
1,377,2286,3575845203,3575845240,37
1,377,2287,3575845203,3575845245,42
1,378,2288,3575845255,3575845255,0
1,378,2289,3575845255,3575845261,6
1,378,2290,3575845255,3575845262,7
1,378,2291,3575845255,3575845264,9
1,378,2292,3575845255,3575845269,14
1,378,2293,3575845255,3575845275,20
1,378,2294,3575845255,3575845277,22
1,378,2295,3575845255,3575845277,22
1,378,2296,3575845255,3575845280,25
1,378,2297,3575845255,3575845281,26
1,378,2298,3575845255,3575845284,29
1,378,2299,3575845255,3575845285,30
1,378,2300,3575845255,3575845286,31
1,378,2301,3575845255,3575845288,33
1,378,2302,3575845255,3575845292,37
1,378,2303,3575845255,3575845296,41
1,378,2304,3575845255,3575845297,42
1,379,2305,3575845307,3575845307,0
1,379,2306,3575845307,3575845310,3
1,379,2307,3575845307,3575845312,5
1,379,2308,3575845307,3575845314,7
1,379,2309,3575845307,3575845320,13
1,379,2310,3575845307,3575845322,15
1,379,2311,3575845307,3575845328,21
1,379,2312,3575845307,3575845331,24
1,379,2313,3575845307,3575845332,25
1,379,2314,3575845307,3575845333,26
1,379,2315,3575845307,3575845342,35
1,379,2316,3575845307,3575845350,43
1,379,2317,3575845307,3575845350,43
1,379,2318,3575845307,3575845353,46
1,379,2319,3575845307,3575845354,47
1,380,2320,3575845359,3575845361,2
1,380,2321,3575845359,3575845367,8
1,380,2322,3575845359,3575845368,9
1,380,2323,3575845359,3575845370,11
1,380,2324,3575845359,3575845373,14
1,380,2325,3575845359,3575845374,15
1,380,2326,3575845359,3575845374,15
1,380,2327,3575845359,3575845375,16
1,380,2328,3575845359,3575845376,17
1,380,2329,3575845359,3575845377,18
1,380,2330,3575845359,3575845383,24
1,380,2331,3575845359,3575845383,24
1,380,2332,3575845359,3575845387,28
1,380,2333,3575845359,3575845394,35
1,380,2334,3575845359,3575845400,41
1,380,2335,3575845359,3575845400,41
1,380,2336,3575845359,3575845406,47
1,380,2337,3575845359,3575845409,50
1,381,2338,3575845411,3575845411,0
1,381,2339,3575845411,3575845411,0
1,381,2340,3575845411,3575845412,1
1,381,2341,3575845411,3575845413,2
1,381,2342,3575845411,3575845418,7
1,381,2343,3575845411,3575845425,14
1,381,2344,3575845411,3575845425,14
1,381,2345,3575845411,3575845426,15
1,381,2346,3575845411,3575845426,15
1,381,2347,3575845411,3575845429,18
1,381,2348,3575845411,3575845430,19
1,381,2349,3575845411,3575845431,20
1,381,2350,3575845411,3575845434,23
1,381,2351,3575845411,3575845435,24
1,381,2352,3575845411,3575845436,25
1,381,2353,3575845411,3575845438,27
1,381,2354,3575845411,3575845440,29
1,381,2355,3575845411,3575845444,33
1,381,2356,3575845411,3575845449,38
1,381,2357,3575845411,3575845451,40
1,381,2358,3575845411,3575845454,43
1,381,2359,3575845411,3575845461,50
1,382,2360,3575845463,3575845464,1
1,382,2361,3575845463,3575845465,2
1,382,2362,3575845463,3575845469,6
1,382,2363,3575845463,3575845475,12
1,382,2364,3575845463,3575845477,14
1,382,2365,3575845463,3575845477,14
1,382,2366,3575845463,3575845481,18
1,382,2367,3575845463,3575845481,18
1,382,2368,3575845463,3575845485,22
1,382,2369,3575845463,3575845485,22
1,382,2370,3575845463,3575845486,23
1,382,2371,3575845463,3575845488,25
1,382,2372,3575845463,3575845492,29
1,382,2373,3575845463,3575845496,33
1,382,2374,3575845463,3575845497,34
1,382,2375,3575845463,3575845505,42
1,382,2376,3575845463,3575845509,46
1,382,2377,3575845463,3575845512,49
1,383,2378,3575845515,3575845515,0
1,383,2379,3575845515,3575845519,4
1,383,2380,3575845515,3575845521,6
1,383,2381,3575845515,3575845528,13
1,383,2382,3575845515,3575845530,15
1,383,2383,3575845515,3575845531,16
1,383,2384,3575845515,3575845532,17
1,383,2385,3575845515,3575845541,26
1,383,2386,3575845515,3575845550,35
1,383,2387,3575845515,3575845550,35
1,383,2388,3575845515,3575845552,37
1,383,2389,3575845515,3575845552,37
1,383,2390,3575845515,3575845561,46
1,384,2391,3575845567,3575845567,0
1,384,2392,3575845567,3575845568,1
1,384,2393,3575845567,3575845569,2
1,384,2394,3575845567,3575845572,5
1,384,2395,3575845567,3575845574,7
1,384,2396,3575845567,3575845574,7
1,384,2397,3575845567,3575845574,7
1,384,2398,3575845567,3575845576,9
1,384,2399,3575845567,3575845577,10
1,384,2400,3575845567,3575845582,15
1,384,2401,3575845567,3575845582,15
1,384,2402,3575845567,3575845587,20
1,384,2403,3575845567,3575845593,26
1,384,2404,3575845567,3575845596,29
1,384,2405,3575845567,3575845599,32
1,384,2406,3575845567,3575845599,32
1,384,2407,3575845567,3575845605,38
1,384,2408,3575845567,3575845608,41
1,384,2409,3575845567,3575845609,42
1,384,2410,3575845567,3575845610,43
1,384,2411,3575845567,3575845612,45
1,384,2412,3575845567,3575845612,45
1,384,2413,3575845567,3575845616,49
1,385,2414,3575845619,3575845619,0
1,385,2415,3575845619,3575845625,6
1,385,2416,3575845619,3575845625,6
1,385,2417,3575845619,3575845625,6
1,385,2418,3575845619,3575845625,6
1,385,2419,3575845619,3575845628,9
1,385,2420,3575845619,3575845629,10
1,385,2421,3575845619,3575845630,11
1,385,2422,3575845619,3575845633,14
1,385,2423,3575845619,3575845634,15
1,385,2424,3575845619,3575845635,16
1,385,2425,3575845619,3575845638,19
1,385,2426,3575845619,3575845639,20
1,385,2427,3575845619,3575845644,25
1,385,2428,3575845619,3575845649,30
1,385,2429,3575845619,3575845651,32
1,385,2430,3575845619,3575845654,35
1,385,2431,3575845619,3575845660,41
1,385,2432,3575845619,3575845663,44
1,385,2433,3575845619,3575845664,45
1,385,2434,3575845619,3575845669,50
1,386,2435,3575845671,3575845674,3
1,386,2436,3575845671,3575845677,6
1,386,2437,3575845671,3575845677,6
1,386,2438,3575845671,3575845680,9
1,386,2439,3575845671,3575845681,10
1,386,2440,3575845671,3575845685,14
1,386,2441,3575845671,3575845686,15
1,386,2442,3575845671,3575845686,15
1,386,2443,3575845671,3575845688,17
1,386,2444,3575845671,3575845693,22
1,386,2445,3575845671,3575845697,26
1,386,2446,3575845671,3575845697,26
1,386,2447,3575845671,3575845710,39
1,386,2448,3575845671,3575845712,41
1,386,2449,3575845671,3575845714,43
1,386,2450,3575845671,3575845719,48
1,386,2451,3575845671,3575845721,50
1,387,2452,3575845723,3575845729,6
1,387,2453,3575845723,3575845731,8
1,387,2454,3575845723,3575845731,8
1,387,2455,3575845723,3575845731,8
1,387,2456,3575845723,3575845742,19
1,387,2457,3575845723,3575845749,26
1,387,2458,3575845723,3575845749,26
1,387,2459,3575845723,3575845753,30
1,387,2460,3575845723,3575845753,30
1,387,2461,3575845723,3575845761,38
1,387,2462,3575845723,3575845766,43
1,387,2463,3575845723,3575845768,45
1,387,2464,3575845723,3575845768,45
1,387,2465,3575845723,3575845771,48
1,387,2466,3575845723,3575845771,48
1,387,2467,3575845723,3575845773,50
1,388,2468,3575845775,3575845775,0
1,388,2469,3575845775,3575845775,0
1,388,2470,3575845775,3575845775,0
1,388,2471,3575845775,3575845778,3
1,388,2472,3575845775,3575845781,6
1,388,2473,3575845775,3575845781,6
1,388,2474,3575845775,3575845787,12
1,388,2475,3575845775,3575845793,18
1,388,2476,3575845775,3575845793,18
1,388,2477,3575845775,3575845796,21
1,388,2478,3575845775,3575845800,25
1,388,2479,3575845775,3575845800,25
1,388,2480,3575845775,3575845805,30
1,388,2481,3575845775,3575845809,34
1,388,2482,3575845775,3575845810,35
1,388,2483,3575845775,3575845812,37
1,388,2484,3575845775,3575845812,37
1,388,2485,3575845775,3575845816,41
1,388,2486,3575845775,3575845817,42
1,388,2487,3575845775,3575845825,50
1,389,2488,3575845827,3575845827,0
1,389,2489,3575845827,3575845827,0
1,389,2490,3575845827,3575845827,0
1,389,2491,3575845827,3575845829,2
1,389,2492,3575845827,3575845830,3
1,389,2493,3575845827,3575845831,4
1,389,2494,3575845827,3575845833,6
1,389,2495,3575845827,3575845834,7
1,389,2496,3575845827,3575845835,8
1,389,2497,3575845827,3575845838,11
1,389,2498,3575845827,3575845839,12
1,389,2499,3575845827,3575845844,17
1,389,2500,3575845827,3575845849,22
1,389,2501,3575845827,3575845851,24
1,389,2502,3575845827,3575845854,27
1,389,2503,3575845827,3575845860,33
1,389,2504,3575845827,3575845863,36
1,389,2505,3575845827,3575845864,37
1,389,2506,3575845827,3575845869,42
1,389,2507,3575845827,3575845875,48
1,390,2508,3575845879,3575845879,0
1,390,2509,3575845879,3575845879,0
1,390,2510,3575845879,3575845880,1
1,390,2511,3575845879,3575845880,1
1,390,2512,3575845879,3575845886,7
1,390,2513,3575845879,3575845887,8
1,390,2514,3575845879,3575845888,9
1,390,2515,3575845879,3575845892,13
1,390,2516,3575845879,3575845896,17
1,390,2517,3575845879,3575845897,18
1,390,2518,3575845879,3575845905,26
1,390,2519,3575845879,3575845910,31
1,390,2520,3575845879,3575845912,33
1,390,2521,3575845879,3575845914,35
1,390,2522,3575845879,3575845919,40
1,390,2523,3575845879,3575845921,42
1,391,2524,3575845931,3575845931,0
1,391,2525,3575845931,3575845931,0
1,391,2526,3575845931,3575845931,0
1,391,2527,3575845931,3575845932,1
1,391,2528,3575845931,3575845935,4
1,391,2529,3575845931,3575845942,11
1,391,2530,3575845931,3575845950,19
1,391,2531,3575845931,3575845950,19
1,391,2532,3575845931,3575845953,22
1,391,2533,3575845931,3575845954,23
1,391,2534,3575845931,3575845960,29
1,391,2535,3575845931,3575845966,35
1,391,2536,3575845931,3575845969,38
1,391,2537,3575845931,3575845970,39
1,391,2538,3575845931,3575845971,40
1,391,2539,3575845931,3575845972,41
1,391,2540,3575845931,3575845974,43
1,391,2541,3575845931,3575845974,43
1,391,2542,3575845931,3575845974,43
1,391,2543,3575845931,3575845975,44
1,391,2544,3575845931,3575845977,46
1,392,2545,3575845983,3575845983,0
1,392,2546,3575845983,3575845983,0
1,392,2547,3575845983,3575845988,5
1,392,2548,3575845983,3575845993,10
1,392,2549,3575845983,3575845993,10
1,392,2550,3575845983,3575845996,13
1,392,2551,3575845983,3575846000,17
1,392,2552,3575845983,3575846000,17
1,392,2553,3575845983,3575846006,23
1,392,2554,3575845983,3575846008,25
1,392,2555,3575845983,3575846009,26
1,392,2556,3575845983,3575846010,27
1,392,2557,3575845983,3575846012,29
1,392,2558,3575845983,3575846012,29
1,392,2559,3575845983,3575846016,33
1,392,2560,3575845983,3575846018,35
1,392,2561,3575845983,3575846024,41
1,392,2562,3575845983,3575846025,42
1,392,2563,3575845983,3575846025,42
1,392,2564,3575845983,3575846025,42
1,392,2565,3575845983,3575846029,46
1,392,2566,3575845983,3575846030,47
1,392,2567,3575845983,3575846032,49
1,393,2568,3575846036,3575846036,0
1,393,2569,3575846036,3575846036,0
1,393,2570,3575846036,3575846036,0
1,393,2571,3575846036,3575846037,1
1,393,2572,3575846036,3575846039,3
1,393,2573,3575846036,3575846045,9
1,393,2574,3575846036,3575846049,13
1,393,2575,3575846036,3575846051,15
1,393,2576,3575846036,3575846053,17
1,393,2577,3575846036,3575846059,23
1,393,2578,3575846036,3575846062,26
1,393,2579,3575846036,3575846063,27
1,393,2580,3575846036,3575846068,32
1,393,2581,3575846036,3575846074,38
1,393,2582,3575846036,3575846077,41
1,393,2583,3575846036,3575846078,42
1,393,2584,3575846036,3575846080,44
1,393,2585,3575846036,3575846081,45
1,393,2586,3575846036,3575846085,49
1,394,2587,3575846088,3575846088,0
1,394,2588,3575846088,3575846089,1
1,394,2589,3575846088,3575846093,5
1,394,2590,3575846088,3575846097,9
1,394,2591,3575846088,3575846097,9
1,394,2592,3575846088,3575846105,17
1,394,2593,3575846088,3575846112,24
1,394,2594,3575846088,3575846114,26
1,394,2595,3575846088,3575846119,31
1,394,2596,3575846088,3575846121,33
1,394,2597,3575846088,3575846131,43
1,394,2598,3575846088,3575846131,43
1,394,2599,3575846088,3575846132,44
1,394,2600,3575846088,3575846132,44
1,394,2601,3575846088,3575846135,47
1,395,2602,3575846140,3575846143,3
1,395,2603,3575846140,3575846150,10
1,395,2604,3575846140,3575846151,11
1,395,2605,3575846140,3575846152,12
1,395,2606,3575846140,3575846153,13
1,395,2607,3575846140,3575846160,20
1,395,2608,3575846140,3575846166,26
1,395,2609,3575846140,3575846168,28
1,395,2610,3575846140,3575846170,30
1,395,2611,3575846140,3575846171,31
1,395,2612,3575846140,3575846172,32
1,395,2613,3575846140,3575846174,34
1,395,2614,3575846140,3575846174,34
1,395,2615,3575846140,3575846174,34
1,395,2616,3575846140,3575846176,36
1,395,2617,3575846140,3575846178,38
1,395,2618,3575846140,3575846182,42
1,395,2619,3575846140,3575846183,43
1,395,2620,3575846140,3575846188,48
1,396,2621,3575846192,3575846193,1
1,396,2622,3575846192,3575846193,1
1,396,2623,3575846192,3575846196,4
1,396,2624,3575846192,3575846199,7
1,396,2625,3575846192,3575846201,9
1,396,2626,3575846192,3575846207,15
1,396,2627,3575846192,3575846209,17
1,396,2628,3575846192,3575846210,18
1,396,2629,3575846192,3575846210,18
1,396,2630,3575846192,3575846212,20
1,396,2631,3575846192,3575846212,20
1,396,2632,3575846192,3575846216,24
1,396,2633,3575846192,3575846219,27
1,396,2634,3575846192,3575846224,32
1,396,2635,3575846192,3575846224,32
1,396,2636,3575846192,3575846227,35
1,396,2637,3575846192,3575846229,37
1,396,2638,3575846192,3575846230,38
1,396,2639,3575846192,3575846232,40
1,396,2640,3575846192,3575846234,42
1,396,2641,3575846192,3575846235,43
1,396,2642,3575846192,3575846236,44
1,396,2643,3575846192,3575846238,46
1,396,2644,3575846192,3575846240,48
1,397,2645,3575846244,3575846245,1
1,397,2646,3575846244,3575846249,5
1,397,2647,3575846244,3575846251,7
1,397,2648,3575846244,3575846254,10
1,397,2649,3575846244,3575846261,17
1,397,2650,3575846244,3575846263,19
1,397,2651,3575846244,3575846264,20
1,397,2652,3575846244,3575846268,24
1,397,2653,3575846244,3575846275,31
1,397,2654,3575846244,3575846277,33
1,397,2655,3575846244,3575846278,34
1,397,2656,3575846244,3575846281,37
1,397,2657,3575846244,3575846281,37
1,397,2658,3575846244,3575846285,41
1,397,2659,3575846244,3575846288,44
1,397,2660,3575846244,3575846288,44
1,397,2661,3575846244,3575846292,48
1,398,2662,3575846296,3575846296,0
1,398,2663,3575846296,3575846297,1
1,398,2664,3575846296,3575846304,8
1,398,2665,3575846296,3575846310,14
1,398,2666,3575846296,3575846312,16
1,398,2667,3575846296,3575846315,19
1,398,2668,3575846296,3575846319,23
1,398,2669,3575846296,3575846322,26
1,398,2670,3575846296,3575846331,35
1,398,2671,3575846296,3575846331,35
1,398,2672,3575846296,3575846332,36
1,398,2673,3575846296,3575846335,39
1,398,2674,3575846296,3575846343,47
1,399,2675,3575846348,3575846350,2
1,399,2676,3575846348,3575846350,2
1,399,2677,3575846348,3575846353,5
1,399,2678,3575846348,3575846354,6
1,399,2679,3575846348,3575846360,12
1,399,2680,3575846348,3575846366,18
1,399,2681,3575846348,3575846368,20
1,399,2682,3575846348,3575846370,22
1,399,2683,3575846348,3575846373,25
1,399,2684,3575846348,3575846374,26
1,399,2685,3575846348,3575846374,26
1,399,2686,3575846348,3575846374,26
1,399,2687,3575846348,3575846376,28
1,399,2688,3575846348,3575846377,29
1,399,2689,3575846348,3575846381,33
1,399,2690,3575846348,3575846383,35
1,399,2691,3575846348,3575846388,40
1,399,2692,3575846348,3575846392,44
1,399,2693,3575846348,3575846395,47
1,399,2694,3575846348,3575846397,49
1,400,2695,3575846400,3575846401,1
1,400,2696,3575846400,3575846407,7
1,400,2697,3575846400,3575846409,9
1,400,2698,3575846400,3575846409,9
1,400,2699,3575846400,3575846411,11
1,400,2700,3575846400,3575846412,12
1,400,2701,3575846400,3575846413,13
1,400,2702,3575846400,3575846416,16
1,400,2703,3575846400,3575846418,18
1,400,2704,3575846400,3575846425,25
1,400,2705,3575846400,3575846426,26
1,400,2706,3575846400,3575846428,28
1,400,2707,3575846400,3575846429,29
1,400,2708,3575846400,3575846430,30
1,400,2709,3575846400,3575846433,33
1,400,2710,3575846400,3575846434,34
1,400,2711,3575846400,3575846435,35
1,400,2712,3575846400,3575846436,36
1,400,2713,3575846400,3575846438,38
1,400,2714,3575846400,3575846439,39
1,400,2715,3575846400,3575846445,45
1,401,2716,3575846452,3575846452,0
1,401,2717,3575846452,3575846452,0
1,401,2718,3575846452,3575846452,0
1,401,2719,3575846452,3575846455,3
1,401,2720,3575846452,3575846461,9
1,401,2721,3575846452,3575846463,11
1,401,2722,3575846452,3575846465,13
1,401,2723,3575846452,3575846469,17
1,401,2724,3575846452,3575846475,23
1,401,2725,3575846452,3575846477,25
1,401,2726,3575846452,3575846478,26
1,401,2727,3575846452,3575846480,28
1,401,2728,3575846452,3575846481,29
1,401,2729,3575846452,3575846485,33
1,401,2730,3575846452,3575846488,36
1,401,2731,3575846452,3575846488,36
1,401,2732,3575846452,3575846493,41
1,401,2733,3575846452,3575846497,45
1,401,2734,3575846452,3575846497,45
1,401,2735,3575846452,3575846502,50
1,402,2736,3575846505,3575846505,0
1,402,2737,3575846505,3575846509,4
1,402,2738,3575846505,3575846511,6
1,402,2739,3575846505,3575846513,8
1,402,2740,3575846505,3575846517,12
1,402,2741,3575846505,3575846521,16
1,402,2742,3575846505,3575846530,25
1,402,2743,3575846505,3575846530,25
1,402,2744,3575846505,3575846530,25
1,402,2745,3575846505,3575846532,27
1,402,2746,3575846505,3575846534,29
1,402,2747,3575846505,3575846542,37
1,402,2748,3575846505,3575846549,44
1,402,2749,3575846505,3575846549,44
1,402,2750,3575846505,3575846551,46
1,402,2751,3575846505,3575846552,47
1,403,2752,3575846558,3575846559,1
1,403,2753,3575846558,3575846565,7
1,403,2754,3575846558,3575846567,9
1,403,2755,3575846558,3575846569,11
1,403,2756,3575846558,3575846572,14
1,403,2757,3575846558,3575846573,15
1,403,2758,3575846558,3575846574,16
1,403,2759,3575846558,3575846574,16
1,403,2760,3575846558,3575846575,17
1,403,2761,3575846558,3575846576,18
1,403,2762,3575846558,3575846581,23
1,403,2763,3575846558,3575846583,25
1,403,2764,3575846558,3575846587,29
1,403,2765,3575846558,3575846592,34
1,403,2766,3575846558,3575846594,36
1,403,2767,3575846558,3575846595,37
1,403,2768,3575846558,3575846600,42
1,403,2769,3575846558,3575846602,44
1,403,2770,3575846558,3575846606,48
1,404,2771,3575846610,3575846610,0
1,404,2772,3575846610,3575846611,1
1,404,2773,3575846610,3575846612,2
1,404,2774,3575846610,3575846612,2
1,404,2775,3575846610,3575846615,5
1,404,2776,3575846610,3575846618,8
1,404,2777,3575846610,3575846624,14
1,404,2778,3575846610,3575846624,14
1,404,2779,3575846610,3575846625,15
1,404,2780,3575846610,3575846626,16
1,404,2781,3575846610,3575846629,19
1,404,2782,3575846610,3575846629,19
1,404,2783,3575846610,3575846632,22
1,404,2784,3575846610,3575846633,23
1,404,2785,3575846610,3575846634,24
1,404,2786,3575846610,3575846635,25
1,404,2787,3575846610,3575846637,27
1,404,2788,3575846610,3575846639,29
1,404,2789,3575846610,3575846644,34
1,404,2790,3575846610,3575846649,39
1,404,2791,3575846610,3575846651,41
1,404,2792,3575846610,3575846651,41
1,404,2793,3575846610,3575846654,44
1,405,2794,3575846662,3575846662,0
1,405,2795,3575846662,3575846663,1
1,405,2796,3575846662,3575846667,5
1,405,2797,3575846662,3575846675,13
1,405,2798,3575846662,3575846677,15
1,405,2799,3575846662,3575846678,16
1,405,2800,3575846662,3575846681,19
1,405,2801,3575846662,3575846681,19
1,405,2802,3575846662,3575846686,24
1,405,2803,3575846662,3575846688,26
1,405,2804,3575846662,3575846688,26
1,405,2805,3575846662,3575846692,30
1,405,2806,3575846662,3575846696,34
1,405,2807,3575846662,3575846696,34
1,405,2808,3575846662,3575846702,40
1,405,2809,3575846662,3575846704,42
1,405,2810,3575846662,3575846707,45
1,405,2811,3575846662,3575846708,46
1,405,2812,3575846662,3575846711,49
1,406,2813,3575846714,3575846714,0
1,406,2814,3575846714,3575846718,4
1,406,2815,3575846714,3575846721,7
1,406,2816,3575846714,3575846730,16
1,406,2817,3575846714,3575846730,16
1,406,2818,3575846714,3575846731,17
1,406,2819,3575846714,3575846731,17
1,406,2820,3575846714,3575846734,20
1,406,2821,3575846714,3575846742,28
1,406,2822,3575846714,3575846749,35
1,406,2823,3575846714,3575846750,36
1,406,2824,3575846714,3575846752,38
1,406,2825,3575846714,3575846753,39
1,406,2826,3575846714,3575846756,42
1,406,2827,3575846714,3575846759,45
1,407,2828,3575846767,3575846767,0
1,407,2829,3575846767,3575846767,0
1,407,2830,3575846767,3575846769,2
1,407,2831,3575846767,3575846772,5
1,407,2832,3575846767,3575846774,7
1,407,2833,3575846767,3575846774,7
1,407,2834,3575846767,3575846774,7
1,407,2835,3575846767,3575846775,8
1,407,2836,3575846767,3575846777,10
1,407,2837,3575846767,3575846782,15
1,407,2838,3575846767,3575846787,20
1,407,2839,3575846767,3575846792,25
1,407,2840,3575846767,3575846794,27
1,407,2841,3575846767,3575846796,29
1,407,2842,3575846767,3575846800,33
1,407,2843,3575846767,3575846800,33
1,407,2844,3575846767,3575846802,35
1,407,2845,3575846767,3575846806,39
1,407,2846,3575846767,3575846809,42
1,407,2847,3575846767,3575846810,43
1,407,2848,3575846767,3575846812,45
1,407,2849,3575846767,3575846812,45
1,407,2850,3575846767,3575846816,49
1,407,2851,3575846767,3575846817,50
1,408,2852,3575846819,3575846824,5
1,408,2853,3575846819,3575846825,6
1,408,2854,3575846819,3575846826,7
1,408,2855,3575846819,3575846827,8
1,408,2856,3575846819,3575846829,10
1,408,2857,3575846819,3575846830,11
1,408,2858,3575846819,3575846832,13
1,408,2859,3575846819,3575846833,14
1,408,2860,3575846819,3575846835,16
1,408,2861,3575846819,3575846836,17
1,408,2862,3575846819,3575846836,17
1,408,2863,3575846819,3575846839,20
1,408,2864,3575846819,3575846844,25
1,408,2865,3575846819,3575846848,29
1,408,2866,3575846819,3575846851,32
1,408,2867,3575846819,3575846851,32
1,408,2868,3575846819,3575846853,34
1,408,2869,3575846819,3575846860,41
1,408,2870,3575846819,3575846863,44
1,408,2871,3575846819,3575846865,46
1,408,2872,3575846819,3575846869,50
1,409,2873,3575846872,3575846875,3
1,409,2874,3575846872,3575846877,5
1,409,2875,3575846872,3575846879,7
1,409,2876,3575846872,3575846881,9
1,409,2877,3575846872,3575846881,9
1,409,2878,3575846872,3575846885,13
1,409,2879,3575846872,3575846888,16
1,409,2880,3575846872,3575846888,16
1,409,2881,3575846872,3575846892,20
1,409,2882,3575846872,3575846896,24
1,409,2883,3575846872,3575846897,25
1,409,2884,3575846872,3575846902,30
1,409,2885,3575846872,3575846905,33
1,409,2886,3575846872,3575846907,35
1,409,2887,3575846872,3575846909,37
1,409,2888,3575846872,3575846912,40
1,409,2889,3575846872,3575846913,41
1,409,2890,3575846872,3575846919,47
1,409,2891,3575846872,3575846921,49
1,410,2892,3575846924,3575846930,6
1,410,2893,3575846924,3575846931,7
1,410,2894,3575846924,3575846931,7
1,410,2895,3575846924,3575846932,8
1,410,2896,3575846924,3575846934,10
1,410,2897,3575846924,3575846943,19
1,410,2898,3575846924,3575846949,25
1,410,2899,3575846924,3575846952,28
1,410,2900,3575846924,3575846953,29
1,410,2901,3575846924,3575846955,31
1,410,2902,3575846924,3575846960,36
1,410,2903,3575846924,3575846965,41
1,410,2904,3575846924,3575846967,43
1,410,2905,3575846924,3575846970,46
1,410,2906,3575846924,3575846972,48
1,410,2907,3575846924,3575846974,50
1,411,2908,3575846977,3575846977,0
1,411,2909,3575846977,3575846977,0
1,411,2910,3575846977,3575846977,0
1,411,2911,3575846977,3575846977,0
1,411,2912,3575846977,3575846982,5
1,411,2913,3575846977,3575846983,6
1,411,2914,3575846977,3575846987,10
1,411,2915,3575846977,3575846993,16
1,411,2916,3575846977,3575846994,17
1,411,2917,3575846977,3575847000,23
1,411,2918,3575846977,3575847001,24
1,411,2919,3575846977,3575847002,25
1,411,2920,3575846977,3575847006,29
1,411,2921,3575846977,3575847009,32
1,411,2922,3575846977,3575847010,33
1,411,2923,3575846977,3575847010,33
1,411,2924,3575846977,3575847012,35
1,411,2925,3575846977,3575847013,36
1,411,2926,3575846977,3575847016,39
1,411,2927,3575846977,3575847019,42
1,411,2928,3575846977,3575847024,47
1,411,2929,3575846977,3575847024,47
1,411,2930,3575846977,3575847026,49
1,412,2931,3575847029,3575847029,0
1,412,2932,3575847029,3575847030,1
1,412,2933,3575847029,3575847032,3
1,412,2934,3575847029,3575847033,4
1,412,2935,3575847029,3575847034,5
1,412,2936,3575847029,3575847036,7
1,412,2937,3575847029,3575847036,7
1,412,2938,3575847029,3575847039,10
1,412,2939,3575847029,3575847044,15
1,412,2940,3575847029,3575847048,19
1,412,2941,3575847029,3575847051,22
1,412,2942,3575847029,3575847051,22
1,412,2943,3575847029,3575847053,24
1,412,2944,3575847029,3575847061,32
1,412,2945,3575847029,3575847063,34
1,412,2946,3575847029,3575847065,36
1,412,2947,3575847029,3575847075,46
1,412,2948,3575847029,3575847077,48
1,412,2949,3575847029,3575847078,49
1,413,2950,3575847082,3575847082,0
1,413,2951,3575847082,3575847082,0
1,413,2952,3575847082,3575847085,3
1,413,2953,3575847082,3575847087,5
1,413,2954,3575847082,3575847088,6
1,413,2955,3575847082,3575847092,10
1,413,2956,3575847082,3575847096,14
1,413,2957,3575847082,3575847097,15
1,413,2958,3575847082,3575847101,19
1,413,2959,3575847082,3575847105,23
1,413,2960,3575847082,3575847107,25
1,413,2961,3575847082,3575847108,26
1,413,2962,3575847082,3575847111,29
1,413,2963,3575847082,3575847113,31
1,413,2964,3575847082,3575847119,37
1,413,2965,3575847082,3575847122,40
1,413,2966,3575847082,3575847129,47
1,413,2967,3575847082,3575847131,49
1,413,2968,3575847082,3575847131,49
1,413,2969,3575847082,3575847132,50
1,414,2970,3575847134,3575847134,0
1,414,2971,3575847134,3575847142,8
1,414,2972,3575847134,3575847150,16
1,414,2973,3575847134,3575847152,18
1,414,2974,3575847134,3575847154,20
1,414,2975,3575847134,3575847156,22
1,414,2976,3575847134,3575847159,25
1,414,2977,3575847134,3575847165,31
1,414,2978,3575847134,3575847168,34
1,414,2979,3575847134,3575847169,35
1,414,2980,3575847134,3575847172,38
1,414,2981,3575847134,3575847173,39
1,414,2982,3575847134,3575847174,40
1,414,2983,3575847134,3575847175,41
1,414,2984,3575847134,3575847177,43
1,414,2985,3575847134,3575847181,47
1,414,2986,3575847134,3575847183,49
1,415,2987,3575847186,3575847187,1
1,415,2988,3575847186,3575847193,7
1,415,2989,3575847186,3575847194,8
1,415,2990,3575847186,3575847200,14
1,415,2991,3575847186,3575847202,16
1,415,2992,3575847186,3575847203,17
1,415,2993,3575847186,3575847206,20
1,415,2994,3575847186,3575847209,23
1,415,2995,3575847186,3575847210,24
1,415,2996,3575847186,3575847210,24
1,415,2997,3575847186,3575847211,25
1,415,2998,3575847186,3575847212,26
1,415,2999,3575847186,3575847213,27
1,415,3000,3575847186,3575847216,30
1,415,3001,3575847186,3575847219,33
1,415,3002,3575847186,3575847224,38
1,415,3003,3575847186,3575847225,39
1,415,3004,3575847186,3575847225,39
1,415,3005,3575847186,3575847229,43
1,415,3006,3575847186,3575847230,44
1,415,3007,3575847186,3575847232,46
1,415,3008,3575847186,3575847234,48
1,415,3009,3575847186,3575847234,48
1,416,3010,3575847239,3575847239,0
1,416,3011,3575847239,3575847239,0
1,416,3012,3575847239,3575847239,0
1,416,3013,3575847239,3575847245,6
1,416,3014,3575847239,3575847248,9
1,416,3015,3575847239,3575847252,13
1,416,3016,3575847239,3575847253,14
1,416,3017,3575847239,3575847262,23
1,416,3018,3575847239,3575847265,26
1,416,3019,3575847239,3575847275,36
1,416,3020,3575847239,3575847277,38
1,416,3021,3575847239,3575847281,42
1,416,3022,3575847239,3575847281,42
1,416,3023,3575847239,3575847285,46
1,416,3024,3575847239,3575847288,49
1,416,3025,3575847239,3575847289,50
1,417,3026,3575847291,3575847292,1
1,417,3027,3575847291,3575847296,5
1,417,3028,3575847291,3575847297,6
1,417,3029,3575847291,3575847301,10
1,417,3030,3575847291,3575847305,14
1,417,3031,3575847291,3575847307,16
1,417,3032,3575847291,3575847310,19
1,417,3033,3575847291,3575847311,20
1,417,3034,3575847291,3575847319,28
1,417,3035,3575847291,3575847323,32
1,417,3036,3575847291,3575847330,39
1,417,3037,3575847291,3575847331,40
1,417,3038,3575847291,3575847331,40
1,417,3039,3575847291,3575847333,42
1,417,3040,3575847291,3575847335,44
1,418,3041,3575847344,3575847344,0
1,418,3042,3575847344,3575847349,5
1,418,3043,3575847344,3575847352,8
1,418,3044,3575847344,3575847353,9
1,418,3045,3575847344,3575847355,11
1,418,3046,3575847344,3575847360,16
1,418,3047,3575847344,3575847364,20
1,418,3048,3575847344,3575847365,21
1,418,3049,3575847344,3575847367,23
1,418,3050,3575847344,3575847370,26
1,418,3051,3575847344,3575847374,30
1,418,3052,3575847344,3575847375,31
1,418,3053,3575847344,3575847377,33
1,418,3054,3575847344,3575847378,34
1,418,3055,3575847344,3575847382,38
1,418,3056,3575847344,3575847383,39
1,418,3057,3575847344,3575847387,43
1,418,3058,3575847344,3575847393,49
1,419,3059,3575847396,3575847396,0
1,419,3060,3575847396,3575847397,1
1,419,3061,3575847396,3575847399,3
1,419,3062,3575847396,3575847402,6
1,419,3063,3575847396,3575847403,7
1,419,3064,3575847396,3575847406,10
1,419,3065,3575847396,3575847410,14
1,419,3066,3575847396,3575847411,15
1,419,3067,3575847396,3575847411,15
1,419,3068,3575847396,3575847412,16
1,419,3069,3575847396,3575847413,17
1,419,3070,3575847396,3575847413,17
1,419,3071,3575847396,3575847416,20
1,419,3072,3575847396,3575847418,22
1,419,3073,3575847396,3575847424,28
1,419,3074,3575847396,3575847426,30
1,419,3075,3575847396,3575847426,30
1,419,3076,3575847396,3575847429,33
1,419,3077,3575847396,3575847430,34
1,419,3078,3575847396,3575847431,35
1,419,3079,3575847396,3575847434,38
1,419,3080,3575847396,3575847434,38
1,419,3081,3575847396,3575847436,40
1,419,3082,3575847396,3575847438,42
1,419,3083,3575847396,3575847439,43
1,419,3084,3575847396,3575847445,49
1,420,3085,3575847449,3575847449,0
1,420,3086,3575847449,3575847452,3
1,420,3087,3575847449,3575847454,5
1,420,3088,3575847449,3575847463,14
1,420,3089,3575847449,3575847464,15
1,420,3090,3575847449,3575847469,20
1,420,3091,3575847449,3575847475,26
1,420,3092,3575847449,3575847477,28
1,420,3093,3575847449,3575847481,32
1,420,3094,3575847449,3575847482,33
1,420,3095,3575847449,3575847485,36
1,420,3096,3575847449,3575847488,39
1,420,3097,3575847449,3575847488,39
1,420,3098,3575847449,3575847492,43
1,420,3099,3575847449,3575847497,48
1,420,3100,3575847449,3575847497,48
1,421,3101,3575847502,3575847502,0
1,421,3102,3575847502,3575847504,2
1,421,3103,3575847502,3575847506,4
1,421,3104,3575847502,3575847510,8
1,421,3105,3575847502,3575847512,10
1,421,3106,3575847502,3575847518,16
1,421,3107,3575847502,3575847522,20
1,421,3108,3575847502,3575847530,28
1,421,3109,3575847502,3575847530,28
1,421,3110,3575847502,3575847531,29
1,421,3111,3575847502,3575847535,33
1,421,3112,3575847502,3575847542,40
1,421,3113,3575847502,3575847550,48
1,421,3114,3575847502,3575847552,50
1,422,3115,3575847555,3575847555,0
1,422,3116,3575847555,3575847555,0
1,422,3117,3575847555,3575847559,4
1,422,3118,3575847555,3575847563,8
1,422,3119,3575847555,3575847565,10
1,422,3120,3575847555,3575847567,12
1,422,3121,3575847555,3575847569,14
1,422,3122,3575847555,3575847574,19
1,422,3123,3575847555,3575847574,19
1,422,3124,3575847555,3575847575,20
1,422,3125,3575847555,3575847576,21
1,422,3126,3575847555,3575847580,25
1,422,3127,3575847555,3575847582,27
1,422,3128,3575847555,3575847586,31
1,422,3129,3575847555,3575847591,36
1,422,3130,3575847555,3575847593,38
1,422,3131,3575847555,3575847596,41
1,422,3132,3575847555,3575847600,45
1,422,3133,3575847555,3575847601,46
1,422,3134,3575847555,3575847602,47
1,423,3135,3575847607,3575847607,0
1,423,3136,3575847607,3575847609,2
1,423,3137,3575847607,3575847610,3
1,423,3138,3575847607,3575847610,3
1,423,3139,3575847607,3575847611,4
1,423,3140,3575847607,3575847612,5
1,423,3141,3575847607,3575847613,6
1,423,3142,3575847607,3575847615,8
1,423,3143,3575847607,3575847617,10
1,423,3144,3575847607,3575847618,11
1,423,3145,3575847607,3575847623,16
1,423,3146,3575847607,3575847624,17
1,423,3147,3575847607,3575847625,18
1,423,3148,3575847607,3575847627,20
1,423,3149,3575847607,3575847629,22
1,423,3150,3575847607,3575847630,23
1,423,3151,3575847607,3575847633,26
1,423,3152,3575847607,3575847633,26
1,423,3153,3575847607,3575847635,28
1,423,3154,3575847607,3575847637,30
1,423,3155,3575847607,3575847639,32
1,423,3156,3575847607,3575847643,36
1,423,3157,3575847607,3575847648,41
1,423,3158,3575847607,3575847651,44
1,423,3159,3575847607,3575847653,46
1,424,3160,3575847660,3575847663,3
1,424,3161,3575847660,3575847664,4
1,424,3162,3575847660,3575847668,8
1,424,3163,3575847660,3575847675,15
1,424,3164,3575847660,3575847677,17
1,424,3165,3575847660,3575847679,19
1,424,3166,3575847660,3575847681,21
1,424,3167,3575847660,3575847682,22
1,424,3168,3575847660,3575847685,25
1,424,3169,3575847660,3575847689,29
1,424,3170,3575847660,3575847689,29
1,424,3171,3575847660,3575847692,32
1,424,3172,3575847660,3575847697,37
1,424,3173,3575847660,3575847697,37
1,424,3174,3575847660,3575847700,40
1,424,3175,3575847660,3575847704,44
1,424,3176,3575847660,3575847706,46
1,424,3177,3575847660,3575847710,50
1,425,3178,3575847713,3575847713,0
1,425,3179,3575847713,3575847718,5
1,425,3180,3575847713,3575847722,9
1,425,3181,3575847713,3575847729,16
1,425,3182,3575847713,3575847730,17
1,425,3183,3575847713,3575847731,18
1,425,3184,3575847713,3575847735,22
1,425,3185,3575847713,3575847742,29
1,425,3186,3575847713,3575847750,37
1,425,3187,3575847713,3575847753,40
1,425,3188,3575847713,3575847753,40
1,425,3189,3575847713,3575847754,41
1,425,3190,3575847713,3575847759,46
1,426,3191,3575847765,3575847765,0
1,426,3192,3575847765,3575847765,0
1,426,3193,3575847765,3575847767,2
1,426,3194,3575847765,3575847769,4
1,426,3195,3575847765,3575847769,4
1,426,3196,3575847765,3575847772,7
1,426,3197,3575847765,3575847774,9
1,426,3198,3575847765,3575847775,10
1,426,3199,3575847765,3575847775,10
1,426,3200,3575847765,3575847776,11
1,426,3201,3575847765,3575847777,12
1,426,3202,3575847765,3575847782,17
1,426,3203,3575847765,3575847782,17
1,426,3204,3575847765,3575847787,22
1,426,3205,3575847765,3575847792,27
1,426,3206,3575847765,3575847793,28
1,426,3207,3575847765,3575847796,31
1,426,3208,3575847765,3575847799,34
1,426,3209,3575847765,3575847801,36
1,426,3210,3575847765,3575847802,37
1,426,3211,3575847765,3575847805,40
1,426,3212,3575847765,3575847809,44
1,426,3213,3575847765,3575847810,45
1,426,3214,3575847765,3575847810,45
1,426,3215,3575847765,3575847811,46
1,426,3216,3575847765,3575847812,47
1,426,3217,3575847765,3575847813,48
1,427,3218,3575847818,3575847818,0
1,427,3219,3575847818,3575847818,0
1,427,3220,3575847818,3575847818,0
1,427,3221,3575847818,3575847820,2
1,427,3222,3575847818,3575847824,6
1,427,3223,3575847818,3575847824,6
1,427,3224,3575847818,3575847825,7
1,427,3225,3575847818,3575847828,10
1,427,3226,3575847818,3575847830,12
1,427,3227,3575847818,3575847831,13
1,427,3228,3575847818,3575847833,15
1,427,3229,3575847818,3575847833,15
1,427,3230,3575847818,3575847836,18
1,427,3231,3575847818,3575847837,19
1,427,3232,3575847818,3575847844,26
1,427,3233,3575847818,3575847848,30
1,427,3234,3575847818,3575847851,33
1,427,3235,3575847818,3575847851,33
1,427,3236,3575847818,3575847854,36
1,427,3237,3575847818,3575847859,41
1,427,3238,3575847818,3575847863,45
1,427,3239,3575847818,3575847863,45
1,428,3240,3575847871,3575847871,0
1,428,3241,3575847871,3575847875,4
1,428,3242,3575847871,3575847877,6
1,428,3243,3575847871,3575847879,8
1,428,3244,3575847871,3575847881,10
1,428,3245,3575847871,3575847881,10
1,428,3246,3575847871,3575847885,14
1,428,3247,3575847871,3575847888,17
1,428,3248,3575847871,3575847888,17
1,428,3249,3575847871,3575847893,22
1,428,3250,3575847871,3575847897,26
1,428,3251,3575847871,3575847897,26
1,428,3252,3575847871,3575847901,30
1,428,3253,3575847871,3575847905,34
1,428,3254,3575847871,3575847907,36
1,428,3255,3575847871,3575847910,39
1,428,3256,3575847871,3575847912,41
1,428,3257,3575847871,3575847919,48
1,429,3258,3575847924,3575847924,0
1,429,3259,3575847924,3575847930,6
1,429,3260,3575847924,3575847931,7
1,429,3261,3575847924,3575847932,8
1,429,3262,3575847924,3575847932,8
1,429,3263,3575847924,3575847935,11
1,429,3264,3575847924,3575847943,19
1,429,3265,3575847924,3575847950,26
1,429,3266,3575847924,3575847953,29
1,429,3267,3575847924,3575847954,30
1,429,3268,3575847924,3575847954,30
1,429,3269,3575847924,3575847960,36
1,429,3270,3575847924,3575847965,41
1,429,3271,3575847924,3575847965,41
1,429,3272,3575847924,3575847968,44
1,429,3273,3575847924,3575847969,45
1,429,3274,3575847924,3575847970,46
1,429,3275,3575847924,3575847972,48
1,429,3276,3575847924,3575847974,50
1,430,3277,3575847977,3575847977,0
1,430,3278,3575847977,3575847977,0
1,430,3279,3575847977,3575847977,0
1,430,3280,3575847977,3575847977,0
1,430,3281,3575847977,3575847982,5
1,430,3282,3575847977,3575847983,6
1,430,3283,3575847977,3575847987,10
1,430,3284,3575847977,3575847993,16
1,430,3285,3575847977,3575847994,17
1,430,3286,3575847977,3575847996,19
1,430,3287,3575847977,3575848000,23
1,430,3288,3575847977,3575848001,24
1,430,3289,3575847977,3575848006,29
1,430,3290,3575847977,3575848009,32
1,430,3291,3575847977,3575848010,33
1,430,3292,3575847977,3575848011,34
1,430,3293,3575847977,3575848012,35
1,430,3294,3575847977,3575848013,36
1,430,3295,3575847977,3575848016,39
1,430,3296,3575847977,3575848018,41
1,430,3297,3575847977,3575848020,43
1,430,3298,3575847977,3575848024,47
1,430,3299,3575847977,3575848024,47
1,430,3300,3575847977,3575848024,47
1,431,3301,3575848030,3575848030,0
1,431,3302,3575848030,3575848030,0
1,431,3303,3575848030,3575848032,2
1,431,3304,3575848030,3575848033,3
1,431,3305,3575848030,3575848033,3
1,431,3306,3575848030,3575848036,6
1,431,3307,3575848030,3575848038,8
1,431,3308,3575848030,3575848038,8
1,431,3309,3575848030,3575848045,15
1,431,3310,3575848030,3575848048,18
1,431,3311,3575848030,3575848051,21
1,431,3312,3575848030,3575848051,21
1,431,3313,3575848030,3575848054,24
1,431,3314,3575848030,3575848059,29
1,431,3315,3575848030,3575848062,32
1,431,3316,3575848030,3575848063,33
1,431,3317,3575848030,3575848068,38
1,431,3318,3575848030,3575848076,46
1,431,3319,3575848030,3575848078,48
1,431,3320,3575848030,3575848079,49
1,432,3321,3575848083,3575848083,0
1,432,3322,3575848083,3575848083,0
1,432,3323,3575848083,3575848085,2
1,432,3324,3575848083,3575848088,5
1,432,3325,3575848083,3575848088,5
1,432,3326,3575848083,3575848093,10
1,432,3327,3575848083,3575848096,13
1,432,3328,3575848083,3575848097,14
1,432,3329,3575848083,3575848101,18
1,432,3330,3575848083,3575848105,22
1,432,3331,3575848083,3575848110,27
1,432,3332,3575848083,3575848112,29
1,432,3333,3575848083,3575848119,36
1,432,3334,3575848083,3575848122,39
1,432,3335,3575848083,3575848130,47
1,432,3336,3575848083,3575848131,48
1,432,3337,3575848083,3575848131,48
1,432,3338,3575848083,3575848132,49
1,433,3339,3575848136,3575848136,0
1,433,3340,3575848136,3575848143,7
1,433,3341,3575848136,3575848149,13
1,433,3342,3575848136,3575848152,16
1,433,3343,3575848136,3575848153,17
1,433,3344,3575848136,3575848154,18
1,433,3345,3575848136,3575848159,23
1,433,3346,3575848136,3575848165,29
1,433,3347,3575848136,3575848165,29
1,433,3348,3575848136,3575848167,31
1,433,3349,3575848136,3575848170,34
1,433,3350,3575848136,3575848170,34
1,433,3351,3575848136,3575848172,36
1,433,3352,3575848136,3575848174,38
1,433,3353,3575848136,3575848176,40
1,433,3354,3575848136,3575848176,40
1,433,3355,3575848136,3575848176,40
1,433,3356,3575848136,3575848178,42
1,433,3357,3575848136,3575848182,46
1,433,3358,3575848136,3575848183,47
1,434,3359,3575848189,3575848189,0
1,434,3360,3575848189,3575848193,4
1,434,3361,3575848189,3575848194,5
1,434,3362,3575848189,3575848196,7
1,434,3363,3575848189,3575848200,11
1,434,3364,3575848189,3575848201,12
1,434,3365,3575848189,3575848206,17
1,434,3366,3575848189,3575848209,20
1,434,3367,3575848189,3575848210,21
1,434,3368,3575848189,3575848211,22
1,434,3369,3575848189,3575848212,23
1,434,3370,3575848189,3575848213,24
1,434,3371,3575848189,3575848216,27
1,434,3372,3575848189,3575848218,29
1,434,3373,3575848189,3575848220,31
1,434,3374,3575848189,3575848224,35
1,434,3375,3575848189,3575848224,35
1,434,3376,3575848189,3575848225,36
1,434,3377,3575848189,3575848229,40
1,434,3378,3575848189,3575848230,41
1,434,3379,3575848189,3575848232,43
1,434,3380,3575848189,3575848233,44
1,434,3381,3575848189,3575848234,45
1,434,3382,3575848189,3575848236,47
1,434,3383,3575848189,3575848237,48
1,434,3384,3575848189,3575848238,49
1,435,3385,3575848242,3575848245,3
1,435,3386,3575848242,3575848248,6
1,435,3387,3575848242,3575848251,9
1,435,3388,3575848242,3575848251,9
1,435,3389,3575848242,3575848254,12
1,435,3390,3575848242,3575848260,18
1,435,3391,3575848242,3575848262,20
1,435,3392,3575848242,3575848263,21
1,435,3393,3575848242,3575848268,26
1,435,3394,3575848242,3575848276,34
1,435,3395,3575848242,3575848279,37
1,435,3396,3575848242,3575848279,37
1,435,3397,3575848242,3575848281,39
1,435,3398,3575848242,3575848281,39
1,435,3399,3575848242,3575848285,43
1,435,3400,3575848242,3575848289,47
1,435,3401,3575848242,3575848289,47
1,436,3402,3575848296,3575848296,0
1,436,3403,3575848296,3575848296,0
1,436,3404,3575848296,3575848297,1
1,436,3405,3575848296,3575848302,6
1,436,3406,3575848296,3575848305,9
1,436,3407,3575848296,3575848310,14
1,436,3408,3575848296,3575848312,16
1,436,3409,3575848296,3575848319,23
1,436,3410,3575848296,3575848322,26
1,436,3411,3575848296,3575848331,35
1,436,3412,3575848296,3575848331,35
1,436,3413,3575848296,3575848331,35
1,436,3414,3575848296,3575848333,37
1,436,3415,3575848296,3575848336,40
1,436,3416,3575848296,3575848343,47
1,437,3417,3575848349,3575848350,1
1,437,3418,3575848349,3575848353,4
1,437,3419,3575848349,3575848353,4
1,437,3420,3575848349,3575848355,6
1,437,3421,3575848349,3575848360,11
1,437,3422,3575848349,3575848365,16
1,437,3423,3575848349,3575848365,16
1,437,3424,3575848349,3575848368,19
1,437,3425,3575848349,3575848369,20
1,437,3426,3575848349,3575848369,20
1,437,3427,3575848349,3575848373,24
1,437,3428,3575848349,3575848374,25
1,437,3429,3575848349,3575848376,27
1,437,3430,3575848349,3575848377,28
1,437,3431,3575848349,3575848381,32
1,437,3432,3575848349,3575848388,39
1,437,3433,3575848349,3575848393,44
1,437,3434,3575848349,3575848394,45
1,437,3435,3575848349,3575848397,48
1,438,3436,3575848401,3575848401,0
1,438,3437,3575848401,3575848402,1
1,438,3438,3575848401,3575848406,5
1,438,3439,3575848401,3575848410,9
1,438,3440,3575848401,3575848411,10
1,438,3441,3575848401,3575848412,11
1,438,3442,3575848401,3575848412,11
1,438,3443,3575848401,3575848414,13
1,438,3444,3575848401,3575848416,15
1,438,3445,3575848401,3575848418,17
1,438,3446,3575848401,3575848420,19
1,438,3447,3575848401,3575848424,23
1,438,3448,3575848401,3575848425,24
1,438,3449,3575848401,3575848426,25
1,438,3450,3575848401,3575848430,29
1,438,3451,3575848401,3575848432,31
1,438,3452,3575848401,3575848433,32
1,438,3453,3575848401,3575848434,33
1,438,3454,3575848401,3575848437,36
1,438,3455,3575848401,3575848438,37
1,438,3456,3575848401,3575848439,38
1,438,3457,3575848401,3575848444,43
1,438,3458,3575848401,3575848449,48
1,438,3459,3575848401,3575848451,50
1,439,3460,3575848454,3575848454,0
1,439,3461,3575848454,3575848454,0
1,439,3462,3575848454,3575848461,7
1,439,3463,3575848454,3575848464,10
1,439,3464,3575848454,3575848465,11
1,439,3465,3575848454,3575848469,15
1,439,3466,3575848454,3575848476,22
1,439,3467,3575848454,3575848478,24
1,439,3468,3575848454,3575848479,25
1,439,3469,3575848454,3575848481,27
1,439,3470,3575848454,3575848482,28
1,439,3471,3575848454,3575848485,31
1,439,3472,3575848454,3575848489,35
1,439,3473,3575848454,3575848489,35
1,439,3474,3575848454,3575848493,39
1,439,3475,3575848454,3575848496,42
1,439,3476,3575848454,3575848497,43
1,439,3477,3575848454,3575848502,48
1,439,3478,3575848454,3575848504,50
1,440,3479,3575848507,3575848507,0
1,440,3480,3575848507,3575848509,2
1,440,3481,3575848507,3575848511,4
1,440,3482,3575848507,3575848518,11
1,440,3483,3575848507,3575848521,14
1,440,3484,3575848507,3575848530,23
1,440,3485,3575848507,3575848530,23
1,440,3486,3575848507,3575848531,24
1,440,3487,3575848507,3575848531,24
1,440,3488,3575848507,3575848535,28
1,440,3489,3575848507,3575848541,34
1,440,3490,3575848507,3575848550,43
1,440,3491,3575848507,3575848551,44
1,440,3492,3575848507,3575848553,46
1,440,3493,3575848507,3575848553,46
1,441,3494,3575848560,3575848560,0
1,441,3495,3575848560,3575848564,4
1,441,3496,3575848560,3575848565,5
1,441,3497,3575848560,3575848566,6
1,441,3498,3575848560,3575848569,9
1,441,3499,3575848560,3575848569,9
1,441,3500,3575848560,3575848572,12
1,441,3501,3575848560,3575848574,14
1,441,3502,3575848560,3575848575,15
1,441,3503,3575848560,3575848576,16
1,441,3504,3575848560,3575848580,20
1,441,3505,3575848560,3575848587,27
1,441,3506,3575848560,3575848592,32
1,441,3507,3575848560,3575848593,33
1,441,3508,3575848560,3575848596,36
1,441,3509,3575848560,3575848599,39
1,441,3510,3575848560,3575848601,41
1,441,3511,3575848560,3575848605,45
1,441,3512,3575848560,3575848609,49
1,441,3513,3575848560,3575848610,50
1,442,3514,3575848613,3575848613,0
1,442,3515,3575848613,3575848613,0
1,442,3516,3575848613,3575848613,0
1,442,3517,3575848613,3575848615,2
1,442,3518,3575848613,3575848616,3
1,442,3519,3575848613,3575848618,5
1,442,3520,3575848613,3575848619,6
1,442,3521,3575848613,3575848624,11
1,442,3522,3575848613,3575848624,11
1,442,3523,3575848613,3575848625,12
1,442,3524,3575848613,3575848629,16
1,442,3525,3575848613,3575848632,19
1,442,3526,3575848613,3575848632,19
1,442,3527,3575848613,3575848634,21
1,442,3528,3575848613,3575848636,23
1,442,3529,3575848613,3575848637,24
1,442,3530,3575848613,3575848639,26
1,442,3531,3575848613,3575848644,31
1,442,3532,3575848613,3575848648,35
1,442,3533,3575848613,3575848650,37
1,442,3534,3575848613,3575848651,38
1,442,3535,3575848613,3575848654,41
1,442,3536,3575848613,3575848660,47
1,443,3537,3575848666,3575848666,0
1,443,3538,3575848666,3575848666,0
1,443,3539,3575848666,3575848668,2
1,443,3540,3575848666,3575848676,10
1,443,3541,3575848666,3575848678,12
1,443,3542,3575848666,3575848679,13
1,443,3543,3575848666,3575848681,15
1,443,3544,3575848666,3575848681,15
1,443,3545,3575848666,3575848686,20
1,443,3546,3575848666,3575848689,23
1,443,3547,3575848666,3575848689,23
1,443,3548,3575848666,3575848693,27
1,443,3549,3575848666,3575848696,30
1,443,3550,3575848666,3575848697,31
1,443,3551,3575848666,3575848703,37
1,443,3552,3575848666,3575848705,39
1,443,3553,3575848666,3575848706,40
1,443,3554,3575848666,3575848709,43
1,443,3555,3575848666,3575848712,46
1,444,3556,3575848719,3575848719,0
1,444,3557,3575848719,3575848721,2
1,444,3558,3575848719,3575848729,10
1,444,3559,3575848719,3575848730,11
1,444,3560,3575848719,3575848731,12
1,444,3561,3575848719,3575848732,13
1,444,3562,3575848719,3575848735,16
1,444,3563,3575848719,3575848741,22
1,444,3564,3575848719,3575848751,32
1,444,3565,3575848719,3575848752,33
1,444,3566,3575848719,3575848753,34
1,444,3567,3575848719,3575848753,34
1,444,3568,3575848719,3575848759,40
1,444,3569,3575848719,3575848764,45
1,444,3570,3575848719,3575848765,46
1,444,3571,3575848719,3575848767,48
1,444,3572,3575848719,3575848769,50
1,445,3573,3575848771,3575848771,0
1,445,3574,3575848771,3575848772,1
1,445,3575,3575848771,3575848773,2
1,445,3576,3575848771,3575848775,4
1,445,3577,3575848771,3575848775,4
1,445,3578,3575848771,3575848778,7
1,445,3579,3575848771,3575848778,7
1,445,3580,3575848771,3575848781,10
1,445,3581,3575848771,3575848787,16
1,445,3582,3575848771,3575848792,21
1,445,3583,3575848771,3575848793,22
1,445,3584,3575848771,3575848796,25
1,445,3585,3575848771,3575848799,28
1,445,3586,3575848771,3575848801,30
1,445,3587,3575848771,3575848805,34
1,445,3588,3575848771,3575848809,38
1,445,3589,3575848771,3575848810,39
1,445,3590,3575848771,3575848810,39
1,445,3591,3575848771,3575848812,41
1,445,3592,3575848771,3575848812,41
1,445,3593,3575848771,3575848816,45
1,445,3594,3575848771,3575848817,46
1,445,3595,3575848771,3575848818,47
1,445,3596,3575848771,3575848819,48
1,446,3597,3575848823,3575848823,0
1,446,3598,3575848823,3575848824,1
1,446,3599,3575848823,3575848825,2
1,446,3600,3575848823,3575848830,7
1,446,3601,3575848823,3575848831,8
1,446,3602,3575848823,3575848832,9
1,446,3603,3575848823,3575848834,11
1,446,3604,3575848823,3575848836,13
1,446,3605,3575848823,3575848836,13
1,446,3606,3575848823,3575848839,16
1,446,3607,3575848823,3575848843,20
1,446,3608,3575848823,3575848848,25
1,446,3609,3575848823,3575848850,27
1,446,3610,3575848823,3575848851,28
1,446,3611,3575848823,3575848853,30
1,446,3612,3575848823,3575848860,37
1,446,3613,3575848823,3575848863,40
1,446,3614,3575848823,3575848865,42
1,446,3615,3575848823,3575848869,46
1,447,3616,3575848876,3575848876,0
1,447,3617,3575848876,3575848878,2
1,447,3618,3575848876,3575848880,4
1,447,3619,3575848876,3575848880,4
1,447,3620,3575848876,3575848881,5
1,447,3621,3575848876,3575848885,9
1,447,3622,3575848876,3575848889,13
1,447,3623,3575848876,3575848889,13
1,447,3624,3575848876,3575848894,18
1,447,3625,3575848876,3575848896,20
1,447,3626,3575848876,3575848897,21
1,447,3627,3575848876,3575848903,27
1,447,3628,3575848876,3575848905,29
1,447,3629,3575848876,3575848906,30
1,447,3630,3575848876,3575848909,33
1,447,3631,3575848876,3575848911,35
1,447,3632,3575848876,3575848919,43
1,447,3633,3575848876,3575848921,45
1,448,3634,3575848929,3575848930,1
1,448,3635,3575848929,3575848931,2
1,448,3636,3575848929,3575848931,2
1,448,3637,3575848929,3575848931,2
1,448,3638,3575848929,3575848935,6
1,448,3639,3575848929,3575848941,12
1,448,3640,3575848929,3575848952,23
1,448,3641,3575848929,3575848952,23
1,448,3642,3575848929,3575848953,24
1,448,3643,3575848929,3575848953,24
1,448,3644,3575848929,3575848959,30
1,448,3645,3575848929,3575848964,35
1,448,3646,3575848929,3575848965,36
1,448,3647,3575848929,3575848967,38
1,448,3648,3575848929,3575848968,39
1,448,3649,3575848929,3575848970,41
1,448,3650,3575848929,3575848972,43
1,448,3651,3575848929,3575848974,45
1,448,3652,3575848929,3575848975,46
1,448,3653,3575848929,3575848975,46
1,448,3654,3575848929,3575848975,46
1,448,3655,3575848929,3575848977,48
1,448,3656,3575848929,3575848977,48
1,449,3657,3575848982,3575848982,0
1,449,3658,3575848982,3575848987,5
1,449,3659,3575848982,3575848993,11
1,449,3660,3575848982,3575848993,11
1,449,3661,3575848982,3575848997,15
1,449,3662,3575848982,3575849000,18
1,449,3663,3575848982,3575849001,19
1,449,3664,3575848982,3575849006,24
1,449,3665,3575848982,3575849009,27
1,449,3666,3575848982,3575849010,28
1,449,3667,3575848982,3575849011,29
1,449,3668,3575848982,3575849012,30
1,449,3669,3575848982,3575849012,30
1,449,3670,3575848982,3575849016,34
1,449,3671,3575848982,3575849017,35
1,449,3672,3575848982,3575849018,36
1,449,3673,3575848982,3575849019,37
1,449,3674,3575848982,3575849024,42
1,449,3675,3575848982,3575849024,42
1,449,3676,3575848982,3575849025,43
1,449,3677,3575848982,3575849029,47
1,449,3678,3575848982,3575849030,48
1,449,3679,3575848982,3575849031,49
1,449,3680,3575848982,3575849032,50
1,450,3681,3575849035,3575849035,0
1,450,3682,3575849035,3575849036,1
1,450,3683,3575849035,3575849037,2
1,450,3684,3575849035,3575849038,3
1,450,3685,3575849035,3575849045,10
1,450,3686,3575849035,3575849048,13
1,450,3687,3575849035,3575849051,16
1,450,3688,3575849035,3575849051,16
1,450,3689,3575849035,3575849054,19
1,450,3690,3575849035,3575849059,24
1,450,3691,3575849035,3575849062,27
1,450,3692,3575849035,3575849064,29
1,450,3693,3575849035,3575849069,34
1,450,3694,3575849035,3575849075,40
1,450,3695,3575849035,3575849078,43
1,450,3696,3575849035,3575849080,45
1,450,3697,3575849035,3575849082,47
1,450,3698,3575849035,3575849085,50
1,451,3699,3575849088,3575849089,1
1,451,3700,3575849088,3575849090,2
1,451,3701,3575849088,3575849094,6
1,451,3702,3575849088,3575849096,8
1,451,3703,3575849088,3575849096,8
1,451,3704,3575849088,3575849103,15
1,451,3705,3575849088,3575849105,17
1,451,3706,3575849088,3575849108,20
1,451,3707,3575849088,3575849109,21
1,451,3708,3575849088,3575849111,23
1,451,3709,3575849088,3575849119,31
1,451,3710,3575849088,3575849121,33
1,451,3711,3575849088,3575849130,42
1,451,3712,3575849088,3575849131,43
1,451,3713,3575849088,3575849131,43
1,451,3714,3575849088,3575849132,44
1,451,3715,3575849088,3575849135,47
1,452,3716,3575849142,3575849142,0
1,452,3717,3575849142,3575849152,10
1,452,3718,3575849142,3575849153,11
1,452,3719,3575849142,3575849153,11
1,452,3720,3575849142,3575849154,12
1,452,3721,3575849142,3575849160,18
1,452,3722,3575849142,3575849164,22
1,452,3723,3575849142,3575849165,23
1,452,3724,3575849142,3575849168,26
1,452,3725,3575849142,3575849168,26
1,452,3726,3575849142,3575849169,27
1,452,3727,3575849142,3575849173,31
1,452,3728,3575849142,3575849173,31
1,452,3729,3575849142,3575849175,33
1,452,3730,3575849142,3575849175,33
1,452,3731,3575849142,3575849175,33
1,452,3732,3575849142,3575849177,35
1,452,3733,3575849142,3575849178,36
1,452,3734,3575849142,3575849181,39
1,452,3735,3575849142,3575849187,45
1,453,3736,3575849195,3575849195,0
1,453,3737,3575849195,3575849195,0
1,453,3738,3575849195,3575849196,1
1,453,3739,3575849195,3575849200,5
1,453,3740,3575849195,3575849201,6
1,453,3741,3575849195,3575849206,11
1,453,3742,3575849195,3575849210,15
1,453,3743,3575849195,3575849210,15
1,453,3744,3575849195,3575849211,16
1,453,3745,3575849195,3575849211,16
1,453,3746,3575849195,3575849213,18
1,453,3747,3575849195,3575849216,21
1,453,3748,3575849195,3575849218,23
1,453,3749,3575849195,3575849220,25
1,453,3750,3575849195,3575849224,29
1,453,3751,3575849195,3575849225,30
1,453,3752,3575849195,3575849225,30
1,453,3753,3575849195,3575849229,34
1,453,3754,3575849195,3575849230,35
1,453,3755,3575849195,3575849232,37
1,453,3756,3575849195,3575849232,37
1,453,3757,3575849195,3575849234,39
1,453,3758,3575849195,3575849236,41
1,453,3759,3575849195,3575849236,41
1,453,3760,3575849195,3575849239,44
1,453,3761,3575849195,3575849244,49
1,454,3762,3575849248,3575849248,0
1,454,3763,3575849248,3575849251,3
1,454,3764,3575849248,3575849251,3
1,454,3765,3575849248,3575849253,5
1,454,3766,3575849248,3575849262,14
1,454,3767,3575849248,3575849264,16
1,454,3768,3575849248,3575849269,21
1,454,3769,3575849248,3575849276,28
1,454,3770,3575849248,3575849278,30
1,454,3771,3575849248,3575849279,31
1,454,3772,3575849248,3575849282,34
1,454,3773,3575849248,3575849286,38
1,454,3774,3575849248,3575849289,41
1,454,3775,3575849248,3575849289,41
1,454,3776,3575849248,3575849293,45
1,454,3777,3575849248,3575849296,48
1,454,3778,3575849248,3575849297,49
1,455,3779,3575849300,3575849303,3
1,455,3780,3575849300,3575849305,5
1,455,3781,3575849300,3575849307,7
1,455,3782,3575849300,3575849310,10
1,455,3783,3575849300,3575849311,11
1,455,3784,3575849300,3575849319,19
1,455,3785,3575849300,3575849322,22
1,455,3786,3575849300,3575849330,30
1,455,3787,3575849300,3575849331,31
1,455,3788,3575849300,3575849331,31
1,455,3789,3575849300,3575849332,32
1,455,3790,3575849300,3575849335,35
1,455,3791,3575849300,3575849341,41
1,455,3792,3575849300,3575849342,42
1,456,3793,3575849353,3575849353,0
1,456,3794,3575849353,3575849353,0
1,456,3795,3575849353,3575849353,0
1,456,3796,3575849353,3575849354,1
1,456,3797,3575849353,3575849360,7
1,456,3798,3575849353,3575849364,11
1,456,3799,3575849353,3575849365,12
1,456,3800,3575849353,3575849367,14
1,456,3801,3575849353,3575849368,15
1,456,3802,3575849353,3575849370,17
1,456,3803,3575849353,3575849372,19
1,456,3804,3575849353,3575849375,22
1,456,3805,3575849353,3575849375,22
1,456,3806,3575849353,3575849375,22
1,456,3807,3575849353,3575849376,23
1,456,3808,3575849353,3575849377,24
1,456,3809,3575849353,3575849377,24
1,456,3810,3575849353,3575849382,29
1,456,3811,3575849353,3575849387,34
1,456,3812,3575849353,3575849391,38
1,456,3813,3575849353,3575849393,40
1,456,3814,3575849353,3575849393,40
1,456,3815,3575849353,3575849397,44
1,456,3816,3575849353,3575849399,46
1,456,3817,3575849353,3575849403,50
1,457,3818,3575849407,3575849407,0
1,457,3819,3575849407,3575849410,3
1,457,3820,3575849407,3575849411,4
1,457,3821,3575849407,3575849411,4
1,457,3822,3575849407,3575849412,5
1,457,3823,3575849407,3575849413,6
1,457,3824,3575849407,3575849416,9
1,457,3825,3575849407,3575849417,10
1,457,3826,3575849407,3575849418,11
1,457,3827,3575849407,3575849420,13
1,457,3828,3575849407,3575849424,17
1,457,3829,3575849407,3575849424,17
1,457,3830,3575849407,3575849426,19
1,457,3831,3575849407,3575849429,22
1,457,3832,3575849407,3575849430,23
1,457,3833,3575849407,3575849432,25
1,457,3834,3575849407,3575849432,25
1,457,3835,3575849407,3575849434,27
1,457,3836,3575849407,3575849436,29
1,457,3837,3575849407,3575849437,30
1,457,3838,3575849407,3575849439,32
1,457,3839,3575849407,3575849445,38
1,457,3840,3575849407,3575849450,43
1,457,3841,3575849407,3575849451,44
1,457,3842,3575849407,3575849451,44
1,457,3843,3575849407,3575849453,46
1,458,3844,3575849462,3575849462,0
1,458,3845,3575849462,3575849463,1
1,458,3846,3575849462,3575849464,2
1,458,3847,3575849462,3575849469,7
1,458,3848,3575849462,3575849476,14
1,458,3849,3575849462,3575849478,16
1,458,3850,3575849462,3575849480,18
1,458,3851,3575849462,3575849481,19
1,458,3852,3575849462,3575849482,20
1,458,3853,3575849462,3575849485,23
1,458,3854,3575849462,3575849489,27
1,458,3855,3575849462,3575849489,27
1,458,3856,3575849462,3575849497,35
1,458,3857,3575849462,3575849497,35
1,458,3858,3575849462,3575849503,41
1,458,3859,3575849462,3575849505,43
1,458,3860,3575849462,3575849507,45
1,458,3861,3575849462,3575849510,48
1,459,3862,3575849515,3575849515,0
1,459,3863,3575849515,3575849518,3
1,459,3864,3575849515,3575849521,6
1,459,3865,3575849515,3575849529,14
1,459,3866,3575849515,3575849530,15
1,459,3867,3575849515,3575849530,15
1,459,3868,3575849515,3575849531,16
1,459,3869,3575849515,3575849534,19
1,459,3870,3575849515,3575849540,25
1,459,3871,3575849515,3575849541,26
1,459,3872,3575849515,3575849550,35
1,459,3873,3575849515,3575849552,37
1,459,3874,3575849515,3575849553,38
1,459,3875,3575849515,3575849553,38
1,459,3876,3575849515,3575849560,45
1,459,3877,3575849515,3575849563,48
1,460,3878,3575849568,3575849568,0
1,460,3879,3575849568,3575849568,0
1,460,3880,3575849568,3575849568,0
1,460,3881,3575849568,3575849572,4
1,460,3882,3575849568,3575849574,6
1,460,3883,3575849568,3575849574,6
1,460,3884,3575849568,3575849574,6
1,460,3885,3575849568,3575849575,7
1,460,3886,3575849568,3575849576,8
1,460,3887,3575849568,3575849577,9
1,460,3888,3575849568,3575849580,12
1,460,3889,3575849568,3575849586,18
1,460,3890,3575849568,3575849590,22
1,460,3891,3575849568,3575849591,23
1,460,3892,3575849568,3575849592,24
1,460,3893,3575849568,3575849594,26
1,460,3894,3575849568,3575849596,28
1,460,3895,3575849568,3575849601,33
1,460,3896,3575849568,3575849605,37
1,460,3897,3575849568,3575849609,41
1,460,3898,3575849568,3575849610,42
1,460,3899,3575849568,3575849612,44
1,460,3900,3575849568,3575849612,44
1,460,3901,3575849568,3575849615,47
1,460,3902,3575849568,3575849615,47
1,460,3903,3575849568,3575849617,49
1,461,3904,3575849621,3575849621,0
1,461,3905,3575849621,3575849624,3
1,461,3906,3575849621,3575849624,3
1,461,3907,3575849621,3575849625,4
1,461,3908,3575849621,3575849628,7
1,461,3909,3575849621,3575849630,9
1,461,3910,3575849621,3575849631,10
1,461,3911,3575849621,3575849634,13
1,461,3912,3575849621,3575849636,15
1,461,3913,3575849621,3575849639,18
1,461,3914,3575849621,3575849644,23
1,461,3915,3575849621,3575849649,28
1,461,3916,3575849621,3575849650,29
1,461,3917,3575849621,3575849651,30
1,461,3918,3575849621,3575849653,32
1,461,3919,3575849621,3575849659,38
1,461,3920,3575849621,3575849663,42
1,461,3921,3575849621,3575849663,42
1,461,3922,3575849621,3575849668,47
1,462,3923,3575849674,3575849676,2
1,462,3924,3575849674,3575849678,4
1,462,3925,3575849674,3575849680,6
1,462,3926,3575849674,3575849680,6
1,462,3927,3575849674,3575849682,8
1,462,3928,3575849674,3575849686,12
1,462,3929,3575849674,3575849689,15
1,462,3930,3575849674,3575849690,16
1,462,3931,3575849674,3575849697,23
1,462,3932,3575849674,3575849697,23
1,462,3933,3575849674,3575849703,29
1,462,3934,3575849674,3575849705,31
1,462,3935,3575849674,3575849707,33
1,462,3936,3575849674,3575849710,36
1,462,3937,3575849674,3575849712,38
1,462,3938,3575849674,3575849718,44
1,462,3939,3575849674,3575849721,47
1,463,3940,3575849727,3575849729,2
1,463,3941,3575849727,3575849731,4
1,463,3942,3575849727,3575849731,4
1,463,3943,3575849727,3575849731,4
1,463,3944,3575849727,3575849734,7
1,463,3945,3575849727,3575849740,13
1,463,3946,3575849727,3575849741,14
1,463,3947,3575849727,3575849751,24
1,463,3948,3575849727,3575849753,26
1,463,3949,3575849727,3575849754,27
1,463,3950,3575849727,3575849754,27
1,463,3951,3575849727,3575849759,32
1,463,3952,3575849727,3575849763,36
1,463,3953,3575849727,3575849765,38
1,463,3954,3575849727,3575849767,40
1,463,3955,3575849727,3575849768,41
1,463,3956,3575849727,3575849772,45
1,463,3957,3575849727,3575849774,47
1,463,3958,3575849727,3575849774,47
1,463,3959,3575849727,3575849774,47
1,463,3960,3575849727,3575849775,48
1,464,3961,3575849780,3575849780,0
1,464,3962,3575849780,3575849782,2
1,464,3963,3575849780,3575849787,7
1,464,3964,3575849780,3575849790,10
1,464,3965,3575849780,3575849792,12
1,464,3966,3575849780,3575849792,12
1,464,3967,3575849780,3575849795,15
1,464,3968,3575849780,3575849795,15
1,464,3969,3575849780,3575849801,21
1,464,3970,3575849780,3575849805,25
1,464,3971,3575849780,3575849809,29
1,464,3972,3575849780,3575849810,30
1,464,3973,3575849780,3575849810,30
1,464,3974,3575849780,3575849812,32
1,464,3975,3575849780,3575849813,33
1,464,3976,3575849780,3575849816,36
1,464,3977,3575849780,3575849816,36
1,464,3978,3575849780,3575849818,38
1,464,3979,3575849780,3575849819,39
1,464,3980,3575849780,3575849823,43
1,464,3981,3575849780,3575849825,45
1,464,3982,3575849780,3575849825,45
1,464,3983,3575849780,3575849828,48
1,464,3984,3575849780,3575849830,50
1,465,3985,3575849833,3575849833,0
1,465,3986,3575849833,3575849834,1
1,465,3987,3575849833,3575849835,2
1,465,3988,3575849833,3575849836,3
1,465,3989,3575849833,3575849839,6
1,465,3990,3575849833,3575849843,10
1,465,3991,3575849833,3575849849,16
1,465,3992,3575849833,3575849850,17
1,465,3993,3575849833,3575849851,18
1,465,3994,3575849833,3575849854,21
1,465,3995,3575849833,3575849861,28
1,465,3996,3575849833,3575849863,30
1,465,3997,3575849833,3575849864,31
1,465,3998,3575849833,3575849868,35
1,465,3999,3575849833,3575849876,43
1,465,4000,3575849833,3575849878,45
1,465,4001,3575849833,3575849880,47
1,465,4002,3575849833,3575849881,48
1,465,4003,3575849833,3575849882,49
1,466,4004,3575849886,3575849886,0
1,466,4005,3575849886,3575849890,4
1,466,4006,3575849886,3575849891,5
1,466,4007,3575849886,3575849894,8
1,466,4008,3575849886,3575849896,10
1,466,4009,3575849886,3575849897,11
1,466,4010,3575849886,3575849903,17
1,466,4011,3575849886,3575849905,19
1,466,4012,3575849886,3575849907,21
1,466,4013,3575849886,3575849910,24
1,466,4014,3575849886,3575849912,26
1,466,4015,3575849886,3575849919,33
1,466,4016,3575849886,3575849921,35
1,466,4017,3575849886,3575849929,43
1,466,4018,3575849886,3575849931,45
1,466,4019,3575849886,3575849931,45
1,466,4020,3575849886,3575849934,48
1,467,4021,3575849939,3575849940,1
1,467,4022,3575849939,3575849941,2
1,467,4023,3575849939,3575849951,12
1,467,4024,3575849939,3575849954,15
1,467,4025,3575849939,3575849954,15
1,467,4026,3575849939,3575849955,16
1,467,4027,3575849939,3575849959,20
1,467,4028,3575849939,3575849963,24
1,467,4029,3575849939,3575849965,26
1,467,4030,3575849939,3575849968,29
1,467,4031,3575849939,3575849970,31
1,467,4032,3575849939,3575849972,33
1,467,4033,3575849939,3575849973,34
1,467,4034,3575849939,3575849974,35
1,467,4035,3575849939,3575849974,35
1,467,4036,3575849939,3575849975,36
1,467,4037,3575849939,3575849977,38
1,467,4038,3575849939,3575849981,42
1,467,4039,3575849939,3575849987,48
1,468,4040,3575849992,3575849992,0
1,468,4041,3575849992,3575849992,0
1,468,4042,3575849992,3575849992,0
1,468,4043,3575849992,3575849994,2
1,468,4044,3575849992,3575849999,7
1,468,4045,3575849992,3575850001,9
1,468,4046,3575849992,3575850006,14
1,468,4047,3575849992,3575850009,17
1,468,4048,3575849992,3575850010,18
1,468,4049,3575849992,3575850011,19
1,468,4050,3575849992,3575850012,20
1,468,4051,3575849992,3575850012,20
1,468,4052,3575849992,3575850015,23
1,468,4053,3575849992,3575850016,24
1,468,4054,3575849992,3575850019,27
1,468,4055,3575849992,3575850019,27
1,468,4056,3575849992,3575850023,31
1,468,4057,3575849992,3575850024,32
1,468,4058,3575849992,3575850025,33
1,468,4059,3575849992,3575850028,36
1,468,4060,3575849992,3575850030,38
1,468,4061,3575849992,3575850031,39
1,468,4062,3575849992,3575850031,39
1,468,4063,3575849992,3575850034,42
1,468,4064,3575849992,3575850035,43
1,468,4065,3575849992,3575850037,45
1,468,4066,3575849992,3575850039,47
1,469,4067,3575850045,3575850045,0
1,469,4068,3575850045,3575850050,5
1,469,4069,3575850045,3575850051,6
1,469,4070,3575850045,3575850051,6
1,469,4071,3575850045,3575850054,9
1,469,4072,3575850045,3575850062,17
1,469,4073,3575850045,3575850064,19
1,469,4074,3575850045,3575850069,24
1,469,4075,3575850045,3575850076,31
1,469,4076,3575850045,3575850079,34
1,469,4077,3575850045,3575850080,35
1,469,4078,3575850045,3575850081,36
1,469,4079,3575850045,3575850083,38
1,469,4080,3575850045,3575850087,42
1,469,4081,3575850045,3575850090,45
1,469,4082,3575850045,3575850090,45
1,469,4083,3575850045,3575850093,48
1,470,4084,3575850097,3575850097,0
1,470,4085,3575850097,3575850097,0
1,470,4086,3575850097,3575850103,6
1,470,4087,3575850097,3575850105,8
1,470,4088,3575850097,3575850107,10
1,470,4089,3575850097,3575850110,13
1,470,4090,3575850097,3575850112,15
1,470,4091,3575850097,3575850119,22
1,470,4092,3575850097,3575850121,24
1,470,4093,3575850097,3575850128,31
1,470,4094,3575850097,3575850131,34
1,470,4095,3575850097,3575850131,34
1,470,4096,3575850097,3575850140,43
1,470,4097,3575850097,3575850141,44
1,471,4098,3575850150,3575850152,2
1,471,4099,3575850150,3575850154,4
1,471,4100,3575850150,3575850154,4
1,471,4101,3575850150,3575850156,6
1,471,4102,3575850150,3575850159,9
1,471,4103,3575850150,3575850163,13
1,471,4104,3575850150,3575850165,15
1,471,4105,3575850150,3575850168,18
1,471,4106,3575850150,3575850170,20
1,471,4107,3575850150,3575850172,22
1,471,4108,3575850150,3575850174,24
1,471,4109,3575850150,3575850174,24
1,471,4110,3575850150,3575850175,25
1,471,4111,3575850150,3575850177,27
1,471,4112,3575850150,3575850182,32
1,471,4113,3575850150,3575850187,37
1,471,4114,3575850150,3575850191,41
1,471,4115,3575850150,3575850192,42
1,471,4116,3575850150,3575850192,42
1,471,4117,3575850150,3575850195,45
1,472,4118,3575850203,3575850203,0
1,472,4119,3575850203,3575850207,4
1,472,4120,3575850203,3575850210,7
1,472,4121,3575850203,3575850210,7
1,472,4122,3575850203,3575850211,8
1,472,4123,3575850203,3575850212,9
1,472,4124,3575850203,3575850212,9
1,472,4125,3575850203,3575850215,12
1,472,4126,3575850203,3575850216,13
1,472,4127,3575850203,3575850218,15
1,472,4128,3575850203,3575850219,16
1,472,4129,3575850203,3575850225,22
1,472,4130,3575850203,3575850225,22
1,472,4131,3575850203,3575850225,22
1,472,4132,3575850203,3575850229,26
1,472,4133,3575850203,3575850230,27
1,472,4134,3575850203,3575850231,28
1,472,4135,3575850203,3575850232,29
1,472,4136,3575850203,3575850234,31
1,472,4137,3575850203,3575850236,33
1,472,4138,3575850203,3575850239,36
1,472,4139,3575850203,3575850251,48
1,472,4140,3575850203,3575850252,49
1,472,4141,3575850203,3575850252,49
1,473,4142,3575850258,3575850258,0
1,473,4143,3575850258,3575850261,3
1,473,4144,3575850258,3575850264,6
1,473,4145,3575850258,3575850265,7
1,473,4146,3575850258,3575850270,12
1,473,4147,3575850258,3575850276,18
1,473,4148,3575850258,3575850279,21
1,473,4149,3575850258,3575850280,22
1,473,4150,3575850258,3575850282,24
1,473,4151,3575850258,3575850282,24
1,473,4152,3575850258,3575850289,31
1,473,4153,3575850258,3575850290,32
1,473,4154,3575850258,3575850293,35
1,473,4155,3575850258,3575850297,39
1,473,4156,3575850258,3575850297,39
1,473,4157,3575850258,3575850303,45
1,473,4158,3575850258,3575850305,47
1,473,4159,3575850258,3575850307,49
1,474,4160,3575850312,3575850313,1
1,474,4161,3575850312,3575850319,7
1,474,4162,3575850312,3575850322,10
1,474,4163,3575850312,3575850329,17
1,474,4164,3575850312,3575850331,19
1,474,4165,3575850312,3575850332,20
1,474,4166,3575850312,3575850333,21
1,474,4167,3575850312,3575850340,28
1,474,4168,3575850312,3575850341,29
1,474,4169,3575850312,3575850352,40
1,474,4170,3575850312,3575850354,42
1,474,4171,3575850312,3575850354,42
1,474,4172,3575850312,3575850356,44
1,474,4173,3575850312,3575850360,48
1,475,4174,3575850365,3575850365,0
1,475,4175,3575850365,3575850365,0
1,475,4176,3575850365,3575850367,2
1,475,4177,3575850365,3575850370,5
1,475,4178,3575850365,3575850373,8
1,475,4179,3575850365,3575850374,9
1,475,4180,3575850365,3575850375,10
1,475,4181,3575850365,3575850376,11
1,475,4182,3575850365,3575850378,13
1,475,4183,3575850365,3575850381,16
1,475,4184,3575850365,3575850386,21
1,475,4185,3575850365,3575850391,26
1,475,4186,3575850365,3575850392,27
1,475,4187,3575850365,3575850393,28
1,475,4188,3575850365,3575850395,30
1,475,4189,3575850365,3575850403,38
1,475,4190,3575850365,3575850407,42
1,475,4191,3575850365,3575850410,45
1,475,4192,3575850365,3575850411,46
1,475,4193,3575850365,3575850411,46
1,475,4194,3575850365,3575850413,48
1,475,4195,3575850365,3575850413,48
1,476,4196,3575850418,3575850418,0
1,476,4197,3575850418,3575850419,1
1,476,4198,3575850418,3575850419,1
1,476,4199,3575850418,3575850425,7
1,476,4200,3575850418,3575850425,7
1,476,4201,3575850418,3575850426,8
1,476,4202,3575850418,3575850428,10
1,476,4203,3575850418,3575850430,12
1,476,4204,3575850418,3575850431,13
1,476,4205,3575850418,3575850431,13
1,476,4206,3575850418,3575850434,16
1,476,4207,3575850418,3575850436,18
1,476,4208,3575850418,3575850439,21
1,476,4209,3575850418,3575850449,31
1,476,4210,3575850418,3575850451,33
1,476,4211,3575850418,3575850452,34
1,476,4212,3575850418,3575850452,34
1,476,4213,3575850418,3575850454,36
1,476,4214,3575850418,3575850462,44
1,476,4215,3575850418,3575850464,46
1,476,4216,3575850418,3575850465,47
1,477,4217,3575850471,3575850471,0
1,477,4218,3575850471,3575850476,5
1,477,4219,3575850471,3575850479,8
1,477,4220,3575850471,3575850480,9
1,477,4221,3575850471,3575850482,11
1,477,4222,3575850471,3575850483,12
1,477,4223,3575850471,3575850490,19
1,477,4224,3575850471,3575850491,20
1,477,4225,3575850471,3575850493,22
1,477,4226,3575850471,3575850497,26
1,477,4227,3575850471,3575850498,27
1,477,4228,3575850471,3575850503,32
1,477,4229,3575850471,3575850505,34
1,477,4230,3575850471,3575850507,36
1,477,4231,3575850471,3575850513,42
1,477,4232,3575850471,3575850519,48
1,478,4233,3575850525,3575850525,0
1,478,4234,3575850525,3575850528,3
1,478,4235,3575850525,3575850530,5
1,478,4236,3575850525,3575850531,6
1,478,4237,3575850525,3575850531,6
1,478,4238,3575850525,3575850539,14
1,478,4239,3575850525,3575850540,15
1,478,4240,3575850525,3575850551,26
1,478,4241,3575850525,3575850553,28
1,478,4242,3575850525,3575850554,29
1,478,4243,3575850525,3575850554,29
1,478,4244,3575850525,3575850557,32
1,478,4245,3575850525,3575850559,34
1,478,4246,3575850525,3575850562,37
1,478,4247,3575850525,3575850565,40
1,478,4248,3575850525,3575850567,42
1,478,4249,3575850525,3575850569,44
1,478,4250,3575850525,3575850572,47
1,478,4251,3575850525,3575850574,49
1,478,4252,3575850525,3575850574,49
1,479,4253,3575850579,3575850579,0
1,479,4254,3575850579,3575850579,0
1,479,4255,3575850579,3575850580,1
1,479,4256,3575850579,3575850586,7
1,479,4257,3575850579,3575850590,11
1,479,4258,3575850579,3575850591,12
1,479,4259,3575850579,3575850591,12
1,479,4260,3575850579,3575850593,14
1,479,4261,3575850579,3575850596,17
1,479,4262,3575850579,3575850601,22
1,479,4263,3575850579,3575850606,27
1,479,4264,3575850579,3575850607,28
1,479,4265,3575850579,3575850609,30
1,479,4266,3575850579,3575850610,31
1,479,4267,3575850579,3575850610,31
1,479,4268,3575850579,3575850611,32
1,479,4269,3575850579,3575850612,33
1,479,4270,3575850579,3575850615,36
1,479,4271,3575850579,3575850615,36
1,479,4272,3575850579,3575850618,39
1,479,4273,3575850579,3575850618,39
1,479,4274,3575850579,3575850624,45
1,479,4275,3575850579,3575850624,45
1,479,4276,3575850579,3575850625,46
1,479,4277,3575850579,3575850628,49
1,480,4278,3575850632,3575850632,0
1,480,4279,3575850632,3575850632,0
1,480,4280,3575850632,3575850632,0
1,480,4281,3575850632,3575850633,1
1,480,4282,3575850632,3575850635,3
1,480,4283,3575850632,3575850639,7
1,480,4284,3575850632,3575850644,12
1,480,4285,3575850632,3575850649,17
1,480,4286,3575850632,3575850650,18
1,480,4287,3575850632,3575850651,19
1,480,4288,3575850632,3575850652,20
1,480,4289,3575850632,3575850653,21
1,480,4290,3575850632,3575850661,29
1,480,4291,3575850632,3575850663,31
1,480,4292,3575850632,3575850664,32
1,480,4293,3575850632,3575850668,36
1,480,4294,3575850632,3575850676,44
1,480,4295,3575850632,3575850679,47
1,480,4296,3575850632,3575850682,50
1,481,4297,3575850685,3575850685,0
1,481,4298,3575850685,3575850688,3
1,481,4299,3575850685,3575850691,6
1,481,4300,3575850685,3575850691,6
1,481,4301,3575850685,3575850694,9
1,481,4302,3575850685,3575850697,12
1,481,4303,3575850685,3575850698,13
1,481,4304,3575850685,3575850703,18
1,481,4305,3575850685,3575850705,20
1,481,4306,3575850685,3575850707,22
1,481,4307,3575850685,3575850710,25
1,481,4308,3575850685,3575850713,28
1,481,4309,3575850685,3575850719,34
1,481,4310,3575850685,3575850722,37
1,481,4311,3575850685,3575850728,43
1,481,4312,3575850685,3575850731,46
1,481,4313,3575850685,3575850731,46
1,482,4314,3575850738,3575850739,1
1,482,4315,3575850738,3575850741,3
1,482,4316,3575850738,3575850751,13
1,482,4317,3575850738,3575850753,15
1,482,4318,3575850738,3575850753,15
1,482,4319,3575850738,3575850754,16
1,482,4320,3575850738,3575850757,19
1,482,4321,3575850738,3575850759,21
1,482,4322,3575850738,3575850762,24
1,482,4323,3575850738,3575850765,27
1,482,4324,3575850738,3575850768,30
1,482,4325,3575850738,3575850769,31
1,482,4326,3575850738,3575850772,34
1,482,4327,3575850738,3575850774,36
1,482,4328,3575850738,3575850774,36
1,482,4329,3575850738,3575850774,36
1,482,4330,3575850738,3575850777,39
1,482,4331,3575850738,3575850777,39
1,482,4332,3575850738,3575850782,44
1,482,4333,3575850738,3575850787,49
1,483,4334,3575850791,3575850791,0
1,483,4335,3575850791,3575850791,0
1,483,4336,3575850791,3575850792,1
1,483,4337,3575850791,3575850794,3
1,483,4338,3575850791,3575850796,5
1,483,4339,3575850791,3575850802,11
1,483,4340,3575850791,3575850806,15
1,483,4341,3575850791,3575850807,16
1,483,4342,3575850791,3575850809,18
1,483,4343,3575850791,3575850810,19
1,483,4344,3575850791,3575850811,20
1,483,4345,3575850791,3575850812,21
1,483,4346,3575850791,3575850812,21
1,483,4347,3575850791,3575850815,24
1,483,4348,3575850791,3575850816,25
1,483,4349,3575850791,3575850818,27
1,483,4350,3575850791,3575850818,27
1,483,4351,3575850791,3575850824,33
1,483,4352,3575850791,3575850824,33
1,483,4353,3575850791,3575850825,34
1,483,4354,3575850791,3575850829,38
1,483,4355,3575850791,3575850830,39
1,483,4356,3575850791,3575850830,39
1,483,4357,3575850791,3575850830,39
1,483,4358,3575850791,3575850833,42
1,483,4359,3575850791,3575850835,44
1,483,4360,3575850791,3575850839,48
1,484,4361,3575850844,3575850844,0
1,484,4362,3575850844,3575850848,4
1,484,4363,3575850844,3575850850,6
1,484,4364,3575850844,3575850851,7
1,484,4365,3575850844,3575850852,8
1,484,4366,3575850844,3575850854,10
1,484,4367,3575850844,3575850860,16
1,484,4368,3575850844,3575850863,19
1,484,4369,3575850844,3575850863,19
1,484,4370,3575850844,3575850868,24
1,484,4371,3575850844,3575850876,32
1,484,4372,3575850844,3575850879,35
1,484,4373,3575850844,3575850882,38
1,484,4374,3575850844,3575850882,38
1,484,4375,3575850844,3575850888,44
1,484,4376,3575850844,3575850891,47
1,484,4377,3575850844,3575850891,47
1,484,4378,3575850844,3575850893,49
1,485,4379,3575850897,3575850897,0
1,485,4380,3575850897,3575850904,7
1,485,4381,3575850897,3575850905,8
1,485,4382,3575850897,3575850908,11
1,485,4383,3575850897,3575850910,13
1,485,4384,3575850897,3575850913,16
1,485,4385,3575850897,3575850919,22
1,485,4386,3575850897,3575850922,25
1,485,4387,3575850897,3575850929,32
1,485,4388,3575850897,3575850931,34
1,485,4389,3575850897,3575850931,34
1,485,4390,3575850897,3575850939,42
1,485,4391,3575850897,3575850942,45
1,486,4392,3575850950,3575850952,2
1,486,4393,3575850950,3575850953,3
1,486,4394,3575850950,3575850954,4
1,486,4395,3575850950,3575850955,5
1,486,4396,3575850950,3575850957,7
1,486,4397,3575850950,3575850960,10
1,486,4398,3575850950,3575850963,13
1,486,4399,3575850950,3575850965,15
1,486,4400,3575850950,3575850967,17
1,486,4401,3575850950,3575850969,19
1,486,4402,3575850950,3575850972,22
1,486,4403,3575850950,3575850973,23
1,486,4404,3575850950,3575850974,24
1,486,4405,3575850950,3575850974,24
1,486,4406,3575850950,3575850977,27
1,486,4407,3575850950,3575850977,27
1,486,4408,3575850950,3575850982,32
1,486,4409,3575850950,3575850987,37
1,486,4410,3575850950,3575850990,40
1,486,4411,3575850950,3575850993,43
1,486,4412,3575850950,3575850993,43
1,486,4413,3575850950,3575850996,46
1,487,4414,3575851003,3575851003,0
1,487,4415,3575851003,3575851006,3
1,487,4416,3575851003,3575851007,4
1,487,4417,3575851003,3575851009,6
1,487,4418,3575851003,3575851011,8
1,487,4419,3575851003,3575851011,8
1,487,4420,3575851003,3575851012,9
1,487,4421,3575851003,3575851012,9
1,487,4422,3575851003,3575851014,11
1,487,4423,3575851003,3575851015,12
1,487,4424,3575851003,3575851016,13
1,487,4425,3575851003,3575851018,15
1,487,4426,3575851003,3575851019,16
1,487,4427,3575851003,3575851023,20
1,487,4428,3575851003,3575851025,22
1,487,4429,3575851003,3575851025,22
1,487,4430,3575851003,3575851029,26
1,487,4431,3575851003,3575851030,27
1,487,4432,3575851003,3575851031,28
1,487,4433,3575851003,3575851031,28
1,487,4434,3575851003,3575851033,30
1,487,4435,3575851003,3575851035,32
1,487,4436,3575851003,3575851039,36
1,487,4437,3575851003,3575851044,41
1,487,4438,3575851003,3575851048,45
1,487,4439,3575851003,3575851050,47
1,487,4440,3575851003,3575851051,48
1,487,4441,3575851003,3575851051,48
1,488,4442,3575851057,3575851057,0
1,488,4443,3575851057,3575851060,3
1,488,4444,3575851057,3575851062,5
1,488,4445,3575851057,3575851063,6
1,488,4446,3575851057,3575851068,11
1,488,4447,3575851057,3575851076,19
1,488,4448,3575851057,3575851080,23
1,488,4449,3575851057,3575851082,25
1,488,4450,3575851057,3575851088,31
1,488,4451,3575851057,3575851091,34
1,488,4452,3575851057,3575851091,34
1,488,4453,3575851057,3575851094,37
1,488,4454,3575851057,3575851097,40
1,488,4455,3575851057,3575851104,47
1,488,4456,3575851057,3575851105,48
1,489,4457,3575851111,3575851111,0
1,489,4458,3575851111,3575851111,0
1,489,4459,3575851111,3575851113,2
1,489,4460,3575851111,3575851120,9
1,489,4461,3575851111,3575851122,11
1,489,4462,3575851111,3575851128,17
1,489,4463,3575851111,3575851131,20
1,489,4464,3575851111,3575851131,20
1,489,4465,3575851111,3575851139,28
1,489,4466,3575851111,3575851142,31
1,489,4467,3575851111,3575851152,41
1,489,4468,3575851111,3575851153,42
1,489,4469,3575851111,3575851153,42
1,489,4470,3575851111,3575851154,43
1,489,4471,3575851111,3575851156,45
1,489,4472,3575851111,3575851160,49
1,490,4473,3575851164,3575851164,0
1,490,4474,3575851164,3575851165,1
1,490,4475,3575851164,3575851167,3
1,490,4476,3575851164,3575851167,3
1,490,4477,3575851164,3575851169,5
1,490,4478,3575851164,3575851172,8
1,490,4479,3575851164,3575851173,9
1,490,4480,3575851164,3575851174,10
1,490,4481,3575851164,3575851174,10
1,490,4482,3575851164,3575851177,13
1,490,4483,3575851164,3575851181,17
1,490,4484,3575851164,3575851187,23
1,490,4485,3575851164,3575851190,26
1,490,4486,3575851164,3575851193,29
1,490,4487,3575851164,3575851193,29
1,490,4488,3575851164,3575851197,33
1,490,4489,3575851164,3575851203,39
1,490,4490,3575851164,3575851206,42
1,490,4491,3575851164,3575851207,43
1,490,4492,3575851164,3575851210,46
1,490,4493,3575851164,3575851211,47
1,490,4494,3575851164,3575851211,47
1,490,4495,3575851164,3575851212,48
1,490,4496,3575851164,3575851212,48
1,491,4497,3575851217,3575851217,0
1,491,4498,3575851217,3575851217,0
1,491,4499,3575851217,3575851217,0
1,491,4500,3575851217,3575851217,0
1,491,4501,3575851217,3575851218,1
1,491,4502,3575851217,3575851219,2
1,491,4503,3575851217,3575851225,8
1,491,4504,3575851217,3575851225,8
1,491,4505,3575851217,3575851225,8
1,491,4506,3575851217,3575851229,12
1,491,4507,3575851217,3575851230,13
1,491,4508,3575851217,3575851231,14
1,491,4509,3575851217,3575851231,14
1,491,4510,3575851217,3575851234,17
1,491,4511,3575851217,3575851235,18
1,491,4512,3575851217,3575851239,22
1,491,4513,3575851217,3575851244,27
1,491,4514,3575851217,3575851249,32
1,491,4515,3575851217,3575851251,34
1,491,4516,3575851217,3575851251,34
1,491,4517,3575851217,3575851251,34
1,491,4518,3575851217,3575851255,38
1,491,4519,3575851217,3575851261,44
1,491,4520,3575851217,3575851263,46
1,491,4521,3575851217,3575851264,47
1,492,4522,3575851271,3575851271,0
1,492,4523,3575851271,3575851271,0
1,492,4524,3575851271,3575851276,5
1,492,4525,3575851271,3575851280,9
1,492,4526,3575851271,3575851283,12
1,492,4527,3575851271,3575851288,17
1,492,4528,3575851271,3575851292,21
1,492,4529,3575851271,3575851292,21
1,492,4530,3575851271,3575851293,22
1,492,4531,3575851271,3575851297,26
1,492,4532,3575851271,3575851298,27
1,492,4533,3575851271,3575851304,33
1,492,4534,3575851271,3575851305,34
1,492,4535,3575851271,3575851308,37
1,492,4536,3575851271,3575851310,39
1,492,4537,3575851271,3575851313,42
1,492,4538,3575851271,3575851320,49
1,493,4539,3575851325,3575851325,0
1,493,4540,3575851325,3575851329,4
1,493,4541,3575851325,3575851331,6
1,493,4542,3575851325,3575851332,7
1,493,4543,3575851325,3575851332,7
1,493,4544,3575851325,3575851340,15
1,493,4545,3575851325,3575851341,16
1,493,4546,3575851325,3575851352,27
1,493,4547,3575851325,3575851353,28
1,493,4548,3575851325,3575851354,29
1,493,4549,3575851325,3575851355,30
1,493,4550,3575851325,3575851357,32
1,493,4551,3575851325,3575851360,35
1,493,4552,3575851325,3575851363,38
1,493,4553,3575851325,3575851365,40
1,493,4554,3575851325,3575851367,42
1,493,4555,3575851325,3575851368,43
1,493,4556,3575851325,3575851370,45
1,493,4557,3575851325,3575851373,48
1,493,4558,3575851325,3575851374,49
1,493,4559,3575851325,3575851374,49
1,493,4560,3575851325,3575851375,50
1,494,4561,3575851379,3575851379,0
1,494,4562,3575851379,3575851382,3
1,494,4563,3575851379,3575851387,8
1,494,4564,3575851379,3575851390,11
1,494,4565,3575851379,3575851391,12
1,494,4566,3575851379,3575851394,15
1,494,4567,3575851379,3575851394,15
1,494,4568,3575851379,3575851396,17
1,494,4569,3575851379,3575851404,25
1,494,4570,3575851379,3575851406,27
1,494,4571,3575851379,3575851407,28
1,494,4572,3575851379,3575851410,31
1,494,4573,3575851379,3575851411,32
1,494,4574,3575851379,3575851411,32
1,494,4575,3575851379,3575851412,33
1,494,4576,3575851379,3575851412,33
1,494,4577,3575851379,3575851415,36
1,494,4578,3575851379,3575851416,37
1,494,4579,3575851379,3575851416,37
1,494,4580,3575851379,3575851418,39
1,494,4581,3575851379,3575851418,39
1,494,4582,3575851379,3575851419,40
1,494,4583,3575851379,3575851419,40
1,494,4584,3575851379,3575851424,45
1,494,4585,3575851379,3575851424,45
1,494,4586,3575851379,3575851425,46
1,494,4587,3575851379,3575851429,50
1,495,4588,3575851432,3575851432,0
1,495,4589,3575851432,3575851434,2
1,495,4590,3575851432,3575851436,4
1,495,4591,3575851432,3575851439,7
1,495,4592,3575851432,3575851444,12
1,495,4593,3575851432,3575851450,18
1,495,4594,3575851432,3575851451,19
1,495,4595,3575851432,3575851451,19
1,495,4596,3575851432,3575851451,19
1,495,4597,3575851432,3575851454,22
1,495,4598,3575851432,3575851461,29
1,495,4599,3575851432,3575851464,32
1,495,4600,3575851432,3575851465,33
1,495,4601,3575851432,3575851469,37
1,495,4602,3575851432,3575851469,37
1,495,4603,3575851432,3575851476,44
1,495,4604,3575851432,3575851480,48
1,495,4605,3575851432,3575851482,50
1,496,4606,3575851485,3575851485,0
1,496,4607,3575851485,3575851487,2
1,496,4608,3575851485,3575851490,5
1,496,4609,3575851485,3575851490,5
1,496,4610,3575851485,3575851492,7
1,496,4611,3575851485,3575851496,11
1,496,4612,3575851485,3575851496,11
1,496,4613,3575851485,3575851503,18
1,496,4614,3575851485,3575851504,19
1,496,4615,3575851485,3575851507,22
1,496,4616,3575851485,3575851509,24
1,496,4617,3575851485,3575851513,28
1,496,4618,3575851485,3575851519,34
1,496,4619,3575851485,3575851521,36
1,496,4620,3575851485,3575851528,43
1,496,4621,3575851485,3575851530,45
1,496,4622,3575851485,3575851530,45
1,496,4623,3575851485,3575851532,47
1,497,4624,3575851538,3575851539,1
1,497,4625,3575851538,3575851541,3
1,497,4626,3575851538,3575851551,13
1,497,4627,3575851538,3575851552,14
1,497,4628,3575851538,3575851553,15
1,497,4629,3575851538,3575851554,16
1,497,4630,3575851538,3575851556,18
1,497,4631,3575851538,3575851560,22
1,497,4632,3575851538,3575851563,25
1,497,4633,3575851538,3575851565,27
1,497,4634,3575851538,3575851566,28
1,497,4635,3575851538,3575851568,30
1,497,4636,3575851538,3575851569,31
1,497,4637,3575851538,3575851572,34
1,497,4638,3575851538,3575851574,36
1,497,4639,3575851538,3575851574,36
1,497,4640,3575851538,3575851574,36
1,497,4641,3575851538,3575851576,38
1,497,4642,3575851538,3575851581,43
1,497,4643,3575851538,3575851587,49
1,498,4644,3575851592,3575851592,0
1,498,4645,3575851592,3575851592,0
1,498,4646,3575851592,3575851592,0
1,498,4647,3575851592,3575851593,1
1,498,4648,3575851592,3575851603,11
1,498,4649,3575851592,3575851605,13
1,498,4650,3575851592,3575851606,14
1,498,4651,3575851592,3575851608,16
1,498,4652,3575851592,3575851610,18
1,498,4653,3575851592,3575851610,18
1,498,4654,3575851592,3575851612,20
1,498,4655,3575851592,3575851613,21
1,498,4656,3575851592,3575851614,22
1,498,4657,3575851592,3575851615,23
1,498,4658,3575851592,3575851616,24
1,498,4659,3575851592,3575851617,25
1,498,4660,3575851592,3575851618,26
1,498,4661,3575851592,3575851618,26
1,498,4662,3575851592,3575851619,27
1,498,4663,3575851592,3575851624,32
1,498,4664,3575851592,3575851624,32
1,498,4665,3575851592,3575851625,33
1,498,4666,3575851592,3575851628,36
1,498,4667,3575851592,3575851631,39
1,498,4668,3575851592,3575851631,39
1,498,4669,3575851592,3575851633,41
1,498,4670,3575851592,3575851635,43
1,498,4671,3575851592,3575851639,47
1,499,4672,3575851646,3575851646,0
1,499,4673,3575851646,3575851648,2
1,499,4674,3575851646,3575851650,4
1,499,4675,3575851646,3575851650,4
1,499,4676,3575851646,3575851651,5
1,499,4677,3575851646,3575851653,7
1,499,4678,3575851646,3575851661,15
1,499,4679,3575851646,3575851663,17
1,499,4680,3575851646,3575851665,19
1,499,4681,3575851646,3575851668,22
1,499,4682,3575851646,3575851669,23
1,499,4683,3575851646,3575851676,30
1,499,4684,3575851646,3575851680,34
1,499,4685,3575851646,3575851682,36
1,499,4686,3575851646,3575851684,38
1,499,4687,3575851646,3575851687,41
1,499,4688,3575851646,3575851691,45
1,499,4689,3575851646,3575851691,45
1,499,4690,3575851646,3575851692,46
1,499,4691,3575851646,3575851695,49
1,500,4692,3575851700,3575851700,0
1,500,4693,3575851700,3575851703,3
1,500,4694,3575851700,3575851704,4
1,500,4695,3575851700,3575851707,7
1,500,4696,3575851700,3575851721,21
1,500,4697,3575851700,3575851728,28
1,500,4698,3575851700,3575851730,30
1,500,4699,3575851700,3575851731,31
1,500,4700,3575851700,3575851732,32
1,500,4701,3575851700,3575851739,39
1,500,4702,3575851700,3575851741,41
1,501,4703,3575851753,3575851753,0
1,501,4704,3575851753,3575851753,0
1,501,4705,3575851753,3575851753,0
1,501,4706,3575851753,3575851753,0
1,501,4707,3575851753,3575851756,3
1,501,4708,3575851753,3575851760,7
1,501,4709,3575851753,3575851763,10
1,501,4710,3575851753,3575851765,12
1,501,4711,3575851753,3575851766,13
1,501,4712,3575851753,3575851768,15
1,501,4713,3575851753,3575851769,16
1,501,4714,3575851753,3575851771,18
1,501,4715,3575851753,3575851774,21
1,501,4716,3575851753,3575851774,21
1,501,4717,3575851753,3575851774,21
1,501,4718,3575851753,3575851778,25
1,501,4719,3575851753,3575851782,29
1,501,4720,3575851753,3575851787,34
1,501,4721,3575851753,3575851789,36
1,501,4722,3575851753,3575851791,38
1,501,4723,3575851753,3575851793,40
1,501,4724,3575851753,3575851793,40
1,501,4725,3575851753,3575851803,50
1,502,4726,3575851806,3575851806,0
1,502,4727,3575851806,3575851807,1
1,502,4728,3575851806,3575851809,3
1,502,4729,3575851806,3575851810,4
1,502,4730,3575851806,3575851810,4
1,502,4731,3575851806,3575851812,6
1,502,4732,3575851806,3575851812,6
1,502,4733,3575851806,3575851814,8
1,502,4734,3575851806,3575851815,9
1,502,4735,3575851806,3575851816,10
1,502,4736,3575851806,3575851817,11
1,502,4737,3575851806,3575851817,11
1,502,4738,3575851806,3575851818,12
1,502,4739,3575851806,3575851818,12
1,502,4740,3575851806,3575851824,18
1,502,4741,3575851806,3575851825,19
1,502,4742,3575851806,3575851825,19
1,502,4743,3575851806,3575851828,22
1,502,4744,3575851806,3575851829,23
1,502,4745,3575851806,3575851830,24
1,502,4746,3575851806,3575851831,25
1,502,4747,3575851806,3575851831,25
1,502,4748,3575851806,3575851833,27
1,502,4749,3575851806,3575851835,29
1,502,4750,3575851806,3575851839,33
1,502,4751,3575851806,3575851845,39
1,502,4752,3575851806,3575851850,44
1,502,4753,3575851806,3575851851,45
1,502,4754,3575851806,3575851851,45
1,502,4755,3575851806,3575851854,48
1,503,4756,3575851860,3575851860,0
1,503,4757,3575851860,3575851862,2
1,503,4758,3575851860,3575851865,5
1,503,4759,3575851860,3575851868,8
1,503,4760,3575851860,3575851868,8
1,503,4761,3575851860,3575851880,20
1,503,4762,3575851860,3575851881,21
1,503,4763,3575851860,3575851883,23
1,503,4764,3575851860,3575851883,23
1,503,4765,3575851860,3575851888,28
1,503,4766,3575851860,3575851891,31
1,503,4767,3575851860,3575851891,31
1,503,4768,3575851860,3575851893,33
1,503,4769,3575851860,3575851896,36
1,503,4770,3575851860,3575851897,37
1,503,4771,3575851860,3575851903,43
1,503,4772,3575851860,3575851905,45
1,503,4773,3575851860,3575851907,47
1,504,4774,3575851913,3575851921,8
1,504,4775,3575851913,3575851928,15
1,504,4776,3575851913,3575851929,16
1,504,4777,3575851913,3575851931,18
1,504,4778,3575851913,3575851931,18
1,504,4779,3575851913,3575851932,19
1,504,4780,3575851913,3575851939,26
1,504,4781,3575851913,3575851942,29
1,504,4782,3575851913,3575851950,37
1,504,4783,3575851913,3575851952,39
1,504,4784,3575851913,3575851953,40
1,504,4785,3575851913,3575851953,40
1,504,4786,3575851913,3575851956,43
1,504,4787,3575851913,3575851960,47
1,505,4788,3575851967,3575851967,0
1,505,4789,3575851967,3575851967,0
1,505,4790,3575851967,3575851967,0
1,505,4791,3575851967,3575851968,1
1,505,4792,3575851967,3575851970,3
1,505,4793,3575851967,3575851972,5
1,505,4794,3575851967,3575851974,7
1,505,4795,3575851967,3575851974,7
1,505,4796,3575851967,3575851974,7
1,505,4797,3575851967,3575851978,11
1,505,4798,3575851967,3575851983,16
1,505,4799,3575851967,3575851987,20
1,505,4800,3575851967,3575851990,23
1,505,4801,3575851967,3575851991,24
1,505,4802,3575851967,3575851993,26
1,505,4803,3575851967,3575851994,27
1,505,4804,3575851967,3575851995,28
1,505,4805,3575851967,3575852003,36
1,505,4806,3575851967,3575852006,39
1,505,4807,3575851967,3575852006,39
1,505,4808,3575851967,3575852009,42
1,505,4809,3575851967,3575852010,43
1,505,4810,3575851967,3575852011,44
1,505,4811,3575851967,3575852011,44
1,505,4812,3575851967,3575852012,45
1,505,4813,3575851967,3575852015,48
1,505,4814,3575851967,3575852016,49
1,505,4815,3575851967,3575852016,49
1,505,4816,3575851967,3575852017,50
1,506,4817,3575852020,3575852020,0
1,506,4818,3575852020,3575852020,0
1,506,4819,3575852020,3575852020,0
1,506,4820,3575852020,3575852023,3
1,506,4821,3575852020,3575852024,4
1,506,4822,3575852020,3575852024,4
1,506,4823,3575852020,3575852027,7
1,506,4824,3575852020,3575852028,8
1,506,4825,3575852020,3575852030,10
1,506,4826,3575852020,3575852031,11
1,506,4827,3575852020,3575852032,12
1,506,4828,3575852020,3575852033,13
1,506,4829,3575852020,3575852035,15
1,506,4830,3575852020,3575852038,18
1,506,4831,3575852020,3575852045,25
1,506,4832,3575852020,3575852051,31
1,506,4833,3575852020,3575852051,31
1,506,4834,3575852020,3575852051,31
1,506,4835,3575852020,3575852053,33
1,506,4836,3575852020,3575852060,40
1,506,4837,3575852020,3575852062,42
1,506,4838,3575852020,3575852068,48
1,506,4839,3575852020,3575852069,49
1,507,4840,3575852073,3575852079,6
1,507,4841,3575852073,3575852081,8
1,507,4842,3575852073,3575852083,10
1,507,4843,3575852073,3575852083,10
1,507,4844,3575852073,3575852088,15
1,507,4845,3575852073,3575852091,18
1,507,4846,3575852073,3575852091,18
1,507,4847,3575852073,3575852092,19
1,507,4848,3575852073,3575852095,22
1,507,4849,3575852073,3575852097,24
1,507,4850,3575852073,3575852103,30
1,507,4851,3575852073,3575852105,32
1,507,4852,3575852073,3575852107,34
1,507,4853,3575852073,3575852109,36
1,507,4854,3575852073,3575852112,39
1,507,4855,3575852073,3575852119,46
1,507,4856,3575852073,3575852121,48
1,508,4857,3575852126,3575852128,2
1,508,4858,3575852126,3575852129,3
1,508,4859,3575852126,3575852131,5
1,508,4860,3575852126,3575852131,5
1,508,4861,3575852126,3575852132,6
1,508,4862,3575852126,3575852133,7
1,508,4863,3575852126,3575852139,13
1,508,4864,3575852126,3575852141,15
1,508,4865,3575852126,3575852151,25
1,508,4866,3575852126,3575852153,27
1,508,4867,3575852126,3575852153,27
1,508,4868,3575852126,3575852153,27
1,508,4869,3575852126,3575852160,34
1,508,4870,3575852126,3575852163,37
1,508,4871,3575852126,3575852165,39
1,508,4872,3575852126,3575852166,40
1,508,4873,3575852126,3575852167,41
1,508,4874,3575852126,3575852169,43
1,508,4875,3575852126,3575852171,45
1,508,4876,3575852126,3575852173,47
1,508,4877,3575852126,3575852174,48
1,508,4878,3575852126,3575852175,49
1,509,4879,3575852181,3575852181,0
1,509,4880,3575852181,3575852181,0
1,509,4881,3575852181,3575852182,1
1,509,4882,3575852181,3575852187,6
1,509,4883,3575852181,3575852190,9
1,509,4884,3575852181,3575852191,10
1,509,4885,3575852181,3575852193,12
1,509,4886,3575852181,3575852194,13
1,509,4887,3575852181,3575852196,15
1,509,4888,3575852181,3575852203,22
1,509,4889,3575852181,3575852206,25
1,509,4890,3575852181,3575852207,26
1,509,4891,3575852181,3575852210,29
1,509,4892,3575852181,3575852210,29
1,509,4893,3575852181,3575852211,30
1,509,4894,3575852181,3575852212,31
1,509,4895,3575852181,3575852213,32
1,509,4896,3575852181,3575852214,33
1,509,4897,3575852181,3575852216,35
1,509,4898,3575852181,3575852216,35
1,509,4899,3575852181,3575852217,36
1,509,4900,3575852181,3575852218,37
1,509,4901,3575852181,3575852218,37
1,509,4902,3575852181,3575852220,39
1,509,4903,3575852181,3575852224,43
1,509,4904,3575852181,3575852225,44
1,509,4905,3575852181,3575852225,44
1,509,4906,3575852181,3575852227,46
1,509,4907,3575852181,3575852229,48
1,509,4908,3575852181,3575852230,49
1,510,4909,3575852235,3575852235,0
1,510,4910,3575852235,3575852235,0
1,510,4911,3575852235,3575852235,0
1,510,4912,3575852235,3575852236,1
1,510,4913,3575852235,3575852239,4
1,510,4914,3575852235,3575852245,10
1,510,4915,3575852235,3575852251,16
1,510,4916,3575852235,3575852251,16
1,510,4917,3575852235,3575852251,16
1,510,4918,3575852235,3575852254,19
1,510,4919,3575852235,3575852261,26
1,510,4920,3575852235,3575852263,28
1,510,4921,3575852235,3575852268,33
1,510,4922,3575852235,3575852268,33
1,510,4923,3575852235,3575852280,45
1,510,4924,3575852235,3575852281,46
1,510,4925,3575852235,3575852283,48
1,510,4926,3575852235,3575852283,48
1,511,4927,3575852289,3575852289,0
1,511,4928,3575852289,3575852291,2
1,511,4929,3575852289,3575852291,2
1,511,4930,3575852289,3575852293,4
1,511,4931,3575852289,3575852296,7
1,511,4932,3575852289,3575852297,8
1,511,4933,3575852289,3575852303,14
1,511,4934,3575852289,3575852305,16
1,511,4935,3575852289,3575852308,19
1,511,4936,3575852289,3575852310,21
1,511,4937,3575852289,3575852312,23
1,511,4938,3575852289,3575852319,30
1,511,4939,3575852289,3575852322,33
1,511,4940,3575852289,3575852328,39
1,511,4941,3575852289,3575852328,39
1,511,4942,3575852289,3575852331,42
1,511,4943,3575852289,3575852331,42
1,511,4944,3575852289,3575852332,43
1,511,4945,3575852289,3575852332,43
1,512,4946,3575852343,3575852343,0
1,512,4947,3575852343,3575852343,0
1,512,4948,3575852343,3575852351,8
1,512,4949,3575852343,3575852353,10
1,512,4950,3575852343,3575852354,11
1,512,4951,3575852343,3575852354,11
1,512,4952,3575852343,3575852357,14
1,512,4953,3575852343,3575852360,17
1,512,4954,3575852343,3575852363,20
1,512,4955,3575852343,3575852365,22
1,512,4956,3575852343,3575852366,23
1,512,4957,3575852343,3575852368,25
1,512,4958,3575852343,3575852370,27
1,512,4959,3575852343,3575852373,30
1,512,4960,3575852343,3575852374,31
1,512,4961,3575852343,3575852375,32
1,512,4962,3575852343,3575852375,32
1,512,4963,3575852343,3575852377,34
1,512,4964,3575852343,3575852378,35
1,512,4965,3575852343,3575852382,39
1,512,4966,3575852343,3575852387,44
1,512,4967,3575852343,3575852390,47
1,512,4968,3575852343,3575852392,49
1,513,4969,3575852396,3575852396,0
1,513,4970,3575852396,3575852396,0
1,513,4971,3575852396,3575852396,0
1,513,4972,3575852396,3575852403,7
1,513,4973,3575852396,3575852406,10
1,513,4974,3575852396,3575852407,11
1,513,4975,3575852396,3575852410,14
1,513,4976,3575852396,3575852411,15
1,513,4977,3575852396,3575852411,15
1,513,4978,3575852396,3575852412,16
1,513,4979,3575852396,3575852413,17
1,513,4980,3575852396,3575852416,20
1,513,4981,3575852396,3575852416,20
1,513,4982,3575852396,3575852417,21
1,513,4983,3575852396,3575852418,22
1,513,4984,3575852396,3575852420,24
1,513,4985,3575852396,3575852421,25
1,513,4986,3575852396,3575852424,28
1,513,4987,3575852396,3575852425,29
1,513,4988,3575852396,3575852425,29
1,513,4989,3575852396,3575852427,31
1,513,4990,3575852396,3575852428,32
1,513,4991,3575852396,3575852430,34
1,513,4992,3575852396,3575852431,35
1,513,4993,3575852396,3575852433,37
1,513,4994,3575852396,3575852434,38
1,513,4995,3575852396,3575852436,40
1,513,4996,3575852396,3575852436,40
1,513,4997,3575852396,3575852438,42
1,513,4998,3575852396,3575852444,48
1,514,4999,3575852449,3575852450,1
1,514,5000,3575852449,3575852451,2
1,514,5001,3575852449,3575852451,2
1,514,5002,3575852449,3575852453,4
1,514,5003,3575852449,3575852461,12
1,514,5004,3575852449,3575852464,15
1,514,5005,3575852449,3575852467,18
1,514,5006,3575852449,3575852468,19
1,514,5007,3575852449,3575852468,19
1,514,5008,3575852449,3575852476,27
1,514,5009,3575852449,3575852480,31
1,514,5010,3575852449,3575852481,32
1,514,5011,3575852449,3575852484,35
1,514,5012,3575852449,3575852484,35
1,514,5013,3575852449,3575852487,38
1,514,5014,3575852449,3575852488,39
1,514,5015,3575852449,3575852490,41
1,514,5016,3575852449,3575852491,42
1,514,5017,3575852449,3575852492,43
1,514,5018,3575852449,3575852496,47
1,514,5019,3575852449,3575852497,48
1,515,5020,3575852505,3575852505,0
1,515,5021,3575852505,3575852505,0
1,515,5022,3575852505,3575852507,2
1,515,5023,3575852505,3575852509,4
1,515,5024,3575852505,3575852511,6
1,515,5025,3575852505,3575852518,13
1,515,5026,3575852505,3575852521,16
1,515,5027,3575852505,3575852528,23
1,515,5028,3575852505,3575852528,23
1,515,5029,3575852505,3575852530,25
1,515,5030,3575852505,3575852530,25
1,515,5031,3575852505,3575852531,26
1,515,5032,3575852505,3575852531,26
1,515,5033,3575852505,3575852539,34
1,515,5034,3575852505,3575852541,36
1,515,5035,3575852505,3575852549,44
1,515,5036,3575852505,3575852553,48
1,515,5037,3575852505,3575852553,48
1,515,5038,3575852505,3575852553,48
1,516,5039,3575852558,3575852558,0
1,516,5040,3575852558,3575852559,1
1,516,5041,3575852558,3575852563,5
1,516,5042,3575852558,3575852565,7
1,516,5043,3575852558,3575852565,7
1,516,5044,3575852558,3575852567,9
1,516,5045,3575852558,3575852568,10
1,516,5046,3575852558,3575852572,14
1,516,5047,3575852558,3575852574,16
1,516,5048,3575852558,3575852574,16
1,516,5049,3575852558,3575852574,16
1,516,5050,3575852558,3575852576,18
1,516,5051,3575852558,3575852576,18
1,516,5052,3575852558,3575852582,24
1,516,5053,3575852558,3575852587,29
1,516,5054,3575852558,3575852589,31
1,516,5055,3575852558,3575852591,33
1,516,5056,3575852558,3575852591,33
1,516,5057,3575852558,3575852594,36
1,516,5058,3575852558,3575852596,38
1,516,5059,3575852558,3575852603,45
1,516,5060,3575852558,3575852605,47
1,516,5061,3575852558,3575852606,48
1,517,5062,3575852611,3575852611,0
1,517,5063,3575852611,3575852611,0
1,517,5064,3575852611,3575852611,0
1,517,5065,3575852611,3575852612,1
1,517,5066,3575852611,3575852612,1
1,517,5067,3575852611,3575852614,3
1,517,5068,3575852611,3575852615,4
1,517,5069,3575852611,3575852616,5
1,517,5070,3575852611,3575852618,7
1,517,5071,3575852611,3575852618,7
1,517,5072,3575852611,3575852618,7
1,517,5073,3575852611,3575852624,13
1,517,5074,3575852611,3575852624,13
1,517,5075,3575852611,3575852625,14
1,517,5076,3575852611,3575852627,16
1,517,5077,3575852611,3575852628,17
1,517,5078,3575852611,3575852629,18
1,517,5079,3575852611,3575852632,21
1,517,5080,3575852611,3575852633,22
1,517,5081,3575852611,3575852634,23
1,517,5082,3575852611,3575852635,24
1,517,5083,3575852611,3575852639,28
1,517,5084,3575852611,3575852644,33
1,517,5085,3575852611,3575852650,39
1,517,5086,3575852611,3575852650,39
1,517,5087,3575852611,3575852651,40
1,517,5088,3575852611,3575852653,42
1,517,5089,3575852611,3575852660,49
1,518,5090,3575852664,3575852664,0
1,518,5091,3575852664,3575852666,2
1,518,5092,3575852664,3575852667,3
1,518,5093,3575852664,3575852668,4
1,518,5094,3575852664,3575852677,13
1,518,5095,3575852664,3575852680,16
1,518,5096,3575852664,3575852681,17
1,518,5097,3575852664,3575852684,20
1,518,5098,3575852664,3575852684,20
1,518,5099,3575852664,3575852684,20
1,518,5100,3575852664,3575852687,23
1,518,5101,3575852664,3575852688,24
1,518,5102,3575852664,3575852691,27
1,518,5103,3575852664,3575852692,28
1,518,5104,3575852664,3575852695,31
1,518,5105,3575852664,3575852697,33
1,518,5106,3575852664,3575852701,37
1,518,5107,3575852664,3575852703,39
1,518,5108,3575852664,3575852707,43
1,518,5109,3575852664,3575852708,44
1,518,5110,3575852664,3575852711,47
1,519,5111,3575852717,3575852718,1
1,519,5112,3575852717,3575852722,5
1,519,5113,3575852717,3575852727,10
1,519,5114,3575852717,3575852729,12
1,519,5115,3575852717,3575852730,13
1,519,5116,3575852717,3575852730,13
1,519,5117,3575852717,3575852731,14
1,519,5118,3575852717,3575852732,15
1,519,5119,3575852717,3575852732,15
1,519,5120,3575852717,3575852739,22
1,519,5121,3575852717,3575852742,25
1,519,5122,3575852717,3575852750,33
1,519,5123,3575852717,3575852753,36
1,519,5124,3575852717,3575852753,36
1,519,5125,3575852717,3575852756,39
1,519,5126,3575852717,3575852760,43
1,519,5127,3575852717,3575852763,46
1,519,5128,3575852717,3575852765,48
1,519,5129,3575852717,3575852765,48
1,519,5130,3575852717,3575852767,50
1,520,5131,3575852771,3575852771,0
1,520,5132,3575852771,3575852771,0
1,520,5133,3575852771,3575852773,2
1,520,5134,3575852771,3575852774,3
1,520,5135,3575852771,3575852775,4
1,520,5136,3575852771,3575852777,6
1,520,5137,3575852771,3575852778,7
1,520,5138,3575852771,3575852781,10
1,520,5139,3575852771,3575852787,16
1,520,5140,3575852771,3575852789,18
1,520,5141,3575852771,3575852791,20
1,520,5142,3575852771,3575852792,21
1,520,5143,3575852771,3575852793,22
1,520,5144,3575852771,3575852803,32
1,520,5145,3575852771,3575852805,34
1,520,5146,3575852771,3575852806,35
1,520,5147,3575852771,3575852810,39
1,520,5148,3575852771,3575852810,39
1,520,5149,3575852771,3575852810,39
1,520,5150,3575852771,3575852812,41
1,520,5151,3575852771,3575852813,42
1,520,5152,3575852771,3575852815,44
1,520,5153,3575852771,3575852816,45
1,520,5154,3575852771,3575852816,45
1,520,5155,3575852771,3575852818,47
1,520,5156,3575852771,3575852818,47
1,520,5157,3575852771,3575852818,47
1,521,5158,3575852825,3575852825,0
1,521,5159,3575852825,3575852825,0
1,521,5160,3575852825,3575852825,0
1,521,5161,3575852825,3575852826,1
1,521,5162,3575852825,3575852829,4
1,521,5163,3575852825,3575852830,5
1,521,5164,3575852825,3575852832,7
1,521,5165,3575852825,3575852833,8
1,521,5166,3575852825,3575852834,9
1,521,5167,3575852825,3575852835,10
1,521,5168,3575852825,3575852838,13
1,521,5169,3575852825,3575852844,19
1,521,5170,3575852825,3575852849,24
1,521,5171,3575852825,3575852850,25
1,521,5172,3575852825,3575852851,26
1,521,5173,3575852825,3575852854,29
1,521,5174,3575852825,3575852860,35
1,521,5175,3575852825,3575852863,38
1,521,5176,3575852825,3575852866,41
1,521,5177,3575852825,3575852868,43
1,521,5178,3575852825,3575852868,43
1,522,5179,3575852880,3575852880,0
1,522,5180,3575852880,3575852880,0
1,522,5181,3575852880,3575852881,1
1,522,5182,3575852880,3575852883,3
1,522,5183,3575852880,3575852883,3
1,522,5184,3575852880,3575852884,4
1,522,5185,3575852880,3575852886,6
1,522,5186,3575852880,3575852888,8
1,522,5187,3575852880,3575852891,11
1,522,5188,3575852880,3575852892,12
1,522,5189,3575852880,3575852893,13
1,522,5190,3575852880,3575852896,16
1,522,5191,3575852880,3575852896,16
1,522,5192,3575852880,3575852902,22
1,522,5193,3575852880,3575852905,25
1,522,5194,3575852880,3575852908,28
1,522,5195,3575852880,3575852909,29
1,522,5196,3575852880,3575852911,31
1,522,5197,3575852880,3575852919,39
1,522,5198,3575852880,3575852922,42
1,522,5199,3575852880,3575852927,47
1,523,5200,3575852934,3575852934,0
1,523,5201,3575852934,3575852934,0
1,523,5202,3575852934,3575852934,0
1,523,5203,3575852934,3575852934,0
1,523,5204,3575852934,3575852934,0
1,523,5205,3575852934,3575852939,5
1,523,5206,3575852934,3575852942,8
1,523,5207,3575852934,3575852950,16
1,523,5208,3575852934,3575852953,19
1,523,5209,3575852934,3575852954,20
1,523,5210,3575852934,3575852956,22
1,523,5211,3575852934,3575852959,25
1,523,5212,3575852934,3575852963,29
1,523,5213,3575852934,3575852965,31
1,523,5214,3575852934,3575852965,31
1,523,5215,3575852934,3575852967,33
1,523,5216,3575852934,3575852970,36
1,523,5217,3575852934,3575852972,38
1,523,5218,3575852934,3575852974,40
1,523,5219,3575852934,3575852974,40
1,523,5220,3575852934,3575852975,41
1,523,5221,3575852934,3575852977,43
1,523,5222,3575852934,3575852978,44
1,523,5223,3575852934,3575852982,48
1,524,5224,3575852987,3575852987,0
1,524,5225,3575852987,3575852989,2
1,524,5226,3575852987,3575852991,4
1,524,5227,3575852987,3575852993,6
1,524,5228,3575852987,3575852993,6
1,524,5229,3575852987,3575852994,7
1,524,5230,3575852987,3575853002,15
1,524,5231,3575852987,3575853006,19
1,524,5232,3575852987,3575853006,19
1,524,5233,3575852987,3575853010,23
1,524,5234,3575852987,3575853011,24
1,524,5235,3575852987,3575853011,24
1,524,5236,3575852987,3575853012,25
1,524,5237,3575852987,3575853014,27
1,524,5238,3575852987,3575853015,28
1,524,5239,3575852987,3575853015,28
1,524,5240,3575852987,3575853016,29
1,524,5241,3575852987,3575853018,31
1,524,5242,3575852987,3575853018,31
1,524,5243,3575852987,3575853019,32
1,524,5244,3575852987,3575853024,37
1,524,5245,3575852987,3575853024,37
1,524,5246,3575852987,3575853025,38
1,524,5247,3575852987,3575853028,41
1,524,5248,3575852987,3575853032,45
1,524,5249,3575852987,3575853032,45
1,524,5250,3575852987,3575853033,46
1,524,5251,3575852987,3575853034,47
1,524,5252,3575852987,3575853036,49
1,525,5253,3575853041,3575853041,0
1,525,5254,3575853041,3575853045,4
1,525,5255,3575853041,3575853049,8
1,525,5256,3575853041,3575853050,9
1,525,5257,3575853041,3575853051,10
1,525,5258,3575853041,3575853055,14
1,525,5259,3575853041,3575853060,19
1,525,5260,3575853041,3575853063,22
1,525,5261,3575853041,3575853066,25
1,525,5262,3575853041,3575853067,26
1,525,5263,3575853041,3575853068,27
1,525,5264,3575853041,3575853077,36
1,525,5265,3575853041,3575853080,39
1,525,5266,3575853041,3575853082,41
1,525,5267,3575853041,3575853083,42
1,525,5268,3575853041,3575853083,42
1,525,5269,3575853041,3575853084,43
1,525,5270,3575853041,3575853086,45
1,525,5271,3575853041,3575853088,47
1,526,5272,3575853095,3575853095,0
1,526,5273,3575853095,3575853095,0
1,526,5274,3575853095,3575853096,1
1,526,5275,3575853095,3575853097,2
1,526,5276,3575853095,3575853102,7
1,526,5277,3575853095,3575853105,10
1,526,5278,3575853095,3575853107,12
1,526,5279,3575853095,3575853109,14
1,526,5280,3575853095,3575853111,16
1,526,5281,3575853095,3575853119,24
1,526,5282,3575853095,3575853122,27
1,526,5283,3575853095,3575853131,36
1,526,5284,3575853095,3575853131,36
1,526,5285,3575853095,3575853132,37
1,526,5286,3575853095,3575853132,37
1,526,5287,3575853095,3575853134,39
1,526,5288,3575853095,3575853140,45
1,526,5289,3575853095,3575853142,47
1,527,5290,3575853149,3575853151,2
1,527,5291,3575853149,3575853153,4
1,527,5292,3575853149,3575853155,6
1,527,5293,3575853149,3575853156,7
1,527,5294,3575853149,3575853160,11
1,527,5295,3575853149,3575853163,14
1,527,5296,3575853149,3575853165,16
1,527,5297,3575853149,3575853165,16
1,527,5298,3575853149,3575853168,19
1,527,5299,3575853149,3575853170,21
1,527,5300,3575853149,3575853172,23
1,527,5301,3575853149,3575853174,25
1,527,5302,3575853149,3575853174,25
1,527,5303,3575853149,3575853175,26
1,527,5304,3575853149,3575853178,29
1,527,5305,3575853149,3575853182,33
1,527,5306,3575853149,3575853187,38
1,527,5307,3575853149,3575853190,41
1,527,5308,3575853149,3575853191,42
1,527,5309,3575853149,3575853193,44
1,527,5310,3575853149,3575853194,45
1,527,5311,3575853149,3575853194,45
1,527,5312,3575853149,3575853197,48
1,528,5313,3575853204,3575853204,0
1,528,5314,3575853204,3575853206,2
1,528,5315,3575853204,3575853206,2
1,528,5316,3575853204,3575853210,6
1,528,5317,3575853204,3575853211,7
1,528,5318,3575853204,3575853211,7
1,528,5319,3575853204,3575853212,8
1,528,5320,3575853204,3575853212,8
1,528,5321,3575853204,3575853214,10
1,528,5322,3575853204,3575853216,12
1,528,5323,3575853204,3575853216,12
1,528,5324,3575853204,3575853216,12
1,528,5325,3575853204,3575853218,14
1,528,5326,3575853204,3575853218,14
1,528,5327,3575853204,3575853219,15
1,528,5328,3575853204,3575853224,20
1,528,5329,3575853204,3575853225,21
1,528,5330,3575853204,3575853225,21
1,528,5331,3575853204,3575853226,22
1,528,5332,3575853204,3575853228,24
1,528,5333,3575853204,3575853232,28
1,528,5334,3575853204,3575853232,28
1,528,5335,3575853204,3575853234,30
1,528,5336,3575853204,3575853235,31
1,528,5337,3575853204,3575853236,32
1,528,5338,3575853204,3575853239,35
1,528,5339,3575853204,3575853244,40
1,528,5340,3575853204,3575853249,45
1,528,5341,3575853204,3575853251,47
1,528,5342,3575853204,3575853251,47
1,529,5343,3575853258,3575853258,0
1,529,5344,3575853258,3575853260,2
1,529,5345,3575853258,3575853263,5
1,529,5346,3575853258,3575853266,8
1,529,5347,3575853258,3575853268,10
1,529,5348,3575853258,3575853268,10
1,529,5349,3575853258,3575853277,19
1,529,5350,3575853258,3575853280,22
1,529,5351,3575853258,3575853282,24
1,529,5352,3575853258,3575853283,25
1,529,5353,3575853258,3575853284,26
1,529,5354,3575853258,3575853284,26
1,529,5355,3575853258,3575853286,28
1,529,5356,3575853258,3575853288,30
1,529,5357,3575853258,3575853291,33
1,529,5358,3575853258,3575853292,34
1,529,5359,3575853258,3575853296,38
1,529,5360,3575853258,3575853296,38
1,529,5361,3575853258,3575853297,39
1,529,5362,3575853258,3575853302,44
1,529,5363,3575853258,3575853305,47
1,529,5364,3575853258,3575853307,49
1,530,5365,3575853312,3575853312,0
1,530,5366,3575853312,3575853312,0
1,530,5367,3575853312,3575853319,7
1,530,5368,3575853312,3575853322,10
1,530,5369,3575853312,3575853328,16
1,530,5370,3575853312,3575853331,19
1,530,5371,3575853312,3575853331,19
1,530,5372,3575853312,3575853332,20
1,530,5373,3575853312,3575853332,20
1,530,5374,3575853312,3575853333,21
1,530,5375,3575853312,3575853339,27
1,530,5376,3575853312,3575853342,30
1,530,5377,3575853312,3575853351,39
1,530,5378,3575853312,3575853353,41
1,530,5379,3575853312,3575853355,43
1,530,5380,3575853312,3575853357,45
1,530,5381,3575853312,3575853361,49
1,531,5382,3575853367,3575853367,0
1,531,5383,3575853367,3575853367,0
1,531,5384,3575853367,3575853367,0
1,531,5385,3575853367,3575853367,0
1,531,5386,3575853367,3575853370,3
1,531,5387,3575853367,3575853373,6
1,531,5388,3575853367,3575853374,7
1,531,5389,3575853367,3575853375,8
1,531,5390,3575853367,3575853375,8
1,531,5391,3575853367,3575853378,11
1,531,5392,3575853367,3575853387,20
1,531,5393,3575853367,3575853391,24
1,531,5394,3575853367,3575853391,24
1,531,5395,3575853367,3575853393,26
1,531,5396,3575853367,3575853394,27
1,531,5397,3575853367,3575853394,27
1,531,5398,3575853367,3575853397,30
1,531,5399,3575853367,3575853406,39
1,531,5400,3575853367,3575853408,41
1,531,5401,3575853367,3575853410,43
1,531,5402,3575853367,3575853411,44
1,531,5403,3575853367,3575853411,44
1,531,5404,3575853367,3575853412,45
1,531,5405,3575853367,3575853413,46
1,531,5406,3575853367,3575853414,47
1,531,5407,3575853367,3575853416,49
1,531,5408,3575853367,3575853416,49
1,531,5409,3575853367,3575853416,49
1,532,5410,3575853422,3575853422,0
1,532,5411,3575853422,3575853422,0
1,532,5412,3575853422,3575853424,2
1,532,5413,3575853422,3575853424,2
1,532,5414,3575853422,3575853425,3
1,532,5415,3575853422,3575853426,4
1,532,5416,3575853422,3575853428,6
1,532,5417,3575853422,3575853432,10
1,532,5418,3575853422,3575853432,10
1,532,5419,3575853422,3575853434,12
1,532,5420,3575853422,3575853435,13
1,532,5421,3575853422,3575853436,14
1,532,5422,3575853422,3575853439,17
1,532,5423,3575853422,3575853445,23
1,532,5424,3575853422,3575853450,28
1,532,5425,3575853422,3575853451,29
1,532,5426,3575853422,3575853451,29
1,532,5427,3575853422,3575853454,32
1,532,5428,3575853422,3575853460,38
1,532,5429,3575853422,3575853464,42
1,532,5430,3575853422,3575853465,43
1,532,5431,3575853422,3575853468,46
1,532,5432,3575853422,3575853468,46
1,533,5433,3575853476,3575853476,0
1,533,5434,3575853476,3575853479,3
1,533,5435,3575853476,3575853481,5
1,533,5436,3575853476,3575853482,6
1,533,5437,3575853476,3575853483,7
1,533,5438,3575853476,3575853483,7
1,533,5439,3575853476,3575853485,9
1,533,5440,3575853476,3575853487,11
1,533,5441,3575853476,3575853490,14
1,533,5442,3575853476,3575853491,15
1,533,5443,3575853476,3575853495,19
1,533,5444,3575853476,3575853496,20
1,533,5445,3575853476,3575853497,21
1,533,5446,3575853476,3575853501,25
1,533,5447,3575853476,3575853505,29
1,533,5448,3575853476,3575853506,30
1,533,5449,3575853476,3575853509,33
1,533,5450,3575853476,3575853511,35
1,533,5451,3575853476,3575853517,41
1,533,5452,3575853476,3575853521,45
1,534,5453,3575853530,3575853530,0
1,534,5454,3575853530,3575853530,0
1,534,5455,3575853530,3575853530,0
1,534,5456,3575853530,3575853531,1
1,534,5457,3575853530,3575853531,1
1,534,5458,3575853530,3575853531,1
1,534,5459,3575853530,3575853533,3
1,534,5460,3575853530,3575853539,9
1,534,5461,3575853530,3575853542,12
1,534,5462,3575853530,3575853549,19
1,534,5463,3575853530,3575853552,22
1,534,5464,3575853530,3575853554,24
1,534,5465,3575853530,3575853556,26
1,534,5466,3575853530,3575853561,31
1,534,5467,3575853530,3575853562,32
1,534,5468,3575853530,3575853564,34
1,534,5469,3575853530,3575853565,35
1,534,5470,3575853530,3575853568,38
1,534,5471,3575853530,3575853569,39
1,534,5472,3575853530,3575853572,42
1,534,5473,3575853530,3575853574,44
1,534,5474,3575853530,3575853574,44
1,534,5475,3575853530,3575853574,44
1,534,5476,3575853530,3575853576,46
1,535,5477,3575853584,3575853587,3
1,535,5478,3575853584,3575853589,5
1,535,5479,3575853584,3575853591,7
1,535,5480,3575853584,3575853592,8
1,535,5481,3575853584,3575853592,8
1,535,5482,3575853584,3575853592,8
1,535,5483,3575853584,3575853596,12
1,535,5484,3575853584,3575853605,21
1,535,5485,3575853584,3575853607,23
1,535,5486,3575853584,3575853609,25
1,535,5487,3575853584,3575853610,26
1,535,5488,3575853584,3575853612,28
1,535,5489,3575853584,3575853613,29
1,535,5490,3575853584,3575853613,29
1,535,5491,3575853584,3575853615,31
1,535,5492,3575853584,3575853615,31
1,535,5493,3575853584,3575853618,34
1,535,5494,3575853584,3575853618,34
1,535,5495,3575853584,3575853624,40
1,535,5496,3575853584,3575853624,40
1,535,5497,3575853584,3575853625,41
1,535,5498,3575853584,3575853625,41
1,535,5499,3575853584,3575853627,43
1,535,5500,3575853584,3575853629,45
1,535,5501,3575853584,3575853631,47
1,535,5502,3575853584,3575853633,49
1,535,5503,3575853584,3575853634,50
1,536,5504,3575853637,3575853637,0
1,536,5505,3575853637,3575853639,2
1,536,5506,3575853637,3575853644,7
1,536,5507,3575853637,3575853649,12
1,536,5508,3575853637,3575853650,13
1,536,5509,3575853637,3575853651,14
1,536,5510,3575853637,3575853654,17
1,536,5511,3575853637,3575853660,23
1,536,5512,3575853637,3575853662,25
1,536,5513,3575853637,3575853665,28
1,536,5514,3575853637,3575853666,29
1,536,5515,3575853637,3575853668,31
1,536,5516,3575853637,3575853676,39
1,536,5517,3575853637,3575853679,42
1,536,5518,3575853637,3575853681,44
1,536,5519,3575853637,3575853682,45
1,536,5520,3575853637,3575853683,46
1,536,5521,3575853637,3575853685,48
1,537,5522,3575853691,3575853691,0
1,537,5523,3575853691,3575853691,0
1,537,5524,3575853691,3575853691,0
1,537,5525,3575853691,3575853691,0
1,537,5526,3575853691,3575853695,4
1,537,5527,3575853691,3575853695,4
1,537,5528,3575853691,3575853698,7
1,537,5529,3575853691,3575853700,9
1,537,5530,3575853691,3575853705,14
1,537,5531,3575853691,3575853706,15
1,537,5532,3575853691,3575853706,15
1,537,5533,3575853691,3575853709,18
1,537,5534,3575853691,3575853718,27
1,537,5535,3575853691,3575853722,31
1,537,5536,3575853691,3575853728,37
1,537,5537,3575853691,3575853728,37
1,537,5538,3575853691,3575853731,40
1,537,5539,3575853691,3575853731,40
1,537,5540,3575853691,3575853731,40
1,537,5541,3575853691,3575853731,40
1,537,5542,3575853691,3575853733,42
1,537,5543,3575853691,3575853739,48
1,538,5544,3575853744,3575853745,1
1,538,5545,3575853744,3575853749,5
1,538,5546,3575853744,3575853753,9
1,538,5547,3575853744,3575853754,10
1,538,5548,3575853744,3575853756,12
1,538,5549,3575853744,3575853762,18
1,538,5550,3575853744,3575853762,18
1,538,5551,3575853744,3575853765,21
1,538,5552,3575853744,3575853765,21
1,538,5553,3575853744,3575853767,23
1,538,5554,3575853744,3575853768,24
1,538,5555,3575853744,3575853773,29
1,538,5556,3575853744,3575853773,29
1,538,5557,3575853744,3575853774,30
1,538,5558,3575853744,3575853775,31
1,538,5559,3575853744,3575853777,33
1,538,5560,3575853744,3575853781,37
1,538,5561,3575853744,3575853787,43
1,538,5562,3575853744,3575853789,45
1,538,5563,3575853744,3575853791,47
1,538,5564,3575853744,3575853792,48
1,538,5565,3575853744,3575853792,48
1,538,5566,3575853744,3575853792,48
1,539,5567,3575853798,3575853798,0
1,539,5568,3575853798,3575853801,3
1,539,5569,3575853798,3575853805,7
1,539,5570,3575853798,3575853807,9
1,539,5571,3575853798,3575853807,9
1,539,5572,3575853798,3575853809,11
1,539,5573,3575853798,3575853810,12
1,539,5574,3575853798,3575853813,15
1,539,5575,3575853798,3575853813,15
1,539,5576,3575853798,3575853813,15
1,539,5577,3575853798,3575853815,17
1,539,5578,3575853798,3575853816,18
1,539,5579,3575853798,3575853816,18
1,539,5580,3575853798,3575853818,20
1,539,5581,3575853798,3575853818,20
1,539,5582,3575853798,3575853819,21
1,539,5583,3575853798,3575853824,26
1,539,5584,3575853798,3575853824,26
1,539,5585,3575853798,3575853825,27
1,539,5586,3575853798,3575853825,27
1,539,5587,3575853798,3575853828,30
1,539,5588,3575853798,3575853831,33
1,539,5589,3575853798,3575853831,33
1,539,5590,3575853798,3575853831,33
1,539,5591,3575853798,3575853833,35
1,539,5592,3575853798,3575853834,36
1,539,5593,3575853798,3575853835,37
1,539,5594,3575853798,3575853840,42
1,539,5595,3575853798,3575853844,46
1,540,5596,3575853852,3575853852,0
1,540,5597,3575853852,3575853852,0
1,540,5598,3575853852,3575853853,1
1,540,5599,3575853852,3575853857,5
1,540,5600,3575853852,3575853859,7
1,540,5601,3575853852,3575853862,10
1,540,5602,3575853852,3575853864,12
1,540,5603,3575853852,3575853867,15
1,540,5604,3575853852,3575853868,16
1,540,5605,3575853852,3575853876,24
1,540,5606,3575853852,3575853879,27
1,540,5607,3575853852,3575853881,29
1,540,5608,3575853852,3575853883,31
1,540,5609,3575853852,3575853883,31
1,540,5610,3575853852,3575853887,35
1,540,5611,3575853852,3575853890,38
1,540,5612,3575853852,3575853891,39
1,540,5613,3575853852,3575853892,40
1,540,5614,3575853852,3575853894,42
1,540,5615,3575853852,3575853895,43
1,540,5616,3575853852,3575853897,45
1,540,5617,3575853852,3575853900,48
1,541,5618,3575853906,3575853906,0
1,541,5619,3575853906,3575853906,0
1,541,5620,3575853906,3575853906,0
1,541,5621,3575853906,3575853910,4
1,541,5622,3575853906,3575853919,13
1,541,5623,3575853906,3575853922,16
1,541,5624,3575853906,3575853929,23
1,541,5625,3575853906,3575853929,23
1,541,5626,3575853906,3575853931,25
1,541,5627,3575853906,3575853931,25
1,541,5628,3575853906,3575853931,25
1,541,5629,3575853906,3575853931,25
1,541,5630,3575853906,3575853933,27
1,541,5631,3575853906,3575853938,32
1,541,5632,3575853906,3575853943,37
1,541,5633,3575853906,3575853949,43
1,541,5634,3575853906,3575853953,47
1,541,5635,3575853906,3575853954,48
1,541,5636,3575853906,3575853956,50
1,542,5637,3575853960,3575853962,2
1,542,5638,3575853960,3575853962,2
1,542,5639,3575853960,3575853965,5
1,542,5640,3575853960,3575853965,5
1,542,5641,3575853960,3575853967,7
1,542,5642,3575853960,3575853969,9
1,542,5643,3575853960,3575853969,9
1,542,5644,3575853960,3575853973,13
1,542,5645,3575853960,3575853973,13
1,542,5646,3575853960,3575853974,14
1,542,5647,3575853960,3575853974,14
1,542,5648,3575853960,3575853978,18
1,542,5649,3575853960,3575853981,21
1,542,5650,3575853960,3575853987,27
1,542,5651,3575853960,3575853989,29
1,542,5652,3575853960,3575853992,32
1,542,5653,3575853960,3575853993,33
1,542,5654,3575853960,3575853996,36
1,542,5655,3575853960,3575854001,41
1,542,5656,3575853960,3575854006,46
1,542,5657,3575853960,3575854007,47
1,542,5658,3575853960,3575854007,47
1,542,5659,3575853960,3575854009,49
1,542,5660,3575853960,3575854009,49
1,542,5661,3575853960,3575854010,50
1,543,5662,3575854014,3575854014,0
1,543,5663,3575854014,3575854014,0
1,543,5664,3575854014,3575854014,0
1,543,5665,3575854014,3575854014,0
1,543,5666,3575854014,3575854015,1
1,543,5667,3575854014,3575854016,2
1,543,5668,3575854014,3575854016,2
1,543,5669,3575854014,3575854018,4
1,543,5670,3575854014,3575854018,4
1,543,5671,3575854014,3575854019,5
1,543,5672,3575854014,3575854024,10
1,543,5673,3575854014,3575854024,10
1,543,5674,3575854014,3575854025,11
1,543,5675,3575854014,3575854029,15
1,543,5676,3575854014,3575854031,17
1,543,5677,3575854014,3575854031,17
1,543,5678,3575854014,3575854032,18
1,543,5679,3575854014,3575854033,19
1,543,5680,3575854014,3575854034,20
1,543,5681,3575854014,3575854041,27
1,543,5682,3575854014,3575854045,31
1,543,5683,3575854014,3575854049,35
1,543,5684,3575854014,3575854049,35
1,543,5685,3575854014,3575854054,40
1,543,5686,3575854014,3575854058,44
1,543,5687,3575854014,3575854060,46
1,543,5688,3575854014,3575854062,48
1,544,5689,3575854069,3575854069,0
1,544,5690,3575854069,3575854069,0
1,544,5691,3575854069,3575854069,0
1,544,5692,3575854069,3575854076,7
1,544,5693,3575854069,3575854080,11
1,544,5694,3575854069,3575854081,12
1,544,5695,3575854069,3575854082,13
1,544,5696,3575854069,3575854083,14
1,544,5697,3575854069,3575854083,14
1,544,5698,3575854069,3575854085,16
1,544,5699,3575854069,3575854087,18
1,544,5700,3575854069,3575854090,21
1,544,5701,3575854069,3575854090,21
1,544,5702,3575854069,3575854092,23
1,544,5703,3575854069,3575854094,25
1,544,5704,3575854069,3575854096,27
1,544,5705,3575854069,3575854098,29
1,544,5706,3575854069,3575854101,32
1,544,5707,3575854069,3575854105,36
1,544,5708,3575854069,3575854106,37
1,544,5709,3575854069,3575854107,38
1,544,5710,3575854069,3575854111,42
1,544,5711,3575854069,3575854111,42
1,544,5712,3575854069,3575854119,50
1,545,5713,3575854123,3575854123,0
1,545,5714,3575854123,3575854129,6
1,545,5715,3575854123,3575854130,7
1,545,5716,3575854123,3575854131,8
1,545,5717,3575854123,3575854131,8
1,545,5718,3575854123,3575854131,8
1,545,5719,3575854123,3575854133,10
1,545,5720,3575854123,3575854140,17
1,545,5721,3575854123,3575854143,20
1,545,5722,3575854123,3575854150,27
1,545,5723,3575854123,3575854153,30
1,545,5724,3575854123,3575854154,31
1,545,5725,3575854123,3575854156,33
1,545,5726,3575854123,3575854161,38
1,545,5727,3575854123,3575854163,40
1,545,5728,3575854123,3575854165,42
1,545,5729,3575854123,3575854165,42
1,545,5730,3575854123,3575854168,45
1,545,5731,3575854123,3575854168,45
1,545,5732,3575854123,3575854170,47
1,546,5733,3575854177,3575854177,0
1,546,5734,3575854177,3575854177,0
1,546,5735,3575854177,3575854177,0
1,546,5736,3575854177,3575854177,0
1,546,5737,3575854177,3575854178,1
1,546,5738,3575854177,3575854181,4
1,546,5739,3575854177,3575854187,10
1,546,5740,3575854177,3575854190,13
1,546,5741,3575854177,3575854192,15
1,546,5742,3575854177,3575854192,15
1,546,5743,3575854177,3575854196,19
1,546,5744,3575854177,3575854201,24
1,546,5745,3575854177,3575854206,29
1,546,5746,3575854177,3575854207,30
1,546,5747,3575854177,3575854207,30
1,546,5748,3575854177,3575854210,33
1,546,5749,3575854177,3575854210,33
1,546,5750,3575854177,3575854210,33
1,546,5751,3575854177,3575854211,34
1,546,5752,3575854177,3575854213,36
1,546,5753,3575854177,3575854213,36
1,546,5754,3575854177,3575854215,38
1,546,5755,3575854177,3575854215,38
1,546,5756,3575854177,3575854216,39
1,546,5757,3575854177,3575854216,39
1,546,5758,3575854177,3575854219,42
1,546,5759,3575854177,3575854219,42
1,546,5760,3575854177,3575854219,42
1,546,5761,3575854177,3575854224,47
1,546,5762,3575854177,3575854224,47
1,546,5763,3575854177,3575854225,48
1,547,5764,3575854234,3575854234,0
1,547,5765,3575854234,3575854234,0
1,547,5766,3575854234,3575854234,0
1,547,5767,3575854234,3575854234,0
1,547,5768,3575854234,3575854235,1
1,547,5769,3575854234,3575854235,1
1,547,5770,3575854234,3575854241,7
1,547,5771,3575854234,3575854245,11
1,547,5772,3575854234,3575854249,15
1,547,5773,3575854234,3575854251,17
1,547,5774,3575854234,3575854253,19
1,547,5775,3575854234,3575854257,23
1,547,5776,3575854234,3575854260,26
1,547,5777,3575854234,3575854263,29
1,547,5778,3575854234,3575854265,31
1,547,5779,3575854234,3575854267,33
1,547,5780,3575854234,3575854276,42
1,547,5781,3575854234,3575854280,46
1,547,5782,3575854234,3575854281,47
1,547,5783,3575854234,3575854283,49
1,547,5784,3575854234,3575854283,49
1,547,5785,3575854234,3575854283,49
1,548,5786,3575854288,3575854288,0
1,548,5787,3575854288,3575854288,0
1,548,5788,3575854288,3575854289,1
1,548,5789,3575854288,3575854291,3
1,548,5790,3575854288,3575854292,4
1,548,5791,3575854288,3575854295,7
1,548,5792,3575854288,3575854298,10
1,548,5793,3575854288,3575854300,12
1,548,5794,3575854288,3575854306,18
1,548,5795,3575854288,3575854306,18
1,548,5796,3575854288,3575854307,19
1,548,5797,3575854288,3575854310,22
1,548,5798,3575854288,3575854311,23
1,548,5799,3575854288,3575854311,23
1,548,5800,3575854288,3575854319,31
1,548,5801,3575854288,3575854322,34
1,548,5802,3575854288,3575854329,41
1,548,5803,3575854288,3575854331,43
1,548,5804,3575854288,3575854331,43
1,548,5805,3575854288,3575854332,44
1,548,5806,3575854288,3575854333,45
1,549,5807,3575854342,3575854342,0
1,549,5808,3575854342,3575854343,1
1,549,5809,3575854342,3575854349,7
1,549,5810,3575854342,3575854353,11
1,549,5811,3575854342,3575854354,12
1,549,5812,3575854342,3575854357,15
1,549,5813,3575854342,3575854362,20
1,549,5814,3575854342,3575854363,21
1,549,5815,3575854342,3575854364,22
1,549,5816,3575854342,3575854365,23
1,549,5817,3575854342,3575854366,24
1,549,5818,3575854342,3575854367,25
1,549,5819,3575854342,3575854368,26
1,549,5820,3575854342,3575854369,27
1,549,5821,3575854342,3575854373,31
1,549,5822,3575854342,3575854374,32
1,549,5823,3575854342,3575854375,33
1,549,5824,3575854342,3575854377,35
1,549,5825,3575854342,3575854378,36
1,549,5826,3575854342,3575854381,39
1,549,5827,3575854342,3575854387,45
1,549,5828,3575854342,3575854390,48
1,550,5829,3575854396,3575854396,0
1,550,5830,3575854396,3575854396,0
1,550,5831,3575854396,3575854396,0
1,550,5832,3575854396,3575854397,1
1,550,5833,3575854396,3575854402,6
1,550,5834,3575854396,3575854407,11
1,550,5835,3575854396,3575854407,11
1,550,5836,3575854396,3575854407,11
1,550,5837,3575854396,3575854409,13
1,550,5838,3575854396,3575854410,14
1,550,5839,3575854396,3575854411,15
1,550,5840,3575854396,3575854411,15
1,550,5841,3575854396,3575854413,17
1,550,5842,3575854396,3575854413,17
1,550,5843,3575854396,3575854415,19
1,550,5844,3575854396,3575854416,20
1,550,5845,3575854396,3575854416,20
1,550,5846,3575854396,3575854416,20
1,550,5847,3575854396,3575854419,23
1,550,5848,3575854396,3575854419,23
1,550,5849,3575854396,3575854419,23
1,550,5850,3575854396,3575854425,29
1,550,5851,3575854396,3575854425,29
1,550,5852,3575854396,3575854426,30
1,550,5853,3575854396,3575854431,35
1,550,5854,3575854396,3575854431,35
1,550,5855,3575854396,3575854432,36
1,550,5856,3575854396,3575854434,38
1,550,5857,3575854396,3575854435,39
1,550,5858,3575854396,3575854436,40
1,550,5859,3575854396,3575854441,45
1,551,5860,3575854450,3575854450,0
1,551,5861,3575854450,3575854451,1
1,551,5862,3575854450,3575854451,1
1,551,5863,3575854450,3575854453,3
1,551,5864,3575854450,3575854457,7
1,551,5865,3575854450,3575854461,11
1,551,5866,3575854450,3575854464,14
1,551,5867,3575854450,3575854465,15
1,551,5868,3575854450,3575854467,17
1,551,5869,3575854450,3575854469,19
1,551,5870,3575854450,3575854476,26
1,551,5871,3575854450,3575854480,30
1,551,5872,3575854450,3575854481,31
1,551,5873,3575854450,3575854483,33
1,551,5874,3575854450,3575854483,33
1,551,5875,3575854450,3575854483,33
1,551,5876,3575854450,3575854486,36
1,551,5877,3575854450,3575854487,37
1,551,5878,3575854450,3575854490,40
1,551,5879,3575854450,3575854491,41
1,551,5880,3575854450,3575854492,42
1,551,5881,3575854450,3575854494,44
1,551,5882,3575854450,3575854498,48
1,552,5883,3575854504,3575854504,0
1,552,5884,3575854504,3575854505,1
1,552,5885,3575854504,3575854505,1
1,552,5886,3575854504,3575854506,2
1,552,5887,3575854504,3575854510,6
1,552,5888,3575854504,3575854510,6
1,552,5889,3575854504,3575854511,7
1,552,5890,3575854504,3575854518,14
1,552,5891,3575854504,3575854521,17
1,552,5892,3575854504,3575854528,24
1,552,5893,3575854504,3575854530,26
1,552,5894,3575854504,3575854530,26
1,552,5895,3575854504,3575854531,27
1,552,5896,3575854504,3575854531,27
1,552,5897,3575854504,3575854531,27
1,552,5898,3575854504,3575854542,38
1,552,5899,3575854504,3575854550,46
1,552,5900,3575854504,3575854552,48
1,552,5901,3575854504,3575854553,49
1,553,5902,3575854558,3575854558,0
1,553,5903,3575854558,3575854560,2
1,553,5904,3575854558,3575854562,4
1,553,5905,3575854558,3575854564,6
1,553,5906,3575854558,3575854564,6
1,553,5907,3575854558,3575854565,7
1,553,5908,3575854558,3575854567,9
1,553,5909,3575854558,3575854568,10
1,553,5910,3575854558,3575854568,10
1,553,5911,3575854558,3575854573,15
1,553,5912,3575854558,3575854574,16
1,553,5913,3575854558,3575854575,17
1,553,5914,3575854558,3575854575,17
1,553,5915,3575854558,3575854577,19
1,553,5916,3575854558,3575854580,22
1,553,5917,3575854558,3575854587,29
1,553,5918,3575854558,3575854589,31
1,553,5919,3575854558,3575854591,33
1,553,5920,3575854558,3575854592,34
1,553,5921,3575854558,3575854592,34
1,553,5922,3575854558,3575854593,35
1,553,5923,3575854558,3575854596,38
1,553,5924,3575854558,3575854601,43
1,553,5925,3575854558,3575854606,48
1,553,5926,3575854558,3575854606,48
1,553,5927,3575854558,3575854607,49
1,554,5928,3575854611,3575854611,0
1,554,5929,3575854611,3575854611,0
1,554,5930,3575854611,3575854611,0
1,554,5931,3575854611,3575854611,0
1,554,5932,3575854611,3575854612,1
1,554,5933,3575854611,3575854613,2
1,554,5934,3575854611,3575854615,4
1,554,5935,3575854611,3575854615,4
1,554,5936,3575854611,3575854615,4
1,554,5937,3575854611,3575854616,5
1,554,5938,3575854611,3575854618,7
1,554,5939,3575854611,3575854618,7
1,554,5940,3575854611,3575854618,7
1,554,5941,3575854611,3575854619,8
1,554,5942,3575854611,3575854624,13
1,554,5943,3575854611,3575854624,13
1,554,5944,3575854611,3575854625,14
1,554,5945,3575854611,3575854628,17
1,554,5946,3575854611,3575854630,19
1,554,5947,3575854611,3575854630,19
1,554,5948,3575854611,3575854630,19
1,554,5949,3575854611,3575854633,22
1,554,5950,3575854611,3575854633,22
1,554,5951,3575854611,3575854635,24
1,554,5952,3575854611,3575854640,29
1,554,5953,3575854611,3575854644,33
1,554,5954,3575854611,3575854649,38
1,554,5955,3575854611,3575854650,39
1,554,5956,3575854611,3575854651,40
1,554,5957,3575854611,3575854653,42
1,554,5958,3575854611,3575854657,46
1,554,5959,3575854611,3575854660,49
1,555,5960,3575854665,3575854665,0
1,555,5961,3575854665,3575854665,0
1,555,5962,3575854665,3575854667,2
1,555,5963,3575854665,3575854667,2
1,555,5964,3575854665,3575854676,11
1,555,5965,3575854665,3575854680,15
1,555,5966,3575854665,3575854681,16
1,555,5967,3575854665,3575854682,17
1,555,5968,3575854665,3575854683,18
1,555,5969,3575854665,3575854683,18
1,555,5970,3575854665,3575854685,20
1,555,5971,3575854665,3575854687,22
1,555,5972,3575854665,3575854689,24
1,555,5973,3575854665,3575854690,25
1,555,5974,3575854665,3575854695,30
1,555,5975,3575854665,3575854696,31
1,555,5976,3575854665,3575854698,33
1,555,5977,3575854665,3575854701,36
1,555,5978,3575854665,3575854704,39
1,555,5979,3575854665,3575854705,40
1,555,5980,3575854665,3575854707,42
1,555,5981,3575854665,3575854709,44
1,555,5982,3575854665,3575854710,45
1,555,5983,3575854665,3575854712,47
1,556,5984,3575854719,3575854719,0
1,556,5985,3575854719,3575854721,2
1,556,5986,3575854719,3575854728,9
1,556,5987,3575854719,3575854729,10
1,556,5988,3575854719,3575854730,11
1,556,5989,3575854719,3575854731,12
1,556,5990,3575854719,3575854731,12
1,556,5991,3575854719,3575854731,12
1,556,5992,3575854719,3575854732,13
1,556,5993,3575854719,3575854743,24
1,556,5994,3575854719,3575854753,34
1,556,5995,3575854719,3575854753,34
1,556,5996,3575854719,3575854758,39
1,556,5997,3575854719,3575854761,42
1,556,5998,3575854719,3575854762,43
1,556,5999,3575854719,3575854764,45
1,556,6000,3575854719,3575854765,46
1,556,6001,3575854719,3575854765,46
1,556,6002,3575854719,3575854768,49
1,556,6003,3575854719,3575854768,49
1,556,6004,3575854719,3575854768,49
1,557,6005,3575854773,3575854773,0
1,557,6006,3575854773,3575854774,1
1,557,6007,3575854773,3575854775,2
1,557,6008,3575854773,3575854775,2
1,557,6009,3575854773,3575854777,4
1,557,6010,3575854773,3575854782,9
1,557,6011,3575854773,3575854788,15
1,557,6012,3575854773,3575854790,17
1,557,6013,3575854773,3575854792,19
1,557,6014,3575854773,3575854793,20
1,557,6015,3575854773,3575854793,20
1,557,6016,3575854773,3575854794,21
1,557,6017,3575854773,3575854796,23
1,557,6018,3575854773,3575854801,28
1,557,6019,3575854773,3575854806,33
1,557,6020,3575854773,3575854807,34
1,557,6021,3575854773,3575854808,35
1,557,6022,3575854773,3575854809,36
1,557,6023,3575854773,3575854809,36
1,557,6024,3575854773,3575854810,37
1,557,6025,3575854773,3575854810,37
1,557,6026,3575854773,3575854812,39
1,557,6027,3575854773,3575854812,39
1,557,6028,3575854773,3575854814,41
1,557,6029,3575854773,3575854815,42
1,557,6030,3575854773,3575854816,43
1,557,6031,3575854773,3575854816,43
1,557,6032,3575854773,3575854818,45
1,557,6033,3575854773,3575854818,45
1,557,6034,3575854773,3575854818,45
1,558,6035,3575854828,3575854828,0
1,558,6036,3575854828,3575854828,0
1,558,6037,3575854828,3575854828,0
1,558,6038,3575854828,3575854830,2
1,558,6039,3575854828,3575854830,2
1,558,6040,3575854828,3575854831,3
1,558,6041,3575854828,3575854833,5
1,558,6042,3575854828,3575854834,6
1,558,6043,3575854828,3575854835,7
1,558,6044,3575854828,3575854840,12
1,558,6045,3575854828,3575854844,16
1,558,6046,3575854828,3575854849,21
1,558,6047,3575854828,3575854850,22
1,558,6048,3575854828,3575854851,23
1,558,6049,3575854828,3575854853,25
1,558,6050,3575854828,3575854856,28
1,558,6051,3575854828,3575854859,31
1,558,6052,3575854828,3575854863,35
1,558,6053,3575854828,3575854864,36
1,558,6054,3575854828,3575854867,39
1,558,6055,3575854828,3575854868,40
1,558,6056,3575854828,3575854876,48
1,559,6057,3575854882,3575854882,0
1,559,6058,3575854882,3575854882,0
1,559,6059,3575854882,3575854882,0
1,559,6060,3575854882,3575854883,1
1,559,6061,3575854882,3575854883,1
1,559,6062,3575854882,3575854885,3
1,559,6063,3575854882,3575854887,5
1,559,6064,3575854882,3575854889,7
1,559,6065,3575854882,3575854889,7
1,559,6066,3575854882,3575854890,8
1,559,6067,3575854882,3575854895,13
1,559,6068,3575854882,3575854897,15
1,559,6069,3575854882,3575854898,16
1,559,6070,3575854882,3575854901,19
1,559,6071,3575854882,3575854904,22
1,559,6072,3575854882,3575854905,23
1,559,6073,3575854882,3575854908,26
1,559,6074,3575854882,3575854910,28
1,559,6075,3575854882,3575854911,29
1,559,6076,3575854882,3575854918,36
1,559,6077,3575854882,3575854921,39
1,559,6078,3575854882,3575854929,47
1,559,6079,3575854882,3575854929,47
1,559,6080,3575854882,3575854931,49
1,559,6081,3575854882,3575854931,49
1,559,6082,3575854882,3575854931,49
1,559,6083,3575854882,3575854931,49
1,559,6084,3575854882,3575854931,49
1,560,6085,3575854936,3575854939,3
1,560,6086,3575854936,3575854942,6
1,560,6087,3575854936,3575854950,14
1,560,6088,3575854936,3575854953,17
1,560,6089,3575854936,3575854954,18
1,560,6090,3575854936,3575854958,22
1,560,6091,3575854936,3575854961,25
1,560,6092,3575854936,3575854962,26
1,560,6093,3575854936,3575854964,28
1,560,6094,3575854936,3575854965,29
1,560,6095,3575854936,3575854965,29
1,560,6096,3575854936,3575854967,31
1,560,6097,3575854936,3575854968,32
1,560,6098,3575854936,3575854970,34
1,560,6099,3575854936,3575854973,37
1,560,6100,3575854936,3575854975,39
1,560,6101,3575854936,3575854976,40
1,560,6102,3575854936,3575854978,42
1,560,6103,3575854936,3575854981,45
1,561,6104,3575854990,3575854990,0
1,561,6105,3575854990,3575854990,0
1,561,6106,3575854990,3575854992,2
1,561,6107,3575854990,3575854993,3
1,561,6108,3575854990,3575854993,3
1,561,6109,3575854990,3575854995,5
1,561,6110,3575854990,3575854996,6
1,561,6111,3575854990,3575855002,12
1,561,6112,3575854990,3575855006,16
1,561,6113,3575854990,3575855008,18
1,561,6114,3575854990,3575855009,19
1,561,6115,3575854990,3575855010,20
1,561,6116,3575854990,3575855010,20
1,561,6117,3575854990,3575855011,21
1,561,6118,3575854990,3575855012,22
1,561,6119,3575854990,3575855012,22
1,561,6120,3575854990,3575855015,25
1,561,6121,3575854990,3575855015,25
1,561,6122,3575854990,3575855016,26
1,561,6123,3575854990,3575855018,28
1,561,6124,3575854990,3575855018,28
1,561,6125,3575854990,3575855019,29
1,561,6126,3575854990,3575855019,29
1,561,6127,3575854990,3575855024,34
1,561,6128,3575854990,3575855024,34
1,561,6129,3575854990,3575855025,35
1,561,6130,3575854990,3575855025,35
1,561,6131,3575854990,3575855029,39
1,561,6132,3575854990,3575855031,41
1,561,6133,3575854990,3575855031,41
1,561,6134,3575854990,3575855033,43
1,561,6135,3575854990,3575855033,43
1,561,6136,3575854990,3575855035,45
1,561,6137,3575854990,3575855040,50
1,562,6138,3575855044,3575855044,0
1,562,6139,3575855044,3575855050,6
1,562,6140,3575855044,3575855050,6
1,562,6141,3575855044,3575855051,7
1,562,6142,3575855044,3575855054,10
1,562,6143,3575855044,3575855057,13
1,562,6144,3575855044,3575855059,15
1,562,6145,3575855044,3575855062,18
1,562,6146,3575855044,3575855063,19
1,562,6147,3575855044,3575855064,20
1,562,6148,3575855044,3575855066,22
1,562,6149,3575855044,3575855068,24
1,562,6150,3575855044,3575855075,31
1,562,6151,3575855044,3575855079,35
1,562,6152,3575855044,3575855081,37
1,562,6153,3575855044,3575855082,38
1,562,6154,3575855044,3575855082,38
1,562,6155,3575855044,3575855083,39
1,562,6156,3575855044,3575855085,41
1,562,6157,3575855044,3575855087,43
1,562,6158,3575855044,3575855089,45
1,562,6159,3575855044,3575855090,46
1,562,6160,3575855044,3575855093,49
1,563,6161,3575855100,3575855100,0
1,563,6162,3575855100,3575855100,0
1,563,6163,3575855100,3575855101,1
1,563,6164,3575855100,3575855105,5
1,563,6165,3575855100,3575855107,7
1,563,6166,3575855100,3575855110,10
1,563,6167,3575855100,3575855112,12
1,563,6168,3575855100,3575855119,19
1,563,6169,3575855100,3575855121,21
1,563,6170,3575855100,3575855128,28
1,563,6171,3575855100,3575855129,29
1,563,6172,3575855100,3575855130,30
1,563,6173,3575855100,3575855131,31
1,563,6174,3575855100,3575855132,32
1,563,6175,3575855100,3575855132,32
1,563,6176,3575855100,3575855132,32
1,563,6177,3575855100,3575855140,40
1,563,6178,3575855100,3575855142,42
1,563,6179,3575855100,3575855150,50
1,564,6180,3575855154,3575855154,0
1,564,6181,3575855154,3575855154,0
1,564,6182,3575855154,3575855158,4
1,564,6183,3575855154,3575855161,7
1,564,6184,3575855154,3575855163,9
1,564,6185,3575855154,3575855163,9
1,564,6186,3575855154,3575855165,11
1,564,6187,3575855154,3575855166,12
1,564,6188,3575855154,3575855167,13
1,564,6189,3575855154,3575855168,14
1,564,6190,3575855154,3575855171,17
1,564,6191,3575855154,3575855173,19
1,564,6192,3575855154,3575855174,20
1,564,6193,3575855154,3575855175,21
1,564,6194,3575855154,3575855177,23
1,564,6195,3575855154,3575855177,23
1,564,6196,3575855154,3575855177,23
1,564,6197,3575855154,3575855181,27
1,564,6198,3575855154,3575855188,34
1,564,6199,3575855154,3575855190,36
1,564,6200,3575855154,3575855192,38
1,564,6201,3575855154,3575855193,39
1,564,6202,3575855154,3575855194,40
1,564,6203,3575855154,3575855195,41
1,564,6204,3575855154,3575855197,43
1,564,6205,3575855154,3575855202,48
1,565,6206,3575855208,3575855208,0
1,565,6207,3575855208,3575855208,0
1,565,6208,3575855208,3575855209,1
1,565,6209,3575855208,3575855209,1
1,565,6210,3575855208,3575855210,2
1,565,6211,3575855208,3575855210,2
1,565,6212,3575855208,3575855211,3
1,565,6213,3575855208,3575855211,3
1,565,6214,3575855208,3575855212,4
1,565,6215,3575855208,3575855215,7
1,565,6216,3575855208,3575855216,8
1,565,6217,3575855208,3575855216,8
1,565,6218,3575855208,3575855216,8
1,565,6219,3575855208,3575855217,9
1,565,6220,3575855208,3575855218,10
1,565,6221,3575855208,3575855218,10
1,565,6222,3575855208,3575855219,11
1,565,6223,3575855208,3575855224,16
1,565,6224,3575855208,3575855224,16
1,565,6225,3575855208,3575855225,17
1,565,6226,3575855208,3575855226,18
1,565,6227,3575855208,3575855230,22
1,565,6228,3575855208,3575855231,23
1,565,6229,3575855208,3575855232,24
1,565,6230,3575855208,3575855234,26
1,565,6231,3575855208,3575855235,27
1,565,6232,3575855208,3575855235,27
1,565,6233,3575855208,3575855240,32
1,565,6234,3575855208,3575855244,36
1,565,6235,3575855208,3575855249,41
1,565,6236,3575855208,3575855251,43
1,565,6237,3575855208,3575855251,43
1,565,6238,3575855208,3575855254,46
1,565,6239,3575855208,3575855256,48
1,566,6240,3575855262,3575855262,0
1,566,6241,3575855262,3575855263,1
1,566,6242,3575855262,3575855263,1
1,566,6243,3575855262,3575855264,2
1,566,6244,3575855262,3575855266,4
1,566,6245,3575855262,3575855268,6
1,566,6246,3575855262,3575855276,14
1,566,6247,3575855262,3575855280,18
1,566,6248,3575855262,3575855281,19
1,566,6249,3575855262,3575855282,20
1,566,6250,3575855262,3575855282,20
1,566,6251,3575855262,3575855283,21
1,566,6252,3575855262,3575855287,25
1,566,6253,3575855262,3575855289,27
1,566,6254,3575855262,3575855289,27
1,566,6255,3575855262,3575855291,29
1,566,6256,3575855262,3575855293,31
1,566,6257,3575855262,3575855295,33
1,566,6258,3575855262,3575855298,36
1,566,6259,3575855262,3575855301,39
1,566,6260,3575855262,3575855304,42
1,566,6261,3575855262,3575855305,43
1,566,6262,3575855262,3575855307,45
1,566,6263,3575855262,3575855310,48
1,566,6264,3575855262,3575855311,49
1,567,6265,3575855316,3575855319,3
1,567,6266,3575855316,3575855322,6
1,567,6267,3575855316,3575855328,12
1,567,6268,3575855316,3575855329,13
1,567,6269,3575855316,3575855330,14
1,567,6270,3575855316,3575855330,14
1,567,6271,3575855316,3575855331,15
1,567,6272,3575855316,3575855331,15
1,567,6273,3575855316,3575855332,16
1,567,6274,3575855316,3575855333,17
1,567,6275,3575855316,3575855340,24
1,567,6276,3575855316,3575855350,34
1,567,6277,3575855316,3575855354,38
1,567,6278,3575855316,3575855354,38
1,567,6279,3575855316,3575855358,42
1,567,6280,3575855316,3575855360,44
1,567,6281,3575855316,3575855363,47
1,567,6282,3575855316,3575855364,48
1,567,6283,3575855316,3575855365,49
1,568,6284,3575855370,3575855370,0
1,568,6285,3575855370,3575855370,0
1,568,6286,3575855370,3575855370,0
1,568,6287,3575855370,3575855371,1
1,568,6288,3575855370,3575855373,3
1,568,6289,3575855370,3575855374,4
1,568,6290,3575855370,3575855375,5
1,568,6291,3575855370,3575855377,7
1,568,6292,3575855370,3575855377,7
1,568,6293,3575855370,3575855377,7
1,568,6294,3575855370,3575855382,12
1,568,6295,3575855370,3575855388,18
1,568,6296,3575855370,3575855390,20
1,568,6297,3575855370,3575855393,23
1,568,6298,3575855370,3575855393,23
1,568,6299,3575855370,3575855394,24
1,568,6300,3575855370,3575855395,25
1,568,6301,3575855370,3575855397,27
1,568,6302,3575855370,3575855409,39
1,568,6303,3575855370,3575855410,40
1,568,6304,3575855370,3575855410,40
1,568,6305,3575855370,3575855411,41
1,568,6306,3575855370,3575855411,41
1,568,6307,3575855370,3575855413,43
1,568,6308,3575855370,3575855413,43
1,568,6309,3575855370,3575855415,45
1,568,6310,3575855370,3575855416,46
1,568,6311,3575855370,3575855416,46
1,568,6312,3575855370,3575855417,47
1,568,6313,3575855370,3575855418,48
1,568,6314,3575855370,3575855418,48
1,568,6315,3575855370,3575855419,49
1,568,6316,3575855370,3575855419,49
1,569,6317,3575855426,3575855426,0
1,569,6318,3575855426,3575855426,0
1,569,6319,3575855426,3575855426,0
1,569,6320,3575855426,3575855426,0
1,569,6321,3575855426,3575855429,3
1,569,6322,3575855426,3575855430,4
1,569,6323,3575855426,3575855431,5
1,569,6324,3575855426,3575855433,7
1,569,6325,3575855426,3575855434,8
1,569,6326,3575855426,3575855435,9
1,569,6327,3575855426,3575855436,10
1,569,6328,3575855426,3575855441,15
1,569,6329,3575855426,3575855445,19
1,569,6330,3575855426,3575855449,23
1,569,6331,3575855426,3575855451,25
1,569,6332,3575855426,3575855453,27
1,569,6333,3575855426,3575855456,30
1,569,6334,3575855426,3575855460,34
1,569,6335,3575855426,3575855463,37
1,569,6336,3575855426,3575855464,38
1,569,6337,3575855426,3575855464,38
1,569,6338,3575855426,3575855466,40
1,569,6339,3575855426,3575855468,42
1,570,6340,3575855480,3575855480,0
1,570,6341,3575855480,3575855480,0
1,570,6342,3575855480,3575855481,1
1,570,6343,3575855480,3575855481,1
1,570,6344,3575855480,3575855481,1
1,570,6345,3575855480,3575855482,2
1,570,6346,3575855480,3575855486,6
1,570,6347,3575855480,3575855487,7
1,570,6348,3575855480,3575855489,9
1,570,6349,3575855480,3575855493,13
1,570,6350,3575855480,3575855494,14
1,570,6351,3575855480,3575855498,18
1,570,6352,3575855480,3575855501,21
1,570,6353,3575855480,3575855504,24
1,570,6354,3575855480,3575855507,27
1,570,6355,3575855480,3575855509,29
1,570,6356,3575855480,3575855511,31
1,570,6357,3575855480,3575855518,38
1,570,6358,3575855480,3575855521,41
1,570,6359,3575855480,3575855527,47
1,570,6360,3575855480,3575855527,47
1,570,6361,3575855480,3575855529,49
1,570,6362,3575855480,3575855529,49
1,570,6363,3575855480,3575855530,50
1,571,6364,3575855534,3575855534,0
1,571,6365,3575855534,3575855534,0
1,571,6366,3575855534,3575855534,0
1,571,6367,3575855534,3575855539,5
1,571,6368,3575855534,3575855542,8
1,571,6369,3575855534,3575855550,16
1,571,6370,3575855534,3575855552,18
1,571,6371,3575855534,3575855554,20
1,571,6372,3575855534,3575855557,23
1,571,6373,3575855534,3575855559,25
1,571,6374,3575855534,3575855562,28
1,571,6375,3575855534,3575855562,28
1,571,6376,3575855534,3575855564,30
1,571,6377,3575855534,3575855565,31
1,571,6378,3575855534,3575855567,33
1,571,6379,3575855534,3575855568,34
1,571,6380,3575855534,3575855570,36
1,571,6381,3575855534,3575855572,38
1,571,6382,3575855534,3575855574,40
1,571,6383,3575855534,3575855574,40
1,571,6384,3575855534,3575855575,41
1,571,6385,3575855534,3575855576,42
1,571,6386,3575855534,3575855577,43
1,571,6387,3575855534,3575855581,47
1,571,6388,3575855534,3575855582,48
1,572,6389,3575855589,3575855589,0
1,572,6390,3575855589,3575855590,1
1,572,6391,3575855589,3575855592,3
1,572,6392,3575855589,3575855592,3
1,572,6393,3575855589,3575855593,4
1,572,6394,3575855589,3575855594,5
1,572,6395,3575855589,3575855596,7
1,572,6396,3575855589,3575855607,18
1,572,6397,3575855589,3575855609,20
1,572,6398,3575855589,3575855609,20
1,572,6399,3575855589,3575855610,21
1,572,6400,3575855589,3575855610,21
1,572,6401,3575855589,3575855612,23
1,572,6402,3575855589,3575855613,24
1,572,6403,3575855589,3575855614,25
1,572,6404,3575855589,3575855615,26
1,572,6405,3575855589,3575855616,27
1,572,6406,3575855589,3575855616,27
1,572,6407,3575855589,3575855616,27
1,572,6408,3575855589,3575855618,29
1,572,6409,3575855589,3575855618,29
1,572,6410,3575855589,3575855623,34
1,572,6411,3575855589,3575855624,35
1,572,6412,3575855589,3575855624,35
1,572,6413,3575855589,3575855625,36
1,572,6414,3575855589,3575855628,39
1,572,6415,3575855589,3575855630,41
1,572,6416,3575855589,3575855632,43
1,572,6417,3575855589,3575855633,44
1,572,6418,3575855589,3575855633,44
1,572,6419,3575855589,3575855635,46
1,573,6420,3575855643,3575855643,0
1,573,6421,3575855643,3575855645,2
1,573,6422,3575855643,3575855649,6
1,573,6423,3575855643,3575855650,7
1,573,6424,3575855643,3575855651,8
1,573,6425,3575855643,3575855653,10
1,573,6426,3575855643,3575855655,12
1,573,6427,3575855643,3575855659,16
1,573,6428,3575855643,3575855662,19
1,573,6429,3575855643,3575855663,20
1,573,6430,3575855643,3575855663,20
1,573,6431,3575855643,3575855666,23
1,573,6432,3575855643,3575855668,25
1,573,6433,3575855643,3575855679,36
1,573,6434,3575855643,3575855681,38
1,573,6435,3575855643,3575855681,38
1,573,6436,3575855643,3575855682,39
1,573,6437,3575855643,3575855682,39
1,573,6438,3575855643,3575855684,41
1,573,6439,3575855643,3575855686,43
1,573,6440,3575855643,3575855688,45
1,573,6441,3575855643,3575855692,49
1,574,6442,3575855696,3575855696,0
1,574,6443,3575855696,3575855698,2
1,574,6444,3575855696,3575855698,2
1,574,6445,3575855696,3575855701,5
1,574,6446,3575855696,3575855704,8
1,574,6447,3575855696,3575855704,8
1,574,6448,3575855696,3575855706,10
1,574,6449,3575855696,3575855709,13
1,574,6450,3575855696,3575855711,15
1,574,6451,3575855696,3575855718,22
1,574,6452,3575855696,3575855721,25
1,574,6453,3575855696,3575855727,31
1,574,6454,3575855696,3575855728,32
1,574,6455,3575855696,3575855729,33
1,574,6456,3575855696,3575855729,33
1,574,6457,3575855696,3575855731,35
1,574,6458,3575855696,3575855732,36
1,574,6459,3575855696,3575855732,36
1,574,6460,3575855696,3575855738,42
1,574,6461,3575855696,3575855741,45
1,575,6462,3575855751,3575855751,0
1,575,6463,3575855751,3575855754,3
1,575,6464,3575855751,3575855757,6
1,575,6465,3575855751,3575855760,9
1,575,6466,3575855751,3575855762,11
1,575,6467,3575855751,3575855763,12
1,575,6468,3575855751,3575855764,13
1,575,6469,3575855751,3575855765,14
1,575,6470,3575855751,3575855767,16
1,575,6471,3575855751,3575855767,16
1,575,6472,3575855751,3575855770,19
1,575,6473,3575855751,3575855772,21
1,575,6474,3575855751,3575855774,23
1,575,6475,3575855751,3575855774,23
1,575,6476,3575855751,3575855775,24
1,575,6477,3575855751,3575855776,25
1,575,6478,3575855751,3575855777,26
1,575,6479,3575855751,3575855781,30
1,575,6480,3575855751,3575855782,31
1,575,6481,3575855751,3575855786,35
1,575,6482,3575855751,3575855787,36
1,575,6483,3575855751,3575855791,40
1,575,6484,3575855751,3575855792,41
1,575,6485,3575855751,3575855793,42
1,575,6486,3575855751,3575855794,43
1,575,6487,3575855751,3575855797,46
1,576,6488,3575855805,3575855805,0
1,576,6489,3575855805,3575855808,3
1,576,6490,3575855805,3575855809,4
1,576,6491,3575855805,3575855809,4
1,576,6492,3575855805,3575855810,5
1,576,6493,3575855805,3575855810,5
1,576,6494,3575855805,3575855812,7
1,576,6495,3575855805,3575855813,8
1,576,6496,3575855805,3575855815,10
1,576,6497,3575855805,3575855815,10
1,576,6498,3575855805,3575855816,11
1,576,6499,3575855805,3575855816,11
1,576,6500,3575855805,3575855817,12
1,576,6501,3575855805,3575855817,12
1,576,6502,3575855805,3575855818,13
1,576,6503,3575855805,3575855824,19
1,576,6504,3575855805,3575855824,19
1,576,6505,3575855805,3575855825,20
1,576,6506,3575855805,3575855828,23
1,576,6507,3575855805,3575855832,27
1,576,6508,3575855805,3575855833,28
1,576,6509,3575855805,3575855834,29
1,576,6510,3575855805,3575855835,30
1,576,6511,3575855805,3575855842,37
1,576,6512,3575855805,3575855845,40
1,576,6513,3575855805,3575855849,44
1,576,6514,3575855805,3575855850,45
1,576,6515,3575855805,3575855851,46
1,576,6516,3575855805,3575855854,49
1,576,6517,3575855805,3575855855,50
1,577,6518,3575855860,3575855860,0
1,577,6519,3575855860,3575855863,3
1,577,6520,3575855860,3575855863,3
1,577,6521,3575855860,3575855864,4
1,577,6522,3575855860,3575855865,5
1,577,6523,3575855860,3575855868,8
1,577,6524,3575855860,3575855879,19
1,577,6525,3575855860,3575855879,19
1,577,6526,3575855860,3575855881,21
1,577,6527,3575855860,3575855881,21
1,577,6528,3575855860,3575855881,21
1,577,6529,3575855860,3575855882,22
1,577,6530,3575855860,3575855884,24
1,577,6531,3575855860,3575855886,26
1,577,6532,3575855860,3575855888,28
1,577,6533,3575855860,3575855889,29
1,577,6534,3575855860,3575855891,31
1,577,6535,3575855860,3575855893,33
1,577,6536,3575855860,3575855895,35
1,577,6537,3575855860,3575855898,38
1,577,6538,3575855860,3575855898,38
1,577,6539,3575855860,3575855901,41
1,577,6540,3575855860,3575855905,45
1,577,6541,3575855860,3575855905,45
1,577,6542,3575855860,3575855906,46
1,578,6543,3575855915,3575855915,0
1,578,6544,3575855915,3575855918,3
1,578,6545,3575855915,3575855921,6
1,578,6546,3575855915,3575855928,13
1,578,6547,3575855915,3575855929,14
1,578,6548,3575855915,3575855930,15
1,578,6549,3575855915,3575855931,16
1,578,6550,3575855915,3575855931,16
1,578,6551,3575855915,3575855931,16
1,578,6552,3575855915,3575855931,16
1,578,6553,3575855915,3575855932,17
1,578,6554,3575855915,3575855933,18
1,578,6555,3575855915,3575855939,24
1,578,6556,3575855915,3575855941,26
1,578,6557,3575855915,3575855950,35
1,578,6558,3575855915,3575855954,39
1,578,6559,3575855915,3575855955,40
1,578,6560,3575855915,3575855956,41
1,578,6561,3575855915,3575855960,45
1,578,6562,3575855915,3575855962,47
1,578,6563,3575855915,3575855963,48
1,578,6564,3575855915,3575855965,50
1,579,6565,3575855970,3575855970,0
1,579,6566,3575855970,3575855970,0
1,579,6567,3575855970,3575855970,0
1,579,6568,3575855970,3575855970,0
1,579,6569,3575855970,3575855972,2
1,579,6570,3575855970,3575855974,4
1,579,6571,3575855970,3575855974,4
1,579,6572,3575855970,3575855975,5
1,579,6573,3575855970,3575855976,6
1,579,6574,3575855970,3575855977,7
1,579,6575,3575855970,3575855982,12
1,579,6576,3575855970,3575855982,12
1,579,6577,3575855970,3575855987,17
1,579,6578,3575855970,3575855987,17
1,579,6579,3575855970,3575855991,21
1,579,6580,3575855970,3575855992,22
1,579,6581,3575855970,3575855993,23
1,579,6582,3575855970,3575855993,23
1,579,6583,3575855970,3575855994,24
1,579,6584,3575855970,3575856001,31
1,579,6585,3575855970,3575856006,36
1,579,6586,3575855970,3575856008,38
1,579,6587,3575855970,3575856009,39
1,579,6588,3575855970,3575856010,40
1,579,6589,3575855970,3575856010,40
1,579,6590,3575855970,3575856011,41
1,579,6591,3575855970,3575856012,42
1,579,6592,3575855970,3575856012,42
1,579,6593,3575855970,3575856015,45
1,579,6594,3575855970,3575856015,45
1,579,6595,3575855970,3575856015,45
1,579,6596,3575855970,3575856016,46
1,579,6597,3575855970,3575856017,47
1,579,6598,3575855970,3575856017,47
1,579,6599,3575855970,3575856018,48
1,579,6600,3575855970,3575856018,48
1,580,6601,3575856025,3575856025,0
1,580,6602,3575856025,3575856025,0
1,580,6603,3575856025,3575856025,0
1,580,6604,3575856025,3575856028,3
1,580,6605,3575856025,3575856031,6
1,580,6606,3575856025,3575856032,7
1,580,6607,3575856025,3575856033,8
1,580,6608,3575856025,3575856034,9
1,580,6609,3575856025,3575856035,10
1,580,6610,3575856025,3575856043,18
1,580,6611,3575856025,3575856045,20
1,580,6612,3575856025,3575856049,24
1,580,6613,3575856025,3575856050,25
1,580,6614,3575856025,3575856051,26
1,580,6615,3575856025,3575856054,29
1,580,6616,3575856025,3575856055,30
1,580,6617,3575856025,3575856060,35
1,580,6618,3575856025,3575856062,37
1,580,6619,3575856025,3575856063,38
1,580,6620,3575856025,3575856063,38
1,580,6621,3575856025,3575856067,42
1,580,6622,3575856025,3575856069,44
1,581,6623,3575856080,3575856080,0
1,581,6624,3575856080,3575856080,0
1,581,6625,3575856080,3575856081,1
1,581,6626,3575856080,3575856081,1
1,581,6627,3575856080,3575856082,2
1,581,6628,3575856080,3575856083,3
1,581,6629,3575856080,3575856084,4
1,581,6630,3575856080,3575856087,7
1,581,6631,3575856080,3575856087,7
1,581,6632,3575856080,3575856088,8
1,581,6633,3575856080,3575856090,10
1,581,6634,3575856080,3575856092,12
1,581,6635,3575856080,3575856095,15
1,581,6636,3575856080,3575856097,17
1,581,6637,3575856080,3575856101,21
1,581,6638,3575856080,3575856104,24
1,581,6639,3575856080,3575856105,25
1,581,6640,3575856080,3575856107,27
1,581,6641,3575856080,3575856109,29
1,581,6642,3575856080,3575856111,31
1,581,6643,3575856080,3575856119,39
1,581,6644,3575856080,3575856121,41
1,581,6645,3575856080,3575856129,49
1,582,6646,3575856134,3575856134,0
1,582,6647,3575856134,3575856134,0
1,582,6648,3575856134,3575856134,0
1,582,6649,3575856134,3575856134,0
1,582,6650,3575856134,3575856134,0
1,582,6651,3575856134,3575856134,0
1,582,6652,3575856134,3575856134,0
1,582,6653,3575856134,3575856142,8
1,582,6654,3575856134,3575856150,16
1,582,6655,3575856134,3575856153,19
1,582,6656,3575856134,3575856155,21
1,582,6657,3575856134,3575856157,23
1,582,6658,3575856134,3575856160,26
1,582,6659,3575856134,3575856163,29
1,582,6660,3575856134,3575856164,30
1,582,6661,3575856134,3575856165,31
1,582,6662,3575856134,3575856166,32
1,582,6663,3575856134,3575856166,32
1,582,6664,3575856134,3575856167,33
1,582,6665,3575856134,3575856168,34
1,582,6666,3575856134,3575856169,35
1,582,6667,3575856134,3575856172,38
1,582,6668,3575856134,3575856173,39
1,582,6669,3575856134,3575856174,40
1,582,6670,3575856134,3575856176,42
1,582,6671,3575856134,3575856177,43
1,582,6672,3575856134,3575856178,44
1,582,6673,3575856134,3575856181,47
1,582,6674,3575856134,3575856183,49
1,583,6675,3575856188,3575856188,0
1,583,6676,3575856188,3575856188,0
1,583,6677,3575856188,3575856192,4
1,583,6678,3575856188,3575856192,4
1,583,6679,3575856188,3575856193,5
1,583,6680,3575856188,3575856193,5
1,583,6681,3575856188,3575856193,5
1,583,6682,3575856188,3575856194,6
1,583,6683,3575856188,3575856201,13
1,583,6684,3575856188,3575856206,18
1,583,6685,3575856188,3575856209,21
1,583,6686,3575856188,3575856210,22
1,583,6687,3575856188,3575856210,22
1,583,6688,3575856188,3575856210,22
1,583,6689,3575856188,3575856211,23
1,583,6690,3575856188,3575856213,25
1,583,6691,3575856188,3575856213,25
1,583,6692,3575856188,3575856215,27
1,583,6693,3575856188,3575856215,27
1,583,6694,3575856188,3575856216,28
1,583,6695,3575856188,3575856216,28
1,583,6696,3575856188,3575856218,30
1,583,6697,3575856188,3575856218,30
1,583,6698,3575856188,3575856218,30
1,583,6699,3575856188,3575856219,31
1,583,6700,3575856188,3575856224,36
1,583,6701,3575856188,3575856224,36
1,583,6702,3575856188,3575856225,37
1,583,6703,3575856188,3575856225,37
1,583,6704,3575856188,3575856228,40
1,583,6705,3575856188,3575856230,42
1,583,6706,3575856188,3575856231,43
1,583,6707,3575856188,3575856232,44
1,583,6708,3575856188,3575856234,46
1,583,6709,3575856188,3575856235,47
1,583,6710,3575856188,3575856235,47
1,584,6711,3575856243,3575856243,0
1,584,6712,3575856243,3575856244,1
1,584,6713,3575856243,3575856249,6
1,584,6714,3575856243,3575856251,8
1,584,6715,3575856243,3575856251,8
1,584,6716,3575856243,3575856254,11
1,584,6717,3575856243,3575856255,12
1,584,6718,3575856243,3575856261,18
1,584,6719,3575856243,3575856263,20
1,584,6720,3575856243,3575856263,20
1,584,6721,3575856243,3575856264,21
1,584,6722,3575856243,3575856266,23
1,584,6723,3575856243,3575856269,26
1,584,6724,3575856243,3575856279,36
1,584,6725,3575856243,3575856279,36
1,584,6726,3575856243,3575856282,39
1,584,6727,3575856243,3575856282,39
1,584,6728,3575856243,3575856282,39
1,584,6729,3575856243,3575856283,40
1,584,6730,3575856243,3575856286,43
1,584,6731,3575856243,3575856288,45
1,584,6732,3575856243,3575856288,45
1,584,6733,3575856243,3575856291,48
1,584,6734,3575856243,3575856292,49
1,585,6735,3575856298,3575856298,0
1,585,6736,3575856298,3575856298,0
1,585,6737,3575856298,3575856298,0
1,585,6738,3575856298,3575856301,3
1,585,6739,3575856298,3575856305,7
1,585,6740,3575856298,3575856306,8
1,585,6741,3575856298,3575856307,9
1,585,6742,3575856298,3575856310,12
1,585,6743,3575856298,3575856312,14
1,585,6744,3575856298,3575856319,21
1,585,6745,3575856298,3575856322,24
1,585,6746,3575856298,3575856328,30
1,585,6747,3575856298,3575856328,30
1,585,6748,3575856298,3575856330,32
1,585,6749,3575856298,3575856330,32
1,585,6750,3575856298,3575856331,33
1,585,6751,3575856298,3575856332,34
1,585,6752,3575856298,3575856332,34
1,585,6753,3575856298,3575856333,35
1,585,6754,3575856298,3575856334,36
1,585,6755,3575856298,3575856339,41
1,585,6756,3575856298,3575856341,43
1,585,6757,3575856298,3575856345,47
1,586,6758,3575856352,3575856352,0
1,586,6759,3575856352,3575856354,2
1,586,6760,3575856352,3575856354,2
1,586,6761,3575856352,3575856356,4
1,586,6762,3575856352,3575856360,8
1,586,6763,3575856352,3575856363,11
1,586,6764,3575856352,3575856364,12
1,586,6765,3575856352,3575856365,13
1,586,6766,3575856352,3575856366,14
1,586,6767,3575856352,3575856366,14
1,586,6768,3575856352,3575856368,16
1,586,6769,3575856352,3575856368,16
1,586,6770,3575856352,3575856370,18
1,586,6771,3575856352,3575856373,21
1,586,6772,3575856352,3575856374,22
1,586,6773,3575856352,3575856375,23
1,586,6774,3575856352,3575856375,23
1,586,6775,3575856352,3575856376,24
1,586,6776,3575856352,3575856378,26
1,586,6777,3575856352,3575856381,29
1,586,6778,3575856352,3575856382,30
1,586,6779,3575856352,3575856387,35
1,586,6780,3575856352,3575856388,36
1,586,6781,3575856352,3575856392,40
1,586,6782,3575856352,3575856392,40
1,586,6783,3575856352,3575856393,41
1,586,6784,3575856352,3575856393,41
1,586,6785,3575856352,3575856393,41
1,586,6786,3575856352,3575856395,43
1,586,6787,3575856352,3575856397,45
1,586,6788,3575856352,3575856402,50
1,587,6789,3575856407,3575856407,0
1,587,6790,3575856407,3575856408,1
1,587,6791,3575856407,3575856409,2
1,587,6792,3575856407,3575856410,3
1,587,6793,3575856407,3575856411,4
1,587,6794,3575856407,3575856411,4
1,587,6795,3575856407,3575856412,5
1,587,6796,3575856407,3575856412,5
1,587,6797,3575856407,3575856415,8
1,587,6798,3575856407,3575856416,9
1,587,6799,3575856407,3575856417,10
1,587,6800,3575856407,3575856418,11
1,587,6801,3575856407,3575856418,11
1,587,6802,3575856407,3575856418,11
1,587,6803,3575856407,3575856419,12
1,587,6804,3575856407,3575856424,17
1,587,6805,3575856407,3575856424,17
1,587,6806,3575856407,3575856424,17
1,587,6807,3575856407,3575856426,19
1,587,6808,3575856407,3575856428,21
1,587,6809,3575856407,3575856431,24
1,587,6810,3575856407,3575856431,24
1,587,6811,3575856407,3575856431,24
1,587,6812,3575856407,3575856434,27
1,587,6813,3575856407,3575856434,27
1,587,6814,3575856407,3575856436,29
1,587,6815,3575856407,3575856443,36
1,587,6816,3575856407,3575856445,38
1,587,6817,3575856407,3575856450,43
1,587,6818,3575856407,3575856451,44
1,587,6819,3575856407,3575856451,44
1,587,6820,3575856407,3575856453,46
1,587,6821,3575856407,3575856456,49
1,588,6822,3575856461,3575856461,0
1,588,6823,3575856461,3575856463,2
1,588,6824,3575856461,3575856464,3
1,588,6825,3575856461,3575856465,4
1,588,6826,3575856461,3575856466,5
1,588,6827,3575856461,3575856469,8
1,588,6828,3575856461,3575856478,17
1,588,6829,3575856461,3575856478,17
1,588,6830,3575856461,3575856481,20
1,588,6831,3575856461,3575856482,21
1,588,6832,3575856461,3575856482,21
1,588,6833,3575856461,3575856487,26
1,588,6834,3575856461,3575856487,26
1,588,6835,3575856461,3575856487,26
1,588,6836,3575856461,3575856491,30
1,588,6837,3575856461,3575856492,31
1,588,6838,3575856461,3575856493,32
1,588,6839,3575856461,3575856495,34
1,588,6840,3575856461,3575856495,34
1,588,6841,3575856461,3575856501,40
1,588,6842,3575856461,3575856506,45
1,588,6843,3575856461,3575856507,46
1,588,6844,3575856461,3575856510,49
1,589,6845,3575856515,3575856515,0
1,589,6846,3575856515,3575856518,3
1,589,6847,3575856515,3575856522,7
1,589,6848,3575856515,3575856526,11
1,589,6849,3575856515,3575856527,12
1,589,6850,3575856515,3575856528,13
1,589,6851,3575856515,3575856529,14
1,589,6852,3575856515,3575856530,15
1,589,6853,3575856515,3575856530,15
1,589,6854,3575856515,3575856531,16
1,589,6855,3575856515,3575856532,17
1,589,6856,3575856515,3575856533,18
1,589,6857,3575856515,3575856539,24
1,589,6858,3575856515,3575856540,25
1,589,6859,3575856515,3575856544,29
1,589,6860,3575856515,3575856553,38
1,589,6861,3575856515,3575856554,39
1,589,6862,3575856515,3575856556,41
1,589,6863,3575856515,3575856560,45
1,589,6864,3575856515,3575856563,48
1,590,6865,3575856569,3575856569,0
1,590,6866,3575856569,3575856569,0
1,590,6867,3575856569,3575856569,0
1,590,6868,3575856569,3575856569,0
1,590,6869,3575856569,3575856569,0
1,590,6870,3575856569,3575856569,0
1,590,6871,3575856569,3575856572,3
1,590,6872,3575856569,3575856573,4
1,590,6873,3575856569,3575856574,5
1,590,6874,3575856569,3575856574,5
1,590,6875,3575856569,3575856575,6
1,590,6876,3575856569,3575856576,7
1,590,6877,3575856569,3575856581,12
1,590,6878,3575856569,3575856582,13
1,590,6879,3575856569,3575856586,17
1,590,6880,3575856569,3575856587,18
1,590,6881,3575856569,3575856591,22
1,590,6882,3575856569,3575856591,22
1,590,6883,3575856569,3575856592,23
1,590,6884,3575856569,3575856592,23
1,590,6885,3575856569,3575856593,24
1,590,6886,3575856569,3575856594,25
1,590,6887,3575856569,3575856597,28
1,590,6888,3575856569,3575856597,28
1,590,6889,3575856569,3575856602,33
1,590,6890,3575856569,3575856605,36
1,590,6891,3575856569,3575856608,39
1,590,6892,3575856569,3575856608,39
1,590,6893,3575856569,3575856609,40
1,590,6894,3575856569,3575856610,41
1,590,6895,3575856569,3575856610,41
1,590,6896,3575856569,3575856612,43
1,590,6897,3575856569,3575856612,43
1,590,6898,3575856569,3575856615,46
1,590,6899,3575856569,3575856615,46
1,590,6900,3575856569,3575856615,46
1,590,6901,3575856569,3575856618,49
1,590,6902,3575856569,3575856618,49
1,590,6903,3575856569,3575856618,49
1,590,6904,3575856569,3575856618,49
1,591,6905,3575856624,3575856624,0
1,591,6906,3575856624,3575856624,0
1,591,6907,3575856624,3575856624,0
1,591,6908,3575856624,3575856625,1
1,591,6909,3575856624,3575856627,3
1,591,6910,3575856624,3575856630,6
1,591,6911,3575856624,3575856630,6
1,591,6912,3575856624,3575856630,6
1,591,6913,3575856624,3575856633,9
1,591,6914,3575856624,3575856633,9
1,591,6915,3575856624,3575856635,11
1,591,6916,3575856624,3575856642,18
1,591,6917,3575856624,3575856644,20
1,591,6918,3575856624,3575856649,25
1,591,6919,3575856624,3575856650,26
1,591,6920,3575856624,3575856651,27
1,591,6921,3575856624,3575856653,29
1,591,6922,3575856624,3575856656,32
1,591,6923,3575856624,3575856660,36
1,591,6924,3575856624,3575856662,38
1,591,6925,3575856624,3575856663,39
1,591,6926,3575856624,3575856664,40
1,591,6927,3575856624,3575856668,44
1,592,6928,3575856679,3575856679,0
1,592,6929,3575856679,3575856679,0
1,592,6930,3575856679,3575856681,2
1,592,6931,3575856679,3575856682,3
1,592,6932,3575856679,3575856682,3
1,592,6933,3575856679,3575856686,7
1,592,6934,3575856679,3575856687,8
1,592,6935,3575856679,3575856688,9
1,592,6936,3575856679,3575856691,12
1,592,6937,3575856679,3575856692,13
1,592,6938,3575856679,3575856694,15
1,592,6939,3575856679,3575856694,15
1,592,6940,3575856679,3575856694,15
1,592,6941,3575856679,3575856698,19
1,592,6942,3575856679,3575856701,22
1,592,6943,3575856679,3575856705,26
1,592,6944,3575856679,3575856706,27
1,592,6945,3575856679,3575856707,28
1,592,6946,3575856679,3575856710,31
1,592,6947,3575856679,3575856714,35
1,592,6948,3575856679,3575856718,39
1,592,6949,3575856679,3575856722,43
1,592,6950,3575856679,3575856727,48
1,592,6951,3575856679,3575856729,50
1,593,6952,3575856733,3575856733,0
1,593,6953,3575856733,3575856733,0
1,593,6954,3575856733,3575856733,0
1,593,6955,3575856733,3575856733,0
1,593,6956,3575856733,3575856733,0
1,593,6957,3575856733,3575856733,0
1,593,6958,3575856733,3575856733,0
1,593,6959,3575856733,3575856739,6
1,593,6960,3575856733,3575856741,8
1,593,6961,3575856733,3575856744,11
1,593,6962,3575856733,3575856753,20
1,593,6963,3575856733,3575856753,20
1,593,6964,3575856733,3575856756,23
1,593,6965,3575856733,3575856760,27
1,593,6966,3575856733,3575856763,30
1,593,6967,3575856733,3575856763,30
1,593,6968,3575856733,3575856767,34
1,593,6969,3575856733,3575856767,34
1,593,6970,3575856733,3575856768,35
1,593,6971,3575856733,3575856768,35
1,593,6972,3575856733,3575856769,36
1,593,6973,3575856733,3575856769,36
1,593,6974,3575856733,3575856772,39
1,593,6975,3575856733,3575856774,41
1,593,6976,3575856733,3575856774,41
1,593,6977,3575856733,3575856775,42
1,593,6978,3575856733,3575856775,42
1,593,6979,3575856733,3575856778,45
1,593,6980,3575856733,3575856781,48
1,593,6981,3575856733,3575856782,49
1,594,6982,3575856788,3575856788,0
1,594,6983,3575856788,3575856788,0
1,594,6984,3575856788,3575856791,3
1,594,6985,3575856788,3575856792,4
1,594,6986,3575856788,3575856792,4
1,594,6987,3575856788,3575856792,4
1,594,6988,3575856788,3575856794,6
1,594,6989,3575856788,3575856797,9
1,594,6990,3575856788,3575856798,10
1,594,6991,3575856788,3575856802,14
1,594,6992,3575856788,3575856805,17
1,594,6993,3575856788,3575856807,19
1,594,6994,3575856788,3575856807,19
1,594,6995,3575856788,3575856808,20
1,594,6996,3575856788,3575856809,21
1,594,6997,3575856788,3575856810,22
1,594,6998,3575856788,3575856811,23
1,594,6999,3575856788,3575856812,24
1,594,7000,3575856788,3575856813,25
1,594,7001,3575856788,3575856815,27
1,594,7002,3575856788,3575856815,27
1,594,7003,3575856788,3575856815,27
1,594,7004,3575856788,3575856816,28
1,594,7005,3575856788,3575856817,29
1,594,7006,3575856788,3575856818,30
1,594,7007,3575856788,3575856818,30
1,594,7008,3575856788,3575856818,30
1,594,7009,3575856788,3575856823,35
1,594,7010,3575856788,3575856823,35
1,594,7011,3575856788,3575856825,37
1,594,7012,3575856788,3575856825,37
1,594,7013,3575856788,3575856829,41
1,594,7014,3575856788,3575856830,42
1,594,7015,3575856788,3575856831,43
1,594,7016,3575856788,3575856831,43
1,594,7017,3575856788,3575856833,45
1,594,7018,3575856788,3575856834,46
1,594,7019,3575856788,3575856835,47
1,595,7020,3575856842,3575856842,0
1,595,7021,3575856842,3575856844,2
1,595,7022,3575856842,3575856846,4
1,595,7023,3575856842,3575856849,7
1,595,7024,3575856842,3575856850,8
1,595,7025,3575856842,3575856852,10
1,595,7026,3575856842,3575856853,11
1,595,7027,3575856842,3575856853,11
1,595,7028,3575856842,3575856855,13
1,595,7029,3575856842,3575856860,18
1,595,7030,3575856842,3575856862,20
1,595,7031,3575856842,3575856863,21
1,595,7032,3575856842,3575856864,22
1,595,7033,3575856842,3575856866,24
1,595,7034,3575856842,3575856868,26
1,595,7035,3575856842,3575856879,37
1,595,7036,3575856842,3575856880,38
1,595,7037,3575856842,3575856882,40
1,595,7038,3575856842,3575856882,40
1,595,7039,3575856842,3575856882,40
1,595,7040,3575856842,3575856886,44
1,595,7041,3575856842,3575856887,45
1,595,7042,3575856842,3575856888,46
1,595,7043,3575856842,3575856891,49
1,595,7044,3575856842,3575856892,50
1,596,7045,3575856896,3575856896,0
1,596,7046,3575856896,3575856896,0
1,596,7047,3575856896,3575856896,0
1,596,7048,3575856896,3575856898,2
1,596,7049,3575856896,3575856898,2
1,596,7050,3575856896,3575856901,5
1,596,7051,3575856896,3575856905,9
1,596,7052,3575856896,3575856906,10
1,596,7053,3575856896,3575856907,11
1,596,7054,3575856896,3575856910,14
1,596,7055,3575856896,3575856914,18
1,596,7056,3575856896,3575856919,23
1,596,7057,3575856896,3575856922,26
1,596,7058,3575856896,3575856927,31
1,596,7059,3575856896,3575856929,33
1,596,7060,3575856896,3575856929,33
1,596,7061,3575856896,3575856931,35
1,596,7062,3575856896,3575856931,35
1,596,7063,3575856896,3575856931,35
1,596,7064,3575856896,3575856932,36
1,596,7065,3575856896,3575856932,36
1,596,7066,3575856896,3575856932,36
1,596,7067,3575856896,3575856939,43
1,596,7068,3575856896,3575856942,46
1,596,7069,3575856896,3575856944,48
1,597,7070,3575856950,3575856952,2
1,597,7071,3575856950,3575856953,3
1,597,7072,3575856950,3575856954,4
1,597,7073,3575856950,3575856956,6
1,597,7074,3575856950,3575856960,10
1,597,7075,3575856950,3575856962,12
1,597,7076,3575856950,3575856963,13
1,597,7077,3575856950,3575856963,13
1,597,7078,3575856950,3575856967,17
1,597,7079,3575856950,3575856967,17
1,597,7080,3575856950,3575856968,18
1,597,7081,3575856950,3575856968,18
1,597,7082,3575856950,3575856968,18
1,597,7083,3575856950,3575856970,20
1,597,7084,3575856950,3575856972,22
1,597,7085,3575856950,3575856974,24
1,597,7086,3575856950,3575856974,24
1,597,7087,3575856950,3575856974,24
1,597,7088,3575856950,3575856976,26
1,597,7089,3575856950,3575856978,28
1,597,7090,3575856950,3575856981,31
1,597,7091,3575856950,3575856981,31
1,597,7092,3575856950,3575856986,36
1,597,7093,3575856950,3575856987,37
1,597,7094,3575856950,3575856991,41
1,597,7095,3575856950,3575856991,41
1,597,7096,3575856950,3575856993,43
1,597,7097,3575856950,3575856993,43
1,597,7098,3575856950,3575856993,43
1,597,7099,3575856950,3575856995,45
1,597,7100,3575856950,3575856997,47
1,597,7101,3575856950,3575856997,47
1,598,7102,3575857004,3575857004,0
1,598,7103,3575857004,3575857005,1
1,598,7104,3575857004,3575857007,3
1,598,7105,3575857004,3575857008,4
1,598,7106,3575857004,3575857008,4
1,598,7107,3575857004,3575857009,5
1,598,7108,3575857004,3575857010,6
1,598,7109,3575857004,3575857011,7
1,598,7110,3575857004,3575857013,9
1,598,7111,3575857004,3575857015,11
1,598,7112,3575857004,3575857015,11
1,598,7113,3575857004,3575857016,12
1,598,7114,3575857004,3575857017,13
1,598,7115,3575857004,3575857018,14
1,598,7116,3575857004,3575857018,14
1,598,7117,3575857004,3575857018,14
1,598,7118,3575857004,3575857023,19
1,598,7119,3575857004,3575857023,19
1,598,7120,3575857004,3575857025,21
1,598,7121,3575857004,3575857025,21
1,598,7122,3575857004,3575857029,25
1,598,7123,3575857004,3575857030,26
1,598,7124,3575857004,3575857031,27
1,598,7125,3575857004,3575857032,28
1,598,7126,3575857004,3575857033,29
1,598,7127,3575857004,3575857034,30
1,598,7128,3575857004,3575857035,31
1,598,7129,3575857004,3575857042,38
1,598,7130,3575857004,3575857045,41
1,598,7131,3575857004,3575857046,42
1,598,7132,3575857004,3575857049,45
1,598,7133,3575857004,3575857050,46
1,598,7134,3575857004,3575857052,48
1,598,7135,3575857004,3575857053,49
1,598,7136,3575857004,3575857054,50
1,599,7137,3575857058,3575857058,0
1,599,7138,3575857058,3575857061,3
1,599,7139,3575857058,3575857063,5
1,599,7140,3575857058,3575857063,5
1,599,7141,3575857058,3575857065,7
1,599,7142,3575857058,3575857067,9
1,599,7143,3575857058,3575857069,11
1,599,7144,3575857058,3575857078,20
1,599,7145,3575857058,3575857079,21
1,599,7146,3575857058,3575857081,23
1,599,7147,3575857058,3575857082,24
1,599,7148,3575857058,3575857082,24
1,599,7149,3575857058,3575857087,29
1,599,7150,3575857058,3575857088,30
1,599,7151,3575857058,3575857089,31
1,599,7152,3575857058,3575857091,33
1,599,7153,3575857058,3575857091,33
1,599,7154,3575857058,3575857094,36
1,599,7155,3575857058,3575857094,36
1,599,7156,3575857058,3575857096,38
1,599,7157,3575857058,3575857097,39
1,599,7158,3575857058,3575857098,40
1,599,7159,3575857058,3575857104,46
1,599,7160,3575857058,3575857106,48
1,599,7161,3575857058,3575857107,49
1,600,7162,3575857112,3575857112,0
1,600,7163,3575857112,3575857114,2
1,600,7164,3575857112,3575857119,7
1,600,7165,3575857112,3575857122,10
1,600,7166,3575857112,3575857127,15
1,600,7167,3575857112,3575857129,17
1,600,7168,3575857112,3575857130,18
1,600,7169,3575857112,3575857131,19
1,600,7170,3575857112,3575857131,19
1,600,7171,3575857112,3575857132,20
1,600,7172,3575857112,3575857133,21
1,600,7173,3575857112,3575857133,21
1,600,7174,3575857112,3575857133,21
1,600,7175,3575857112,3575857139,27
1,600,7176,3575857112,3575857142,30
1,600,7177,3575857112,3575857144,32
1,600,7178,3575857112,3575857152,40
1,600,7179,3575857112,3575857153,41
1,600,7180,3575857112,3575857154,42
1,600,7181,3575857112,3575857156,44
1,600,7182,3575857112,3575857160,48
1,600,7183,3575857112,3575857162,50
1,601,7184,3575857168,3575857168,0
1,601,7185,3575857168,3575857168,0
1,601,7186,3575857168,3575857168,0
1,601,7187,3575857168,3575857168,0
1,601,7188,3575857168,3575857169,1
1,601,7189,3575857168,3575857169,1
1,601,7190,3575857168,3575857169,1
1,601,7191,3575857168,3575857169,1
1,601,7192,3575857168,3575857172,4
1,601,7193,3575857168,3575857173,5
1,601,7194,3575857168,3575857174,6
1,601,7195,3575857168,3575857175,7
1,601,7196,3575857168,3575857177,9
1,601,7197,3575857168,3575857178,10
1,601,7198,3575857168,3575857181,13
1,601,7199,3575857168,3575857181,13
1,601,7200,3575857168,3575857186,18
1,601,7201,3575857168,3575857187,19
1,601,7202,3575857168,3575857191,23
1,601,7203,3575857168,3575857191,23
1,601,7204,3575857168,3575857192,24
1,601,7205,3575857168,3575857193,25
1,601,7206,3575857168,3575857193,25
1,601,7207,3575857168,3575857194,26
1,601,7208,3575857168,3575857198,30
1,601,7209,3575857168,3575857198,30
1,601,7210,3575857168,3575857206,38
1,601,7211,3575857168,3575857208,40
1,601,7212,3575857168,3575857208,40
1,601,7213,3575857168,3575857210,42
1,601,7214,3575857168,3575857212,44
1,601,7215,3575857168,3575857213,45
1,601,7216,3575857168,3575857215,47
1,601,7217,3575857168,3575857215,47
1,601,7218,3575857168,3575857216,48
1,601,7219,3575857168,3575857217,49
1,601,7220,3575857168,3575857218,50
1,602,7221,3575857223,3575857223,0
1,602,7222,3575857223,3575857223,0
1,602,7223,3575857223,3575857224,1
1,602,7224,3575857223,3575857224,1
1,602,7225,3575857223,3575857225,2
1,602,7226,3575857223,3575857226,3
1,602,7227,3575857223,3575857229,6
1,602,7228,3575857223,3575857230,7
1,602,7229,3575857223,3575857231,8
1,602,7230,3575857223,3575857232,9
1,602,7231,3575857223,3575857234,11
1,602,7232,3575857223,3575857234,11
1,602,7233,3575857223,3575857235,12
1,602,7234,3575857223,3575857242,19
1,602,7235,3575857223,3575857245,22
1,602,7236,3575857223,3575857246,23
1,602,7237,3575857223,3575857249,26
1,602,7238,3575857223,3575857251,28
1,602,7239,3575857223,3575857252,29
1,602,7240,3575857223,3575857253,30
1,602,7241,3575857223,3575857254,31
1,602,7242,3575857223,3575857255,32
1,602,7243,3575857223,3575857261,38
1,602,7244,3575857223,3575857263,40
1,602,7245,3575857223,3575857263,40
1,602,7246,3575857223,3575857265,42
1,602,7247,3575857223,3575857266,43
1,602,7248,3575857223,3575857269,46
1,603,7249,3575857278,3575857280,2
1,603,7250,3575857278,3575857281,3
1,603,7251,3575857278,3575857282,4
1,603,7252,3575857278,3575857282,4
1,603,7253,3575857278,3575857282,4
1,603,7254,3575857278,3575857286,8
1,603,7255,3575857278,3575857288,10
1,603,7256,3575857278,3575857289,11
1,603,7257,3575857278,3575857290,12
1,603,7258,3575857278,3575857292,14
1,603,7259,3575857278,3575857294,16
1,603,7260,3575857278,3575857294,16
1,603,7261,3575857278,3575857296,18
1,603,7262,3575857278,3575857297,19
1,603,7263,3575857278,3575857298,20
1,603,7264,3575857278,3575857305,27
1,603,7265,3575857278,3575857306,28
1,603,7266,3575857278,3575857307,29
1,603,7267,3575857278,3575857310,32
1,603,7268,3575857278,3575857314,36
1,603,7269,3575857278,3575857316,38
1,603,7270,3575857278,3575857319,41
1,603,7271,3575857278,3575857323,45
1,603,7272,3575857278,3575857327,49
1,604,7273,3575857333,3575857333,0
1,604,7274,3575857333,3575857333,0
1,604,7275,3575857333,3575857333,0
1,604,7276,3575857333,3575857333,0
1,604,7277,3575857333,3575857333,0
1,604,7278,3575857333,3575857333,0
1,604,7279,3575857333,3575857333,0
1,604,7280,3575857333,3575857333,0
1,604,7281,3575857333,3575857340,7
1,604,7282,3575857333,3575857342,9
1,604,7283,3575857333,3575857344,11
1,604,7284,3575857333,3575857351,18
1,604,7285,3575857333,3575857353,20
1,604,7286,3575857333,3575857355,22
1,604,7287,3575857333,3575857357,24
1,604,7288,3575857333,3575857360,27
1,604,7289,3575857333,3575857362,29
1,604,7290,3575857333,3575857363,30
1,604,7291,3575857333,3575857364,31
1,604,7292,3575857333,3575857367,34
1,604,7293,3575857333,3575857369,36
1,604,7294,3575857333,3575857369,36
1,604,7295,3575857333,3575857369,36
1,604,7296,3575857333,3575857370,37
1,604,7297,3575857333,3575857373,40
1,604,7298,3575857333,3575857374,41
1,604,7299,3575857333,3575857374,41
1,604,7300,3575857333,3575857375,42
1,604,7301,3575857333,3575857378,45
1,604,7302,3575857333,3575857382,49
1,605,7303,3575857388,3575857388,0
1,605,7304,3575857388,3575857388,0
1,605,7305,3575857388,3575857391,3
1,605,7306,3575857388,3575857391,3
1,605,7307,3575857388,3575857392,4
1,605,7308,3575857388,3575857393,5
1,605,7309,3575857388,3575857393,5
1,605,7310,3575857388,3575857394,6
1,605,7311,3575857388,3575857397,9
1,605,7312,3575857388,3575857397,9
1,605,7313,3575857388,3575857400,12
1,605,7314,3575857388,3575857403,15
1,605,7315,3575857388,3575857407,19
1,605,7316,3575857388,3575857408,20
1,605,7317,3575857388,3575857409,21
1,605,7318,3575857388,3575857410,22
1,605,7319,3575857388,3575857411,23
1,605,7320,3575857388,3575857412,24
1,605,7321,3575857388,3575857413,25
1,605,7322,3575857388,3575857414,26
1,605,7323,3575857388,3575857416,28
1,605,7324,3575857388,3575857416,28
1,605,7325,3575857388,3575857416,28
1,605,7326,3575857388,3575857418,30
1,605,7327,3575857388,3575857419,31
1,605,7328,3575857388,3575857419,31
1,605,7329,3575857388,3575857424,36
1,605,7330,3575857388,3575857425,37
1,605,7331,3575857388,3575857425,37
1,605,7332,3575857388,3575857425,37
1,605,7333,3575857388,3575857428,40
1,605,7334,3575857388,3575857430,42
1,605,7335,3575857388,3575857431,43
1,605,7336,3575857388,3575857432,44
1,605,7337,3575857388,3575857434,46
1,605,7338,3575857388,3575857434,46
1,605,7339,3575857388,3575857436,48
1,606,7340,3575857445,3575857445,0
1,606,7341,3575857445,3575857445,0
1,606,7342,3575857445,3575857446,1
1,606,7343,3575857445,3575857450,5
1,606,7344,3575857445,3575857452,7
1,606,7345,3575857445,3575857453,8
1,606,7346,3575857445,3575857454,9
1,606,7347,3575857445,3575857456,11
1,606,7348,3575857445,3575857460,15
1,606,7349,3575857445,3575857463,18
1,606,7350,3575857445,3575857463,18
1,606,7351,3575857445,3575857464,19
1,606,7352,3575857445,3575857467,22
1,606,7353,3575857445,3575857468,23
1,606,7354,3575857445,3575857469,24
1,606,7355,3575857445,3575857480,35
1,606,7356,3575857445,3575857481,36
1,606,7357,3575857445,3575857482,37
1,606,7358,3575857445,3575857482,37
1,606,7359,3575857445,3575857487,42
1,606,7360,3575857445,3575857489,44
1,606,7361,3575857445,3575857490,45
1,606,7362,3575857445,3575857491,46
1,606,7363,3575857445,3575857494,49
1,606,7364,3575857445,3575857494,49
1,607,7365,3575857499,3575857499,0
1,607,7366,3575857499,3575857499,0
1,607,7367,3575857499,3575857500,1
1,607,7368,3575857499,3575857504,5
1,607,7369,3575857499,3575857505,6
1,607,7370,3575857499,3575857506,7
1,607,7371,3575857499,3575857509,10
1,607,7372,3575857499,3575857514,15
1,607,7373,3575857499,3575857515,16
1,607,7374,3575857499,3575857517,18
1,607,7375,3575857499,3575857522,23
1,607,7376,3575857499,3575857526,27
1,607,7377,3575857499,3575857527,28
1,607,7378,3575857499,3575857529,30
1,607,7379,3575857499,3575857530,31
1,607,7380,3575857499,3575857530,31
1,607,7381,3575857499,3575857531,32
1,607,7382,3575857499,3575857531,32
1,607,7383,3575857499,3575857531,32
1,607,7384,3575857499,3575857531,32
1,607,7385,3575857499,3575857532,33
1,607,7386,3575857499,3575857539,40
1,607,7387,3575857499,3575857541,42
1,607,7388,3575857499,3575857543,44
1,607,7389,3575857499,3575857547,48
1,608,7390,3575857553,3575857553,0
1,608,7391,3575857553,3575857553,0
1,608,7392,3575857553,3575857553,0
1,608,7393,3575857553,3575857556,3
1,608,7394,3575857553,3575857560,7
1,608,7395,3575857553,3575857561,8
1,608,7396,3575857553,3575857562,9
1,608,7397,3575857553,3575857564,11
1,608,7398,3575857553,3575857566,13
1,608,7399,3575857553,3575857567,14
1,608,7400,3575857553,3575857567,14
1,608,7401,3575857553,3575857568,15
1,608,7402,3575857553,3575857568,15
1,608,7403,3575857553,3575857569,16
1,608,7404,3575857553,3575857572,19
1,608,7405,3575857553,3575857574,21
1,608,7406,3575857553,3575857574,21
1,608,7407,3575857553,3575857575,22
1,608,7408,3575857553,3575857575,22
1,608,7409,3575857553,3575857576,23
1,608,7410,3575857553,3575857581,28
1,608,7411,3575857553,3575857581,28
1,608,7412,3575857553,3575857585,32
1,608,7413,3575857553,3575857587,34
1,608,7414,3575857553,3575857591,38
1,608,7415,3575857553,3575857591,38
1,608,7416,3575857553,3575857591,38
1,608,7417,3575857553,3575857592,39
1,608,7418,3575857553,3575857594,41
1,608,7419,3575857553,3575857596,43
1,608,7420,3575857553,3575857597,44
1,608,7421,3575857553,3575857599,46
1,609,7422,3575857608,3575857608,0
1,609,7423,3575857608,3575857608,0
1,609,7424,3575857608,3575857608,0
1,609,7425,3575857608,3575857609,1
1,609,7426,3575857608,3575857610,2
1,609,7427,3575857608,3575857612,4
1,609,7428,3575857608,3575857613,5
1,609,7429,3575857608,3575857613,5
1,609,7430,3575857608,3575857615,7
1,609,7431,3575857608,3575857615,7
1,609,7432,3575857608,3575857616,8
1,609,7433,3575857608,3575857616,8
1,609,7434,3575857608,3575857617,9
1,609,7435,3575857608,3575857618,10
1,609,7436,3575857608,3575857619,11
1,609,7437,3575857608,3575857622,14
1,609,7438,3575857608,3575857624,16
1,609,7439,3575857608,3575857625,17
1,609,7440,3575857608,3575857625,17
1,609,7441,3575857608,3575857627,19
1,609,7442,3575857608,3575857629,21
1,609,7443,3575857608,3575857630,22
1,609,7444,3575857608,3575857633,25
1,609,7445,3575857608,3575857634,26
1,609,7446,3575857608,3575857635,27
1,609,7447,3575857608,3575857641,33
1,609,7448,3575857608,3575857643,35
1,609,7449,3575857608,3575857648,40
1,609,7450,3575857608,3575857650,42
1,609,7451,3575857608,3575857652,44
1,609,7452,3575857608,3575857653,45
1,609,7453,3575857608,3575857655,47
1,610,7454,3575857663,3575857663,0
1,610,7455,3575857663,3575857663,0
1,610,7456,3575857663,3575857663,0
1,610,7457,3575857663,3575857664,1
1,610,7458,3575857663,3575857667,4
1,610,7459,3575857663,3575857668,5
1,610,7460,3575857663,3575857679,16
1,610,7461,3575857663,3575857681,18
1,610,7462,3575857663,3575857682,19
1,610,7463,3575857663,3575857682,19
1,610,7464,3575857663,3575857682,19
1,610,7465,3575857663,3575857686,23
1,610,7466,3575857663,3575857687,24
1,610,7467,3575857663,3575857689,26
1,610,7468,3575857663,3575857691,28
1,610,7469,3575857663,3575857692,29
1,610,7470,3575857663,3575857694,31
1,610,7471,3575857663,3575857694,31
1,610,7472,3575857663,3575857696,33
1,610,7473,3575857663,3575857698,35
1,610,7474,3575857663,3575857700,37
1,610,7475,3575857663,3575857703,40
1,610,7476,3575857663,3575857705,42
1,610,7477,3575857663,3575857707,44
1,610,7478,3575857663,3575857710,47
1,611,7479,3575857718,3575857718,0
1,611,7480,3575857718,3575857718,0
1,611,7481,3575857718,3575857722,4
1,611,7482,3575857718,3575857727,9
1,611,7483,3575857718,3575857728,10
1,611,7484,3575857718,3575857729,11
1,611,7485,3575857718,3575857730,12
1,611,7486,3575857718,3575857731,13
1,611,7487,3575857718,3575857731,13
1,611,7488,3575857718,3575857731,13
1,611,7489,3575857718,3575857731,13
1,611,7490,3575857718,3575857732,14
1,611,7491,3575857718,3575857732,14
1,611,7492,3575857718,3575857739,21
1,611,7493,3575857718,3575857742,24
1,611,7494,3575857718,3575857743,25
1,611,7495,3575857718,3575857747,29
1,611,7496,3575857718,3575857751,33
1,611,7497,3575857718,3575857753,35
1,611,7498,3575857718,3575857753,35
1,611,7499,3575857718,3575857756,38
1,611,7500,3575857718,3575857760,42
1,611,7501,3575857718,3575857761,43
1,611,7502,3575857718,3575857762,44
1,611,7503,3575857718,3575857764,46
1,611,7504,3575857718,3575857766,48
1,611,7505,3575857718,3575857767,49
1,611,7506,3575857718,3575857767,49
1,611,7507,3575857718,3575857768,50
1,612,7508,3575857775,3575857775,0
1,612,7509,3575857775,3575857775,0
1,612,7510,3575857775,3575857775,0
1,612,7511,3575857775,3575857775,0
1,612,7512,3575857775,3575857775,0
1,612,7513,3575857775,3575857775,0
1,612,7514,3575857775,3575857776,1
1,612,7515,3575857775,3575857777,2
1,612,7516,3575857775,3575857781,6
1,612,7517,3575857775,3575857781,6
1,612,7518,3575857775,3575857785,10
1,612,7519,3575857775,3575857787,12
1,612,7520,3575857775,3575857790,15
1,612,7521,3575857775,3575857791,16
1,612,7522,3575857775,3575857791,16
1,612,7523,3575857775,3575857793,18
1,612,7524,3575857775,3575857793,18
1,612,7525,3575857775,3575857796,21
1,612,7526,3575857775,3575857797,22
1,612,7527,3575857775,3575857799,24
1,612,7528,3575857775,3575857806,31
1,612,7529,3575857775,3575857808,33
1,612,7530,3575857775,3575857808,33
1,612,7531,3575857775,3575857810,35
1,612,7532,3575857775,3575857810,35
1,612,7533,3575857775,3575857812,37
1,612,7534,3575857775,3575857812,37
1,612,7535,3575857775,3575857813,38
1,612,7536,3575857775,3575857815,40
1,612,7537,3575857775,3575857815,40
1,612,7538,3575857775,3575857816,41
1,612,7539,3575857775,3575857817,42
1,612,7540,3575857775,3575857817,42
1,612,7541,3575857775,3575857818,43
1,612,7542,3575857775,3575857818,43
1,612,7543,3575857775,3575857824,49
1,613,7544,3575857830,3575857830,0
1,613,7545,3575857830,3575857830,0
1,613,7546,3575857830,3575857830,0
1,613,7547,3575857830,3575857830,0
1,613,7548,3575857830,3575857830,0
1,613,7549,3575857830,3575857830,0
1,613,7550,3575857830,3575857830,0
1,613,7551,3575857830,3575857831,1
1,613,7552,3575857830,3575857833,3
1,613,7553,3575857830,3575857835,5
1,613,7554,3575857830,3575857835,5
1,613,7555,3575857830,3575857841,11
1,613,7556,3575857830,3575857844,14
1,613,7557,3575857830,3575857845,15
1,613,7558,3575857830,3575857849,19
1,613,7559,3575857830,3575857850,20
1,613,7560,3575857830,3575857853,23
1,613,7561,3575857830,3575857854,24
1,613,7562,3575857830,3575857856,26
1,613,7563,3575857830,3575857859,29
1,613,7564,3575857830,3575857863,33
1,613,7565,3575857830,3575857863,33
1,613,7566,3575857830,3575857864,34
1,613,7567,3575857830,3575857865,35
1,613,7568,3575857830,3575857868,38
1,613,7569,3575857830,3575857868,38
1,613,7570,3575857830,3575857879,49
1,614,7571,3575857885,3575857885,0
1,614,7572,3575857885,3575857885,0
1,614,7573,3575857885,3575857885,0
1,614,7574,3575857885,3575857885,0
1,614,7575,3575857885,3575857886,1
1,614,7576,3575857885,3575857887,2
1,614,7577,3575857885,3575857889,4
1,614,7578,3575857885,3575857889,4
1,614,7579,3575857885,3575857891,6
1,614,7580,3575857885,3575857892,7
1,614,7581,3575857885,3575857894,9
1,614,7582,3575857885,3575857895,10
1,614,7583,3575857885,3575857895,10
1,614,7584,3575857885,3575857898,13
1,614,7585,3575857885,3575857900,15
1,614,7586,3575857885,3575857905,20
1,614,7587,3575857885,3575857906,21
1,614,7588,3575857885,3575857913,28
1,614,7589,3575857885,3575857916,31
1,614,7590,3575857885,3575857919,34
1,614,7591,3575857885,3575857922,37
1,614,7592,3575857885,3575857927,42
1,614,7593,3575857885,3575857929,44
1,614,7594,3575857885,3575857929,44
1,614,7595,3575857885,3575857930,45
1,614,7596,3575857885,3575857931,46
1,614,7597,3575857885,3575857931,46
1,614,7598,3575857885,3575857931,46
1,614,7599,3575857885,3575857931,46
1,614,7600,3575857885,3575857932,47
1,614,7601,3575857885,3575857932,47
1,615,7602,3575857940,3575857942,2
1,615,7603,3575857940,3575857943,3
1,615,7604,3575857940,3575857951,11
1,615,7605,3575857940,3575857953,13
1,615,7606,3575857940,3575857954,14
1,615,7607,3575857940,3575857956,16
1,615,7608,3575857940,3575857960,20
1,615,7609,3575857940,3575857961,21
1,615,7610,3575857940,3575857962,22
1,615,7611,3575857940,3575857964,24
1,615,7612,3575857940,3575857966,26
1,615,7613,3575857940,3575857968,28
1,615,7614,3575857940,3575857968,28
1,615,7615,3575857940,3575857969,29
1,615,7616,3575857940,3575857969,29
1,615,7617,3575857940,3575857970,30
1,615,7618,3575857940,3575857972,32
1,615,7619,3575857940,3575857974,34
1,615,7620,3575857940,3575857974,34
1,615,7621,3575857940,3575857974,34
1,615,7622,3575857940,3575857976,36
1,615,7623,3575857940,3575857978,38
1,615,7624,3575857940,3575857981,41
1,615,7625,3575857940,3575857981,41
1,615,7626,3575857940,3575857986,46
1,615,7627,3575857940,3575857987,47
1,615,7628,3575857940,3575857990,50
1,616,7629,3575857995,3575857995,0
1,616,7630,3575857995,3575857995,0
1,616,7631,3575857995,3575857995,0
1,616,7632,3575857995,3575857995,0
1,616,7633,3575857995,3575857995,0
1,616,7634,3575857995,3575857996,1
1,616,7635,3575857995,3575857997,2
1,616,7636,3575857995,3575857998,3
1,616,7637,3575857995,3575858006,11
1,616,7638,3575857995,3575858008,13
1,616,7639,3575857995,3575858009,14
1,616,7640,3575857995,3575858010,15
1,616,7641,3575857995,3575858010,15
1,616,7642,3575857995,3575858012,17
1,616,7643,3575857995,3575858012,17
1,616,7644,3575857995,3575858014,19
1,616,7645,3575857995,3575858015,20
1,616,7646,3575857995,3575858016,21
1,616,7647,3575857995,3575858017,22
1,616,7648,3575857995,3575858017,22
1,616,7649,3575857995,3575858018,23
1,616,7650,3575857995,3575858018,23
1,616,7651,3575857995,3575858019,24
1,616,7652,3575857995,3575858023,28
1,616,7653,3575857995,3575858025,30
1,616,7654,3575857995,3575858025,30
1,616,7655,3575857995,3575858026,31
1,616,7656,3575857995,3575858026,31
1,616,7657,3575857995,3575858028,33
1,616,7658,3575857995,3575858030,35
1,616,7659,3575857995,3575858031,36
1,616,7660,3575857995,3575858031,36
1,616,7661,3575857995,3575858033,38
1,616,7662,3575857995,3575858034,39
1,616,7663,3575857995,3575858035,40
1,616,7664,3575857995,3575858040,45
1,616,7665,3575857995,3575858044,49
1,616,7666,3575857995,3575858044,49
1,617,7667,3575858049,3575858050,1
1,617,7668,3575858049,3575858050,1
1,617,7669,3575858049,3575858052,3
1,617,7670,3575858049,3575858053,4
1,617,7671,3575858049,3575858054,5
1,617,7672,3575858049,3575858055,6
1,617,7673,3575858049,3575858060,11
1,617,7674,3575858049,3575858063,14
1,617,7675,3575858049,3575858063,14
1,617,7676,3575858049,3575858065,16
1,617,7677,3575858049,3575858066,17
1,617,7678,3575858049,3575858066,17
1,617,7679,3575858049,3575858067,18
1,617,7680,3575858049,3575858068,19
1,617,7681,3575858049,3575858080,31
1,617,7682,3575858049,3575858080,31
1,617,7683,3575858049,3575858081,32
1,617,7684,3575858049,3575858082,33
1,617,7685,3575858049,3575858086,37
1,617,7686,3575858049,3575858087,38
1,617,7687,3575858049,3575858089,40
1,617,7688,3575858049,3575858089,40
1,617,7689,3575858049,3575858091,42
1,617,7690,3575858049,3575858092,43
1,617,7691,3575858049,3575858094,45
1,617,7692,3575858049,3575858095,46
1,617,7693,3575858049,3575858096,47
1,617,7694,3575858049,3575858098,49
1,617,7695,3575858049,3575858098,49
1,618,7696,3575858104,3575858104,0
1,618,7697,3575858104,3575858105,1
1,618,7698,3575858104,3575858105,1
1,618,7699,3575858104,3575858107,3
1,618,7700,3575858104,3575858114,10
1,618,7701,3575858104,3575858116,12
1,618,7702,3575858104,3575858119,15
1,618,7703,3575858104,3575858122,18
1,618,7704,3575858104,3575858127,23
1,618,7705,3575858104,3575858129,25
1,618,7706,3575858104,3575858130,26
1,618,7707,3575858104,3575858130,26
1,618,7708,3575858104,3575858131,27
1,618,7709,3575858104,3575858131,27
1,618,7710,3575858104,3575858131,27
1,618,7711,3575858104,3575858132,28
1,618,7712,3575858104,3575858132,28
1,618,7713,3575858104,3575858133,29
1,618,7714,3575858104,3575858139,35
1,618,7715,3575858104,3575858143,39
1,618,7716,3575858104,3575858144,40
1,618,7717,3575858104,3575858151,47
1,618,7718,3575858104,3575858153,49
1,618,7719,3575858104,3575858153,49
1,619,7720,3575858158,3575858158,0
1,619,7721,3575858158,3575858160,2
1,619,7722,3575858158,3575858161,3
1,619,7723,3575858158,3575858164,6
1,619,7724,3575858158,3575858164,6
1,619,7725,3575858158,3575858166,8
1,619,7726,3575858158,3575858167,9
1,619,7727,3575858158,3575858168,10
1,619,7728,3575858158,3575858169,11
1,619,7729,3575858158,3575858170,12
1,619,7730,3575858158,3575858170,12
1,619,7731,3575858158,3575858173,15
1,619,7732,3575858158,3575858174,16
1,619,7733,3575858158,3575858174,16
1,619,7734,3575858158,3575858175,17
1,619,7735,3575858158,3575858178,20
1,619,7736,3575858158,3575858182,24
1,619,7737,3575858158,3575858182,24
1,619,7738,3575858158,3575858186,28
1,619,7739,3575858158,3575858187,29
1,619,7740,3575858158,3575858190,32
1,619,7741,3575858158,3575858191,33
1,619,7742,3575858158,3575858192,34
1,619,7743,3575858158,3575858193,35
1,619,7744,3575858158,3575858193,35
1,619,7745,3575858158,3575858193,35
1,619,7746,3575858158,3575858197,39
1,619,7747,3575858158,3575858197,39
1,619,7748,3575858158,3575858199,41
1,619,7749,3575858158,3575858201,43
1,619,7750,3575858158,3575858206,48
1,620,7751,3575858212,3575858212,0
1,620,7752,3575858212,3575858212,0
1,620,7753,3575858212,3575858212,0
1,620,7754,3575858212,3575858212,0
1,620,7755,3575858212,3575858213,1
1,620,7756,3575858212,3575858214,2
1,620,7757,3575858212,3575858216,4
1,620,7758,3575858212,3575858216,4
1,620,7759,3575858212,3575858217,5
1,620,7760,3575858212,3575858217,5
1,620,7761,3575858212,3575858218,6
1,620,7762,3575858212,3575858219,7
1,620,7763,3575858212,3575858219,7
1,620,7764,3575858212,3575858223,11
1,620,7765,3575858212,3575858224,12
1,620,7766,3575858212,3575858224,12
1,620,7767,3575858212,3575858226,14
1,620,7768,3575858212,3575858226,14
1,620,7769,3575858212,3575858228,16
1,620,7770,3575858212,3575858230,18
1,620,7771,3575858212,3575858232,20
1,620,7772,3575858212,3575858234,22
1,620,7773,3575858212,3575858234,22
1,620,7774,3575858212,3575858235,23
1,620,7775,3575858212,3575858235,23
1,620,7776,3575858212,3575858241,29
1,620,7777,3575858212,3575858245,33
1,620,7778,3575858212,3575858245,33
1,620,7779,3575858212,3575858250,38
1,620,7780,3575858212,3575858251,39
1,620,7781,3575858212,3575858252,40
1,620,7782,3575858212,3575858254,42
1,620,7783,3575858212,3575858255,43
1,620,7784,3575858212,3575858256,44
1,620,7785,3575858212,3575858260,48
1,621,7786,3575858267,3575858267,0
1,621,7787,3575858267,3575858267,0
1,621,7788,3575858267,3575858267,0
1,621,7789,3575858267,3575858267,0
1,621,7790,3575858267,3575858267,0
1,621,7791,3575858267,3575858268,1
1,621,7792,3575858267,3575858269,2
1,621,7793,3575858267,3575858280,13
1,621,7794,3575858267,3575858281,14
1,621,7795,3575858267,3575858282,15
1,621,7796,3575858267,3575858282,15
1,621,7797,3575858267,3575858286,19
1,621,7798,3575858267,3575858287,20
1,621,7799,3575858267,3575858289,22
1,621,7800,3575858267,3575858289,22
1,621,7801,3575858267,3575858291,24
1,621,7802,3575858267,3575858292,25
1,621,7803,3575858267,3575858294,27
1,621,7804,3575858267,3575858294,27
1,621,7805,3575858267,3575858296,29
1,621,7806,3575858267,3575858298,31
1,621,7807,3575858267,3575858298,31
1,621,7808,3575858267,3575858302,35
1,621,7809,3575858267,3575858305,38
1,621,7810,3575858267,3575858305,38
1,621,7811,3575858267,3575858308,41
1,621,7812,3575858267,3575858310,43
1,621,7813,3575858267,3575858314,47
1,622,7814,3575858321,3575858321,0
1,622,7815,3575858321,3575858322,1
1,622,7816,3575858321,3575858327,6
1,622,7817,3575858321,3575858329,8
1,622,7818,3575858321,3575858329,8
1,622,7819,3575858321,3575858330,9
1,622,7820,3575858321,3575858331,10
1,622,7821,3575858321,3575858331,10
1,622,7822,3575858321,3575858331,10
1,622,7823,3575858321,3575858332,11
1,622,7824,3575858321,3575858332,11
1,622,7825,3575858321,3575858333,12
1,622,7826,3575858321,3575858336,15
1,622,7827,3575858321,3575858340,19
1,622,7828,3575858321,3575858343,22
1,622,7829,3575858321,3575858344,23
1,622,7830,3575858321,3575858352,31
1,622,7831,3575858321,3575858353,32
1,622,7832,3575858321,3575858354,33
1,622,7833,3575858321,3575858357,36
1,622,7834,3575858321,3575858360,39
1,622,7835,3575858321,3575858361,40
1,622,7836,3575858321,3575858364,43
1,622,7837,3575858321,3575858364,43
1,622,7838,3575858321,3575858367,46
1,622,7839,3575858321,3575858367,46
1,622,7840,3575858321,3575858368,47
1,622,7841,3575858321,3575858369,48
1,622,7842,3575858321,3575858370,49
1,622,7843,3575858321,3575858370,49
1,623,7844,3575858375,3575858375,0
1,623,7845,3575858375,3575858375,0
1,623,7846,3575858375,3575858375,0
1,623,7847,3575858375,3575858376,1
1,623,7848,3575858375,3575858379,4
1,623,7849,3575858375,3575858382,7
1,623,7850,3575858375,3575858382,7
1,623,7851,3575858375,3575858386,11
1,623,7852,3575858375,3575858387,12
1,623,7853,3575858375,3575858387,12
1,623,7854,3575858375,3575858390,15
1,623,7855,3575858375,3575858392,17
1,623,7856,3575858375,3575858392,17
1,623,7857,3575858375,3575858393,18
1,623,7858,3575858375,3575858393,18
1,623,7859,3575858375,3575858394,19
1,623,7860,3575858375,3575858397,22
1,623,7861,3575858375,3575858397,22
1,623,7862,3575858375,3575858404,29
1,623,7863,3575858375,3575858407,32
1,623,7864,3575858375,3575858408,33
1,623,7865,3575858375,3575858410,35
1,623,7866,3575858375,3575858411,36
1,623,7867,3575858375,3575858412,37
1,623,7868,3575858375,3575858412,37
1,623,7869,3575858375,3575858414,39
1,623,7870,3575858375,3575858416,41
1,623,7871,3575858375,3575858416,41
1,623,7872,3575858375,3575858417,42
1,623,7873,3575858375,3575858417,42
1,623,7874,3575858375,3575858418,43
1,623,7875,3575858375,3575858418,43
1,623,7876,3575858375,3575858419,44
1,623,7877,3575858375,3575858423,48
1,623,7878,3575858375,3575858424,49
1,623,7879,3575858375,3575858425,50
1,624,7880,3575858429,3575858429,0
1,624,7881,3575858429,3575858429,0
1,624,7882,3575858429,3575858429,0
1,624,7883,3575858429,3575858430,1
1,624,7884,3575858429,3575858431,2
1,624,7885,3575858429,3575858434,5
1,624,7886,3575858429,3575858434,5
1,624,7887,3575858429,3575858434,5
1,624,7888,3575858429,3575858436,7
1,624,7889,3575858429,3575858438,9
1,624,7890,3575858429,3575858441,12
1,624,7891,3575858429,3575858444,15
1,624,7892,3575858429,3575858446,17
1,624,7893,3575858429,3575858450,21
1,624,7894,3575858429,3575858450,21
1,624,7895,3575858429,3575858452,23
1,624,7896,3575858429,3575858454,25
1,624,7897,3575858429,3575858454,25
1,624,7898,3575858429,3575858456,27
1,624,7899,3575858429,3575858461,32
1,624,7900,3575858429,3575858463,34
1,624,7901,3575858429,3575858463,34
1,624,7902,3575858429,3575858465,36
1,624,7903,3575858429,3575858467,38
1,624,7904,3575858429,3575858467,38
1,624,7905,3575858429,3575858469,40
1,624,7906,3575858429,3575858469,40
1,625,7907,3575858484,3575858484,0
1,625,7908,3575858484,3575858484,0
1,625,7909,3575858484,3575858484,0
1,625,7910,3575858484,3575858484,0
1,625,7911,3575858484,3575858485,1
1,625,7912,3575858484,3575858486,2
1,625,7913,3575858484,3575858488,4
1,625,7914,3575858484,3575858488,4
1,625,7915,3575858484,3575858491,7
1,625,7916,3575858484,3575858491,7
1,625,7917,3575858484,3575858494,10
1,625,7918,3575858484,3575858494,10
1,625,7919,3575858484,3575858497,13
1,625,7920,3575858484,3575858498,14
1,625,7921,3575858484,3575858501,17
1,625,7922,3575858484,3575858504,20
1,625,7923,3575858484,3575858505,21
1,625,7924,3575858484,3575858506,22
1,625,7925,3575858484,3575858512,28
1,625,7926,3575858484,3575858515,31
1,625,7927,3575858484,3575858518,34
1,625,7928,3575858484,3575858521,37
1,625,7929,3575858484,3575858526,42
1,625,7930,3575858484,3575858528,44
1,625,7931,3575858484,3575858529,45
1,625,7932,3575858484,3575858530,46
1,625,7933,3575858484,3575858530,46
1,625,7934,3575858484,3575858530,46
1,625,7935,3575858484,3575858530,46
1,625,7936,3575858484,3575858531,47
1,625,7937,3575858484,3575858531,47
1,625,7938,3575858484,3575858532,48
1,626,7939,3575858539,3575858539,0
1,626,7940,3575858539,3575858539,0
1,626,7941,3575858539,3575858543,4
1,626,7942,3575858539,3575858543,4
1,626,7943,3575858539,3575858552,13
1,626,7944,3575858539,3575858552,13
1,626,7945,3575858539,3575858554,15
1,626,7946,3575858539,3575858556,17
1,626,7947,3575858539,3575858559,20
1,626,7948,3575858539,3575858560,21
1,626,7949,3575858539,3575858563,24
1,626,7950,3575858539,3575858563,24
1,626,7951,3575858539,3575858565,26
1,626,7952,3575858539,3575858567,28
1,626,7953,3575858539,3575858568,29
1,626,7954,3575858539,3575858568,29
1,626,7955,3575858539,3575858568,29
1,626,7956,3575858539,3575858569,30
1,626,7957,3575858539,3575858574,35
1,626,7958,3575858539,3575858574,35
1,626,7959,3575858539,3575858576,37
1,626,7960,3575858539,3575858578,39
1,626,7961,3575858539,3575858581,42
1,626,7962,3575858539,3575858581,42
1,626,7963,3575858539,3575858585,46
1,626,7964,3575858539,3575858586,47
1,626,7965,3575858539,3575858587,48
1,627,7966,3575858594,3575858594,0
1,627,7967,3575858594,3575858594,0
1,627,7968,3575858594,3575858594,0
1,627,7969,3575858594,3575858594,0
1,627,7970,3575858594,3575858594,0
1,627,7971,3575858594,3575858594,0
1,627,7972,3575858594,3575858596,2
1,627,7973,3575858594,3575858597,3
1,627,7974,3575858594,3575858603,9
1,627,7975,3575858594,3575858605,11
1,627,7976,3575858594,3575858607,13
1,627,7977,3575858594,3575858608,14
1,627,7978,3575858594,3575858609,15
1,627,7979,3575858594,3575858610,16
1,627,7980,3575858594,3575858612,18
1,627,7981,3575858594,3575858613,19
1,627,7982,3575858594,3575858613,19
1,627,7983,3575858594,3575858615,21
1,627,7984,3575858594,3575858616,22
1,627,7985,3575858594,3575858616,22
1,627,7986,3575858594,3575858618,24
1,627,7987,3575858594,3575858618,24
1,627,7988,3575858594,3575858618,24
1,627,7989,3575858594,3575858622,28
1,627,7990,3575858594,3575858624,30
1,627,7991,3575858594,3575858624,30
1,627,7992,3575858594,3575858626,32
1,627,7993,3575858594,3575858626,32
1,627,7994,3575858594,3575858627,33
1,627,7995,3575858594,3575858629,35
1,627,7996,3575858594,3575858631,37
1,627,7997,3575858594,3575858633,39
1,627,7998,3575858594,3575858633,39
1,627,7999,3575858594,3575858634,40
1,627,8000,3575858594,3575858635,41
1,627,8001,3575858594,3575858638,44
1,627,8002,3575858594,3575858640,46
1,627,8003,3575858594,3575858640,46
1,627,8004,3575858594,3575858644,50
1,628,8005,3575858649,3575858649,0
1,628,8006,3575858649,3575858649,0
1,628,8007,3575858649,3575858650,1
1,628,8008,3575858649,3575858651,2
1,628,8009,3575858649,3575858653,4
1,628,8010,3575858649,3575858653,4
1,628,8011,3575858649,3575858655,6
1,628,8012,3575858649,3575858660,11
1,628,8013,3575858649,3575858663,14
1,628,8014,3575858649,3575858663,14
1,628,8015,3575858649,3575858665,16
1,628,8016,3575858649,3575858665,16
1,628,8017,3575858649,3575858665,16
1,628,8018,3575858649,3575858668,19
1,628,8019,3575858649,3575858668,19
1,628,8020,3575858649,3575858680,31
1,628,8021,3575858649,3575858681,32
1,628,8022,3575858649,3575858681,32
1,628,8023,3575858649,3575858682,33
1,628,8024,3575858649,3575858687,38
1,628,8025,3575858649,3575858688,39
1,628,8026,3575858649,3575858688,39
1,628,8027,3575858649,3575858691,42
1,628,8028,3575858649,3575858692,43
1,628,8029,3575858649,3575858693,44
1,628,8030,3575858649,3575858694,45
1,628,8031,3575858649,3575858694,45
1,628,8032,3575858649,3575858697,48
1,628,8033,3575858649,3575858697,48
1,629,8034,3575858704,3575858704,0
1,629,8035,3575858704,3575858704,0
1,629,8036,3575858704,3575858706,2
1,629,8037,3575858704,3575858706,2
1,629,8038,3575858704,3575858712,8
1,629,8039,3575858704,3575858715,11
1,629,8040,3575858704,3575858718,14
1,629,8041,3575858704,3575858722,18
1,629,8042,3575858704,3575858727,23
1,629,8043,3575858704,3575858729,25
1,629,8044,3575858704,3575858730,26
1,629,8045,3575858704,3575858730,26
1,629,8046,3575858704,3575858731,27
1,629,8047,3575858704,3575858731,27
1,629,8048,3575858704,3575858731,27
1,629,8049,3575858704,3575858732,28
1,629,8050,3575858704,3575858732,28
1,629,8051,3575858704,3575858735,31
1,629,8052,3575858704,3575858739,35
1,629,8053,3575858704,3575858743,39
1,629,8054,3575858704,3575858743,39
1,629,8055,3575858704,3575858753,49
1,629,8056,3575858704,3575858753,49
1,629,8057,3575858704,3575858754,50
1,630,8058,3575858759,3575858759,0
1,630,8059,3575858759,3575858760,1
1,630,8060,3575858759,3575858761,2
1,630,8061,3575858759,3575858762,3
1,630,8062,3575858759,3575858763,4
1,630,8063,3575858759,3575858765,6
1,630,8064,3575858759,3575858767,8
1,630,8065,3575858759,3575858768,9
1,630,8066,3575858759,3575858768,9
1,630,8067,3575858759,3575858769,10
1,630,8068,3575858759,3575858770,11
1,630,8069,3575858759,3575858774,15
1,630,8070,3575858759,3575858775,16
1,630,8071,3575858759,3575858778,19
1,630,8072,3575858759,3575858781,22
1,630,8073,3575858759,3575858781,22
1,630,8074,3575858759,3575858785,26
1,630,8075,3575858759,3575858786,27
1,630,8076,3575858759,3575858787,28
1,630,8077,3575858759,3575858789,30
1,630,8078,3575858759,3575858792,33
1,630,8079,3575858759,3575858792,33
1,630,8080,3575858759,3575858792,33
1,630,8081,3575858759,3575858792,33
1,630,8082,3575858759,3575858793,34
1,630,8083,3575858759,3575858793,34
1,630,8084,3575858759,3575858797,38
1,630,8085,3575858759,3575858797,38
1,630,8086,3575858759,3575858803,44
1,630,8087,3575858759,3575858805,46
1,630,8088,3575858759,3575858806,47
1,630,8089,3575858759,3575858808,49
1,630,8090,3575858759,3575858809,50
1,631,8091,3575858814,3575858814,0
1,631,8092,3575858814,3575858814,0
1,631,8093,3575858814,3575858814,0
1,631,8094,3575858814,3575858814,0
1,631,8095,3575858814,3575858815,1
1,631,8096,3575858814,3575858815,1
1,631,8097,3575858814,3575858817,3
1,631,8098,3575858814,3575858817,3
1,631,8099,3575858814,3575858818,4
1,631,8100,3575858814,3575858818,4
1,631,8101,3575858814,3575858823,9
1,631,8102,3575858814,3575858824,10
1,631,8103,3575858814,3575858825,11
1,631,8104,3575858814,3575858825,11
1,631,8105,3575858814,3575858826,12
1,631,8106,3575858814,3575858828,14
1,631,8107,3575858814,3575858830,16
1,631,8108,3575858814,3575858830,16
1,631,8109,3575858814,3575858833,19
1,631,8110,3575858814,3575858833,19
1,631,8111,3575858814,3575858834,20
1,631,8112,3575858814,3575858835,21
1,631,8113,3575858814,3575858839,25
1,631,8114,3575858814,3575858841,27
1,631,8115,3575858814,3575858843,29
1,631,8116,3575858814,3575858843,29
1,631,8117,3575858814,3575858848,34
1,631,8118,3575858814,3575858850,36
1,631,8119,3575858814,3575858850,36
1,631,8120,3575858814,3575858851,37
1,631,8121,3575858814,3575858852,38
1,631,8122,3575858814,3575858854,40
1,631,8123,3575858814,3575858855,41
1,631,8124,3575858814,3575858860,46
1,631,8125,3575858814,3575858862,48
1,631,8126,3575858814,3575858863,49
1,632,8127,3575858870,3575858870,0
1,632,8128,3575858870,3575858870,0
1,632,8129,3575858870,3575858870,0
1,632,8130,3575858870,3575858870,0
1,632,8131,3575858870,3575858870,0
1,632,8132,3575858870,3575858880,10
1,632,8133,3575858870,3575858880,10
1,632,8134,3575858870,3575858881,11
1,632,8135,3575858870,3575858881,11
1,632,8136,3575858870,3575858885,15
1,632,8137,3575858870,3575858886,16
1,632,8138,3575858870,3575858888,18
1,632,8139,3575858870,3575858888,18
1,632,8140,3575858870,3575858892,22
1,632,8141,3575858870,3575858893,23
1,632,8142,3575858870,3575858894,24
1,632,8143,3575858870,3575858895,25
1,632,8144,3575858870,3575858897,27
1,632,8145,3575858870,3575858901,31
1,632,8146,3575858870,3575858905,35
1,632,8147,3575858870,3575858905,35
1,632,8148,3575858870,3575858906,36
1,632,8149,3575858870,3575858912,42
1,632,8150,3575858870,3575858919,49
1,633,8151,3575858926,3575858926,0
1,633,8152,3575858926,3575858927,1
1,633,8153,3575858926,3575858929,3
1,633,8154,3575858926,3575858930,4
1,633,8155,3575858926,3575858931,5
1,633,8156,3575858926,3575858931,5
1,633,8157,3575858926,3575858931,5
1,633,8158,3575858926,3575858932,6
1,633,8159,3575858926,3575858932,6
1,633,8160,3575858926,3575858932,6
1,633,8161,3575858926,3575858934,8
1,633,8162,3575858926,3575858940,14
1,633,8163,3575858926,3575858943,17
1,633,8164,3575858926,3575858944,18
1,633,8165,3575858926,3575858945,19
1,633,8166,3575858926,3575858953,27
1,633,8167,3575858926,3575858954,28
1,633,8168,3575858926,3575858955,29
1,633,8169,3575858926,3575858958,32
1,633,8170,3575858926,3575858960,34
1,633,8171,3575858926,3575858961,35
1,633,8172,3575858926,3575858963,37
1,633,8173,3575858926,3575858964,38
1,633,8174,3575858926,3575858965,39
1,633,8175,3575858926,3575858967,41
1,633,8176,3575858926,3575858968,42
1,633,8177,3575858926,3575858968,42
1,633,8178,3575858926,3575858970,44
1,633,8179,3575858926,3575858971,45
1,633,8180,3575858926,3575858974,48
1,633,8181,3575858926,3575858974,48
1,633,8182,3575858926,3575858974,48
1,634,8183,3575858981,3575858981,0
1,634,8184,3575858981,3575858981,0
1,634,8185,3575858981,3575858982,1
1,634,8186,3575858981,3575858984,3
1,634,8187,3575858981,3575858986,5
1,634,8188,3575858981,3575858987,6
1,634,8189,3575858981,3575858990,9
1,634,8190,3575858981,3575858991,10
1,634,8191,3575858981,3575858992,11
1,634,8192,3575858981,3575858992,11
1,634,8193,3575858981,3575858992,11
1,634,8194,3575858981,3575858992,11
1,634,8195,3575858981,3575858993,12
1,634,8196,3575858981,3575858997,16
1,634,8197,3575858981,3575858997,16
1,634,8198,3575858981,3575858999,18
1,634,8199,3575858981,3575859004,23
1,634,8200,3575858981,3575859006,25
1,634,8201,3575858981,3575859007,26
1,634,8202,3575858981,3575859008,27
1,634,8203,3575858981,3575859009,28
1,634,8204,3575858981,3575859010,29
1,634,8205,3575858981,3575859013,32
1,634,8206,3575858981,3575859013,32
1,634,8207,3575858981,3575859013,32
1,634,8208,3575858981,3575859015,34
1,634,8209,3575858981,3575859016,35
1,634,8210,3575858981,3575859016,35
1,634,8211,3575858981,3575859017,36
1,634,8212,3575858981,3575859018,37
1,634,8213,3575858981,3575859018,37
1,634,8214,3575858981,3575859019,38
1,634,8215,3575858981,3575859024,43
1,634,8216,3575858981,3575859025,44
1,634,8217,3575858981,3575859025,44
1,634,8218,3575858981,3575859025,44
1,634,8219,3575858981,3575859026,45
1,634,8220,3575858981,3575859028,47
1,634,8221,3575858981,3575859030,49
1,635,8222,3575859035,3575859035,0
1,635,8223,3575859035,3575859035,0
1,635,8224,3575859035,3575859035,0
1,635,8225,3575859035,3575859035,0
1,635,8226,3575859035,3575859035,0
1,635,8227,3575859035,3575859039,4
1,635,8228,3575859035,3575859039,4
1,635,8229,3575859035,3575859041,6
1,635,8230,3575859035,3575859043,8
1,635,8231,3575859035,3575859044,9
1,635,8232,3575859035,3575859048,13
1,635,8233,3575859035,3575859049,14
1,635,8234,3575859035,3575859050,15
1,635,8235,3575859035,3575859051,16
1,635,8236,3575859035,3575859052,17
1,635,8237,3575859035,3575859054,19
1,635,8238,3575859035,3575859054,19
1,635,8239,3575859035,3575859055,20
1,635,8240,3575859035,3575859060,25
1,635,8241,3575859035,3575859063,28
1,635,8242,3575859035,3575859065,30
1,635,8243,3575859035,3575859067,32
1,635,8244,3575859035,3575859068,33
1,635,8245,3575859035,3575859081,46
1,635,8246,3575859035,3575859081,46
1,635,8247,3575859035,3575859081,46
1,635,8248,3575859035,3575859082,47
1,635,8249,3575859035,3575859085,50
1,636,8250,3575859090,3575859090,0
1,636,8251,3575859090,3575859090,0
1,636,8252,3575859090,3575859090,0
1,636,8253,3575859090,3575859091,1
1,636,8254,3575859090,3575859092,2
1,636,8255,3575859090,3575859093,3
1,636,8256,3575859090,3575859093,3
1,636,8257,3575859090,3575859094,4
1,636,8258,3575859090,3575859098,8
1,636,8259,3575859090,3575859101,11
1,636,8260,3575859090,3575859105,15
1,636,8261,3575859090,3575859106,16
1,636,8262,3575859090,3575859107,17
1,636,8263,3575859090,3575859109,19
1,636,8264,3575859090,3575859113,23
1,636,8265,3575859090,3575859116,26
1,636,8266,3575859090,3575859120,30
1,636,8267,3575859090,3575859122,32
1,636,8268,3575859090,3575859126,36
1,636,8269,3575859090,3575859127,37
1,636,8270,3575859090,3575859129,39
1,636,8271,3575859090,3575859130,40
1,636,8272,3575859090,3575859131,41
1,636,8273,3575859090,3575859131,41
1,636,8274,3575859090,3575859131,41
1,636,8275,3575859090,3575859132,42
1,636,8276,3575859090,3575859133,43
1,636,8277,3575859090,3575859135,45
1,636,8278,3575859090,3575859140,50
1,637,8279,3575859145,3575859145,0
1,637,8280,3575859145,3575859145,0
1,637,8281,3575859145,3575859145,0
1,637,8282,3575859145,3575859152,7
1,637,8283,3575859145,3575859153,8
1,637,8284,3575859145,3575859154,9
1,637,8285,3575859145,3575859155,10
1,637,8286,3575859145,3575859158,13
1,637,8287,3575859145,3575859160,15
1,637,8288,3575859145,3575859162,17
1,637,8289,3575859145,3575859163,18
1,637,8290,3575859145,3575859164,19
1,637,8291,3575859145,3575859165,20
1,637,8292,3575859145,3575859168,23
1,637,8293,3575859145,3575859168,23
1,637,8294,3575859145,3575859169,24
1,637,8295,3575859145,3575859170,25
1,637,8296,3575859145,3575859171,26
1,637,8297,3575859145,3575859174,29
1,637,8298,3575859145,3575859177,32
1,637,8299,3575859145,3575859179,34
1,637,8300,3575859145,3575859182,37
1,637,8301,3575859145,3575859182,37
1,637,8302,3575859145,3575859184,39
1,637,8303,3575859145,3575859186,41
1,637,8304,3575859145,3575859187,42
1,637,8305,3575859145,3575859190,45
1,637,8306,3575859145,3575859191,46
1,637,8307,3575859145,3575859192,47
1,637,8308,3575859145,3575859192,47
1,637,8309,3575859145,3575859193,48
1,637,8310,3575859145,3575859193,48
1,637,8311,3575859145,3575859193,48
1,638,8312,3575859200,3575859200,0
1,638,8313,3575859200,3575859200,0
1,638,8314,3575859200,3575859200,0
1,638,8315,3575859200,3575859209,9
1,638,8316,3575859200,3575859210,10
1,638,8317,3575859200,3575859210,10
1,638,8318,3575859200,3575859213,13
1,638,8319,3575859200,3575859213,13
1,638,8320,3575859200,3575859213,13
1,638,8321,3575859200,3575859215,15
1,638,8322,3575859200,3575859216,16
1,638,8323,3575859200,3575859216,16
1,638,8324,3575859200,3575859216,16
1,638,8325,3575859200,3575859218,18
1,638,8326,3575859200,3575859218,18
1,638,8327,3575859200,3575859219,19
1,638,8328,3575859200,3575859224,24
1,638,8329,3575859200,3575859225,25
1,638,8330,3575859200,3575859226,26
1,638,8331,3575859200,3575859226,26
1,638,8332,3575859200,3575859229,29
1,638,8333,3575859200,3575859230,30
1,638,8334,3575859200,3575859231,31
1,638,8335,3575859200,3575859232,32
1,638,8336,3575859200,3575859233,33
1,638,8337,3575859200,3575859234,34
1,638,8338,3575859200,3575859235,35
1,638,8339,3575859200,3575859235,35
1,638,8340,3575859200,3575859239,39
1,638,8341,3575859200,3575859241,41
1,638,8342,3575859200,3575859243,43
1,638,8343,3575859200,3575859245,45
1,638,8344,3575859200,3575859250,50
1,639,8345,3575859255,3575859255,0
1,639,8346,3575859255,3575859255,0
1,639,8347,3575859255,3575859255,0
1,639,8348,3575859255,3575859255,0
1,639,8349,3575859255,3575859255,0
1,639,8350,3575859255,3575859255,0
1,639,8351,3575859255,3575859261,6
1,639,8352,3575859255,3575859263,8
1,639,8353,3575859255,3575859266,11
1,639,8354,3575859255,3575859267,12
1,639,8355,3575859255,3575859268,13
1,639,8356,3575859255,3575859281,26
1,639,8357,3575859255,3575859281,26
1,639,8358,3575859255,3575859281,26
1,639,8359,3575859255,3575859282,27
1,639,8360,3575859255,3575859285,30
1,639,8361,3575859255,3575859286,31
1,639,8362,3575859255,3575859288,33
1,639,8363,3575859255,3575859288,33
1,639,8364,3575859255,3575859291,36
1,639,8365,3575859255,3575859292,37
1,639,8366,3575859255,3575859293,38
1,639,8367,3575859255,3575859293,38
1,639,8368,3575859255,3575859295,40
1,639,8369,3575859255,3575859297,42
1,639,8370,3575859255,3575859301,46
1,639,8371,3575859255,3575859305,50
1,640,8372,3575859310,3575859310,0
1,640,8373,3575859310,3575859310,0
1,640,8374,3575859310,3575859310,0
1,640,8375,3575859310,3575859314,4
1,640,8376,3575859310,3575859315,5
1,640,8377,3575859310,3575859321,11
1,640,8378,3575859310,3575859327,17
1,640,8379,3575859310,3575859328,18
1,640,8380,3575859310,3575859330,20
1,640,8381,3575859310,3575859330,20
1,640,8382,3575859310,3575859330,20
1,640,8383,3575859310,3575859331,21
1,640,8384,3575859310,3575859331,21
1,640,8385,3575859310,3575859332,22
1,640,8386,3575859310,3575859333,23
1,640,8387,3575859310,3575859333,23
1,640,8388,3575859310,3575859335,25
1,640,8389,3575859310,3575859340,30
1,640,8390,3575859310,3575859344,34
1,640,8391,3575859310,3575859344,34
1,640,8392,3575859310,3575859346,36
1,640,8393,3575859310,3575859352,42
1,640,8394,3575859310,3575859353,43
1,640,8395,3575859310,3575859355,45
1,640,8396,3575859310,3575859355,45
1,640,8397,3575859310,3575859355,45
1,640,8398,3575859310,3575859357,47
1,640,8399,3575859310,3575859360,50
1,641,8400,3575859365,3575859365,0
1,641,8401,3575859365,3575859365,0
1,641,8402,3575859365,3575859365,0
1,641,8403,3575859365,3575859365,0
1,641,8404,3575859365,3575859367,2
1,641,8405,3575859365,3575859368,3
1,641,8406,3575859365,3575859369,4
1,641,8407,3575859365,3575859370,5
1,641,8408,3575859365,3575859371,6
1,641,8409,3575859365,3575859374,9
1,641,8410,3575859365,3575859375,10
1,641,8411,3575859365,3575859376,11
1,641,8412,3575859365,3575859379,14
1,641,8413,3575859365,3575859382,17
1,641,8414,3575859365,3575859382,17
1,641,8415,3575859365,3575859385,20
1,641,8416,3575859365,3575859387,22
1,641,8417,3575859365,3575859387,22
1,641,8418,3575859365,3575859390,25
1,641,8419,3575859365,3575859391,26
1,641,8420,3575859365,3575859392,27
1,641,8421,3575859365,3575859393,28
1,641,8422,3575859365,3575859393,28
1,641,8423,3575859365,3575859393,28
1,641,8424,3575859365,3575859396,31
1,641,8425,3575859365,3575859399,34
1,641,8426,3575859365,3575859408,43
1,641,8427,3575859365,3575859410,45
1,641,8428,3575859365,3575859411,46
1,641,8429,3575859365,3575859412,47
1,641,8430,3575859365,3575859414,49
1,641,8431,3575859365,3575859414,49
1,642,8432,3575859419,3575859419,0
1,642,8433,3575859419,3575859419,0
1,642,8434,3575859419,3575859419,0
1,642,8435,3575859419,3575859419,0
1,642,8436,3575859419,3575859419,0
1,642,8437,3575859419,3575859419,0
1,642,8438,3575859419,3575859420,1
1,642,8439,3575859419,3575859425,6
1,642,8440,3575859419,3575859425,6
1,642,8441,3575859419,3575859425,6
1,642,8442,3575859419,3575859426,7
1,642,8443,3575859419,3575859426,7
1,642,8444,3575859419,3575859428,9
1,642,8445,3575859419,3575859430,11
1,642,8446,3575859419,3575859431,12
1,642,8447,3575859419,3575859431,12
1,642,8448,3575859419,3575859434,15
1,642,8449,3575859419,3575859434,15
1,642,8450,3575859419,3575859435,16
1,642,8451,3575859419,3575859436,17
1,642,8452,3575859419,3575859439,20
1,642,8453,3575859419,3575859441,22
1,642,8454,3575859419,3575859443,24
1,642,8455,3575859419,3575859444,25
1,642,8456,3575859419,3575859450,31
1,642,8457,3575859419,3575859451,32
1,642,8458,3575859419,3575859452,33
1,642,8459,3575859419,3575859452,33
1,642,8460,3575859419,3575859454,35
1,642,8461,3575859419,3575859454,35
1,642,8462,3575859419,3575859455,36
1,642,8463,3575859419,3575859461,42
1,642,8464,3575859419,3575859463,44
1,642,8465,3575859419,3575859465,46
1,642,8466,3575859419,3575859467,48
1,642,8467,3575859419,3575859467,48
1,642,8468,3575859419,3575859469,50
1,643,8469,3575859476,3575859479,3
1,643,8470,3575859476,3575859482,6
1,643,8471,3575859476,3575859483,7
1,643,8472,3575859476,3575859486,10
1,643,8473,3575859476,3575859486,10
1,643,8474,3575859476,3575859486,10
1,643,8475,3575859476,3575859487,11
1,643,8476,3575859476,3575859492,16
1,643,8477,3575859476,3575859492,16
1,643,8478,3575859476,3575859492,16
1,643,8479,3575859476,3575859493,17
1,643,8480,3575859476,3575859495,19
1,643,8481,3575859476,3575859497,21
1,643,8482,3575859476,3575859497,21
1,643,8483,3575859476,3575859501,25
1,643,8484,3575859476,3575859505,29
1,643,8485,3575859476,3575859505,29
1,643,8486,3575859476,3575859508,32
1,643,8487,3575859476,3575859510,34
1,643,8488,3575859476,3575859514,38
1,643,8489,3575859476,3575859515,39
1,643,8490,3575859476,3575859521,45
1,643,8491,3575859476,3575859526,50
1,644,8492,3575859532,3575859532,0
1,644,8493,3575859532,3575859532,0
1,644,8494,3575859532,3575859532,0
1,644,8495,3575859532,3575859532,0
1,644,8496,3575859532,3575859532,0
1,644,8497,3575859532,3575859532,0
1,644,8498,3575859532,3575859533,1
1,644,8499,3575859532,3575859534,2
1,644,8500,3575859532,3575859539,7
1,644,8501,3575859532,3575859543,11
1,644,8502,3575859532,3575859544,12
1,644,8503,3575859532,3575859544,12
1,644,8504,3575859532,3575859551,19
1,644,8505,3575859532,3575859553,21
1,644,8506,3575859532,3575859554,22
1,644,8507,3575859532,3575859554,22
1,644,8508,3575859532,3575859554,22
1,644,8509,3575859532,3575859557,25
1,644,8510,3575859532,3575859557,25
1,644,8511,3575859532,3575859560,28
1,644,8512,3575859532,3575859561,29
1,644,8513,3575859532,3575859562,30
1,644,8514,3575859532,3575859563,31
1,644,8515,3575859532,3575859564,32
1,644,8516,3575859532,3575859567,35
1,644,8517,3575859532,3575859568,36
1,644,8518,3575859532,3575859569,37
1,644,8519,3575859532,3575859570,38
1,644,8520,3575859532,3575859574,42
1,644,8521,3575859532,3575859574,42
1,644,8522,3575859532,3575859579,47
1,644,8523,3575859532,3575859580,48
1,645,8524,3575859587,3575859587,0
1,645,8525,3575859587,3575859587,0
1,645,8526,3575859587,3575859587,0
1,645,8527,3575859587,3575859590,3
1,645,8528,3575859587,3575859591,4
1,645,8529,3575859587,3575859591,4
1,645,8530,3575859587,3575859591,4
1,645,8531,3575859587,3575859592,5
1,645,8532,3575859587,3575859592,5
1,645,8533,3575859587,3575859592,5
1,645,8534,3575859587,3575859596,9
1,645,8535,3575859587,3575859599,12
1,645,8536,3575859587,3575859602,15
1,645,8537,3575859587,3575859607,20
1,645,8538,3575859587,3575859609,22
1,645,8539,3575859587,3575859610,23
1,645,8540,3575859587,3575859612,25
1,645,8541,3575859587,3575859613,26
1,645,8542,3575859587,3575859613,26
1,645,8543,3575859587,3575859615,28
1,645,8544,3575859587,3575859615,28
1,645,8545,3575859587,3575859615,28
1,645,8546,3575859587,3575859616,29
1,645,8547,3575859587,3575859617,30
1,645,8548,3575859587,3575859618,31
1,645,8549,3575859587,3575859619,32
1,645,8550,3575859587,3575859623,36
1,645,8551,3575859587,3575859625,38
1,645,8552,3575859587,3575859625,38
1,645,8553,3575859587,3575859625,38
1,645,8554,3575859587,3575859625,38
1,645,8555,3575859587,3575859627,40
1,645,8556,3575859587,3575859630,43
1,645,8557,3575859587,3575859631,44
1,645,8558,3575859587,3575859633,46
1,645,8559,3575859587,3575859634,47
1,645,8560,3575859587,3575859635,48
1,645,8561,3575859587,3575859635,48
1,646,8562,3575859642,3575859642,0
1,646,8563,3575859642,3575859642,0
1,646,8564,3575859642,3575859644,2
1,646,8565,3575859642,3575859649,7
1,646,8566,3575859642,3575859651,9
1,646,8567,3575859642,3575859651,9
1,646,8568,3575859642,3575859651,9
1,646,8569,3575859642,3575859653,11
1,646,8570,3575859642,3575859654,12
1,646,8571,3575859642,3575859655,13
1,646,8572,3575859642,3575859661,19
1,646,8573,3575859642,3575859662,20
1,646,8574,3575859642,3575859665,23
1,646,8575,3575859642,3575859666,24
1,646,8576,3575859642,3575859666,24
1,646,8577,3575859642,3575859667,25
1,646,8578,3575859642,3575859679,37
1,646,8579,3575859642,3575859681,39
1,646,8580,3575859642,3575859686,44
1,646,8581,3575859642,3575859687,45
1,646,8582,3575859642,3575859687,45
1,646,8583,3575859642,3575859687,45
1,646,8584,3575859642,3575859691,49
1,646,8585,3575859642,3575859692,50
1,647,8586,3575859696,3575859696,0
1,647,8587,3575859696,3575859696,0
1,647,8588,3575859696,3575859696,0
1,647,8589,3575859696,3575859697,1
1,647,8590,3575859696,3575859698,2
1,647,8591,3575859696,3575859701,5
1,647,8592,3575859696,3575859705,9
1,647,8593,3575859696,3575859707,11
1,647,8594,3575859696,3575859710,14
1,647,8595,3575859696,3575859714,18
1,647,8596,3575859696,3575859722,26
1,647,8597,3575859696,3575859722,26
1,647,8598,3575859696,3575859726,30
1,647,8599,3575859696,3575859727,31
1,647,8600,3575859696,3575859728,32
1,647,8601,3575859696,3575859729,33
1,647,8602,3575859696,3575859730,34
1,647,8603,3575859696,3575859731,35
1,647,8604,3575859696,3575859732,36
1,647,8605,3575859696,3575859732,36
1,647,8606,3575859696,3575859733,37
1,647,8607,3575859696,3575859734,38
1,647,8608,3575859696,3575859739,43
1,647,8609,3575859696,3575859743,47
1,647,8610,3575859696,3575859745,49
1,647,8611,3575859696,3575859745,49
1,648,8612,3575859753,3575859753,0
1,648,8613,3575859753,3575859753,0
1,648,8614,3575859753,3575859753,0
1,648,8615,3575859753,3575859754,1
1,648,8616,3575859753,3575859755,2
1,648,8617,3575859753,3575859757,4
1,648,8618,3575859753,3575859760,7
1,648,8619,3575859753,3575859761,8
1,648,8620,3575859753,3575859762,9
1,648,8621,3575859753,3575859762,9
1,648,8622,3575859753,3575859763,10
1,648,8623,3575859753,3575859764,11
1,648,8624,3575859753,3575859767,14
1,648,8625,3575859753,3575859768,15
1,648,8626,3575859753,3575859770,17
1,648,8627,3575859753,3575859771,18
1,648,8628,3575859753,3575859774,21
1,648,8629,3575859753,3575859775,22
1,648,8630,3575859753,3575859775,22
1,648,8631,3575859753,3575859775,22
1,648,8632,3575859753,3575859779,26
1,648,8633,3575859753,3575859781,28
1,648,8634,3575859753,3575859781,28
1,648,8635,3575859753,3575859785,32
1,648,8636,3575859753,3575859786,33
1,648,8637,3575859753,3575859787,34
1,648,8638,3575859753,3575859789,36
1,648,8639,3575859753,3575859791,38
1,648,8640,3575859753,3575859791,38
1,648,8641,3575859753,3575859791,38
1,648,8642,3575859753,3575859792,39
1,648,8643,3575859753,3575859792,39
1,648,8644,3575859753,3575859792,39
1,648,8645,3575859753,3575859796,43
1,648,8646,3575859753,3575859798,45
1,648,8647,3575859753,3575859798,45
1,648,8648,3575859753,3575859803,50
1,649,8649,3575859808,3575859808,0
1,649,8650,3575859808,3575859808,0
1,649,8651,3575859808,3575859809,1
1,649,8652,3575859808,3575859810,2
1,649,8653,3575859808,3575859813,5
1,649,8654,3575859808,3575859813,5
1,649,8655,3575859808,3575859814,6
1,649,8656,3575859808,3575859815,7
1,649,8657,3575859808,3575859816,8
1,649,8658,3575859808,3575859816,8
1,649,8659,3575859808,3575859816,8
1,649,8660,3575859808,3575859817,9
1,649,8661,3575859808,3575859818,10
1,649,8662,3575859808,3575859819,11
1,649,8663,3575859808,3575859823,15
1,649,8664,3575859808,3575859825,17
1,649,8665,3575859808,3575859825,17
1,649,8666,3575859808,3575859825,17
1,649,8667,3575859808,3575859825,17
1,649,8668,3575859808,3575859829,21
1,649,8669,3575859808,3575859830,22
1,649,8670,3575859808,3575859831,23
1,649,8671,3575859808,3575859833,25
1,649,8672,3575859808,3575859835,27
1,649,8673,3575859808,3575859835,27
1,649,8674,3575859808,3575859835,27
1,649,8675,3575859808,3575859838,30
1,649,8676,3575859808,3575859840,32
1,649,8677,3575859808,3575859842,34
1,649,8678,3575859808,3575859844,36
1,649,8679,3575859808,3575859849,41
1,649,8680,3575859808,3575859850,42
1,649,8681,3575859808,3575859851,43
1,649,8682,3575859808,3575859852,44
1,649,8683,3575859808,3575859853,45
1,649,8684,3575859808,3575859855,47
1,650,8685,3575859866,3575859866,0
1,650,8686,3575859866,3575859866,0
1,650,8687,3575859866,3575859866,0
1,650,8688,3575859866,3575859866,0
1,650,8689,3575859866,3575859866,0
1,650,8690,3575859866,3575859867,1
1,650,8691,3575859866,3575859880,14
1,650,8692,3575859866,3575859880,14
1,650,8693,3575859866,3575859881,15
1,650,8694,3575859866,3575859882,16
1,650,8695,3575859866,3575859884,18
1,650,8696,3575859866,3575859887,21
1,650,8697,3575859866,3575859887,21
1,650,8698,3575859866,3575859887,21
1,650,8699,3575859866,3575859888,22
1,650,8700,3575859866,3575859892,26
1,650,8701,3575859866,3575859892,26
1,650,8702,3575859866,3575859893,27
1,650,8703,3575859866,3575859895,29
1,650,8704,3575859866,3575859898,32
1,650,8705,3575859866,3575859901,35
1,650,8706,3575859866,3575859905,39
1,650,8707,3575859866,3575859907,41
1,650,8708,3575859866,3575859910,44
1,650,8709,3575859866,3575859913,47
1,651,8710,3575859922,3575859922,0
1,651,8711,3575859922,3575859922,0
1,651,8712,3575859922,3575859927,5
1,651,8713,3575859922,3575859927,5
1,651,8714,3575859922,3575859929,7
1,651,8715,3575859922,3575859930,8
1,651,8716,3575859922,3575859931,9
1,651,8717,3575859922,3575859931,9
1,651,8718,3575859922,3575859931,9
1,651,8719,3575859922,3575859933,11
1,651,8720,3575859922,3575859933,11
1,651,8721,3575859922,3575859934,12
1,651,8722,3575859922,3575859936,14
1,651,8723,3575859922,3575859939,17
1,651,8724,3575859922,3575859943,21
1,651,8725,3575859922,3575859945,23
1,651,8726,3575859922,3575859946,24
1,651,8727,3575859922,3575859951,29
1,651,8728,3575859922,3575859953,31
1,651,8729,3575859922,3575859953,31
1,651,8730,3575859922,3575859954,32
1,651,8731,3575859922,3575859955,33
1,651,8732,3575859922,3575859958,36
1,651,8733,3575859922,3575859961,39
1,651,8734,3575859922,3575859961,39
1,651,8735,3575859922,3575859962,40
1,651,8736,3575859922,3575859962,40
1,651,8737,3575859922,3575859963,41
1,651,8738,3575859922,3575859965,43
1,651,8739,3575859922,3575859968,46
1,651,8740,3575859922,3575859969,47
1,651,8741,3575859922,3575859970,48
1,651,8742,3575859922,3575859972,50
1,652,8743,3575859977,3575859977,0
1,652,8744,3575859977,3575859977,0
1,652,8745,3575859977,3575859979,2
1,652,8746,3575859977,3575859981,4
1,652,8747,3575859977,3575859982,5
1,652,8748,3575859977,3575859984,7
1,652,8749,3575859977,3575859986,9
1,652,8750,3575859977,3575859987,10
1,652,8751,3575859977,3575859990,13
1,652,8752,3575859977,3575859991,14
1,652,8753,3575859977,3575859991,14
1,652,8754,3575859977,3575859992,15
1,652,8755,3575859977,3575859992,15
1,652,8756,3575859977,3575859993,16
1,652,8757,3575859977,3575859993,16
1,652,8758,3575859977,3575859996,19
1,652,8759,3575859977,3575859999,22
1,652,8760,3575859977,3575859999,22
1,652,8761,3575859977,3575860002,25
1,652,8762,3575859977,3575860008,31
1,652,8763,3575859977,3575860009,32
1,652,8764,3575859977,3575860010,33
1,652,8765,3575859977,3575860010,33
1,652,8766,3575859977,3575860013,36
1,652,8767,3575859977,3575860013,36
1,652,8768,3575859977,3575860014,37
1,652,8769,3575859977,3575860015,38
1,652,8770,3575859977,3575860015,38
1,652,8771,3575859977,3575860016,39
1,652,8772,3575859977,3575860016,39
1,652,8773,3575859977,3575860016,39
1,652,8774,3575859977,3575860018,41
1,652,8775,3575859977,3575860019,42
1,652,8776,3575859977,3575860019,42
1,652,8777,3575859977,3575860023,46
1,652,8778,3575859977,3575860024,47
1,652,8779,3575859977,3575860024,47
1,652,8780,3575859977,3575860025,48
1,652,8781,3575859977,3575860025,48
1,653,8782,3575860033,3575860033,0
1,653,8783,3575860033,3575860033,0
1,653,8784,3575860033,3575860033,0
1,653,8785,3575860033,3575860033,0
1,653,8786,3575860033,3575860033,0
1,653,8787,3575860033,3575860035,2
1,653,8788,3575860033,3575860036,3
1,653,8789,3575860033,3575860040,7
1,653,8790,3575860033,3575860042,9
1,653,8791,3575860033,3575860045,12
1,653,8792,3575860033,3575860049,16
1,653,8793,3575860033,3575860051,18
1,653,8794,3575860033,3575860052,19
1,653,8795,3575860033,3575860052,19
1,653,8796,3575860033,3575860054,21
1,653,8797,3575860033,3575860055,22
1,653,8798,3575860033,3575860061,28
1,653,8799,3575860033,3575860063,30
1,653,8800,3575860033,3575860066,33
1,653,8801,3575860033,3575860068,35
1,653,8802,3575860033,3575860080,47
1,653,8803,3575860033,3575860080,47
1,653,8804,3575860033,3575860083,50
1,654,8805,3575860090,3575860090,0
1,654,8806,3575860090,3575860090,0
1,654,8807,3575860090,3575860090,0
1,654,8808,3575860090,3575860090,0
1,654,8809,3575860090,3575860092,2
1,654,8810,3575860090,3575860094,4
1,654,8811,3575860090,3575860096,6
1,654,8812,3575860090,3575860099,9
1,654,8813,3575860090,3575860101,11
1,654,8814,3575860090,3575860105,15
1,654,8815,3575860090,3575860110,20
1,654,8816,3575860090,3575860113,23
1,654,8817,3575860090,3575860122,32
1,654,8818,3575860090,3575860128,38
1,654,8819,3575860090,3575860128,38
1,654,8820,3575860090,3575860130,40
1,654,8821,3575860090,3575860131,41
1,654,8822,3575860090,3575860131,41
1,654,8823,3575860090,3575860132,42
1,654,8824,3575860090,3575860132,42
1,654,8825,3575860090,3575860134,44
1,654,8826,3575860090,3575860134,44
1,654,8827,3575860090,3575860135,45
1,654,8828,3575860090,3575860136,46
1,655,8829,3575860145,3575860145,0
1,655,8830,3575860145,3575860145,0
1,655,8831,3575860145,3575860146,1
1,655,8832,3575860145,3575860150,5
1,655,8833,3575860145,3575860153,8
1,655,8834,3575860145,3575860154,9
1,655,8835,3575860145,3575860154,9
1,655,8836,3575860145,3575860156,11
1,655,8837,3575860145,3575860158,13
1,655,8838,3575860145,3575860161,16
1,655,8839,3575860145,3575860161,16
1,655,8840,3575860145,3575860162,17
1,655,8841,3575860145,3575860163,18
1,655,8842,3575860145,3575860164,19
1,655,8843,3575860145,3575860165,20
1,655,8844,3575860145,3575860168,23
1,655,8845,3575860145,3575860168,23
1,655,8846,3575860145,3575860171,26
1,655,8847,3575860145,3575860173,28
1,655,8848,3575860145,3575860174,29
1,655,8849,3575860145,3575860175,30
1,655,8850,3575860145,3575860175,30
1,655,8851,3575860145,3575860176,31
1,655,8852,3575860145,3575860180,35
1,655,8853,3575860145,3575860181,36
1,655,8854,3575860145,3575860182,37
1,655,8855,3575860145,3575860185,40
1,655,8856,3575860145,3575860187,42
1,655,8857,3575860145,3575860187,42
1,655,8858,3575860145,3575860190,45
1,655,8859,3575860145,3575860191,46
1,655,8860,3575860145,3575860191,46
1,655,8861,3575860145,3575860192,47
1,655,8862,3575860145,3575860192,47
1,655,8863,3575860145,3575860192,47
1,655,8864,3575860145,3575860192,47
1,656,8865,3575860201,3575860201,0
1,656,8866,3575860201,3575860201,0
1,656,8867,3575860201,3575860201,0
1,656,8868,3575860201,3575860202,1
1,656,8869,3575860201,3575860207,6
1,656,8870,3575860201,3575860208,7
1,656,8871,3575860201,3575860210,9
1,656,8872,3575860201,3575860210,9
1,656,8873,3575860201,3575860211,10
1,656,8874,3575860201,3575860213,12
1,656,8875,3575860201,3575860214,13
1,656,8876,3575860201,3575860215,14
1,656,8877,3575860201,3575860215,14
1,656,8878,3575860201,3575860216,15
1,656,8879,3575860201,3575860216,15
1,656,8880,3575860201,3575860217,16
1,656,8881,3575860201,3575860218,17
1,656,8882,3575860201,3575860219,18
1,656,8883,3575860201,3575860220,19
1,656,8884,3575860201,3575860224,23
1,656,8885,3575860201,3575860225,24
1,656,8886,3575860201,3575860225,24
1,656,8887,3575860201,3575860225,24
1,656,8888,3575860201,3575860225,24
1,656,8889,3575860201,3575860229,28
1,656,8890,3575860201,3575860230,29
1,656,8891,3575860201,3575860231,30
1,656,8892,3575860201,3575860232,31
1,656,8893,3575860201,3575860235,34
1,656,8894,3575860201,3575860236,35
1,656,8895,3575860201,3575860239,38
1,656,8896,3575860201,3575860240,39
1,656,8897,3575860201,3575860242,41
1,656,8898,3575860201,3575860245,44
1,656,8899,3575860201,3575860247,46
1,656,8900,3575860201,3575860249,48
1,656,8901,3575860201,3575860251,50
1,657,8902,3575860256,3575860256,0
1,657,8903,3575860256,3575860256,0
1,657,8904,3575860256,3575860256,0
1,657,8905,3575860256,3575860256,0
1,657,8906,3575860256,3575860261,5
1,657,8907,3575860256,3575860262,6
1,657,8908,3575860256,3575860265,9
1,657,8909,3575860256,3575860267,11
1,657,8910,3575860256,3575860267,11
1,657,8911,3575860256,3575860268,12
1,657,8912,3575860256,3575860280,24
1,657,8913,3575860256,3575860280,24
1,657,8914,3575860256,3575860281,25
1,657,8915,3575860256,3575860283,27
1,657,8916,3575860256,3575860286,30
1,657,8917,3575860256,3575860287,31
1,657,8918,3575860256,3575860287,31
1,657,8919,3575860256,3575860287,31
1,657,8920,3575860256,3575860288,32
1,657,8921,3575860256,3575860292,36
1,657,8922,3575860256,3575860293,37
1,657,8923,3575860256,3575860293,37
1,657,8924,3575860256,3575860293,37
1,657,8925,3575860256,3575860295,39
1,657,8926,3575860256,3575860299,43
1,657,8927,3575860256,3575860301,45
1,657,8928,3575860256,3575860305,49
1,657,8929,3575860256,3575860305,49
1,658,8930,3575860309,3575860310,1
1,658,8931,3575860309,3575860313,4
1,658,8932,3575860309,3575860315,6
1,658,8933,3575860309,3575860322,13
1,658,8934,3575860309,3575860322,13
1,658,8935,3575860309,3575860326,17
1,658,8936,3575860309,3575860329,20
1,658,8937,3575860309,3575860330,21
1,658,8938,3575860309,3575860331,22
1,658,8939,3575860309,3575860331,22
1,658,8940,3575860309,3575860331,22
1,658,8941,3575860309,3575860332,23
1,658,8942,3575860309,3575860334,25
1,658,8943,3575860309,3575860334,25
1,658,8944,3575860309,3575860334,25
1,658,8945,3575860309,3575860336,27
1,658,8946,3575860309,3575860340,31
1,658,8947,3575860309,3575860344,35
1,658,8948,3575860309,3575860346,37
1,658,8949,3575860309,3575860351,42
1,658,8950,3575860309,3575860353,44
1,658,8951,3575860309,3575860353,44
1,658,8952,3575860309,3575860354,45
1,658,8953,3575860309,3575860356,47
1,658,8954,3575860309,3575860357,48
1,659,8955,3575860365,3575860365,0
1,659,8956,3575860365,3575860365,0
1,659,8957,3575860365,3575860365,0
1,659,8958,3575860365,3575860365,0
1,659,8959,3575860365,3575860365,0
1,659,8960,3575860365,3575860365,0
1,659,8961,3575860365,3575860368,3
1,659,8962,3575860365,3575860369,4
1,659,8963,3575860365,3575860371,6
1,659,8964,3575860365,3575860373,8
1,659,8965,3575860365,3575860374,9
1,659,8966,3575860365,3575860376,11
1,659,8967,3575860365,3575860380,15
1,659,8968,3575860365,3575860381,16
1,659,8969,3575860365,3575860382,17
1,659,8970,3575860365,3575860385,20
1,659,8971,3575860365,3575860386,21
1,659,8972,3575860365,3575860387,22
1,659,8973,3575860365,3575860390,25
1,659,8974,3575860365,3575860391,26
1,659,8975,3575860365,3575860391,26
1,659,8976,3575860365,3575860392,27
1,659,8977,3575860365,3575860393,28
1,659,8978,3575860365,3575860393,28
1,659,8979,3575860365,3575860393,28
1,659,8980,3575860365,3575860396,31
1,659,8981,3575860365,3575860400,35
1,659,8982,3575860365,3575860401,36
1,659,8983,3575860365,3575860403,38
1,659,8984,3575860365,3575860408,43
1,659,8985,3575860365,3575860410,45
1,659,8986,3575860365,3575860411,46
1,659,8987,3575860365,3575860411,46
1,659,8988,3575860365,3575860414,49
1,659,8989,3575860365,3575860414,49
1,659,8990,3575860365,3575860415,50
1,660,8991,3575860420,3575860420,0
1,660,8992,3575860420,3575860420,0
1,660,8993,3575860420,3575860420,0
1,660,8994,3575860420,3575860420,0
1,660,8995,3575860420,3575860420,0
1,660,8996,3575860420,3575860420,0
1,660,8997,3575860420,3575860420,0
1,660,8998,3575860420,3575860422,2
1,660,8999,3575860420,3575860423,3
1,660,9000,3575860420,3575860425,5
1,660,9001,3575860420,3575860425,5
1,660,9002,3575860420,3575860426,6
1,660,9003,3575860420,3575860426,6
1,660,9004,3575860420,3575860429,9
1,660,9005,3575860420,3575860430,10
1,660,9006,3575860420,3575860431,11
1,660,9007,3575860420,3575860433,13
1,660,9008,3575860420,3575860436,16
1,660,9009,3575860420,3575860436,16
1,660,9010,3575860420,3575860439,19
1,660,9011,3575860420,3575860442,22
1,660,9012,3575860420,3575860444,24
1,660,9013,3575860420,3575860447,27
1,660,9014,3575860420,3575860449,29
1,660,9015,3575860420,3575860451,31
1,660,9016,3575860420,3575860451,31
1,660,9017,3575860420,3575860452,32
1,660,9018,3575860420,3575860453,33
1,660,9019,3575860420,3575860454,34
1,660,9020,3575860420,3575860455,35
1,660,9021,3575860420,3575860462,42
1,660,9022,3575860420,3575860464,44
1,660,9023,3575860420,3575860466,46
1,660,9024,3575860420,3575860467,47
1,660,9025,3575860420,3575860467,47
1,661,9026,3575860475,3575860479,4
1,661,9027,3575860475,3575860480,5
1,661,9028,3575860475,3575860480,5
1,661,9029,3575860475,3575860482,7
1,661,9030,3575860475,3575860486,11
1,661,9031,3575860475,3575860486,11
1,661,9032,3575860475,3575860486,11
1,661,9033,3575860475,3575860487,12
1,661,9034,3575860475,3575860492,17
1,661,9035,3575860475,3575860492,17
1,661,9036,3575860475,3575860492,17
1,661,9037,3575860475,3575860493,18
1,661,9038,3575860475,3575860496,21
1,661,9039,3575860475,3575860496,21
1,661,9040,3575860475,3575860498,23
1,661,9041,3575860475,3575860499,24
1,661,9042,3575860475,3575860504,29
1,661,9043,3575860475,3575860509,34
1,661,9044,3575860475,3575860512,37
1,661,9045,3575860475,3575860515,40
1,661,9046,3575860475,3575860521,46
1,662,9047,3575860531,3575860531,0
1,662,9048,3575860531,3575860531,0
1,662,9049,3575860531,3575860531,0
1,662,9050,3575860531,3575860531,0
1,662,9051,3575860531,3575860531,0
1,662,9052,3575860531,3575860531,0
1,662,9053,3575860531,3575860531,0
1,662,9054,3575860531,3575860532,1
1,662,9055,3575860531,3575860533,2
1,662,9056,3575860531,3575860534,3
1,662,9057,3575860531,3575860534,3
1,662,9058,3575860531,3575860535,4
1,662,9059,3575860531,3575860539,8
1,662,9060,3575860531,3575860543,12
1,662,9061,3575860531,3575860544,13
1,662,9062,3575860531,3575860546,15
1,662,9063,3575860531,3575860549,18
1,662,9064,3575860531,3575860553,22
1,662,9065,3575860531,3575860553,22
1,662,9066,3575860531,3575860553,22
1,662,9067,3575860531,3575860556,25
1,662,9068,3575860531,3575860560,29
1,662,9069,3575860531,3575860562,31
1,662,9070,3575860531,3575860562,31
1,662,9071,3575860531,3575860562,31
1,662,9072,3575860531,3575860563,32
1,662,9073,3575860531,3575860563,32
1,662,9074,3575860531,3575860564,33
1,662,9075,3575860531,3575860567,36
1,662,9076,3575860531,3575860567,36
1,662,9077,3575860531,3575860570,39
1,662,9078,3575860531,3575860573,42
1,662,9079,3575860531,3575860574,43
1,662,9080,3575860531,3575860574,43
1,662,9081,3575860531,3575860575,44
1,662,9082,3575860531,3575860575,44
1,662,9083,3575860531,3575860580,49
1,662,9084,3575860531,3575860580,49
1,662,9085,3575860531,3575860581,50
1,663,9086,3575860587,3575860587,0
1,663,9087,3575860587,3575860587,0
1,663,9088,3575860587,3575860587,0
1,663,9089,3575860587,3575860590,3
1,663,9090,3575860587,3575860590,3
1,663,9091,3575860587,3575860590,3
1,663,9092,3575860587,3575860591,4
1,663,9093,3575860587,3575860591,4
1,663,9094,3575860587,3575860592,5
1,663,9095,3575860587,3575860592,5
1,663,9096,3575860587,3575860595,8
1,663,9097,3575860587,3575860599,12
1,663,9098,3575860587,3575860600,13
1,663,9099,3575860587,3575860601,14
1,663,9100,3575860587,3575860607,20
1,663,9101,3575860587,3575860608,21
1,663,9102,3575860587,3575860609,22
1,663,9103,3575860587,3575860610,23
1,663,9104,3575860587,3575860611,24
1,663,9105,3575860587,3575860612,25
1,663,9106,3575860587,3575860612,25
1,663,9107,3575860587,3575860614,27
1,663,9108,3575860587,3575860614,27
1,663,9109,3575860587,3575860615,28
1,663,9110,3575860587,3575860615,28
1,663,9111,3575860587,3575860617,30
1,663,9112,3575860587,3575860618,31
1,663,9113,3575860587,3575860618,31
1,663,9114,3575860587,3575860618,31
1,663,9115,3575860587,3575860619,32
1,663,9116,3575860587,3575860619,32
1,663,9117,3575860587,3575860621,34
1,663,9118,3575860587,3575860622,35
1,663,9119,3575860587,3575860624,37
1,663,9120,3575860587,3575860625,38
1,663,9121,3575860587,3575860625,38
1,663,9122,3575860587,3575860626,39
1,663,9123,3575860587,3575860626,39
1,663,9124,3575860587,3575860629,42
1,663,9125,3575860587,3575860630,43
1,663,9126,3575860587,3575860632,45
1,663,9127,3575860587,3575860635,48
1,663,9128,3575860587,3575860637,50
1,664,9129,3575860644,3575860644,0
1,664,9130,3575860644,3575860644,0
1,664,9131,3575860644,3575860644,0
1,664,9132,3575860644,3575860644,0
1,664,9133,3575860644,3575860646,2
1,664,9134,3575860644,3575860648,4
1,664,9135,3575860644,3575860649,5
1,664,9136,3575860644,3575860651,7
1,664,9137,3575860644,3575860651,7
1,664,9138,3575860644,3575860653,9
1,664,9139,3575860644,3575860653,9
1,664,9140,3575860644,3575860655,11
1,664,9141,3575860644,3575860661,17
1,664,9142,3575860644,3575860664,20
1,664,9143,3575860644,3575860665,21
1,664,9144,3575860644,3575860666,22
1,664,9145,3575860644,3575860667,23
1,664,9146,3575860644,3575860680,36
1,664,9147,3575860644,3575860680,36
1,664,9148,3575860644,3575860680,36
1,664,9149,3575860644,3575860683,39
1,664,9150,3575860644,3575860683,39
1,664,9151,3575860644,3575860686,42
1,664,9152,3575860644,3575860686,42
1,664,9153,3575860644,3575860687,43
1,664,9154,3575860644,3575860687,43
1,664,9155,3575860644,3575860692,48
1,664,9156,3575860644,3575860692,48
1,664,9157,3575860644,3575860693,49
1,664,9158,3575860644,3575860694,50
1,665,9159,3575860700,3575860700,0
1,665,9160,3575860700,3575860700,0
1,665,9161,3575860700,3575860700,0
1,665,9162,3575860700,3575860700,0
1,665,9163,3575860700,3575860700,0
1,665,9164,3575860700,3575860704,4
1,665,9165,3575860700,3575860704,4
1,665,9166,3575860700,3575860704,4
1,665,9167,3575860700,3575860706,6
1,665,9168,3575860700,3575860709,9
1,665,9169,3575860700,3575860713,13
1,665,9170,3575860700,3575860715,15
1,665,9171,3575860700,3575860721,21
1,665,9172,3575860700,3575860721,21
1,665,9173,3575860700,3575860725,25
1,665,9174,3575860700,3575860728,28
1,665,9175,3575860700,3575860730,30
1,665,9176,3575860700,3575860730,30
1,665,9177,3575860700,3575860730,30
1,665,9178,3575860700,3575860731,31
1,665,9179,3575860700,3575860731,31
1,665,9180,3575860700,3575860734,34
1,665,9181,3575860700,3575860735,35
1,665,9182,3575860700,3575860735,35
1,665,9183,3575860700,3575860735,35
1,665,9184,3575860700,3575860738,38
1,665,9185,3575860700,3575860743,43
1,665,9186,3575860700,3575860743,43
1,665,9187,3575860700,3575860744,44
1,665,9188,3575860700,3575860746,46
1,665,9189,3575860700,3575860750,50
1,666,9190,3575860756,3575860756,0
1,666,9191,3575860756,3575860756,0
1,666,9192,3575860756,3575860756,0
1,666,9193,3575860756,3575860756,0
1,666,9194,3575860756,3575860761,5
1,666,9195,3575860756,3575860762,6
1,666,9196,3575860756,3575860762,6
1,666,9197,3575860756,3575860762,6
1,666,9198,3575860756,3575860763,7
1,666,9199,3575860756,3575860764,8
1,666,9200,3575860756,3575860764,8
1,666,9201,3575860756,3575860766,10
1,666,9202,3575860756,3575860768,12
1,666,9203,3575860756,3575860768,12
1,666,9204,3575860756,3575860770,14
1,666,9205,3575860756,3575860773,17
1,666,9206,3575860756,3575860774,18
1,666,9207,3575860756,3575860775,19
1,666,9208,3575860756,3575860780,24
1,666,9209,3575860756,3575860781,25
1,666,9210,3575860756,3575860781,25
1,666,9211,3575860756,3575860782,26
1,666,9212,3575860756,3575860785,29
1,666,9213,3575860756,3575860786,30
1,666,9214,3575860756,3575860787,31
1,666,9215,3575860756,3575860790,34
1,666,9216,3575860756,3575860791,35
1,666,9217,3575860756,3575860791,35
1,666,9218,3575860756,3575860792,36
1,666,9219,3575860756,3575860792,36
1,666,9220,3575860756,3575860792,36
1,666,9221,3575860756,3575860793,37
1,666,9222,3575860756,3575860796,40
1,666,9223,3575860756,3575860799,43
1,666,9224,3575860756,3575860800,44
1,666,9225,3575860756,3575860802,46
1,667,9226,3575860813,3575860813,0
1,667,9227,3575860813,3575860813,0
1,667,9228,3575860813,3575860813,0
1,667,9229,3575860813,3575860813,0
1,667,9230,3575860813,3575860813,0
1,667,9231,3575860813,3575860813,0
1,667,9232,3575860813,3575860813,0
1,667,9233,3575860813,3575860814,1
1,667,9234,3575860813,3575860814,1
1,667,9235,3575860813,3575860815,2
1,667,9236,3575860813,3575860815,2
1,667,9237,3575860813,3575860817,4
1,667,9238,3575860813,3575860818,5
1,667,9239,3575860813,3575860818,5
1,667,9240,3575860813,3575860819,6
1,667,9241,3575860813,3575860819,6
1,667,9242,3575860813,3575860820,7
1,667,9243,3575860813,3575860821,8
1,667,9244,3575860813,3575860823,10
1,667,9245,3575860813,3575860824,11
1,667,9246,3575860813,3575860826,13
1,667,9247,3575860813,3575860826,13
1,667,9248,3575860813,3575860826,13
1,667,9249,3575860813,3575860827,14
1,667,9250,3575860813,3575860828,15
1,667,9251,3575860813,3575860829,16
1,667,9252,3575860813,3575860830,17
1,667,9253,3575860813,3575860830,17
1,667,9254,3575860813,3575860831,18
1,667,9255,3575860813,3575860832,19
1,667,9256,3575860813,3575860835,22
1,667,9257,3575860813,3575860836,23
1,667,9258,3575860813,3575860837,24
1,667,9259,3575860813,3575860839,26
1,667,9260,3575860813,3575860842,29
1,667,9261,3575860813,3575860846,33
1,667,9262,3575860813,3575860849,36
1,667,9263,3575860813,3575860850,37
1,667,9264,3575860813,3575860851,38
1,667,9265,3575860813,3575860852,39
1,667,9266,3575860813,3575860852,39
1,667,9267,3575860813,3575860853,40
1,667,9268,3575860813,3575860861,48
1,668,9269,3575860869,3575860869,0
1,668,9270,3575860869,3575860869,0
1,668,9271,3575860869,3575860869,0
1,668,9272,3575860869,3575860869,0
1,668,9273,3575860869,3575860869,0
1,668,9274,3575860869,3575860880,11
1,668,9275,3575860869,3575860880,11
1,668,9276,3575860869,3575860886,17
1,668,9277,3575860869,3575860887,18
1,668,9278,3575860869,3575860887,18
1,668,9279,3575860869,3575860892,23
1,668,9280,3575860869,3575860892,23
1,668,9281,3575860869,3575860893,24
1,668,9282,3575860869,3575860897,28
1,668,9283,3575860869,3575860898,29
1,668,9284,3575860869,3575860899,30
1,668,9285,3575860869,3575860904,35
1,668,9286,3575860869,3575860905,36
1,668,9287,3575860869,3575860905,36
1,668,9288,3575860869,3575860906,37
1,668,9289,3575860869,3575860908,39
1,668,9290,3575860869,3575860912,43
1,668,9291,3575860869,3575860915,46
1,669,9292,3575860924,3575860924,0
1,669,9293,3575860924,3575860926,2
1,669,9294,3575860924,3575860928,4
1,669,9295,3575860924,3575860930,6
1,669,9296,3575860924,3575860931,7
1,669,9297,3575860924,3575860931,7
1,669,9298,3575860924,3575860931,7
1,669,9299,3575860924,3575860932,8
1,669,9300,3575860924,3575860932,8
1,669,9301,3575860924,3575860933,9
1,669,9302,3575860924,3575860935,11
1,669,9303,3575860924,3575860935,11
1,669,9304,3575860924,3575860939,15
1,669,9305,3575860924,3575860943,19
1,669,9306,3575860924,3575860944,20
1,669,9307,3575860924,3575860945,21
1,669,9308,3575860924,3575860946,22
1,669,9309,3575860924,3575860951,27
1,669,9310,3575860924,3575860952,28
1,669,9311,3575860924,3575860953,29
1,669,9312,3575860924,3575860953,29
1,669,9313,3575860924,3575860957,33
1,669,9314,3575860924,3575860957,33
1,669,9315,3575860924,3575860961,37
1,669,9316,3575860924,3575860961,37
1,669,9317,3575860924,3575860962,38
1,669,9318,3575860924,3575860962,38
1,669,9319,3575860924,3575860963,39
1,669,9320,3575860924,3575860963,39
1,669,9321,3575860924,3575860965,41
1,669,9322,3575860924,3575860965,41
1,669,9323,3575860924,3575860967,43
1,669,9324,3575860924,3575860969,45
1,669,9325,3575860924,3575860972,48
1,669,9326,3575860924,3575860973,49
1,670,9327,3575860980,3575860980,0
1,670,9328,3575860980,3575860980,0
1,670,9329,3575860980,3575860980,0
1,670,9330,3575860980,3575860980,0
1,670,9331,3575860980,3575860981,1
1,670,9332,3575860980,3575860981,1
1,670,9333,3575860980,3575860981,1
1,670,9334,3575860980,3575860982,2
1,670,9335,3575860980,3575860982,2
1,670,9336,3575860980,3575860985,5
1,670,9337,3575860980,3575860985,5
1,670,9338,3575860980,3575860987,7
1,670,9339,3575860980,3575860990,10
1,670,9340,3575860980,3575860991,11
1,670,9341,3575860980,3575860991,11
1,670,9342,3575860980,3575860991,11
1,670,9343,3575860980,3575860992,12
1,670,9344,3575860980,3575860993,13
1,670,9345,3575860980,3575860993,13
1,670,9346,3575860980,3575860996,16
1,670,9347,3575860980,3575861001,21
1,670,9348,3575860980,3575861002,22
1,670,9349,3575860980,3575861008,28
1,670,9350,3575860980,3575861009,29
1,670,9351,3575860980,3575861011,31
1,670,9352,3575860980,3575861012,32
1,670,9353,3575860980,3575861013,33
1,670,9354,3575860980,3575861014,34
1,670,9355,3575860980,3575861014,34
1,670,9356,3575860980,3575861015,35
1,670,9357,3575860980,3575861016,36
1,670,9358,3575860980,3575861017,37
1,670,9359,3575860980,3575861018,38
1,670,9360,3575860980,3575861018,38
1,670,9361,3575860980,3575861019,39
1,670,9362,3575860980,3575861019,39
1,670,9363,3575860980,3575861021,41
1,670,9364,3575860980,3575861021,41
1,670,9365,3575860980,3575861024,44
1,670,9366,3575860980,3575861024,44
1,670,9367,3575860980,3575861026,46
1,670,9368,3575860980,3575861026,46
1,670,9369,3575860980,3575861027,47
1,670,9370,3575860980,3575861028,48
1,670,9371,3575860980,3575861029,49
1,670,9372,3575860980,3575861029,49
1,670,9373,3575860980,3575861030,50
1,671,9374,3575861036,3575861036,0
1,671,9375,3575861036,3575861036,0
1,671,9376,3575861036,3575861036,0
1,671,9377,3575861036,3575861036,0
1,671,9378,3575861036,3575861036,0
1,671,9379,3575861036,3575861037,1
1,671,9380,3575861036,3575861039,3
1,671,9381,3575861036,3575861039,3
1,671,9382,3575861036,3575861042,6
1,671,9383,3575861036,3575861045,9
1,671,9384,3575861036,3575861046,10
1,671,9385,3575861036,3575861049,13
1,671,9386,3575861036,3575861050,14
1,671,9387,3575861036,3575861052,16
1,671,9388,3575861036,3575861053,17
1,671,9389,3575861036,3575861053,17
1,671,9390,3575861036,3575861054,18
1,671,9391,3575861036,3575861062,26
1,671,9392,3575861036,3575861064,28
1,671,9393,3575861036,3575861066,30
1,671,9394,3575861036,3575861066,30
1,671,9395,3575861036,3575861066,30
1,671,9396,3575861036,3575861080,44
1,671,9397,3575861036,3575861080,44
1,671,9398,3575861036,3575861081,45
1,672,9399,3575861092,3575861092,0
1,672,9400,3575861092,3575861092,0
1,672,9401,3575861092,3575861092,0
1,672,9402,3575861092,3575861092,0
1,672,9403,3575861092,3575861092,0
1,672,9404,3575861092,3575861094,2
1,672,9405,3575861092,3575861097,5
1,672,9406,3575861092,3575861097,5
1,672,9407,3575861092,3575861100,8
1,672,9408,3575861092,3575861104,12
1,672,9409,3575861092,3575861105,13
1,672,9410,3575861092,3575861107,15
1,672,9411,3575861092,3575861109,17
1,672,9412,3575861092,3575861112,20
1,672,9413,3575861092,3575861115,23
1,672,9414,3575861092,3575861121,29
1,672,9415,3575861092,3575861121,29
1,672,9416,3575861092,3575861126,34
1,672,9417,3575861092,3575861128,36
1,672,9418,3575861092,3575861129,37
1,672,9419,3575861092,3575861130,38
1,672,9420,3575861092,3575861130,38
1,672,9421,3575861092,3575861130,38
1,672,9422,3575861092,3575861131,39
1,672,9423,3575861092,3575861131,39
1,672,9424,3575861092,3575861134,42
1,672,9425,3575861092,3575861136,44
1,672,9426,3575861092,3575861140,48
1,673,9427,3575861147,3575861147,0
1,673,9428,3575861147,3575861148,1
1,673,9429,3575861147,3575861148,1
1,673,9430,3575861147,3575861148,1
1,673,9431,3575861147,3575861151,4
1,673,9432,3575861147,3575861153,6
1,673,9433,3575861147,3575861153,6
1,673,9434,3575861147,3575861154,7
1,673,9435,3575861147,3575861157,10
1,673,9436,3575861147,3575861161,14
1,673,9437,3575861147,3575861162,15
1,673,9438,3575861147,3575861163,16
1,673,9439,3575861147,3575861163,16
1,673,9440,3575861147,3575861164,17
1,673,9441,3575861147,3575861165,18
1,673,9442,3575861147,3575861166,19
1,673,9443,3575861147,3575861167,20
1,673,9444,3575861147,3575861169,22
1,673,9445,3575861147,3575861172,25
1,673,9446,3575861147,3575861174,27
1,673,9447,3575861147,3575861175,28
1,673,9448,3575861147,3575861177,30
1,673,9449,3575861147,3575861181,34
1,673,9450,3575861147,3575861181,34
1,673,9451,3575861147,3575861181,34
1,673,9452,3575861147,3575861182,35
1,673,9453,3575861147,3575861183,36
1,673,9454,3575861147,3575861185,38
1,673,9455,3575861147,3575861186,39
1,673,9456,3575861147,3575861187,40
1,673,9457,3575861147,3575861191,44
1,673,9458,3575861147,3575861191,44
1,673,9459,3575861147,3575861191,44
1,673,9460,3575861147,3575861192,45
1,673,9461,3575861147,3575861192,45
1,673,9462,3575861147,3575861193,46
1,673,9463,3575861147,3575861193,46
1,673,9464,3575861147,3575861197,50
1,674,9465,3575861202,3575861202,0
1,674,9466,3575861202,3575861202,0
1,674,9467,3575861202,3575861209,7
1,674,9468,3575861202,3575861209,7
1,674,9469,3575861202,3575861210,8
1,674,9470,3575861202,3575861211,9
1,674,9471,3575861202,3575861213,11
1,674,9472,3575861202,3575861214,12
1,674,9473,3575861202,3575861214,12
1,674,9474,3575861202,3575861215,13
1,674,9475,3575861202,3575861215,13
1,674,9476,3575861202,3575861217,15
1,674,9477,3575861202,3575861218,16
1,674,9478,3575861202,3575861218,16
1,674,9479,3575861202,3575861218,16
1,674,9480,3575861202,3575861218,16
1,674,9481,3575861202,3575861220,18
1,674,9482,3575861202,3575861221,19
1,674,9483,3575861202,3575861221,19
1,674,9484,3575861202,3575861223,21
1,674,9485,3575861202,3575861224,22
1,674,9486,3575861202,3575861225,23
1,674,9487,3575861202,3575861227,25
1,674,9488,3575861202,3575861228,26
1,674,9489,3575861202,3575861228,26
1,674,9490,3575861202,3575861229,27
1,674,9491,3575861202,3575861229,27
1,674,9492,3575861202,3575861230,28
1,674,9493,3575861202,3575861231,29
1,674,9494,3575861202,3575861231,29
1,674,9495,3575861202,3575861232,30
1,674,9496,3575861202,3575861235,33
1,674,9497,3575861202,3575861237,35
1,674,9498,3575861202,3575861238,36
1,674,9499,3575861202,3575861242,40
1,674,9500,3575861202,3575861245,43
1,674,9501,3575861202,3575861250,48
1,674,9502,3575861202,3575861251,49
1,674,9503,3575861202,3575861252,50
1,675,9504,3575861258,3575861258,0
1,675,9505,3575861258,3575861258,0
1,675,9506,3575861258,3575861258,0
1,675,9507,3575861258,3575861258,0
1,675,9508,3575861258,3575861262,4
1,675,9509,3575861258,3575861263,5
1,675,9510,3575861258,3575861264,6
1,675,9511,3575861258,3575861266,8
1,675,9512,3575861258,3575861267,9
1,675,9513,3575861258,3575861267,9
1,675,9514,3575861258,3575861280,22
1,675,9515,3575861258,3575861280,22
1,675,9516,3575861258,3575861283,25
1,675,9517,3575861258,3575861286,28
1,675,9518,3575861258,3575861287,29
1,675,9519,3575861258,3575861287,29
1,675,9520,3575861258,3575861292,34
1,675,9521,3575861258,3575861294,36
1,675,9522,3575861258,3575861294,36
1,675,9523,3575861258,3575861297,39
1,675,9524,3575861258,3575861298,40
1,675,9525,3575861258,3575861300,42
1,675,9526,3575861258,3575861305,47
1,675,9527,3575861258,3575861305,47
1,675,9528,3575861258,3575861306,48
1,675,9529,3575861258,3575861307,49
1,676,9530,3575861313,3575861313,0
1,676,9531,3575861313,3575861313,0
1,676,9532,3575861313,3575861315,2
1,676,9533,3575861313,3575861321,8
1,676,9534,3575861313,3575861326,13
1,676,9535,3575861313,3575861326,13
1,676,9536,3575861313,3575861329,16
1,676,9537,3575861313,3575861330,17
1,676,9538,3575861313,3575861331,18
1,676,9539,3575861313,3575861331,18
1,676,9540,3575861313,3575861331,18
1,676,9541,3575861313,3575861332,19
1,676,9542,3575861313,3575861332,19
1,676,9543,3575861313,3575861334,21
1,676,9544,3575861313,3575861335,22
1,676,9545,3575861313,3575861336,23
1,676,9546,3575861313,3575861338,25
1,676,9547,3575861313,3575861340,27
1,676,9548,3575861313,3575861345,32
1,676,9549,3575861313,3575861345,32
1,676,9550,3575861313,3575861346,33
1,676,9551,3575861313,3575861347,34
1,676,9552,3575861313,3575861351,38
1,676,9553,3575861313,3575861352,39
1,676,9554,3575861313,3575861354,41
1,676,9555,3575861313,3575861359,46
1,676,9556,3575861313,3575861361,48
1,676,9557,3575861313,3575861362,49
1,676,9558,3575861313,3575861363,50
1,677,9559,3575861368,3575861369,1
1,677,9560,3575861368,3575861369,1
1,677,9561,3575861368,3575861369,1
1,677,9562,3575861368,3575861369,1
1,677,9563,3575861368,3575861369,1
1,677,9564,3575861368,3575861370,2
1,677,9565,3575861368,3575861372,4
1,677,9566,3575861368,3575861374,6
1,677,9567,3575861368,3575861375,7
1,677,9568,3575861368,3575861375,7
1,677,9569,3575861368,3575861376,8
1,677,9570,3575861368,3575861376,8
1,677,9571,3575861368,3575861382,14
1,677,9572,3575861368,3575861382,14
1,677,9573,3575861368,3575861383,15
1,677,9574,3575861368,3575861385,17
1,677,9575,3575861368,3575861386,18
1,677,9576,3575861368,3575861387,19
1,677,9577,3575861368,3575861391,23
1,677,9578,3575861368,3575861391,23
1,677,9579,3575861368,3575861391,23
1,677,9580,3575861368,3575861393,25
1,677,9581,3575861368,3575861393,25
1,677,9582,3575861368,3575861393,25
1,677,9583,3575861368,3575861393,25
1,677,9584,3575861368,3575861396,28
1,677,9585,3575861368,3575861403,35
1,677,9586,3575861368,3575861403,35
1,677,9587,3575861368,3575861408,40
1,677,9588,3575861368,3575861410,42
1,677,9589,3575861368,3575861411,43
1,677,9590,3575861368,3575861413,45
1,677,9591,3575861368,3575861414,46
1,677,9592,3575861368,3575861414,46
1,677,9593,3575861368,3575861415,47
1,677,9594,3575861368,3575861417,49
1,677,9595,3575861368,3575861418,50
1,677,9596,3575861368,3575861418,50
1,678,9597,3575861425,3575861425,0
1,678,9598,3575861425,3575861425,0
1,678,9599,3575861425,3575861425,0
1,678,9600,3575861425,3575861425,0
1,678,9601,3575861425,3575861425,0
1,678,9602,3575861425,3575861425,0
1,678,9603,3575861425,3575861425,0
1,678,9604,3575861425,3575861425,0
1,678,9605,3575861425,3575861426,1
1,678,9606,3575861425,3575861427,2
1,678,9607,3575861425,3575861428,3
1,678,9608,3575861425,3575861429,4
1,678,9609,3575861425,3575861429,4
1,678,9610,3575861425,3575861429,4
1,678,9611,3575861425,3575861430,5
1,678,9612,3575861425,3575861431,6
1,678,9613,3575861425,3575861431,6
1,678,9614,3575861425,3575861433,8
1,678,9615,3575861425,3575861436,11
1,678,9616,3575861425,3575861437,12
1,678,9617,3575861425,3575861438,13
1,678,9618,3575861425,3575861439,14
1,678,9619,3575861425,3575861439,14
1,678,9620,3575861425,3575861442,17
1,678,9621,3575861425,3575861445,20
1,678,9622,3575861425,3575861446,21
1,678,9623,3575861425,3575861450,25
1,678,9624,3575861425,3575861451,26
1,678,9625,3575861425,3575861452,27
1,678,9626,3575861425,3575861454,29
1,678,9627,3575861425,3575861454,29
1,678,9628,3575861425,3575861456,31
1,678,9629,3575861425,3575861457,32
1,678,9630,3575861425,3575861463,38
1,678,9631,3575861425,3575861464,39
1,678,9632,3575861425,3575861465,40
1,678,9633,3575861425,3575861466,41
1,678,9634,3575861425,3575861467,42
1,678,9635,3575861425,3575861467,42
1,679,9636,3575861480,3575861480,0
1,679,9637,3575861480,3575861480,0
1,679,9638,3575861480,3575861480,0
1,679,9639,3575861480,3575861482,2
1,679,9640,3575861480,3575861485,5
1,679,9641,3575861480,3575861486,6
1,679,9642,3575861480,3575861486,6
1,679,9643,3575861480,3575861491,11
1,679,9644,3575861480,3575861493,13
1,679,9645,3575861480,3575861493,13
1,679,9646,3575861480,3575861495,15
1,679,9647,3575861480,3575861496,16
1,679,9648,3575861480,3575861496,16
1,679,9649,3575861480,3575861496,16
1,679,9650,3575861480,3575861500,20
1,679,9651,3575861480,3575861504,24
1,679,9652,3575861480,3575861505,25
1,679,9653,3575861480,3575861505,25
1,679,9654,3575861480,3575861507,27
1,679,9655,3575861480,3575861511,31
1,679,9656,3575861480,3575861514,34
1,679,9657,3575861480,3575861521,41
1,679,9658,3575861480,3575861523,43
1,679,9659,3575861480,3575861524,44
1,679,9660,3575861480,3575861525,45
1,679,9661,3575861480,3575861528,48
1,679,9662,3575861480,3575861529,49
1,679,9663,3575861480,3575861529,49
1,679,9664,3575861480,3575861530,50
1,680,9665,3575861535,3575861535,0
1,680,9666,3575861535,3575861535,0
1,680,9667,3575861535,3575861535,0
1,680,9668,3575861535,3575861535,0
1,680,9669,3575861535,3575861535,0
1,680,9670,3575861535,3575861536,1
1,680,9671,3575861535,3575861536,1
1,680,9672,3575861535,3575861539,4
1,680,9673,3575861535,3575861540,5
1,680,9674,3575861535,3575861544,9
1,680,9675,3575861535,3575861545,10
1,680,9676,3575861535,3575861545,10
1,680,9677,3575861535,3575861546,11
1,680,9678,3575861535,3575861549,14
1,680,9679,3575861535,3575861552,17
1,680,9680,3575861535,3575861553,18
1,680,9681,3575861535,3575861554,19
1,680,9682,3575861535,3575861559,24
1,680,9683,3575861535,3575861560,25
1,680,9684,3575861535,3575861560,25
1,680,9685,3575861535,3575861561,26
1,680,9686,3575861535,3575861562,27
1,680,9687,3575861535,3575861562,27
1,680,9688,3575861535,3575861563,28
1,680,9689,3575861535,3575861564,29
1,680,9690,3575861535,3575861566,31
1,680,9691,3575861535,3575861567,32
1,680,9692,3575861535,3575861568,33
1,680,9693,3575861535,3575861572,37
1,680,9694,3575861535,3575861573,38
1,680,9695,3575861535,3575861574,39
1,680,9696,3575861535,3575861574,39
1,680,9697,3575861535,3575861576,41
1,680,9698,3575861535,3575861580,45
1,680,9699,3575861535,3575861581,46
1,680,9700,3575861535,3575861581,46
1,680,9701,3575861535,3575861582,47
1,680,9702,3575861535,3575861584,49
1,680,9703,3575861535,3575861585,50
1,681,9704,3575861590,3575861590,0
1,681,9705,3575861590,3575861590,0
1,681,9706,3575861590,3575861591,1
1,681,9707,3575861590,3575861591,1
1,681,9708,3575861590,3575861592,2
1,681,9709,3575861590,3575861592,2
1,681,9710,3575861590,3575861592,2
1,681,9711,3575861590,3575861593,3
1,681,9712,3575861590,3575861595,5
1,681,9713,3575861590,3575861602,12
1,681,9714,3575861590,3575861602,12
1,681,9715,3575861590,3575861607,17
1,681,9716,3575861590,3575861608,18
1,681,9717,3575861590,3575861609,19
1,681,9718,3575861590,3575861610,20
1,681,9719,3575861590,3575861613,23
1,681,9720,3575861590,3575861614,24
1,681,9721,3575861590,3575861615,25
1,681,9722,3575861590,3575861616,26
1,681,9723,3575861590,3575861616,26
1,681,9724,3575861590,3575861618,28
1,681,9725,3575861590,3575861618,28
1,681,9726,3575861590,3575861618,28
1,681,9727,3575861590,3575861619,29
1,681,9728,3575861590,3575861620,30
1,681,9729,3575861590,3575861620,30
1,681,9730,3575861590,3575861622,32
1,681,9731,3575861590,3575861623,33
1,681,9732,3575861590,3575861624,34
1,681,9733,3575861590,3575861626,36
1,681,9734,3575861590,3575861627,37
1,681,9735,3575861590,3575861628,38
1,681,9736,3575861590,3575861628,38
1,681,9737,3575861590,3575861629,39
1,681,9738,3575861590,3575861629,39
1,681,9739,3575861590,3575861630,40
1,681,9740,3575861590,3575861632,42
1,681,9741,3575861590,3575861635,45
1,681,9742,3575861590,3575861635,45
1,681,9743,3575861590,3575861637,47
1,681,9744,3575861590,3575861637,47
1,681,9745,3575861590,3575861639,49
1,682,9746,3575861648,3575861648,0
1,682,9747,3575861648,3575861648,0
1,682,9748,3575861648,3575861648,0
1,682,9749,3575861648,3575861649,1
1,682,9750,3575861648,3575861650,2
1,682,9751,3575861648,3575861651,3
1,682,9752,3575861648,3575861653,5
1,682,9753,3575861648,3575861653,5
1,682,9754,3575861648,3575861655,7
1,682,9755,3575861648,3575861656,8
1,682,9756,3575861648,3575861662,14
1,682,9757,3575861648,3575861662,14
1,682,9758,3575861648,3575861664,16
1,682,9759,3575861648,3575861665,17
1,682,9760,3575861648,3575861665,17
1,682,9761,3575861648,3575861667,19
1,682,9762,3575861648,3575861679,31
1,682,9763,3575861648,3575861679,31
1,682,9764,3575861648,3575861682,34
1,682,9765,3575861648,3575861685,37
1,682,9766,3575861648,3575861685,37
1,682,9767,3575861648,3575861686,38
1,682,9768,3575861648,3575861691,43
1,682,9769,3575861648,3575861692,44
1,682,9770,3575861648,3575861694,46
1,682,9771,3575861648,3575861696,48
1,682,9772,3575861648,3575861696,48
1,682,9773,3575861648,3575861697,49
1,683,9774,3575861704,3575861704,0
1,683,9775,3575861704,3575861704,0
1,683,9776,3575861704,3575861705,1
1,683,9777,3575861704,3575861705,1
1,683,9778,3575861704,3575861711,7
1,683,9779,3575861704,3575861711,7
1,683,9780,3575861704,3575861714,10
1,683,9781,3575861704,3575861721,17
1,683,9782,3575861704,3575861725,21
1,683,9783,3575861704,3575861727,23
1,683,9784,3575861704,3575861729,25
1,683,9785,3575861704,3575861729,25
1,683,9786,3575861704,3575861729,25
1,683,9787,3575861704,3575861730,26
1,683,9788,3575861704,3575861733,29
1,683,9789,3575861704,3575861734,30
1,683,9790,3575861704,3575861735,31
1,683,9791,3575861704,3575861736,32
1,683,9792,3575861704,3575861738,34
1,683,9793,3575861704,3575861740,36
1,683,9794,3575861704,3575861745,41
1,683,9795,3575861704,3575861745,41
1,683,9796,3575861704,3575861745,41
1,683,9797,3575861704,3575861746,42
1,683,9798,3575861704,3575861750,46
1,683,9799,3575861704,3575861752,48
1,683,9800,3575861704,3575861753,49
1,684,9801,3575861760,3575861760,0
1,684,9802,3575861760,3575861760,0
1,684,9803,3575861760,3575861760,0
1,684,9804,3575861760,3575861761,1
1,684,9805,3575861760,3575861761,1
1,684,9806,3575861760,3575861762,2
1,684,9807,3575861760,3575861763,3
1,684,9808,3575861760,3575861764,4
1,684,9809,3575861760,3575861765,5
1,684,9810,3575861760,3575861766,6
1,684,9811,3575861760,3575861767,7
1,684,9812,3575861760,3575861768,8
1,684,9813,3575861760,3575861772,12
1,684,9814,3575861760,3575861774,14
1,684,9815,3575861760,3575861774,14
1,684,9816,3575861760,3575861776,16
1,684,9817,3575861760,3575861776,16
1,684,9818,3575861760,3575861781,21
1,684,9819,3575861760,3575861782,22
1,684,9820,3575861760,3575861782,22
1,684,9821,3575861760,3575861782,22
1,684,9822,3575861760,3575861784,24
1,684,9823,3575861760,3575861785,25
1,684,9824,3575861760,3575861788,28
1,684,9825,3575861760,3575861790,30
1,684,9826,3575861760,3575861791,31
1,684,9827,3575861760,3575861792,32
1,684,9828,3575861760,3575861792,32
1,684,9829,3575861760,3575861792,32
1,684,9830,3575861760,3575861792,32
1,684,9831,3575861760,3575861793,33
1,684,9832,3575861760,3575861796,36
1,684,9833,3575861760,3575861801,41
1,684,9834,3575861760,3575861802,42
1,684,9835,3575861760,3575861808,48
1,684,9836,3575861760,3575861809,49
1,685,9837,3575861816,3575861816,0
1,685,9838,3575861816,3575861816,0
1,685,9839,3575861816,3575861816,0
1,685,9840,3575861816,3575861816,0
1,685,9841,3575861816,3575861816,0
1,685,9842,3575861816,3575861816,0
1,685,9843,3575861816,3575861817,1
1,685,9844,3575861816,3575861817,1
1,685,9845,3575861816,3575861818,2
1,685,9846,3575861816,3575861818,2
1,685,9847,3575861816,3575861818,2
1,685,9848,3575861816,3575861818,2
1,685,9849,3575861816,3575861821,5
1,685,9850,3575861816,3575861821,5
1,685,9851,3575861816,3575861823,7
1,685,9852,3575861816,3575861824,8
1,685,9853,3575861816,3575861825,9
1,685,9854,3575861816,3575861826,10
1,685,9855,3575861816,3575861828,12
1,685,9856,3575861816,3575861828,12
1,685,9857,3575861816,3575861829,13
1,685,9858,3575861816,3575861830,14
1,685,9859,3575861816,3575861830,14
1,685,9860,3575861816,3575861832,16
1,685,9861,3575861816,3575861834,18
1,685,9862,3575861816,3575861836,20
1,685,9863,3575861816,3575861838,22
1,685,9864,3575861816,3575861838,22
1,685,9865,3575861816,3575861838,22
1,685,9866,3575861816,3575861839,23
1,685,9867,3575861816,3575861841,25
1,685,9868,3575861816,3575861842,26
1,685,9869,3575861816,3575861845,29
1,685,9870,3575861816,3575861850,34
1,685,9871,3575861816,3575861850,34
1,685,9872,3575861816,3575861851,35
1,685,9873,3575861816,3575861853,37
1,685,9874,3575861816,3575861854,38
1,685,9875,3575861816,3575861855,39
1,685,9876,3575861816,3575861855,39
1,685,9877,3575861816,3575861862,46
1,685,9878,3575861816,3575861863,47
1,685,9879,3575861816,3575861865,49
1,685,9880,3575861816,3575861865,49
1,685,9881,3575861816,3575861865,49
1,685,9882,3575861816,3575861866,50
1,686,9883,3575861871,3575861879,8
1,686,9884,3575861871,3575861879,8
1,686,9885,3575861871,3575861881,10
1,686,9886,3575861871,3575861882,11
1,686,9887,3575861871,3575861885,14
1,686,9888,3575861871,3575861886,15
1,686,9889,3575861871,3575861886,15
1,686,9890,3575861871,3575861887,16
1,686,9891,3575861871,3575861891,20
1,686,9892,3575861871,3575861893,22
1,686,9893,3575861871,3575861895,24
1,686,9894,3575861871,3575861895,24
1,686,9895,3575861871,3575861897,26
1,686,9896,3575861871,3575861897,26
1,686,9897,3575861871,3575861901,30
1,686,9898,3575861871,3575861905,34
1,686,9899,3575861871,3575861905,34
1,686,9900,3575861871,3575861905,34
1,686,9901,3575861871,3575861906,35
1,686,9902,3575861871,3575861911,40
1,686,9903,3575861871,3575861912,41
1,686,9904,3575861871,3575861914,43
1,686,9905,3575861871,3575861921,50
1,687,9906,3575861926,3575861926,0
1,687,9907,3575861926,3575861926,0
1,687,9908,3575861926,3575861927,1
1,687,9909,3575861926,3575861928,2
1,687,9910,3575861926,3575861929,3
1,687,9911,3575861926,3575861931,5
1,687,9912,3575861926,3575861931,5
1,687,9913,3575861926,3575861932,6
1,687,9914,3575861926,3575861933,7
1,687,9915,3575861926,3575861933,7
1,687,9916,3575861926,3575861935,9
1,687,9917,3575861926,3575861936,10
1,687,9918,3575861926,3575861936,10
1,687,9919,3575861926,3575861939,13
1,687,9920,3575861926,3575861940,14
1,687,9921,3575861926,3575861945,19
1,687,9922,3575861926,3575861945,19
1,687,9923,3575861926,3575861945,19
1,687,9924,3575861926,3575861946,20
1,687,9925,3575861926,3575861951,25
1,687,9926,3575861926,3575861952,26
1,687,9927,3575861926,3575861953,27
1,687,9928,3575861926,3575861954,28
1,687,9929,3575861926,3575861959,33
1,687,9930,3575861926,3575861960,34
1,687,9931,3575861926,3575861961,35
1,687,9932,3575861926,3575861961,35
1,687,9933,3575861926,3575861962,36
1,687,9934,3575861926,3575861962,36
1,687,9935,3575861926,3575861965,39
1,687,9936,3575861926,3575861965,39
1,687,9937,3575861926,3575861967,41
1,687,9938,3575861926,3575861969,43
1,687,9939,3575861926,3575861972,46
1,687,9940,3575861926,3575861974,48
1,687,9941,3575861926,3575861974,48
1,687,9942,3575861926,3575861974,48
1,687,9943,3575861926,3575861976,50
1,688,9944,3575861981,3575861981,0
1,688,9945,3575861981,3575861981,0
1,688,9946,3575861981,3575861981,0
1,688,9947,3575861981,3575861982,1
1,688,9948,3575861981,3575861984,3
1,688,9949,3575861981,3575861986,5
1,688,9950,3575861981,3575861988,7
1,688,9951,3575861981,3575861990,9
1,688,9952,3575861981,3575861990,9
1,688,9953,3575861981,3575861992,11
1,688,9954,3575861981,3575861992,11
1,688,9955,3575861981,3575861993,12
1,688,9956,3575861981,3575861993,12
1,688,9957,3575861981,3575861993,12
1,688,9958,3575861981,3575861995,14
1,688,9959,3575861981,3575861998,17
1,688,9960,3575861981,3575862001,20
1,688,9961,3575861981,3575862002,21
1,688,9962,3575861981,3575862008,27
1,688,9963,3575861981,3575862008,27
1,688,9964,3575861981,3575862009,28
1,688,9965,3575861981,3575862012,31
1,688,9966,3575861981,3575862013,32
1,688,9967,3575861981,3575862014,33
1,688,9968,3575861981,3575862015,34
1,688,9969,3575861981,3575862016,35
1,688,9970,3575861981,3575862017,36
1,688,9971,3575861981,3575862017,36
1,688,9972,3575861981,3575862018,37
1,688,9973,3575861981,3575862018,37
1,688,9974,3575861981,3575862019,38
1,688,9975,3575861981,3575862021,40
1,688,9976,3575861981,3575862021,40
1,688,9977,3575861981,3575862023,42
1,688,9978,3575861981,3575862024,43
1,688,9979,3575861981,3575862025,44
1,688,9980,3575861981,3575862026,45
1,688,9981,3575861981,3575862028,47
1,688,9982,3575861981,3575862028,47
1,688,9983,3575861981,3575862029,48
1,688,9984,3575861981,3575862030,49
1,688,9985,3575861981,3575862031,50
1,689,9986,3575862036,3575862036,0
1,689,9987,3575862036,3575862036,0
1,689,9988,3575862036,3575862036,0
1,689,9989,3575862036,3575862036,0
1,689,9990,3575862036,3575862037,1
1,689,9991,3575862036,3575862038,2
1,689,9992,3575862036,3575862039,3
1,689,9993,3575862036,3575862039,3
1,689,9994,3575862036,3575862040,4
1,689,9995,3575862036,3575862041,5
1,689,9996,3575862036,3575862045,9
1,689,9997,3575862036,3575862051,15
1,689,9998,3575862036,3575862051,15
1,689,9999,3575862036,3575862051,15
1,689,10000,3575862036,3575862051,15
1,689,10001,3575862036,3575862053,17
1,689,10002,3575862036,3575862054,18
1,689,10003,3575862036,3575862056,20
1,689,10004,3575862036,3575862056,20
1,689,10005,3575862036,3575862062,26
1,689,10006,3575862036,3575862063,27
1,689,10007,3575862036,3575862065,29
1,689,10008,3575862036,3575862065,29
1,689,10009,3575862036,3575862066,30
1,689,10010,3575862036,3575862067,31
1,689,10011,3575862036,3575862078,42
1,689,10012,3575862036,3575862079,43
1,689,10013,3575862036,3575862081,45
1,689,10014,3575862036,3575862081,45
1,689,10015,3575862036,3575862085,49
1,689,10016,3575862036,3575862086,50
1,690,10017,3575862091,3575862091,0
1,690,10018,3575862091,3575862091,0
1,690,10019,3575862091,3575862093,2
1,690,10020,3575862091,3575862095,4
1,690,10021,3575862091,3575862096,5
1,690,10022,3575862091,3575862096,5
1,690,10023,3575862091,3575862097,6
1,690,10024,3575862091,3575862097,6
1,690,10025,3575862091,3575862097,6
1,690,10026,3575862091,3575862101,10
1,690,10027,3575862091,3575862105,14
1,690,10028,3575862091,3575862106,15
1,690,10029,3575862091,3575862107,16
1,690,10030,3575862091,3575862112,21
1,690,10031,3575862091,3575862115,24
1,690,10032,3575862091,3575862121,30
1,690,10033,3575862091,3575862126,35
1,690,10034,3575862091,3575862126,35
1,690,10035,3575862091,3575862128,37
1,690,10036,3575862091,3575862128,37
1,690,10037,3575862091,3575862131,40
1,690,10038,3575862091,3575862131,40
1,690,10039,3575862091,3575862131,40
1,690,10040,3575862091,3575862133,42
1,690,10041,3575862091,3575862135,44
1,690,10042,3575862091,3575862137,46
1,690,10043,3575862091,3575862140,49
1,690,10044,3575862091,3575862140,49
1,691,10045,3575862146,3575862146,0
1,691,10046,3575862146,3575862146,0
1,691,10047,3575862146,3575862146,0
1,691,10048,3575862146,3575862146,0
1,691,10049,3575862146,3575862151,5
1,691,10050,3575862146,3575862153,7
1,691,10051,3575862146,3575862154,8
1,691,10052,3575862146,3575862157,11
1,691,10053,3575862146,3575862160,14
1,691,10054,3575862146,3575862160,14
1,691,10055,3575862146,3575862161,15
1,691,10056,3575862146,3575862161,15
1,691,10057,3575862146,3575862163,17
1,691,10058,3575862146,3575862164,18
1,691,10059,3575862146,3575862165,19
1,691,10060,3575862146,3575862165,19
1,691,10061,3575862146,3575862168,22
1,691,10062,3575862146,3575862169,23
1,691,10063,3575862146,3575862172,26
1,691,10064,3575862146,3575862174,28
1,691,10065,3575862146,3575862174,28
1,691,10066,3575862146,3575862176,30
1,691,10067,3575862146,3575862178,32
1,691,10068,3575862146,3575862181,35
1,691,10069,3575862146,3575862182,36
1,691,10070,3575862146,3575862182,36
1,691,10071,3575862146,3575862183,37
1,691,10072,3575862146,3575862185,39
1,691,10073,3575862146,3575862185,39
1,691,10074,3575862146,3575862188,42
1,691,10075,3575862146,3575862191,45
1,691,10076,3575862146,3575862191,45
1,691,10077,3575862146,3575862192,46
1,691,10078,3575862146,3575862193,47
1,691,10079,3575862146,3575862193,47
1,691,10080,3575862146,3575862193,47
1,691,10081,3575862146,3575862193,47
1,692,10082,3575862201,3575862201,0
1,692,10083,3575862201,3575862201,0
1,692,10084,3575862201,3575862201,0
1,692,10085,3575862201,3575862203,2
1,692,10086,3575862201,3575862203,2
1,692,10087,3575862201,3575862208,7
1,692,10088,3575862201,3575862210,9
1,692,10089,3575862201,3575862212,11
1,692,10090,3575862201,3575862213,12
1,692,10091,3575862201,3575862213,12
1,692,10092,3575862201,3575862215,14
1,692,10093,3575862201,3575862215,14
1,692,10094,3575862201,3575862217,16
1,692,10095,3575862201,3575862217,16
1,692,10096,3575862201,3575862217,16
1,692,10097,3575862201,3575862218,17
1,692,10098,3575862201,3575862218,17
1,692,10099,3575862201,3575862218,17
1,692,10100,3575862201,3575862219,18
1,692,10101,3575862201,3575862221,20
1,692,10102,3575862201,3575862223,22
1,692,10103,3575862201,3575862224,23
1,692,10104,3575862201,3575862225,24
1,692,10105,3575862201,3575862225,24
1,692,10106,3575862201,3575862228,27
1,692,10107,3575862201,3575862228,27
1,692,10108,3575862201,3575862229,28
1,692,10109,3575862201,3575862230,29
1,692,10110,3575862201,3575862231,30
1,692,10111,3575862201,3575862231,30
1,692,10112,3575862201,3575862231,30
1,692,10113,3575862201,3575862232,31
1,692,10114,3575862201,3575862236,35
1,692,10115,3575862201,3575862238,37
1,692,10116,3575862201,3575862239,38
1,692,10117,3575862201,3575862239,38
1,692,10118,3575862201,3575862239,38
1,692,10119,3575862201,3575862241,40
1,692,10120,3575862201,3575862241,40
1,692,10121,3575862201,3575862245,44
1,692,10122,3575862201,3575862245,44
1,692,10123,3575862201,3575862251,50
1,693,10124,3575862257,3575862257,0
1,693,10125,3575862257,3575862257,0
1,693,10126,3575862257,3575862257,0
1,693,10127,3575862257,3575862257,0
1,693,10128,3575862257,3575862257,0
1,693,10129,3575862257,3575862257,0
1,693,10130,3575862257,3575862262,5
1,693,10131,3575862257,3575862263,6
1,693,10132,3575862257,3575862265,8
1,693,10133,3575862257,3575862266,9
1,693,10134,3575862257,3575862267,10
1,693,10135,3575862257,3575862267,10
1,693,10136,3575862257,3575862279,22
1,693,10137,3575862257,3575862279,22
1,693,10138,3575862257,3575862281,24
1,693,10139,3575862257,3575862286,29
1,693,10140,3575862257,3575862286,29
1,693,10141,3575862257,3575862286,29
1,693,10142,3575862257,3575862291,34
1,693,10143,3575862257,3575862294,37
1,693,10144,3575862257,3575862295,38
1,693,10145,3575862257,3575862296,39
1,693,10146,3575862257,3575862297,40
1,693,10147,3575862257,3575862297,40
1,693,10148,3575862257,3575862297,40
1,693,10149,3575862257,3575862301,44
1,693,10150,3575862257,3575862304,47
1,693,10151,3575862257,3575862305,48
1,693,10152,3575862257,3575862305,48
1,693,10153,3575862257,3575862306,49
1,694,10154,3575862312,3575862312,0
1,694,10155,3575862312,3575862312,0
1,694,10156,3575862312,3575862315,3
1,694,10157,3575862312,3575862321,9
1,694,10158,3575862312,3575862323,11
1,694,10159,3575862312,3575862326,14
1,694,10160,3575862312,3575862327,15
1,694,10161,3575862312,3575862328,16
1,694,10162,3575862312,3575862329,17
1,694,10163,3575862312,3575862329,17
1,694,10164,3575862312,3575862331,19
1,694,10165,3575862312,3575862332,20
1,694,10166,3575862312,3575862334,22
1,694,10167,3575862312,3575862334,22
1,694,10168,3575862312,3575862336,24
1,694,10169,3575862312,3575862336,24
1,694,10170,3575862312,3575862338,26
1,694,10171,3575862312,3575862340,28
1,694,10172,3575862312,3575862340,28
1,694,10173,3575862312,3575862345,33
1,694,10174,3575862312,3575862346,34
1,694,10175,3575862312,3575862346,34
1,694,10176,3575862312,3575862346,34
1,694,10177,3575862312,3575862351,39
1,694,10178,3575862312,3575862353,41
1,694,10179,3575862312,3575862354,42
1,694,10180,3575862312,3575862358,46
1,694,10181,3575862312,3575862359,47
1,694,10182,3575862312,3575862361,49
1,694,10183,3575862312,3575862361,49
1,694,10184,3575862312,3575862361,49
1,695,10185,3575862369,3575862369,0
1,695,10186,3575862369,3575862369,0
1,695,10187,3575862369,3575862369,0
1,695,10188,3575862369,3575862369,0
1,695,10189,3575862369,3575862369,0
1,695,10190,3575862369,3575862369,0
1,695,10191,3575862369,3575862373,4
1,695,10192,3575862369,3575862374,5
1,695,10193,3575862369,3575862375,6
1,695,10194,3575862369,3575862375,6
1,695,10195,3575862369,3575862376,7
1,695,10196,3575862369,3575862382,13
1,695,10197,3575862369,3575862382,13
1,695,10198,3575862369,3575862383,14
1,695,10199,3575862369,3575862385,16
1,695,10200,3575862369,3575862386,17
1,695,10201,3575862369,3575862388,19
1,695,10202,3575862369,3575862390,21
1,695,10203,3575862369,3575862391,22
1,695,10204,3575862369,3575862392,23
1,695,10205,3575862369,3575862393,24
1,695,10206,3575862369,3575862393,24
1,695,10207,3575862369,3575862394,25
1,695,10208,3575862369,3575862396,27
1,695,10209,3575862369,3575862398,29
1,695,10210,3575862369,3575862402,33
1,695,10211,3575862369,3575862403,34
1,695,10212,3575862369,3575862403,34
1,695,10213,3575862369,3575862406,37
1,695,10214,3575862369,3575862408,39
1,695,10215,3575862369,3575862409,40
1,695,10216,3575862369,3575862411,42
1,695,10217,3575862369,3575862413,44
1,695,10218,3575862369,3575862413,44
1,695,10219,3575862369,3575862413,44
1,695,10220,3575862369,3575862415,46
1,695,10221,3575862369,3575862416,47
1,695,10222,3575862369,3575862417,48
1,695,10223,3575862369,3575862417,48
1,695,10224,3575862369,3575862417,48
1,695,10225,3575862369,3575862418,49
1,695,10226,3575862369,3575862418,49
1,695,10227,3575862369,3575862418,49
1,696,10228,3575862424,3575862424,0
1,696,10229,3575862424,3575862424,0
1,696,10230,3575862424,3575862424,0
1,696,10231,3575862424,3575862425,1
1,696,10232,3575862424,3575862426,2
1,696,10233,3575862424,3575862429,5
1,696,10234,3575862424,3575862429,5
1,696,10235,3575862424,3575862430,6
1,696,10236,3575862424,3575862431,7
1,696,10237,3575862424,3575862431,7
1,696,10238,3575862424,3575862432,8
1,696,10239,3575862424,3575862433,9
1,696,10240,3575862424,3575862436,12
1,696,10241,3575862424,3575862438,14
1,696,10242,3575862424,3575862439,15
1,696,10243,3575862424,3575862439,15
1,696,10244,3575862424,3575862441,17
1,696,10245,3575862424,3575862445,21
1,696,10246,3575862424,3575862446,22
1,696,10247,3575862424,3575862450,26
1,696,10248,3575862424,3575862451,27
1,696,10249,3575862424,3575862451,27
1,696,10250,3575862424,3575862452,28
1,696,10251,3575862424,3575862454,30
1,696,10252,3575862424,3575862455,31
1,696,10253,3575862424,3575862456,32
1,696,10254,3575862424,3575862462,38
1,696,10255,3575862424,3575862463,39
1,696,10256,3575862424,3575862464,40
1,696,10257,3575862424,3575862467,43
1,696,10258,3575862424,3575862467,43
1,696,10259,3575862424,3575862467,43
1,697,10260,3575862481,3575862481,0
1,697,10261,3575862481,3575862481,0
1,697,10262,3575862481,3575862481,0
1,697,10263,3575862481,3575862481,0
1,697,10264,3575862481,3575862484,3
1,697,10265,3575862481,3575862484,3
1,697,10266,3575862481,3575862486,5
1,697,10267,3575862481,3575862491,10
1,697,10268,3575862481,3575862492,11
1,697,10269,3575862481,3575862495,14
1,697,10270,3575862481,3575862495,14
1,697,10271,3575862481,3575862496,15
1,697,10272,3575862481,3575862496,15
1,697,10273,3575862481,3575862500,19
1,697,10274,3575862481,3575862503,22
1,697,10275,3575862481,3575862504,23
1,697,10276,3575862481,3575862505,24
1,697,10277,3575862481,3575862506,25
1,697,10278,3575862481,3575862506,25
1,697,10279,3575862481,3575862510,29
1,697,10280,3575862481,3575862514,33
1,697,10281,3575862481,3575862520,39
1,697,10282,3575862481,3575862525,44
1,697,10283,3575862481,3575862527,46
1,697,10284,3575862481,3575862527,46
1,697,10285,3575862481,3575862528,47
1,697,10286,3575862481,3575862530,49
1,697,10287,3575862481,3575862530,49
1,697,10288,3575862481,3575862530,49
1,698,10289,3575862538,3575862538,0
1,698,10290,3575862538,3575862538,0
1,698,10291,3575862538,3575862538,0
1,698,10292,3575862538,3575862538,0
1,698,10293,3575862538,3575862539,1
1,698,10294,3575862538,3575862544,6
1,698,10295,3575862538,3575862544,6
1,698,10296,3575862538,3575862545,7
1,698,10297,3575862538,3575862546,8
1,698,10298,3575862538,3575862549,11
1,698,10299,3575862538,3575862551,13
1,698,10300,3575862538,3575862553,15
1,698,10301,3575862538,3575862556,18
1,698,10302,3575862538,3575862557,19
1,698,10303,3575862538,3575862557,19
1,698,10304,3575862538,3575862559,21
1,698,10305,3575862538,3575862560,22
1,698,10306,3575862538,3575862560,22
1,698,10307,3575862538,3575862561,23
1,698,10308,3575862538,3575862562,24
1,698,10309,3575862538,3575862563,25
1,698,10310,3575862538,3575862564,26
1,698,10311,3575862538,3575862566,28
1,698,10312,3575862538,3575862567,29
1,698,10313,3575862538,3575862572,34
1,698,10314,3575862538,3575862573,35
1,698,10315,3575862538,3575862574,36
1,698,10316,3575862538,3575862574,36
1,698,10317,3575862538,3575862575,37
1,698,10318,3575862538,3575862577,39
1,698,10319,3575862538,3575862580,42
1,698,10320,3575862538,3575862581,43
1,698,10321,3575862538,3575862581,43
1,698,10322,3575862538,3575862582,44
1,698,10323,3575862538,3575862585,47
1,698,10324,3575862538,3575862585,47
1,698,10325,3575862538,3575862586,48
1,698,10326,3575862538,3575862587,49
1,699,10327,3575862593,3575862593,0
1,699,10328,3575862593,3575862593,0
1,699,10329,3575862593,3575862593,0
1,699,10330,3575862593,3575862593,0
1,699,10331,3575862593,3575862593,0
1,699,10332,3575862593,3575862593,0
1,699,10333,3575862593,3575862596,3
1,699,10334,3575862593,3575862598,5
1,699,10335,3575862593,3575862601,8
1,699,10336,3575862593,3575862602,9
1,699,10337,3575862593,3575862603,10
1,699,10338,3575862593,3575862606,13
1,699,10339,3575862593,3575862607,14
1,699,10340,3575862593,3575862610,17
1,699,10341,3575862593,3575862612,19
1,699,10342,3575862593,3575862612,19
1,699,10343,3575862593,3575862613,20
1,699,10344,3575862593,3575862613,20
1,699,10345,3575862593,3575862614,21
1,699,10346,3575862593,3575862615,22
1,699,10347,3575862593,3575862616,23
1,699,10348,3575862593,3575862616,23
1,699,10349,3575862593,3575862616,23
1,699,10350,3575862593,3575862617,24
1,699,10351,3575862593,3575862617,24
1,699,10352,3575862593,3575862618,25
1,699,10353,3575862593,3575862621,28
1,699,10354,3575862593,3575862622,29
1,699,10355,3575862593,3575862623,30
1,699,10356,3575862593,3575862624,31
1,699,10357,3575862593,3575862625,32
1,699,10358,3575862593,3575862627,34
1,699,10359,3575862593,3575862628,35
1,699,10360,3575862593,3575862628,35
1,699,10361,3575862593,3575862628,35
1,699,10362,3575862593,3575862630,37
1,699,10363,3575862593,3575862630,37
1,699,10364,3575862593,3575862632,39
1,699,10365,3575862593,3575862635,42
1,699,10366,3575862593,3575862637,44
1,699,10367,3575862593,3575862639,46
1,699,10368,3575862593,3575862639,46
1,699,10369,3575862593,3575862640,47
1,699,10370,3575862593,3575862641,48
1,700,10371,3575862649,3575862649,0
1,700,10372,3575862649,3575862649,0
1,700,10373,3575862649,3575862649,0
1,700,10374,3575862649,3575862650,1
1,700,10375,3575862649,3575862651,2
1,700,10376,3575862649,3575862651,2
1,700,10377,3575862649,3575862654,5
1,700,10378,3575862649,3575862655,6
1,700,10379,3575862649,3575862655,6
1,700,10380,3575862649,3575862655,6
1,700,10381,3575862649,3575862662,13
1,700,10382,3575862649,3575862663,14
1,700,10383,3575862649,3575862664,15
1,700,10384,3575862649,3575862666,17
1,700,10385,3575862649,3575862667,18
1,700,10386,3575862649,3575862667,18
1,700,10387,3575862649,3575862678,29
1,700,10388,3575862649,3575862679,30
1,700,10389,3575862649,3575862681,32
1,700,10390,3575862649,3575862681,32
1,700,10391,3575862649,3575862684,35
1,700,10392,3575862649,3575862685,36
1,700,10393,3575862649,3575862685,36
1,700,10394,3575862649,3575862687,38
1,700,10395,3575862649,3575862691,42
1,700,10396,3575862649,3575862693,44
1,700,10397,3575862649,3575862695,46
1,700,10398,3575862649,3575862695,46
1,700,10399,3575862649,3575862696,47
1,700,10400,3575862649,3575862696,47
1,700,10401,3575862649,3575862696,47
1,701,10402,3575862706,3575862706,0
1,701,10403,3575862706,3575862706,0
1,701,10404,3575862706,3575862706,0
1,701,10405,3575862706,3575862706,0
1,701,10406,3575862706,3575862706,0
1,701,10407,3575862706,3575862706,0
1,701,10408,3575862706,3575862711,5
1,701,10409,3575862706,3575862711,5
1,701,10410,3575862706,3575862714,8
1,701,10411,3575862706,3575862720,14
1,701,10412,3575862706,3575862723,17
1,701,10413,3575862706,3575862727,21
1,701,10414,3575862706,3575862728,22
1,701,10415,3575862706,3575862729,23
1,701,10416,3575862706,3575862731,25
1,701,10417,3575862706,3575862731,25
1,701,10418,3575862706,3575862732,26
1,701,10419,3575862706,3575862734,28
1,701,10420,3575862706,3575862735,29
1,701,10421,3575862706,3575862735,29
1,701,10422,3575862706,3575862737,31
1,701,10423,3575862706,3575862740,34
1,701,10424,3575862706,3575862740,34
1,701,10425,3575862706,3575862744,38
1,701,10426,3575862706,3575862744,38
1,701,10427,3575862706,3575862744,38
1,701,10428,3575862706,3575862746,40
1,701,10429,3575862706,3575862750,44
1,701,10430,3575862706,3575862752,46
1,701,10431,3575862706,3575862753,47
1,701,10432,3575862706,3575862753,47
1,701,10433,3575862706,3575862756,50
1,702,10434,3575862762,3575862762,0
1,702,10435,3575862762,3575862762,0
1,702,10436,3575862762,3575862762,0
1,702,10437,3575862762,3575862762,0
1,702,10438,3575862762,3575862762,0
1,702,10439,3575862762,3575862762,0
1,702,10440,3575862762,3575862762,0
1,702,10441,3575862762,3575862763,1
1,702,10442,3575862762,3575862764,2
1,702,10443,3575862762,3575862766,4
1,702,10444,3575862762,3575862766,4
1,702,10445,3575862762,3575862767,5
1,702,10446,3575862762,3575862768,6
1,702,10447,3575862762,3575862772,10
1,702,10448,3575862762,3575862773,11
1,702,10449,3575862762,3575862774,12
1,702,10450,3575862762,3575862775,13
1,702,10451,3575862762,3575862775,13
1,702,10452,3575862762,3575862777,15
1,702,10453,3575862762,3575862780,18
1,702,10454,3575862762,3575862781,19
1,702,10455,3575862762,3575862781,19
1,702,10456,3575862762,3575862783,21
1,702,10457,3575862762,3575862784,22
1,702,10458,3575862762,3575862784,22
1,702,10459,3575862762,3575862786,24
1,702,10460,3575862762,3575862787,25
1,702,10461,3575862762,3575862790,28
1,702,10462,3575862762,3575862791,29
1,702,10463,3575862762,3575862791,29
1,702,10464,3575862762,3575862792,30
1,702,10465,3575862762,3575862792,30
1,702,10466,3575862762,3575862792,30
1,702,10467,3575862762,3575862793,31
1,702,10468,3575862762,3575862796,34
1,702,10469,3575862762,3575862797,35
1,702,10470,3575862762,3575862801,39
1,702,10471,3575862762,3575862802,40
1,702,10472,3575862762,3575862803,41
1,702,10473,3575862762,3575862805,43
1,702,10474,3575862762,3575862808,46
1,702,10475,3575862762,3575862809,47
1,702,10476,3575862762,3575862810,48
1,703,10477,3575862817,3575862817,0
1,703,10478,3575862817,3575862817,0
1,703,10479,3575862817,3575862817,0
1,703,10480,3575862817,3575862817,0
1,703,10481,3575862817,3575862817,0
1,703,10482,3575862817,3575862817,0
1,703,10483,3575862817,3575862817,0
1,703,10484,3575862817,3575862817,0
1,703,10485,3575862817,3575862817,0
1,703,10486,3575862817,3575862817,0
1,703,10487,3575862817,3575862817,0
1,703,10488,3575862817,3575862818,1
1,703,10489,3575862817,3575862818,1
1,703,10490,3575862817,3575862820,3
1,703,10491,3575862817,3575862822,5
1,703,10492,3575862817,3575862822,5
1,703,10493,3575862817,3575862824,7
1,703,10494,3575862817,3575862825,8
1,703,10495,3575862817,3575862829,12
1,703,10496,3575862817,3575862829,12
1,703,10497,3575862817,3575862829,12
1,703,10498,3575862817,3575862830,13
1,703,10499,3575862817,3575862830,13
1,703,10500,3575862817,3575862831,14
1,703,10501,3575862817,3575862832,15
1,703,10502,3575862817,3575862835,18
1,703,10503,3575862817,3575862838,21
1,703,10504,3575862817,3575862839,22
1,703,10505,3575862817,3575862840,23
1,703,10506,3575862817,3575862841,24
1,703,10507,3575862817,3575862841,24
1,703,10508,3575862817,3575862843,26
1,703,10509,3575862817,3575862845,28
1,703,10510,3575862817,3575862850,33
1,703,10511,3575862817,3575862850,33
1,703,10512,3575862817,3575862851,34
1,703,10513,3575862817,3575862851,34
1,703,10514,3575862817,3575862853,36
1,703,10515,3575862817,3575862855,38
1,703,10516,3575862817,3575862855,38
1,703,10517,3575862817,3575862856,39
1,703,10518,3575862817,3575862862,45
1,703,10519,3575862817,3575862863,46
1,703,10520,3575862817,3575862864,47
1,703,10521,3575862817,3575862864,47
1,703,10522,3575862817,3575862866,49
1,703,10523,3575862817,3575862867,50
1,704,10524,3575862874,3575862874,0
1,704,10525,3575862874,3575862878,4
1,704,10526,3575862874,3575862879,5
1,704,10527,3575862874,3575862881,7
1,704,10528,3575862874,3575862881,7
1,704,10529,3575862874,3575862884,10
1,704,10530,3575862874,3575862885,11
1,704,10531,3575862874,3575862885,11
1,704,10532,3575862874,3575862891,17
1,704,10533,3575862874,3575862892,18
1,704,10534,3575862874,3575862895,21
1,704,10535,3575862874,3575862896,22
1,704,10536,3575862874,3575862896,22
1,704,10537,3575862874,3575862896,22
1,704,10538,3575862874,3575862896,22
1,704,10539,3575862874,3575862900,26
1,704,10540,3575862874,3575862902,28
1,704,10541,3575862874,3575862904,30
1,704,10542,3575862874,3575862905,31
1,704,10543,3575862874,3575862906,32
1,704,10544,3575862874,3575862907,33
1,704,10545,3575862874,3575862911,37
1,704,10546,3575862874,3575862912,38
1,704,10547,3575862874,3575862914,40
1,704,10548,3575862874,3575862920,46
1,705,10549,3575862930,3575862930,0
1,705,10550,3575862930,3575862930,0
1,705,10551,3575862930,3575862930,0
1,705,10552,3575862930,3575862930,0
1,705,10553,3575862930,3575862931,1
1,705,10554,3575862930,3575862931,1
1,705,10555,3575862930,3575862931,1
1,705,10556,3575862930,3575862932,2
1,705,10557,3575862930,3575862934,4
1,705,10558,3575862930,3575862934,4
1,705,10559,3575862930,3575862935,5
1,705,10560,3575862930,3575862938,8
1,705,10561,3575862930,3575862940,10
1,705,10562,3575862930,3575862940,10
1,705,10563,3575862930,3575862944,14
1,705,10564,3575862930,3575862945,15
1,705,10565,3575862930,3575862945,15
1,705,10566,3575862930,3575862946,16
1,705,10567,3575862930,3575862951,21
1,705,10568,3575862930,3575862952,22
1,705,10569,3575862930,3575862953,23
1,705,10570,3575862930,3575862954,24
1,705,10571,3575862930,3575862955,25
1,705,10572,3575862930,3575862957,27
1,705,10573,3575862930,3575862960,30
1,705,10574,3575862930,3575862960,30
1,705,10575,3575862930,3575862960,30
1,705,10576,3575862930,3575862961,31
1,705,10577,3575862930,3575862961,31
1,705,10578,3575862930,3575862962,32
1,705,10579,3575862930,3575862963,33
1,705,10580,3575862930,3575862966,36
1,705,10581,3575862930,3575862967,37
1,705,10582,3575862930,3575862968,38
1,705,10583,3575862930,3575862972,42
1,705,10584,3575862930,3575862975,45
1,705,10585,3575862930,3575862975,45
1,705,10586,3575862930,3575862975,45
1,705,10587,3575862930,3575862976,46
1,705,10588,3575862930,3575862977,47
1,706,10589,3575862987,3575862987,0
1,706,10590,3575862987,3575862987,0
1,706,10591,3575862987,3575862987,0
1,706,10592,3575862987,3575862987,0
1,706,10593,3575862987,3575862987,0
1,706,10594,3575862987,3575862987,0
1,706,10595,3575862987,3575862987,0
1,706,10596,3575862987,3575862987,0
1,706,10597,3575862987,3575862990,3
1,706,10598,3575862987,3575862991,4
1,706,10599,3575862987,3575862991,4
1,706,10600,3575862987,3575862992,5
1,706,10601,3575862987,3575862992,5
1,706,10602,3575862987,3575862992,5
1,706,10603,3575862987,3575862995,8
1,706,10604,3575862987,3575862997,10
1,706,10605,3575862987,3575863001,14
1,706,10606,3575862987,3575863002,15
1,706,10607,3575862987,3575863004,17
1,706,10608,3575862987,3575863005,18
1,706,10609,3575862987,3575863008,21
1,706,10610,3575862987,3575863009,22
1,706,10611,3575862987,3575863010,23
1,706,10612,3575862987,3575863011,24
1,706,10613,3575862987,3575863013,26
1,706,10614,3575862987,3575863015,28
1,706,10615,3575862987,3575863016,29
1,706,10616,3575862987,3575863016,29
1,706,10617,3575862987,3575863016,29
1,706,10618,3575862987,3575863016,29
1,706,10619,3575862987,3575863016,29
1,706,10620,3575862987,3575863016,29
1,706,10621,3575862987,3575863017,30
1,706,10622,3575862987,3575863017,30
1,706,10623,3575862987,3575863018,31
1,706,10624,3575862987,3575863018,31
1,706,10625,3575862987,3575863020,33
1,706,10626,3575862987,3575863021,34
1,706,10627,3575862987,3575863022,35
1,706,10628,3575862987,3575863023,36
1,706,10629,3575862987,3575863024,37
1,706,10630,3575862987,3575863025,38
1,706,10631,3575862987,3575863029,42
1,706,10632,3575862987,3575863030,43
1,706,10633,3575862987,3575863030,43
1,706,10634,3575862987,3575863030,43
1,706,10635,3575862987,3575863030,43
1,706,10636,3575862987,3575863031,44
1,706,10637,3575862987,3575863032,45
1,706,10638,3575862987,3575863033,46
1,706,10639,3575862987,3575863034,47
1,706,10640,3575862987,3575863035,48
1,706,10641,3575862987,3575863037,50
1,707,10642,3575863043,3575863043,0
1,707,10643,3575863043,3575863043,0
1,707,10644,3575863043,3575863043,0
1,707,10645,3575863043,3575863043,0
1,707,10646,3575863043,3575863044,1
1,707,10647,3575863043,3575863046,3
1,707,10648,3575863043,3575863050,7
1,707,10649,3575863043,3575863050,7
1,707,10650,3575863043,3575863051,8
1,707,10651,3575863043,3575863051,8
1,707,10652,3575863043,3575863053,10
1,707,10653,3575863043,3575863055,12
1,707,10654,3575863043,3575863055,12
1,707,10655,3575863043,3575863056,13
1,707,10656,3575863043,3575863062,19
1,707,10657,3575863043,3575863063,20
1,707,10658,3575863043,3575863064,21
1,707,10659,3575863043,3575863064,21
1,707,10660,3575863043,3575863066,23
1,707,10661,3575863043,3575863066,23
1,707,10662,3575863043,3575863077,34
1,707,10663,3575863043,3575863079,36
1,707,10664,3575863043,3575863081,38
1,707,10665,3575863043,3575863081,38
1,707,10666,3575863043,3575863084,41
1,707,10667,3575863043,3575863085,42
1,707,10668,3575863043,3575863086,43
1,707,10669,3575863043,3575863091,48
1,708,10670,3575863099,3575863099,0
1,708,10671,3575863099,3575863099,0
1,708,10672,3575863099,3575863099,0
1,708,10673,3575863099,3575863099,0
1,708,10674,3575863099,3575863099,0
1,708,10675,3575863099,3575863099,0
1,708,10676,3575863099,3575863101,2
1,708,10677,3575863099,3575863103,4
1,708,10678,3575863099,3575863106,7
1,708,10679,3575863099,3575863108,9
1,708,10680,3575863099,3575863111,12
1,708,10681,3575863099,3575863111,12
1,708,10682,3575863099,3575863115,16
1,708,10683,3575863099,3575863120,21
1,708,10684,3575863099,3575863124,25
1,708,10685,3575863099,3575863126,27
1,708,10686,3575863099,3575863127,28
1,708,10687,3575863099,3575863129,30
1,708,10688,3575863099,3575863130,31
1,708,10689,3575863099,3575863131,32
1,708,10690,3575863099,3575863131,32
1,708,10691,3575863099,3575863132,33
1,708,10692,3575863099,3575863132,33
1,708,10693,3575863099,3575863134,35
1,708,10694,3575863099,3575863134,35
1,708,10695,3575863099,3575863135,36
1,708,10696,3575863099,3575863137,38
1,708,10697,3575863099,3575863139,40
1,708,10698,3575863099,3575863140,41
1,708,10699,3575863099,3575863144,45
1,708,10700,3575863099,3575863144,45
1,708,10701,3575863099,3575863145,46
1,708,10702,3575863099,3575863145,46
1,709,10703,3575863156,3575863156,0
1,709,10704,3575863156,3575863156,0
1,709,10705,3575863156,3575863156,0
1,709,10706,3575863156,3575863156,0
1,709,10707,3575863156,3575863156,0
1,709,10708,3575863156,3575863157,1
1,709,10709,3575863156,3575863159,3
1,709,10710,3575863156,3575863160,4
1,709,10711,3575863156,3575863160,4
1,709,10712,3575863156,3575863161,5
1,709,10713,3575863156,3575863161,5
1,709,10714,3575863156,3575863163,7
1,709,10715,3575863156,3575863164,8
1,709,10716,3575863156,3575863166,10
1,709,10717,3575863156,3575863166,10
1,709,10718,3575863156,3575863168,12
1,709,10719,3575863156,3575863168,12
1,709,10720,3575863156,3575863172,16
1,709,10721,3575863156,3575863174,18
1,709,10722,3575863156,3575863174,18
1,709,10723,3575863156,3575863175,19
1,709,10724,3575863156,3575863175,19
1,709,10725,3575863156,3575863176,20
1,709,10726,3575863156,3575863181,25
1,709,10727,3575863156,3575863182,26
1,709,10728,3575863156,3575863182,26
1,709,10729,3575863156,3575863183,27
1,709,10730,3575863156,3575863185,29
1,709,10731,3575863156,3575863186,30
1,709,10732,3575863156,3575863187,31
1,709,10733,3575863156,3575863190,34
1,709,10734,3575863156,3575863191,35
1,709,10735,3575863156,3575863191,35
1,709,10736,3575863156,3575863193,37
1,709,10737,3575863156,3575863193,37
1,709,10738,3575863156,3575863193,37
1,709,10739,3575863156,3575863197,41
1,709,10740,3575863156,3575863198,42
1,709,10741,3575863156,3575863202,46
1,709,10742,3575863156,3575863202,46
1,709,10743,3575863156,3575863202,46
1,709,10744,3575863156,3575863203,47
1,709,10745,3575863156,3575863206,50
1,710,10746,3575863212,3575863212,0
1,710,10747,3575863212,3575863212,0
1,710,10748,3575863212,3575863212,0
1,710,10749,3575863212,3575863212,0
1,710,10750,3575863212,3575863213,1
1,710,10751,3575863212,3575863215,3
1,710,10752,3575863212,3575863216,4
1,710,10753,3575863212,3575863216,4
1,710,10754,3575863212,3575863216,4
1,710,10755,3575863212,3575863216,4
1,710,10756,3575863212,3575863216,4
1,710,10757,3575863212,3575863217,5
1,710,10758,3575863212,3575863217,5
1,710,10759,3575863212,3575863218,6
1,710,10760,3575863212,3575863219,7
1,710,10761,3575863212,3575863221,9
1,710,10762,3575863212,3575863221,9
1,710,10763,3575863212,3575863222,10
1,710,10764,3575863212,3575863223,11
1,710,10765,3575863212,3575863224,12
1,710,10766,3575863212,3575863225,13
1,710,10767,3575863212,3575863230,18
1,710,10768,3575863212,3575863230,18
1,710,10769,3575863212,3575863230,18
1,710,10770,3575863212,3575863231,19
1,710,10771,3575863212,3575863231,19
1,710,10772,3575863212,3575863232,20
1,710,10773,3575863212,3575863232,20
1,710,10774,3575863212,3575863233,21
1,710,10775,3575863212,3575863234,22
1,710,10776,3575863212,3575863235,23
1,710,10777,3575863212,3575863237,25
1,710,10778,3575863212,3575863239,27
1,710,10779,3575863212,3575863240,28
1,710,10780,3575863212,3575863241,29
1,710,10781,3575863212,3575863242,30
1,710,10782,3575863212,3575863242,30
1,710,10783,3575863212,3575863245,33
1,710,10784,3575863212,3575863246,34
1,710,10785,3575863212,3575863251,39
1,710,10786,3575863212,3575863251,39
1,710,10787,3575863212,3575863251,39
1,710,10788,3575863212,3575863251,39
1,710,10789,3575863212,3575863254,42
1,710,10790,3575863212,3575863255,43
1,710,10791,3575863212,3575863255,43
1,710,10792,3575863212,3575863256,44
1,711,10793,3575863268,3575863268,0
1,711,10794,3575863268,3575863268,0
1,711,10795,3575863268,3575863268,0
1,711,10796,3575863268,3575863268,0
1,711,10797,3575863268,3575863268,0
1,711,10798,3575863268,3575863268,0
1,711,10799,3575863268,3575863279,11
1,711,10800,3575863268,3575863281,13
1,711,10801,3575863268,3575863282,14
1,711,10802,3575863268,3575863284,16
1,711,10803,3575863268,3575863285,17
1,711,10804,3575863268,3575863287,19
1,711,10805,3575863268,3575863291,23
1,711,10806,3575863268,3575863293,25
1,711,10807,3575863268,3575863295,27
1,711,10808,3575863268,3575863295,27
1,711,10809,3575863268,3575863296,28
1,711,10810,3575863268,3575863296,28
1,711,10811,3575863268,3575863297,29
1,711,10812,3575863268,3575863301,33
1,711,10813,3575863268,3575863303,35
1,711,10814,3575863268,3575863304,36
1,711,10815,3575863268,3575863306,38
1,711,10816,3575863268,3575863308,40
1,711,10817,3575863268,3575863308,40
1,711,10818,3575863268,3575863311,43
1,711,10819,3575863268,3575863312,44
1,711,10820,3575863268,3575863315,47
1,712,10821,3575863325,3575863325,0
1,712,10822,3575863325,3575863327,2
1,712,10823,3575863325,3575863327,2
1,712,10824,3575863325,3575863329,4
1,712,10825,3575863325,3575863330,5
1,712,10826,3575863325,3575863330,5
1,712,10827,3575863325,3575863331,6
1,712,10828,3575863325,3575863331,6
1,712,10829,3575863325,3575863331,6
1,712,10830,3575863325,3575863332,7
1,712,10831,3575863325,3575863334,9
1,712,10832,3575863325,3575863335,10
1,712,10833,3575863325,3575863335,10
1,712,10834,3575863325,3575863338,13
1,712,10835,3575863325,3575863340,15
1,712,10836,3575863325,3575863340,15
1,712,10837,3575863325,3575863344,19
1,712,10838,3575863325,3575863345,20
1,712,10839,3575863325,3575863347,22
1,712,10840,3575863325,3575863351,26
1,712,10841,3575863325,3575863353,28
1,712,10842,3575863325,3575863353,28
1,712,10843,3575863325,3575863354,29
1,712,10844,3575863325,3575863356,31
1,712,10845,3575863325,3575863358,33
1,712,10846,3575863325,3575863359,34
1,712,10847,3575863325,3575863360,35
1,712,10848,3575863325,3575863361,36
1,712,10849,3575863325,3575863361,36
1,712,10850,3575863325,3575863362,37
1,712,10851,3575863325,3575863363,38
1,712,10852,3575863325,3575863364,39
1,712,10853,3575863325,3575863367,42
1,712,10854,3575863325,3575863368,43
1,712,10855,3575863325,3575863369,44
1,712,10856,3575863325,3575863373,48
1,712,10857,3575863325,3575863375,50
1,713,10858,3575863382,3575863382,0
1,713,10859,3575863382,3575863382,0
1,713,10860,3575863382,3575863382,0
1,713,10861,3575863382,3575863382,0
1,713,10862,3575863382,3575863382,0
1,713,10863,3575863382,3575863382,0
1,713,10864,3575863382,3575863382,0
1,713,10865,3575863382,3575863384,2
1,713,10866,3575863382,3575863385,3
1,713,10867,3575863382,3575863385,3
1,713,10868,3575863382,3575863386,4
1,713,10869,3575863382,3575863387,5
1,713,10870,3575863382,3575863390,8
1,713,10871,3575863382,3575863391,9
1,713,10872,3575863382,3575863392,10
1,713,10873,3575863382,3575863393,11
1,713,10874,3575863382,3575863393,11
1,713,10875,3575863382,3575863393,11
1,713,10876,3575863382,3575863397,15
1,713,10877,3575863382,3575863398,16
1,713,10878,3575863382,3575863402,20
1,713,10879,3575863382,3575863402,20
1,713,10880,3575863382,3575863403,21
1,713,10881,3575863382,3575863403,21
1,713,10882,3575863382,3575863408,26
1,713,10883,3575863382,3575863409,27
1,713,10884,3575863382,3575863410,28
1,713,10885,3575863382,3575863411,29
1,713,10886,3575863382,3575863416,34
1,713,10887,3575863382,3575863416,34
1,713,10888,3575863382,3575863416,34
1,713,10889,3575863382,3575863416,34
1,713,10890,3575863382,3575863416,34
1,713,10891,3575863382,3575863417,35
1,713,10892,3575863382,3575863417,35
1,713,10893,3575863382,3575863417,35
1,713,10894,3575863382,3575863418,36
1,713,10895,3575863382,3575863419,37
1,713,10896,3575863382,3575863420,38
1,713,10897,3575863382,3575863421,39
1,713,10898,3575863382,3575863422,40
1,713,10899,3575863382,3575863422,40
1,713,10900,3575863382,3575863423,41
1,713,10901,3575863382,3575863424,42
1,713,10902,3575863382,3575863424,42
1,713,10903,3575863382,3575863425,43
1,713,10904,3575863382,3575863430,48
1,713,10905,3575863382,3575863430,48
1,713,10906,3575863382,3575863430,48
1,713,10907,3575863382,3575863431,49
1,713,10908,3575863382,3575863431,49
1,714,10909,3575863439,3575863439,0
1,714,10910,3575863439,3575863439,0
1,714,10911,3575863439,3575863439,0
1,714,10912,3575863439,3575863439,0
1,714,10913,3575863439,3575863439,0
1,714,10914,3575863439,3575863439,0
1,714,10915,3575863439,3575863441,2
1,714,10916,3575863439,3575863441,2
1,714,10917,3575863439,3575863441,2
1,714,10918,3575863439,3575863442,3
1,714,10919,3575863439,3575863444,5
1,714,10920,3575863439,3575863445,6
1,714,10921,3575863439,3575863451,12
1,714,10922,3575863439,3575863451,12
1,714,10923,3575863439,3575863451,12
1,714,10924,3575863439,3575863453,14
1,714,10925,3575863439,3575863455,16
1,714,10926,3575863439,3575863455,16
1,714,10927,3575863439,3575863456,17
1,714,10928,3575863439,3575863462,23
1,714,10929,3575863439,3575863464,25
1,714,10930,3575863439,3575863466,27
1,714,10931,3575863439,3575863467,28
1,714,10932,3575863439,3575863467,28
1,714,10933,3575863439,3575863479,40
1,714,10934,3575863439,3575863481,42
1,714,10935,3575863439,3575863482,43
1,714,10936,3575863439,3575863485,46
1,714,10937,3575863439,3575863486,47
1,714,10938,3575863439,3575863486,47
1,714,10939,3575863439,3575863487,48
1,715,10940,3575863496,3575863496,0
1,715,10941,3575863496,3575863496,0
1,715,10942,3575863496,3575863496,0
1,715,10943,3575863496,3575863496,0
1,715,10944,3575863496,3575863496,0
1,715,10945,3575863496,3575863496,0
1,715,10946,3575863496,3575863497,1
1,715,10947,3575863496,3575863500,4
1,715,10948,3575863496,3575863501,5
1,715,10949,3575863496,3575863503,7
1,715,10950,3575863496,3575863505,9
1,715,10951,3575863496,3575863507,11
1,715,10952,3575863496,3575863507,11
1,715,10953,3575863496,3575863511,15
1,715,10954,3575863496,3575863512,16
1,715,10955,3575863496,3575863514,18
1,715,10956,3575863496,3575863519,23
1,715,10957,3575863496,3575863523,27
1,715,10958,3575863496,3575863525,29
1,715,10959,3575863496,3575863526,30
1,715,10960,3575863496,3575863528,32
1,715,10961,3575863496,3575863530,34
1,715,10962,3575863496,3575863530,34
1,715,10963,3575863496,3575863530,34
1,715,10964,3575863496,3575863531,35
1,715,10965,3575863496,3575863532,36
1,715,10966,3575863496,3575863533,37
1,715,10967,3575863496,3575863535,39
1,715,10968,3575863496,3575863535,39
1,715,10969,3575863496,3575863539,43
1,715,10970,3575863496,3575863540,44
1,715,10971,3575863496,3575863543,47
1,715,10972,3575863496,3575863543,47
1,715,10973,3575863496,3575863544,48
1,716,10974,3575863552,3575863552,0
1,716,10975,3575863552,3575863552,0
1,716,10976,3575863552,3575863553,1
1,716,10977,3575863552,3575863553,1
1,716,10978,3575863552,3575863553,1
1,716,10979,3575863552,3575863556,4
1,716,10980,3575863552,3575863556,4
1,716,10981,3575863552,3575863558,6
1,716,10982,3575863552,3575863559,7
1,716,10983,3575863552,3575863559,7
1,716,10984,3575863552,3575863561,9
1,716,10985,3575863552,3575863561,9
1,716,10986,3575863552,3575863562,10
1,716,10987,3575863552,3575863562,10
1,716,10988,3575863552,3575863562,10
1,716,10989,3575863552,3575863563,11
1,716,10990,3575863552,3575863565,13
1,716,10991,3575863552,3575863566,14
1,716,10992,3575863552,3575863567,15
1,716,10993,3575863552,3575863568,16
1,716,10994,3575863552,3575863573,21
1,716,10995,3575863552,3575863574,22
1,716,10996,3575863552,3575863574,22
1,716,10997,3575863552,3575863575,23
1,716,10998,3575863552,3575863576,24
1,716,10999,3575863552,3575863577,25
1,716,11000,3575863552,3575863580,28
1,716,11001,3575863552,3575863581,29
1,716,11002,3575863552,3575863583,31
1,716,11003,3575863552,3575863585,33
1,716,11004,3575863552,3575863585,33
1,716,11005,3575863552,3575863586,34
1,716,11006,3575863552,3575863587,35
1,716,11007,3575863552,3575863589,37
1,716,11008,3575863552,3575863591,39
1,716,11009,3575863552,3575863591,39
1,716,11010,3575863552,3575863592,40
1,716,11011,3575863552,3575863592,40
1,716,11012,3575863552,3575863592,40
1,716,11013,3575863552,3575863593,41
1,716,11014,3575863552,3575863595,43
1,716,11015,3575863552,3575863598,46
1,716,11016,3575863552,3575863601,49
1,716,11017,3575863552,3575863601,49
1,716,11018,3575863552,3575863602,50
1,717,11019,3575863610,3575863610,0
1,717,11020,3575863610,3575863610,0
1,717,11021,3575863610,3575863610,0
1,717,11022,3575863610,3575863610,0
1,717,11023,3575863610,3575863610,0
1,717,11024,3575863610,3575863610,0
1,717,11025,3575863610,3575863614,4
1,717,11026,3575863610,3575863615,5
1,717,11027,3575863610,3575863615,5
1,717,11028,3575863610,3575863615,5
1,717,11029,3575863610,3575863615,5
1,717,11030,3575863610,3575863615,5
1,717,11031,3575863610,3575863616,6
1,717,11032,3575863610,3575863616,6
1,717,11033,3575863610,3575863616,6
1,717,11034,3575863610,3575863618,8
1,717,11035,3575863610,3575863620,10
1,717,11036,3575863610,3575863620,10
1,717,11037,3575863610,3575863620,10
1,717,11038,3575863610,3575863621,11
1,717,11039,3575863610,3575863622,12
1,717,11040,3575863610,3575863623,13
1,717,11041,3575863610,3575863624,14
1,717,11042,3575863610,3575863624,14
1,717,11043,3575863610,3575863625,15
1,717,11044,3575863610,3575863630,20
1,717,11045,3575863610,3575863630,20
1,717,11046,3575863610,3575863630,20
1,717,11047,3575863610,3575863630,20
1,717,11048,3575863610,3575863630,20
1,717,11049,3575863610,3575863631,21
1,717,11050,3575863610,3575863631,21
1,717,11051,3575863610,3575863633,23
1,717,11052,3575863610,3575863634,24
1,717,11053,3575863610,3575863635,25
1,717,11054,3575863610,3575863638,28
1,717,11055,3575863610,3575863639,29
1,717,11056,3575863610,3575863640,30
1,717,11057,3575863610,3575863640,30
1,717,11058,3575863610,3575863640,30
1,717,11059,3575863610,3575863641,31
1,717,11060,3575863610,3575863644,34
1,717,11061,3575863610,3575863645,35
1,717,11062,3575863610,3575863650,40
1,717,11063,3575863610,3575863651,41
1,717,11064,3575863610,3575863652,42
1,717,11065,3575863610,3575863654,44
1,717,11066,3575863610,3575863654,44
1,717,11067,3575863610,3575863656,46
1,718,11068,3575863666,3575863666,0
1,718,11069,3575863666,3575863666,0
1,718,11070,3575863666,3575863666,0
1,718,11071,3575863666,3575863666,0
1,718,11072,3575863666,3575863666,0
1,718,11073,3575863666,3575863678,12
1,718,11074,3575863666,3575863680,14
1,718,11075,3575863666,3575863682,16
1,718,11076,3575863666,3575863686,20
1,718,11077,3575863666,3575863687,21
1,718,11078,3575863666,3575863692,26
1,718,11079,3575863666,3575863693,27
1,718,11080,3575863666,3575863695,29
1,718,11081,3575863666,3575863695,29
1,718,11082,3575863666,3575863695,29
1,718,11083,3575863666,3575863695,29
1,718,11084,3575863666,3575863695,29
1,718,11085,3575863666,3575863696,30
1,718,11086,3575863666,3575863701,35
1,718,11087,3575863666,3575863701,35
1,718,11088,3575863666,3575863704,38
1,718,11089,3575863666,3575863706,40
1,718,11090,3575863666,3575863707,41
1,718,11091,3575863666,3575863708,42
1,718,11092,3575863666,3575863711,45
1,718,11093,3575863666,3575863711,45
1,719,11094,3575863722,3575863722,0
1,719,11095,3575863722,3575863726,4
1,719,11096,3575863722,3575863728,6
1,719,11097,3575863722,3575863729,7
1,719,11098,3575863722,3575863729,7
1,719,11099,3575863722,3575863729,7
1,719,11100,3575863722,3575863731,9
1,719,11101,3575863722,3575863731,9
1,719,11102,3575863722,3575863731,9
1,719,11103,3575863722,3575863731,9
1,719,11104,3575863722,3575863734,12
1,719,11105,3575863722,3575863735,13
1,719,11106,3575863722,3575863735,13
1,719,11107,3575863722,3575863736,14
1,719,11108,3575863722,3575863741,19
1,719,11109,3575863722,3575863743,21
1,719,11110,3575863722,3575863744,22
1,719,11111,3575863722,3575863744,22
1,719,11112,3575863722,3575863746,24
1,719,11113,3575863722,3575863750,28
1,719,11114,3575863722,3575863753,31
1,719,11115,3575863722,3575863753,31
1,719,11116,3575863722,3575863754,32
1,719,11117,3575863722,3575863756,34
1,719,11118,3575863722,3575863757,35
1,719,11119,3575863722,3575863758,36
1,719,11120,3575863722,3575863759,37
1,719,11121,3575863722,3575863759,37
1,719,11122,3575863722,3575863761,39
1,719,11123,3575863722,3575863761,39
1,719,11124,3575863722,3575863761,39
1,719,11125,3575863722,3575863763,41
1,719,11126,3575863722,3575863763,41
1,719,11127,3575863722,3575863764,42
1,719,11128,3575863722,3575863766,44
1,719,11129,3575863722,3575863768,46
1,719,11130,3575863722,3575863768,46
1,720,11131,3575863778,3575863778,0
1,720,11132,3575863778,3575863778,0
1,720,11133,3575863778,3575863778,0
1,720,11134,3575863778,3575863778,0
1,720,11135,3575863778,3575863778,0
1,720,11136,3575863778,3575863781,3
1,720,11137,3575863778,3575863781,3
1,720,11138,3575863778,3575863781,3
1,720,11139,3575863778,3575863784,6
1,720,11140,3575863778,3575863786,8
1,720,11141,3575863778,3575863786,8
1,720,11142,3575863778,3575863787,9
1,720,11143,3575863778,3575863789,11
1,720,11144,3575863778,3575863791,13
1,720,11145,3575863778,3575863791,13
1,720,11146,3575863778,3575863792,14
1,720,11147,3575863778,3575863792,14
1,720,11148,3575863778,3575863793,15
1,720,11149,3575863778,3575863794,16
1,720,11150,3575863778,3575863795,17
1,720,11151,3575863778,3575863798,20
1,720,11152,3575863778,3575863801,23
1,720,11153,3575863778,3575863801,23
1,720,11154,3575863778,3575863803,25
1,720,11155,3575863778,3575863804,26
1,720,11156,3575863778,3575863808,30
1,720,11157,3575863778,3575863808,30
1,720,11158,3575863778,3575863809,31
1,720,11159,3575863778,3575863811,33
1,720,11160,3575863778,3575863813,35
1,720,11161,3575863778,3575863814,36
1,720,11162,3575863778,3575863815,37
1,720,11163,3575863778,3575863815,37
1,720,11164,3575863778,3575863815,37
1,720,11165,3575863778,3575863815,37
1,720,11166,3575863778,3575863816,38
1,720,11167,3575863778,3575863816,38
1,720,11168,3575863778,3575863816,38
1,720,11169,3575863778,3575863816,38
1,720,11170,3575863778,3575863816,38
1,720,11171,3575863778,3575863818,40
1,720,11172,3575863778,3575863820,42
1,720,11173,3575863778,3575863821,43
1,720,11174,3575863778,3575863822,44
1,720,11175,3575863778,3575863823,45
1,720,11176,3575863778,3575863823,45
1,720,11177,3575863778,3575863824,46
1,720,11178,3575863778,3575863824,46
1,720,11179,3575863778,3575863825,47
1,721,11180,3575863835,3575863835,0
1,721,11181,3575863835,3575863835,0
1,721,11182,3575863835,3575863835,0
1,721,11183,3575863835,3575863835,0
1,721,11184,3575863835,3575863835,0
1,721,11185,3575863835,3575863835,0
1,721,11186,3575863835,3575863835,0
1,721,11187,3575863835,3575863835,0
1,721,11188,3575863835,3575863835,0
1,721,11189,3575863835,3575863835,0
1,721,11190,3575863835,3575863838,3
1,721,11191,3575863835,3575863839,4
1,721,11192,3575863835,3575863840,5
1,721,11193,3575863835,3575863840,5
1,721,11194,3575863835,3575863841,6
1,721,11195,3575863835,3575863842,7
1,721,11196,3575863835,3575863845,10
1,721,11197,3575863835,3575863850,15
1,721,11198,3575863835,3575863851,16
1,721,11199,3575863835,3575863851,16
1,721,11200,3575863835,3575863853,18
1,721,11201,3575863835,3575863853,18
1,721,11202,3575863835,3575863854,19
1,721,11203,3575863835,3575863855,20
1,721,11204,3575863835,3575863863,28
1,721,11205,3575863835,3575863864,29
1,721,11206,3575863835,3575863864,29
1,721,11207,3575863835,3575863866,31
1,721,11208,3575863835,3575863866,31
1,721,11209,3575863835,3575863879,44
1,721,11210,3575863835,3575863879,44
1,721,11211,3575863835,3575863879,44
1,721,11212,3575863835,3575863881,46
1,721,11213,3575863835,3575863882,47
1,722,11214,3575863892,3575863892,0
1,722,11215,3575863892,3575863892,0
1,722,11216,3575863892,3575863892,0
1,722,11217,3575863892,3575863894,2
1,722,11218,3575863892,3575863894,2
1,722,11219,3575863892,3575863895,3
1,722,11220,3575863892,3575863895,3
1,722,11221,3575863892,3575863896,4
1,722,11222,3575863892,3575863896,4
1,722,11223,3575863892,3575863901,9
1,722,11224,3575863892,3575863902,10
1,722,11225,3575863892,3575863904,12
1,722,11226,3575863892,3575863906,14
1,722,11227,3575863892,3575863908,16
1,722,11228,3575863892,3575863909,17
1,722,11229,3575863892,3575863911,19
1,722,11230,3575863892,3575863915,23
1,722,11231,3575863892,3575863919,27
1,722,11232,3575863892,3575863923,31
1,722,11233,3575863892,3575863927,35
1,722,11234,3575863892,3575863928,36
1,722,11235,3575863892,3575863929,37
1,722,11236,3575863892,3575863930,38
1,722,11237,3575863892,3575863930,38
1,722,11238,3575863892,3575863931,39
1,722,11239,3575863892,3575863931,39
1,722,11240,3575863892,3575863931,39
1,722,11241,3575863892,3575863934,42
1,722,11242,3575863892,3575863935,43
1,722,11243,3575863892,3575863935,43
1,722,11244,3575863892,3575863937,45
1,722,11245,3575863892,3575863939,47
1,722,11246,3575863892,3575863940,48
1,723,11247,3575863948,3575863948,0
1,723,11248,3575863948,3575863948,0
1,723,11249,3575863948,3575863948,0
1,723,11250,3575863948,3575863948,0
1,723,11251,3575863948,3575863951,3
1,723,11252,3575863948,3575863953,5
1,723,11253,3575863948,3575863953,5
1,723,11254,3575863948,3575863953,5
1,723,11255,3575863948,3575863956,8
1,723,11256,3575863948,3575863957,9
1,723,11257,3575863948,3575863958,10
1,723,11258,3575863948,3575863959,11
1,723,11259,3575863948,3575863959,11
1,723,11260,3575863948,3575863961,13
1,723,11261,3575863948,3575863961,13
1,723,11262,3575863948,3575863962,14
1,723,11263,3575863948,3575863963,15
1,723,11264,3575863948,3575863965,17
1,723,11265,3575863948,3575863966,18
1,723,11266,3575863948,3575863968,20
1,723,11267,3575863948,3575863969,21
1,723,11268,3575863948,3575863974,26
1,723,11269,3575863948,3575863974,26
1,723,11270,3575863948,3575863975,27
1,723,11271,3575863948,3575863977,29
1,723,11272,3575863948,3575863977,29
1,723,11273,3575863948,3575863977,29
1,723,11274,3575863948,3575863981,33
1,723,11275,3575863948,3575863981,33
1,723,11276,3575863948,3575863985,37
1,723,11277,3575863948,3575863985,37
1,723,11278,3575863948,3575863986,38
1,723,11279,3575863948,3575863986,38
1,723,11280,3575863948,3575863987,39
1,723,11281,3575863948,3575863990,42
1,723,11282,3575863948,3575863990,42
1,723,11283,3575863948,3575863991,43
1,723,11284,3575863948,3575863993,45
1,723,11285,3575863948,3575863993,45
1,723,11286,3575863948,3575863995,47
1,723,11287,3575863948,3575863996,48
1,724,11288,3575864004,3575864004,0
1,724,11289,3575864004,3575864004,0
1,724,11290,3575864004,3575864004,0
1,724,11291,3575864004,3575864004,0
1,724,11292,3575864004,3575864004,0
1,724,11293,3575864004,3575864008,4
1,724,11294,3575864004,3575864008,4
1,724,11295,3575864004,3575864009,5
1,724,11296,3575864004,3575864010,6
1,724,11297,3575864004,3575864013,9
1,724,11298,3575864004,3575864015,11
1,724,11299,3575864004,3575864015,11
1,724,11300,3575864004,3575864015,11
1,724,11301,3575864004,3575864015,11
1,724,11302,3575864004,3575864016,12
1,724,11303,3575864004,3575864016,12
1,724,11304,3575864004,3575864016,12
1,724,11305,3575864004,3575864016,12
1,724,11306,3575864004,3575864017,13
1,724,11307,3575864004,3575864018,14
1,724,11308,3575864004,3575864019,15
1,724,11309,3575864004,3575864020,16
1,724,11310,3575864004,3575864020,16
1,724,11311,3575864004,3575864022,18
1,724,11312,3575864004,3575864022,18
1,724,11313,3575864004,3575864023,19
1,724,11314,3575864004,3575864023,19
1,724,11315,3575864004,3575864024,20
1,724,11316,3575864004,3575864024,20
1,724,11317,3575864004,3575864025,21
1,724,11318,3575864004,3575864029,25
1,724,11319,3575864004,3575864030,26
1,724,11320,3575864004,3575864030,26
1,724,11321,3575864004,3575864031,27
1,724,11322,3575864004,3575864032,28
1,724,11323,3575864004,3575864033,29
1,724,11324,3575864004,3575864033,29
1,724,11325,3575864004,3575864034,30
1,724,11326,3575864004,3575864034,30
1,724,11327,3575864004,3575864035,31
1,724,11328,3575864004,3575864035,31
1,724,11329,3575864004,3575864038,34
1,724,11330,3575864004,3575864039,35
1,724,11331,3575864004,3575864040,36
1,724,11332,3575864004,3575864041,37
1,724,11333,3575864004,3575864042,38
1,724,11334,3575864004,3575864045,41
1,724,11335,3575864004,3575864049,45
1,724,11336,3575864004,3575864050,46
1,724,11337,3575864004,3575864051,47
1,724,11338,3575864004,3575864051,47
1,724,11339,3575864004,3575864052,48
1,724,11340,3575864004,3575864054,50
1,725,11341,3575864063,3575864063,0
1,725,11342,3575864063,3575864063,0
1,725,11343,3575864063,3575864063,0
1,725,11344,3575864063,3575864063,0
1,725,11345,3575864063,3575864064,1
1,725,11346,3575864063,3575864065,2
1,725,11347,3575864063,3575864066,3
1,725,11348,3575864063,3575864079,16
1,725,11349,3575864063,3575864079,16
1,725,11350,3575864063,3575864080,17
1,725,11351,3575864063,3575864081,18
1,725,11352,3575864063,3575864083,20
1,725,11353,3575864063,3575864085,22
1,725,11354,3575864063,3575864086,23
1,725,11355,3575864063,3575864091,28
1,725,11356,3575864063,3575864093,30
1,725,11357,3575864063,3575864093,30
1,725,11358,3575864063,3575864095,32
1,725,11359,3575864063,3575864095,32
1,725,11360,3575864063,3575864096,33
1,725,11361,3575864063,3575864096,33
1,725,11362,3575864063,3575864097,34
1,725,11363,3575864063,3575864101,38
1,725,11364,3575864063,3575864103,40
1,725,11365,3575864063,3575864103,40
1,725,11366,3575864063,3575864106,43
1,725,11367,3575864063,3575864107,44
1,725,11368,3575864063,3575864109,46
1,725,11369,3575864063,3575864111,48
1,726,11370,3575864120,3575864120,0
1,726,11371,3575864120,3575864120,0
1,726,11372,3575864120,3575864124,4
1,726,11373,3575864120,3575864125,5
1,726,11374,3575864120,3575864127,7
1,726,11375,3575864120,3575864129,9
1,726,11376,3575864120,3575864130,10
1,726,11377,3575864120,3575864131,11
1,726,11378,3575864120,3575864131,11
1,726,11379,3575864120,3575864131,11
1,726,11380,3575864120,3575864132,12
1,726,11381,3575864120,3575864133,13
1,726,11382,3575864120,3575864134,14
1,726,11383,3575864120,3575864134,14
1,726,11384,3575864120,3575864135,15
1,726,11385,3575864120,3575864136,16
1,726,11386,3575864120,3575864136,16
1,726,11387,3575864120,3575864139,19
1,726,11388,3575864120,3575864141,21
1,726,11389,3575864120,3575864144,24
1,726,11390,3575864120,3575864144,24
1,726,11391,3575864120,3575864144,24
1,726,11392,3575864120,3575864146,26
1,726,11393,3575864120,3575864151,31
1,726,11394,3575864120,3575864152,32
1,726,11395,3575864120,3575864153,33
1,726,11396,3575864120,3575864154,34
1,726,11397,3575864120,3575864156,36
1,726,11398,3575864120,3575864158,38
1,726,11399,3575864120,3575864158,38
1,726,11400,3575864120,3575864159,39
1,726,11401,3575864120,3575864159,39
1,726,11402,3575864120,3575864161,41
1,726,11403,3575864120,3575864161,41
1,726,11404,3575864120,3575864163,43
1,726,11405,3575864120,3575864164,44
1,726,11406,3575864120,3575864168,48
1,727,11407,3575864176,3575864176,0
1,727,11408,3575864176,3575864176,0
1,727,11409,3575864176,3575864176,0
1,727,11410,3575864176,3575864176,0
1,727,11411,3575864176,3575864176,0
1,727,11412,3575864176,3575864177,1
1,727,11413,3575864176,3575864177,1
1,727,11414,3575864176,3575864177,1
1,727,11415,3575864176,3575864180,4
1,727,11416,3575864176,3575864181,5
1,727,11417,3575864176,3575864181,5
1,727,11418,3575864176,3575864185,9
1,727,11419,3575864176,3575864185,9
1,727,11420,3575864176,3575864186,10
1,727,11421,3575864176,3575864187,11
1,727,11422,3575864176,3575864187,11
1,727,11423,3575864176,3575864190,14
1,727,11424,3575864176,3575864190,14
1,727,11425,3575864176,3575864191,15
1,727,11426,3575864176,3575864193,17
1,727,11427,3575864176,3575864193,17
1,727,11428,3575864176,3575864194,18
1,727,11429,3575864176,3575864196,20
1,727,11430,3575864176,3575864197,21
1,727,11431,3575864176,3575864198,22
1,727,11432,3575864176,3575864201,25
1,727,11433,3575864176,3575864201,25
1,727,11434,3575864176,3575864202,26
1,727,11435,3575864176,3575864203,27
1,727,11436,3575864176,3575864206,30
1,727,11437,3575864176,3575864207,31
1,727,11438,3575864176,3575864209,33
1,727,11439,3575864176,3575864210,34
1,727,11440,3575864176,3575864210,34
1,727,11441,3575864176,3575864214,38
1,727,11442,3575864176,3575864215,39
1,727,11443,3575864176,3575864215,39
1,727,11444,3575864176,3575864216,40
1,727,11445,3575864176,3575864216,40
1,727,11446,3575864176,3575864216,40
1,727,11447,3575864176,3575864216,40
1,727,11448,3575864176,3575864216,40
1,727,11449,3575864176,3575864217,41
1,727,11450,3575864176,3575864218,42
1,727,11451,3575864176,3575864219,43
1,727,11452,3575864176,3575864221,45
1,727,11453,3575864176,3575864223,47
1,727,11454,3575864176,3575864224,48
1,727,11455,3575864176,3575864224,48
1,727,11456,3575864176,3575864225,49
1,728,11457,3575864234,3575864234,0
1,728,11458,3575864234,3575864234,0
1,728,11459,3575864234,3575864234,0
1,728,11460,3575864234,3575864234,0
1,728,11461,3575864234,3575864234,0
1,728,11462,3575864234,3575864234,0
1,728,11463,3575864234,3575864234,0
1,728,11464,3575864234,3575864234,0
1,728,11465,3575864234,3575864234,0
1,728,11466,3575864234,3575864235,1
1,728,11467,3575864234,3575864235,1
1,728,11468,3575864234,3575864235,1
1,728,11469,3575864234,3575864237,3
1,728,11470,3575864234,3575864239,5
1,728,11471,3575864234,3575864240,6
1,728,11472,3575864234,3575864241,7
1,728,11473,3575864234,3575864242,8
1,728,11474,3575864234,3575864244,10
1,728,11475,3575864234,3575864246,12
1,728,11476,3575864234,3575864251,17
1,728,11477,3575864234,3575864251,17
1,728,11478,3575864234,3575864251,17
1,728,11479,3575864234,3575864252,18
1,728,11480,3575864234,3575864253,19
1,728,11481,3575864234,3575864254,20
1,728,11482,3575864234,3575864255,21
1,728,11483,3575864234,3575864263,29
1,728,11484,3575864234,3575864264,30
1,728,11485,3575864234,3575864264,30
1,728,11486,3575864234,3575864266,32
1,728,11487,3575864234,3575864267,33
1,728,11488,3575864234,3575864279,45
1,728,11489,3575864234,3575864279,45
1,728,11490,3575864234,3575864279,45
1,728,11491,3575864234,3575864281,47
1,728,11492,3575864234,3575864283,49
1,729,11493,3575864292,3575864292,0
1,729,11494,3575864292,3575864292,0
1,729,11495,3575864292,3575864292,0
1,729,11496,3575864292,3575864293,1
1,729,11497,3575864292,3575864293,1
1,729,11498,3575864292,3575864294,2
1,729,11499,3575864292,3575864295,3
1,729,11500,3575864292,3575864295,3
1,729,11501,3575864292,3575864295,3
1,729,11502,3575864292,3575864296,4
1,729,11503,3575864292,3575864297,5
1,729,11504,3575864292,3575864297,5
1,729,11505,3575864292,3575864301,9
1,729,11506,3575864292,3575864304,12
1,729,11507,3575864292,3575864304,12
1,729,11508,3575864292,3575864306,14
1,729,11509,3575864292,3575864307,15
1,729,11510,3575864292,3575864309,17
1,729,11511,3575864292,3575864312,20
1,729,11512,3575864292,3575864316,24
1,729,11513,3575864292,3575864319,27
1,729,11514,3575864292,3575864324,32
1,729,11515,3575864292,3575864325,33
1,729,11516,3575864292,3575864326,34
1,729,11517,3575864292,3575864328,36
1,729,11518,3575864292,3575864328,36
1,729,11519,3575864292,3575864329,37
1,729,11520,3575864292,3575864330,38
1,729,11521,3575864292,3575864331,39
1,729,11522,3575864292,3575864331,39
1,729,11523,3575864292,3575864332,40
1,729,11524,3575864292,3575864332,40
1,729,11525,3575864292,3575864335,43
1,729,11526,3575864292,3575864335,43
1,729,11527,3575864292,3575864336,44
1,729,11528,3575864292,3575864336,44
1,729,11529,3575864292,3575864337,45
1,729,11530,3575864292,3575864340,48
1,729,11531,3575864292,3575864340,48
1,729,11532,3575864292,3575864341,49
1,730,11533,3575864351,3575864351,0
1,730,11534,3575864351,3575864351,0
1,730,11535,3575864351,3575864351,0
1,730,11536,3575864351,3575864351,0
1,730,11537,3575864351,3575864351,0
1,730,11538,3575864351,3575864353,2
1,730,11539,3575864351,3575864353,2
1,730,11540,3575864351,3575864353,2
1,730,11541,3575864351,3575864357,6
1,730,11542,3575864351,3575864357,6
1,730,11543,3575864351,3575864358,7
1,730,11544,3575864351,3575864359,8
1,730,11545,3575864351,3575864359,8
1,730,11546,3575864351,3575864361,10
1,730,11547,3575864351,3575864362,11
1,730,11548,3575864351,3575864362,11
1,730,11549,3575864351,3575864363,12
1,730,11550,3575864351,3575864363,12
1,730,11551,3575864351,3575864365,14
1,730,11552,3575864351,3575864366,15
1,730,11553,3575864351,3575864368,17
1,730,11554,3575864351,3575864370,19
1,730,11555,3575864351,3575864374,23
1,730,11556,3575864351,3575864374,23
1,730,11557,3575864351,3575864376,25
1,730,11558,3575864351,3575864377,26
1,730,11559,3575864351,3575864377,26
1,730,11560,3575864351,3575864377,26
1,730,11561,3575864351,3575864381,30
1,730,11562,3575864351,3575864381,30
1,730,11563,3575864351,3575864383,32
1,730,11564,3575864351,3575864385,34
1,730,11565,3575864351,3575864386,35
1,730,11566,3575864351,3575864386,35
1,730,11567,3575864351,3575864387,36
1,730,11568,3575864351,3575864387,36
1,730,11569,3575864351,3575864390,39
1,730,11570,3575864351,3575864391,40
1,730,11571,3575864351,3575864391,40
1,730,11572,3575864351,3575864393,42
1,730,11573,3575864351,3575864393,42
1,730,11574,3575864351,3575864396,45
1,730,11575,3575864351,3575864396,45
1,730,11576,3575864351,3575864399,48
1,731,11577,3575864409,3575864409,0
1,731,11578,3575864409,3575864409,0
1,731,11579,3575864409,3575864409,0
1,731,11580,3575864409,3575864409,0
1,731,11581,3575864409,3575864409,0
1,731,11582,3575864409,3575864409,0
1,731,11583,3575864409,3575864410,1
1,731,11584,3575864409,3575864415,6
1,731,11585,3575864409,3575864415,6
1,731,11586,3575864409,3575864415,6
1,731,11587,3575864409,3575864416,7
1,731,11588,3575864409,3575864416,7
1,731,11589,3575864409,3575864416,7
1,731,11590,3575864409,3575864416,7
1,731,11591,3575864409,3575864417,8
1,731,11592,3575864409,3575864417,8
1,731,11593,3575864409,3575864417,8
1,731,11594,3575864409,3575864418,9
1,731,11595,3575864409,3575864418,9
1,731,11596,3575864409,3575864421,12
1,731,11597,3575864409,3575864422,13
1,731,11598,3575864409,3575864423,14
1,731,11599,3575864409,3575864423,14
1,731,11600,3575864409,3575864424,15
1,731,11601,3575864409,3575864425,16
1,731,11602,3575864409,3575864425,16
1,731,11603,3575864409,3575864430,21
1,731,11604,3575864409,3575864431,22
1,731,11605,3575864409,3575864431,22
1,731,11606,3575864409,3575864431,22
1,731,11607,3575864409,3575864431,22
1,731,11608,3575864409,3575864432,23
1,731,11609,3575864409,3575864433,24
1,731,11610,3575864409,3575864434,25
1,731,11611,3575864409,3575864434,25
1,731,11612,3575864409,3575864435,26
1,731,11613,3575864409,3575864435,26
1,731,11614,3575864409,3575864436,27
1,731,11615,3575864409,3575864437,28
1,731,11616,3575864409,3575864439,30
1,731,11617,3575864409,3575864440,31
1,731,11618,3575864409,3575864441,32
1,731,11619,3575864409,3575864441,32
1,731,11620,3575864409,3575864441,32
1,731,11621,3575864409,3575864442,33
1,731,11622,3575864409,3575864445,36
1,731,11623,3575864409,3575864446,37
1,731,11624,3575864409,3575864451,42
1,731,11625,3575864409,3575864451,42
1,731,11626,3575864409,3575864453,44
1,731,11627,3575864409,3575864454,45
1,731,11628,3575864409,3575864454,45
1,731,11629,3575864409,3575864455,46
1,732,11630,3575864467,3575864467,0
1,732,11631,3575864467,3575864467,0
1,732,11632,3575864467,3575864467,0
1,732,11633,3575864467,3575864467,0
1,732,11634,3575864467,3575864467,0
1,732,11635,3575864467,3575864468,1
1,732,11636,3575864467,3575864479,12
1,732,11637,3575864467,3575864479,12
1,732,11638,3575864467,3575864480,13
1,732,11639,3575864467,3575864481,14
1,732,11640,3575864467,3575864483,16
1,732,11641,3575864467,3575864486,19
1,732,11642,3575864467,3575864487,20
1,732,11643,3575864467,3575864493,26
1,732,11644,3575864467,3575864494,27
1,732,11645,3575864467,3575864494,27
1,732,11646,3575864467,3575864495,28
1,732,11647,3575864467,3575864495,28
1,732,11648,3575864467,3575864496,29
1,732,11649,3575864467,3575864496,29
1,732,11650,3575864467,3575864497,30
1,732,11651,3575864467,3575864501,34
1,732,11652,3575864467,3575864505,38
1,732,11653,3575864467,3575864506,39
1,732,11654,3575864467,3575864509,42
1,732,11655,3575864467,3575864511,44
1,732,11656,3575864467,3575864513,46
1,732,11657,3575864467,3575864515,48
1,733,11658,3575864524,3575864524,0
1,733,11659,3575864524,3575864524,0
1,733,11660,3575864524,3575864524,0
1,733,11661,3575864524,3575864525,1
1,733,11662,3575864524,3575864526,2
1,733,11663,3575864524,3575864530,6
1,733,11664,3575864524,3575864530,6
1,733,11665,3575864524,3575864530,6
1,733,11666,3575864524,3575864531,7
1,733,11667,3575864524,3575864531,7
1,733,11668,3575864524,3575864533,9
1,733,11669,3575864524,3575864534,10
1,733,11670,3575864524,3575864536,12
1,733,11671,3575864524,3575864536,12
1,733,11672,3575864524,3575864536,12
1,733,11673,3575864524,3575864539,15
1,733,11674,3575864524,3575864541,17
1,733,11675,3575864524,3575864543,19
1,733,11676,3575864524,3575864543,19
1,733,11677,3575864524,3575864543,19
1,733,11678,3575864524,3575864546,22
1,733,11679,3575864524,3575864550,26
1,733,11680,3575864524,3575864552,28
1,733,11681,3575864524,3575864553,29
1,733,11682,3575864524,3575864553,29
1,733,11683,3575864524,3575864557,33
1,733,11684,3575864524,3575864557,33
1,733,11685,3575864524,3575864558,34
1,733,11686,3575864524,3575864559,35
1,733,11687,3575864524,3575864560,36
1,733,11688,3575864524,3575864562,38
1,733,11689,3575864524,3575864562,38
1,733,11690,3575864524,3575864562,38
1,733,11691,3575864524,3575864564,40
1,733,11692,3575864524,3575864567,43
1,733,11693,3575864524,3575864569,45
1,733,11694,3575864524,3575864574,50
1,734,11695,3575864580,3575864580,0
1,734,11696,3575864580,3575864580,0
1,734,11697,3575864580,3575864580,0
1,734,11698,3575864580,3575864580,0
1,734,11699,3575864580,3575864580,0
1,734,11700,3575864580,3575864580,0
1,734,11701,3575864580,3575864581,1
1,734,11702,3575864580,3575864584,4
1,734,11703,3575864580,3575864584,4
1,734,11704,3575864580,3575864585,5
1,734,11705,3575864580,3575864586,6
1,734,11706,3575864580,3575864587,7
1,734,11707,3575864580,3575864590,10
1,734,11708,3575864580,3575864590,10
1,734,11709,3575864580,3575864591,11
1,734,11710,3575864580,3575864592,12
1,734,11711,3575864580,3575864595,15
1,734,11712,3575864580,3575864596,16
1,734,11713,3575864580,3575864597,17
1,734,11714,3575864580,3575864602,22
1,734,11715,3575864580,3575864602,22
1,734,11716,3575864580,3575864603,23
1,734,11717,3575864580,3575864604,24
1,734,11718,3575864580,3575864607,27
1,734,11719,3575864580,3575864608,28
1,734,11720,3575864580,3575864609,29
1,734,11721,3575864580,3575864614,34
1,734,11722,3575864580,3575864614,34
1,734,11723,3575864580,3575864614,34
1,734,11724,3575864580,3575864614,34
1,734,11725,3575864580,3575864615,35
1,734,11726,3575864580,3575864615,35
1,734,11727,3575864580,3575864615,35
1,734,11728,3575864580,3575864616,36
1,734,11729,3575864580,3575864616,36
1,734,11730,3575864580,3575864617,37
1,734,11731,3575864580,3575864617,37
1,734,11732,3575864580,3575864618,38
1,734,11733,3575864580,3575864620,40
1,734,11734,3575864580,3575864620,40
1,734,11735,3575864580,3575864621,41
1,734,11736,3575864580,3575864622,42
1,734,11737,3575864580,3575864622,42
1,734,11738,3575864580,3575864624,44
1,734,11739,3575864580,3575864624,44
1,734,11740,3575864580,3575864625,45
1,734,11741,3575864580,3575864630,50
1,735,11742,3575864638,3575864638,0
1,735,11743,3575864638,3575864638,0
1,735,11744,3575864638,3575864638,0
1,735,11745,3575864638,3575864638,0
1,735,11746,3575864638,3575864638,0
1,735,11747,3575864638,3575864638,0
1,735,11748,3575864638,3575864638,0
1,735,11749,3575864638,3575864638,0
1,735,11750,3575864638,3575864638,0
1,735,11751,3575864638,3575864638,0
1,735,11752,3575864638,3575864638,0
1,735,11753,3575864638,3575864639,1
1,735,11754,3575864638,3575864640,2
1,735,11755,3575864638,3575864641,3
1,735,11756,3575864638,3575864641,3
1,735,11757,3575864638,3575864641,3
1,735,11758,3575864638,3575864641,3
1,735,11759,3575864638,3575864644,6
1,735,11760,3575864638,3575864645,7
1,735,11761,3575864638,3575864649,11
1,735,11762,3575864638,3575864650,12
1,735,11763,3575864638,3575864651,13
1,735,11764,3575864638,3575864652,14
1,735,11765,3575864638,3575864654,16
1,735,11766,3575864638,3575864656,18
1,735,11767,3575864638,3575864662,24
1,735,11768,3575864638,3575864664,26
1,735,11769,3575864638,3575864664,26
1,735,11770,3575864638,3575864665,27
1,735,11771,3575864638,3575864666,28
1,735,11772,3575864638,3575864667,29
1,735,11773,3575864638,3575864679,41
1,735,11774,3575864638,3575864679,41
1,735,11775,3575864638,3575864680,42
1,735,11776,3575864638,3575864682,44
1,735,11777,3575864638,3575864683,45
1,735,11778,3575864638,3575864683,45
1,735,11779,3575864638,3575864686,48
1,735,11780,3575864638,3575864687,49
1,736,11781,3575864695,3575864695,0
1,736,11782,3575864695,3575864695,0
1,736,11783,3575864695,3575864695,0
1,736,11784,3575864695,3575864695,0
1,736,11785,3575864695,3575864695,0
1,736,11786,3575864695,3575864696,1
1,736,11787,3575864695,3575864697,2
1,736,11788,3575864695,3575864701,6
1,736,11789,3575864695,3575864703,8
1,736,11790,3575864695,3575864704,9
1,736,11791,3575864695,3575864706,11
1,736,11792,3575864695,3575864707,12
1,736,11793,3575864695,3575864709,14
1,736,11794,3575864695,3575864712,17
1,736,11795,3575864695,3575864713,18
1,736,11796,3575864695,3575864716,21
1,736,11797,3575864695,3575864718,23
1,736,11798,3575864695,3575864723,28
1,736,11799,3575864695,3575864724,29
1,736,11800,3575864695,3575864725,30
1,736,11801,3575864695,3575864728,33
1,736,11802,3575864695,3575864730,35
1,736,11803,3575864695,3575864731,36
1,736,11804,3575864695,3575864731,36
1,736,11805,3575864695,3575864731,36
1,736,11806,3575864695,3575864731,36
1,736,11807,3575864695,3575864734,39
1,736,11808,3575864695,3575864734,39
1,736,11809,3575864695,3575864736,41
1,736,11810,3575864695,3575864737,42
1,736,11811,3575864695,3575864739,44
1,736,11812,3575864695,3575864739,44
1,736,11813,3575864695,3575864741,46
1,736,11814,3575864695,3575864743,48
1,736,11815,3575864695,3575864743,48
1,736,11816,3575864695,3575864744,49
1,737,11817,3575864750,3575864750,0
1,737,11818,3575864750,3575864751,1
1,737,11819,3575864750,3575864751,1
1,737,11820,3575864750,3575864753,3
1,737,11821,3575864750,3575864757,7
1,737,11822,3575864750,3575864757,7
1,737,11823,3575864750,3575864758,8
1,737,11824,3575864750,3575864759,9
1,737,11825,3575864750,3575864761,11
1,737,11826,3575864750,3575864761,11
1,737,11827,3575864750,3575864762,12
1,737,11828,3575864750,3575864763,13
1,737,11829,3575864750,3575864764,14
1,737,11830,3575864750,3575864764,14
1,737,11831,3575864750,3575864767,17
1,737,11832,3575864750,3575864770,20
1,737,11833,3575864750,3575864774,24
1,737,11834,3575864750,3575864774,24
1,737,11835,3575864750,3575864775,25
1,737,11836,3575864750,3575864775,25
1,737,11837,3575864750,3575864776,26
1,737,11838,3575864750,3575864778,28
1,737,11839,3575864750,3575864781,31
1,737,11840,3575864750,3575864782,32
1,737,11841,3575864750,3575864784,34
1,737,11842,3575864750,3575864784,34
1,737,11843,3575864750,3575864785,35
1,737,11844,3575864750,3575864785,35
1,737,11845,3575864750,3575864786,36
1,737,11846,3575864750,3575864787,37
1,737,11847,3575864750,3575864789,39
1,737,11848,3575864750,3575864791,41
1,737,11849,3575864750,3575864791,41
1,737,11850,3575864750,3575864792,42
1,737,11851,3575864750,3575864792,42
1,737,11852,3575864750,3575864796,46
1,737,11853,3575864750,3575864796,46
1,737,11854,3575864750,3575864797,47
1,738,11855,3575864808,3575864808,0
1,738,11856,3575864808,3575864808,0
1,738,11857,3575864808,3575864808,0
1,738,11858,3575864808,3575864808,0
1,738,11859,3575864808,3575864808,0
1,738,11860,3575864808,3575864809,1
1,738,11861,3575864808,3575864809,1
1,738,11862,3575864808,3575864811,3
1,738,11863,3575864808,3575864814,6
1,738,11864,3575864808,3575864815,7
1,738,11865,3575864808,3575864815,7
1,738,11866,3575864808,3575864815,7
1,738,11867,3575864808,3575864815,7
1,738,11868,3575864808,3575864816,8
1,738,11869,3575864808,3575864816,8
1,738,11870,3575864808,3575864816,8
1,738,11871,3575864808,3575864816,8
1,738,11872,3575864808,3575864817,9
1,738,11873,3575864808,3575864817,9
1,738,11874,3575864808,3575864817,9
1,738,11875,3575864808,3575864818,10
1,738,11876,3575864808,3575864821,13
1,738,11877,3575864808,3575864821,13
1,738,11878,3575864808,3575864822,14
1,738,11879,3575864808,3575864823,15
1,738,11880,3575864808,3575864824,16
1,738,11881,3575864808,3575864824,16
1,738,11882,3575864808,3575864824,16
1,738,11883,3575864808,3575864825,17
1,738,11884,3575864808,3575864830,22
1,738,11885,3575864808,3575864830,22
1,738,11886,3575864808,3575864830,22
1,738,11887,3575864808,3575864830,22
1,738,11888,3575864808,3575864831,23
1,738,11889,3575864808,3575864832,24
1,738,11890,3575864808,3575864832,24
1,738,11891,3575864808,3575864833,25
1,738,11892,3575864808,3575864833,25
1,738,11893,3575864808,3575864834,26
1,738,11894,3575864808,3575864836,28
1,738,11895,3575864808,3575864837,29
1,738,11896,3575864808,3575864839,31
1,738,11897,3575864808,3575864840,32
1,738,11898,3575864808,3575864841,33
1,738,11899,3575864808,3575864841,33
1,738,11900,3575864808,3575864841,33
1,738,11901,3575864808,3575864841,33
1,738,11902,3575864808,3575864845,37
1,738,11903,3575864808,3575864845,37
1,738,11904,3575864808,3575864849,41
1,738,11905,3575864808,3575864850,42
1,738,11906,3575864808,3575864850,42
1,738,11907,3575864808,3575864853,45
1,738,11908,3575864808,3575864855,47
1,738,11909,3575864808,3575864855,47
1,739,11910,3575864865,3575864865,0
1,739,11911,3575864865,3575864865,0
1,739,11912,3575864865,3575864865,0
1,739,11913,3575864865,3575864865,0
1,739,11914,3575864865,3575864865,0
1,739,11915,3575864865,3575864866,1
1,739,11916,3575864865,3575864878,13
1,739,11917,3575864865,3575864879,14
1,739,11918,3575864865,3575864880,15
1,739,11919,3575864865,3575864881,16
1,739,11920,3575864865,3575864883,18
1,739,11921,3575864865,3575864884,19
1,739,11922,3575864865,3575864886,21
1,739,11923,3575864865,3575864886,21
1,739,11924,3575864865,3575864893,28
1,739,11925,3575864865,3575864894,29
1,739,11926,3575864865,3575864894,29
1,739,11927,3575864865,3575864894,29
1,739,11928,3575864865,3575864895,30
1,739,11929,3575864865,3575864896,31
1,739,11930,3575864865,3575864896,31
1,739,11931,3575864865,3575864898,33
1,739,11932,3575864865,3575864902,37
1,739,11933,3575864865,3575864904,39
1,739,11934,3575864865,3575864904,39
1,739,11935,3575864865,3575864906,41
1,739,11936,3575864865,3575864907,42
1,739,11937,3575864865,3575864909,44
1,739,11938,3575864865,3575864912,47
1,739,11939,3575864865,3575864912,47
1,740,11940,3575864926,3575864926,0
1,740,11941,3575864926,3575864926,0
1,740,11942,3575864926,3575864926,0
1,740,11943,3575864926,3575864926,0
1,740,11944,3575864926,3575864926,0
1,740,11945,3575864926,3575864928,2
1,740,11946,3575864926,3575864929,3
1,740,11947,3575864926,3575864931,5
1,740,11948,3575864926,3575864931,5
1,740,11949,3575864926,3575864931,5
1,740,11950,3575864926,3575864931,5
1,740,11951,3575864926,3575864931,5
1,740,11952,3575864926,3575864934,8
1,740,11953,3575864926,3575864934,8
1,740,11954,3575864926,3575864935,9
1,740,11955,3575864926,3575864936,10
1,740,11956,3575864926,3575864937,11
1,740,11957,3575864926,3575864939,13
1,740,11958,3575864926,3575864944,18
1,740,11959,3575864926,3575864944,18
1,740,11960,3575864926,3575864944,18
1,740,11961,3575864926,3575864948,22
1,740,11962,3575864926,3575864951,25
1,740,11963,3575864926,3575864952,26
1,740,11964,3575864926,3575864953,27
1,740,11965,3575864926,3575864954,28
1,740,11966,3575864926,3575864957,31
1,740,11967,3575864926,3575864958,32
1,740,11968,3575864926,3575864958,32
1,740,11969,3575864926,3575864959,33
1,740,11970,3575864926,3575864961,35
1,740,11971,3575864926,3575864962,36
1,740,11972,3575864926,3575864962,36
1,740,11973,3575864926,3575864964,38
1,740,11974,3575864926,3575864964,38
1,740,11975,3575864926,3575864968,42
1,740,11976,3575864926,3575864971,45
1,740,11977,3575864926,3575864973,47
1,740,11978,3575864926,3575864974,48
1,740,11979,3575864926,3575864974,48
1,740,11980,3575864926,3575864975,49
1,741,11981,3575864983,3575864983,0
1,741,11982,3575864983,3575864983,0
1,741,11983,3575864983,3575864983,0
1,741,11984,3575864983,3575864983,0
1,741,11985,3575864983,3575864983,0
1,741,11986,3575864983,3575864983,0
1,741,11987,3575864983,3575864983,0
1,741,11988,3575864983,3575864984,1
1,741,11989,3575864983,3575864985,2
1,741,11990,3575864983,3575864985,2
1,741,11991,3575864983,3575864985,2
1,741,11992,3575864983,3575864987,4
1,741,11993,3575864983,3575864989,6
1,741,11994,3575864983,3575864991,8
1,741,11995,3575864983,3575864991,8
1,741,11996,3575864983,3575864992,9
1,741,11997,3575864983,3575864993,10
1,741,11998,3575864983,3575864996,13
1,741,11999,3575864983,3575864996,13
1,741,12000,3575864983,3575864997,14
1,741,12001,3575864983,3575865002,19
1,741,12002,3575864983,3575865002,19
1,741,12003,3575864983,3575865003,20
1,741,12004,3575864983,3575865004,21
1,741,12005,3575864983,3575865004,21
1,741,12006,3575864983,3575865008,25
1,741,12007,3575864983,3575865008,25
1,741,12008,3575864983,3575865010,27
1,741,12009,3575864983,3575865010,27
1,741,12010,3575864983,3575865011,28
1,741,12011,3575864983,3575865014,31
1,741,12012,3575864983,3575865015,32
1,741,12013,3575864983,3575865015,32
1,741,12014,3575864983,3575865015,32
1,741,12015,3575864983,3575865016,33
1,741,12016,3575864983,3575865016,33
1,741,12017,3575864983,3575865016,33
1,741,12018,3575864983,3575865016,33
1,741,12019,3575864983,3575865017,34
1,741,12020,3575864983,3575865017,34
1,741,12021,3575864983,3575865017,34
1,741,12022,3575864983,3575865018,35
1,741,12023,3575864983,3575865018,35
1,741,12024,3575864983,3575865020,37
1,741,12025,3575864983,3575865021,38
1,741,12026,3575864983,3575865021,38
1,741,12027,3575864983,3575865022,39
1,741,12028,3575864983,3575865023,40
1,741,12029,3575864983,3575865023,40
1,741,12030,3575864983,3575865024,41
1,741,12031,3575864983,3575865024,41
1,741,12032,3575864983,3575865026,43
1,741,12033,3575864983,3575865029,46
1,741,12034,3575864983,3575865030,47
1,741,12035,3575864983,3575865031,48
1,741,12036,3575864983,3575865031,48
1,741,12037,3575864983,3575865032,49
1,742,12038,3575865040,3575865040,0
1,742,12039,3575865040,3575865040,0
1,742,12040,3575865040,3575865040,0
1,742,12041,3575865040,3575865040,0
1,742,12042,3575865040,3575865040,0
1,742,12043,3575865040,3575865040,0
1,742,12044,3575865040,3575865040,0
1,742,12045,3575865040,3575865040,0
1,742,12046,3575865040,3575865040,0
1,742,12047,3575865040,3575865041,1
1,742,12048,3575865040,3575865041,1
1,742,12049,3575865040,3575865042,2
1,742,12050,3575865040,3575865042,2
1,742,12051,3575865040,3575865045,5
1,742,12052,3575865040,3575865050,10
1,742,12053,3575865040,3575865050,10
1,742,12054,3575865040,3575865053,13
1,742,12055,3575865040,3575865055,15
1,742,12056,3575865040,3575865055,15
1,742,12057,3575865040,3575865063,23
1,742,12058,3575865040,3575865063,23
1,742,12059,3575865040,3575865064,24
1,742,12060,3575865040,3575865065,25
1,742,12061,3575865040,3575865066,26
1,742,12062,3575865040,3575865066,26
1,742,12063,3575865040,3575865079,39
1,742,12064,3575865040,3575865079,39
1,742,12065,3575865040,3575865080,40
1,742,12066,3575865040,3575865082,42
1,742,12067,3575865040,3575865083,43
1,742,12068,3575865040,3575865084,44
1,742,12069,3575865040,3575865086,46
1,742,12070,3575865040,3575865086,46
1,742,12071,3575865040,3575865087,47
1,743,12072,3575865097,3575865097,0
1,743,12073,3575865097,3575865097,0
1,743,12074,3575865097,3575865097,0
1,743,12075,3575865097,3575865097,0
1,743,12076,3575865097,3575865097,0
1,743,12077,3575865097,3575865097,0
1,743,12078,3575865097,3575865097,0
1,743,12079,3575865097,3575865102,5
1,743,12080,3575865097,3575865104,7
1,743,12081,3575865097,3575865105,8
1,743,12082,3575865097,3575865105,8
1,743,12083,3575865097,3575865107,10
1,743,12084,3575865097,3575865107,10
1,743,12085,3575865097,3575865109,12
1,743,12086,3575865097,3575865111,14
1,743,12087,3575865097,3575865113,16
1,743,12088,3575865097,3575865116,19
1,743,12089,3575865097,3575865120,23
1,743,12090,3575865097,3575865123,26
1,743,12091,3575865097,3575865124,27
1,743,12092,3575865097,3575865126,29
1,743,12093,3575865097,3575865127,30
1,743,12094,3575865097,3575865129,32
1,743,12095,3575865097,3575865131,34
1,743,12096,3575865097,3575865131,34
1,743,12097,3575865097,3575865131,34
1,743,12098,3575865097,3575865132,35
1,743,12099,3575865097,3575865134,37
1,743,12100,3575865097,3575865135,38
1,743,12101,3575865097,3575865137,40
1,743,12102,3575865097,3575865137,40
1,743,12103,3575865097,3575865137,40
1,743,12104,3575865097,3575865139,42
1,743,12105,3575865097,3575865139,42
1,743,12106,3575865097,3575865141,44
1,743,12107,3575865097,3575865144,47
1,743,12108,3575865097,3575865144,47
1,743,12109,3575865097,3575865145,48
1,744,12110,3575865154,3575865154,0
1,744,12111,3575865154,3575865154,0
1,744,12112,3575865154,3575865154,0
1,744,12113,3575865154,3575865154,0
1,744,12114,3575865154,3575865155,1
1,744,12115,3575865154,3575865156,2
1,744,12116,3575865154,3575865158,4
1,744,12117,3575865154,3575865158,4
1,744,12118,3575865154,3575865158,4
1,744,12119,3575865154,3575865159,5
1,744,12120,3575865154,3575865161,7
1,744,12121,3575865154,3575865162,8
1,744,12122,3575865154,3575865163,9
1,744,12123,3575865154,3575865164,10
1,744,12124,3575865154,3575865164,10
1,744,12125,3575865154,3575865164,10
1,744,12126,3575865154,3575865165,11
1,744,12127,3575865154,3575865168,14
1,744,12128,3575865154,3575865170,16
1,744,12129,3575865154,3575865174,20
1,744,12130,3575865154,3575865174,20
1,744,12131,3575865154,3575865174,20
1,744,12132,3575865154,3575865175,21
1,744,12133,3575865154,3575865177,23
1,744,12134,3575865154,3575865178,24
1,744,12135,3575865154,3575865181,27
1,744,12136,3575865154,3575865181,27
1,744,12137,3575865154,3575865182,28
1,744,12138,3575865154,3575865185,31
1,744,12139,3575865154,3575865185,31
1,744,12140,3575865154,3575865185,31
1,744,12141,3575865154,3575865185,31
1,744,12142,3575865154,3575865187,33
1,744,12143,3575865154,3575865187,33
1,744,12144,3575865154,3575865190,36
1,744,12145,3575865154,3575865191,37
1,744,12146,3575865154,3575865191,37
1,744,12147,3575865154,3575865192,38
1,744,12148,3575865154,3575865193,39
1,744,12149,3575865154,3575865193,39
1,744,12150,3575865154,3575865195,41
1,744,12151,3575865154,3575865197,43
1,744,12152,3575865154,3575865197,43
1,744,12153,3575865154,3575865202,48
1,744,12154,3575865154,3575865202,48
1,744,12155,3575865154,3575865203,49
1,744,12156,3575865154,3575865204,50
1,745,12157,3575865211,3575865211,0
1,745,12158,3575865211,3575865211,0
1,745,12159,3575865211,3575865211,0
1,745,12160,3575865211,3575865211,0
1,745,12161,3575865211,3575865211,0
1,745,12162,3575865211,3575865211,0
1,745,12163,3575865211,3575865212,1
1,745,12164,3575865211,3575865214,3
1,745,12165,3575865211,3575865214,3
1,745,12166,3575865211,3575865215,4
1,745,12167,3575865211,3575865216,5
1,745,12168,3575865211,3575865216,5
1,745,12169,3575865211,3575865216,5
1,745,12170,3575865211,3575865218,7
1,745,12171,3575865211,3575865218,7
1,745,12172,3575865211,3575865218,7
1,745,12173,3575865211,3575865218,7
1,745,12174,3575865211,3575865219,8
1,745,12175,3575865211,3575865220,9
1,745,12176,3575865211,3575865221,10
1,745,12177,3575865211,3575865221,10
1,745,12178,3575865211,3575865221,10
1,745,12179,3575865211,3575865222,11
1,745,12180,3575865211,3575865224,13
1,745,12181,3575865211,3575865224,13
1,745,12182,3575865211,3575865225,14
1,745,12183,3575865211,3575865226,15
1,745,12184,3575865211,3575865230,19
1,745,12185,3575865211,3575865231,20
1,745,12186,3575865211,3575865231,20
1,745,12187,3575865211,3575865232,21
1,745,12188,3575865211,3575865233,22
1,745,12189,3575865211,3575865233,22
1,745,12190,3575865211,3575865234,23
1,745,12191,3575865211,3575865234,23
1,745,12192,3575865211,3575865235,24
1,745,12193,3575865211,3575865235,24
1,745,12194,3575865211,3575865237,26
1,745,12195,3575865211,3575865237,26
1,745,12196,3575865211,3575865238,27
1,745,12197,3575865211,3575865240,29
1,745,12198,3575865211,3575865241,30
1,745,12199,3575865211,3575865241,30
1,745,12200,3575865211,3575865243,32
1,745,12201,3575865211,3575865243,32
1,745,12202,3575865211,3575865245,34
1,745,12203,3575865211,3575865251,40
1,745,12204,3575865211,3575865251,40
1,745,12205,3575865211,3575865252,41
1,745,12206,3575865211,3575865253,42
1,745,12207,3575865211,3575865255,44
1,745,12208,3575865211,3575865256,45
1,746,12209,3575865269,3575865269,0
1,746,12210,3575865269,3575865269,0
1,746,12211,3575865269,3575865269,0
1,746,12212,3575865269,3575865269,0
1,746,12213,3575865269,3575865269,0
1,746,12214,3575865269,3575865278,9
1,746,12215,3575865269,3575865279,10
1,746,12216,3575865269,3575865279,10
1,746,12217,3575865269,3575865281,12
1,746,12218,3575865269,3575865284,15
1,746,12219,3575865269,3575865285,16
1,746,12220,3575865269,3575865287,18
1,746,12221,3575865269,3575865287,18
1,746,12222,3575865269,3575865293,24
1,746,12223,3575865269,3575865294,25
1,746,12224,3575865269,3575865295,26
1,746,12225,3575865269,3575865295,26
1,746,12226,3575865269,3575865296,27
1,746,12227,3575865269,3575865296,27
1,746,12228,3575865269,3575865297,28
1,746,12229,3575865269,3575865299,30
1,746,12230,3575865269,3575865302,33
1,746,12231,3575865269,3575865304,35
1,746,12232,3575865269,3575865305,36
1,746,12233,3575865269,3575865305,36
1,746,12234,3575865269,3575865307,38
1,746,12235,3575865269,3575865308,39
1,746,12236,3575865269,3575865309,40
1,746,12237,3575865269,3575865312,43
1,746,12238,3575865269,3575865313,44
1,746,12239,3575865269,3575865316,47
1,747,12240,3575865325,3575865325,0
1,747,12241,3575865325,3575865325,0
1,747,12242,3575865325,3575865325,0
1,747,12243,3575865325,3575865327,2
1,747,12244,3575865325,3575865329,4
1,747,12245,3575865325,3575865330,5
1,747,12246,3575865325,3575865331,6
1,747,12247,3575865325,3575865331,6
1,747,12248,3575865325,3575865332,7
1,747,12249,3575865325,3575865334,9
1,747,12250,3575865325,3575865334,9
1,747,12251,3575865325,3575865336,11
1,747,12252,3575865325,3575865337,12
1,747,12253,3575865325,3575865337,12
1,747,12254,3575865325,3575865340,15
1,747,12255,3575865325,3575865341,16
1,747,12256,3575865325,3575865344,19
1,747,12257,3575865325,3575865344,19
1,747,12258,3575865325,3575865344,19
1,747,12259,3575865325,3575865349,24
1,747,12260,3575865325,3575865351,26
1,747,12261,3575865325,3575865352,27
1,747,12262,3575865325,3575865353,28
1,747,12263,3575865325,3575865356,31
1,747,12264,3575865325,3575865357,32
1,747,12265,3575865325,3575865358,33
1,747,12266,3575865325,3575865358,33
1,747,12267,3575865325,3575865358,33
1,747,12268,3575865325,3575865360,35
1,747,12269,3575865325,3575865361,36
1,747,12270,3575865325,3575865363,38
1,747,12271,3575865325,3575865363,38
1,747,12272,3575865325,3575865364,39
1,747,12273,3575865325,3575865364,39
1,747,12274,3575865325,3575865364,39
1,747,12275,3575865325,3575865368,43
1,747,12276,3575865325,3575865371,46
1,747,12277,3575865325,3575865374,49
1,747,12278,3575865325,3575865374,49
1,747,12279,3575865325,3575865375,50
1,748,12280,3575865384,3575865384,0
1,748,12281,3575865384,3575865384,0
1,748,12282,3575865384,3575865384,0
1,748,12283,3575865384,3575865384,0
1,748,12284,3575865384,3575865384,0
1,748,12285,3575865384,3575865384,0
1,748,12286,3575865384,3575865384,0
1,748,12287,3575865384,3575865384,0
1,748,12288,3575865384,3575865385,1
1,748,12289,3575865384,3575865386,2
1,748,12290,3575865384,3575865386,2
1,748,12291,3575865384,3575865387,3
1,748,12292,3575865384,3575865387,3
1,748,12293,3575865384,3575865390,6
1,748,12294,3575865384,3575865391,7
1,748,12295,3575865384,3575865391,7
1,748,12296,3575865384,3575865392,8
1,748,12297,3575865384,3575865392,8
1,748,12298,3575865384,3575865396,12
1,748,12299,3575865384,3575865396,12
1,748,12300,3575865384,3575865397,13
1,748,12301,3575865384,3575865402,18
1,748,12302,3575865384,3575865402,18
1,748,12303,3575865384,3575865403,19
1,748,12304,3575865384,3575865403,19
1,748,12305,3575865384,3575865405,21
1,748,12306,3575865384,3575865408,24
1,748,12307,3575865384,3575865409,25
1,748,12308,3575865384,3575865410,26
1,748,12309,3575865384,3575865410,26
1,748,12310,3575865384,3575865411,27
1,748,12311,3575865384,3575865413,29
1,748,12312,3575865384,3575865414,30
1,748,12313,3575865384,3575865414,30
1,748,12314,3575865384,3575865415,31
1,748,12315,3575865384,3575865415,31
1,748,12316,3575865384,3575865416,32
1,748,12317,3575865384,3575865416,32
1,748,12318,3575865384,3575865417,33
1,748,12319,3575865384,3575865417,33
1,748,12320,3575865384,3575865417,33
1,748,12321,3575865384,3575865418,34
1,748,12322,3575865384,3575865419,35
1,748,12323,3575865384,3575865419,35
1,748,12324,3575865384,3575865419,35
1,748,12325,3575865384,3575865421,37
1,748,12326,3575865384,3575865421,37
1,748,12327,3575865384,3575865421,37
1,748,12328,3575865384,3575865422,38
1,748,12329,3575865384,3575865423,39
1,748,12330,3575865384,3575865423,39
1,748,12331,3575865384,3575865424,40
1,748,12332,3575865384,3575865426,42
1,748,12333,3575865384,3575865431,47
1,748,12334,3575865384,3575865431,47
1,748,12335,3575865384,3575865432,48
1,748,12336,3575865384,3575865433,49
1,748,12337,3575865384,3575865433,49
1,748,12338,3575865384,3575865433,49
1,748,12339,3575865384,3575865433,49
1,748,12340,3575865384,3575865434,50
1,749,12341,3575865439,3575865439,0
1,749,12342,3575865439,3575865439,0
1,749,12343,3575865439,3575865439,0
1,749,12344,3575865439,3575865439,0
1,749,12345,3575865439,3575865440,1
1,749,12346,3575865439,3575865441,2
1,749,12347,3575865439,3575865441,2
1,749,12348,3575865439,3575865442,3
1,749,12349,3575865439,3575865443,4
1,749,12350,3575865439,3575865445,6
1,749,12351,3575865439,3575865446,7
1,749,12352,3575865439,3575865449,10
1,749,12353,3575865439,3575865451,12
1,749,12354,3575865439,3575865451,12
1,749,12355,3575865439,3575865453,14
1,749,12356,3575865439,3575865455,16
1,749,12357,3575865439,3575865455,16
1,749,12358,3575865439,3575865462,23
1,749,12359,3575865439,3575865464,25
1,749,12360,3575865439,3575865465,26
1,749,12361,3575865439,3575865466,27
1,749,12362,3575865439,3575865467,28
1,749,12363,3575865439,3575865479,40
1,749,12364,3575865439,3575865479,40
1,749,12365,3575865439,3575865479,40
1,749,12366,3575865439,3575865482,43
1,749,12367,3575865439,3575865484,45
1,749,12368,3575865439,3575865484,45
1,749,12369,3575865439,3575865486,47
1,749,12370,3575865439,3575865487,48
1,750,12371,3575865496,3575865496,0
1,750,12372,3575865496,3575865496,0
1,750,12373,3575865496,3575865496,0
1,750,12374,3575865496,3575865496,0
1,750,12375,3575865496,3575865496,0
1,750,12376,3575865496,3575865496,0
1,750,12377,3575865496,3575865496,0
1,750,12378,3575865496,3575865499,3
1,750,12379,3575865496,3575865501,5
1,750,12380,3575865496,3575865503,7
1,750,12381,3575865496,3575865503,7
1,750,12382,3575865496,3575865503,7
1,750,12383,3575865496,3575865506,10
1,750,12384,3575865496,3575865506,10
1,750,12385,3575865496,3575865509,13
1,750,12386,3575865496,3575865511,15
1,750,12387,3575865496,3575865512,16
1,750,12388,3575865496,3575865515,19
1,750,12389,3575865496,3575865519,23
1,750,12390,3575865496,3575865523,27
1,750,12391,3575865496,3575865523,27
1,750,12392,3575865496,3575865525,29
1,750,12393,3575865496,3575865526,30
1,750,12394,3575865496,3575865528,32
1,750,12395,3575865496,3575865530,34
1,750,12396,3575865496,3575865530,34
1,750,12397,3575865496,3575865531,35
1,750,12398,3575865496,3575865531,35
1,750,12399,3575865496,3575865533,37
1,750,12400,3575865496,3575865534,38
1,750,12401,3575865496,3575865535,39
1,750,12402,3575865496,3575865536,40
1,750,12403,3575865496,3575865537,41
1,750,12404,3575865496,3575865539,43
1,750,12405,3575865496,3575865539,43
1,750,12406,3575865496,3575865539,43
1,750,12407,3575865496,3575865543,47
1,750,12408,3575865496,3575865543,47
1,750,12409,3575865496,3575865544,48
1,751,12410,3575865553,3575865553,0
1,751,12411,3575865553,3575865553,0
1,751,12412,3575865553,3575865553,0
1,751,12413,3575865553,3575865553,0
1,751,12414,3575865553,3575865553,0
1,751,12415,3575865553,3575865554,1
1,751,12416,3575865553,3575865557,4
1,751,12417,3575865553,3575865557,4
1,751,12418,3575865553,3575865557,4
1,751,12419,3575865553,3575865558,5
1,751,12420,3575865553,3575865559,6
1,751,12421,3575865553,3575865560,7
1,751,12422,3575865553,3575865561,8
1,751,12423,3575865553,3575865562,9
1,751,12424,3575865553,3575865563,10
1,751,12425,3575865553,3575865563,10
1,751,12426,3575865553,3575865564,11
1,751,12427,3575865553,3575865568,15
1,751,12428,3575865553,3575865571,18
1,751,12429,3575865553,3575865573,20
1,751,12430,3575865553,3575865574,21
1,751,12431,3575865553,3575865574,21
1,751,12432,3575865553,3575865574,21
1,751,12433,3575865553,3575865576,23
1,751,12434,3575865553,3575865577,24
1,751,12435,3575865553,3575865579,26
1,751,12436,3575865553,3575865580,27
1,751,12437,3575865553,3575865581,28
1,751,12438,3575865553,3575865581,28
1,751,12439,3575865553,3575865583,30
1,751,12440,3575865553,3575865584,31
1,751,12441,3575865553,3575865585,32
1,751,12442,3575865553,3575865586,33
1,751,12443,3575865553,3575865587,34
1,751,12444,3575865553,3575865587,34
1,751,12445,3575865553,3575865589,36
1,751,12446,3575865553,3575865590,37
1,751,12447,3575865553,3575865592,39
1,751,12448,3575865553,3575865592,39
1,751,12449,3575865553,3575865596,43
1,751,12450,3575865553,3575865596,43
1,751,12451,3575865553,3575865597,44
1,751,12452,3575865553,3575865601,48
1,751,12453,3575865553,3575865601,48
1,751,12454,3575865553,3575865602,49
1,751,12455,3575865553,3575865603,50
1,752,12456,3575865611,3575865611,0
1,752,12457,3575865611,3575865611,0
1,752,12458,3575865611,3575865611,0
1,752,12459,3575865611,3575865611,0
1,752,12460,3575865611,3575865611,0
1,752,12461,3575865611,3575865611,0
1,752,12462,3575865611,3575865612,1
1,752,12463,3575865611,3575865613,2
1,752,12464,3575865611,3575865613,2
1,752,12465,3575865611,3575865614,3
1,752,12466,3575865611,3575865615,4
1,752,12467,3575865611,3575865615,4
1,752,12468,3575865611,3575865615,4
1,752,12469,3575865611,3575865616,5
1,752,12470,3575865611,3575865616,5
1,752,12471,3575865611,3575865616,5
1,752,12472,3575865611,3575865616,5
1,752,12473,3575865611,3575865618,7
1,752,12474,3575865611,3575865618,7
1,752,12475,3575865611,3575865618,7
1,752,12476,3575865611,3575865619,8
1,752,12477,3575865611,3575865619,8
1,752,12478,3575865611,3575865622,11
1,752,12479,3575865611,3575865622,11
1,752,12480,3575865611,3575865623,12
1,752,12481,3575865611,3575865624,13
1,752,12482,3575865611,3575865624,13
1,752,12483,3575865611,3575865625,14
1,752,12484,3575865611,3575865629,18
1,752,12485,3575865611,3575865631,20
1,752,12486,3575865611,3575865631,20
1,752,12487,3575865611,3575865631,20
1,752,12488,3575865611,3575865631,20
1,752,12489,3575865611,3575865632,21
1,752,12490,3575865611,3575865633,22
1,752,12491,3575865611,3575865634,23
1,752,12492,3575865611,3575865634,23
1,752,12493,3575865611,3575865634,23
1,752,12494,3575865611,3575865636,25
1,752,12495,3575865611,3575865637,26
1,752,12496,3575865611,3575865638,27
1,752,12497,3575865611,3575865640,29
1,752,12498,3575865611,3575865640,29
1,752,12499,3575865611,3575865641,30
1,752,12500,3575865611,3575865641,30
1,752,12501,3575865611,3575865642,31
1,752,12502,3575865611,3575865645,34
1,752,12503,3575865611,3575865645,34
1,752,12504,3575865611,3575865647,36
1,752,12505,3575865611,3575865649,38
1,752,12506,3575865611,3575865650,39
1,752,12507,3575865611,3575865652,41
1,752,12508,3575865611,3575865655,44
1,752,12509,3575865611,3575865656,45
1,752,12510,3575865611,3575865661,50
1,753,12511,3575865668,3575865668,0
1,753,12512,3575865668,3575865668,0
1,753,12513,3575865668,3575865668,0
1,753,12514,3575865668,3575865668,0
1,753,12515,3575865668,3575865668,0
1,753,12516,3575865668,3575865678,10
1,753,12517,3575865668,3575865679,11
1,753,12518,3575865668,3575865679,11
1,753,12519,3575865668,3575865681,13
1,753,12520,3575865668,3575865684,16
1,753,12521,3575865668,3575865684,16
1,753,12522,3575865668,3575865686,18
1,753,12523,3575865668,3575865686,18
1,753,12524,3575865668,3575865692,24
1,753,12525,3575865668,3575865693,25
1,753,12526,3575865668,3575865694,26
1,753,12527,3575865668,3575865695,27
1,753,12528,3575865668,3575865695,27
1,753,12529,3575865668,3575865695,27
1,753,12530,3575865668,3575865696,28
1,753,12531,3575865668,3575865696,28
1,753,12532,3575865668,3575865699,31
1,753,12533,3575865668,3575865702,34
1,753,12534,3575865668,3575865703,35
1,753,12535,3575865668,3575865705,37
1,753,12536,3575865668,3575865706,38
1,753,12537,3575865668,3575865706,38
1,753,12538,3575865668,3575865709,41
1,753,12539,3575865668,3575865711,43
1,753,12540,3575865668,3575865711,43
1,753,12541,3575865668,3575865715,47
1,754,12542,3575865726,3575865726,0
1,754,12543,3575865726,3575865726,0
1,754,12544,3575865726,3575865726,0
1,754,12545,3575865726,3575865727,1
1,754,12546,3575865726,3575865730,4
1,754,12547,3575865726,3575865730,4
1,754,12548,3575865726,3575865731,5
1,754,12549,3575865726,3575865731,5
1,754,12550,3575865726,3575865732,6
1,754,12551,3575865726,3575865732,6
1,754,12552,3575865726,3575865733,7
1,754,12553,3575865726,3575865735,9
1,754,12554,3575865726,3575865736,10
1,754,12555,3575865726,3575865738,12
1,754,12556,3575865726,3575865739,13
1,754,12557,3575865726,3575865740,14
1,754,12558,3575865726,3575865743,17
1,754,12559,3575865726,3575865744,18
1,754,12560,3575865726,3575865744,18
1,754,12561,3575865726,3575865748,22
1,754,12562,3575865726,3575865750,24
1,754,12563,3575865726,3575865752,26
1,754,12564,3575865726,3575865752,26
1,754,12565,3575865726,3575865753,27
1,754,12566,3575865726,3575865754,28
1,754,12567,3575865726,3575865757,31
1,754,12568,3575865726,3575865757,31
1,754,12569,3575865726,3575865757,31
1,754,12570,3575865726,3575865758,32
1,754,12571,3575865726,3575865759,33
1,754,12572,3575865726,3575865761,35
1,754,12573,3575865726,3575865761,35
1,754,12574,3575865726,3575865762,36
1,754,12575,3575865726,3575865762,36
1,754,12576,3575865726,3575865764,38
1,754,12577,3575865726,3575865766,40
1,754,12578,3575865726,3575865771,45
1,754,12579,3575865726,3575865774,48
1,754,12580,3575865726,3575865774,48
1,754,12581,3575865726,3575865774,48
1,754,12582,3575865726,3575865776,50
1,755,12583,3575865782,3575865782,0
1,755,12584,3575865782,3575865782,0
1,755,12585,3575865782,3575865782,0
1,755,12586,3575865782,3575865782,0
1,755,12587,3575865782,3575865782,0
1,755,12588,3575865782,3575865783,1
1,755,12589,3575865782,3575865784,2
1,755,12590,3575865782,3575865785,3
1,755,12591,3575865782,3575865786,4
1,755,12592,3575865782,3575865787,5
1,755,12593,3575865782,3575865787,5
1,755,12594,3575865782,3575865789,7
1,755,12595,3575865782,3575865790,8
1,755,12596,3575865782,3575865792,10
1,755,12597,3575865782,3575865792,10
1,755,12598,3575865782,3575865793,11
1,755,12599,3575865782,3575865796,14
1,755,12600,3575865782,3575865796,14
1,755,12601,3575865782,3575865797,15
1,755,12602,3575865782,3575865801,19
1,755,12603,3575865782,3575865801,19
1,755,12604,3575865782,3575865802,20
1,755,12605,3575865782,3575865802,20
1,755,12606,3575865782,3575865805,23
1,755,12607,3575865782,3575865808,26
1,755,12608,3575865782,3575865809,27
1,755,12609,3575865782,3575865809,27
1,755,12610,3575865782,3575865809,27
1,755,12611,3575865782,3575865811,29
1,755,12612,3575865782,3575865812,30
1,755,12613,3575865782,3575865814,32
1,755,12614,3575865782,3575865814,32
1,755,12615,3575865782,3575865814,32
1,755,12616,3575865782,3575865815,33
1,755,12617,3575865782,3575865815,33
1,755,12618,3575865782,3575865815,33
1,755,12619,3575865782,3575865816,34
1,755,12620,3575865782,3575865816,34
1,755,12621,3575865782,3575865816,34
1,755,12622,3575865782,3575865817,35
1,755,12623,3575865782,3575865818,36
1,755,12624,3575865782,3575865818,36
1,755,12625,3575865782,3575865818,36
1,755,12626,3575865782,3575865819,37
1,755,12627,3575865782,3575865819,37
1,755,12628,3575865782,3575865820,38
1,755,12629,3575865782,3575865821,39
1,755,12630,3575865782,3575865823,41
1,755,12631,3575865782,3575865824,42
1,755,12632,3575865782,3575865824,42
1,755,12633,3575865782,3575865826,44
1,755,12634,3575865782,3575865831,49
1,755,12635,3575865782,3575865831,49
1,755,12636,3575865782,3575865832,50
1,756,12637,3575865839,3575865839,0
1,756,12638,3575865839,3575865839,0
1,756,12639,3575865839,3575865839,0
1,756,12640,3575865839,3575865839,0
1,756,12641,3575865839,3575865839,0
1,756,12642,3575865839,3575865839,0
1,756,12643,3575865839,3575865839,0
1,756,12644,3575865839,3575865839,0
1,756,12645,3575865839,3575865839,0
1,756,12646,3575865839,3575865841,2
1,756,12647,3575865839,3575865841,2
1,756,12648,3575865839,3575865842,3
1,756,12649,3575865839,3575865843,4
1,756,12650,3575865839,3575865845,6
1,756,12651,3575865839,3575865848,9
1,756,12652,3575865839,3575865851,12
1,756,12653,3575865839,3575865851,12
1,756,12654,3575865839,3575865852,13
1,756,12655,3575865839,3575865855,16
1,756,12656,3575865839,3575865856,17
1,756,12657,3575865839,3575865861,22
1,756,12658,3575865839,3575865861,22
1,756,12659,3575865839,3575865863,24
1,756,12660,3575865839,3575865864,25
1,756,12661,3575865839,3575865865,26
1,756,12662,3575865839,3575865867,28
1,756,12663,3575865839,3575865867,28
1,756,12664,3575865839,3575865879,40
1,756,12665,3575865839,3575865879,40
1,756,12666,3575865839,3575865879,40
1,756,12667,3575865839,3575865882,43
1,756,12668,3575865839,3575865884,45
1,756,12669,3575865839,3575865884,45
1,756,12670,3575865839,3575865886,47
1,756,12671,3575865839,3575865886,47
1,756,12672,3575865839,3575865887,48
1,757,12673,3575865898,3575865898,0
1,757,12674,3575865898,3575865898,0
1,757,12675,3575865898,3575865898,0
1,757,12676,3575865898,3575865898,0
1,757,12677,3575865898,3575865898,0
1,757,12678,3575865898,3575865898,0
1,757,12679,3575865898,3575865898,0
1,757,12680,3575865898,3575865898,0
1,757,12681,3575865898,3575865900,2
1,757,12682,3575865898,3575865902,4
1,757,12683,3575865898,3575865903,5
1,757,12684,3575865898,3575865904,6
1,757,12685,3575865898,3575865905,7
1,757,12686,3575865898,3575865906,8
1,757,12687,3575865898,3575865906,8
1,757,12688,3575865898,3575865910,12
1,757,12689,3575865898,3575865911,13
1,757,12690,3575865898,3575865911,13
1,757,12691,3575865898,3575865919,21
1,757,12692,3575865898,3575865923,25
1,757,12693,3575865898,3575865924,26
1,757,12694,3575865898,3575865925,27
1,757,12695,3575865898,3575865927,29
1,757,12696,3575865898,3575865928,30
1,757,12697,3575865898,3575865930,32
1,757,12698,3575865898,3575865931,33
1,757,12699,3575865898,3575865932,34
1,757,12700,3575865898,3575865932,34
1,757,12701,3575865898,3575865934,36
1,757,12702,3575865898,3575865935,37
1,757,12703,3575865898,3575865936,38
1,757,12704,3575865898,3575865938,40
1,757,12705,3575865898,3575865939,41
1,757,12706,3575865898,3575865940,42
1,757,12707,3575865898,3575865941,43
1,757,12708,3575865898,3575865943,45
1,757,12709,3575865898,3575865943,45
1,757,12710,3575865898,3575865947,49
1,758,12711,3575865957,3575865957,0
1,758,12712,3575865957,3575865957,0
1,758,12713,3575865957,3575865957,0
1,758,12714,3575865957,3575865957,0
1,758,12715,3575865957,3575865957,0
1,758,12716,3575865957,3575865957,0
1,758,12717,3575865957,3575865957,0
1,758,12718,3575865957,3575865958,1
1,758,12719,3575865957,3575865958,1
1,758,12720,3575865957,3575865959,2
1,758,12721,3575865957,3575865961,4
1,758,12722,3575865957,3575865961,4
1,758,12723,3575865957,3575865962,5
1,758,12724,3575865957,3575865963,6
1,758,12725,3575865957,3575865963,6
1,758,12726,3575865957,3575865965,8
1,758,12727,3575865957,3575865966,9
1,758,12728,3575865957,3575865969,12
1,758,12729,3575865957,3575865971,14
1,758,12730,3575865957,3575865974,17
1,758,12731,3575865957,3575865974,17
1,758,12732,3575865957,3575865975,18
1,758,12733,3575865957,3575865976,19
1,758,12734,3575865957,3575865978,21
1,758,12735,3575865957,3575865980,23
1,758,12736,3575865957,3575865980,23
1,758,12737,3575865957,3575865981,24
1,758,12738,3575865957,3575865982,25
1,758,12739,3575865957,3575865983,26
1,758,12740,3575865957,3575865984,27
1,758,12741,3575865957,3575865985,28
1,758,12742,3575865957,3575865986,29
1,758,12743,3575865957,3575865987,30
1,758,12744,3575865957,3575865987,30
1,758,12745,3575865957,3575865989,32
1,758,12746,3575865957,3575865991,34
1,758,12747,3575865957,3575865992,35
1,758,12748,3575865957,3575865993,36
1,758,12749,3575865957,3575865997,40
1,758,12750,3575865957,3575865997,40
1,758,12751,3575865957,3575865998,41
1,758,12752,3575865957,3575866001,44
1,758,12753,3575865957,3575866001,44
1,758,12754,3575865957,3575866002,45
1,758,12755,3575865957,3575866003,46
1,758,12756,3575865957,3575866003,46
1,758,12757,3575865957,3575866004,47
1,759,12758,3575866013,3575866013,0
1,759,12759,3575866013,3575866013,0
1,759,12760,3575866013,3575866013,0
1,759,12761,3575866013,3575866013,0
1,759,12762,3575866013,3575866013,0
1,759,12763,3575866013,3575866013,0
1,759,12764,3575866013,3575866014,1
1,759,12765,3575866013,3575866014,1
1,759,12766,3575866013,3575866014,1
1,759,12767,3575866013,3575866015,2
1,759,12768,3575866013,3575866015,2
1,759,12769,3575866013,3575866016,3
1,759,12770,3575866013,3575866016,3
1,759,12771,3575866013,3575866016,3
1,759,12772,3575866013,3575866017,4
1,759,12773,3575866013,3575866018,5
1,759,12774,3575866013,3575866018,5
1,759,12775,3575866013,3575866019,6
1,759,12776,3575866013,3575866019,6
1,759,12777,3575866013,3575866020,7
1,759,12778,3575866013,3575866020,7
1,759,12779,3575866013,3575866021,8
1,759,12780,3575866013,3575866022,9
1,759,12781,3575866013,3575866023,10
1,759,12782,3575866013,3575866024,11
1,759,12783,3575866013,3575866024,11
1,759,12784,3575866013,3575866026,13
1,759,12785,3575866013,3575866028,15
1,759,12786,3575866013,3575866030,17
1,759,12787,3575866013,3575866031,18
1,759,12788,3575866013,3575866032,19
1,759,12789,3575866013,3575866032,19
1,759,12790,3575866013,3575866033,20
1,759,12791,3575866013,3575866033,20
1,759,12792,3575866013,3575866033,20
1,759,12793,3575866013,3575866034,21
1,759,12794,3575866013,3575866034,21
1,759,12795,3575866013,3575866035,22
1,759,12796,3575866013,3575866037,24
1,759,12797,3575866013,3575866037,24
1,759,12798,3575866013,3575866039,26
1,759,12799,3575866013,3575866040,27
1,759,12800,3575866013,3575866041,28
1,759,12801,3575866013,3575866041,28
1,759,12802,3575866013,3575866041,28
1,759,12803,3575866013,3575866044,31
1,759,12804,3575866013,3575866045,32
1,759,12805,3575866013,3575866048,35
1,759,12806,3575866013,3575866052,39
1,759,12807,3575866013,3575866052,39
1,759,12808,3575866013,3575866052,39
1,759,12809,3575866013,3575866055,42
1,759,12810,3575866013,3575866055,42
1,759,12811,3575866013,3575866061,48
1,759,12812,3575866013,3575866061,48
1,759,12813,3575866013,3575866063,50
1,760,12814,3575866068,3575866068,0
1,760,12815,3575866068,3575866068,0
1,760,12816,3575866068,3575866068,0
1,760,12817,3575866068,3575866068,0
1,760,12818,3575866068,3575866079,11
1,760,12819,3575866068,3575866079,11
1,760,12820,3575866068,3575866079,11
1,760,12821,3575866068,3575866082,14
1,760,12822,3575866068,3575866084,16
1,760,12823,3575866068,3575866086,18
1,760,12824,3575866068,3575866087,19
1,760,12825,3575866068,3575866087,19
1,760,12826,3575866068,3575866092,24
1,760,12827,3575866068,3575866094,26
1,760,12828,3575866068,3575866094,26
1,760,12829,3575866068,3575866094,26
1,760,12830,3575866068,3575866095,27
1,760,12831,3575866068,3575866096,28
1,760,12832,3575866068,3575866097,29
1,760,12833,3575866068,3575866097,29
1,760,12834,3575866068,3575866101,33
1,760,12835,3575866068,3575866102,34
1,760,12836,3575866068,3575866103,35
1,760,12837,3575866068,3575866103,35
1,760,12838,3575866068,3575866105,37
1,760,12839,3575866068,3575866106,38
1,760,12840,3575866068,3575866107,39
1,760,12841,3575866068,3575866110,42
1,760,12842,3575866068,3575866111,43
1,760,12843,3575866068,3575866112,44
1,761,12844,3575866126,3575866126,0
1,761,12845,3575866126,3575866126,0
1,761,12846,3575866126,3575866126,0
1,761,12847,3575866126,3575866126,0
1,761,12848,3575866126,3575866127,1
1,761,12849,3575866126,3575866128,2
1,761,12850,3575866126,3575866129,3
1,761,12851,3575866126,3575866130,4
1,761,12852,3575866126,3575866131,5
1,761,12853,3575866126,3575866131,5
1,761,12854,3575866126,3575866132,6
1,761,12855,3575866126,3575866133,7
1,761,12856,3575866126,3575866133,7
1,761,12857,3575866126,3575866134,8
1,761,12858,3575866126,3575866136,10
1,761,12859,3575866126,3575866136,10
1,761,12860,3575866126,3575866138,12
1,761,12861,3575866126,3575866139,13
1,761,12862,3575866126,3575866142,16
1,761,12863,3575866126,3575866144,18
1,761,12864,3575866126,3575866144,18
1,761,12865,3575866126,3575866144,18
1,761,12866,3575866126,3575866151,25
1,761,12867,3575866126,3575866152,26
1,761,12868,3575866126,3575866153,27
1,761,12869,3575866126,3575866157,31
1,761,12870,3575866126,3575866157,31
1,761,12871,3575866126,3575866157,31
1,761,12872,3575866126,3575866158,32
1,761,12873,3575866126,3575866159,33
1,761,12874,3575866126,3575866161,35
1,761,12875,3575866126,3575866162,36
1,761,12876,3575866126,3575866163,37
1,761,12877,3575866126,3575866163,37
1,761,12878,3575866126,3575866163,37
1,761,12879,3575866126,3575866165,39
1,761,12880,3575866126,3575866166,40
1,761,12881,3575866126,3575866170,44
1,761,12882,3575866126,3575866172,46
1,761,12883,3575866126,3575866174,48
1,761,12884,3575866126,3575866174,48
1,762,12885,3575866184,3575866184,0
1,762,12886,3575866184,3575866184,0
1,762,12887,3575866184,3575866184,0
1,762,12888,3575866184,3575866184,0
1,762,12889,3575866184,3575866184,0
1,762,12890,3575866184,3575866184,0
1,762,12891,3575866184,3575866184,0
1,762,12892,3575866184,3575866184,0
1,762,12893,3575866184,3575866184,0
1,762,12894,3575866184,3575866185,1
1,762,12895,3575866184,3575866187,3
1,762,12896,3575866184,3575866187,3
1,762,12897,3575866184,3575866188,4
1,762,12898,3575866184,3575866190,6
1,762,12899,3575866184,3575866190,6
1,762,12900,3575866184,3575866191,7
1,762,12901,3575866184,3575866192,8
1,762,12902,3575866184,3575866193,9
1,762,12903,3575866184,3575866197,13
1,762,12904,3575866184,3575866198,14
1,762,12905,3575866184,3575866199,15
1,762,12906,3575866184,3575866201,17
1,762,12907,3575866184,3575866201,17
1,762,12908,3575866184,3575866202,18
1,762,12909,3575866184,3575866202,18
1,762,12910,3575866184,3575866203,19
1,762,12911,3575866184,3575866205,21
1,762,12912,3575866184,3575866209,25
1,762,12913,3575866184,3575866210,26
1,762,12914,3575866184,3575866210,26
1,762,12915,3575866184,3575866211,27
1,762,12916,3575866184,3575866211,27
1,762,12917,3575866184,3575866213,29
1,762,12918,3575866184,3575866214,30
1,762,12919,3575866184,3575866214,30
1,762,12920,3575866184,3575866215,31
1,762,12921,3575866184,3575866215,31
1,762,12922,3575866184,3575866216,32
1,762,12923,3575866184,3575866216,32
1,762,12924,3575866184,3575866216,32
1,762,12925,3575866184,3575866218,34
1,762,12926,3575866184,3575866218,34
1,762,12927,3575866184,3575866219,35
1,762,12928,3575866184,3575866219,35
1,762,12929,3575866184,3575866219,35
1,762,12930,3575866184,3575866220,36
1,762,12931,3575866184,3575866221,37
1,762,12932,3575866184,3575866221,37
1,762,12933,3575866184,3575866223,39
1,762,12934,3575866184,3575866223,39
1,762,12935,3575866184,3575866223,39
1,762,12936,3575866184,3575866223,39
1,762,12937,3575866184,3575866224,40
1,762,12938,3575866184,3575866226,42
1,762,12939,3575866184,3575866227,43
1,762,12940,3575866184,3575866231,47
1,762,12941,3575866184,3575866231,47
1,762,12942,3575866184,3575866231,47
1,762,12943,3575866184,3575866232,48
1,762,12944,3575866184,3575866233,49
1,762,12945,3575866184,3575866233,49
1,763,12946,3575866244,3575866244,0
1,763,12947,3575866244,3575866244,0
1,763,12948,3575866244,3575866244,0
1,763,12949,3575866244,3575866244,0
1,763,12950,3575866244,3575866244,0
1,763,12951,3575866244,3575866244,0
1,763,12952,3575866244,3575866244,0
1,763,12953,3575866244,3575866244,0
1,763,12954,3575866244,3575866244,0
1,763,12955,3575866244,3575866244,0
1,763,12956,3575866244,3575866244,0
1,763,12957,3575866244,3575866244,0
1,763,12958,3575866244,3575866245,1
1,763,12959,3575866244,3575866248,4
1,763,12960,3575866244,3575866250,6
1,763,12961,3575866244,3575866250,6
1,763,12962,3575866244,3575866251,7
1,763,12963,3575866244,3575866252,8
1,763,12964,3575866244,3575866252,8
1,763,12965,3575866244,3575866255,11
1,763,12966,3575866244,3575866256,12
1,763,12967,3575866244,3575866261,17
1,763,12968,3575866244,3575866262,18
1,763,12969,3575866244,3575866263,19
1,763,12970,3575866244,3575866263,19
1,763,12971,3575866244,3575866265,21
1,763,12972,3575866244,3575866266,22
1,763,12973,3575866244,3575866266,22
1,763,12974,3575866244,3575866266,22
1,763,12975,3575866244,3575866268,24
1,763,12976,3575866244,3575866279,35
1,763,12977,3575866244,3575866279,35
1,763,12978,3575866244,3575866280,36
1,763,12979,3575866244,3575866282,38
1,763,12980,3575866244,3575866284,40
1,763,12981,3575866244,3575866286,42
1,763,12982,3575866244,3575866287,43
1,763,12983,3575866244,3575866287,43
1,763,12984,3575866244,3575866292,48
1,763,12985,3575866244,3575866294,50
1,764,12986,3575866300,3575866300,0
1,764,12987,3575866300,3575866300,0
1,764,12988,3575866300,3575866300,0
1,764,12989,3575866300,3575866300,0
1,764,12990,3575866300,3575866300,0
1,764,12991,3575866300,3575866302,2
1,764,12992,3575866300,3575866302,2
1,764,12993,3575866300,3575866304,4
1,764,12994,3575866300,3575866304,4
1,764,12995,3575866300,3575866306,6
1,764,12996,3575866300,3575866306,6
1,764,12997,3575866300,3575866310,10
1,764,12998,3575866300,3575866311,11
1,764,12999,3575866300,3575866312,12
1,764,13000,3575866300,3575866315,15
1,764,13001,3575866300,3575866318,18
1,764,13002,3575866300,3575866323,23
1,764,13003,3575866300,3575866324,24
1,764,13004,3575866300,3575866325,25
1,764,13005,3575866300,3575866328,28
1,764,13006,3575866300,3575866328,28
1,764,13007,3575866300,3575866328,28
1,764,13008,3575866300,3575866331,31
1,764,13009,3575866300,3575866331,31
1,764,13010,3575866300,3575866331,31
1,764,13011,3575866300,3575866332,32
1,764,13012,3575866300,3575866333,33
1,764,13013,3575866300,3575866333,33
1,764,13014,3575866300,3575866335,35
1,764,13015,3575866300,3575866336,36
1,764,13016,3575866300,3575866336,36
1,764,13017,3575866300,3575866338,38
1,764,13018,3575866300,3575866340,40
1,764,13019,3575866300,3575866340,40
1,764,13020,3575866300,3575866343,43
1,764,13021,3575866300,3575866343,43
1,764,13022,3575866300,3575866343,43
1,764,13023,3575866300,3575866344,44
1,765,13024,3575866360,3575866360,0
1,765,13025,3575866360,3575866360,0
1,765,13026,3575866360,3575866360,0
1,765,13027,3575866360,3575866360,0
1,765,13028,3575866360,3575866360,0
1,765,13029,3575866360,3575866360,0
1,765,13030,3575866360,3575866360,0
1,765,13031,3575866360,3575866360,0
1,765,13032,3575866360,3575866360,0
1,765,13033,3575866360,3575866360,0
1,765,13034,3575866360,3575866361,1
1,765,13035,3575866360,3575866362,2
1,765,13036,3575866360,3575866363,3
1,765,13037,3575866360,3575866364,4
1,765,13038,3575866360,3575866367,7
1,765,13039,3575866360,3575866371,11
1,765,13040,3575866360,3575866371,11
1,765,13041,3575866360,3575866374,14
1,765,13042,3575866360,3575866375,15
1,765,13043,3575866360,3575866375,15
1,765,13044,3575866360,3575866377,17
1,765,13045,3575866360,3575866377,17
1,765,13046,3575866360,3575866379,19
1,765,13047,3575866360,3575866381,21
1,765,13048,3575866360,3575866381,21
1,765,13049,3575866360,3575866381,21
1,765,13050,3575866360,3575866383,23
1,765,13051,3575866360,3575866384,24
1,765,13052,3575866360,3575866385,25
1,765,13053,3575866360,3575866385,25
1,765,13054,3575866360,3575866387,27
1,765,13055,3575866360,3575866387,27
1,765,13056,3575866360,3575866388,28
1,765,13057,3575866360,3575866390,30
1,765,13058,3575866360,3575866390,30
1,765,13059,3575866360,3575866393,33
1,765,13060,3575866360,3575866397,37
1,765,13061,3575866360,3575866399,39
1,765,13062,3575866360,3575866399,39
1,765,13063,3575866360,3575866402,42
1,765,13064,3575866360,3575866402,42
1,765,13065,3575866360,3575866402,42
1,765,13066,3575866360,3575866403,43
1,765,13067,3575866360,3575866404,44
1,765,13068,3575866360,3575866405,45
1,765,13069,3575866360,3575866409,49
1,766,13070,3575866417,3575866417,0
1,766,13071,3575866417,3575866417,0
1,766,13072,3575866417,3575866417,0
1,766,13073,3575866417,3575866417,0
1,766,13074,3575866417,3575866417,0
1,766,13075,3575866417,3575866417,0
1,766,13076,3575866417,3575866417,0
1,766,13077,3575866417,3575866417,0
1,766,13078,3575866417,3575866417,0
1,766,13079,3575866417,3575866417,0
1,766,13080,3575866417,3575866417,0
1,766,13081,3575866417,3575866419,2
1,766,13082,3575866417,3575866419,2
1,766,13083,3575866417,3575866420,3
1,766,13084,3575866417,3575866420,3
1,766,13085,3575866417,3575866421,4
1,766,13086,3575866417,3575866422,5
1,766,13087,3575866417,3575866422,5
1,766,13088,3575866417,3575866424,7
1,766,13089,3575866417,3575866424,7
1,766,13090,3575866417,3575866426,9
1,766,13091,3575866417,3575866426,9
1,766,13092,3575866417,3575866428,11
1,766,13093,3575866417,3575866430,13
1,766,13094,3575866417,3575866431,14
1,766,13095,3575866417,3575866431,14
1,766,13096,3575866417,3575866432,15
1,766,13097,3575866417,3575866433,16
1,766,13098,3575866417,3575866433,16
1,766,13099,3575866417,3575866434,17
1,766,13100,3575866417,3575866434,17
1,766,13101,3575866417,3575866434,17
1,766,13102,3575866417,3575866435,18
1,766,13103,3575866417,3575866437,20
1,766,13104,3575866417,3575866438,21
1,766,13105,3575866417,3575866439,22
1,766,13106,3575866417,3575866440,23
1,766,13107,3575866417,3575866441,24
1,766,13108,3575866417,3575866442,25
1,766,13109,3575866417,3575866445,28
1,766,13110,3575866417,3575866448,31
1,766,13111,3575866417,3575866451,34
1,766,13112,3575866417,3575866452,35
1,766,13113,3575866417,3575866453,36
1,766,13114,3575866417,3575866455,38
1,766,13115,3575866417,3575866455,38
1,766,13116,3575866417,3575866461,44
1,766,13117,3575866417,3575866462,45
1,766,13118,3575866417,3575866462,45
1,766,13119,3575866417,3575866464,47
1,766,13120,3575866417,3575866465,48
1,766,13121,3575866417,3575866466,49
1,766,13122,3575866417,3575866466,49
1,766,13123,3575866417,3575866467,50
1,767,13124,3575866473,3575866473,0
1,767,13125,3575866473,3575866479,6
1,767,13126,3575866473,3575866479,6
1,767,13127,3575866473,3575866479,6
1,767,13128,3575866473,3575866483,10
1,767,13129,3575866473,3575866487,14
1,767,13130,3575866473,3575866487,14
1,767,13131,3575866473,3575866487,14
1,767,13132,3575866473,3575866492,19
1,767,13133,3575866473,3575866494,21
1,767,13134,3575866473,3575866494,21
1,767,13135,3575866473,3575866495,22
1,767,13136,3575866473,3575866495,22
1,767,13137,3575866473,3575866497,24
1,767,13138,3575866473,3575866498,25
1,767,13139,3575866473,3575866498,25
1,767,13140,3575866473,3575866502,29
1,767,13141,3575866473,3575866502,29
1,767,13142,3575866473,3575866503,30
1,767,13143,3575866473,3575866504,31
1,767,13144,3575866473,3575866506,33
1,767,13145,3575866473,3575866506,33
1,767,13146,3575866473,3575866507,34
1,767,13147,3575866473,3575866510,37
1,767,13148,3575866473,3575866511,38
1,767,13149,3575866473,3575866512,39
1,767,13150,3575866473,3575866515,42
1,767,13151,3575866473,3575866518,45
1,767,13152,3575866473,3575866523,50
1,768,13153,3575866530,3575866530,0
1,768,13154,3575866530,3575866530,0
1,768,13155,3575866530,3575866530,0
1,768,13156,3575866530,3575866530,0
1,768,13157,3575866530,3575866530,0
1,768,13158,3575866530,3575866530,0
1,768,13159,3575866530,3575866531,1
1,768,13160,3575866530,3575866531,1
1,768,13161,3575866530,3575866532,2
1,768,13162,3575866530,3575866533,3
1,768,13163,3575866530,3575866535,5
1,768,13164,3575866530,3575866535,5
1,768,13165,3575866530,3575866537,7
1,768,13166,3575866530,3575866540,10
1,768,13167,3575866530,3575866542,12
1,768,13168,3575866530,3575866543,13
1,768,13169,3575866530,3575866543,13
1,768,13170,3575866530,3575866550,20
1,768,13171,3575866530,3575866551,21
1,768,13172,3575866530,3575866552,22
1,768,13173,3575866530,3575866553,23
1,768,13174,3575866530,3575866553,23
1,768,13175,3575866530,3575866556,26
1,768,13176,3575866530,3575866557,27
1,768,13177,3575866530,3575866557,27
1,768,13178,3575866530,3575866557,27
1,768,13179,3575866530,3575866559,29
1,768,13180,3575866530,3575866560,30
1,768,13181,3575866530,3575866562,32
1,768,13182,3575866530,3575866562,32
1,768,13183,3575866530,3575866562,32
1,768,13184,3575866530,3575866563,33
1,768,13185,3575866530,3575866566,36
1,768,13186,3575866530,3575866571,41
1,768,13187,3575866530,3575866571,41
1,768,13188,3575866530,3575866573,43
1,768,13189,3575866530,3575866574,44
1,768,13190,3575866530,3575866574,44
1,768,13191,3575866530,3575866576,46
1,768,13192,3575866530,3575866576,46
1,768,13193,3575866530,3575866579,49
1,768,13194,3575866530,3575866580,50
1,769,13195,3575866587,3575866587,0
1,769,13196,3575866587,3575866587,0
1,769,13197,3575866587,3575866587,0
1,769,13198,3575866587,3575866587,0
1,769,13199,3575866587,3575866587,0
1,769,13200,3575866587,3575866587,0
1,769,13201,3575866587,3575866587,0
1,769,13202,3575866587,3575866587,0
1,769,13203,3575866587,3575866587,0
1,769,13204,3575866587,3575866587,0
1,769,13205,3575866587,3575866588,1
1,769,13206,3575866587,3575866589,2
1,769,13207,3575866587,3575866590,3
1,769,13208,3575866587,3575866592,5
1,769,13209,3575866587,3575866594,7
1,769,13210,3575866587,3575866596,9
1,769,13211,3575866587,3575866598,11
1,769,13212,3575866587,3575866599,12
1,769,13213,3575866587,3575866600,13
1,769,13214,3575866587,3575866601,14
1,769,13215,3575866587,3575866601,14
1,769,13216,3575866587,3575866602,15
1,769,13217,3575866587,3575866604,17
1,769,13218,3575866587,3575866607,20
1,769,13219,3575866587,3575866609,22
1,769,13220,3575866587,3575866610,23
1,769,13221,3575866587,3575866612,25
1,769,13222,3575866587,3575866613,26
1,769,13223,3575866587,3575866613,26
1,769,13224,3575866587,3575866613,26
1,769,13225,3575866587,3575866614,27
1,769,13226,3575866587,3575866615,28
1,769,13227,3575866587,3575866615,28
1,769,13228,3575866587,3575866616,29
1,769,13229,3575866587,3575866616,29
1,769,13230,3575866587,3575866616,29
1,769,13231,3575866587,3575866616,29
1,769,13232,3575866587,3575866618,31
1,769,13233,3575866587,3575866619,32
1,769,13234,3575866587,3575866619,32
1,769,13235,3575866587,3575866619,32
1,769,13236,3575866587,3575866620,33
1,769,13237,3575866587,3575866620,33
1,769,13238,3575866587,3575866622,35
1,769,13239,3575866587,3575866622,35
1,769,13240,3575866587,3575866622,35
1,769,13241,3575866587,3575866623,36
1,769,13242,3575866587,3575866624,37
1,769,13243,3575866587,3575866625,38
1,769,13244,3575866587,3575866626,39
1,769,13245,3575866587,3575866629,42
1,769,13246,3575866587,3575866630,43
1,769,13247,3575866587,3575866630,43
1,769,13248,3575866587,3575866631,44
1,769,13249,3575866587,3575866632,45
1,769,13250,3575866587,3575866633,46
1,769,13251,3575866587,3575866633,46
1,769,13252,3575866587,3575866633,46
1,769,13253,3575866587,3575866633,46
1,769,13254,3575866587,3575866634,47
1,769,13255,3575866587,3575866636,49
1,770,13256,3575866646,3575866646,0
1,770,13257,3575866646,3575866646,0
1,770,13258,3575866646,3575866646,0
1,770,13259,3575866646,3575866646,0
1,770,13260,3575866646,3575866646,0
1,770,13261,3575866646,3575866646,0
1,770,13262,3575866646,3575866646,0
1,770,13263,3575866646,3575866646,0
1,770,13264,3575866646,3575866646,0
1,770,13265,3575866646,3575866647,1
1,770,13266,3575866646,3575866650,4
1,770,13267,3575866646,3575866650,4
1,770,13268,3575866646,3575866651,5
1,770,13269,3575866646,3575866651,5
1,770,13270,3575866646,3575866655,9
1,770,13271,3575866646,3575866660,14
1,770,13272,3575866646,3575866661,15
1,770,13273,3575866646,3575866663,17
1,770,13274,3575866646,3575866663,17
1,770,13275,3575866646,3575866664,18
1,770,13276,3575866646,3575866665,19
1,770,13277,3575866646,3575866665,19
1,770,13278,3575866646,3575866667,21
1,770,13279,3575866646,3575866678,32
1,770,13280,3575866646,3575866679,33
1,770,13281,3575866646,3575866679,33
1,770,13282,3575866646,3575866682,36
1,770,13283,3575866646,3575866684,38
1,770,13284,3575866646,3575866684,38
1,770,13285,3575866646,3575866686,40
1,770,13286,3575866646,3575866688,42
1,770,13287,3575866646,3575866692,46
1,770,13288,3575866646,3575866694,48
1,770,13289,3575866646,3575866694,48
1,770,13290,3575866646,3575866695,49
1,770,13291,3575866646,3575866695,49
1,771,13292,3575866703,3575866703,0
1,771,13293,3575866703,3575866703,0
1,771,13294,3575866703,3575866703,0
1,771,13295,3575866703,3575866703,0
1,771,13296,3575866703,3575866704,1
1,771,13297,3575866703,3575866704,1
1,771,13298,3575866703,3575866705,2
1,771,13299,3575866703,3575866707,4
1,771,13300,3575866703,3575866707,4
1,771,13301,3575866703,3575866708,5
1,771,13302,3575866703,3575866710,7
1,771,13303,3575866703,3575866711,8
1,771,13304,3575866703,3575866713,10
1,771,13305,3575866703,3575866715,12
1,771,13306,3575866703,3575866719,16
1,771,13307,3575866703,3575866723,20
1,771,13308,3575866703,3575866726,23
1,771,13309,3575866703,3575866728,25
1,771,13310,3575866703,3575866728,25
1,771,13311,3575866703,3575866730,27
1,771,13312,3575866703,3575866731,28
1,771,13313,3575866703,3575866732,29
1,771,13314,3575866703,3575866732,29
1,771,13315,3575866703,3575866732,29
1,771,13316,3575866703,3575866734,31
1,771,13317,3575866703,3575866735,32
1,771,13318,3575866703,3575866735,32
1,771,13319,3575866703,3575866737,34
1,771,13320,3575866703,3575866738,35
1,771,13321,3575866703,3575866740,37
1,771,13322,3575866703,3575866742,39
1,771,13323,3575866703,3575866743,40
1,771,13324,3575866703,3575866744,41
1,771,13325,3575866703,3575866744,41
1,771,13326,3575866703,3575866750,47
1,771,13327,3575866703,3575866752,49
1,771,13328,3575866703,3575866753,50
1,772,13329,3575866759,3575866759,0
1,772,13330,3575866759,3575866759,0
1,772,13331,3575866759,3575866759,0
1,772,13332,3575866759,3575866759,0
1,772,13333,3575866759,3575866760,1
1,772,13334,3575866759,3575866761,2
1,772,13335,3575866759,3575866762,3
1,772,13336,3575866759,3575866763,4
1,772,13337,3575866759,3575866763,4
1,772,13338,3575866759,3575866764,5
1,772,13339,3575866759,3575866767,8
1,772,13340,3575866759,3575866770,11
1,772,13341,3575866759,3575866771,12
1,772,13342,3575866759,3575866773,14
1,772,13343,3575866759,3575866774,15
1,772,13344,3575866759,3575866775,16
1,772,13345,3575866759,3575866776,17
1,772,13346,3575866759,3575866777,18
1,772,13347,3575866759,3575866779,20
1,772,13348,3575866759,3575866780,21
1,772,13349,3575866759,3575866781,22
1,772,13350,3575866759,3575866781,22
1,772,13351,3575866759,3575866781,22
1,772,13352,3575866759,3575866782,23
1,772,13353,3575866759,3575866784,25
1,772,13354,3575866759,3575866784,25
1,772,13355,3575866759,3575866785,26
1,772,13356,3575866759,3575866787,28
1,772,13357,3575866759,3575866787,28
1,772,13358,3575866759,3575866788,29
1,772,13359,3575866759,3575866789,30
1,772,13360,3575866759,3575866790,31
1,772,13361,3575866759,3575866791,32
1,772,13362,3575866759,3575866791,32
1,772,13363,3575866759,3575866794,35
1,772,13364,3575866759,3575866797,38
1,772,13365,3575866759,3575866798,39
1,772,13366,3575866759,3575866800,41
1,772,13367,3575866759,3575866800,41
1,772,13368,3575866759,3575866801,42
1,772,13369,3575866759,3575866802,43
1,772,13370,3575866759,3575866802,43
1,772,13371,3575866759,3575866805,46
1,772,13372,3575866759,3575866807,48
1,772,13373,3575866759,3575866809,50
1,773,13374,3575866822,3575866822,0
1,773,13375,3575866822,3575866822,0
1,773,13376,3575866822,3575866822,0
1,773,13377,3575866822,3575866822,0
1,773,13378,3575866822,3575866822,0
1,773,13379,3575866822,3575866822,0
1,773,13380,3575866822,3575866822,0
1,773,13381,3575866822,3575866822,0
1,773,13382,3575866822,3575866822,0
1,773,13383,3575866822,3575866822,0
1,773,13384,3575866822,3575866822,0
1,773,13385,3575866822,3575866822,0
1,773,13386,3575866822,3575866822,0
1,773,13387,3575866822,3575866822,0
1,773,13388,3575866822,3575866822,0
1,773,13389,3575866822,3575866822,0
1,773,13390,3575866822,3575866822,0
1,773,13391,3575866822,3575866822,0
1,773,13392,3575866822,3575866822,0
1,773,13393,3575866822,3575866822,0
1,773,13394,3575866822,3575866822,0
1,773,13395,3575866822,3575866822,0
1,773,13396,3575866822,3575866823,1
1,773,13397,3575866822,3575866824,2
1,773,13398,3575866822,3575866824,2
1,773,13399,3575866822,3575866824,2
1,773,13400,3575866822,3575866826,4
1,773,13401,3575866822,3575866826,4
1,773,13402,3575866822,3575866829,7
1,773,13403,3575866822,3575866831,9
1,773,13404,3575866822,3575866831,9
1,773,13405,3575866822,3575866831,9
1,773,13406,3575866822,3575866831,9
1,773,13407,3575866822,3575866833,11
1,773,13408,3575866822,3575866833,11
1,773,13409,3575866822,3575866833,11
1,773,13410,3575866822,3575866834,12
1,773,13411,3575866822,3575866834,12
1,773,13412,3575866822,3575866836,14
1,773,13413,3575866822,3575866837,15
1,773,13414,3575866822,3575866838,16
1,773,13415,3575866822,3575866840,18
1,773,13416,3575866822,3575866841,19
1,773,13417,3575866822,3575866841,19
1,773,13418,3575866822,3575866841,19
1,773,13419,3575866822,3575866844,22
1,773,13420,3575866822,3575866845,23
1,773,13421,3575866822,3575866845,23
1,773,13422,3575866822,3575866847,25
1,773,13423,3575866822,3575866849,27
1,773,13424,3575866822,3575866852,30
1,773,13425,3575866822,3575866852,30
1,773,13426,3575866822,3575866853,31
1,773,13427,3575866822,3575866855,33
1,773,13428,3575866822,3575866861,39
1,773,13429,3575866822,3575866861,39
1,773,13430,3575866822,3575866862,40
1,773,13431,3575866822,3575866863,41
1,773,13432,3575866822,3575866864,42
1,773,13433,3575866822,3575866865,43
1,773,13434,3575866822,3575866866,44
1,773,13435,3575866822,3575866866,44
1,774,13436,3575866879,3575866879,0
1,774,13437,3575866879,3575866879,0
1,774,13438,3575866879,3575866880,1
1,774,13439,3575866879,3575866882,3
1,774,13440,3575866879,3575866884,5
1,774,13441,3575866879,3575866887,8
1,774,13442,3575866879,3575866888,9
1,774,13443,3575866879,3575866892,13
1,774,13444,3575866879,3575866895,16
1,774,13445,3575866879,3575866895,16
1,774,13446,3575866879,3575866895,16
1,774,13447,3575866879,3575866895,16
1,774,13448,3575866879,3575866898,19
1,774,13449,3575866879,3575866899,20
1,774,13450,3575866879,3575866902,23
1,774,13451,3575866879,3575866904,25
1,774,13452,3575866879,3575866905,26
1,774,13453,3575866879,3575866907,28
1,774,13454,3575866879,3575866908,29
1,774,13455,3575866879,3575866908,29
1,774,13456,3575866879,3575866910,31
1,774,13457,3575866879,3575866911,32
1,774,13458,3575866879,3575866912,33
1,774,13459,3575866879,3575866915,36
1,774,13460,3575866879,3575866919,40
1,774,13461,3575866879,3575866923,44
1,774,13462,3575866879,3575866925,46
1,774,13463,3575866879,3575866928,49
1,774,13464,3575866879,3575866929,50
1,775,13465,3575866936,3575866936,0
1,775,13466,3575866936,3575866936,0
1,775,13467,3575866936,3575866936,0
1,775,13468,3575866936,3575866936,0
1,775,13469,3575866936,3575866936,0
1,775,13470,3575866936,3575866936,0
1,775,13471,3575866936,3575866936,0
1,775,13472,3575866936,3575866936,0
1,775,13473,3575866936,3575866937,1
1,775,13474,3575866936,3575866938,2
1,775,13475,3575866936,3575866940,4
1,775,13476,3575866936,3575866942,6
1,775,13477,3575866936,3575866943,7
1,775,13478,3575866936,3575866944,8
1,775,13479,3575866936,3575866951,15
1,775,13480,3575866936,3575866953,17
1,775,13481,3575866936,3575866953,17
1,775,13482,3575866936,3575866956,20
1,775,13483,3575866936,3575866956,20
1,775,13484,3575866936,3575866957,21
1,775,13485,3575866936,3575866958,22
1,775,13486,3575866936,3575866960,24
1,775,13487,3575866936,3575866961,25
1,775,13488,3575866936,3575866962,26
1,775,13489,3575866936,3575866963,27
1,775,13490,3575866936,3575866963,27
1,775,13491,3575866936,3575866963,27
1,775,13492,3575866936,3575866964,28
1,775,13493,3575866936,3575866965,29
1,775,13494,3575866936,3575866966,30
1,775,13495,3575866936,3575866971,35
1,775,13496,3575866936,3575866972,36
1,775,13497,3575866936,3575866973,37
1,775,13498,3575866936,3575866974,38
1,775,13499,3575866936,3575866975,39
1,775,13500,3575866936,3575866976,40
1,775,13501,3575866936,3575866977,41
1,775,13502,3575866936,3575866979,43
1,775,13503,3575866936,3575866979,43
1,775,13504,3575866936,3575866981,45
1,775,13505,3575866936,3575866981,45
1,775,13506,3575866936,3575866982,46
1,775,13507,3575866936,3575866983,47
1,775,13508,3575866936,3575866984,48
1,775,13509,3575866936,3575866985,49
1,775,13510,3575866936,3575866985,49
1,776,13511,3575866993,3575866993,0
1,776,13512,3575866993,3575866993,0
1,776,13513,3575866993,3575866993,0
1,776,13514,3575866993,3575866993,0
1,776,13515,3575866993,3575866993,0
1,776,13516,3575866993,3575866993,0
1,776,13517,3575866993,3575866993,0
1,776,13518,3575866993,3575866993,0
1,776,13519,3575866993,3575866997,4
1,776,13520,3575866993,3575866998,5
1,776,13521,3575866993,3575867000,7
1,776,13522,3575866993,3575867001,8
1,776,13523,3575866993,3575867002,9
1,776,13524,3575866993,3575867002,9
1,776,13525,3575866993,3575867004,11
1,776,13526,3575866993,3575867008,15
1,776,13527,3575866993,3575867009,16
1,776,13528,3575866993,3575867011,18
1,776,13529,3575866993,3575867013,20
1,776,13530,3575866993,3575867013,20
1,776,13531,3575866993,3575867014,21
1,776,13532,3575866993,3575867014,21
1,776,13533,3575866993,3575867015,22
1,776,13534,3575866993,3575867015,22
1,776,13535,3575866993,3575867016,23
1,776,13536,3575866993,3575867016,23
1,776,13537,3575866993,3575867016,23
1,776,13538,3575866993,3575867017,24
1,776,13539,3575866993,3575867017,24
1,776,13540,3575866993,3575867017,24
1,776,13541,3575866993,3575867017,24
1,776,13542,3575866993,3575867018,25
1,776,13543,3575866993,3575867018,25
1,776,13544,3575866993,3575867019,26
1,776,13545,3575866993,3575867020,27
1,776,13546,3575866993,3575867020,27
1,776,13547,3575866993,3575867022,29
1,776,13548,3575866993,3575867022,29
1,776,13549,3575866993,3575867023,30
1,776,13550,3575866993,3575867024,31
1,776,13551,3575866993,3575867024,31
1,776,13552,3575866993,3575867024,31
1,776,13553,3575866993,3575867025,32
1,776,13554,3575866993,3575867026,33
1,776,13555,3575866993,3575867029,36
1,776,13556,3575866993,3575867031,38
1,776,13557,3575866993,3575867031,38
1,776,13558,3575866993,3575867032,39
1,776,13559,3575866993,3575867032,39
1,776,13560,3575866993,3575867032,39
1,776,13561,3575866993,3575867033,40
1,776,13562,3575866993,3575867033,40
1,776,13563,3575866993,3575867034,41
1,776,13564,3575866993,3575867034,41
1,776,13565,3575866993,3575867036,43
1,776,13566,3575866993,3575867038,45
1,776,13567,3575866993,3575867039,46
1,776,13568,3575866993,3575867040,47
1,776,13569,3575866993,3575867041,48
1,776,13570,3575866993,3575867041,48
1,776,13571,3575866993,3575867041,48
1,777,13572,3575867050,3575867050,0
1,777,13573,3575867050,3575867050,0
1,777,13574,3575867050,3575867050,0
1,777,13575,3575867050,3575867050,0
1,777,13576,3575867050,3575867050,0
1,777,13577,3575867050,3575867053,3
1,777,13578,3575867050,3575867054,4
1,777,13579,3575867050,3575867055,5
1,777,13580,3575867050,3575867056,6
1,777,13581,3575867050,3575867061,11
1,777,13582,3575867050,3575867061,11
1,777,13583,3575867050,3575867062,12
1,777,13584,3575867050,3575867064,14
1,777,13585,3575867050,3575867064,14
1,777,13586,3575867050,3575867065,15
1,777,13587,3575867050,3575867066,16
1,777,13588,3575867050,3575867066,16
1,777,13589,3575867050,3575867079,29
1,777,13590,3575867050,3575867079,29
1,777,13591,3575867050,3575867080,30
1,777,13592,3575867050,3575867083,33
1,777,13593,3575867050,3575867084,34
1,777,13594,3575867050,3575867086,36
1,777,13595,3575867050,3575867089,39
1,777,13596,3575867050,3575867092,42
1,777,13597,3575867050,3575867095,45
1,777,13598,3575867050,3575867095,45
1,777,13599,3575867050,3575867096,46
1,777,13600,3575867050,3575867098,48
1,777,13601,3575867050,3575867098,48
1,778,13602,3575867111,3575867111,0
1,778,13603,3575867111,3575867111,0
1,778,13604,3575867111,3575867111,0
1,778,13605,3575867111,3575867111,0
1,778,13606,3575867111,3575867111,0
1,778,13607,3575867111,3575867111,0
1,778,13608,3575867111,3575867111,0
1,778,13609,3575867111,3575867111,0
1,778,13610,3575867111,3575867111,0
1,778,13611,3575867111,3575867112,1
1,778,13612,3575867111,3575867116,5
1,778,13613,3575867111,3575867119,8
1,778,13614,3575867111,3575867123,12
1,778,13615,3575867111,3575867125,14
1,778,13616,3575867111,3575867129,18
1,778,13617,3575867111,3575867129,18
1,778,13618,3575867111,3575867129,18
1,778,13619,3575867111,3575867129,18
1,778,13620,3575867111,3575867131,20
1,778,13621,3575867111,3575867131,20
1,778,13622,3575867111,3575867133,22
1,778,13623,3575867111,3575867133,22
1,778,13624,3575867111,3575867134,23
1,778,13625,3575867111,3575867135,24
1,778,13626,3575867111,3575867135,24
1,778,13627,3575867111,3575867136,25
1,778,13628,3575867111,3575867138,27
1,778,13629,3575867111,3575867140,29
1,778,13630,3575867111,3575867143,32
1,778,13631,3575867111,3575867144,33
1,778,13632,3575867111,3575867144,33
1,778,13633,3575867111,3575867144,33
1,778,13634,3575867111,3575867151,40
1,778,13635,3575867111,3575867153,42
1,778,13636,3575867111,3575867154,43
1,778,13637,3575867111,3575867156,45
1,778,13638,3575867111,3575867157,46
1,778,13639,3575867111,3575867158,47
1,778,13640,3575867111,3575867160,49
1,778,13641,3575867111,3575867161,50
1,779,13642,3575867166,3575867167,1
1,779,13643,3575867166,3575867167,1
1,779,13644,3575867166,3575867167,1
1,779,13645,3575867166,3575867167,1
1,779,13646,3575867166,3575867167,1
1,779,13647,3575867166,3575867170,4
1,779,13648,3575867166,3575867172,6
1,779,13649,3575867166,3575867173,7
1,779,13650,3575867166,3575867173,7
1,779,13651,3575867166,3575867174,8
1,779,13652,3575867166,3575867177,11
1,779,13653,3575867166,3575867177,11
1,779,13654,3575867166,3575867179,13
1,779,13655,3575867166,3575867179,13
1,779,13656,3575867166,3575867181,15
1,779,13657,3575867166,3575867181,15
1,779,13658,3575867166,3575867181,15
1,779,13659,3575867166,3575867182,16
1,779,13660,3575867166,3575867184,18
1,779,13661,3575867166,3575867185,19
1,779,13662,3575867166,3575867185,19
1,779,13663,3575867166,3575867185,19
1,779,13664,3575867166,3575867187,21
1,779,13665,3575867166,3575867187,21
1,779,13666,3575867166,3575867188,22
1,779,13667,3575867166,3575867190,24
1,779,13668,3575867166,3575867190,24
1,779,13669,3575867166,3575867192,26
1,779,13670,3575867166,3575867193,27
1,779,13671,3575867166,3575867194,28
1,779,13672,3575867166,3575867198,32
1,779,13673,3575867166,3575867198,32
1,779,13674,3575867166,3575867201,35
1,779,13675,3575867166,3575867201,35
1,779,13676,3575867166,3575867201,35
1,779,13677,3575867166,3575867201,35
1,779,13678,3575867166,3575867201,35
1,779,13679,3575867166,3575867202,36
1,779,13680,3575867166,3575867206,40
1,779,13681,3575867166,3575867207,41
1,779,13682,3575867166,3575867210,44
1,779,13683,3575867166,3575867212,46
1,779,13684,3575867166,3575867213,47
1,779,13685,3575867166,3575867213,47
1,779,13686,3575867166,3575867213,47
1,779,13687,3575867166,3575867214,48
1,779,13688,3575867166,3575867215,49
1,779,13689,3575867166,3575867215,49
1,779,13690,3575867166,3575867216,50
1,780,13691,3575867227,3575867227,0
1,780,13692,3575867227,3575867227,0
1,780,13693,3575867227,3575867227,0
1,780,13694,3575867227,3575867227,0
1,780,13695,3575867227,3575867227,0
1,780,13696,3575867227,3575867227,0
1,780,13697,3575867227,3575867227,0
1,780,13698,3575867227,3575867227,0
1,780,13699,3575867227,3575867227,0
1,780,13700,3575867227,3575867227,0
1,780,13701,3575867227,3575867227,0
1,780,13702,3575867227,3575867227,0
1,780,13703,3575867227,3575867227,0
1,780,13704,3575867227,3575867227,0
1,780,13705,3575867227,3575867227,0
1,780,13706,3575867227,3575867227,0
1,780,13707,3575867227,3575867227,0
1,780,13708,3575867227,3575867228,1
1,780,13709,3575867227,3575867230,3
1,780,13710,3575867227,3575867232,5
1,780,13711,3575867227,3575867232,5
1,780,13712,3575867227,3575867232,5
1,780,13713,3575867227,3575867233,6
1,780,13714,3575867227,3575867233,6
1,780,13715,3575867227,3575867233,6
1,780,13716,3575867227,3575867234,7
1,780,13717,3575867227,3575867235,8
1,780,13718,3575867227,3575867235,8
1,780,13719,3575867227,3575867239,12
1,780,13720,3575867227,3575867239,12
1,780,13721,3575867227,3575867240,13
1,780,13722,3575867227,3575867241,14
1,780,13723,3575867227,3575867241,14
1,780,13724,3575867227,3575867242,15
1,780,13725,3575867227,3575867244,17
1,780,13726,3575867227,3575867244,17
1,780,13727,3575867227,3575867246,19
1,780,13728,3575867227,3575867248,21
1,780,13729,3575867227,3575867250,23
1,780,13730,3575867227,3575867253,26
1,780,13731,3575867227,3575867254,27
1,780,13732,3575867227,3575867256,29
1,780,13733,3575867227,3575867257,30
1,780,13734,3575867227,3575867261,34
1,780,13735,3575867227,3575867261,34
1,780,13736,3575867227,3575867263,36
1,780,13737,3575867227,3575867263,36
1,780,13738,3575867227,3575867264,37
1,780,13739,3575867227,3575867265,38
1,780,13740,3575867227,3575867267,40
1,780,13741,3575867227,3575867267,40
1,780,13742,3575867227,3575867270,43
1,781,13743,3575867284,3575867284,0
1,781,13744,3575867284,3575867284,0
1,781,13745,3575867284,3575867284,0
1,781,13746,3575867284,3575867284,0
1,781,13747,3575867284,3575867284,0
1,781,13748,3575867284,3575867286,2
1,781,13749,3575867284,3575867287,3
1,781,13750,3575867284,3575867290,6
1,781,13751,3575867284,3575867292,8
1,781,13752,3575867284,3575867294,10
1,781,13753,3575867284,3575867297,13
1,781,13754,3575867284,3575867299,15
1,781,13755,3575867284,3575867299,15
1,781,13756,3575867284,3575867302,18
1,781,13757,3575867284,3575867304,20
1,781,13758,3575867284,3575867304,20
1,781,13759,3575867284,3575867305,21
1,781,13760,3575867284,3575867307,23
1,781,13761,3575867284,3575867308,24
1,781,13762,3575867284,3575867311,27
1,781,13763,3575867284,3575867311,27
1,781,13764,3575867284,3575867312,28
1,781,13765,3575867284,3575867316,32
1,781,13766,3575867284,3575867319,35
1,781,13767,3575867284,3575867323,39
1,781,13768,3575867284,3575867325,41
1,781,13769,3575867284,3575867328,44
1,781,13770,3575867284,3575867328,44
1,781,13771,3575867284,3575867331,47
1,781,13772,3575867284,3575867332,48
1,781,13773,3575867284,3575867333,49
1,781,13774,3575867284,3575867333,49
1,781,13775,3575867284,3575867333,49
1,782,13776,3575867341,3575867341,0
1,782,13777,3575867341,3575867341,0
1,782,13778,3575867341,3575867341,0
1,782,13779,3575867341,3575867341,0
1,782,13780,3575867341,3575867341,0
1,782,13781,3575867341,3575867341,0
1,782,13782,3575867341,3575867343,2
1,782,13783,3575867341,3575867344,3
1,782,13784,3575867341,3575867344,3
1,782,13785,3575867341,3575867351,10
1,782,13786,3575867341,3575867354,13
1,782,13787,3575867341,3575867354,13
1,782,13788,3575867341,3575867354,13
1,782,13789,3575867341,3575867354,13
1,782,13790,3575867341,3575867357,16
1,782,13791,3575867341,3575867357,16
1,782,13792,3575867341,3575867357,16
1,782,13793,3575867341,3575867358,17
1,782,13794,3575867341,3575867360,19
1,782,13795,3575867341,3575867361,20
1,782,13796,3575867341,3575867363,22
1,782,13797,3575867341,3575867364,23
1,782,13798,3575867341,3575867365,24
1,782,13799,3575867341,3575867366,25
1,782,13800,3575867341,3575867367,26
1,782,13801,3575867341,3575867371,30
1,782,13802,3575867341,3575867373,32
1,782,13803,3575867341,3575867373,32
1,782,13804,3575867341,3575867375,34
1,782,13805,3575867341,3575867375,34
1,782,13806,3575867341,3575867377,36
1,782,13807,3575867341,3575867377,36
1,782,13808,3575867341,3575867379,38
1,782,13809,3575867341,3575867379,38
1,782,13810,3575867341,3575867381,40
1,782,13811,3575867341,3575867382,41
1,782,13812,3575867341,3575867382,41
1,782,13813,3575867341,3575867383,42
1,782,13814,3575867341,3575867384,43
1,782,13815,3575867341,3575867385,44
1,782,13816,3575867341,3575867385,44
1,782,13817,3575867341,3575867386,45
1,782,13818,3575867341,3575867386,45
1,782,13819,3575867341,3575867387,46
1,782,13820,3575867341,3575867388,47
1,782,13821,3575867341,3575867390,49
1,782,13822,3575867341,3575867390,49
1,782,13823,3575867341,3575867391,50
1,783,13824,3575867400,3575867400,0
1,783,13825,3575867400,3575867400,0
1,783,13826,3575867400,3575867400,0
1,783,13827,3575867400,3575867401,1
1,783,13828,3575867400,3575867401,1
1,783,13829,3575867400,3575867401,1
1,783,13830,3575867400,3575867401,1
1,783,13831,3575867400,3575867401,1
1,783,13832,3575867400,3575867406,6
1,783,13833,3575867400,3575867408,8
1,783,13834,3575867400,3575867410,10
1,783,13835,3575867400,3575867412,12
1,783,13836,3575867400,3575867413,13
1,783,13837,3575867400,3575867413,13
1,783,13838,3575867400,3575867414,14
1,783,13839,3575867400,3575867415,15
1,783,13840,3575867400,3575867415,15
1,783,13841,3575867400,3575867416,16
1,783,13842,3575867400,3575867416,16
1,783,13843,3575867400,3575867417,17
1,783,13844,3575867400,3575867417,17
1,783,13845,3575867400,3575867418,18
1,783,13846,3575867400,3575867418,18
1,783,13847,3575867400,3575867419,19
1,783,13848,3575867400,3575867419,19
1,783,13849,3575867400,3575867420,20
1,783,13850,3575867400,3575867420,20
1,783,13851,3575867400,3575867421,21
1,783,13852,3575867400,3575867421,21
1,783,13853,3575867400,3575867421,21
1,783,13854,3575867400,3575867424,24
1,783,13855,3575867400,3575867424,24
1,783,13856,3575867400,3575867424,24
1,783,13857,3575867400,3575867425,25
1,783,13858,3575867400,3575867425,25
1,783,13859,3575867400,3575867428,28
1,783,13860,3575867400,3575867429,29
1,783,13861,3575867400,3575867430,30
1,783,13862,3575867400,3575867431,31
1,783,13863,3575867400,3575867432,32
1,783,13864,3575867400,3575867432,32
1,783,13865,3575867400,3575867433,33
1,783,13866,3575867400,3575867433,33
1,783,13867,3575867400,3575867434,34
1,783,13868,3575867400,3575867434,34
1,783,13869,3575867400,3575867435,35
1,783,13870,3575867400,3575867436,36
1,783,13871,3575867400,3575867440,40
1,783,13872,3575867400,3575867440,40
1,783,13873,3575867400,3575867440,40
1,783,13874,3575867400,3575867441,41
1,783,13875,3575867400,3575867441,41
1,783,13876,3575867400,3575867441,41
1,783,13877,3575867400,3575867444,44
1,783,13878,3575867400,3575867446,46
1,783,13879,3575867400,3575867449,49
1,784,13880,3575867458,3575867458,0
1,784,13881,3575867458,3575867458,0
1,784,13882,3575867458,3575867458,0
1,784,13883,3575867458,3575867458,0
1,784,13884,3575867458,3575867458,0
1,784,13885,3575867458,3575867458,0
1,784,13886,3575867458,3575867461,3
1,784,13887,3575867458,3575867461,3
1,784,13888,3575867458,3575867463,5
1,784,13889,3575867458,3575867464,6
1,784,13890,3575867458,3575867464,6
1,784,13891,3575867458,3575867465,7
1,784,13892,3575867458,3575867466,8
1,784,13893,3575867458,3575867466,8
1,784,13894,3575867458,3575867471,13
1,784,13895,3575867458,3575867478,20
1,784,13896,3575867458,3575867479,21
1,784,13897,3575867458,3575867480,22
1,784,13898,3575867458,3575867482,24
1,784,13899,3575867458,3575867484,26
1,784,13900,3575867458,3575867486,28
1,784,13901,3575867458,3575867490,32
1,784,13902,3575867458,3575867495,37
1,784,13903,3575867458,3575867497,39
1,784,13904,3575867458,3575867497,39
1,784,13905,3575867458,3575867499,41
1,784,13906,3575867458,3575867499,41
1,784,13907,3575867458,3575867503,45
1,784,13908,3575867458,3575867504,46
1,784,13909,3575867458,3575867505,47
1,784,13910,3575867458,3575867505,47
1,784,13911,3575867458,3575867508,50
1,785,13912,3575867515,3575867515,0
1,785,13913,3575867515,3575867515,0
1,785,13914,3575867515,3575867515,0
1,785,13915,3575867515,3575867515,0
1,785,13916,3575867515,3575867515,0
1,785,13917,3575867515,3575867518,3
1,785,13918,3575867515,3575867522,7
1,785,13919,3575867515,3575867524,9
1,785,13920,3575867515,3575867527,12
1,785,13921,3575867515,3575867529,14
1,785,13922,3575867515,3575867530,15
1,785,13923,3575867515,3575867531,16
1,785,13924,3575867515,3575867531,16
1,785,13925,3575867515,3575867532,17
1,785,13926,3575867515,3575867533,18
1,785,13927,3575867515,3575867534,19
1,785,13928,3575867515,3575867535,20
1,785,13929,3575867515,3575867537,22
1,785,13930,3575867515,3575867539,24
1,785,13931,3575867515,3575867542,27
1,785,13932,3575867515,3575867543,28
1,785,13933,3575867515,3575867543,28
1,785,13934,3575867515,3575867543,28
1,785,13935,3575867515,3575867550,35
1,785,13936,3575867515,3575867552,37
1,785,13937,3575867515,3575867553,38
1,785,13938,3575867515,3575867553,38
1,785,13939,3575867515,3575867554,39
1,785,13940,3575867515,3575867556,41
1,785,13941,3575867515,3575867557,42
1,785,13942,3575867515,3575867557,42
1,785,13943,3575867515,3575867559,44
1,785,13944,3575867515,3575867560,45
1,785,13945,3575867515,3575867562,47
1,785,13946,3575867515,3575867563,48
1,785,13947,3575867515,3575867565,50
1,786,13948,3575867572,3575867572,0
1,786,13949,3575867572,3575867572,0
1,786,13950,3575867572,3575867572,0
1,786,13951,3575867572,3575867572,0
1,786,13952,3575867572,3575867573,1
1,786,13953,3575867572,3575867573,1
1,786,13954,3575867572,3575867574,2
1,786,13955,3575867572,3575867576,4
1,786,13956,3575867572,3575867577,5
1,786,13957,3575867572,3575867578,6
1,786,13958,3575867572,3575867578,6
1,786,13959,3575867572,3575867580,8
1,786,13960,3575867572,3575867580,8
1,786,13961,3575867572,3575867581,9
1,786,13962,3575867572,3575867582,10
1,786,13963,3575867572,3575867583,11
1,786,13964,3575867572,3575867585,13
1,786,13965,3575867572,3575867585,13
1,786,13966,3575867572,3575867585,13
1,786,13967,3575867572,3575867586,14
1,786,13968,3575867572,3575867587,15
1,786,13969,3575867572,3575867587,15
1,786,13970,3575867572,3575867589,17
1,786,13971,3575867572,3575867590,18
1,786,13972,3575867572,3575867591,19
1,786,13973,3575867572,3575867592,20
1,786,13974,3575867572,3575867594,22
1,786,13975,3575867572,3575867597,25
1,786,13976,3575867572,3575867598,26
1,786,13977,3575867572,3575867600,28
1,786,13978,3575867572,3575867600,28
1,786,13979,3575867572,3575867600,28
1,786,13980,3575867572,3575867600,28
1,786,13981,3575867572,3575867601,29
1,786,13982,3575867572,3575867604,32
1,786,13983,3575867572,3575867606,34
1,786,13984,3575867572,3575867609,37
1,786,13985,3575867572,3575867611,39
1,786,13986,3575867572,3575867612,40
1,786,13987,3575867572,3575867612,40
1,786,13988,3575867572,3575867612,40
1,786,13989,3575867572,3575867613,41
1,786,13990,3575867572,3575867614,42
1,786,13991,3575867572,3575867615,43
1,786,13992,3575867572,3575867615,43
1,786,13993,3575867572,3575867615,43
1,786,13994,3575867572,3575867617,45
1,786,13995,3575867572,3575867617,45
1,786,13996,3575867572,3575867617,45
1,786,13997,3575867572,3575867617,45
1,786,13998,3575867572,3575867617,45
1,786,13999,3575867572,3575867617,45
1,786,14000,3575867572,3575867619,47
1,786,14001,3575867572,3575867620,48
1,786,14002,3575867572,3575867620,48
1,786,14003,3575867572,3575867620,48
1,786,14004,3575867572,3575867621,49
1,787,14005,3575867631,3575867631,0
1,787,14006,3575867631,3575867631,0
1,787,14007,3575867631,3575867631,0
1,787,14008,3575867631,3575867631,0
1,787,14009,3575867631,3575867631,0
1,787,14010,3575867631,3575867631,0
1,787,14011,3575867631,3575867631,0
1,787,14012,3575867631,3575867631,0
1,787,14013,3575867631,3575867631,0
1,787,14014,3575867631,3575867631,0
1,787,14015,3575867631,3575867632,1
1,787,14016,3575867631,3575867632,1
1,787,14017,3575867631,3575867632,1
1,787,14018,3575867631,3575867632,1
1,787,14019,3575867631,3575867633,2
1,787,14020,3575867631,3575867634,3
1,787,14021,3575867631,3575867635,4
1,787,14022,3575867631,3575867638,7
1,787,14023,3575867631,3575867640,9
1,787,14024,3575867631,3575867640,9
1,787,14025,3575867631,3575867640,9
1,787,14026,3575867631,3575867640,9
1,787,14027,3575867631,3575867641,10
1,787,14028,3575867631,3575867643,12
1,787,14029,3575867631,3575867644,13
1,787,14030,3575867631,3575867645,14
1,787,14031,3575867631,3575867649,18
1,787,14032,3575867631,3575867649,18
1,787,14033,3575867631,3575867653,22
1,787,14034,3575867631,3575867653,22
1,787,14035,3575867631,3575867655,24
1,787,14036,3575867631,3575867655,24
1,787,14037,3575867631,3575867659,28
1,787,14038,3575867631,3575867660,29
1,787,14039,3575867631,3575867660,29
1,787,14040,3575867631,3575867663,32
1,787,14041,3575867631,3575867663,32
1,787,14042,3575867631,3575867664,33
1,787,14043,3575867631,3575867665,34
1,787,14044,3575867631,3575867665,34
1,787,14045,3575867631,3575867665,34
1,787,14046,3575867631,3575867669,38
1,787,14047,3575867631,3575867679,48
1,787,14048,3575867631,3575867681,50
1,788,14049,3575867689,3575867689,0
1,788,14050,3575867689,3575867689,0
1,788,14051,3575867689,3575867689,0
1,788,14052,3575867689,3575867689,0
1,788,14053,3575867689,3575867690,1
1,788,14054,3575867689,3575867695,6
1,788,14055,3575867689,3575867695,6
1,788,14056,3575867689,3575867697,8
1,788,14057,3575867689,3575867697,8
1,788,14058,3575867689,3575867699,10
1,788,14059,3575867689,3575867703,14
1,788,14060,3575867689,3575867704,15
1,788,14061,3575867689,3575867704,15
1,788,14062,3575867689,3575867705,16
1,788,14063,3575867689,3575867708,19
1,788,14064,3575867689,3575867709,20
1,788,14065,3575867689,3575867711,22
1,788,14066,3575867689,3575867711,22
1,788,14067,3575867689,3575867713,24
1,788,14068,3575867689,3575867713,24
1,788,14069,3575867689,3575867718,29
1,788,14070,3575867689,3575867722,33
1,788,14071,3575867689,3575867725,36
1,788,14072,3575867689,3575867727,38
1,788,14073,3575867689,3575867731,42
1,788,14074,3575867689,3575867731,42
1,788,14075,3575867689,3575867732,43
1,788,14076,3575867689,3575867733,44
1,788,14077,3575867689,3575867733,44
1,788,14078,3575867689,3575867733,44
1,788,14079,3575867689,3575867735,46
1,788,14080,3575867689,3575867736,47
1,788,14081,3575867689,3575867737,48
1,788,14082,3575867689,3575867738,49
1,789,14083,3575867745,3575867745,0
1,789,14084,3575867745,3575867745,0
1,789,14085,3575867745,3575867745,0
1,789,14086,3575867745,3575867745,0
1,789,14087,3575867745,3575867745,0
1,789,14088,3575867745,3575867749,4
1,789,14089,3575867745,3575867752,7
1,789,14090,3575867745,3575867753,8
1,789,14091,3575867745,3575867753,8
1,789,14092,3575867745,3575867756,11
1,789,14093,3575867745,3575867756,11
1,789,14094,3575867745,3575867756,11
1,789,14095,3575867745,3575867757,12
1,789,14096,3575867745,3575867759,14
1,789,14097,3575867745,3575867761,16
1,789,14098,3575867745,3575867762,17
1,789,14099,3575867745,3575867763,18
1,789,14100,3575867745,3575867763,18
1,789,14101,3575867745,3575867764,19
1,789,14102,3575867745,3575867765,20
1,789,14103,3575867745,3575867766,21
1,789,14104,3575867745,3575867770,25
1,789,14105,3575867745,3575867772,27
1,789,14106,3575867745,3575867774,29
1,789,14107,3575867745,3575867774,29
1,789,14108,3575867745,3575867774,29
1,789,14109,3575867745,3575867775,30
1,789,14110,3575867745,3575867777,32
1,789,14111,3575867745,3575867778,33
1,789,14112,3575867745,3575867778,33
1,789,14113,3575867745,3575867781,36
1,789,14114,3575867745,3575867782,37
1,789,14115,3575867745,3575867782,37
1,789,14116,3575867745,3575867784,39
1,789,14117,3575867745,3575867785,40
1,789,14118,3575867745,3575867785,40
1,789,14119,3575867745,3575867785,40
1,789,14120,3575867745,3575867786,41
1,789,14121,3575867745,3575867787,42
1,789,14122,3575867745,3575867789,44
1,789,14123,3575867745,3575867791,46
1,789,14124,3575867745,3575867791,46
1,789,14125,3575867745,3575867791,46
1,789,14126,3575867745,3575867792,47
1,790,14127,3575867802,3575867802,0
1,790,14128,3575867802,3575867802,0
1,790,14129,3575867802,3575867802,0
1,790,14130,3575867802,3575867802,0
1,790,14131,3575867802,3575867802,0
1,790,14132,3575867802,3575867802,0
1,790,14133,3575867802,3575867802,0
1,790,14134,3575867802,3575867804,2
1,790,14135,3575867802,3575867806,4
1,790,14136,3575867802,3575867809,7
1,790,14137,3575867802,3575867810,8
1,790,14138,3575867802,3575867812,10
1,790,14139,3575867802,3575867813,11
1,790,14140,3575867802,3575867813,11
1,790,14141,3575867802,3575867814,12
1,790,14142,3575867802,3575867815,13
1,790,14143,3575867802,3575867815,13
1,790,14144,3575867802,3575867815,13
1,790,14145,3575867802,3575867815,13
1,790,14146,3575867802,3575867817,15
1,790,14147,3575867802,3575867817,15
1,790,14148,3575867802,3575867817,15
1,790,14149,3575867802,3575867818,16
1,790,14150,3575867802,3575867819,17
1,790,14151,3575867802,3575867820,18
1,790,14152,3575867802,3575867820,18
1,790,14153,3575867802,3575867821,19
1,790,14154,3575867802,3575867823,21
1,790,14155,3575867802,3575867824,22
1,790,14156,3575867802,3575867826,24
1,790,14157,3575867802,3575867826,24
1,790,14158,3575867802,3575867827,25
1,790,14159,3575867802,3575867828,26
1,790,14160,3575867802,3575867828,26
1,790,14161,3575867802,3575867829,27
1,790,14162,3575867802,3575867831,29
1,790,14163,3575867802,3575867831,29
1,790,14164,3575867802,3575867832,30
1,790,14165,3575867802,3575867833,31
1,790,14166,3575867802,3575867833,31
1,790,14167,3575867802,3575867833,31
1,790,14168,3575867802,3575867834,32
1,790,14169,3575867802,3575867835,33
1,790,14170,3575867802,3575867839,37
1,790,14171,3575867802,3575867840,38
1,790,14172,3575867802,3575867840,38
1,790,14173,3575867802,3575867841,39
1,790,14174,3575867802,3575867841,39
1,790,14175,3575867802,3575867841,39
1,790,14176,3575867802,3575867841,39
1,790,14177,3575867802,3575867843,41
1,790,14178,3575867802,3575867844,42
1,790,14179,3575867802,3575867844,42
1,790,14180,3575867802,3575867849,47
1,790,14181,3575867802,3575867849,47
1,790,14182,3575867802,3575867849,47
1,790,14183,3575867802,3575867850,48
1,791,14184,3575867859,3575867859,0
1,791,14185,3575867859,3575867859,0
1,791,14186,3575867859,3575867859,0
1,791,14187,3575867859,3575867859,0
1,791,14188,3575867859,3575867859,0
1,791,14189,3575867859,3575867860,1
1,791,14190,3575867859,3575867862,3
1,791,14191,3575867859,3575867863,4
1,791,14192,3575867859,3575867863,4
1,791,14193,3575867859,3575867864,5
1,791,14194,3575867859,3575867866,7
1,791,14195,3575867859,3575867866,7
1,791,14196,3575867859,3575867869,10
1,791,14197,3575867859,3575867879,20
1,791,14198,3575867859,3575867880,21
1,791,14199,3575867859,3575867881,22
1,791,14200,3575867859,3575867883,24
1,791,14201,3575867859,3575867884,25
1,791,14202,3575867859,3575867886,27
1,791,14203,3575867859,3575867891,32
1,791,14204,3575867859,3575867896,37
1,791,14205,3575867859,3575867896,37
1,791,14206,3575867859,3575867897,38
1,791,14207,3575867859,3575867900,41
1,791,14208,3575867859,3575867903,44
1,791,14209,3575867859,3575867903,44
1,791,14210,3575867859,3575867905,46
1,791,14211,3575867859,3575867905,46
1,791,14212,3575867859,3575867908,49
1,792,14213,3575867916,3575867916,0
1,792,14214,3575867916,3575867916,0
1,792,14215,3575867916,3575867916,0
1,792,14216,3575867916,3575867916,0
1,792,14217,3575867916,3575867916,0
1,792,14218,3575867916,3575867916,0
1,792,14219,3575867916,3575867919,3
1,792,14220,3575867916,3575867922,6
1,792,14221,3575867916,3575867926,10
1,792,14222,3575867916,3575867927,11
1,792,14223,3575867916,3575867929,13
1,792,14224,3575867916,3575867931,15
1,792,14225,3575867916,3575867932,16
1,792,14226,3575867916,3575867932,16
1,792,14227,3575867916,3575867933,17
1,792,14228,3575867916,3575867933,17
1,792,14229,3575867916,3575867933,17
1,792,14230,3575867916,3575867935,19
1,792,14231,3575867916,3575867936,20
1,792,14232,3575867916,3575867937,21
1,792,14233,3575867916,3575867940,24
1,792,14234,3575867916,3575867943,27
1,792,14235,3575867916,3575867943,27
1,792,14236,3575867916,3575867943,27
1,792,14237,3575867916,3575867944,28
1,792,14238,3575867916,3575867951,35
1,792,14239,3575867916,3575867952,36
1,792,14240,3575867916,3575867953,37
1,792,14241,3575867916,3575867953,37
1,792,14242,3575867916,3575867954,38
1,792,14243,3575867916,3575867956,40
1,792,14244,3575867916,3575867956,40
1,792,14245,3575867916,3575867957,41
1,792,14246,3575867916,3575867959,43
1,792,14247,3575867916,3575867962,46
1,792,14248,3575867916,3575867963,47
1,792,14249,3575867916,3575867964,48
1,792,14250,3575867916,3575867965,49
1,793,14251,3575867976,3575867976,0
1,793,14252,3575867976,3575867976,0
1,793,14253,3575867976,3575867976,0
1,793,14254,3575867976,3575867976,0
1,793,14255,3575867976,3575867976,0
1,793,14256,3575867976,3575867976,0
1,793,14257,3575867976,3575867976,0
1,793,14258,3575867976,3575867977,1
1,793,14259,3575867976,3575867978,2
1,793,14260,3575867976,3575867979,3
1,793,14261,3575867976,3575867981,5
1,793,14262,3575867976,3575867981,5
1,793,14263,3575867976,3575867982,6
1,793,14264,3575867976,3575867983,7
1,793,14265,3575867976,3575867984,8
1,793,14266,3575867976,3575867985,9
1,793,14267,3575867976,3575867985,9
1,793,14268,3575867976,3575867986,10
1,793,14269,3575867976,3575867987,11
1,793,14270,3575867976,3575867987,11
1,793,14271,3575867976,3575867987,11
1,793,14272,3575867976,3575867989,13
1,793,14273,3575867976,3575867990,14
1,793,14274,3575867976,3575867991,15
1,793,14275,3575867976,3575867993,17
1,793,14276,3575867976,3575867994,18
1,793,14277,3575867976,3575867999,23
1,793,14278,3575867976,3575867999,23
1,793,14279,3575867976,3575868000,24
1,793,14280,3575867976,3575868001,25
1,793,14281,3575867976,3575868001,25
1,793,14282,3575867976,3575868001,25
1,793,14283,3575867976,3575868001,25
1,793,14284,3575867976,3575868002,26
1,793,14285,3575867976,3575868005,29
1,793,14286,3575867976,3575868008,32
1,793,14287,3575867976,3575868010,34
1,793,14288,3575867976,3575868012,36
1,793,14289,3575867976,3575868012,36
1,793,14290,3575867976,3575868014,38
1,793,14291,3575867976,3575868015,39
1,793,14292,3575867976,3575868015,39
1,793,14293,3575867976,3575868015,39
1,793,14294,3575867976,3575868015,39
1,793,14295,3575867976,3575868016,40
1,793,14296,3575867976,3575868018,42
1,793,14297,3575867976,3575868019,43
1,793,14298,3575867976,3575868019,43
1,793,14299,3575867976,3575868019,43
1,793,14300,3575867976,3575868019,43
1,793,14301,3575867976,3575868020,44
1,793,14302,3575867976,3575868020,44
1,793,14303,3575867976,3575868020,44
1,793,14304,3575867976,3575868021,45
1,793,14305,3575867976,3575868023,47
1,793,14306,3575867976,3575868024,48
1,793,14307,3575867976,3575868025,49
1,794,14308,3575868034,3575868034,0
1,794,14309,3575868034,3575868034,0
1,794,14310,3575868034,3575868034,0
1,794,14311,3575868034,3575868034,0
1,794,14312,3575868034,3575868034,0
1,794,14313,3575868034,3575868034,0
1,794,14314,3575868034,3575868034,0
1,794,14315,3575868034,3575868034,0
1,794,14316,3575868034,3575868034,0
1,794,14317,3575868034,3575868035,1
1,794,14318,3575868034,3575868035,1
1,794,14319,3575868034,3575868039,5
1,794,14320,3575868034,3575868040,6
1,794,14321,3575868034,3575868040,6
1,794,14322,3575868034,3575868041,7
1,794,14323,3575868034,3575868041,7
1,794,14324,3575868034,3575868041,7
1,794,14325,3575868034,3575868043,9
1,794,14326,3575868034,3575868044,10
1,794,14327,3575868034,3575868049,15
1,794,14328,3575868034,3575868049,15
1,794,14329,3575868034,3575868051,17
1,794,14330,3575868034,3575868053,19
1,794,14331,3575868034,3575868053,19
1,794,14332,3575868034,3575868055,21
1,794,14333,3575868034,3575868056,22
1,794,14334,3575868034,3575868058,24
1,794,14335,3575868034,3575868061,27
1,794,14336,3575868034,3575868063,29
1,794,14337,3575868034,3575868063,29
1,794,14338,3575868034,3575868064,30
1,794,14339,3575868034,3575868066,32
1,794,14340,3575868034,3575868067,33
1,794,14341,3575868034,3575868068,34
1,794,14342,3575868034,3575868070,36
1,794,14343,3575868034,3575868079,45
1,794,14344,3575868034,3575868081,47
1,794,14345,3575868034,3575868082,48
1,794,14346,3575868034,3575868084,50
1,795,14347,3575868094,3575868094,0
1,795,14348,3575868094,3575868094,0
1,795,14349,3575868094,3575868094,0
1,795,14350,3575868094,3575868097,3
1,795,14351,3575868094,3575868097,3
1,795,14352,3575868094,3575868097,3
1,795,14353,3575868094,3575868098,4
1,795,14354,3575868094,3575868099,5
1,795,14355,3575868094,3575868099,5
1,795,14356,3575868094,3575868103,9
1,795,14357,3575868094,3575868104,10
1,795,14358,3575868094,3575868105,11
1,795,14359,3575868094,3575868106,12
1,795,14360,3575868094,3575868107,13
1,795,14361,3575868094,3575868111,17
1,795,14362,3575868094,3575868111,17
1,795,14363,3575868094,3575868112,18
1,795,14364,3575868094,3575868113,19
1,795,14365,3575868094,3575868113,19
1,795,14366,3575868094,3575868115,21
1,795,14367,3575868094,3575868119,25
1,795,14368,3575868094,3575868122,28
1,795,14369,3575868094,3575868126,32
1,795,14370,3575868094,3575868128,34
1,795,14371,3575868094,3575868129,35
1,795,14372,3575868094,3575868131,37
1,795,14373,3575868094,3575868132,38
1,795,14374,3575868094,3575868133,39
1,795,14375,3575868094,3575868134,40
1,795,14376,3575868094,3575868135,41
1,795,14377,3575868094,3575868135,41
1,795,14378,3575868094,3575868137,43
1,795,14379,3575868094,3575868137,43
1,795,14380,3575868094,3575868139,45
1,795,14381,3575868094,3575868140,46
1,795,14382,3575868094,3575868143,49
1,795,14383,3575868094,3575868143,49
1,795,14384,3575868094,3575868144,50
1,796,14385,3575868152,3575868152,0
1,796,14386,3575868152,3575868152,0
1,796,14387,3575868152,3575868152,0
1,796,14388,3575868152,3575868154,2
1,796,14389,3575868152,3575868154,2
1,796,14390,3575868152,3575868156,4
1,796,14391,3575868152,3575868156,4
1,796,14392,3575868152,3575868157,5
1,796,14393,3575868152,3575868157,5
1,796,14394,3575868152,3575868159,7
1,796,14395,3575868152,3575868163,11
1,796,14396,3575868152,3575868163,11
1,796,14397,3575868152,3575868164,12
1,796,14398,3575868152,3575868165,13
1,796,14399,3575868152,3575868167,15
1,796,14400,3575868152,3575868171,19
1,796,14401,3575868152,3575868172,20
1,796,14402,3575868152,3575868172,20
1,796,14403,3575868152,3575868174,22
1,796,14404,3575868152,3575868174,22
1,796,14405,3575868152,3575868175,23
1,796,14406,3575868152,3575868176,24
1,796,14407,3575868152,3575868177,25
1,796,14408,3575868152,3575868179,27
1,796,14409,3575868152,3575868181,29
1,796,14410,3575868152,3575868181,29
1,796,14411,3575868152,3575868181,29
1,796,14412,3575868152,3575868182,30
1,796,14413,3575868152,3575868185,33
1,796,14414,3575868152,3575868185,33
1,796,14415,3575868152,3575868185,33
1,796,14416,3575868152,3575868186,34
1,796,14417,3575868152,3575868186,34
1,796,14418,3575868152,3575868187,35
1,796,14419,3575868152,3575868187,35
1,796,14420,3575868152,3575868187,35
1,796,14421,3575868152,3575868190,38
1,796,14422,3575868152,3575868191,39
1,796,14423,3575868152,3575868199,47
1,796,14424,3575868152,3575868199,47
1,796,14425,3575868152,3575868200,48
1,796,14426,3575868152,3575868200,48
1,796,14427,3575868152,3575868201,49
1,797,14428,3575868209,3575868209,0
1,797,14429,3575868209,3575868209,0
1,797,14430,3575868209,3575868209,0
1,797,14431,3575868209,3575868210,1
1,797,14432,3575868209,3575868211,2
1,797,14433,3575868209,3575868212,3
1,797,14434,3575868209,3575868213,4
1,797,14435,3575868209,3575868213,4
1,797,14436,3575868209,3575868215,6
1,797,14437,3575868209,3575868215,6
1,797,14438,3575868209,3575868215,6
1,797,14439,3575868209,3575868216,7
1,797,14440,3575868209,3575868216,7
1,797,14441,3575868209,3575868217,8
1,797,14442,3575868209,3575868218,9
1,797,14443,3575868209,3575868219,10
1,797,14444,3575868209,3575868219,10
1,797,14445,3575868209,3575868219,10
1,797,14446,3575868209,3575868219,10
1,797,14447,3575868209,3575868220,11
1,797,14448,3575868209,3575868221,12
1,797,14449,3575868209,3575868221,12
1,797,14450,3575868209,3575868225,16
1,797,14451,3575868209,3575868226,17
1,797,14452,3575868209,3575868227,18
1,797,14453,3575868209,3575868228,19
1,797,14454,3575868209,3575868229,20
1,797,14455,3575868209,3575868231,22
1,797,14456,3575868209,3575868231,22
1,797,14457,3575868209,3575868231,22
1,797,14458,3575868209,3575868232,23
1,797,14459,3575868209,3575868232,23
1,797,14460,3575868209,3575868232,23
1,797,14461,3575868209,3575868234,25
1,797,14462,3575868209,3575868236,27
1,797,14463,3575868209,3575868236,27
1,797,14464,3575868209,3575868240,31
1,797,14465,3575868209,3575868240,31
1,797,14466,3575868209,3575868241,32
1,797,14467,3575868209,3575868241,32
1,797,14468,3575868209,3575868241,32
1,797,14469,3575868209,3575868241,32
1,797,14470,3575868209,3575868242,33
1,797,14471,3575868209,3575868245,36
1,797,14472,3575868209,3575868246,37
1,797,14473,3575868209,3575868249,40
1,797,14474,3575868209,3575868249,40
1,797,14475,3575868209,3575868250,41
1,797,14476,3575868209,3575868251,42
1,797,14477,3575868209,3575868253,44
1,797,14478,3575868209,3575868253,44
1,797,14479,3575868209,3575868256,47
1,797,14480,3575868209,3575868256,47
1,797,14481,3575868209,3575868259,50
1,798,14482,3575868266,3575868266,0
1,798,14483,3575868266,3575868266,0
1,798,14484,3575868266,3575868266,0
1,798,14485,3575868266,3575868266,0
1,798,14486,3575868266,3575868266,0
1,798,14487,3575868266,3575868268,2
1,798,14488,3575868266,3575868269,3
1,798,14489,3575868266,3575868272,6
1,798,14490,3575868266,3575868279,13
1,798,14491,3575868266,3575868282,16
1,798,14492,3575868266,3575868282,16
1,798,14493,3575868266,3575868285,19
1,798,14494,3575868266,3575868287,21
1,798,14495,3575868266,3575868293,27
1,798,14496,3575868266,3575868297,31
1,798,14497,3575868266,3575868297,31
1,798,14498,3575868266,3575868297,31
1,798,14499,3575868266,3575868297,31
1,798,14500,3575868266,3575868298,32
1,798,14501,3575868266,3575868299,33
1,798,14502,3575868266,3575868304,38
1,798,14503,3575868266,3575868304,38
1,798,14504,3575868266,3575868306,40
1,798,14505,3575868266,3575868307,41
1,798,14506,3575868266,3575868309,43
1,798,14507,3575868266,3575868311,45
1,798,14508,3575868266,3575868311,45
1,798,14509,3575868266,3575868313,47
1,798,14510,3575868266,3575868313,47
1,798,14511,3575868266,3575868313,47
1,798,14512,3575868266,3575868315,49
1,799,14513,3575868323,3575868323,0
1,799,14514,3575868323,3575868323,0
1,799,14515,3575868323,3575868324,1
1,799,14516,3575868323,3575868325,2
1,799,14517,3575868323,3575868328,5
1,799,14518,3575868323,3575868328,5
1,799,14519,3575868323,3575868330,7
1,799,14520,3575868323,3575868331,8
1,799,14521,3575868323,3575868332,9
1,799,14522,3575868323,3575868332,9
1,799,14523,3575868323,3575868333,10
1,799,14524,3575868323,3575868335,12
1,799,14525,3575868323,3575868335,12
1,799,14526,3575868323,3575868335,12
1,799,14527,3575868323,3575868336,13
1,799,14528,3575868323,3575868337,14
1,799,14529,3575868323,3575868340,17
1,799,14530,3575868323,3575868343,20
1,799,14531,3575868323,3575868343,20
1,799,14532,3575868323,3575868343,20
1,799,14533,3575868323,3575868344,21
1,799,14534,3575868323,3575868351,28
1,799,14535,3575868323,3575868353,30
1,799,14536,3575868323,3575868354,31
1,799,14537,3575868323,3575868354,31
1,799,14538,3575868323,3575868355,32
1,799,14539,3575868323,3575868356,33
1,799,14540,3575868323,3575868357,34
1,799,14541,3575868323,3575868359,36
1,799,14542,3575868323,3575868363,40
1,799,14543,3575868323,3575868363,40
1,799,14544,3575868323,3575868364,41
1,799,14545,3575868323,3575868365,42
1,799,14546,3575868323,3575868368,45
1,799,14547,3575868323,3575868371,48
1,799,14548,3575868323,3575868371,48
1,799,14549,3575868323,3575868372,49
1,800,14550,3575868383,3575868383,0
1,800,14551,3575868383,3575868383,0
1,800,14552,3575868383,3575868383,0
1,800,14553,3575868383,3575868383,0
1,800,14554,3575868383,3575868383,0
1,800,14555,3575868383,3575868383,0
1,800,14556,3575868383,3575868383,0
1,800,14557,3575868383,3575868383,0
1,800,14558,3575868383,3575868383,0
1,800,14559,3575868383,3575868383,0
1,800,14560,3575868383,3575868385,2
1,800,14561,3575868383,3575868385,2
1,800,14562,3575868383,3575868385,2
1,800,14563,3575868383,3575868385,2
1,800,14564,3575868383,3575868386,3
1,800,14565,3575868383,3575868387,4
1,800,14566,3575868383,3575868387,4
1,800,14567,3575868383,3575868388,5
1,800,14568,3575868383,3575868390,7
1,800,14569,3575868383,3575868391,8
1,800,14570,3575868383,3575868395,12
1,800,14571,3575868383,3575868399,16
1,800,14572,3575868383,3575868400,17
1,800,14573,3575868383,3575868400,17
1,800,14574,3575868383,3575868401,18
1,800,14575,3575868383,3575868401,18
1,800,14576,3575868383,3575868402,19
1,800,14577,3575868383,3575868402,19
1,800,14578,3575868383,3575868405,22
1,800,14579,3575868383,3575868408,25
1,800,14580,3575868383,3575868410,27
1,800,14581,3575868383,3575868411,28
1,800,14582,3575868383,3575868413,30
1,800,14583,3575868383,3575868413,30
1,800,14584,3575868383,3575868414,31
1,800,14585,3575868383,3575868415,32
1,800,14586,3575868383,3575868416,33
1,800,14587,3575868383,3575868416,33
1,800,14588,3575868383,3575868416,33
1,800,14589,3575868383,3575868416,33
1,800,14590,3575868383,3575868417,34
1,800,14591,3575868383,3575868417,34
1,800,14592,3575868383,3575868417,34
1,800,14593,3575868383,3575868418,35
1,800,14594,3575868383,3575868419,36
1,800,14595,3575868383,3575868419,36
1,800,14596,3575868383,3575868419,36
1,800,14597,3575868383,3575868419,36
1,800,14598,3575868383,3575868419,36
1,800,14599,3575868383,3575868420,37
1,800,14600,3575868383,3575868420,37
1,800,14601,3575868383,3575868422,39
1,800,14602,3575868383,3575868424,41
1,800,14603,3575868383,3575868425,42
1,800,14604,3575868383,3575868425,42
1,800,14605,3575868383,3575868426,43
1,800,14606,3575868383,3575868427,44
1,800,14607,3575868383,3575868428,45
1,800,14608,3575868383,3575868430,47
1,800,14609,3575868383,3575868431,48
1,800,14610,3575868383,3575868431,48
1,800,14611,3575868383,3575868432,49
1,800,14612,3575868383,3575868432,49
1,800,14613,3575868383,3575868433,50
1,801,14614,3575868442,3575868442,0
1,801,14615,3575868442,3575868442,0
1,801,14616,3575868442,3575868442,0
1,801,14617,3575868442,3575868442,0
1,801,14618,3575868442,3575868442,0
1,801,14619,3575868442,3575868442,0
1,801,14620,3575868442,3575868442,0
1,801,14621,3575868442,3575868442,0
1,801,14622,3575868442,3575868442,0
1,801,14623,3575868442,3575868442,0
1,801,14624,3575868442,3575868443,1
1,801,14625,3575868442,3575868444,2
1,801,14626,3575868442,3575868446,4
1,801,14627,3575868442,3575868449,7
1,801,14628,3575868442,3575868450,8
1,801,14629,3575868442,3575868450,8
1,801,14630,3575868442,3575868450,8
1,801,14631,3575868442,3575868451,9
1,801,14632,3575868442,3575868453,11
1,801,14633,3575868442,3575868453,11
1,801,14634,3575868442,3575868455,13
1,801,14635,3575868442,3575868456,14
1,801,14636,3575868442,3575868460,18
1,801,14637,3575868442,3575868462,20
1,801,14638,3575868442,3575868463,21
1,801,14639,3575868442,3575868464,22
1,801,14640,3575868442,3575868465,23
1,801,14641,3575868442,3575868467,25
1,801,14642,3575868442,3575868468,26
1,801,14643,3575868442,3575868469,27
1,801,14644,3575868442,3575868472,30
1,801,14645,3575868442,3575868480,38
1,801,14646,3575868442,3575868480,38
1,801,14647,3575868442,3575868482,40
1,801,14648,3575868442,3575868483,41
1,801,14649,3575868442,3575868484,42
1,801,14650,3575868442,3575868487,45
1,802,14651,3575868500,3575868500,0
1,802,14652,3575868500,3575868500,0
1,802,14653,3575868500,3575868500,0
1,802,14654,3575868500,3575868500,0
1,802,14655,3575868500,3575868500,0
1,802,14656,3575868500,3575868500,0
1,802,14657,3575868500,3575868500,0
1,802,14658,3575868500,3575868500,0
1,802,14659,3575868500,3575868502,2
1,802,14660,3575868500,3575868503,3
1,802,14661,3575868500,3575868503,3
1,802,14662,3575868500,3575868505,5
1,802,14663,3575868500,3575868507,7
1,802,14664,3575868500,3575868510,10
1,802,14665,3575868500,3575868510,10
1,802,14666,3575868500,3575868512,12
1,802,14667,3575868500,3575868513,13
1,802,14668,3575868500,3575868513,13
1,802,14669,3575868500,3575868514,14
1,802,14670,3575868500,3575868518,18
1,802,14671,3575868500,3575868521,21
1,802,14672,3575868500,3575868524,24
1,802,14673,3575868500,3575868525,25
1,802,14674,3575868500,3575868527,27
1,802,14675,3575868500,3575868530,30
1,802,14676,3575868500,3575868531,31
1,802,14677,3575868500,3575868531,31
1,802,14678,3575868500,3575868531,31
1,802,14679,3575868500,3575868531,31
1,802,14680,3575868500,3575868533,33
1,802,14681,3575868500,3575868535,35
1,802,14682,3575868500,3575868535,35
1,802,14683,3575868500,3575868536,36
1,802,14684,3575868500,3575868540,40
1,802,14685,3575868500,3575868542,42
1,802,14686,3575868500,3575868543,43
1,802,14687,3575868500,3575868543,43
1,802,14688,3575868500,3575868543,43
1,803,14689,3575868559,3575868559,0
1,803,14690,3575868559,3575868559,0
1,803,14691,3575868559,3575868559,0
1,803,14692,3575868559,3575868559,0
1,803,14693,3575868559,3575868559,0
1,803,14694,3575868559,3575868559,0
1,803,14695,3575868559,3575868559,0
1,803,14696,3575868559,3575868559,0
1,803,14697,3575868559,3575868561,2
1,803,14698,3575868559,3575868562,3
1,803,14699,3575868559,3575868563,4
1,803,14700,3575868559,3575868563,4
1,803,14701,3575868559,3575868564,5
1,803,14702,3575868559,3575868566,7
1,803,14703,3575868559,3575868570,11
1,803,14704,3575868559,3575868571,12
1,803,14705,3575868559,3575868575,16
1,803,14706,3575868559,3575868576,17
1,803,14707,3575868559,3575868576,17
1,803,14708,3575868559,3575868576,17
1,803,14709,3575868559,3575868578,19
1,803,14710,3575868559,3575868579,20
1,803,14711,3575868559,3575868579,20
1,803,14712,3575868559,3575868581,22
1,803,14713,3575868559,3575868581,22
1,803,14714,3575868559,3575868582,23
1,803,14715,3575868559,3575868584,25
1,803,14716,3575868559,3575868584,25
1,803,14717,3575868559,3575868585,26
1,803,14718,3575868559,3575868585,26
1,803,14719,3575868559,3575868586,27
1,803,14720,3575868559,3575868587,28
1,803,14721,3575868559,3575868587,28
1,803,14722,3575868559,3575868589,30
1,803,14723,3575868559,3575868590,31
1,803,14724,3575868559,3575868591,32
1,803,14725,3575868559,3575868591,32
1,803,14726,3575868559,3575868592,33
1,803,14727,3575868559,3575868598,39
1,803,14728,3575868559,3575868599,40
1,803,14729,3575868559,3575868599,40
1,803,14730,3575868559,3575868600,41
1,803,14731,3575868559,3575868600,41
1,803,14732,3575868559,3575868600,41
1,803,14733,3575868559,3575868601,42
1,803,14734,3575868559,3575868602,43
1,803,14735,3575868559,3575868605,46
1,803,14736,3575868559,3575868607,48
1,804,14737,3575868616,3575868616,0
1,804,14738,3575868616,3575868616,0
1,804,14739,3575868616,3575868616,0
1,804,14740,3575868616,3575868616,0
1,804,14741,3575868616,3575868616,0
1,804,14742,3575868616,3575868616,0
1,804,14743,3575868616,3575868616,0
1,804,14744,3575868616,3575868616,0
1,804,14745,3575868616,3575868616,0
1,804,14746,3575868616,3575868616,0
1,804,14747,3575868616,3575868616,0
1,804,14748,3575868616,3575868617,1
1,804,14749,3575868616,3575868618,2
1,804,14750,3575868616,3575868618,2
1,804,14751,3575868616,3575868618,2
1,804,14752,3575868616,3575868619,3
1,804,14753,3575868616,3575868619,3
1,804,14754,3575868616,3575868620,4
1,804,14755,3575868616,3575868620,4
1,804,14756,3575868616,3575868620,4
1,804,14757,3575868616,3575868621,5
1,804,14758,3575868616,3575868623,7
1,804,14759,3575868616,3575868625,9
1,804,14760,3575868616,3575868625,9
1,804,14761,3575868616,3575868626,10
1,804,14762,3575868616,3575868628,12
1,804,14763,3575868616,3575868629,13
1,804,14764,3575868616,3575868630,14
1,804,14765,3575868616,3575868631,15
1,804,14766,3575868616,3575868631,15
1,804,14767,3575868616,3575868632,16
1,804,14768,3575868616,3575868632,16
1,804,14769,3575868616,3575868633,17
1,804,14770,3575868616,3575868634,18
1,804,14771,3575868616,3575868635,19
1,804,14772,3575868616,3575868635,19
1,804,14773,3575868616,3575868639,23
1,804,14774,3575868616,3575868640,24
1,804,14775,3575868616,3575868640,24
1,804,14776,3575868616,3575868641,25
1,804,14777,3575868616,3575868641,25
1,804,14778,3575868616,3575868641,25
1,804,14779,3575868616,3575868643,27
1,804,14780,3575868616,3575868645,29
1,804,14781,3575868616,3575868648,32
1,804,14782,3575868616,3575868649,33
1,804,14783,3575868616,3575868649,33
1,804,14784,3575868616,3575868649,33
1,804,14785,3575868616,3575868652,36
1,804,14786,3575868616,3575868652,36
1,804,14787,3575868616,3575868652,36
1,804,14788,3575868616,3575868655,39
1,804,14789,3575868616,3575868655,39
1,804,14790,3575868616,3575868658,42
1,804,14791,3575868616,3575868659,43
1,804,14792,3575868616,3575868660,44
1,804,14793,3575868616,3575868662,46
1,804,14794,3575868616,3575868664,48
1,804,14795,3575868616,3575868665,49
1,804,14796,3575868616,3575868665,49
1,805,14797,3575868675,3575868675,0
1,805,14798,3575868675,3575868675,0
1,805,14799,3575868675,3575868675,0
1,805,14800,3575868675,3575868680,5
1,805,14801,3575868675,3575868680,5
1,805,14802,3575868675,3575868682,7
1,805,14803,3575868675,3575868683,8
1,805,14804,3575868675,3575868684,9
1,805,14805,3575868675,3575868687,12
1,805,14806,3575868675,3575868692,17
1,805,14807,3575868675,3575868696,21
1,805,14808,3575868675,3575868697,22
1,805,14809,3575868675,3575868697,22
1,805,14810,3575868675,3575868698,23
1,805,14811,3575868675,3575868698,23
1,805,14812,3575868675,3575868699,24
1,805,14813,3575868675,3575868703,28
1,805,14814,3575868675,3575868703,28
1,805,14815,3575868675,3575868704,29
1,805,14816,3575868675,3575868705,30
1,805,14817,3575868675,3575868707,32
1,805,14818,3575868675,3575868710,35
1,805,14819,3575868675,3575868712,37
1,805,14820,3575868675,3575868713,38
1,805,14821,3575868675,3575868713,38
1,805,14822,3575868675,3575868714,39
1,805,14823,3575868675,3575868714,39
1,805,14824,3575868675,3575868719,44
1,805,14825,3575868675,3575868721,46
1,805,14826,3575868675,3575868724,49
1,806,14827,3575868732,3575868732,0
1,806,14828,3575868732,3575868732,0
1,806,14829,3575868732,3575868732,0
1,806,14830,3575868732,3575868732,0
1,806,14831,3575868732,3575868732,0
1,806,14832,3575868732,3575868732,0
1,806,14833,3575868732,3575868732,0
1,806,14834,3575868732,3575868734,2
1,806,14835,3575868732,3575868734,2
1,806,14836,3575868732,3575868734,2
1,806,14837,3575868732,3575868736,4
1,806,14838,3575868732,3575868736,4
1,806,14839,3575868732,3575868740,8
1,806,14840,3575868732,3575868743,11
1,806,14841,3575868732,3575868743,11
1,806,14842,3575868732,3575868744,12
1,806,14843,3575868732,3575868744,12
1,806,14844,3575868732,3575868753,21
1,806,14845,3575868732,3575868754,22
1,806,14846,3575868732,3575868754,22
1,806,14847,3575868732,3575868754,22
1,806,14848,3575868732,3575868755,23
1,806,14849,3575868732,3575868757,25
1,806,14850,3575868732,3575868757,25
1,806,14851,3575868732,3575868760,28
1,806,14852,3575868732,3575868762,30
1,806,14853,3575868732,3575868763,31
1,806,14854,3575868732,3575868764,32
1,806,14855,3575868732,3575868767,35
1,806,14856,3575868732,3575868770,38
1,806,14857,3575868732,3575868772,40
1,806,14858,3575868732,3575868774,42
1,806,14859,3575868732,3575868775,43
1,806,14860,3575868732,3575868776,44
1,806,14861,3575868732,3575868776,44
1,806,14862,3575868732,3575868777,45
1,806,14863,3575868732,3575868778,46
1,806,14864,3575868732,3575868778,46
1,806,14865,3575868732,3575868779,47
1,806,14866,3575868732,3575868780,48
1,806,14867,3575868732,3575868780,48
1,806,14868,3575868732,3575868781,49
1,806,14869,3575868732,3575868782,50
1,807,14870,3575868790,3575868790,0
1,807,14871,3575868790,3575868790,0
1,807,14872,3575868790,3575868790,0
1,807,14873,3575868790,3575868790,0
1,807,14874,3575868790,3575868790,0
1,807,14875,3575868790,3575868790,0
1,807,14876,3575868790,3575868790,0
1,807,14877,3575868790,3575868790,0
1,807,14878,3575868790,3575868791,1
1,807,14879,3575868790,3575868792,2
1,807,14880,3575868790,3575868792,2
1,807,14881,3575868790,3575868794,4
1,807,14882,3575868790,3575868799,9
1,807,14883,3575868790,3575868799,9
1,807,14884,3575868790,3575868799,9
1,807,14885,3575868790,3575868800,10
1,807,14886,3575868790,3575868800,10
1,807,14887,3575868790,3575868801,11
1,807,14888,3575868790,3575868802,12
1,807,14889,3575868790,3575868803,13
1,807,14890,3575868790,3575868804,14
1,807,14891,3575868790,3575868810,20
1,807,14892,3575868790,3575868812,22
1,807,14893,3575868790,3575868813,23
1,807,14894,3575868790,3575868814,24
1,807,14895,3575868790,3575868815,25
1,807,14896,3575868790,3575868815,25
1,807,14897,3575868790,3575868815,25
1,807,14898,3575868790,3575868815,25
1,807,14899,3575868790,3575868815,25
1,807,14900,3575868790,3575868816,26
1,807,14901,3575868790,3575868816,26
1,807,14902,3575868790,3575868816,26
1,807,14903,3575868790,3575868816,26
1,807,14904,3575868790,3575868818,28
1,807,14905,3575868790,3575868818,28
1,807,14906,3575868790,3575868818,28
1,807,14907,3575868790,3575868818,28
1,807,14908,3575868790,3575868819,29
1,807,14909,3575868790,3575868820,30
1,807,14910,3575868790,3575868820,30
1,807,14911,3575868790,3575868821,31
1,807,14912,3575868790,3575868823,33
1,807,14913,3575868790,3575868825,35
1,807,14914,3575868790,3575868825,35
1,807,14915,3575868790,3575868826,36
1,807,14916,3575868790,3575868827,37
1,807,14917,3575868790,3575868827,37
1,807,14918,3575868790,3575868829,39
1,807,14919,3575868790,3575868830,40
1,807,14920,3575868790,3575868830,40
1,807,14921,3575868790,3575868831,41
1,807,14922,3575868790,3575868833,43
1,807,14923,3575868790,3575868833,43
1,807,14924,3575868790,3575868834,44
1,807,14925,3575868790,3575868835,45
1,807,14926,3575868790,3575868835,45
1,807,14927,3575868790,3575868839,49
1,807,14928,3575868790,3575868840,50
1,808,14929,3575868847,3575868847,0
1,808,14930,3575868847,3575868847,0
1,808,14931,3575868847,3575868847,0
1,808,14932,3575868847,3575868847,0
1,808,14933,3575868847,3575868847,0
1,808,14934,3575868847,3575868847,0
1,808,14935,3575868847,3575868847,0
1,808,14936,3575868847,3575868849,2
1,808,14937,3575868847,3575868849,2
1,808,14938,3575868847,3575868851,4
1,808,14939,3575868847,3575868852,5
1,808,14940,3575868847,3575868852,5
1,808,14941,3575868847,3575868855,8
1,808,14942,3575868847,3575868856,9
1,808,14943,3575868847,3575868858,11
1,808,14944,3575868847,3575868860,13
1,808,14945,3575868847,3575868862,15
1,808,14946,3575868847,3575868862,15
1,808,14947,3575868847,3575868864,17
1,808,14948,3575868847,3575868865,18
1,808,14949,3575868847,3575868865,18
1,808,14950,3575868847,3575868866,19
1,808,14951,3575868847,3575868868,21
1,808,14952,3575868847,3575868868,21
1,808,14953,3575868847,3575868871,24
1,808,14954,3575868847,3575868873,26
1,808,14955,3575868847,3575868880,33
1,808,14956,3575868847,3575868880,33
1,808,14957,3575868847,3575868882,35
1,808,14958,3575868847,3575868883,36
1,808,14959,3575868847,3575868884,37
1,808,14960,3575868847,3575868887,40
1,808,14961,3575868847,3575868887,40
1,808,14962,3575868847,3575868893,46
1,808,14963,3575868847,3575868895,48
1,808,14964,3575868847,3575868897,50
1,808,14965,3575868847,3575868897,50
1,809,14966,3575868907,3575868907,0
1,809,14967,3575868907,3575868907,0
1,809,14968,3575868907,3575868907,0
1,809,14969,3575868907,3575868907,0
1,809,14970,3575868907,3575868907,0
1,809,14971,3575868907,3575868907,0
1,809,14972,3575868907,3575868907,0
1,809,14973,3575868907,3575868910,3
1,809,14974,3575868907,3575868912,5
1,809,14975,3575868907,3575868913,6
1,809,14976,3575868907,3575868913,6
1,809,14977,3575868907,3575868914,7
1,809,14978,3575868907,3575868918,11
1,809,14979,3575868907,3575868921,14
1,809,14980,3575868907,3575868924,17
1,809,14981,3575868907,3575868925,18
1,809,14982,3575868907,3575868927,20
1,809,14983,3575868907,3575868931,24
1,809,14984,3575868907,3575868931,24
1,809,14985,3575868907,3575868931,24
1,809,14986,3575868907,3575868932,25
1,809,14987,3575868907,3575868933,26
1,809,14988,3575868907,3575868934,27
1,809,14989,3575868907,3575868935,28
1,809,14990,3575868907,3575868937,30
1,809,14991,3575868907,3575868938,31
1,809,14992,3575868907,3575868940,33
1,809,14993,3575868907,3575868943,36
1,809,14994,3575868907,3575868943,36
1,809,14995,3575868907,3575868944,37
1,809,14996,3575868907,3575868944,37
1,809,14997,3575868907,3575868953,46
1,809,14998,3575868907,3575868953,46
1,809,14999,3575868907,3575868954,47
1,809,15000,3575868907,3575868954,47
1,809,15001,3575868907,3575868955,48
1,809,15002,3575868907,3575868955,48
1,809,15003,3575868907,3575868956,49
1,809,15004,3575868907,3575868957,50
1,810,15005,3575868965,3575868965,0
1,810,15006,3575868965,3575868965,0
1,810,15007,3575868965,3575868965,0
1,810,15008,3575868965,3575868965,0
1,810,15009,3575868965,3575868965,0
1,810,15010,3575868965,3575868965,0
1,810,15011,3575868965,3575868967,2
1,810,15012,3575868965,3575868970,5
1,810,15013,3575868965,3575868972,7
1,810,15014,3575868965,3575868973,8
1,810,15015,3575868965,3575868975,10
1,810,15016,3575868965,3575868976,11
1,810,15017,3575868965,3575868976,11
1,810,15018,3575868965,3575868978,13
1,810,15019,3575868965,3575868978,13
1,810,15020,3575868965,3575868978,13
1,810,15021,3575868965,3575868979,14
1,810,15022,3575868965,3575868981,16
1,810,15023,3575868965,3575868981,16
1,810,15024,3575868965,3575868981,16
1,810,15025,3575868965,3575868981,16
1,810,15026,3575868965,3575868984,19
1,810,15027,3575868965,3575868984,19
1,810,15028,3575868965,3575868984,19
1,810,15029,3575868965,3575868985,20
1,810,15030,3575868965,3575868985,20
1,810,15031,3575868965,3575868986,21
1,810,15032,3575868965,3575868986,21
1,810,15033,3575868965,3575868987,22
1,810,15034,3575868965,3575868989,24
1,810,15035,3575868965,3575868991,26
1,810,15036,3575868965,3575868999,34
1,810,15037,3575868965,3575869000,35
1,810,15038,3575868965,3575869000,35
1,810,15039,3575868965,3575869000,35
1,810,15040,3575868965,3575869000,35
1,810,15041,3575868965,3575869003,38
1,810,15042,3575868965,3575869004,39
1,810,15043,3575868965,3575869007,42
1,810,15044,3575868965,3575869011,46
1,810,15045,3575868965,3575869012,47
1,810,15046,3575868965,3575869015,50
1,811,15047,3575869025,3575869025,0
1,811,15048,3575869025,3575869025,0
1,811,15049,3575869025,3575869025,0
1,811,15050,3575869025,3575869025,0
1,811,15051,3575869025,3575869025,0
1,811,15052,3575869025,3575869025,0
1,811,15053,3575869025,3575869025,0
1,811,15054,3575869025,3575869025,0
1,811,15055,3575869025,3575869025,0
1,811,15056,3575869025,3575869025,0
1,811,15057,3575869025,3575869025,0
1,811,15058,3575869025,3575869025,0
1,811,15059,3575869025,3575869025,0
1,811,15060,3575869025,3575869025,0
1,811,15061,3575869025,3575869025,0
1,811,15062,3575869025,3575869025,0
1,811,15063,3575869025,3575869025,0
1,811,15064,3575869025,3575869026,1
1,811,15065,3575869025,3575869028,3
1,811,15066,3575869025,3575869030,5
1,811,15067,3575869025,3575869030,5
1,811,15068,3575869025,3575869031,6
1,811,15069,3575869025,3575869032,7
1,811,15070,3575869025,3575869033,8
1,811,15071,3575869025,3575869033,8
1,811,15072,3575869025,3575869034,9
1,811,15073,3575869025,3575869034,9
1,811,15074,3575869025,3575869035,10
1,811,15075,3575869025,3575869035,10
1,811,15076,3575869025,3575869039,14
1,811,15077,3575869025,3575869040,15
1,811,15078,3575869025,3575869041,16
1,811,15079,3575869025,3575869041,16
1,811,15080,3575869025,3575869042,17
1,811,15081,3575869025,3575869044,19
1,811,15082,3575869025,3575869044,19
1,811,15083,3575869025,3575869045,20
1,811,15084,3575869025,3575869045,20
1,811,15085,3575869025,3575869047,22
1,811,15086,3575869025,3575869049,24
1,811,15087,3575869025,3575869049,24
1,811,15088,3575869025,3575869051,26
1,811,15089,3575869025,3575869055,30
1,811,15090,3575869025,3575869055,30
1,811,15091,3575869025,3575869056,31
1,811,15092,3575869025,3575869058,33
1,811,15093,3575869025,3575869060,35
1,811,15094,3575869025,3575869062,37
1,811,15095,3575869025,3575869063,38
1,811,15096,3575869025,3575869064,39
1,811,15097,3575869025,3575869065,40
1,811,15098,3575869025,3575869066,41
1,811,15099,3575869025,3575869066,41
1,811,15100,3575869025,3575869067,42
1,811,15101,3575869025,3575869070,45
1,811,15102,3575869025,3575869071,46
1,811,15103,3575869025,3575869073,48
1,812,15104,3575869084,3575869084,0
1,812,15105,3575869084,3575869084,0
1,812,15106,3575869084,3575869084,0
1,812,15107,3575869084,3575869084,0
1,812,15108,3575869084,3575869085,1
1,812,15109,3575869084,3575869088,4
1,812,15110,3575869084,3575869094,10
1,812,15111,3575869084,3575869094,10
1,812,15112,3575869084,3575869096,12
1,812,15113,3575869084,3575869097,13
1,812,15114,3575869084,3575869097,13
1,812,15115,3575869084,3575869098,14
1,812,15116,3575869084,3575869099,15
1,812,15117,3575869084,3575869099,15
1,812,15118,3575869084,3575869103,19
1,812,15119,3575869084,3575869103,19
1,812,15120,3575869084,3575869103,19
1,812,15121,3575869084,3575869106,22
1,812,15122,3575869084,3575869107,23
1,812,15123,3575869084,3575869108,24
1,812,15124,3575869084,3575869110,26
1,812,15125,3575869084,3575869112,28
1,812,15126,3575869084,3575869113,29
1,812,15127,3575869084,3575869113,29
1,812,15128,3575869084,3575869114,30
1,812,15129,3575869084,3575869115,31
1,812,15130,3575869084,3575869119,35
1,812,15131,3575869084,3575869121,37
1,812,15132,3575869084,3575869124,40
1,812,15133,3575869084,3575869125,41
1,812,15134,3575869084,3575869127,43
1,812,15135,3575869084,3575869130,46
1,812,15136,3575869084,3575869130,46
1,812,15137,3575869084,3575869131,47
1,812,15138,3575869084,3575869131,47
1,812,15139,3575869084,3575869132,48
1,812,15140,3575869084,3575869132,48
1,813,15141,3575869141,3575869141,0
1,813,15142,3575869141,3575869141,0
1,813,15143,3575869141,3575869141,0
1,813,15144,3575869141,3575869141,0
1,813,15145,3575869141,3575869141,0
1,813,15146,3575869141,3575869141,0
1,813,15147,3575869141,3575869142,1
1,813,15148,3575869141,3575869144,3
1,813,15149,3575869141,3575869144,3
1,813,15150,3575869141,3575869144,3
1,813,15151,3575869141,3575869148,7
1,813,15152,3575869141,3575869153,12
1,813,15153,3575869141,3575869153,12
1,813,15154,3575869141,3575869154,13
1,813,15155,3575869141,3575869154,13
1,813,15156,3575869141,3575869156,15
1,813,15157,3575869141,3575869157,16
1,813,15158,3575869141,3575869157,16
1,813,15159,3575869141,3575869159,18
1,813,15160,3575869141,3575869162,21
1,813,15161,3575869141,3575869163,22
1,813,15162,3575869141,3575869163,22
1,813,15163,3575869141,3575869166,25
1,813,15164,3575869141,3575869167,26
1,813,15165,3575869141,3575869171,30
1,813,15166,3575869141,3575869171,30
1,813,15167,3575869141,3575869173,32
1,813,15168,3575869141,3575869173,32
1,813,15169,3575869141,3575869175,34
1,813,15170,3575869141,3575869176,35
1,813,15171,3575869141,3575869177,36
1,813,15172,3575869141,3575869178,37
1,813,15173,3575869141,3575869178,37
1,813,15174,3575869141,3575869179,38
1,813,15175,3575869141,3575869181,40
1,813,15176,3575869141,3575869181,40
1,813,15177,3575869141,3575869181,40
1,813,15178,3575869141,3575869184,43
1,813,15179,3575869141,3575869184,43
1,813,15180,3575869141,3575869184,43
1,813,15181,3575869141,3575869185,44
1,813,15182,3575869141,3575869185,44
1,813,15183,3575869141,3575869186,45
1,813,15184,3575869141,3575869187,46
1,813,15185,3575869141,3575869187,46
1,813,15186,3575869141,3575869190,49
1,813,15187,3575869141,3575869191,50
1,814,15188,3575869200,3575869200,0
1,814,15189,3575869200,3575869200,0
1,814,15190,3575869200,3575869200,0
1,814,15191,3575869200,3575869200,0
1,814,15192,3575869200,3575869200,0
1,814,15193,3575869200,3575869200,0
1,814,15194,3575869200,3575869202,2
1,814,15195,3575869200,3575869203,3
1,814,15196,3575869200,3575869205,5
1,814,15197,3575869200,3575869211,11
1,814,15198,3575869200,3575869212,12
1,814,15199,3575869200,3575869212,12
1,814,15200,3575869200,3575869214,14
1,814,15201,3575869200,3575869215,15
1,814,15202,3575869200,3575869215,15
1,814,15203,3575869200,3575869215,15
1,814,15204,3575869200,3575869216,16
1,814,15205,3575869200,3575869216,16
1,814,15206,3575869200,3575869217,17
1,814,15207,3575869200,3575869217,17
1,814,15208,3575869200,3575869218,18
1,814,15209,3575869200,3575869219,19
1,814,15210,3575869200,3575869219,19
1,814,15211,3575869200,3575869220,20
1,814,15212,3575869200,3575869221,21
1,814,15213,3575869200,3575869221,21
1,814,15214,3575869200,3575869223,23
1,814,15215,3575869200,3575869224,24
1,814,15216,3575869200,3575869225,25
1,814,15217,3575869200,3575869225,25
1,814,15218,3575869200,3575869226,26
1,814,15219,3575869200,3575869229,29
1,814,15220,3575869200,3575869230,30
1,814,15221,3575869200,3575869231,31
1,814,15222,3575869200,3575869231,31
1,814,15223,3575869200,3575869231,31
1,814,15224,3575869200,3575869232,32
1,814,15225,3575869200,3575869232,32
1,814,15226,3575869200,3575869233,33
1,814,15227,3575869200,3575869233,33
1,814,15228,3575869200,3575869234,34
1,814,15229,3575869200,3575869235,35
1,814,15230,3575869200,3575869235,35
1,814,15231,3575869200,3575869239,39
1,814,15232,3575869200,3575869241,41
1,814,15233,3575869200,3575869241,41
1,814,15234,3575869200,3575869241,41
1,814,15235,3575869200,3575869242,42
1,814,15236,3575869200,3575869244,44
1,814,15237,3575869200,3575869245,45
1,814,15238,3575869200,3575869245,45
1,814,15239,3575869200,3575869245,45
1,814,15240,3575869200,3575869248,48
1,814,15241,3575869200,3575869249,49
1,815,15242,3575869259,3575869259,0
1,815,15243,3575869259,3575869259,0
1,815,15244,3575869259,3575869259,0
1,815,15245,3575869259,3575869259,0
1,815,15246,3575869259,3575869259,0
1,815,15247,3575869259,3575869260,1
1,815,15248,3575869259,3575869262,3
1,815,15249,3575869259,3575869262,3
1,815,15250,3575869259,3575869263,4
1,815,15251,3575869259,3575869266,7
1,815,15252,3575869259,3575869266,7
1,815,15253,3575869259,3575869266,7
1,815,15254,3575869259,3575869268,9
1,815,15255,3575869259,3575869269,10
1,815,15256,3575869259,3575869272,13
1,815,15257,3575869259,3575869280,21
1,815,15258,3575869259,3575869281,22
1,815,15259,3575869259,3575869282,23
1,815,15260,3575869259,3575869283,24
1,815,15261,3575869259,3575869284,25
1,815,15262,3575869259,3575869287,28
1,815,15263,3575869259,3575869294,35
1,815,15264,3575869259,3575869295,36
1,815,15265,3575869259,3575869296,37
1,815,15266,3575869259,3575869297,38
1,815,15267,3575869259,3575869297,38
1,815,15268,3575869259,3575869297,38
1,815,15269,3575869259,3575869298,39
1,815,15270,3575869259,3575869299,40
1,815,15271,3575869259,3575869299,40
1,815,15272,3575869259,3575869303,44
1,815,15273,3575869259,3575869304,45
1,815,15274,3575869259,3575869304,45
1,815,15275,3575869259,3575869306,47
1,815,15276,3575869259,3575869308,49
1,815,15277,3575869259,3575869308,49
1,816,15278,3575869317,3575869317,0
1,816,15279,3575869317,3575869317,0
1,816,15280,3575869317,3575869317,0
1,816,15281,3575869317,3575869317,0
1,816,15282,3575869317,3575869317,0
1,816,15283,3575869317,3575869319,2
1,816,15284,3575869317,3575869322,5
1,816,15285,3575869317,3575869325,8
1,816,15286,3575869317,3575869327,10
1,816,15287,3575869317,3575869330,13
1,816,15288,3575869317,3575869331,14
1,816,15289,3575869317,3575869331,14
1,816,15290,3575869317,3575869332,15
1,816,15291,3575869317,3575869332,15
1,816,15292,3575869317,3575869333,16
1,816,15293,3575869317,3575869334,17
1,816,15294,3575869317,3575869335,18
1,816,15295,3575869317,3575869337,20
1,816,15296,3575869317,3575869337,20
1,816,15297,3575869317,3575869338,21
1,816,15298,3575869317,3575869338,21
1,816,15299,3575869317,3575869340,23
1,816,15300,3575869317,3575869343,26
1,816,15301,3575869317,3575869344,27
1,816,15302,3575869317,3575869344,27
1,816,15303,3575869317,3575869345,28
1,816,15304,3575869317,3575869348,31
1,816,15305,3575869317,3575869353,36
1,816,15306,3575869317,3575869354,37
1,816,15307,3575869317,3575869354,37
1,816,15308,3575869317,3575869354,37
1,816,15309,3575869317,3575869355,38
1,816,15310,3575869317,3575869355,38
1,816,15311,3575869317,3575869357,40
1,816,15312,3575869317,3575869357,40
1,816,15313,3575869317,3575869359,42
1,816,15314,3575869317,3575869363,46
1,816,15315,3575869317,3575869364,47
1,816,15316,3575869317,3575869365,48
1,816,15317,3575869317,3575869366,49
1,817,15318,3575869376,3575869376,0
1,817,15319,3575869376,3575869376,0
1,817,15320,3575869376,3575869376,0
1,817,15321,3575869376,3575869376,0
1,817,15322,3575869376,3575869376,0
1,817,15323,3575869376,3575869377,1
1,817,15324,3575869376,3575869379,3
1,817,15325,3575869376,3575869379,3
1,817,15326,3575869376,3575869380,4
1,817,15327,3575869376,3575869381,5
1,817,15328,3575869376,3575869382,6
1,817,15329,3575869376,3575869384,8
1,817,15330,3575869376,3575869385,9
1,817,15331,3575869376,3575869385,9
1,817,15332,3575869376,3575869385,9
1,817,15333,3575869376,3575869386,10
1,817,15334,3575869376,3575869387,11
1,817,15335,3575869376,3575869387,11
1,817,15336,3575869376,3575869390,14
1,817,15337,3575869376,3575869391,15
1,817,15338,3575869376,3575869391,15
1,817,15339,3575869376,3575869391,15
1,817,15340,3575869376,3575869400,24
1,817,15341,3575869376,3575869400,24
1,817,15342,3575869376,3575869401,25
1,817,15343,3575869376,3575869401,25
1,817,15344,3575869376,3575869401,25
1,817,15345,3575869376,3575869403,27
1,817,15346,3575869376,3575869403,27
1,817,15347,3575869376,3575869406,30
1,817,15348,3575869376,3575869408,32
1,817,15349,3575869376,3575869411,35
1,817,15350,3575869376,3575869412,36
1,817,15351,3575869376,3575869413,37
1,817,15352,3575869376,3575869415,39
1,817,15353,3575869376,3575869415,39
1,817,15354,3575869376,3575869416,40
1,817,15355,3575869376,3575869416,40
1,817,15356,3575869376,3575869416,40
1,817,15357,3575869376,3575869416,40
1,817,15358,3575869376,3575869416,40
1,817,15359,3575869376,3575869417,41
1,817,15360,3575869376,3575869417,41
1,817,15361,3575869376,3575869417,41
1,817,15362,3575869376,3575869418,42
1,817,15363,3575869376,3575869419,43
1,817,15364,3575869376,3575869419,43
1,817,15365,3575869376,3575869420,44
1,817,15366,3575869376,3575869420,44
1,817,15367,3575869376,3575869421,45
1,817,15368,3575869376,3575869422,46
1,817,15369,3575869376,3575869423,47
1,817,15370,3575869376,3575869424,48
1,817,15371,3575869376,3575869424,48
1,817,15372,3575869376,3575869425,49
1,817,15373,3575869376,3575869425,49
1,817,15374,3575869376,3575869426,50
1,818,15375,3575869435,3575869435,0
1,818,15376,3575869435,3575869435,0
1,818,15377,3575869435,3575869435,0
1,818,15378,3575869435,3575869435,0
1,818,15379,3575869435,3575869435,0
1,818,15380,3575869435,3575869435,0
1,818,15381,3575869435,3575869435,0
1,818,15382,3575869435,3575869435,0
1,818,15383,3575869435,3575869435,0
1,818,15384,3575869435,3575869435,0
1,818,15385,3575869435,3575869435,0
1,818,15386,3575869435,3575869435,0
1,818,15387,3575869435,3575869435,0
1,818,15388,3575869435,3575869442,7
1,818,15389,3575869435,3575869442,7
1,818,15390,3575869435,3575869443,8
1,818,15391,3575869435,3575869444,9
1,818,15392,3575869435,3575869444,9
1,818,15393,3575869435,3575869445,10
1,818,15394,3575869435,3575869445,10
1,818,15395,3575869435,3575869446,11
1,818,15396,3575869435,3575869448,13
1,818,15397,3575869435,3575869449,14
1,818,15398,3575869435,3575869449,14
1,818,15399,3575869435,3575869450,15
1,818,15400,3575869435,3575869452,17
1,818,15401,3575869435,3575869455,20
1,818,15402,3575869435,3575869455,20
1,818,15403,3575869435,3575869456,21
1,818,15404,3575869435,3575869459,24
1,818,15405,3575869435,3575869460,25
1,818,15406,3575869435,3575869462,27
1,818,15407,3575869435,3575869464,29
1,818,15408,3575869435,3575869466,31
1,818,15409,3575869435,3575869466,31
1,818,15410,3575869435,3575869466,31
1,818,15411,3575869435,3575869467,32
1,818,15412,3575869435,3575869470,35
1,818,15413,3575869435,3575869471,36
1,818,15414,3575869435,3575869472,37
1,818,15415,3575869435,3575869480,45
1,818,15416,3575869435,3575869480,45
1,818,15417,3575869435,3575869483,48
1,818,15418,3575869435,3575869484,49
1,818,15419,3575869435,3575869485,50
1,819,15420,3575869494,3575869495,1
1,819,15421,3575869494,3575869495,1
1,819,15422,3575869494,3575869495,1
1,819,15423,3575869494,3575869495,1
1,819,15424,3575869494,3575869496,2
1,819,15425,3575869494,3575869496,2
1,819,15426,3575869494,3575869497,3
1,819,15427,3575869494,3575869497,3
1,819,15428,3575869494,3575869498,4
1,819,15429,3575869494,3575869502,8
1,819,15430,3575869494,3575869502,8
1,819,15431,3575869494,3575869503,9
1,819,15432,3575869494,3575869505,11
1,819,15433,3575869494,3575869507,13
1,819,15434,3575869494,3575869509,15
1,819,15435,3575869494,3575869512,18
1,819,15436,3575869494,3575869513,19
1,819,15437,3575869494,3575869513,19
1,819,15438,3575869494,3575869514,20
1,819,15439,3575869494,3575869518,24
1,819,15440,3575869494,3575869521,27
1,819,15441,3575869494,3575869523,29
1,819,15442,3575869494,3575869524,30
1,819,15443,3575869494,3575869526,32
1,819,15444,3575869494,3575869529,35
1,819,15445,3575869494,3575869530,36
1,819,15446,3575869494,3575869531,37
1,819,15447,3575869494,3575869532,38
1,819,15448,3575869494,3575869534,40
1,819,15449,3575869494,3575869534,40
1,819,15450,3575869494,3575869535,41
1,819,15451,3575869494,3575869536,42
1,819,15452,3575869494,3575869536,42
1,819,15453,3575869494,3575869537,43
1,819,15454,3575869494,3575869539,45
1,819,15455,3575869494,3575869542,48
1,819,15456,3575869494,3575869542,48
1,819,15457,3575869494,3575869543,49
1,820,15458,3575869551,3575869551,0
1,820,15459,3575869551,3575869551,0
1,820,15460,3575869551,3575869552,1
1,820,15461,3575869551,3575869553,2
1,820,15462,3575869551,3575869553,2
1,820,15463,3575869551,3575869553,2
1,820,15464,3575869551,3575869554,3
1,820,15465,3575869551,3575869556,5
1,820,15466,3575869551,3575869557,6
1,820,15467,3575869551,3575869559,8
1,820,15468,3575869551,3575869562,11
1,820,15469,3575869551,3575869563,12
1,820,15470,3575869551,3575869564,13
1,820,15471,3575869551,3575869566,15
1,820,15472,3575869551,3575869570,19
1,820,15473,3575869551,3575869571,20
1,820,15474,3575869551,3575869573,22
1,820,15475,3575869551,3575869574,23
1,820,15476,3575869551,3575869575,24
1,820,15477,3575869551,3575869575,24
1,820,15478,3575869551,3575869576,25
1,820,15479,3575869551,3575869577,26
1,820,15480,3575869551,3575869578,27
1,820,15481,3575869551,3575869579,28
1,820,15482,3575869551,3575869580,29
1,820,15483,3575869551,3575869580,29
1,820,15484,3575869551,3575869581,30
1,820,15485,3575869551,3575869584,33
1,820,15486,3575869551,3575869584,33
1,820,15487,3575869551,3575869584,33
1,820,15488,3575869551,3575869585,34
1,820,15489,3575869551,3575869585,34
1,820,15490,3575869551,3575869585,34
1,820,15491,3575869551,3575869586,35
1,820,15492,3575869551,3575869587,36
1,820,15493,3575869551,3575869590,39
1,820,15494,3575869551,3575869590,39
1,820,15495,3575869551,3575869590,39
1,820,15496,3575869551,3575869593,42
1,820,15497,3575869551,3575869594,43
1,820,15498,3575869551,3575869598,47
1,820,15499,3575869551,3575869599,48
1,820,15500,3575869551,3575869600,49
1,820,15501,3575869551,3575869600,49
1,820,15502,3575869551,3575869600,49
1,820,15503,3575869551,3575869600,49
1,820,15504,3575869551,3575869601,50
1,821,15505,3575869608,3575869608,0
1,821,15506,3575869608,3575869608,0
1,821,15507,3575869608,3575869608,0
1,821,15508,3575869608,3575869610,2
1,821,15509,3575869608,3575869611,3
1,821,15510,3575869608,3575869612,4
1,821,15511,3575869608,3575869612,4
1,821,15512,3575869608,3575869614,6
1,821,15513,3575869608,3575869614,6
1,821,15514,3575869608,3575869615,7
1,821,15515,3575869608,3575869615,7
1,821,15516,3575869608,3575869615,7
1,821,15517,3575869608,3575869616,8
1,821,15518,3575869608,3575869617,9
1,821,15519,3575869608,3575869617,9
1,821,15520,3575869608,3575869617,9
1,821,15521,3575869608,3575869618,10
1,821,15522,3575869608,3575869619,11
1,821,15523,3575869608,3575869619,11
1,821,15524,3575869608,3575869619,11
1,821,15525,3575869608,3575869620,12
1,821,15526,3575869608,3575869620,12
1,821,15527,3575869608,3575869622,14
1,821,15528,3575869608,3575869623,15
1,821,15529,3575869608,3575869624,16
1,821,15530,3575869608,3575869624,16
1,821,15531,3575869608,3575869625,17
1,821,15532,3575869608,3575869628,20
1,821,15533,3575869608,3575869630,22
1,821,15534,3575869608,3575869630,22
1,821,15535,3575869608,3575869630,22
1,821,15536,3575869608,3575869630,22
1,821,15537,3575869608,3575869632,24
1,821,15538,3575869608,3575869632,24
1,821,15539,3575869608,3575869633,25
1,821,15540,3575869608,3575869633,25
1,821,15541,3575869608,3575869634,26
1,821,15542,3575869608,3575869635,27
1,821,15543,3575869608,3575869641,33
1,821,15544,3575869608,3575869642,34
1,821,15545,3575869608,3575869642,34
1,821,15546,3575869608,3575869643,35
1,821,15547,3575869608,3575869643,35
1,821,15548,3575869608,3575869644,36
1,821,15549,3575869608,3575869644,36
1,821,15550,3575869608,3575869647,39
1,821,15551,3575869608,3575869648,40
1,821,15552,3575869608,3575869648,40
1,821,15553,3575869608,3575869649,41
1,821,15554,3575869608,3575869651,43
1,821,15555,3575869608,3575869654,46
1,821,15556,3575869608,3575869654,46
1,821,15557,3575869608,3575869655,47
1,821,15558,3575869608,3575869656,48
1,821,15559,3575869608,3575869657,49
1,822,15560,3575869666,3575869666,0
1,822,15561,3575869666,3575869666,0
1,822,15562,3575869666,3575869666,0
1,822,15563,3575869666,3575869666,0
1,822,15564,3575869666,3575869666,0
1,822,15565,3575869666,3575869666,0
1,822,15566,3575869666,3575869666,0
1,822,15567,3575869666,3575869669,3
1,822,15568,3575869666,3575869671,5
1,822,15569,3575869666,3575869672,6
1,822,15570,3575869666,3575869680,14
1,822,15571,3575869666,3575869681,15
1,822,15572,3575869666,3575869682,16
1,822,15573,3575869666,3575869684,18
1,822,15574,3575869666,3575869684,18
1,822,15575,3575869666,3575869685,19
1,822,15576,3575869666,3575869687,21
1,822,15577,3575869666,3575869687,21
1,822,15578,3575869666,3575869695,29
1,822,15579,3575869666,3575869695,29
1,822,15580,3575869666,3575869696,30
1,822,15581,3575869666,3575869696,30
1,822,15582,3575869666,3575869697,31
1,822,15583,3575869666,3575869698,32
1,822,15584,3575869666,3575869702,36
1,822,15585,3575869666,3575869703,37
1,822,15586,3575869666,3575869704,38
1,822,15587,3575869666,3575869705,39
1,822,15588,3575869666,3575869706,40
1,822,15589,3575869666,3575869709,43
1,822,15590,3575869666,3575869712,46
1,822,15591,3575869666,3575869713,47
1,822,15592,3575869666,3575869713,47
1,822,15593,3575869666,3575869713,47
1,822,15594,3575869666,3575869714,48
1,823,15595,3575869726,3575869726,0
1,823,15596,3575869726,3575869726,0
1,823,15597,3575869726,3575869726,0
1,823,15598,3575869726,3575869726,0
1,823,15599,3575869726,3575869727,1
1,823,15600,3575869726,3575869729,3
1,823,15601,3575869726,3575869731,5
1,823,15602,3575869726,3575869731,5
1,823,15603,3575869726,3575869731,5
1,823,15604,3575869726,3575869732,6
1,823,15605,3575869726,3575869733,7
1,823,15606,3575869726,3575869734,8
1,823,15607,3575869726,3575869736,10
1,823,15608,3575869726,3575869736,10
1,823,15609,3575869726,3575869736,10
1,823,15610,3575869726,3575869740,14
1,823,15611,3575869726,3575869742,16
1,823,15612,3575869726,3575869743,17
1,823,15613,3575869726,3575869744,18
1,823,15614,3575869726,3575869747,21
1,823,15615,3575869726,3575869752,26
1,823,15616,3575869726,3575869753,27
1,823,15617,3575869726,3575869753,27
1,823,15618,3575869726,3575869753,27
1,823,15619,3575869726,3575869754,28
1,823,15620,3575869726,3575869754,28
1,823,15621,3575869726,3575869756,30
1,823,15622,3575869726,3575869756,30
1,823,15623,3575869726,3575869757,31
1,823,15624,3575869726,3575869757,31
1,823,15625,3575869726,3575869759,33
1,823,15626,3575869726,3575869761,35
1,823,15627,3575869726,3575869762,36
1,823,15628,3575869726,3575869762,36
1,823,15629,3575869726,3575869763,37
1,823,15630,3575869726,3575869764,38
1,823,15631,3575869726,3575869765,39
1,823,15632,3575869726,3575869770,44
1,823,15633,3575869726,3575869773,47
1,823,15634,3575869726,3575869774,48
1,823,15635,3575869726,3575869775,49
1,823,15636,3575869726,3575869776,50
1,824,15637,3575869786,3575869786,0
1,824,15638,3575869786,3575869786,0
1,824,15639,3575869786,3575869786,0
1,824,15640,3575869786,3575869786,0
1,824,15641,3575869786,3575869786,0
1,824,15642,3575869786,3575869786,0
1,824,15643,3575869786,3575869786,0
1,824,15644,3575869786,3575869786,0
1,824,15645,3575869786,3575869786,0
1,824,15646,3575869786,3575869786,0
1,824,15647,3575869786,3575869786,0
1,824,15648,3575869786,3575869786,0
1,824,15649,3575869786,3575869786,0
1,824,15650,3575869786,3575869786,0
1,824,15651,3575869786,3575869786,0
1,824,15652,3575869786,3575869786,0
1,824,15653,3575869786,3575869787,1
1,824,15654,3575869786,3575869790,4
1,824,15655,3575869786,3575869791,5
1,824,15656,3575869786,3575869798,12
1,824,15657,3575869786,3575869799,13
1,824,15658,3575869786,3575869799,13
1,824,15659,3575869786,3575869800,14
1,824,15660,3575869786,3575869800,14
1,824,15661,3575869786,3575869800,14
1,824,15662,3575869786,3575869802,16
1,824,15663,3575869786,3575869803,17
1,824,15664,3575869786,3575869804,18
1,824,15665,3575869786,3575869807,21
1,824,15666,3575869786,3575869810,24
1,824,15667,3575869786,3575869811,25
1,824,15668,3575869786,3575869813,27
1,824,15669,3575869786,3575869813,27
1,824,15670,3575869786,3575869814,28
1,824,15671,3575869786,3575869815,29
1,824,15672,3575869786,3575869815,29
1,824,15673,3575869786,3575869815,29
1,824,15674,3575869786,3575869816,30
1,824,15675,3575869786,3575869816,30
1,824,15676,3575869786,3575869817,31
1,824,15677,3575869786,3575869817,31
1,824,15678,3575869786,3575869817,31
1,824,15679,3575869786,3575869818,32
1,824,15680,3575869786,3575869818,32
1,824,15681,3575869786,3575869819,33
1,824,15682,3575869786,3575869819,33
1,824,15683,3575869786,3575869820,34
1,824,15684,3575869786,3575869820,34
1,824,15685,3575869786,3575869822,36
1,824,15686,3575869786,3575869822,36
1,824,15687,3575869786,3575869823,37
1,824,15688,3575869786,3575869824,38
1,824,15689,3575869786,3575869825,39
1,824,15690,3575869786,3575869825,39
1,824,15691,3575869786,3575869827,41
1,824,15692,3575869786,3575869827,41
1,824,15693,3575869786,3575869830,44
1,824,15694,3575869786,3575869830,44
1,824,15695,3575869786,3575869830,44
1,824,15696,3575869786,3575869831,45
1,824,15697,3575869786,3575869832,46
1,824,15698,3575869786,3575869832,46
1,824,15699,3575869786,3575869833,47
1,824,15700,3575869786,3575869833,47
1,824,15701,3575869786,3575869834,48
1,824,15702,3575869786,3575869834,48
1,825,15703,3575869844,3575869844,0
1,825,15704,3575869844,3575869844,0
1,825,15705,3575869844,3575869844,0
1,825,15706,3575869844,3575869844,0
1,825,15707,3575869844,3575869844,0
1,825,15708,3575869844,3575869844,0
1,825,15709,3575869844,3575869844,0
1,825,15710,3575869844,3575869844,0
1,825,15711,3575869844,3575869849,5
1,825,15712,3575869844,3575869849,5
1,825,15713,3575869844,3575869850,6
1,825,15714,3575869844,3575869851,7
1,825,15715,3575869844,3575869852,8
1,825,15716,3575869844,3575869854,10
1,825,15717,3575869844,3575869854,10
1,825,15718,3575869844,3575869856,12
1,825,15719,3575869844,3575869857,13
1,825,15720,3575869844,3575869862,18
1,825,15721,3575869844,3575869862,18
1,825,15722,3575869844,3575869862,18
1,825,15723,3575869844,3575869864,20
1,825,15724,3575869844,3575869865,21
1,825,15725,3575869844,3575869865,21
1,825,15726,3575869844,3575869867,23
1,825,15727,3575869844,3575869869,25
1,825,15728,3575869844,3575869871,27
1,825,15729,3575869844,3575869872,28
1,825,15730,3575869844,3575869880,36
1,825,15731,3575869844,3575869884,40
1,825,15732,3575869844,3575869885,41
1,825,15733,3575869844,3575869887,43
1,826,15734,3575869904,3575869904,0
1,826,15735,3575869904,3575869904,0
1,826,15736,3575869904,3575869904,0
1,826,15737,3575869904,3575869904,0
1,826,15738,3575869904,3575869904,0
1,826,15739,3575869904,3575869904,0
1,826,15740,3575869904,3575869904,0
1,826,15741,3575869904,3575869904,0
1,826,15742,3575869904,3575869904,0
1,826,15743,3575869904,3575869905,1
1,826,15744,3575869904,3575869906,2
1,826,15745,3575869904,3575869909,5
1,826,15746,3575869904,3575869913,9
1,826,15747,3575869904,3575869914,10
1,826,15748,3575869904,3575869914,10
1,826,15749,3575869904,3575869914,10
1,826,15750,3575869904,3575869914,10
1,826,15751,3575869904,3575869920,16
1,826,15752,3575869904,3575869921,17
1,826,15753,3575869904,3575869924,20
1,826,15754,3575869904,3575869925,21
1,826,15755,3575869904,3575869927,23
1,826,15756,3575869904,3575869930,26
1,826,15757,3575869904,3575869931,27
1,826,15758,3575869904,3575869931,27
1,826,15759,3575869904,3575869932,28
1,826,15760,3575869904,3575869932,28
1,826,15761,3575869904,3575869934,30
1,826,15762,3575869904,3575869936,32
1,826,15763,3575869904,3575869936,32
1,826,15764,3575869904,3575869937,33
1,826,15765,3575869904,3575869937,33
1,826,15766,3575869904,3575869940,36
1,826,15767,3575869904,3575869942,38
1,826,15768,3575869904,3575869943,39
1,826,15769,3575869904,3575869943,39
1,826,15770,3575869904,3575869946,42
1,826,15771,3575869904,3575869947,43
1,826,15772,3575869904,3575869952,48
1,826,15773,3575869904,3575869953,49
1,826,15774,3575869904,3575869953,49
1,826,15775,3575869904,3575869954,50
1,827,15776,3575869962,3575869962,0
1,827,15777,3575869962,3575869962,0
1,827,15778,3575869962,3575869962,0
1,827,15779,3575869962,3575869962,0
1,827,15780,3575869962,3575869962,0
1,827,15781,3575869962,3575869962,0
1,827,15782,3575869962,3575869962,0
1,827,15783,3575869962,3575869963,1
1,827,15784,3575869962,3575869963,1
1,827,15785,3575869962,3575869965,3
1,827,15786,3575869962,3575869966,4
1,827,15787,3575869962,3575869970,8
1,827,15788,3575869962,3575869972,10
1,827,15789,3575869962,3575869973,11
1,827,15790,3575869962,3575869975,13
1,827,15791,3575869962,3575869975,13
1,827,15792,3575869962,3575869976,14
1,827,15793,3575869962,3575869976,14
1,827,15794,3575869962,3575869977,15
1,827,15795,3575869962,3575869977,15
1,827,15796,3575869962,3575869979,17
1,827,15797,3575869962,3575869981,19
1,827,15798,3575869962,3575869981,19
1,827,15799,3575869962,3575869982,20
1,827,15800,3575869962,3575869984,22
1,827,15801,3575869962,3575869984,22
1,827,15802,3575869962,3575869985,23
1,827,15803,3575869962,3575869985,23
1,827,15804,3575869962,3575869985,23
1,827,15805,3575869962,3575869986,24
1,827,15806,3575869962,3575869986,24
1,827,15807,3575869962,3575869988,26
1,827,15808,3575869962,3575869990,28
1,827,15809,3575869962,3575869991,29
1,827,15810,3575869962,3575869993,31
1,827,15811,3575869962,3575869998,36
1,827,15812,3575869962,3575870000,38
1,827,15813,3575869962,3575870000,38
1,827,15814,3575869962,3575870000,38
1,827,15815,3575869962,3575870000,38
1,827,15816,3575869962,3575870001,39
1,827,15817,3575869962,3575870002,40
1,827,15818,3575869962,3575870004,42
1,827,15819,3575869962,3575870004,42
1,827,15820,3575869962,3575870007,45
1,827,15821,3575869962,3575870008,46
1,827,15822,3575869962,3575870010,48
1,827,15823,3575869962,3575870011,49
1,827,15824,3575869962,3575870012,50
1,828,15825,3575870020,3575870020,0
1,828,15826,3575870020,3575870020,0
1,828,15827,3575870020,3575870020,0
1,828,15828,3575870020,3575870020,0
1,828,15829,3575870020,3575870020,0
1,828,15830,3575870020,3575870020,0
1,828,15831,3575870020,3575870020,0
1,828,15832,3575870020,3575870020,0
1,828,15833,3575870020,3575870020,0
1,828,15834,3575870020,3575870020,0
1,828,15835,3575870020,3575870020,0
1,828,15836,3575870020,3575870020,0
1,828,15837,3575870020,3575870020,0
1,828,15838,3575870020,3575870021,1
1,828,15839,3575870020,3575870021,1
1,828,15840,3575870020,3575870022,2
1,828,15841,3575870020,3575870025,5
1,828,15842,3575870020,3575870025,5
1,828,15843,3575870020,3575870027,7
1,828,15844,3575870020,3575870028,8
1,828,15845,3575870020,3575870030,10
1,828,15846,3575870020,3575870031,11
1,828,15847,3575870020,3575870031,11
1,828,15848,3575870020,3575870032,12
1,828,15849,3575870020,3575870033,13
1,828,15850,3575870020,3575870034,14
1,828,15851,3575870020,3575870034,14
1,828,15852,3575870020,3575870034,14
1,828,15853,3575870020,3575870035,15
1,828,15854,3575870020,3575870040,20
1,828,15855,3575870020,3575870041,21
1,828,15856,3575870020,3575870042,22
1,828,15857,3575870020,3575870042,22
1,828,15858,3575870020,3575870043,23
1,828,15859,3575870020,3575870044,24
1,828,15860,3575870020,3575870044,24
1,828,15861,3575870020,3575870044,24
1,828,15862,3575870020,3575870045,25
1,828,15863,3575870020,3575870047,27
1,828,15864,3575870020,3575870048,28
1,828,15865,3575870020,3575870049,29
1,828,15866,3575870020,3575870051,31
1,828,15867,3575870020,3575870051,31
1,828,15868,3575870020,3575870052,32
1,828,15869,3575870020,3575870054,34
1,828,15870,3575870020,3575870056,36
1,828,15871,3575870020,3575870058,38
1,828,15872,3575870020,3575870058,38
1,828,15873,3575870020,3575870062,42
1,828,15874,3575870020,3575870062,42
1,828,15875,3575870020,3575870063,43
1,828,15876,3575870020,3575870064,44
1,828,15877,3575870020,3575870066,46
1,828,15878,3575870020,3575870066,46
1,828,15879,3575870020,3575870067,47
1,828,15880,3575870020,3575870070,50
1,829,15881,3575870078,3575870078,0
1,829,15882,3575870078,3575870078,0
1,829,15883,3575870078,3575870078,0
1,829,15884,3575870078,3575870080,2
1,829,15885,3575870078,3575870083,5
1,829,15886,3575870078,3575870083,5
1,829,15887,3575870078,3575870086,8
1,829,15888,3575870078,3575870087,9
1,829,15889,3575870078,3575870095,17
1,829,15890,3575870078,3575870095,17
1,829,15891,3575870078,3575870096,18
1,829,15892,3575870078,3575870096,18
1,829,15893,3575870078,3575870097,19
1,829,15894,3575870078,3575870097,19
1,829,15895,3575870078,3575870098,20
1,829,15896,3575870078,3575870102,24
1,829,15897,3575870078,3575870103,25
1,829,15898,3575870078,3575870104,26
1,829,15899,3575870078,3575870105,27
1,829,15900,3575870078,3575870107,29
1,829,15901,3575870078,3575870108,30
1,829,15902,3575870078,3575870109,31
1,829,15903,3575870078,3575870112,34
1,829,15904,3575870078,3575870113,35
1,829,15905,3575870078,3575870114,36
1,829,15906,3575870078,3575870114,36
1,829,15907,3575870078,3575870120,42
1,829,15908,3575870078,3575870121,43
1,829,15909,3575870078,3575870125,47
1,829,15910,3575870078,3575870127,49
1,830,15911,3575870136,3575870136,0
1,830,15912,3575870136,3575870136,0
1,830,15913,3575870136,3575870136,0
1,830,15914,3575870136,3575870136,0
1,830,15915,3575870136,3575870136,0
1,830,15916,3575870136,3575870136,0
1,830,15917,3575870136,3575870136,0
1,830,15918,3575870136,3575870136,0
1,830,15919,3575870136,3575870136,0
1,830,15920,3575870136,3575870136,0
1,830,15921,3575870136,3575870136,0
1,830,15922,3575870136,3575870136,0
1,830,15923,3575870136,3575870138,2
1,830,15924,3575870136,3575870140,4
1,830,15925,3575870136,3575870142,6
1,830,15926,3575870136,3575870143,7
1,830,15927,3575870136,3575870144,8
1,830,15928,3575870136,3575870146,10
1,830,15929,3575870136,3575870148,12
1,830,15930,3575870136,3575870152,16
1,830,15931,3575870136,3575870152,16
1,830,15932,3575870136,3575870153,17
1,830,15933,3575870136,3575870154,18
1,830,15934,3575870136,3575870154,18
1,830,15935,3575870136,3575870156,20
1,830,15936,3575870136,3575870157,21
1,830,15937,3575870136,3575870157,21
1,830,15938,3575870136,3575870158,22
1,830,15939,3575870136,3575870162,26
1,830,15940,3575870136,3575870163,27
1,830,15941,3575870136,3575870163,27
1,830,15942,3575870136,3575870164,28
1,830,15943,3575870136,3575870164,28
1,830,15944,3575870136,3575870165,29
1,830,15945,3575870136,3575870167,31
1,830,15946,3575870136,3575870171,35
1,830,15947,3575870136,3575870175,39
1,830,15948,3575870136,3575870176,40
1,830,15949,3575870136,3575870176,40
1,830,15950,3575870136,3575870177,41
1,830,15951,3575870136,3575870178,42
1,830,15952,3575870136,3575870178,42
1,830,15953,3575870136,3575870179,43
1,830,15954,3575870136,3575870182,46
1,830,15955,3575870136,3575870182,46
1,830,15956,3575870136,3575870184,48
1,830,15957,3575870136,3575870185,49
1,830,15958,3575870136,3575870185,49
1,830,15959,3575870136,3575870186,50
1,831,15960,3575870198,3575870198,0
1,831,15961,3575870198,3575870198,0
1,831,15962,3575870198,3575870198,0
1,831,15963,3575870198,3575870198,0
1,831,15964,3575870198,3575870198,0
1,831,15965,3575870198,3575870198,0
1,831,15966,3575870198,3575870198,0
1,831,15967,3575870198,3575870199,1
1,831,15968,3575870198,3575870200,2
1,831,15969,3575870198,3575870200,2
1,831,15970,3575870198,3575870200,2
1,831,15971,3575870198,3575870201,3
1,831,15972,3575870198,3575870202,4
1,831,15973,3575870198,3575870202,4
1,831,15974,3575870198,3575870204,6
1,831,15975,3575870198,3575870205,7
1,831,15976,3575870198,3575870207,9
1,831,15977,3575870198,3575870209,11
1,831,15978,3575870198,3575870210,12
1,831,15979,3575870198,3575870213,15
1,831,15980,3575870198,3575870214,16
1,831,15981,3575870198,3575870214,16
1,831,15982,3575870198,3575870214,16
1,831,15983,3575870198,3575870214,16
1,831,15984,3575870198,3575870215,17
1,831,15985,3575870198,3575870216,18
1,831,15986,3575870198,3575870216,18
1,831,15987,3575870198,3575870216,18
1,831,15988,3575870198,3575870217,19
1,831,15989,3575870198,3575870217,19
1,831,15990,3575870198,3575870218,20
1,831,15991,3575870198,3575870218,20
1,831,15992,3575870198,3575870219,21
1,831,15993,3575870198,3575870219,21
1,831,15994,3575870198,3575870220,22
1,831,15995,3575870198,3575870220,22
1,831,15996,3575870198,3575870221,23
1,831,15997,3575870198,3575870223,25
1,831,15998,3575870198,3575870224,26
1,831,15999,3575870198,3575870224,26
1,831,16000,3575870198,3575870224,26
1,831,16001,3575870198,3575870226,28
1,831,16002,3575870198,3575870227,29
1,831,16003,3575870198,3575870229,31
1,831,16004,3575870198,3575870229,31
1,831,16005,3575870198,3575870230,32
1,831,16006,3575870198,3575870231,33
1,831,16007,3575870198,3575870231,33
1,831,16008,3575870198,3575870232,34
1,831,16009,3575870198,3575870232,34
1,831,16010,3575870198,3575870233,35
1,831,16011,3575870198,3575870234,36
1,831,16012,3575870198,3575870234,36
1,831,16013,3575870198,3575870235,37
1,831,16014,3575870198,3575870235,37
1,831,16015,3575870198,3575870239,41
1,831,16016,3575870198,3575870241,43
1,831,16017,3575870198,3575870242,44
1,831,16018,3575870198,3575870243,45
1,831,16019,3575870198,3575870244,46
1,831,16020,3575870198,3575870244,46
1,831,16021,3575870198,3575870244,46
1,831,16022,3575870198,3575870245,47
1,831,16023,3575870198,3575870246,48
1,831,16024,3575870198,3575870246,48
1,831,16025,3575870198,3575870247,49
1,832,16026,3575870255,3575870255,0
1,832,16027,3575870255,3575870255,0
1,832,16028,3575870255,3575870255,0
1,832,16029,3575870255,3575870255,0
1,832,16030,3575870255,3575870255,0
1,832,16031,3575870255,3575870255,0
1,832,16032,3575870255,3575870256,1
1,832,16033,3575870255,3575870257,2
1,832,16034,3575870255,3575870258,3
1,832,16035,3575870255,3575870262,7
1,832,16036,3575870255,3575870262,7
1,832,16037,3575870255,3575870262,7
1,832,16038,3575870255,3575870263,8
1,832,16039,3575870255,3575870265,10
1,832,16040,3575870255,3575870266,11
1,832,16041,3575870255,3575870266,11
1,832,16042,3575870255,3575870268,13
1,832,16043,3575870255,3575870270,15
1,832,16044,3575870255,3575870270,15
1,832,16045,3575870255,3575870272,17
1,832,16046,3575870255,3575870274,19
1,832,16047,3575870255,3575870275,20
1,832,16048,3575870255,3575870280,25
1,832,16049,3575870255,3575870284,29
1,832,16050,3575870255,3575870286,31
1,832,16051,3575870255,3575870287,32
1,832,16052,3575870255,3575870295,40
1,832,16053,3575870255,3575870296,41
1,832,16054,3575870255,3575870296,41
1,832,16055,3575870255,3575870296,41
1,832,16056,3575870255,3575870297,42
1,832,16057,3575870255,3575870297,42
1,832,16058,3575870255,3575870298,43
1,832,16059,3575870255,3575870298,43
1,832,16060,3575870255,3575870300,45
1,832,16061,3575870255,3575870302,47
1,832,16062,3575870255,3575870303,48
1,832,16063,3575870255,3575870303,48
1,833,16064,3575870317,3575870317,0
1,833,16065,3575870317,3575870317,0
1,833,16066,3575870317,3575870317,0
1,833,16067,3575870317,3575870317,0
1,833,16068,3575870317,3575870317,0
1,833,16069,3575870317,3575870317,0
1,833,16070,3575870317,3575870317,0
1,833,16071,3575870317,3575870317,0
1,833,16072,3575870317,3575870320,3
1,833,16073,3575870317,3575870323,6
1,833,16074,3575870317,3575870325,8
1,833,16075,3575870317,3575870326,9
1,833,16076,3575870317,3575870327,10
1,833,16077,3575870317,3575870330,13
1,833,16078,3575870317,3575870330,13
1,833,16079,3575870317,3575870331,14
1,833,16080,3575870317,3575870332,15
1,833,16081,3575870317,3575870332,15
1,833,16082,3575870317,3575870333,16
1,833,16083,3575870317,3575870333,16
1,833,16084,3575870317,3575870334,17
1,833,16085,3575870317,3575870335,18
1,833,16086,3575870317,3575870336,19
1,833,16087,3575870317,3575870336,19
1,833,16088,3575870317,3575870337,20
1,833,16089,3575870317,3575870337,20
1,833,16090,3575870317,3575870338,21
1,833,16091,3575870317,3575870341,24
1,833,16092,3575870317,3575870342,25
1,833,16093,3575870317,3575870344,27
1,833,16094,3575870317,3575870344,27
1,833,16095,3575870317,3575870346,29
1,833,16096,3575870317,3575870347,30
1,833,16097,3575870317,3575870347,30
1,833,16098,3575870317,3575870352,35
1,833,16099,3575870317,3575870352,35
1,833,16100,3575870317,3575870353,36
1,833,16101,3575870317,3575870353,36
1,833,16102,3575870317,3575870357,40
1,833,16103,3575870317,3575870357,40
1,833,16104,3575870317,3575870358,41
1,833,16105,3575870317,3575870359,42
1,833,16106,3575870317,3575870359,42
1,833,16107,3575870317,3575870362,45
1,833,16108,3575870317,3575870362,45
1,833,16109,3575870317,3575870363,46
1,833,16110,3575870317,3575870364,47
1,833,16111,3575870317,3575870364,47
1,833,16112,3575870317,3575870365,48
1,833,16113,3575870317,3575870367,50
1,834,16114,3575870374,3575870374,0
1,834,16115,3575870374,3575870375,1
1,834,16116,3575870374,3575870376,2
1,834,16117,3575870374,3575870376,2
1,834,16118,3575870374,3575870377,3
1,834,16119,3575870374,3575870377,3
1,834,16120,3575870374,3575870378,4
1,834,16121,3575870374,3575870378,4
1,834,16122,3575870374,3575870379,5
1,834,16123,3575870374,3575870381,7
1,834,16124,3575870374,3575870382,8
1,834,16125,3575870374,3575870384,10
1,834,16126,3575870374,3575870385,11
1,834,16127,3575870374,3575870386,12
1,834,16128,3575870374,3575870386,12
1,834,16129,3575870374,3575870386,12
1,834,16130,3575870374,3575870387,13
1,834,16131,3575870374,3575870388,14
1,834,16132,3575870374,3575870390,16
1,834,16133,3575870374,3575870391,17
1,834,16134,3575870374,3575870391,17
1,834,16135,3575870374,3575870392,18
1,834,16136,3575870374,3575870393,19
1,834,16137,3575870374,3575870395,21
1,834,16138,3575870374,3575870398,24
1,834,16139,3575870374,3575870400,26
1,834,16140,3575870374,3575870400,26
1,834,16141,3575870374,3575870401,27
1,834,16142,3575870374,3575870402,28
1,834,16143,3575870374,3575870402,28
1,834,16144,3575870374,3575870403,29
1,834,16145,3575870374,3575870405,31
1,834,16146,3575870374,3575870406,32
1,834,16147,3575870374,3575870408,34
1,834,16148,3575870374,3575870409,35
1,834,16149,3575870374,3575870410,36
1,834,16150,3575870374,3575870412,38
1,834,16151,3575870374,3575870412,38
1,834,16152,3575870374,3575870414,40
1,834,16153,3575870374,3575870414,40
1,834,16154,3575870374,3575870414,40
1,834,16155,3575870374,3575870415,41
1,834,16156,3575870374,3575870416,42
1,834,16157,3575870374,3575870416,42
1,834,16158,3575870374,3575870417,43
1,834,16159,3575870374,3575870417,43
1,834,16160,3575870374,3575870418,44
1,834,16161,3575870374,3575870418,44
1,834,16162,3575870374,3575870419,45
1,834,16163,3575870374,3575870419,45
1,834,16164,3575870374,3575870420,46
1,834,16165,3575870374,3575870421,47
1,834,16166,3575870374,3575870421,47
1,834,16167,3575870374,3575870422,48
1,834,16168,3575870374,3575870423,49
1,834,16169,3575870374,3575870423,49
1,834,16170,3575870374,3575870423,49
1,834,16171,3575870374,3575870423,49
1,834,16172,3575870374,3575870424,50
1,835,16173,3575870434,3575870434,0
1,835,16174,3575870434,3575870434,0
1,835,16175,3575870434,3575870434,0
1,835,16176,3575870434,3575870434,0
1,835,16177,3575870434,3575870434,0
1,835,16178,3575870434,3575870434,0
1,835,16179,3575870434,3575870434,0
1,835,16180,3575870434,3575870434,0
1,835,16181,3575870434,3575870434,0
1,835,16182,3575870434,3575870434,0
1,835,16183,3575870434,3575870434,0
1,835,16184,3575870434,3575870435,1
1,835,16185,3575870434,3575870435,1
1,835,16186,3575870434,3575870435,1
1,835,16187,3575870434,3575870435,1
1,835,16188,3575870434,3575870439,5
1,835,16189,3575870434,3575870441,7
1,835,16190,3575870434,3575870443,9
1,835,16191,3575870434,3575870444,10
1,835,16192,3575870434,3575870444,10
1,835,16193,3575870434,3575870444,10
1,835,16194,3575870434,3575870445,11
1,835,16195,3575870434,3575870445,11
1,835,16196,3575870434,3575870446,12
1,835,16197,3575870434,3575870447,13
1,835,16198,3575870434,3575870447,13
1,835,16199,3575870434,3575870449,15
1,835,16200,3575870434,3575870450,16
1,835,16201,3575870434,3575870451,17
1,835,16202,3575870434,3575870453,19
1,835,16203,3575870434,3575870454,20
1,835,16204,3575870434,3575870454,20
1,835,16205,3575870434,3575870454,20
1,835,16206,3575870434,3575870457,23
1,835,16207,3575870434,3575870459,25
1,835,16208,3575870434,3575870459,25
1,835,16209,3575870434,3575870462,28
1,835,16210,3575870434,3575870462,28
1,835,16211,3575870434,3575870462,28
1,835,16212,3575870434,3575870463,29
1,835,16213,3575870434,3575870466,32
1,835,16214,3575870434,3575870466,32
1,835,16215,3575870434,3575870467,33
1,835,16216,3575870434,3575870469,35
1,835,16217,3575870434,3575870470,36
1,835,16218,3575870434,3575870470,36
1,835,16219,3575870434,3575870470,36
1,835,16220,3575870434,3575870473,39
1,835,16221,3575870434,3575870474,40
1,835,16222,3575870434,3575870475,41
1,835,16223,3575870434,3575870481,47
1,835,16224,3575870434,3575870482,48
1,835,16225,3575870434,3575870484,50
1,836,16226,3575870494,3575870494,0
1,836,16227,3575870494,3575870494,0
1,836,16228,3575870494,3575870494,0
1,836,16229,3575870494,3575870495,1
1,836,16230,3575870494,3575870495,1
1,836,16231,3575870494,3575870495,1
1,836,16232,3575870494,3575870496,2
1,836,16233,3575870494,3575870497,3
1,836,16234,3575870494,3575870501,7
1,836,16235,3575870494,3575870503,9
1,836,16236,3575870494,3575870504,10
1,836,16237,3575870494,3575870504,10
1,836,16238,3575870494,3575870506,12
1,836,16239,3575870494,3575870508,14
1,836,16240,3575870494,3575870512,18
1,836,16241,3575870494,3575870512,18
1,836,16242,3575870494,3575870513,19
1,836,16243,3575870494,3575870513,19
1,836,16244,3575870494,3575870515,21
1,836,16245,3575870494,3575870519,25
1,836,16246,3575870494,3575870522,28
1,836,16247,3575870494,3575870524,30
1,836,16248,3575870494,3575870525,31
1,836,16249,3575870494,3575870526,32
1,836,16250,3575870494,3575870529,35
1,836,16251,3575870494,3575870529,35
1,836,16252,3575870494,3575870530,36
1,836,16253,3575870494,3575870531,37
1,836,16254,3575870494,3575870531,37
1,836,16255,3575870494,3575870532,38
1,836,16256,3575870494,3575870534,40
1,836,16257,3575870494,3575870535,41
1,836,16258,3575870494,3575870535,41
1,836,16259,3575870494,3575870536,42
1,836,16260,3575870494,3575870538,44
1,836,16261,3575870494,3575870540,46
1,836,16262,3575870494,3575870541,47
1,836,16263,3575870494,3575870543,49
1,836,16264,3575870494,3575870543,49
1,837,16265,3575870553,3575870553,0
1,837,16266,3575870553,3575870553,0
1,837,16267,3575870553,3575870553,0
1,837,16268,3575870553,3575870553,0
1,837,16269,3575870553,3575870553,0
1,837,16270,3575870553,3575870553,0
1,837,16271,3575870553,3575870553,0
1,837,16272,3575870553,3575870554,1
1,837,16273,3575870553,3575870554,1
1,837,16274,3575870553,3575870556,3
1,837,16275,3575870553,3575870557,4
1,837,16276,3575870553,3575870558,5
1,837,16277,3575870553,3575870559,6
1,837,16278,3575870553,3575870559,6
1,837,16279,3575870553,3575870560,7
1,837,16280,3575870553,3575870562,9
1,837,16281,3575870553,3575870562,9
1,837,16282,3575870553,3575870562,9
1,837,16283,3575870553,3575870563,10
1,837,16284,3575870553,3575870563,10
1,837,16285,3575870553,3575870564,11
1,837,16286,3575870553,3575870566,13
1,837,16287,3575870553,3575870570,17
1,837,16288,3575870553,3575870570,17
1,837,16289,3575870553,3575870574,21
1,837,16290,3575870553,3575870574,21
1,837,16291,3575870553,3575870576,23
1,837,16292,3575870553,3575870576,23
1,837,16293,3575870553,3575870576,23
1,837,16294,3575870553,3575870577,24
1,837,16295,3575870553,3575870577,24
1,837,16296,3575870553,3575870578,25
1,837,16297,3575870553,3575870578,25
1,837,16298,3575870553,3575870578,25
1,837,16299,3575870553,3575870580,27
1,837,16300,3575870553,3575870581,28
1,837,16301,3575870553,3575870584,31
1,837,16302,3575870553,3575870585,32
1,837,16303,3575870553,3575870585,32
1,837,16304,3575870553,3575870585,32
1,837,16305,3575870553,3575870586,33
1,837,16306,3575870553,3575870586,33
1,837,16307,3575870553,3575870587,34
1,837,16308,3575870553,3575870589,36
1,837,16309,3575870553,3575870590,37
1,837,16310,3575870553,3575870592,39
1,837,16311,3575870553,3575870594,41
1,837,16312,3575870553,3575870597,44
1,837,16313,3575870553,3575870599,46
1,837,16314,3575870553,3575870600,47
1,837,16315,3575870553,3575870600,47
1,837,16316,3575870553,3575870600,47
1,837,16317,3575870553,3575870601,48
1,837,16318,3575870553,3575870602,49
1,838,16319,3575870610,3575870610,0
1,838,16320,3575870610,3575870610,0
1,838,16321,3575870610,3575870610,0
1,838,16322,3575870610,3575870611,1
1,838,16323,3575870610,3575870612,2
1,838,16324,3575870610,3575870612,2
1,838,16325,3575870610,3575870613,3
1,838,16326,3575870610,3575870613,3
1,838,16327,3575870610,3575870614,4
1,838,16328,3575870610,3575870615,5
1,838,16329,3575870610,3575870615,5
1,838,16330,3575870610,3575870615,5
1,838,16331,3575870610,3575870615,5
1,838,16332,3575870610,3575870615,5
1,838,16333,3575870610,3575870617,7
1,838,16334,3575870610,3575870617,7
1,838,16335,3575870610,3575870617,7
1,838,16336,3575870610,3575870618,8
1,838,16337,3575870610,3575870618,8
1,838,16338,3575870610,3575870618,8
1,838,16339,3575870610,3575870619,9
1,838,16340,3575870610,3575870620,10
1,838,16341,3575870610,3575870620,10
1,838,16342,3575870610,3575870620,10
1,838,16343,3575870610,3575870622,12
1,838,16344,3575870610,3575870622,12
1,838,16345,3575870610,3575870622,12
1,838,16346,3575870610,3575870623,13
1,838,16347,3575870610,3575870623,13
1,838,16348,3575870610,3575870626,16
1,838,16349,3575870610,3575870627,17
1,838,16350,3575870610,3575870627,17
1,838,16351,3575870610,3575870627,17
1,838,16352,3575870610,3575870629,19
1,838,16353,3575870610,3575870629,19
1,838,16354,3575870610,3575870630,20
1,838,16355,3575870610,3575870631,21
1,838,16356,3575870610,3575870631,21
1,838,16357,3575870610,3575870632,22
1,838,16358,3575870610,3575870633,23
1,838,16359,3575870610,3575870633,23
1,838,16360,3575870610,3575870634,24
1,838,16361,3575870610,3575870634,24
1,838,16362,3575870610,3575870634,24
1,838,16363,3575870610,3575870638,28
1,838,16364,3575870610,3575870640,30
1,838,16365,3575870610,3575870643,33
1,838,16366,3575870610,3575870643,33
1,838,16367,3575870610,3575870643,33
1,838,16368,3575870610,3575870644,34
1,838,16369,3575870610,3575870645,35
1,838,16370,3575870610,3575870645,35
1,838,16371,3575870610,3575870645,35
1,838,16372,3575870610,3575870646,36
1,838,16373,3575870610,3575870647,37
1,838,16374,3575870610,3575870649,39
1,838,16375,3575870610,3575870651,41
1,838,16376,3575870610,3575870653,43
1,838,16377,3575870610,3575870653,43
1,838,16378,3575870610,3575870653,43
1,838,16379,3575870610,3575870655,45
1,838,16380,3575870610,3575870657,47
1,838,16381,3575870610,3575870659,49
1,839,16382,3575870668,3575870668,0
1,839,16383,3575870668,3575870668,0
1,839,16384,3575870668,3575870668,0
1,839,16385,3575870668,3575870668,0
1,839,16386,3575870668,3575870668,0
1,839,16387,3575870668,3575870668,0
1,839,16388,3575870668,3575870668,0
1,839,16389,3575870668,3575870668,0
1,839,16390,3575870668,3575870669,1
1,839,16391,3575870668,3575870669,1
1,839,16392,3575870668,3575870670,2
1,839,16393,3575870668,3575870673,5
1,839,16394,3575870668,3575870674,6
1,839,16395,3575870668,3575870675,7
1,839,16396,3575870668,3575870680,12
1,839,16397,3575870668,3575870681,13
1,839,16398,3575870668,3575870682,14
1,839,16399,3575870668,3575870683,15
1,839,16400,3575870668,3575870684,16
1,839,16401,3575870668,3575870685,17
1,839,16402,3575870668,3575870694,26
1,839,16403,3575870668,3575870694,26
1,839,16404,3575870668,3575870694,26
1,839,16405,3575870668,3575870695,27
1,839,16406,3575870668,3575870696,28
1,839,16407,3575870668,3575870696,28
1,839,16408,3575870668,3575870696,28
1,839,16409,3575870668,3575870700,32
1,839,16410,3575870668,3575870701,33
1,839,16411,3575870668,3575870703,35
1,839,16412,3575870668,3575870704,36
1,839,16413,3575870668,3575870704,36
1,839,16414,3575870668,3575870707,39
1,839,16415,3575870668,3575870707,39
1,839,16416,3575870668,3575870712,44
1,839,16417,3575870668,3575870713,45
1,839,16418,3575870668,3575870713,45
1,839,16419,3575870668,3575870713,45
1,840,16420,3575870725,3575870725,0
1,840,16421,3575870725,3575870725,0
1,840,16422,3575870725,3575870725,0
1,840,16423,3575870725,3575870725,0
1,840,16424,3575870725,3575870727,2
1,840,16425,3575870725,3575870730,5
1,840,16426,3575870725,3575870730,5
1,840,16427,3575870725,3575870730,5
1,840,16428,3575870725,3575870732,7
1,840,16429,3575870725,3575870732,7
1,840,16430,3575870725,3575870732,7
1,840,16431,3575870725,3575870733,8
1,840,16432,3575870725,3575870734,9
1,840,16433,3575870725,3575870735,10
1,840,16434,3575870725,3575870735,10
1,840,16435,3575870725,3575870735,10
1,840,16436,3575870725,3575870736,11
1,840,16437,3575870725,3575870736,11
1,840,16438,3575870725,3575870737,12
1,840,16439,3575870725,3575870741,16
1,840,16440,3575870725,3575870741,16
1,840,16441,3575870725,3575870743,18
1,840,16442,3575870725,3575870744,19
1,840,16443,3575870725,3575870746,21
1,840,16444,3575870725,3575870746,21
1,840,16445,3575870725,3575870746,21
1,840,16446,3575870725,3575870751,26
1,840,16447,3575870725,3575870752,27
1,840,16448,3575870725,3575870752,27
1,840,16449,3575870725,3575870753,28
1,840,16450,3575870725,3575870754,29
1,840,16451,3575870725,3575870756,31
1,840,16452,3575870725,3575870756,31
1,840,16453,3575870725,3575870758,33
1,840,16454,3575870725,3575870759,34
1,840,16455,3575870725,3575870760,35
1,840,16456,3575870725,3575870761,36
1,840,16457,3575870725,3575870762,37
1,840,16458,3575870725,3575870762,37
1,840,16459,3575870725,3575870763,38
1,840,16460,3575870725,3575870763,38
1,840,16461,3575870725,3575870763,38
1,840,16462,3575870725,3575870764,39
1,840,16463,3575870725,3575870766,41
1,840,16464,3575870725,3575870770,45
1,840,16465,3575870725,3575870770,45
1,840,16466,3575870725,3575870774,49
1,840,16467,3575870725,3575870774,49
1,841,16468,3575870783,3575870783,0
1,841,16469,3575870783,3575870783,0
1,841,16470,3575870783,3575870783,0
1,841,16471,3575870783,3575870783,0
1,841,16472,3575870783,3575870783,0
1,841,16473,3575870783,3575870783,0
1,841,16474,3575870783,3575870783,0
1,841,16475,3575870783,3575870783,0
1,841,16476,3575870783,3575870783,0
1,841,16477,3575870783,3575870783,0
1,841,16478,3575870783,3575870784,1
1,841,16479,3575870783,3575870784,1
1,841,16480,3575870783,3575870785,2
1,841,16481,3575870783,3575870785,2
1,841,16482,3575870783,3575870786,3
1,841,16483,3575870783,3575870787,4
1,841,16484,3575870783,3575870787,4
1,841,16485,3575870783,3575870787,4
1,841,16486,3575870783,3575870791,8
1,841,16487,3575870783,3575870791,8
1,841,16488,3575870783,3575870793,10
1,841,16489,3575870783,3575870797,14
1,841,16490,3575870783,3575870798,15
1,841,16491,3575870783,3575870800,17
1,841,16492,3575870783,3575870801,18
1,841,16493,3575870783,3575870801,18
1,841,16494,3575870783,3575870801,18
1,841,16495,3575870783,3575870802,19
1,841,16496,3575870783,3575870805,22
1,841,16497,3575870783,3575870807,24
1,841,16498,3575870783,3575870808,25
1,841,16499,3575870783,3575870809,26
1,841,16500,3575870783,3575870811,28
1,841,16501,3575870783,3575870812,29
1,841,16502,3575870783,3575870813,30
1,841,16503,3575870783,3575870814,31
1,841,16504,3575870783,3575870814,31
1,841,16505,3575870783,3575870815,32
1,841,16506,3575870783,3575870816,33
1,841,16507,3575870783,3575870816,33
1,841,16508,3575870783,3575870816,33
1,841,16509,3575870783,3575870817,34
1,841,16510,3575870783,3575870817,34
1,841,16511,3575870783,3575870817,34
1,841,16512,3575870783,3575870817,34
1,841,16513,3575870783,3575870818,35
1,841,16514,3575870783,3575870818,35
1,841,16515,3575870783,3575870818,35
1,841,16516,3575870783,3575870819,36
1,841,16517,3575870783,3575870820,37
1,841,16518,3575870783,3575870820,37
1,841,16519,3575870783,3575870822,39
1,841,16520,3575870783,3575870822,39
1,841,16521,3575870783,3575870823,40
1,841,16522,3575870783,3575870823,40
1,841,16523,3575870783,3575870824,41
1,841,16524,3575870783,3575870824,41
1,841,16525,3575870783,3575870827,44
1,841,16526,3575870783,3575870828,45
1,841,16527,3575870783,3575870829,46
1,841,16528,3575870783,3575870829,46
1,841,16529,3575870783,3575870830,47
1,841,16530,3575870783,3575870831,48
1,841,16531,3575870783,3575870831,48
1,841,16532,3575870783,3575870832,49
1,841,16533,3575870783,3575870833,50
1,842,16534,3575870842,3575870842,0
1,842,16535,3575870842,3575870842,0
1,842,16536,3575870842,3575870842,0
1,842,16537,3575870842,3575870842,0
1,842,16538,3575870842,3575870842,0
1,842,16539,3575870842,3575870842,0
1,842,16540,3575870842,3575870844,2
1,842,16541,3575870842,3575870844,2
1,842,16542,3575870842,3575870844,2
1,842,16543,3575870842,3575870845,3
1,842,16544,3575870842,3575870845,3
1,842,16545,3575870842,3575870845,3
1,842,16546,3575870842,3575870846,4
1,842,16547,3575870842,3575870846,4
1,842,16548,3575870842,3575870847,5
1,842,16549,3575870842,3575870847,5
1,842,16550,3575870842,3575870851,9
1,842,16551,3575870842,3575870851,9
1,842,16552,3575870842,3575870852,10
1,842,16553,3575870842,3575870853,11
1,842,16554,3575870842,3575870853,11
1,842,16555,3575870842,3575870854,12
1,842,16556,3575870842,3575870855,13
1,842,16557,3575870842,3575870858,16
1,842,16558,3575870842,3575870858,16
1,842,16559,3575870842,3575870861,19
1,842,16560,3575870842,3575870862,20
1,842,16561,3575870842,3575870862,20
1,842,16562,3575870842,3575870865,23
1,842,16563,3575870842,3575870866,24
1,842,16564,3575870842,3575870867,25
1,842,16565,3575870842,3575870867,25
1,842,16566,3575870842,3575870868,26
1,842,16567,3575870842,3575870870,28
1,842,16568,3575870842,3575870870,28
1,842,16569,3575870842,3575870873,31
1,842,16570,3575870842,3575870874,32
1,842,16571,3575870842,3575870874,32
1,842,16572,3575870842,3575870880,38
1,842,16573,3575870842,3575870882,40
1,842,16574,3575870842,3575870882,40
1,842,16575,3575870842,3575870883,41
1,842,16576,3575870842,3575870884,42
1,842,16577,3575870842,3575870885,43
1,842,16578,3575870842,3575870886,44
1,843,16579,3575870902,3575870902,0
1,843,16580,3575870902,3575870902,0
1,843,16581,3575870902,3575870902,0
1,843,16582,3575870902,3575870902,0
1,843,16583,3575870902,3575870902,0
1,843,16584,3575870902,3575870902,0
1,843,16585,3575870902,3575870902,0
1,843,16586,3575870902,3575870902,0
1,843,16587,3575870902,3575870903,1
1,843,16588,3575870902,3575870905,3
1,843,16589,3575870902,3575870905,3
1,843,16590,3575870902,3575870906,4
1,843,16591,3575870902,3575870906,4
1,843,16592,3575870902,3575870908,6
1,843,16593,3575870902,3575870911,9
1,843,16594,3575870902,3575870913,11
1,843,16595,3575870902,3575870913,11
1,843,16596,3575870902,3575870914,12
1,843,16597,3575870902,3575870915,13
1,843,16598,3575870902,3575870922,20
1,843,16599,3575870902,3575870922,20
1,843,16600,3575870902,3575870925,23
1,843,16601,3575870902,3575870926,24
1,843,16602,3575870902,3575870927,25
1,843,16603,3575870902,3575870929,27
1,843,16604,3575870902,3575870930,28
1,843,16605,3575870902,3575870930,28
1,843,16606,3575870902,3575870931,29
1,843,16607,3575870902,3575870932,30
1,843,16608,3575870902,3575870932,30
1,843,16609,3575870902,3575870932,30
1,843,16610,3575870902,3575870932,30
1,843,16611,3575870902,3575870934,32
1,843,16612,3575870902,3575870936,34
1,843,16613,3575870902,3575870936,34
1,843,16614,3575870902,3575870936,34
1,843,16615,3575870902,3575870937,35
1,843,16616,3575870902,3575870940,38
1,843,16617,3575870902,3575870943,41
1,843,16618,3575870902,3575870943,41
1,843,16619,3575870902,3575870946,44
1,843,16620,3575870902,3575870946,44
1,843,16621,3575870902,3575870948,46
1,844,16622,3575870961,3575870961,0
1,844,16623,3575870961,3575870961,0
1,844,16624,3575870961,3575870961,0
1,844,16625,3575870961,3575870961,0
1,844,16626,3575870961,3575870961,0
1,844,16627,3575870961,3575870961,0
1,844,16628,3575870961,3575870961,0
1,844,16629,3575870961,3575870961,0
1,844,16630,3575870961,3575870961,0
1,844,16631,3575870961,3575870961,0
1,844,16632,3575870961,3575870961,0
1,844,16633,3575870961,3575870962,1
1,844,16634,3575870961,3575870962,1
1,844,16635,3575870961,3575870963,2
1,844,16636,3575870961,3575870963,2
1,844,16637,3575870961,3575870963,2
1,844,16638,3575870961,3575870965,4
1,844,16639,3575870961,3575870967,6
1,844,16640,3575870961,3575870970,9
1,844,16641,3575870961,3575870970,9
1,844,16642,3575870961,3575870974,13
1,844,16643,3575870961,3575870974,13
1,844,16644,3575870961,3575870976,15
1,844,16645,3575870961,3575870977,16
1,844,16646,3575870961,3575870978,17
1,844,16647,3575870961,3575870978,17
1,844,16648,3575870961,3575870979,18
1,844,16649,3575870961,3575870979,18
1,844,16650,3575870961,3575870980,19
1,844,16651,3575870961,3575870981,20
1,844,16652,3575870961,3575870982,21
1,844,16653,3575870961,3575870982,21
1,844,16654,3575870961,3575870982,21
1,844,16655,3575870961,3575870984,23
1,844,16656,3575870961,3575870984,23
1,844,16657,3575870961,3575870985,24
1,844,16658,3575870961,3575870985,24
1,844,16659,3575870961,3575870985,24
1,844,16660,3575870961,3575870987,26
1,844,16661,3575870961,3575870987,26
1,844,16662,3575870961,3575870987,26
1,844,16663,3575870961,3575870987,26
1,844,16664,3575870961,3575870992,31
1,844,16665,3575870961,3575870993,32
1,844,16666,3575870961,3575870998,37
1,844,16667,3575870961,3575871000,39
1,844,16668,3575870961,3575871001,40
1,844,16669,3575870961,3575871001,40
1,844,16670,3575870961,3575871001,40
1,844,16671,3575870961,3575871002,41
1,844,16672,3575870961,3575871005,44
1,844,16673,3575870961,3575871008,47
1,844,16674,3575870961,3575871009,48
1,845,16675,3575871021,3575871022,1
1,845,16676,3575871021,3575871022,1
1,845,16677,3575871021,3575871022,1
1,845,16678,3575871021,3575871022,1
1,845,16679,3575871021,3575871022,1
1,845,16680,3575871021,3575871022,1
1,845,16681,3575871021,3575871022,1
1,845,16682,3575871021,3575871022,1
1,845,16683,3575871021,3575871022,1
1,845,16684,3575871021,3575871022,1
1,845,16685,3575871021,3575871022,1
1,845,16686,3575871021,3575871022,1
1,845,16687,3575871021,3575871022,1
1,845,16688,3575871021,3575871022,1
1,845,16689,3575871021,3575871022,1
1,845,16690,3575871021,3575871022,1
1,845,16691,3575871021,3575871022,1
1,845,16692,3575871021,3575871022,1
1,845,16693,3575871021,3575871022,1
1,845,16694,3575871021,3575871022,1
1,845,16695,3575871021,3575871023,2
1,845,16696,3575871021,3575871023,2
1,845,16697,3575871021,3575871024,3
1,845,16698,3575871021,3575871024,3
1,845,16699,3575871021,3575871024,3
1,845,16700,3575871021,3575871026,5
1,845,16701,3575871021,3575871027,6
1,845,16702,3575871021,3575871027,6
1,845,16703,3575871021,3575871027,6
1,845,16704,3575871021,3575871030,9
1,845,16705,3575871021,3575871031,10
1,845,16706,3575871021,3575871031,10
1,845,16707,3575871021,3575871032,11
1,845,16708,3575871021,3575871032,11
1,845,16709,3575871021,3575871032,11
1,845,16710,3575871021,3575871033,12
1,845,16711,3575871021,3575871034,13
1,845,16712,3575871021,3575871035,14
1,845,16713,3575871021,3575871037,16
1,845,16714,3575871021,3575871038,17
1,845,16715,3575871021,3575871041,20
1,845,16716,3575871021,3575871044,23
1,845,16717,3575871021,3575871044,23
1,845,16718,3575871021,3575871045,24
1,845,16719,3575871021,3575871045,24
1,845,16720,3575871021,3575871045,24
1,845,16721,3575871021,3575871045,24
1,845,16722,3575871021,3575871046,25
1,845,16723,3575871021,3575871046,25
1,845,16724,3575871021,3575871047,26
1,845,16725,3575871021,3575871047,26
1,845,16726,3575871021,3575871050,29
1,845,16727,3575871021,3575871051,30
1,845,16728,3575871021,3575871053,32
1,845,16729,3575871021,3575871053,32
1,845,16730,3575871021,3575871054,33
1,845,16731,3575871021,3575871054,33
1,845,16732,3575871021,3575871056,35
1,845,16733,3575871021,3575871058,37
1,845,16734,3575871021,3575871059,38
1,845,16735,3575871021,3575871061,40
1,845,16736,3575871021,3575871062,41
1,845,16737,3575871021,3575871062,41
1,845,16738,3575871021,3575871064,43
1,845,16739,3575871021,3575871066,45
1,845,16740,3575871021,3575871066,45
1,845,16741,3575871021,3575871067,46
1,845,16742,3575871021,3575871068,47
1,845,16743,3575871021,3575871068,47
1,845,16744,3575871021,3575871071,50
1,846,16745,3575871079,3575871079,0
1,846,16746,3575871079,3575871079,0
1,846,16747,3575871079,3575871079,0
1,846,16748,3575871079,3575871080,1
1,846,16749,3575871079,3575871083,4
1,846,16750,3575871079,3575871083,4
1,846,16751,3575871079,3575871084,5
1,846,16752,3575871079,3575871085,6
1,846,16753,3575871079,3575871093,14
1,846,16754,3575871079,3575871095,16
1,846,16755,3575871079,3575871095,16
1,846,16756,3575871079,3575871095,16
1,846,16757,3575871079,3575871096,17
1,846,16758,3575871079,3575871096,17
1,846,16759,3575871079,3575871098,19
1,846,16760,3575871079,3575871098,19
1,846,16761,3575871079,3575871100,21
1,846,16762,3575871079,3575871101,22
1,846,16763,3575871079,3575871103,24
1,846,16764,3575871079,3575871104,25
1,846,16765,3575871079,3575871105,26
1,846,16766,3575871079,3575871105,26
1,846,16767,3575871079,3575871106,27
1,846,16768,3575871079,3575871107,28
1,846,16769,3575871079,3575871109,30
1,846,16770,3575871079,3575871112,33
1,846,16771,3575871079,3575871113,34
1,846,16772,3575871079,3575871113,34
1,846,16773,3575871079,3575871114,35
1,846,16774,3575871079,3575871115,36
1,846,16775,3575871079,3575871122,43
1,846,16776,3575871079,3575871123,44
1,846,16777,3575871079,3575871126,47
1,846,16778,3575871079,3575871126,47
1,846,16779,3575871079,3575871127,48
1,847,16780,3575871139,3575871139,0
1,847,16781,3575871139,3575871139,0
1,847,16782,3575871139,3575871139,0
1,847,16783,3575871139,3575871139,0
1,847,16784,3575871139,3575871139,0
1,847,16785,3575871139,3575871139,0
1,847,16786,3575871139,3575871139,0
1,847,16787,3575871139,3575871139,0
1,847,16788,3575871139,3575871139,0
1,847,16789,3575871139,3575871139,0
1,847,16790,3575871139,3575871141,2
1,847,16791,3575871139,3575871141,2
1,847,16792,3575871139,3575871144,5
1,847,16793,3575871139,3575871144,5
1,847,16794,3575871139,3575871145,6
1,847,16795,3575871139,3575871146,7
1,847,16796,3575871139,3575871147,8
1,847,16797,3575871139,3575871152,13
1,847,16798,3575871139,3575871153,14
1,847,16799,3575871139,3575871153,14
1,847,16800,3575871139,3575871154,15
1,847,16801,3575871139,3575871155,16
1,847,16802,3575871139,3575871157,18
1,847,16803,3575871139,3575871157,18
1,847,16804,3575871139,3575871158,19
1,847,16805,3575871139,3575871160,21
1,847,16806,3575871139,3575871160,21
1,847,16807,3575871139,3575871162,23
1,847,16808,3575871139,3575871163,24
1,847,16809,3575871139,3575871163,24
1,847,16810,3575871139,3575871164,25
1,847,16811,3575871139,3575871165,26
1,847,16812,3575871139,3575871166,27
1,847,16813,3575871139,3575871170,31
1,847,16814,3575871139,3575871170,31
1,847,16815,3575871139,3575871174,35
1,847,16816,3575871139,3575871174,35
1,847,16817,3575871139,3575871176,37
1,847,16818,3575871139,3575871177,38
1,847,16819,3575871139,3575871178,39
1,847,16820,3575871139,3575871178,39
1,847,16821,3575871139,3575871180,41
1,847,16822,3575871139,3575871180,41
1,847,16823,3575871139,3575871180,41
1,847,16824,3575871139,3575871181,42
1,847,16825,3575871139,3575871182,43
1,847,16826,3575871139,3575871184,45
1,847,16827,3575871139,3575871185,46
1,847,16828,3575871139,3575871185,46
1,847,16829,3575871139,3575871185,46
1,847,16830,3575871139,3575871186,47
1,847,16831,3575871139,3575871187,48
1,847,16832,3575871139,3575871187,48
1,847,16833,3575871139,3575871188,49
1,847,16834,3575871139,3575871188,49
1,848,16835,3575871198,3575871198,0
1,848,16836,3575871198,3575871198,0
1,848,16837,3575871198,3575871198,0
1,848,16838,3575871198,3575871198,0
1,848,16839,3575871198,3575871198,0
1,848,16840,3575871198,3575871200,2
1,848,16841,3575871198,3575871201,3
1,848,16842,3575871198,3575871201,3
1,848,16843,3575871198,3575871202,4
1,848,16844,3575871198,3575871203,5
1,848,16845,3575871198,3575871203,5
1,848,16846,3575871198,3575871205,7
1,848,16847,3575871198,3575871208,10
1,848,16848,3575871198,3575871209,11
1,848,16849,3575871198,3575871209,11
1,848,16850,3575871198,3575871211,13
1,848,16851,3575871198,3575871213,15
1,848,16852,3575871198,3575871213,15
1,848,16853,3575871198,3575871215,17
1,848,16854,3575871198,3575871216,18
1,848,16855,3575871198,3575871217,19
1,848,16856,3575871198,3575871217,19
1,848,16857,3575871198,3575871217,19
1,848,16858,3575871198,3575871217,19
1,848,16859,3575871198,3575871217,19
1,848,16860,3575871198,3575871218,20
1,848,16861,3575871198,3575871218,20
1,848,16862,3575871198,3575871219,21
1,848,16863,3575871198,3575871220,22
1,848,16864,3575871198,3575871221,23
1,848,16865,3575871198,3575871221,23
1,848,16866,3575871198,3575871221,23
1,848,16867,3575871198,3575871221,23
1,848,16868,3575871198,3575871222,24
1,848,16869,3575871198,3575871223,25
1,848,16870,3575871198,3575871223,25
1,848,16871,3575871198,3575871224,26
1,848,16872,3575871198,3575871224,26
1,848,16873,3575871198,3575871225,27
1,848,16874,3575871198,3575871227,29
1,848,16875,3575871198,3575871228,30
1,848,16876,3575871198,3575871229,31
1,848,16877,3575871198,3575871230,32
1,848,16878,3575871198,3575871231,33
1,848,16879,3575871198,3575871232,34
1,848,16880,3575871198,3575871232,34
1,848,16881,3575871198,3575871233,35
1,848,16882,3575871198,3575871233,35
1,848,16883,3575871198,3575871234,36
1,848,16884,3575871198,3575871234,36
1,848,16885,3575871198,3575871236,38
1,848,16886,3575871198,3575871237,39
1,848,16887,3575871198,3575871238,40
1,848,16888,3575871198,3575871240,42
1,848,16889,3575871198,3575871244,46
1,848,16890,3575871198,3575871244,46
1,848,16891,3575871198,3575871245,47
1,848,16892,3575871198,3575871245,47
1,848,16893,3575871198,3575871246,48
1,848,16894,3575871198,3575871246,48
1,848,16895,3575871198,3575871246,48
1,848,16896,3575871198,3575871247,49
1,848,16897,3575871198,3575871248,50
1,849,16898,3575871260,3575871261,1
1,849,16899,3575871260,3575871261,1
1,849,16900,3575871260,3575871261,1
1,849,16901,3575871260,3575871261,1
1,849,16902,3575871260,3575871261,1
1,849,16903,3575871260,3575871261,1
1,849,16904,3575871260,3575871261,1
1,849,16905,3575871260,3575871261,1
1,849,16906,3575871260,3575871261,1
1,849,16907,3575871260,3575871261,1
1,849,16908,3575871260,3575871262,2
1,849,16909,3575871260,3575871264,4
1,849,16910,3575871260,3575871266,6
1,849,16911,3575871260,3575871266,6
1,849,16912,3575871260,3575871267,7
1,849,16913,3575871260,3575871268,8
1,849,16914,3575871260,3575871269,9
1,849,16915,3575871260,3575871269,9
1,849,16916,3575871260,3575871274,14
1,849,16917,3575871260,3575871274,14
1,849,16918,3575871260,3575871276,16
1,849,16919,3575871260,3575871280,20
1,849,16920,3575871260,3575871283,23
1,849,16921,3575871260,3575871284,24
1,849,16922,3575871260,3575871285,25
1,849,16923,3575871260,3575871285,25
1,849,16924,3575871260,3575871287,27
1,849,16925,3575871260,3575871293,33
1,849,16926,3575871260,3575871295,35
1,849,16927,3575871260,3575871295,35
1,849,16928,3575871260,3575871296,36
1,849,16929,3575871260,3575871297,37
1,849,16930,3575871260,3575871298,38
1,849,16931,3575871260,3575871298,38
1,849,16932,3575871260,3575871301,41
1,849,16933,3575871260,3575871302,42
1,849,16934,3575871260,3575871304,44
1,849,16935,3575871260,3575871306,46
1,849,16936,3575871260,3575871306,46
1,849,16937,3575871260,3575871307,47
1,849,16938,3575871260,3575871308,48
1,850,16939,3575871321,3575871321,0
1,850,16940,3575871321,3575871321,0
1,850,16941,3575871321,3575871321,0
1,850,16942,3575871321,3575871321,0
1,850,16943,3575871321,3575871321,0
1,850,16944,3575871321,3575871323,2
1,850,16945,3575871321,3575871323,2
1,850,16946,3575871321,3575871325,4
1,850,16947,3575871321,3575871327,6
1,850,16948,3575871321,3575871330,9
1,850,16949,3575871321,3575871332,11
1,850,16950,3575871321,3575871334,13
1,850,16951,3575871321,3575871334,13
1,850,16952,3575871321,3575871335,14
1,850,16953,3575871321,3575871335,14
1,850,16954,3575871321,3575871336,15
1,850,16955,3575871321,3575871336,15
1,850,16956,3575871321,3575871337,16
1,850,16957,3575871321,3575871338,17
1,850,16958,3575871321,3575871340,19
1,850,16959,3575871321,3575871341,20
1,850,16960,3575871321,3575871343,22
1,850,16961,3575871321,3575871344,23
1,850,16962,3575871321,3575871345,24
1,850,16963,3575871321,3575871347,26
1,850,16964,3575871321,3575871347,26
1,850,16965,3575871321,3575871352,31
1,850,16966,3575871321,3575871352,31
1,850,16967,3575871321,3575871353,32
1,850,16968,3575871321,3575871353,32
1,850,16969,3575871321,3575871355,34
1,850,16970,3575871321,3575871355,34
1,850,16971,3575871321,3575871360,39
1,850,16972,3575871321,3575871360,39
1,850,16973,3575871321,3575871362,41
1,850,16974,3575871321,3575871362,41
1,850,16975,3575871321,3575871363,42
1,850,16976,3575871321,3575871364,43
1,850,16977,3575871321,3575871364,43
1,850,16978,3575871321,3575871365,44
1,850,16979,3575871321,3575871367,46
1,850,16980,3575871321,3575871370,49
1,850,16981,3575871321,3575871370,49
1,851,16982,3575871380,3575871380,0
1,851,16983,3575871380,3575871380,0
1,851,16984,3575871380,3575871380,0
1,851,16985,3575871380,3575871380,0
1,851,16986,3575871380,3575871380,0
1,851,16987,3575871380,3575871380,0
1,851,16988,3575871380,3575871380,0
1,851,16989,3575871380,3575871380,0
1,851,16990,3575871380,3575871381,1
1,851,16991,3575871380,3575871382,2
1,851,16992,3575871380,3575871382,2
1,851,16993,3575871380,3575871383,3
1,851,16994,3575871380,3575871383,3
1,851,16995,3575871380,3575871385,5
1,851,16996,3575871380,3575871385,5
1,851,16997,3575871380,3575871385,5
1,851,16998,3575871380,3575871385,5
1,851,16999,3575871380,3575871387,7
1,851,17000,3575871380,3575871387,7
1,851,17001,3575871380,3575871387,7
1,851,17002,3575871380,3575871388,8
1,851,17003,3575871380,3575871391,11
1,851,17004,3575871380,3575871392,12
1,851,17005,3575871380,3575871394,14
1,851,17006,3575871380,3575871394,14
1,851,17007,3575871380,3575871398,18
1,851,17008,3575871380,3575871400,20
1,851,17009,3575871380,3575871401,21
1,851,17010,3575871380,3575871401,21
1,851,17011,3575871380,3575871402,22
1,851,17012,3575871380,3575871402,22
1,851,17013,3575871380,3575871404,24
1,851,17014,3575871380,3575871410,30
1,851,17015,3575871380,3575871410,30
1,851,17016,3575871380,3575871411,31
1,851,17017,3575871380,3575871413,33
1,851,17018,3575871380,3575871413,33
1,851,17019,3575871380,3575871414,34
1,851,17020,3575871380,3575871415,35
1,851,17021,3575871380,3575871415,35
1,851,17022,3575871380,3575871416,36
1,851,17023,3575871380,3575871416,36
1,851,17024,3575871380,3575871417,37
1,851,17025,3575871380,3575871418,38
1,851,17026,3575871380,3575871418,38
1,851,17027,3575871380,3575871418,38
1,851,17028,3575871380,3575871420,40
1,851,17029,3575871380,3575871420,40
1,851,17030,3575871380,3575871422,42
1,851,17031,3575871380,3575871422,42
1,851,17032,3575871380,3575871422,42
1,851,17033,3575871380,3575871423,43
1,851,17034,3575871380,3575871424,44
1,851,17035,3575871380,3575871424,44
1,851,17036,3575871380,3575871424,44
1,851,17037,3575871380,3575871425,45
1,851,17038,3575871380,3575871427,47
1,851,17039,3575871380,3575871428,48
1,851,17040,3575871380,3575871429,49
1,851,17041,3575871380,3575871429,49
1,852,17042,3575871439,3575871439,0
1,852,17043,3575871439,3575871439,0
1,852,17044,3575871439,3575871439,0
1,852,17045,3575871439,3575871439,0
1,852,17046,3575871439,3575871439,0
1,852,17047,3575871439,3575871439,0
1,852,17048,3575871439,3575871439,0
1,852,17049,3575871439,3575871439,0
1,852,17050,3575871439,3575871439,0
1,852,17051,3575871439,3575871442,3
1,852,17052,3575871439,3575871445,6
1,852,17053,3575871439,3575871445,6
1,852,17054,3575871439,3575871446,7
1,852,17055,3575871439,3575871446,7
1,852,17056,3575871439,3575871446,7
1,852,17057,3575871439,3575871446,7
1,852,17058,3575871439,3575871446,7
1,852,17059,3575871439,3575871447,8
1,852,17060,3575871439,3575871448,9
1,852,17061,3575871439,3575871449,10
1,852,17062,3575871439,3575871450,11
1,852,17063,3575871439,3575871450,11
1,852,17064,3575871439,3575871452,13
1,852,17065,3575871439,3575871453,14
1,852,17066,3575871439,3575871453,14
1,852,17067,3575871439,3575871454,15
1,852,17068,3575871439,3575871454,15
1,852,17069,3575871439,3575871456,17
1,852,17070,3575871439,3575871458,19
1,852,17071,3575871439,3575871462,23
1,852,17072,3575871439,3575871462,23
1,852,17073,3575871439,3575871462,23
1,852,17074,3575871439,3575871465,26
1,852,17075,3575871439,3575871466,27
1,852,17076,3575871439,3575871467,28
1,852,17077,3575871439,3575871467,28
1,852,17078,3575871439,3575871468,29
1,852,17079,3575871439,3575871469,30
1,852,17080,3575871439,3575871470,31
1,852,17081,3575871439,3575871470,31
1,852,17082,3575871439,3575871474,35
1,852,17083,3575871439,3575871475,36
1,852,17084,3575871439,3575871476,37
1,852,17085,3575871439,3575871480,41
1,852,17086,3575871439,3575871483,44
1,852,17087,3575871439,3575871485,46
1,852,17088,3575871439,3575871485,46
1,852,17089,3575871439,3575871486,47
1,853,17090,3575871498,3575871498,0
1,853,17091,3575871498,3575871498,0
1,853,17092,3575871498,3575871498,0
1,853,17093,3575871498,3575871498,0
1,853,17094,3575871498,3575871498,0
1,853,17095,3575871498,3575871498,0
1,853,17096,3575871498,3575871498,0
1,853,17097,3575871498,3575871498,0
1,853,17098,3575871498,3575871498,0
1,853,17099,3575871498,3575871500,2
1,853,17100,3575871498,3575871502,4
1,853,17101,3575871498,3575871504,6
1,853,17102,3575871498,3575871505,7
1,853,17103,3575871498,3575871505,7
1,853,17104,3575871498,3575871507,9
1,853,17105,3575871498,3575871510,12
1,853,17106,3575871498,3575871511,13
1,853,17107,3575871498,3575871513,15
1,853,17108,3575871498,3575871514,16
1,853,17109,3575871498,3575871522,24
1,853,17110,3575871498,3575871523,25
1,853,17111,3575871498,3575871527,29
1,853,17112,3575871498,3575871528,30
1,853,17113,3575871498,3575871529,31
1,853,17114,3575871498,3575871530,32
1,853,17115,3575871498,3575871531,33
1,853,17116,3575871498,3575871533,35
1,853,17117,3575871498,3575871533,35
1,853,17118,3575871498,3575871534,36
1,853,17119,3575871498,3575871534,36
1,853,17120,3575871498,3575871534,36
1,853,17121,3575871498,3575871535,37
1,853,17122,3575871498,3575871535,37
1,853,17123,3575871498,3575871537,39
1,853,17124,3575871498,3575871538,40
1,853,17125,3575871498,3575871540,42
1,853,17126,3575871498,3575871540,42
1,853,17127,3575871498,3575871542,44
1,853,17128,3575871498,3575871543,45
1,853,17129,3575871498,3575871545,47
1,853,17130,3575871498,3575871546,48
1,853,17131,3575871498,3575871546,48
1,854,17132,3575871558,3575871558,0
1,854,17133,3575871558,3575871558,0
1,854,17134,3575871558,3575871558,0
1,854,17135,3575871558,3575871558,0
1,854,17136,3575871558,3575871558,0
1,854,17137,3575871558,3575871558,0
1,854,17138,3575871558,3575871559,1
1,854,17139,3575871558,3575871561,3
1,854,17140,3575871558,3575871562,4
1,854,17141,3575871558,3575871562,4
1,854,17142,3575871558,3575871562,4
1,854,17143,3575871558,3575871562,4
1,854,17144,3575871558,3575871563,5
1,854,17145,3575871558,3575871564,6
1,854,17146,3575871558,3575871567,9
1,854,17147,3575871558,3575871569,11
1,854,17148,3575871558,3575871569,11
1,854,17149,3575871558,3575871574,16
1,854,17150,3575871558,3575871574,16
1,854,17151,3575871558,3575871576,18
1,854,17152,3575871558,3575871578,20
1,854,17153,3575871558,3575871578,20
1,854,17154,3575871558,3575871579,21
1,854,17155,3575871558,3575871579,21
1,854,17156,3575871558,3575871579,21
1,854,17157,3575871558,3575871580,22
1,854,17158,3575871558,3575871581,23
1,854,17159,3575871558,3575871581,23
1,854,17160,3575871558,3575871582,24
1,854,17161,3575871558,3575871583,25
1,854,17162,3575871558,3575871583,25
1,854,17163,3575871558,3575871584,26
1,854,17164,3575871558,3575871585,27
1,854,17165,3575871558,3575871585,27
1,854,17166,3575871558,3575871586,28
1,854,17167,3575871558,3575871586,28
1,854,17168,3575871558,3575871587,29
1,854,17169,3575871558,3575871588,30
1,854,17170,3575871558,3575871589,31
1,854,17171,3575871558,3575871590,32
1,854,17172,3575871558,3575871591,33
1,854,17173,3575871558,3575871593,35
1,854,17174,3575871558,3575871597,39
1,854,17175,3575871558,3575871599,41
1,854,17176,3575871558,3575871599,41
1,854,17177,3575871558,3575871599,41
1,854,17178,3575871558,3575871601,43
1,854,17179,3575871558,3575871602,44
1,854,17180,3575871558,3575871602,44
1,854,17181,3575871558,3575871604,46
1,854,17182,3575871558,3575871607,49
1,855,17183,3575871618,3575871618,0
1,855,17184,3575871618,3575871618,0
1,855,17185,3575871618,3575871618,0
1,855,17186,3575871618,3575871618,0
1,855,17187,3575871618,3575871618,0
1,855,17188,3575871618,3575871618,0
1,855,17189,3575871618,3575871618,0
1,855,17190,3575871618,3575871618,0
1,855,17191,3575871618,3575871618,0
1,855,17192,3575871618,3575871618,0
1,855,17193,3575871618,3575871618,0
1,855,17194,3575871618,3575871618,0
1,855,17195,3575871618,3575871618,0
1,855,17196,3575871618,3575871618,0
1,855,17197,3575871618,3575871619,1
1,855,17198,3575871618,3575871620,2
1,855,17199,3575871618,3575871621,3
1,855,17200,3575871618,3575871621,3
1,855,17201,3575871618,3575871622,4
1,855,17202,3575871618,3575871622,4
1,855,17203,3575871618,3575871623,5
1,855,17204,3575871618,3575871624,6
1,855,17205,3575871618,3575871625,7
1,855,17206,3575871618,3575871626,8
1,855,17207,3575871618,3575871627,9
1,855,17208,3575871618,3575871629,11
1,855,17209,3575871618,3575871630,12
1,855,17210,3575871618,3575871630,12
1,855,17211,3575871618,3575871631,13
1,855,17212,3575871618,3575871631,13
1,855,17213,3575871618,3575871633,15
1,855,17214,3575871618,3575871634,16
1,855,17215,3575871618,3575871634,16
1,855,17216,3575871618,3575871634,16
1,855,17217,3575871618,3575871635,17
1,855,17218,3575871618,3575871635,17
1,855,17219,3575871618,3575871638,20
1,855,17220,3575871618,3575871641,23
1,855,17221,3575871618,3575871644,26
1,855,17222,3575871618,3575871645,27
1,855,17223,3575871618,3575871645,27
1,855,17224,3575871618,3575871645,27
1,855,17225,3575871618,3575871645,27
1,855,17226,3575871618,3575871645,27
1,855,17227,3575871618,3575871646,28
1,855,17228,3575871618,3575871648,30
1,855,17229,3575871618,3575871648,30
1,855,17230,3575871618,3575871648,30
1,855,17231,3575871618,3575871649,31
1,855,17232,3575871618,3575871651,33
1,855,17233,3575871618,3575871652,34
1,855,17234,3575871618,3575871653,35
1,855,17235,3575871618,3575871653,35
1,855,17236,3575871618,3575871654,36
1,855,17237,3575871618,3575871655,37
1,855,17238,3575871618,3575871657,39
1,855,17239,3575871618,3575871658,40
1,855,17240,3575871618,3575871661,43
1,855,17241,3575871618,3575871661,43
1,855,17242,3575871618,3575871661,43
1,855,17243,3575871618,3575871663,45
1,855,17244,3575871618,3575871665,47
1,855,17245,3575871618,3575871666,48
1,855,17246,3575871618,3575871666,48
1,855,17247,3575871618,3575871668,50
1,856,17248,3575871678,3575871678,0
1,856,17249,3575871678,3575871678,0
1,856,17250,3575871678,3575871678,0
1,856,17251,3575871678,3575871678,0
1,856,17252,3575871678,3575871678,0
1,856,17253,3575871678,3575871678,0
1,856,17254,3575871678,3575871680,2
1,856,17255,3575871678,3575871682,4
1,856,17256,3575871678,3575871682,4
1,856,17257,3575871678,3575871685,7
1,856,17258,3575871678,3575871686,8
1,856,17259,3575871678,3575871687,9
1,856,17260,3575871678,3575871695,17
1,856,17261,3575871678,3575871696,18
1,856,17262,3575871678,3575871698,20
1,856,17263,3575871678,3575871698,20
1,856,17264,3575871678,3575871699,21
1,856,17265,3575871678,3575871700,22
1,856,17266,3575871678,3575871702,24
1,856,17267,3575871678,3575871705,27
1,856,17268,3575871678,3575871705,27
1,856,17269,3575871678,3575871707,29
1,856,17270,3575871678,3575871708,30
1,856,17271,3575871678,3575871711,33
1,856,17272,3575871678,3575871711,33
1,856,17273,3575871678,3575871713,35
1,856,17274,3575871678,3575871714,36
1,856,17275,3575871678,3575871715,37
1,856,17276,3575871678,3575871722,44
1,856,17277,3575871678,3575871723,45
1,856,17278,3575871678,3575871725,47
1,856,17279,3575871678,3575871727,49
1,857,17280,3575871738,3575871738,0
1,857,17281,3575871738,3575871738,0
1,857,17282,3575871738,3575871738,0
1,857,17283,3575871738,3575871738,0
1,857,17284,3575871738,3575871738,0
1,857,17285,3575871738,3575871738,0
1,857,17286,3575871738,3575871738,0
1,857,17287,3575871738,3575871738,0
1,857,17288,3575871738,3575871738,0
1,857,17289,3575871738,3575871738,0
1,857,17290,3575871738,3575871738,0
1,857,17291,3575871738,3575871738,0
1,857,17292,3575871738,3575871740,2
1,857,17293,3575871738,3575871740,2
1,857,17294,3575871738,3575871742,4
1,857,17295,3575871738,3575871744,6
1,857,17296,3575871738,3575871746,8
1,857,17297,3575871738,3575871746,8
1,857,17298,3575871738,3575871747,9
1,857,17299,3575871738,3575871750,12
1,857,17300,3575871738,3575871750,12
1,857,17301,3575871738,3575871751,13
1,857,17302,3575871738,3575871754,16
1,857,17303,3575871738,3575871755,17
1,857,17304,3575871738,3575871757,19
1,857,17305,3575871738,3575871759,21
1,857,17306,3575871738,3575871760,22
1,857,17307,3575871738,3575871762,24
1,857,17308,3575871738,3575871762,24
1,857,17309,3575871738,3575871763,25
1,857,17310,3575871738,3575871763,25
1,857,17311,3575871738,3575871764,26
1,857,17312,3575871738,3575871764,26
1,857,17313,3575871738,3575871767,29
1,857,17314,3575871738,3575871769,31
1,857,17315,3575871738,3575871769,31
1,857,17316,3575871738,3575871775,37
1,857,17317,3575871738,3575871775,37
1,857,17318,3575871738,3575871777,39
1,857,17319,3575871738,3575871777,39
1,857,17320,3575871738,3575871778,40
1,857,17321,3575871738,3575871778,40
1,857,17322,3575871738,3575871779,41
1,857,17323,3575871738,3575871779,41
1,857,17324,3575871738,3575871780,42
1,857,17325,3575871738,3575871781,43
1,857,17326,3575871738,3575871781,43
1,857,17327,3575871738,3575871782,44
1,857,17328,3575871738,3575871782,44
1,857,17329,3575871738,3575871783,45
1,857,17330,3575871738,3575871785,47
1,857,17331,3575871738,3575871785,47
1,857,17332,3575871738,3575871785,47
1,857,17333,3575871738,3575871786,48
1,857,17334,3575871738,3575871787,49
1,857,17335,3575871738,3575871787,49
1,857,17336,3575871738,3575871788,50
1,858,17337,3575871799,3575871799,0
1,858,17338,3575871799,3575871799,0
1,858,17339,3575871799,3575871799,0
1,858,17340,3575871799,3575871799,0
1,858,17341,3575871799,3575871799,0
1,858,17342,3575871799,3575871800,1
1,858,17343,3575871799,3575871800,1
1,858,17344,3575871799,3575871801,2
1,858,17345,3575871799,3575871802,3
1,858,17346,3575871799,3575871802,3
1,858,17347,3575871799,3575871804,5
1,858,17348,3575871799,3575871807,8
1,858,17349,3575871799,3575871807,8
1,858,17350,3575871799,3575871808,9
1,858,17351,3575871799,3575871811,12
1,858,17352,3575871799,3575871813,14
1,858,17353,3575871799,3575871813,14
1,858,17354,3575871799,3575871813,14
1,858,17355,3575871799,3575871813,14
1,858,17356,3575871799,3575871814,15
1,858,17357,3575871799,3575871815,16
1,858,17358,3575871799,3575871815,16
1,858,17359,3575871799,3575871815,16
1,858,17360,3575871799,3575871816,17
1,858,17361,3575871799,3575871816,17
1,858,17362,3575871799,3575871816,17
1,858,17363,3575871799,3575871816,17
1,858,17364,3575871799,3575871818,19
1,858,17365,3575871799,3575871818,19
1,858,17366,3575871799,3575871819,20
1,858,17367,3575871799,3575871820,21
1,858,17368,3575871799,3575871821,22
1,858,17369,3575871799,3575871821,22
1,858,17370,3575871799,3575871822,23
1,858,17371,3575871799,3575871822,23
1,858,17372,3575871799,3575871823,24
1,858,17373,3575871799,3575871825,26
1,858,17374,3575871799,3575871826,27
1,858,17375,3575871799,3575871827,28
1,858,17376,3575871799,3575871827,28
1,858,17377,3575871799,3575871828,29
1,858,17378,3575871799,3575871830,31
1,858,17379,3575871799,3575871831,32
1,858,17380,3575871799,3575871831,32
1,858,17381,3575871799,3575871832,33
1,858,17382,3575871799,3575871832,33
1,858,17383,3575871799,3575871833,34
1,858,17384,3575871799,3575871833,34
1,858,17385,3575871799,3575871833,34
1,858,17386,3575871799,3575871834,35
1,858,17387,3575871799,3575871835,36
1,858,17388,3575871799,3575871836,37
1,858,17389,3575871799,3575871838,39
1,858,17390,3575871799,3575871842,43
1,858,17391,3575871799,3575871843,44
1,858,17392,3575871799,3575871845,46
1,858,17393,3575871799,3575871845,46
1,858,17394,3575871799,3575871845,46
1,858,17395,3575871799,3575871845,46
1,858,17396,3575871799,3575871845,46
1,858,17397,3575871799,3575871845,46
1,858,17398,3575871799,3575871846,47
1,858,17399,3575871799,3575871847,48
1,858,17400,3575871799,3575871848,49
1,858,17401,3575871799,3575871848,49
1,859,17402,3575871857,3575871857,0
1,859,17403,3575871857,3575871857,0
1,859,17404,3575871857,3575871857,0
1,859,17405,3575871857,3575871857,0
1,859,17406,3575871857,3575871857,0
1,859,17407,3575871857,3575871857,0
1,859,17408,3575871857,3575871857,0
1,859,17409,3575871857,3575871858,1
1,859,17410,3575871857,3575871858,1
1,859,17411,3575871857,3575871858,1
1,859,17412,3575871857,3575871861,4
1,859,17413,3575871857,3575871861,4
1,859,17414,3575871857,3575871861,4
1,859,17415,3575871857,3575871863,6
1,859,17416,3575871857,3575871865,8
1,859,17417,3575871857,3575871865,8
1,859,17418,3575871857,3575871867,10
1,859,17419,3575871857,3575871868,11
1,859,17420,3575871857,3575871868,11
1,859,17421,3575871857,3575871869,12
1,859,17422,3575871857,3575871870,13
1,859,17423,3575871857,3575871874,17
1,859,17424,3575871857,3575871875,18
1,859,17425,3575871857,3575871876,19
1,859,17426,3575871857,3575871880,23
1,859,17427,3575871857,3575871883,26
1,859,17428,3575871857,3575871883,26
1,859,17429,3575871857,3575871885,28
1,859,17430,3575871857,3575871885,28
1,859,17431,3575871857,3575871887,30
1,859,17432,3575871857,3575871895,38
1,859,17433,3575871857,3575871896,39
1,859,17434,3575871857,3575871897,40
1,859,17435,3575871857,3575871899,42
1,859,17436,3575871857,3575871899,42
1,859,17437,3575871857,3575871900,43
1,859,17438,3575871857,3575871902,45
1,859,17439,3575871857,3575871905,48
1,859,17440,3575871857,3575871905,48
1,859,17441,3575871857,3575871905,48
1,860,17442,3575871917,3575871917,0
1,860,17443,3575871917,3575871917,0
1,860,17444,3575871917,3575871917,0
1,860,17445,3575871917,3575871917,0
1,860,17446,3575871917,3575871917,0
1,860,17447,3575871917,3575871917,0
1,860,17448,3575871917,3575871917,0
1,860,17449,3575871917,3575871922,5
1,860,17450,3575871917,3575871923,6
1,860,17451,3575871917,3575871924,7
1,860,17452,3575871917,3575871926,9
1,860,17453,3575871917,3575871927,10
1,860,17454,3575871917,3575871927,10
1,860,17455,3575871917,3575871931,14
1,860,17456,3575871917,3575871932,15
1,860,17457,3575871917,3575871933,16
1,860,17458,3575871917,3575871934,17
1,860,17459,3575871917,3575871934,17
1,860,17460,3575871917,3575871934,17
1,860,17461,3575871917,3575871935,18
1,860,17462,3575871917,3575871935,18
1,860,17463,3575871917,3575871936,19
1,860,17464,3575871917,3575871937,20
1,860,17465,3575871917,3575871938,21
1,860,17466,3575871917,3575871940,23
1,860,17467,3575871917,3575871940,23
1,860,17468,3575871917,3575871943,26
1,860,17469,3575871917,3575871943,26
1,860,17470,3575871917,3575871946,29
1,860,17471,3575871917,3575871946,29
1,860,17472,3575871917,3575871950,33
1,860,17473,3575871917,3575871951,34
1,860,17474,3575871917,3575871951,34
1,860,17475,3575871917,3575871953,36
1,860,17476,3575871917,3575871953,36
1,860,17477,3575871917,3575871955,38
1,860,17478,3575871917,3575871955,38
1,860,17479,3575871917,3575871957,40
1,860,17480,3575871917,3575871957,40
1,860,17481,3575871917,3575871957,40
1,860,17482,3575871917,3575871959,42
1,860,17483,3575871917,3575871960,43
1,860,17484,3575871917,3575871962,45
1,860,17485,3575871917,3575871962,45
1,860,17486,3575871917,3575871963,46
1,860,17487,3575871917,3575871963,46
1,860,17488,3575871917,3575871963,46
1,860,17489,3575871917,3575871963,46
1,860,17490,3575871917,3575871963,46
1,860,17491,3575871917,3575871965,48
1,861,17492,3575871977,3575871977,0
1,861,17493,3575871977,3575871977,0
1,861,17494,3575871977,3575871977,0
1,861,17495,3575871977,3575871977,0
1,861,17496,3575871977,3575871977,0
1,861,17497,3575871977,3575871977,0
1,861,17498,3575871977,3575871977,0
1,861,17499,3575871977,3575871978,1
1,861,17500,3575871977,3575871978,1
1,861,17501,3575871977,3575871979,2
1,861,17502,3575871977,3575871979,2
1,861,17503,3575871977,3575871979,2
1,861,17504,3575871977,3575871981,4
1,861,17505,3575871977,3575871981,4
1,861,17506,3575871977,3575871982,5
1,861,17507,3575871977,3575871982,5
1,861,17508,3575871977,3575871983,6
1,861,17509,3575871977,3575871984,7
1,861,17510,3575871977,3575871984,7
1,861,17511,3575871977,3575871985,8
1,861,17512,3575871977,3575871986,9
1,861,17513,3575871977,3575871987,10
1,861,17514,3575871977,3575871987,10
1,861,17515,3575871977,3575871987,10
1,861,17516,3575871977,3575871988,11
1,861,17517,3575871977,3575871989,12
1,861,17518,3575871977,3575871990,13
1,861,17519,3575871977,3575871991,14
1,861,17520,3575871977,3575871991,14
1,861,17521,3575871977,3575871992,15
1,861,17522,3575871977,3575871998,21
1,861,17523,3575871977,3575872000,23
1,861,17524,3575871977,3575872000,23
1,861,17525,3575871977,3575872000,23
1,861,17526,3575871977,3575872002,25
1,861,17527,3575871977,3575872002,25
1,861,17528,3575871977,3575872002,25
1,861,17529,3575871977,3575872003,26
1,861,17530,3575871977,3575872004,27
1,861,17531,3575871977,3575872007,30
1,861,17532,3575871977,3575872008,31
1,861,17533,3575871977,3575872011,34
1,861,17534,3575871977,3575872012,35
1,861,17535,3575871977,3575872013,36
1,861,17536,3575871977,3575872013,36
1,861,17537,3575871977,3575872014,37
1,861,17538,3575871977,3575872016,39
1,861,17539,3575871977,3575872016,39
1,861,17540,3575871977,3575872016,39
1,861,17541,3575871977,3575872016,39
1,861,17542,3575871977,3575872016,39
1,861,17543,3575871977,3575872017,40
1,861,17544,3575871977,3575872017,40
1,861,17545,3575871977,3575872018,41
1,861,17546,3575871977,3575872019,42
1,861,17547,3575871977,3575872020,43
1,861,17548,3575871977,3575872020,43
1,861,17549,3575871977,3575872020,43
1,861,17550,3575871977,3575872021,44
1,861,17551,3575871977,3575872022,45
1,861,17552,3575871977,3575872022,45
1,861,17553,3575871977,3575872022,45
1,861,17554,3575871977,3575872024,47
1,861,17555,3575871977,3575872024,47
1,861,17556,3575871977,3575872025,48
1,861,17557,3575871977,3575872025,48
1,862,17558,3575872036,3575872036,0
1,862,17559,3575872036,3575872036,0
1,862,17560,3575872036,3575872036,0
1,862,17561,3575872036,3575872036,0
1,862,17562,3575872036,3575872036,0
1,862,17563,3575872036,3575872036,0
1,862,17564,3575872036,3575872036,0
1,862,17565,3575872036,3575872036,0
1,862,17566,3575872036,3575872036,0
1,862,17567,3575872036,3575872036,0
1,862,17568,3575872036,3575872036,0
1,862,17569,3575872036,3575872036,0
1,862,17570,3575872036,3575872036,0
1,862,17571,3575872036,3575872038,2
1,862,17572,3575872036,3575872042,6
1,862,17573,3575872036,3575872044,8
1,862,17574,3575872036,3575872044,8
1,862,17575,3575872036,3575872045,9
1,862,17576,3575872036,3575872045,9
1,862,17577,3575872036,3575872045,9
1,862,17578,3575872036,3575872045,9
1,862,17579,3575872036,3575872046,10
1,862,17580,3575872036,3575872047,11
1,862,17581,3575872036,3575872048,12
1,862,17582,3575872036,3575872049,13
1,862,17583,3575872036,3575872051,15
1,862,17584,3575872036,3575872052,16
1,862,17585,3575872036,3575872053,17
1,862,17586,3575872036,3575872053,17
1,862,17587,3575872036,3575872055,19
1,862,17588,3575872036,3575872056,20
1,862,17589,3575872036,3575872058,22
1,862,17590,3575872036,3575872058,22
1,862,17591,3575872036,3575872058,22
1,862,17592,3575872036,3575872061,25
1,862,17593,3575872036,3575872061,25
1,862,17594,3575872036,3575872061,25
1,862,17595,3575872036,3575872063,27
1,862,17596,3575872036,3575872066,30
1,862,17597,3575872036,3575872068,32
1,862,17598,3575872036,3575872069,33
1,862,17599,3575872036,3575872069,33
1,862,17600,3575872036,3575872070,34
1,862,17601,3575872036,3575872074,38
1,862,17602,3575872036,3575872075,39
1,862,17603,3575872036,3575872076,40
1,862,17604,3575872036,3575872080,44
1,862,17605,3575872036,3575872083,47
1,862,17606,3575872036,3575872083,47
1,862,17607,3575872036,3575872085,49
1,862,17608,3575872036,3575872086,50
1,863,17609,3575872095,3575872095,0
1,863,17610,3575872095,3575872095,0
1,863,17611,3575872095,3575872095,0
1,863,17612,3575872095,3575872095,0
1,863,17613,3575872095,3575872096,1
1,863,17614,3575872095,3575872099,4
1,863,17615,3575872095,3575872099,4
1,863,17616,3575872095,3575872099,4
1,863,17617,3575872095,3575872100,5
1,863,17618,3575872095,3575872103,8
1,863,17619,3575872095,3575872105,10
1,863,17620,3575872095,3575872106,11
1,863,17621,3575872095,3575872108,13
1,863,17622,3575872095,3575872110,15
1,863,17623,3575872095,3575872111,16
1,863,17624,3575872095,3575872112,17
1,863,17625,3575872095,3575872114,19
1,863,17626,3575872095,3575872115,20
1,863,17627,3575872095,3575872115,20
1,863,17628,3575872095,3575872116,21
1,863,17629,3575872095,3575872121,26
1,863,17630,3575872095,3575872123,28
1,863,17631,3575872095,3575872125,30
1,863,17632,3575872095,3575872125,30
1,863,17633,3575872095,3575872127,32
1,863,17634,3575872095,3575872127,32
1,863,17635,3575872095,3575872131,36
1,863,17636,3575872095,3575872132,37
1,863,17637,3575872095,3575872133,38
1,863,17638,3575872095,3575872134,39
1,863,17639,3575872095,3575872134,39
1,863,17640,3575872095,3575872134,39
1,863,17641,3575872095,3575872134,39
1,863,17642,3575872095,3575872136,41
1,863,17643,3575872095,3575872136,41
1,863,17644,3575872095,3575872139,44
1,863,17645,3575872095,3575872139,44
1,863,17646,3575872095,3575872140,45
1,863,17647,3575872095,3575872140,45
1,863,17648,3575872095,3575872144,49
1,863,17649,3575872095,3575872144,49
1,864,17650,3575872155,3575872155,0
1,864,17651,3575872155,3575872155,0
1,864,17652,3575872155,3575872155,0
1,864,17653,3575872155,3575872155,0
1,864,17654,3575872155,3575872155,0
1,864,17655,3575872155,3575872155,0
1,864,17656,3575872155,3575872155,0
1,864,17657,3575872155,3575872155,0
1,864,17658,3575872155,3575872155,0
1,864,17659,3575872155,3575872155,0
1,864,17660,3575872155,3575872159,4
1,864,17661,3575872155,3575872160,5
1,864,17662,3575872155,3575872162,7
1,864,17663,3575872155,3575872162,7
1,864,17664,3575872155,3575872163,8
1,864,17665,3575872155,3575872163,8
1,864,17666,3575872155,3575872163,8
1,864,17667,3575872155,3575872164,9
1,864,17668,3575872155,3575872164,9
1,864,17669,3575872155,3575872165,10
1,864,17670,3575872155,3575872168,13
1,864,17671,3575872155,3575872169,14
1,864,17672,3575872155,3575872170,15
1,864,17673,3575872155,3575872174,19
1,864,17674,3575872155,3575872175,20
1,864,17675,3575872155,3575872176,21
1,864,17676,3575872155,3575872177,22
1,864,17677,3575872155,3575872178,23
1,864,17678,3575872155,3575872179,24
1,864,17679,3575872155,3575872179,24
1,864,17680,3575872155,3575872179,24
1,864,17681,3575872155,3575872179,24
1,864,17682,3575872155,3575872181,26
1,864,17683,3575872155,3575872182,27
1,864,17684,3575872155,3575872182,27
1,864,17685,3575872155,3575872184,29
1,864,17686,3575872155,3575872185,30
1,864,17687,3575872155,3575872185,30
1,864,17688,3575872155,3575872187,32
1,864,17689,3575872155,3575872187,32
1,864,17690,3575872155,3575872187,32
1,864,17691,3575872155,3575872188,33
1,864,17692,3575872155,3575872188,33
1,864,17693,3575872155,3575872190,35
1,864,17694,3575872155,3575872191,36
1,864,17695,3575872155,3575872191,36
1,864,17696,3575872155,3575872192,37
1,864,17697,3575872155,3575872193,38
1,864,17698,3575872155,3575872199,44
1,864,17699,3575872155,3575872200,45
1,864,17700,3575872155,3575872200,45
1,864,17701,3575872155,3575872200,45
1,864,17702,3575872155,3575872202,47
1,864,17703,3575872155,3575872202,47
1,864,17704,3575872155,3575872204,49
1,864,17705,3575872155,3575872204,49
1,865,17706,3575872214,3575872214,0
1,865,17707,3575872214,3575872214,0
1,865,17708,3575872214,3575872214,0
1,865,17709,3575872214,3575872214,0
1,865,17710,3575872214,3575872214,0
1,865,17711,3575872214,3575872214,0
1,865,17712,3575872214,3575872214,0
1,865,17713,3575872214,3575872214,0
1,865,17714,3575872214,3575872214,0
1,865,17715,3575872214,3575872216,2
1,865,17716,3575872214,3575872216,2
1,865,17717,3575872214,3575872216,2
1,865,17718,3575872214,3575872217,3
1,865,17719,3575872214,3575872217,3
1,865,17720,3575872214,3575872217,3
1,865,17721,3575872214,3575872218,4
1,865,17722,3575872214,3575872218,4
1,865,17723,3575872214,3575872219,5
1,865,17724,3575872214,3575872220,6
1,865,17725,3575872214,3575872220,6
1,865,17726,3575872214,3575872221,7
1,865,17727,3575872214,3575872221,7
1,865,17728,3575872214,3575872222,8
1,865,17729,3575872214,3575872222,8
1,865,17730,3575872214,3575872223,9
1,865,17731,3575872214,3575872223,9
1,865,17732,3575872214,3575872223,9
1,865,17733,3575872214,3575872224,10
1,865,17734,3575872214,3575872226,12
1,865,17735,3575872214,3575872226,12
1,865,17736,3575872214,3575872227,13
1,865,17737,3575872214,3575872227,13
1,865,17738,3575872214,3575872229,15
1,865,17739,3575872214,3575872229,15
1,865,17740,3575872214,3575872230,16
1,865,17741,3575872214,3575872231,17
1,865,17742,3575872214,3575872232,18
1,865,17743,3575872214,3575872232,18
1,865,17744,3575872214,3575872233,19
1,865,17745,3575872214,3575872233,19
1,865,17746,3575872214,3575872233,19
1,865,17747,3575872214,3575872234,20
1,865,17748,3575872214,3575872234,20
1,865,17749,3575872214,3575872234,20
1,865,17750,3575872214,3575872235,21
1,865,17751,3575872214,3575872236,22
1,865,17752,3575872214,3575872238,24
1,865,17753,3575872214,3575872241,27
1,865,17754,3575872214,3575872244,30
1,865,17755,3575872214,3575872246,32
1,865,17756,3575872214,3575872246,32
1,865,17757,3575872214,3575872246,32
1,865,17758,3575872214,3575872246,32
1,865,17759,3575872214,3575872246,32
1,865,17760,3575872214,3575872246,32
1,865,17761,3575872214,3575872247,33
1,865,17762,3575872214,3575872248,34
1,865,17763,3575872214,3575872249,35
1,865,17764,3575872214,3575872251,37
1,865,17765,3575872214,3575872252,38
1,865,17766,3575872214,3575872252,38
1,865,17767,3575872214,3575872253,39
1,865,17768,3575872214,3575872253,39
1,865,17769,3575872214,3575872256,42
1,865,17770,3575872214,3575872256,42
1,865,17771,3575872214,3575872258,44
1,865,17772,3575872214,3575872258,44
1,865,17773,3575872214,3575872258,44
1,865,17774,3575872214,3575872261,47
1,865,17775,3575872214,3575872262,48
1,865,17776,3575872214,3575872262,48
1,865,17777,3575872214,3575872264,50
1,866,17778,3575872274,3575872274,0
1,866,17779,3575872274,3575872274,0
1,866,17780,3575872274,3575872274,0
1,866,17781,3575872274,3575872274,0
1,866,17782,3575872274,3575872274,0
1,866,17783,3575872274,3575872275,1
1,866,17784,3575872274,3575872277,3
1,866,17785,3575872274,3575872280,6
1,866,17786,3575872274,3575872285,11
1,866,17787,3575872274,3575872286,12
1,866,17788,3575872274,3575872287,13
1,866,17789,3575872274,3575872288,14
1,866,17790,3575872274,3575872295,21
1,866,17791,3575872274,3575872295,21
1,866,17792,3575872274,3575872296,22
1,866,17793,3575872274,3575872299,25
1,866,17794,3575872274,3575872299,25
1,866,17795,3575872274,3575872300,26
1,866,17796,3575872274,3575872301,27
1,866,17797,3575872274,3575872303,29
1,866,17798,3575872274,3575872304,30
1,866,17799,3575872274,3575872305,31
1,866,17800,3575872274,3575872308,34
1,866,17801,3575872274,3575872310,36
1,866,17802,3575872274,3575872311,37
1,866,17803,3575872274,3575872312,38
1,866,17804,3575872274,3575872314,40
1,866,17805,3575872274,3575872315,41
1,866,17806,3575872274,3575872316,42
1,866,17807,3575872274,3575872316,42
1,866,17808,3575872274,3575872321,47
1,866,17809,3575872274,3575872323,49
1,866,17810,3575872274,3575872324,50
1,867,17811,3575872337,3575872338,1
1,867,17812,3575872337,3575872338,1
1,867,17813,3575872337,3575872338,1
1,867,17814,3575872337,3575872338,1
1,867,17815,3575872337,3575872338,1
1,867,17816,3575872337,3575872338,1
1,867,17817,3575872337,3575872338,1
1,867,17818,3575872337,3575872338,1
1,867,17819,3575872337,3575872338,1
1,867,17820,3575872337,3575872338,1
1,867,17821,3575872337,3575872338,1
1,867,17822,3575872337,3575872338,1
1,867,17823,3575872337,3575872339,2
1,867,17824,3575872337,3575872339,2
1,867,17825,3575872337,3575872340,3
1,867,17826,3575872337,3575872340,3
1,867,17827,3575872337,3575872344,7
1,867,17828,3575872337,3575872347,10
1,867,17829,3575872337,3575872347,10
1,867,17830,3575872337,3575872348,11
1,867,17831,3575872337,3575872350,13
1,867,17832,3575872337,3575872350,13
1,867,17833,3575872337,3575872353,16
1,867,17834,3575872337,3575872353,16
1,867,17835,3575872337,3575872354,17
1,867,17836,3575872337,3575872355,18
1,867,17837,3575872337,3575872356,19
1,867,17838,3575872337,3575872357,20
1,867,17839,3575872337,3575872360,23
1,867,17840,3575872337,3575872361,24
1,867,17841,3575872337,3575872362,25
1,867,17842,3575872337,3575872363,26
1,867,17843,3575872337,3575872363,26
1,867,17844,3575872337,3575872364,27
1,867,17845,3575872337,3575872364,27
1,867,17846,3575872337,3575872365,28
1,867,17847,3575872337,3575872365,28
1,867,17848,3575872337,3575872368,31
1,867,17849,3575872337,3575872369,32
1,867,17850,3575872337,3575872370,33
1,867,17851,3575872337,3575872375,38
1,867,17852,3575872337,3575872375,38
1,867,17853,3575872337,3575872375,38
1,867,17854,3575872337,3575872376,39
1,867,17855,3575872337,3575872379,42
1,867,17856,3575872337,3575872379,42
1,867,17857,3575872337,3575872379,42
1,867,17858,3575872337,3575872379,42
1,867,17859,3575872337,3575872379,42
1,867,17860,3575872337,3575872381,44
1,867,17861,3575872337,3575872382,45
1,867,17862,3575872337,3575872382,45
1,867,17863,3575872337,3575872382,45
1,867,17864,3575872337,3575872384,47
1,867,17865,3575872337,3575872385,48
1,867,17866,3575872337,3575872385,48
1,867,17867,3575872337,3575872386,49
1,868,17868,3575872398,3575872398,0
1,868,17869,3575872398,3575872398,0
1,868,17870,3575872398,3575872398,0
1,868,17871,3575872398,3575872398,0
1,868,17872,3575872398,3575872398,0
1,868,17873,3575872398,3575872398,0
1,868,17874,3575872398,3575872398,0
1,868,17875,3575872398,3575872399,1
1,868,17876,3575872398,3575872400,2
1,868,17877,3575872398,3575872400,2
1,868,17878,3575872398,3575872402,4
1,868,17879,3575872398,3575872402,4
1,868,17880,3575872398,3575872403,5
1,868,17881,3575872398,3575872408,10
1,868,17882,3575872398,3575872409,11
1,868,17883,3575872398,3575872411,13
1,868,17884,3575872398,3575872413,15
1,868,17885,3575872398,3575872414,16
1,868,17886,3575872398,3575872414,16
1,868,17887,3575872398,3575872414,16
1,868,17888,3575872398,3575872416,18
1,868,17889,3575872398,3575872416,18
1,868,17890,3575872398,3575872417,19
1,868,17891,3575872398,3575872417,19
1,868,17892,3575872398,3575872418,20
1,868,17893,3575872398,3575872418,20
1,868,17894,3575872398,3575872418,20
1,868,17895,3575872398,3575872418,20
1,868,17896,3575872398,3575872420,22
1,868,17897,3575872398,3575872420,22
1,868,17898,3575872398,3575872422,24
1,868,17899,3575872398,3575872422,24
1,868,17900,3575872398,3575872422,24
1,868,17901,3575872398,3575872422,24
1,868,17902,3575872398,3575872423,25
1,868,17903,3575872398,3575872424,26
1,868,17904,3575872398,3575872424,26
1,868,17905,3575872398,3575872426,28
1,868,17906,3575872398,3575872426,28
1,868,17907,3575872398,3575872427,29
1,868,17908,3575872398,3575872428,30
1,868,17909,3575872398,3575872428,30
1,868,17910,3575872398,3575872430,32
1,868,17911,3575872398,3575872431,33
1,868,17912,3575872398,3575872431,33
1,868,17913,3575872398,3575872432,34
1,868,17914,3575872398,3575872433,35
1,868,17915,3575872398,3575872434,36
1,868,17916,3575872398,3575872434,36
1,868,17917,3575872398,3575872434,36
1,868,17918,3575872398,3575872434,36
1,868,17919,3575872398,3575872434,36
1,868,17920,3575872398,3575872435,37
1,868,17921,3575872398,3575872436,38
1,868,17922,3575872398,3575872439,41
1,868,17923,3575872398,3575872445,47
1,868,17924,3575872398,3575872445,47
1,868,17925,3575872398,3575872445,47
1,868,17926,3575872398,3575872445,47
1,868,17927,3575872398,3575872446,48
1,868,17928,3575872398,3575872446,48
1,868,17929,3575872398,3575872446,48
1,868,17930,3575872398,3575872446,48
1,868,17931,3575872398,3575872448,50
1,869,17932,3575872460,3575872460,0
1,869,17933,3575872460,3575872460,0
1,869,17934,3575872460,3575872460,0
1,869,17935,3575872460,3575872460,0
1,869,17936,3575872460,3575872460,0
1,869,17937,3575872460,3575872460,0
1,869,17938,3575872460,3575872460,0
1,869,17939,3575872460,3575872460,0
1,869,17940,3575872460,3575872460,0
1,869,17941,3575872460,3575872460,0
1,869,17942,3575872460,3575872460,0
1,869,17943,3575872460,3575872462,2
1,869,17944,3575872460,3575872463,3
1,869,17945,3575872460,3575872464,4
1,869,17946,3575872460,3575872466,6
1,869,17947,3575872460,3575872466,6
1,869,17948,3575872460,3575872469,9
1,869,17949,3575872460,3575872469,9
1,869,17950,3575872460,3575872470,10
1,869,17951,3575872460,3575872475,15
1,869,17952,3575872460,3575872475,15
1,869,17953,3575872460,3575872477,17
1,869,17954,3575872460,3575872480,20
1,869,17955,3575872460,3575872482,22
1,869,17956,3575872460,3575872485,25
1,869,17957,3575872460,3575872486,26
1,869,17958,3575872460,3575872488,28
1,869,17959,3575872460,3575872488,28
1,869,17960,3575872460,3575872495,35
1,869,17961,3575872460,3575872495,35
1,869,17962,3575872460,3575872496,36
1,869,17963,3575872460,3575872497,37
1,869,17964,3575872460,3575872499,39
1,869,17965,3575872460,3575872500,40
1,869,17966,3575872460,3575872500,40
1,869,17967,3575872460,3575872501,41
1,869,17968,3575872460,3575872504,44
1,869,17969,3575872460,3575872505,45
1,869,17970,3575872460,3575872506,46
1,869,17971,3575872460,3575872506,46
1,869,17972,3575872460,3575872508,48
1,870,17973,3575872519,3575872519,0
1,870,17974,3575872519,3575872520,1
1,870,17975,3575872519,3575872520,1
1,870,17976,3575872519,3575872520,1
1,870,17977,3575872519,3575872520,1
1,870,17978,3575872519,3575872520,1
1,870,17979,3575872519,3575872520,1
1,870,17980,3575872519,3575872521,2
1,870,17981,3575872519,3575872522,3
1,870,17982,3575872519,3575872523,4
1,870,17983,3575872519,3575872524,5
1,870,17984,3575872519,3575872526,7
1,870,17985,3575872519,3575872526,7
1,870,17986,3575872519,3575872527,8
1,870,17987,3575872519,3575872529,10
1,870,17988,3575872519,3575872530,11
1,870,17989,3575872519,3575872531,12
1,870,17990,3575872519,3575872532,13
1,870,17991,3575872519,3575872533,14
1,870,17992,3575872519,3575872534,15
1,870,17993,3575872519,3575872535,16
1,870,17994,3575872519,3575872535,16
1,870,17995,3575872519,3575872538,19
1,870,17996,3575872519,3575872539,20
1,870,17997,3575872519,3575872539,20
1,870,17998,3575872519,3575872540,21
1,870,17999,3575872519,3575872543,24
1,870,18000,3575872519,3575872545,26
1,870,18001,3575872519,3575872546,27
1,870,18002,3575872519,3575872547,28
1,870,18003,3575872519,3575872550,31
1,870,18004,3575872519,3575872550,31
1,870,18005,3575872519,3575872551,32
1,870,18006,3575872519,3575872553,34
1,870,18007,3575872519,3575872554,35
1,870,18008,3575872519,3575872554,35
1,870,18009,3575872519,3575872554,35
1,870,18010,3575872519,3575872555,36
1,870,18011,3575872519,3575872559,40
1,870,18012,3575872519,3575872560,41
1,870,18013,3575872519,3575872561,42
1,870,18014,3575872519,3575872561,42
1,870,18015,3575872519,3575872562,43
1,870,18016,3575872519,3575872562,43
1,870,18017,3575872519,3575872563,44
1,870,18018,3575872519,3575872564,45
1,870,18019,3575872519,3575872564,45
1,870,18020,3575872519,3575872567,48
1,870,18021,3575872519,3575872568,49
1,870,18022,3575872519,3575872569,50
1,871,18023,3575872581,3575872581,0
1,871,18024,3575872581,3575872581,0
1,871,18025,3575872581,3575872581,0
1,871,18026,3575872581,3575872581,0
1,871,18027,3575872581,3575872581,0
1,871,18028,3575872581,3575872581,0
1,871,18029,3575872581,3575872581,0
1,871,18030,3575872581,3575872581,0
1,871,18031,3575872581,3575872581,0
1,871,18032,3575872581,3575872581,0
1,871,18033,3575872581,3575872581,0
1,871,18034,3575872581,3575872581,0
1,871,18035,3575872581,3575872581,0
1,871,18036,3575872581,3575872582,1
1,871,18037,3575872581,3575872584,3
1,871,18038,3575872581,3575872584,3
1,871,18039,3575872581,3575872584,3
1,871,18040,3575872581,3575872584,3
1,871,18041,3575872581,3575872586,5
1,871,18042,3575872581,3575872586,5
1,871,18043,3575872581,3575872587,6
1,871,18044,3575872581,3575872587,6
1,871,18045,3575872581,3575872588,7
1,871,18046,3575872581,3575872589,8
1,871,18047,3575872581,3575872591,10
1,871,18048,3575872581,3575872591,10
1,871,18049,3575872581,3575872592,11
1,871,18050,3575872581,3575872598,17
1,871,18051,3575872581,3575872599,18
1,871,18052,3575872581,3575872599,18
1,871,18053,3575872581,3575872600,19
1,871,18054,3575872581,3575872600,19
1,871,18055,3575872581,3575872601,20
1,871,18056,3575872581,3575872603,22
1,871,18057,3575872581,3575872607,26
1,871,18058,3575872581,3575872607,26
1,871,18059,3575872581,3575872607,26
1,871,18060,3575872581,3575872610,29
1,871,18061,3575872581,3575872612,31
1,871,18062,3575872581,3575872612,31
1,871,18063,3575872581,3575872613,32
1,871,18064,3575872581,3575872613,32
1,871,18065,3575872581,3575872614,33
1,871,18066,3575872581,3575872615,34
1,871,18067,3575872581,3575872615,34
1,871,18068,3575872581,3575872616,35
1,871,18069,3575872581,3575872616,35
1,871,18070,3575872581,3575872617,36
1,871,18071,3575872581,3575872617,36
1,871,18072,3575872581,3575872617,36
1,871,18073,3575872581,3575872617,36
1,871,18074,3575872581,3575872618,37
1,871,18075,3575872581,3575872618,37
1,871,18076,3575872581,3575872619,38
1,871,18077,3575872581,3575872621,40
1,871,18078,3575872581,3575872621,40
1,871,18079,3575872581,3575872621,40
1,871,18080,3575872581,3575872622,41
1,871,18081,3575872581,3575872623,42
1,871,18082,3575872581,3575872624,43
1,871,18083,3575872581,3575872625,44
1,871,18084,3575872581,3575872625,44
1,871,18085,3575872581,3575872627,46
1,871,18086,3575872581,3575872628,47
1,871,18087,3575872581,3575872629,48
1,871,18088,3575872581,3575872630,49
1,871,18089,3575872581,3575872631,50
1,872,18090,3575872641,3575872641,0
1,872,18091,3575872641,3575872641,0
1,872,18092,3575872641,3575872641,0
1,872,18093,3575872641,3575872641,0
1,872,18094,3575872641,3575872641,0
1,872,18095,3575872641,3575872641,0
1,872,18096,3575872641,3575872641,0
1,872,18097,3575872641,3575872641,0
1,872,18098,3575872641,3575872641,0
1,872,18099,3575872641,3575872641,0
1,872,18100,3575872641,3575872641,0
1,872,18101,3575872641,3575872644,3
1,872,18102,3575872641,3575872644,3
1,872,18103,3575872641,3575872644,3
1,872,18104,3575872641,3575872645,4
1,872,18105,3575872641,3575872645,4
1,872,18106,3575872641,3575872645,4
1,872,18107,3575872641,3575872648,7
1,872,18108,3575872641,3575872648,7
1,872,18109,3575872641,3575872648,7
1,872,18110,3575872641,3575872650,9
1,872,18111,3575872641,3575872651,10
1,872,18112,3575872641,3575872651,10
1,872,18113,3575872641,3575872652,11
1,872,18114,3575872641,3575872655,14
1,872,18115,3575872641,3575872657,16
1,872,18116,3575872641,3575872657,16
1,872,18117,3575872641,3575872657,16
1,872,18118,3575872641,3575872658,17
1,872,18119,3575872641,3575872660,19
1,872,18120,3575872641,3575872662,21
1,872,18121,3575872641,3575872662,21
1,872,18122,3575872641,3575872664,23
1,872,18123,3575872641,3575872665,24
1,872,18124,3575872641,3575872666,25
1,872,18125,3575872641,3575872667,26
1,872,18126,3575872641,3575872667,26
1,872,18127,3575872641,3575872668,27
1,872,18128,3575872641,3575872668,27
1,872,18129,3575872641,3575872669,28
1,872,18130,3575872641,3575872674,33
1,872,18131,3575872641,3575872676,35
1,872,18132,3575872641,3575872678,37
1,872,18133,3575872641,3575872682,41
1,872,18134,3575872641,3575872683,42
1,872,18135,3575872641,3575872685,44
1,872,18136,3575872641,3575872686,45
1,872,18137,3575872641,3575872688,47
1,872,18138,3575872641,3575872688,47
1,873,18139,3575872704,3575872704,0
1,873,18140,3575872704,3575872704,0
1,873,18141,3575872704,3575872704,0
1,873,18142,3575872704,3575872704,0
1,873,18143,3575872704,3575872704,0
1,873,18144,3575872704,3575872704,0
1,873,18145,3575872704,3575872704,0
1,873,18146,3575872704,3575872704,0
1,873,18147,3575872704,3575872705,1
1,873,18148,3575872704,3575872706,2
1,873,18149,3575872704,3575872706,2
1,873,18150,3575872704,3575872706,2
1,873,18151,3575872704,3575872709,5
1,873,18152,3575872704,3575872710,6
1,873,18153,3575872704,3575872711,7
1,873,18154,3575872704,3575872712,8
1,873,18155,3575872704,3575872712,8
1,873,18156,3575872704,3575872714,10
1,873,18157,3575872704,3575872715,11
1,873,18158,3575872704,3575872716,12
1,873,18159,3575872704,3575872716,12
1,873,18160,3575872704,3575872721,17
1,873,18161,3575872704,3575872723,19
1,873,18162,3575872704,3575872724,20
1,873,18163,3575872704,3575872725,21
1,873,18164,3575872704,3575872725,21
1,873,18165,3575872704,3575872728,24
1,873,18166,3575872704,3575872729,25
1,873,18167,3575872704,3575872730,26
1,873,18168,3575872704,3575872730,26
1,873,18169,3575872704,3575872733,29
1,873,18170,3575872704,3575872733,29
1,873,18171,3575872704,3575872734,30
1,873,18172,3575872704,3575872734,30
1,873,18173,3575872704,3575872735,31
1,873,18174,3575872704,3575872737,33
1,873,18175,3575872704,3575872739,35
1,873,18176,3575872704,3575872739,35
1,873,18177,3575872704,3575872740,36
1,873,18178,3575872704,3575872743,39
1,873,18179,3575872704,3575872746,42
1,873,18180,3575872704,3575872746,42
1,873,18181,3575872704,3575872747,43
1,873,18182,3575872704,3575872750,46
1,873,18183,3575872704,3575872750,46
1,873,18184,3575872704,3575872752,48
1,873,18185,3575872704,3575872753,49
1,873,18186,3575872704,3575872754,50
1,874,18187,3575872765,3575872765,0
1,874,18188,3575872765,3575872765,0
1,874,18189,3575872765,3575872765,0
1,874,18190,3575872765,3575872765,0
1,874,18191,3575872765,3575872765,0
1,874,18192,3575872765,3575872765,0
1,874,18193,3575872765,3575872765,0
1,874,18194,3575872765,3575872765,0
1,874,18195,3575872765,3575872765,0
1,874,18196,3575872765,3575872765,0
1,874,18197,3575872765,3575872765,0
1,874,18198,3575872765,3575872765,0
1,874,18199,3575872765,3575872765,0
1,874,18200,3575872765,3575872765,0
1,874,18201,3575872765,3575872768,3
1,874,18202,3575872765,3575872769,4
1,874,18203,3575872765,3575872769,4
1,874,18204,3575872765,3575872774,9
1,874,18205,3575872765,3575872775,10
1,874,18206,3575872765,3575872775,10
1,874,18207,3575872765,3575872776,11
1,874,18208,3575872765,3575872778,13
1,874,18209,3575872765,3575872778,13
1,874,18210,3575872765,3575872778,13
1,874,18211,3575872765,3575872779,14
1,874,18212,3575872765,3575872779,14
1,874,18213,3575872765,3575872779,14
1,874,18214,3575872765,3575872780,15
1,874,18215,3575872765,3575872781,16
1,874,18216,3575872765,3575872781,16
1,874,18217,3575872765,3575872782,17
1,874,18218,3575872765,3575872783,18
1,874,18219,3575872765,3575872783,18
1,874,18220,3575872765,3575872785,20
1,874,18221,3575872765,3575872786,21
1,874,18222,3575872765,3575872786,21
1,874,18223,3575872765,3575872787,22
1,874,18224,3575872765,3575872787,22
1,874,18225,3575872765,3575872788,23
1,874,18226,3575872765,3575872789,24
1,874,18227,3575872765,3575872791,26
1,874,18228,3575872765,3575872793,28
1,874,18229,3575872765,3575872798,33
1,874,18230,3575872765,3575872799,34
1,874,18231,3575872765,3575872800,35
1,874,18232,3575872765,3575872800,35
1,874,18233,3575872765,3575872801,36
1,874,18234,3575872765,3575872801,36
1,874,18235,3575872765,3575872801,36
1,874,18236,3575872765,3575872804,39
1,874,18237,3575872765,3575872805,40
1,874,18238,3575872765,3575872807,42
1,874,18239,3575872765,3575872808,43
1,874,18240,3575872765,3575872810,45
1,874,18241,3575872765,3575872812,47
1,874,18242,3575872765,3575872813,48
1,874,18243,3575872765,3575872814,49
1,874,18244,3575872765,3575872814,49
1,874,18245,3575872765,3575872814,49
1,875,18246,3575872824,3575872824,0
1,875,18247,3575872824,3575872824,0
1,875,18248,3575872824,3575872824,0
1,875,18249,3575872824,3575872824,0
1,875,18250,3575872824,3575872824,0
1,875,18251,3575872824,3575872824,0
1,875,18252,3575872824,3575872825,1
1,875,18253,3575872824,3575872825,1
1,875,18254,3575872824,3575872825,1
1,875,18255,3575872824,3575872825,1
1,875,18256,3575872824,3575872825,1
1,875,18257,3575872824,3575872825,1
1,875,18258,3575872824,3575872825,1
1,875,18259,3575872824,3575872825,1
1,875,18260,3575872824,3575872825,1
1,875,18261,3575872824,3575872825,1
1,875,18262,3575872824,3575872826,2
1,875,18263,3575872824,3575872826,2
1,875,18264,3575872824,3575872826,2
1,875,18265,3575872824,3575872828,4
1,875,18266,3575872824,3575872828,4
1,875,18267,3575872824,3575872829,5
1,875,18268,3575872824,3575872830,6
1,875,18269,3575872824,3575872830,6
1,875,18270,3575872824,3575872830,6
1,875,18271,3575872824,3575872832,8
1,875,18272,3575872824,3575872832,8
1,875,18273,3575872824,3575872833,9
1,875,18274,3575872824,3575872833,9
1,875,18275,3575872824,3575872833,9
1,875,18276,3575872824,3575872833,9
1,875,18277,3575872824,3575872834,10
1,875,18278,3575872824,3575872835,11
1,875,18279,3575872824,3575872835,11
1,875,18280,3575872824,3575872839,15
1,875,18281,3575872824,3575872841,17
1,875,18282,3575872824,3575872843,19
1,875,18283,3575872824,3575872844,20
1,875,18284,3575872824,3575872844,20
1,875,18285,3575872824,3575872844,20
1,875,18286,3575872824,3575872845,21
1,875,18287,3575872824,3575872845,21
1,875,18288,3575872824,3575872845,21
1,875,18289,3575872824,3575872845,21
1,875,18290,3575872824,3575872847,23
1,875,18291,3575872824,3575872848,24
1,875,18292,3575872824,3575872849,25
1,875,18293,3575872824,3575872850,26
1,875,18294,3575872824,3575872851,27
1,875,18295,3575872824,3575872852,28
1,875,18296,3575872824,3575872853,29
1,875,18297,3575872824,3575872855,31
1,875,18298,3575872824,3575872857,33
1,875,18299,3575872824,3575872857,33
1,875,18300,3575872824,3575872858,34
1,875,18301,3575872824,3575872858,34
1,875,18302,3575872824,3575872860,36
1,875,18303,3575872824,3575872861,37
1,875,18304,3575872824,3575872863,39
1,875,18305,3575872824,3575872863,39
1,875,18306,3575872824,3575872865,41
1,875,18307,3575872824,3575872868,44
1,875,18308,3575872824,3575872868,44
1,875,18309,3575872824,3575872869,45
1,876,18310,3575872881,3575872881,0
1,876,18311,3575872881,3575872881,0
1,876,18312,3575872881,3575872881,0
1,876,18313,3575872881,3575872881,0
1,876,18314,3575872881,3575872882,1
1,876,18315,3575872881,3575872884,3
1,876,18316,3575872881,3575872885,4
1,876,18317,3575872881,3575872887,6
1,876,18318,3575872881,3575872887,6
1,876,18319,3575872881,3575872888,7
1,876,18320,3575872881,3575872895,14
1,876,18321,3575872881,3575872896,15
1,876,18322,3575872881,3575872896,15
1,876,18323,3575872881,3575872898,17
1,876,18324,3575872881,3575872899,18
1,876,18325,3575872881,3575872901,20
1,876,18326,3575872881,3575872902,21
1,876,18327,3575872881,3575872902,21
1,876,18328,3575872881,3575872904,23
1,876,18329,3575872881,3575872905,24
1,876,18330,3575872881,3575872905,24
1,876,18331,3575872881,3575872906,25
1,876,18332,3575872881,3575872906,25
1,876,18333,3575872881,3575872910,29
1,876,18334,3575872881,3575872911,30
1,876,18335,3575872881,3575872912,31
1,876,18336,3575872881,3575872913,32
1,876,18337,3575872881,3575872914,33
1,876,18338,3575872881,3575872915,34
1,876,18339,3575872881,3575872916,35
1,876,18340,3575872881,3575872916,35
1,876,18341,3575872881,3575872921,40
1,876,18342,3575872881,3575872923,42
1,876,18343,3575872881,3575872923,42
1,876,18344,3575872881,3575872926,45
1,876,18345,3575872881,3575872926,45
1,876,18346,3575872881,3575872927,46
1,876,18347,3575872881,3575872930,49
1,876,18348,3575872881,3575872930,49
1,876,18349,3575872881,3575872931,50
1,877,18350,3575872938,3575872938,0
1,877,18351,3575872938,3575872938,0
1,877,18352,3575872938,3575872938,0
1,877,18353,3575872938,3575872938,0
1,877,18354,3575872938,3575872938,0
1,877,18355,3575872938,3575872938,0
1,877,18356,3575872938,3575872938,0
1,877,18357,3575872938,3575872938,0
1,877,18358,3575872938,3575872939,1
1,877,18359,3575872938,3575872940,2
1,877,18360,3575872938,3575872940,2
1,877,18361,3575872938,3575872941,3
1,877,18362,3575872938,3575872943,5
1,877,18363,3575872938,3575872944,6
1,877,18364,3575872938,3575872946,8
1,877,18365,3575872938,3575872947,9
1,877,18366,3575872938,3575872948,10
1,877,18367,3575872938,3575872950,12
1,877,18368,3575872938,3575872950,12
1,877,18369,3575872938,3575872951,13
1,877,18370,3575872938,3575872952,14
1,877,18371,3575872938,3575872954,16
1,877,18372,3575872938,3575872955,17
1,877,18373,3575872938,3575872956,18
1,877,18374,3575872938,3575872956,18
1,877,18375,3575872938,3575872957,19
1,877,18376,3575872938,3575872960,22
1,877,18377,3575872938,3575872960,22
1,877,18378,3575872938,3575872960,22
1,877,18379,3575872938,3575872962,24
1,877,18380,3575872938,3575872962,24
1,877,18381,3575872938,3575872964,26
1,877,18382,3575872938,3575872965,27
1,877,18383,3575872938,3575872965,27
1,877,18384,3575872938,3575872965,27
1,877,18385,3575872938,3575872969,31
1,877,18386,3575872938,3575872970,32
1,877,18387,3575872938,3575872974,36
1,877,18388,3575872938,3575872974,36
1,877,18389,3575872938,3575872975,37
1,877,18390,3575872938,3575872976,38
1,877,18391,3575872938,3575872978,40
1,877,18392,3575872938,3575872978,40
1,877,18393,3575872938,3575872978,40
1,877,18394,3575872938,3575872978,40
1,877,18395,3575872938,3575872979,41
1,877,18396,3575872938,3575872980,42
1,877,18397,3575872938,3575872981,43
1,877,18398,3575872938,3575872981,43
1,877,18399,3575872938,3575872981,43
1,877,18400,3575872938,3575872983,45
1,877,18401,3575872938,3575872983,45
1,877,18402,3575872938,3575872984,46
1,877,18403,3575872938,3575872985,47
1,877,18404,3575872938,3575872986,48
1,877,18405,3575872938,3575872986,48
1,877,18406,3575872938,3575872986,48
1,877,18407,3575872938,3575872988,50
1,878,18408,3575872996,3575872996,0
1,878,18409,3575872996,3575872996,0
1,878,18410,3575872996,3575872996,0
1,878,18411,3575872996,3575872996,0
1,878,18412,3575872996,3575872996,0
1,878,18413,3575872996,3575872996,0
1,878,18414,3575872996,3575872996,0
1,878,18415,3575872996,3575872999,3
1,878,18416,3575872996,3575872999,3
1,878,18417,3575872996,3575873000,4
1,878,18418,3575872996,3575873000,4
1,878,18419,3575872996,3575873000,4
1,878,18420,3575872996,3575873001,5
1,878,18421,3575872996,3575873004,8
1,878,18422,3575872996,3575873005,9
1,878,18423,3575872996,3575873007,11
1,878,18424,3575872996,3575873007,11
1,878,18425,3575872996,3575873008,12
1,878,18426,3575872996,3575873010,14
1,878,18427,3575872996,3575873013,17
1,878,18428,3575872996,3575873013,17
1,878,18429,3575872996,3575873014,18
1,878,18430,3575872996,3575873014,18
1,878,18431,3575872996,3575873014,18
1,878,18432,3575872996,3575873015,19
1,878,18433,3575872996,3575873016,20
1,878,18434,3575872996,3575873016,20
1,878,18435,3575872996,3575873017,21
1,878,18436,3575872996,3575873018,22
1,878,18437,3575872996,3575873018,22
1,878,18438,3575872996,3575873018,22
1,878,18439,3575872996,3575873019,23
1,878,18440,3575872996,3575873019,23
1,878,18441,3575872996,3575873020,24
1,878,18442,3575872996,3575873021,25
1,878,18443,3575872996,3575873021,25
1,878,18444,3575872996,3575873023,27
1,878,18445,3575872996,3575873023,27
1,878,18446,3575872996,3575873026,30
1,878,18447,3575872996,3575873027,31
1,878,18448,3575872996,3575873028,32
1,878,18449,3575872996,3575873029,33
1,878,18450,3575872996,3575873029,33
1,878,18451,3575872996,3575873030,34
1,878,18452,3575872996,3575873031,35
1,878,18453,3575872996,3575873032,36
1,878,18454,3575872996,3575873032,36
1,878,18455,3575872996,3575873033,37
1,878,18456,3575872996,3575873033,37
1,878,18457,3575872996,3575873034,38
1,878,18458,3575872996,3575873034,38
1,878,18459,3575872996,3575873034,38
1,878,18460,3575872996,3575873034,38
1,878,18461,3575872996,3575873035,39
1,878,18462,3575872996,3575873042,46
1,878,18463,3575872996,3575873044,48
1,878,18464,3575872996,3575873044,48
1,878,18465,3575872996,3575873044,48
1,878,18466,3575872996,3575873045,49
1,878,18467,3575872996,3575873045,49
1,878,18468,3575872996,3575873045,49
1,878,18469,3575872996,3575873045,49
1,878,18470,3575872996,3575873045,49
1,878,18471,3575872996,3575873046,50
1,879,18472,3575873058,3575873058,0
1,879,18473,3575873058,3575873058,0
1,879,18474,3575873058,3575873058,0
1,879,18475,3575873058,3575873058,0
1,879,18476,3575873058,3575873058,0
1,879,18477,3575873058,3575873058,0
1,879,18478,3575873058,3575873058,0
1,879,18479,3575873058,3575873058,0
1,879,18480,3575873058,3575873058,0
1,879,18481,3575873058,3575873058,0
1,879,18482,3575873058,3575873058,0
1,879,18483,3575873058,3575873058,0
1,879,18484,3575873058,3575873058,0
1,879,18485,3575873058,3575873061,3
1,879,18486,3575873058,3575873061,3
1,879,18487,3575873058,3575873063,5
1,879,18488,3575873058,3575873066,8
1,879,18489,3575873058,3575873067,9
1,879,18490,3575873058,3575873068,10
1,879,18491,3575873058,3575873069,11
1,879,18492,3575873058,3575873069,11
1,879,18493,3575873058,3575873075,17
1,879,18494,3575873058,3575873078,20
1,879,18495,3575873058,3575873079,21
1,879,18496,3575873058,3575873080,22
1,879,18497,3575873058,3575873081,23
1,879,18498,3575873058,3575873082,24
1,879,18499,3575873058,3575873084,26
1,879,18500,3575873058,3575873085,27
1,879,18501,3575873058,3575873089,31
1,879,18502,3575873058,3575873096,38
1,879,18503,3575873058,3575873096,38
1,879,18504,3575873058,3575873096,38
1,879,18505,3575873058,3575873097,39
1,879,18506,3575873058,3575873099,41
1,879,18507,3575873058,3575873101,43
1,879,18508,3575873058,3575873102,44
1,879,18509,3575873058,3575873103,45
1,879,18510,3575873058,3575873104,46
1,879,18511,3575873058,3575873105,47
1,879,18512,3575873058,3575873106,48
1,879,18513,3575873058,3575873106,48
1,879,18514,3575873058,3575873106,48
1,880,18515,3575873121,3575873121,0
1,880,18516,3575873121,3575873121,0
1,880,18517,3575873121,3575873121,0
1,880,18518,3575873121,3575873121,0
1,880,18519,3575873121,3575873121,0
1,880,18520,3575873121,3575873121,0
1,880,18521,3575873121,3575873121,0
1,880,18522,3575873121,3575873121,0
1,880,18523,3575873121,3575873121,0
1,880,18524,3575873121,3575873124,3
1,880,18525,3575873121,3575873124,3
1,880,18526,3575873121,3575873126,5
1,880,18527,3575873121,3575873127,6
1,880,18528,3575873121,3575873128,7
1,880,18529,3575873121,3575873130,9
1,880,18530,3575873121,3575873130,9
1,880,18531,3575873121,3575873130,9
1,880,18532,3575873121,3575873130,9
1,880,18533,3575873121,3575873132,11
1,880,18534,3575873121,3575873133,12
1,880,18535,3575873121,3575873135,14
1,880,18536,3575873121,3575873136,15
1,880,18537,3575873121,3575873136,15
1,880,18538,3575873121,3575873137,16
1,880,18539,3575873121,3575873138,17
1,880,18540,3575873121,3575873139,18
1,880,18541,3575873121,3575873140,19
1,880,18542,3575873121,3575873141,20
1,880,18543,3575873121,3575873141,20
1,880,18544,3575873121,3575873144,23
1,880,18545,3575873121,3575873144,23
1,880,18546,3575873121,3575873146,25
1,880,18547,3575873121,3575873147,26
1,880,18548,3575873121,3575873149,28
1,880,18549,3575873121,3575873150,29
1,880,18550,3575873121,3575873150,29
1,880,18551,3575873121,3575873151,30
1,880,18552,3575873121,3575873153,32
1,880,18553,3575873121,3575873154,33
1,880,18554,3575873121,3575873154,33
1,880,18555,3575873121,3575873155,34
1,880,18556,3575873121,3575873156,35
1,880,18557,3575873121,3575873157,36
1,880,18558,3575873121,3575873159,38
1,880,18559,3575873121,3575873160,39
1,880,18560,3575873121,3575873161,40
1,880,18561,3575873121,3575873163,42
1,880,18562,3575873121,3575873163,42
1,880,18563,3575873121,3575873163,42
1,880,18564,3575873121,3575873165,44
1,880,18565,3575873121,3575873165,44
1,880,18566,3575873121,3575873165,44
1,880,18567,3575873121,3575873169,48
1,880,18568,3575873121,3575873170,49
1,881,18569,3575873180,3575873180,0
1,881,18570,3575873180,3575873180,0
1,881,18571,3575873180,3575873180,0
1,881,18572,3575873180,3575873180,0
1,881,18573,3575873180,3575873180,0
1,881,18574,3575873180,3575873180,0
1,881,18575,3575873180,3575873180,0
1,881,18576,3575873180,3575873180,0
1,881,18577,3575873180,3575873180,0
1,881,18578,3575873180,3575873181,1
1,881,18579,3575873180,3575873181,1
1,881,18580,3575873180,3575873181,1
1,881,18581,3575873180,3575873182,2
1,881,18582,3575873180,3575873183,3
1,881,18583,3575873180,3575873183,3
1,881,18584,3575873180,3575873184,4
1,881,18585,3575873180,3575873185,5
1,881,18586,3575873180,3575873185,5
1,881,18587,3575873180,3575873187,7
1,881,18588,3575873180,3575873187,7
1,881,18589,3575873180,3575873188,8
1,881,18590,3575873180,3575873189,9
1,881,18591,3575873180,3575873191,11
1,881,18592,3575873180,3575873191,11
1,881,18593,3575873180,3575873191,11
1,881,18594,3575873180,3575873191,11
1,881,18595,3575873180,3575873193,13
1,881,18596,3575873180,3575873193,13
1,881,18597,3575873180,3575873197,17
1,881,18598,3575873180,3575873198,18
1,881,18599,3575873180,3575873199,19
1,881,18600,3575873180,3575873199,19
1,881,18601,3575873180,3575873200,20
1,881,18602,3575873180,3575873201,21
1,881,18603,3575873180,3575873201,21
1,881,18604,3575873180,3575873204,24
1,881,18605,3575873180,3575873206,26
1,881,18606,3575873180,3575873207,27
1,881,18607,3575873180,3575873209,29
1,881,18608,3575873180,3575873210,30
1,881,18609,3575873180,3575873213,33
1,881,18610,3575873180,3575873213,33
1,881,18611,3575873180,3575873214,34
1,881,18612,3575873180,3575873215,35
1,881,18613,3575873180,3575873215,35
1,881,18614,3575873180,3575873216,36
1,881,18615,3575873180,3575873217,37
1,881,18616,3575873180,3575873217,37
1,881,18617,3575873180,3575873218,38
1,881,18618,3575873180,3575873218,38
1,881,18619,3575873180,3575873218,38
1,881,18620,3575873180,3575873219,39
1,881,18621,3575873180,3575873219,39
1,881,18622,3575873180,3575873220,40
1,881,18623,3575873180,3575873221,41
1,881,18624,3575873180,3575873222,42
1,881,18625,3575873180,3575873223,43
1,881,18626,3575873180,3575873223,43
1,881,18627,3575873180,3575873223,43
1,881,18628,3575873180,3575873226,46
1,881,18629,3575873180,3575873228,48
1,881,18630,3575873180,3575873229,49
1,881,18631,3575873180,3575873229,49
1,882,18632,3575873241,3575873241,0
1,882,18633,3575873241,3575873241,0
1,882,18634,3575873241,3575873241,0
1,882,18635,3575873241,3575873241,0
1,882,18636,3575873241,3575873241,0
1,882,18637,3575873241,3575873241,0
1,882,18638,3575873241,3575873241,0
1,882,18639,3575873241,3575873241,0
1,882,18640,3575873241,3575873241,0
1,882,18641,3575873241,3575873241,0
1,882,18642,3575873241,3575873242,1
1,882,18643,3575873241,3575873244,3
1,882,18644,3575873241,3575873244,3
1,882,18645,3575873241,3575873244,3
1,882,18646,3575873241,3575873244,3
1,882,18647,3575873241,3575873245,4
1,882,18648,3575873241,3575873246,5
1,882,18649,3575873241,3575873246,5
1,882,18650,3575873241,3575873246,5
1,882,18651,3575873241,3575873250,9
1,882,18652,3575873241,3575873250,9
1,882,18653,3575873241,3575873251,10
1,882,18654,3575873241,3575873252,11
1,882,18655,3575873241,3575873253,12
1,882,18656,3575873241,3575873255,14
1,882,18657,3575873241,3575873256,15
1,882,18658,3575873241,3575873257,16
1,882,18659,3575873241,3575873259,18
1,882,18660,3575873241,3575873261,20
1,882,18661,3575873241,3575873261,20
1,882,18662,3575873241,3575873263,22
1,882,18663,3575873241,3575873267,26
1,882,18664,3575873241,3575873267,26
1,882,18665,3575873241,3575873268,27
1,882,18666,3575873241,3575873269,28
1,882,18667,3575873241,3575873269,28
1,882,18668,3575873241,3575873275,34
1,882,18669,3575873241,3575873277,36
1,882,18670,3575873241,3575873279,38
1,882,18671,3575873241,3575873280,39
1,882,18672,3575873241,3575873281,40
1,882,18673,3575873241,3575873282,41
1,882,18674,3575873241,3575873286,45
1,882,18675,3575873241,3575873286,45
1,882,18676,3575873241,3575873290,49
1,883,18677,3575873300,3575873300,0
1,883,18678,3575873300,3575873300,0
1,883,18679,3575873300,3575873300,0
1,883,18680,3575873300,3575873300,0
1,883,18681,3575873300,3575873300,0
1,883,18682,3575873300,3575873300,0
1,883,18683,3575873300,3575873301,1
1,883,18684,3575873300,3575873302,2
1,883,18685,3575873300,3575873303,3
1,883,18686,3575873300,3575873303,3
1,883,18687,3575873300,3575873305,5
1,883,18688,3575873300,3575873306,6
1,883,18689,3575873300,3575873311,11
1,883,18690,3575873300,3575873312,12
1,883,18691,3575873300,3575873312,12
1,883,18692,3575873300,3575873312,12
1,883,18693,3575873300,3575873313,13
1,883,18694,3575873300,3575873314,14
1,883,18695,3575873300,3575873315,15
1,883,18696,3575873300,3575873316,16
1,883,18697,3575873300,3575873317,17
1,883,18698,3575873300,3575873321,21
1,883,18699,3575873300,3575873322,22
1,883,18700,3575873300,3575873325,25
1,883,18701,3575873300,3575873325,25
1,883,18702,3575873300,3575873325,25
1,883,18703,3575873300,3575873327,27
1,883,18704,3575873300,3575873327,27
1,883,18705,3575873300,3575873331,31
1,883,18706,3575873300,3575873331,31
1,883,18707,3575873300,3575873333,33
1,883,18708,3575873300,3575873333,33
1,883,18709,3575873300,3575873334,34
1,883,18710,3575873300,3575873335,35
1,883,18711,3575873300,3575873336,36
1,883,18712,3575873300,3575873336,36
1,883,18713,3575873300,3575873338,38
1,883,18714,3575873300,3575873338,38
1,883,18715,3575873300,3575873340,40
1,883,18716,3575873300,3575873341,41
1,883,18717,3575873300,3575873341,41
1,883,18718,3575873300,3575873344,44
1,883,18719,3575873300,3575873344,44
1,883,18720,3575873300,3575873347,47
1,883,18721,3575873300,3575873347,47
1,883,18722,3575873300,3575873350,50
1,884,18723,3575873361,3575873361,0
1,884,18724,3575873361,3575873361,0
1,884,18725,3575873361,3575873361,0
1,884,18726,3575873361,3575873361,0
1,884,18727,3575873361,3575873361,0
1,884,18728,3575873361,3575873361,0
1,884,18729,3575873361,3575873361,0
1,884,18730,3575873361,3575873361,0
1,884,18731,3575873361,3575873361,0
1,884,18732,3575873361,3575873361,0
1,884,18733,3575873361,3575873361,0
1,884,18734,3575873361,3575873361,0
1,884,18735,3575873361,3575873361,0
1,884,18736,3575873361,3575873362,1
1,884,18737,3575873361,3575873363,2
1,884,18738,3575873361,3575873363,2
1,884,18739,3575873361,3575873365,4
1,884,18740,3575873361,3575873365,4
1,884,18741,3575873361,3575873365,4
1,884,18742,3575873361,3575873368,7
1,884,18743,3575873361,3575873369,8
1,884,18744,3575873361,3575873371,10
1,884,18745,3575873361,3575873375,14
1,884,18746,3575873361,3575873375,14
1,884,18747,3575873361,3575873375,14
1,884,18748,3575873361,3575873377,16
1,884,18749,3575873361,3575873378,17
1,884,18750,3575873361,3575873379,18
1,884,18751,3575873361,3575873379,18
1,884,18752,3575873361,3575873379,18
1,884,18753,3575873361,3575873381,20
1,884,18754,3575873361,3575873382,21
1,884,18755,3575873361,3575873382,21
1,884,18756,3575873361,3575873383,22
1,884,18757,3575873361,3575873383,22
1,884,18758,3575873361,3575873383,22
1,884,18759,3575873361,3575873385,24
1,884,18760,3575873361,3575873385,24
1,884,18761,3575873361,3575873386,25
1,884,18762,3575873361,3575873386,25
1,884,18763,3575873361,3575873387,26
1,884,18764,3575873361,3575873388,27
1,884,18765,3575873361,3575873390,29
1,884,18766,3575873361,3575873391,30
1,884,18767,3575873361,3575873391,30
1,884,18768,3575873361,3575873391,30
1,884,18769,3575873361,3575873393,32
1,884,18770,3575873361,3575873397,36
1,884,18771,3575873361,3575873398,37
1,884,18772,3575873361,3575873399,38
1,884,18773,3575873361,3575873399,38
1,884,18774,3575873361,3575873400,39
1,884,18775,3575873361,3575873400,39
1,884,18776,3575873361,3575873402,41
1,884,18777,3575873361,3575873403,42
1,884,18778,3575873361,3575873406,45
1,884,18779,3575873361,3575873407,46
1,884,18780,3575873361,3575873408,47
1,884,18781,3575873361,3575873409,48
1,884,18782,3575873361,3575873409,48
1,884,18783,3575873361,3575873410,49
1,885,18784,3575873422,3575873422,0
1,885,18785,3575873422,3575873422,0
1,885,18786,3575873422,3575873422,0
1,885,18787,3575873422,3575873422,0
1,885,18788,3575873422,3575873422,0
1,885,18789,3575873422,3575873422,0
1,885,18790,3575873422,3575873422,0
1,885,18791,3575873422,3575873422,0
1,885,18792,3575873422,3575873422,0
1,885,18793,3575873422,3575873422,0
1,885,18794,3575873422,3575873422,0
1,885,18795,3575873422,3575873422,0
1,885,18796,3575873422,3575873422,0
1,885,18797,3575873422,3575873422,0
1,885,18798,3575873422,3575873422,0
1,885,18799,3575873422,3575873422,0
1,885,18800,3575873422,3575873422,0
1,885,18801,3575873422,3575873422,0
1,885,18802,3575873422,3575873422,0
1,885,18803,3575873422,3575873423,1
1,885,18804,3575873422,3575873423,1
1,885,18805,3575873422,3575873424,2
1,885,18806,3575873422,3575873424,2
1,885,18807,3575873422,3575873424,2
1,885,18808,3575873422,3575873427,5
1,885,18809,3575873422,3575873429,7
1,885,18810,3575873422,3575873430,8
1,885,18811,3575873422,3575873431,9
1,885,18812,3575873422,3575873433,11
1,885,18813,3575873422,3575873434,12
1,885,18814,3575873422,3575873434,12
1,885,18815,3575873422,3575873434,12
1,885,18816,3575873422,3575873434,12
1,885,18817,3575873422,3575873435,13
1,885,18818,3575873422,3575873435,13
1,885,18819,3575873422,3575873436,14
1,885,18820,3575873422,3575873436,14
1,885,18821,3575873422,3575873440,18
1,885,18822,3575873422,3575873442,20
1,885,18823,3575873422,3575873444,22
1,885,18824,3575873422,3575873444,22
1,885,18825,3575873422,3575873445,23
1,885,18826,3575873422,3575873445,23
1,885,18827,3575873422,3575873445,23
1,885,18828,3575873422,3575873446,24
1,885,18829,3575873422,3575873446,24
1,885,18830,3575873422,3575873446,24
1,885,18831,3575873422,3575873447,25
1,885,18832,3575873422,3575873450,28
1,885,18833,3575873422,3575873450,28
1,885,18834,3575873422,3575873451,29
1,885,18835,3575873422,3575873453,31
1,885,18836,3575873422,3575873454,32
1,885,18837,3575873422,3575873456,34
1,885,18838,3575873422,3575873456,34
1,885,18839,3575873422,3575873457,35
1,885,18840,3575873422,3575873460,38
1,885,18841,3575873422,3575873461,39
1,885,18842,3575873422,3575873461,39
1,885,18843,3575873422,3575873463,41
1,885,18844,3575873422,3575873465,43
1,885,18845,3575873422,3575873466,44
1,885,18846,3575873422,3575873467,45
1,885,18847,3575873422,3575873467,45
1,885,18848,3575873422,3575873467,45
1,885,18849,3575873422,3575873468,46
1,885,18850,3575873422,3575873469,47
1,885,18851,3575873422,3575873469,47
1,886,18852,3575873483,3575873483,0
1,886,18853,3575873483,3575873483,0
1,886,18854,3575873483,3575873483,0
1,886,18855,3575873483,3575873483,0
1,886,18856,3575873483,3575873483,0
1,886,18857,3575873483,3575873483,0
1,886,18858,3575873483,3575873484,1
1,886,18859,3575873483,3575873485,2
1,886,18860,3575873483,3575873486,3
1,886,18861,3575873483,3575873489,6
1,886,18862,3575873483,3575873494,11
1,886,18863,3575873483,3575873495,12
1,886,18864,3575873483,3575873495,12
1,886,18865,3575873483,3575873497,14
1,886,18866,3575873483,3575873497,14
1,886,18867,3575873483,3575873498,15
1,886,18868,3575873483,3575873501,18
1,886,18869,3575873483,3575873501,18
1,886,18870,3575873483,3575873501,18
1,886,18871,3575873483,3575873502,19
1,886,18872,3575873483,3575873503,20
1,886,18873,3575873483,3575873504,21
1,886,18874,3575873483,3575873506,23
1,886,18875,3575873483,3575873510,27
1,886,18876,3575873483,3575873511,28
1,886,18877,3575873483,3575873512,29
1,886,18878,3575873483,3575873512,29
1,886,18879,3575873483,3575873512,29
1,886,18880,3575873483,3575873513,30
1,886,18881,3575873483,3575873514,31
1,886,18882,3575873483,3575873515,32
1,886,18883,3575873483,3575873516,33
1,886,18884,3575873483,3575873520,37
1,886,18885,3575873483,3575873521,38
1,886,18886,3575873483,3575873523,40
1,886,18887,3575873483,3575873525,42
1,886,18888,3575873483,3575873525,42
1,886,18889,3575873483,3575873526,43
1,886,18890,3575873483,3575873526,43
1,886,18891,3575873483,3575873529,46
1,886,18892,3575873483,3575873530,47
1,886,18893,3575873483,3575873532,49
1,886,18894,3575873483,3575873532,49
1,887,18895,3575873544,3575873544,0
1,887,18896,3575873544,3575873544,0
1,887,18897,3575873544,3575873544,0
1,887,18898,3575873544,3575873544,0
1,887,18899,3575873544,3575873544,0
1,887,18900,3575873544,3575873544,0
1,887,18901,3575873544,3575873544,0
1,887,18902,3575873544,3575873544,0
1,887,18903,3575873544,3575873544,0
1,887,18904,3575873544,3575873544,0
1,887,18905,3575873544,3575873544,0
1,887,18906,3575873544,3575873544,0
1,887,18907,3575873544,3575873546,2
1,887,18908,3575873544,3575873546,2
1,887,18909,3575873544,3575873548,4
1,887,18910,3575873544,3575873549,5
1,887,18911,3575873544,3575873549,5
1,887,18912,3575873544,3575873550,6
1,887,18913,3575873544,3575873552,8
1,887,18914,3575873544,3575873553,9
1,887,18915,3575873544,3575873554,10
1,887,18916,3575873544,3575873554,10
1,887,18917,3575873544,3575873556,12
1,887,18918,3575873544,3575873556,12
1,887,18919,3575873544,3575873556,12
1,887,18920,3575873544,3575873559,15
1,887,18921,3575873544,3575873560,16
1,887,18922,3575873544,3575873560,16
1,887,18923,3575873544,3575873562,18
1,887,18924,3575873544,3575873562,18
1,887,18925,3575873544,3575873562,18
1,887,18926,3575873544,3575873563,19
1,887,18927,3575873544,3575873564,20
1,887,18928,3575873544,3575873564,20
1,887,18929,3575873544,3575873568,24
1,887,18930,3575873544,3575873569,25
1,887,18931,3575873544,3575873570,26
1,887,18932,3575873544,3575873575,31
1,887,18933,3575873544,3575873575,31
1,887,18934,3575873544,3575873576,32
1,887,18935,3575873544,3575873578,34
1,887,18936,3575873544,3575873578,34
1,887,18937,3575873544,3575873578,34
1,887,18938,3575873544,3575873579,35
1,887,18939,3575873544,3575873580,36
1,887,18940,3575873544,3575873580,36
1,887,18941,3575873544,3575873581,37
1,887,18942,3575873544,3575873582,38
1,887,18943,3575873544,3575873582,38
1,887,18944,3575873544,3575873584,40
1,887,18945,3575873544,3575873584,40
1,887,18946,3575873544,3575873585,41
1,887,18947,3575873544,3575873586,42
1,887,18948,3575873544,3575873587,43
1,887,18949,3575873544,3575873589,45
1,887,18950,3575873544,3575873589,45
1,887,18951,3575873544,3575873590,46
1,887,18952,3575873544,3575873591,47
1,887,18953,3575873544,3575873592,48
1,888,18954,3575873605,3575873605,0
1,888,18955,3575873605,3575873605,0
1,888,18956,3575873605,3575873605,0
1,888,18957,3575873605,3575873605,0
1,888,18958,3575873605,3575873605,0
1,888,18959,3575873605,3575873605,0
1,888,18960,3575873605,3575873605,0
1,888,18961,3575873605,3575873605,0
1,888,18962,3575873605,3575873606,1
1,888,18963,3575873605,3575873607,2
1,888,18964,3575873605,3575873608,3
1,888,18965,3575873605,3575873609,4
1,888,18966,3575873605,3575873613,8
1,888,18967,3575873605,3575873614,9
1,888,18968,3575873605,3575873615,10
1,888,18969,3575873605,3575873615,10
1,888,18970,3575873605,3575873616,11
1,888,18971,3575873605,3575873616,11
1,888,18972,3575873605,3575873616,11
1,888,18973,3575873605,3575873616,11
1,888,18974,3575873605,3575873618,13
1,888,18975,3575873605,3575873618,13
1,888,18976,3575873605,3575873618,13
1,888,18977,3575873605,3575873619,14
1,888,18978,3575873605,3575873619,14
1,888,18979,3575873605,3575873620,15
1,888,18980,3575873605,3575873621,16
1,888,18981,3575873605,3575873622,17
1,888,18982,3575873605,3575873622,17
1,888,18983,3575873605,3575873623,18
1,888,18984,3575873605,3575873623,18
1,888,18985,3575873605,3575873625,20
1,888,18986,3575873605,3575873625,20
1,888,18987,3575873605,3575873627,22
1,888,18988,3575873605,3575873628,23
1,888,18989,3575873605,3575873630,25
1,888,18990,3575873605,3575873631,26
1,888,18991,3575873605,3575873632,27
1,888,18992,3575873605,3575873632,27
1,888,18993,3575873605,3575873633,28
1,888,18994,3575873605,3575873633,28
1,888,18995,3575873605,3575873633,28
1,888,18996,3575873605,3575873634,29
1,888,18997,3575873605,3575873634,29
1,888,18998,3575873605,3575873635,30
1,888,18999,3575873605,3575873635,30
1,888,19000,3575873605,3575873636,31
1,888,19001,3575873605,3575873638,33
1,888,19002,3575873605,3575873640,35
1,888,19003,3575873605,3575873642,37
1,888,19004,3575873605,3575873643,38
1,888,19005,3575873605,3575873643,38
1,888,19006,3575873605,3575873644,39
1,888,19007,3575873605,3575873644,39
1,888,19008,3575873605,3575873644,39
1,888,19009,3575873605,3575873645,40
1,888,19010,3575873605,3575873645,40
1,888,19011,3575873605,3575873646,41
1,888,19012,3575873605,3575873647,42
1,888,19013,3575873605,3575873649,44
1,888,19014,3575873605,3575873649,44
1,888,19015,3575873605,3575873650,45
1,888,19016,3575873605,3575873652,47
1,888,19017,3575873605,3575873655,50
1,889,19018,3575873663,3575873663,0
1,889,19019,3575873663,3575873663,0
1,889,19020,3575873663,3575873663,0
1,889,19021,3575873663,3575873663,0
1,889,19022,3575873663,3575873663,0
1,889,19023,3575873663,3575873663,0
1,889,19024,3575873663,3575873665,2
1,889,19025,3575873663,3575873666,3
1,889,19026,3575873663,3575873666,3
1,889,19027,3575873663,3575873669,6
1,889,19028,3575873663,3575873674,11
1,889,19029,3575873663,3575873677,14
1,889,19030,3575873663,3575873678,15
1,889,19031,3575873663,3575873679,16
1,889,19032,3575873663,3575873681,18
1,889,19033,3575873663,3575873683,20
1,889,19034,3575873663,3575873685,22
1,889,19035,3575873663,3575873685,22
1,889,19036,3575873663,3575873686,23
1,889,19037,3575873663,3575873687,24
1,889,19038,3575873663,3575873695,32
1,889,19039,3575873663,3575873695,32
1,889,19040,3575873663,3575873695,32
1,889,19041,3575873663,3575873698,35
1,889,19042,3575873663,3575873701,38
1,889,19043,3575873663,3575873701,38
1,889,19044,3575873663,3575873701,38
1,889,19045,3575873663,3575873702,39
1,889,19046,3575873663,3575873702,39
1,889,19047,3575873663,3575873704,41
1,889,19048,3575873663,3575873704,41
1,889,19049,3575873663,3575873705,42
1,889,19050,3575873663,3575873706,43
1,889,19051,3575873663,3575873710,47
1,889,19052,3575873663,3575873711,48
1,889,19053,3575873663,3575873711,48
1,889,19054,3575873663,3575873712,49
1,889,19055,3575873663,3575873712,49
1,890,19056,3575873723,3575873723,0
1,890,19057,3575873723,3575873723,0
1,890,19058,3575873723,3575873723,0
1,890,19059,3575873723,3575873723,0
1,890,19060,3575873723,3575873723,0
1,890,19061,3575873723,3575873723,0
1,890,19062,3575873723,3575873723,0
1,890,19063,3575873723,3575873724,1
1,890,19064,3575873723,3575873725,2
1,890,19065,3575873723,3575873726,3
1,890,19066,3575873723,3575873729,6
1,890,19067,3575873723,3575873730,7
1,890,19068,3575873723,3575873732,9
1,890,19069,3575873723,3575873734,11
1,890,19070,3575873723,3575873734,11
1,890,19071,3575873723,3575873735,12
1,890,19072,3575873723,3575873736,13
1,890,19073,3575873723,3575873737,14
1,890,19074,3575873723,3575873739,16
1,890,19075,3575873723,3575873739,16
1,890,19076,3575873723,3575873739,16
1,890,19077,3575873723,3575873740,17
1,890,19078,3575873723,3575873741,18
1,890,19079,3575873723,3575873743,20
1,890,19080,3575873723,3575873744,21
1,890,19081,3575873723,3575873746,23
1,890,19082,3575873723,3575873746,23
1,890,19083,3575873723,3575873748,25
1,890,19084,3575873723,3575873749,26
1,890,19085,3575873723,3575873750,27
1,890,19086,3575873723,3575873750,27
1,890,19087,3575873723,3575873751,28
1,890,19088,3575873723,3575873752,29
1,890,19089,3575873723,3575873753,30
1,890,19090,3575873723,3575873754,31
1,890,19091,3575873723,3575873754,31
1,890,19092,3575873723,3575873755,32
1,890,19093,3575873723,3575873756,33
1,890,19094,3575873723,3575873756,33
1,890,19095,3575873723,3575873759,36
1,890,19096,3575873723,3575873761,38
1,890,19097,3575873723,3575873761,38
1,890,19098,3575873723,3575873761,38
1,890,19099,3575873723,3575873762,39
1,890,19100,3575873723,3575873763,40
1,890,19101,3575873723,3575873764,41
1,890,19102,3575873723,3575873764,41
1,890,19103,3575873723,3575873764,41
1,890,19104,3575873723,3575873768,45
1,890,19105,3575873723,3575873770,47
1,890,19106,3575873723,3575873770,47
1,891,19107,3575873783,3575873783,0
1,891,19108,3575873783,3575873783,0
1,891,19109,3575873783,3575873783,0
1,891,19110,3575873783,3575873783,0
1,891,19111,3575873783,3575873783,0
1,891,19112,3575873783,3575873783,0
1,891,19113,3575873783,3575873783,0
1,891,19114,3575873783,3575873783,0
1,891,19115,3575873783,3575873783,0
1,891,19116,3575873783,3575873783,0
1,891,19117,3575873783,3575873783,0
1,891,19118,3575873783,3575873783,0
1,891,19119,3575873783,3575873783,0
1,891,19120,3575873783,3575873783,0
1,891,19121,3575873783,3575873784,1
1,891,19122,3575873783,3575873785,2
1,891,19123,3575873783,3575873786,3
1,891,19124,3575873783,3575873786,3
1,891,19125,3575873783,3575873787,4
1,891,19126,3575873783,3575873787,4
1,891,19127,3575873783,3575873789,6
1,891,19128,3575873783,3575873789,6
1,891,19129,3575873783,3575873791,8
1,891,19130,3575873783,3575873791,8
1,891,19131,3575873783,3575873792,9
1,891,19132,3575873783,3575873792,9
1,891,19133,3575873783,3575873796,13
1,891,19134,3575873783,3575873797,14
1,891,19135,3575873783,3575873799,16
1,891,19136,3575873783,3575873799,16
1,891,19137,3575873783,3575873799,16
1,891,19138,3575873783,3575873800,17
1,891,19139,3575873783,3575873801,18
1,891,19140,3575873783,3575873802,19
1,891,19141,3575873783,3575873805,22
1,891,19142,3575873783,3575873806,23
1,891,19143,3575873783,3575873808,25
1,891,19144,3575873783,3575873809,26
1,891,19145,3575873783,3575873813,30
1,891,19146,3575873783,3575873814,31
1,891,19147,3575873783,3575873815,32
1,891,19148,3575873783,3575873816,33
1,891,19149,3575873783,3575873816,33
1,891,19150,3575873783,3575873816,33
1,891,19151,3575873783,3575873817,34
1,891,19152,3575873783,3575873817,34
1,891,19153,3575873783,3575873818,35
1,891,19154,3575873783,3575873818,35
1,891,19155,3575873783,3575873818,35
1,891,19156,3575873783,3575873819,36
1,891,19157,3575873783,3575873819,36
1,891,19158,3575873783,3575873819,36
1,891,19159,3575873783,3575873821,38
1,891,19160,3575873783,3575873821,38
1,891,19161,3575873783,3575873822,39
1,891,19162,3575873783,3575873823,40
1,891,19163,3575873783,3575873824,41
1,891,19164,3575873783,3575873824,41
1,891,19165,3575873783,3575873825,42
1,891,19166,3575873783,3575873825,42
1,891,19167,3575873783,3575873825,42
1,891,19168,3575873783,3575873827,44
1,891,19169,3575873783,3575873828,45
1,891,19170,3575873783,3575873830,47
1,891,19171,3575873783,3575873831,48
1,891,19172,3575873783,3575873831,48
1,891,19173,3575873783,3575873832,49
1,891,19174,3575873783,3575873833,50
1,892,19175,3575873844,3575873844,0
1,892,19176,3575873844,3575873844,0
1,892,19177,3575873844,3575873844,0
1,892,19178,3575873844,3575873844,0
1,892,19179,3575873844,3575873844,0
1,892,19180,3575873844,3575873844,0
1,892,19181,3575873844,3575873844,0
1,892,19182,3575873844,3575873844,0
1,892,19183,3575873844,3575873844,0
1,892,19184,3575873844,3575873844,0
1,892,19185,3575873844,3575873844,0
1,892,19186,3575873844,3575873844,0
1,892,19187,3575873844,3575873844,0
1,892,19188,3575873844,3575873845,1
1,892,19189,3575873844,3575873845,1
1,892,19190,3575873844,3575873845,1
1,892,19191,3575873844,3575873845,1
1,892,19192,3575873844,3575873845,1
1,892,19193,3575873844,3575873847,3
1,892,19194,3575873844,3575873849,5
1,892,19195,3575873844,3575873850,6
1,892,19196,3575873844,3575873850,6
1,892,19197,3575873844,3575873851,7
1,892,19198,3575873844,3575873852,8
1,892,19199,3575873844,3575873854,10
1,892,19200,3575873844,3575873855,11
1,892,19201,3575873844,3575873856,12
1,892,19202,3575873844,3575873857,13
1,892,19203,3575873844,3575873859,15
1,892,19204,3575873844,3575873861,17
1,892,19205,3575873844,3575873861,17
1,892,19206,3575873844,3575873863,19
1,892,19207,3575873844,3575873866,22
1,892,19208,3575873844,3575873867,23
1,892,19209,3575873844,3575873868,24
1,892,19210,3575873844,3575873869,25
1,892,19211,3575873844,3575873878,34
1,892,19212,3575873844,3575873878,34
1,892,19213,3575873844,3575873882,38
1,892,19214,3575873844,3575873883,39
1,892,19215,3575873844,3575873883,39
1,892,19216,3575873844,3575873885,41
1,892,19217,3575873844,3575873885,41
1,892,19218,3575873844,3575873886,42
1,892,19219,3575873844,3575873888,44
1,893,19220,3575873905,3575873905,0
1,893,19221,3575873905,3575873905,0
1,893,19222,3575873905,3575873905,0
1,893,19223,3575873905,3575873905,0
1,893,19224,3575873905,3575873905,0
1,893,19225,3575873905,3575873905,0
1,893,19226,3575873905,3575873905,0
1,893,19227,3575873905,3575873905,0
1,893,19228,3575873905,3575873905,0
1,893,19229,3575873905,3575873905,0
1,893,19230,3575873905,3575873905,0
1,893,19231,3575873905,3575873905,0
1,893,19232,3575873905,3575873905,0
1,893,19233,3575873905,3575873905,0
1,893,19234,3575873905,3575873906,1
1,893,19235,3575873905,3575873910,5
1,893,19236,3575873905,3575873911,6
1,893,19237,3575873905,3575873912,7
1,893,19238,3575873905,3575873912,7
1,893,19239,3575873905,3575873912,7
1,893,19240,3575873905,3575873912,7
1,893,19241,3575873905,3575873914,9
1,893,19242,3575873905,3575873914,9
1,893,19243,3575873905,3575873917,12
1,893,19244,3575873905,3575873923,18
1,893,19245,3575873905,3575873924,19
1,893,19246,3575873905,3575873925,20
1,893,19247,3575873905,3575873926,21
1,893,19248,3575873905,3575873929,24
1,893,19249,3575873905,3575873930,25
1,893,19250,3575873905,3575873930,25
1,893,19251,3575873905,3575873930,25
1,893,19252,3575873905,3575873932,27
1,893,19253,3575873905,3575873933,28
1,893,19254,3575873905,3575873934,29
1,893,19255,3575873905,3575873936,31
1,893,19256,3575873905,3575873937,32
1,893,19257,3575873905,3575873939,34
1,893,19258,3575873905,3575873939,34
1,893,19259,3575873905,3575873940,35
1,893,19260,3575873905,3575873940,35
1,893,19261,3575873905,3575873940,35
1,893,19262,3575873905,3575873943,38
1,893,19263,3575873905,3575873944,39
1,893,19264,3575873905,3575873946,41
1,893,19265,3575873905,3575873948,43
1,893,19266,3575873905,3575873949,44
1,893,19267,3575873905,3575873950,45
1,893,19268,3575873905,3575873950,45
1,893,19269,3575873905,3575873951,46
1,893,19270,3575873905,3575873952,47
1,893,19271,3575873905,3575873954,49
1,894,19272,3575873965,3575873965,0
1,894,19273,3575873965,3575873965,0
1,894,19274,3575873965,3575873965,0
1,894,19275,3575873965,3575873965,0
1,894,19276,3575873965,3575873965,0
1,894,19277,3575873965,3575873965,0
1,894,19278,3575873965,3575873965,0
1,894,19279,3575873965,3575873965,0
1,894,19280,3575873965,3575873965,0
1,894,19281,3575873965,3575873965,0
1,894,19282,3575873965,3575873965,0
1,894,19283,3575873965,3575873965,0
1,894,19284,3575873965,3575873968,3
1,894,19285,3575873965,3575873970,5
1,894,19286,3575873965,3575873971,6
1,894,19287,3575873965,3575873974,9
1,894,19288,3575873965,3575873975,10
1,894,19289,3575873965,3575873977,12
1,894,19290,3575873965,3575873978,13
1,894,19291,3575873965,3575873978,13
1,894,19292,3575873965,3575873979,14
1,894,19293,3575873965,3575873979,14
1,894,19294,3575873965,3575873979,14
1,894,19295,3575873965,3575873981,16
1,894,19296,3575873965,3575873981,16
1,894,19297,3575873965,3575873982,17
1,894,19298,3575873965,3575873982,17
1,894,19299,3575873965,3575873982,17
1,894,19300,3575873965,3575873984,19
1,894,19301,3575873965,3575873984,19
1,894,19302,3575873965,3575873984,19
1,894,19303,3575873965,3575873985,20
1,894,19304,3575873965,3575873985,20
1,894,19305,3575873965,3575873986,21
1,894,19306,3575873965,3575873987,22
1,894,19307,3575873965,3575873987,22
1,894,19308,3575873965,3575873989,24
1,894,19309,3575873965,3575873989,24
1,894,19310,3575873965,3575873991,26
1,894,19311,3575873965,3575873992,27
1,894,19312,3575873965,3575873992,27
1,894,19313,3575873965,3575873993,28
1,894,19314,3575873965,3575873996,31
1,894,19315,3575873965,3575873998,33
1,894,19316,3575873965,3575873999,34
1,894,19317,3575873965,3575873999,34
1,894,19318,3575873965,3575874000,35
1,894,19319,3575873965,3575874000,35
1,894,19320,3575873965,3575874001,36
1,894,19321,3575873965,3575874003,38
1,894,19322,3575873965,3575874006,41
1,894,19323,3575873965,3575874006,41
1,894,19324,3575873965,3575874006,41
1,894,19325,3575873965,3575874008,43
1,894,19326,3575873965,3575874009,44
1,894,19327,3575873965,3575874013,48
1,894,19328,3575873965,3575874014,49
1,895,19329,3575874027,3575874027,0
1,895,19330,3575874027,3575874027,0
1,895,19331,3575874027,3575874027,0
1,895,19332,3575874027,3575874027,0
1,895,19333,3575874027,3575874027,0
1,895,19334,3575874027,3575874027,0
1,895,19335,3575874027,3575874027,0
1,895,19336,3575874027,3575874027,0
1,895,19337,3575874027,3575874027,0
1,895,19338,3575874027,3575874027,0
1,895,19339,3575874027,3575874027,0
1,895,19340,3575874027,3575874027,0
1,895,19341,3575874027,3575874027,0
1,895,19342,3575874027,3575874027,0
1,895,19343,3575874027,3575874027,0
1,895,19344,3575874027,3575874027,0
1,895,19345,3575874027,3575874027,0
1,895,19346,3575874027,3575874027,0
1,895,19347,3575874027,3575874028,1
1,895,19348,3575874027,3575874028,1
1,895,19349,3575874027,3575874032,5
1,895,19350,3575874027,3575874032,5
1,895,19351,3575874027,3575874032,5
1,895,19352,3575874027,3575874033,6
1,895,19353,3575874027,3575874033,6
1,895,19354,3575874027,3575874033,6
1,895,19355,3575874027,3575874034,7
1,895,19356,3575874027,3575874035,8
1,895,19357,3575874027,3575874035,8
1,895,19358,3575874027,3575874036,9
1,895,19359,3575874027,3575874038,11
1,895,19360,3575874027,3575874038,11
1,895,19361,3575874027,3575874041,14
1,895,19362,3575874027,3575874043,16
1,895,19363,3575874027,3575874043,16
1,895,19364,3575874027,3575874044,17
1,895,19365,3575874027,3575874044,17
1,895,19366,3575874027,3575874045,18
1,895,19367,3575874027,3575874045,18
1,895,19368,3575874027,3575874046,19
1,895,19369,3575874027,3575874047,20
1,895,19370,3575874027,3575874047,20
1,895,19371,3575874027,3575874050,23
1,895,19372,3575874027,3575874050,23
1,895,19373,3575874027,3575874052,25
1,895,19374,3575874027,3575874054,27
1,895,19375,3575874027,3575874055,28
1,895,19376,3575874027,3575874056,29
1,895,19377,3575874027,3575874057,30
1,895,19378,3575874027,3575874059,32
1,895,19379,3575874027,3575874061,34
1,895,19380,3575874027,3575874061,34
1,895,19381,3575874027,3575874062,35
1,895,19382,3575874027,3575874065,38
1,895,19383,3575874027,3575874067,40
1,895,19384,3575874027,3575874068,41
1,895,19385,3575874027,3575874069,42
1,895,19386,3575874027,3575874070,43
1,896,19387,3575874088,3575874088,0
1,896,19388,3575874088,3575874088,0
1,896,19389,3575874088,3575874088,0
1,896,19390,3575874088,3575874088,0
1,896,19391,3575874088,3575874088,0
1,896,19392,3575874088,3575874088,0
1,896,19393,3575874088,3575874088,0
1,896,19394,3575874088,3575874088,0
1,896,19395,3575874088,3575874095,7
1,896,19396,3575874088,3575874097,9
1,896,19397,3575874088,3575874097,9
1,896,19398,3575874088,3575874098,10
1,896,19399,3575874088,3575874098,10
1,896,19400,3575874088,3575874101,13
1,896,19401,3575874088,3575874101,13
1,896,19402,3575874088,3575874102,14
1,896,19403,3575874088,3575874102,14
1,896,19404,3575874088,3575874103,15
1,896,19405,3575874088,3575874103,15
1,896,19406,3575874088,3575874104,16
1,896,19407,3575874088,3575874105,17
1,896,19408,3575874088,3575874106,18
1,896,19409,3575874088,3575874106,18
1,896,19410,3575874088,3575874111,23
1,896,19411,3575874088,3575874111,23
1,896,19412,3575874088,3575874111,23
1,896,19413,3575874088,3575874112,24
1,896,19414,3575874088,3575874112,24
1,896,19415,3575874088,3575874114,26
1,896,19416,3575874088,3575874114,26
1,896,19417,3575874088,3575874115,27
1,896,19418,3575874088,3575874117,29
1,896,19419,3575874088,3575874120,32
1,896,19420,3575874088,3575874123,35
1,896,19421,3575874088,3575874123,35
1,896,19422,3575874088,3575874125,37
1,896,19423,3575874088,3575874125,37
1,896,19424,3575874088,3575874126,38
1,896,19425,3575874088,3575874127,39
1,896,19426,3575874088,3575874129,41
1,896,19427,3575874088,3575874131,43
1,896,19428,3575874088,3575874131,43
1,896,19429,3575874088,3575874133,45
1,896,19430,3575874088,3575874134,46
1,896,19431,3575874088,3575874134,46
1,896,19432,3575874088,3575874135,47
1,896,19433,3575874088,3575874137,49
1,897,19434,3575874152,3575874152,0
1,897,19435,3575874152,3575874152,0
1,897,19436,3575874152,3575874152,0
1,897,19437,3575874152,3575874152,0
1,897,19438,3575874152,3575874152,0
1,897,19439,3575874152,3575874152,0
1,897,19440,3575874152,3575874152,0
1,897,19441,3575874152,3575874152,0
1,897,19442,3575874152,3575874152,0
1,897,19443,3575874152,3575874152,0
1,897,19444,3575874152,3575874152,0
1,897,19445,3575874152,3575874152,0
1,897,19446,3575874152,3575874153,1
1,897,19447,3575874152,3575874154,2
1,897,19448,3575874152,3575874154,2
1,897,19449,3575874152,3575874154,2
1,897,19450,3575874152,3575874156,4
1,897,19451,3575874152,3575874156,4
1,897,19452,3575874152,3575874156,4
1,897,19453,3575874152,3575874159,7
1,897,19454,3575874152,3575874161,9
1,897,19455,3575874152,3575874161,9
1,897,19456,3575874152,3575874163,11
1,897,19457,3575874152,3575874163,11
1,897,19458,3575874152,3575874163,11
1,897,19459,3575874152,3575874164,12
1,897,19460,3575874152,3575874164,12
1,897,19461,3575874152,3575874165,13
1,897,19462,3575874152,3575874168,16
1,897,19463,3575874152,3575874171,19
1,897,19464,3575874152,3575874171,19
1,897,19465,3575874152,3575874174,22
1,897,19466,3575874152,3575874174,22
1,897,19467,3575874152,3575874176,24
1,897,19468,3575874152,3575874176,24
1,897,19469,3575874152,3575874178,26
1,897,19470,3575874152,3575874178,26
1,897,19471,3575874152,3575874179,27
1,897,19472,3575874152,3575874179,27
1,897,19473,3575874152,3575874180,28
1,897,19474,3575874152,3575874181,29
1,897,19475,3575874152,3575874182,30
1,897,19476,3575874152,3575874182,30
1,897,19477,3575874152,3575874182,30
1,897,19478,3575874152,3575874183,31
1,897,19479,3575874152,3575874185,33
1,897,19480,3575874152,3575874185,33
1,897,19481,3575874152,3575874185,33
1,897,19482,3575874152,3575874186,34
1,897,19483,3575874152,3575874186,34
1,897,19484,3575874152,3575874186,34
1,897,19485,3575874152,3575874187,35
1,897,19486,3575874152,3575874189,37
1,897,19487,3575874152,3575874189,37
1,897,19488,3575874152,3575874190,38
1,897,19489,3575874152,3575874191,39
1,897,19490,3575874152,3575874191,39
1,897,19491,3575874152,3575874191,39
1,897,19492,3575874152,3575874192,40
1,897,19493,3575874152,3575874193,41
1,897,19494,3575874152,3575874196,44
1,897,19495,3575874152,3575874197,45
1,897,19496,3575874152,3575874199,47
1,897,19497,3575874152,3575874200,48
1,897,19498,3575874152,3575874200,48
1,897,19499,3575874152,3575874200,48
1,897,19500,3575874152,3575874201,49
1,898,19501,3575874210,3575874210,0
1,898,19502,3575874210,3575874210,0
1,898,19503,3575874210,3575874210,0
1,898,19504,3575874210,3575874210,0
1,898,19505,3575874210,3575874210,0
1,898,19506,3575874210,3575874214,4
1,898,19507,3575874210,3575874214,4
1,898,19508,3575874210,3575874215,5
1,898,19509,3575874210,3575874215,5
1,898,19510,3575874210,3575874215,5
1,898,19511,3575874210,3575874216,6
1,898,19512,3575874210,3575874217,7
1,898,19513,3575874210,3575874217,7
1,898,19514,3575874210,3575874217,7
1,898,19515,3575874210,3575874218,8
1,898,19516,3575874210,3575874218,8
1,898,19517,3575874210,3575874218,8
1,898,19518,3575874210,3575874219,9
1,898,19519,3575874210,3575874220,10
1,898,19520,3575874210,3575874221,11
1,898,19521,3575874210,3575874221,11
1,898,19522,3575874210,3575874222,12
1,898,19523,3575874210,3575874223,13
1,898,19524,3575874210,3575874224,14
1,898,19525,3575874210,3575874224,14
1,898,19526,3575874210,3575874224,14
1,898,19527,3575874210,3575874225,15
1,898,19528,3575874210,3575874225,15
1,898,19529,3575874210,3575874226,16
1,898,19530,3575874210,3575874228,18
1,898,19531,3575874210,3575874232,22
1,898,19532,3575874210,3575874233,23
1,898,19533,3575874210,3575874233,23
1,898,19534,3575874210,3575874233,23
1,898,19535,3575874210,3575874233,23
1,898,19536,3575874210,3575874234,24
1,898,19537,3575874210,3575874234,24
1,898,19538,3575874210,3575874236,26
1,898,19539,3575874210,3575874236,26
1,898,19540,3575874210,3575874236,26
1,898,19541,3575874210,3575874238,28
1,898,19542,3575874210,3575874238,28
1,898,19543,3575874210,3575874243,33
1,898,19544,3575874210,3575874245,35
1,898,19545,3575874210,3575874245,35
1,898,19546,3575874210,3575874246,36
1,898,19547,3575874210,3575874248,38
1,898,19548,3575874210,3575874248,38
1,898,19549,3575874210,3575874250,40
1,898,19550,3575874210,3575874251,41
1,898,19551,3575874210,3575874251,41
1,898,19552,3575874210,3575874252,42
1,898,19553,3575874210,3575874254,44
1,898,19554,3575874210,3575874255,45
1,898,19555,3575874210,3575874256,46
1,898,19556,3575874210,3575874257,47
1,898,19557,3575874210,3575874259,49
1,899,19558,3575874269,3575874269,0
1,899,19559,3575874269,3575874269,0
1,899,19560,3575874269,3575874269,0
1,899,19561,3575874269,3575874269,0
1,899,19562,3575874269,3575874269,0
1,899,19563,3575874269,3575874269,0
1,899,19564,3575874269,3575874269,0
1,899,19565,3575874269,3575874269,0
1,899,19566,3575874269,3575874269,0
1,899,19567,3575874269,3575874269,0
1,899,19568,3575874269,3575874271,2
1,899,19569,3575874269,3575874274,5
1,899,19570,3575874269,3575874277,8
1,899,19571,3575874269,3575874278,9
1,899,19572,3575874269,3575874279,10
1,899,19573,3575874269,3575874281,12
1,899,19574,3575874269,3575874283,14
1,899,19575,3575874269,3575874285,16
1,899,19576,3575874269,3575874286,17
1,899,19577,3575874269,3575874286,17
1,899,19578,3575874269,3575874288,19
1,899,19579,3575874269,3575874295,26
1,899,19580,3575874269,3575874296,27
1,899,19581,3575874269,3575874298,29
1,899,19582,3575874269,3575874298,29
1,899,19583,3575874269,3575874298,29
1,899,19584,3575874269,3575874301,32
1,899,19585,3575874269,3575874301,32
1,899,19586,3575874269,3575874302,33
1,899,19587,3575874269,3575874302,33
1,899,19588,3575874269,3575874303,34
1,899,19589,3575874269,3575874303,34
1,899,19590,3575874269,3575874304,35
1,899,19591,3575874269,3575874305,36
1,899,19592,3575874269,3575874306,37
1,899,19593,3575874269,3575874306,37
1,899,19594,3575874269,3575874311,42
1,899,19595,3575874269,3575874311,42
1,899,19596,3575874269,3575874312,43
1,899,19597,3575874269,3575874312,43
1,899,19598,3575874269,3575874314,45
1,899,19599,3575874269,3575874315,46
1,899,19600,3575874269,3575874315,46
1,899,19601,3575874269,3575874318,49
1,900,19602,3575874328,3575874328,0
1,900,19603,3575874328,3575874328,0
1,900,19604,3575874328,3575874328,0
1,900,19605,3575874328,3575874328,0
1,900,19606,3575874328,3575874328,0
1,900,19607,3575874328,3575874328,0
1,900,19608,3575874328,3575874328,0
1,900,19609,3575874328,3575874328,0
1,900,19610,3575874328,3575874329,1
1,900,19611,3575874328,3575874331,3
1,900,19612,3575874328,3575874331,3
1,900,19613,3575874328,3575874333,5
1,900,19614,3575874328,3575874335,7
1,900,19615,3575874328,3575874335,7
1,900,19616,3575874328,3575874337,9
1,900,19617,3575874328,3575874339,11
1,900,19618,3575874328,3575874340,12
1,900,19619,3575874328,3575874340,12
1,900,19620,3575874328,3575874343,15
1,900,19621,3575874328,3575874344,16
1,900,19622,3575874328,3575874344,16
1,900,19623,3575874328,3575874346,18
1,900,19624,3575874328,3575874347,19
1,900,19625,3575874328,3575874349,21
1,900,19626,3575874328,3575874349,21
1,900,19627,3575874328,3575874350,22
1,900,19628,3575874328,3575874350,22
1,900,19629,3575874328,3575874352,24
1,900,19630,3575874328,3575874353,25
1,900,19631,3575874328,3575874353,25
1,900,19632,3575874328,3575874355,27
1,900,19633,3575874328,3575874357,29
1,900,19634,3575874328,3575874357,29
1,900,19635,3575874328,3575874360,32
1,900,19636,3575874328,3575874360,32
1,900,19637,3575874328,3575874361,33
1,900,19638,3575874328,3575874362,34
1,900,19639,3575874328,3575874363,35
1,900,19640,3575874328,3575874363,35
1,900,19641,3575874328,3575874364,36
1,900,19642,3575874328,3575874364,36
1,900,19643,3575874328,3575874365,37
1,900,19644,3575874328,3575874368,40
1,900,19645,3575874328,3575874371,43
1,900,19646,3575874328,3575874371,43
1,900,19647,3575874328,3575874374,46
1,900,19648,3575874328,3575874375,47
1,900,19649,3575874328,3575874375,47
1,900,19650,3575874328,3575874376,48
1,900,19651,3575874328,3575874378,50
1,901,19652,3575874388,3575874388,0
1,901,19653,3575874388,3575874388,0
1,901,19654,3575874388,3575874388,0
1,901,19655,3575874388,3575874388,0
1,901,19656,3575874388,3575874388,0
1,901,19657,3575874388,3575874388,0
1,901,19658,3575874388,3575874388,0
1,901,19659,3575874388,3575874388,0
1,901,19660,3575874388,3575874388,0
1,901,19661,3575874388,3575874388,0
1,901,19662,3575874388,3575874388,0
1,901,19663,3575874388,3575874388,0
1,901,19664,3575874388,3575874388,0
1,901,19665,3575874388,3575874388,0
1,901,19666,3575874388,3575874388,0
1,901,19667,3575874388,3575874388,0
1,901,19668,3575874388,3575874388,0
1,901,19669,3575874388,3575874389,1
1,901,19670,3575874388,3575874390,2
1,901,19671,3575874388,3575874390,2
1,901,19672,3575874388,3575874391,3
1,901,19673,3575874388,3575874391,3
1,901,19674,3575874388,3575874392,4
1,901,19675,3575874388,3575874396,8
1,901,19676,3575874388,3575874397,9
1,901,19677,3575874388,3575874399,11
1,901,19678,3575874388,3575874399,11
1,901,19679,3575874388,3575874400,12
1,901,19680,3575874388,3575874400,12
1,901,19681,3575874388,3575874401,13
1,901,19682,3575874388,3575874402,14
1,901,19683,3575874388,3575874402,14
1,901,19684,3575874388,3575874406,18
1,901,19685,3575874388,3575874406,18
1,901,19686,3575874388,3575874407,19
1,901,19687,3575874388,3575874408,20
1,901,19688,3575874388,3575874409,21
1,901,19689,3575874388,3575874413,25
1,901,19690,3575874388,3575874415,27
1,901,19691,3575874388,3575874415,27
1,901,19692,3575874388,3575874416,28
1,901,19693,3575874388,3575874416,28
1,901,19694,3575874388,3575874417,29
1,901,19695,3575874388,3575874418,30
1,901,19696,3575874388,3575874418,30
1,901,19697,3575874388,3575874418,30
1,901,19698,3575874388,3575874419,31
1,901,19699,3575874388,3575874421,33
1,901,19700,3575874388,3575874421,33
1,901,19701,3575874388,3575874421,33
1,901,19702,3575874388,3575874422,34
1,901,19703,3575874388,3575874423,35
1,901,19704,3575874388,3575874423,35
1,901,19705,3575874388,3575874423,35
1,901,19706,3575874388,3575874424,36
1,901,19707,3575874388,3575874424,36
1,901,19708,3575874388,3575874426,38
1,901,19709,3575874388,3575874426,38
1,901,19710,3575874388,3575874428,40
1,901,19711,3575874388,3575874432,44
1,901,19712,3575874388,3575874432,44
1,901,19713,3575874388,3575874432,44
1,901,19714,3575874388,3575874432,44
1,901,19715,3575874388,3575874433,45
1,901,19716,3575874388,3575874433,45
1,901,19717,3575874388,3575874433,45
1,901,19718,3575874388,3575874434,46
1,901,19719,3575874388,3575874436,48
1,901,19720,3575874388,3575874437,49
1,901,19721,3575874388,3575874437,49
1,902,19722,3575874450,3575874450,0
1,902,19723,3575874450,3575874450,0
1,902,19724,3575874450,3575874450,0
1,902,19725,3575874450,3575874450,0
1,902,19726,3575874450,3575874450,0
1,902,19727,3575874450,3575874450,0
1,902,19728,3575874450,3575874450,0
1,902,19729,3575874450,3575874450,0
1,902,19730,3575874450,3575874450,0
1,902,19731,3575874450,3575874451,1
1,902,19732,3575874450,3575874452,2
1,902,19733,3575874450,3575874455,5
1,902,19734,3575874450,3575874456,6
1,902,19735,3575874450,3575874460,10
1,902,19736,3575874450,3575874463,13
1,902,19737,3575874450,3575874463,13
1,902,19738,3575874450,3575874464,14
1,902,19739,3575874450,3575874465,15
1,902,19740,3575874450,3575874467,17
1,902,19741,3575874450,3575874468,18
1,902,19742,3575874450,3575874468,18
1,902,19743,3575874450,3575874469,19
1,902,19744,3575874450,3575874471,21
1,902,19745,3575874450,3575874475,25
1,902,19746,3575874450,3575874477,27
1,902,19747,3575874450,3575874479,29
1,902,19748,3575874450,3575874479,29
1,902,19749,3575874450,3575874482,32
1,902,19750,3575874450,3575874483,33
1,902,19751,3575874450,3575874484,34
1,902,19752,3575874450,3575874486,36
1,902,19753,3575874450,3575874486,36
1,902,19754,3575874450,3575874487,37
1,902,19755,3575874450,3575874496,46
1,902,19756,3575874450,3575874497,47
1,902,19757,3575874450,3575874498,48
1,902,19758,3575874450,3575874498,48
1,902,19759,3575874450,3575874499,49
1,903,19760,3575874509,3575874509,0
1,903,19761,3575874509,3575874509,0
1,903,19762,3575874509,3575874509,0
1,903,19763,3575874509,3575874509,0
1,903,19764,3575874509,3575874509,0
1,903,19765,3575874509,3575874509,0
1,903,19766,3575874509,3575874509,0
1,903,19767,3575874509,3575874509,0
1,903,19768,3575874509,3575874509,0
1,903,19769,3575874509,3575874510,1
1,903,19770,3575874509,3575874510,1
1,903,19771,3575874509,3575874511,2
1,903,19772,3575874509,3575874511,2
1,903,19773,3575874509,3575874511,2
1,903,19774,3575874509,3575874512,3
1,903,19775,3575874509,3575874513,4
1,903,19776,3575874509,3575874514,5
1,903,19777,3575874509,3575874515,6
1,903,19778,3575874509,3575874518,9
1,903,19779,3575874509,3575874519,10
1,903,19780,3575874509,3575874522,13
1,903,19781,3575874509,3575874524,15
1,903,19782,3575874509,3575874524,15
1,903,19783,3575874509,3575874525,16
1,903,19784,3575874509,3575874526,17
1,903,19785,3575874509,3575874527,18
1,903,19786,3575874509,3575874527,18
1,903,19787,3575874509,3575874528,19
1,903,19788,3575874509,3575874530,21
1,903,19789,3575874509,3575874530,21
1,903,19790,3575874509,3575874531,22
1,903,19791,3575874509,3575874532,23
1,903,19792,3575874509,3575874533,24
1,903,19793,3575874509,3575874534,25
1,903,19794,3575874509,3575874535,26
1,903,19795,3575874509,3575874535,26
1,903,19796,3575874509,3575874539,30
1,903,19797,3575874509,3575874539,30
1,903,19798,3575874509,3575874540,31
1,903,19799,3575874509,3575874540,31
1,903,19800,3575874509,3575874542,33
1,903,19801,3575874509,3575874542,33
1,903,19802,3575874509,3575874543,34
1,903,19803,3575874509,3575874543,34
1,903,19804,3575874509,3575874546,37
1,903,19805,3575874509,3575874548,39
1,903,19806,3575874509,3575874548,39
1,903,19807,3575874509,3575874548,39
1,903,19808,3575874509,3575874550,41
1,903,19809,3575874509,3575874552,43
1,903,19810,3575874509,3575874553,44
1,903,19811,3575874509,3575874554,45
1,903,19812,3575874509,3575874554,45
1,903,19813,3575874509,3575874556,47
1,903,19814,3575874509,3575874559,50
1,904,19815,3575874572,3575874572,0
1,904,19816,3575874572,3575874572,0
1,904,19817,3575874572,3575874572,0
1,904,19818,3575874572,3575874572,0
1,904,19819,3575874572,3575874572,0
1,904,19820,3575874572,3575874572,0
1,904,19821,3575874572,3575874572,0
1,904,19822,3575874572,3575874572,0
1,904,19823,3575874572,3575874572,0
1,904,19824,3575874572,3575874572,0
1,904,19825,3575874572,3575874572,0
1,904,19826,3575874572,3575874574,2
1,904,19827,3575874572,3575874575,3
1,904,19828,3575874572,3575874575,3
1,904,19829,3575874572,3575874576,4
1,904,19830,3575874572,3575874577,5
1,904,19831,3575874572,3575874578,6
1,904,19832,3575874572,3575874578,6
1,904,19833,3575874572,3575874578,6
1,904,19834,3575874572,3575874578,6
1,904,19835,3575874572,3575874581,9
1,904,19836,3575874572,3575874581,9
1,904,19837,3575874572,3575874582,10
1,904,19838,3575874572,3575874582,10
1,904,19839,3575874572,3575874583,11
1,904,19840,3575874572,3575874583,11
1,904,19841,3575874572,3575874584,12
1,904,19842,3575874572,3575874585,13
1,904,19843,3575874572,3575874585,13
1,904,19844,3575874572,3575874585,13
1,904,19845,3575874572,3575874585,13
1,904,19846,3575874572,3575874587,15
1,904,19847,3575874572,3575874587,15
1,904,19848,3575874572,3575874589,17
1,904,19849,3575874572,3575874590,18
1,904,19850,3575874572,3575874591,19
1,904,19851,3575874572,3575874591,19
1,904,19852,3575874572,3575874591,19
1,904,19853,3575874572,3575874591,19
1,904,19854,3575874572,3575874595,23
1,904,19855,3575874572,3575874597,25
1,904,19856,3575874572,3575874598,26
1,904,19857,3575874572,3575874599,27
1,904,19858,3575874572,3575874600,28
1,904,19859,3575874572,3575874600,28
1,904,19860,3575874572,3575874600,28
1,904,19861,3575874572,3575874602,30
1,904,19862,3575874572,3575874605,33
1,904,19863,3575874572,3575874605,33
1,904,19864,3575874572,3575874608,36
1,904,19865,3575874572,3575874608,36
1,904,19866,3575874572,3575874612,40
1,904,19867,3575874572,3575874614,42
1,904,19868,3575874572,3575874615,43
1,904,19869,3575874572,3575874615,43
1,904,19870,3575874572,3575874615,43
1,904,19871,3575874572,3575874616,44
1,904,19872,3575874572,3575874617,45
1,904,19873,3575874572,3575874617,45
1,904,19874,3575874572,3575874617,45
1,904,19875,3575874572,3575874617,45
1,904,19876,3575874572,3575874617,45
1,904,19877,3575874572,3575874618,46
1,904,19878,3575874572,3575874618,46
1,904,19879,3575874572,3575874619,47
1,904,19880,3575874572,3575874620,48
1,905,19881,3575874631,3575874631,0
1,905,19882,3575874631,3575874631,0
1,905,19883,3575874631,3575874631,0
1,905,19884,3575874631,3575874631,0
1,905,19885,3575874631,3575874631,0
1,905,19886,3575874631,3575874631,0
1,905,19887,3575874631,3575874631,0
1,905,19888,3575874631,3575874631,0
1,905,19889,3575874631,3575874631,0
1,905,19890,3575874631,3575874631,0
1,905,19891,3575874631,3575874631,0
1,905,19892,3575874631,3575874631,0
1,905,19893,3575874631,3575874632,1
1,905,19894,3575874631,3575874632,1
1,905,19895,3575874631,3575874632,1
1,905,19896,3575874631,3575874632,1
1,905,19897,3575874631,3575874633,2
1,905,19898,3575874631,3575874635,4
1,905,19899,3575874631,3575874636,5
1,905,19900,3575874631,3575874636,5
1,905,19901,3575874631,3575874638,7
1,905,19902,3575874631,3575874642,11
1,905,19903,3575874631,3575874642,11
1,905,19904,3575874631,3575874643,12
1,905,19905,3575874631,3575874643,12
1,905,19906,3575874631,3575874644,13
1,905,19907,3575874631,3575874644,13
1,905,19908,3575874631,3575874644,13
1,905,19909,3575874631,3575874645,14
1,905,19910,3575874631,3575874645,14
1,905,19911,3575874631,3575874645,14
1,905,19912,3575874631,3575874646,15
1,905,19913,3575874631,3575874648,17
1,905,19914,3575874631,3575874649,18
1,905,19915,3575874631,3575874650,19
1,905,19916,3575874631,3575874651,20
1,905,19917,3575874631,3575874652,21
1,905,19918,3575874631,3575874656,25
1,905,19919,3575874631,3575874656,25
1,905,19920,3575874631,3575874656,25
1,905,19921,3575874631,3575874659,28
1,905,19922,3575874631,3575874662,31
1,905,19923,3575874631,3575874662,31
1,905,19924,3575874631,3575874663,32
1,905,19925,3575874631,3575874665,34
1,905,19926,3575874631,3575874666,35
1,905,19927,3575874631,3575874666,35
1,905,19928,3575874631,3575874667,36
1,905,19929,3575874631,3575874669,38
1,905,19930,3575874631,3575874670,39
1,905,19931,3575874631,3575874677,46
1,905,19932,3575874631,3575874679,48
1,906,19933,3575874694,3575874694,0
1,906,19934,3575874694,3575874694,0
1,906,19935,3575874694,3575874694,0
1,906,19936,3575874694,3575874694,0
1,906,19937,3575874694,3575874694,0
1,906,19938,3575874694,3575874694,0
1,906,19939,3575874694,3575874694,0
1,906,19940,3575874694,3575874696,2
1,906,19941,3575874694,3575874698,4
1,906,19942,3575874694,3575874698,4
1,906,19943,3575874694,3575874699,5
1,906,19944,3575874694,3575874701,7
1,906,19945,3575874694,3575874703,9
1,906,19946,3575874694,3575874703,9
1,906,19947,3575874694,3575874703,9
1,906,19948,3575874694,3575874704,10
1,906,19949,3575874694,3575874704,10
1,906,19950,3575874694,3575874704,10
1,906,19951,3575874694,3575874705,11
1,906,19952,3575874694,3575874705,11
1,906,19953,3575874694,3575874706,12
1,906,19954,3575874694,3575874710,16
1,906,19955,3575874694,3575874710,16
1,906,19956,3575874694,3575874711,17
1,906,19957,3575874694,3575874711,17
1,906,19958,3575874694,3575874711,17
1,906,19959,3575874694,3575874713,19
1,906,19960,3575874694,3575874713,19
1,906,19961,3575874694,3575874714,20
1,906,19962,3575874694,3575874715,21
1,906,19963,3575874694,3575874718,24
1,906,19964,3575874694,3575874722,28
1,906,19965,3575874694,3575874723,29
1,906,19966,3575874694,3575874724,30
1,906,19967,3575874694,3575874725,31
1,906,19968,3575874694,3575874725,31
1,906,19969,3575874694,3575874726,32
1,906,19970,3575874694,3575874727,33
1,906,19971,3575874694,3575874728,34
1,906,19972,3575874694,3575874729,35
1,906,19973,3575874694,3575874730,36
1,906,19974,3575874694,3575874731,37
1,906,19975,3575874694,3575874733,39
1,906,19976,3575874694,3575874734,40
1,906,19977,3575874694,3575874735,41
1,906,19978,3575874694,3575874735,41
1,906,19979,3575874694,3575874735,41
1,906,19980,3575874694,3575874739,45
1,906,19981,3575874694,3575874739,45
1,906,19982,3575874694,3575874739,45
1,906,19983,3575874694,3575874740,46
1,906,19984,3575874694,3575874741,47
1,906,19985,3575874694,3575874743,49
1,906,19986,3575874694,3575874743,49
1,906,19987,3575874694,3575874744,50
1,907,19988,3575874754,3575874754,0
1,907,19989,3575874754,3575874754,0
1,907,19990,3575874754,3575874754,0
1,907,19991,3575874754,3575874754,0
1,907,19992,3575874754,3575874754,0
1,907,19993,3575874754,3575874754,0
1,907,19994,3575874754,3575874754,0
1,907,19995,3575874754,3575874754,0
1,907,19996,3575874754,3575874754,0
1,907,19997,3575874754,3575874756,2
1,907,19998,3575874754,3575874756,2
1,907,19999,3575874754,3575874759,5
1,907,20000,3575874754,3575874760,6
1,907,20001,3575874754,3575874761,7
1,907,20002,3575874754,3575874761,7
1,907,20003,3575874754,3575874763,9
1,907,20004,3575874754,3575874763,9
1,907,20005,3575874754,3575874764,10
1,907,20006,3575874754,3575874764,10
1,907,20007,3575874754,3575874765,11
1,907,20008,3575874754,3575874767,13
1,907,20009,3575874754,3575874772,18
1,907,20010,3575874754,3575874774,20
1,907,20011,3575874754,3575874774,20
1,907,20012,3575874754,3575874775,21
1,907,20013,3575874754,3575874776,22
1,907,20014,3575874754,3575874777,23
1,907,20015,3575874754,3575874778,24
1,907,20016,3575874754,3575874778,24
1,907,20017,3575874754,3575874779,25
1,907,20018,3575874754,3575874780,26
1,907,20019,3575874754,3575874781,27
1,907,20020,3575874754,3575874782,28
1,907,20021,3575874754,3575874782,28
1,907,20022,3575874754,3575874782,28
1,907,20023,3575874754,3575874782,28
1,907,20024,3575874754,3575874783,29
1,907,20025,3575874754,3575874784,30
1,907,20026,3575874754,3575874784,30
1,907,20027,3575874754,3575874785,31
1,907,20028,3575874754,3575874785,31
1,907,20029,3575874754,3575874785,31
1,907,20030,3575874754,3575874785,31
1,907,20031,3575874754,3575874785,31
1,907,20032,3575874754,3575874787,33
1,907,20033,3575874754,3575874787,33
1,907,20034,3575874754,3575874789,35
1,907,20035,3575874754,3575874789,35
1,907,20036,3575874754,3575874790,36
1,907,20037,3575874754,3575874791,37
1,907,20038,3575874754,3575874792,38
1,907,20039,3575874754,3575874793,39
1,907,20040,3575874754,3575874793,39
1,907,20041,3575874754,3575874794,40
1,907,20042,3575874754,3575874795,41
1,907,20043,3575874754,3575874797,43
1,907,20044,3575874754,3575874797,43
1,907,20045,3575874754,3575874798,44
1,907,20046,3575874754,3575874799,45
1,907,20047,3575874754,3575874801,47
1,907,20048,3575874754,3575874801,47
1,907,20049,3575874754,3575874802,48
1,908,20050,3575874817,3575874817,0
1,908,20051,3575874817,3575874817,0
1,908,20052,3575874817,3575874817,0
1,908,20053,3575874817,3575874817,0
1,908,20054,3575874817,3575874817,0
1,908,20055,3575874817,3575874817,0
1,908,20056,3575874817,3575874817,0
1,908,20057,3575874817,3575874817,0
1,908,20058,3575874817,3575874817,0
1,908,20059,3575874817,3575874817,0
1,908,20060,3575874817,3575874817,0
1,908,20061,3575874817,3575874817,0
1,908,20062,3575874817,3575874817,0
1,908,20063,3575874817,3575874817,0
1,908,20064,3575874817,3575874818,1
1,908,20065,3575874817,3575874819,2
1,908,20066,3575874817,3575874820,3
1,908,20067,3575874817,3575874820,3
1,908,20068,3575874817,3575874823,6
1,908,20069,3575874817,3575874823,6
1,908,20070,3575874817,3575874824,7
1,908,20071,3575874817,3575874824,7
1,908,20072,3575874817,3575874825,8
1,908,20073,3575874817,3575874826,9
1,908,20074,3575874817,3575874827,10
1,908,20075,3575874817,3575874827,10
1,908,20076,3575874817,3575874828,11
1,908,20077,3575874817,3575874831,14
1,908,20078,3575874817,3575874831,14
1,908,20079,3575874817,3575874831,14
1,908,20080,3575874817,3575874832,15
1,908,20081,3575874817,3575874832,15
1,908,20082,3575874817,3575874833,16
1,908,20083,3575874817,3575874833,16
1,908,20084,3575874817,3575874833,16
1,908,20085,3575874817,3575874835,18
1,908,20086,3575874817,3575874836,19
1,908,20087,3575874817,3575874837,20
1,908,20088,3575874817,3575874838,21
1,908,20089,3575874817,3575874842,25
1,908,20090,3575874817,3575874842,25
1,908,20091,3575874817,3575874843,26
1,908,20092,3575874817,3575874843,26
1,908,20093,3575874817,3575874843,26
1,908,20094,3575874817,3575874844,27
1,908,20095,3575874817,3575874845,28
1,908,20096,3575874817,3575874845,28
1,908,20097,3575874817,3575874845,28
1,908,20098,3575874817,3575874845,28
1,908,20099,3575874817,3575874846,29
1,908,20100,3575874817,3575874847,30
1,908,20101,3575874817,3575874847,30
1,908,20102,3575874817,3575874848,31
1,908,20103,3575874817,3575874850,33
1,908,20104,3575874817,3575874851,34
1,908,20105,3575874817,3575874852,35
1,908,20106,3575874817,3575874855,38
1,908,20107,3575874817,3575874856,39
1,908,20108,3575874817,3575874856,39
1,908,20109,3575874817,3575874859,42
1,908,20110,3575874817,3575874862,45
1,908,20111,3575874817,3575874862,45
1,908,20112,3575874817,3575874863,46
1,908,20113,3575874817,3575874864,47
1,908,20114,3575874817,3575874865,48
1,908,20115,3575874817,3575874867,50
1,909,20116,3575874877,3575874877,0
1,909,20117,3575874877,3575874877,0
1,909,20118,3575874877,3575874877,0
1,909,20119,3575874877,3575874877,0
1,909,20120,3575874877,3575874878,1
1,909,20121,3575874877,3575874879,2
1,909,20122,3575874877,3575874882,5
1,909,20123,3575874877,3575874882,5
1,909,20124,3575874877,3575874883,6
1,909,20125,3575874877,3575874883,6
1,909,20126,3575874877,3575874885,8
1,909,20127,3575874877,3575874886,9
1,909,20128,3575874877,3575874886,9
1,909,20129,3575874877,3575874896,19
1,909,20130,3575874877,3575874898,21
1,909,20131,3575874877,3575874898,21
1,909,20132,3575874877,3575874898,21
1,909,20133,3575874877,3575874900,23
1,909,20134,3575874877,3575874900,23
1,909,20135,3575874877,3575874901,24
1,909,20136,3575874877,3575874903,26
1,909,20137,3575874877,3575874903,26
1,909,20138,3575874877,3575874904,27
1,909,20139,3575874877,3575874904,27
1,909,20140,3575874877,3575874904,27
1,909,20141,3575874877,3575874905,28
1,909,20142,3575874877,3575874905,28
1,909,20143,3575874877,3575874906,29
1,909,20144,3575874877,3575874906,29
1,909,20145,3575874877,3575874910,33
1,909,20146,3575874877,3575874911,34
1,909,20147,3575874877,3575874911,34
1,909,20148,3575874877,3575874911,34
1,909,20149,3575874877,3575874911,34
1,909,20150,3575874877,3575874912,35
1,909,20151,3575874877,3575874914,37
1,909,20152,3575874877,3575874914,37
1,909,20153,3575874877,3575874918,41
1,909,20154,3575874877,3575874919,42
1,909,20155,3575874877,3575874922,45
1,909,20156,3575874877,3575874922,45
1,909,20157,3575874877,3575874924,47
1,909,20158,3575874877,3575874924,47
1,909,20159,3575874877,3575874926,49
1,910,20160,3575874939,3575874939,0
1,910,20161,3575874939,3575874939,0
1,910,20162,3575874939,3575874939,0
1,910,20163,3575874939,3575874939,0
1,910,20164,3575874939,3575874939,0
1,910,20165,3575874939,3575874939,0
1,910,20166,3575874939,3575874939,0
1,910,20167,3575874939,3575874939,0
1,910,20168,3575874939,3575874939,0
1,910,20169,3575874939,3575874939,0
1,910,20170,3575874939,3575874939,0
1,910,20171,3575874939,3575874939,0
1,910,20172,3575874939,3575874940,1
1,910,20173,3575874939,3575874941,2
1,910,20174,3575874939,3575874943,4
1,910,20175,3575874939,3575874944,5
1,910,20176,3575874939,3575874944,5
1,910,20177,3575874939,3575874946,7
1,910,20178,3575874939,3575874948,9
1,910,20179,3575874939,3575874948,9
1,910,20180,3575874939,3575874950,11
1,910,20181,3575874939,3575874950,11
1,910,20182,3575874939,3575874950,11
1,910,20183,3575874939,3575874952,13
1,910,20184,3575874939,3575874952,13
1,910,20185,3575874939,3575874953,14
1,910,20186,3575874939,3575874953,14
1,910,20187,3575874939,3575874955,16
1,910,20188,3575874939,3575874956,17
1,910,20189,3575874939,3575874956,17
1,910,20190,3575874939,3575874959,20
1,910,20191,3575874939,3575874960,21
1,910,20192,3575874939,3575874961,22
1,910,20193,3575874939,3575874962,23
1,910,20194,3575874939,3575874963,24
1,910,20195,3575874939,3575874963,24
1,910,20196,3575874939,3575874963,24
1,910,20197,3575874939,3575874966,27
1,910,20198,3575874939,3575874967,28
1,910,20199,3575874939,3575874970,31
1,910,20200,3575874939,3575874972,33
1,910,20201,3575874939,3575874974,35
1,910,20202,3575874939,3575874974,35
1,910,20203,3575874939,3575874974,35
1,910,20204,3575874939,3575874977,38
1,910,20205,3575874939,3575874977,38
1,910,20206,3575874939,3575874978,39
1,910,20207,3575874939,3575874979,40
1,910,20208,3575874939,3575874979,40
1,910,20209,3575874939,3575874980,41
1,910,20210,3575874939,3575874980,41
1,910,20211,3575874939,3575874982,43
1,910,20212,3575874939,3575874982,43
1,910,20213,3575874939,3575874982,43
1,910,20214,3575874939,3575874984,45
1,910,20215,3575874939,3575874984,45
1,910,20216,3575874939,3575874984,45
1,910,20217,3575874939,3575874984,45
1,910,20218,3575874939,3575874985,46
1,910,20219,3575874939,3575874985,46
1,910,20220,3575874939,3575874985,46
1,910,20221,3575874939,3575874986,47
1,910,20222,3575874939,3575874986,47
1,910,20223,3575874939,3575874987,48
1,910,20224,3575874939,3575874989,50
1,911,20225,3575875000,3575875000,0
1,911,20226,3575875000,3575875000,0
1,911,20227,3575875000,3575875000,0
1,911,20228,3575875000,3575875000,0
1,911,20229,3575875000,3575875000,0
1,911,20230,3575875000,3575875000,0
1,911,20231,3575875000,3575875000,0
1,911,20232,3575875000,3575875000,0
1,911,20233,3575875000,3575875000,0
1,911,20234,3575875000,3575875000,0
1,911,20235,3575875000,3575875000,0
1,911,20236,3575875000,3575875001,1
1,911,20237,3575875000,3575875001,1
1,911,20238,3575875000,3575875002,2
1,911,20239,3575875000,3575875006,6
1,911,20240,3575875000,3575875008,8
1,911,20241,3575875000,3575875008,8
1,911,20242,3575875000,3575875008,8
1,911,20243,3575875000,3575875012,12
1,911,20244,3575875000,3575875014,14
1,911,20245,3575875000,3575875015,15
1,911,20246,3575875000,3575875015,15
1,911,20247,3575875000,3575875016,16
1,911,20248,3575875000,3575875016,16
1,911,20249,3575875000,3575875017,17
1,911,20250,3575875000,3575875017,17
1,911,20251,3575875000,3575875017,17
1,911,20252,3575875000,3575875018,18
1,911,20253,3575875000,3575875019,19
1,911,20254,3575875000,3575875019,19
1,911,20255,3575875000,3575875020,20
1,911,20256,3575875000,3575875020,20
1,911,20257,3575875000,3575875022,22
1,911,20258,3575875000,3575875022,22
1,911,20259,3575875000,3575875023,23
1,911,20260,3575875000,3575875024,24
1,911,20261,3575875000,3575875024,24
1,911,20262,3575875000,3575875026,26
1,911,20263,3575875000,3575875026,26
1,911,20264,3575875000,3575875026,26
1,911,20265,3575875000,3575875028,28
1,911,20266,3575875000,3575875028,28
1,911,20267,3575875000,3575875028,28
1,911,20268,3575875000,3575875031,31
1,911,20269,3575875000,3575875031,31
1,911,20270,3575875000,3575875032,32
1,911,20271,3575875000,3575875032,32
1,911,20272,3575875000,3575875032,32
1,911,20273,3575875000,3575875032,32
1,911,20274,3575875000,3575875034,34
1,911,20275,3575875000,3575875034,34
1,911,20276,3575875000,3575875034,34
1,911,20277,3575875000,3575875037,37
1,911,20278,3575875000,3575875037,37
1,911,20279,3575875000,3575875038,38
1,911,20280,3575875000,3575875042,42
1,911,20281,3575875000,3575875042,42
1,911,20282,3575875000,3575875042,42
1,911,20283,3575875000,3575875043,43
1,911,20284,3575875000,3575875043,43
1,911,20285,3575875000,3575875044,44
1,911,20286,3575875000,3575875044,44
1,911,20287,3575875000,3575875045,45
1,911,20288,3575875000,3575875045,45
1,911,20289,3575875000,3575875045,45
1,911,20290,3575875000,3575875045,45
1,911,20291,3575875000,3575875046,46
1,911,20292,3575875000,3575875046,46
1,911,20293,3575875000,3575875048,48
1,911,20294,3575875000,3575875050,50
1,912,20295,3575875064,3575875064,0
1,912,20296,3575875064,3575875065,1
1,912,20297,3575875064,3575875065,1
1,912,20298,3575875064,3575875065,1
1,912,20299,3575875064,3575875065,1
1,912,20300,3575875064,3575875065,1
1,912,20301,3575875064,3575875065,1
1,912,20302,3575875064,3575875065,1
1,912,20303,3575875064,3575875065,1
1,912,20304,3575875064,3575875065,1
1,912,20305,3575875064,3575875065,1
1,912,20306,3575875064,3575875065,1
1,912,20307,3575875064,3575875065,1
1,912,20308,3575875064,3575875066,2
1,912,20309,3575875064,3575875067,3
1,912,20310,3575875064,3575875068,4
1,912,20311,3575875064,3575875069,5
1,912,20312,3575875064,3575875069,5
1,912,20313,3575875064,3575875070,6
1,912,20314,3575875064,3575875071,7
1,912,20315,3575875064,3575875079,15
1,912,20316,3575875064,3575875079,15
1,912,20317,3575875064,3575875082,18
1,912,20318,3575875064,3575875082,18
1,912,20319,3575875064,3575875083,19
1,912,20320,3575875064,3575875083,19
1,912,20321,3575875064,3575875085,21
1,912,20322,3575875064,3575875087,23
1,912,20323,3575875064,3575875087,23
1,912,20324,3575875064,3575875088,24
1,912,20325,3575875064,3575875097,33
1,912,20326,3575875064,3575875098,34
1,912,20327,3575875064,3575875098,34
1,912,20328,3575875064,3575875098,34
1,912,20329,3575875064,3575875099,35
1,912,20330,3575875064,3575875100,36
1,912,20331,3575875064,3575875103,39
1,912,20332,3575875064,3575875104,40
1,912,20333,3575875064,3575875104,40
1,912,20334,3575875064,3575875105,41
1,912,20335,3575875064,3575875105,41
1,912,20336,3575875064,3575875106,42
1,912,20337,3575875064,3575875107,43
1,912,20338,3575875064,3575875110,46
1,912,20339,3575875064,3575875111,47
1,912,20340,3575875064,3575875111,47
1,912,20341,3575875064,3575875111,47
1,912,20342,3575875064,3575875112,48
1,912,20343,3575875064,3575875113,49
1,913,20344,3575875128,3575875128,0
1,913,20345,3575875128,3575875128,0
1,913,20346,3575875128,3575875128,0
1,913,20347,3575875128,3575875128,0
1,913,20348,3575875128,3575875128,0
1,913,20349,3575875128,3575875128,0
1,913,20350,3575875128,3575875128,0
1,913,20351,3575875128,3575875128,0
1,913,20352,3575875128,3575875128,0
1,913,20353,3575875128,3575875128,0
1,913,20354,3575875128,3575875128,0
1,913,20355,3575875128,3575875128,0
1,913,20356,3575875128,3575875129,1
1,913,20357,3575875128,3575875131,3
1,913,20358,3575875128,3575875132,4
1,913,20359,3575875128,3575875133,5
1,913,20360,3575875128,3575875133,5
1,913,20361,3575875128,3575875134,6
1,913,20362,3575875128,3575875136,8
1,913,20363,3575875128,3575875136,8
1,913,20364,3575875128,3575875136,8
1,913,20365,3575875128,3575875139,11
1,913,20366,3575875128,3575875140,12
1,913,20367,3575875128,3575875140,12
1,913,20368,3575875128,3575875142,14
1,913,20369,3575875128,3575875143,15
1,913,20370,3575875128,3575875144,16
1,913,20371,3575875128,3575875144,16
1,913,20372,3575875128,3575875146,18
1,913,20373,3575875128,3575875148,20
1,913,20374,3575875128,3575875149,21
1,913,20375,3575875128,3575875150,22
1,913,20376,3575875128,3575875150,22
1,913,20377,3575875128,3575875150,22
1,913,20378,3575875128,3575875152,24
1,913,20379,3575875128,3575875154,26
1,913,20380,3575875128,3575875154,26
1,913,20381,3575875128,3575875156,28
1,913,20382,3575875128,3575875156,28
1,913,20383,3575875128,3575875157,29
1,913,20384,3575875128,3575875159,31
1,913,20385,3575875128,3575875160,32
1,913,20386,3575875128,3575875161,33
1,913,20387,3575875128,3575875162,34
1,913,20388,3575875128,3575875163,35
1,913,20389,3575875128,3575875164,36
1,913,20390,3575875128,3575875164,36
1,913,20391,3575875128,3575875166,38
1,913,20392,3575875128,3575875167,39
1,913,20393,3575875128,3575875171,43
1,913,20394,3575875128,3575875172,44
1,913,20395,3575875128,3575875174,46
1,913,20396,3575875128,3575875175,47
1,913,20397,3575875128,3575875175,47
1,913,20398,3575875128,3575875177,49
1,914,20399,3575875191,3575875191,0
1,914,20400,3575875191,3575875191,0
1,914,20401,3575875191,3575875191,0
1,914,20402,3575875191,3575875191,0
1,914,20403,3575875191,3575875191,0
1,914,20404,3575875191,3575875191,0
1,914,20405,3575875191,3575875191,0
1,914,20406,3575875191,3575875191,0
1,914,20407,3575875191,3575875191,0
1,914,20408,3575875191,3575875191,0
1,914,20409,3575875191,3575875191,0
1,914,20410,3575875191,3575875191,0
1,914,20411,3575875191,3575875191,0
1,914,20412,3575875191,3575875191,0
1,914,20413,3575875191,3575875191,0
1,914,20414,3575875191,3575875191,0
1,914,20415,3575875191,3575875191,0
1,914,20416,3575875191,3575875192,1
1,914,20417,3575875191,3575875192,1
1,914,20418,3575875191,3575875193,2
1,914,20419,3575875191,3575875196,5
1,914,20420,3575875191,3575875197,6
1,914,20421,3575875191,3575875198,7
1,914,20422,3575875191,3575875200,9
1,914,20423,3575875191,3575875200,9
1,914,20424,3575875191,3575875201,10
1,914,20425,3575875191,3575875201,10
1,914,20426,3575875191,3575875202,11
1,914,20427,3575875191,3575875206,15
1,914,20428,3575875191,3575875207,16
1,914,20429,3575875191,3575875208,17
1,914,20430,3575875191,3575875209,18
1,914,20431,3575875191,3575875212,21
1,914,20432,3575875191,3575875214,23
1,914,20433,3575875191,3575875214,23
1,914,20434,3575875191,3575875215,24
1,914,20435,3575875191,3575875215,24
1,914,20436,3575875191,3575875216,25
1,914,20437,3575875191,3575875216,25
1,914,20438,3575875191,3575875217,26
1,914,20439,3575875191,3575875217,26
1,914,20440,3575875191,3575875218,27
1,914,20441,3575875191,3575875218,27
1,914,20442,3575875191,3575875218,27
1,914,20443,3575875191,3575875218,27
1,914,20444,3575875191,3575875220,29
1,914,20445,3575875191,3575875221,30
1,914,20446,3575875191,3575875222,31
1,914,20447,3575875191,3575875223,32
1,914,20448,3575875191,3575875223,32
1,914,20449,3575875191,3575875224,33
1,914,20450,3575875191,3575875224,33
1,914,20451,3575875191,3575875225,34
1,914,20452,3575875191,3575875226,35
1,914,20453,3575875191,3575875226,35
1,914,20454,3575875191,3575875226,35
1,914,20455,3575875191,3575875228,37
1,914,20456,3575875191,3575875229,38
1,914,20457,3575875191,3575875230,39
1,914,20458,3575875191,3575875232,41
1,914,20459,3575875191,3575875232,41
1,914,20460,3575875191,3575875232,41
1,914,20461,3575875191,3575875233,42
1,914,20462,3575875191,3575875233,42
1,914,20463,3575875191,3575875234,43
1,914,20464,3575875191,3575875234,43
1,914,20465,3575875191,3575875234,43
1,914,20466,3575875191,3575875237,46
1,914,20467,3575875191,3575875237,46
1,914,20468,3575875191,3575875237,46
1,915,20469,3575875250,3575875250,0
1,915,20470,3575875250,3575875250,0
1,915,20471,3575875250,3575875250,0
1,915,20472,3575875250,3575875250,0
1,915,20473,3575875250,3575875250,0
1,915,20474,3575875250,3575875250,0
1,915,20475,3575875250,3575875250,0
1,915,20476,3575875250,3575875250,0
1,915,20477,3575875250,3575875250,0
1,915,20478,3575875250,3575875250,0
1,915,20479,3575875250,3575875250,0
1,915,20480,3575875250,3575875250,0
1,915,20481,3575875250,3575875250,0
1,915,20482,3575875250,3575875251,1
1,915,20483,3575875250,3575875254,4
1,915,20484,3575875250,3575875254,4
1,915,20485,3575875250,3575875254,4
1,915,20486,3575875250,3575875256,6
1,915,20487,3575875250,3575875256,6
1,915,20488,3575875250,3575875257,7
1,915,20489,3575875250,3575875259,9
1,915,20490,3575875250,3575875262,12
1,915,20491,3575875250,3575875262,12
1,915,20492,3575875250,3575875264,14
1,915,20493,3575875250,3575875266,16
1,915,20494,3575875250,3575875267,17
1,915,20495,3575875250,3575875268,18
1,915,20496,3575875250,3575875269,19
1,915,20497,3575875250,3575875270,20
1,915,20498,3575875250,3575875271,21
1,915,20499,3575875250,3575875276,26
1,915,20500,3575875250,3575875278,28
1,915,20501,3575875250,3575875279,29
1,915,20502,3575875250,3575875281,31
1,915,20503,3575875250,3575875282,32
1,915,20504,3575875250,3575875283,33
1,915,20505,3575875250,3575875284,34
1,915,20506,3575875250,3575875285,35
1,915,20507,3575875250,3575875286,36
1,915,20508,3575875250,3575875287,37
1,915,20509,3575875250,3575875287,37
1,915,20510,3575875250,3575875297,47
1,915,20511,3575875250,3575875298,48
1,915,20512,3575875250,3575875299,49
1,915,20513,3575875250,3575875299,49
1,915,20514,3575875250,3575875300,50
1,916,20515,3575875314,3575875314,0
1,916,20516,3575875314,3575875314,0
1,916,20517,3575875314,3575875314,0
1,916,20518,3575875314,3575875314,0
1,916,20519,3575875314,3575875314,0
1,916,20520,3575875314,3575875314,0
1,916,20521,3575875314,3575875314,0
1,916,20522,3575875314,3575875314,0
1,916,20523,3575875314,3575875314,0
1,916,20524,3575875314,3575875314,0
1,916,20525,3575875314,3575875314,0
1,916,20526,3575875314,3575875314,0
1,916,20527,3575875314,3575875314,0
1,916,20528,3575875314,3575875314,0
1,916,20529,3575875314,3575875314,0
1,916,20530,3575875314,3575875315,1
1,916,20531,3575875314,3575875316,2
1,916,20532,3575875314,3575875318,4
1,916,20533,3575875314,3575875319,5
1,916,20534,3575875314,3575875323,9
1,916,20535,3575875314,3575875324,10
1,916,20536,3575875314,3575875325,11
1,916,20537,3575875314,3575875326,12
1,916,20538,3575875314,3575875327,13
1,916,20539,3575875314,3575875328,14
1,916,20540,3575875314,3575875329,15
1,916,20541,3575875314,3575875329,15
1,916,20542,3575875314,3575875332,18
1,916,20543,3575875314,3575875332,18
1,916,20544,3575875314,3575875333,19
1,916,20545,3575875314,3575875334,20
1,916,20546,3575875314,3575875336,22
1,916,20547,3575875314,3575875336,22
1,916,20548,3575875314,3575875336,22
1,916,20549,3575875314,3575875339,25
1,916,20550,3575875314,3575875340,26
1,916,20551,3575875314,3575875341,27
1,916,20552,3575875314,3575875342,28
1,916,20553,3575875314,3575875343,29
1,916,20554,3575875314,3575875343,29
1,916,20555,3575875314,3575875345,31
1,916,20556,3575875314,3575875347,33
1,916,20557,3575875314,3575875348,34
1,916,20558,3575875314,3575875349,35
1,916,20559,3575875314,3575875350,36
1,916,20560,3575875314,3575875350,36
1,916,20561,3575875314,3575875352,38
1,916,20562,3575875314,3575875352,38
1,916,20563,3575875314,3575875353,39
1,916,20564,3575875314,3575875353,39
1,916,20565,3575875314,3575875354,40
1,916,20566,3575875314,3575875355,41
1,916,20567,3575875314,3575875356,42
1,916,20568,3575875314,3575875357,43
1,916,20569,3575875314,3575875357,43
1,916,20570,3575875314,3575875359,45
1,916,20571,3575875314,3575875361,47
1,916,20572,3575875314,3575875361,47
1,916,20573,3575875314,3575875363,49
1,916,20574,3575875314,3575875363,49
1,917,20575,3575875375,3575875375,0
1,917,20576,3575875375,3575875375,0
1,917,20577,3575875375,3575875375,0
1,917,20578,3575875375,3575875375,0
1,917,20579,3575875375,3575875375,0
1,917,20580,3575875375,3575875375,0
1,917,20581,3575875375,3575875375,0
1,917,20582,3575875375,3575875375,0
1,917,20583,3575875375,3575875376,1
1,917,20584,3575875375,3575875376,1
1,917,20585,3575875375,3575875378,3
1,917,20586,3575875375,3575875379,4
1,917,20587,3575875375,3575875379,4
1,917,20588,3575875375,3575875379,4
1,917,20589,3575875375,3575875380,5
1,917,20590,3575875375,3575875380,5
1,917,20591,3575875375,3575875383,8
1,917,20592,3575875375,3575875383,8
1,917,20593,3575875375,3575875384,9
1,917,20594,3575875375,3575875385,10
1,917,20595,3575875375,3575875385,10
1,917,20596,3575875375,3575875385,10
1,917,20597,3575875375,3575875385,10
1,917,20598,3575875375,3575875385,10
1,917,20599,3575875375,3575875386,11
1,917,20600,3575875375,3575875386,11
1,917,20601,3575875375,3575875387,12
1,917,20602,3575875375,3575875387,12
1,917,20603,3575875375,3575875388,13
1,917,20604,3575875375,3575875389,14
1,917,20605,3575875375,3575875390,15
1,917,20606,3575875375,3575875391,16
1,917,20607,3575875375,3575875393,18
1,917,20608,3575875375,3575875393,18
1,917,20609,3575875375,3575875396,21
1,917,20610,3575875375,3575875398,23
1,917,20611,3575875375,3575875398,23
1,917,20612,3575875375,3575875399,24
1,917,20613,3575875375,3575875400,25
1,917,20614,3575875375,3575875402,27
1,917,20615,3575875375,3575875402,27
1,917,20616,3575875375,3575875402,27
1,917,20617,3575875375,3575875405,30
1,917,20618,3575875375,3575875407,32
1,917,20619,3575875375,3575875407,32
1,917,20620,3575875375,3575875408,33
1,917,20621,3575875375,3575875409,34
1,917,20622,3575875375,3575875410,35
1,917,20623,3575875375,3575875412,37
1,917,20624,3575875375,3575875414,39
1,917,20625,3575875375,3575875416,41
1,917,20626,3575875375,3575875416,41
1,917,20627,3575875375,3575875416,41
1,917,20628,3575875375,3575875417,42
1,917,20629,3575875375,3575875417,42
1,917,20630,3575875375,3575875417,42
1,917,20631,3575875375,3575875418,43
1,917,20632,3575875375,3575875418,43
1,917,20633,3575875375,3575875419,44
1,917,20634,3575875375,3575875420,45
1,917,20635,3575875375,3575875421,46
1,917,20636,3575875375,3575875422,47
1,917,20637,3575875375,3575875423,48
1,917,20638,3575875375,3575875423,48
1,917,20639,3575875375,3575875424,49
1,917,20640,3575875375,3575875424,49
1,918,20641,3575875439,3575875440,1
1,918,20642,3575875439,3575875440,1
1,918,20643,3575875439,3575875440,1
1,918,20644,3575875439,3575875440,1
1,918,20645,3575875439,3575875440,1
1,918,20646,3575875439,3575875440,1
1,918,20647,3575875439,3575875440,1
1,918,20648,3575875439,3575875440,1
1,918,20649,3575875439,3575875440,1
1,918,20650,3575875439,3575875440,1
1,918,20651,3575875439,3575875440,1
1,918,20652,3575875439,3575875440,1
1,918,20653,3575875439,3575875440,1
1,918,20654,3575875439,3575875440,1
1,918,20655,3575875439,3575875440,1
1,918,20656,3575875439,3575875440,1
1,918,20657,3575875439,3575875440,1
1,918,20658,3575875439,3575875443,4
1,918,20659,3575875439,3575875444,5
1,918,20660,3575875439,3575875444,5
1,918,20661,3575875439,3575875444,5
1,918,20662,3575875439,3575875445,6
1,918,20663,3575875439,3575875445,6
1,918,20664,3575875439,3575875445,6
1,918,20665,3575875439,3575875445,6
1,918,20666,3575875439,3575875446,7
1,918,20667,3575875439,3575875446,7
1,918,20668,3575875439,3575875446,7
1,918,20669,3575875439,3575875448,9
1,918,20670,3575875439,3575875449,10
1,918,20671,3575875439,3575875450,11
1,918,20672,3575875439,3575875452,13
1,918,20673,3575875439,3575875453,14
1,918,20674,3575875439,3575875453,14
1,918,20675,3575875439,3575875456,17
1,918,20676,3575875439,3575875456,17
1,918,20677,3575875439,3575875462,23
1,918,20678,3575875439,3575875462,23
1,918,20679,3575875439,3575875466,27
1,918,20680,3575875439,3575875467,28
1,918,20681,3575875439,3575875467,28
1,918,20682,3575875439,3575875468,29
1,918,20683,3575875439,3575875469,30
1,918,20684,3575875439,3575875469,30
1,918,20685,3575875439,3575875470,31
1,918,20686,3575875439,3575875471,32
1,918,20687,3575875439,3575875476,37
1,918,20688,3575875439,3575875478,39
1,918,20689,3575875439,3575875478,39
1,918,20690,3575875439,3575875481,42
1,918,20691,3575875439,3575875482,43
1,918,20692,3575875439,3575875483,44
1,918,20693,3575875439,3575875483,44
1,918,20694,3575875439,3575875484,45
1,918,20695,3575875439,3575875486,47
1,918,20696,3575875439,3575875487,48
1,918,20697,3575875439,3575875487,48
1,918,20698,3575875439,3575875488,49
1,919,20699,3575875499,3575875499,0
1,919,20700,3575875499,3575875499,0
1,919,20701,3575875499,3575875499,0
1,919,20702,3575875499,3575875499,0
1,919,20703,3575875499,3575875499,0
1,919,20704,3575875499,3575875502,3
1,919,20705,3575875499,3575875502,3
1,919,20706,3575875499,3575875503,4
1,919,20707,3575875499,3575875504,5
1,919,20708,3575875499,3575875505,6
1,919,20709,3575875499,3575875505,6
1,919,20710,3575875499,3575875507,8
1,919,20711,3575875499,3575875509,10
1,919,20712,3575875499,3575875509,10
1,919,20713,3575875499,3575875510,11
1,919,20714,3575875499,3575875511,12
1,919,20715,3575875499,3575875511,12
1,919,20716,3575875499,3575875512,13
1,919,20717,3575875499,3575875513,14
1,919,20718,3575875499,3575875515,16
1,919,20719,3575875499,3575875517,18
1,919,20720,3575875499,3575875518,19
1,919,20721,3575875499,3575875522,23
1,919,20722,3575875499,3575875524,25
1,919,20723,3575875499,3575875524,25
1,919,20724,3575875499,3575875525,26
1,919,20725,3575875499,3575875526,27
1,919,20726,3575875499,3575875527,28
1,919,20727,3575875499,3575875528,29
1,919,20728,3575875499,3575875528,29
1,919,20729,3575875499,3575875528,29
1,919,20730,3575875499,3575875531,32
1,919,20731,3575875499,3575875531,32
1,919,20732,3575875499,3575875531,32
1,919,20733,3575875499,3575875532,33
1,919,20734,3575875499,3575875534,35
1,919,20735,3575875499,3575875535,36
1,919,20736,3575875499,3575875535,36
1,919,20737,3575875499,3575875535,36
1,919,20738,3575875499,3575875538,39
1,919,20739,3575875499,3575875539,40
1,919,20740,3575875499,3575875540,41
1,919,20741,3575875499,3575875540,41
1,919,20742,3575875499,3575875541,42
1,919,20743,3575875499,3575875542,43
1,919,20744,3575875499,3575875543,44
1,919,20745,3575875499,3575875544,45
1,919,20746,3575875499,3575875547,48
1,919,20747,3575875499,3575875549,50
1,920,20748,3575875559,3575875559,0
1,920,20749,3575875559,3575875559,0
1,920,20750,3575875559,3575875559,0
1,920,20751,3575875559,3575875559,0
1,920,20752,3575875559,3575875559,0
1,920,20753,3575875559,3575875559,0
1,920,20754,3575875559,3575875559,0
1,920,20755,3575875559,3575875559,0
1,920,20756,3575875559,3575875559,0
1,920,20757,3575875559,3575875559,0
1,920,20758,3575875559,3575875559,0
1,920,20759,3575875559,3575875559,0
1,920,20760,3575875559,3575875562,3
1,920,20761,3575875559,3575875562,3
1,920,20762,3575875559,3575875563,4
1,920,20763,3575875559,3575875564,5
1,920,20764,3575875559,3575875565,6
1,920,20765,3575875559,3575875567,8
1,920,20766,3575875559,3575875568,9
1,920,20767,3575875559,3575875570,11
1,920,20768,3575875559,3575875572,13
1,920,20769,3575875559,3575875575,16
1,920,20770,3575875559,3575875575,16
1,920,20771,3575875559,3575875577,18
1,920,20772,3575875559,3575875577,18
1,920,20773,3575875559,3575875579,20
1,920,20774,3575875559,3575875579,20
1,920,20775,3575875559,3575875579,20
1,920,20776,3575875559,3575875580,21
1,920,20777,3575875559,3575875581,22
1,920,20778,3575875559,3575875582,23
1,920,20779,3575875559,3575875583,24
1,920,20780,3575875559,3575875583,24
1,920,20781,3575875559,3575875583,24
1,920,20782,3575875559,3575875583,24
1,920,20783,3575875559,3575875584,25
1,920,20784,3575875559,3575875585,26
1,920,20785,3575875559,3575875585,26
1,920,20786,3575875559,3575875585,26
1,920,20787,3575875559,3575875585,26
1,920,20788,3575875559,3575875586,27
1,920,20789,3575875559,3575875586,27
1,920,20790,3575875559,3575875587,28
1,920,20791,3575875559,3575875589,30
1,920,20792,3575875559,3575875589,30
1,920,20793,3575875559,3575875590,31
1,920,20794,3575875559,3575875591,32
1,920,20795,3575875559,3575875591,32
1,920,20796,3575875559,3575875592,33
1,920,20797,3575875559,3575875593,34
1,920,20798,3575875559,3575875595,36
1,920,20799,3575875559,3575875596,37
1,920,20800,3575875559,3575875597,38
1,920,20801,3575875559,3575875599,40
1,920,20802,3575875559,3575875600,41
1,920,20803,3575875559,3575875601,42
1,920,20804,3575875559,3575875601,42
1,920,20805,3575875559,3575875601,42
1,920,20806,3575875559,3575875605,46
1,920,20807,3575875559,3575875606,47
1,920,20808,3575875559,3575875608,49
1,920,20809,3575875559,3575875608,49
1,921,20810,3575875619,3575875619,0
1,921,20811,3575875619,3575875619,0
1,921,20812,3575875619,3575875619,0
1,921,20813,3575875619,3575875619,0
1,921,20814,3575875619,3575875619,0
1,921,20815,3575875619,3575875619,0
1,921,20816,3575875619,3575875619,0
1,921,20817,3575875619,3575875619,0
1,921,20818,3575875619,3575875619,0
1,921,20819,3575875619,3575875619,0
1,921,20820,3575875619,3575875619,0
1,921,20821,3575875619,3575875619,0
1,921,20822,3575875619,3575875619,0
1,921,20823,3575875619,3575875619,0
1,921,20824,3575875619,3575875620,1
1,921,20825,3575875619,3575875622,3
1,921,20826,3575875619,3575875623,4
1,921,20827,3575875619,3575875623,4
1,921,20828,3575875619,3575875623,4
1,921,20829,3575875619,3575875624,5
1,921,20830,3575875619,3575875625,6
1,921,20831,3575875619,3575875625,6
1,921,20832,3575875619,3575875625,6
1,921,20833,3575875619,3575875627,8
1,921,20834,3575875619,3575875630,11
1,921,20835,3575875619,3575875632,13
1,921,20836,3575875619,3575875632,13
1,921,20837,3575875619,3575875632,13
1,921,20838,3575875619,3575875633,14
1,921,20839,3575875619,3575875633,14
1,921,20840,3575875619,3575875633,14
1,921,20841,3575875619,3575875634,15
1,921,20842,3575875619,3575875635,16
1,921,20843,3575875619,3575875637,18
1,921,20844,3575875619,3575875638,19
1,921,20845,3575875619,3575875642,23
1,921,20846,3575875619,3575875643,24
1,921,20847,3575875619,3575875643,24
1,921,20848,3575875619,3575875644,25
1,921,20849,3575875619,3575875644,25
1,921,20850,3575875619,3575875644,25
1,921,20851,3575875619,3575875644,25
1,921,20852,3575875619,3575875644,25
1,921,20853,3575875619,3575875645,26
1,921,20854,3575875619,3575875645,26
1,921,20855,3575875619,3575875646,27
1,921,20856,3575875619,3575875647,28
1,921,20857,3575875619,3575875647,28
1,921,20858,3575875619,3575875648,29
1,921,20859,3575875619,3575875649,30
1,921,20860,3575875619,3575875652,33
1,921,20861,3575875619,3575875653,34
1,921,20862,3575875619,3575875653,34
1,921,20863,3575875619,3575875654,35
1,921,20864,3575875619,3575875655,36
1,921,20865,3575875619,3575875659,40
1,921,20866,3575875619,3575875661,42
1,921,20867,3575875619,3575875662,43
1,921,20868,3575875619,3575875663,44
1,921,20869,3575875619,3575875666,47
1,921,20870,3575875619,3575875667,48
1,921,20871,3575875619,3575875668,49
1,922,20872,3575875682,3575875682,0
1,922,20873,3575875682,3575875682,0
1,922,20874,3575875682,3575875682,0
1,922,20875,3575875682,3575875682,0
1,922,20876,3575875682,3575875683,1
1,922,20877,3575875682,3575875683,1
1,922,20878,3575875682,3575875683,1
1,922,20879,3575875682,3575875684,2
1,922,20880,3575875682,3575875686,4
1,922,20881,3575875682,3575875686,4
1,922,20882,3575875682,3575875687,5
1,922,20883,3575875682,3575875696,14
1,922,20884,3575875682,3575875697,15
1,922,20885,3575875682,3575875698,16
1,922,20886,3575875682,3575875698,16
1,922,20887,3575875682,3575875699,17
1,922,20888,3575875682,3575875699,17
1,922,20889,3575875682,3575875701,19
1,922,20890,3575875682,3575875703,21
1,922,20891,3575875682,3575875703,21
1,922,20892,3575875682,3575875703,21
1,922,20893,3575875682,3575875704,22
1,922,20894,3575875682,3575875705,23
1,922,20895,3575875682,3575875706,24
1,922,20896,3575875682,3575875708,26
1,922,20897,3575875682,3575875710,28
1,922,20898,3575875682,3575875710,28
1,922,20899,3575875682,3575875711,29
1,922,20900,3575875682,3575875713,31
1,922,20901,3575875682,3575875713,31
1,922,20902,3575875682,3575875715,33
1,922,20903,3575875682,3575875716,34
1,922,20904,3575875682,3575875717,35
1,922,20905,3575875682,3575875718,36
1,922,20906,3575875682,3575875721,39
1,922,20907,3575875682,3575875723,41
1,922,20908,3575875682,3575875724,42
1,922,20909,3575875682,3575875725,43
1,922,20910,3575875682,3575875725,43
1,922,20911,3575875682,3575875726,44
1,922,20912,3575875682,3575875727,45
1,922,20913,3575875682,3575875728,46
1,922,20914,3575875682,3575875728,46
1,922,20915,3575875682,3575875729,47
1,922,20916,3575875682,3575875732,50
1,923,20917,3575875745,3575875745,0
1,923,20918,3575875745,3575875745,0
1,923,20919,3575875745,3575875745,0
1,923,20920,3575875745,3575875745,0
1,923,20921,3575875745,3575875745,0
1,923,20922,3575875745,3575875745,0
1,923,20923,3575875745,3575875745,0
1,923,20924,3575875745,3575875745,0
1,923,20925,3575875745,3575875745,0
1,923,20926,3575875745,3575875745,0
1,923,20927,3575875745,3575875745,0
1,923,20928,3575875745,3575875745,0
1,923,20929,3575875745,3575875747,2
1,923,20930,3575875745,3575875747,2
1,923,20931,3575875745,3575875748,3
1,923,20932,3575875745,3575875749,4
1,923,20933,3575875745,3575875751,6
1,923,20934,3575875745,3575875752,7
1,923,20935,3575875745,3575875753,8
1,923,20936,3575875745,3575875753,8
1,923,20937,3575875745,3575875754,9
1,923,20938,3575875745,3575875755,10
1,923,20939,3575875745,3575875756,11
1,923,20940,3575875745,3575875756,11
1,923,20941,3575875745,3575875756,11
1,923,20942,3575875745,3575875759,14
1,923,20943,3575875745,3575875760,15
1,923,20944,3575875745,3575875762,17
1,923,20945,3575875745,3575875762,17
1,923,20946,3575875745,3575875765,20
1,923,20947,3575875745,3575875765,20
1,923,20948,3575875745,3575875767,22
1,923,20949,3575875745,3575875768,23
1,923,20950,3575875745,3575875770,25
1,923,20951,3575875745,3575875773,28
1,923,20952,3575875745,3575875774,29
1,923,20953,3575875745,3575875775,30
1,923,20954,3575875745,3575875778,33
1,923,20955,3575875745,3575875778,33
1,923,20956,3575875745,3575875779,34
1,923,20957,3575875745,3575875779,34
1,923,20958,3575875745,3575875779,34
1,923,20959,3575875745,3575875781,36
1,923,20960,3575875745,3575875781,36
1,923,20961,3575875745,3575875782,37
1,923,20962,3575875745,3575875782,37
1,923,20963,3575875745,3575875783,38
1,923,20964,3575875745,3575875783,38
1,923,20965,3575875745,3575875783,38
1,923,20966,3575875745,3575875784,39
1,923,20967,3575875745,3575875784,39
1,923,20968,3575875745,3575875785,40
1,923,20969,3575875745,3575875785,40
1,923,20970,3575875745,3575875785,40
1,923,20971,3575875745,3575875785,40
1,923,20972,3575875745,3575875786,41
1,923,20973,3575875745,3575875787,42
1,923,20974,3575875745,3575875787,42
1,923,20975,3575875745,3575875789,44
1,923,20976,3575875745,3575875789,44
1,923,20977,3575875745,3575875790,45
1,923,20978,3575875745,3575875791,46
1,923,20979,3575875745,3575875791,46
1,923,20980,3575875745,3575875792,47
1,923,20981,3575875745,3575875793,48
1,923,20982,3575875745,3575875793,48
1,924,20983,3575875808,3575875808,0
1,924,20984,3575875808,3575875808,0
1,924,20985,3575875808,3575875808,0
1,924,20986,3575875808,3575875808,0
1,924,20987,3575875808,3575875808,0
1,924,20988,3575875808,3575875808,0
1,924,20989,3575875808,3575875808,0
1,924,20990,3575875808,3575875808,0
1,924,20991,3575875808,3575875808,0
1,924,20992,3575875808,3575875808,0
1,924,20993,3575875808,3575875808,0
1,924,20994,3575875808,3575875808,0
1,924,20995,3575875808,3575875808,0
1,924,20996,3575875808,3575875808,0
1,924,20997,3575875808,3575875811,3
1,924,20998,3575875808,3575875814,6
1,924,20999,3575875808,3575875816,8
1,924,21000,3575875808,3575875816,8
1,924,21001,3575875808,3575875816,8
1,924,21002,3575875808,3575875816,8
1,924,21003,3575875808,3575875817,9
1,924,21004,3575875808,3575875817,9
1,924,21005,3575875808,3575875817,9
1,924,21006,3575875808,3575875818,10
1,924,21007,3575875808,3575875818,10
1,924,21008,3575875808,3575875818,10
1,924,21009,3575875808,3575875819,11
1,924,21010,3575875808,3575875822,14
1,924,21011,3575875808,3575875823,15
1,924,21012,3575875808,3575875823,15
1,924,21013,3575875808,3575875825,17
1,924,21014,3575875808,3575875825,17
1,924,21015,3575875808,3575875825,17
1,924,21016,3575875808,3575875825,17
1,924,21017,3575875808,3575875830,22
1,924,21018,3575875808,3575875831,23
1,924,21019,3575875808,3575875831,23
1,924,21020,3575875808,3575875832,24
1,924,21021,3575875808,3575875833,25
1,924,21022,3575875808,3575875833,25
1,924,21023,3575875808,3575875834,26
1,924,21024,3575875808,3575875838,30
1,924,21025,3575875808,3575875838,30
1,924,21026,3575875808,3575875842,34
1,924,21027,3575875808,3575875843,35
1,924,21028,3575875808,3575875843,35
1,924,21029,3575875808,3575875844,36
1,924,21030,3575875808,3575875844,36
1,924,21031,3575875808,3575875844,36
1,924,21032,3575875808,3575875844,36
1,924,21033,3575875808,3575875844,36
1,924,21034,3575875808,3575875844,36
1,924,21035,3575875808,3575875845,37
1,924,21036,3575875808,3575875845,37
1,924,21037,3575875808,3575875845,37
1,924,21038,3575875808,3575875847,39
1,924,21039,3575875808,3575875847,39
1,924,21040,3575875808,3575875847,39
1,924,21041,3575875808,3575875848,40
1,924,21042,3575875808,3575875850,42
1,924,21043,3575875808,3575875852,44
1,924,21044,3575875808,3575875853,45
1,924,21045,3575875808,3575875853,45
1,924,21046,3575875808,3575875854,46
1,924,21047,3575875808,3575875855,47
1,924,21048,3575875808,3575875855,47
1,925,21049,3575875868,3575875868,0
1,925,21050,3575875868,3575875868,0
1,925,21051,3575875868,3575875868,0
1,925,21052,3575875868,3575875868,0
1,925,21053,3575875868,3575875868,0
1,925,21054,3575875868,3575875868,0
1,925,21055,3575875868,3575875868,0
1,925,21056,3575875868,3575875868,0
1,925,21057,3575875868,3575875868,0
1,925,21058,3575875868,3575875868,0
1,925,21059,3575875868,3575875870,2
1,925,21060,3575875868,3575875876,8
1,925,21061,3575875868,3575875878,10
1,925,21062,3575875868,3575875879,11
1,925,21063,3575875868,3575875881,13
1,925,21064,3575875868,3575875882,14
1,925,21065,3575875868,3575875883,15
1,925,21066,3575875868,3575875884,16
1,925,21067,3575875868,3575875886,18
1,925,21068,3575875868,3575875886,18
1,925,21069,3575875868,3575875887,19
1,925,21070,3575875868,3575875887,19
1,925,21071,3575875868,3575875888,20
1,925,21072,3575875868,3575875896,28
1,925,21073,3575875868,3575875896,28
1,925,21074,3575875868,3575875898,30
1,925,21075,3575875868,3575875899,31
1,925,21076,3575875868,3575875899,31
1,925,21077,3575875868,3575875900,32
1,925,21078,3575875868,3575875902,34
1,925,21079,3575875868,3575875903,35
1,925,21080,3575875868,3575875903,35
1,925,21081,3575875868,3575875904,36
1,925,21082,3575875868,3575875904,36
1,925,21083,3575875868,3575875905,37
1,925,21084,3575875868,3575875906,38
1,925,21085,3575875868,3575875908,40
1,925,21086,3575875868,3575875909,41
1,925,21087,3575875868,3575875910,42
1,925,21088,3575875868,3575875911,43
1,925,21089,3575875868,3575875911,43
1,925,21090,3575875868,3575875913,45
1,925,21091,3575875868,3575875914,46
1,925,21092,3575875868,3575875916,48
1,925,21093,3575875868,3575875917,49
1,926,21094,3575875931,3575875931,0
1,926,21095,3575875931,3575875931,0
1,926,21096,3575875931,3575875931,0
1,926,21097,3575875931,3575875931,0
1,926,21098,3575875931,3575875931,0
1,926,21099,3575875931,3575875931,0
1,926,21100,3575875931,3575875931,0
1,926,21101,3575875931,3575875931,0
1,926,21102,3575875931,3575875931,0
1,926,21103,3575875931,3575875931,0
1,926,21104,3575875931,3575875931,0
1,926,21105,3575875931,3575875931,0
1,926,21106,3575875931,3575875931,0
1,926,21107,3575875931,3575875931,0
1,926,21108,3575875931,3575875933,2
1,926,21109,3575875931,3575875934,3
1,926,21110,3575875931,3575875935,4
1,926,21111,3575875931,3575875937,6
1,926,21112,3575875931,3575875938,7
1,926,21113,3575875931,3575875939,8
1,926,21114,3575875931,3575875939,8
1,926,21115,3575875931,3575875940,9
1,926,21116,3575875931,3575875942,11
1,926,21117,3575875931,3575875942,11
1,926,21118,3575875931,3575875944,13
1,926,21119,3575875931,3575875944,13
1,926,21120,3575875931,3575875947,16
1,926,21121,3575875931,3575875947,16
1,926,21122,3575875931,3575875948,17
1,926,21123,3575875931,3575875949,18
1,926,21124,3575875931,3575875952,21
1,926,21125,3575875931,3575875953,22
1,926,21126,3575875931,3575875953,22
1,926,21127,3575875931,3575875954,23
1,926,21128,3575875931,3575875956,25
1,926,21129,3575875931,3575875956,25
1,926,21130,3575875931,3575875956,25
1,926,21131,3575875931,3575875959,28
1,926,21132,3575875931,3575875962,31
1,926,21133,3575875931,3575875963,32
1,926,21134,3575875931,3575875963,32
1,926,21135,3575875931,3575875964,33
1,926,21136,3575875931,3575875965,34
1,926,21137,3575875931,3575875966,35
1,926,21138,3575875931,3575875967,36
1,926,21139,3575875931,3575875968,37
1,926,21140,3575875931,3575875970,39
1,926,21141,3575875931,3575875973,42
1,926,21142,3575875931,3575875974,43
1,926,21143,3575875931,3575875975,44
1,926,21144,3575875931,3575875975,44
1,926,21145,3575875931,3575875977,46
1,926,21146,3575875931,3575875978,47
1,926,21147,3575875931,3575875979,48
1,926,21148,3575875931,3575875979,48
1,926,21149,3575875931,3575875981,50
1,927,21150,3575875994,3575875994,0
1,927,21151,3575875994,3575875994,0
1,927,21152,3575875994,3575875994,0
1,927,21153,3575875994,3575875994,0
1,927,21154,3575875994,3575875994,0
1,927,21155,3575875994,3575875994,0
1,927,21156,3575875994,3575875994,0
1,927,21157,3575875994,3575875994,0
1,927,21158,3575875994,3575875994,0
1,927,21159,3575875994,3575875994,0
1,927,21160,3575875994,3575875994,0
1,927,21161,3575875994,3575875994,0
1,927,21162,3575875994,3575875994,0
1,927,21163,3575875994,3575875994,0
1,927,21164,3575875994,3575875994,0
1,927,21165,3575875994,3575875994,0
1,927,21166,3575875994,3575875994,0
1,927,21167,3575875994,3575875994,0
1,927,21168,3575875994,3575875994,0
1,927,21169,3575875994,3575875994,0
1,927,21170,3575875994,3575875994,0
1,927,21171,3575875994,3575875996,2
1,927,21172,3575875994,3575875997,3
1,927,21173,3575875994,3575875999,5
1,927,21174,3575875994,3575876000,6
1,927,21175,3575875994,3575876000,6
1,927,21176,3575875994,3575876001,7
1,927,21177,3575875994,3575876001,7
1,927,21178,3575875994,3575876002,8
1,927,21179,3575875994,3575876005,11
1,927,21180,3575875994,3575876006,12
1,927,21181,3575875994,3575876007,13
1,927,21182,3575875994,3575876009,15
1,927,21183,3575875994,3575876014,20
1,927,21184,3575875994,3575876014,20
1,927,21185,3575875994,3575876015,21
1,927,21186,3575875994,3575876016,22
1,927,21187,3575875994,3575876016,22
1,927,21188,3575875994,3575876017,23
1,927,21189,3575875994,3575876017,23
1,927,21190,3575875994,3575876017,23
1,927,21191,3575875994,3575876017,23
1,927,21192,3575875994,3575876017,23
1,927,21193,3575875994,3575876017,23
1,927,21194,3575875994,3575876018,24
1,927,21195,3575875994,3575876018,24
1,927,21196,3575875994,3575876018,24
1,927,21197,3575875994,3575876019,25
1,927,21198,3575875994,3575876020,26
1,927,21199,3575875994,3575876022,28
1,927,21200,3575875994,3575876022,28
1,927,21201,3575875994,3575876022,28
1,927,21202,3575875994,3575876022,28
1,927,21203,3575875994,3575876024,30
1,927,21204,3575875994,3575876025,31
1,927,21205,3575875994,3575876025,31
1,927,21206,3575875994,3575876028,34
1,927,21207,3575875994,3575876030,36
1,927,21208,3575875994,3575876031,37
1,927,21209,3575875994,3575876031,37
1,927,21210,3575875994,3575876032,38
1,927,21211,3575875994,3575876032,38
1,927,21212,3575875994,3575876033,39
1,927,21213,3575875994,3575876033,39
1,927,21214,3575875994,3575876033,39
1,927,21215,3575875994,3575876034,40
1,927,21216,3575875994,3575876038,44
1,927,21217,3575875994,3575876041,47
1,927,21218,3575875994,3575876042,48
1,927,21219,3575875994,3575876043,49
1,927,21220,3575875994,3575876043,49
1,927,21221,3575875994,3575876044,50
1,928,21222,3575876056,3575876056,0
1,928,21223,3575876056,3575876056,0
1,928,21224,3575876056,3575876056,0
1,928,21225,3575876056,3575876056,0
1,928,21226,3575876056,3575876056,0
1,928,21227,3575876056,3575876056,0
1,928,21228,3575876056,3575876056,0
1,928,21229,3575876056,3575876056,0
1,928,21230,3575876056,3575876056,0
1,928,21231,3575876056,3575876056,0
1,928,21232,3575876056,3575876056,0
1,928,21233,3575876056,3575876056,0
1,928,21234,3575876056,3575876056,0
1,928,21235,3575876056,3575876056,0
1,928,21236,3575876056,3575876056,0
1,928,21237,3575876056,3575876057,1
1,928,21238,3575876056,3575876057,1
1,928,21239,3575876056,3575876057,1
1,928,21240,3575876056,3575876057,1
1,928,21241,3575876056,3575876059,3
1,928,21242,3575876056,3575876062,6
1,928,21243,3575876056,3575876062,6
1,928,21244,3575876056,3575876065,9
1,928,21245,3575876056,3575876065,9
1,928,21246,3575876056,3575876068,12
1,928,21247,3575876056,3575876070,14
1,928,21248,3575876056,3575876077,21
1,928,21249,3575876056,3575876080,24
1,928,21250,3575876056,3575876081,25
1,928,21251,3575876056,3575876083,27
1,928,21252,3575876056,3575876084,28
1,928,21253,3575876056,3575876084,28
1,928,21254,3575876056,3575876084,28
1,928,21255,3575876056,3575876087,31
1,928,21256,3575876056,3575876087,31
1,928,21257,3575876056,3575876087,31
1,928,21258,3575876056,3575876097,41
1,928,21259,3575876056,3575876098,42
1,928,21260,3575876056,3575876099,43
1,928,21261,3575876056,3575876099,43
1,928,21262,3575876056,3575876100,44
1,928,21263,3575876056,3575876103,47
1,928,21264,3575876056,3575876103,47
1,928,21265,3575876056,3575876103,47
1,928,21266,3575876056,3575876104,48
1,928,21267,3575876056,3575876105,49
1,928,21268,3575876056,3575876105,49
1,929,21269,3575876117,3575876117,0
1,929,21270,3575876117,3575876118,1
1,929,21271,3575876117,3575876118,1
1,929,21272,3575876117,3575876118,1
1,929,21273,3575876117,3575876118,1
1,929,21274,3575876117,3575876118,1
1,929,21275,3575876117,3575876118,1
1,929,21276,3575876117,3575876118,1
1,929,21277,3575876117,3575876118,1
1,929,21278,3575876117,3575876118,1
1,929,21279,3575876117,3575876119,2
1,929,21280,3575876117,3575876120,3
1,929,21281,3575876117,3575876122,5
1,929,21282,3575876117,3575876124,7
1,929,21283,3575876117,3575876125,8
1,929,21284,3575876117,3575876125,8
1,929,21285,3575876117,3575876126,9
1,929,21286,3575876117,3575876126,9
1,929,21287,3575876117,3575876127,10
1,929,21288,3575876117,3575876129,12
1,929,21289,3575876117,3575876129,12
1,929,21290,3575876117,3575876129,12
1,929,21291,3575876117,3575876131,14
1,929,21292,3575876117,3575876132,15
1,929,21293,3575876117,3575876133,16
1,929,21294,3575876117,3575876133,16
1,929,21295,3575876117,3575876135,18
1,929,21296,3575876117,3575876135,18
1,929,21297,3575876117,3575876138,21
1,929,21298,3575876117,3575876139,22
1,929,21299,3575876117,3575876139,22
1,929,21300,3575876117,3575876139,22
1,929,21301,3575876117,3575876140,23
1,929,21302,3575876117,3575876140,23
1,929,21303,3575876117,3575876141,24
1,929,21304,3575876117,3575876142,25
1,929,21305,3575876117,3575876144,27
1,929,21306,3575876117,3575876144,27
1,929,21307,3575876117,3575876147,30
1,929,21308,3575876117,3575876148,31
1,929,21309,3575876117,3575876148,31
1,929,21310,3575876117,3575876149,32
1,929,21311,3575876117,3575876152,35
1,929,21312,3575876117,3575876153,36
1,929,21313,3575876117,3575876153,36
1,929,21314,3575876117,3575876153,36
1,929,21315,3575876117,3575876154,37
1,929,21316,3575876117,3575876155,38
1,929,21317,3575876117,3575876156,39
1,929,21318,3575876117,3575876156,39
1,929,21319,3575876117,3575876156,39
1,929,21320,3575876117,3575876159,42
1,929,21321,3575876117,3575876161,44
1,929,21322,3575876117,3575876162,45
1,929,21323,3575876117,3575876162,45
1,929,21324,3575876117,3575876163,46
1,929,21325,3575876117,3575876164,47
1,929,21326,3575876117,3575876165,48
1,930,21327,3575876177,3575876177,0
1,930,21328,3575876177,3575876177,0
1,930,21329,3575876177,3575876177,0
1,930,21330,3575876177,3575876177,0
1,930,21331,3575876177,3575876177,0
1,930,21332,3575876177,3575876177,0
1,930,21333,3575876177,3575876177,0
1,930,21334,3575876177,3575876177,0
1,930,21335,3575876177,3575876177,0
1,930,21336,3575876177,3575876178,1
1,930,21337,3575876177,3575876178,1
1,930,21338,3575876177,3575876179,2
1,930,21339,3575876177,3575876179,2
1,930,21340,3575876177,3575876180,3
1,930,21341,3575876177,3575876181,4
1,930,21342,3575876177,3575876181,4
1,930,21343,3575876177,3575876182,5
1,930,21344,3575876177,3575876183,6
1,930,21345,3575876177,3575876184,7
1,930,21346,3575876177,3575876184,7
1,930,21347,3575876177,3575876184,7
1,930,21348,3575876177,3575876184,7
1,930,21349,3575876177,3575876184,7
1,930,21350,3575876177,3575876185,8
1,930,21351,3575876177,3575876185,8
1,930,21352,3575876177,3575876186,9
1,930,21353,3575876177,3575876187,10
1,930,21354,3575876177,3575876187,10
1,930,21355,3575876177,3575876187,10
1,930,21356,3575876177,3575876190,13
1,930,21357,3575876177,3575876190,13
1,930,21358,3575876177,3575876191,14
1,930,21359,3575876177,3575876191,14
1,930,21360,3575876177,3575876191,14
1,930,21361,3575876177,3575876192,15
1,930,21362,3575876177,3575876193,16
1,930,21363,3575876177,3575876197,20
1,930,21364,3575876177,3575876197,20
1,930,21365,3575876177,3575876200,23
1,930,21366,3575876177,3575876200,23
1,930,21367,3575876177,3575876201,24
1,930,21368,3575876177,3575876205,28
1,930,21369,3575876177,3575876206,29
1,930,21370,3575876177,3575876207,30
1,930,21371,3575876177,3575876207,30
1,930,21372,3575876177,3575876209,32
1,930,21373,3575876177,3575876211,34
1,930,21374,3575876177,3575876211,34
1,930,21375,3575876177,3575876214,37
1,930,21376,3575876177,3575876214,37
1,930,21377,3575876177,3575876215,38
1,930,21378,3575876177,3575876216,39
1,930,21379,3575876177,3575876217,40
1,930,21380,3575876177,3575876217,40
1,930,21381,3575876177,3575876217,40
1,930,21382,3575876177,3575876217,40
1,930,21383,3575876177,3575876217,40
1,930,21384,3575876177,3575876217,40
1,930,21385,3575876177,3575876217,40
1,930,21386,3575876177,3575876218,41
1,930,21387,3575876177,3575876218,41
1,930,21388,3575876177,3575876220,43
1,930,21389,3575876177,3575876220,43
1,930,21390,3575876177,3575876221,44
1,930,21391,3575876177,3575876222,45
1,930,21392,3575876177,3575876223,46
1,930,21393,3575876177,3575876223,46
1,930,21394,3575876177,3575876224,47
1,930,21395,3575876177,3575876224,47
1,930,21396,3575876177,3575876224,47
1,930,21397,3575876177,3575876225,48
1,930,21398,3575876177,3575876225,48
1,930,21399,3575876177,3575876225,48
1,931,21400,3575876237,3575876237,0
1,931,21401,3575876237,3575876237,0
1,931,21402,3575876237,3575876237,0
1,931,21403,3575876237,3575876237,0
1,931,21404,3575876237,3575876237,0
1,931,21405,3575876237,3575876237,0
1,931,21406,3575876237,3575876237,0
1,931,21407,3575876237,3575876237,0
1,931,21408,3575876237,3575876238,1
1,931,21409,3575876237,3575876239,2
1,931,21410,3575876237,3575876243,6
1,931,21411,3575876237,3575876243,6
1,931,21412,3575876237,3575876244,7
1,931,21413,3575876237,3575876244,7
1,931,21414,3575876237,3575876244,7
1,931,21415,3575876237,3575876245,8
1,931,21416,3575876237,3575876245,8
1,931,21417,3575876237,3575876245,8
1,931,21418,3575876237,3575876245,8
1,931,21419,3575876237,3575876246,9
1,931,21420,3575876237,3575876246,9
1,931,21421,3575876237,3575876247,10
1,931,21422,3575876237,3575876247,10
1,931,21423,3575876237,3575876249,12
1,931,21424,3575876237,3575876251,14
1,931,21425,3575876237,3575876251,14
1,931,21426,3575876237,3575876253,16
1,931,21427,3575876237,3575876253,16
1,931,21428,3575876237,3575876253,16
1,931,21429,3575876237,3575876254,17
1,931,21430,3575876237,3575876255,18
1,931,21431,3575876237,3575876256,19
1,931,21432,3575876237,3575876257,20
1,931,21433,3575876237,3575876262,25
1,931,21434,3575876237,3575876262,25
1,931,21435,3575876237,3575876263,26
1,931,21436,3575876237,3575876263,26
1,931,21437,3575876237,3575876264,27
1,931,21438,3575876237,3575876265,28
1,931,21439,3575876237,3575876266,29
1,931,21440,3575876237,3575876267,30
1,931,21441,3575876237,3575876268,31
1,931,21442,3575876237,3575876268,31
1,931,21443,3575876237,3575876268,31
1,931,21444,3575876237,3575876269,32
1,931,21445,3575876237,3575876270,33
1,931,21446,3575876237,3575876277,40
1,931,21447,3575876237,3575876279,42
1,931,21448,3575876237,3575876281,44
1,931,21449,3575876237,3575876283,46
1,931,21450,3575876237,3575876283,46
1,931,21451,3575876237,3575876284,47
1,931,21452,3575876237,3575876285,48
1,931,21453,3575876237,3575876287,50
1,932,21454,3575876300,3575876300,0
1,932,21455,3575876300,3575876300,0
1,932,21456,3575876300,3575876300,0
1,932,21457,3575876300,3575876300,0
1,932,21458,3575876300,3575876300,0
1,932,21459,3575876300,3575876300,0
1,932,21460,3575876300,3575876300,0
1,932,21461,3575876300,3575876300,0
1,932,21462,3575876300,3575876300,0
1,932,21463,3575876300,3575876303,3
1,932,21464,3575876300,3575876303,3
1,932,21465,3575876300,3575876303,3
1,932,21466,3575876300,3575876304,4
1,932,21467,3575876300,3575876305,5
1,932,21468,3575876300,3575876305,5
1,932,21469,3575876300,3575876306,6
1,932,21470,3575876300,3575876309,9
1,932,21471,3575876300,3575876310,10
1,932,21472,3575876300,3575876311,11
1,932,21473,3575876300,3575876311,11
1,932,21474,3575876300,3575876312,12
1,932,21475,3575876300,3575876312,12
1,932,21476,3575876300,3575876313,13
1,932,21477,3575876300,3575876314,14
1,932,21478,3575876300,3575876317,17
1,932,21479,3575876300,3575876318,18
1,932,21480,3575876300,3575876318,18
1,932,21481,3575876300,3575876319,19
1,932,21482,3575876300,3575876321,21
1,932,21483,3575876300,3575876322,22
1,932,21484,3575876300,3575876324,24
1,932,21485,3575876300,3575876324,24
1,932,21486,3575876300,3575876325,25
1,932,21487,3575876300,3575876325,25
1,932,21488,3575876300,3575876326,26
1,932,21489,3575876300,3575876327,27
1,932,21490,3575876300,3575876329,29
1,932,21491,3575876300,3575876329,29
1,932,21492,3575876300,3575876331,31
1,932,21493,3575876300,3575876332,32
1,932,21494,3575876300,3575876332,32
1,932,21495,3575876300,3575876333,33
1,932,21496,3575876300,3575876334,34
1,932,21497,3575876300,3575876335,35
1,932,21498,3575876300,3575876335,35
1,932,21499,3575876300,3575876338,38
1,932,21500,3575876300,3575876338,38
1,932,21501,3575876300,3575876340,40
1,932,21502,3575876300,3575876340,40
1,932,21503,3575876300,3575876340,40
1,932,21504,3575876300,3575876340,40
1,932,21505,3575876300,3575876341,41
1,932,21506,3575876300,3575876343,43
1,932,21507,3575876300,3575876343,43
1,932,21508,3575876300,3575876344,44
1,932,21509,3575876300,3575876347,47
1,932,21510,3575876300,3575876349,49
1,932,21511,3575876300,3575876349,49
1,932,21512,3575876300,3575876350,50
1,933,21513,3575876362,3575876362,0
1,933,21514,3575876362,3575876362,0
1,933,21515,3575876362,3575876362,0
1,933,21516,3575876362,3575876362,0
1,933,21517,3575876362,3575876362,0
1,933,21518,3575876362,3575876362,0
1,933,21519,3575876362,3575876362,0
1,933,21520,3575876362,3575876362,0
1,933,21521,3575876362,3575876362,0
1,933,21522,3575876362,3575876362,0
1,933,21523,3575876362,3575876362,0
1,933,21524,3575876362,3575876362,0
1,933,21525,3575876362,3575876363,1
1,933,21526,3575876362,3575876363,1
1,933,21527,3575876362,3575876365,3
1,933,21528,3575876362,3575876367,5
1,933,21529,3575876362,3575876367,5
1,933,21530,3575876362,3575876370,8
1,933,21531,3575876362,3575876370,8
1,933,21532,3575876362,3575876375,13
1,933,21533,3575876362,3575876375,13
1,933,21534,3575876362,3575876376,14
1,933,21535,3575876362,3575876377,15
1,933,21536,3575876362,3575876378,16
1,933,21537,3575876362,3575876378,16
1,933,21538,3575876362,3575876379,17
1,933,21539,3575876362,3575876379,17
1,933,21540,3575876362,3575876380,18
1,933,21541,3575876362,3575876381,19
1,933,21542,3575876362,3575876382,20
1,933,21543,3575876362,3575876383,21
1,933,21544,3575876362,3575876384,22
1,933,21545,3575876362,3575876384,22
1,933,21546,3575876362,3575876384,22
1,933,21547,3575876362,3575876385,23
1,933,21548,3575876362,3575876385,23
1,933,21549,3575876362,3575876386,24
1,933,21550,3575876362,3575876386,24
1,933,21551,3575876362,3575876386,24
1,933,21552,3575876362,3575876387,25
1,933,21553,3575876362,3575876387,25
1,933,21554,3575876362,3575876387,25
1,933,21555,3575876362,3575876391,29
1,933,21556,3575876362,3575876391,29
1,933,21557,3575876362,3575876391,29
1,933,21558,3575876362,3575876392,30
1,933,21559,3575876362,3575876392,30
1,933,21560,3575876362,3575876392,30
1,933,21561,3575876362,3575876393,31
1,933,21562,3575876362,3575876397,35
1,933,21563,3575876362,3575876397,35
1,933,21564,3575876362,3575876400,38
1,933,21565,3575876362,3575876400,38
1,933,21566,3575876362,3575876400,38
1,933,21567,3575876362,3575876401,39
1,933,21568,3575876362,3575876402,40
1,933,21569,3575876362,3575876405,43
1,933,21570,3575876362,3575876407,45
1,933,21571,3575876362,3575876407,45
1,933,21572,3575876362,3575876409,47
1,933,21573,3575876362,3575876410,48
1,933,21574,3575876362,3575876412,50
1,934,21575,3575876422,3575876422,0
1,934,21576,3575876422,3575876422,0
1,934,21577,3575876422,3575876422,0
1,934,21578,3575876422,3575876422,0
1,934,21579,3575876422,3575876422,0
1,934,21580,3575876422,3575876422,0
1,934,21581,3575876422,3575876422,0
1,934,21582,3575876422,3575876422,0
1,934,21583,3575876422,3575876422,0
1,934,21584,3575876422,3575876422,0
1,934,21585,3575876422,3575876422,0
1,934,21586,3575876422,3575876422,0
1,934,21587,3575876422,3575876422,0
1,934,21588,3575876422,3575876422,0
1,934,21589,3575876422,3575876422,0
1,934,21590,3575876422,3575876422,0
1,934,21591,3575876422,3575876422,0
1,934,21592,3575876422,3575876423,1
1,934,21593,3575876422,3575876423,1
1,934,21594,3575876422,3575876424,2
1,934,21595,3575876422,3575876424,2
1,934,21596,3575876422,3575876425,3
1,934,21597,3575876422,3575876425,3
1,934,21598,3575876422,3575876425,3
1,934,21599,3575876422,3575876429,7
1,934,21600,3575876422,3575876431,9
1,934,21601,3575876422,3575876431,9
1,934,21602,3575876422,3575876432,10
1,934,21603,3575876422,3575876432,10
1,934,21604,3575876422,3575876433,11
1,934,21605,3575876422,3575876433,11
1,934,21606,3575876422,3575876433,11
1,934,21607,3575876422,3575876433,11
1,934,21608,3575876422,3575876433,11
1,934,21609,3575876422,3575876433,11
1,934,21610,3575876422,3575876434,12
1,934,21611,3575876422,3575876434,12
1,934,21612,3575876422,3575876435,13
1,934,21613,3575876422,3575876439,17
1,934,21614,3575876422,3575876439,17
1,934,21615,3575876422,3575876443,21
1,934,21616,3575876422,3575876443,21
1,934,21617,3575876422,3575876443,21
1,934,21618,3575876422,3575876444,22
1,934,21619,3575876422,3575876444,22
1,934,21620,3575876422,3575876445,23
1,934,21621,3575876422,3575876445,23
1,934,21622,3575876422,3575876445,23
1,934,21623,3575876422,3575876445,23
1,934,21624,3575876422,3575876446,24
1,934,21625,3575876422,3575876446,24
1,934,21626,3575876422,3575876447,25
1,934,21627,3575876422,3575876447,25
1,934,21628,3575876422,3575876448,26
1,934,21629,3575876422,3575876449,27
1,934,21630,3575876422,3575876451,29
1,934,21631,3575876422,3575876451,29
1,934,21632,3575876422,3575876453,31
1,934,21633,3575876422,3575876453,31
1,934,21634,3575876422,3575876454,32
1,934,21635,3575876422,3575876454,32
1,934,21636,3575876422,3575876455,33
1,934,21637,3575876422,3575876456,34
1,934,21638,3575876422,3575876456,34
1,934,21639,3575876422,3575876457,35
1,934,21640,3575876422,3575876459,37
1,934,21641,3575876422,3575876462,40
1,934,21642,3575876422,3575876462,40
1,934,21643,3575876422,3575876463,41
1,934,21644,3575876422,3575876465,43
1,934,21645,3575876422,3575876465,43
1,934,21646,3575876422,3575876466,44
1,934,21647,3575876422,3575876468,46
1,934,21648,3575876422,3575876468,46
1,934,21649,3575876422,3575876471,49
1,935,21650,3575876482,3575876482,0
1,935,21651,3575876482,3575876482,0
1,935,21652,3575876482,3575876482,0
1,935,21653,3575876482,3575876482,0
1,935,21654,3575876482,3575876483,1
1,935,21655,3575876482,3575876485,3
1,935,21656,3575876482,3575876485,3
1,935,21657,3575876482,3575876486,4
1,935,21658,3575876482,3575876486,4
1,935,21659,3575876482,3575876491,9
1,935,21660,3575876482,3575876497,15
1,935,21661,3575876482,3575876497,15
1,935,21662,3575876482,3575876498,16
1,935,21663,3575876482,3575876498,16
1,935,21664,3575876482,3575876500,18
1,935,21665,3575876482,3575876501,19
1,935,21666,3575876482,3575876502,20
1,935,21667,3575876482,3575876502,20
1,935,21668,3575876482,3575876503,21
1,935,21669,3575876482,3575876503,21
1,935,21670,3575876482,3575876505,23
1,935,21671,3575876482,3575876506,24
1,935,21672,3575876482,3575876508,26
1,935,21673,3575876482,3575876509,27
1,935,21674,3575876482,3575876510,28
1,935,21675,3575876482,3575876511,29
1,935,21676,3575876482,3575876511,29
1,935,21677,3575876482,3575876511,29
1,935,21678,3575876482,3575876512,30
1,935,21679,3575876482,3575876513,31
1,935,21680,3575876482,3575876516,34
1,935,21681,3575876482,3575876517,35
1,935,21682,3575876482,3575876518,36
1,935,21683,3575876482,3575876518,36
1,935,21684,3575876482,3575876520,38
1,935,21685,3575876482,3575876521,39
1,935,21686,3575876482,3575876523,41
1,935,21687,3575876482,3575876524,42
1,935,21688,3575876482,3575876524,42
1,935,21689,3575876482,3575876526,44
1,935,21690,3575876482,3575876527,45
1,935,21691,3575876482,3575876527,45
1,935,21692,3575876482,3575876528,46
1,935,21693,3575876482,3575876528,46
1,935,21694,3575876482,3575876529,47
1,935,21695,3575876482,3575876531,49
1,935,21696,3575876482,3575876531,49
1,935,21697,3575876482,3575876532,50
1,936,21698,3575876546,3575876546,0
1,936,21699,3575876546,3575876546,0
1,936,21700,3575876546,3575876546,0
1,936,21701,3575876546,3575876546,0
1,936,21702,3575876546,3575876546,0
1,936,21703,3575876546,3575876546,0
1,936,21704,3575876546,3575876546,0
1,936,21705,3575876546,3575876546,0
1,936,21706,3575876546,3575876546,0
1,936,21707,3575876546,3575876546,0
1,936,21708,3575876546,3575876546,0
1,936,21709,3575876546,3575876546,0
1,936,21710,3575876546,3575876547,1
1,936,21711,3575876546,3575876548,2
1,936,21712,3575876546,3575876549,3
1,936,21713,3575876546,3575876549,3
1,936,21714,3575876546,3575876551,5
1,936,21715,3575876546,3575876552,6
1,936,21716,3575876546,3575876552,6
1,936,21717,3575876546,3575876552,6
1,936,21718,3575876546,3575876552,6
1,936,21719,3575876546,3575876552,6
1,936,21720,3575876546,3575876553,7
1,936,21721,3575876546,3575876554,8
1,936,21722,3575876546,3575876556,10
1,936,21723,3575876546,3575876556,10
1,936,21724,3575876546,3575876557,11
1,936,21725,3575876546,3575876560,14
1,936,21726,3575876546,3575876560,14
1,936,21727,3575876546,3575876562,16
1,936,21728,3575876546,3575876562,16
1,936,21729,3575876546,3575876562,16
1,936,21730,3575876546,3575876563,17
1,936,21731,3575876546,3575876564,18
1,936,21732,3575876546,3575876566,20
1,936,21733,3575876546,3575876566,20
1,936,21734,3575876546,3575876569,23
1,936,21735,3575876546,3575876569,23
1,936,21736,3575876546,3575876574,28
1,936,21737,3575876546,3575876574,28
1,936,21738,3575876546,3575876576,30
1,936,21739,3575876546,3575876576,30
1,936,21740,3575876546,3575876578,32
1,936,21741,3575876546,3575876578,32
1,936,21742,3575876546,3575876578,32
1,936,21743,3575876546,3575876578,32
1,936,21744,3575876546,3575876579,33
1,936,21745,3575876546,3575876580,34
1,936,21746,3575876546,3575876581,35
1,936,21747,3575876546,3575876583,37
1,936,21748,3575876546,3575876583,37
1,936,21749,3575876546,3575876584,38
1,936,21750,3575876546,3575876584,38
1,936,21751,3575876546,3575876584,38
1,936,21752,3575876546,3575876584,38
1,936,21753,3575876546,3575876586,40
1,936,21754,3575876546,3575876586,40
1,936,21755,3575876546,3575876586,40
1,936,21756,3575876546,3575876586,40
1,936,21757,3575876546,3575876587,41
1,936,21758,3575876546,3575876589,43
1,936,21759,3575876546,3575876590,44
1,936,21760,3575876546,3575876591,45
1,936,21761,3575876546,3575876591,45
1,936,21762,3575876546,3575876591,45
1,936,21763,3575876546,3575876592,46
1,936,21764,3575876546,3575876592,46
1,936,21765,3575876546,3575876595,49
1,937,21766,3575876611,3575876611,0
1,937,21767,3575876611,3575876611,0
1,937,21768,3575876611,3575876611,0
1,937,21769,3575876611,3575876611,0
1,937,21770,3575876611,3575876611,0
1,937,21771,3575876611,3575876611,0
1,937,21772,3575876611,3575876611,0
1,937,21773,3575876611,3575876611,0
1,937,21774,3575876611,3575876611,0
1,937,21775,3575876611,3575876611,0
1,937,21776,3575876611,3575876611,0
1,937,21777,3575876611,3575876611,0
1,937,21778,3575876611,3575876611,0
1,937,21779,3575876611,3575876611,0
1,937,21780,3575876611,3575876613,2
1,937,21781,3575876611,3575876614,3
1,937,21782,3575876611,3575876615,4
1,937,21783,3575876611,3575876616,5
1,937,21784,3575876611,3575876616,5
1,937,21785,3575876611,3575876617,6
1,937,21786,3575876611,3575876617,6
1,937,21787,3575876611,3575876617,6
1,937,21788,3575876611,3575876617,6
1,937,21789,3575876611,3575876617,6
1,937,21790,3575876611,3575876618,7
1,937,21791,3575876611,3575876619,8
1,937,21792,3575876611,3575876619,8
1,937,21793,3575876611,3575876619,8
1,937,21794,3575876611,3575876620,9
1,937,21795,3575876611,3575876621,10
1,937,21796,3575876611,3575876622,11
1,937,21797,3575876611,3575876623,12
1,937,21798,3575876611,3575876623,12
1,937,21799,3575876611,3575876623,12
1,937,21800,3575876611,3575876624,13
1,937,21801,3575876611,3575876624,13
1,937,21802,3575876611,3575876625,14
1,937,21803,3575876611,3575876628,17
1,937,21804,3575876611,3575876629,18
1,937,21805,3575876611,3575876631,20
1,937,21806,3575876611,3575876631,20
1,937,21807,3575876611,3575876632,21
1,937,21808,3575876611,3575876632,21
1,937,21809,3575876611,3575876632,21
1,937,21810,3575876611,3575876632,21
1,937,21811,3575876611,3575876632,21
1,937,21812,3575876611,3575876633,22
1,937,21813,3575876611,3575876633,22
1,937,21814,3575876611,3575876633,22
1,937,21815,3575876611,3575876635,24
1,937,21816,3575876611,3575876638,27
1,937,21817,3575876611,3575876638,27
1,937,21818,3575876611,3575876642,31
1,937,21819,3575876611,3575876643,32
1,937,21820,3575876611,3575876643,32
1,937,21821,3575876611,3575876644,33
1,937,21822,3575876611,3575876644,33
1,937,21823,3575876611,3575876645,34
1,937,21824,3575876611,3575876645,34
1,937,21825,3575876611,3575876645,34
1,937,21826,3575876611,3575876645,34
1,937,21827,3575876611,3575876646,35
1,937,21828,3575876611,3575876646,35
1,937,21829,3575876611,3575876647,36
1,937,21830,3575876611,3575876647,36
1,937,21831,3575876611,3575876649,38
1,937,21832,3575876611,3575876650,39
1,937,21833,3575876611,3575876652,41
1,937,21834,3575876611,3575876652,41
1,937,21835,3575876611,3575876653,42
1,937,21836,3575876611,3575876654,43
1,937,21837,3575876611,3575876655,44
1,937,21838,3575876611,3575876656,45
1,937,21839,3575876611,3575876656,45
1,937,21840,3575876611,3575876661,50
1,938,21841,3575876673,3575876673,0
1,938,21842,3575876673,3575876673,0
1,938,21843,3575876673,3575876673,0
1,938,21844,3575876673,3575876673,0
1,938,21845,3575876673,3575876673,0
1,938,21846,3575876673,3575876673,0
1,938,21847,3575876673,3575876673,0
1,938,21848,3575876673,3575876673,0
1,938,21849,3575876673,3575876673,0
1,938,21850,3575876673,3575876673,0
1,938,21851,3575876673,3575876677,4
1,938,21852,3575876673,3575876677,4
1,938,21853,3575876673,3575876678,5
1,938,21854,3575876673,3575876681,8
1,938,21855,3575876673,3575876683,10
1,938,21856,3575876673,3575876683,10
1,938,21857,3575876673,3575876684,11
1,938,21858,3575876673,3575876684,11
1,938,21859,3575876673,3575876685,12
1,938,21860,3575876673,3575876685,12
1,938,21861,3575876673,3575876686,13
1,938,21862,3575876673,3575876686,13
1,938,21863,3575876673,3575876691,18
1,938,21864,3575876673,3575876691,18
1,938,21865,3575876673,3575876696,23
1,938,21866,3575876673,3575876697,24
1,938,21867,3575876673,3575876697,24
1,938,21868,3575876673,3575876699,26
1,938,21869,3575876673,3575876699,26
1,938,21870,3575876673,3575876701,28
1,938,21871,3575876673,3575876701,28
1,938,21872,3575876673,3575876702,29
1,938,21873,3575876673,3575876702,29
1,938,21874,3575876673,3575876703,30
1,938,21875,3575876673,3575876704,31
1,938,21876,3575876673,3575876704,31
1,938,21877,3575876673,3575876706,33
1,938,21878,3575876673,3575876709,36
1,938,21879,3575876673,3575876709,36
1,938,21880,3575876673,3575876710,37
1,938,21881,3575876673,3575876710,37
1,938,21882,3575876673,3575876711,38
1,938,21883,3575876673,3575876712,39
1,938,21884,3575876673,3575876713,40
1,938,21885,3575876673,3575876713,40
1,938,21886,3575876673,3575876717,44
1,938,21887,3575876673,3575876717,44
1,938,21888,3575876673,3575876718,45
1,938,21889,3575876673,3575876718,45
1,938,21890,3575876673,3575876720,47
1,938,21891,3575876673,3575876721,48
1,938,21892,3575876673,3575876723,50
1,939,21893,3575876733,3575876733,0
1,939,21894,3575876733,3575876733,0
1,939,21895,3575876733,3575876733,0
1,939,21896,3575876733,3575876733,0
1,939,21897,3575876733,3575876733,0
1,939,21898,3575876733,3575876733,0
1,939,21899,3575876733,3575876733,0
1,939,21900,3575876733,3575876733,0
1,939,21901,3575876733,3575876733,0
1,939,21902,3575876733,3575876733,0
1,939,21903,3575876733,3575876733,0
1,939,21904,3575876733,3575876733,0
1,939,21905,3575876733,3575876733,0
1,939,21906,3575876733,3575876733,0
1,939,21907,3575876733,3575876734,1
1,939,21908,3575876733,3575876737,4
1,939,21909,3575876733,3575876738,5
1,939,21910,3575876733,3575876739,6
1,939,21911,3575876733,3575876740,7
1,939,21912,3575876733,3575876740,7
1,939,21913,3575876733,3575876740,7
1,939,21914,3575876733,3575876740,7
1,939,21915,3575876733,3575876741,8
1,939,21916,3575876733,3575876743,10
1,939,21917,3575876733,3575876743,10
1,939,21918,3575876733,3575876743,10
1,939,21919,3575876733,3575876746,13
1,939,21920,3575876733,3575876746,13
1,939,21921,3575876733,3575876748,15
1,939,21922,3575876733,3575876749,16
1,939,21923,3575876733,3575876749,16
1,939,21924,3575876733,3575876751,18
1,939,21925,3575876733,3575876751,18
1,939,21926,3575876733,3575876752,19
1,939,21927,3575876733,3575876752,19
1,939,21928,3575876733,3575876753,20
1,939,21929,3575876733,3575876753,20
1,939,21930,3575876733,3575876753,20
1,939,21931,3575876733,3575876754,21
1,939,21932,3575876733,3575876755,22
1,939,21933,3575876733,3575876756,23
1,939,21934,3575876733,3575876757,24
1,939,21935,3575876733,3575876759,26
1,939,21936,3575876733,3575876761,28
1,939,21937,3575876733,3575876762,29
1,939,21938,3575876733,3575876763,30
1,939,21939,3575876733,3575876763,30
1,939,21940,3575876733,3575876764,31
1,939,21941,3575876733,3575876766,33
1,939,21942,3575876733,3575876766,33
1,939,21943,3575876733,3575876769,36
1,939,21944,3575876733,3575876769,36
1,939,21945,3575876733,3575876773,40
1,939,21946,3575876733,3575876775,42
1,939,21947,3575876733,3575876776,43
1,939,21948,3575876733,3575876777,44
1,939,21949,3575876733,3575876778,45
1,939,21950,3575876733,3575876779,46
1,939,21951,3575876733,3575876779,46
1,939,21952,3575876733,3575876779,46
1,939,21953,3575876733,3575876780,47
1,939,21954,3575876733,3575876780,47
1,939,21955,3575876733,3575876782,49
1,939,21956,3575876733,3575876783,50
1,940,21957,3575876795,3575876795,0
1,940,21958,3575876795,3575876795,0
1,940,21959,3575876795,3575876795,0
1,940,21960,3575876795,3575876795,0
1,940,21961,3575876795,3575876795,0
1,940,21962,3575876795,3575876795,0
1,940,21963,3575876795,3575876795,0
1,940,21964,3575876795,3575876795,0
1,940,21965,3575876795,3575876795,0
1,940,21966,3575876795,3575876795,0
1,940,21967,3575876795,3575876795,0
1,940,21968,3575876795,3575876795,0
1,940,21969,3575876795,3575876795,0
1,940,21970,3575876795,3575876795,0
1,940,21971,3575876795,3575876795,0
1,940,21972,3575876795,3575876795,0
1,940,21973,3575876795,3575876795,0
1,940,21974,3575876795,3575876797,2
1,940,21975,3575876795,3575876799,4
1,940,21976,3575876795,3575876800,5
1,940,21977,3575876795,3575876801,6
1,940,21978,3575876795,3575876801,6
1,940,21979,3575876795,3575876801,6
1,940,21980,3575876795,3575876801,6
1,940,21981,3575876795,3575876802,7
1,940,21982,3575876795,3575876802,7
1,940,21983,3575876795,3575876804,9
1,940,21984,3575876795,3575876806,11
1,940,21985,3575876795,3575876806,11
1,940,21986,3575876795,3575876806,11
1,940,21987,3575876795,3575876808,13
1,940,21988,3575876795,3575876810,15
1,940,21989,3575876795,3575876812,17
1,940,21990,3575876795,3575876814,19
1,940,21991,3575876795,3575876815,20
1,940,21992,3575876795,3575876816,21
1,940,21993,3575876795,3575876816,21
1,940,21994,3575876795,3575876817,22
1,940,21995,3575876795,3575876817,22
1,940,21996,3575876795,3575876817,22
1,940,21997,3575876795,3575876817,22
1,940,21998,3575876795,3575876817,22
1,940,21999,3575876795,3575876818,23
1,940,22000,3575876795,3575876818,23
1,940,22001,3575876795,3575876819,24
1,940,22002,3575876795,3575876819,24
1,940,22003,3575876795,3575876819,24
1,940,22004,3575876795,3575876820,25
1,940,22005,3575876795,3575876820,25
1,940,22006,3575876795,3575876822,27
1,940,22007,3575876795,3575876822,27
1,940,22008,3575876795,3575876823,28
1,940,22009,3575876795,3575876824,29
1,940,22010,3575876795,3575876824,29
1,940,22011,3575876795,3575876825,30
1,940,22012,3575876795,3575876828,33
1,940,22013,3575876795,3575876829,34
1,940,22014,3575876795,3575876831,36
1,940,22015,3575876795,3575876832,37
1,940,22016,3575876795,3575876832,37
1,940,22017,3575876795,3575876832,37
1,940,22018,3575876795,3575876832,37
1,940,22019,3575876795,3575876833,38
1,940,22020,3575876795,3575876833,38
1,940,22021,3575876795,3575876833,38
1,940,22022,3575876795,3575876833,38
1,940,22023,3575876795,3575876835,40
1,940,22024,3575876795,3575876836,41
1,940,22025,3575876795,3575876838,43
1,940,22026,3575876795,3575876838,43
1,940,22027,3575876795,3575876842,47
1,940,22028,3575876795,3575876843,48
1,940,22029,3575876795,3575876843,48
1,940,22030,3575876795,3575876843,48
1,940,22031,3575876795,3575876844,49
1,940,22032,3575876795,3575876844,49
1,941,22033,3575876859,3575876859,0
1,941,22034,3575876859,3575876859,0
1,941,22035,3575876859,3575876859,0
1,941,22036,3575876859,3575876859,0
1,941,22037,3575876859,3575876859,0
1,941,22038,3575876859,3575876859,0
1,941,22039,3575876859,3575876859,0
1,941,22040,3575876859,3575876859,0
1,941,22041,3575876859,3575876859,0
1,941,22042,3575876859,3575876859,0
1,941,22043,3575876859,3575876859,0
1,941,22044,3575876859,3575876859,0
1,941,22045,3575876859,3575876859,0
1,941,22046,3575876859,3575876859,0
1,941,22047,3575876859,3575876861,2
1,941,22048,3575876859,3575876862,3
1,941,22049,3575876859,3575876865,6
1,941,22050,3575876859,3575876866,7
1,941,22051,3575876859,3575876867,8
1,941,22052,3575876859,3575876867,8
1,941,22053,3575876859,3575876868,9
1,941,22054,3575876859,3575876869,10
1,941,22055,3575876859,3575876870,11
1,941,22056,3575876859,3575876876,17
1,941,22057,3575876859,3575876878,19
1,941,22058,3575876859,3575876879,20
1,941,22059,3575876859,3575876881,22
1,941,22060,3575876859,3575876883,24
1,941,22061,3575876859,3575876883,24
1,941,22062,3575876859,3575876885,26
1,941,22063,3575876859,3575876885,26
1,941,22064,3575876859,3575876885,26
1,941,22065,3575876859,3575876886,27
1,941,22066,3575876859,3575876886,27
1,941,22067,3575876859,3575876891,32
1,941,22068,3575876859,3575876891,32
1,941,22069,3575876859,3575876897,38
1,941,22070,3575876859,3575876897,38
1,941,22071,3575876859,3575876898,39
1,941,22072,3575876859,3575876898,39
1,941,22073,3575876859,3575876899,40
1,941,22074,3575876859,3575876901,42
1,941,22075,3575876859,3575876901,42
1,941,22076,3575876859,3575876901,42
1,941,22077,3575876859,3575876902,43
1,941,22078,3575876859,3575876903,44
1,941,22079,3575876859,3575876903,44
1,941,22080,3575876859,3575876904,45
1,941,22081,3575876859,3575876905,46
1,941,22082,3575876859,3575876906,47
1,941,22083,3575876859,3575876908,49
1,942,22084,3575876923,3575876923,0
1,942,22085,3575876923,3575876923,0
1,942,22086,3575876923,3575876923,0
1,942,22087,3575876923,3575876923,0
1,942,22088,3575876923,3575876923,0
1,942,22089,3575876923,3575876924,1
1,942,22090,3575876923,3575876924,1
1,942,22091,3575876923,3575876924,1
1,942,22092,3575876923,3575876924,1
1,942,22093,3575876923,3575876924,1
1,942,22094,3575876923,3575876924,1
1,942,22095,3575876923,3575876924,1
1,942,22096,3575876923,3575876924,1
1,942,22097,3575876923,3575876924,1
1,942,22098,3575876923,3575876924,1
1,942,22099,3575876923,3575876926,3
1,942,22100,3575876923,3575876926,3
1,942,22101,3575876923,3575876927,4
1,942,22102,3575876923,3575876928,5
1,942,22103,3575876923,3575876929,6
1,942,22104,3575876923,3575876930,7
1,942,22105,3575876923,3575876931,8
1,942,22106,3575876923,3575876931,8
1,942,22107,3575876923,3575876933,10
1,942,22108,3575876923,3575876933,10
1,942,22109,3575876923,3575876935,12
1,942,22110,3575876923,3575876936,13
1,942,22111,3575876923,3575876936,13
1,942,22112,3575876923,3575876937,14
1,942,22113,3575876923,3575876938,15
1,942,22114,3575876923,3575876939,16
1,942,22115,3575876923,3575876940,17
1,942,22116,3575876923,3575876940,17
1,942,22117,3575876923,3575876940,17
1,942,22118,3575876923,3575876940,17
1,942,22119,3575876923,3575876941,18
1,942,22120,3575876923,3575876943,20
1,942,22121,3575876923,3575876944,21
1,942,22122,3575876923,3575876946,23
1,942,22123,3575876923,3575876947,24
1,942,22124,3575876923,3575876949,26
1,942,22125,3575876923,3575876949,26
1,942,22126,3575876923,3575876949,26
1,942,22127,3575876923,3575876949,26
1,942,22128,3575876923,3575876951,28
1,942,22129,3575876923,3575876951,28
1,942,22130,3575876923,3575876952,29
1,942,22131,3575876923,3575876952,29
1,942,22132,3575876923,3575876953,30
1,942,22133,3575876923,3575876953,30
1,942,22134,3575876923,3575876953,30
1,942,22135,3575876923,3575876954,31
1,942,22136,3575876923,3575876954,31
1,942,22137,3575876923,3575876957,34
1,942,22138,3575876923,3575876957,34
1,942,22139,3575876923,3575876959,36
1,942,22140,3575876923,3575876963,40
1,942,22141,3575876923,3575876963,40
1,942,22142,3575876923,3575876964,41
1,942,22143,3575876923,3575876966,43
1,942,22144,3575876923,3575876966,43
1,942,22145,3575876923,3575876969,46
1,943,22146,3575876984,3575876984,0
1,943,22147,3575876984,3575876984,0
1,943,22148,3575876984,3575876984,0
1,943,22149,3575876984,3575876984,0
1,943,22150,3575876984,3575876984,0
1,943,22151,3575876984,3575876984,0
1,943,22152,3575876984,3575876984,0
1,943,22153,3575876984,3575876984,0
1,943,22154,3575876984,3575876984,0
1,943,22155,3575876984,3575876984,0
1,943,22156,3575876984,3575876984,0
1,943,22157,3575876984,3575876984,0
1,943,22158,3575876984,3575876984,0
1,943,22159,3575876984,3575876984,0
1,943,22160,3575876984,3575876984,0
1,943,22161,3575876984,3575876984,0
1,943,22162,3575876984,3575876984,0
1,943,22163,3575876984,3575876985,1
1,943,22164,3575876984,3575876986,2
1,943,22165,3575876984,3575876986,2
1,943,22166,3575876984,3575876987,3
1,943,22167,3575876984,3575876987,3
1,943,22168,3575876984,3575876987,3
1,943,22169,3575876984,3575876988,4
1,943,22170,3575876984,3575876988,4
1,943,22171,3575876984,3575876989,5
1,943,22172,3575876984,3575876990,6
1,943,22173,3575876984,3575876990,6
1,943,22174,3575876984,3575876991,7
1,943,22175,3575876984,3575876991,7
1,943,22176,3575876984,3575876991,7
1,943,22177,3575876984,3575876993,9
1,943,22178,3575876984,3575876993,9
1,943,22179,3575876984,3575876996,12
1,943,22180,3575876984,3575876996,12
1,943,22181,3575876984,3575877000,16
1,943,22182,3575876984,3575877000,16
1,943,22183,3575876984,3575877001,17
1,943,22184,3575876984,3575877001,17
1,943,22185,3575876984,3575877001,17
1,943,22186,3575876984,3575877002,18
1,943,22187,3575876984,3575877002,18
1,943,22188,3575876984,3575877002,18
1,943,22189,3575876984,3575877005,21
1,943,22190,3575876984,3575877006,22
1,943,22191,3575876984,3575877006,22
1,943,22192,3575876984,3575877007,23
1,943,22193,3575876984,3575877008,24
1,943,22194,3575876984,3575877010,26
1,943,22195,3575876984,3575877014,30
1,943,22196,3575876984,3575877015,31
1,943,22197,3575876984,3575877016,32
1,943,22198,3575876984,3575877016,32
1,943,22199,3575876984,3575877016,32
1,943,22200,3575876984,3575877016,32
1,943,22201,3575876984,3575877016,32
1,943,22202,3575876984,3575877017,33
1,943,22203,3575876984,3575877018,34
1,943,22204,3575876984,3575877018,34
1,943,22205,3575876984,3575877018,34
1,943,22206,3575876984,3575877019,35
1,943,22207,3575876984,3575877020,36
1,943,22208,3575876984,3575877020,36
1,943,22209,3575876984,3575877020,36
1,943,22210,3575876984,3575877022,38
1,943,22211,3575876984,3575877023,39
1,943,22212,3575876984,3575877023,39
1,943,22213,3575876984,3575877023,39
1,943,22214,3575876984,3575877024,40
1,943,22215,3575876984,3575877024,40
1,943,22216,3575876984,3575877025,41
1,943,22217,3575876984,3575877030,46
1,943,22218,3575876984,3575877031,47
1,943,22219,3575876984,3575877031,47
1,943,22220,3575876984,3575877032,48
1,943,22221,3575876984,3575877032,48
1,943,22222,3575876984,3575877032,48
1,943,22223,3575876984,3575877032,48
1,943,22224,3575876984,3575877032,48
1,943,22225,3575876984,3575877033,49
1,943,22226,3575876984,3575877033,49
1,943,22227,3575876984,3575877034,50
1,944,22228,3575877046,3575877046,0
1,944,22229,3575877046,3575877046,0
1,944,22230,3575877046,3575877046,0
1,944,22231,3575877046,3575877046,0
1,944,22232,3575877046,3575877046,0
1,944,22233,3575877046,3575877046,0
1,944,22234,3575877046,3575877046,0
1,944,22235,3575877046,3575877046,0
1,944,22236,3575877046,3575877046,0
1,944,22237,3575877046,3575877046,0
1,944,22238,3575877046,3575877046,0
1,944,22239,3575877046,3575877046,0
1,944,22240,3575877046,3575877047,1
1,944,22241,3575877046,3575877047,1
1,944,22242,3575877046,3575877049,3
1,944,22243,3575877046,3575877049,3
1,944,22244,3575877046,3575877050,4
1,944,22245,3575877046,3575877050,4
1,944,22246,3575877046,3575877053,7
1,944,22247,3575877046,3575877053,7
1,944,22248,3575877046,3575877053,7
1,944,22249,3575877046,3575877053,7
1,944,22250,3575877046,3575877053,7
1,944,22251,3575877046,3575877053,7
1,944,22252,3575877046,3575877055,9
1,944,22253,3575877046,3575877055,9
1,944,22254,3575877046,3575877057,11
1,944,22255,3575877046,3575877057,11
1,944,22256,3575877046,3575877061,15
1,944,22257,3575877046,3575877063,17
1,944,22258,3575877046,3575877063,17
1,944,22259,3575877046,3575877066,20
1,944,22260,3575877046,3575877067,21
1,944,22261,3575877046,3575877068,22
1,944,22262,3575877046,3575877069,23
1,944,22263,3575877046,3575877071,25
1,944,22264,3575877046,3575877076,30
1,944,22265,3575877046,3575877079,33
1,944,22266,3575877046,3575877079,33
1,944,22267,3575877046,3575877081,35
1,944,22268,3575877046,3575877082,36
1,944,22269,3575877046,3575877083,37
1,944,22270,3575877046,3575877083,37
1,944,22271,3575877046,3575877084,38
1,944,22272,3575877046,3575877085,39
1,944,22273,3575877046,3575877086,40
1,944,22274,3575877046,3575877086,40
1,944,22275,3575877046,3575877087,41
1,944,22276,3575877046,3575877091,45
1,944,22277,3575877046,3575877091,45
1,945,22278,3575877104,3575877104,0
1,945,22279,3575877104,3575877104,0
1,945,22280,3575877104,3575877104,0
1,945,22281,3575877104,3575877104,0
1,945,22282,3575877104,3575877104,0
1,945,22283,3575877104,3575877104,0
1,945,22284,3575877104,3575877105,1
1,945,22285,3575877104,3575877105,1
1,945,22286,3575877104,3575877105,1
1,945,22287,3575877104,3575877105,1
1,945,22288,3575877104,3575877105,1
1,945,22289,3575877104,3575877106,2
1,945,22290,3575877104,3575877106,2
1,945,22291,3575877104,3575877109,5
1,945,22292,3575877104,3575877110,6
1,945,22293,3575877104,3575877111,7
1,945,22294,3575877104,3575877111,7
1,945,22295,3575877104,3575877112,8
1,945,22296,3575877104,3575877113,9
1,945,22297,3575877104,3575877114,10
1,945,22298,3575877104,3575877114,10
1,945,22299,3575877104,3575877118,14
1,945,22300,3575877104,3575877118,14
1,945,22301,3575877104,3575877118,14
1,945,22302,3575877104,3575877120,16
1,945,22303,3575877104,3575877122,18
1,945,22304,3575877104,3575877123,19
1,945,22305,3575877104,3575877124,20
1,945,22306,3575877104,3575877124,20
1,945,22307,3575877104,3575877126,22
1,945,22308,3575877104,3575877127,23
1,945,22309,3575877104,3575877127,23
1,945,22310,3575877104,3575877128,24
1,945,22311,3575877104,3575877129,25
1,945,22312,3575877104,3575877131,27
1,945,22313,3575877104,3575877132,28
1,945,22314,3575877104,3575877133,29
1,945,22315,3575877104,3575877134,30
1,945,22316,3575877104,3575877134,30
1,945,22317,3575877104,3575877134,30
1,945,22318,3575877104,3575877136,32
1,945,22319,3575877104,3575877137,33
1,945,22320,3575877104,3575877139,35
1,945,22321,3575877104,3575877139,35
1,945,22322,3575877104,3575877140,36
1,945,22323,3575877104,3575877140,36
1,945,22324,3575877104,3575877140,36
1,945,22325,3575877104,3575877141,37
1,945,22326,3575877104,3575877141,37
1,945,22327,3575877104,3575877144,40
1,945,22328,3575877104,3575877144,40
1,945,22329,3575877104,3575877145,41
1,945,22330,3575877104,3575877146,42
1,945,22331,3575877104,3575877148,44
1,945,22332,3575877104,3575877149,45
1,945,22333,3575877104,3575877149,45
1,945,22334,3575877104,3575877149,45
1,945,22335,3575877104,3575877150,46
1,945,22336,3575877104,3575877152,48
1,945,22337,3575877104,3575877152,48
1,945,22338,3575877104,3575877152,48
1,945,22339,3575877104,3575877153,49
1,945,22340,3575877104,3575877153,49
1,945,22341,3575877104,3575877153,49
1,945,22342,3575877104,3575877154,50
1,946,22343,3575877168,3575877168,0
1,946,22344,3575877168,3575877168,0
1,946,22345,3575877168,3575877168,0
1,946,22346,3575877168,3575877168,0
1,946,22347,3575877168,3575877168,0
1,946,22348,3575877168,3575877168,0
1,946,22349,3575877168,3575877168,0
1,946,22350,3575877168,3575877168,0
1,946,22351,3575877168,3575877168,0
1,946,22352,3575877168,3575877168,0
1,946,22353,3575877168,3575877169,1
1,946,22354,3575877168,3575877174,6
1,946,22355,3575877168,3575877175,7
1,946,22356,3575877168,3575877177,9
1,946,22357,3575877168,3575877177,9
1,946,22358,3575877168,3575877177,9
1,946,22359,3575877168,3575877177,9
1,946,22360,3575877168,3575877178,10
1,946,22361,3575877168,3575877179,11
1,946,22362,3575877168,3575877180,12
1,946,22363,3575877168,3575877180,12
1,946,22364,3575877168,3575877181,13
1,946,22365,3575877168,3575877181,13
1,946,22366,3575877168,3575877182,14
1,946,22367,3575877168,3575877183,15
1,946,22368,3575877168,3575877183,15
1,946,22369,3575877168,3575877185,17
1,946,22370,3575877168,3575877185,17
1,946,22371,3575877168,3575877186,18
1,946,22372,3575877168,3575877187,19
1,946,22373,3575877168,3575877187,19
1,946,22374,3575877168,3575877187,19
1,946,22375,3575877168,3575877187,19
1,946,22376,3575877168,3575877188,20
1,946,22377,3575877168,3575877190,22
1,946,22378,3575877168,3575877191,23
1,946,22379,3575877168,3575877191,23
1,946,22380,3575877168,3575877191,23
1,946,22381,3575877168,3575877192,24
1,946,22382,3575877168,3575877193,25
1,946,22383,3575877168,3575877193,25
1,946,22384,3575877168,3575877196,28
1,946,22385,3575877168,3575877197,29
1,946,22386,3575877168,3575877200,32
1,946,22387,3575877168,3575877201,33
1,946,22388,3575877168,3575877201,33
1,946,22389,3575877168,3575877201,33
1,946,22390,3575877168,3575877201,33
1,946,22391,3575877168,3575877201,33
1,946,22392,3575877168,3575877202,34
1,946,22393,3575877168,3575877202,34
1,946,22394,3575877168,3575877205,37
1,946,22395,3575877168,3575877206,38
1,946,22396,3575877168,3575877207,39
1,946,22397,3575877168,3575877207,39
1,946,22398,3575877168,3575877209,41
1,946,22399,3575877168,3575877210,42
1,946,22400,3575877168,3575877210,42
1,946,22401,3575877168,3575877211,43
1,946,22402,3575877168,3575877214,46
1,946,22403,3575877168,3575877215,47
1,946,22404,3575877168,3575877216,48
1,946,22405,3575877168,3575877216,48
1,946,22406,3575877168,3575877216,48
1,946,22407,3575877168,3575877217,49
1,946,22408,3575877168,3575877217,49
1,946,22409,3575877168,3575877217,49
1,946,22410,3575877168,3575877218,50
1,947,22411,3575877232,3575877232,0
1,947,22412,3575877232,3575877232,0
1,947,22413,3575877232,3575877232,0
1,947,22414,3575877232,3575877232,0
1,947,22415,3575877232,3575877232,0
1,947,22416,3575877232,3575877232,0
1,947,22417,3575877232,3575877232,0
1,947,22418,3575877232,3575877232,0
1,947,22419,3575877232,3575877232,0
1,947,22420,3575877232,3575877232,0
1,947,22421,3575877232,3575877232,0
1,947,22422,3575877232,3575877232,0
1,947,22423,3575877232,3575877232,0
1,947,22424,3575877232,3575877232,0
1,947,22425,3575877232,3575877232,0
1,947,22426,3575877232,3575877232,0
1,947,22427,3575877232,3575877232,0
1,947,22428,3575877232,3575877233,1
1,947,22429,3575877232,3575877233,1
1,947,22430,3575877232,3575877233,1
1,947,22431,3575877232,3575877233,1
1,947,22432,3575877232,3575877235,3
1,947,22433,3575877232,3575877236,4
1,947,22434,3575877232,3575877240,8
1,947,22435,3575877232,3575877242,10
1,947,22436,3575877232,3575877242,10
1,947,22437,3575877232,3575877243,11
1,947,22438,3575877232,3575877243,11
1,947,22439,3575877232,3575877244,12
1,947,22440,3575877232,3575877245,13
1,947,22441,3575877232,3575877245,13
1,947,22442,3575877232,3575877246,14
1,947,22443,3575877232,3575877246,14
1,947,22444,3575877232,3575877246,14
1,947,22445,3575877232,3575877247,15
1,947,22446,3575877232,3575877248,16
1,947,22447,3575877232,3575877249,17
1,947,22448,3575877232,3575877250,18
1,947,22449,3575877232,3575877251,19
1,947,22450,3575877232,3575877251,19
1,947,22451,3575877232,3575877252,20
1,947,22452,3575877232,3575877252,20
1,947,22453,3575877232,3575877252,20
1,947,22454,3575877232,3575877253,21
1,947,22455,3575877232,3575877253,21
1,947,22456,3575877232,3575877254,22
1,947,22457,3575877232,3575877255,23
1,947,22458,3575877232,3575877256,24
1,947,22459,3575877232,3575877257,25
1,947,22460,3575877232,3575877258,26
1,947,22461,3575877232,3575877261,29
1,947,22462,3575877232,3575877262,30
1,947,22463,3575877232,3575877262,30
1,947,22464,3575877232,3575877263,31
1,947,22465,3575877232,3575877263,31
1,947,22466,3575877232,3575877263,31
1,947,22467,3575877232,3575877265,33
1,947,22468,3575877232,3575877266,34
1,947,22469,3575877232,3575877267,35
1,947,22470,3575877232,3575877267,35
1,947,22471,3575877232,3575877268,36
1,947,22472,3575877232,3575877269,37
1,947,22473,3575877232,3575877271,39
1,947,22474,3575877232,3575877276,44
1,947,22475,3575877232,3575877279,47
1,947,22476,3575877232,3575877279,47
1,947,22477,3575877232,3575877280,48
1,948,22478,3575877296,3575877296,0
1,948,22479,3575877296,3575877296,0
1,948,22480,3575877296,3575877296,0
1,948,22481,3575877296,3575877296,0
1,948,22482,3575877296,3575877296,0
1,948,22483,3575877296,3575877296,0
1,948,22484,3575877296,3575877296,0
1,948,22485,3575877296,3575877296,0
1,948,22486,3575877296,3575877296,0
1,948,22487,3575877296,3575877300,4
1,948,22488,3575877296,3575877300,4
1,948,22489,3575877296,3575877300,4
1,948,22490,3575877296,3575877301,5
1,948,22491,3575877296,3575877301,5
1,948,22492,3575877296,3575877303,7
1,948,22493,3575877296,3575877303,7
1,948,22494,3575877296,3575877304,8
1,948,22495,3575877296,3575877305,9
1,948,22496,3575877296,3575877306,10
1,948,22497,3575877296,3575877306,10
1,948,22498,3575877296,3575877310,14
1,948,22499,3575877296,3575877311,15
1,948,22500,3575877296,3575877311,15
1,948,22501,3575877296,3575877311,15
1,948,22502,3575877296,3575877311,15
1,948,22503,3575877296,3575877314,18
1,948,22504,3575877296,3575877314,18
1,948,22505,3575877296,3575877315,19
1,948,22506,3575877296,3575877318,22
1,948,22507,3575877296,3575877318,22
1,948,22508,3575877296,3575877318,22
1,948,22509,3575877296,3575877318,22
1,948,22510,3575877296,3575877319,23
1,948,22511,3575877296,3575877323,27
1,948,22512,3575877296,3575877323,27
1,948,22513,3575877296,3575877324,28
1,948,22514,3575877296,3575877325,29
1,948,22515,3575877296,3575877326,30
1,948,22516,3575877296,3575877326,30
1,948,22517,3575877296,3575877327,31
1,948,22518,3575877296,3575877329,33
1,948,22519,3575877296,3575877329,33
1,948,22520,3575877296,3575877332,36
1,948,22521,3575877296,3575877332,36
1,948,22522,3575877296,3575877334,38
1,948,22523,3575877296,3575877335,39
1,948,22524,3575877296,3575877335,39
1,948,22525,3575877296,3575877336,40
1,948,22526,3575877296,3575877337,41
1,948,22527,3575877296,3575877338,42
1,948,22528,3575877296,3575877340,44
1,948,22529,3575877296,3575877340,44
1,948,22530,3575877296,3575877340,44
1,948,22531,3575877296,3575877340,44
1,948,22532,3575877296,3575877341,45
1,948,22533,3575877296,3575877343,47
1,948,22534,3575877296,3575877344,48
1,948,22535,3575877296,3575877346,50
1,949,22536,3575877356,3575877356,0
1,949,22537,3575877356,3575877356,0
1,949,22538,3575877356,3575877356,0
1,949,22539,3575877356,3575877356,0
1,949,22540,3575877356,3575877356,0
1,949,22541,3575877356,3575877356,0
1,949,22542,3575877356,3575877356,0
1,949,22543,3575877356,3575877356,0
1,949,22544,3575877356,3575877356,0
1,949,22545,3575877356,3575877356,0
1,949,22546,3575877356,3575877356,0
1,949,22547,3575877356,3575877356,0
1,949,22548,3575877356,3575877357,1
1,949,22549,3575877356,3575877357,1
1,949,22550,3575877356,3575877358,2
1,949,22551,3575877356,3575877359,3
1,949,22552,3575877356,3575877359,3
1,949,22553,3575877356,3575877362,6
1,949,22554,3575877356,3575877363,7
1,949,22555,3575877356,3575877363,7
1,949,22556,3575877356,3575877363,7
1,949,22557,3575877356,3575877365,9
1,949,22558,3575877356,3575877366,10
1,949,22559,3575877356,3575877367,11
1,949,22560,3575877356,3575877369,13
1,949,22561,3575877356,3575877371,15
1,949,22562,3575877356,3575877375,19
1,949,22563,3575877356,3575877375,19
1,949,22564,3575877356,3575877376,20
1,949,22565,3575877356,3575877376,20
1,949,22566,3575877356,3575877377,21
1,949,22567,3575877356,3575877377,21
1,949,22568,3575877356,3575877378,22
1,949,22569,3575877356,3575877378,22
1,949,22570,3575877356,3575877380,24
1,949,22571,3575877356,3575877380,24
1,949,22572,3575877356,3575877380,24
1,949,22573,3575877356,3575877381,25
1,949,22574,3575877356,3575877381,25
1,949,22575,3575877356,3575877382,26
1,949,22576,3575877356,3575877382,26
1,949,22577,3575877356,3575877384,28
1,949,22578,3575877356,3575877385,29
1,949,22579,3575877356,3575877385,29
1,949,22580,3575877356,3575877385,29
1,949,22581,3575877356,3575877385,29
1,949,22582,3575877356,3575877386,30
1,949,22583,3575877356,3575877387,31
1,949,22584,3575877356,3575877387,31
1,949,22585,3575877356,3575877387,31
1,949,22586,3575877356,3575877387,31
1,949,22587,3575877356,3575877388,32
1,949,22588,3575877356,3575877390,34
1,949,22589,3575877356,3575877390,34
1,949,22590,3575877356,3575877390,34
1,949,22591,3575877356,3575877391,35
1,949,22592,3575877356,3575877391,35
1,949,22593,3575877356,3575877391,35
1,949,22594,3575877356,3575877392,36
1,949,22595,3575877356,3575877393,37
1,949,22596,3575877356,3575877393,37
1,949,22597,3575877356,3575877396,40
1,949,22598,3575877356,3575877398,42
1,949,22599,3575877356,3575877401,45
1,949,22600,3575877356,3575877401,45
1,949,22601,3575877356,3575877401,45
1,949,22602,3575877356,3575877401,45
1,949,22603,3575877356,3575877402,46
1,949,22604,3575877356,3575877402,46
1,949,22605,3575877356,3575877405,49
1,950,22606,3575877420,3575877420,0
1,950,22607,3575877420,3575877420,0
1,950,22608,3575877420,3575877420,0
1,950,22609,3575877420,3575877420,0
1,950,22610,3575877420,3575877420,0
1,950,22611,3575877420,3575877420,0
1,950,22612,3575877420,3575877420,0
1,950,22613,3575877420,3575877420,0
1,950,22614,3575877420,3575877420,0
1,950,22615,3575877420,3575877420,0
1,950,22616,3575877420,3575877420,0
1,950,22617,3575877420,3575877420,0
1,950,22618,3575877420,3575877420,0
1,950,22619,3575877420,3575877420,0
1,950,22620,3575877420,3575877420,0
1,950,22621,3575877420,3575877420,0
1,950,22622,3575877420,3575877420,0
1,950,22623,3575877420,3575877420,0
1,950,22624,3575877420,3575877421,1
1,950,22625,3575877420,3575877422,2
1,950,22626,3575877420,3575877423,3
1,950,22627,3575877420,3575877424,4
1,950,22628,3575877420,3575877424,4
1,950,22629,3575877420,3575877425,5
1,950,22630,3575877420,3575877425,5
1,950,22631,3575877420,3575877426,6
1,950,22632,3575877420,3575877429,9
1,950,22633,3575877420,3575877430,10
1,950,22634,3575877420,3575877431,11
1,950,22635,3575877420,3575877431,11
1,950,22636,3575877420,3575877432,12
1,950,22637,3575877420,3575877432,12
1,950,22638,3575877420,3575877432,12
1,950,22639,3575877420,3575877433,13
1,950,22640,3575877420,3575877433,13
1,950,22641,3575877420,3575877433,13
1,950,22642,3575877420,3575877434,14
1,950,22643,3575877420,3575877435,15
1,950,22644,3575877420,3575877436,16
1,950,22645,3575877420,3575877440,20
1,950,22646,3575877420,3575877442,22
1,950,22647,3575877420,3575877442,22
1,950,22648,3575877420,3575877444,24
1,950,22649,3575877420,3575877444,24
1,950,22650,3575877420,3575877444,24
1,950,22651,3575877420,3575877444,24
1,950,22652,3575877420,3575877445,25
1,950,22653,3575877420,3575877445,25
1,950,22654,3575877420,3575877446,26
1,950,22655,3575877420,3575877446,26
1,950,22656,3575877420,3575877447,27
1,950,22657,3575877420,3575877447,27
1,950,22658,3575877420,3575877450,30
1,950,22659,3575877420,3575877451,31
1,950,22660,3575877420,3575877451,31
1,950,22661,3575877420,3575877453,33
1,950,22662,3575877420,3575877453,33
1,950,22663,3575877420,3575877453,33
1,950,22664,3575877420,3575877454,34
1,950,22665,3575877420,3575877455,35
1,950,22666,3575877420,3575877456,36
1,950,22667,3575877420,3575877456,36
1,950,22668,3575877420,3575877457,37
1,950,22669,3575877420,3575877460,40
1,950,22670,3575877420,3575877461,41
1,950,22671,3575877420,3575877461,41
1,950,22672,3575877420,3575877462,42
1,950,22673,3575877420,3575877463,43
1,950,22674,3575877420,3575877464,44
1,950,22675,3575877420,3575877464,44
1,950,22676,3575877420,3575877465,45
1,950,22677,3575877420,3575877467,47
1,950,22678,3575877420,3575877468,48
1,951,22679,3575877482,3575877482,0
1,951,22680,3575877482,3575877482,0
1,951,22681,3575877482,3575877482,0
1,951,22682,3575877482,3575877482,0
1,951,22683,3575877482,3575877482,0
1,951,22684,3575877482,3575877483,1
1,951,22685,3575877482,3575877484,2
1,951,22686,3575877482,3575877484,2
1,951,22687,3575877482,3575877484,2
1,951,22688,3575877482,3575877485,3
1,951,22689,3575877482,3575877485,3
1,951,22690,3575877482,3575877485,3
1,951,22691,3575877482,3575877486,4
1,951,22692,3575877482,3575877491,9
1,951,22693,3575877482,3575877492,10
1,951,22694,3575877482,3575877496,14
1,951,22695,3575877482,3575877497,15
1,951,22696,3575877482,3575877499,17
1,951,22697,3575877482,3575877499,17
1,951,22698,3575877482,3575877500,18
1,951,22699,3575877482,3575877500,18
1,951,22700,3575877482,3575877502,20
1,951,22701,3575877482,3575877502,20
1,951,22702,3575877482,3575877502,20
1,951,22703,3575877482,3575877503,21
1,951,22704,3575877482,3575877503,21
1,951,22705,3575877482,3575877503,21
1,951,22706,3575877482,3575877504,22
1,951,22707,3575877482,3575877505,23
1,951,22708,3575877482,3575877505,23
1,951,22709,3575877482,3575877509,27
1,951,22710,3575877482,3575877510,28
1,951,22711,3575877482,3575877510,28
1,951,22712,3575877482,3575877511,29
1,951,22713,3575877482,3575877511,29
1,951,22714,3575877482,3575877512,30
1,951,22715,3575877482,3575877513,31
1,951,22716,3575877482,3575877514,32
1,951,22717,3575877482,3575877514,32
1,951,22718,3575877482,3575877516,34
1,951,22719,3575877482,3575877517,35
1,951,22720,3575877482,3575877517,35
1,951,22721,3575877482,3575877518,36
1,951,22722,3575877482,3575877519,37
1,951,22723,3575877482,3575877522,40
1,951,22724,3575877482,3575877523,41
1,951,22725,3575877482,3575877523,41
1,951,22726,3575877482,3575877525,43
1,951,22727,3575877482,3575877525,43
1,951,22728,3575877482,3575877526,44
1,951,22729,3575877482,3575877528,46
1,951,22730,3575877482,3575877528,46
1,951,22731,3575877482,3575877528,46
1,951,22732,3575877482,3575877530,48
1,952,22733,3575877543,3575877543,0
1,952,22734,3575877543,3575877543,0
1,952,22735,3575877543,3575877543,0
1,952,22736,3575877543,3575877543,0
1,952,22737,3575877543,3575877543,0
1,952,22738,3575877543,3575877543,0
1,952,22739,3575877543,3575877543,0
1,952,22740,3575877543,3575877543,0
1,952,22741,3575877543,3575877543,0
1,952,22742,3575877543,3575877543,0
1,952,22743,3575877543,3575877543,0
1,952,22744,3575877543,3575877543,0
1,952,22745,3575877543,3575877543,0
1,952,22746,3575877543,3575877543,0
1,952,22747,3575877543,3575877543,0
1,952,22748,3575877543,3575877545,2
1,952,22749,3575877543,3575877545,2
1,952,22750,3575877543,3575877547,4
1,952,22751,3575877543,3575877548,5
1,952,22752,3575877543,3575877550,7
1,952,22753,3575877543,3575877550,7
1,952,22754,3575877543,3575877552,9
1,952,22755,3575877543,3575877552,9
1,952,22756,3575877543,3575877552,9
1,952,22757,3575877543,3575877552,9
1,952,22758,3575877543,3575877552,9
1,952,22759,3575877543,3575877553,10
1,952,22760,3575877543,3575877554,11
1,952,22761,3575877543,3575877555,12
1,952,22762,3575877543,3575877556,13
1,952,22763,3575877543,3575877556,13
1,952,22764,3575877543,3575877557,14
1,952,22765,3575877543,3575877558,15
1,952,22766,3575877543,3575877559,16
1,952,22767,3575877543,3575877560,17
1,952,22768,3575877543,3575877563,20
1,952,22769,3575877543,3575877563,20
1,952,22770,3575877543,3575877564,21
1,952,22771,3575877543,3575877565,22
1,952,22772,3575877543,3575877565,22
1,952,22773,3575877543,3575877566,23
1,952,22774,3575877543,3575877568,25
1,952,22775,3575877543,3575877570,27
1,952,22776,3575877543,3575877574,31
1,952,22777,3575877543,3575877575,32
1,952,22778,3575877543,3575877575,32
1,952,22779,3575877543,3575877576,33
1,952,22780,3575877543,3575877576,33
1,952,22781,3575877543,3575877577,34
1,952,22782,3575877543,3575877577,34
1,952,22783,3575877543,3575877579,36
1,952,22784,3575877543,3575877579,36
1,952,22785,3575877543,3575877579,36
1,952,22786,3575877543,3575877581,38
1,952,22787,3575877543,3575877581,38
1,952,22788,3575877543,3575877582,39
1,952,22789,3575877543,3575877584,41
1,952,22790,3575877543,3575877585,42
1,952,22791,3575877543,3575877585,42
1,952,22792,3575877543,3575877585,42
1,952,22793,3575877543,3575877586,43
1,952,22794,3575877543,3575877587,44
1,952,22795,3575877543,3575877587,44
1,952,22796,3575877543,3575877587,44
1,952,22797,3575877543,3575877589,46
1,952,22798,3575877543,3575877590,47
1,952,22799,3575877543,3575877590,47
1,952,22800,3575877543,3575877591,48
1,952,22801,3575877543,3575877592,49
1,952,22802,3575877543,3575877592,49
1,953,22803,3575877606,3575877606,0
1,953,22804,3575877606,3575877606,0
1,953,22805,3575877606,3575877606,0
1,953,22806,3575877606,3575877606,0
1,953,22807,3575877606,3575877606,0
1,953,22808,3575877606,3575877606,0
1,953,22809,3575877606,3575877606,0
1,953,22810,3575877606,3575877606,0
1,953,22811,3575877606,3575877606,0
1,953,22812,3575877606,3575877606,0
1,953,22813,3575877606,3575877606,0
1,953,22814,3575877606,3575877606,0
1,953,22815,3575877606,3575877606,0
1,953,22816,3575877606,3575877607,1
1,953,22817,3575877606,3575877608,2
1,953,22818,3575877606,3575877609,3
1,953,22819,3575877606,3575877609,3
1,953,22820,3575877606,3575877610,4
1,953,22821,3575877606,3575877612,6
1,953,22822,3575877606,3575877613,7
1,953,22823,3575877606,3575877614,8
1,953,22824,3575877606,3575877615,9
1,953,22825,3575877606,3575877615,9
1,953,22826,3575877606,3575877615,9
1,953,22827,3575877606,3575877615,9
1,953,22828,3575877606,3575877616,10
1,953,22829,3575877606,3575877617,11
1,953,22830,3575877606,3575877617,11
1,953,22831,3575877606,3575877618,12
1,953,22832,3575877606,3575877619,13
1,953,22833,3575877606,3575877619,13
1,953,22834,3575877606,3575877619,13
1,953,22835,3575877606,3575877620,14
1,953,22836,3575877606,3575877620,14
1,953,22837,3575877606,3575877622,16
1,953,22838,3575877606,3575877623,17
1,953,22839,3575877606,3575877624,18
1,953,22840,3575877606,3575877624,18
1,953,22841,3575877606,3575877624,18
1,953,22842,3575877606,3575877625,19
1,953,22843,3575877606,3575877628,22
1,953,22844,3575877606,3575877629,23
1,953,22845,3575877606,3575877630,24
1,953,22846,3575877606,3575877630,24
1,953,22847,3575877606,3575877631,25
1,953,22848,3575877606,3575877632,26
1,953,22849,3575877606,3575877632,26
1,953,22850,3575877606,3575877632,26
1,953,22851,3575877606,3575877632,26
1,953,22852,3575877606,3575877633,27
1,953,22853,3575877606,3575877634,28
1,953,22854,3575877606,3575877635,29
1,953,22855,3575877606,3575877637,31
1,953,22856,3575877606,3575877639,33
1,953,22857,3575877606,3575877641,35
1,953,22858,3575877606,3575877642,36
1,953,22859,3575877606,3575877642,36
1,953,22860,3575877606,3575877643,37
1,953,22861,3575877606,3575877643,37
1,953,22862,3575877606,3575877644,38
1,953,22863,3575877606,3575877644,38
1,953,22864,3575877606,3575877644,38
1,953,22865,3575877606,3575877644,38
1,953,22866,3575877606,3575877645,39
1,953,22867,3575877606,3575877645,39
1,953,22868,3575877606,3575877646,40
1,953,22869,3575877606,3575877650,44
1,953,22870,3575877606,3575877650,44
1,953,22871,3575877606,3575877650,44
1,953,22872,3575877606,3575877651,45
1,953,22873,3575877606,3575877652,46
1,953,22874,3575877606,3575877652,46
1,953,22875,3575877606,3575877653,47
1,953,22876,3575877606,3575877655,49
1,953,22877,3575877606,3575877655,49
1,953,22878,3575877606,3575877656,50
1,954,22879,3575877666,3575877667,1
1,954,22880,3575877666,3575877667,1
1,954,22881,3575877666,3575877667,1
1,954,22882,3575877666,3575877667,1
1,954,22883,3575877666,3575877667,1
1,954,22884,3575877666,3575877667,1
1,954,22885,3575877666,3575877667,1
1,954,22886,3575877666,3575877667,1
1,954,22887,3575877666,3575877667,1
1,954,22888,3575877666,3575877670,4
1,954,22889,3575877666,3575877676,10
1,954,22890,3575877666,3575877679,13
1,954,22891,3575877666,3575877680,14
1,954,22892,3575877666,3575877680,14
1,954,22893,3575877666,3575877684,18
1,954,22894,3575877666,3575877684,18
1,954,22895,3575877666,3575877684,18
1,954,22896,3575877666,3575877684,18
1,954,22897,3575877666,3575877685,19
1,954,22898,3575877666,3575877685,19
1,954,22899,3575877666,3575877686,20
1,954,22900,3575877666,3575877688,22
1,954,22901,3575877666,3575877690,24
1,954,22902,3575877666,3575877692,26
1,954,22903,3575877666,3575877696,30
1,954,22904,3575877666,3575877697,31
1,954,22905,3575877666,3575877699,33
1,954,22906,3575877666,3575877699,33
1,954,22907,3575877666,3575877700,34
1,954,22908,3575877666,3575877700,34
1,954,22909,3575877666,3575877702,36
1,954,22910,3575877666,3575877702,36
1,954,22911,3575877666,3575877702,36
1,954,22912,3575877666,3575877703,37
1,954,22913,3575877666,3575877703,37
1,954,22914,3575877666,3575877703,37
1,954,22915,3575877666,3575877704,38
1,954,22916,3575877666,3575877705,39
1,954,22917,3575877666,3575877705,39
1,954,22918,3575877666,3575877709,43
1,954,22919,3575877666,3575877710,44
1,954,22920,3575877666,3575877710,44
1,954,22921,3575877666,3575877710,44
1,954,22922,3575877666,3575877711,45
1,954,22923,3575877666,3575877712,46
1,954,22924,3575877666,3575877713,47
1,954,22925,3575877666,3575877714,48
1,954,22926,3575877666,3575877714,48
1,955,22927,3575877727,3575877727,0
1,955,22928,3575877727,3575877727,0
1,955,22929,3575877727,3575877727,0
1,955,22930,3575877727,3575877727,0
1,955,22931,3575877727,3575877727,0
1,955,22932,3575877727,3575877727,0
1,955,22933,3575877727,3575877727,0
1,955,22934,3575877727,3575877727,0
1,955,22935,3575877727,3575877727,0
1,955,22936,3575877727,3575877727,0
1,955,22937,3575877727,3575877727,0
1,955,22938,3575877727,3575877727,0
1,955,22939,3575877727,3575877727,0
1,955,22940,3575877727,3575877728,1
1,955,22941,3575877727,3575877728,1
1,955,22942,3575877727,3575877729,2
1,955,22943,3575877727,3575877731,4
1,955,22944,3575877727,3575877732,5
1,955,22945,3575877727,3575877733,6
1,955,22946,3575877727,3575877735,8
1,955,22947,3575877727,3575877736,9
1,955,22948,3575877727,3575877737,10
1,955,22949,3575877727,3575877738,11
1,955,22950,3575877727,3575877740,13
1,955,22951,3575877727,3575877740,13
1,955,22952,3575877727,3575877740,13
1,955,22953,3575877727,3575877740,13
1,955,22954,3575877727,3575877741,14
1,955,22955,3575877727,3575877743,16
1,955,22956,3575877727,3575877743,16
1,955,22957,3575877727,3575877745,18
1,955,22958,3575877727,3575877746,19
1,955,22959,3575877727,3575877748,21
1,955,22960,3575877727,3575877748,21
1,955,22961,3575877727,3575877750,23
1,955,22962,3575877727,3575877750,23
1,955,22963,3575877727,3575877750,23
1,955,22964,3575877727,3575877751,24
1,955,22965,3575877727,3575877751,24
1,955,22966,3575877727,3575877752,25
1,955,22967,3575877727,3575877753,26
1,955,22968,3575877727,3575877753,26
1,955,22969,3575877727,3575877753,26
1,955,22970,3575877727,3575877754,27
1,955,22971,3575877727,3575877755,28
1,955,22972,3575877727,3575877755,28
1,955,22973,3575877727,3575877756,29
1,955,22974,3575877727,3575877757,30
1,955,22975,3575877727,3575877758,31
1,955,22976,3575877727,3575877759,32
1,955,22977,3575877727,3575877761,34
1,955,22978,3575877727,3575877763,36
1,955,22979,3575877727,3575877763,36
1,955,22980,3575877727,3575877764,37
1,955,22981,3575877727,3575877765,38
1,955,22982,3575877727,3575877765,38
1,955,22983,3575877727,3575877766,39
1,955,22984,3575877727,3575877768,41
1,955,22985,3575877727,3575877770,43
1,955,22986,3575877727,3575877775,48
1,955,22987,3575877727,3575877775,48
1,955,22988,3575877727,3575877775,48
1,955,22989,3575877727,3575877776,49
1,955,22990,3575877727,3575877776,49
1,955,22991,3575877727,3575877777,50
1,956,22992,3575877789,3575877789,0
1,956,22993,3575877789,3575877789,0
1,956,22994,3575877789,3575877789,0
1,956,22995,3575877789,3575877789,0
1,956,22996,3575877789,3575877789,0
1,956,22997,3575877789,3575877789,0
1,956,22998,3575877789,3575877789,0
1,956,22999,3575877789,3575877789,0
1,956,23000,3575877789,3575877789,0
1,956,23001,3575877789,3575877789,0
1,956,23002,3575877789,3575877789,0
1,956,23003,3575877789,3575877789,0
1,956,23004,3575877789,3575877789,0
1,956,23005,3575877789,3575877789,0
1,956,23006,3575877789,3575877789,0
1,956,23007,3575877789,3575877789,0
1,956,23008,3575877789,3575877789,0
1,956,23009,3575877789,3575877789,0
1,956,23010,3575877789,3575877790,1
1,956,23011,3575877789,3575877790,1
1,956,23012,3575877789,3575877791,2
1,956,23013,3575877789,3575877791,2
1,956,23014,3575877789,3575877792,3
1,956,23015,3575877789,3575877792,3
1,956,23016,3575877789,3575877793,4
1,956,23017,3575877789,3575877795,6
1,956,23018,3575877789,3575877798,9
1,956,23019,3575877789,3575877800,11
1,956,23020,3575877789,3575877800,11
1,956,23021,3575877789,3575877800,11
1,956,23022,3575877789,3575877800,11
1,956,23023,3575877789,3575877801,12
1,956,23024,3575877789,3575877801,12
1,956,23025,3575877789,3575877801,12
1,956,23026,3575877789,3575877802,13
1,956,23027,3575877789,3575877802,13
1,956,23028,3575877789,3575877804,15
1,956,23029,3575877789,3575877805,16
1,956,23030,3575877789,3575877806,17
1,956,23031,3575877789,3575877807,18
1,956,23032,3575877789,3575877809,20
1,956,23033,3575877789,3575877809,20
1,956,23034,3575877789,3575877812,23
1,956,23035,3575877789,3575877814,25
1,956,23036,3575877789,3575877815,26
1,956,23037,3575877789,3575877815,26
1,956,23038,3575877789,3575877815,26
1,956,23039,3575877789,3575877816,27
1,956,23040,3575877789,3575877816,27
1,956,23041,3575877789,3575877817,28
1,956,23042,3575877789,3575877817,28
1,956,23043,3575877789,3575877818,29
1,956,23044,3575877789,3575877819,30
1,956,23045,3575877789,3575877819,30
1,956,23046,3575877789,3575877819,30
1,956,23047,3575877789,3575877820,31
1,956,23048,3575877789,3575877821,32
1,956,23049,3575877789,3575877822,33
1,956,23050,3575877789,3575877822,33
1,956,23051,3575877789,3575877823,34
1,956,23052,3575877789,3575877823,34
1,956,23053,3575877789,3575877824,35
1,956,23054,3575877789,3575877828,39
1,956,23055,3575877789,3575877829,40
1,956,23056,3575877789,3575877829,40
1,956,23057,3575877789,3575877830,41
1,956,23058,3575877789,3575877831,42
1,956,23059,3575877789,3575877832,43
1,956,23060,3575877789,3575877832,43
1,956,23061,3575877789,3575877832,43
1,956,23062,3575877789,3575877833,44
1,956,23063,3575877789,3575877833,44
1,956,23064,3575877789,3575877834,45
1,956,23065,3575877789,3575877835,46
1,956,23066,3575877789,3575877837,48
1,957,23067,3575877851,3575877851,0
1,957,23068,3575877851,3575877851,0
1,957,23069,3575877851,3575877851,0
1,957,23070,3575877851,3575877851,0
1,957,23071,3575877851,3575877851,0
1,957,23072,3575877851,3575877851,0
1,957,23073,3575877851,3575877851,0
1,957,23074,3575877851,3575877851,0
1,957,23075,3575877851,3575877851,0
1,957,23076,3575877851,3575877851,0
1,957,23077,3575877851,3575877851,0
1,957,23078,3575877851,3575877851,0
1,957,23079,3575877851,3575877851,0
1,957,23080,3575877851,3575877851,0
1,957,23081,3575877851,3575877851,0
1,957,23082,3575877851,3575877851,0
1,957,23083,3575877851,3575877851,0
1,957,23084,3575877851,3575877852,1
1,957,23085,3575877851,3575877853,2
1,957,23086,3575877851,3575877854,3
1,957,23087,3575877851,3575877854,3
1,957,23088,3575877851,3575877856,5
1,957,23089,3575877851,3575877856,5
1,957,23090,3575877851,3575877856,5
1,957,23091,3575877851,3575877858,7
1,957,23092,3575877851,3575877861,10
1,957,23093,3575877851,3575877861,10
1,957,23094,3575877851,3575877862,11
1,957,23095,3575877851,3575877863,12
1,957,23096,3575877851,3575877864,13
1,957,23097,3575877851,3575877866,15
1,957,23098,3575877851,3575877866,15
1,957,23099,3575877851,3575877867,16
1,957,23100,3575877851,3575877868,17
1,957,23101,3575877851,3575877869,18
1,957,23102,3575877851,3575877870,19
1,957,23103,3575877851,3575877877,26
1,957,23104,3575877851,3575877880,29
1,957,23105,3575877851,3575877880,29
1,957,23106,3575877851,3575877880,29
1,957,23107,3575877851,3575877882,31
1,957,23108,3575877851,3575877883,32
1,957,23109,3575877851,3575877884,33
1,957,23110,3575877851,3575877884,33
1,957,23111,3575877851,3575877884,33
1,957,23112,3575877851,3575877886,35
1,957,23113,3575877851,3575877886,35
1,957,23114,3575877851,3575877886,35
1,957,23115,3575877851,3575877887,36
1,957,23116,3575877851,3575877890,39
1,957,23117,3575877851,3575877892,41
1,957,23118,3575877851,3575877896,45
1,957,23119,3575877851,3575877897,46
1,957,23120,3575877851,3575877899,48
1,957,23121,3575877851,3575877899,48
1,957,23122,3575877851,3575877899,48
1,957,23123,3575877851,3575877900,49
1,958,23124,3575877911,3575877911,0
1,958,23125,3575877911,3575877911,0
1,958,23126,3575877911,3575877911,0
1,958,23127,3575877911,3575877911,0
1,958,23128,3575877911,3575877911,0
1,958,23129,3575877911,3575877911,0
1,958,23130,3575877911,3575877911,0
1,958,23131,3575877911,3575877911,0
1,958,23132,3575877911,3575877911,0
1,958,23133,3575877911,3575877911,0
1,958,23134,3575877911,3575877911,0
1,958,23135,3575877911,3575877911,0
1,958,23136,3575877911,3575877911,0
1,958,23137,3575877911,3575877911,0
1,958,23138,3575877911,3575877912,1
1,958,23139,3575877911,3575877914,3
1,958,23140,3575877911,3575877915,4
1,958,23141,3575877911,3575877915,4
1,958,23142,3575877911,3575877917,6
1,958,23143,3575877911,3575877918,7
1,958,23144,3575877911,3575877918,7
1,958,23145,3575877911,3575877919,8
1,958,23146,3575877911,3575877920,9
1,958,23147,3575877911,3575877922,11
1,958,23148,3575877911,3575877922,11
1,958,23149,3575877911,3575877923,12
1,958,23150,3575877911,3575877924,13
1,958,23151,3575877911,3575877924,13
1,958,23152,3575877911,3575877925,14
1,958,23153,3575877911,3575877926,15
1,958,23154,3575877911,3575877926,15
1,958,23155,3575877911,3575877927,16
1,958,23156,3575877911,3575877928,17
1,958,23157,3575877911,3575877928,17
1,958,23158,3575877911,3575877929,18
1,958,23159,3575877911,3575877931,20
1,958,23160,3575877911,3575877931,20
1,958,23161,3575877911,3575877932,21
1,958,23162,3575877911,3575877935,24
1,958,23163,3575877911,3575877935,24
1,958,23164,3575877911,3575877937,26
1,958,23165,3575877911,3575877939,28
1,958,23166,3575877911,3575877939,28
1,958,23167,3575877911,3575877940,29
1,958,23168,3575877911,3575877940,29
1,958,23169,3575877911,3575877941,30
1,958,23170,3575877911,3575877943,32
1,958,23171,3575877911,3575877944,33
1,958,23172,3575877911,3575877945,34
1,958,23173,3575877911,3575877946,35
1,958,23174,3575877911,3575877949,38
1,958,23175,3575877911,3575877949,38
1,958,23176,3575877911,3575877950,39
1,958,23177,3575877911,3575877951,40
1,958,23178,3575877911,3575877952,41
1,958,23179,3575877911,3575877952,41
1,958,23180,3575877911,3575877952,41
1,958,23181,3575877911,3575877953,42
1,958,23182,3575877911,3575877953,42
1,958,23183,3575877911,3575877953,42
1,958,23184,3575877911,3575877954,43
1,958,23185,3575877911,3575877955,44
1,958,23186,3575877911,3575877956,45
1,958,23187,3575877911,3575877956,45
1,958,23188,3575877911,3575877957,46
1,958,23189,3575877911,3575877958,47
1,958,23190,3575877911,3575877959,48
1,959,23191,3575877971,3575877971,0
1,959,23192,3575877971,3575877971,0
1,959,23193,3575877971,3575877971,0
1,959,23194,3575877971,3575877971,0
1,959,23195,3575877971,3575877971,0
1,959,23196,3575877971,3575877971,0
1,959,23197,3575877971,3575877971,0
1,959,23198,3575877971,3575877971,0
1,959,23199,3575877971,3575877971,0
1,959,23200,3575877971,3575877971,0
1,959,23201,3575877971,3575877975,4
1,959,23202,3575877971,3575877975,4
1,959,23203,3575877971,3575877976,5
1,959,23204,3575877971,3575877976,5
1,959,23205,3575877971,3575877976,5
1,959,23206,3575877971,3575877976,5
1,959,23207,3575877971,3575877977,6
1,959,23208,3575877971,3575877979,8
1,959,23209,3575877971,3575877979,8
1,959,23210,3575877971,3575877979,8
1,959,23211,3575877971,3575877981,10
1,959,23212,3575877971,3575877981,10
1,959,23213,3575877971,3575877982,11
1,959,23214,3575877971,3575877983,12
1,959,23215,3575877971,3575877984,13
1,959,23216,3575877971,3575877985,14
1,959,23217,3575877971,3575877985,14
1,959,23218,3575877971,3575877986,15
1,959,23219,3575877971,3575877986,15
1,959,23220,3575877971,3575877987,16
1,959,23221,3575877971,3575877987,16
1,959,23222,3575877971,3575877987,16
1,959,23223,3575877971,3575877987,16
1,959,23224,3575877971,3575877989,18
1,959,23225,3575877971,3575877990,19
1,959,23226,3575877971,3575877991,20
1,959,23227,3575877971,3575877991,20
1,959,23228,3575877971,3575877992,21
1,959,23229,3575877971,3575877992,21
1,959,23230,3575877971,3575877992,21
1,959,23231,3575877971,3575877993,22
1,959,23232,3575877971,3575877993,22
1,959,23233,3575877971,3575877996,25
1,959,23234,3575877971,3575877997,26
1,959,23235,3575877971,3575877999,28
1,959,23236,3575877971,3575878000,29
1,959,23237,3575877971,3575878001,30
1,959,23238,3575877971,3575878001,30
1,959,23239,3575877971,3575878002,31
1,959,23240,3575877971,3575878002,31
1,959,23241,3575877971,3575878002,31
1,959,23242,3575877971,3575878002,31
1,959,23243,3575877971,3575878002,31
1,959,23244,3575877971,3575878004,33
1,959,23245,3575877971,3575878005,34
1,959,23246,3575877971,3575878006,35
1,959,23247,3575877971,3575878007,36
1,959,23248,3575877971,3575878008,37
1,959,23249,3575877971,3575878008,37
1,959,23250,3575877971,3575878009,38
1,959,23251,3575877971,3575878009,38
1,959,23252,3575877971,3575878011,40
1,959,23253,3575877971,3575878012,41
1,959,23254,3575877971,3575878014,43
1,959,23255,3575877971,3575878015,44
1,959,23256,3575877971,3575878016,45
1,959,23257,3575877971,3575878016,45
1,959,23258,3575877971,3575878016,45
1,959,23259,3575877971,3575878016,45
1,959,23260,3575877971,3575878017,46
1,959,23261,3575877971,3575878017,46
1,959,23262,3575877971,3575878018,47
1,959,23263,3575877971,3575878018,47
1,959,23264,3575877971,3575878019,48
1,959,23265,3575877971,3575878020,49
1,959,23266,3575877971,3575878021,50
1,960,23267,3575878033,3575878033,0
1,960,23268,3575878033,3575878033,0
1,960,23269,3575878033,3575878033,0
1,960,23270,3575878033,3575878033,0
1,960,23271,3575878033,3575878033,0
1,960,23272,3575878033,3575878033,0
1,960,23273,3575878033,3575878033,0
1,960,23274,3575878033,3575878033,0
1,960,23275,3575878033,3575878033,0
1,960,23276,3575878033,3575878033,0
1,960,23277,3575878033,3575878033,0
1,960,23278,3575878033,3575878033,0
1,960,23279,3575878033,3575878033,0
1,960,23280,3575878033,3575878033,0
1,960,23281,3575878033,3575878033,0
1,960,23282,3575878033,3575878033,0
1,960,23283,3575878033,3575878033,0
1,960,23284,3575878033,3575878033,0
1,960,23285,3575878033,3575878035,2
1,960,23286,3575878033,3575878037,4
1,960,23287,3575878033,3575878039,6
1,960,23288,3575878033,3575878041,8
1,960,23289,3575878033,3575878041,8
1,960,23290,3575878033,3575878042,9
1,960,23291,3575878033,3575878043,10
1,960,23292,3575878033,3575878044,11
1,960,23293,3575878033,3575878044,11
1,960,23294,3575878033,3575878044,11
1,960,23295,3575878033,3575878045,12
1,960,23296,3575878033,3575878045,12
1,960,23297,3575878033,3575878045,12
1,960,23298,3575878033,3575878048,15
1,960,23299,3575878033,3575878048,15
1,960,23300,3575878033,3575878050,17
1,960,23301,3575878033,3575878050,17
1,960,23302,3575878033,3575878050,17
1,960,23303,3575878033,3575878051,18
1,960,23304,3575878033,3575878052,19
1,960,23305,3575878033,3575878053,20
1,960,23306,3575878033,3575878054,21
1,960,23307,3575878033,3575878054,21
1,960,23308,3575878033,3575878056,23
1,960,23309,3575878033,3575878056,23
1,960,23310,3575878033,3575878059,26
1,960,23311,3575878033,3575878061,28
1,960,23312,3575878033,3575878062,29
1,960,23313,3575878033,3575878062,29
1,960,23314,3575878033,3575878063,30
1,960,23315,3575878033,3575878064,31
1,960,23316,3575878033,3575878066,33
1,960,23317,3575878033,3575878066,33
1,960,23318,3575878033,3575878067,34
1,960,23319,3575878033,3575878068,35
1,960,23320,3575878033,3575878069,36
1,960,23321,3575878033,3575878070,37
1,960,23322,3575878033,3575878071,38
1,960,23323,3575878033,3575878077,44
1,960,23324,3575878033,3575878080,47
1,960,23325,3575878033,3575878080,47
1,960,23326,3575878033,3575878080,47
1,960,23327,3575878033,3575878081,48
1,960,23328,3575878033,3575878082,49
1,961,23329,3575878096,3575878096,0
1,961,23330,3575878096,3575878096,0
1,961,23331,3575878096,3575878096,0
1,961,23332,3575878096,3575878096,0
1,961,23333,3575878096,3575878096,0
1,961,23334,3575878096,3575878096,0
1,961,23335,3575878096,3575878096,0
1,961,23336,3575878096,3575878096,0
1,961,23337,3575878096,3575878096,0
1,961,23338,3575878096,3575878096,0
1,961,23339,3575878096,3575878096,0
1,961,23340,3575878096,3575878097,1
1,961,23341,3575878096,3575878099,3
1,961,23342,3575878096,3575878100,4
1,961,23343,3575878096,3575878100,4
1,961,23344,3575878096,3575878103,7
1,961,23345,3575878096,3575878103,7
1,961,23346,3575878096,3575878104,8
1,961,23347,3575878096,3575878104,8
1,961,23348,3575878096,3575878105,9
1,961,23349,3575878096,3575878106,10
1,961,23350,3575878096,3575878106,10
1,961,23351,3575878096,3575878107,11
1,961,23352,3575878096,3575878108,12
1,961,23353,3575878096,3575878110,14
1,961,23354,3575878096,3575878110,14
1,961,23355,3575878096,3575878110,14
1,961,23356,3575878096,3575878111,15
1,961,23357,3575878096,3575878112,16
1,961,23358,3575878096,3575878114,18
1,961,23359,3575878096,3575878114,18
1,961,23360,3575878096,3575878116,20
1,961,23361,3575878096,3575878118,22
1,961,23362,3575878096,3575878118,22
1,961,23363,3575878096,3575878118,22
1,961,23364,3575878096,3575878119,23
1,961,23365,3575878096,3575878120,24
1,961,23366,3575878096,3575878122,26
1,961,23367,3575878096,3575878124,28
1,961,23368,3575878096,3575878124,28
1,961,23369,3575878096,3575878125,29
1,961,23370,3575878096,3575878125,29
1,961,23371,3575878096,3575878125,29
1,961,23372,3575878096,3575878126,30
1,961,23373,3575878096,3575878127,31
1,961,23374,3575878096,3575878127,31
1,961,23375,3575878096,3575878128,32
1,961,23376,3575878096,3575878130,34
1,961,23377,3575878096,3575878131,35
1,961,23378,3575878096,3575878133,37
1,961,23379,3575878096,3575878136,40
1,961,23380,3575878096,3575878137,41
1,961,23381,3575878096,3575878139,43
1,961,23382,3575878096,3575878139,43
1,961,23383,3575878096,3575878140,44
1,961,23384,3575878096,3575878140,44
1,961,23385,3575878096,3575878141,45
1,961,23386,3575878096,3575878141,45
1,961,23387,3575878096,3575878143,47
1,961,23388,3575878096,3575878144,48
1,961,23389,3575878096,3575878145,49
1,961,23390,3575878096,3575878147,51
1,962,23391,3575878161,3575878161,0
1,962,23392,3575878161,3575878161,0
1,962,23393,3575878161,3575878161,0
1,962,23394,3575878161,3575878161,0
1,962,23395,3575878161,3575878161,0
1,962,23396,3575878161,3575878161,0
1,962,23397,3575878161,3575878161,0
1,962,23398,3575878161,3575878161,0
1,962,23399,3575878161,3575878161,0
1,962,23400,3575878161,3575878161,0
1,962,23401,3575878161,3575878161,0
1,962,23402,3575878161,3575878161,0
1,962,23403,3575878161,3575878161,0
1,962,23404,3575878161,3575878161,0
1,962,23405,3575878161,3575878161,0
1,962,23406,3575878161,3575878161,0
1,962,23407,3575878161,3575878162,1
1,962,23408,3575878161,3575878163,2
1,962,23409,3575878161,3575878163,2
1,962,23410,3575878161,3575878164,3
1,962,23411,3575878161,3575878165,4
1,962,23412,3575878161,3575878166,5
1,962,23413,3575878161,3575878166,5
1,962,23414,3575878161,3575878168,7
1,962,23415,3575878161,3575878171,10
1,962,23416,3575878161,3575878175,14
1,962,23417,3575878161,3575878176,15
1,962,23418,3575878161,3575878176,15
1,962,23419,3575878161,3575878176,15
1,962,23420,3575878161,3575878177,16
1,962,23421,3575878161,3575878177,16
1,962,23422,3575878161,3575878178,17
1,962,23423,3575878161,3575878179,18
1,962,23424,3575878161,3575878179,18
1,962,23425,3575878161,3575878181,20
1,962,23426,3575878161,3575878181,20
1,962,23427,3575878161,3575878183,22
1,962,23428,3575878161,3575878185,24
1,962,23429,3575878161,3575878185,24
1,962,23430,3575878161,3575878185,24
1,962,23431,3575878161,3575878185,24
1,962,23432,3575878161,3575878186,25
1,962,23433,3575878161,3575878186,25
1,962,23434,3575878161,3575878186,25
1,962,23435,3575878161,3575878187,26
1,962,23436,3575878161,3575878188,27
1,962,23437,3575878161,3575878190,29
1,962,23438,3575878161,3575878191,30
1,962,23439,3575878161,3575878192,31
1,962,23440,3575878161,3575878192,31
1,962,23441,3575878161,3575878192,31
1,962,23442,3575878161,3575878193,32
1,962,23443,3575878161,3575878193,32
1,962,23444,3575878161,3575878196,35
1,962,23445,3575878161,3575878197,36
1,962,23446,3575878161,3575878200,39
1,962,23447,3575878161,3575878200,39
1,962,23448,3575878161,3575878201,40
1,962,23449,3575878161,3575878202,41
1,962,23450,3575878161,3575878202,41
1,962,23451,3575878161,3575878202,41
1,962,23452,3575878161,3575878202,41
1,962,23453,3575878161,3575878205,44
1,962,23454,3575878161,3575878205,44
1,962,23455,3575878161,3575878207,46
1,962,23456,3575878161,3575878208,47
1,962,23457,3575878161,3575878209,48
1,962,23458,3575878161,3575878209,48
1,962,23459,3575878161,3575878210,49
1,962,23460,3575878161,3575878211,50
1,963,23461,3575878226,3575878226,0
1,963,23462,3575878226,3575878226,0
1,963,23463,3575878226,3575878226,0
1,963,23464,3575878226,3575878226,0
1,963,23465,3575878226,3575878226,0
1,963,23466,3575878226,3575878226,0
1,963,23467,3575878226,3575878226,0
1,963,23468,3575878226,3575878226,0
1,963,23469,3575878226,3575878226,0
1,963,23470,3575878226,3575878226,0
1,963,23471,3575878226,3575878226,0
1,963,23472,3575878226,3575878226,0
1,963,23473,3575878226,3575878226,0
1,963,23474,3575878226,3575878226,0
1,963,23475,3575878226,3575878226,0
1,963,23476,3575878226,3575878226,0
1,963,23477,3575878226,3575878226,0
1,963,23478,3575878226,3575878226,0
1,963,23479,3575878226,3575878229,3
1,963,23480,3575878226,3575878229,3
1,963,23481,3575878226,3575878229,3
1,963,23482,3575878226,3575878231,5
1,963,23483,3575878226,3575878232,6
1,963,23484,3575878226,3575878232,6
1,963,23485,3575878226,3575878233,7
1,963,23486,3575878226,3575878233,7
1,963,23487,3575878226,3575878233,7
1,963,23488,3575878226,3575878233,7
1,963,23489,3575878226,3575878233,7
1,963,23490,3575878226,3575878235,9
1,963,23491,3575878226,3575878237,11
1,963,23492,3575878226,3575878239,13
1,963,23493,3575878226,3575878240,14
1,963,23494,3575878226,3575878241,15
1,963,23495,3575878226,3575878241,15
1,963,23496,3575878226,3575878242,16
1,963,23497,3575878226,3575878243,17
1,963,23498,3575878226,3575878243,17
1,963,23499,3575878226,3575878243,17
1,963,23500,3575878226,3575878244,18
1,963,23501,3575878226,3575878244,18
1,963,23502,3575878226,3575878245,19
1,963,23503,3575878226,3575878245,19
1,963,23504,3575878226,3575878246,20
1,963,23505,3575878226,3575878247,21
1,963,23506,3575878226,3575878248,22
1,963,23507,3575878226,3575878250,24
1,963,23508,3575878226,3575878250,24
1,963,23509,3575878226,3575878250,24
1,963,23510,3575878226,3575878251,25
1,963,23511,3575878226,3575878252,26
1,963,23512,3575878226,3575878253,27
1,963,23513,3575878226,3575878254,28
1,963,23514,3575878226,3575878254,28
1,963,23515,3575878226,3575878256,30
1,963,23516,3575878226,3575878256,30
1,963,23517,3575878226,3575878256,30
1,963,23518,3575878226,3575878257,31
1,963,23519,3575878226,3575878259,33
1,963,23520,3575878226,3575878261,35
1,963,23521,3575878226,3575878261,35
1,963,23522,3575878226,3575878262,36
1,963,23523,3575878226,3575878263,37
1,963,23524,3575878226,3575878263,37
1,963,23525,3575878226,3575878264,38
1,963,23526,3575878226,3575878267,41
1,963,23527,3575878226,3575878267,41
1,963,23528,3575878226,3575878267,41
1,963,23529,3575878226,3575878268,42
1,963,23530,3575878226,3575878268,42
1,963,23531,3575878226,3575878270,44
1,963,23532,3575878226,3575878271,45
1,964,23533,3575878287,3575878287,0
1,964,23534,3575878287,3575878287,0
1,964,23535,3575878287,3575878287,0
1,964,23536,3575878287,3575878287,0
1,964,23537,3575878287,3575878287,0
1,964,23538,3575878287,3575878287,0
1,964,23539,3575878287,3575878287,0
1,964,23540,3575878287,3575878287,0
1,964,23541,3575878287,3575878287,0
1,964,23542,3575878287,3575878287,0
1,964,23543,3575878287,3575878287,0
1,964,23544,3575878287,3575878287,0
1,964,23545,3575878287,3575878287,0
1,964,23546,3575878287,3575878291,4
1,964,23547,3575878287,3575878292,5
1,964,23548,3575878287,3575878294,7
1,964,23549,3575878287,3575878297,10
1,964,23550,3575878287,3575878297,10
1,964,23551,3575878287,3575878299,12
1,964,23552,3575878287,3575878300,13
1,964,23553,3575878287,3575878300,13
1,964,23554,3575878287,3575878303,16
1,964,23555,3575878287,3575878303,16
1,964,23556,3575878287,3575878304,17
1,964,23557,3575878287,3575878305,18
1,964,23558,3575878287,3575878306,19
1,964,23559,3575878287,3575878306,19
1,964,23560,3575878287,3575878307,20
1,964,23561,3575878287,3575878307,20
1,964,23562,3575878287,3575878308,21
1,964,23563,3575878287,3575878310,23
1,964,23564,3575878287,3575878310,23
1,964,23565,3575878287,3575878311,24
1,964,23566,3575878287,3575878311,24
1,964,23567,3575878287,3575878311,24
1,964,23568,3575878287,3575878314,27
1,964,23569,3575878287,3575878315,28
1,964,23570,3575878287,3575878315,28
1,964,23571,3575878287,3575878318,31
1,964,23572,3575878287,3575878318,31
1,964,23573,3575878287,3575878319,32
1,964,23574,3575878287,3575878319,32
1,964,23575,3575878287,3575878322,35
1,964,23576,3575878287,3575878324,37
1,964,23577,3575878287,3575878324,37
1,964,23578,3575878287,3575878324,37
1,964,23579,3575878287,3575878325,38
1,964,23580,3575878287,3575878326,39
1,964,23581,3575878287,3575878326,39
1,964,23582,3575878287,3575878327,40
1,964,23583,3575878287,3575878328,41
1,964,23584,3575878287,3575878328,41
1,964,23585,3575878287,3575878331,44
1,964,23586,3575878287,3575878331,44
1,964,23587,3575878287,3575878333,46
1,964,23588,3575878287,3575878335,48
1,964,23589,3575878287,3575878336,49
1,964,23590,3575878287,3575878336,49
1,965,23591,3575878349,3575878350,1
1,965,23592,3575878349,3575878350,1
1,965,23593,3575878349,3575878350,1
1,965,23594,3575878349,3575878350,1
1,965,23595,3575878349,3575878350,1
1,965,23596,3575878349,3575878350,1
1,965,23597,3575878349,3575878350,1
1,965,23598,3575878349,3575878350,1
1,965,23599,3575878349,3575878350,1
1,965,23600,3575878349,3575878350,1
1,965,23601,3575878349,3575878350,1
1,965,23602,3575878349,3575878350,1
1,965,23603,3575878349,3575878350,1
1,965,23604,3575878349,3575878350,1
1,965,23605,3575878349,3575878350,1
1,965,23606,3575878349,3575878353,4
1,965,23607,3575878349,3575878353,4
1,965,23608,3575878349,3575878353,4
1,965,23609,3575878349,3575878354,5
1,965,23610,3575878349,3575878354,5
1,965,23611,3575878349,3575878354,5
1,965,23612,3575878349,3575878355,6
1,965,23613,3575878349,3575878356,7
1,965,23614,3575878349,3575878357,8
1,965,23615,3575878349,3575878357,8
1,965,23616,3575878349,3575878358,9
1,965,23617,3575878349,3575878360,11
1,965,23618,3575878349,3575878362,13
1,965,23619,3575878349,3575878363,14
1,965,23620,3575878349,3575878364,15
1,965,23621,3575878349,3575878364,15
1,965,23622,3575878349,3575878364,15
1,965,23623,3575878349,3575878365,16
1,965,23624,3575878349,3575878366,17
1,965,23625,3575878349,3575878368,19
1,965,23626,3575878349,3575878371,22
1,965,23627,3575878349,3575878376,27
1,965,23628,3575878349,3575878376,27
1,965,23629,3575878349,3575878376,27
1,965,23630,3575878349,3575878376,27
1,965,23631,3575878349,3575878377,28
1,965,23632,3575878349,3575878377,28
1,965,23633,3575878349,3575878378,29
1,965,23634,3575878349,3575878378,29
1,965,23635,3575878349,3575878379,30
1,965,23636,3575878349,3575878379,30
1,965,23637,3575878349,3575878380,31
1,965,23638,3575878349,3575878381,32
1,965,23639,3575878349,3575878382,33
1,965,23640,3575878349,3575878383,34
1,965,23641,3575878349,3575878384,35
1,965,23642,3575878349,3575878385,36
1,965,23643,3575878349,3575878385,36
1,965,23644,3575878349,3575878385,36
1,965,23645,3575878349,3575878385,36
1,965,23646,3575878349,3575878386,37
1,965,23647,3575878349,3575878386,37
1,965,23648,3575878349,3575878387,38
1,965,23649,3575878349,3575878387,38
1,965,23650,3575878349,3575878388,39
1,965,23651,3575878349,3575878390,41
1,965,23652,3575878349,3575878390,41
1,965,23653,3575878349,3575878391,42
1,965,23654,3575878349,3575878391,42
1,965,23655,3575878349,3575878391,42
1,965,23656,3575878349,3575878392,43
1,965,23657,3575878349,3575878393,44
1,965,23658,3575878349,3575878393,44
1,965,23659,3575878349,3575878396,47
1,965,23660,3575878349,3575878398,49
1,966,23661,3575878408,3575878408,0
1,966,23662,3575878408,3575878408,0
1,966,23663,3575878408,3575878408,0
1,966,23664,3575878408,3575878408,0
1,966,23665,3575878408,3575878408,0
1,966,23666,3575878408,3575878408,0
1,966,23667,3575878408,3575878408,0
1,966,23668,3575878408,3575878408,0
1,966,23669,3575878408,3575878408,0
1,966,23670,3575878408,3575878408,0
1,966,23671,3575878408,3575878408,0
1,966,23672,3575878408,3575878409,1
1,966,23673,3575878408,3575878409,1
1,966,23674,3575878408,3575878409,1
1,966,23675,3575878408,3575878410,2
1,966,23676,3575878408,3575878412,4
1,966,23677,3575878408,3575878412,4
1,966,23678,3575878408,3575878415,7
1,966,23679,3575878408,3575878417,9
1,966,23680,3575878408,3575878417,9
1,966,23681,3575878408,3575878417,9
1,966,23682,3575878408,3575878417,9
1,966,23683,3575878408,3575878418,10
1,966,23684,3575878408,3575878418,10
1,966,23685,3575878408,3575878418,10
1,966,23686,3575878408,3575878419,11
1,966,23687,3575878408,3575878421,13
1,966,23688,3575878408,3575878421,13
1,966,23689,3575878408,3575878422,14
1,966,23690,3575878408,3575878423,15
1,966,23691,3575878408,3575878423,15
1,966,23692,3575878408,3575878424,16
1,966,23693,3575878408,3575878424,16
1,966,23694,3575878408,3575878425,17
1,966,23695,3575878408,3575878425,17
1,966,23696,3575878408,3575878426,18
1,966,23697,3575878408,3575878429,21
1,966,23698,3575878408,3575878429,21
1,966,23699,3575878408,3575878430,22
1,966,23700,3575878408,3575878431,23
1,966,23701,3575878408,3575878432,24
1,966,23702,3575878408,3575878433,25
1,966,23703,3575878408,3575878433,25
1,966,23704,3575878408,3575878433,25
1,966,23705,3575878408,3575878433,25
1,966,23706,3575878408,3575878433,25
1,966,23707,3575878408,3575878433,25
1,966,23708,3575878408,3575878435,27
1,966,23709,3575878408,3575878436,28
1,966,23710,3575878408,3575878439,31
1,966,23711,3575878408,3575878440,32
1,966,23712,3575878408,3575878441,33
1,966,23713,3575878408,3575878441,33
1,966,23714,3575878408,3575878442,34
1,966,23715,3575878408,3575878443,35
1,966,23716,3575878408,3575878444,36
1,966,23717,3575878408,3575878444,36
1,966,23718,3575878408,3575878444,36
1,966,23719,3575878408,3575878444,36
1,966,23720,3575878408,3575878444,36
1,966,23721,3575878408,3575878445,37
1,966,23722,3575878408,3575878446,38
1,966,23723,3575878408,3575878446,38
1,966,23724,3575878408,3575878448,40
1,966,23725,3575878408,3575878448,40
1,966,23726,3575878408,3575878450,42
1,966,23727,3575878408,3575878451,43
1,966,23728,3575878408,3575878451,43
1,966,23729,3575878408,3575878451,43
1,966,23730,3575878408,3575878452,44
1,966,23731,3575878408,3575878454,46
1,966,23732,3575878408,3575878454,46
1,966,23733,3575878408,3575878454,46
1,966,23734,3575878408,3575878456,48
1,966,23735,3575878408,3575878457,49
1,966,23736,3575878408,3575878457,49
1,967,23737,3575878469,3575878469,0
1,967,23738,3575878469,3575878469,0
1,967,23739,3575878469,3575878469,0
1,967,23740,3575878469,3575878469,0
1,967,23741,3575878469,3575878469,0
1,967,23742,3575878469,3575878469,0
1,967,23743,3575878469,3575878469,0
1,967,23744,3575878469,3575878469,0
1,967,23745,3575878469,3575878469,0
1,967,23746,3575878469,3575878469,0
1,967,23747,3575878469,3575878469,0
1,967,23748,3575878469,3575878470,1
1,967,23749,3575878469,3575878471,2
1,967,23750,3575878469,3575878477,8
1,967,23751,3575878469,3575878480,11
1,967,23752,3575878469,3575878480,11
1,967,23753,3575878469,3575878481,12
1,967,23754,3575878469,3575878481,12
1,967,23755,3575878469,3575878482,13
1,967,23756,3575878469,3575878483,14
1,967,23757,3575878469,3575878484,15
1,967,23758,3575878469,3575878485,16
1,967,23759,3575878469,3575878485,16
1,967,23760,3575878469,3575878487,18
1,967,23761,3575878469,3575878487,18
1,967,23762,3575878469,3575878487,18
1,967,23763,3575878469,3575878488,19
1,967,23764,3575878469,3575878491,22
1,967,23765,3575878469,3575878492,23
1,967,23766,3575878469,3575878495,26
1,967,23767,3575878469,3575878497,28
1,967,23768,3575878469,3575878498,29
1,967,23769,3575878469,3575878499,30
1,967,23770,3575878469,3575878499,30
1,967,23771,3575878469,3575878503,34
1,967,23772,3575878469,3575878503,34
1,967,23773,3575878469,3575878504,35
1,967,23774,3575878469,3575878505,36
1,967,23775,3575878469,3575878505,36
1,967,23776,3575878469,3575878506,37
1,967,23777,3575878469,3575878506,37
1,967,23778,3575878469,3575878507,38
1,967,23779,3575878469,3575878508,39
1,967,23780,3575878469,3575878510,41
1,967,23781,3575878469,3575878510,41
1,967,23782,3575878469,3575878511,42
1,967,23783,3575878469,3575878511,42
1,967,23784,3575878469,3575878512,43
1,967,23785,3575878469,3575878514,45
1,967,23786,3575878469,3575878514,45
1,967,23787,3575878469,3575878515,46
1,967,23788,3575878469,3575878518,49
1,967,23789,3575878469,3575878518,49
1,967,23790,3575878469,3575878519,50
1,968,23791,3575878533,3575878533,0
1,968,23792,3575878533,3575878533,0
1,968,23793,3575878533,3575878533,0
1,968,23794,3575878533,3575878533,0
1,968,23795,3575878533,3575878533,0
1,968,23796,3575878533,3575878533,0
1,968,23797,3575878533,3575878533,0
1,968,23798,3575878533,3575878533,0
1,968,23799,3575878533,3575878533,0
1,968,23800,3575878533,3575878533,0
1,968,23801,3575878533,3575878533,0
1,968,23802,3575878533,3575878533,0
1,968,23803,3575878533,3575878533,0
1,968,23804,3575878533,3575878533,0
1,968,23805,3575878533,3575878533,0
1,968,23806,3575878533,3575878533,0
1,968,23807,3575878533,3575878534,1
1,968,23808,3575878533,3575878534,1
1,968,23809,3575878533,3575878535,2
1,968,23810,3575878533,3575878537,4
1,968,23811,3575878533,3575878538,5
1,968,23812,3575878533,3575878539,6
1,968,23813,3575878533,3575878539,6
1,968,23814,3575878533,3575878539,6
1,968,23815,3575878533,3575878540,7
1,968,23816,3575878533,3575878540,7
1,968,23817,3575878533,3575878540,7
1,968,23818,3575878533,3575878542,9
1,968,23819,3575878533,3575878543,10
1,968,23820,3575878533,3575878545,12
1,968,23821,3575878533,3575878546,13
1,968,23822,3575878533,3575878547,14
1,968,23823,3575878533,3575878549,16
1,968,23824,3575878533,3575878549,16
1,968,23825,3575878533,3575878551,18
1,968,23826,3575878533,3575878552,19
1,968,23827,3575878533,3575878553,20
1,968,23828,3575878533,3575878553,20
1,968,23829,3575878533,3575878553,20
1,968,23830,3575878533,3575878554,21
1,968,23831,3575878533,3575878554,21
1,968,23832,3575878533,3575878556,23
1,968,23833,3575878533,3575878556,23
1,968,23834,3575878533,3575878558,25
1,968,23835,3575878533,3575878558,25
1,968,23836,3575878533,3575878560,27
1,968,23837,3575878533,3575878562,29
1,968,23838,3575878533,3575878562,29
1,968,23839,3575878533,3575878562,29
1,968,23840,3575878533,3575878563,30
1,968,23841,3575878533,3575878565,32
1,968,23842,3575878533,3575878565,32
1,968,23843,3575878533,3575878565,32
1,968,23844,3575878533,3575878567,34
1,968,23845,3575878533,3575878570,37
1,968,23846,3575878533,3575878575,42
1,968,23847,3575878533,3575878575,42
1,968,23848,3575878533,3575878575,42
1,968,23849,3575878533,3575878576,43
1,968,23850,3575878533,3575878576,43
1,968,23851,3575878533,3575878576,43
1,968,23852,3575878533,3575878576,43
1,968,23853,3575878533,3575878577,44
1,968,23854,3575878533,3575878577,44
1,968,23855,3575878533,3575878578,45
1,968,23856,3575878533,3575878579,46
1,968,23857,3575878533,3575878580,47
1,968,23858,3575878533,3575878581,48
1,969,23859,3575878594,3575878594,0
1,969,23860,3575878594,3575878594,0
1,969,23861,3575878594,3575878594,0
1,969,23862,3575878594,3575878594,0
1,969,23863,3575878594,3575878594,0
1,969,23864,3575878594,3575878594,0
1,969,23865,3575878594,3575878594,0
1,969,23866,3575878594,3575878594,0
1,969,23867,3575878594,3575878594,0
1,969,23868,3575878594,3575878594,0
1,969,23869,3575878594,3575878594,0
1,969,23870,3575878594,3575878594,0
1,969,23871,3575878594,3575878594,0
1,969,23872,3575878594,3575878594,0
1,969,23873,3575878594,3575878594,0
1,969,23874,3575878594,3575878594,0
1,969,23875,3575878594,3575878594,0
1,969,23876,3575878594,3575878594,0
1,969,23877,3575878594,3575878595,1
1,969,23878,3575878594,3575878597,3
1,969,23879,3575878594,3575878599,5
1,969,23880,3575878594,3575878600,6
1,969,23881,3575878594,3575878601,7
1,969,23882,3575878594,3575878601,7
1,969,23883,3575878594,3575878602,8
1,969,23884,3575878594,3575878602,8
1,969,23885,3575878594,3575878602,8
1,969,23886,3575878594,3575878603,9
1,969,23887,3575878594,3575878604,10
1,969,23888,3575878594,3575878604,10
1,969,23889,3575878594,3575878605,11
1,969,23890,3575878594,3575878606,12
1,969,23891,3575878594,3575878607,13
1,969,23892,3575878594,3575878608,14
1,969,23893,3575878594,3575878608,14
1,969,23894,3575878594,3575878609,15
1,969,23895,3575878594,3575878610,16
1,969,23896,3575878594,3575878612,18
1,969,23897,3575878594,3575878615,21
1,969,23898,3575878594,3575878616,22
1,969,23899,3575878594,3575878616,22
1,969,23900,3575878594,3575878616,22
1,969,23901,3575878594,3575878616,22
1,969,23902,3575878594,3575878616,22
1,969,23903,3575878594,3575878617,23
1,969,23904,3575878594,3575878617,23
1,969,23905,3575878594,3575878617,23
1,969,23906,3575878594,3575878618,24
1,969,23907,3575878594,3575878618,24
1,969,23908,3575878594,3575878619,25
1,969,23909,3575878594,3575878620,26
1,969,23910,3575878594,3575878620,26
1,969,23911,3575878594,3575878622,28
1,969,23912,3575878594,3575878622,28
1,969,23913,3575878594,3575878622,28
1,969,23914,3575878594,3575878623,29
1,969,23915,3575878594,3575878623,29
1,969,23916,3575878594,3575878624,30
1,969,23917,3575878594,3575878624,30
1,969,23918,3575878594,3575878626,32
1,969,23919,3575878594,3575878629,35
1,969,23920,3575878594,3575878629,35
1,969,23921,3575878594,3575878630,36
1,969,23922,3575878594,3575878631,37
1,969,23923,3575878594,3575878631,37
1,969,23924,3575878594,3575878631,37
1,969,23925,3575878594,3575878631,37
1,969,23926,3575878594,3575878632,38
1,969,23927,3575878594,3575878632,38
1,969,23928,3575878594,3575878633,39
1,969,23929,3575878594,3575878636,42
1,969,23930,3575878594,3575878638,44
1,969,23931,3575878594,3575878638,44
1,969,23932,3575878594,3575878640,46
1,969,23933,3575878594,3575878641,47
1,969,23934,3575878594,3575878641,47
1,969,23935,3575878594,3575878642,48
1,969,23936,3575878594,3575878643,49
1,969,23937,3575878594,3575878643,49
1,969,23938,3575878594,3575878643,49
1,969,23939,3575878594,3575878644,50
1,970,23940,3575878656,3575878656,0
1,970,23941,3575878656,3575878656,0
1,970,23942,3575878656,3575878656,0
1,970,23943,3575878656,3575878656,0
1,970,23944,3575878656,3575878656,0
1,970,23945,3575878656,3575878656,0
1,970,23946,3575878656,3575878656,0
1,970,23947,3575878656,3575878656,0
1,970,23948,3575878656,3575878656,0
1,970,23949,3575878656,3575878656,0
1,970,23950,3575878656,3575878656,0
1,970,23951,3575878656,3575878656,0
1,970,23952,3575878656,3575878656,0
1,970,23953,3575878656,3575878656,0
1,970,23954,3575878656,3575878656,0
1,970,23955,3575878656,3575878656,0
1,970,23956,3575878656,3575878656,0
1,970,23957,3575878656,3575878657,1
1,970,23958,3575878656,3575878658,2
1,970,23959,3575878656,3575878660,4
1,970,23960,3575878656,3575878661,5
1,970,23961,3575878656,3575878661,5
1,970,23962,3575878656,3575878662,6
1,970,23963,3575878656,3575878663,7
1,970,23964,3575878656,3575878664,8
1,970,23965,3575878656,3575878665,9
1,970,23966,3575878656,3575878666,10
1,970,23967,3575878656,3575878667,11
1,970,23968,3575878656,3575878667,11
1,970,23969,3575878656,3575878667,11
1,970,23970,3575878656,3575878669,13
1,970,23971,3575878656,3575878670,14
1,970,23972,3575878656,3575878677,21
1,970,23973,3575878656,3575878680,24
1,970,23974,3575878656,3575878680,24
1,970,23975,3575878656,3575878680,24
1,970,23976,3575878656,3575878680,24
1,970,23977,3575878656,3575878682,26
1,970,23978,3575878656,3575878684,28
1,970,23979,3575878656,3575878684,28
1,970,23980,3575878656,3575878686,30
1,970,23981,3575878656,3575878686,30
1,970,23982,3575878656,3575878686,30
1,970,23983,3575878656,3575878687,31
1,970,23984,3575878656,3575878687,31
1,970,23985,3575878656,3575878688,32
1,970,23986,3575878656,3575878691,35
1,970,23987,3575878656,3575878692,36
1,970,23988,3575878656,3575878695,39
1,970,23989,3575878656,3575878697,41
1,970,23990,3575878656,3575878697,41
1,970,23991,3575878656,3575878699,43
1,970,23992,3575878656,3575878699,43
1,970,23993,3575878656,3575878700,44
1,970,23994,3575878656,3575878700,44
1,970,23995,3575878656,3575878703,47
1,970,23996,3575878656,3575878703,47
1,970,23997,3575878656,3575878704,48
1,970,23998,3575878656,3575878705,49
1,970,23999,3575878656,3575878705,49
1,970,24000,3575878656,3575878705,49
1,970,24001,3575878656,3575878706,50
1,971,24002,3575878718,3575878718,0
1,971,24003,3575878718,3575878718,0
1,971,24004,3575878718,3575878718,0
1,971,24005,3575878718,3575878718,0
1,971,24006,3575878718,3575878718,0
1,971,24007,3575878718,3575878718,0
1,971,24008,3575878718,3575878718,0
1,971,24009,3575878718,3575878718,0
1,971,24010,3575878718,3575878718,0
1,971,24011,3575878718,3575878718,0
1,971,24012,3575878718,3575878718,0
1,971,24013,3575878718,3575878718,0
1,971,24014,3575878718,3575878718,0
1,971,24015,3575878718,3575878719,1
1,971,24016,3575878718,3575878719,1
1,971,24017,3575878718,3575878720,2
1,971,24018,3575878718,3575878722,4
1,971,24019,3575878718,3575878724,6
1,971,24020,3575878718,3575878724,6
1,971,24021,3575878718,3575878725,7
1,971,24022,3575878718,3575878725,7
1,971,24023,3575878718,3575878726,8
1,971,24024,3575878718,3575878726,8
1,971,24025,3575878718,3575878727,9
1,971,24026,3575878718,3575878727,9
1,971,24027,3575878718,3575878728,10
1,971,24028,3575878718,3575878729,11
1,971,24029,3575878718,3575878730,12
1,971,24030,3575878718,3575878732,14
1,971,24031,3575878718,3575878732,14
1,971,24032,3575878718,3575878734,16
1,971,24033,3575878718,3575878734,16
1,971,24034,3575878718,3575878735,17
1,971,24035,3575878718,3575878736,18
1,971,24036,3575878718,3575878739,21
1,971,24037,3575878718,3575878739,21
1,971,24038,3575878718,3575878740,22
1,971,24039,3575878718,3575878741,23
1,971,24040,3575878718,3575878743,25
1,971,24041,3575878718,3575878744,26
1,971,24042,3575878718,3575878745,27
1,971,24043,3575878718,3575878746,28
1,971,24044,3575878718,3575878747,29
1,971,24045,3575878718,3575878749,31
1,971,24046,3575878718,3575878749,31
1,971,24047,3575878718,3575878751,33
1,971,24048,3575878718,3575878752,34
1,971,24049,3575878718,3575878753,35
1,971,24050,3575878718,3575878753,35
1,971,24051,3575878718,3575878753,35
1,971,24052,3575878718,3575878754,36
1,971,24053,3575878718,3575878756,38
1,971,24054,3575878718,3575878756,38
1,971,24055,3575878718,3575878757,39
1,971,24056,3575878718,3575878757,39
1,971,24057,3575878718,3575878758,40
1,971,24058,3575878718,3575878759,41
1,971,24059,3575878718,3575878761,43
1,971,24060,3575878718,3575878762,44
1,971,24061,3575878718,3575878762,44
1,971,24062,3575878718,3575878763,45
1,971,24063,3575878718,3575878764,46
1,971,24064,3575878718,3575878765,47
1,971,24065,3575878718,3575878765,47
1,971,24066,3575878718,3575878767,49
1,972,24067,3575878778,3575878778,0
1,972,24068,3575878778,3575878778,0
1,972,24069,3575878778,3575878778,0
1,972,24070,3575878778,3575878778,0
1,972,24071,3575878778,3575878778,0
1,972,24072,3575878778,3575878778,0
1,972,24073,3575878778,3575878778,0
1,972,24074,3575878778,3575878778,0
1,972,24075,3575878778,3575878778,0
1,972,24076,3575878778,3575878778,0
1,972,24077,3575878778,3575878778,0
1,972,24078,3575878778,3575878779,1
1,972,24079,3575878778,3575878781,3
1,972,24080,3575878778,3575878781,3
1,972,24081,3575878778,3575878781,3
1,972,24082,3575878778,3575878784,6
1,972,24083,3575878778,3575878784,6
1,972,24084,3575878778,3575878784,6
1,972,24085,3575878778,3575878784,6
1,972,24086,3575878778,3575878785,7
1,972,24087,3575878778,3575878785,7
1,972,24088,3575878778,3575878785,7
1,972,24089,3575878778,3575878785,7
1,972,24090,3575878778,3575878786,8
1,972,24091,3575878778,3575878787,9
1,972,24092,3575878778,3575878788,10
1,972,24093,3575878778,3575878789,11
1,972,24094,3575878778,3575878790,12
1,972,24095,3575878778,3575878790,12
1,972,24096,3575878778,3575878791,13
1,972,24097,3575878778,3575878792,14
1,972,24098,3575878778,3575878792,14
1,972,24099,3575878778,3575878792,14
1,972,24100,3575878778,3575878793,15
1,972,24101,3575878778,3575878795,17
1,972,24102,3575878778,3575878797,19
1,972,24103,3575878778,3575878799,21
1,972,24104,3575878778,3575878800,22
1,972,24105,3575878778,3575878801,23
1,972,24106,3575878778,3575878801,23
1,972,24107,3575878778,3575878802,24
1,972,24108,3575878778,3575878802,24
1,972,24109,3575878778,3575878802,24
1,972,24110,3575878778,3575878803,25
1,972,24111,3575878778,3575878803,25
1,972,24112,3575878778,3575878804,26
1,972,24113,3575878778,3575878804,26
1,972,24114,3575878778,3575878804,26
1,972,24115,3575878778,3575878805,27
1,972,24116,3575878778,3575878807,29
1,972,24117,3575878778,3575878808,30
1,972,24118,3575878778,3575878808,30
1,972,24119,3575878778,3575878808,30
1,972,24120,3575878778,3575878809,31
1,972,24121,3575878778,3575878810,32
1,972,24122,3575878778,3575878810,32
1,972,24123,3575878778,3575878812,34
1,972,24124,3575878778,3575878814,36
1,972,24125,3575878778,3575878815,37
1,972,24126,3575878778,3575878816,38
1,972,24127,3575878778,3575878816,38
1,972,24128,3575878778,3575878816,38
1,972,24129,3575878778,3575878817,39
1,972,24130,3575878778,3575878817,39
1,972,24131,3575878778,3575878817,39
1,972,24132,3575878778,3575878818,40
1,972,24133,3575878778,3575878819,41
1,972,24134,3575878778,3575878819,41
1,972,24135,3575878778,3575878820,42
1,972,24136,3575878778,3575878821,43
1,972,24137,3575878778,3575878821,43
1,972,24138,3575878778,3575878822,44
1,972,24139,3575878778,3575878822,44
1,972,24140,3575878778,3575878822,44
1,972,24141,3575878778,3575878823,45
1,972,24142,3575878778,3575878823,45
1,972,24143,3575878778,3575878824,46
1,972,24144,3575878778,3575878824,46
1,972,24145,3575878778,3575878825,47
1,972,24146,3575878778,3575878827,49
1,973,24147,3575878843,3575878843,0
1,973,24148,3575878843,3575878843,0
1,973,24149,3575878843,3575878843,0
1,973,24150,3575878843,3575878843,0
1,973,24151,3575878843,3575878843,0
1,973,24152,3575878843,3575878843,0
1,973,24153,3575878843,3575878843,0
1,973,24154,3575878843,3575878843,0
1,973,24155,3575878843,3575878843,0
1,973,24156,3575878843,3575878843,0
1,973,24157,3575878843,3575878843,0
1,973,24158,3575878843,3575878843,0
1,973,24159,3575878843,3575878843,0
1,973,24160,3575878843,3575878843,0
1,973,24161,3575878843,3575878843,0
1,973,24162,3575878843,3575878843,0
1,973,24163,3575878843,3575878843,0
1,973,24164,3575878843,3575878843,0
1,973,24165,3575878843,3575878843,0
1,973,24166,3575878843,3575878843,0
1,973,24167,3575878843,3575878844,1
1,973,24168,3575878843,3575878844,1
1,973,24169,3575878843,3575878844,1
1,973,24170,3575878843,3575878845,2
1,973,24171,3575878843,3575878847,4
1,973,24172,3575878843,3575878847,4
1,973,24173,3575878843,3575878849,6
1,973,24174,3575878843,3575878850,7
1,973,24175,3575878843,3575878850,7
1,973,24176,3575878843,3575878850,7
1,973,24177,3575878843,3575878851,8
1,973,24178,3575878843,3575878851,8
1,973,24179,3575878843,3575878853,10
1,973,24180,3575878843,3575878853,10
1,973,24181,3575878843,3575878854,11
1,973,24182,3575878843,3575878854,11
1,973,24183,3575878843,3575878854,11
1,973,24184,3575878843,3575878855,12
1,973,24185,3575878843,3575878855,12
1,973,24186,3575878843,3575878856,13
1,973,24187,3575878843,3575878857,14
1,973,24188,3575878843,3575878858,15
1,973,24189,3575878843,3575878860,17
1,973,24190,3575878843,3575878861,18
1,973,24191,3575878843,3575878862,19
1,973,24192,3575878843,3575878862,19
1,973,24193,3575878843,3575878862,19
1,973,24194,3575878843,3575878863,20
1,973,24195,3575878843,3575878864,21
1,973,24196,3575878843,3575878865,22
1,973,24197,3575878843,3575878866,23
1,973,24198,3575878843,3575878867,24
1,973,24199,3575878843,3575878867,24
1,973,24200,3575878843,3575878869,26
1,973,24201,3575878843,3575878870,27
1,973,24202,3575878843,3575878877,34
1,973,24203,3575878843,3575878880,37
1,973,24204,3575878843,3575878880,37
1,973,24205,3575878843,3575878880,37
1,973,24206,3575878843,3575878881,38
1,973,24207,3575878843,3575878882,39
1,973,24208,3575878843,3575878883,40
1,973,24209,3575878843,3575878884,41
1,973,24210,3575878843,3575878885,42
1,973,24211,3575878843,3575878885,42
1,973,24212,3575878843,3575878886,43
1,973,24213,3575878843,3575878886,43
1,973,24214,3575878843,3575878887,44
1,973,24215,3575878843,3575878887,44
1,973,24216,3575878843,3575878889,46
1,973,24217,3575878843,3575878891,48
1,973,24218,3575878843,3575878892,49
1,974,24219,3575878904,3575878904,0
1,974,24220,3575878904,3575878904,0
1,974,24221,3575878904,3575878904,0
1,974,24222,3575878904,3575878904,0
1,974,24223,3575878904,3575878904,0
1,974,24224,3575878904,3575878904,0
1,974,24225,3575878904,3575878904,0
1,974,24226,3575878904,3575878904,0
1,974,24227,3575878904,3575878904,0
1,974,24228,3575878904,3575878904,0
1,974,24229,3575878904,3575878905,1
1,974,24230,3575878904,3575878906,2
1,974,24231,3575878904,3575878906,2
1,974,24232,3575878904,3575878907,3
1,974,24233,3575878904,3575878907,3
1,974,24234,3575878904,3575878909,5
1,974,24235,3575878904,3575878911,7
1,974,24236,3575878904,3575878911,7
1,974,24237,3575878904,3575878911,7
1,974,24238,3575878904,3575878912,8
1,974,24239,3575878904,3575878912,8
1,974,24240,3575878904,3575878913,9
1,974,24241,3575878904,3575878914,10
1,974,24242,3575878904,3575878914,10
1,974,24243,3575878904,3575878918,14
1,974,24244,3575878904,3575878918,14
1,974,24245,3575878904,3575878919,15
1,974,24246,3575878904,3575878919,15
1,974,24247,3575878904,3575878920,16
1,974,24248,3575878904,3575878922,18
1,974,24249,3575878904,3575878924,20
1,974,24250,3575878904,3575878924,20
1,974,24251,3575878904,3575878925,21
1,974,24252,3575878904,3575878925,21
1,974,24253,3575878904,3575878926,22
1,974,24254,3575878904,3575878926,22
1,974,24255,3575878904,3575878927,23
1,974,24256,3575878904,3575878927,23
1,974,24257,3575878904,3575878928,24
1,974,24258,3575878904,3575878929,25
1,974,24259,3575878904,3575878930,26
1,974,24260,3575878904,3575878932,28
1,974,24261,3575878904,3575878932,28
1,974,24262,3575878904,3575878934,30
1,974,24263,3575878904,3575878935,31
1,974,24264,3575878904,3575878935,31
1,974,24265,3575878904,3575878937,33
1,974,24266,3575878904,3575878939,35
1,974,24267,3575878904,3575878939,35
1,974,24268,3575878904,3575878940,36
1,974,24269,3575878904,3575878943,39
1,974,24270,3575878904,3575878944,40
1,974,24271,3575878904,3575878945,41
1,974,24272,3575878904,3575878946,42
1,974,24273,3575878904,3575878947,43
1,974,24274,3575878904,3575878950,46
1,974,24275,3575878904,3575878950,46
1,974,24276,3575878904,3575878950,46
1,974,24277,3575878904,3575878952,48
1,974,24278,3575878904,3575878953,49
1,974,24279,3575878904,3575878953,49
1,974,24280,3575878904,3575878954,50
1,975,24281,3575878964,3575878964,0
1,975,24282,3575878964,3575878964,0
1,975,24283,3575878964,3575878964,0
1,975,24284,3575878964,3575878964,0
1,975,24285,3575878964,3575878964,0
1,975,24286,3575878964,3575878964,0
1,975,24287,3575878964,3575878964,0
1,975,24288,3575878964,3575878964,0
1,975,24289,3575878964,3575878964,0
1,975,24290,3575878964,3575878964,0
1,975,24291,3575878964,3575878964,0
1,975,24292,3575878964,3575878964,0
1,975,24293,3575878964,3575878964,0
1,975,24294,3575878964,3575878964,0
1,975,24295,3575878964,3575878965,1
1,975,24296,3575878964,3575878965,1
1,975,24297,3575878964,3575878965,1
1,975,24298,3575878964,3575878967,3
1,975,24299,3575878964,3575878970,6
1,975,24300,3575878964,3575878974,10
1,975,24301,3575878964,3575878975,11
1,975,24302,3575878964,3575878975,11
1,975,24303,3575878964,3575878976,12
1,975,24304,3575878964,3575878976,12
1,975,24305,3575878964,3575878976,12
1,975,24306,3575878964,3575878976,12
1,975,24307,3575878964,3575878977,13
1,975,24308,3575878964,3575878978,14
1,975,24309,3575878964,3575878978,14
1,975,24310,3575878964,3575878979,15
1,975,24311,3575878964,3575878980,16
1,975,24312,3575878964,3575878981,17
1,975,24313,3575878964,3575878982,18
1,975,24314,3575878964,3575878984,20
1,975,24315,3575878964,3575878984,20
1,975,24316,3575878964,3575878984,20
1,975,24317,3575878964,3575878985,21
1,975,24318,3575878964,3575878985,21
1,975,24319,3575878964,3575878985,21
1,975,24320,3575878964,3575878985,21
1,975,24321,3575878964,3575878985,21
1,975,24322,3575878964,3575878987,23
1,975,24323,3575878964,3575878988,24
1,975,24324,3575878964,3575878989,25
1,975,24325,3575878964,3575878990,26
1,975,24326,3575878964,3575878991,27
1,975,24327,3575878964,3575878991,27
1,975,24328,3575878964,3575878992,28
1,975,24329,3575878964,3575878993,29
1,975,24330,3575878964,3575878993,29
1,975,24331,3575878964,3575878996,32
1,975,24332,3575878964,3575878996,32
1,975,24333,3575878964,3575878999,35
1,975,24334,3575878964,3575879000,36
1,975,24335,3575878964,3575879001,37
1,975,24336,3575878964,3575879002,38
1,975,24337,3575878964,3575879002,38
1,975,24338,3575878964,3575879002,38
1,975,24339,3575878964,3575879002,38
1,975,24340,3575878964,3575879003,39
1,975,24341,3575878964,3575879003,39
1,975,24342,3575878964,3575879004,40
1,975,24343,3575878964,3575879004,40
1,975,24344,3575878964,3575879005,41
1,975,24345,3575878964,3575879006,42
1,975,24346,3575878964,3575879006,42
1,975,24347,3575878964,3575879008,44
1,975,24348,3575878964,3575879008,44
1,975,24349,3575878964,3575879009,45
1,975,24350,3575878964,3575879009,45
1,975,24351,3575878964,3575879010,46
1,975,24352,3575878964,3575879011,47
1,975,24353,3575878964,3575879011,47
1,975,24354,3575878964,3575879015,51
1,976,24355,3575879026,3575879026,0
1,976,24356,3575879026,3575879026,0
1,976,24357,3575879026,3575879026,0
1,976,24358,3575879026,3575879026,0
1,976,24359,3575879026,3575879026,0
1,976,24360,3575879026,3575879026,0
1,976,24361,3575879026,3575879026,0
1,976,24362,3575879026,3575879026,0
1,976,24363,3575879026,3575879026,0
1,976,24364,3575879026,3575879026,0
1,976,24365,3575879026,3575879026,0
1,976,24366,3575879026,3575879026,0
1,976,24367,3575879026,3575879026,0
1,976,24368,3575879026,3575879026,0
1,976,24369,3575879026,3575879026,0
1,976,24370,3575879026,3575879026,0
1,976,24371,3575879026,3575879026,0
1,976,24372,3575879026,3575879026,0
1,976,24373,3575879026,3575879026,0
1,976,24374,3575879026,3575879026,0
1,976,24375,3575879026,3575879027,1
1,976,24376,3575879026,3575879029,3
1,976,24377,3575879026,3575879030,4
1,976,24378,3575879026,3575879031,5
1,976,24379,3575879026,3575879032,6
1,976,24380,3575879026,3575879032,6
1,976,24381,3575879026,3575879032,6
1,976,24382,3575879026,3575879033,7
1,976,24383,3575879026,3575879033,7
1,976,24384,3575879026,3575879034,8
1,976,24385,3575879026,3575879037,11
1,976,24386,3575879026,3575879039,13
1,976,24387,3575879026,3575879039,13
1,976,24388,3575879026,3575879041,15
1,976,24389,3575879026,3575879041,15
1,976,24390,3575879026,3575879042,16
1,976,24391,3575879026,3575879043,17
1,976,24392,3575879026,3575879043,17
1,976,24393,3575879026,3575879044,18
1,976,24394,3575879026,3575879044,18
1,976,24395,3575879026,3575879044,18
1,976,24396,3575879026,3575879045,19
1,976,24397,3575879026,3575879045,19
1,976,24398,3575879026,3575879047,21
1,976,24399,3575879026,3575879047,21
1,976,24400,3575879026,3575879049,23
1,976,24401,3575879026,3575879050,24
1,976,24402,3575879026,3575879050,24
1,976,24403,3575879026,3575879050,24
1,976,24404,3575879026,3575879050,24
1,976,24405,3575879026,3575879052,26
1,976,24406,3575879026,3575879053,27
1,976,24407,3575879026,3575879053,27
1,976,24408,3575879026,3575879053,27
1,976,24409,3575879026,3575879053,27
1,976,24410,3575879026,3575879055,29
1,976,24411,3575879026,3575879055,29
1,976,24412,3575879026,3575879056,30
1,976,24413,3575879026,3575879057,31
1,976,24414,3575879026,3575879058,32
1,976,24415,3575879026,3575879062,36
1,976,24416,3575879026,3575879062,36
1,976,24417,3575879026,3575879062,36
1,976,24418,3575879026,3575879063,37
1,976,24419,3575879026,3575879065,39
1,976,24420,3575879026,3575879067,41
1,976,24421,3575879026,3575879067,41
1,976,24422,3575879026,3575879068,42
1,976,24423,3575879026,3575879069,43
1,976,24424,3575879026,3575879069,43
1,977,24425,3575879090,3575879090,0
1,977,24426,3575879090,3575879090,0
1,977,24427,3575879090,3575879090,0
1,977,24428,3575879090,3575879090,0
1,977,24429,3575879090,3575879090,0
1,977,24430,3575879090,3575879090,0
1,977,24431,3575879090,3575879090,0
1,977,24432,3575879090,3575879090,0
1,977,24433,3575879090,3575879090,0
1,977,24434,3575879090,3575879090,0
1,977,24435,3575879090,3575879090,0
1,977,24436,3575879090,3575879090,0
1,977,24437,3575879090,3575879090,0
1,977,24438,3575879090,3575879090,0
1,977,24439,3575879090,3575879090,0
1,977,24440,3575879090,3575879092,2
1,977,24441,3575879090,3575879092,2
1,977,24442,3575879090,3575879095,5
1,977,24443,3575879090,3575879097,7
1,977,24444,3575879090,3575879098,8
1,977,24445,3575879090,3575879099,9
1,977,24446,3575879090,3575879100,10
1,977,24447,3575879090,3575879101,11
1,977,24448,3575879090,3575879104,14
1,977,24449,3575879090,3575879104,14
1,977,24450,3575879090,3575879105,15
1,977,24451,3575879090,3575879105,15
1,977,24452,3575879090,3575879106,16
1,977,24453,3575879090,3575879107,17
1,977,24454,3575879090,3575879108,18
1,977,24455,3575879090,3575879110,20
1,977,24456,3575879090,3575879111,21
1,977,24457,3575879090,3575879112,22
1,977,24458,3575879090,3575879112,22
1,977,24459,3575879090,3575879114,24
1,977,24460,3575879090,3575879114,24
1,977,24461,3575879090,3575879115,25
1,977,24462,3575879090,3575879118,28
1,977,24463,3575879090,3575879118,28
1,977,24464,3575879090,3575879119,29
1,977,24465,3575879090,3575879119,29
1,977,24466,3575879090,3575879120,30
1,977,24467,3575879090,3575879122,32
1,977,24468,3575879090,3575879123,33
1,977,24469,3575879090,3575879124,34
1,977,24470,3575879090,3575879124,34
1,977,24471,3575879090,3575879125,35
1,977,24472,3575879090,3575879125,35
1,977,24473,3575879090,3575879126,36
1,977,24474,3575879090,3575879126,36
1,977,24475,3575879090,3575879128,38
1,977,24476,3575879090,3575879128,38
1,977,24477,3575879090,3575879130,40
1,977,24478,3575879090,3575879130,40
1,977,24479,3575879090,3575879132,42
1,977,24480,3575879090,3575879133,43
1,977,24481,3575879090,3575879134,44
1,977,24482,3575879090,3575879135,45
1,977,24483,3575879090,3575879137,47
1,977,24484,3575879090,3575879139,49
1,977,24485,3575879090,3575879140,50
1,978,24486,3575879154,3575879154,0
1,978,24487,3575879154,3575879154,0
1,978,24488,3575879154,3575879154,0
1,978,24489,3575879154,3575879154,0
1,978,24490,3575879154,3575879154,0
1,978,24491,3575879154,3575879154,0
1,978,24492,3575879154,3575879154,0
1,978,24493,3575879154,3575879154,0
1,978,24494,3575879154,3575879154,0
1,978,24495,3575879154,3575879154,0
1,978,24496,3575879154,3575879154,0
1,978,24497,3575879154,3575879154,0
1,978,24498,3575879154,3575879154,0
1,978,24499,3575879154,3575879154,0
1,978,24500,3575879154,3575879154,0
1,978,24501,3575879154,3575879154,0
1,978,24502,3575879154,3575879156,2
1,978,24503,3575879154,3575879156,2
1,978,24504,3575879154,3575879156,2
1,978,24505,3575879154,3575879157,3
1,978,24506,3575879154,3575879159,5
1,978,24507,3575879154,3575879160,6
1,978,24508,3575879154,3575879161,7
1,978,24509,3575879154,3575879162,8
1,978,24510,3575879154,3575879162,8
1,978,24511,3575879154,3575879163,9
1,978,24512,3575879154,3575879164,10
1,978,24513,3575879154,3575879164,10
1,978,24514,3575879154,3575879165,11
1,978,24515,3575879154,3575879165,11
1,978,24516,3575879154,3575879167,13
1,978,24517,3575879154,3575879170,16
1,978,24518,3575879154,3575879174,20
1,978,24519,3575879154,3575879175,21
1,978,24520,3575879154,3575879176,22
1,978,24521,3575879154,3575879176,22
1,978,24522,3575879154,3575879176,22
1,978,24523,3575879154,3575879177,23
1,978,24524,3575879154,3575879177,23
1,978,24525,3575879154,3575879178,24
1,978,24526,3575879154,3575879181,27
1,978,24527,3575879154,3575879182,28
1,978,24528,3575879154,3575879183,29
1,978,24529,3575879154,3575879184,30
1,978,24530,3575879154,3575879184,30
1,978,24531,3575879154,3575879184,30
1,978,24532,3575879154,3575879185,31
1,978,24533,3575879154,3575879185,31
1,978,24534,3575879154,3575879185,31
1,978,24535,3575879154,3575879186,32
1,978,24536,3575879154,3575879186,32
1,978,24537,3575879154,3575879187,33
1,978,24538,3575879154,3575879188,34
1,978,24539,3575879154,3575879189,35
1,978,24540,3575879154,3575879190,36
1,978,24541,3575879154,3575879190,36
1,978,24542,3575879154,3575879190,36
1,978,24543,3575879154,3575879191,37
1,978,24544,3575879154,3575879192,38
1,978,24545,3575879154,3575879193,39
1,978,24546,3575879154,3575879193,39
1,978,24547,3575879154,3575879196,42
1,978,24548,3575879154,3575879197,43
1,978,24549,3575879154,3575879199,45
1,978,24550,3575879154,3575879200,46
1,978,24551,3575879154,3575879201,47
1,978,24552,3575879154,3575879201,47
1,978,24553,3575879154,3575879202,48
1,978,24554,3575879154,3575879203,49
1,978,24555,3575879154,3575879203,49
1,978,24556,3575879154,3575879203,49
1,978,24557,3575879154,3575879203,49
1,978,24558,3575879154,3575879204,50
1,979,24559,3575879217,3575879217,0
1,979,24560,3575879217,3575879217,0
1,979,24561,3575879217,3575879217,0
1,979,24562,3575879217,3575879217,0
1,979,24563,3575879217,3575879217,0
1,979,24564,3575879217,3575879217,0
1,979,24565,3575879217,3575879217,0
1,979,24566,3575879217,3575879217,0
1,979,24567,3575879217,3575879217,0
1,979,24568,3575879217,3575879217,0
1,979,24569,3575879217,3575879217,0
1,979,24570,3575879217,3575879217,0
1,979,24571,3575879217,3575879217,0
1,979,24572,3575879217,3575879218,1
1,979,24573,3575879217,3575879218,1
1,979,24574,3575879217,3575879219,2
1,979,24575,3575879217,3575879219,2
1,979,24576,3575879217,3575879219,2
1,979,24577,3575879217,3575879219,2
1,979,24578,3575879217,3575879219,2
1,979,24579,3575879217,3575879220,3
1,979,24580,3575879217,3575879221,4
1,979,24581,3575879217,3575879222,5
1,979,24582,3575879217,3575879223,6
1,979,24583,3575879217,3575879223,6
1,979,24584,3575879217,3575879223,6
1,979,24585,3575879217,3575879223,6
1,979,24586,3575879217,3575879224,7
1,979,24587,3575879217,3575879224,7
1,979,24588,3575879217,3575879226,9
1,979,24589,3575879217,3575879229,12
1,979,24590,3575879217,3575879230,13
1,979,24591,3575879217,3575879231,14
1,979,24592,3575879217,3575879231,14
1,979,24593,3575879217,3575879232,15
1,979,24594,3575879217,3575879232,15
1,979,24595,3575879217,3575879232,15
1,979,24596,3575879217,3575879233,16
1,979,24597,3575879217,3575879234,17
1,979,24598,3575879217,3575879235,18
1,979,24599,3575879217,3575879236,19
1,979,24600,3575879217,3575879238,21
1,979,24601,3575879217,3575879239,22
1,979,24602,3575879217,3575879240,23
1,979,24603,3575879217,3575879241,24
1,979,24604,3575879217,3575879242,25
1,979,24605,3575879217,3575879242,25
1,979,24606,3575879217,3575879243,26
1,979,24607,3575879217,3575879243,26
1,979,24608,3575879217,3575879244,27
1,979,24609,3575879217,3575879244,27
1,979,24610,3575879217,3575879244,27
1,979,24611,3575879217,3575879245,28
1,979,24612,3575879217,3575879245,28
1,979,24613,3575879217,3575879246,29
1,979,24614,3575879217,3575879248,31
1,979,24615,3575879217,3575879248,31
1,979,24616,3575879217,3575879249,32
1,979,24617,3575879217,3575879250,33
1,979,24618,3575879217,3575879250,33
1,979,24619,3575879217,3575879250,33
1,979,24620,3575879217,3575879251,34
1,979,24621,3575879217,3575879252,35
1,979,24622,3575879217,3575879253,36
1,979,24623,3575879217,3575879253,36
1,979,24624,3575879217,3575879254,37
1,979,24625,3575879217,3575879254,37
1,979,24626,3575879217,3575879254,37
1,979,24627,3575879217,3575879255,38
1,979,24628,3575879217,3575879255,38
1,979,24629,3575879217,3575879256,39
1,979,24630,3575879217,3575879256,39
1,979,24631,3575879217,3575879257,40
1,979,24632,3575879217,3575879258,41
1,979,24633,3575879217,3575879260,43
1,979,24634,3575879217,3575879261,44
1,979,24635,3575879217,3575879262,45
1,979,24636,3575879217,3575879262,45
1,979,24637,3575879217,3575879263,46
1,979,24638,3575879217,3575879264,47
1,979,24639,3575879217,3575879266,49
1,979,24640,3575879217,3575879267,50
1,980,24641,3575879277,3575879277,0
1,980,24642,3575879277,3575879277,0
1,980,24643,3575879277,3575879277,0
1,980,24644,3575879277,3575879277,0
1,980,24645,3575879277,3575879280,3
1,980,24646,3575879277,3575879280,3
1,980,24647,3575879277,3575879281,4
1,980,24648,3575879277,3575879281,4
1,980,24649,3575879277,3575879282,5
1,980,24650,3575879277,3575879283,6
1,980,24651,3575879277,3575879284,7
1,980,24652,3575879277,3575879284,7
1,980,24653,3575879277,3575879284,7
1,980,24654,3575879277,3575879286,9
1,980,24655,3575879277,3575879287,10
1,980,24656,3575879277,3575879287,10
1,980,24657,3575879277,3575879287,10
1,980,24658,3575879277,3575879289,12
1,980,24659,3575879277,3575879290,13
1,980,24660,3575879277,3575879291,14
1,980,24661,3575879277,3575879292,15
1,980,24662,3575879277,3575879295,18
1,980,24663,3575879277,3575879297,20
1,980,24664,3575879277,3575879299,22
1,980,24665,3575879277,3575879299,22
1,980,24666,3575879277,3575879300,23
1,980,24667,3575879277,3575879300,23
1,980,24668,3575879277,3575879304,27
1,980,24669,3575879277,3575879304,27
1,980,24670,3575879277,3575879305,28
1,980,24671,3575879277,3575879305,28
1,980,24672,3575879277,3575879306,29
1,980,24673,3575879277,3575879307,30
1,980,24674,3575879277,3575879308,31
1,980,24675,3575879277,3575879308,31
1,980,24676,3575879277,3575879311,34
1,980,24677,3575879277,3575879312,35
1,980,24678,3575879277,3575879312,35
1,980,24679,3575879277,3575879314,37
1,980,24680,3575879277,3575879315,38
1,980,24681,3575879277,3575879315,38
1,980,24682,3575879277,3575879317,40
1,980,24683,3575879277,3575879319,42
1,980,24684,3575879277,3575879319,42
1,980,24685,3575879277,3575879320,43
1,980,24686,3575879277,3575879322,45
1,980,24687,3575879277,3575879323,46
1,980,24688,3575879277,3575879324,47
1,980,24689,3575879277,3575879325,48
1,980,24690,3575879277,3575879325,48
1,980,24691,3575879277,3575879325,48
1,980,24692,3575879277,3575879326,49
1,980,24693,3575879277,3575879326,49
1,980,24694,3575879277,3575879327,50
1,981,24695,3575879341,3575879341,0
1,981,24696,3575879341,3575879341,0
1,981,24697,3575879341,3575879341,0
1,981,24698,3575879341,3575879341,0
1,981,24699,3575879341,3575879341,0
1,981,24700,3575879341,3575879342,1
1,981,24701,3575879341,3575879342,1
1,981,24702,3575879341,3575879342,1
1,981,24703,3575879341,3575879342,1
1,981,24704,3575879341,3575879342,1
1,981,24705,3575879341,3575879342,1
1,981,24706,3575879341,3575879342,1
1,981,24707,3575879341,3575879342,1
1,981,24708,3575879341,3575879342,1
1,981,24709,3575879341,3575879342,1
1,981,24710,3575879341,3575879344,3
1,981,24711,3575879341,3575879345,4
1,981,24712,3575879341,3575879347,6
1,981,24713,3575879341,3575879350,9
1,981,24714,3575879341,3575879350,9
1,981,24715,3575879341,3575879350,9
1,981,24716,3575879341,3575879352,11
1,981,24717,3575879341,3575879353,12
1,981,24718,3575879341,3575879353,12
1,981,24719,3575879341,3575879354,13
1,981,24720,3575879341,3575879354,13
1,981,24721,3575879341,3575879354,13
1,981,24722,3575879341,3575879357,16
1,981,24723,3575879341,3575879357,16
1,981,24724,3575879341,3575879357,16
1,981,24725,3575879341,3575879357,16
1,981,24726,3575879341,3575879358,17
1,981,24727,3575879341,3575879360,19
1,981,24728,3575879341,3575879361,20
1,981,24729,3575879341,3575879362,21
1,981,24730,3575879341,3575879363,22
1,981,24731,3575879341,3575879363,22
1,981,24732,3575879341,3575879364,23
1,981,24733,3575879341,3575879364,23
1,981,24734,3575879341,3575879366,25
1,981,24735,3575879341,3575879366,25
1,981,24736,3575879341,3575879368,27
1,981,24737,3575879341,3575879370,29
1,981,24738,3575879341,3575879374,33
1,981,24739,3575879341,3575879375,34
1,981,24740,3575879341,3575879375,34
1,981,24741,3575879341,3575879376,35
1,981,24742,3575879341,3575879376,35
1,981,24743,3575879341,3575879376,35
1,981,24744,3575879341,3575879376,35
1,981,24745,3575879341,3575879377,36
1,981,24746,3575879341,3575879377,36
1,981,24747,3575879341,3575879379,38
1,981,24748,3575879341,3575879379,38
1,981,24749,3575879341,3575879379,38
1,981,24750,3575879341,3575879381,40
1,981,24751,3575879341,3575879381,40
1,981,24752,3575879341,3575879381,40
1,981,24753,3575879341,3575879382,41
1,981,24754,3575879341,3575879383,42
1,981,24755,3575879341,3575879384,43
1,981,24756,3575879341,3575879385,44
1,981,24757,3575879341,3575879385,44
1,981,24758,3575879341,3575879385,44
1,981,24759,3575879341,3575879385,44
1,981,24760,3575879341,3575879386,45
1,981,24761,3575879341,3575879386,45
1,981,24762,3575879341,3575879387,46
1,981,24763,3575879341,3575879387,46
1,981,24764,3575879341,3575879388,47
1,981,24765,3575879341,3575879389,48
1,981,24766,3575879341,3575879390,49
1,981,24767,3575879341,3575879390,49
1,981,24768,3575879341,3575879391,50
1,982,24769,3575879402,3575879402,0
1,982,24770,3575879402,3575879402,0
1,982,24771,3575879402,3575879402,0
1,982,24772,3575879402,3575879402,0
1,982,24773,3575879402,3575879402,0
1,982,24774,3575879402,3575879402,0
1,982,24775,3575879402,3575879402,0
1,982,24776,3575879402,3575879402,0
1,982,24777,3575879402,3575879402,0
1,982,24778,3575879402,3575879402,0
1,982,24779,3575879402,3575879402,0
1,982,24780,3575879402,3575879403,1
1,982,24781,3575879402,3575879403,1
1,982,24782,3575879402,3575879404,2
1,982,24783,3575879402,3575879404,2
1,982,24784,3575879402,3575879406,4
1,982,24785,3575879402,3575879408,6
1,982,24786,3575879402,3575879408,6
1,982,24787,3575879402,3575879409,7
1,982,24788,3575879402,3575879409,7
1,982,24789,3575879402,3575879410,8
1,982,24790,3575879402,3575879410,8
1,982,24791,3575879402,3575879411,9
1,982,24792,3575879402,3575879412,10
1,982,24793,3575879402,3575879416,14
1,982,24794,3575879402,3575879417,15
1,982,24795,3575879402,3575879417,15
1,982,24796,3575879402,3575879418,16
1,982,24797,3575879402,3575879418,16
1,982,24798,3575879402,3575879418,16
1,982,24799,3575879402,3575879418,16
1,982,24800,3575879402,3575879419,17
1,982,24801,3575879402,3575879419,17
1,982,24802,3575879402,3575879419,17
1,982,24803,3575879402,3575879420,18
1,982,24804,3575879402,3575879420,18
1,982,24805,3575879402,3575879421,19
1,982,24806,3575879402,3575879422,20
1,982,24807,3575879402,3575879423,21
1,982,24808,3575879402,3575879423,21
1,982,24809,3575879402,3575879424,22
1,982,24810,3575879402,3575879424,22
1,982,24811,3575879402,3575879424,22
1,982,24812,3575879402,3575879426,24
1,982,24813,3575879402,3575879428,26
1,982,24814,3575879402,3575879430,28
1,982,24815,3575879402,3575879431,29
1,982,24816,3575879402,3575879431,29
1,982,24817,3575879402,3575879431,29
1,982,24818,3575879402,3575879432,30
1,982,24819,3575879402,3575879432,30
1,982,24820,3575879402,3575879433,31
1,982,24821,3575879402,3575879433,31
1,982,24822,3575879402,3575879434,32
1,982,24823,3575879402,3575879434,32
1,982,24824,3575879402,3575879435,33
1,982,24825,3575879402,3575879436,34
1,982,24826,3575879402,3575879439,37
1,982,24827,3575879402,3575879439,37
1,982,24828,3575879402,3575879441,39
1,982,24829,3575879402,3575879442,40
1,982,24830,3575879402,3575879442,40
1,982,24831,3575879402,3575879442,40
1,982,24832,3575879402,3575879444,42
1,982,24833,3575879402,3575879444,42
1,982,24834,3575879402,3575879444,42
1,982,24835,3575879402,3575879444,42
1,982,24836,3575879402,3575879444,42
1,982,24837,3575879402,3575879445,43
1,982,24838,3575879402,3575879445,43
1,982,24839,3575879402,3575879447,45
1,982,24840,3575879402,3575879449,47
1,982,24841,3575879402,3575879449,47
1,982,24842,3575879402,3575879450,48
1,982,24843,3575879402,3575879450,48
1,982,24844,3575879402,3575879451,49
1,982,24845,3575879402,3575879451,49
1,983,24846,3575879465,3575879465,0
1,983,24847,3575879465,3575879466,1
1,983,24848,3575879465,3575879466,1
1,983,24849,3575879465,3575879466,1
1,983,24850,3575879465,3575879466,1
1,983,24851,3575879465,3575879466,1
1,983,24852,3575879465,3575879466,1
1,983,24853,3575879465,3575879466,1
1,983,24854,3575879465,3575879466,1
1,983,24855,3575879465,3575879466,1
1,983,24856,3575879465,3575879466,1
1,983,24857,3575879465,3575879466,1
1,983,24858,3575879465,3575879466,1
1,983,24859,3575879465,3575879466,1
1,983,24860,3575879465,3575879466,1
1,983,24861,3575879465,3575879466,1
1,983,24862,3575879465,3575879467,2
1,983,24863,3575879465,3575879467,2
1,983,24864,3575879465,3575879467,2
1,983,24865,3575879465,3575879468,3
1,983,24866,3575879465,3575879469,4
1,983,24867,3575879465,3575879470,5
1,983,24868,3575879465,3575879480,15
1,983,24869,3575879465,3575879480,15
1,983,24870,3575879465,3575879480,15
1,983,24871,3575879465,3575879481,16
1,983,24872,3575879465,3575879482,17
1,983,24873,3575879465,3575879483,18
1,983,24874,3575879465,3575879483,18
1,983,24875,3575879465,3575879484,19
1,983,24876,3575879465,3575879485,20
1,983,24877,3575879465,3575879485,20
1,983,24878,3575879465,3575879486,21
1,983,24879,3575879465,3575879486,21
1,983,24880,3575879465,3575879487,22
1,983,24881,3575879465,3575879487,22
1,983,24882,3575879465,3575879489,24
1,983,24883,3575879465,3575879490,25
1,983,24884,3575879465,3575879491,26
1,983,24885,3575879465,3575879492,27
1,983,24886,3575879465,3575879495,30
1,983,24887,3575879465,3575879497,32
1,983,24888,3575879465,3575879499,34
1,983,24889,3575879465,3575879499,34
1,983,24890,3575879465,3575879499,34
1,983,24891,3575879465,3575879500,35
1,983,24892,3575879465,3575879501,36
1,983,24893,3575879465,3575879502,37
1,983,24894,3575879465,3575879504,39
1,983,24895,3575879465,3575879505,40
1,983,24896,3575879465,3575879505,40
1,983,24897,3575879465,3575879505,40
1,983,24898,3575879465,3575879506,41
1,983,24899,3575879465,3575879506,41
1,983,24900,3575879465,3575879507,42
1,983,24901,3575879465,3575879508,43
1,983,24902,3575879465,3575879511,46
1,983,24903,3575879465,3575879513,48
1,983,24904,3575879465,3575879513,48
1,983,24905,3575879465,3575879514,49
1,983,24906,3575879465,3575879514,49
1,984,24907,3575879526,3575879526,0
1,984,24908,3575879526,3575879526,0
1,984,24909,3575879526,3575879526,0
1,984,24910,3575879526,3575879526,0
1,984,24911,3575879526,3575879526,0
1,984,24912,3575879526,3575879526,0
1,984,24913,3575879526,3575879526,0
1,984,24914,3575879526,3575879526,0
1,984,24915,3575879526,3575879526,0
1,984,24916,3575879526,3575879526,0
1,984,24917,3575879526,3575879526,0
1,984,24918,3575879526,3575879526,0
1,984,24919,3575879526,3575879526,0
1,984,24920,3575879526,3575879527,1
1,984,24921,3575879526,3575879527,1
1,984,24922,3575879526,3575879529,3
1,984,24923,3575879526,3575879530,4
1,984,24924,3575879526,3575879530,4
1,984,24925,3575879526,3575879531,5
1,984,24926,3575879526,3575879532,6
1,984,24927,3575879526,3575879534,8
1,984,24928,3575879526,3575879534,8
1,984,24929,3575879526,3575879537,11
1,984,24930,3575879526,3575879538,12
1,984,24931,3575879526,3575879539,13
1,984,24932,3575879526,3575879539,13
1,984,24933,3575879526,3575879540,14
1,984,24934,3575879526,3575879540,14
1,984,24935,3575879526,3575879540,14
1,984,24936,3575879526,3575879543,17
1,984,24937,3575879526,3575879544,18
1,984,24938,3575879526,3575879544,18
1,984,24939,3575879526,3575879545,19
1,984,24940,3575879526,3575879546,20
1,984,24941,3575879526,3575879548,22
1,984,24942,3575879526,3575879550,24
1,984,24943,3575879526,3575879551,25
1,984,24944,3575879526,3575879552,26
1,984,24945,3575879526,3575879553,27
1,984,24946,3575879526,3575879553,27
1,984,24947,3575879526,3575879553,27
1,984,24948,3575879526,3575879555,29
1,984,24949,3575879526,3575879556,30
1,984,24950,3575879526,3575879556,30
1,984,24951,3575879526,3575879556,30
1,984,24952,3575879526,3575879556,30
1,984,24953,3575879526,3575879557,31
1,984,24954,3575879526,3575879560,34
1,984,24955,3575879526,3575879560,34
1,984,24956,3575879526,3575879561,35
1,984,24957,3575879526,3575879561,35
1,984,24958,3575879526,3575879562,36
1,984,24959,3575879526,3575879563,37
1,984,24960,3575879526,3575879563,37
1,984,24961,3575879526,3575879565,39
1,984,24962,3575879526,3575879566,40
1,984,24963,3575879526,3575879572,46
1,984,24964,3575879526,3575879574,48
1,984,24965,3575879526,3575879575,49
1,984,24966,3575879526,3575879576,50
1,984,24967,3575879526,3575879576,50
1,985,24968,3575879588,3575879588,0
1,985,24969,3575879588,3575879588,0
1,985,24970,3575879588,3575879588,0
1,985,24971,3575879588,3575879588,0
1,985,24972,3575879588,3575879588,0
1,985,24973,3575879588,3575879588,0
1,985,24974,3575879588,3575879588,0
1,985,24975,3575879588,3575879588,0
1,985,24976,3575879588,3575879588,0
1,985,24977,3575879588,3575879588,0
1,985,24978,3575879588,3575879588,0
1,985,24979,3575879588,3575879588,0
1,985,24980,3575879588,3575879588,0
1,985,24981,3575879588,3575879588,0
1,985,24982,3575879588,3575879588,0
1,985,24983,3575879588,3575879588,0
1,985,24984,3575879588,3575879588,0
1,985,24985,3575879588,3575879588,0
1,985,24986,3575879588,3575879588,0
1,985,24987,3575879588,3575879589,1
1,985,24988,3575879588,3575879589,1
1,985,24989,3575879588,3575879589,1
1,985,24990,3575879588,3575879591,3
1,985,24991,3575879588,3575879591,3
1,985,24992,3575879588,3575879592,4
1,985,24993,3575879588,3575879592,4
1,985,24994,3575879588,3575879592,4
1,985,24995,3575879588,3575879593,5
1,985,24996,3575879588,3575879595,7
1,985,24997,3575879588,3575879597,9
1,985,24998,3575879588,3575879599,11
1,985,24999,3575879588,3575879599,11
1,985,25000,3575879588,3575879602,14
1,985,25001,3575879588,3575879602,14
1,985,25002,3575879588,3575879602,14
1,985,25003,3575879588,3575879603,15
1,985,25004,3575879588,3575879603,15
1,985,25005,3575879588,3575879604,16
1,985,25006,3575879588,3575879605,17
1,985,25007,3575879588,3575879607,19
1,985,25008,3575879588,3575879607,19
1,985,25009,3575879588,3575879607,19
1,985,25010,3575879588,3575879607,19
1,985,25011,3575879588,3575879609,21
1,985,25012,3575879588,3575879610,22
1,985,25013,3575879588,3575879610,22
1,985,25014,3575879588,3575879614,26
1,985,25015,3575879588,3575879616,28
1,985,25016,3575879588,3575879616,28
1,985,25017,3575879588,3575879616,28
1,985,25018,3575879588,3575879617,29
1,985,25019,3575879588,3575879617,29
1,985,25020,3575879588,3575879617,29
1,985,25021,3575879588,3575879618,30
1,985,25022,3575879588,3575879618,30
1,985,25023,3575879588,3575879618,30
1,985,25024,3575879588,3575879618,30
1,985,25025,3575879588,3575879619,31
1,985,25026,3575879588,3575879620,32
1,985,25027,3575879588,3575879621,33
1,985,25028,3575879588,3575879621,33
1,985,25029,3575879588,3575879622,34
1,985,25030,3575879588,3575879622,34
1,985,25031,3575879588,3575879623,35
1,985,25032,3575879588,3575879624,36
1,985,25033,3575879588,3575879624,36
1,985,25034,3575879588,3575879625,37
1,985,25035,3575879588,3575879628,40
1,985,25036,3575879588,3575879630,42
1,985,25037,3575879588,3575879630,42
1,985,25038,3575879588,3575879630,42
1,985,25039,3575879588,3575879630,42
1,985,25040,3575879588,3575879631,43
1,985,25041,3575879588,3575879631,43
1,985,25042,3575879588,3575879632,44
1,985,25043,3575879588,3575879632,44
1,985,25044,3575879588,3575879633,45
1,985,25045,3575879588,3575879633,45
1,985,25046,3575879588,3575879634,46
1,985,25047,3575879588,3575879635,47
1,985,25048,3575879588,3575879638,50
1,986,25049,3575879649,3575879649,0
1,986,25050,3575879649,3575879649,0
1,986,25051,3575879649,3575879649,0
1,986,25052,3575879649,3575879649,0
1,986,25053,3575879649,3575879649,0
1,986,25054,3575879649,3575879649,0
1,986,25055,3575879649,3575879649,0
1,986,25056,3575879649,3575879649,0
1,986,25057,3575879649,3575879649,0
1,986,25058,3575879649,3575879649,0
1,986,25059,3575879649,3575879649,0
1,986,25060,3575879649,3575879649,0
1,986,25061,3575879649,3575879649,0
1,986,25062,3575879649,3575879649,0
1,986,25063,3575879649,3575879649,0
1,986,25064,3575879649,3575879649,0
1,986,25065,3575879649,3575879649,0
1,986,25066,3575879649,3575879650,1
1,986,25067,3575879649,3575879651,2
1,986,25068,3575879649,3575879652,3
1,986,25069,3575879649,3575879652,3
1,986,25070,3575879649,3575879654,5
1,986,25071,3575879649,3575879655,6
1,986,25072,3575879649,3575879655,6
1,986,25073,3575879649,3575879655,6
1,986,25074,3575879649,3575879655,6
1,986,25075,3575879649,3575879657,8
1,986,25076,3575879649,3575879659,10
1,986,25077,3575879649,3575879661,12
1,986,25078,3575879649,3575879662,13
1,986,25079,3575879649,3575879662,13
1,986,25080,3575879649,3575879663,14
1,986,25081,3575879649,3575879666,17
1,986,25082,3575879649,3575879666,17
1,986,25083,3575879649,3575879667,18
1,986,25084,3575879649,3575879667,18
1,986,25085,3575879649,3575879667,18
1,986,25086,3575879649,3575879668,19
1,986,25087,3575879649,3575879669,20
1,986,25088,3575879649,3575879680,31
1,986,25089,3575879649,3575879681,32
1,986,25090,3575879649,3575879682,33
1,986,25091,3575879649,3575879683,34
1,986,25092,3575879649,3575879683,34
1,986,25093,3575879649,3575879685,36
1,986,25094,3575879649,3575879685,36
1,986,25095,3575879649,3575879685,36
1,986,25096,3575879649,3575879686,37
1,986,25097,3575879649,3575879686,37
1,986,25098,3575879649,3575879687,38
1,986,25099,3575879649,3575879687,38
1,986,25100,3575879649,3575879689,40
1,986,25101,3575879649,3575879689,40
1,986,25102,3575879649,3575879692,43
1,986,25103,3575879649,3575879692,43
1,986,25104,3575879649,3575879694,45
1,986,25105,3575879649,3575879697,48
1,986,25106,3575879649,3575879699,50
1,987,25107,3575879711,3575879711,0
1,987,25108,3575879711,3575879711,0
1,987,25109,3575879711,3575879711,0
1,987,25110,3575879711,3575879711,0
1,987,25111,3575879711,3575879711,0
1,987,25112,3575879711,3575879711,0
1,987,25113,3575879711,3575879711,0
1,987,25114,3575879711,3575879711,0
1,987,25115,3575879711,3575879711,0
1,987,25116,3575879711,3575879711,0
1,987,25117,3575879711,3575879711,0
1,987,25118,3575879711,3575879711,0
1,987,25119,3575879711,3575879712,1
1,987,25120,3575879711,3575879712,1
1,987,25121,3575879711,3575879712,1
1,987,25122,3575879711,3575879713,2
1,987,25123,3575879711,3575879714,3
1,987,25124,3575879711,3575879715,4
1,987,25125,3575879711,3575879715,4
1,987,25126,3575879711,3575879718,7
1,987,25127,3575879711,3575879718,7
1,987,25128,3575879711,3575879719,8
1,987,25129,3575879711,3575879720,9
1,987,25130,3575879711,3575879722,11
1,987,25131,3575879711,3575879722,11
1,987,25132,3575879711,3575879723,12
1,987,25133,3575879711,3575879723,12
1,987,25134,3575879711,3575879724,13
1,987,25135,3575879711,3575879724,13
1,987,25136,3575879711,3575879724,13
1,987,25137,3575879711,3575879725,14
1,987,25138,3575879711,3575879727,16
1,987,25139,3575879711,3575879727,16
1,987,25140,3575879711,3575879729,18
1,987,25141,3575879711,3575879730,19
1,987,25142,3575879711,3575879730,19
1,987,25143,3575879711,3575879730,19
1,987,25144,3575879711,3575879731,20
1,987,25145,3575879711,3575879732,21
1,987,25146,3575879711,3575879733,22
1,987,25147,3575879711,3575879735,24
1,987,25148,3575879711,3575879737,26
1,987,25149,3575879711,3575879739,28
1,987,25150,3575879711,3575879739,28
1,987,25151,3575879711,3575879740,29
1,987,25152,3575879711,3575879740,29
1,987,25153,3575879711,3575879744,33
1,987,25154,3575879711,3575879745,34
1,987,25155,3575879711,3575879746,35
1,987,25156,3575879711,3575879747,36
1,987,25157,3575879711,3575879749,38
1,987,25158,3575879711,3575879749,38
1,987,25159,3575879711,3575879751,40
1,987,25160,3575879711,3575879752,41
1,987,25161,3575879711,3575879752,41
1,987,25162,3575879711,3575879752,41
1,987,25163,3575879711,3575879754,43
1,987,25164,3575879711,3575879756,45
1,987,25165,3575879711,3575879756,45
1,987,25166,3575879711,3575879756,45
1,987,25167,3575879711,3575879757,46
1,987,25168,3575879711,3575879757,46
1,987,25169,3575879711,3575879757,46
1,987,25170,3575879711,3575879759,48
1,987,25171,3575879711,3575879761,50
1,988,25172,3575879776,3575879776,0
1,988,25173,3575879776,3575879776,0
1,988,25174,3575879776,3575879776,0
1,988,25175,3575879776,3575879776,0
1,988,25176,3575879776,3575879776,0
1,988,25177,3575879776,3575879776,0
1,988,25178,3575879776,3575879776,0
1,988,25179,3575879776,3575879776,0
1,988,25180,3575879776,3575879776,0
1,988,25181,3575879776,3575879776,0
1,988,25182,3575879776,3575879776,0
1,988,25183,3575879776,3575879776,0
1,988,25184,3575879776,3575879776,0
1,988,25185,3575879776,3575879776,0
1,988,25186,3575879776,3575879776,0
1,988,25187,3575879776,3575879776,0
1,988,25188,3575879776,3575879777,1
1,988,25189,3575879776,3575879778,2
1,988,25190,3575879776,3575879778,2
1,988,25191,3575879776,3575879779,3
1,988,25192,3575879776,3575879780,4
1,988,25193,3575879776,3575879781,5
1,988,25194,3575879776,3575879781,5
1,988,25195,3575879776,3575879781,5
1,988,25196,3575879776,3575879782,6
1,988,25197,3575879776,3575879783,7
1,988,25198,3575879776,3575879783,7
1,988,25199,3575879776,3575879784,8
1,988,25200,3575879776,3575879784,8
1,988,25201,3575879776,3575879785,9
1,988,25202,3575879776,3575879785,9
1,988,25203,3575879776,3575879785,9
1,988,25204,3575879776,3575879785,9
1,988,25205,3575879776,3575879786,10
1,988,25206,3575879776,3575879789,13
1,988,25207,3575879776,3575879789,13
1,988,25208,3575879776,3575879790,14
1,988,25209,3575879776,3575879791,15
1,988,25210,3575879776,3575879791,15
1,988,25211,3575879776,3575879792,16
1,988,25212,3575879776,3575879792,16
1,988,25213,3575879776,3575879792,16
1,988,25214,3575879776,3575879793,17
1,988,25215,3575879776,3575879795,19
1,988,25216,3575879776,3575879796,20
1,988,25217,3575879776,3575879799,23
1,988,25218,3575879776,3575879799,23
1,988,25219,3575879776,3575879801,25
1,988,25220,3575879776,3575879802,26
1,988,25221,3575879776,3575879802,26
1,988,25222,3575879776,3575879802,26
1,988,25223,3575879776,3575879803,27
1,988,25224,3575879776,3575879803,27
1,988,25225,3575879776,3575879804,28
1,988,25226,3575879776,3575879805,29
1,988,25227,3575879776,3575879806,30
1,988,25228,3575879776,3575879806,30
1,988,25229,3575879776,3575879807,31
1,988,25230,3575879776,3575879808,32
1,988,25231,3575879776,3575879809,33
1,988,25232,3575879776,3575879810,34
1,988,25233,3575879776,3575879811,35
1,988,25234,3575879776,3575879814,38
1,988,25235,3575879776,3575879816,40
1,988,25236,3575879776,3575879816,40
1,988,25237,3575879776,3575879816,40
1,988,25238,3575879776,3575879817,41
1,988,25239,3575879776,3575879817,41
1,988,25240,3575879776,3575879818,42
1,988,25241,3575879776,3575879818,42
1,988,25242,3575879776,3575879818,42
1,988,25243,3575879776,3575879818,42
1,988,25244,3575879776,3575879818,42
1,988,25245,3575879776,3575879819,43
1,988,25246,3575879776,3575879819,43
1,988,25247,3575879776,3575879820,44
1,988,25248,3575879776,3575879821,45
1,988,25249,3575879776,3575879822,46
1,988,25250,3575879776,3575879822,46
1,988,25251,3575879776,3575879822,46
1,988,25252,3575879776,3575879822,46
1,988,25253,3575879776,3575879823,47
1,988,25254,3575879776,3575879823,47
1,988,25255,3575879776,3575879824,48
1,989,25256,3575879838,3575879838,0
1,989,25257,3575879838,3575879838,0
1,989,25258,3575879838,3575879838,0
1,989,25259,3575879838,3575879838,0
1,989,25260,3575879838,3575879838,0
1,989,25261,3575879838,3575879838,0
1,989,25262,3575879838,3575879838,0
1,989,25263,3575879838,3575879838,0
1,989,25264,3575879838,3575879838,0
1,989,25265,3575879838,3575879838,0
1,989,25266,3575879838,3575879838,0
1,989,25267,3575879838,3575879838,0
1,989,25268,3575879838,3575879838,0
1,989,25269,3575879838,3575879840,2
1,989,25270,3575879838,3575879841,3
1,989,25271,3575879838,3575879842,4
1,989,25272,3575879838,3575879843,5
1,989,25273,3575879838,3575879843,5
1,989,25274,3575879838,3575879843,5
1,989,25275,3575879838,3575879843,5
1,989,25276,3575879838,3575879844,6
1,989,25277,3575879838,3575879844,6
1,989,25278,3575879838,3575879845,7
1,989,25279,3575879838,3575879845,7
1,989,25280,3575879838,3575879845,7
1,989,25281,3575879838,3575879845,7
1,989,25282,3575879838,3575879847,9
1,989,25283,3575879838,3575879848,10
1,989,25284,3575879838,3575879848,10
1,989,25285,3575879838,3575879848,10
1,989,25286,3575879838,3575879849,11
1,989,25287,3575879838,3575879850,12
1,989,25288,3575879838,3575879850,12
1,989,25289,3575879838,3575879851,13
1,989,25290,3575879838,3575879851,13
1,989,25291,3575879838,3575879853,15
1,989,25292,3575879838,3575879854,16
1,989,25293,3575879838,3575879854,16
1,989,25294,3575879838,3575879855,17
1,989,25295,3575879838,3575879855,17
1,989,25296,3575879838,3575879856,18
1,989,25297,3575879838,3575879856,18
1,989,25298,3575879838,3575879857,19
1,989,25299,3575879838,3575879859,21
1,989,25300,3575879838,3575879860,22
1,989,25301,3575879838,3575879861,23
1,989,25302,3575879838,3575879862,24
1,989,25303,3575879838,3575879863,25
1,989,25304,3575879838,3575879866,28
1,989,25305,3575879838,3575879867,29
1,989,25306,3575879838,3575879867,29
1,989,25307,3575879838,3575879868,30
1,989,25308,3575879838,3575879868,30
1,989,25309,3575879838,3575879869,31
1,989,25310,3575879838,3575879869,31
1,989,25311,3575879838,3575879880,42
1,989,25312,3575879838,3575879880,42
1,989,25313,3575879838,3575879880,42
1,989,25314,3575879838,3575879882,44
1,989,25315,3575879838,3575879883,45
1,989,25316,3575879838,3575879884,46
1,989,25317,3575879838,3575879884,46
1,989,25318,3575879838,3575879885,47
1,989,25319,3575879838,3575879885,47
1,989,25320,3575879838,3575879886,48
1,989,25321,3575879838,3575879886,48
1,989,25322,3575879838,3575879887,49
1,989,25323,3575879838,3575879887,49
1,989,25324,3575879838,3575879887,49
1,990,25325,3575879900,3575879900,0
1,990,25326,3575879900,3575879900,0
1,990,25327,3575879900,3575879900,0
1,990,25328,3575879900,3575879900,0
1,990,25329,3575879900,3575879900,0
1,990,25330,3575879900,3575879900,0
1,990,25331,3575879900,3575879900,0
1,990,25332,3575879900,3575879901,1
1,990,25333,3575879900,3575879901,1
1,990,25334,3575879900,3575879902,2
1,990,25335,3575879900,3575879903,3
1,990,25336,3575879900,3575879905,5
1,990,25337,3575879900,3575879905,5
1,990,25338,3575879900,3575879905,5
1,990,25339,3575879900,3575879905,5
1,990,25340,3575879900,3575879906,6
1,990,25341,3575879900,3575879906,6
1,990,25342,3575879900,3575879907,7
1,990,25343,3575879900,3575879907,7
1,990,25344,3575879900,3575879911,11
1,990,25345,3575879900,3575879912,12
1,990,25346,3575879900,3575879912,12
1,990,25347,3575879900,3575879913,13
1,990,25348,3575879900,3575879914,14
1,990,25349,3575879900,3575879914,14
1,990,25350,3575879900,3575879914,14
1,990,25351,3575879900,3575879915,15
1,990,25352,3575879900,3575879918,18
1,990,25353,3575879900,3575879918,18
1,990,25354,3575879900,3575879919,19
1,990,25355,3575879900,3575879919,19
1,990,25356,3575879900,3575879920,20
1,990,25357,3575879900,3575879922,22
1,990,25358,3575879900,3575879923,23
1,990,25359,3575879900,3575879924,24
1,990,25360,3575879900,3575879925,25
1,990,25361,3575879900,3575879926,26
1,990,25362,3575879900,3575879926,26
1,990,25363,3575879900,3575879927,27
1,990,25364,3575879900,3575879929,29
1,990,25365,3575879900,3575879930,30
1,990,25366,3575879900,3575879930,30
1,990,25367,3575879900,3575879931,31
1,990,25368,3575879900,3575879931,31
1,990,25369,3575879900,3575879933,33
1,990,25370,3575879900,3575879934,34
1,990,25371,3575879900,3575879935,35
1,990,25372,3575879900,3575879937,37
1,990,25373,3575879900,3575879939,39
1,990,25374,3575879900,3575879940,40
1,990,25375,3575879900,3575879941,41
1,990,25376,3575879900,3575879944,44
1,990,25377,3575879900,3575879944,44
1,990,25378,3575879900,3575879946,46
1,990,25379,3575879900,3575879947,47
1,990,25380,3575879900,3575879948,48
1,990,25381,3575879900,3575879950,50
1,991,25382,3575879962,3575879962,0
1,991,25383,3575879962,3575879962,0
1,991,25384,3575879962,3575879962,0
1,991,25385,3575879962,3575879962,0
1,991,25386,3575879962,3575879962,0
1,991,25387,3575879962,3575879962,0
1,991,25388,3575879962,3575879962,0
1,991,25389,3575879962,3575879962,0
1,991,25390,3575879962,3575879962,0
1,991,25391,3575879962,3575879962,0
1,991,25392,3575879962,3575879962,0
1,991,25393,3575879962,3575879962,0
1,991,25394,3575879962,3575879962,0
1,991,25395,3575879962,3575879962,0
1,991,25396,3575879962,3575879962,0
1,991,25397,3575879962,3575879962,0
1,991,25398,3575879962,3575879962,0
1,991,25399,3575879962,3575879964,2
1,991,25400,3575879962,3575879964,2
1,991,25401,3575879962,3575879964,2
1,991,25402,3575879962,3575879965,3
1,991,25403,3575879962,3575879970,8
1,991,25404,3575879962,3575879971,9
1,991,25405,3575879962,3575879973,11
1,991,25406,3575879962,3575879973,11
1,991,25407,3575879962,3575879974,12
1,991,25408,3575879962,3575879975,13
1,991,25409,3575879962,3575879975,13
1,991,25410,3575879962,3575879976,14
1,991,25411,3575879962,3575879976,14
1,991,25412,3575879962,3575879977,15
1,991,25413,3575879962,3575879977,15
1,991,25414,3575879962,3575879978,16
1,991,25415,3575879962,3575879979,17
1,991,25416,3575879962,3575879980,18
1,991,25417,3575879962,3575879980,18
1,991,25418,3575879962,3575879980,18
1,991,25419,3575879962,3575879981,19
1,991,25420,3575879962,3575879982,20
1,991,25421,3575879962,3575879982,20
1,991,25422,3575879962,3575879982,20
1,991,25423,3575879962,3575879983,21
1,991,25424,3575879962,3575879983,21
1,991,25425,3575879962,3575879984,22
1,991,25426,3575879962,3575879984,22
1,991,25427,3575879962,3575879985,23
1,991,25428,3575879962,3575879985,23
1,991,25429,3575879962,3575879985,23
1,991,25430,3575879962,3575879985,23
1,991,25431,3575879962,3575879986,24
1,991,25432,3575879962,3575879989,27
1,991,25433,3575879962,3575879989,27
1,991,25434,3575879962,3575879989,27
1,991,25435,3575879962,3575879991,29
1,991,25436,3575879962,3575879992,30
1,991,25437,3575879962,3575879992,30
1,991,25438,3575879962,3575879993,31
1,991,25439,3575879962,3575879993,31
1,991,25440,3575879962,3575879996,34
1,991,25441,3575879962,3575879997,35
1,991,25442,3575879962,3575879999,37
1,991,25443,3575879962,3575879999,37
1,991,25444,3575879962,3575880001,39
1,991,25445,3575879962,3575880001,39
1,991,25446,3575879962,3575880002,40
1,991,25447,3575879962,3575880002,40
1,991,25448,3575879962,3575880003,41
1,991,25449,3575879962,3575880004,42
1,991,25450,3575879962,3575880004,42
1,991,25451,3575879962,3575880006,44
1,991,25452,3575879962,3575880006,44
1,991,25453,3575879962,3575880007,45
1,991,25454,3575879962,3575880008,46
1,991,25455,3575879962,3575880009,47
1,991,25456,3575879962,3575880010,48
1,991,25457,3575879962,3575880011,49
1,992,25458,3575880028,3575880028,0
1,992,25459,3575880028,3575880028,0
1,992,25460,3575880028,3575880028,0
1,992,25461,3575880028,3575880028,0
1,992,25462,3575880028,3575880028,0
1,992,25463,3575880028,3575880028,0
1,992,25464,3575880028,3575880028,0
1,992,25465,3575880028,3575880028,0
1,992,25466,3575880028,3575880028,0
1,992,25467,3575880028,3575880028,0
1,992,25468,3575880028,3575880029,1
1,992,25469,3575880028,3575880029,1
1,992,25470,3575880028,3575880029,1
1,992,25471,3575880028,3575880029,1
1,992,25472,3575880028,3575880029,1
1,992,25473,3575880028,3575880029,1
1,992,25474,3575880028,3575880029,1
1,992,25475,3575880028,3575880029,1
1,992,25476,3575880028,3575880029,1
1,992,25477,3575880028,3575880029,1
1,992,25478,3575880028,3575880029,1
1,992,25479,3575880028,3575880030,2
1,992,25480,3575880028,3575880030,2
1,992,25481,3575880028,3575880031,3
1,992,25482,3575880028,3575880031,3
1,992,25483,3575880028,3575880031,3
1,992,25484,3575880028,3575880031,3
1,992,25485,3575880028,3575880033,5
1,992,25486,3575880028,3575880033,5
1,992,25487,3575880028,3575880036,8
1,992,25488,3575880028,3575880037,9
1,992,25489,3575880028,3575880038,10
1,992,25490,3575880028,3575880040,12
1,992,25491,3575880028,3575880041,13
1,992,25492,3575880028,3575880042,14
1,992,25493,3575880028,3575880043,15
1,992,25494,3575880028,3575880043,15
1,992,25495,3575880028,3575880043,15
1,992,25496,3575880028,3575880045,17
1,992,25497,3575880028,3575880045,17
1,992,25498,3575880028,3575880045,17
1,992,25499,3575880028,3575880045,17
1,992,25500,3575880028,3575880045,17
1,992,25501,3575880028,3575880045,17
1,992,25502,3575880028,3575880045,17
1,992,25503,3575880028,3575880047,19
1,992,25504,3575880028,3575880047,19
1,992,25505,3575880028,3575880048,20
1,992,25506,3575880028,3575880049,21
1,992,25507,3575880028,3575880049,21
1,992,25508,3575880028,3575880050,22
1,992,25509,3575880028,3575880050,22
1,992,25510,3575880028,3575880050,22
1,992,25511,3575880028,3575880052,24
1,992,25512,3575880028,3575880054,26
1,992,25513,3575880028,3575880054,26
1,992,25514,3575880028,3575880055,27
1,992,25515,3575880028,3575880055,27
1,992,25516,3575880028,3575880055,27
1,992,25517,3575880028,3575880056,28
1,992,25518,3575880028,3575880056,28
1,992,25519,3575880028,3575880056,28
1,992,25520,3575880028,3575880056,28
1,992,25521,3575880028,3575880057,29
1,992,25522,3575880028,3575880058,30
1,992,25523,3575880028,3575880059,31
1,992,25524,3575880028,3575880061,33
1,992,25525,3575880028,3575880063,35
1,992,25526,3575880028,3575880064,36
1,992,25527,3575880028,3575880066,38
1,992,25528,3575880028,3575880067,39
1,992,25529,3575880028,3575880067,39
1,992,25530,3575880028,3575880067,39
1,992,25531,3575880028,3575880069,41
1,992,25532,3575880028,3575880069,41
1,992,25533,3575880028,3575880070,42
1,993,25534,3575880092,3575880092,0
1,993,25535,3575880092,3575880092,0
1,993,25536,3575880092,3575880092,0
1,993,25537,3575880092,3575880092,0
1,993,25538,3575880092,3575880092,0
1,993,25539,3575880092,3575880092,0
1,993,25540,3575880092,3575880092,0
1,993,25541,3575880092,3575880092,0
1,993,25542,3575880092,3575880092,0
1,993,25543,3575880092,3575880092,0
1,993,25544,3575880092,3575880092,0
1,993,25545,3575880092,3575880092,0
1,993,25546,3575880092,3575880092,0
1,993,25547,3575880092,3575880092,0
1,993,25548,3575880092,3575880092,0
1,993,25549,3575880092,3575880093,1
1,993,25550,3575880092,3575880093,1
1,993,25551,3575880092,3575880094,2
1,993,25552,3575880092,3575880097,5
1,993,25553,3575880092,3575880099,7
1,993,25554,3575880092,3575880101,9
1,993,25555,3575880092,3575880101,9
1,993,25556,3575880092,3575880101,9
1,993,25557,3575880092,3575880103,11
1,993,25558,3575880092,3575880104,12
1,993,25559,3575880092,3575880104,12
1,993,25560,3575880092,3575880105,13
1,993,25561,3575880092,3575880105,13
1,993,25562,3575880092,3575880105,13
1,993,25563,3575880092,3575880106,14
1,993,25564,3575880092,3575880107,15
1,993,25565,3575880092,3575880107,15
1,993,25566,3575880092,3575880108,16
1,993,25567,3575880092,3575880110,18
1,993,25568,3575880092,3575880111,19
1,993,25569,3575880092,3575880112,20
1,993,25570,3575880092,3575880113,21
1,993,25571,3575880092,3575880113,21
1,993,25572,3575880092,3575880114,22
1,993,25573,3575880092,3575880114,22
1,993,25574,3575880092,3575880116,24
1,993,25575,3575880092,3575880119,27
1,993,25576,3575880092,3575880119,27
1,993,25577,3575880092,3575880119,27
1,993,25578,3575880092,3575880120,28
1,993,25579,3575880092,3575880124,32
1,993,25580,3575880092,3575880124,32
1,993,25581,3575880092,3575880125,33
1,993,25582,3575880092,3575880125,33
1,993,25583,3575880092,3575880126,34
1,993,25584,3575880092,3575880126,34
1,993,25585,3575880092,3575880127,35
1,993,25586,3575880092,3575880128,36
1,993,25587,3575880092,3575880128,36
1,993,25588,3575880092,3575880130,38
1,993,25589,3575880092,3575880130,38
1,993,25590,3575880092,3575880131,39
1,993,25591,3575880092,3575880133,41
1,993,25592,3575880092,3575880133,41
1,993,25593,3575880092,3575880135,43
1,993,25594,3575880092,3575880137,45
1,993,25595,3575880092,3575880139,47
1,993,25596,3575880092,3575880139,47
1,993,25597,3575880092,3575880140,48
1,993,25598,3575880092,3575880141,49
1,994,25599,3575880155,3575880155,0
1,994,25600,3575880155,3575880155,0
1,994,25601,3575880155,3575880155,0
1,994,25602,3575880155,3575880155,0
1,994,25603,3575880155,3575880155,0
1,994,25604,3575880155,3575880155,0
1,994,25605,3575880155,3575880155,0
1,994,25606,3575880155,3575880155,0
1,994,25607,3575880155,3575880155,0
1,994,25608,3575880155,3575880155,0
1,994,25609,3575880155,3575880155,0
1,994,25610,3575880155,3575880156,1
1,994,25611,3575880155,3575880157,2
1,994,25612,3575880155,3575880157,2
1,994,25613,3575880155,3575880158,3
1,994,25614,3575880155,3575880159,4
1,994,25615,3575880155,3575880161,6
1,994,25616,3575880155,3575880161,6
1,994,25617,3575880155,3575880162,7
1,994,25618,3575880155,3575880163,8
1,994,25619,3575880155,3575880164,9
1,994,25620,3575880155,3575880165,10
1,994,25621,3575880155,3575880165,10
1,994,25622,3575880155,3575880165,10
1,994,25623,3575880155,3575880166,11
1,994,25624,3575880155,3575880170,15
1,994,25625,3575880155,3575880171,16
1,994,25626,3575880155,3575880173,18
1,994,25627,3575880155,3575880174,19
1,994,25628,3575880155,3575880175,20
1,994,25629,3575880155,3575880176,21
1,994,25630,3575880155,3575880176,21
1,994,25631,3575880155,3575880177,22
1,994,25632,3575880155,3575880177,22
1,994,25633,3575880155,3575880177,22
1,994,25634,3575880155,3575880178,23
1,994,25635,3575880155,3575880179,24
1,994,25636,3575880155,3575880180,25
1,994,25637,3575880155,3575880180,25
1,994,25638,3575880155,3575880180,25
1,994,25639,3575880155,3575880181,26
1,994,25640,3575880155,3575880181,26
1,994,25641,3575880155,3575880182,27
1,994,25642,3575880155,3575880182,27
1,994,25643,3575880155,3575880183,28
1,994,25644,3575880155,3575880184,29
1,994,25645,3575880155,3575880184,29
1,994,25646,3575880155,3575880184,29
1,994,25647,3575880155,3575880185,30
1,994,25648,3575880155,3575880185,30
1,994,25649,3575880155,3575880185,30
1,994,25650,3575880155,3575880185,30
1,994,25651,3575880155,3575880189,34
1,994,25652,3575880155,3575880190,35
1,994,25653,3575880155,3575880190,35
1,994,25654,3575880155,3575880191,36
1,994,25655,3575880155,3575880191,36
1,994,25656,3575880155,3575880192,37
1,994,25657,3575880155,3575880192,37
1,994,25658,3575880155,3575880193,38
1,994,25659,3575880155,3575880193,38
1,994,25660,3575880155,3575880196,41
1,994,25661,3575880155,3575880197,42
1,994,25662,3575880155,3575880200,45
1,994,25663,3575880155,3575880200,45
1,994,25664,3575880155,3575880201,46
1,994,25665,3575880155,3575880201,46
1,994,25666,3575880155,3575880202,47
1,994,25667,3575880155,3575880202,47
1,994,25668,3575880155,3575880202,47
1,994,25669,3575880155,3575880203,48
1,994,25670,3575880155,3575880203,48
1,994,25671,3575880155,3575880203,48
1,994,25672,3575880155,3575880205,50
1,995,25673,3575880219,3575880219,0
1,995,25674,3575880219,3575880219,0
1,995,25675,3575880219,3575880219,0
1,995,25676,3575880219,3575880219,0
1,995,25677,3575880219,3575880219,0
1,995,25678,3575880219,3575880219,0
1,995,25679,3575880219,3575880219,0
1,995,25680,3575880219,3575880219,0
1,995,25681,3575880219,3575880219,0
1,995,25682,3575880219,3575880219,0
1,995,25683,3575880219,3575880219,0
1,995,25684,3575880219,3575880219,0
1,995,25685,3575880219,3575880219,0
1,995,25686,3575880219,3575880219,0
1,995,25687,3575880219,3575880219,0
1,995,25688,3575880219,3575880219,0
1,995,25689,3575880219,3575880219,0
1,995,25690,3575880219,3575880219,0
1,995,25691,3575880219,3575880219,0
1,995,25692,3575880219,3575880219,0
1,995,25693,3575880219,3575880220,1
1,995,25694,3575880219,3575880221,2
1,995,25695,3575880219,3575880221,2
1,995,25696,3575880219,3575880222,3
1,995,25697,3575880219,3575880222,3
1,995,25698,3575880219,3575880223,4
1,995,25699,3575880219,3575880223,4
1,995,25700,3575880219,3575880224,5
1,995,25701,3575880219,3575880224,5
1,995,25702,3575880219,3575880225,6
1,995,25703,3575880219,3575880226,7
1,995,25704,3575880219,3575880230,11
1,995,25705,3575880219,3575880231,12
1,995,25706,3575880219,3575880232,13
1,995,25707,3575880219,3575880232,13
1,995,25708,3575880219,3575880232,13
1,995,25709,3575880219,3575880232,13
1,995,25710,3575880219,3575880233,14
1,995,25711,3575880219,3575880234,15
1,995,25712,3575880219,3575880235,16
1,995,25713,3575880219,3575880235,16
1,995,25714,3575880219,3575880238,19
1,995,25715,3575880219,3575880238,19
1,995,25716,3575880219,3575880239,20
1,995,25717,3575880219,3575880240,21
1,995,25718,3575880219,3575880241,22
1,995,25719,3575880219,3575880243,24
1,995,25720,3575880219,3575880243,24
1,995,25721,3575880219,3575880243,24
1,995,25722,3575880219,3575880244,25
1,995,25723,3575880219,3575880244,25
1,995,25724,3575880219,3575880245,26
1,995,25725,3575880219,3575880245,26
1,995,25726,3575880219,3575880245,26
1,995,25727,3575880219,3575880246,27
1,995,25728,3575880219,3575880247,28
1,995,25729,3575880219,3575880248,29
1,995,25730,3575880219,3575880249,30
1,995,25731,3575880219,3575880249,30
1,995,25732,3575880219,3575880249,30
1,995,25733,3575880219,3575880250,31
1,995,25734,3575880219,3575880251,32
1,995,25735,3575880219,3575880252,33
1,995,25736,3575880219,3575880253,34
1,995,25737,3575880219,3575880255,36
1,995,25738,3575880219,3575880255,36
1,995,25739,3575880219,3575880255,36
1,995,25740,3575880219,3575880255,36
1,995,25741,3575880219,3575880255,36
1,995,25742,3575880219,3575880256,37
1,995,25743,3575880219,3575880256,37
1,995,25744,3575880219,3575880257,38
1,995,25745,3575880219,3575880258,39
1,995,25746,3575880219,3575880259,40
1,995,25747,3575880219,3575880261,42
1,995,25748,3575880219,3575880261,42
1,995,25749,3575880219,3575880263,44
1,995,25750,3575880219,3575880264,45
1,995,25751,3575880219,3575880266,47
1,995,25752,3575880219,3575880267,48
1,995,25753,3575880219,3575880267,48
1,995,25754,3575880219,3575880268,49
1,995,25755,3575880219,3575880268,49
1,995,25756,3575880219,3575880269,50
1,996,25757,3575880279,3575880279,0
1,996,25758,3575880279,3575880280,1
1,996,25759,3575880279,3575880280,1
1,996,25760,3575880279,3575880282,3
1,996,25761,3575880279,3575880282,3
1,996,25762,3575880279,3575880284,5
1,996,25763,3575880279,3575880285,6
1,996,25764,3575880279,3575880286,7
1,996,25765,3575880279,3575880286,7
1,996,25766,3575880279,3575880286,7
1,996,25767,3575880279,3575880287,8
1,996,25768,3575880279,3575880287,8
1,996,25769,3575880279,3575880287,8
1,996,25770,3575880279,3575880289,10
1,996,25771,3575880279,3575880291,12
1,996,25772,3575880279,3575880293,14
1,996,25773,3575880279,3575880293,14
1,996,25774,3575880279,3575880295,16
1,996,25775,3575880279,3575880297,18
1,996,25776,3575880279,3575880299,20
1,996,25777,3575880279,3575880300,21
1,996,25778,3575880279,3575880301,22
1,996,25779,3575880279,3575880301,22
1,996,25780,3575880279,3575880302,23
1,996,25781,3575880279,3575880303,24
1,996,25782,3575880279,3575880305,26
1,996,25783,3575880279,3575880305,26
1,996,25784,3575880279,3575880305,26
1,996,25785,3575880279,3575880305,26
1,996,25786,3575880279,3575880305,26
1,996,25787,3575880279,3575880305,26
1,996,25788,3575880279,3575880307,28
1,996,25789,3575880279,3575880308,29
1,996,25790,3575880279,3575880308,29
1,996,25791,3575880279,3575880310,31
1,996,25792,3575880279,3575880312,33
1,996,25793,3575880279,3575880312,33
1,996,25794,3575880279,3575880313,34
1,996,25795,3575880279,3575880313,34
1,996,25796,3575880279,3575880314,35
1,996,25797,3575880279,3575880315,36
1,996,25798,3575880279,3575880317,38
1,996,25799,3575880279,3575880319,40
1,996,25800,3575880279,3575880319,40
1,996,25801,3575880279,3575880320,41
1,996,25802,3575880279,3575880320,41
1,996,25803,3575880279,3575880322,43
1,996,25804,3575880279,3575880322,43
1,996,25805,3575880279,3575880324,45
1,996,25806,3575880279,3575880325,46
1,996,25807,3575880279,3575880325,46
1,996,25808,3575880279,3575880326,47
1,996,25809,3575880279,3575880327,48
1,996,25810,3575880279,3575880327,48
1,996,25811,3575880279,3575880328,49
1,997,25812,3575880348,3575880348,0
1,997,25813,3575880348,3575880348,0
1,997,25814,3575880348,3575880348,0
1,997,25815,3575880348,3575880348,0
1,997,25816,3575880348,3575880348,0
1,997,25817,3575880348,3575880348,0
1,997,25818,3575880348,3575880348,0
1,997,25819,3575880348,3575880348,0
1,997,25820,3575880348,3575880348,0
1,997,25821,3575880348,3575880348,0
1,997,25822,3575880348,3575880348,0
1,997,25823,3575880348,3575880348,0
1,997,25824,3575880348,3575880348,0
1,997,25825,3575880348,3575880348,0
1,997,25826,3575880348,3575880349,1
1,997,25827,3575880348,3575880351,3
1,997,25828,3575880348,3575880352,4
1,997,25829,3575880348,3575880353,5
1,997,25830,3575880348,3575880354,6
1,997,25831,3575880348,3575880356,8
1,997,25832,3575880348,3575880356,8
1,997,25833,3575880348,3575880357,9
1,997,25834,3575880348,3575880358,10
1,997,25835,3575880348,3575880358,10
1,997,25836,3575880348,3575880360,12
1,997,25837,3575880348,3575880361,13
1,997,25838,3575880348,3575880361,13
1,997,25839,3575880348,3575880363,15
1,997,25840,3575880348,3575880364,16
1,997,25841,3575880348,3575880365,17
1,997,25842,3575880348,3575880365,17
1,997,25843,3575880348,3575880365,17
1,997,25844,3575880348,3575880366,18
1,997,25845,3575880348,3575880371,23
1,997,25846,3575880348,3575880371,23
1,997,25847,3575880348,3575880374,26
1,997,25848,3575880348,3575880374,26
1,997,25849,3575880348,3575880375,27
1,997,25850,3575880348,3575880375,27
1,997,25851,3575880348,3575880377,29
1,997,25852,3575880348,3575880377,29
1,997,25853,3575880348,3575880378,30
1,997,25854,3575880348,3575880378,30
1,997,25855,3575880348,3575880379,31
1,997,25856,3575880348,3575880380,32
1,997,25857,3575880348,3575880380,32
1,997,25858,3575880348,3575880380,32
1,997,25859,3575880348,3575880381,33
1,997,25860,3575880348,3575880382,34
1,997,25861,3575880348,3575880382,34
1,997,25862,3575880348,3575880383,35
1,997,25863,3575880348,3575880383,35
1,997,25864,3575880348,3575880383,35
1,997,25865,3575880348,3575880384,36
1,997,25866,3575880348,3575880385,37
1,997,25867,3575880348,3575880385,37
1,997,25868,3575880348,3575880386,38
1,997,25869,3575880348,3575880386,38
1,997,25870,3575880348,3575880386,38
1,997,25871,3575880348,3575880390,42
1,997,25872,3575880348,3575880390,42
1,997,25873,3575880348,3575880391,43
1,997,25874,3575880348,3575880392,44
1,997,25875,3575880348,3575880392,44
1,997,25876,3575880348,3575880393,45
1,997,25877,3575880348,3575880393,45
1,997,25878,3575880348,3575880396,48
1,997,25879,3575880348,3575880397,49
1,998,25880,3575880414,3575880414,0
1,998,25881,3575880414,3575880414,0
1,998,25882,3575880414,3575880414,0
1,998,25883,3575880414,3575880414,0
1,998,25884,3575880414,3575880414,0
1,998,25885,3575880414,3575880414,0
1,998,25886,3575880414,3575880414,0
1,998,25887,3575880414,3575880414,0
1,998,25888,3575880414,3575880414,0
1,998,25889,3575880414,3575880414,0
1,998,25890,3575880414,3575880414,0
1,998,25891,3575880414,3575880414,0
1,998,25892,3575880414,3575880414,0
1,998,25893,3575880414,3575880414,0
1,998,25894,3575880414,3575880414,0
1,998,25895,3575880414,3575880414,0
1,998,25896,3575880414,3575880414,0
1,998,25897,3575880414,3575880414,0
1,998,25898,3575880414,3575880414,0
1,998,25899,3575880414,3575880414,0
1,998,25900,3575880414,3575880415,1
1,998,25901,3575880414,3575880416,2
1,998,25902,3575880414,3575880417,3
1,998,25903,3575880414,3575880417,3
1,998,25904,3575880414,3575880417,3
1,998,25905,3575880414,3575880418,4
1,998,25906,3575880414,3575880418,4
1,998,25907,3575880414,3575880418,4
1,998,25908,3575880414,3575880419,5
1,998,25909,3575880414,3575880419,5
1,998,25910,3575880414,3575880419,5
1,998,25911,3575880414,3575880420,6
1,998,25912,3575880414,3575880420,6
1,998,25913,3575880414,3575880421,7
1,998,25914,3575880414,3575880421,7
1,998,25915,3575880414,3575880422,8
1,998,25916,3575880414,3575880422,8
1,998,25917,3575880414,3575880424,10
1,998,25918,3575880414,3575880424,10
1,998,25919,3575880414,3575880424,10
1,998,25920,3575880414,3575880424,10
1,998,25921,3575880414,3575880426,12
1,998,25922,3575880414,3575880430,16
1,998,25923,3575880414,3575880431,17
1,998,25924,3575880414,3575880431,17
1,998,25925,3575880414,3575880431,17
1,998,25926,3575880414,3575880431,17
1,998,25927,3575880414,3575880431,17
1,998,25928,3575880414,3575880432,18
1,998,25929,3575880414,3575880433,19
1,998,25930,3575880414,3575880433,19
1,998,25931,3575880414,3575880435,21
1,998,25932,3575880414,3575880436,22
1,998,25933,3575880414,3575880436,22
1,998,25934,3575880414,3575880438,24
1,998,25935,3575880414,3575880438,24
1,998,25936,3575880414,3575880440,26
1,998,25937,3575880414,3575880441,27
1,998,25938,3575880414,3575880443,29
1,998,25939,3575880414,3575880443,29
1,998,25940,3575880414,3575880443,29
1,998,25941,3575880414,3575880443,29
1,998,25942,3575880414,3575880445,31
1,998,25943,3575880414,3575880445,31
1,998,25944,3575880414,3575880445,31
1,998,25945,3575880414,3575880445,31
1,998,25946,3575880414,3575880446,32
1,998,25947,3575880414,3575880446,32
1,998,25948,3575880414,3575880447,33
1,998,25949,3575880414,3575880448,34
1,998,25950,3575880414,3575880448,34
1,998,25951,3575880414,3575880448,34
1,998,25952,3575880414,3575880450,36
1,998,25953,3575880414,3575880450,36
1,998,25954,3575880414,3575880450,36
1,998,25955,3575880414,3575880451,37
1,998,25956,3575880414,3575880451,37
1,998,25957,3575880414,3575880453,39
1,998,25958,3575880414,3575880454,40
1,998,25959,3575880414,3575880454,40
1,998,25960,3575880414,3575880455,41
1,998,25961,3575880414,3575880456,42
1,998,25962,3575880414,3575880456,42
1,998,25963,3575880414,3575880456,42
1,998,25964,3575880414,3575880456,42
1,998,25965,3575880414,3575880456,42
1,998,25966,3575880414,3575880459,45
1,998,25967,3575880414,3575880459,45
1,998,25968,3575880414,3575880461,47
1,998,25969,3575880414,3575880461,47
1,998,25970,3575880414,3575880462,48
1,999,25971,3575880477,3575880477,0
1,999,25972,3575880477,3575880477,0
1,999,25973,3575880477,3575880477,0
1,999,25974,3575880477,3575880477,0
1,999,25975,3575880477,3575880477,0
1,999,25976,3575880477,3575880477,0
1,999,25977,3575880477,3575880477,0
1,999,25978,3575880477,3575880477,0
1,999,25979,3575880477,3575880480,3
1,999,25980,3575880477,3575880480,3
1,999,25981,3575880477,3575880481,4
1,999,25982,3575880477,3575880481,4
1,999,25983,3575880477,3575880483,6
1,999,25984,3575880477,3575880485,8
1,999,25985,3575880477,3575880486,9
1,999,25986,3575880477,3575880486,9
1,999,25987,3575880477,3575880486,9
1,999,25988,3575880477,3575880487,10
1,999,25989,3575880477,3575880487,10
1,999,25990,3575880477,3575880487,10
1,999,25991,3575880477,3575880487,10
1,999,25992,3575880477,3575880491,14
1,999,25993,3575880477,3575880491,14
1,999,25994,3575880477,3575880493,16
1,999,25995,3575880477,3575880493,16
1,999,25996,3575880477,3575880494,17
1,999,25997,3575880477,3575880497,20
1,999,25998,3575880477,3575880499,22
1,999,25999,3575880477,3575880499,22
1,999,26000,3575880477,3575880499,22
1,999,26001,3575880477,3575880501,24
1,999,26002,3575880477,3575880501,24
1,999,26003,3575880477,3575880504,27
1,999,26004,3575880477,3575880504,27
1,999,26005,3575880477,3575880504,27
1,999,26006,3575880477,3575880504,27
1,999,26007,3575880477,3575880504,27
1,999,26008,3575880477,3575880505,28
1,999,26009,3575880477,3575880505,28
1,999,26010,3575880477,3575880507,30
1,999,26011,3575880477,3575880507,30
1,999,26012,3575880477,3575880508,31
1,999,26013,3575880477,3575880508,31
1,999,26014,3575880477,3575880509,32
1,999,26015,3575880477,3575880511,34
1,999,26016,3575880477,3575880512,35
1,999,26017,3575880477,3575880512,35
1,999,26018,3575880477,3575880514,37
1,999,26019,3575880477,3575880514,37
1,999,26020,3575880477,3575880517,40
1,999,26021,3575880477,3575880519,42
1,999,26022,3575880477,3575880519,42
1,999,26023,3575880477,3575880519,42
1,999,26024,3575880477,3575880522,45
1,999,26025,3575880477,3575880522,45
1,999,26026,3575880477,3575880523,46
1,999,26027,3575880477,3575880524,47
1,999,26028,3575880477,3575880525,48
1,999,26029,3575880477,3575880525,48
1,999,26030,3575880477,3575880526,49
1,999,26031,3575880477,3575880526,49
1,1000,26032,3575880538,3575880538,0
1,1000,26033,3575880538,3575880538,0
1,1000,26034,3575880538,3575880538,0
1,1000,26035,3575880538,3575880538,0
1,1000,26036,3575880538,3575880538,0
1,1000,26037,3575880538,3575880538,0
1,1000,26038,3575880538,3575880538,0
1,1000,26039,3575880538,3575880538,0
1,1000,26040,3575880538,3575880539,1
1,1000,26041,3575880538,3575880539,1
1,1000,26042,3575880538,3575880539,1
1,1000,26043,3575880538,3575880540,2
1,1000,26044,3575880538,3575880543,5
1,1000,26045,3575880538,3575880543,5
1,1000,26046,3575880538,3575880544,6
1,1000,26047,3575880538,3575880546,8
1,1000,26048,3575880538,3575880547,9
1,1000,26049,3575880538,3575880549,11
1,1000,26050,3575880538,3575880550,12
1,1000,26051,3575880538,3575880552,14
1,1000,26052,3575880538,3575880552,14
1,1000,26053,3575880538,3575880553,15
1,1000,26054,3575880538,3575880555,17
1,1000,26055,3575880538,3575880555,17
1,1000,26056,3575880538,3575880556,18
1,1000,26057,3575880538,3575880556,18
1,1000,26058,3575880538,3575880557,19
1,1000,26059,3575880538,3575880558,20
1,1000,26060,3575880538,3575880560,22
1,1000,26061,3575880538,3575880560,22
1,1000,26062,3575880538,3575880560,22
1,1000,26063,3575880538,3575880562,24
1,1000,26064,3575880538,3575880563,25
1,1000,26065,3575880538,3575880563,25
1,1000,26066,3575880538,3575880564,26
1,1000,26067,3575880538,3575880565,27
1,1000,26068,3575880538,3575880565,27
1,1000,26069,3575880538,3575880565,27
1,1000,26070,3575880538,3575880569,31
1,1000,26071,3575880538,3575880570,32
1,1000,26072,3575880538,3575880573,35
1,1000,26073,3575880538,3575880574,36
1,1000,26074,3575880538,3575880575,37
1,1000,26075,3575880538,3575880575,37
1,1000,26076,3575880538,3575880576,38
1,1000,26077,3575880538,3575880576,38
1,1000,26078,3575880538,3575880577,39
1,1000,26079,3575880538,3575880577,39
1,1000,26080,3575880538,3575880578,40
1,1000,26081,3575880538,3575880578,40
1,1000,26082,3575880538,3575880578,40
1,1000,26083,3575880538,3575880579,41
1,1000,26084,3575880538,3575880580,42
1,1000,26085,3575880538,3575880580,42
1,1000,26086,3575880538,3575880582,44
1,1000,26087,3575880538,3575880582,44
1,1000,26088,3575880538,3575880582,44
1,1000,26089,3575880538,3575880583,45
1,1000,26090,3575880538,3575880583,45
1,1000,26091,3575880538,3575880583,45
1,1000,26092,3575880538,3575880584,46
1,1000,26093,3575880538,3575880585,47
1,1000,26094,3575880538,3575880585,47
1,1000,26095,3575880538,3575880585,47
1,1000,26096,3575880538,3575880586,48
1,1000,26097,3575880538,3575880588,50
1,1001,26098,3575880602,3575880602,0
1,1001,26099,3575880602,3575880602,0
1,1001,26100,3575880602,3575880602,0
1,1001,26101,3575880602,3575880602,0
1,1001,26102,3575880602,3575880602,0
1,1001,26103,3575880602,3575880602,0
1,1001,26104,3575880602,3575880602,0
1,1001,26105,3575880602,3575880602,0
1,1001,26106,3575880602,3575880602,0
1,1001,26107,3575880602,3575880602,0
1,1001,26108,3575880602,3575880602,0
1,1001,26109,3575880602,3575880602,0
1,1001,26110,3575880602,3575880602,0
1,1001,26111,3575880602,3575880602,0
1,1001,26112,3575880602,3575880602,0
1,1001,26113,3575880602,3575880602,0
1,1001,26114,3575880602,3575880602,0
1,1001,26115,3575880602,3575880602,0
1,1001,26116,3575880602,3575880603,1
1,1001,26117,3575880602,3575880604,2
1,1001,26118,3575880602,3575880604,2
1,1001,26119,3575880602,3575880605,3
1,1001,26120,3575880602,3575880605,3
1,1001,26121,3575880602,3575880606,4
1,1001,26122,3575880602,3575880608,6
1,1001,26123,3575880602,3575880608,6
1,1001,26124,3575880602,3575880609,7
1,1001,26125,3575880602,3575880610,8
1,1001,26126,3575880602,3575880611,9
1,1001,26127,3575880602,3575880613,11
1,1001,26128,3575880602,3575880614,12
1,1001,26129,3575880602,3575880615,13
1,1001,26130,3575880602,3575880616,14
1,1001,26131,3575880602,3575880616,14
1,1001,26132,3575880602,3575880616,14
1,1001,26133,3575880602,3575880617,15
1,1001,26134,3575880602,3575880618,16
1,1001,26135,3575880602,3575880618,16
1,1001,26136,3575880602,3575880618,16
1,1001,26137,3575880602,3575880618,16
1,1001,26138,3575880602,3575880619,17
1,1001,26139,3575880602,3575880619,17
1,1001,26140,3575880602,3575880621,19
1,1001,26141,3575880602,3575880622,20
1,1001,26142,3575880602,3575880623,21
1,1001,26143,3575880602,3575880623,21
1,1001,26144,3575880602,3575880623,21
1,1001,26145,3575880602,3575880624,22
1,1001,26146,3575880602,3575880626,24
1,1001,26147,3575880602,3575880629,27
1,1001,26148,3575880602,3575880629,27
1,1001,26149,3575880602,3575880630,28
1,1001,26150,3575880602,3575880630,28
1,1001,26151,3575880602,3575880631,29
1,1001,26152,3575880602,3575880631,29
1,1001,26153,3575880602,3575880631,29
1,1001,26154,3575880602,3575880632,30
1,1001,26155,3575880602,3575880632,30
1,1001,26156,3575880602,3575880634,32
1,1001,26157,3575880602,3575880635,33
1,1001,26158,3575880602,3575880635,33
1,1001,26159,3575880602,3575880637,35
1,1001,26160,3575880602,3575880637,35
1,1001,26161,3575880602,3575880638,36
1,1001,26162,3575880602,3575880639,37
1,1001,26163,3575880602,3575880640,38
1,1001,26164,3575880602,3575880642,40
1,1001,26165,3575880602,3575880643,41
1,1001,26166,3575880602,3575880643,41
1,1001,26167,3575880602,3575880644,42
1,1001,26168,3575880602,3575880644,42
1,1001,26169,3575880602,3575880644,42
1,1001,26170,3575880602,3575880645,43
1,1001,26171,3575880602,3575880645,43
1,1001,26172,3575880602,3575880645,43
1,1001,26173,3575880602,3575880645,43
1,1001,26174,3575880602,3575880646,44
1,1001,26175,3575880602,3575880647,45
1,1001,26176,3575880602,3575880647,45
1,1001,26177,3575880602,3575880647,45
1,1001,26178,3575880602,3575880648,46
1,1001,26179,3575880602,3575880650,48
1,1001,26180,3575880602,3575880651,49
1,1001,26181,3575880602,3575880651,49
1,1002,26182,3575880666,3575880666,0
1,1002,26183,3575880666,3575880666,0
1,1002,26184,3575880666,3575880666,0
1,1002,26185,3575880666,3575880666,0
1,1002,26186,3575880666,3575880666,0
1,1002,26187,3575880666,3575880666,0
1,1002,26188,3575880666,3575880666,0
1,1002,26189,3575880666,3575880666,0
1,1002,26190,3575880666,3575880666,0
1,1002,26191,3575880666,3575880666,0
1,1002,26192,3575880666,3575880666,0
1,1002,26193,3575880666,3575880666,0
1,1002,26194,3575880666,3575880666,0
1,1002,26195,3575880666,3575880666,0
1,1002,26196,3575880666,3575880666,0
1,1002,26197,3575880666,3575880666,0
1,1002,26198,3575880666,3575880666,0
1,1002,26199,3575880666,3575880667,1
1,1002,26200,3575880666,3575880668,2
1,1002,26201,3575880666,3575880669,3
1,1002,26202,3575880666,3575880680,14
1,1002,26203,3575880666,3575880680,14
1,1002,26204,3575880666,3575880681,15
1,1002,26205,3575880666,3575880681,15
1,1002,26206,3575880666,3575880683,17
1,1002,26207,3575880666,3575880684,18
1,1002,26208,3575880666,3575880686,20
1,1002,26209,3575880666,3575880686,20
1,1002,26210,3575880666,3575880686,20
1,1002,26211,3575880666,3575880686,20
1,1002,26212,3575880666,3575880687,21
1,1002,26213,3575880666,3575880687,21
1,1002,26214,3575880666,3575880687,21
1,1002,26215,3575880666,3575880688,22
1,1002,26216,3575880666,3575880691,25
1,1002,26217,3575880666,3575880691,25
1,1002,26218,3575880666,3575880693,27
1,1002,26219,3575880666,3575880693,27
1,1002,26220,3575880666,3575880697,31
1,1002,26221,3575880666,3575880699,33
1,1002,26222,3575880666,3575880700,34
1,1002,26223,3575880666,3575880700,34
1,1002,26224,3575880666,3575880701,35
1,1002,26225,3575880666,3575880702,36
1,1002,26226,3575880666,3575880704,38
1,1002,26227,3575880666,3575880704,38
1,1002,26228,3575880666,3575880704,38
1,1002,26229,3575880666,3575880704,38
1,1002,26230,3575880666,3575880705,39
1,1002,26231,3575880666,3575880705,39
1,1002,26232,3575880666,3575880706,40
1,1002,26233,3575880666,3575880707,41
1,1002,26234,3575880666,3575880707,41
1,1002,26235,3575880666,3575880707,41
1,1002,26236,3575880666,3575880708,42
1,1002,26237,3575880666,3575880712,46
1,1002,26238,3575880666,3575880712,46
1,1002,26239,3575880666,3575880713,47
1,1002,26240,3575880666,3575880713,47
1,1002,26241,3575880666,3575880714,48
1,1002,26242,3575880666,3575880714,48
1,1003,26243,3575880730,3575880730,0
1,1003,26244,3575880730,3575880730,0
1,1003,26245,3575880730,3575880730,0
1,1003,26246,3575880730,3575880730,0
1,1003,26247,3575880730,3575880730,0
1,1003,26248,3575880730,3575880730,0
1,1003,26249,3575880730,3575880730,0
1,1003,26250,3575880730,3575880730,0
1,1003,26251,3575880730,3575880730,0
1,1003,26252,3575880730,3575880730,0
1,1003,26253,3575880730,3575880730,0
1,1003,26254,3575880730,3575880730,0
1,1003,26255,3575880730,3575880730,0
1,1003,26256,3575880730,3575880730,0
1,1003,26257,3575880730,3575880731,1
1,1003,26258,3575880730,3575880732,2
1,1003,26259,3575880730,3575880733,3
1,1003,26260,3575880730,3575880735,5
1,1003,26261,3575880730,3575880736,6
1,1003,26262,3575880730,3575880739,9
1,1003,26263,3575880730,3575880739,9
1,1003,26264,3575880730,3575880740,10
1,1003,26265,3575880730,3575880741,11
1,1003,26266,3575880730,3575880743,13
1,1003,26267,3575880730,3575880743,13
1,1003,26268,3575880730,3575880743,13
1,1003,26269,3575880730,3575880746,16
1,1003,26270,3575880730,3575880746,16
1,1003,26271,3575880730,3575880749,19
1,1003,26272,3575880730,3575880749,19
1,1003,26273,3575880730,3575880750,20
1,1003,26274,3575880730,3575880750,20
1,1003,26275,3575880730,3575880752,22
1,1003,26276,3575880730,3575880752,22
1,1003,26277,3575880730,3575880753,23
1,1003,26278,3575880730,3575880754,24
1,1003,26279,3575880730,3575880754,24
1,1003,26280,3575880730,3575880754,24
1,1003,26281,3575880730,3575880755,25
1,1003,26282,3575880730,3575880756,26
1,1003,26283,3575880730,3575880757,27
1,1003,26284,3575880730,3575880757,27
1,1003,26285,3575880730,3575880758,28
1,1003,26286,3575880730,3575880760,30
1,1003,26287,3575880730,3575880761,31
1,1003,26288,3575880730,3575880761,31
1,1003,26289,3575880730,3575880761,31
1,1003,26290,3575880730,3575880762,32
1,1003,26291,3575880730,3575880762,32
1,1003,26292,3575880730,3575880764,34
1,1003,26293,3575880730,3575880764,34
1,1003,26294,3575880730,3575880764,34
1,1003,26295,3575880730,3575880765,35
1,1003,26296,3575880730,3575880766,36
1,1003,26297,3575880730,3575880769,39
1,1003,26298,3575880730,3575880769,39
1,1003,26299,3575880730,3575880773,43
1,1003,26300,3575880730,3575880774,44
1,1003,26301,3575880730,3575880774,44
1,1003,26302,3575880730,3575880774,44
1,1003,26303,3575880730,3575880776,46
1,1003,26304,3575880730,3575880776,46
1,1003,26305,3575880730,3575880777,47
1,1003,26306,3575880730,3575880777,47
1,1003,26307,3575880730,3575880778,48
1,1003,26308,3575880730,3575880779,49
1,1003,26309,3575880730,3575880779,49
1,1003,26310,3575880730,3575880779,49
1,1003,26311,3575880730,3575880780,50
1,1004,26312,3575880794,3575880794,0
1,1004,26313,3575880794,3575880794,0
1,1004,26314,3575880794,3575880794,0
1,1004,26315,3575880794,3575880794,0
1,1004,26316,3575880794,3575880794,0
1,1004,26317,3575880794,3575880794,0
1,1004,26318,3575880794,3575880794,0
1,1004,26319,3575880794,3575880794,0
1,1004,26320,3575880794,3575880794,0
1,1004,26321,3575880794,3575880794,0
1,1004,26322,3575880794,3575880794,0
1,1004,26323,3575880794,3575880794,0
1,1004,26324,3575880794,3575880794,0
1,1004,26325,3575880794,3575880794,0
1,1004,26326,3575880794,3575880794,0
1,1004,26327,3575880794,3575880794,0
1,1004,26328,3575880794,3575880794,0
1,1004,26329,3575880794,3575880794,0
1,1004,26330,3575880794,3575880794,0
1,1004,26331,3575880794,3575880794,0
1,1004,26332,3575880794,3575880794,0
1,1004,26333,3575880794,3575880795,1
1,1004,26334,3575880794,3575880795,1
1,1004,26335,3575880794,3575880798,4
1,1004,26336,3575880794,3575880798,4
1,1004,26337,3575880794,3575880800,6
1,1004,26338,3575880794,3575880800,6
1,1004,26339,3575880794,3575880801,7
1,1004,26340,3575880794,3575880801,7
1,1004,26341,3575880794,3575880802,8
1,1004,26342,3575880794,3575880802,8
1,1004,26343,3575880794,3575880803,9
1,1004,26344,3575880794,3575880803,9
1,1004,26345,3575880794,3575880804,10
1,1004,26346,3575880794,3575880805,11
1,1004,26347,3575880794,3575880805,11
1,1004,26348,3575880794,3575880805,11
1,1004,26349,3575880794,3575880809,15
1,1004,26350,3575880794,3575880809,15
1,1004,26351,3575880794,3575880810,16
1,1004,26352,3575880794,3575880811,17
1,1004,26353,3575880794,3575880812,18
1,1004,26354,3575880794,3575880814,20
1,1004,26355,3575880794,3575880816,22
1,1004,26356,3575880794,3575880816,22
1,1004,26357,3575880794,3575880816,22
1,1004,26358,3575880794,3575880817,23
1,1004,26359,3575880794,3575880817,23
1,1004,26360,3575880794,3575880817,23
1,1004,26361,3575880794,3575880818,24
1,1004,26362,3575880794,3575880818,24
1,1004,26363,3575880794,3575880818,24
1,1004,26364,3575880794,3575880818,24
1,1004,26365,3575880794,3575880819,25
1,1004,26366,3575880794,3575880819,25
1,1004,26367,3575880794,3575880819,25
1,1004,26368,3575880794,3575880820,26
1,1004,26369,3575880794,3575880822,28
1,1004,26370,3575880794,3575880822,28
1,1004,26371,3575880794,3575880823,29
1,1004,26372,3575880794,3575880823,29
1,1004,26373,3575880794,3575880824,30
1,1004,26374,3575880794,3575880824,30
1,1004,26375,3575880794,3575880825,31
1,1004,26376,3575880794,3575880829,35
1,1004,26377,3575880794,3575880830,36
1,1004,26378,3575880794,3575880830,36
1,1004,26379,3575880794,3575880830,36
1,1004,26380,3575880794,3575880830,36
1,1004,26381,3575880794,3575880830,36
1,1004,26382,3575880794,3575880831,37
1,1004,26383,3575880794,3575880832,38
1,1004,26384,3575880794,3575880833,39
1,1004,26385,3575880794,3575880834,40
1,1004,26386,3575880794,3575880834,40
1,1004,26387,3575880794,3575880835,41
1,1004,26388,3575880794,3575880836,42
1,1004,26389,3575880794,3575880837,43
1,1004,26390,3575880794,3575880838,44
1,1004,26391,3575880794,3575880839,45
1,1004,26392,3575880794,3575880840,46
1,1004,26393,3575880794,3575880841,47
1,1004,26394,3575880794,3575880843,49
1,1004,26395,3575880794,3575880843,49
1,1004,26396,3575880794,3575880844,50
1,1005,26397,3575880855,3575880855,0
1,1005,26398,3575880855,3575880855,0
1,1005,26399,3575880855,3575880855,0
1,1005,26400,3575880855,3575880855,0
1,1005,26401,3575880855,3575880855,0
1,1005,26402,3575880855,3575880855,0
1,1005,26403,3575880855,3575880855,0
1,1005,26404,3575880855,3575880855,0
1,1005,26405,3575880855,3575880855,0
1,1005,26406,3575880855,3575880855,0
1,1005,26407,3575880855,3575880855,0
1,1005,26408,3575880855,3575880855,0
1,1005,26409,3575880855,3575880855,0
1,1005,26410,3575880855,3575880855,0
1,1005,26411,3575880855,3575880855,0
1,1005,26412,3575880855,3575880855,0
1,1005,26413,3575880855,3575880855,0
1,1005,26414,3575880855,3575880855,0
1,1005,26415,3575880855,3575880857,2
1,1005,26416,3575880855,3575880857,2
1,1005,26417,3575880855,3575880858,3
1,1005,26418,3575880855,3575880858,3
1,1005,26419,3575880855,3575880859,4
1,1005,26420,3575880855,3575880861,6
1,1005,26421,3575880855,3575880861,6
1,1005,26422,3575880855,3575880864,9
1,1005,26423,3575880855,3575880865,10
1,1005,26424,3575880855,3575880866,11
1,1005,26425,3575880855,3575880867,12
1,1005,26426,3575880855,3575880868,13
1,1005,26427,3575880855,3575880868,13
1,1005,26428,3575880855,3575880869,14
1,1005,26429,3575880855,3575880879,24
1,1005,26430,3575880855,3575880880,25
1,1005,26431,3575880855,3575880881,26
1,1005,26432,3575880855,3575880882,27
1,1005,26433,3575880855,3575880883,28
1,1005,26434,3575880855,3575880886,31
1,1005,26435,3575880855,3575880886,31
1,1005,26436,3575880855,3575880886,31
1,1005,26437,3575880855,3575880887,32
1,1005,26438,3575880855,3575880887,32
1,1005,26439,3575880855,3575880887,32
1,1005,26440,3575880855,3575880887,32
1,1005,26441,3575880855,3575880888,33
1,1005,26442,3575880855,3575880891,36
1,1005,26443,3575880855,3575880892,37
1,1005,26444,3575880855,3575880893,38
1,1005,26445,3575880855,3575880893,38
1,1005,26446,3575880855,3575880897,42
1,1005,26447,3575880855,3575880899,44
1,1005,26448,3575880855,3575880899,44
1,1005,26449,3575880855,3575880899,44
1,1005,26450,3575880855,3575880900,45
1,1005,26451,3575880855,3575880900,45
1,1005,26452,3575880855,3575880902,47
1,1005,26453,3575880855,3575880904,49
1,1005,26454,3575880855,3575880904,49
1,1005,26455,3575880855,3575880904,49
1,1005,26456,3575880855,3575880904,49
1,1005,26457,3575880855,3575880905,50
1,1006,26458,3575880920,3575880920,0
1,1006,26459,3575880920,3575880920,0
1,1006,26460,3575880920,3575880920,0
1,1006,26461,3575880920,3575880920,0
1,1006,26462,3575880920,3575880920,0
1,1006,26463,3575880920,3575880920,0
1,1006,26464,3575880920,3575880920,0
1,1006,26465,3575880920,3575880920,0
1,1006,26466,3575880920,3575880920,0
1,1006,26467,3575880920,3575880920,0
1,1006,26468,3575880920,3575880920,0
1,1006,26469,3575880920,3575880920,0
1,1006,26470,3575880920,3575880920,0
1,1006,26471,3575880920,3575880920,0
1,1006,26472,3575880920,3575880920,0
1,1006,26473,3575880920,3575880922,2
1,1006,26474,3575880920,3575880924,4
1,1006,26475,3575880920,3575880924,4
1,1006,26476,3575880920,3575880925,5
1,1006,26477,3575880920,3575880925,5
1,1006,26478,3575880920,3575880926,6
1,1006,26479,3575880920,3575880927,7
1,1006,26480,3575880920,3575880927,7
1,1006,26481,3575880920,3575880927,7
1,1006,26482,3575880920,3575880928,8
1,1006,26483,3575880920,3575880929,9
1,1006,26484,3575880920,3575880931,11
1,1006,26485,3575880920,3575880931,11
1,1006,26486,3575880920,3575880932,12
1,1006,26487,3575880920,3575880932,12
1,1006,26488,3575880920,3575880932,12
1,1006,26489,3575880920,3575880935,15
1,1006,26490,3575880920,3575880935,15
1,1006,26491,3575880920,3575880939,19
1,1006,26492,3575880920,3575880939,19
1,1006,26493,3575880920,3575880939,19
1,1006,26494,3575880920,3575880940,20
1,1006,26495,3575880920,3575880943,23
1,1006,26496,3575880920,3575880943,23
1,1006,26497,3575880920,3575880944,24
1,1006,26498,3575880920,3575880946,26
1,1006,26499,3575880920,3575880948,28
1,1006,26500,3575880920,3575880949,29
1,1006,26501,3575880920,3575880949,29
1,1006,26502,3575880920,3575880950,30
1,1006,26503,3575880920,3575880950,30
1,1006,26504,3575880920,3575880952,32
1,1006,26505,3575880920,3575880953,33
1,1006,26506,3575880920,3575880953,33
1,1006,26507,3575880920,3575880953,33
1,1006,26508,3575880920,3575880955,35
1,1006,26509,3575880920,3575880955,35
1,1006,26510,3575880920,3575880957,37
1,1006,26511,3575880920,3575880957,37
1,1006,26512,3575880920,3575880959,39
1,1006,26513,3575880920,3575880960,40
1,1006,26514,3575880920,3575880961,41
1,1006,26515,3575880920,3575880961,41
1,1006,26516,3575880920,3575880961,41
1,1006,26517,3575880920,3575880962,42
1,1006,26518,3575880920,3575880963,43
1,1006,26519,3575880920,3575880963,43
1,1006,26520,3575880920,3575880963,43
1,1006,26521,3575880920,3575880963,43
1,1006,26522,3575880920,3575880964,44
1,1006,26523,3575880920,3575880965,45
1,1006,26524,3575880920,3575880965,45
1,1006,26525,3575880920,3575880970,50
1,1007,26526,3575880987,3575880987,0
1,1007,26527,3575880987,3575880987,0
1,1007,26528,3575880987,3575880987,0
1,1007,26529,3575880987,3575880988,1
1,1007,26530,3575880987,3575880988,1
1,1007,26531,3575880987,3575880988,1
1,1007,26532,3575880987,3575880988,1
1,1007,26533,3575880987,3575880988,1
1,1007,26534,3575880987,3575880988,1
1,1007,26535,3575880987,3575880988,1
1,1007,26536,3575880987,3575880988,1
1,1007,26537,3575880987,3575880988,1
1,1007,26538,3575880987,3575880988,1
1,1007,26539,3575880987,3575880988,1
1,1007,26540,3575880987,3575880988,1
1,1007,26541,3575880987,3575880988,1
1,1007,26542,3575880987,3575880988,1
1,1007,26543,3575880987,3575880988,1
1,1007,26544,3575880987,3575880988,1
1,1007,26545,3575880987,3575880988,1
1,1007,26546,3575880987,3575880988,1
1,1007,26547,3575880987,3575880988,1
1,1007,26548,3575880987,3575880988,1
1,1007,26549,3575880987,3575880988,1
1,1007,26550,3575880987,3575880988,1
1,1007,26551,3575880987,3575880989,2
1,1007,26552,3575880987,3575880990,3
1,1007,26553,3575880987,3575880991,4
1,1007,26554,3575880987,3575880992,5
1,1007,26555,3575880987,3575880993,6
1,1007,26556,3575880987,3575880993,6
1,1007,26557,3575880987,3575880994,7
1,1007,26558,3575880987,3575880994,7
1,1007,26559,3575880987,3575880995,8
1,1007,26560,3575880987,3575880995,8
1,1007,26561,3575880987,3575880996,9
1,1007,26562,3575880987,3575880998,11
1,1007,26563,3575880987,3575880999,12
1,1007,26564,3575880987,3575880999,12
1,1007,26565,3575880987,3575881001,14
1,1007,26566,3575880987,3575881001,14
1,1007,26567,3575880987,3575881002,15
1,1007,26568,3575880987,3575881002,15
1,1007,26569,3575880987,3575881003,16
1,1007,26570,3575880987,3575881003,16
1,1007,26571,3575880987,3575881004,17
1,1007,26572,3575880987,3575881005,18
1,1007,26573,3575880987,3575881005,18
1,1007,26574,3575880987,3575881005,18
1,1007,26575,3575880987,3575881008,21
1,1007,26576,3575880987,3575881009,22
1,1007,26577,3575880987,3575881010,23
1,1007,26578,3575880987,3575881010,23
1,1007,26579,3575880987,3575881011,24
1,1007,26580,3575880987,3575881012,25
1,1007,26581,3575880987,3575881014,27
1,1007,26582,3575880987,3575881016,29
1,1007,26583,3575880987,3575881016,29
1,1007,26584,3575880987,3575881016,29
1,1007,26585,3575880987,3575881017,30
1,1007,26586,3575880987,3575881017,30
1,1007,26587,3575880987,3575881018,31
1,1007,26588,3575880987,3575881018,31
1,1007,26589,3575880987,3575881018,31
1,1007,26590,3575880987,3575881018,31
1,1007,26591,3575880987,3575881018,31
1,1007,26592,3575880987,3575881018,31
1,1007,26593,3575880987,3575881019,32
1,1007,26594,3575880987,3575881020,33
1,1007,26595,3575880987,3575881020,33
1,1007,26596,3575880987,3575881022,35
1,1007,26597,3575880987,3575881022,35
1,1007,26598,3575880987,3575881023,36
1,1007,26599,3575880987,3575881023,36
1,1007,26600,3575880987,3575881024,37
1,1007,26601,3575880987,3575881024,37
1,1007,26602,3575880987,3575881025,38
1,1007,26603,3575880987,3575881028,41
1,1007,26604,3575880987,3575881029,42
1,1007,26605,3575880987,3575881030,43
1,1007,26606,3575880987,3575881030,43
1,1007,26607,3575880987,3575881030,43
1,1007,26608,3575880987,3575881031,44
1,1007,26609,3575880987,3575881031,44
1,1007,26610,3575880987,3575881032,45
1,1007,26611,3575880987,3575881034,47
1,1007,26612,3575880987,3575881035,48
1,1007,26613,3575880987,3575881035,48
1,1007,26614,3575880987,3575881037,50
1,1008,26615,3575881049,3575881049,0
1,1008,26616,3575881049,3575881049,0
1,1008,26617,3575881049,3575881049,0
1,1008,26618,3575881049,3575881049,0
1,1008,26619,3575881049,3575881049,0
1,1008,26620,3575881049,3575881049,0
1,1008,26621,3575881049,3575881049,0
1,1008,26622,3575881049,3575881049,0
1,1008,26623,3575881049,3575881049,0
1,1008,26624,3575881049,3575881049,0
1,1008,26625,3575881049,3575881049,0
1,1008,26626,3575881049,3575881049,0
1,1008,26627,3575881049,3575881049,0
1,1008,26628,3575881049,3575881049,0
1,1008,26629,3575881049,3575881049,0
1,1008,26630,3575881049,3575881049,0
1,1008,26631,3575881049,3575881049,0
1,1008,26632,3575881049,3575881050,1
1,1008,26633,3575881049,3575881050,1
1,1008,26634,3575881049,3575881051,2
1,1008,26635,3575881049,3575881051,2
1,1008,26636,3575881049,3575881053,4
1,1008,26637,3575881049,3575881053,4
1,1008,26638,3575881049,3575881054,5
1,1008,26639,3575881049,3575881054,5
1,1008,26640,3575881049,3575881057,8
1,1008,26641,3575881049,3575881057,8
1,1008,26642,3575881049,3575881058,9
1,1008,26643,3575881049,3575881058,9
1,1008,26644,3575881049,3575881058,9
1,1008,26645,3575881049,3575881061,12
1,1008,26646,3575881049,3575881061,12
1,1008,26647,3575881049,3575881062,13
1,1008,26648,3575881049,3575881064,15
1,1008,26649,3575881049,3575881065,16
1,1008,26650,3575881049,3575881067,18
1,1008,26651,3575881049,3575881067,18
1,1008,26652,3575881049,3575881068,19
1,1008,26653,3575881049,3575881068,19
1,1008,26654,3575881049,3575881069,20
1,1008,26655,3575881049,3575881079,30
1,1008,26656,3575881049,3575881081,32
1,1008,26657,3575881049,3575881081,32
1,1008,26658,3575881049,3575881084,35
1,1008,26659,3575881049,3575881086,37
1,1008,26660,3575881049,3575881086,37
1,1008,26661,3575881049,3575881086,37
1,1008,26662,3575881049,3575881087,38
1,1008,26663,3575881049,3575881087,38
1,1008,26664,3575881049,3575881087,38
1,1008,26665,3575881049,3575881087,38
1,1008,26666,3575881049,3575881087,38
1,1008,26667,3575881049,3575881087,38
1,1008,26668,3575881049,3575881091,42
1,1008,26669,3575881049,3575881093,44
1,1008,26670,3575881049,3575881093,44
1,1008,26671,3575881049,3575881093,44
1,1008,26672,3575881049,3575881093,44
1,1008,26673,3575881049,3575881097,48
1,1008,26674,3575881049,3575881099,50
1,1009,26675,3575881117,3575881117,0
1,1009,26676,3575881117,3575881117,0
1,1009,26677,3575881117,3575881117,0
1,1009,26678,3575881117,3575881117,0
1,1009,26679,3575881117,3575881117,0
1,1009,26680,3575881117,3575881117,0
1,1009,26681,3575881117,3575881117,0
1,1009,26682,3575881117,3575881117,0
1,1009,26683,3575881117,3575881117,0
1,1009,26684,3575881117,3575881117,0
1,1009,26685,3575881117,3575881117,0
1,1009,26686,3575881117,3575881117,0
1,1009,26687,3575881117,3575881117,0
1,1009,26688,3575881117,3575881117,0
1,1009,26689,3575881117,3575881117,0
1,1009,26690,3575881117,3575881117,0
1,1009,26691,3575881117,3575881117,0
1,1009,26692,3575881117,3575881117,0
1,1009,26693,3575881117,3575881117,0
1,1009,26694,3575881117,3575881117,0
1,1009,26695,3575881117,3575881117,0
1,1009,26696,3575881117,3575881118,1
1,1009,26697,3575881117,3575881119,2
1,1009,26698,3575881117,3575881119,2
1,1009,26699,3575881117,3575881120,3
1,1009,26700,3575881117,3575881120,3
1,1009,26701,3575881117,3575881122,5
1,1009,26702,3575881117,3575881124,7
1,1009,26703,3575881117,3575881124,7
1,1009,26704,3575881117,3575881125,8
1,1009,26705,3575881117,3575881126,9
1,1009,26706,3575881117,3575881126,9
1,1009,26707,3575881117,3575881126,9
1,1009,26708,3575881117,3575881127,10
1,1009,26709,3575881117,3575881128,11
1,1009,26710,3575881117,3575881128,11
1,1009,26711,3575881117,3575881129,12
1,1009,26712,3575881117,3575881130,13
1,1009,26713,3575881117,3575881132,15
1,1009,26714,3575881117,3575881132,15
1,1009,26715,3575881117,3575881133,16
1,1009,26716,3575881117,3575881134,17
1,1009,26717,3575881117,3575881135,18
1,1009,26718,3575881117,3575881136,19
1,1009,26719,3575881117,3575881138,21
1,1009,26720,3575881117,3575881139,22
1,1009,26721,3575881117,3575881140,23
1,1009,26722,3575881117,3575881140,23
1,1009,26723,3575881117,3575881143,26
1,1009,26724,3575881117,3575881144,27
1,1009,26725,3575881117,3575881144,27
1,1009,26726,3575881117,3575881146,29
1,1009,26727,3575881117,3575881147,30
1,1009,26728,3575881117,3575881149,32
1,1009,26729,3575881117,3575881149,32
1,1009,26730,3575881117,3575881149,32
1,1009,26731,3575881117,3575881150,33
1,1009,26732,3575881117,3575881152,35
1,1009,26733,3575881117,3575881152,35
1,1009,26734,3575881117,3575881153,36
1,1009,26735,3575881117,3575881153,36
1,1009,26736,3575881117,3575881155,38
1,1009,26737,3575881117,3575881156,39
1,1009,26738,3575881117,3575881157,40
1,1009,26739,3575881117,3575881157,40
1,1009,26740,3575881117,3575881159,42
1,1009,26741,3575881117,3575881160,43
1,1009,26742,3575881117,3575881161,44
1,1009,26743,3575881117,3575881161,44
1,1009,26744,3575881117,3575881161,44
1,1009,26745,3575881117,3575881162,45
1,1009,26746,3575881117,3575881163,46
1,1009,26747,3575881117,3575881163,46
1,1009,26748,3575881117,3575881163,46
1,1009,26749,3575881117,3575881164,47
1,1009,26750,3575881117,3575881165,48
1,1009,26751,3575881117,3575881165,48
1,1010,26752,3575881184,3575881184,0
1,1010,26753,3575881184,3575881184,0
1,1010,26754,3575881184,3575881184,0
1,1010,26755,3575881184,3575881184,0
1,1010,26756,3575881184,3575881184,0
1,1010,26757,3575881184,3575881184,0
1,1010,26758,3575881184,3575881184,0
1,1010,26759,3575881184,3575881184,0
1,1010,26760,3575881184,3575881184,0
1,1010,26761,3575881184,3575881184,0
1,1010,26762,3575881184,3575881184,0
1,1010,26763,3575881184,3575881184,0
1,1010,26764,3575881184,3575881184,0
1,1010,26765,3575881184,3575881184,0
1,1010,26766,3575881184,3575881184,0
1,1010,26767,3575881184,3575881184,0
1,1010,26768,3575881184,3575881184,0
1,1010,26769,3575881184,3575881184,0
1,1010,26770,3575881184,3575881184,0
1,1010,26771,3575881184,3575881184,0
1,1010,26772,3575881184,3575881184,0
1,1010,26773,3575881184,3575881185,1
1,1010,26774,3575881184,3575881185,1
1,1010,26775,3575881184,3575881185,1
1,1010,26776,3575881184,3575881186,2
1,1010,26777,3575881184,3575881190,6
1,1010,26778,3575881184,3575881190,6
1,1010,26779,3575881184,3575881192,8
1,1010,26780,3575881184,3575881194,10
1,1010,26781,3575881184,3575881194,10
1,1010,26782,3575881184,3575881195,11
1,1010,26783,3575881184,3575881195,11
1,1010,26784,3575881184,3575881196,12
1,1010,26785,3575881184,3575881196,12
1,1010,26786,3575881184,3575881197,13
1,1010,26787,3575881184,3575881198,14
1,1010,26788,3575881184,3575881199,15
1,1010,26789,3575881184,3575881200,16
1,1010,26790,3575881184,3575881201,17
1,1010,26791,3575881184,3575881202,18
1,1010,26792,3575881184,3575881202,18
1,1010,26793,3575881184,3575881202,18
1,1010,26794,3575881184,3575881202,18
1,1010,26795,3575881184,3575881202,18
1,1010,26796,3575881184,3575881203,19
1,1010,26797,3575881184,3575881205,21
1,1010,26798,3575881184,3575881205,21
1,1010,26799,3575881184,3575881205,21
1,1010,26800,3575881184,3575881205,21
1,1010,26801,3575881184,3575881206,22
1,1010,26802,3575881184,3575881207,23
1,1010,26803,3575881184,3575881209,25
1,1010,26804,3575881184,3575881209,25
1,1010,26805,3575881184,3575881209,25
1,1010,26806,3575881184,3575881210,26
1,1010,26807,3575881184,3575881211,27
1,1010,26808,3575881184,3575881213,29
1,1010,26809,3575881184,3575881214,30
1,1010,26810,3575881184,3575881216,32
1,1010,26811,3575881184,3575881216,32
1,1010,26812,3575881184,3575881216,32
1,1010,26813,3575881184,3575881217,33
1,1010,26814,3575881184,3575881217,33
1,1010,26815,3575881184,3575881217,33
1,1010,26816,3575881184,3575881218,34
1,1010,26817,3575881184,3575881218,34
1,1010,26818,3575881184,3575881218,34
1,1010,26819,3575881184,3575881218,34
1,1010,26820,3575881184,3575881218,34
1,1010,26821,3575881184,3575881219,35
1,1010,26822,3575881184,3575881219,35
1,1010,26823,3575881184,3575881220,36
1,1010,26824,3575881184,3575881221,37
1,1010,26825,3575881184,3575881222,38
1,1010,26826,3575881184,3575881223,39
1,1010,26827,3575881184,3575881223,39
1,1010,26828,3575881184,3575881223,39
1,1010,26829,3575881184,3575881224,40
1,1010,26830,3575881184,3575881224,40
1,1010,26831,3575881184,3575881225,41
1,1010,26832,3575881184,3575881229,45
1,1010,26833,3575881184,3575881229,45
1,1010,26834,3575881184,3575881230,46
1,1010,26835,3575881184,3575881231,47
1,1010,26836,3575881184,3575881231,47
1,1010,26837,3575881184,3575881232,48
1,1010,26838,3575881184,3575881232,48
1,1010,26839,3575881184,3575881232,48
1,1010,26840,3575881184,3575881232,48
1,1010,26841,3575881184,3575881233,49
1,1010,26842,3575881184,3575881234,50
1,1011,26843,3575881250,3575881250,0
1,1011,26844,3575881250,3575881250,0
1,1011,26845,3575881250,3575881250,0
1,1011,26846,3575881250,3575881250,0
1,1011,26847,3575881250,3575881250,0
1,1011,26848,3575881250,3575881250,0
1,1011,26849,3575881250,3575881250,0
1,1011,26850,3575881250,3575881250,0
1,1011,26851,3575881250,3575881250,0
1,1011,26852,3575881250,3575881250,0
1,1011,26853,3575881250,3575881250,0
1,1011,26854,3575881250,3575881250,0
1,1011,26855,3575881250,3575881250,0
1,1011,26856,3575881250,3575881250,0
1,1011,26857,3575881250,3575881250,0
1,1011,26858,3575881250,3575881250,0
1,1011,26859,3575881250,3575881250,0
1,1011,26860,3575881250,3575881250,0
1,1011,26861,3575881250,3575881250,0
1,1011,26862,3575881250,3575881250,0
1,1011,26863,3575881250,3575881250,0
1,1011,26864,3575881250,3575881251,1
1,1011,26865,3575881250,3575881251,1
1,1011,26866,3575881250,3575881252,2
1,1011,26867,3575881250,3575881253,3
1,1011,26868,3575881250,3575881254,4
1,1011,26869,3575881250,3575881254,4
1,1011,26870,3575881250,3575881254,4
1,1011,26871,3575881250,3575881257,7
1,1011,26872,3575881250,3575881258,8
1,1011,26873,3575881250,3575881258,8
1,1011,26874,3575881250,3575881258,8
1,1011,26875,3575881250,3575881259,9
1,1011,26876,3575881250,3575881260,10
1,1011,26877,3575881250,3575881261,11
1,1011,26878,3575881250,3575881262,12
1,1011,26879,3575881250,3575881263,13
1,1011,26880,3575881250,3575881267,17
1,1011,26881,3575881250,3575881267,17
1,1011,26882,3575881250,3575881267,17
1,1011,26883,3575881250,3575881267,17
1,1011,26884,3575881250,3575881270,20
1,1011,26885,3575881250,3575881279,29
1,1011,26886,3575881250,3575881280,30
1,1011,26887,3575881250,3575881281,31
1,1011,26888,3575881250,3575881281,31
1,1011,26889,3575881250,3575881284,34
1,1011,26890,3575881250,3575881286,36
1,1011,26891,3575881250,3575881286,36
1,1011,26892,3575881250,3575881286,36
1,1011,26893,3575881250,3575881286,36
1,1011,26894,3575881250,3575881287,37
1,1011,26895,3575881250,3575881287,37
1,1011,26896,3575881250,3575881287,37
1,1011,26897,3575881250,3575881287,37
1,1011,26898,3575881250,3575881287,37
1,1011,26899,3575881250,3575881290,40
1,1011,26900,3575881250,3575881293,43
1,1011,26901,3575881250,3575881293,43
1,1011,26902,3575881250,3575881294,44
1,1011,26903,3575881250,3575881294,44
1,1011,26904,3575881250,3575881297,47
1,1011,26905,3575881250,3575881298,48
1,1011,26906,3575881250,3575881299,49
1,1011,26907,3575881250,3575881300,50
1,1012,26908,3575881311,3575881311,0
1,1012,26909,3575881311,3575881311,0
1,1012,26910,3575881311,3575881311,0
1,1012,26911,3575881311,3575881311,0
1,1012,26912,3575881311,3575881311,0
1,1012,26913,3575881311,3575881311,0
1,1012,26914,3575881311,3575881311,0
1,1012,26915,3575881311,3575881311,0
1,1012,26916,3575881311,3575881311,0
1,1012,26917,3575881311,3575881311,0
1,1012,26918,3575881311,3575881311,0
1,1012,26919,3575881311,3575881311,0
1,1012,26920,3575881311,3575881311,0
1,1012,26921,3575881311,3575881311,0
1,1012,26922,3575881311,3575881311,0
1,1012,26923,3575881311,3575881312,1
1,1012,26924,3575881311,3575881313,2
1,1012,26925,3575881311,3575881314,3
1,1012,26926,3575881311,3575881314,3
1,1012,26927,3575881311,3575881318,7
1,1012,26928,3575881311,3575881319,8
1,1012,26929,3575881311,3575881319,8
1,1012,26930,3575881311,3575881320,9
1,1012,26931,3575881311,3575881320,9
1,1012,26932,3575881311,3575881322,11
1,1012,26933,3575881311,3575881324,13
1,1012,26934,3575881311,3575881324,13
1,1012,26935,3575881311,3575881326,15
1,1012,26936,3575881311,3575881326,15
1,1012,26937,3575881311,3575881327,16
1,1012,26938,3575881311,3575881327,16
1,1012,26939,3575881311,3575881328,17
1,1012,26940,3575881311,3575881328,17
1,1012,26941,3575881311,3575881330,19
1,1012,26942,3575881311,3575881331,20
1,1012,26943,3575881311,3575881332,21
1,1012,26944,3575881311,3575881332,21
1,1012,26945,3575881311,3575881333,22
1,1012,26946,3575881311,3575881333,22
1,1012,26947,3575881311,3575881335,24
1,1012,26948,3575881311,3575881335,24
1,1012,26949,3575881311,3575881338,27
1,1012,26950,3575881311,3575881340,29
1,1012,26951,3575881311,3575881340,29
1,1012,26952,3575881311,3575881340,29
1,1012,26953,3575881311,3575881343,32
1,1012,26954,3575881311,3575881344,33
1,1012,26955,3575881311,3575881344,33
1,1012,26956,3575881311,3575881347,36
1,1012,26957,3575881311,3575881348,37
1,1012,26958,3575881311,3575881349,38
1,1012,26959,3575881311,3575881350,39
1,1012,26960,3575881311,3575881350,39
1,1012,26961,3575881311,3575881350,39
1,1012,26962,3575881311,3575881350,39
1,1012,26963,3575881311,3575881353,42
1,1012,26964,3575881311,3575881353,42
1,1012,26965,3575881311,3575881353,42
1,1012,26966,3575881311,3575881353,42
1,1012,26967,3575881311,3575881353,42
1,1012,26968,3575881311,3575881357,46
1,1012,26969,3575881311,3575881357,46
1,1012,26970,3575881311,3575881357,46
1,1012,26971,3575881311,3575881360,49
1,1012,26972,3575881311,3575881360,49
1,1012,26973,3575881311,3575881361,50
1,1013,26974,3575881374,3575881374,0
1,1013,26975,3575881374,3575881374,0
1,1013,26976,3575881374,3575881374,0
1,1013,26977,3575881374,3575881374,0
1,1013,26978,3575881374,3575881374,0
1,1013,26979,3575881374,3575881374,0
1,1013,26980,3575881374,3575881374,0
1,1013,26981,3575881374,3575881374,0
1,1013,26982,3575881374,3575881374,0
1,1013,26983,3575881374,3575881374,0
1,1013,26984,3575881374,3575881374,0
1,1013,26985,3575881374,3575881374,0
1,1013,26986,3575881374,3575881374,0
1,1013,26987,3575881374,3575881375,1
1,1013,26988,3575881374,3575881375,1
1,1013,26989,3575881374,3575881376,2
1,1013,26990,3575881374,3575881376,2
1,1013,26991,3575881374,3575881377,3
1,1013,26992,3575881374,3575881378,4
1,1013,26993,3575881374,3575881378,4
1,1013,26994,3575881374,3575881379,5
1,1013,26995,3575881374,3575881380,6
1,1013,26996,3575881374,3575881380,6
1,1013,26997,3575881374,3575881381,7
1,1013,26998,3575881374,3575881381,7
1,1013,26999,3575881374,3575881382,8
1,1013,27000,3575881374,3575881383,9
1,1013,27001,3575881374,3575881383,9
1,1013,27002,3575881374,3575881383,9
1,1013,27003,3575881374,3575881384,10
1,1013,27004,3575881374,3575881384,10
1,1013,27005,3575881374,3575881384,10
1,1013,27006,3575881374,3575881384,10
1,1013,27007,3575881374,3575881385,11
1,1013,27008,3575881374,3575881386,12
1,1013,27009,3575881374,3575881388,14
1,1013,27010,3575881374,3575881389,15
1,1013,27011,3575881374,3575881390,16
1,1013,27012,3575881374,3575881392,18
1,1013,27013,3575881374,3575881392,18
1,1013,27014,3575881374,3575881394,20
1,1013,27015,3575881374,3575881394,20
1,1013,27016,3575881374,3575881394,20
1,1013,27017,3575881374,3575881395,21
1,1013,27018,3575881374,3575881396,22
1,1013,27019,3575881374,3575881397,23
1,1013,27020,3575881374,3575881397,23
1,1013,27021,3575881374,3575881399,25
1,1013,27022,3575881374,3575881400,26
1,1013,27023,3575881374,3575881400,26
1,1013,27024,3575881374,3575881401,27
1,1013,27025,3575881374,3575881402,28
1,1013,27026,3575881374,3575881402,28
1,1013,27027,3575881374,3575881402,28
1,1013,27028,3575881374,3575881403,29
1,1013,27029,3575881374,3575881403,29
1,1013,27030,3575881374,3575881403,29
1,1013,27031,3575881374,3575881405,31
1,1013,27032,3575881374,3575881405,31
1,1013,27033,3575881374,3575881405,31
1,1013,27034,3575881374,3575881405,31
1,1013,27035,3575881374,3575881406,32
1,1013,27036,3575881374,3575881407,33
1,1013,27037,3575881374,3575881409,35
1,1013,27038,3575881374,3575881409,35
1,1013,27039,3575881374,3575881410,36
1,1013,27040,3575881374,3575881410,36
1,1013,27041,3575881374,3575881410,36
1,1013,27042,3575881374,3575881411,37
1,1013,27043,3575881374,3575881413,39
1,1013,27044,3575881374,3575881413,39
1,1013,27045,3575881374,3575881414,40
1,1013,27046,3575881374,3575881416,42
1,1013,27047,3575881374,3575881416,42
1,1013,27048,3575881374,3575881416,42
1,1013,27049,3575881374,3575881417,43
1,1013,27050,3575881374,3575881417,43
1,1013,27051,3575881374,3575881417,43
1,1013,27052,3575881374,3575881418,44
1,1013,27053,3575881374,3575881418,44
1,1013,27054,3575881374,3575881419,45
1,1013,27055,3575881374,3575881419,45
1,1013,27056,3575881374,3575881419,45
1,1013,27057,3575881374,3575881420,46
1,1013,27058,3575881374,3575881421,47
1,1013,27059,3575881374,3575881423,49
1,1013,27060,3575881374,3575881423,49
1,1013,27061,3575881374,3575881423,49
1,1013,27062,3575881374,3575881424,50
1,1014,27063,3575881443,3575881443,0
1,1014,27064,3575881443,3575881443,0
1,1014,27065,3575881443,3575881443,0
1,1014,27066,3575881443,3575881443,0
1,1014,27067,3575881443,3575881443,0
1,1014,27068,3575881443,3575881443,0
1,1014,27069,3575881443,3575881443,0
1,1014,27070,3575881443,3575881443,0
1,1014,27071,3575881443,3575881444,1
1,1014,27072,3575881443,3575881444,1
1,1014,27073,3575881443,3575881444,1
1,1014,27074,3575881443,3575881444,1
1,1014,27075,3575881443,3575881444,1
1,1014,27076,3575881443,3575881444,1
1,1014,27077,3575881443,3575881444,1
1,1014,27078,3575881443,3575881444,1
1,1014,27079,3575881443,3575881444,1
1,1014,27080,3575881443,3575881444,1
1,1014,27081,3575881443,3575881444,1
1,1014,27082,3575881443,3575881444,1
1,1014,27083,3575881443,3575881444,1
1,1014,27084,3575881443,3575881444,1
1,1014,27085,3575881443,3575881444,1
1,1014,27086,3575881443,3575881444,1
1,1014,27087,3575881443,3575881445,2
1,1014,27088,3575881443,3575881445,2
1,1014,27089,3575881443,3575881445,2
1,1014,27090,3575881443,3575881446,3
1,1014,27091,3575881443,3575881448,5
1,1014,27092,3575881443,3575881449,6
1,1014,27093,3575881443,3575881449,6
1,1014,27094,3575881443,3575881450,7
1,1014,27095,3575881443,3575881450,7
1,1014,27096,3575881443,3575881450,7
1,1014,27097,3575881443,3575881451,8
1,1014,27098,3575881443,3575881451,8
1,1014,27099,3575881443,3575881453,10
1,1014,27100,3575881443,3575881454,11
1,1014,27101,3575881443,3575881454,11
1,1014,27102,3575881443,3575881454,11
1,1014,27103,3575881443,3575881454,11
1,1014,27104,3575881443,3575881456,13
1,1014,27105,3575881443,3575881456,13
1,1014,27106,3575881443,3575881458,15
1,1014,27107,3575881443,3575881458,15
1,1014,27108,3575881443,3575881459,16
1,1014,27109,3575881443,3575881459,16
1,1014,27110,3575881443,3575881459,16
1,1014,27111,3575881443,3575881460,17
1,1014,27112,3575881443,3575881461,18
1,1014,27113,3575881443,3575881463,20
1,1014,27114,3575881443,3575881465,22
1,1014,27115,3575881443,3575881466,23
1,1014,27116,3575881443,3575881466,23
1,1014,27117,3575881443,3575881468,25
1,1014,27118,3575881443,3575881468,25
1,1014,27119,3575881443,3575881468,25
1,1014,27120,3575881443,3575881469,26
1,1014,27121,3575881443,3575881479,36
1,1014,27122,3575881443,3575881481,38
1,1014,27123,3575881443,3575881481,38
1,1014,27124,3575881443,3575881482,39
1,1014,27125,3575881443,3575881483,40
1,1014,27126,3575881443,3575881484,41
1,1014,27127,3575881443,3575881486,43
1,1014,27128,3575881443,3575881486,43
1,1014,27129,3575881443,3575881486,43
1,1014,27130,3575881443,3575881486,43
1,1014,27131,3575881443,3575881487,44
1,1014,27132,3575881443,3575881487,44
1,1014,27133,3575881443,3575881487,44
1,1014,27134,3575881443,3575881488,45
1,1014,27135,3575881443,3575881488,45
1,1014,27136,3575881443,3575881491,48
1,1014,27137,3575881443,3575881493,50
1,1015,27138,3575881508,3575881508,0
1,1015,27139,3575881508,3575881508,0
1,1015,27140,3575881508,3575881508,0
1,1015,27141,3575881508,3575881508,0
1,1015,27142,3575881508,3575881508,0
1,1015,27143,3575881508,3575881508,0
1,1015,27144,3575881508,3575881508,0
1,1015,27145,3575881508,3575881508,0
1,1015,27146,3575881508,3575881508,0
1,1015,27147,3575881508,3575881509,1
1,1015,27148,3575881508,3575881509,1
1,1015,27149,3575881508,3575881509,1
1,1015,27150,3575881508,3575881509,1
1,1015,27151,3575881508,3575881509,1
1,1015,27152,3575881508,3575881509,1
1,1015,27153,3575881508,3575881509,1
1,1015,27154,3575881508,3575881509,1
1,1015,27155,3575881508,3575881509,1
1,1015,27156,3575881508,3575881509,1
1,1015,27157,3575881508,3575881509,1
1,1015,27158,3575881508,3575881509,1
1,1015,27159,3575881508,3575881510,2
1,1015,27160,3575881508,3575881511,3
1,1015,27161,3575881508,3575881511,3
1,1015,27162,3575881508,3575881513,5
1,1015,27163,3575881508,3575881513,5
1,1015,27164,3575881508,3575881517,9
1,1015,27165,3575881508,3575881517,9
1,1015,27166,3575881508,3575881519,11
1,1015,27167,3575881508,3575881519,11
1,1015,27168,3575881508,3575881519,11
1,1015,27169,3575881508,3575881522,14
1,1015,27170,3575881508,3575881522,14
1,1015,27171,3575881508,3575881523,15
1,1015,27172,3575881508,3575881524,16
1,1015,27173,3575881508,3575881524,16
1,1015,27174,3575881508,3575881524,16
1,1015,27175,3575881508,3575881526,18
1,1015,27176,3575881508,3575881526,18
1,1015,27177,3575881508,3575881527,19
1,1015,27178,3575881508,3575881528,20
1,1015,27179,3575881508,3575881529,21
1,1015,27180,3575881508,3575881529,21
1,1015,27181,3575881508,3575881531,23
1,1015,27182,3575881508,3575881531,23
1,1015,27183,3575881508,3575881532,24
1,1015,27184,3575881508,3575881532,24
1,1015,27185,3575881508,3575881534,26
1,1015,27186,3575881508,3575881535,27
1,1015,27187,3575881508,3575881537,29
1,1015,27188,3575881508,3575881538,30
1,1015,27189,3575881508,3575881539,31
1,1015,27190,3575881508,3575881540,32
1,1015,27191,3575881508,3575881543,35
1,1015,27192,3575881508,3575881543,35
1,1015,27193,3575881508,3575881543,35
1,1015,27194,3575881508,3575881547,39
1,1015,27195,3575881508,3575881549,41
1,1015,27196,3575881508,3575881549,41
1,1015,27197,3575881508,3575881549,41
1,1015,27198,3575881508,3575881550,42
1,1015,27199,3575881508,3575881551,43
1,1015,27200,3575881508,3575881552,44
1,1015,27201,3575881508,3575881553,45
1,1015,27202,3575881508,3575881554,46
1,1015,27203,3575881508,3575881555,47
1,1015,27204,3575881508,3575881555,47
1,1015,27205,3575881508,3575881556,48
1,1015,27206,3575881508,3575881556,48
1,1016,27207,3575881576,3575881576,0
1,1016,27208,3575881576,3575881576,0
1,1016,27209,3575881576,3575881576,0
1,1016,27210,3575881576,3575881576,0
1,1016,27211,3575881576,3575881576,0
1,1016,27212,3575881576,3575881576,0
1,1016,27213,3575881576,3575881576,0
1,1016,27214,3575881576,3575881576,0
1,1016,27215,3575881576,3575881576,0
1,1016,27216,3575881576,3575881576,0
1,1016,27217,3575881576,3575881576,0
1,1016,27218,3575881576,3575881576,0
1,1016,27219,3575881576,3575881576,0
1,1016,27220,3575881576,3575881576,0
1,1016,27221,3575881576,3575881576,0
1,1016,27222,3575881576,3575881576,0
1,1016,27223,3575881576,3575881576,0
1,1016,27224,3575881576,3575881576,0
1,1016,27225,3575881576,3575881576,0
1,1016,27226,3575881576,3575881576,0
1,1016,27227,3575881576,3575881577,1
1,1016,27228,3575881576,3575881577,1
1,1016,27229,3575881576,3575881579,3
1,1016,27230,3575881576,3575881579,3
1,1016,27231,3575881576,3575881579,3
1,1016,27232,3575881576,3575881580,4
1,1016,27233,3575881576,3575881580,4
1,1016,27234,3575881576,3575881581,5
1,1016,27235,3575881576,3575881582,6
1,1016,27236,3575881576,3575881582,6
1,1016,27237,3575881576,3575881582,6
1,1016,27238,3575881576,3575881583,7
1,1016,27239,3575881576,3575881583,7
1,1016,27240,3575881576,3575881584,8
1,1016,27241,3575881576,3575881584,8
1,1016,27242,3575881576,3575881585,9
1,1016,27243,3575881576,3575881585,9
1,1016,27244,3575881576,3575881587,11
1,1016,27245,3575881576,3575881589,13
1,1016,27246,3575881576,3575881590,14
1,1016,27247,3575881576,3575881591,15
1,1016,27248,3575881576,3575881592,16
1,1016,27249,3575881576,3575881592,16
1,1016,27250,3575881576,3575881593,17
1,1016,27251,3575881576,3575881594,18
1,1016,27252,3575881576,3575881594,18
1,1016,27253,3575881576,3575881595,19
1,1016,27254,3575881576,3575881596,20
1,1016,27255,3575881576,3575881596,20
1,1016,27256,3575881576,3575881598,22
1,1016,27257,3575881576,3575881598,22
1,1016,27258,3575881576,3575881599,23
1,1016,27259,3575881576,3575881600,24
1,1016,27260,3575881576,3575881601,25
1,1016,27261,3575881576,3575881601,25
1,1016,27262,3575881576,3575881601,25
1,1016,27263,3575881576,3575881601,25
1,1016,27264,3575881576,3575881602,26
1,1016,27265,3575881576,3575881603,27
1,1016,27266,3575881576,3575881604,28
1,1016,27267,3575881576,3575881604,28
1,1016,27268,3575881576,3575881605,29
1,1016,27269,3575881576,3575881605,29
1,1016,27270,3575881576,3575881607,31
1,1016,27271,3575881576,3575881607,31
1,1016,27272,3575881576,3575881609,33
1,1016,27273,3575881576,3575881609,33
1,1016,27274,3575881576,3575881609,33
1,1016,27275,3575881576,3575881609,33
1,1016,27276,3575881576,3575881610,34
1,1016,27277,3575881576,3575881612,36
1,1016,27278,3575881576,3575881613,37
1,1016,27279,3575881576,3575881613,37
1,1016,27280,3575881576,3575881615,39
1,1016,27281,3575881576,3575881615,39
1,1016,27282,3575881576,3575881615,39
1,1016,27283,3575881576,3575881616,40
1,1016,27284,3575881576,3575881616,40
1,1016,27285,3575881576,3575881617,41
1,1016,27286,3575881576,3575881617,41
1,1016,27287,3575881576,3575881617,41
1,1016,27288,3575881576,3575881617,41
1,1016,27289,3575881576,3575881617,41
1,1016,27290,3575881576,3575881617,41
1,1016,27291,3575881576,3575881618,42
1,1016,27292,3575881576,3575881619,43
1,1016,27293,3575881576,3575881620,44
1,1016,27294,3575881576,3575881620,44
1,1016,27295,3575881576,3575881622,46
1,1016,27296,3575881576,3575881622,46
1,1016,27297,3575881576,3575881623,47
1,1016,27298,3575881576,3575881623,47
1,1016,27299,3575881576,3575881623,47
1,1016,27300,3575881576,3575881624,48
1,1017,27301,3575881637,3575881637,0
1,1017,27302,3575881637,3575881637,0
1,1017,27303,3575881637,3575881637,0
1,1017,27304,3575881637,3575881637,0
1,1017,27305,3575881637,3575881637,0
1,1017,27306,3575881637,3575881637,0
1,1017,27307,3575881637,3575881637,0
1,1017,27308,3575881637,3575881637,0
1,1017,27309,3575881637,3575881637,0
1,1017,27310,3575881637,3575881637,0
1,1017,27311,3575881637,3575881637,0
1,1017,27312,3575881637,3575881638,1
1,1017,27313,3575881637,3575881638,1
1,1017,27314,3575881637,3575881640,3
1,1017,27315,3575881637,3575881641,4
1,1017,27316,3575881637,3575881642,5
1,1017,27317,3575881637,3575881642,5
1,1017,27318,3575881637,3575881643,6
1,1017,27319,3575881637,3575881644,7
1,1017,27320,3575881637,3575881644,7
1,1017,27321,3575881637,3575881644,7
1,1017,27322,3575881637,3575881645,8
1,1017,27323,3575881637,3575881645,8
1,1017,27324,3575881637,3575881646,9
1,1017,27325,3575881637,3575881647,10
1,1017,27326,3575881637,3575881648,11
1,1017,27327,3575881637,3575881648,11
1,1017,27328,3575881637,3575881649,12
1,1017,27329,3575881637,3575881649,12
1,1017,27330,3575881637,3575881650,13
1,1017,27331,3575881637,3575881650,13
1,1017,27332,3575881637,3575881651,14
1,1017,27333,3575881637,3575881652,15
1,1017,27334,3575881637,3575881653,16
1,1017,27335,3575881637,3575881653,16
1,1017,27336,3575881637,3575881653,16
1,1017,27337,3575881637,3575881655,18
1,1017,27338,3575881637,3575881655,18
1,1017,27339,3575881637,3575881657,20
1,1017,27340,3575881637,3575881657,20
1,1017,27341,3575881637,3575881657,20
1,1017,27342,3575881637,3575881658,21
1,1017,27343,3575881637,3575881658,21
1,1017,27344,3575881637,3575881659,22
1,1017,27345,3575881637,3575881660,23
1,1017,27346,3575881637,3575881662,25
1,1017,27347,3575881637,3575881663,26
1,1017,27348,3575881637,3575881665,28
1,1017,27349,3575881637,3575881665,28
1,1017,27350,3575881637,3575881666,29
1,1017,27351,3575881637,3575881666,29
1,1017,27352,3575881637,3575881666,29
1,1017,27353,3575881637,3575881669,32
1,1017,27354,3575881637,3575881679,42
1,1017,27355,3575881637,3575881680,43
1,1017,27356,3575881637,3575881681,44
1,1017,27357,3575881637,3575881681,44
1,1017,27358,3575881637,3575881684,47
1,1017,27359,3575881637,3575881685,48
1,1017,27360,3575881637,3575881685,48
1,1017,27361,3575881637,3575881686,49
1,1017,27362,3575881637,3575881686,49
1,1017,27363,3575881637,3575881686,49
1,1017,27364,3575881637,3575881687,50
1,1018,27365,3575881702,3575881702,0
1,1018,27366,3575881702,3575881702,0
1,1018,27367,3575881702,3575881702,0
1,1018,27368,3575881702,3575881702,0
1,1018,27369,3575881702,3575881702,0
1,1018,27370,3575881702,3575881702,0
1,1018,27371,3575881702,3575881702,0
1,1018,27372,3575881702,3575881702,0
1,1018,27373,3575881702,3575881702,0
1,1018,27374,3575881702,3575881702,0
1,1018,27375,3575881702,3575881702,0
1,1018,27376,3575881702,3575881702,0
1,1018,27377,3575881702,3575881702,0
1,1018,27378,3575881702,3575881702,0
1,1018,27379,3575881702,3575881702,0
1,1018,27380,3575881702,3575881703,1
1,1018,27381,3575881702,3575881703,1
1,1018,27382,3575881702,3575881703,1
1,1018,27383,3575881702,3575881704,2
1,1018,27384,3575881702,3575881704,2
1,1018,27385,3575881702,3575881706,4
1,1018,27386,3575881702,3575881706,4
1,1018,27387,3575881702,3575881706,4
1,1018,27388,3575881702,3575881707,5
1,1018,27389,3575881702,3575881708,6
1,1018,27390,3575881702,3575881709,7
1,1018,27391,3575881702,3575881711,9
1,1018,27392,3575881702,3575881711,9
1,1018,27393,3575881702,3575881712,10
1,1018,27394,3575881702,3575881713,11
1,1018,27395,3575881702,3575881714,12
1,1018,27396,3575881702,3575881718,16
1,1018,27397,3575881702,3575881719,17
1,1018,27398,3575881702,3575881719,17
1,1018,27399,3575881702,3575881719,17
1,1018,27400,3575881702,3575881722,20
1,1018,27401,3575881702,3575881723,21
1,1018,27402,3575881702,3575881723,21
1,1018,27403,3575881702,3575881724,22
1,1018,27404,3575881702,3575881724,22
1,1018,27405,3575881702,3575881726,24
1,1018,27406,3575881702,3575881726,24
1,1018,27407,3575881702,3575881727,25
1,1018,27408,3575881702,3575881729,27
1,1018,27409,3575881702,3575881730,28
1,1018,27410,3575881702,3575881730,28
1,1018,27411,3575881702,3575881731,29
1,1018,27412,3575881702,3575881731,29
1,1018,27413,3575881702,3575881731,29
1,1018,27414,3575881702,3575881732,30
1,1018,27415,3575881702,3575881735,33
1,1018,27416,3575881702,3575881735,33
1,1018,27417,3575881702,3575881737,35
1,1018,27418,3575881702,3575881739,37
1,1018,27419,3575881702,3575881739,37
1,1018,27420,3575881702,3575881740,38
1,1018,27421,3575881702,3575881742,40
1,1018,27422,3575881702,3575881743,41
1,1018,27423,3575881702,3575881743,41
1,1018,27424,3575881702,3575881746,44
1,1018,27425,3575881702,3575881748,46
1,1018,27426,3575881702,3575881748,46
1,1018,27427,3575881702,3575881749,47
1,1018,27428,3575881702,3575881750,48
1,1018,27429,3575881702,3575881750,48
1,1018,27430,3575881702,3575881752,50
1,1019,27431,3575881768,3575881768,0
1,1019,27432,3575881768,3575881768,0
1,1019,27433,3575881768,3575881768,0
1,1019,27434,3575881768,3575881768,0
1,1019,27435,3575881768,3575881768,0
1,1019,27436,3575881768,3575881768,0
1,1019,27437,3575881768,3575881768,0
1,1019,27438,3575881768,3575881768,0
1,1019,27439,3575881768,3575881768,0
1,1019,27440,3575881768,3575881768,0
1,1019,27441,3575881768,3575881768,0
1,1019,27442,3575881768,3575881768,0
1,1019,27443,3575881768,3575881768,0
1,1019,27444,3575881768,3575881768,0
1,1019,27445,3575881768,3575881768,0
1,1019,27446,3575881768,3575881768,0
1,1019,27447,3575881768,3575881768,0
1,1019,27448,3575881768,3575881768,0
1,1019,27449,3575881768,3575881768,0
1,1019,27450,3575881768,3575881768,0
1,1019,27451,3575881768,3575881768,0
1,1019,27452,3575881768,3575881768,0
1,1019,27453,3575881768,3575881768,0
1,1019,27454,3575881768,3575881770,2
1,1019,27455,3575881768,3575881773,5
1,1019,27456,3575881768,3575881774,6
1,1019,27457,3575881768,3575881774,6
1,1019,27458,3575881768,3575881775,7
1,1019,27459,3575881768,3575881775,7
1,1019,27460,3575881768,3575881776,8
1,1019,27461,3575881768,3575881778,10
1,1019,27462,3575881768,3575881778,10
1,1019,27463,3575881768,3575881778,10
1,1019,27464,3575881768,3575881779,11
1,1019,27465,3575881768,3575881780,12
1,1019,27466,3575881768,3575881780,12
1,1019,27467,3575881768,3575881781,13
1,1019,27468,3575881768,3575881782,14
1,1019,27469,3575881768,3575881782,14
1,1019,27470,3575881768,3575881782,14
1,1019,27471,3575881768,3575881783,15
1,1019,27472,3575881768,3575881783,15
1,1019,27473,3575881768,3575881783,15
1,1019,27474,3575881768,3575881784,16
1,1019,27475,3575881768,3575881785,17
1,1019,27476,3575881768,3575881785,17
1,1019,27477,3575881768,3575881785,17
1,1019,27478,3575881768,3575881785,17
1,1019,27479,3575881768,3575881787,19
1,1019,27480,3575881768,3575881788,20
1,1019,27481,3575881768,3575881790,22
1,1019,27482,3575881768,3575881791,23
1,1019,27483,3575881768,3575881791,23
1,1019,27484,3575881768,3575881791,23
1,1019,27485,3575881768,3575881792,24
1,1019,27486,3575881768,3575881793,25
1,1019,27487,3575881768,3575881793,25
1,1019,27488,3575881768,3575881794,26
1,1019,27489,3575881768,3575881794,26
1,1019,27490,3575881768,3575881795,27
1,1019,27491,3575881768,3575881796,28
1,1019,27492,3575881768,3575881796,28
1,1019,27493,3575881768,3575881798,30
1,1019,27494,3575881768,3575881799,31
1,1019,27495,3575881768,3575881800,32
1,1019,27496,3575881768,3575881801,33
1,1019,27497,3575881768,3575881801,33
1,1019,27498,3575881768,3575881802,34
1,1019,27499,3575881768,3575881802,34
1,1019,27500,3575881768,3575881802,34
1,1019,27501,3575881768,3575881803,35
1,1019,27502,3575881768,3575881804,36
1,1019,27503,3575881768,3575881804,36
1,1019,27504,3575881768,3575881805,37
1,1019,27505,3575881768,3575881805,37
1,1019,27506,3575881768,3575881807,39
1,1019,27507,3575881768,3575881808,40
1,1019,27508,3575881768,3575881809,41
1,1019,27509,3575881768,3575881809,41
1,1019,27510,3575881768,3575881809,41
1,1019,27511,3575881768,3575881810,42
1,1019,27512,3575881768,3575881810,42
1,1019,27513,3575881768,3575881812,44
1,1019,27514,3575881768,3575881813,45
1,1019,27515,3575881768,3575881814,46
1,1019,27516,3575881768,3575881815,47
1,1019,27517,3575881768,3575881816,48
1,1019,27518,3575881768,3575881816,48
1,1019,27519,3575881768,3575881816,48
1,1019,27520,3575881768,3575881817,49
1,1019,27521,3575881768,3575881817,49
1,1019,27522,3575881768,3575881817,49
1,1019,27523,3575881768,3575881817,49
1,1019,27524,3575881768,3575881818,50
1,1020,27525,3575881832,3575881832,0
1,1020,27526,3575881832,3575881832,0
1,1020,27527,3575881832,3575881832,0
1,1020,27528,3575881832,3575881832,0
1,1020,27529,3575881832,3575881832,0
1,1020,27530,3575881832,3575881832,0
1,1020,27531,3575881832,3575881832,0
1,1020,27532,3575881832,3575881832,0
1,1020,27533,3575881832,3575881832,0
1,1020,27534,3575881832,3575881832,0
1,1020,27535,3575881832,3575881832,0
1,1020,27536,3575881832,3575881832,0
1,1020,27537,3575881832,3575881832,0
1,1020,27538,3575881832,3575881832,0
1,1020,27539,3575881832,3575881832,0
1,1020,27540,3575881832,3575881832,0
1,1020,27541,3575881832,3575881832,0
1,1020,27542,3575881832,3575881832,0
1,1020,27543,3575881832,3575881832,0
1,1020,27544,3575881832,3575881833,1
1,1020,27545,3575881832,3575881833,1
1,1020,27546,3575881832,3575881834,2
1,1020,27547,3575881832,3575881834,2
1,1020,27548,3575881832,3575881837,5
1,1020,27549,3575881832,3575881837,5
1,1020,27550,3575881832,3575881838,6
1,1020,27551,3575881832,3575881839,7
1,1020,27552,3575881832,3575881840,8
1,1020,27553,3575881832,3575881842,10
1,1020,27554,3575881832,3575881843,11
1,1020,27555,3575881832,3575881844,12
1,1020,27556,3575881832,3575881845,13
1,1020,27557,3575881832,3575881845,13
1,1020,27558,3575881832,3575881846,14
1,1020,27559,3575881832,3575881848,16
1,1020,27560,3575881832,3575881848,16
1,1020,27561,3575881832,3575881848,16
1,1020,27562,3575881832,3575881849,17
1,1020,27563,3575881832,3575881849,17
1,1020,27564,3575881832,3575881849,17
1,1020,27565,3575881832,3575881850,18
1,1020,27566,3575881832,3575881851,19
1,1020,27567,3575881832,3575881851,19
1,1020,27568,3575881832,3575881853,21
1,1020,27569,3575881832,3575881853,21
1,1020,27570,3575881832,3575881853,21
1,1020,27571,3575881832,3575881855,23
1,1020,27572,3575881832,3575881855,23
1,1020,27573,3575881832,3575881855,23
1,1020,27574,3575881832,3575881858,26
1,1020,27575,3575881832,3575881858,26
1,1020,27576,3575881832,3575881858,26
1,1020,27577,3575881832,3575881858,26
1,1020,27578,3575881832,3575881858,26
1,1020,27579,3575881832,3575881859,27
1,1020,27580,3575881832,3575881861,29
1,1020,27581,3575881832,3575881862,30
1,1020,27582,3575881832,3575881863,31
1,1020,27583,3575881832,3575881866,34
1,1020,27584,3575881832,3575881866,34
1,1020,27585,3575881832,3575881867,35
1,1020,27586,3575881832,3575881868,36
1,1020,27587,3575881832,3575881869,37
1,1020,27588,3575881832,3575881880,48
1,1020,27589,3575881832,3575881880,48
1,1020,27590,3575881832,3575881881,49
1,1020,27591,3575881832,3575881881,49
1,1021,27592,3575881897,3575881897,0
1,1021,27593,3575881897,3575881897,0
1,1021,27594,3575881897,3575881897,0
1,1021,27595,3575881897,3575881897,0
1,1021,27596,3575881897,3575881897,0
1,1021,27597,3575881897,3575881897,0
1,1021,27598,3575881897,3575881897,0
1,1021,27599,3575881897,3575881897,0
1,1021,27600,3575881897,3575881897,0
1,1021,27601,3575881897,3575881897,0
1,1021,27602,3575881897,3575881897,0
1,1021,27603,3575881897,3575881897,0
1,1021,27604,3575881897,3575881897,0
1,1021,27605,3575881897,3575881897,0
1,1021,27606,3575881897,3575881897,0
1,1021,27607,3575881897,3575881897,0
1,1021,27608,3575881897,3575881897,0
1,1021,27609,3575881897,3575881897,0
1,1021,27610,3575881897,3575881899,2
1,1021,27611,3575881897,3575881899,2
1,1021,27612,3575881897,3575881899,2
1,1021,27613,3575881897,3575881900,3
1,1021,27614,3575881897,3575881901,4
1,1021,27615,3575881897,3575881902,5
1,1021,27616,3575881897,3575881903,6
1,1021,27617,3575881897,3575881903,6
1,1021,27618,3575881897,3575881904,7
1,1021,27619,3575881897,3575881904,7
1,1021,27620,3575881897,3575881904,7
1,1021,27621,3575881897,3575881904,7
1,1021,27622,3575881897,3575881905,8
1,1021,27623,3575881897,3575881906,9
1,1021,27624,3575881897,3575881906,9
1,1021,27625,3575881897,3575881906,9
1,1021,27626,3575881897,3575881909,12
1,1021,27627,3575881897,3575881911,14
1,1021,27628,3575881897,3575881911,14
1,1021,27629,3575881897,3575881911,14
1,1021,27630,3575881897,3575881914,17
1,1021,27631,3575881897,3575881914,17
1,1021,27632,3575881897,3575881918,21
1,1021,27633,3575881897,3575881919,22
1,1021,27634,3575881897,3575881919,22
1,1021,27635,3575881897,3575881919,22
1,1021,27636,3575881897,3575881919,22
1,1021,27637,3575881897,3575881922,25
1,1021,27638,3575881897,3575881922,25
1,1021,27639,3575881897,3575881923,26
1,1021,27640,3575881897,3575881924,27
1,1021,27641,3575881897,3575881924,27
1,1021,27642,3575881897,3575881926,29
1,1021,27643,3575881897,3575881926,29
1,1021,27644,3575881897,3575881927,30
1,1021,27645,3575881897,3575881927,30
1,1021,27646,3575881897,3575881928,31
1,1021,27647,3575881897,3575881929,32
1,1021,27648,3575881897,3575881931,34
1,1021,27649,3575881897,3575881931,34
1,1021,27650,3575881897,3575881931,34
1,1021,27651,3575881897,3575881931,34
1,1021,27652,3575881897,3575881931,34
1,1021,27653,3575881897,3575881932,35
1,1021,27654,3575881897,3575881935,38
1,1021,27655,3575881897,3575881935,38
1,1021,27656,3575881897,3575881938,41
1,1021,27657,3575881897,3575881939,42
1,1021,27658,3575881897,3575881940,43
1,1021,27659,3575881897,3575881940,43
1,1021,27660,3575881897,3575881942,45
1,1021,27661,3575881897,3575881943,46
1,1021,27662,3575881897,3575881944,47
1,1021,27663,3575881897,3575881946,49
1,1022,27664,3575881960,3575881960,0
1,1022,27665,3575881960,3575881960,0
1,1022,27666,3575881960,3575881960,0
1,1022,27667,3575881960,3575881960,0
1,1022,27668,3575881960,3575881960,0
1,1022,27669,3575881960,3575881960,0
1,1022,27670,3575881960,3575881960,0
1,1022,27671,3575881960,3575881960,0
1,1022,27672,3575881960,3575881960,0
1,1022,27673,3575881960,3575881960,0
1,1022,27674,3575881960,3575881960,0
1,1022,27675,3575881960,3575881961,1
1,1022,27676,3575881960,3575881961,1
1,1022,27677,3575881960,3575881961,1
1,1022,27678,3575881960,3575881961,1
1,1022,27679,3575881960,3575881961,1
1,1022,27680,3575881960,3575881961,1
1,1022,27681,3575881960,3575881961,1
1,1022,27682,3575881960,3575881961,1
1,1022,27683,3575881960,3575881961,1
1,1022,27684,3575881960,3575881961,1
1,1022,27685,3575881960,3575881962,2
1,1022,27686,3575881960,3575881962,2
1,1022,27687,3575881960,3575881962,2
1,1022,27688,3575881960,3575881964,4
1,1022,27689,3575881960,3575881964,4
1,1022,27690,3575881960,3575881964,4
1,1022,27691,3575881960,3575881965,5
1,1022,27692,3575881960,3575881970,10
1,1022,27693,3575881960,3575881970,10
1,1022,27694,3575881960,3575881973,13
1,1022,27695,3575881960,3575881974,14
1,1022,27696,3575881960,3575881974,14
1,1022,27697,3575881960,3575881977,17
1,1022,27698,3575881960,3575881977,17
1,1022,27699,3575881960,3575881977,17
1,1022,27700,3575881960,3575881978,18
1,1022,27701,3575881960,3575881978,18
1,1022,27702,3575881960,3575881979,19
1,1022,27703,3575881960,3575881980,20
1,1022,27704,3575881960,3575881980,20
1,1022,27705,3575881960,3575881981,21
1,1022,27706,3575881960,3575881982,22
1,1022,27707,3575881960,3575881982,22
1,1022,27708,3575881960,3575881982,22
1,1022,27709,3575881960,3575881982,22
1,1022,27710,3575881960,3575881983,23
1,1022,27711,3575881960,3575881984,24
1,1022,27712,3575881960,3575881984,24
1,1022,27713,3575881960,3575881984,24
1,1022,27714,3575881960,3575881985,25
1,1022,27715,3575881960,3575881985,25
1,1022,27716,3575881960,3575881985,25
1,1022,27717,3575881960,3575881987,27
1,1022,27718,3575881960,3575881988,28
1,1022,27719,3575881960,3575881990,30
1,1022,27720,3575881960,3575881991,31
1,1022,27721,3575881960,3575881991,31
1,1022,27722,3575881960,3575881992,32
1,1022,27723,3575881960,3575881992,32
1,1022,27724,3575881960,3575881993,33
1,1022,27725,3575881960,3575881993,33
1,1022,27726,3575881960,3575881993,33
1,1022,27727,3575881960,3575881994,34
1,1022,27728,3575881960,3575881995,35
1,1022,27729,3575881960,3575881996,36
1,1022,27730,3575881960,3575881997,37
1,1022,27731,3575881960,3575881998,38
1,1022,27732,3575881960,3575881999,39
1,1022,27733,3575881960,3575882000,40
1,1022,27734,3575881960,3575882001,41
1,1022,27735,3575881960,3575882001,41
1,1022,27736,3575881960,3575882002,42
1,1022,27737,3575881960,3575882002,42
1,1022,27738,3575881960,3575882003,43
1,1022,27739,3575881960,3575882004,44
1,1022,27740,3575881960,3575882004,44
1,1022,27741,3575881960,3575882004,44
1,1022,27742,3575881960,3575882006,46
1,1022,27743,3575881960,3575882006,46
1,1022,27744,3575881960,3575882009,49
1,1022,27745,3575881960,3575882009,49
1,1022,27746,3575881960,3575882009,49
1,1022,27747,3575881960,3575882009,49
1,1022,27748,3575881960,3575882010,50
1,1023,27749,3575882028,3575882028,0
1,1023,27750,3575882028,3575882028,0
1,1023,27751,3575882028,3575882028,0
1,1023,27752,3575882028,3575882028,0
1,1023,27753,3575882028,3575882028,0
1,1023,27754,3575882028,3575882028,0
1,1023,27755,3575882028,3575882028,0
1,1023,27756,3575882028,3575882028,0
1,1023,27757,3575882028,3575882028,0
1,1023,27758,3575882028,3575882028,0
1,1023,27759,3575882028,3575882028,0
1,1023,27760,3575882028,3575882028,0
1,1023,27761,3575882028,3575882028,0
1,1023,27762,3575882028,3575882028,0
1,1023,27763,3575882028,3575882028,0
1,1023,27764,3575882028,3575882028,0
1,1023,27765,3575882028,3575882028,0
1,1023,27766,3575882028,3575882028,0
1,1023,27767,3575882028,3575882028,0
1,1023,27768,3575882028,3575882028,0
1,1023,27769,3575882028,3575882028,0
1,1023,27770,3575882028,3575882028,0
1,1023,27771,3575882028,3575882028,0
1,1023,27772,3575882028,3575882028,0
1,1023,27773,3575882028,3575882028,0
1,1023,27774,3575882028,3575882029,1
1,1023,27775,3575882028,3575882030,2
1,1023,27776,3575882028,3575882030,2
1,1023,27777,3575882028,3575882031,3
1,1023,27778,3575882028,3575882031,3
1,1023,27779,3575882028,3575882031,3
1,1023,27780,3575882028,3575882031,3
1,1023,27781,3575882028,3575882032,4
1,1023,27782,3575882028,3575882033,5
1,1023,27783,3575882028,3575882034,6
1,1023,27784,3575882028,3575882034,6
1,1023,27785,3575882028,3575882037,9
1,1023,27786,3575882028,3575882037,9
1,1023,27787,3575882028,3575882038,10
1,1023,27788,3575882028,3575882041,13
1,1023,27789,3575882028,3575882041,13
1,1023,27790,3575882028,3575882042,14
1,1023,27791,3575882028,3575882042,14
1,1023,27792,3575882028,3575882043,15
1,1023,27793,3575882028,3575882044,16
1,1023,27794,3575882028,3575882044,16
1,1023,27795,3575882028,3575882045,17
1,1023,27796,3575882028,3575882046,18
1,1023,27797,3575882028,3575882047,19
1,1023,27798,3575882028,3575882048,20
1,1023,27799,3575882028,3575882048,20
1,1023,27800,3575882028,3575882048,20
1,1023,27801,3575882028,3575882048,20
1,1023,27802,3575882028,3575882049,21
1,1023,27803,3575882028,3575882049,21
1,1023,27804,3575882028,3575882051,23
1,1023,27805,3575882028,3575882051,23
1,1023,27806,3575882028,3575882051,23
1,1023,27807,3575882028,3575882051,23
1,1023,27808,3575882028,3575882053,25
1,1023,27809,3575882028,3575882053,25
1,1023,27810,3575882028,3575882054,26
1,1023,27811,3575882028,3575882055,27
1,1023,27812,3575882028,3575882056,28
1,1023,27813,3575882028,3575882056,28
1,1023,27814,3575882028,3575882059,31
1,1023,27815,3575882028,3575882059,31
1,1023,27816,3575882028,3575882059,31
1,1023,27817,3575882028,3575882059,31
1,1023,27818,3575882028,3575882062,34
1,1023,27819,3575882028,3575882062,34
1,1023,27820,3575882028,3575882064,36
1,1023,27821,3575882028,3575882065,37
1,1023,27822,3575882028,3575882066,38
1,1023,27823,3575882028,3575882066,38
1,1023,27824,3575882028,3575882066,38
1,1023,27825,3575882028,3575882067,39
1,1023,27826,3575882028,3575882069,41
1,1024,27827,3575882092,3575882092,0
1,1024,27828,3575882092,3575882092,0
1,1024,27829,3575882092,3575882092,0
1,1024,27830,3575882092,3575882092,0
1,1024,27831,3575882092,3575882092,0
1,1024,27832,3575882092,3575882092,0
1,1024,27833,3575882092,3575882092,0
1,1024,27834,3575882092,3575882092,0
1,1024,27835,3575882092,3575882092,0
1,1024,27836,3575882092,3575882092,0
1,1024,27837,3575882092,3575882092,0
1,1024,27838,3575882092,3575882092,0
1,1024,27839,3575882092,3575882092,0
1,1024,27840,3575882092,3575882092,0
1,1024,27841,3575882092,3575882093,1
1,1024,27842,3575882092,3575882094,2
1,1024,27843,3575882092,3575882094,2
1,1024,27844,3575882092,3575882095,3
1,1024,27845,3575882092,3575882095,3
1,1024,27846,3575882092,3575882097,5
1,1024,27847,3575882092,3575882099,7
1,1024,27848,3575882092,3575882099,7
1,1024,27849,3575882092,3575882100,8
1,1024,27850,3575882092,3575882100,8
1,1024,27851,3575882092,3575882101,9
1,1024,27852,3575882092,3575882102,10
1,1024,27853,3575882092,3575882103,11
1,1024,27854,3575882092,3575882103,11
1,1024,27855,3575882092,3575882104,12
1,1024,27856,3575882092,3575882104,12
1,1024,27857,3575882092,3575882105,13
1,1024,27858,3575882092,3575882105,13
1,1024,27859,3575882092,3575882105,13
1,1024,27860,3575882092,3575882106,14
1,1024,27861,3575882092,3575882107,15
1,1024,27862,3575882092,3575882107,15
1,1024,27863,3575882092,3575882107,15
1,1024,27864,3575882092,3575882109,17
1,1024,27865,3575882092,3575882111,19
1,1024,27866,3575882092,3575882111,19
1,1024,27867,3575882092,3575882111,19
1,1024,27868,3575882092,3575882113,21
1,1024,27869,3575882092,3575882114,22
1,1024,27870,3575882092,3575882118,26
1,1024,27871,3575882092,3575882119,27
1,1024,27872,3575882092,3575882119,27
1,1024,27873,3575882092,3575882119,27
1,1024,27874,3575882092,3575882122,30
1,1024,27875,3575882092,3575882123,31
1,1024,27876,3575882092,3575882123,31
1,1024,27877,3575882092,3575882124,32
1,1024,27878,3575882092,3575882125,33
1,1024,27879,3575882092,3575882127,35
1,1024,27880,3575882092,3575882127,35
1,1024,27881,3575882092,3575882127,35
1,1024,27882,3575882092,3575882128,36
1,1024,27883,3575882092,3575882129,37
1,1024,27884,3575882092,3575882130,38
1,1024,27885,3575882092,3575882131,39
1,1024,27886,3575882092,3575882131,39
1,1024,27887,3575882092,3575882132,40
1,1024,27888,3575882092,3575882132,40
1,1024,27889,3575882092,3575882133,41
1,1024,27890,3575882092,3575882135,43
1,1024,27891,3575882092,3575882135,43
1,1024,27892,3575882092,3575882138,46
1,1024,27893,3575882092,3575882139,47
1,1024,27894,3575882092,3575882140,48
1,1025,27895,3575882156,3575882156,0
1,1025,27896,3575882156,3575882156,0
1,1025,27897,3575882156,3575882156,0
1,1025,27898,3575882156,3575882156,0
1,1025,27899,3575882156,3575882156,0
1,1025,27900,3575882156,3575882156,0
1,1025,27901,3575882156,3575882156,0
1,1025,27902,3575882156,3575882156,0
1,1025,27903,3575882156,3575882156,0
1,1025,27904,3575882156,3575882156,0
1,1025,27905,3575882156,3575882156,0
1,1025,27906,3575882156,3575882156,0
1,1025,27907,3575882156,3575882156,0
1,1025,27908,3575882156,3575882156,0
1,1025,27909,3575882156,3575882156,0
1,1025,27910,3575882156,3575882156,0
1,1025,27911,3575882156,3575882156,0
1,1025,27912,3575882156,3575882156,0
1,1025,27913,3575882156,3575882156,0
1,1025,27914,3575882156,3575882158,2
1,1025,27915,3575882156,3575882158,2
1,1025,27916,3575882156,3575882159,3
1,1025,27917,3575882156,3575882160,4
1,1025,27918,3575882156,3575882161,5
1,1025,27919,3575882156,3575882161,5
1,1025,27920,3575882156,3575882162,6
1,1025,27921,3575882156,3575882162,6
1,1025,27922,3575882156,3575882164,8
1,1025,27923,3575882156,3575882164,8
1,1025,27924,3575882156,3575882164,8
1,1025,27925,3575882156,3575882165,9
1,1025,27926,3575882156,3575882166,10
1,1025,27927,3575882156,3575882170,14
1,1025,27928,3575882156,3575882171,15
1,1025,27929,3575882156,3575882173,17
1,1025,27930,3575882156,3575882174,18
1,1025,27931,3575882156,3575882175,19
1,1025,27932,3575882156,3575882175,19
1,1025,27933,3575882156,3575882176,20
1,1025,27934,3575882156,3575882178,22
1,1025,27935,3575882156,3575882178,22
1,1025,27936,3575882156,3575882179,23
1,1025,27937,3575882156,3575882180,24
1,1025,27938,3575882156,3575882180,24
1,1025,27939,3575882156,3575882181,25
1,1025,27940,3575882156,3575882182,26
1,1025,27941,3575882156,3575882182,26
1,1025,27942,3575882156,3575882183,27
1,1025,27943,3575882156,3575882183,27
1,1025,27944,3575882156,3575882183,27
1,1025,27945,3575882156,3575882184,28
1,1025,27946,3575882156,3575882185,29
1,1025,27947,3575882156,3575882185,29
1,1025,27948,3575882156,3575882185,29
1,1025,27949,3575882156,3575882186,30
1,1025,27950,3575882156,3575882186,30
1,1025,27951,3575882156,3575882189,33
1,1025,27952,3575882156,3575882190,34
1,1025,27953,3575882156,3575882191,35
1,1025,27954,3575882156,3575882191,35
1,1025,27955,3575882156,3575882192,36
1,1025,27956,3575882156,3575882193,37
1,1025,27957,3575882156,3575882193,37
1,1025,27958,3575882156,3575882194,38
1,1025,27959,3575882156,3575882195,39
1,1025,27960,3575882156,3575882196,40
1,1025,27961,3575882156,3575882196,40
1,1025,27962,3575882156,3575882198,42
1,1025,27963,3575882156,3575882198,42
1,1025,27964,3575882156,3575882199,43
1,1025,27965,3575882156,3575882200,44
1,1025,27966,3575882156,3575882200,44
1,1025,27967,3575882156,3575882200,44
1,1025,27968,3575882156,3575882201,45
1,1025,27969,3575882156,3575882201,45
1,1025,27970,3575882156,3575882202,46
1,1025,27971,3575882156,3575882202,46
1,1025,27972,3575882156,3575882203,47
1,1025,27973,3575882156,3575882203,47
1,1025,27974,3575882156,3575882205,49
1,1025,27975,3575882156,3575882205,49
1,1025,27976,3575882156,3575882205,49
1,1025,27977,3575882156,3575882205,49
1,1025,27978,3575882156,3575882206,50
1,1026,27979,3575882219,3575882219,0
1,1026,27980,3575882219,3575882219,0
1,1026,27981,3575882219,3575882219,0
1,1026,27982,3575882219,3575882219,0
1,1026,27983,3575882219,3575882219,0
1,1026,27984,3575882219,3575882219,0
1,1026,27985,3575882219,3575882219,0
1,1026,27986,3575882219,3575882219,0
1,1026,27987,3575882219,3575882219,0
1,1026,27988,3575882219,3575882219,0
1,1026,27989,3575882219,3575882220,1
1,1026,27990,3575882219,3575882220,1
1,1026,27991,3575882219,3575882220,1
1,1026,27992,3575882219,3575882220,1
1,1026,27993,3575882219,3575882220,1
1,1026,27994,3575882219,3575882220,1
1,1026,27995,3575882219,3575882220,1
1,1026,27996,3575882219,3575882220,1
1,1026,27997,3575882219,3575882220,1
1,1026,27998,3575882219,3575882220,1
1,1026,27999,3575882219,3575882220,1
1,1026,28000,3575882219,3575882220,1
1,1026,28001,3575882219,3575882222,3
1,1026,28002,3575882219,3575882223,4
1,1026,28003,3575882219,3575882223,4
1,1026,28004,3575882219,3575882223,4
1,1026,28005,3575882219,3575882224,5
1,1026,28006,3575882219,3575882224,5
1,1026,28007,3575882219,3575882224,5
1,1026,28008,3575882219,3575882225,6
1,1026,28009,3575882219,3575882226,7
1,1026,28010,3575882219,3575882228,9
1,1026,28011,3575882219,3575882228,9
1,1026,28012,3575882219,3575882230,11
1,1026,28013,3575882219,3575882230,11
1,1026,28014,3575882219,3575882231,12
1,1026,28015,3575882219,3575882231,12
1,1026,28016,3575882219,3575882232,13
1,1026,28017,3575882219,3575882232,13
1,1026,28018,3575882219,3575882233,14
1,1026,28019,3575882219,3575882234,15
1,1026,28020,3575882219,3575882235,16
1,1026,28021,3575882219,3575882235,16
1,1026,28022,3575882219,3575882237,18
1,1026,28023,3575882219,3575882238,19
1,1026,28024,3575882219,3575882238,19
1,1026,28025,3575882219,3575882241,22
1,1026,28026,3575882219,3575882241,22
1,1026,28027,3575882219,3575882242,23
1,1026,28028,3575882219,3575882242,23
1,1026,28029,3575882219,3575882244,25
1,1026,28030,3575882219,3575882244,25
1,1026,28031,3575882219,3575882246,27
1,1026,28032,3575882219,3575882246,27
1,1026,28033,3575882219,3575882247,28
1,1026,28034,3575882219,3575882247,28
1,1026,28035,3575882219,3575882248,29
1,1026,28036,3575882219,3575882248,29
1,1026,28037,3575882219,3575882248,29
1,1026,28038,3575882219,3575882248,29
1,1026,28039,3575882219,3575882249,30
1,1026,28040,3575882219,3575882249,30
1,1026,28041,3575882219,3575882251,32
1,1026,28042,3575882219,3575882251,32
1,1026,28043,3575882219,3575882252,33
1,1026,28044,3575882219,3575882252,33
1,1026,28045,3575882219,3575882253,34
1,1026,28046,3575882219,3575882253,34
1,1026,28047,3575882219,3575882254,35
1,1026,28048,3575882219,3575882255,36
1,1026,28049,3575882219,3575882255,36
1,1026,28050,3575882219,3575882257,38
1,1026,28051,3575882219,3575882257,38
1,1026,28052,3575882219,3575882258,39
1,1026,28053,3575882219,3575882259,40
1,1026,28054,3575882219,3575882259,40
1,1026,28055,3575882219,3575882262,43
1,1026,28056,3575882219,3575882265,46
1,1026,28057,3575882219,3575882267,48
1,1026,28058,3575882219,3575882267,48
1,1026,28059,3575882219,3575882267,48
1,1026,28060,3575882219,3575882267,48
1,1026,28061,3575882219,3575882268,49
1,1027,28062,3575882288,3575882288,0
1,1027,28063,3575882288,3575882288,0
1,1027,28064,3575882288,3575882288,0
1,1027,28065,3575882288,3575882289,1
1,1027,28066,3575882288,3575882289,1
1,1027,28067,3575882288,3575882289,1
1,1027,28068,3575882288,3575882289,1
1,1027,28069,3575882288,3575882289,1
1,1027,28070,3575882288,3575882289,1
1,1027,28071,3575882288,3575882289,1
1,1027,28072,3575882288,3575882289,1
1,1027,28073,3575882288,3575882289,1
1,1027,28074,3575882288,3575882289,1
1,1027,28075,3575882288,3575882289,1
1,1027,28076,3575882288,3575882289,1
1,1027,28077,3575882288,3575882289,1
1,1027,28078,3575882288,3575882293,5
1,1027,28079,3575882288,3575882294,6
1,1027,28080,3575882288,3575882294,6
1,1027,28081,3575882288,3575882294,6
1,1027,28082,3575882288,3575882294,6
1,1027,28083,3575882288,3575882296,8
1,1027,28084,3575882288,3575882297,9
1,1027,28085,3575882288,3575882298,10
1,1027,28086,3575882288,3575882299,11
1,1027,28087,3575882288,3575882300,12
1,1027,28088,3575882288,3575882300,12
1,1027,28089,3575882288,3575882302,14
1,1027,28090,3575882288,3575882302,14
1,1027,28091,3575882288,3575882302,14
1,1027,28092,3575882288,3575882303,15
1,1027,28093,3575882288,3575882303,15
1,1027,28094,3575882288,3575882304,16
1,1027,28095,3575882288,3575882305,17
1,1027,28096,3575882288,3575882305,17
1,1027,28097,3575882288,3575882306,18
1,1027,28098,3575882288,3575882306,18
1,1027,28099,3575882288,3575882307,19
1,1027,28100,3575882288,3575882308,20
1,1027,28101,3575882288,3575882309,21
1,1027,28102,3575882288,3575882311,23
1,1027,28103,3575882288,3575882312,24
1,1027,28104,3575882288,3575882313,25
1,1027,28105,3575882288,3575882318,30
1,1027,28106,3575882288,3575882319,31
1,1027,28107,3575882288,3575882319,31
1,1027,28108,3575882288,3575882319,31
1,1027,28109,3575882288,3575882322,34
1,1027,28110,3575882288,3575882323,35
1,1027,28111,3575882288,3575882324,36
1,1027,28112,3575882288,3575882324,36
1,1027,28113,3575882288,3575882325,37
1,1027,28114,3575882288,3575882326,38
1,1027,28115,3575882288,3575882326,38
1,1027,28116,3575882288,3575882326,38
1,1027,28117,3575882288,3575882326,38
1,1027,28118,3575882288,3575882328,40
1,1027,28119,3575882288,3575882328,40
1,1027,28120,3575882288,3575882329,41
1,1027,28121,3575882288,3575882330,42
1,1027,28122,3575882288,3575882331,43
1,1027,28123,3575882288,3575882331,43
1,1027,28124,3575882288,3575882332,44
1,1027,28125,3575882288,3575882332,44
1,1027,28126,3575882288,3575882333,45
1,1027,28127,3575882288,3575882335,47
1,1027,28128,3575882288,3575882336,48
1,1028,28129,3575882351,3575882351,0
1,1028,28130,3575882351,3575882351,0
1,1028,28131,3575882351,3575882351,0
1,1028,28132,3575882351,3575882351,0
1,1028,28133,3575882351,3575882351,0
1,1028,28134,3575882351,3575882351,0
1,1028,28135,3575882351,3575882351,0
1,1028,28136,3575882351,3575882351,0
1,1028,28137,3575882351,3575882351,0
1,1028,28138,3575882351,3575882351,0
1,1028,28139,3575882351,3575882351,0
1,1028,28140,3575882351,3575882351,0
1,1028,28141,3575882351,3575882352,1
1,1028,28142,3575882351,3575882352,1
1,1028,28143,3575882351,3575882352,1
1,1028,28144,3575882351,3575882353,2
1,1028,28145,3575882351,3575882353,2
1,1028,28146,3575882351,3575882354,3
1,1028,28147,3575882351,3575882356,5
1,1028,28148,3575882351,3575882357,6
1,1028,28149,3575882351,3575882358,7
1,1028,28150,3575882351,3575882359,8
1,1028,28151,3575882351,3575882360,9
1,1028,28152,3575882351,3575882360,9
1,1028,28153,3575882351,3575882361,10
1,1028,28154,3575882351,3575882362,11
1,1028,28155,3575882351,3575882362,11
1,1028,28156,3575882351,3575882363,12
1,1028,28157,3575882351,3575882364,13
1,1028,28158,3575882351,3575882364,13
1,1028,28159,3575882351,3575882365,14
1,1028,28160,3575882351,3575882365,14
1,1028,28161,3575882351,3575882366,15
1,1028,28162,3575882351,3575882369,18
1,1028,28163,3575882351,3575882371,20
1,1028,28164,3575882351,3575882374,23
1,1028,28165,3575882351,3575882374,23
1,1028,28166,3575882351,3575882375,24
1,1028,28167,3575882351,3575882375,24
1,1028,28168,3575882351,3575882376,25
1,1028,28169,3575882351,3575882378,27
1,1028,28170,3575882351,3575882379,28
1,1028,28171,3575882351,3575882379,28
1,1028,28172,3575882351,3575882379,28
1,1028,28173,3575882351,3575882380,29
1,1028,28174,3575882351,3575882380,29
1,1028,28175,3575882351,3575882381,30
1,1028,28176,3575882351,3575882382,31
1,1028,28177,3575882351,3575882382,31
1,1028,28178,3575882351,3575882383,32
1,1028,28179,3575882351,3575882383,32
1,1028,28180,3575882351,3575882383,32
1,1028,28181,3575882351,3575882383,32
1,1028,28182,3575882351,3575882384,33
1,1028,28183,3575882351,3575882384,33
1,1028,28184,3575882351,3575882384,33
1,1028,28185,3575882351,3575882385,34
1,1028,28186,3575882351,3575882385,34
1,1028,28187,3575882351,3575882385,34
1,1028,28188,3575882351,3575882387,36
1,1028,28189,3575882351,3575882389,38
1,1028,28190,3575882351,3575882391,40
1,1028,28191,3575882351,3575882391,40
1,1028,28192,3575882351,3575882391,40
1,1028,28193,3575882351,3575882392,41
1,1028,28194,3575882351,3575882392,41
1,1028,28195,3575882351,3575882392,41
1,1028,28196,3575882351,3575882393,42
1,1028,28197,3575882351,3575882395,44
1,1028,28198,3575882351,3575882396,45
1,1028,28199,3575882351,3575882396,45
1,1028,28200,3575882351,3575882396,45
1,1028,28201,3575882351,3575882398,47
1,1028,28202,3575882351,3575882398,47
1,1028,28203,3575882351,3575882398,47
1,1028,28204,3575882351,3575882398,47
1,1028,28205,3575882351,3575882400,49
1,1028,28206,3575882351,3575882401,50
1,1029,28207,3575882413,3575882413,0
1,1029,28208,3575882413,3575882413,0
1,1029,28209,3575882413,3575882413,0
1,1029,28210,3575882413,3575882413,0
1,1029,28211,3575882413,3575882413,0
1,1029,28212,3575882413,3575882413,0
1,1029,28213,3575882413,3575882413,0
1,1029,28214,3575882413,3575882413,0
1,1029,28215,3575882413,3575882413,0
1,1029,28216,3575882413,3575882413,0
1,1029,28217,3575882413,3575882413,0
1,1029,28218,3575882413,3575882413,0
1,1029,28219,3575882413,3575882413,0
1,1029,28220,3575882413,3575882413,0
1,1029,28221,3575882413,3575882413,0
1,1029,28222,3575882413,3575882413,0
1,1029,28223,3575882413,3575882413,0
1,1029,28224,3575882413,3575882413,0
1,1029,28225,3575882413,3575882413,0
1,1029,28226,3575882413,3575882413,0
1,1029,28227,3575882413,3575882413,0
1,1029,28228,3575882413,3575882415,2
1,1029,28229,3575882413,3575882416,3
1,1029,28230,3575882413,3575882416,3
1,1029,28231,3575882413,3575882417,4
1,1029,28232,3575882413,3575882417,4
1,1029,28233,3575882413,3575882418,5
1,1029,28234,3575882413,3575882418,5
1,1029,28235,3575882413,3575882418,5
1,1029,28236,3575882413,3575882418,5
1,1029,28237,3575882413,3575882418,5
1,1029,28238,3575882413,3575882418,5
1,1029,28239,3575882413,3575882418,5
1,1029,28240,3575882413,3575882418,5
1,1029,28241,3575882413,3575882422,9
1,1029,28242,3575882413,3575882423,10
1,1029,28243,3575882413,3575882423,10
1,1029,28244,3575882413,3575882424,11
1,1029,28245,3575882413,3575882424,11
1,1029,28246,3575882413,3575882424,11
1,1029,28247,3575882413,3575882425,12
1,1029,28248,3575882413,3575882425,12
1,1029,28249,3575882413,3575882428,15
1,1029,28250,3575882413,3575882429,16
1,1029,28251,3575882413,3575882430,17
1,1029,28252,3575882413,3575882431,18
1,1029,28253,3575882413,3575882431,18
1,1029,28254,3575882413,3575882431,18
1,1029,28255,3575882413,3575882432,19
1,1029,28256,3575882413,3575882433,20
1,1029,28257,3575882413,3575882433,20
1,1029,28258,3575882413,3575882435,22
1,1029,28259,3575882413,3575882435,22
1,1029,28260,3575882413,3575882435,22
1,1029,28261,3575882413,3575882437,24
1,1029,28262,3575882413,3575882439,26
1,1029,28263,3575882413,3575882441,28
1,1029,28264,3575882413,3575882441,28
1,1029,28265,3575882413,3575882442,29
1,1029,28266,3575882413,3575882443,30
1,1029,28267,3575882413,3575882444,31
1,1029,28268,3575882413,3575882444,31
1,1029,28269,3575882413,3575882444,31
1,1029,28270,3575882413,3575882445,32
1,1029,28271,3575882413,3575882446,33
1,1029,28272,3575882413,3575882446,33
1,1029,28273,3575882413,3575882447,34
1,1029,28274,3575882413,3575882448,35
1,1029,28275,3575882413,3575882448,35
1,1029,28276,3575882413,3575882448,35
1,1029,28277,3575882413,3575882448,35
1,1029,28278,3575882413,3575882449,36
1,1029,28279,3575882413,3575882449,36
1,1029,28280,3575882413,3575882451,38
1,1029,28281,3575882413,3575882451,38
1,1029,28282,3575882413,3575882452,39
1,1029,28283,3575882413,3575882452,39
1,1029,28284,3575882413,3575882453,40
1,1029,28285,3575882413,3575882454,41
1,1029,28286,3575882413,3575882455,42
1,1029,28287,3575882413,3575882455,42
1,1029,28288,3575882413,3575882457,44
1,1029,28289,3575882413,3575882458,45
1,1029,28290,3575882413,3575882459,46
1,1029,28291,3575882413,3575882459,46
1,1029,28292,3575882413,3575882459,46
1,1029,28293,3575882413,3575882459,46
1,1029,28294,3575882413,3575882460,47
1,1030,28295,3575882478,3575882478,0
1,1030,28296,3575882478,3575882478,0
1,1030,28297,3575882478,3575882478,0
1,1030,28298,3575882478,3575882478,0
1,1030,28299,3575882478,3575882478,0
1,1030,28300,3575882478,3575882478,0
1,1030,28301,3575882478,3575882478,0
1,1030,28302,3575882478,3575882478,0
1,1030,28303,3575882478,3575882480,2
1,1030,28304,3575882478,3575882481,3
1,1030,28305,3575882478,3575882481,3
1,1030,28306,3575882478,3575882482,4
1,1030,28307,3575882478,3575882483,5
1,1030,28308,3575882478,3575882485,7
1,1030,28309,3575882478,3575882485,7
1,1030,28310,3575882478,3575882486,8
1,1030,28311,3575882478,3575882487,9
1,1030,28312,3575882478,3575882487,9
1,1030,28313,3575882478,3575882487,9
1,1030,28314,3575882478,3575882488,10
1,1030,28315,3575882478,3575882489,11
1,1030,28316,3575882478,3575882493,15
1,1030,28317,3575882478,3575882493,15
1,1030,28318,3575882478,3575882494,16
1,1030,28319,3575882478,3575882495,17
1,1030,28320,3575882478,3575882495,17
1,1030,28321,3575882478,3575882499,21
1,1030,28322,3575882478,3575882499,21
1,1030,28323,3575882478,3575882500,22
1,1030,28324,3575882478,3575882500,22
1,1030,28325,3575882478,3575882500,22
1,1030,28326,3575882478,3575882503,25
1,1030,28327,3575882478,3575882503,25
1,1030,28328,3575882478,3575882504,26
1,1030,28329,3575882478,3575882504,26
1,1030,28330,3575882478,3575882505,27
1,1030,28331,3575882478,3575882506,28
1,1030,28332,3575882478,3575882506,28
1,1030,28333,3575882478,3575882506,28
1,1030,28334,3575882478,3575882506,28
1,1030,28335,3575882478,3575882506,28
1,1030,28336,3575882478,3575882507,29
1,1030,28337,3575882478,3575882508,30
1,1030,28338,3575882478,3575882508,30
1,1030,28339,3575882478,3575882510,32
1,1030,28340,3575882478,3575882511,33
1,1030,28341,3575882478,3575882511,33
1,1030,28342,3575882478,3575882511,33
1,1030,28343,3575882478,3575882513,35
1,1030,28344,3575882478,3575882517,39
1,1030,28345,3575882478,3575882518,40
1,1030,28346,3575882478,3575882518,40
1,1030,28347,3575882478,3575882519,41
1,1030,28348,3575882478,3575882521,43
1,1030,28349,3575882478,3575882523,45
1,1030,28350,3575882478,3575882523,45
1,1030,28351,3575882478,3575882523,45
1,1030,28352,3575882478,3575882524,46
1,1030,28353,3575882478,3575882525,47
1,1030,28354,3575882478,3575882525,47
1,1030,28355,3575882478,3575882526,48
1,1030,28356,3575882478,3575882526,48
1,1030,28357,3575882478,3575882526,48
1,1030,28358,3575882478,3575882527,49
1,1030,28359,3575882478,3575882528,50
1,1031,28360,3575882544,3575882544,0
1,1031,28361,3575882544,3575882544,0
1,1031,28362,3575882544,3575882544,0
1,1031,28363,3575882544,3575882544,0
1,1031,28364,3575882544,3575882544,0
1,1031,28365,3575882544,3575882544,0
1,1031,28366,3575882544,3575882544,0
1,1031,28367,3575882544,3575882544,0
1,1031,28368,3575882544,3575882544,0
1,1031,28369,3575882544,3575882544,0
1,1031,28370,3575882544,3575882544,0
1,1031,28371,3575882544,3575882544,0
1,1031,28372,3575882544,3575882544,0
1,1031,28373,3575882544,3575882544,0
1,1031,28374,3575882544,3575882548,4
1,1031,28375,3575882544,3575882549,5
1,1031,28376,3575882544,3575882550,6
1,1031,28377,3575882544,3575882550,6
1,1031,28378,3575882544,3575882550,6
1,1031,28379,3575882544,3575882550,6
1,1031,28380,3575882544,3575882550,6
1,1031,28381,3575882544,3575882552,8
1,1031,28382,3575882544,3575882552,8
1,1031,28383,3575882544,3575882553,9
1,1031,28384,3575882544,3575882553,9
1,1031,28385,3575882544,3575882555,11
1,1031,28386,3575882544,3575882556,12
1,1031,28387,3575882544,3575882556,12
1,1031,28388,3575882544,3575882557,13
1,1031,28389,3575882544,3575882558,14
1,1031,28390,3575882544,3575882559,15
1,1031,28391,3575882544,3575882559,15
1,1031,28392,3575882544,3575882559,15
1,1031,28393,3575882544,3575882560,16
1,1031,28394,3575882544,3575882560,16
1,1031,28395,3575882544,3575882562,18
1,1031,28396,3575882544,3575882563,19
1,1031,28397,3575882544,3575882563,19
1,1031,28398,3575882544,3575882563,19
1,1031,28399,3575882544,3575882564,20
1,1031,28400,3575882544,3575882565,21
1,1031,28401,3575882544,3575882565,21
1,1031,28402,3575882544,3575882568,24
1,1031,28403,3575882544,3575882570,26
1,1031,28404,3575882544,3575882573,29
1,1031,28405,3575882544,3575882573,29
1,1031,28406,3575882544,3575882574,30
1,1031,28407,3575882544,3575882574,30
1,1031,28408,3575882544,3575882575,31
1,1031,28409,3575882544,3575882575,31
1,1031,28410,3575882544,3575882577,33
1,1031,28411,3575882544,3575882577,33
1,1031,28412,3575882544,3575882577,33
1,1031,28413,3575882544,3575882578,34
1,1031,28414,3575882544,3575882579,35
1,1031,28415,3575882544,3575882580,36
1,1031,28416,3575882544,3575882580,36
1,1031,28417,3575882544,3575882581,37
1,1031,28418,3575882544,3575882582,38
1,1031,28419,3575882544,3575882582,38
1,1031,28420,3575882544,3575882582,38
1,1031,28421,3575882544,3575882582,38
1,1031,28422,3575882544,3575882583,39
1,1031,28423,3575882544,3575882583,39
1,1031,28424,3575882544,3575882583,39
1,1031,28425,3575882544,3575882584,40
1,1031,28426,3575882544,3575882584,40
1,1031,28427,3575882544,3575882584,40
1,1031,28428,3575882544,3575882585,41
1,1031,28429,3575882544,3575882587,43
1,1031,28430,3575882544,3575882589,45
1,1031,28431,3575882544,3575882589,45
1,1031,28432,3575882544,3575882590,46
1,1031,28433,3575882544,3575882591,47
1,1031,28434,3575882544,3575882591,47
1,1031,28435,3575882544,3575882591,47
1,1031,28436,3575882544,3575882592,48
1,1031,28437,3575882544,3575882594,50
1,1032,28438,3575882615,3575882615,0
1,1032,28439,3575882615,3575882615,0
1,1032,28440,3575882615,3575882615,0
1,1032,28441,3575882615,3575882615,0
1,1032,28442,3575882615,3575882615,0
1,1032,28443,3575882615,3575882615,0
1,1032,28444,3575882615,3575882615,0
1,1032,28445,3575882615,3575882615,0
1,1032,28446,3575882615,3575882615,0
1,1032,28447,3575882615,3575882615,0
1,1032,28448,3575882615,3575882615,0
1,1032,28449,3575882615,3575882615,0
1,1032,28450,3575882615,3575882615,0
1,1032,28451,3575882615,3575882615,0
1,1032,28452,3575882615,3575882615,0
1,1032,28453,3575882615,3575882615,0
1,1032,28454,3575882615,3575882615,0
1,1032,28455,3575882615,3575882615,0
1,1032,28456,3575882615,3575882615,0
1,1032,28457,3575882615,3575882615,0
1,1032,28458,3575882615,3575882615,0
1,1032,28459,3575882615,3575882615,0
1,1032,28460,3575882615,3575882615,0
1,1032,28461,3575882615,3575882615,0
1,1032,28462,3575882615,3575882615,0
1,1032,28463,3575882615,3575882615,0
1,1032,28464,3575882615,3575882615,0
1,1032,28465,3575882615,3575882615,0
1,1032,28466,3575882615,3575882615,0
1,1032,28467,3575882615,3575882615,0
1,1032,28468,3575882615,3575882615,0
1,1032,28469,3575882615,3575882615,0
1,1032,28470,3575882615,3575882616,1
1,1032,28471,3575882615,3575882616,1
1,1032,28472,3575882615,3575882616,1
1,1032,28473,3575882615,3575882616,1
1,1032,28474,3575882615,3575882616,1
1,1032,28475,3575882615,3575882617,2
1,1032,28476,3575882615,3575882617,2
1,1032,28477,3575882615,3575882617,2
1,1032,28478,3575882615,3575882617,2
1,1032,28479,3575882615,3575882621,6
1,1032,28480,3575882615,3575882621,6
1,1032,28481,3575882615,3575882622,7
1,1032,28482,3575882615,3575882622,7
1,1032,28483,3575882615,3575882623,8
1,1032,28484,3575882615,3575882623,8
1,1032,28485,3575882615,3575882624,9
1,1032,28486,3575882615,3575882625,10
1,1032,28487,3575882615,3575882627,12
1,1032,28488,3575882615,3575882627,12
1,1032,28489,3575882615,3575882630,15
1,1032,28490,3575882615,3575882630,15
1,1032,28491,3575882615,3575882630,15
1,1032,28492,3575882615,3575882631,16
1,1032,28493,3575882615,3575882631,16
1,1032,28494,3575882615,3575882632,17
1,1032,28495,3575882615,3575882632,17
1,1032,28496,3575882615,3575882635,20
1,1032,28497,3575882615,3575882635,20
1,1032,28498,3575882615,3575882636,21
1,1032,28499,3575882615,3575882638,23
1,1032,28500,3575882615,3575882639,24
1,1032,28501,3575882615,3575882639,24
1,1032,28502,3575882615,3575882641,26
1,1032,28503,3575882615,3575882642,27
1,1032,28504,3575882615,3575882642,27
1,1032,28505,3575882615,3575882643,28
1,1032,28506,3575882615,3575882644,29
1,1032,28507,3575882615,3575882644,29
1,1032,28508,3575882615,3575882645,30
1,1032,28509,3575882615,3575882645,30
1,1032,28510,3575882615,3575882647,32
1,1032,28511,3575882615,3575882647,32
1,1032,28512,3575882615,3575882647,32
1,1032,28513,3575882615,3575882647,32
1,1032,28514,3575882615,3575882648,33
1,1032,28515,3575882615,3575882650,35
1,1032,28516,3575882615,3575882650,35
1,1032,28517,3575882615,3575882651,36
1,1032,28518,3575882615,3575882651,36
1,1032,28519,3575882615,3575882653,38
1,1032,28520,3575882615,3575882653,38
1,1032,28521,3575882615,3575882654,39
1,1032,28522,3575882615,3575882655,40
1,1032,28523,3575882615,3575882656,41
1,1032,28524,3575882615,3575882656,41
1,1032,28525,3575882615,3575882657,42
1,1032,28526,3575882615,3575882657,42
1,1032,28527,3575882615,3575882658,43
1,1032,28528,3575882615,3575882658,43
1,1032,28529,3575882615,3575882658,43
1,1033,28530,3575882680,3575882680,0
1,1033,28531,3575882680,3575882680,0
1,1033,28532,3575882680,3575882680,0
1,1033,28533,3575882680,3575882680,0
1,1033,28534,3575882680,3575882680,0
1,1033,28535,3575882680,3575882680,0
1,1033,28536,3575882680,3575882680,0
1,1033,28537,3575882680,3575882680,0
1,1033,28538,3575882680,3575882681,1
1,1033,28539,3575882680,3575882682,2
1,1033,28540,3575882680,3575882682,2
1,1033,28541,3575882680,3575882683,3
1,1033,28542,3575882680,3575882685,5
1,1033,28543,3575882680,3575882685,5
1,1033,28544,3575882680,3575882685,5
1,1033,28545,3575882680,3575882686,6
1,1033,28546,3575882680,3575882687,7
1,1033,28547,3575882680,3575882688,8
1,1033,28548,3575882680,3575882688,8
1,1033,28549,3575882680,3575882689,9
1,1033,28550,3575882680,3575882693,13
1,1033,28551,3575882680,3575882694,14
1,1033,28552,3575882680,3575882695,15
1,1033,28553,3575882680,3575882696,16
1,1033,28554,3575882680,3575882698,18
1,1033,28555,3575882680,3575882699,19
1,1033,28556,3575882680,3575882699,19
1,1033,28557,3575882680,3575882700,20
1,1033,28558,3575882680,3575882700,20
1,1033,28559,3575882680,3575882701,21
1,1033,28560,3575882680,3575882701,21
1,1033,28561,3575882680,3575882702,22
1,1033,28562,3575882680,3575882703,23
1,1033,28563,3575882680,3575882703,23
1,1033,28564,3575882680,3575882703,23
1,1033,28565,3575882680,3575882704,24
1,1033,28566,3575882680,3575882705,25
1,1033,28567,3575882680,3575882705,25
1,1033,28568,3575882680,3575882705,25
1,1033,28569,3575882680,3575882706,26
1,1033,28570,3575882680,3575882706,26
1,1033,28571,3575882680,3575882706,26
1,1033,28572,3575882680,3575882707,27
1,1033,28573,3575882680,3575882708,28
1,1033,28574,3575882680,3575882709,29
1,1033,28575,3575882680,3575882710,30
1,1033,28576,3575882680,3575882710,30
1,1033,28577,3575882680,3575882711,31
1,1033,28578,3575882680,3575882711,31
1,1033,28579,3575882680,3575882713,33
1,1033,28580,3575882680,3575882717,37
1,1033,28581,3575882680,3575882718,38
1,1033,28582,3575882680,3575882718,38
1,1033,28583,3575882680,3575882718,38
1,1033,28584,3575882680,3575882719,39
1,1033,28585,3575882680,3575882720,40
1,1033,28586,3575882680,3575882721,41
1,1033,28587,3575882680,3575882723,43
1,1033,28588,3575882680,3575882723,43
1,1033,28589,3575882680,3575882724,44
1,1033,28590,3575882680,3575882725,45
1,1033,28591,3575882680,3575882725,45
1,1033,28592,3575882680,3575882725,45
1,1033,28593,3575882680,3575882726,46
1,1033,28594,3575882680,3575882727,47
1,1033,28595,3575882680,3575882728,48
1,1033,28596,3575882680,3575882729,49
1,1033,28597,3575882680,3575882730,50
1,1034,28598,3575882747,3575882747,0
1,1034,28599,3575882747,3575882747,0
1,1034,28600,3575882747,3575882747,0
1,1034,28601,3575882747,3575882747,0
1,1034,28602,3575882747,3575882747,0
1,1034,28603,3575882747,3575882747,0
1,1034,28604,3575882747,3575882747,0
1,1034,28605,3575882747,3575882747,0
1,1034,28606,3575882747,3575882747,0
1,1034,28607,3575882747,3575882747,0
1,1034,28608,3575882747,3575882747,0
1,1034,28609,3575882747,3575882747,0
1,1034,28610,3575882747,3575882747,0
1,1034,28611,3575882747,3575882747,0
1,1034,28612,3575882747,3575882747,0
1,1034,28613,3575882747,3575882747,0
1,1034,28614,3575882747,3575882748,1
1,1034,28615,3575882747,3575882749,2
1,1034,28616,3575882747,3575882750,3
1,1034,28617,3575882747,3575882750,3
1,1034,28618,3575882747,3575882750,3
1,1034,28619,3575882747,3575882750,3
1,1034,28620,3575882747,3575882751,4
1,1034,28621,3575882747,3575882752,5
1,1034,28622,3575882747,3575882753,6
1,1034,28623,3575882747,3575882753,6
1,1034,28624,3575882747,3575882753,6
1,1034,28625,3575882747,3575882755,8
1,1034,28626,3575882747,3575882755,8
1,1034,28627,3575882747,3575882756,9
1,1034,28628,3575882747,3575882757,10
1,1034,28629,3575882747,3575882758,11
1,1034,28630,3575882747,3575882759,12
1,1034,28631,3575882747,3575882760,13
1,1034,28632,3575882747,3575882761,14
1,1034,28633,3575882747,3575882762,15
1,1034,28634,3575882747,3575882762,15
1,1034,28635,3575882747,3575882762,15
1,1034,28636,3575882747,3575882763,16
1,1034,28637,3575882747,3575882763,16
1,1034,28638,3575882747,3575882763,16
1,1034,28639,3575882747,3575882765,18
1,1034,28640,3575882747,3575882765,18
1,1034,28641,3575882747,3575882769,22
1,1034,28642,3575882747,3575882770,23
1,1034,28643,3575882747,3575882773,26
1,1034,28644,3575882747,3575882774,27
1,1034,28645,3575882747,3575882774,27
1,1034,28646,3575882747,3575882774,27
1,1034,28647,3575882747,3575882774,27
1,1034,28648,3575882747,3575882777,30
1,1034,28649,3575882747,3575882778,31
1,1034,28650,3575882747,3575882778,31
1,1034,28651,3575882747,3575882779,32
1,1034,28652,3575882747,3575882780,33
1,1034,28653,3575882747,3575882780,33
1,1034,28654,3575882747,3575882780,33
1,1034,28655,3575882747,3575882781,34
1,1034,28656,3575882747,3575882782,35
1,1034,28657,3575882747,3575882782,35
1,1034,28658,3575882747,3575882782,35
1,1034,28659,3575882747,3575882782,35
1,1034,28660,3575882747,3575882783,36
1,1034,28661,3575882747,3575882784,37
1,1034,28662,3575882747,3575882784,37
1,1034,28663,3575882747,3575882785,38
1,1034,28664,3575882747,3575882785,38
1,1034,28665,3575882747,3575882785,38
1,1034,28666,3575882747,3575882787,40
1,1034,28667,3575882747,3575882790,43
1,1034,28668,3575882747,3575882790,43
1,1034,28669,3575882747,3575882791,44
1,1034,28670,3575882747,3575882791,44
1,1034,28671,3575882747,3575882792,45
1,1034,28672,3575882747,3575882792,45
1,1034,28673,3575882747,3575882794,47
1,1034,28674,3575882747,3575882794,47
1,1034,28675,3575882747,3575882795,48
1,1034,28676,3575882747,3575882796,49
1,1034,28677,3575882747,3575882797,50
1,1035,28678,3575882816,3575882816,0
1,1035,28679,3575882816,3575882816,0
1,1035,28680,3575882816,3575882816,0
1,1035,28681,3575882816,3575882816,0
1,1035,28682,3575882816,3575882816,0
1,1035,28683,3575882816,3575882816,0
1,1035,28684,3575882816,3575882816,0
1,1035,28685,3575882816,3575882816,0
1,1035,28686,3575882816,3575882816,0
1,1035,28687,3575882816,3575882816,0
1,1035,28688,3575882816,3575882816,0
1,1035,28689,3575882816,3575882816,0
1,1035,28690,3575882816,3575882816,0
1,1035,28691,3575882816,3575882816,0
1,1035,28692,3575882816,3575882816,0
1,1035,28693,3575882816,3575882816,0
1,1035,28694,3575882816,3575882816,0
1,1035,28695,3575882816,3575882816,0
1,1035,28696,3575882816,3575882816,0
1,1035,28697,3575882816,3575882816,0
1,1035,28698,3575882816,3575882816,0
1,1035,28699,3575882816,3575882816,0
1,1035,28700,3575882816,3575882816,0
1,1035,28701,3575882816,3575882816,0
1,1035,28702,3575882816,3575882816,0
1,1035,28703,3575882816,3575882816,0
1,1035,28704,3575882816,3575882816,0
1,1035,28705,3575882816,3575882816,0
1,1035,28706,3575882816,3575882816,0
1,1035,28707,3575882816,3575882816,0
1,1035,28708,3575882816,3575882816,0
1,1035,28709,3575882816,3575882817,1
1,1035,28710,3575882816,3575882817,1
1,1035,28711,3575882816,3575882817,1
1,1035,28712,3575882816,3575882817,1
1,1035,28713,3575882816,3575882817,1
1,1035,28714,3575882816,3575882817,1
1,1035,28715,3575882816,3575882819,3
1,1035,28716,3575882816,3575882821,5
1,1035,28717,3575882816,3575882822,6
1,1035,28718,3575882816,3575882822,6
1,1035,28719,3575882816,3575882823,7
1,1035,28720,3575882816,3575882823,7
1,1035,28721,3575882816,3575882824,8
1,1035,28722,3575882816,3575882824,8
1,1035,28723,3575882816,3575882825,9
1,1035,28724,3575882816,3575882829,13
1,1035,28725,3575882816,3575882830,14
1,1035,28726,3575882816,3575882830,14
1,1035,28727,3575882816,3575882831,15
1,1035,28728,3575882816,3575882831,15
1,1035,28729,3575882816,3575882831,15
1,1035,28730,3575882816,3575882832,16
1,1035,28731,3575882816,3575882834,18
1,1035,28732,3575882816,3575882834,18
1,1035,28733,3575882816,3575882837,21
1,1035,28734,3575882816,3575882838,22
1,1035,28735,3575882816,3575882839,23
1,1035,28736,3575882816,3575882839,23
1,1035,28737,3575882816,3575882841,25
1,1035,28738,3575882816,3575882841,25
1,1035,28739,3575882816,3575882842,26
1,1035,28740,3575882816,3575882844,28
1,1035,28741,3575882816,3575882844,28
1,1035,28742,3575882816,3575882845,29
1,1035,28743,3575882816,3575882846,30
1,1035,28744,3575882816,3575882846,30
1,1035,28745,3575882816,3575882846,30
1,1035,28746,3575882816,3575882847,31
1,1035,28747,3575882816,3575882848,32
1,1035,28748,3575882816,3575882848,32
1,1035,28749,3575882816,3575882848,32
1,1035,28750,3575882816,3575882850,34
1,1035,28751,3575882816,3575882850,34
1,1035,28752,3575882816,3575882850,34
1,1035,28753,3575882816,3575882850,34
1,1035,28754,3575882816,3575882851,35
1,1035,28755,3575882816,3575882853,37
1,1035,28756,3575882816,3575882853,37
1,1035,28757,3575882816,3575882854,38
1,1035,28758,3575882816,3575882854,38
1,1035,28759,3575882816,3575882855,39
1,1035,28760,3575882816,3575882857,41
1,1035,28761,3575882816,3575882857,41
1,1035,28762,3575882816,3575882858,42
1,1035,28763,3575882816,3575882858,42
1,1035,28764,3575882816,3575882858,42
1,1035,28765,3575882816,3575882858,42
1,1035,28766,3575882816,3575882858,42
1,1035,28767,3575882816,3575882862,46
1,1035,28768,3575882816,3575882866,50
1,1036,28769,3575882879,3575882879,0
1,1036,28770,3575882879,3575882879,0
1,1036,28771,3575882879,3575882879,0
1,1036,28772,3575882879,3575882879,0
1,1036,28773,3575882879,3575882879,0
1,1036,28774,3575882879,3575882879,0
1,1036,28775,3575882879,3575882879,0
1,1036,28776,3575882879,3575882881,2
1,1036,28777,3575882879,3575882882,3
1,1036,28778,3575882879,3575882883,4
1,1036,28779,3575882879,3575882885,6
1,1036,28780,3575882879,3575882885,6
1,1036,28781,3575882879,3575882885,6
1,1036,28782,3575882879,3575882886,7
1,1036,28783,3575882879,3575882886,7
1,1036,28784,3575882879,3575882887,8
1,1036,28785,3575882879,3575882887,8
1,1036,28786,3575882879,3575882887,8
1,1036,28787,3575882879,3575882889,10
1,1036,28788,3575882879,3575882889,10
1,1036,28789,3575882879,3575882894,15
1,1036,28790,3575882879,3575882895,16
1,1036,28791,3575882879,3575882895,16
1,1036,28792,3575882879,3575882895,16
1,1036,28793,3575882879,3575882898,19
1,1036,28794,3575882879,3575882899,20
1,1036,28795,3575882879,3575882899,20
1,1036,28796,3575882879,3575882900,21
1,1036,28797,3575882879,3575882901,22
1,1036,28798,3575882879,3575882901,22
1,1036,28799,3575882879,3575882901,22
1,1036,28800,3575882879,3575882902,23
1,1036,28801,3575882879,3575882902,23
1,1036,28802,3575882879,3575882903,24
1,1036,28803,3575882879,3575882903,24
1,1036,28804,3575882879,3575882904,25
1,1036,28805,3575882879,3575882904,25
1,1036,28806,3575882879,3575882905,26
1,1036,28807,3575882879,3575882905,26
1,1036,28808,3575882879,3575882905,26
1,1036,28809,3575882879,3575882906,27
1,1036,28810,3575882879,3575882906,27
1,1036,28811,3575882879,3575882908,29
1,1036,28812,3575882879,3575882909,30
1,1036,28813,3575882879,3575882910,31
1,1036,28814,3575882879,3575882910,31
1,1036,28815,3575882879,3575882910,31
1,1036,28816,3575882879,3575882911,32
1,1036,28817,3575882879,3575882912,33
1,1036,28818,3575882879,3575882912,33
1,1036,28819,3575882879,3575882914,35
1,1036,28820,3575882879,3575882917,38
1,1036,28821,3575882879,3575882918,39
1,1036,28822,3575882879,3575882918,39
1,1036,28823,3575882879,3575882919,40
1,1036,28824,3575882879,3575882919,40
1,1036,28825,3575882879,3575882919,40
1,1036,28826,3575882879,3575882921,42
1,1036,28827,3575882879,3575882922,43
1,1036,28828,3575882879,3575882923,44
1,1036,28829,3575882879,3575882923,44
1,1036,28830,3575882879,3575882924,45
1,1036,28831,3575882879,3575882925,46
1,1036,28832,3575882879,3575882926,47
1,1036,28833,3575882879,3575882927,48
1,1036,28834,3575882879,3575882927,48
1,1036,28835,3575882879,3575882928,49
1,1036,28836,3575882879,3575882929,50
1,1037,28837,3575882944,3575882944,0
1,1037,28838,3575882944,3575882944,0
1,1037,28839,3575882944,3575882944,0
1,1037,28840,3575882944,3575882944,0
1,1037,28841,3575882944,3575882944,0
1,1037,28842,3575882944,3575882944,0
1,1037,28843,3575882944,3575882944,0
1,1037,28844,3575882944,3575882944,0
1,1037,28845,3575882944,3575882944,0
1,1037,28846,3575882944,3575882944,0
1,1037,28847,3575882944,3575882944,0
1,1037,28848,3575882944,3575882944,0
1,1037,28849,3575882944,3575882944,0
1,1037,28850,3575882944,3575882944,0
1,1037,28851,3575882944,3575882944,0
1,1037,28852,3575882944,3575882944,0
1,1037,28853,3575882944,3575882944,0
1,1037,28854,3575882944,3575882949,5
1,1037,28855,3575882944,3575882950,6
1,1037,28856,3575882944,3575882950,6
1,1037,28857,3575882944,3575882950,6
1,1037,28858,3575882944,3575882951,7
1,1037,28859,3575882944,3575882952,8
1,1037,28860,3575882944,3575882953,9
1,1037,28861,3575882944,3575882953,9
1,1037,28862,3575882944,3575882953,9
1,1037,28863,3575882944,3575882953,9
1,1037,28864,3575882944,3575882953,9
1,1037,28865,3575882944,3575882954,10
1,1037,28866,3575882944,3575882955,11
1,1037,28867,3575882944,3575882956,12
1,1037,28868,3575882944,3575882957,13
1,1037,28869,3575882944,3575882958,14
1,1037,28870,3575882944,3575882960,16
1,1037,28871,3575882944,3575882960,16
1,1037,28872,3575882944,3575882962,18
1,1037,28873,3575882944,3575882962,18
1,1037,28874,3575882944,3575882962,18
1,1037,28875,3575882944,3575882962,18
1,1037,28876,3575882944,3575882963,19
1,1037,28877,3575882944,3575882963,19
1,1037,28878,3575882944,3575882963,19
1,1037,28879,3575882944,3575882965,21
1,1037,28880,3575882944,3575882966,22
1,1037,28881,3575882944,3575882969,25
1,1037,28882,3575882944,3575882971,27
1,1037,28883,3575882944,3575882972,28
1,1037,28884,3575882944,3575882974,30
1,1037,28885,3575882944,3575882974,30
1,1037,28886,3575882944,3575882974,30
1,1037,28887,3575882944,3575882975,31
1,1037,28888,3575882944,3575882977,33
1,1037,28889,3575882944,3575882978,34
1,1037,28890,3575882944,3575882978,34
1,1037,28891,3575882944,3575882979,35
1,1037,28892,3575882944,3575882979,35
1,1037,28893,3575882944,3575882980,36
1,1037,28894,3575882944,3575882981,37
1,1037,28895,3575882944,3575882981,37
1,1037,28896,3575882944,3575882982,38
1,1037,28897,3575882944,3575882982,38
1,1037,28898,3575882944,3575882983,39
1,1037,28899,3575882944,3575882983,39
1,1037,28900,3575882944,3575882983,39
1,1037,28901,3575882944,3575882984,40
1,1037,28902,3575882944,3575882984,40
1,1037,28903,3575882944,3575882984,40
1,1037,28904,3575882944,3575882985,41
1,1037,28905,3575882944,3575882986,42
1,1037,28906,3575882944,3575882990,46
1,1037,28907,3575882944,3575882991,47
1,1037,28908,3575882944,3575882991,47
1,1037,28909,3575882944,3575882992,48
1,1037,28910,3575882944,3575882992,48
1,1037,28911,3575882944,3575882993,49
1,1037,28912,3575882944,3575882994,50
1,1038,28913,3575883007,3575883007,0
1,1038,28914,3575883007,3575883007,0
1,1038,28915,3575883007,3575883007,0
1,1038,28916,3575883007,3575883007,0
1,1038,28917,3575883007,3575883007,0
1,1038,28918,3575883007,3575883007,0
1,1038,28919,3575883007,3575883007,0
1,1038,28920,3575883007,3575883007,0
1,1038,28921,3575883007,3575883007,0
1,1038,28922,3575883007,3575883007,0
1,1038,28923,3575883007,3575883007,0
1,1038,28924,3575883007,3575883007,0
1,1038,28925,3575883007,3575883007,0
1,1038,28926,3575883007,3575883007,0
1,1038,28927,3575883007,3575883007,0
1,1038,28928,3575883007,3575883007,0
1,1038,28929,3575883007,3575883007,0
1,1038,28930,3575883007,3575883007,0
1,1038,28931,3575883007,3575883007,0
1,1038,28932,3575883007,3575883007,0
1,1038,28933,3575883007,3575883007,0
1,1038,28934,3575883007,3575883008,1
1,1038,28935,3575883007,3575883008,1
1,1038,28936,3575883007,3575883008,1
1,1038,28937,3575883007,3575883009,2
1,1038,28938,3575883007,3575883010,3
1,1038,28939,3575883007,3575883012,5
1,1038,28940,3575883007,3575883012,5
1,1038,28941,3575883007,3575883012,5
1,1038,28942,3575883007,3575883014,7
1,1038,28943,3575883007,3575883015,8
1,1038,28944,3575883007,3575883016,9
1,1038,28945,3575883007,3575883016,9
1,1038,28946,3575883007,3575883017,10
1,1038,28947,3575883007,3575883017,10
1,1038,28948,3575883007,3575883017,10
1,1038,28949,3575883007,3575883017,10
1,1038,28950,3575883007,3575883017,10
1,1038,28951,3575883007,3575883017,10
1,1038,28952,3575883007,3575883019,12
1,1038,28953,3575883007,3575883021,14
1,1038,28954,3575883007,3575883021,14
1,1038,28955,3575883007,3575883022,15
1,1038,28956,3575883007,3575883022,15
1,1038,28957,3575883007,3575883023,16
1,1038,28958,3575883007,3575883023,16
1,1038,28959,3575883007,3575883024,17
1,1038,28960,3575883007,3575883024,17
1,1038,28961,3575883007,3575883025,18
1,1038,28962,3575883007,3575883028,21
1,1038,28963,3575883007,3575883029,22
1,1038,28964,3575883007,3575883029,22
1,1038,28965,3575883007,3575883030,23
1,1038,28966,3575883007,3575883031,24
1,1038,28967,3575883007,3575883031,24
1,1038,28968,3575883007,3575883031,24
1,1038,28969,3575883007,3575883032,25
1,1038,28970,3575883007,3575883034,27
1,1038,28971,3575883007,3575883038,31
1,1038,28972,3575883007,3575883038,31
1,1038,28973,3575883007,3575883039,32
1,1038,28974,3575883007,3575883040,33
1,1038,28975,3575883007,3575883041,34
1,1038,28976,3575883007,3575883041,34
1,1038,28977,3575883007,3575883042,35
1,1038,28978,3575883007,3575883043,36
1,1038,28979,3575883007,3575883043,36
1,1038,28980,3575883007,3575883044,37
1,1038,28981,3575883007,3575883045,38
1,1038,28982,3575883007,3575883045,38
1,1038,28983,3575883007,3575883045,38
1,1038,28984,3575883007,3575883046,39
1,1038,28985,3575883007,3575883046,39
1,1038,28986,3575883007,3575883047,40
1,1038,28987,3575883007,3575883047,40
1,1038,28988,3575883007,3575883047,40
1,1038,28989,3575883007,3575883048,41
1,1038,28990,3575883007,3575883048,41
1,1038,28991,3575883007,3575883048,41
1,1038,28992,3575883007,3575883049,42
1,1038,28993,3575883007,3575883050,43
1,1038,28994,3575883007,3575883050,43
1,1038,28995,3575883007,3575883050,43
1,1038,28996,3575883007,3575883051,44
1,1038,28997,3575883007,3575883053,46
1,1038,28998,3575883007,3575883053,46
1,1038,28999,3575883007,3575883054,47
1,1038,29000,3575883007,3575883054,47
1,1038,29001,3575883007,3575883057,50
1,1039,29002,3575883071,3575883071,0
1,1039,29003,3575883071,3575883071,0
1,1039,29004,3575883071,3575883071,0
1,1039,29005,3575883071,3575883071,0
1,1039,29006,3575883071,3575883071,0
1,1039,29007,3575883071,3575883071,0
1,1039,29008,3575883071,3575883071,0
1,1039,29009,3575883071,3575883071,0
1,1039,29010,3575883071,3575883071,0
1,1039,29011,3575883071,3575883071,0
1,1039,29012,3575883071,3575883071,0
1,1039,29013,3575883071,3575883071,0
1,1039,29014,3575883071,3575883071,0
1,1039,29015,3575883071,3575883071,0
1,1039,29016,3575883071,3575883079,8
1,1039,29017,3575883071,3575883080,9
1,1039,29018,3575883071,3575883081,10
1,1039,29019,3575883071,3575883082,11
1,1039,29020,3575883071,3575883084,13
1,1039,29021,3575883071,3575883085,14
1,1039,29022,3575883071,3575883086,15
1,1039,29023,3575883071,3575883086,15
1,1039,29024,3575883071,3575883087,16
1,1039,29025,3575883071,3575883087,16
1,1039,29026,3575883071,3575883089,18
1,1039,29027,3575883071,3575883089,18
1,1039,29028,3575883071,3575883094,23
1,1039,29029,3575883071,3575883094,23
1,1039,29030,3575883071,3575883095,24
1,1039,29031,3575883071,3575883097,26
1,1039,29032,3575883071,3575883098,27
1,1039,29033,3575883071,3575883098,27
1,1039,29034,3575883071,3575883099,28
1,1039,29035,3575883071,3575883100,29
1,1039,29036,3575883071,3575883100,29
1,1039,29037,3575883071,3575883101,30
1,1039,29038,3575883071,3575883101,30
1,1039,29039,3575883071,3575883102,31
1,1039,29040,3575883071,3575883103,32
1,1039,29041,3575883071,3575883103,32
1,1039,29042,3575883071,3575883103,32
1,1039,29043,3575883071,3575883104,33
1,1039,29044,3575883071,3575883104,33
1,1039,29045,3575883071,3575883105,34
1,1039,29046,3575883071,3575883105,34
1,1039,29047,3575883071,3575883106,35
1,1039,29048,3575883071,3575883106,35
1,1039,29049,3575883071,3575883106,35
1,1039,29050,3575883071,3575883108,37
1,1039,29051,3575883071,3575883108,37
1,1039,29052,3575883071,3575883109,38
1,1039,29053,3575883071,3575883110,39
1,1039,29054,3575883071,3575883111,40
1,1039,29055,3575883071,3575883111,40
1,1039,29056,3575883071,3575883111,40
1,1039,29057,3575883071,3575883113,42
1,1039,29058,3575883071,3575883114,43
1,1039,29059,3575883071,3575883116,45
1,1039,29060,3575883071,3575883118,47
1,1039,29061,3575883071,3575883119,48
1,1039,29062,3575883071,3575883119,48
1,1039,29063,3575883071,3575883119,48
1,1039,29064,3575883071,3575883119,48
1,1039,29065,3575883071,3575883121,50
1,1040,29066,3575883135,3575883135,0
1,1040,29067,3575883135,3575883135,0
1,1040,29068,3575883135,3575883135,0
1,1040,29069,3575883135,3575883135,0
1,1040,29070,3575883135,3575883135,0
1,1040,29071,3575883135,3575883135,0
1,1040,29072,3575883135,3575883135,0
1,1040,29073,3575883135,3575883135,0
1,1040,29074,3575883135,3575883135,0
1,1040,29075,3575883135,3575883135,0
1,1040,29076,3575883135,3575883135,0
1,1040,29077,3575883135,3575883135,0
1,1040,29078,3575883135,3575883135,0
1,1040,29079,3575883135,3575883135,0
1,1040,29080,3575883135,3575883135,0
1,1040,29081,3575883135,3575883135,0
1,1040,29082,3575883135,3575883135,0
1,1040,29083,3575883135,3575883135,0
1,1040,29084,3575883135,3575883135,0
1,1040,29085,3575883135,3575883135,0
1,1040,29086,3575883135,3575883136,1
1,1040,29087,3575883135,3575883138,3
1,1040,29088,3575883135,3575883139,4
1,1040,29089,3575883135,3575883141,6
1,1040,29090,3575883135,3575883143,8
1,1040,29091,3575883135,3575883144,9
1,1040,29092,3575883135,3575883144,9
1,1040,29093,3575883135,3575883146,11
1,1040,29094,3575883135,3575883149,14
1,1040,29095,3575883135,3575883149,14
1,1040,29096,3575883135,3575883150,15
1,1040,29097,3575883135,3575883150,15
1,1040,29098,3575883135,3575883151,16
1,1040,29099,3575883135,3575883151,16
1,1040,29100,3575883135,3575883152,17
1,1040,29101,3575883135,3575883152,17
1,1040,29102,3575883135,3575883152,17
1,1040,29103,3575883135,3575883152,17
1,1040,29104,3575883135,3575883153,18
1,1040,29105,3575883135,3575883153,18
1,1040,29106,3575883135,3575883155,20
1,1040,29107,3575883135,3575883155,20
1,1040,29108,3575883135,3575883156,21
1,1040,29109,3575883135,3575883157,22
1,1040,29110,3575883135,3575883158,23
1,1040,29111,3575883135,3575883159,24
1,1040,29112,3575883135,3575883160,25
1,1040,29113,3575883135,3575883161,26
1,1040,29114,3575883135,3575883161,26
1,1040,29115,3575883135,3575883162,27
1,1040,29116,3575883135,3575883163,28
1,1040,29117,3575883135,3575883163,28
1,1040,29118,3575883135,3575883163,28
1,1040,29119,3575883135,3575883163,28
1,1040,29120,3575883135,3575883164,29
1,1040,29121,3575883135,3575883165,30
1,1040,29122,3575883135,3575883166,31
1,1040,29123,3575883135,3575883169,34
1,1040,29124,3575883135,3575883174,39
1,1040,29125,3575883135,3575883174,39
1,1040,29126,3575883135,3575883174,39
1,1040,29127,3575883135,3575883174,39
1,1040,29128,3575883135,3575883177,42
1,1040,29129,3575883135,3575883177,42
1,1040,29130,3575883135,3575883178,43
1,1040,29131,3575883135,3575883179,44
1,1040,29132,3575883135,3575883179,44
1,1040,29133,3575883135,3575883181,46
1,1040,29134,3575883135,3575883181,46
1,1040,29135,3575883135,3575883181,46
1,1040,29136,3575883135,3575883182,47
1,1040,29137,3575883135,3575883183,48
1,1040,29138,3575883135,3575883183,48
1,1040,29139,3575883135,3575883183,48
1,1040,29140,3575883135,3575883184,49
1,1040,29141,3575883135,3575883184,49
1,1041,29142,3575883198,3575883198,0
1,1041,29143,3575883198,3575883198,0
1,1041,29144,3575883198,3575883198,0
1,1041,29145,3575883198,3575883198,0
1,1041,29146,3575883198,3575883198,0
1,1041,29147,3575883198,3575883198,0
1,1041,29148,3575883198,3575883198,0
1,1041,29149,3575883198,3575883198,0
1,1041,29150,3575883198,3575883198,0
1,1041,29151,3575883198,3575883198,0
1,1041,29152,3575883198,3575883198,0
1,1041,29153,3575883198,3575883198,0
1,1041,29154,3575883198,3575883198,0
1,1041,29155,3575883198,3575883198,0
1,1041,29156,3575883198,3575883198,0
1,1041,29157,3575883198,3575883200,2
1,1041,29158,3575883198,3575883200,2
1,1041,29159,3575883198,3575883201,3
1,1041,29160,3575883198,3575883201,3
1,1041,29161,3575883198,3575883202,4
1,1041,29162,3575883198,3575883203,5
1,1041,29163,3575883198,3575883203,5
1,1041,29164,3575883198,3575883204,6
1,1041,29165,3575883198,3575883205,7
1,1041,29166,3575883198,3575883205,7
1,1041,29167,3575883198,3575883205,7
1,1041,29168,3575883198,3575883206,8
1,1041,29169,3575883198,3575883207,9
1,1041,29170,3575883198,3575883208,10
1,1041,29171,3575883198,3575883208,10
1,1041,29172,3575883198,3575883209,11
1,1041,29173,3575883198,3575883210,12
1,1041,29174,3575883198,3575883211,13
1,1041,29175,3575883198,3575883212,14
1,1041,29176,3575883198,3575883213,15
1,1041,29177,3575883198,3575883215,17
1,1041,29178,3575883198,3575883215,17
1,1041,29179,3575883198,3575883216,18
1,1041,29180,3575883198,3575883216,18
1,1041,29181,3575883198,3575883217,19
1,1041,29182,3575883198,3575883217,19
1,1041,29183,3575883198,3575883217,19
1,1041,29184,3575883198,3575883217,19
1,1041,29185,3575883198,3575883217,19
1,1041,29186,3575883198,3575883219,21
1,1041,29187,3575883198,3575883222,24
1,1041,29188,3575883198,3575883222,24
1,1041,29189,3575883198,3575883222,24
1,1041,29190,3575883198,3575883223,25
1,1041,29191,3575883198,3575883223,25
1,1041,29192,3575883198,3575883223,25
1,1041,29193,3575883198,3575883224,26
1,1041,29194,3575883198,3575883225,27
1,1041,29195,3575883198,3575883225,27
1,1041,29196,3575883198,3575883225,27
1,1041,29197,3575883198,3575883229,31
1,1041,29198,3575883198,3575883229,31
1,1041,29199,3575883198,3575883230,32
1,1041,29200,3575883198,3575883230,32
1,1041,29201,3575883198,3575883231,33
1,1041,29202,3575883198,3575883231,33
1,1041,29203,3575883198,3575883231,33
1,1041,29204,3575883198,3575883232,34
1,1041,29205,3575883198,3575883232,34
1,1041,29206,3575883198,3575883234,36
1,1041,29207,3575883198,3575883235,37
1,1041,29208,3575883198,3575883236,38
1,1041,29209,3575883198,3575883237,39
1,1041,29210,3575883198,3575883238,40
1,1041,29211,3575883198,3575883239,41
1,1041,29212,3575883198,3575883239,41
1,1041,29213,3575883198,3575883241,43
1,1041,29214,3575883198,3575883241,43
1,1041,29215,3575883198,3575883242,44
1,1041,29216,3575883198,3575883242,44
1,1041,29217,3575883198,3575883243,45
1,1041,29218,3575883198,3575883244,46
1,1041,29219,3575883198,3575883244,46
1,1041,29220,3575883198,3575883245,47
1,1041,29221,3575883198,3575883246,48
1,1041,29222,3575883198,3575883246,48
1,1041,29223,3575883198,3575883246,48
1,1041,29224,3575883198,3575883247,49
1,1041,29225,3575883198,3575883247,49
1,1041,29226,3575883198,3575883248,50
1,1041,29227,3575883198,3575883248,50
1,1042,29228,3575883262,3575883262,0
1,1042,29229,3575883262,3575883262,0
1,1042,29230,3575883262,3575883262,0
1,1042,29231,3575883262,3575883262,0
1,1042,29232,3575883262,3575883262,0
1,1042,29233,3575883262,3575883262,0
1,1042,29234,3575883262,3575883262,0
1,1042,29235,3575883262,3575883262,0
1,1042,29236,3575883262,3575883262,0
1,1042,29237,3575883262,3575883262,0
1,1042,29238,3575883262,3575883262,0
1,1042,29239,3575883262,3575883262,0
1,1042,29240,3575883262,3575883262,0
1,1042,29241,3575883262,3575883262,0
1,1042,29242,3575883262,3575883262,0
1,1042,29243,3575883262,3575883262,0
1,1042,29244,3575883262,3575883262,0
1,1042,29245,3575883262,3575883262,0
1,1042,29246,3575883262,3575883262,0
1,1042,29247,3575883262,3575883267,5
1,1042,29248,3575883262,3575883267,5
1,1042,29249,3575883262,3575883267,5
1,1042,29250,3575883262,3575883267,5
1,1042,29251,3575883262,3575883267,5
1,1042,29252,3575883262,3575883269,7
1,1042,29253,3575883262,3575883269,7
1,1042,29254,3575883262,3575883280,18
1,1042,29255,3575883262,3575883280,18
1,1042,29256,3575883262,3575883282,20
1,1042,29257,3575883262,3575883284,22
1,1042,29258,3575883262,3575883285,23
1,1042,29259,3575883262,3575883285,23
1,1042,29260,3575883262,3575883286,24
1,1042,29261,3575883262,3575883286,24
1,1042,29262,3575883262,3575883286,24
1,1042,29263,3575883262,3575883287,25
1,1042,29264,3575883262,3575883287,25
1,1042,29265,3575883262,3575883288,26
1,1042,29266,3575883262,3575883288,26
1,1042,29267,3575883262,3575883289,27
1,1042,29268,3575883262,3575883290,28
1,1042,29269,3575883262,3575883294,32
1,1042,29270,3575883262,3575883294,32
1,1042,29271,3575883262,3575883295,33
1,1042,29272,3575883262,3575883295,33
1,1042,29273,3575883262,3575883296,34
1,1042,29274,3575883262,3575883297,35
1,1042,29275,3575883262,3575883299,37
1,1042,29276,3575883262,3575883299,37
1,1042,29277,3575883262,3575883300,38
1,1042,29278,3575883262,3575883301,39
1,1042,29279,3575883262,3575883301,39
1,1042,29280,3575883262,3575883302,40
1,1042,29281,3575883262,3575883302,40
1,1042,29282,3575883262,3575883303,41
1,1042,29283,3575883262,3575883303,41
1,1042,29284,3575883262,3575883304,42
1,1042,29285,3575883262,3575883304,42
1,1042,29286,3575883262,3575883304,42
1,1042,29287,3575883262,3575883305,43
1,1042,29288,3575883262,3575883306,44
1,1042,29289,3575883262,3575883306,44
1,1042,29290,3575883262,3575883306,44
1,1042,29291,3575883262,3575883306,44
1,1042,29292,3575883262,3575883309,47
1,1042,29293,3575883262,3575883309,47
1,1042,29294,3575883262,3575883310,48
1,1042,29295,3575883262,3575883311,49
1,1042,29296,3575883262,3575883311,49
1,1042,29297,3575883262,3575883312,50
1,1043,29298,3575883325,3575883325,0
1,1043,29299,3575883325,3575883325,0
1,1043,29300,3575883325,3575883325,0
1,1043,29301,3575883325,3575883325,0
1,1043,29302,3575883325,3575883325,0
1,1043,29303,3575883325,3575883325,0
1,1043,29304,3575883325,3575883325,0
1,1043,29305,3575883325,3575883325,0
1,1043,29306,3575883325,3575883325,0
1,1043,29307,3575883325,3575883325,0
1,1043,29308,3575883325,3575883325,0
1,1043,29309,3575883325,3575883325,0
1,1043,29310,3575883325,3575883325,0
1,1043,29311,3575883325,3575883326,1
1,1043,29312,3575883325,3575883326,1
1,1043,29313,3575883325,3575883327,2
1,1043,29314,3575883325,3575883328,3
1,1043,29315,3575883325,3575883328,3
1,1043,29316,3575883325,3575883330,5
1,1043,29317,3575883325,3575883330,5
1,1043,29318,3575883325,3575883330,5
1,1043,29319,3575883325,3575883331,6
1,1043,29320,3575883325,3575883332,7
1,1043,29321,3575883325,3575883333,8
1,1043,29322,3575883325,3575883334,9
1,1043,29323,3575883325,3575883335,10
1,1043,29324,3575883325,3575883336,11
1,1043,29325,3575883325,3575883336,11
1,1043,29326,3575883325,3575883336,11
1,1043,29327,3575883325,3575883339,14
1,1043,29328,3575883325,3575883339,14
1,1043,29329,3575883325,3575883340,15
1,1043,29330,3575883325,3575883344,19
1,1043,29331,3575883325,3575883344,19
1,1043,29332,3575883325,3575883344,19
1,1043,29333,3575883325,3575883347,22
1,1043,29334,3575883325,3575883350,25
1,1043,29335,3575883325,3575883350,25
1,1043,29336,3575883325,3575883350,25
1,1043,29337,3575883325,3575883350,25
1,1043,29338,3575883325,3575883350,25
1,1043,29339,3575883325,3575883351,26
1,1043,29340,3575883325,3575883351,26
1,1043,29341,3575883325,3575883352,27
1,1043,29342,3575883325,3575883352,27
1,1043,29343,3575883325,3575883353,28
1,1043,29344,3575883325,3575883353,28
1,1043,29345,3575883325,3575883353,28
1,1043,29346,3575883325,3575883353,28
1,1043,29347,3575883325,3575883354,29
1,1043,29348,3575883325,3575883355,30
1,1043,29349,3575883325,3575883357,32
1,1043,29350,3575883325,3575883357,32
1,1043,29351,3575883325,3575883358,33
1,1043,29352,3575883325,3575883359,34
1,1043,29353,3575883325,3575883360,35
1,1043,29354,3575883325,3575883361,36
1,1043,29355,3575883325,3575883362,37
1,1043,29356,3575883325,3575883363,38
1,1043,29357,3575883325,3575883363,38
1,1043,29358,3575883325,3575883363,38
1,1043,29359,3575883325,3575883363,38
1,1043,29360,3575883325,3575883364,39
1,1043,29361,3575883325,3575883365,40
1,1043,29362,3575883325,3575883367,42
1,1043,29363,3575883325,3575883369,44
1,1043,29364,3575883325,3575883370,45
1,1043,29365,3575883325,3575883374,49
1,1043,29366,3575883325,3575883374,49
1,1043,29367,3575883325,3575883374,49
1,1043,29368,3575883325,3575883374,49
1,1043,29369,3575883325,3575883375,50
1,1044,29370,3575883392,3575883392,0
1,1044,29371,3575883392,3575883392,0
1,1044,29372,3575883392,3575883392,0
1,1044,29373,3575883392,3575883392,0
1,1044,29374,3575883392,3575883392,0
1,1044,29375,3575883392,3575883392,0
1,1044,29376,3575883392,3575883392,0
1,1044,29377,3575883392,3575883392,0
1,1044,29378,3575883392,3575883392,0
1,1044,29379,3575883392,3575883392,0
1,1044,29380,3575883392,3575883392,0
1,1044,29381,3575883392,3575883392,0
1,1044,29382,3575883392,3575883392,0
1,1044,29383,3575883392,3575883392,0
1,1044,29384,3575883392,3575883392,0
1,1044,29385,3575883392,3575883392,0
1,1044,29386,3575883392,3575883392,0
1,1044,29387,3575883392,3575883392,0
1,1044,29388,3575883392,3575883392,0
1,1044,29389,3575883392,3575883393,1
1,1044,29390,3575883392,3575883394,2
1,1044,29391,3575883392,3575883394,2
1,1044,29392,3575883392,3575883396,4
1,1044,29393,3575883392,3575883396,4
1,1044,29394,3575883392,3575883397,5
1,1044,29395,3575883392,3575883398,6
1,1044,29396,3575883392,3575883398,6
1,1044,29397,3575883392,3575883399,7
1,1044,29398,3575883392,3575883400,8
1,1044,29399,3575883392,3575883400,8
1,1044,29400,3575883392,3575883402,10
1,1044,29401,3575883392,3575883402,10
1,1044,29402,3575883392,3575883403,11
1,1044,29403,3575883392,3575883404,12
1,1044,29404,3575883392,3575883404,12
1,1044,29405,3575883392,3575883404,12
1,1044,29406,3575883392,3575883404,12
1,1044,29407,3575883392,3575883404,12
1,1044,29408,3575883392,3575883406,14
1,1044,29409,3575883392,3575883407,15
1,1044,29410,3575883392,3575883407,15
1,1044,29411,3575883392,3575883408,16
1,1044,29412,3575883392,3575883409,17
1,1044,29413,3575883392,3575883409,17
1,1044,29414,3575883392,3575883410,18
1,1044,29415,3575883392,3575883411,19
1,1044,29416,3575883392,3575883412,20
1,1044,29417,3575883392,3575883412,20
1,1044,29418,3575883392,3575883415,23
1,1044,29419,3575883392,3575883415,23
1,1044,29420,3575883392,3575883417,25
1,1044,29421,3575883392,3575883417,25
1,1044,29422,3575883392,3575883417,25
1,1044,29423,3575883392,3575883417,25
1,1044,29424,3575883392,3575883418,26
1,1044,29425,3575883392,3575883418,26
1,1044,29426,3575883392,3575883418,26
1,1044,29427,3575883392,3575883418,26
1,1044,29428,3575883392,3575883419,27
1,1044,29429,3575883392,3575883421,29
1,1044,29430,3575883392,3575883422,30
1,1044,29431,3575883392,3575883422,30
1,1044,29432,3575883392,3575883422,30
1,1044,29433,3575883392,3575883423,31
1,1044,29434,3575883392,3575883423,31
1,1044,29435,3575883392,3575883424,32
1,1044,29436,3575883392,3575883425,33
1,1044,29437,3575883392,3575883425,33
1,1044,29438,3575883392,3575883426,34
1,1044,29439,3575883392,3575883430,38
1,1044,29440,3575883392,3575883430,38
1,1044,29441,3575883392,3575883430,38
1,1044,29442,3575883392,3575883431,39
1,1044,29443,3575883392,3575883431,39
1,1044,29444,3575883392,3575883431,39
1,1044,29445,3575883392,3575883433,41
1,1044,29446,3575883392,3575883435,43
1,1044,29447,3575883392,3575883435,43
1,1044,29448,3575883392,3575883436,44
1,1044,29449,3575883392,3575883438,46
1,1044,29450,3575883392,3575883439,47
1,1044,29451,3575883392,3575883439,47
1,1044,29452,3575883392,3575883441,49
1,1044,29453,3575883392,3575883441,49
1,1045,29454,3575883456,3575883456,0
1,1045,29455,3575883456,3575883456,0
1,1045,29456,3575883456,3575883456,0
1,1045,29457,3575883456,3575883456,0
1,1045,29458,3575883456,3575883456,0
1,1045,29459,3575883456,3575883456,0
1,1045,29460,3575883456,3575883456,0
1,1045,29461,3575883456,3575883456,0
1,1045,29462,3575883456,3575883456,0
1,1045,29463,3575883456,3575883456,0
1,1045,29464,3575883456,3575883456,0
1,1045,29465,3575883456,3575883456,0
1,1045,29466,3575883456,3575883456,0
1,1045,29467,3575883456,3575883456,0
1,1045,29468,3575883456,3575883456,0
1,1045,29469,3575883456,3575883456,0
1,1045,29470,3575883456,3575883456,0
1,1045,29471,3575883456,3575883456,0
1,1045,29472,3575883456,3575883456,0
1,1045,29473,3575883456,3575883456,0
1,1045,29474,3575883456,3575883456,0
1,1045,29475,3575883456,3575883456,0
1,1045,29476,3575883456,3575883456,0
1,1045,29477,3575883456,3575883457,1
1,1045,29478,3575883456,3575883458,2
1,1045,29479,3575883456,3575883458,2
1,1045,29480,3575883456,3575883458,2
1,1045,29481,3575883456,3575883458,2
1,1045,29482,3575883456,3575883459,3
1,1045,29483,3575883456,3575883460,4
1,1045,29484,3575883456,3575883463,7
1,1045,29485,3575883456,3575883466,10
1,1045,29486,3575883456,3575883467,11
1,1045,29487,3575883456,3575883467,11
1,1045,29488,3575883456,3575883467,11
1,1045,29489,3575883456,3575883468,12
1,1045,29490,3575883456,3575883469,13
1,1045,29491,3575883456,3575883469,13
1,1045,29492,3575883456,3575883469,13
1,1045,29493,3575883456,3575883479,23
1,1045,29494,3575883456,3575883480,24
1,1045,29495,3575883456,3575883480,24
1,1045,29496,3575883456,3575883481,25
1,1045,29497,3575883456,3575883482,26
1,1045,29498,3575883456,3575883482,26
1,1045,29499,3575883456,3575883483,27
1,1045,29500,3575883456,3575883483,27
1,1045,29501,3575883456,3575883485,29
1,1045,29502,3575883456,3575883485,29
1,1045,29503,3575883456,3575883486,30
1,1045,29504,3575883456,3575883486,30
1,1045,29505,3575883456,3575883487,31
1,1045,29506,3575883456,3575883487,31
1,1045,29507,3575883456,3575883487,31
1,1045,29508,3575883456,3575883489,33
1,1045,29509,3575883456,3575883489,33
1,1045,29510,3575883456,3575883489,33
1,1045,29511,3575883456,3575883491,35
1,1045,29512,3575883456,3575883493,37
1,1045,29513,3575883456,3575883494,38
1,1045,29514,3575883456,3575883494,38
1,1045,29515,3575883456,3575883494,38
1,1045,29516,3575883456,3575883495,39
1,1045,29517,3575883456,3575883495,39
1,1045,29518,3575883456,3575883496,40
1,1045,29519,3575883456,3575883499,43
1,1045,29520,3575883456,3575883499,43
1,1045,29521,3575883456,3575883499,43
1,1045,29522,3575883456,3575883499,43
1,1045,29523,3575883456,3575883501,45
1,1045,29524,3575883456,3575883502,46
1,1045,29525,3575883456,3575883502,46
1,1045,29526,3575883456,3575883503,47
1,1045,29527,3575883456,3575883503,47
1,1045,29528,3575883456,3575883504,48
1,1045,29529,3575883456,3575883505,49
1,1045,29530,3575883456,3575883505,49
1,1045,29531,3575883456,3575883506,50
1,1046,29532,3575883519,3575883519,0
1,1046,29533,3575883519,3575883519,0
1,1046,29534,3575883519,3575883519,0
1,1046,29535,3575883519,3575883519,0
1,1046,29536,3575883519,3575883519,0
1,1046,29537,3575883519,3575883519,0
1,1046,29538,3575883519,3575883519,0
1,1046,29539,3575883519,3575883519,0
1,1046,29540,3575883519,3575883519,0
1,1046,29541,3575883519,3575883519,0
1,1046,29542,3575883519,3575883519,0
1,1046,29543,3575883519,3575883519,0
1,1046,29544,3575883519,3575883519,0
1,1046,29545,3575883519,3575883520,1
1,1046,29546,3575883519,3575883521,2
1,1046,29547,3575883519,3575883523,4
1,1046,29548,3575883519,3575883523,4
1,1046,29549,3575883519,3575883523,4
1,1046,29550,3575883519,3575883523,4
1,1046,29551,3575883519,3575883524,5
1,1046,29552,3575883519,3575883525,6
1,1046,29553,3575883519,3575883526,7
1,1046,29554,3575883519,3575883527,8
1,1046,29555,3575883519,3575883528,9
1,1046,29556,3575883519,3575883528,9
1,1046,29557,3575883519,3575883529,10
1,1046,29558,3575883519,3575883529,10
1,1046,29559,3575883519,3575883530,11
1,1046,29560,3575883519,3575883531,12
1,1046,29561,3575883519,3575883533,14
1,1046,29562,3575883519,3575883533,14
1,1046,29563,3575883519,3575883534,15
1,1046,29564,3575883519,3575883535,16
1,1046,29565,3575883519,3575883535,16
1,1046,29566,3575883519,3575883535,16
1,1046,29567,3575883519,3575883539,20
1,1046,29568,3575883519,3575883539,20
1,1046,29569,3575883519,3575883540,21
1,1046,29570,3575883519,3575883544,25
1,1046,29571,3575883519,3575883544,25
1,1046,29572,3575883519,3575883544,25
1,1046,29573,3575883519,3575883548,29
1,1046,29574,3575883519,3575883549,30
1,1046,29575,3575883519,3575883549,30
1,1046,29576,3575883519,3575883549,30
1,1046,29577,3575883519,3575883550,31
1,1046,29578,3575883519,3575883551,32
1,1046,29579,3575883519,3575883551,32
1,1046,29580,3575883519,3575883551,32
1,1046,29581,3575883519,3575883552,33
1,1046,29582,3575883519,3575883552,33
1,1046,29583,3575883519,3575883553,34
1,1046,29584,3575883519,3575883554,35
1,1046,29585,3575883519,3575883554,35
1,1046,29586,3575883519,3575883555,36
1,1046,29587,3575883519,3575883555,36
1,1046,29588,3575883519,3575883556,37
1,1046,29589,3575883519,3575883558,39
1,1046,29590,3575883519,3575883558,39
1,1046,29591,3575883519,3575883559,40
1,1046,29592,3575883519,3575883560,41
1,1046,29593,3575883519,3575883561,42
1,1046,29594,3575883519,3575883561,42
1,1046,29595,3575883519,3575883562,43
1,1046,29596,3575883519,3575883562,43
1,1046,29597,3575883519,3575883562,43
1,1046,29598,3575883519,3575883562,43
1,1046,29599,3575883519,3575883563,44
1,1046,29600,3575883519,3575883565,46
1,1046,29601,3575883519,3575883565,46
1,1046,29602,3575883519,3575883568,49
1,1046,29603,3575883519,3575883569,50
1,1047,29604,3575883583,3575883584,1
1,1047,29605,3575883583,3575883584,1
1,1047,29606,3575883583,3575883584,1
1,1047,29607,3575883583,3575883584,1
1,1047,29608,3575883583,3575883584,1
1,1047,29609,3575883583,3575883584,1
1,1047,29610,3575883583,3575883584,1
1,1047,29611,3575883583,3575883584,1
1,1047,29612,3575883583,3575883584,1
1,1047,29613,3575883583,3575883584,1
1,1047,29614,3575883583,3575883584,1
1,1047,29615,3575883583,3575883584,1
1,1047,29616,3575883583,3575883584,1
1,1047,29617,3575883583,3575883584,1
1,1047,29618,3575883583,3575883584,1
1,1047,29619,3575883583,3575883584,1
1,1047,29620,3575883583,3575883584,1
1,1047,29621,3575883583,3575883584,1
1,1047,29622,3575883583,3575883584,1
1,1047,29623,3575883583,3575883585,2
1,1047,29624,3575883583,3575883585,2
1,1047,29625,3575883583,3575883587,4
1,1047,29626,3575883583,3575883588,5
1,1047,29627,3575883583,3575883589,6
1,1047,29628,3575883583,3575883590,7
1,1047,29629,3575883583,3575883591,8
1,1047,29630,3575883583,3575883591,8
1,1047,29631,3575883583,3575883591,8
1,1047,29632,3575883583,3575883592,9
1,1047,29633,3575883583,3575883593,10
1,1047,29634,3575883583,3575883595,12
1,1047,29635,3575883583,3575883595,12
1,1047,29636,3575883583,3575883597,14
1,1047,29637,3575883583,3575883597,14
1,1047,29638,3575883583,3575883598,15
1,1047,29639,3575883583,3575883598,15
1,1047,29640,3575883583,3575883599,16
1,1047,29641,3575883583,3575883599,16
1,1047,29642,3575883583,3575883601,18
1,1047,29643,3575883583,3575883601,18
1,1047,29644,3575883583,3575883602,19
1,1047,29645,3575883583,3575883602,19
1,1047,29646,3575883583,3575883603,20
1,1047,29647,3575883583,3575883604,21
1,1047,29648,3575883583,3575883604,21
1,1047,29649,3575883583,3575883604,21
1,1047,29650,3575883583,3575883604,21
1,1047,29651,3575883583,3575883605,22
1,1047,29652,3575883583,3575883607,24
1,1047,29653,3575883583,3575883607,24
1,1047,29654,3575883583,3575883608,25
1,1047,29655,3575883583,3575883609,26
1,1047,29656,3575883583,3575883609,26
1,1047,29657,3575883583,3575883610,27
1,1047,29658,3575883583,3575883612,29
1,1047,29659,3575883583,3575883612,29
1,1047,29660,3575883583,3575883614,31
1,1047,29661,3575883583,3575883614,31
1,1047,29662,3575883583,3575883615,32
1,1047,29663,3575883583,3575883616,33
1,1047,29664,3575883583,3575883616,33
1,1047,29665,3575883583,3575883616,33
1,1047,29666,3575883583,3575883616,33
1,1047,29667,3575883583,3575883616,33
1,1047,29668,3575883583,3575883616,33
1,1047,29669,3575883583,3575883616,33
1,1047,29670,3575883583,3575883617,34
1,1047,29671,3575883583,3575883618,35
1,1047,29672,3575883583,3575883618,35
1,1047,29673,3575883583,3575883621,38
1,1047,29674,3575883583,3575883621,38
1,1047,29675,3575883583,3575883621,38
1,1047,29676,3575883583,3575883621,38
1,1047,29677,3575883583,3575883622,39
1,1047,29678,3575883583,3575883623,40
1,1047,29679,3575883583,3575883623,40
1,1047,29680,3575883583,3575883625,42
1,1047,29681,3575883583,3575883625,42
1,1047,29682,3575883583,3575883625,42
1,1047,29683,3575883583,3575883628,45
1,1047,29684,3575883583,3575883629,46
1,1047,29685,3575883583,3575883629,46
1,1047,29686,3575883583,3575883630,47
1,1047,29687,3575883583,3575883630,47
1,1047,29688,3575883583,3575883630,47
1,1047,29689,3575883583,3575883631,48
1,1047,29690,3575883583,3575883631,48
1,1047,29691,3575883583,3575883632,49
1,1047,29692,3575883583,3575883633,50
1,1048,29693,3575883647,3575883647,0
1,1048,29694,3575883647,3575883647,0
1,1048,29695,3575883647,3575883647,0
1,1048,29696,3575883647,3575883647,0
1,1048,29697,3575883647,3575883647,0
1,1048,29698,3575883647,3575883647,0
1,1048,29699,3575883647,3575883647,0
1,1048,29700,3575883647,3575883647,0
1,1048,29701,3575883647,3575883647,0
1,1048,29702,3575883647,3575883647,0
1,1048,29703,3575883647,3575883647,0
1,1048,29704,3575883647,3575883647,0
1,1048,29705,3575883647,3575883647,0
1,1048,29706,3575883647,3575883647,0
1,1048,29707,3575883647,3575883647,0
1,1048,29708,3575883647,3575883647,0
1,1048,29709,3575883647,3575883647,0
1,1048,29710,3575883647,3575883647,0
1,1048,29711,3575883647,3575883647,0
1,1048,29712,3575883647,3575883647,0
1,1048,29713,3575883647,3575883648,1
1,1048,29714,3575883647,3575883648,1
1,1048,29715,3575883647,3575883649,2
1,1048,29716,3575883647,3575883649,2
1,1048,29717,3575883647,3575883650,3
1,1048,29718,3575883647,3575883651,4
1,1048,29719,3575883647,3575883652,5
1,1048,29720,3575883647,3575883652,5
1,1048,29721,3575883647,3575883654,7
1,1048,29722,3575883647,3575883654,7
1,1048,29723,3575883647,3575883655,8
1,1048,29724,3575883647,3575883656,9
1,1048,29725,3575883647,3575883656,9
1,1048,29726,3575883647,3575883656,9
1,1048,29727,3575883647,3575883657,10
1,1048,29728,3575883647,3575883658,11
1,1048,29729,3575883647,3575883658,11
1,1048,29730,3575883647,3575883658,11
1,1048,29731,3575883647,3575883662,15
1,1048,29732,3575883647,3575883666,19
1,1048,29733,3575883647,3575883666,19
1,1048,29734,3575883647,3575883666,19
1,1048,29735,3575883647,3575883667,20
1,1048,29736,3575883647,3575883667,20
1,1048,29737,3575883647,3575883668,21
1,1048,29738,3575883647,3575883668,21
1,1048,29739,3575883647,3575883669,22
1,1048,29740,3575883647,3575883679,32
1,1048,29741,3575883647,3575883681,34
1,1048,29742,3575883647,3575883682,35
1,1048,29743,3575883647,3575883682,35
1,1048,29744,3575883647,3575883683,36
1,1048,29745,3575883647,3575883684,37
1,1048,29746,3575883647,3575883685,38
1,1048,29747,3575883647,3575883685,38
1,1048,29748,3575883647,3575883686,39
1,1048,29749,3575883647,3575883687,40
1,1048,29750,3575883647,3575883687,40
1,1048,29751,3575883647,3575883688,41
1,1048,29752,3575883647,3575883688,41
1,1048,29753,3575883647,3575883688,41
1,1048,29754,3575883647,3575883689,42
1,1048,29755,3575883647,3575883690,43
1,1048,29756,3575883647,3575883691,44
1,1048,29757,3575883647,3575883694,47
1,1048,29758,3575883647,3575883694,47
1,1048,29759,3575883647,3575883694,47
1,1048,29760,3575883647,3575883696,49
1,1048,29761,3575883647,3575883696,49
1,1049,29762,3575883711,3575883711,0
1,1049,29763,3575883711,3575883711,0
1,1049,29764,3575883711,3575883711,0
1,1049,29765,3575883711,3575883711,0
1,1049,29766,3575883711,3575883711,0
1,1049,29767,3575883711,3575883711,0
1,1049,29768,3575883711,3575883711,0
1,1049,29769,3575883711,3575883711,0
1,1049,29770,3575883711,3575883711,0
1,1049,29771,3575883711,3575883711,0
1,1049,29772,3575883711,3575883711,0
1,1049,29773,3575883711,3575883711,0
1,1049,29774,3575883711,3575883711,0
1,1049,29775,3575883711,3575883711,0
1,1049,29776,3575883711,3575883711,0
1,1049,29777,3575883711,3575883711,0
1,1049,29778,3575883711,3575883711,0
1,1049,29779,3575883711,3575883711,0
1,1049,29780,3575883711,3575883711,0
1,1049,29781,3575883711,3575883711,0
1,1049,29782,3575883711,3575883712,1
1,1049,29783,3575883711,3575883712,1
1,1049,29784,3575883711,3575883713,2
1,1049,29785,3575883711,3575883714,3
1,1049,29786,3575883711,3575883717,6
1,1049,29787,3575883711,3575883718,7
1,1049,29788,3575883711,3575883718,7
1,1049,29789,3575883711,3575883718,7
1,1049,29790,3575883711,3575883719,8
1,1049,29791,3575883711,3575883722,11
1,1049,29792,3575883711,3575883724,13
1,1049,29793,3575883711,3575883724,13
1,1049,29794,3575883711,3575883725,14
1,1049,29795,3575883711,3575883725,14
1,1049,29796,3575883711,3575883727,16
1,1049,29797,3575883711,3575883727,16
1,1049,29798,3575883711,3575883729,18
1,1049,29799,3575883711,3575883729,18
1,1049,29800,3575883711,3575883729,18
1,1049,29801,3575883711,3575883730,19
1,1049,29802,3575883711,3575883731,20
1,1049,29803,3575883711,3575883732,21
1,1049,29804,3575883711,3575883733,22
1,1049,29805,3575883711,3575883734,23
1,1049,29806,3575883711,3575883735,24
1,1049,29807,3575883711,3575883735,24
1,1049,29808,3575883711,3575883735,24
1,1049,29809,3575883711,3575883738,27
1,1049,29810,3575883711,3575883740,29
1,1049,29811,3575883711,3575883740,29
1,1049,29812,3575883711,3575883743,32
1,1049,29813,3575883711,3575883744,33
1,1049,29814,3575883711,3575883746,35
1,1049,29815,3575883711,3575883748,37
1,1049,29816,3575883711,3575883749,38
1,1049,29817,3575883711,3575883749,38
1,1049,29818,3575883711,3575883750,39
1,1049,29819,3575883711,3575883750,39
1,1049,29820,3575883711,3575883750,39
1,1049,29821,3575883711,3575883751,40
1,1049,29822,3575883711,3575883752,41
1,1049,29823,3575883711,3575883752,41
1,1049,29824,3575883711,3575883752,41
1,1049,29825,3575883711,3575883752,41
1,1049,29826,3575883711,3575883753,42
1,1049,29827,3575883711,3575883754,43
1,1049,29828,3575883711,3575883755,44
1,1049,29829,3575883711,3575883756,45
1,1049,29830,3575883711,3575883756,45
1,1049,29831,3575883711,3575883758,47
1,1049,29832,3575883711,3575883758,47
1,1049,29833,3575883711,3575883760,49
1,1050,29834,3575883773,3575883773,0
1,1050,29835,3575883773,3575883773,0
1,1050,29836,3575883773,3575883773,0
1,1050,29837,3575883773,3575883773,0
1,1050,29838,3575883773,3575883773,0
1,1050,29839,3575883773,3575883773,0
1,1050,29840,3575883773,3575883773,0
1,1050,29841,3575883773,3575883773,0
1,1050,29842,3575883773,3575883773,0
1,1050,29843,3575883773,3575883773,0
1,1050,29844,3575883773,3575883773,0
1,1050,29845,3575883773,3575883773,0
1,1050,29846,3575883773,3575883773,0
1,1050,29847,3575883773,3575883774,1
1,1050,29848,3575883773,3575883774,1
1,1050,29849,3575883773,3575883774,1
1,1050,29850,3575883773,3575883776,3
1,1050,29851,3575883773,3575883776,3
1,1050,29852,3575883773,3575883778,5
1,1050,29853,3575883773,3575883778,5
1,1050,29854,3575883773,3575883778,5
1,1050,29855,3575883773,3575883781,8
1,1050,29856,3575883773,3575883781,8
1,1050,29857,3575883773,3575883781,8
1,1050,29858,3575883773,3575883782,9
1,1050,29859,3575883773,3575883782,9
1,1050,29860,3575883773,3575883782,9
1,1050,29861,3575883773,3575883782,9
1,1050,29862,3575883773,3575883783,10
1,1050,29863,3575883773,3575883784,11
1,1050,29864,3575883773,3575883784,11
1,1050,29865,3575883773,3575883784,11
1,1050,29866,3575883773,3575883784,11
1,1050,29867,3575883773,3575883785,12
1,1050,29868,3575883773,3575883787,14
1,1050,29869,3575883773,3575883787,14
1,1050,29870,3575883773,3575883788,15
1,1050,29871,3575883773,3575883789,16
1,1050,29872,3575883773,3575883791,18
1,1050,29873,3575883773,3575883791,18
1,1050,29874,3575883773,3575883792,19
1,1050,29875,3575883773,3575883792,19
1,1050,29876,3575883773,3575883793,20
1,1050,29877,3575883773,3575883794,21
1,1050,29878,3575883773,3575883795,22
1,1050,29879,3575883773,3575883796,23
1,1050,29880,3575883773,3575883797,24
1,1050,29881,3575883773,3575883797,24
1,1050,29882,3575883773,3575883798,25
1,1050,29883,3575883773,3575883799,26
1,1050,29884,3575883773,3575883800,27
1,1050,29885,3575883773,3575883801,28
1,1050,29886,3575883773,3575883802,29
1,1050,29887,3575883773,3575883802,29
1,1050,29888,3575883773,3575883803,30
1,1050,29889,3575883773,3575883803,30
1,1050,29890,3575883773,3575883803,30
1,1050,29891,3575883773,3575883803,30
1,1050,29892,3575883773,3575883804,31
1,1050,29893,3575883773,3575883804,31
1,1050,29894,3575883773,3575883805,32
1,1050,29895,3575883773,3575883805,32
1,1050,29896,3575883773,3575883806,33
1,1050,29897,3575883773,3575883806,33
1,1050,29898,3575883773,3575883807,34
1,1050,29899,3575883773,3575883809,36
1,1050,29900,3575883773,3575883809,36
1,1050,29901,3575883773,3575883810,37
1,1050,29902,3575883773,3575883811,38
1,1050,29903,3575883773,3575883811,38
1,1050,29904,3575883773,3575883812,39
1,1050,29905,3575883773,3575883814,41
1,1050,29906,3575883773,3575883814,41
1,1050,29907,3575883773,3575883815,42
1,1050,29908,3575883773,3575883816,43
1,1050,29909,3575883773,3575883816,43
1,1050,29910,3575883773,3575883816,43
1,1050,29911,3575883773,3575883816,43
1,1050,29912,3575883773,3575883816,43
1,1050,29913,3575883773,3575883817,44
1,1050,29914,3575883773,3575883817,44
1,1050,29915,3575883773,3575883817,44
1,1050,29916,3575883773,3575883817,44
1,1050,29917,3575883773,3575883818,45
1,1050,29918,3575883773,3575883818,45
1,1050,29919,3575883773,3575883821,48
1,1050,29920,3575883773,3575883821,48
1,1050,29921,3575883773,3575883822,49
1,1050,29922,3575883773,3575883822,49
1,1050,29923,3575883773,3575883822,49
1,1050,29924,3575883773,3575883823,50
1,1051,29925,3575883840,3575883840,0
1,1051,29926,3575883840,3575883840,0
1,1051,29927,3575883840,3575883840,0
1,1051,29928,3575883840,3575883840,0
1,1051,29929,3575883840,3575883840,0
1,1051,29930,3575883840,3575883840,0
1,1051,29931,3575883840,3575883840,0
1,1051,29932,3575883840,3575883840,0
1,1051,29933,3575883840,3575883840,0
1,1051,29934,3575883840,3575883840,0
1,1051,29935,3575883840,3575883840,0
1,1051,29936,3575883840,3575883840,0
1,1051,29937,3575883840,3575883840,0
1,1051,29938,3575883840,3575883840,0
1,1051,29939,3575883840,3575883840,0
1,1051,29940,3575883840,3575883840,0
1,1051,29941,3575883840,3575883840,0
1,1051,29942,3575883840,3575883840,0
1,1051,29943,3575883840,3575883840,0
1,1051,29944,3575883840,3575883840,0
1,1051,29945,3575883840,3575883841,1
1,1051,29946,3575883840,3575883841,1
1,1051,29947,3575883840,3575883841,1
1,1051,29948,3575883840,3575883843,3
1,1051,29949,3575883840,3575883845,5
1,1051,29950,3575883840,3575883845,5
1,1051,29951,3575883840,3575883845,5
1,1051,29952,3575883840,3575883847,7
1,1051,29953,3575883840,3575883847,7
1,1051,29954,3575883840,3575883847,7
1,1051,29955,3575883840,3575883848,8
1,1051,29956,3575883840,3575883848,8
1,1051,29957,3575883840,3575883848,8
1,1051,29958,3575883840,3575883849,9
1,1051,29959,3575883840,3575883849,9
1,1051,29960,3575883840,3575883850,10
1,1051,29961,3575883840,3575883851,11
1,1051,29962,3575883840,3575883853,13
1,1051,29963,3575883840,3575883853,13
1,1051,29964,3575883840,3575883854,14
1,1051,29965,3575883840,3575883856,16
1,1051,29966,3575883840,3575883856,16
1,1051,29967,3575883840,3575883856,16
1,1051,29968,3575883840,3575883857,17
1,1051,29969,3575883840,3575883858,18
1,1051,29970,3575883840,3575883858,18
1,1051,29971,3575883840,3575883858,18
1,1051,29972,3575883840,3575883862,22
1,1051,29973,3575883840,3575883865,25
1,1051,29974,3575883840,3575883866,26
1,1051,29975,3575883840,3575883866,26
1,1051,29976,3575883840,3575883867,27
1,1051,29977,3575883840,3575883867,27
1,1051,29978,3575883840,3575883869,29
1,1051,29979,3575883840,3575883869,29
1,1051,29980,3575883840,3575883870,30
1,1051,29981,3575883840,3575883879,39
1,1051,29982,3575883840,3575883881,41
1,1051,29983,3575883840,3575883881,41
1,1051,29984,3575883840,3575883882,42
1,1051,29985,3575883840,3575883883,43
1,1051,29986,3575883840,3575883884,44
1,1051,29987,3575883840,3575883884,44
1,1051,29988,3575883840,3575883885,45
1,1051,29989,3575883840,3575883885,45
1,1051,29990,3575883840,3575883887,47
1,1051,29991,3575883840,3575883887,47
1,1051,29992,3575883840,3575883887,47
1,1051,29993,3575883840,3575883888,48
1,1051,29994,3575883840,3575883888,48
1,1051,29995,3575883840,3575883888,48
1,1051,29996,3575883840,3575883889,49
1,1052,29997,3575883902,3575883902,0
1,1052,29998,3575883902,3575883902,0
1,1052,29999,3575883902,3575883902,0
1,1052,30000,3575883902,3575883902,0
1,1052,30001,3575883902,3575883902,0
1,1052,30002,3575883902,3575883902,0
1,1052,30003,3575883902,3575883902,0
1,1052,30004,3575883902,3575883902,0
1,1052,30005,3575883902,3575883902,0
1,1052,30006,3575883902,3575883902,0
1,1052,30007,3575883902,3575883902,0
1,1052,30008,3575883902,3575883902,0
1,1052,30009,3575883902,3575883902,0
1,1052,30010,3575883902,3575883902,0
1,1052,30011,3575883902,3575883903,1
1,1052,30012,3575883902,3575883904,2
1,1052,30013,3575883902,3575883904,2
1,1052,30014,3575883902,3575883905,3
1,1052,30015,3575883902,3575883905,3
1,1052,30016,3575883902,3575883906,4
1,1052,30017,3575883902,3575883906,4
1,1052,30018,3575883902,3575883907,5
1,1052,30019,3575883902,3575883908,6
1,1052,30020,3575883902,3575883908,6
1,1052,30021,3575883902,3575883909,7
1,1052,30022,3575883902,3575883909,7
1,1052,30023,3575883902,3575883910,8
1,1052,30024,3575883902,3575883911,9
1,1052,30025,3575883902,3575883913,11
1,1052,30026,3575883902,3575883913,11
1,1052,30027,3575883902,3575883914,12
1,1052,30028,3575883902,3575883914,12
1,1052,30029,3575883902,3575883917,15
1,1052,30030,3575883902,3575883918,16
1,1052,30031,3575883902,3575883918,16
1,1052,30032,3575883902,3575883919,17
1,1052,30033,3575883902,3575883919,17
1,1052,30034,3575883902,3575883921,19
1,1052,30035,3575883902,3575883921,19
1,1052,30036,3575883902,3575883922,20
1,1052,30037,3575883902,3575883924,22
1,1052,30038,3575883902,3575883924,22
1,1052,30039,3575883902,3575883924,22
1,1052,30040,3575883902,3575883925,23
1,1052,30041,3575883902,3575883926,24
1,1052,30042,3575883902,3575883928,26
1,1052,30043,3575883902,3575883928,26
1,1052,30044,3575883902,3575883929,27
1,1052,30045,3575883902,3575883930,28
1,1052,30046,3575883902,3575883930,28
1,1052,30047,3575883902,3575883932,30
1,1052,30048,3575883902,3575883933,31
1,1052,30049,3575883902,3575883935,33
1,1052,30050,3575883902,3575883936,34
1,1052,30051,3575883902,3575883938,36
1,1052,30052,3575883902,3575883939,37
1,1052,30053,3575883902,3575883940,38
1,1052,30054,3575883902,3575883943,41
1,1052,30055,3575883902,3575883944,42
1,1052,30056,3575883902,3575883945,43
1,1052,30057,3575883902,3575883946,44
1,1052,30058,3575883902,3575883949,47
1,1052,30059,3575883902,3575883949,47
1,1052,30060,3575883902,3575883949,47
1,1052,30061,3575883902,3575883950,48
1,1052,30062,3575883902,3575883950,48
1,1052,30063,3575883902,3575883950,48
1,1052,30064,3575883902,3575883951,49
1,1052,30065,3575883902,3575883952,50
1,1053,30066,3575883968,3575883968,0
1,1053,30067,3575883968,3575883968,0
1,1053,30068,3575883968,3575883968,0
1,1053,30069,3575883968,3575883968,0
1,1053,30070,3575883968,3575883968,0
1,1053,30071,3575883968,3575883968,0
1,1053,30072,3575883968,3575883968,0
1,1053,30073,3575883968,3575883968,0
1,1053,30074,3575883968,3575883968,0
1,1053,30075,3575883968,3575883968,0
1,1053,30076,3575883968,3575883968,0
1,1053,30077,3575883968,3575883968,0
1,1053,30078,3575883968,3575883968,0
1,1053,30079,3575883968,3575883968,0
1,1053,30080,3575883968,3575883968,0
1,1053,30081,3575883968,3575883968,0
1,1053,30082,3575883968,3575883968,0
1,1053,30083,3575883968,3575883968,0
1,1053,30084,3575883968,3575883970,2
1,1053,30085,3575883968,3575883971,3
1,1053,30086,3575883968,3575883972,4
1,1053,30087,3575883968,3575883974,6
1,1053,30088,3575883968,3575883974,6
1,1053,30089,3575883968,3575883976,8
1,1053,30090,3575883968,3575883977,9
1,1053,30091,3575883968,3575883978,10
1,1053,30092,3575883968,3575883978,10
1,1053,30093,3575883968,3575883979,11
1,1053,30094,3575883968,3575883981,13
1,1053,30095,3575883968,3575883981,13
1,1053,30096,3575883968,3575883981,13
1,1053,30097,3575883968,3575883982,14
1,1053,30098,3575883968,3575883982,14
1,1053,30099,3575883968,3575883982,14
1,1053,30100,3575883968,3575883983,15
1,1053,30101,3575883968,3575883983,15
1,1053,30102,3575883968,3575883984,16
1,1053,30103,3575883968,3575883984,16
1,1053,30104,3575883968,3575883984,16
1,1053,30105,3575883968,3575883985,17
1,1053,30106,3575883968,3575883985,17
1,1053,30107,3575883968,3575883986,18
1,1053,30108,3575883968,3575883988,20
1,1053,30109,3575883968,3575883989,21
1,1053,30110,3575883968,3575883990,22
1,1053,30111,3575883968,3575883991,23
1,1053,30112,3575883968,3575883991,23
1,1053,30113,3575883968,3575883992,24
1,1053,30114,3575883968,3575883993,25
1,1053,30115,3575883968,3575883993,25
1,1053,30116,3575883968,3575883994,26
1,1053,30117,3575883968,3575883996,28
1,1053,30118,3575883968,3575883997,29
1,1053,30119,3575883968,3575883997,29
1,1053,30120,3575883968,3575883997,29
1,1053,30121,3575883968,3575883999,31
1,1053,30122,3575883968,3575883999,31
1,1053,30123,3575883968,3575884001,33
1,1053,30124,3575883968,3575884001,33
1,1053,30125,3575883968,3575884002,34
1,1053,30126,3575883968,3575884003,35
1,1053,30127,3575883968,3575884003,35
1,1053,30128,3575883968,3575884003,35
1,1053,30129,3575883968,3575884004,36
1,1053,30130,3575883968,3575884004,36
1,1053,30131,3575883968,3575884005,37
1,1053,30132,3575883968,3575884005,37
1,1053,30133,3575883968,3575884005,37
1,1053,30134,3575883968,3575884006,38
1,1053,30135,3575883968,3575884006,38
1,1053,30136,3575883968,3575884007,39
1,1053,30137,3575883968,3575884009,41
1,1053,30138,3575883968,3575884009,41
1,1053,30139,3575883968,3575884009,41
1,1053,30140,3575883968,3575884010,42
1,1053,30141,3575883968,3575884011,43
1,1053,30142,3575883968,3575884012,44
1,1053,30143,3575883968,3575884013,45
1,1053,30144,3575883968,3575884013,45
1,1053,30145,3575883968,3575884014,46
1,1053,30146,3575883968,3575884016,48
1,1053,30147,3575883968,3575884016,48
1,1053,30148,3575883968,3575884016,48
1,1053,30149,3575883968,3575884016,48
1,1053,30150,3575883968,3575884016,48
1,1053,30151,3575883968,3575884016,48
1,1053,30152,3575883968,3575884016,48
1,1053,30153,3575883968,3575884016,48
1,1053,30154,3575883968,3575884017,49
1,1053,30155,3575883968,3575884018,50
1,1054,30156,3575884033,3575884033,0
1,1054,30157,3575884033,3575884033,0
1,1054,30158,3575884033,3575884033,0
1,1054,30159,3575884033,3575884033,0
1,1054,30160,3575884033,3575884033,0
1,1054,30161,3575884033,3575884033,0
1,1054,30162,3575884033,3575884033,0
1,1054,30163,3575884033,3575884033,0
1,1054,30164,3575884033,3575884033,0
1,1054,30165,3575884033,3575884033,0
1,1054,30166,3575884033,3575884033,0
1,1054,30167,3575884033,3575884033,0
1,1054,30168,3575884033,3575884033,0
1,1054,30169,3575884033,3575884033,0
1,1054,30170,3575884033,3575884033,0
1,1054,30171,3575884033,3575884033,0
1,1054,30172,3575884033,3575884033,0
1,1054,30173,3575884033,3575884033,0
1,1054,30174,3575884033,3575884033,0
1,1054,30175,3575884033,3575884033,0
1,1054,30176,3575884033,3575884034,1
1,1054,30177,3575884033,3575884035,2
1,1054,30178,3575884033,3575884036,3
1,1054,30179,3575884033,3575884037,4
1,1054,30180,3575884033,3575884037,4
1,1054,30181,3575884033,3575884038,5
1,1054,30182,3575884033,3575884038,5
1,1054,30183,3575884033,3575884040,7
1,1054,30184,3575884033,3575884040,7
1,1054,30185,3575884033,3575884042,9
1,1054,30186,3575884033,3575884044,11
1,1054,30187,3575884033,3575884044,11
1,1054,30188,3575884033,3575884045,12
1,1054,30189,3575884033,3575884045,12
1,1054,30190,3575884033,3575884046,13
1,1054,30191,3575884033,3575884047,14
1,1054,30192,3575884033,3575884048,15
1,1054,30193,3575884033,3575884048,15
1,1054,30194,3575884033,3575884048,15
1,1054,30195,3575884033,3575884048,15
1,1054,30196,3575884033,3575884048,15
1,1054,30197,3575884033,3575884050,17
1,1054,30198,3575884033,3575884050,17
1,1054,30199,3575884033,3575884051,18
1,1054,30200,3575884033,3575884051,18
1,1054,30201,3575884033,3575884054,21
1,1054,30202,3575884033,3575884054,21
1,1054,30203,3575884033,3575884054,21
1,1054,30204,3575884033,3575884057,24
1,1054,30205,3575884033,3575884057,24
1,1054,30206,3575884033,3575884057,24
1,1054,30207,3575884033,3575884058,25
1,1054,30208,3575884033,3575884062,29
1,1054,30209,3575884033,3575884065,32
1,1054,30210,3575884033,3575884065,32
1,1054,30211,3575884033,3575884065,32
1,1054,30212,3575884033,3575884066,33
1,1054,30213,3575884033,3575884067,34
1,1054,30214,3575884033,3575884068,35
1,1054,30215,3575884033,3575884070,37
1,1054,30216,3575884033,3575884071,38
1,1054,30217,3575884033,3575884079,46
1,1054,30218,3575884033,3575884080,47
1,1054,30219,3575884033,3575884080,47
1,1054,30220,3575884033,3575884082,49
1,1054,30221,3575884033,3575884082,49
1,1054,30222,3575884033,3575884083,50
1,1055,30223,3575884096,3575884096,0
1,1055,30224,3575884096,3575884096,0
1,1055,30225,3575884096,3575884096,0
1,1055,30226,3575884096,3575884096,0
1,1055,30227,3575884096,3575884096,0
1,1055,30228,3575884096,3575884096,0
1,1055,30229,3575884096,3575884096,0
1,1055,30230,3575884096,3575884096,0
1,1055,30231,3575884096,3575884096,0
1,1055,30232,3575884096,3575884096,0
1,1055,30233,3575884096,3575884096,0
1,1055,30234,3575884096,3575884096,0
1,1055,30235,3575884096,3575884096,0
1,1055,30236,3575884096,3575884096,0
1,1055,30237,3575884096,3575884096,0
1,1055,30238,3575884096,3575884096,0
1,1055,30239,3575884096,3575884097,1
1,1055,30240,3575884096,3575884098,2
1,1055,30241,3575884096,3575884098,2
1,1055,30242,3575884096,3575884098,2
1,1055,30243,3575884096,3575884101,5
1,1055,30244,3575884096,3575884101,5
1,1055,30245,3575884096,3575884101,5
1,1055,30246,3575884096,3575884102,6
1,1055,30247,3575884096,3575884103,7
1,1055,30248,3575884096,3575884103,7
1,1055,30249,3575884096,3575884103,7
1,1055,30250,3575884096,3575884103,7
1,1055,30251,3575884096,3575884104,8
1,1055,30252,3575884096,3575884105,9
1,1055,30253,3575884096,3575884106,10
1,1055,30254,3575884096,3575884106,10
1,1055,30255,3575884096,3575884106,10
1,1055,30256,3575884096,3575884107,11
1,1055,30257,3575884096,3575884107,11
1,1055,30258,3575884096,3575884108,12
1,1055,30259,3575884096,3575884109,13
1,1055,30260,3575884096,3575884110,14
1,1055,30261,3575884096,3575884110,14
1,1055,30262,3575884096,3575884111,15
1,1055,30263,3575884096,3575884112,16
1,1055,30264,3575884096,3575884113,17
1,1055,30265,3575884096,3575884114,18
1,1055,30266,3575884096,3575884115,19
1,1055,30267,3575884096,3575884118,22
1,1055,30268,3575884096,3575884118,22
1,1055,30269,3575884096,3575884119,23
1,1055,30270,3575884096,3575884120,24
1,1055,30271,3575884096,3575884121,25
1,1055,30272,3575884096,3575884121,25
1,1055,30273,3575884096,3575884122,26
1,1055,30274,3575884096,3575884125,29
1,1055,30275,3575884096,3575884126,30
1,1055,30276,3575884096,3575884126,30
1,1055,30277,3575884096,3575884126,30
1,1055,30278,3575884096,3575884127,31
1,1055,30279,3575884096,3575884128,32
1,1055,30280,3575884096,3575884129,33
1,1055,30281,3575884096,3575884130,34
1,1055,30282,3575884096,3575884130,34
1,1055,30283,3575884096,3575884133,37
1,1055,30284,3575884096,3575884133,37
1,1055,30285,3575884096,3575884134,38
1,1055,30286,3575884096,3575884135,39
1,1055,30287,3575884096,3575884135,39
1,1055,30288,3575884096,3575884136,40
1,1055,30289,3575884096,3575884140,44
1,1055,30290,3575884096,3575884144,48
1,1055,30291,3575884096,3575884144,48
1,1055,30292,3575884096,3575884145,49
1,1055,30293,3575884096,3575884145,49
1,1056,30294,3575884163,3575884163,0
1,1056,30295,3575884163,3575884163,0
1,1056,30296,3575884163,3575884163,0
1,1056,30297,3575884163,3575884163,0
1,1056,30298,3575884163,3575884163,0
1,1056,30299,3575884163,3575884163,0
1,1056,30300,3575884163,3575884163,0
1,1056,30301,3575884163,3575884163,0
1,1056,30302,3575884163,3575884163,0
1,1056,30303,3575884163,3575884163,0
1,1056,30304,3575884163,3575884163,0
1,1056,30305,3575884163,3575884163,0
1,1056,30306,3575884163,3575884163,0
1,1056,30307,3575884163,3575884163,0
1,1056,30308,3575884163,3575884163,0
1,1056,30309,3575884163,3575884163,0
1,1056,30310,3575884163,3575884163,0
1,1056,30311,3575884163,3575884163,0
1,1056,30312,3575884163,3575884163,0
1,1056,30313,3575884163,3575884163,0
1,1056,30314,3575884163,3575884163,0
1,1056,30315,3575884163,3575884163,0
1,1056,30316,3575884163,3575884163,0
1,1056,30317,3575884163,3575884163,0
1,1056,30318,3575884163,3575884164,1
1,1056,30319,3575884163,3575884165,2
1,1056,30320,3575884163,3575884165,2
1,1056,30321,3575884163,3575884171,8
1,1056,30322,3575884163,3575884174,11
1,1056,30323,3575884163,3575884174,11
1,1056,30324,3575884163,3575884174,11
1,1056,30325,3575884163,3575884174,11
1,1056,30326,3575884163,3575884176,13
1,1056,30327,3575884163,3575884177,14
1,1056,30328,3575884163,3575884178,15
1,1056,30329,3575884163,3575884178,15
1,1056,30330,3575884163,3575884179,16
1,1056,30331,3575884163,3575884181,18
1,1056,30332,3575884163,3575884181,18
1,1056,30333,3575884163,3575884181,18
1,1056,30334,3575884163,3575884181,18
1,1056,30335,3575884163,3575884182,19
1,1056,30336,3575884163,3575884183,20
1,1056,30337,3575884163,3575884184,21
1,1056,30338,3575884163,3575884184,21
1,1056,30339,3575884163,3575884184,21
1,1056,30340,3575884163,3575884184,21
1,1056,30341,3575884163,3575884186,23
1,1056,30342,3575884163,3575884187,24
1,1056,30343,3575884163,3575884188,25
1,1056,30344,3575884163,3575884189,26
1,1056,30345,3575884163,3575884190,27
1,1056,30346,3575884163,3575884191,28
1,1056,30347,3575884163,3575884191,28
1,1056,30348,3575884163,3575884192,29
1,1056,30349,3575884163,3575884193,30
1,1056,30350,3575884163,3575884193,30
1,1056,30351,3575884163,3575884193,30
1,1056,30352,3575884163,3575884195,32
1,1056,30353,3575884163,3575884196,33
1,1056,30354,3575884163,3575884197,34
1,1056,30355,3575884163,3575884197,34
1,1056,30356,3575884163,3575884197,34
1,1056,30357,3575884163,3575884199,36
1,1056,30358,3575884163,3575884199,36
1,1056,30359,3575884163,3575884201,38
1,1056,30360,3575884163,3575884201,38
1,1056,30361,3575884163,3575884202,39
1,1056,30362,3575884163,3575884202,39
1,1056,30363,3575884163,3575884203,40
1,1056,30364,3575884163,3575884204,41
1,1056,30365,3575884163,3575884204,41
1,1056,30366,3575884163,3575884204,41
1,1056,30367,3575884163,3575884204,41
1,1056,30368,3575884163,3575884205,42
1,1056,30369,3575884163,3575884205,42
1,1056,30370,3575884163,3575884206,43
1,1056,30371,3575884163,3575884207,44
1,1056,30372,3575884163,3575884208,45
1,1056,30373,3575884163,3575884208,45
1,1056,30374,3575884163,3575884209,46
1,1056,30375,3575884163,3575884209,46
1,1056,30376,3575884163,3575884210,47
1,1056,30377,3575884163,3575884211,48
1,1056,30378,3575884163,3575884212,49
1,1056,30379,3575884163,3575884213,50
1,1057,30380,3575884227,3575884227,0
1,1057,30381,3575884227,3575884227,0
1,1057,30382,3575884227,3575884227,0
1,1057,30383,3575884227,3575884227,0
1,1057,30384,3575884227,3575884227,0
1,1057,30385,3575884227,3575884227,0
1,1057,30386,3575884227,3575884227,0
1,1057,30387,3575884227,3575884227,0
1,1057,30388,3575884227,3575884227,0
1,1057,30389,3575884227,3575884227,0
1,1057,30390,3575884227,3575884227,0
1,1057,30391,3575884227,3575884227,0
1,1057,30392,3575884227,3575884227,0
1,1057,30393,3575884227,3575884227,0
1,1057,30394,3575884227,3575884227,0
1,1057,30395,3575884227,3575884227,0
1,1057,30396,3575884227,3575884227,0
1,1057,30397,3575884227,3575884227,0
1,1057,30398,3575884227,3575884227,0
1,1057,30399,3575884227,3575884227,0
1,1057,30400,3575884227,3575884227,0
1,1057,30401,3575884227,3575884227,0
1,1057,30402,3575884227,3575884227,0
1,1057,30403,3575884227,3575884228,1
1,1057,30404,3575884227,3575884230,3
1,1057,30405,3575884227,3575884230,3
1,1057,30406,3575884227,3575884230,3
1,1057,30407,3575884227,3575884231,4
1,1057,30408,3575884227,3575884231,4
1,1057,30409,3575884227,3575884231,4
1,1057,30410,3575884227,3575884232,5
1,1057,30411,3575884227,3575884232,5
1,1057,30412,3575884227,3575884232,5
1,1057,30413,3575884227,3575884234,7
1,1057,30414,3575884227,3575884236,9
1,1057,30415,3575884227,3575884236,9
1,1057,30416,3575884227,3575884241,14
1,1057,30417,3575884227,3575884241,14
1,1057,30418,3575884227,3575884242,15
1,1057,30419,3575884227,3575884243,16
1,1057,30420,3575884227,3575884244,17
1,1057,30421,3575884227,3575884244,17
1,1057,30422,3575884227,3575884245,18
1,1057,30423,3575884227,3575884246,19
1,1057,30424,3575884227,3575884246,19
1,1057,30425,3575884227,3575884247,20
1,1057,30426,3575884227,3575884247,20
1,1057,30427,3575884227,3575884248,21
1,1057,30428,3575884227,3575884248,21
1,1057,30429,3575884227,3575884248,21
1,1057,30430,3575884227,3575884249,22
1,1057,30431,3575884227,3575884249,22
1,1057,30432,3575884227,3575884249,22
1,1057,30433,3575884227,3575884249,22
1,1057,30434,3575884227,3575884250,23
1,1057,30435,3575884227,3575884251,24
1,1057,30436,3575884227,3575884251,24
1,1057,30437,3575884227,3575884253,26
1,1057,30438,3575884227,3575884254,27
1,1057,30439,3575884227,3575884254,27
1,1057,30440,3575884227,3575884255,28
1,1057,30441,3575884227,3575884257,30
1,1057,30442,3575884227,3575884258,31
1,1057,30443,3575884227,3575884258,31
1,1057,30444,3575884227,3575884258,31
1,1057,30445,3575884227,3575884259,32
1,1057,30446,3575884227,3575884262,35
1,1057,30447,3575884227,3575884265,38
1,1057,30448,3575884227,3575884266,39
1,1057,30449,3575884227,3575884266,39
1,1057,30450,3575884227,3575884267,40
1,1057,30451,3575884227,3575884268,41
1,1057,30452,3575884227,3575884268,41
1,1057,30453,3575884227,3575884270,43
1,1057,30454,3575884227,3575884271,44
1,1058,30455,3575884292,3575884292,0
1,1058,30456,3575884292,3575884292,0
1,1058,30457,3575884292,3575884292,0
1,1058,30458,3575884292,3575884292,0
1,1058,30459,3575884292,3575884292,0
1,1058,30460,3575884292,3575884292,0
1,1058,30461,3575884292,3575884292,0
1,1058,30462,3575884292,3575884292,0
1,1058,30463,3575884292,3575884292,0
1,1058,30464,3575884292,3575884292,0
1,1058,30465,3575884292,3575884292,0
1,1058,30466,3575884292,3575884292,0
1,1058,30467,3575884292,3575884292,0
1,1058,30468,3575884292,3575884293,1
1,1058,30469,3575884292,3575884293,1
1,1058,30470,3575884292,3575884293,1
1,1058,30471,3575884292,3575884293,1
1,1058,30472,3575884292,3575884293,1
1,1058,30473,3575884292,3575884294,2
1,1058,30474,3575884292,3575884294,2
1,1058,30475,3575884292,3575884295,3
1,1058,30476,3575884292,3575884297,5
1,1058,30477,3575884292,3575884297,5
1,1058,30478,3575884292,3575884298,6
1,1058,30479,3575884292,3575884298,6
1,1058,30480,3575884292,3575884299,7
1,1058,30481,3575884292,3575884299,7
1,1058,30482,3575884292,3575884301,9
1,1058,30483,3575884292,3575884301,9
1,1058,30484,3575884292,3575884301,9
1,1058,30485,3575884292,3575884302,10
1,1058,30486,3575884292,3575884303,11
1,1058,30487,3575884292,3575884303,11
1,1058,30488,3575884292,3575884303,11
1,1058,30489,3575884292,3575884304,12
1,1058,30490,3575884292,3575884304,12
1,1058,30491,3575884292,3575884306,14
1,1058,30492,3575884292,3575884306,14
1,1058,30493,3575884292,3575884306,14
1,1058,30494,3575884292,3575884306,14
1,1058,30495,3575884292,3575884306,14
1,1058,30496,3575884292,3575884307,15
1,1058,30497,3575884292,3575884307,15
1,1058,30498,3575884292,3575884308,16
1,1058,30499,3575884292,3575884310,18
1,1058,30500,3575884292,3575884310,18
1,1058,30501,3575884292,3575884311,19
1,1058,30502,3575884292,3575884312,20
1,1058,30503,3575884292,3575884313,21
1,1058,30504,3575884292,3575884314,22
1,1058,30505,3575884292,3575884314,22
1,1058,30506,3575884292,3575884315,23
1,1058,30507,3575884292,3575884317,25
1,1058,30508,3575884292,3575884318,26
1,1058,30509,3575884292,3575884318,26
1,1058,30510,3575884292,3575884319,27
1,1058,30511,3575884292,3575884320,28
1,1058,30512,3575884292,3575884322,30
1,1058,30513,3575884292,3575884322,30
1,1058,30514,3575884292,3575884323,31
1,1058,30515,3575884292,3575884324,32
1,1058,30516,3575884292,3575884325,33
1,1058,30517,3575884292,3575884326,34
1,1058,30518,3575884292,3575884326,34
1,1058,30519,3575884292,3575884327,35
1,1058,30520,3575884292,3575884327,35
1,1058,30521,3575884292,3575884328,36
1,1058,30522,3575884292,3575884329,37
1,1058,30523,3575884292,3575884329,37
1,1058,30524,3575884292,3575884330,38
1,1058,30525,3575884292,3575884331,39
1,1058,30526,3575884292,3575884331,39
1,1058,30527,3575884292,3575884333,41
1,1058,30528,3575884292,3575884334,42
1,1058,30529,3575884292,3575884335,43
1,1058,30530,3575884292,3575884335,43
1,1058,30531,3575884292,3575884336,44
1,1058,30532,3575884292,3575884339,47
1,1058,30533,3575884292,3575884339,47
1,1058,30534,3575884292,3575884340,48
1,1059,30535,3575884356,3575884356,0
1,1059,30536,3575884356,3575884356,0
1,1059,30537,3575884356,3575884356,0
1,1059,30538,3575884356,3575884356,0
1,1059,30539,3575884356,3575884356,0
1,1059,30540,3575884356,3575884356,0
1,1059,30541,3575884356,3575884356,0
1,1059,30542,3575884356,3575884356,0
1,1059,30543,3575884356,3575884356,0
1,1059,30544,3575884356,3575884356,0
1,1059,30545,3575884356,3575884356,0
1,1059,30546,3575884356,3575884356,0
1,1059,30547,3575884356,3575884356,0
1,1059,30548,3575884356,3575884356,0
1,1059,30549,3575884356,3575884356,0
1,1059,30550,3575884356,3575884356,0
1,1059,30551,3575884356,3575884356,0
1,1059,30552,3575884356,3575884357,1
1,1059,30553,3575884356,3575884358,2
1,1059,30554,3575884356,3575884358,2
1,1059,30555,3575884356,3575884359,3
1,1059,30556,3575884356,3575884360,4
1,1059,30557,3575884356,3575884361,5
1,1059,30558,3575884356,3575884362,6
1,1059,30559,3575884356,3575884362,6
1,1059,30560,3575884356,3575884363,7
1,1059,30561,3575884356,3575884363,7
1,1059,30562,3575884356,3575884364,8
1,1059,30563,3575884356,3575884364,8
1,1059,30564,3575884356,3575884365,9
1,1059,30565,3575884356,3575884365,9
1,1059,30566,3575884356,3575884370,14
1,1059,30567,3575884356,3575884371,15
1,1059,30568,3575884356,3575884374,18
1,1059,30569,3575884356,3575884374,18
1,1059,30570,3575884356,3575884374,18
1,1059,30571,3575884356,3575884375,19
1,1059,30572,3575884356,3575884376,20
1,1059,30573,3575884356,3575884376,20
1,1059,30574,3575884356,3575884378,22
1,1059,30575,3575884356,3575884379,23
1,1059,30576,3575884356,3575884379,23
1,1059,30577,3575884356,3575884381,25
1,1059,30578,3575884356,3575884381,25
1,1059,30579,3575884356,3575884381,25
1,1059,30580,3575884356,3575884382,26
1,1059,30581,3575884356,3575884383,27
1,1059,30582,3575884356,3575884383,27
1,1059,30583,3575884356,3575884383,27
1,1059,30584,3575884356,3575884384,28
1,1059,30585,3575884356,3575884385,29
1,1059,30586,3575884356,3575884385,29
1,1059,30587,3575884356,3575884386,30
1,1059,30588,3575884356,3575884387,31
1,1059,30589,3575884356,3575884388,32
1,1059,30590,3575884356,3575884389,33
1,1059,30591,3575884356,3575884390,34
1,1059,30592,3575884356,3575884391,35
1,1059,30593,3575884356,3575884391,35
1,1059,30594,3575884356,3575884392,36
1,1059,30595,3575884356,3575884393,37
1,1059,30596,3575884356,3575884393,37
1,1059,30597,3575884356,3575884393,37
1,1059,30598,3575884356,3575884394,38
1,1059,30599,3575884356,3575884396,40
1,1059,30600,3575884356,3575884397,41
1,1059,30601,3575884356,3575884397,41
1,1059,30602,3575884356,3575884397,41
1,1059,30603,3575884356,3575884399,43
1,1059,30604,3575884356,3575884400,44
1,1059,30605,3575884356,3575884402,46
1,1059,30606,3575884356,3575884403,47
1,1059,30607,3575884356,3575884403,47
1,1059,30608,3575884356,3575884403,47
1,1059,30609,3575884356,3575884403,47
1,1059,30610,3575884356,3575884403,47
1,1059,30611,3575884356,3575884403,47
1,1059,30612,3575884356,3575884405,49
1,1059,30613,3575884356,3575884405,49
1,1059,30614,3575884356,3575884406,50
1,1060,30615,3575884424,3575884424,0
1,1060,30616,3575884424,3575884424,0
1,1060,30617,3575884424,3575884424,0
1,1060,30618,3575884424,3575884424,0
1,1060,30619,3575884424,3575884424,0
1,1060,30620,3575884424,3575884424,0
1,1060,30621,3575884424,3575884424,0
1,1060,30622,3575884424,3575884424,0
1,1060,30623,3575884424,3575884424,0
1,1060,30624,3575884424,3575884424,0
1,1060,30625,3575884424,3575884424,0
1,1060,30626,3575884424,3575884424,0
1,1060,30627,3575884424,3575884424,0
1,1060,30628,3575884424,3575884424,0
1,1060,30629,3575884424,3575884424,0
1,1060,30630,3575884424,3575884424,0
1,1060,30631,3575884424,3575884424,0
1,1060,30632,3575884424,3575884424,0
1,1060,30633,3575884424,3575884424,0
1,1060,30634,3575884424,3575884424,0
1,1060,30635,3575884424,3575884424,0
1,1060,30636,3575884424,3575884424,0
1,1060,30637,3575884424,3575884424,0
1,1060,30638,3575884424,3575884424,0
1,1060,30639,3575884424,3575884424,0
1,1060,30640,3575884424,3575884424,0
1,1060,30641,3575884424,3575884424,0
1,1060,30642,3575884424,3575884424,0
1,1060,30643,3575884424,3575884424,0
1,1060,30644,3575884424,3575884424,0
1,1060,30645,3575884424,3575884425,1
1,1060,30646,3575884424,3575884425,1
1,1060,30647,3575884424,3575884425,1
1,1060,30648,3575884424,3575884429,5
1,1060,30649,3575884424,3575884429,5
1,1060,30650,3575884424,3575884430,6
1,1060,30651,3575884424,3575884431,7
1,1060,30652,3575884424,3575884431,7
1,1060,30653,3575884424,3575884431,7
1,1060,30654,3575884424,3575884431,7
1,1060,30655,3575884424,3575884432,8
1,1060,30656,3575884424,3575884433,9
1,1060,30657,3575884424,3575884433,9
1,1060,30658,3575884424,3575884435,11
1,1060,30659,3575884424,3575884436,12
1,1060,30660,3575884424,3575884437,13
1,1060,30661,3575884424,3575884438,14
1,1060,30662,3575884424,3575884439,15
1,1060,30663,3575884424,3575884441,17
1,1060,30664,3575884424,3575884441,17
1,1060,30665,3575884424,3575884441,17
1,1060,30666,3575884424,3575884444,20
1,1060,30667,3575884424,3575884444,20
1,1060,30668,3575884424,3575884444,20
1,1060,30669,3575884424,3575884444,20
1,1060,30670,3575884424,3575884446,22
1,1060,30671,3575884424,3575884446,22
1,1060,30672,3575884424,3575884447,23
1,1060,30673,3575884424,3575884447,23
1,1060,30674,3575884424,3575884447,23
1,1060,30675,3575884424,3575884448,24
1,1060,30676,3575884424,3575884449,25
1,1060,30677,3575884424,3575884449,25
1,1060,30678,3575884424,3575884450,26
1,1060,30679,3575884424,3575884450,26
1,1060,30680,3575884424,3575884451,27
1,1060,30681,3575884424,3575884451,27
1,1060,30682,3575884424,3575884454,30
1,1060,30683,3575884424,3575884454,30
1,1060,30684,3575884424,3575884454,30
1,1060,30685,3575884424,3575884456,32
1,1060,30686,3575884424,3575884457,33
1,1060,30687,3575884424,3575884457,33
1,1060,30688,3575884424,3575884457,33
1,1060,30689,3575884424,3575884458,34
1,1060,30690,3575884424,3575884458,34
1,1060,30691,3575884424,3575884459,35
1,1060,30692,3575884424,3575884459,35
1,1060,30693,3575884424,3575884465,41
1,1060,30694,3575884424,3575884465,41
1,1060,30695,3575884424,3575884466,42
1,1060,30696,3575884424,3575884467,43
1,1060,30697,3575884424,3575884468,44
1,1060,30698,3575884424,3575884469,45
1,1060,30699,3575884424,3575884469,45
1,1060,30700,3575884424,3575884470,46
1,1060,30701,3575884424,3575884470,46
1,1061,30702,3575884486,3575884486,0
1,1061,30703,3575884486,3575884486,0
1,1061,30704,3575884486,3575884486,0
1,1061,30705,3575884486,3575884486,0
1,1061,30706,3575884486,3575884486,0
1,1061,30707,3575884486,3575884486,0
1,1061,30708,3575884486,3575884486,0
1,1061,30709,3575884486,3575884486,0
1,1061,30710,3575884486,3575884486,0
1,1061,30711,3575884486,3575884486,0
1,1061,30712,3575884486,3575884487,1
1,1061,30713,3575884486,3575884489,3
1,1061,30714,3575884486,3575884489,3
1,1061,30715,3575884486,3575884490,4
1,1061,30716,3575884486,3575884491,5
1,1061,30717,3575884486,3575884493,7
1,1061,30718,3575884486,3575884493,7
1,1061,30719,3575884486,3575884495,9
1,1061,30720,3575884486,3575884495,9
1,1061,30721,3575884486,3575884496,10
1,1061,30722,3575884486,3575884497,11
1,1061,30723,3575884486,3575884497,11
1,1061,30724,3575884486,3575884498,12
1,1061,30725,3575884486,3575884498,12
1,1061,30726,3575884486,3575884500,14
1,1061,30727,3575884486,3575884500,14
1,1061,30728,3575884486,3575884501,15
1,1061,30729,3575884486,3575884501,15
1,1061,30730,3575884486,3575884501,15
1,1061,30731,3575884486,3575884502,16
1,1061,30732,3575884486,3575884502,16
1,1061,30733,3575884486,3575884503,17
1,1061,30734,3575884486,3575884503,17
1,1061,30735,3575884486,3575884505,19
1,1061,30736,3575884486,3575884505,19
1,1061,30737,3575884486,3575884505,19
1,1061,30738,3575884486,3575884506,20
1,1061,30739,3575884486,3575884506,20
1,1061,30740,3575884486,3575884507,21
1,1061,30741,3575884486,3575884507,21
1,1061,30742,3575884486,3575884508,22
1,1061,30743,3575884486,3575884509,23
1,1061,30744,3575884486,3575884510,24
1,1061,30745,3575884486,3575884511,25
1,1061,30746,3575884486,3575884511,25
1,1061,30747,3575884486,3575884512,26
1,1061,30748,3575884486,3575884513,27
1,1061,30749,3575884486,3575884514,28
1,1061,30750,3575884486,3575884516,30
1,1061,30751,3575884486,3575884517,31
1,1061,30752,3575884486,3575884518,32
1,1061,30753,3575884486,3575884519,33
1,1061,30754,3575884486,3575884521,35
1,1061,30755,3575884486,3575884521,35
1,1061,30756,3575884486,3575884521,35
1,1061,30757,3575884486,3575884524,38
1,1061,30758,3575884486,3575884524,38
1,1061,30759,3575884486,3575884524,38
1,1061,30760,3575884486,3575884524,38
1,1061,30761,3575884486,3575884525,39
1,1061,30762,3575884486,3575884526,40
1,1061,30763,3575884486,3575884526,40
1,1061,30764,3575884486,3575884526,40
1,1061,30765,3575884486,3575884528,42
1,1061,30766,3575884486,3575884529,43
1,1061,30767,3575884486,3575884529,43
1,1061,30768,3575884486,3575884529,43
1,1061,30769,3575884486,3575884530,44
1,1061,30770,3575884486,3575884532,46
1,1061,30771,3575884486,3575884532,46
1,1061,30772,3575884486,3575884534,48
1,1061,30773,3575884486,3575884534,48
1,1061,30774,3575884486,3575884534,48
1,1062,30775,3575884552,3575884552,0
1,1062,30776,3575884552,3575884552,0
1,1062,30777,3575884552,3575884552,0
1,1062,30778,3575884552,3575884552,0
1,1062,30779,3575884552,3575884552,0
1,1062,30780,3575884552,3575884552,0
1,1062,30781,3575884552,3575884552,0
1,1062,30782,3575884552,3575884552,0
1,1062,30783,3575884552,3575884552,0
1,1062,30784,3575884552,3575884552,0
1,1062,30785,3575884552,3575884552,0
1,1062,30786,3575884552,3575884552,0
1,1062,30787,3575884552,3575884552,0
1,1062,30788,3575884552,3575884552,0
1,1062,30789,3575884552,3575884552,0
1,1062,30790,3575884552,3575884552,0
1,1062,30791,3575884552,3575884552,0
1,1062,30792,3575884552,3575884553,1
1,1062,30793,3575884552,3575884553,1
1,1062,30794,3575884552,3575884553,1
1,1062,30795,3575884552,3575884554,2
1,1062,30796,3575884552,3575884555,3
1,1062,30797,3575884552,3575884556,4
1,1062,30798,3575884552,3575884557,5
1,1062,30799,3575884552,3575884557,5
1,1062,30800,3575884552,3575884559,7
1,1062,30801,3575884552,3575884559,7
1,1062,30802,3575884552,3575884561,9
1,1062,30803,3575884552,3575884562,10
1,1062,30804,3575884552,3575884562,10
1,1062,30805,3575884552,3575884562,10
1,1062,30806,3575884552,3575884563,11
1,1062,30807,3575884552,3575884563,11
1,1062,30808,3575884552,3575884564,12
1,1062,30809,3575884552,3575884564,12
1,1062,30810,3575884552,3575884565,13
1,1062,30811,3575884552,3575884569,17
1,1062,30812,3575884552,3575884570,18
1,1062,30813,3575884552,3575884573,21
1,1062,30814,3575884552,3575884573,21
1,1062,30815,3575884552,3575884573,21
1,1062,30816,3575884552,3575884574,22
1,1062,30817,3575884552,3575884574,22
1,1062,30818,3575884552,3575884575,23
1,1062,30819,3575884552,3575884576,24
1,1062,30820,3575884552,3575884578,26
1,1062,30821,3575884552,3575884578,26
1,1062,30822,3575884552,3575884580,28
1,1062,30823,3575884552,3575884580,28
1,1062,30824,3575884552,3575884581,29
1,1062,30825,3575884552,3575884581,29
1,1062,30826,3575884552,3575884583,31
1,1062,30827,3575884552,3575884583,31
1,1062,30828,3575884552,3575884583,31
1,1062,30829,3575884552,3575884583,31
1,1062,30830,3575884552,3575884583,31
1,1062,30831,3575884552,3575884584,32
1,1062,30832,3575884552,3575884584,32
1,1062,30833,3575884552,3575884585,33
1,1062,30834,3575884552,3575884586,34
1,1062,30835,3575884552,3575884588,36
1,1062,30836,3575884552,3575884588,36
1,1062,30837,3575884552,3575884588,36
1,1062,30838,3575884552,3575884589,37
1,1062,30839,3575884552,3575884591,39
1,1062,30840,3575884552,3575884591,39
1,1062,30841,3575884552,3575884591,39
1,1062,30842,3575884552,3575884592,40
1,1062,30843,3575884552,3575884592,40
1,1062,30844,3575884552,3575884592,40
1,1062,30845,3575884552,3575884594,42
1,1062,30846,3575884552,3575884595,43
1,1062,30847,3575884552,3575884596,44
1,1062,30848,3575884552,3575884596,44
1,1062,30849,3575884552,3575884596,44
1,1062,30850,3575884552,3575884597,45
1,1062,30851,3575884552,3575884599,47
1,1062,30852,3575884552,3575884601,49
1,1062,30853,3575884552,3575884601,49
1,1062,30854,3575884552,3575884602,50
1,1063,30855,3575884613,3575884613,0
1,1063,30856,3575884613,3575884613,0
1,1063,30857,3575884613,3575884613,0
1,1063,30858,3575884613,3575884613,0
1,1063,30859,3575884613,3575884613,0
1,1063,30860,3575884613,3575884613,0
1,1063,30861,3575884613,3575884613,0
1,1063,30862,3575884613,3575884613,0
1,1063,30863,3575884613,3575884613,0
1,1063,30864,3575884613,3575884613,0
1,1063,30865,3575884613,3575884613,0
1,1063,30866,3575884613,3575884613,0
1,1063,30867,3575884613,3575884613,0
1,1063,30868,3575884613,3575884613,0
1,1063,30869,3575884613,3575884613,0
1,1063,30870,3575884613,3575884613,0
1,1063,30871,3575884613,3575884613,0
1,1063,30872,3575884613,3575884613,0
1,1063,30873,3575884613,3575884613,0
1,1063,30874,3575884613,3575884615,2
1,1063,30875,3575884613,3575884615,2
1,1063,30876,3575884613,3575884615,2
1,1063,30877,3575884613,3575884615,2
1,1063,30878,3575884613,3575884616,3
1,1063,30879,3575884613,3575884616,3
1,1063,30880,3575884613,3575884616,3
1,1063,30881,3575884613,3575884617,4
1,1063,30882,3575884613,3575884617,4
1,1063,30883,3575884613,3575884617,4
1,1063,30884,3575884613,3575884618,5
1,1063,30885,3575884613,3575884618,5
1,1063,30886,3575884613,3575884620,7
1,1063,30887,3575884613,3575884622,9
1,1063,30888,3575884613,3575884622,9
1,1063,30889,3575884613,3575884624,11
1,1063,30890,3575884613,3575884625,12
1,1063,30891,3575884613,3575884625,12
1,1063,30892,3575884613,3575884625,12
1,1063,30893,3575884613,3575884627,14
1,1063,30894,3575884613,3575884629,16
1,1063,30895,3575884613,3575884629,16
1,1063,30896,3575884613,3575884630,17
1,1063,30897,3575884613,3575884630,17
1,1063,30898,3575884613,3575884630,17
1,1063,30899,3575884613,3575884630,17
1,1063,30900,3575884613,3575884631,18
1,1063,30901,3575884613,3575884631,18
1,1063,30902,3575884613,3575884632,19
1,1063,30903,3575884613,3575884632,19
1,1063,30904,3575884613,3575884635,22
1,1063,30905,3575884613,3575884636,23
1,1063,30906,3575884613,3575884636,23
1,1063,30907,3575884613,3575884638,25
1,1063,30908,3575884613,3575884640,27
1,1063,30909,3575884613,3575884640,27
1,1063,30910,3575884613,3575884641,28
1,1063,30911,3575884613,3575884643,30
1,1063,30912,3575884613,3575884643,30
1,1063,30913,3575884613,3575884644,31
1,1063,30914,3575884613,3575884644,31
1,1063,30915,3575884613,3575884644,31
1,1063,30916,3575884613,3575884645,32
1,1063,30917,3575884613,3575884646,33
1,1063,30918,3575884613,3575884646,33
1,1063,30919,3575884613,3575884647,34
1,1063,30920,3575884613,3575884647,34
1,1063,30921,3575884613,3575884647,34
1,1063,30922,3575884613,3575884647,34
1,1063,30923,3575884613,3575884648,35
1,1063,30924,3575884613,3575884648,35
1,1063,30925,3575884613,3575884649,36
1,1063,30926,3575884613,3575884649,36
1,1063,30927,3575884613,3575884649,36
1,1063,30928,3575884613,3575884652,39
1,1063,30929,3575884613,3575884652,39
1,1063,30930,3575884613,3575884652,39
1,1063,30931,3575884613,3575884652,39
1,1063,30932,3575884613,3575884653,40
1,1063,30933,3575884613,3575884655,42
1,1063,30934,3575884613,3575884655,42
1,1063,30935,3575884613,3575884655,42
1,1063,30936,3575884613,3575884656,43
1,1063,30937,3575884613,3575884657,44
1,1063,30938,3575884613,3575884657,44
1,1063,30939,3575884613,3575884658,45
1,1063,30940,3575884613,3575884658,45
1,1064,30941,3575884676,3575884676,0
1,1064,30942,3575884676,3575884676,0
1,1064,30943,3575884676,3575884676,0
1,1064,30944,3575884676,3575884676,0
1,1064,30945,3575884676,3575884676,0
1,1064,30946,3575884676,3575884676,0
1,1064,30947,3575884676,3575884676,0
1,1064,30948,3575884676,3575884676,0
1,1064,30949,3575884676,3575884679,3
1,1064,30950,3575884676,3575884682,6
1,1064,30951,3575884676,3575884683,7
1,1064,30952,3575884676,3575884683,7
1,1064,30953,3575884676,3575884683,7
1,1064,30954,3575884676,3575884684,8
1,1064,30955,3575884676,3575884686,10
1,1064,30956,3575884676,3575884686,10
1,1064,30957,3575884676,3575884687,11
1,1064,30958,3575884676,3575884687,11
1,1064,30959,3575884676,3575884688,12
1,1064,30960,3575884676,3575884688,12
1,1064,30961,3575884676,3575884689,13
1,1064,30962,3575884676,3575884690,14
1,1064,30963,3575884676,3575884690,14
1,1064,30964,3575884676,3575884691,15
1,1064,30965,3575884676,3575884693,17
1,1064,30966,3575884676,3575884693,17
1,1064,30967,3575884676,3575884694,18
1,1064,30968,3575884676,3575884695,19
1,1064,30969,3575884676,3575884696,20
1,1064,30970,3575884676,3575884697,21
1,1064,30971,3575884676,3575884697,21
1,1064,30972,3575884676,3575884698,22
1,1064,30973,3575884676,3575884698,22
1,1064,30974,3575884676,3575884700,24
1,1064,30975,3575884676,3575884700,24
1,1064,30976,3575884676,3575884700,24
1,1064,30977,3575884676,3575884701,25
1,1064,30978,3575884676,3575884702,26
1,1064,30979,3575884676,3575884702,26
1,1064,30980,3575884676,3575884703,27
1,1064,30981,3575884676,3575884704,28
1,1064,30982,3575884676,3575884704,28
1,1064,30983,3575884676,3575884705,29
1,1064,30984,3575884676,3575884706,30
1,1064,30985,3575884676,3575884706,30
1,1064,30986,3575884676,3575884707,31
1,1064,30987,3575884676,3575884707,31
1,1064,30988,3575884676,3575884708,32
1,1064,30989,3575884676,3575884708,32
1,1064,30990,3575884676,3575884708,32
1,1064,30991,3575884676,3575884710,34
1,1064,30992,3575884676,3575884710,34
1,1064,30993,3575884676,3575884711,35
1,1064,30994,3575884676,3575884712,36
1,1064,30995,3575884676,3575884712,36
1,1064,30996,3575884676,3575884713,37
1,1064,30997,3575884676,3575884714,38
1,1064,30998,3575884676,3575884717,41
1,1064,30999,3575884676,3575884718,42
1,1064,31000,3575884676,3575884718,42
1,1064,31001,3575884676,3575884719,43
1,1064,31002,3575884676,3575884719,43
1,1064,31003,3575884676,3575884721,45
1,1064,31004,3575884676,3575884721,45
1,1064,31005,3575884676,3575884721,45
1,1064,31006,3575884676,3575884724,48
1,1064,31007,3575884676,3575884724,48
1,1064,31008,3575884676,3575884725,49
1,1064,31009,3575884676,3575884725,49
1,1064,31010,3575884676,3575884725,49
1,1064,31011,3575884676,3575884726,50
1,1065,31012,3575884741,3575884741,0
1,1065,31013,3575884741,3575884741,0
1,1065,31014,3575884741,3575884741,0
1,1065,31015,3575884741,3575884741,0
1,1065,31016,3575884741,3575884741,0
1,1065,31017,3575884741,3575884741,0
1,1065,31018,3575884741,3575884741,0
1,1065,31019,3575884741,3575884741,0
1,1065,31020,3575884741,3575884741,0
1,1065,31021,3575884741,3575884741,0
1,1065,31022,3575884741,3575884741,0
1,1065,31023,3575884741,3575884741,0
1,1065,31024,3575884741,3575884741,0
1,1065,31025,3575884741,3575884741,0
1,1065,31026,3575884741,3575884741,0
1,1065,31027,3575884741,3575884743,2
1,1065,31028,3575884741,3575884744,3
1,1065,31029,3575884741,3575884745,4
1,1065,31030,3575884741,3575884748,7
1,1065,31031,3575884741,3575884749,8
1,1065,31032,3575884741,3575884749,8
1,1065,31033,3575884741,3575884749,8
1,1065,31034,3575884741,3575884749,8
1,1065,31035,3575884741,3575884750,9
1,1065,31036,3575884741,3575884750,9
1,1065,31037,3575884741,3575884750,9
1,1065,31038,3575884741,3575884752,11
1,1065,31039,3575884741,3575884752,11
1,1065,31040,3575884741,3575884752,11
1,1065,31041,3575884741,3575884753,12
1,1065,31042,3575884741,3575884753,12
1,1065,31043,3575884741,3575884754,13
1,1065,31044,3575884741,3575884755,14
1,1065,31045,3575884741,3575884755,14
1,1065,31046,3575884741,3575884756,15
1,1065,31047,3575884741,3575884756,15
1,1065,31048,3575884741,3575884757,16
1,1065,31049,3575884741,3575884757,16
1,1065,31050,3575884741,3575884759,18
1,1065,31051,3575884741,3575884759,18
1,1065,31052,3575884741,3575884761,20
1,1065,31053,3575884741,3575884762,21
1,1065,31054,3575884741,3575884762,21
1,1065,31055,3575884741,3575884762,21
1,1065,31056,3575884741,3575884763,22
1,1065,31057,3575884741,3575884763,22
1,1065,31058,3575884741,3575884764,23
1,1065,31059,3575884741,3575884764,23
1,1065,31060,3575884741,3575884765,24
1,1065,31061,3575884741,3575884769,28
1,1065,31062,3575884741,3575884773,32
1,1065,31063,3575884741,3575884773,32
1,1065,31064,3575884741,3575884773,32
1,1065,31065,3575884741,3575884774,33
1,1065,31066,3575884741,3575884774,33
1,1065,31067,3575884741,3575884775,34
1,1065,31068,3575884741,3575884778,37
1,1065,31069,3575884741,3575884779,38
1,1065,31070,3575884741,3575884780,39
1,1065,31071,3575884741,3575884780,39
1,1065,31072,3575884741,3575884782,41
1,1065,31073,3575884741,3575884782,41
1,1065,31074,3575884741,3575884783,42
1,1065,31075,3575884741,3575884783,42
1,1065,31076,3575884741,3575884783,42
1,1065,31077,3575884741,3575884783,42
1,1065,31078,3575884741,3575884784,43
1,1065,31079,3575884741,3575884784,43
1,1065,31080,3575884741,3575884785,44
1,1065,31081,3575884741,3575884786,45
1,1065,31082,3575884741,3575884788,47
1,1065,31083,3575884741,3575884788,47
1,1065,31084,3575884741,3575884789,48
1,1065,31085,3575884741,3575884789,48
1,1065,31086,3575884741,3575884791,50
1,1066,31087,3575884806,3575884806,0
1,1066,31088,3575884806,3575884806,0
1,1066,31089,3575884806,3575884806,0
1,1066,31090,3575884806,3575884806,0
1,1066,31091,3575884806,3575884806,0
1,1066,31092,3575884806,3575884806,0
1,1066,31093,3575884806,3575884806,0
1,1066,31094,3575884806,3575884806,0
1,1066,31095,3575884806,3575884806,0
1,1066,31096,3575884806,3575884806,0
1,1066,31097,3575884806,3575884806,0
1,1066,31098,3575884806,3575884806,0
1,1066,31099,3575884806,3575884806,0
1,1066,31100,3575884806,3575884806,0
1,1066,31101,3575884806,3575884806,0
1,1066,31102,3575884806,3575884806,0
1,1066,31103,3575884806,3575884806,0
1,1066,31104,3575884806,3575884806,0
1,1066,31105,3575884806,3575884806,0
1,1066,31106,3575884806,3575884806,0
1,1066,31107,3575884806,3575884806,0
1,1066,31108,3575884806,3575884806,0
1,1066,31109,3575884806,3575884807,1
1,1066,31110,3575884806,3575884808,2
1,1066,31111,3575884806,3575884809,3
1,1066,31112,3575884806,3575884810,4
1,1066,31113,3575884806,3575884810,4
1,1066,31114,3575884806,3575884810,4
1,1066,31115,3575884806,3575884812,6
1,1066,31116,3575884806,3575884814,8
1,1066,31117,3575884806,3575884814,8
1,1066,31118,3575884806,3575884815,9
1,1066,31119,3575884806,3575884815,9
1,1066,31120,3575884806,3575884815,9
1,1066,31121,3575884806,3575884816,10
1,1066,31122,3575884806,3575884816,10
1,1066,31123,3575884806,3575884816,10
1,1066,31124,3575884806,3575884816,10
1,1066,31125,3575884806,3575884817,11
1,1066,31126,3575884806,3575884817,11
1,1066,31127,3575884806,3575884817,11
1,1066,31128,3575884806,3575884817,11
1,1066,31129,3575884806,3575884818,12
1,1066,31130,3575884806,3575884819,13
1,1066,31131,3575884806,3575884821,15
1,1066,31132,3575884806,3575884822,16
1,1066,31133,3575884806,3575884822,16
1,1066,31134,3575884806,3575884822,16
1,1066,31135,3575884806,3575884822,16
1,1066,31136,3575884806,3575884824,18
1,1066,31137,3575884806,3575884825,19
1,1066,31138,3575884806,3575884825,19
1,1066,31139,3575884806,3575884826,20
1,1066,31140,3575884806,3575884829,23
1,1066,31141,3575884806,3575884829,23
1,1066,31142,3575884806,3575884829,23
1,1066,31143,3575884806,3575884829,23
1,1066,31144,3575884806,3575884830,24
1,1066,31145,3575884806,3575884830,24
1,1066,31146,3575884806,3575884831,25
1,1066,31147,3575884806,3575884831,25
1,1066,31148,3575884806,3575884832,26
1,1066,31149,3575884806,3575884832,26
1,1066,31150,3575884806,3575884836,30
1,1066,31151,3575884806,3575884836,30
1,1066,31152,3575884806,3575884837,31
1,1066,31153,3575884806,3575884838,32
1,1066,31154,3575884806,3575884840,34
1,1066,31155,3575884806,3575884840,34
1,1066,31156,3575884806,3575884841,35
1,1066,31157,3575884806,3575884844,38
1,1066,31158,3575884806,3575884844,38
1,1066,31159,3575884806,3575884844,38
1,1066,31160,3575884806,3575884845,39
1,1066,31161,3575884806,3575884845,39
1,1066,31162,3575884806,3575884845,39
1,1066,31163,3575884806,3575884846,40
1,1066,31164,3575884806,3575884846,40
1,1066,31165,3575884806,3575884847,41
1,1066,31166,3575884806,3575884847,41
1,1066,31167,3575884806,3575884847,41
1,1066,31168,3575884806,3575884848,42
1,1066,31169,3575884806,3575884848,42
1,1066,31170,3575884806,3575884849,43
1,1066,31171,3575884806,3575884849,43
1,1066,31172,3575884806,3575884850,44
1,1066,31173,3575884806,3575884850,44
1,1066,31174,3575884806,3575884852,46
1,1066,31175,3575884806,3575884853,47
1,1066,31176,3575884806,3575884853,47
1,1066,31177,3575884806,3575884853,47
1,1066,31178,3575884806,3575884855,49
1,1066,31179,3575884806,3575884856,50
1,1067,31180,3575884875,3575884875,0
1,1067,31181,3575884875,3575884875,0
1,1067,31182,3575884875,3575884875,0
1,1067,31183,3575884875,3575884875,0
1,1067,31184,3575884875,3575884875,0
1,1067,31185,3575884875,3575884875,0
1,1067,31186,3575884875,3575884875,0
1,1067,31187,3575884875,3575884876,1
1,1067,31188,3575884875,3575884876,1
1,1067,31189,3575884875,3575884876,1
1,1067,31190,3575884875,3575884876,1
1,1067,31191,3575884875,3575884876,1
1,1067,31192,3575884875,3575884876,1
1,1067,31193,3575884875,3575884876,1
1,1067,31194,3575884875,3575884876,1
1,1067,31195,3575884875,3575884876,1
1,1067,31196,3575884875,3575884879,4
1,1067,31197,3575884875,3575884880,5
1,1067,31198,3575884875,3575884882,7
1,1067,31199,3575884875,3575884882,7
1,1067,31200,3575884875,3575884883,8
1,1067,31201,3575884875,3575884883,8
1,1067,31202,3575884875,3575884883,8
1,1067,31203,3575884875,3575884884,9
1,1067,31204,3575884875,3575884885,10
1,1067,31205,3575884875,3575884887,12
1,1067,31206,3575884875,3575884887,12
1,1067,31207,3575884875,3575884887,12
1,1067,31208,3575884875,3575884887,12
1,1067,31209,3575884875,3575884888,13
1,1067,31210,3575884875,3575884888,13
1,1067,31211,3575884875,3575884889,14
1,1067,31212,3575884875,3575884890,15
1,1067,31213,3575884875,3575884890,15
1,1067,31214,3575884875,3575884891,16
1,1067,31215,3575884875,3575884893,18
1,1067,31216,3575884875,3575884893,18
1,1067,31217,3575884875,3575884894,19
1,1067,31218,3575884875,3575884896,21
1,1067,31219,3575884875,3575884897,22
1,1067,31220,3575884875,3575884897,22
1,1067,31221,3575884875,3575884898,23
1,1067,31222,3575884875,3575884899,24
1,1067,31223,3575884875,3575884900,25
1,1067,31224,3575884875,3575884900,25
1,1067,31225,3575884875,3575884900,25
1,1067,31226,3575884875,3575884901,26
1,1067,31227,3575884875,3575884902,27
1,1067,31228,3575884875,3575884902,27
1,1067,31229,3575884875,3575884903,28
1,1067,31230,3575884875,3575884904,29
1,1067,31231,3575884875,3575884904,29
1,1067,31232,3575884875,3575884905,30
1,1067,31233,3575884875,3575884905,30
1,1067,31234,3575884875,3575884906,31
1,1067,31235,3575884875,3575884906,31
1,1067,31236,3575884875,3575884907,32
1,1067,31237,3575884875,3575884909,34
1,1067,31238,3575884875,3575884909,34
1,1067,31239,3575884875,3575884910,35
1,1067,31240,3575884875,3575884910,35
1,1067,31241,3575884875,3575884911,36
1,1067,31242,3575884875,3575884911,36
1,1067,31243,3575884875,3575884912,37
1,1067,31244,3575884875,3575884913,38
1,1067,31245,3575884875,3575884914,39
1,1067,31246,3575884875,3575884917,42
1,1067,31247,3575884875,3575884918,43
1,1067,31248,3575884875,3575884918,43
1,1067,31249,3575884875,3575884919,44
1,1067,31250,3575884875,3575884919,44
1,1067,31251,3575884875,3575884921,46
1,1067,31252,3575884875,3575884921,46
1,1067,31253,3575884875,3575884922,47
1,1067,31254,3575884875,3575884924,49
1,1067,31255,3575884875,3575884924,49
1,1068,31256,3575884939,3575884939,0
1,1068,31257,3575884939,3575884939,0
1,1068,31258,3575884939,3575884939,0
1,1068,31259,3575884939,3575884939,0
1,1068,31260,3575884939,3575884939,0
1,1068,31261,3575884939,3575884939,0
1,1068,31262,3575884939,3575884939,0
1,1068,31263,3575884939,3575884939,0
1,1068,31264,3575884939,3575884939,0
1,1068,31265,3575884939,3575884939,0
1,1068,31266,3575884939,3575884939,0
1,1068,31267,3575884939,3575884939,0
1,1068,31268,3575884939,3575884939,0
1,1068,31269,3575884939,3575884939,0
1,1068,31270,3575884939,3575884939,0
1,1068,31271,3575884939,3575884939,0
1,1068,31272,3575884939,3575884939,0
1,1068,31273,3575884939,3575884939,0
1,1068,31274,3575884939,3575884939,0
1,1068,31275,3575884939,3575884940,1
1,1068,31276,3575884939,3575884943,4
1,1068,31277,3575884939,3575884944,5
1,1068,31278,3575884939,3575884944,5
1,1068,31279,3575884939,3575884946,7
1,1068,31280,3575884939,3575884949,10
1,1068,31281,3575884939,3575884949,10
1,1068,31282,3575884939,3575884949,10
1,1068,31283,3575884939,3575884949,10
1,1068,31284,3575884939,3575884949,10
1,1068,31285,3575884939,3575884950,11
1,1068,31286,3575884939,3575884950,11
1,1068,31287,3575884939,3575884952,13
1,1068,31288,3575884939,3575884953,14
1,1068,31289,3575884939,3575884953,14
1,1068,31290,3575884939,3575884953,14
1,1068,31291,3575884939,3575884954,15
1,1068,31292,3575884939,3575884955,16
1,1068,31293,3575884939,3575884955,16
1,1068,31294,3575884939,3575884956,17
1,1068,31295,3575884939,3575884956,17
1,1068,31296,3575884939,3575884957,18
1,1068,31297,3575884939,3575884959,20
1,1068,31298,3575884939,3575884959,20
1,1068,31299,3575884939,3575884961,22
1,1068,31300,3575884939,3575884963,24
1,1068,31301,3575884939,3575884963,24
1,1068,31302,3575884939,3575884963,24
1,1068,31303,3575884939,3575884963,24
1,1068,31304,3575884939,3575884963,24
1,1068,31305,3575884939,3575884965,26
1,1068,31306,3575884939,3575884965,26
1,1068,31307,3575884939,3575884969,30
1,1068,31308,3575884939,3575884970,31
1,1068,31309,3575884939,3575884973,34
1,1068,31310,3575884939,3575884973,34
1,1068,31311,3575884939,3575884974,35
1,1068,31312,3575884939,3575884974,35
1,1068,31313,3575884939,3575884974,35
1,1068,31314,3575884939,3575884976,37
1,1068,31315,3575884939,3575884977,38
1,1068,31316,3575884939,3575884978,39
1,1068,31317,3575884939,3575884980,41
1,1068,31318,3575884939,3575884981,42
1,1068,31319,3575884939,3575884982,43
1,1068,31320,3575884939,3575884982,43
1,1068,31321,3575884939,3575884983,44
1,1068,31322,3575884939,3575884983,44
1,1068,31323,3575884939,3575884983,44
1,1068,31324,3575884939,3575884984,45
1,1068,31325,3575884939,3575884984,45
1,1068,31326,3575884939,3575884984,45
1,1068,31327,3575884939,3575884985,46
1,1068,31328,3575884939,3575884986,47
1,1068,31329,3575884939,3575884988,49
1,1068,31330,3575884939,3575884989,50
1,1069,31331,3575885003,3575885003,0
1,1069,31332,3575885003,3575885003,0
1,1069,31333,3575885003,3575885003,0
1,1069,31334,3575885003,3575885003,0
1,1069,31335,3575885003,3575885003,0
1,1069,31336,3575885003,3575885003,0
1,1069,31337,3575885003,3575885003,0
1,1069,31338,3575885003,3575885003,0
1,1069,31339,3575885003,3575885003,0
1,1069,31340,3575885003,3575885003,0
1,1069,31341,3575885003,3575885003,0
1,1069,31342,3575885003,3575885003,0
1,1069,31343,3575885003,3575885003,0
1,1069,31344,3575885003,3575885003,0
1,1069,31345,3575885003,3575885003,0
1,1069,31346,3575885003,3575885003,0
1,1069,31347,3575885003,3575885003,0
1,1069,31348,3575885003,3575885003,0
1,1069,31349,3575885003,3575885003,0
1,1069,31350,3575885003,3575885003,0
1,1069,31351,3575885003,3575885003,0
1,1069,31352,3575885003,3575885003,0
1,1069,31353,3575885003,3575885003,0
1,1069,31354,3575885003,3575885004,1
1,1069,31355,3575885003,3575885005,2
1,1069,31356,3575885003,3575885005,2
1,1069,31357,3575885003,3575885005,2
1,1069,31358,3575885003,3575885006,3
1,1069,31359,3575885003,3575885007,4
1,1069,31360,3575885003,3575885007,4
1,1069,31361,3575885003,3575885008,5
1,1069,31362,3575885003,3575885009,6
1,1069,31363,3575885003,3575885010,7
1,1069,31364,3575885003,3575885011,8
1,1069,31365,3575885003,3575885011,8
1,1069,31366,3575885003,3575885012,9
1,1069,31367,3575885003,3575885014,11
1,1069,31368,3575885003,3575885016,13
1,1069,31369,3575885003,3575885016,13
1,1069,31370,3575885003,3575885016,13
1,1069,31371,3575885003,3575885016,13
1,1069,31372,3575885003,3575885016,13
1,1069,31373,3575885003,3575885016,13
1,1069,31374,3575885003,3575885016,13
1,1069,31375,3575885003,3575885016,13
1,1069,31376,3575885003,3575885018,15
1,1069,31377,3575885003,3575885018,15
1,1069,31378,3575885003,3575885018,15
1,1069,31379,3575885003,3575885020,17
1,1069,31380,3575885003,3575885021,18
1,1069,31381,3575885003,3575885022,19
1,1069,31382,3575885003,3575885022,19
1,1069,31383,3575885003,3575885022,19
1,1069,31384,3575885003,3575885023,20
1,1069,31385,3575885003,3575885024,21
1,1069,31386,3575885003,3575885025,22
1,1069,31387,3575885003,3575885025,22
1,1069,31388,3575885003,3575885025,22
1,1069,31389,3575885003,3575885026,23
1,1069,31390,3575885003,3575885029,26
1,1069,31391,3575885003,3575885029,26
1,1069,31392,3575885003,3575885030,27
1,1069,31393,3575885003,3575885030,27
1,1069,31394,3575885003,3575885030,27
1,1069,31395,3575885003,3575885031,28
1,1069,31396,3575885003,3575885032,29
1,1069,31397,3575885003,3575885033,30
1,1069,31398,3575885003,3575885036,33
1,1069,31399,3575885003,3575885036,33
1,1069,31400,3575885003,3575885037,34
1,1069,31401,3575885003,3575885037,34
1,1069,31402,3575885003,3575885039,36
1,1069,31403,3575885003,3575885040,37
1,1069,31404,3575885003,3575885040,37
1,1069,31405,3575885003,3575885041,38
1,1069,31406,3575885003,3575885042,39
1,1069,31407,3575885003,3575885044,41
1,1069,31408,3575885003,3575885044,41
1,1069,31409,3575885003,3575885044,41
1,1069,31410,3575885003,3575885045,42
1,1069,31411,3575885003,3575885045,42
1,1069,31412,3575885003,3575885045,42
1,1069,31413,3575885003,3575885046,43
1,1069,31414,3575885003,3575885046,43
1,1069,31415,3575885003,3575885047,44
1,1069,31416,3575885003,3575885047,44
1,1069,31417,3575885003,3575885048,45
1,1069,31418,3575885003,3575885048,45
1,1069,31419,3575885003,3575885048,45
1,1069,31420,3575885003,3575885049,46
1,1069,31421,3575885003,3575885050,47
1,1069,31422,3575885003,3575885050,47
1,1069,31423,3575885003,3575885050,47
1,1069,31424,3575885003,3575885053,50
1,1070,31425,3575885072,3575885072,0
1,1070,31426,3575885072,3575885072,0
1,1070,31427,3575885072,3575885072,0
1,1070,31428,3575885072,3575885072,0
1,1070,31429,3575885072,3575885072,0
1,1070,31430,3575885072,3575885072,0
1,1070,31431,3575885072,3575885072,0
1,1070,31432,3575885072,3575885072,0
1,1070,31433,3575885072,3575885072,0
1,1070,31434,3575885072,3575885072,0
1,1070,31435,3575885072,3575885072,0
1,1070,31436,3575885072,3575885072,0
1,1070,31437,3575885072,3575885072,0
1,1070,31438,3575885072,3575885072,0
1,1070,31439,3575885072,3575885072,0
1,1070,31440,3575885072,3575885072,0
1,1070,31441,3575885072,3575885072,0
1,1070,31442,3575885072,3575885072,0
1,1070,31443,3575885072,3575885072,0
1,1070,31444,3575885072,3575885072,0
1,1070,31445,3575885072,3575885072,0
1,1070,31446,3575885072,3575885081,9
1,1070,31447,3575885072,3575885082,10
1,1070,31448,3575885072,3575885083,11
1,1070,31449,3575885072,3575885083,11
1,1070,31450,3575885072,3575885083,11
1,1070,31451,3575885072,3575885084,12
1,1070,31452,3575885072,3575885085,13
1,1070,31453,3575885072,3575885086,14
1,1070,31454,3575885072,3575885087,15
1,1070,31455,3575885072,3575885087,15
1,1070,31456,3575885072,3575885087,15
1,1070,31457,3575885072,3575885088,16
1,1070,31458,3575885072,3575885089,17
1,1070,31459,3575885072,3575885089,17
1,1070,31460,3575885072,3575885090,18
1,1070,31461,3575885072,3575885091,19
1,1070,31462,3575885072,3575885092,20
1,1070,31463,3575885072,3575885093,21
1,1070,31464,3575885072,3575885093,21
1,1070,31465,3575885072,3575885094,22
1,1070,31466,3575885072,3575885096,24
1,1070,31467,3575885072,3575885096,24
1,1070,31468,3575885072,3575885097,25
1,1070,31469,3575885072,3575885098,26
1,1070,31470,3575885072,3575885098,26
1,1070,31471,3575885072,3575885099,27
1,1070,31472,3575885072,3575885100,28
1,1070,31473,3575885072,3575885100,28
1,1070,31474,3575885072,3575885100,28
1,1070,31475,3575885072,3575885101,29
1,1070,31476,3575885072,3575885102,30
1,1070,31477,3575885072,3575885103,31
1,1070,31478,3575885072,3575885104,32
1,1070,31479,3575885072,3575885105,33
1,1070,31480,3575885072,3575885106,34
1,1070,31481,3575885072,3575885106,34
1,1070,31482,3575885072,3575885106,34
1,1070,31483,3575885072,3575885107,35
1,1070,31484,3575885072,3575885109,37
1,1070,31485,3575885072,3575885109,37
1,1070,31486,3575885072,3575885109,37
1,1070,31487,3575885072,3575885110,38
1,1070,31488,3575885072,3575885111,39
1,1070,31489,3575885072,3575885112,40
1,1070,31490,3575885072,3575885112,40
1,1070,31491,3575885072,3575885113,41
1,1070,31492,3575885072,3575885114,42
1,1070,31493,3575885072,3575885117,45
1,1070,31494,3575885072,3575885118,46
1,1070,31495,3575885072,3575885119,47
1,1070,31496,3575885072,3575885119,47
1,1070,31497,3575885072,3575885121,49
1,1070,31498,3575885072,3575885121,49
1,1071,31499,3575885136,3575885136,0
1,1071,31500,3575885136,3575885136,0
1,1071,31501,3575885136,3575885136,0
1,1071,31502,3575885136,3575885136,0
1,1071,31503,3575885136,3575885136,0
1,1071,31504,3575885136,3575885136,0
1,1071,31505,3575885136,3575885136,0
1,1071,31506,3575885136,3575885136,0
1,1071,31507,3575885136,3575885136,0
1,1071,31508,3575885136,3575885136,0
1,1071,31509,3575885136,3575885136,0
1,1071,31510,3575885136,3575885136,0
1,1071,31511,3575885136,3575885136,0
1,1071,31512,3575885136,3575885136,0
1,1071,31513,3575885136,3575885136,0
1,1071,31514,3575885136,3575885136,0
1,1071,31515,3575885136,3575885136,0
1,1071,31516,3575885136,3575885136,0
1,1071,31517,3575885136,3575885137,1
1,1071,31518,3575885136,3575885138,2
1,1071,31519,3575885136,3575885139,3
1,1071,31520,3575885136,3575885139,3
1,1071,31521,3575885136,3575885144,8
1,1071,31522,3575885136,3575885144,8
1,1071,31523,3575885136,3575885145,9
1,1071,31524,3575885136,3575885146,10
1,1071,31525,3575885136,3575885148,12
1,1071,31526,3575885136,3575885149,13
1,1071,31527,3575885136,3575885149,13
1,1071,31528,3575885136,3575885149,13
1,1071,31529,3575885136,3575885150,14
1,1071,31530,3575885136,3575885150,14
1,1071,31531,3575885136,3575885150,14
1,1071,31532,3575885136,3575885150,14
1,1071,31533,3575885136,3575885153,17
1,1071,31534,3575885136,3575885153,17
1,1071,31535,3575885136,3575885153,17
1,1071,31536,3575885136,3575885153,17
1,1071,31537,3575885136,3575885154,18
1,1071,31538,3575885136,3575885154,18
1,1071,31539,3575885136,3575885155,19
1,1071,31540,3575885136,3575885155,19
1,1071,31541,3575885136,3575885156,20
1,1071,31542,3575885136,3575885156,20
1,1071,31543,3575885136,3575885157,21
1,1071,31544,3575885136,3575885157,21
1,1071,31545,3575885136,3575885159,23
1,1071,31546,3575885136,3575885160,24
1,1071,31547,3575885136,3575885161,25
1,1071,31548,3575885136,3575885162,26
1,1071,31549,3575885136,3575885163,27
1,1071,31550,3575885136,3575885163,27
1,1071,31551,3575885136,3575885163,27
1,1071,31552,3575885136,3575885163,27
1,1071,31553,3575885136,3575885164,28
1,1071,31554,3575885136,3575885165,29
1,1071,31555,3575885136,3575885165,29
1,1071,31556,3575885136,3575885169,33
1,1071,31557,3575885136,3575885170,34
1,1071,31558,3575885136,3575885173,37
1,1071,31559,3575885136,3575885173,37
1,1071,31560,3575885136,3575885174,38
1,1071,31561,3575885136,3575885174,38
1,1071,31562,3575885136,3575885175,39
1,1071,31563,3575885136,3575885176,40
1,1071,31564,3575885136,3575885176,40
1,1071,31565,3575885136,3575885178,42
1,1071,31566,3575885136,3575885180,44
1,1071,31567,3575885136,3575885180,44
1,1071,31568,3575885136,3575885180,44
1,1071,31569,3575885136,3575885182,46
1,1071,31570,3575885136,3575885183,47
1,1071,31571,3575885136,3575885183,47
1,1071,31572,3575885136,3575885183,47
1,1071,31573,3575885136,3575885183,47
1,1071,31574,3575885136,3575885184,48
1,1071,31575,3575885136,3575885185,49
1,1071,31576,3575885136,3575885186,50
1,1072,31577,3575885201,3575885201,0
1,1072,31578,3575885201,3575885201,0
1,1072,31579,3575885201,3575885201,0
1,1072,31580,3575885201,3575885201,0
1,1072,31581,3575885201,3575885201,0
1,1072,31582,3575885201,3575885201,0
1,1072,31583,3575885201,3575885201,0
1,1072,31584,3575885201,3575885201,0
1,1072,31585,3575885201,3575885201,0
1,1072,31586,3575885201,3575885201,0
1,1072,31587,3575885201,3575885201,0
1,1072,31588,3575885201,3575885201,0
1,1072,31589,3575885201,3575885201,0
1,1072,31590,3575885201,3575885201,0
1,1072,31591,3575885201,3575885201,0
1,1072,31592,3575885201,3575885201,0
1,1072,31593,3575885201,3575885201,0
1,1072,31594,3575885201,3575885201,0
1,1072,31595,3575885201,3575885201,0
1,1072,31596,3575885201,3575885201,0
1,1072,31597,3575885201,3575885201,0
1,1072,31598,3575885201,3575885202,1
1,1072,31599,3575885201,3575885202,1
1,1072,31600,3575885201,3575885203,2
1,1072,31601,3575885201,3575885203,2
1,1072,31602,3575885201,3575885204,3
1,1072,31603,3575885201,3575885205,4
1,1072,31604,3575885201,3575885205,4
1,1072,31605,3575885201,3575885206,5
1,1072,31606,3575885201,3575885206,5
1,1072,31607,3575885201,3575885207,6
1,1072,31608,3575885201,3575885208,7
1,1072,31609,3575885201,3575885210,9
1,1072,31610,3575885201,3575885210,9
1,1072,31611,3575885201,3575885210,9
1,1072,31612,3575885201,3575885211,10
1,1072,31613,3575885201,3575885212,11
1,1072,31614,3575885201,3575885214,13
1,1072,31615,3575885201,3575885215,14
1,1072,31616,3575885201,3575885216,15
1,1072,31617,3575885201,3575885216,15
1,1072,31618,3575885201,3575885216,15
1,1072,31619,3575885201,3575885216,15
1,1072,31620,3575885201,3575885216,15
1,1072,31621,3575885201,3575885216,15
1,1072,31622,3575885201,3575885217,16
1,1072,31623,3575885201,3575885217,16
1,1072,31624,3575885201,3575885217,16
1,1072,31625,3575885201,3575885218,17
1,1072,31626,3575885201,3575885218,17
1,1072,31627,3575885201,3575885220,19
1,1072,31628,3575885201,3575885221,20
1,1072,31629,3575885201,3575885222,21
1,1072,31630,3575885201,3575885222,21
1,1072,31631,3575885201,3575885223,22
1,1072,31632,3575885201,3575885223,22
1,1072,31633,3575885201,3575885224,23
1,1072,31634,3575885201,3575885224,23
1,1072,31635,3575885201,3575885224,23
1,1072,31636,3575885201,3575885226,25
1,1072,31637,3575885201,3575885226,25
1,1072,31638,3575885201,3575885229,28
1,1072,31639,3575885201,3575885229,28
1,1072,31640,3575885201,3575885230,29
1,1072,31641,3575885201,3575885230,29
1,1072,31642,3575885201,3575885230,29
1,1072,31643,3575885201,3575885231,30
1,1072,31644,3575885201,3575885232,31
1,1072,31645,3575885201,3575885232,31
1,1072,31646,3575885201,3575885232,31
1,1072,31647,3575885201,3575885235,34
1,1072,31648,3575885201,3575885236,35
1,1072,31649,3575885201,3575885237,36
1,1072,31650,3575885201,3575885237,36
1,1072,31651,3575885201,3575885237,36
1,1072,31652,3575885201,3575885239,38
1,1072,31653,3575885201,3575885240,39
1,1072,31654,3575885201,3575885241,40
1,1072,31655,3575885201,3575885241,40
1,1072,31656,3575885201,3575885242,41
1,1072,31657,3575885201,3575885244,43
1,1072,31658,3575885201,3575885244,43
1,1072,31659,3575885201,3575885245,44
1,1072,31660,3575885201,3575885245,44
1,1072,31661,3575885201,3575885245,44
1,1072,31662,3575885201,3575885246,45
1,1072,31663,3575885201,3575885246,45
1,1072,31664,3575885201,3575885246,45
1,1072,31665,3575885201,3575885247,46
1,1072,31666,3575885201,3575885247,46
1,1072,31667,3575885201,3575885247,46
1,1072,31668,3575885201,3575885248,47
1,1072,31669,3575885201,3575885248,47
1,1072,31670,3575885201,3575885249,48
1,1072,31671,3575885201,3575885249,48
1,1072,31672,3575885201,3575885250,49
1,1072,31673,3575885201,3575885250,49
1,1073,31674,3575885265,3575885265,0
1,1073,31675,3575885265,3575885265,0
1,1073,31676,3575885265,3575885265,0
1,1073,31677,3575885265,3575885265,0
1,1073,31678,3575885265,3575885265,0
1,1073,31679,3575885265,3575885265,0
1,1073,31680,3575885265,3575885265,0
1,1073,31681,3575885265,3575885265,0
1,1073,31682,3575885265,3575885265,0
1,1073,31683,3575885265,3575885265,0
1,1073,31684,3575885265,3575885265,0
1,1073,31685,3575885265,3575885265,0
1,1073,31686,3575885265,3575885265,0
1,1073,31687,3575885265,3575885265,0
1,1073,31688,3575885265,3575885267,2
1,1073,31689,3575885265,3575885267,2
1,1073,31690,3575885265,3575885268,3
1,1073,31691,3575885265,3575885269,4
1,1073,31692,3575885265,3575885269,4
1,1073,31693,3575885265,3575885270,5
1,1073,31694,3575885265,3575885270,5
1,1073,31695,3575885265,3575885279,14
1,1073,31696,3575885265,3575885280,15
1,1073,31697,3575885265,3575885282,17
1,1073,31698,3575885265,3575885282,17
1,1073,31699,3575885265,3575885283,18
1,1073,31700,3575885265,3575885283,18
1,1073,31701,3575885265,3575885283,18
1,1073,31702,3575885265,3575885284,19
1,1073,31703,3575885265,3575885286,21
1,1073,31704,3575885265,3575885286,21
1,1073,31705,3575885265,3575885288,23
1,1073,31706,3575885265,3575885289,24
1,1073,31707,3575885265,3575885289,24
1,1073,31708,3575885265,3575885291,26
1,1073,31709,3575885265,3575885291,26
1,1073,31710,3575885265,3575885292,27
1,1073,31711,3575885265,3575885293,28
1,1073,31712,3575885265,3575885293,28
1,1073,31713,3575885265,3575885295,30
1,1073,31714,3575885265,3575885296,31
1,1073,31715,3575885265,3575885296,31
1,1073,31716,3575885265,3575885297,32
1,1073,31717,3575885265,3575885298,33
1,1073,31718,3575885265,3575885298,33
1,1073,31719,3575885265,3575885299,34
1,1073,31720,3575885265,3575885300,35
1,1073,31721,3575885265,3575885300,35
1,1073,31722,3575885265,3575885301,36
1,1073,31723,3575885265,3575885302,37
1,1073,31724,3575885265,3575885302,37
1,1073,31725,3575885265,3575885303,38
1,1073,31726,3575885265,3575885303,38
1,1073,31727,3575885265,3575885304,39
1,1073,31728,3575885265,3575885305,40
1,1073,31729,3575885265,3575885305,40
1,1073,31730,3575885265,3575885306,41
1,1073,31731,3575885265,3575885306,41
1,1073,31732,3575885265,3575885306,41
1,1073,31733,3575885265,3575885306,41
1,1073,31734,3575885265,3575885308,43
1,1073,31735,3575885265,3575885308,43
1,1073,31736,3575885265,3575885309,44
1,1073,31737,3575885265,3575885310,45
1,1073,31738,3575885265,3575885310,45
1,1073,31739,3575885265,3575885311,46
1,1073,31740,3575885265,3575885312,47
1,1073,31741,3575885265,3575885313,48
1,1074,31742,3575885330,3575885330,0
1,1074,31743,3575885330,3575885330,0
1,1074,31744,3575885330,3575885330,0
1,1074,31745,3575885330,3575885330,0
1,1074,31746,3575885330,3575885330,0
1,1074,31747,3575885330,3575885330,0
1,1074,31748,3575885330,3575885330,0
1,1074,31749,3575885330,3575885330,0
1,1074,31750,3575885330,3575885330,0
1,1074,31751,3575885330,3575885330,0
1,1074,31752,3575885330,3575885330,0
1,1074,31753,3575885330,3575885330,0
1,1074,31754,3575885330,3575885330,0
1,1074,31755,3575885330,3575885330,0
1,1074,31756,3575885330,3575885330,0
1,1074,31757,3575885330,3575885330,0
1,1074,31758,3575885330,3575885330,0
1,1074,31759,3575885330,3575885331,1
1,1074,31760,3575885330,3575885333,3
1,1074,31761,3575885330,3575885333,3
1,1074,31762,3575885330,3575885335,5
1,1074,31763,3575885330,3575885336,6
1,1074,31764,3575885330,3575885337,7
1,1074,31765,3575885330,3575885339,9
1,1074,31766,3575885330,3575885339,9
1,1074,31767,3575885330,3575885340,10
1,1074,31768,3575885330,3575885344,14
1,1074,31769,3575885330,3575885344,14
1,1074,31770,3575885330,3575885344,14
1,1074,31771,3575885330,3575885347,17
1,1074,31772,3575885330,3575885349,19
1,1074,31773,3575885330,3575885350,20
1,1074,31774,3575885330,3575885350,20
1,1074,31775,3575885330,3575885350,20
1,1074,31776,3575885330,3575885350,20
1,1074,31777,3575885330,3575885350,20
1,1074,31778,3575885330,3575885350,20
1,1074,31779,3575885330,3575885351,21
1,1074,31780,3575885330,3575885353,23
1,1074,31781,3575885330,3575885353,23
1,1074,31782,3575885330,3575885353,23
1,1074,31783,3575885330,3575885353,23
1,1074,31784,3575885330,3575885353,23
1,1074,31785,3575885330,3575885354,24
1,1074,31786,3575885330,3575885354,24
1,1074,31787,3575885330,3575885354,24
1,1074,31788,3575885330,3575885357,27
1,1074,31789,3575885330,3575885357,27
1,1074,31790,3575885330,3575885357,27
1,1074,31791,3575885330,3575885357,27
1,1074,31792,3575885330,3575885359,29
1,1074,31793,3575885330,3575885359,29
1,1074,31794,3575885330,3575885360,30
1,1074,31795,3575885330,3575885362,32
1,1074,31796,3575885330,3575885362,32
1,1074,31797,3575885330,3575885363,33
1,1074,31798,3575885330,3575885363,33
1,1074,31799,3575885330,3575885363,33
1,1074,31800,3575885330,3575885364,34
1,1074,31801,3575885330,3575885365,35
1,1074,31802,3575885330,3575885365,35
1,1074,31803,3575885330,3575885368,38
1,1074,31804,3575885330,3575885371,41
1,1074,31805,3575885330,3575885374,44
1,1074,31806,3575885330,3575885374,44
1,1074,31807,3575885330,3575885374,44
1,1074,31808,3575885330,3575885374,44
1,1074,31809,3575885330,3575885374,44
1,1074,31810,3575885330,3575885376,46
1,1074,31811,3575885330,3575885376,46
1,1074,31812,3575885330,3575885378,48
1,1074,31813,3575885330,3575885380,50
1,1075,31814,3575885393,3575885393,0
1,1075,31815,3575885393,3575885393,0
1,1075,31816,3575885393,3575885393,0
1,1075,31817,3575885393,3575885393,0
1,1075,31818,3575885393,3575885393,0
1,1075,31819,3575885393,3575885393,0
1,1075,31820,3575885393,3575885393,0
1,1075,31821,3575885393,3575885393,0
1,1075,31822,3575885393,3575885393,0
1,1075,31823,3575885393,3575885393,0
1,1075,31824,3575885393,3575885393,0
1,1075,31825,3575885393,3575885393,0
1,1075,31826,3575885393,3575885393,0
1,1075,31827,3575885393,3575885393,0
1,1075,31828,3575885393,3575885393,0
1,1075,31829,3575885393,3575885393,0
1,1075,31830,3575885393,3575885393,0
1,1075,31831,3575885393,3575885393,0
1,1075,31832,3575885393,3575885394,1
1,1075,31833,3575885393,3575885396,3
1,1075,31834,3575885393,3575885397,4
1,1075,31835,3575885393,3575885398,5
1,1075,31836,3575885393,3575885399,6
1,1075,31837,3575885393,3575885400,7
1,1075,31838,3575885393,3575885402,9
1,1075,31839,3575885393,3575885402,9
1,1075,31840,3575885393,3575885403,10
1,1075,31841,3575885393,3575885403,10
1,1075,31842,3575885393,3575885403,10
1,1075,31843,3575885393,3575885405,12
1,1075,31844,3575885393,3575885405,12
1,1075,31845,3575885393,3575885405,12
1,1075,31846,3575885393,3575885407,14
1,1075,31847,3575885393,3575885408,15
1,1075,31848,3575885393,3575885408,15
1,1075,31849,3575885393,3575885409,16
1,1075,31850,3575885393,3575885409,16
1,1075,31851,3575885393,3575885410,17
1,1075,31852,3575885393,3575885410,17
1,1075,31853,3575885393,3575885411,18
1,1075,31854,3575885393,3575885411,18
1,1075,31855,3575885393,3575885412,19
1,1075,31856,3575885393,3575885414,21
1,1075,31857,3575885393,3575885416,23
1,1075,31858,3575885393,3575885416,23
1,1075,31859,3575885393,3575885416,23
1,1075,31860,3575885393,3575885416,23
1,1075,31861,3575885393,3575885416,23
1,1075,31862,3575885393,3575885417,24
1,1075,31863,3575885393,3575885417,24
1,1075,31864,3575885393,3575885417,24
1,1075,31865,3575885393,3575885418,25
1,1075,31866,3575885393,3575885418,25
1,1075,31867,3575885393,3575885418,25
1,1075,31868,3575885393,3575885419,26
1,1075,31869,3575885393,3575885420,27
1,1075,31870,3575885393,3575885421,28
1,1075,31871,3575885393,3575885421,28
1,1075,31872,3575885393,3575885422,29
1,1075,31873,3575885393,3575885423,30
1,1075,31874,3575885393,3575885423,30
1,1075,31875,3575885393,3575885423,30
1,1075,31876,3575885393,3575885424,31
1,1075,31877,3575885393,3575885424,31
1,1075,31878,3575885393,3575885425,32
1,1075,31879,3575885393,3575885425,32
1,1075,31880,3575885393,3575885429,36
1,1075,31881,3575885393,3575885429,36
1,1075,31882,3575885393,3575885429,36
1,1075,31883,3575885393,3575885430,37
1,1075,31884,3575885393,3575885430,37
1,1075,31885,3575885393,3575885431,38
1,1075,31886,3575885393,3575885432,39
1,1075,31887,3575885393,3575885433,40
1,1075,31888,3575885393,3575885433,40
1,1075,31889,3575885393,3575885435,42
1,1075,31890,3575885393,3575885436,43
1,1075,31891,3575885393,3575885437,44
1,1075,31892,3575885393,3575885437,44
1,1075,31893,3575885393,3575885437,44
1,1075,31894,3575885393,3575885439,46
1,1075,31895,3575885393,3575885440,47
1,1075,31896,3575885393,3575885442,49
1,1075,31897,3575885393,3575885442,49
1,1075,31898,3575885393,3575885442,49
1,1076,31899,3575885457,3575885457,0
1,1076,31900,3575885457,3575885457,0
1,1076,31901,3575885457,3575885457,0
1,1076,31902,3575885457,3575885457,0
1,1076,31903,3575885457,3575885458,1
1,1076,31904,3575885457,3575885458,1
1,1076,31905,3575885457,3575885458,1
1,1076,31906,3575885457,3575885458,1
1,1076,31907,3575885457,3575885458,1
1,1076,31908,3575885457,3575885458,1
1,1076,31909,3575885457,3575885458,1
1,1076,31910,3575885457,3575885458,1
1,1076,31911,3575885457,3575885458,1
1,1076,31912,3575885457,3575885458,1
1,1076,31913,3575885457,3575885458,1
1,1076,31914,3575885457,3575885458,1
1,1076,31915,3575885457,3575885458,1
1,1076,31916,3575885457,3575885458,1
1,1076,31917,3575885457,3575885458,1
1,1076,31918,3575885457,3575885458,1
1,1076,31919,3575885457,3575885458,1
1,1076,31920,3575885457,3575885458,1
1,1076,31921,3575885457,3575885458,1
1,1076,31922,3575885457,3575885458,1
1,1076,31923,3575885457,3575885458,1
1,1076,31924,3575885457,3575885458,1
1,1076,31925,3575885457,3575885459,2
1,1076,31926,3575885457,3575885459,2
1,1076,31927,3575885457,3575885463,6
1,1076,31928,3575885457,3575885466,9
1,1076,31929,3575885457,3575885467,10
1,1076,31930,3575885457,3575885467,10
1,1076,31931,3575885457,3575885468,11
1,1076,31932,3575885457,3575885468,11
1,1076,31933,3575885457,3575885469,12
1,1076,31934,3575885457,3575885469,12
1,1076,31935,3575885457,3575885470,13
1,1076,31936,3575885457,3575885470,13
1,1076,31937,3575885457,3575885479,22
1,1076,31938,3575885457,3575885482,25
1,1076,31939,3575885457,3575885483,26
1,1076,31940,3575885457,3575885483,26
1,1076,31941,3575885457,3575885483,26
1,1076,31942,3575885457,3575885484,27
1,1076,31943,3575885457,3575885486,29
1,1076,31944,3575885457,3575885486,29
1,1076,31945,3575885457,3575885487,30
1,1076,31946,3575885457,3575885489,32
1,1076,31947,3575885457,3575885490,33
1,1076,31948,3575885457,3575885491,34
1,1076,31949,3575885457,3575885491,34
1,1076,31950,3575885457,3575885492,35
1,1076,31951,3575885457,3575885493,36
1,1076,31952,3575885457,3575885493,36
1,1076,31953,3575885457,3575885495,38
1,1076,31954,3575885457,3575885496,39
1,1076,31955,3575885457,3575885496,39
1,1076,31956,3575885457,3575885497,40
1,1076,31957,3575885457,3575885498,41
1,1076,31958,3575885457,3575885499,42
1,1076,31959,3575885457,3575885500,43
1,1076,31960,3575885457,3575885500,43
1,1076,31961,3575885457,3575885500,43
1,1076,31962,3575885457,3575885502,45
1,1076,31963,3575885457,3575885503,46
1,1076,31964,3575885457,3575885503,46
1,1076,31965,3575885457,3575885503,46
1,1076,31966,3575885457,3575885504,47
1,1076,31967,3575885457,3575885505,48
1,1076,31968,3575885457,3575885506,49
1,1076,31969,3575885457,3575885506,49
1,1077,31970,3575885519,3575885519,0
1,1077,31971,3575885519,3575885519,0
1,1077,31972,3575885519,3575885519,0
1,1077,31973,3575885519,3575885519,0
1,1077,31974,3575885519,3575885519,0
1,1077,31975,3575885519,3575885519,0
1,1077,31976,3575885519,3575885519,0
1,1077,31977,3575885519,3575885519,0
1,1077,31978,3575885519,3575885519,0
1,1077,31979,3575885519,3575885519,0
1,1077,31980,3575885519,3575885519,0
1,1077,31981,3575885519,3575885519,0
1,1077,31982,3575885519,3575885519,0
1,1077,31983,3575885519,3575885519,0
1,1077,31984,3575885519,3575885519,0
1,1077,31985,3575885519,3575885519,0
1,1077,31986,3575885519,3575885521,2
1,1077,31987,3575885519,3575885522,3
1,1077,31988,3575885519,3575885523,4
1,1077,31989,3575885519,3575885523,4
1,1077,31990,3575885519,3575885524,5
1,1077,31991,3575885519,3575885525,6
1,1077,31992,3575885519,3575885525,6
1,1077,31993,3575885519,3575885526,7
1,1077,31994,3575885519,3575885526,7
1,1077,31995,3575885519,3575885527,8
1,1077,31996,3575885519,3575885528,9
1,1077,31997,3575885519,3575885528,9
1,1077,31998,3575885519,3575885529,10
1,1077,31999,3575885519,3575885529,10
1,1077,32000,3575885519,3575885530,11
1,1077,32001,3575885519,3575885532,13
1,1077,32002,3575885519,3575885532,13
1,1077,32003,3575885519,3575885534,15
1,1077,32004,3575885519,3575885534,15
1,1077,32005,3575885519,3575885536,17
1,1077,32006,3575885519,3575885538,19
1,1077,32007,3575885519,3575885539,20
1,1077,32008,3575885519,3575885539,20
1,1077,32009,3575885519,3575885543,24
1,1077,32010,3575885519,3575885543,24
1,1077,32011,3575885519,3575885544,25
1,1077,32012,3575885519,3575885546,27
1,1077,32013,3575885519,3575885548,29
1,1077,32014,3575885519,3575885548,29
1,1077,32015,3575885519,3575885549,30
1,1077,32016,3575885519,3575885549,30
1,1077,32017,3575885519,3575885549,30
1,1077,32018,3575885519,3575885550,31
1,1077,32019,3575885519,3575885550,31
1,1077,32020,3575885519,3575885551,32
1,1077,32021,3575885519,3575885551,32
1,1077,32022,3575885519,3575885553,34
1,1077,32023,3575885519,3575885554,35
1,1077,32024,3575885519,3575885554,35
1,1077,32025,3575885519,3575885554,35
1,1077,32026,3575885519,3575885554,35
1,1077,32027,3575885519,3575885555,36
1,1077,32028,3575885519,3575885556,37
1,1077,32029,3575885519,3575885556,37
1,1077,32030,3575885519,3575885556,37
1,1077,32031,3575885519,3575885559,40
1,1077,32032,3575885519,3575885559,40
1,1077,32033,3575885519,3575885560,41
1,1077,32034,3575885519,3575885561,42
1,1077,32035,3575885519,3575885562,43
1,1077,32036,3575885519,3575885562,43
1,1077,32037,3575885519,3575885562,43
1,1077,32038,3575885519,3575885562,43
1,1077,32039,3575885519,3575885562,43
1,1077,32040,3575885519,3575885564,45
1,1077,32041,3575885519,3575885565,46
1,1077,32042,3575885519,3575885568,49
1,1077,32043,3575885519,3575885569,50
1,1078,32044,3575885582,3575885582,0
1,1078,32045,3575885582,3575885582,0
1,1078,32046,3575885582,3575885582,0
1,1078,32047,3575885582,3575885582,0
1,1078,32048,3575885582,3575885582,0
1,1078,32049,3575885582,3575885582,0
1,1078,32050,3575885582,3575885582,0
1,1078,32051,3575885582,3575885582,0
1,1078,32052,3575885582,3575885582,0
1,1078,32053,3575885582,3575885582,0
1,1078,32054,3575885582,3575885582,0
1,1078,32055,3575885582,3575885583,1
1,1078,32056,3575885582,3575885583,1
1,1078,32057,3575885582,3575885583,1
1,1078,32058,3575885582,3575885584,2
1,1078,32059,3575885582,3575885584,2
1,1078,32060,3575885582,3575885585,3
1,1078,32061,3575885582,3575885585,3
1,1078,32062,3575885582,3575885585,3
1,1078,32063,3575885582,3575885587,5
1,1078,32064,3575885582,3575885589,7
1,1078,32065,3575885582,3575885589,7
1,1078,32066,3575885582,3575885590,8
1,1078,32067,3575885582,3575885591,9
1,1078,32068,3575885582,3575885591,9
1,1078,32069,3575885582,3575885592,10
1,1078,32070,3575885582,3575885592,10
1,1078,32071,3575885582,3575885592,10
1,1078,32072,3575885582,3575885595,13
1,1078,32073,3575885582,3575885596,14
1,1078,32074,3575885582,3575885597,15
1,1078,32075,3575885582,3575885598,16
1,1078,32076,3575885582,3575885598,16
1,1078,32077,3575885582,3575885598,16
1,1078,32078,3575885582,3575885599,17
1,1078,32079,3575885582,3575885601,19
1,1078,32080,3575885582,3575885601,19
1,1078,32081,3575885582,3575885601,19
1,1078,32082,3575885582,3575885602,20
1,1078,32083,3575885582,3575885602,20
1,1078,32084,3575885582,3575885603,21
1,1078,32085,3575885582,3575885604,22
1,1078,32086,3575885582,3575885605,23
1,1078,32087,3575885582,3575885605,23
1,1078,32088,3575885582,3575885606,24
1,1078,32089,3575885582,3575885606,24
1,1078,32090,3575885582,3575885607,25
1,1078,32091,3575885582,3575885608,26
1,1078,32092,3575885582,3575885609,27
1,1078,32093,3575885582,3575885609,27
1,1078,32094,3575885582,3575885609,27
1,1078,32095,3575885582,3575885610,28
1,1078,32096,3575885582,3575885611,29
1,1078,32097,3575885582,3575885612,30
1,1078,32098,3575885582,3575885613,31
1,1078,32099,3575885582,3575885614,32
1,1078,32100,3575885582,3575885614,32
1,1078,32101,3575885582,3575885614,32
1,1078,32102,3575885582,3575885615,33
1,1078,32103,3575885582,3575885615,33
1,1078,32104,3575885582,3575885615,33
1,1078,32105,3575885582,3575885616,34
1,1078,32106,3575885582,3575885616,34
1,1078,32107,3575885582,3575885616,34
1,1078,32108,3575885582,3575885617,35
1,1078,32109,3575885582,3575885618,36
1,1078,32110,3575885582,3575885618,36
1,1078,32111,3575885582,3575885619,37
1,1078,32112,3575885582,3575885620,38
1,1078,32113,3575885582,3575885621,39
1,1078,32114,3575885582,3575885621,39
1,1078,32115,3575885582,3575885621,39
1,1078,32116,3575885582,3575885622,40
1,1078,32117,3575885582,3575885623,41
1,1078,32118,3575885582,3575885624,42
1,1078,32119,3575885582,3575885624,42
1,1078,32120,3575885582,3575885624,42
1,1078,32121,3575885582,3575885624,42
1,1078,32122,3575885582,3575885627,45
1,1078,32123,3575885582,3575885628,46
1,1078,32124,3575885582,3575885629,47
1,1078,32125,3575885582,3575885629,47
1,1078,32126,3575885582,3575885629,47
1,1078,32127,3575885582,3575885630,48
1,1078,32128,3575885582,3575885631,49
1,1078,32129,3575885582,3575885632,50
1,1079,32130,3575885646,3575885646,0
1,1079,32131,3575885646,3575885646,0
1,1079,32132,3575885646,3575885646,0
1,1079,32133,3575885646,3575885646,0
1,1079,32134,3575885646,3575885646,0
1,1079,32135,3575885646,3575885646,0
1,1079,32136,3575885646,3575885647,1
1,1079,32137,3575885646,3575885647,1
1,1079,32138,3575885646,3575885647,1
1,1079,32139,3575885646,3575885647,1
1,1079,32140,3575885646,3575885647,1
1,1079,32141,3575885646,3575885647,1
1,1079,32142,3575885646,3575885647,1
1,1079,32143,3575885646,3575885647,1
1,1079,32144,3575885646,3575885647,1
1,1079,32145,3575885646,3575885647,1
1,1079,32146,3575885646,3575885647,1
1,1079,32147,3575885646,3575885647,1
1,1079,32148,3575885646,3575885647,1
1,1079,32149,3575885646,3575885647,1
1,1079,32150,3575885646,3575885648,2
1,1079,32151,3575885646,3575885648,2
1,1079,32152,3575885646,3575885649,3
1,1079,32153,3575885646,3575885649,3
1,1079,32154,3575885646,3575885649,3
1,1079,32155,3575885646,3575885650,4
1,1079,32156,3575885646,3575885651,5
1,1079,32157,3575885646,3575885652,6
1,1079,32158,3575885646,3575885652,6
1,1079,32159,3575885646,3575885652,6
1,1079,32160,3575885646,3575885652,6
1,1079,32161,3575885646,3575885655,9
1,1079,32162,3575885646,3575885655,9
1,1079,32163,3575885646,3575885656,10
1,1079,32164,3575885646,3575885656,10
1,1079,32165,3575885646,3575885657,11
1,1079,32166,3575885646,3575885658,12
1,1079,32167,3575885646,3575885658,12
1,1079,32168,3575885646,3575885659,13
1,1079,32169,3575885646,3575885662,16
1,1079,32170,3575885646,3575885665,19
1,1079,32171,3575885646,3575885665,19
1,1079,32172,3575885646,3575885667,21
1,1079,32173,3575885646,3575885668,22
1,1079,32174,3575885646,3575885669,23
1,1079,32175,3575885646,3575885670,24
1,1079,32176,3575885646,3575885680,34
1,1079,32177,3575885646,3575885683,37
1,1079,32178,3575885646,3575885683,37
1,1079,32179,3575885646,3575885683,37
1,1079,32180,3575885646,3575885684,38
1,1079,32181,3575885646,3575885686,40
1,1079,32182,3575885646,3575885687,41
1,1079,32183,3575885646,3575885687,41
1,1079,32184,3575885646,3575885687,41
1,1079,32185,3575885646,3575885689,43
1,1079,32186,3575885646,3575885689,43
1,1079,32187,3575885646,3575885690,44
1,1079,32188,3575885646,3575885691,45
1,1079,32189,3575885646,3575885691,45
1,1079,32190,3575885646,3575885692,46
1,1079,32191,3575885646,3575885693,47
1,1079,32192,3575885646,3575885694,48
1,1079,32193,3575885646,3575885695,49
1,1079,32194,3575885646,3575885695,49
1,1079,32195,3575885646,3575885696,50
1,1080,32196,3575885709,3575885709,0
1,1080,32197,3575885709,3575885709,0
1,1080,32198,3575885709,3575885709,0
1,1080,32199,3575885709,3575885709,0
1,1080,32200,3575885709,3575885709,0
1,1080,32201,3575885709,3575885709,0
1,1080,32202,3575885709,3575885709,0
1,1080,32203,3575885709,3575885709,0
1,1080,32204,3575885709,3575885709,0
1,1080,32205,3575885709,3575885709,0
1,1080,32206,3575885709,3575885709,0
1,1080,32207,3575885709,3575885709,0
1,1080,32208,3575885709,3575885709,0
1,1080,32209,3575885709,3575885709,0
1,1080,32210,3575885709,3575885709,0
1,1080,32211,3575885709,3575885709,0
1,1080,32212,3575885709,3575885709,0
1,1080,32213,3575885709,3575885709,0
1,1080,32214,3575885709,3575885709,0
1,1080,32215,3575885709,3575885709,0
1,1080,32216,3575885709,3575885710,1
1,1080,32217,3575885709,3575885711,2
1,1080,32218,3575885709,3575885712,3
1,1080,32219,3575885709,3575885713,4
1,1080,32220,3575885709,3575885715,6
1,1080,32221,3575885709,3575885715,6
1,1080,32222,3575885709,3575885716,7
1,1080,32223,3575885709,3575885718,9
1,1080,32224,3575885709,3575885718,9
1,1080,32225,3575885709,3575885718,9
1,1080,32226,3575885709,3575885719,10
1,1080,32227,3575885709,3575885720,11
1,1080,32228,3575885709,3575885722,13
1,1080,32229,3575885709,3575885722,13
1,1080,32230,3575885709,3575885723,14
1,1080,32231,3575885709,3575885723,14
1,1080,32232,3575885709,3575885724,15
1,1080,32233,3575885709,3575885724,15
1,1080,32234,3575885709,3575885725,16
1,1080,32235,3575885709,3575885726,17
1,1080,32236,3575885709,3575885727,18
1,1080,32237,3575885709,3575885728,19
1,1080,32238,3575885709,3575885728,19
1,1080,32239,3575885709,3575885729,20
1,1080,32240,3575885709,3575885729,20
1,1080,32241,3575885709,3575885731,22
1,1080,32242,3575885709,3575885732,23
1,1080,32243,3575885709,3575885732,23
1,1080,32244,3575885709,3575885735,26
1,1080,32245,3575885709,3575885735,26
1,1080,32246,3575885709,3575885735,26
1,1080,32247,3575885709,3575885738,29
1,1080,32248,3575885709,3575885738,29
1,1080,32249,3575885709,3575885739,30
1,1080,32250,3575885709,3575885743,34
1,1080,32251,3575885709,3575885743,34
1,1080,32252,3575885709,3575885743,34
1,1080,32253,3575885709,3575885745,36
1,1080,32254,3575885709,3575885748,39
1,1080,32255,3575885709,3575885748,39
1,1080,32256,3575885709,3575885749,40
1,1080,32257,3575885709,3575885749,40
1,1080,32258,3575885709,3575885750,41
1,1080,32259,3575885709,3575885750,41
1,1080,32260,3575885709,3575885751,42
1,1080,32261,3575885709,3575885752,43
1,1080,32262,3575885709,3575885752,43
1,1080,32263,3575885709,3575885753,44
1,1080,32264,3575885709,3575885753,44
1,1080,32265,3575885709,3575885754,45
1,1080,32266,3575885709,3575885754,45
1,1080,32267,3575885709,3575885756,47
1,1080,32268,3575885709,3575885756,47
1,1080,32269,3575885709,3575885756,47
1,1080,32270,3575885709,3575885757,48
1,1081,32271,3575885780,3575885780,0
1,1081,32272,3575885780,3575885780,0
1,1081,32273,3575885780,3575885780,0
1,1081,32274,3575885780,3575885780,0
1,1081,32275,3575885780,3575885780,0
1,1081,32276,3575885780,3575885780,0
1,1081,32277,3575885780,3575885780,0
1,1081,32278,3575885780,3575885780,0
1,1081,32279,3575885780,3575885780,0
1,1081,32280,3575885780,3575885780,0
1,1081,32281,3575885780,3575885780,0
1,1081,32282,3575885780,3575885780,0
1,1081,32283,3575885780,3575885780,0
1,1081,32284,3575885780,3575885780,0
1,1081,32285,3575885780,3575885780,0
1,1081,32286,3575885780,3575885780,0
1,1081,32287,3575885780,3575885780,0
1,1081,32288,3575885780,3575885780,0
1,1081,32289,3575885780,3575885780,0
1,1081,32290,3575885780,3575885780,0
1,1081,32291,3575885780,3575885780,0
1,1081,32292,3575885780,3575885780,0
1,1081,32293,3575885780,3575885780,0
1,1081,32294,3575885780,3575885781,1
1,1081,32295,3575885780,3575885782,2
1,1081,32296,3575885780,3575885783,3
1,1081,32297,3575885780,3575885783,3
1,1081,32298,3575885780,3575885784,4
1,1081,32299,3575885780,3575885784,4
1,1081,32300,3575885780,3575885784,4
1,1081,32301,3575885780,3575885785,5
1,1081,32302,3575885780,3575885786,6
1,1081,32303,3575885780,3575885788,8
1,1081,32304,3575885780,3575885789,9
1,1081,32305,3575885780,3575885789,9
1,1081,32306,3575885780,3575885790,10
1,1081,32307,3575885780,3575885791,11
1,1081,32308,3575885780,3575885791,11
1,1081,32309,3575885780,3575885792,12
1,1081,32310,3575885780,3575885792,12
1,1081,32311,3575885780,3575885793,13
1,1081,32312,3575885780,3575885793,13
1,1081,32313,3575885780,3575885795,15
1,1081,32314,3575885780,3575885797,17
1,1081,32315,3575885780,3575885798,18
1,1081,32316,3575885780,3575885798,18
1,1081,32317,3575885780,3575885798,18
1,1081,32318,3575885780,3575885799,19
1,1081,32319,3575885780,3575885800,20
1,1081,32320,3575885780,3575885801,21
1,1081,32321,3575885780,3575885802,22
1,1081,32322,3575885780,3575885802,22
1,1081,32323,3575885780,3575885802,22
1,1081,32324,3575885780,3575885802,22
1,1081,32325,3575885780,3575885802,22
1,1081,32326,3575885780,3575885803,23
1,1081,32327,3575885780,3575885805,25
1,1081,32328,3575885780,3575885805,25
1,1081,32329,3575885780,3575885806,26
1,1081,32330,3575885780,3575885807,27
1,1081,32331,3575885780,3575885807,27
1,1081,32332,3575885780,3575885808,28
1,1081,32333,3575885780,3575885809,29
1,1081,32334,3575885780,3575885810,30
1,1081,32335,3575885780,3575885810,30
1,1081,32336,3575885780,3575885810,30
1,1081,32337,3575885780,3575885812,32
1,1081,32338,3575885780,3575885812,32
1,1081,32339,3575885780,3575885814,34
1,1081,32340,3575885780,3575885814,34
1,1081,32341,3575885780,3575885814,34
1,1081,32342,3575885780,3575885815,35
1,1081,32343,3575885780,3575885815,35
1,1081,32344,3575885780,3575885815,35
1,1081,32345,3575885780,3575885816,36
1,1081,32346,3575885780,3575885816,36
1,1081,32347,3575885780,3575885816,36
1,1081,32348,3575885780,3575885816,36
1,1081,32349,3575885780,3575885817,37
1,1081,32350,3575885780,3575885818,38
1,1081,32351,3575885780,3575885819,39
1,1081,32352,3575885780,3575885820,40
1,1081,32353,3575885780,3575885822,42
1,1081,32354,3575885780,3575885822,42
1,1081,32355,3575885780,3575885822,42
1,1081,32356,3575885780,3575885824,44
1,1081,32357,3575885780,3575885824,44
1,1081,32358,3575885780,3575885824,44
1,1081,32359,3575885780,3575885824,44
1,1081,32360,3575885780,3575885828,48
1,1081,32361,3575885780,3575885828,48
1,1081,32362,3575885780,3575885828,48
1,1081,32363,3575885780,3575885829,49
1,1081,32364,3575885780,3575885829,49
1,1081,32365,3575885780,3575885830,50
1,1082,32366,3575885843,3575885843,0
1,1082,32367,3575885843,3575885843,0
1,1082,32368,3575885843,3575885843,0
1,1082,32369,3575885843,3575885843,0
1,1082,32370,3575885843,3575885843,0
1,1082,32371,3575885843,3575885843,0
1,1082,32372,3575885843,3575885843,0
1,1082,32373,3575885843,3575885843,0
1,1082,32374,3575885843,3575885843,0
1,1082,32375,3575885843,3575885843,0
1,1082,32376,3575885843,3575885843,0
1,1082,32377,3575885843,3575885843,0
1,1082,32378,3575885843,3575885844,1
1,1082,32379,3575885843,3575885844,1
1,1082,32380,3575885843,3575885844,1
1,1082,32381,3575885843,3575885845,2
1,1082,32382,3575885843,3575885845,2
1,1082,32383,3575885843,3575885846,3
1,1082,32384,3575885843,3575885846,3
1,1082,32385,3575885843,3575885847,4
1,1082,32386,3575885843,3575885847,4
1,1082,32387,3575885843,3575885847,4
1,1082,32388,3575885843,3575885847,4
1,1082,32389,3575885843,3575885848,5
1,1082,32390,3575885843,3575885849,6
1,1082,32391,3575885843,3575885849,6
1,1082,32392,3575885843,3575885850,7
1,1082,32393,3575885843,3575885850,7
1,1082,32394,3575885843,3575885851,8
1,1082,32395,3575885843,3575885852,9
1,1082,32396,3575885843,3575885852,9
1,1082,32397,3575885843,3575885853,10
1,1082,32398,3575885843,3575885855,12
1,1082,32399,3575885843,3575885855,12
1,1082,32400,3575885843,3575885856,13
1,1082,32401,3575885843,3575885856,13
1,1082,32402,3575885843,3575885857,14
1,1082,32403,3575885843,3575885857,14
1,1082,32404,3575885843,3575885858,15
1,1082,32405,3575885843,3575885859,16
1,1082,32406,3575885843,3575885862,19
1,1082,32407,3575885843,3575885865,22
1,1082,32408,3575885843,3575885866,23
1,1082,32409,3575885843,3575885867,24
1,1082,32410,3575885843,3575885867,24
1,1082,32411,3575885843,3575885868,25
1,1082,32412,3575885843,3575885870,27
1,1082,32413,3575885843,3575885879,36
1,1082,32414,3575885843,3575885882,39
1,1082,32415,3575885843,3575885883,40
1,1082,32416,3575885843,3575885883,40
1,1082,32417,3575885843,3575885883,40
1,1082,32418,3575885843,3575885884,41
1,1082,32419,3575885843,3575885885,42
1,1082,32420,3575885843,3575885886,43
1,1082,32421,3575885843,3575885886,43
1,1082,32422,3575885843,3575885887,44
1,1082,32423,3575885843,3575885888,45
1,1082,32424,3575885843,3575885889,46
1,1082,32425,3575885843,3575885890,47
1,1082,32426,3575885843,3575885890,47
1,1082,32427,3575885843,3575885891,48
1,1082,32428,3575885843,3575885893,50
1,1083,32429,3575885906,3575885906,0
1,1083,32430,3575885906,3575885906,0
1,1083,32431,3575885906,3575885906,0
1,1083,32432,3575885906,3575885906,0
1,1083,32433,3575885906,3575885906,0
1,1083,32434,3575885906,3575885906,0
1,1083,32435,3575885906,3575885906,0
1,1083,32436,3575885906,3575885906,0
1,1083,32437,3575885906,3575885906,0
1,1083,32438,3575885906,3575885906,0
1,1083,32439,3575885906,3575885906,0
1,1083,32440,3575885906,3575885906,0
1,1083,32441,3575885906,3575885906,0
1,1083,32442,3575885906,3575885906,0
1,1083,32443,3575885906,3575885906,0
1,1083,32444,3575885906,3575885906,0
1,1083,32445,3575885906,3575885906,0
1,1083,32446,3575885906,3575885906,0
1,1083,32447,3575885906,3575885906,0
1,1083,32448,3575885906,3575885906,0
1,1083,32449,3575885906,3575885907,1
1,1083,32450,3575885906,3575885907,1
1,1083,32451,3575885906,3575885909,3
1,1083,32452,3575885906,3575885909,3
1,1083,32453,3575885906,3575885910,4
1,1083,32454,3575885906,3575885912,6
1,1083,32455,3575885906,3575885912,6
1,1083,32456,3575885906,3575885914,8
1,1083,32457,3575885906,3575885915,9
1,1083,32458,3575885906,3575885915,9
1,1083,32459,3575885906,3575885916,10
1,1083,32460,3575885906,3575885918,12
1,1083,32461,3575885906,3575885918,12
1,1083,32462,3575885906,3575885919,13
1,1083,32463,3575885906,3575885920,14
1,1083,32464,3575885906,3575885921,15
1,1083,32465,3575885906,3575885922,16
1,1083,32466,3575885906,3575885923,17
1,1083,32467,3575885906,3575885924,18
1,1083,32468,3575885906,3575885926,20
1,1083,32469,3575885906,3575885926,20
1,1083,32470,3575885906,3575885927,21
1,1083,32471,3575885906,3575885927,21
1,1083,32472,3575885906,3575885928,22
1,1083,32473,3575885906,3575885929,23
1,1083,32474,3575885906,3575885930,24
1,1083,32475,3575885906,3575885931,25
1,1083,32476,3575885906,3575885932,26
1,1083,32477,3575885906,3575885932,26
1,1083,32478,3575885906,3575885932,26
1,1083,32479,3575885906,3575885935,29
1,1083,32480,3575885906,3575885936,30
1,1083,32481,3575885906,3575885938,32
1,1083,32482,3575885906,3575885940,34
1,1083,32483,3575885906,3575885943,37
1,1083,32484,3575885906,3575885944,38
1,1083,32485,3575885906,3575885946,40
1,1083,32486,3575885906,3575885948,42
1,1083,32487,3575885906,3575885949,43
1,1083,32488,3575885906,3575885949,43
1,1083,32489,3575885906,3575885949,43
1,1083,32490,3575885906,3575885950,44
1,1083,32491,3575885906,3575885950,44
1,1083,32492,3575885906,3575885951,45
1,1083,32493,3575885906,3575885951,45
1,1083,32494,3575885906,3575885952,46
1,1083,32495,3575885906,3575885954,48
1,1083,32496,3575885906,3575885954,48
1,1083,32497,3575885906,3575885954,48
1,1083,32498,3575885906,3575885955,49
1,1084,32499,3575885970,3575885970,0
1,1084,32500,3575885970,3575885970,0
1,1084,32501,3575885970,3575885970,0
1,1084,32502,3575885970,3575885970,0
1,1084,32503,3575885970,3575885970,0
1,1084,32504,3575885970,3575885970,0
1,1084,32505,3575885970,3575885970,0
1,1084,32506,3575885970,3575885970,0
1,1084,32507,3575885970,3575885970,0
1,1084,32508,3575885970,3575885970,0
1,1084,32509,3575885970,3575885970,0
1,1084,32510,3575885970,3575885970,0
1,1084,32511,3575885970,3575885970,0
1,1084,32512,3575885970,3575885970,0
1,1084,32513,3575885970,3575885970,0
1,1084,32514,3575885970,3575885973,3
1,1084,32515,3575885970,3575885973,3
1,1084,32516,3575885970,3575885974,4
1,1084,32517,3575885970,3575885974,4
1,1084,32518,3575885970,3575885974,4
1,1084,32519,3575885970,3575885976,6
1,1084,32520,3575885970,3575885976,6
1,1084,32521,3575885970,3575885978,8
1,1084,32522,3575885970,3575885979,9
1,1084,32523,3575885970,3575885981,11
1,1084,32524,3575885970,3575885981,11
1,1084,32525,3575885970,3575885982,12
1,1084,32526,3575885970,3575885983,13
1,1084,32527,3575885970,3575885983,13
1,1084,32528,3575885970,3575885984,14
1,1084,32529,3575885970,3575885984,14
1,1084,32530,3575885970,3575885984,14
1,1084,32531,3575885970,3575885984,14
1,1084,32532,3575885970,3575885985,15
1,1084,32533,3575885970,3575885986,16
1,1084,32534,3575885970,3575885988,18
1,1084,32535,3575885970,3575885989,19
1,1084,32536,3575885970,3575885989,19
1,1084,32537,3575885970,3575885990,20
1,1084,32538,3575885970,3575885991,21
1,1084,32539,3575885970,3575885991,21
1,1084,32540,3575885970,3575885992,22
1,1084,32541,3575885970,3575885992,22
1,1084,32542,3575885970,3575885992,22
1,1084,32543,3575885970,3575885993,23
1,1084,32544,3575885970,3575885996,26
1,1084,32545,3575885970,3575885996,26
1,1084,32546,3575885970,3575885997,27
1,1084,32547,3575885970,3575885997,27
1,1084,32548,3575885970,3575885998,28
1,1084,32549,3575885970,3575885998,28
1,1084,32550,3575885970,3575886000,30
1,1084,32551,3575885970,3575886001,31
1,1084,32552,3575885970,3575886001,31
1,1084,32553,3575885970,3575886002,32
1,1084,32554,3575885970,3575886002,32
1,1084,32555,3575885970,3575886002,32
1,1084,32556,3575885970,3575886003,33
1,1084,32557,3575885970,3575886004,34
1,1084,32558,3575885970,3575886004,34
1,1084,32559,3575885970,3575886004,34
1,1084,32560,3575885970,3575886005,35
1,1084,32561,3575885970,3575886006,36
1,1084,32562,3575885970,3575886007,37
1,1084,32563,3575885970,3575886007,37
1,1084,32564,3575885970,3575886009,39
1,1084,32565,3575885970,3575886009,39
1,1084,32566,3575885970,3575886010,40
1,1084,32567,3575885970,3575886011,41
1,1084,32568,3575885970,3575886012,42
1,1084,32569,3575885970,3575886013,43
1,1084,32570,3575885970,3575886014,44
1,1084,32571,3575885970,3575886015,45
1,1084,32572,3575885970,3575886015,45
1,1084,32573,3575885970,3575886015,45
1,1084,32574,3575885970,3575886015,45
1,1084,32575,3575885970,3575886016,46
1,1084,32576,3575885970,3575886016,46
1,1084,32577,3575885970,3575886016,46
1,1084,32578,3575885970,3575886016,46
1,1084,32579,3575885970,3575886017,47
1,1084,32580,3575885970,3575886017,47
1,1084,32581,3575885970,3575886017,47
1,1084,32582,3575885970,3575886019,49
1,1084,32583,3575885970,3575886019,49
1,1084,32584,3575885970,3575886020,50
1,1085,32585,3575886037,3575886037,0
1,1085,32586,3575886037,3575886037,0
1,1085,32587,3575886037,3575886037,0
1,1085,32588,3575886037,3575886037,0
1,1085,32589,3575886037,3575886037,0
1,1085,32590,3575886037,3575886037,0
1,1085,32591,3575886037,3575886037,0
1,1085,32592,3575886037,3575886037,0
1,1085,32593,3575886037,3575886037,0
1,1085,32594,3575886037,3575886037,0
1,1085,32595,3575886037,3575886037,0
1,1085,32596,3575886037,3575886037,0
1,1085,32597,3575886037,3575886037,0
1,1085,32598,3575886037,3575886037,0
1,1085,32599,3575886037,3575886037,0
1,1085,32600,3575886037,3575886037,0
1,1085,32601,3575886037,3575886037,0
1,1085,32602,3575886037,3575886037,0
1,1085,32603,3575886037,3575886037,0
1,1085,32604,3575886037,3575886037,0
1,1085,32605,3575886037,3575886037,0
1,1085,32606,3575886037,3575886037,0
1,1085,32607,3575886037,3575886041,4
1,1085,32608,3575886037,3575886042,5
1,1085,32609,3575886037,3575886044,7
1,1085,32610,3575886037,3575886044,7
1,1085,32611,3575886037,3575886044,7
1,1085,32612,3575886037,3575886045,8
1,1085,32613,3575886037,3575886045,8
1,1085,32614,3575886037,3575886045,8
1,1085,32615,3575886037,3575886046,9
1,1085,32616,3575886037,3575886047,10
1,1085,32617,3575886037,3575886047,10
1,1085,32618,3575886037,3575886047,10
1,1085,32619,3575886037,3575886048,11
1,1085,32620,3575886037,3575886049,12
1,1085,32621,3575886037,3575886049,12
1,1085,32622,3575886037,3575886050,13
1,1085,32623,3575886037,3575886053,16
1,1085,32624,3575886037,3575886053,16
1,1085,32625,3575886037,3575886053,16
1,1085,32626,3575886037,3575886053,16
1,1085,32627,3575886037,3575886053,16
1,1085,32628,3575886037,3575886056,19
1,1085,32629,3575886037,3575886056,19
1,1085,32630,3575886037,3575886056,19
1,1085,32631,3575886037,3575886056,19
1,1085,32632,3575886037,3575886057,20
1,1085,32633,3575886037,3575886058,21
1,1085,32634,3575886037,3575886059,22
1,1085,32635,3575886037,3575886059,22
1,1085,32636,3575886037,3575886063,26
1,1085,32637,3575886037,3575886065,28
1,1085,32638,3575886037,3575886066,29
1,1085,32639,3575886037,3575886068,31
1,1085,32640,3575886037,3575886068,31
1,1085,32641,3575886037,3575886068,31
1,1085,32642,3575886037,3575886069,32
1,1085,32643,3575886037,3575886070,33
1,1085,32644,3575886037,3575886079,42
1,1085,32645,3575886037,3575886081,44
1,1085,32646,3575886037,3575886082,45
1,1085,32647,3575886037,3575886082,45
1,1085,32648,3575886037,3575886083,46
1,1085,32649,3575886037,3575886083,46
1,1085,32650,3575886037,3575886084,47
1,1085,32651,3575886037,3575886085,48
1,1085,32652,3575886037,3575886086,49
1,1085,32653,3575886037,3575886086,49
1,1086,32654,3575886103,3575886103,0
1,1086,32655,3575886103,3575886103,0
1,1086,32656,3575886103,3575886103,0
1,1086,32657,3575886103,3575886103,0
1,1086,32658,3575886103,3575886103,0
1,1086,32659,3575886103,3575886103,0
1,1086,32660,3575886103,3575886103,0
1,1086,32661,3575886103,3575886103,0
1,1086,32662,3575886103,3575886103,0
1,1086,32663,3575886103,3575886103,0
1,1086,32664,3575886103,3575886103,0
1,1086,32665,3575886103,3575886103,0
1,1086,32666,3575886103,3575886103,0
1,1086,32667,3575886103,3575886103,0
1,1086,32668,3575886103,3575886103,0
1,1086,32669,3575886103,3575886103,0
1,1086,32670,3575886103,3575886103,0
1,1086,32671,3575886103,3575886103,0
1,1086,32672,3575886103,3575886103,0
1,1086,32673,3575886103,3575886104,1
1,1086,32674,3575886103,3575886105,2
1,1086,32675,3575886103,3575886106,3
1,1086,32676,3575886103,3575886106,3
1,1086,32677,3575886103,3575886106,3
1,1086,32678,3575886103,3575886107,4
1,1086,32679,3575886103,3575886107,4
1,1086,32680,3575886103,3575886107,4
1,1086,32681,3575886103,3575886108,5
1,1086,32682,3575886103,3575886108,5
1,1086,32683,3575886103,3575886109,6
1,1086,32684,3575886103,3575886109,6
1,1086,32685,3575886103,3575886110,7
1,1086,32686,3575886103,3575886112,9
1,1086,32687,3575886103,3575886113,10
1,1086,32688,3575886103,3575886115,12
1,1086,32689,3575886103,3575886115,12
1,1086,32690,3575886103,3575886115,12
1,1086,32691,3575886103,3575886116,13
1,1086,32692,3575886103,3575886118,15
1,1086,32693,3575886103,3575886119,16
1,1086,32694,3575886103,3575886119,16
1,1086,32695,3575886103,3575886119,16
1,1086,32696,3575886103,3575886120,17
1,1086,32697,3575886103,3575886122,19
1,1086,32698,3575886103,3575886122,19
1,1086,32699,3575886103,3575886123,20
1,1086,32700,3575886103,3575886123,20
1,1086,32701,3575886103,3575886125,22
1,1086,32702,3575886103,3575886125,22
1,1086,32703,3575886103,3575886126,23
1,1086,32704,3575886103,3575886127,24
1,1086,32705,3575886103,3575886128,25
1,1086,32706,3575886103,3575886129,26
1,1086,32707,3575886103,3575886129,26
1,1086,32708,3575886103,3575886131,28
1,1086,32709,3575886103,3575886131,28
1,1086,32710,3575886103,3575886132,29
1,1086,32711,3575886103,3575886132,29
1,1086,32712,3575886103,3575886133,30
1,1086,32713,3575886103,3575886134,31
1,1086,32714,3575886103,3575886135,32
1,1086,32715,3575886103,3575886136,33
1,1086,32716,3575886103,3575886138,35
1,1086,32717,3575886103,3575886144,41
1,1086,32718,3575886103,3575886144,41
1,1086,32719,3575886103,3575886146,43
1,1086,32720,3575886103,3575886148,45
1,1086,32721,3575886103,3575886149,46
1,1086,32722,3575886103,3575886149,46
1,1086,32723,3575886103,3575886149,46
1,1086,32724,3575886103,3575886149,46
1,1086,32725,3575886103,3575886149,46
1,1086,32726,3575886103,3575886150,47
1,1086,32727,3575886103,3575886150,47
1,1086,32728,3575886103,3575886153,50
1,1087,32729,3575886165,3575886165,0
1,1087,32730,3575886165,3575886165,0
1,1087,32731,3575886165,3575886165,0
1,1087,32732,3575886165,3575886165,0
1,1087,32733,3575886165,3575886165,0
1,1087,32734,3575886165,3575886165,0
1,1087,32735,3575886165,3575886165,0
1,1087,32736,3575886165,3575886165,0
1,1087,32737,3575886165,3575886165,0
1,1087,32738,3575886165,3575886165,0
1,1087,32739,3575886165,3575886165,0
1,1087,32740,3575886165,3575886165,0
1,1087,32741,3575886165,3575886165,0
1,1087,32742,3575886165,3575886165,0
1,1087,32743,3575886165,3575886165,0
1,1087,32744,3575886165,3575886165,0
1,1087,32745,3575886165,3575886165,0
1,1087,32746,3575886165,3575886165,0
1,1087,32747,3575886165,3575886165,0
1,1087,32748,3575886165,3575886165,0
1,1087,32749,3575886165,3575886165,0
1,1087,32750,3575886165,3575886169,4
1,1087,32751,3575886165,3575886170,5
1,1087,32752,3575886165,3575886172,7
1,1087,32753,3575886165,3575886173,8
1,1087,32754,3575886165,3575886174,9
1,1087,32755,3575886165,3575886174,9
1,1087,32756,3575886165,3575886174,9
1,1087,32757,3575886165,3575886176,11
1,1087,32758,3575886165,3575886176,11
1,1087,32759,3575886165,3575886178,13
1,1087,32760,3575886165,3575886180,15
1,1087,32761,3575886165,3575886181,16
1,1087,32762,3575886165,3575886181,16
1,1087,32763,3575886165,3575886182,17
1,1087,32764,3575886165,3575886183,18
1,1087,32765,3575886165,3575886183,18
1,1087,32766,3575886165,3575886183,18
1,1087,32767,3575886165,3575886184,19
1,1087,32768,3575886165,3575886185,20
1,1087,32769,3575886165,3575886185,20
1,1087,32770,3575886165,3575886188,23
1,1087,32771,3575886165,3575886189,24
1,1087,32772,3575886165,3575886190,25
1,1087,32773,3575886165,3575886190,25
1,1087,32774,3575886165,3575886191,26
1,1087,32775,3575886165,3575886192,27
1,1087,32776,3575886165,3575886192,27
1,1087,32777,3575886165,3575886192,27
1,1087,32778,3575886165,3575886193,28
1,1087,32779,3575886165,3575886193,28
1,1087,32780,3575886165,3575886193,28
1,1087,32781,3575886165,3575886196,31
1,1087,32782,3575886165,3575886196,31
1,1087,32783,3575886165,3575886197,32
1,1087,32784,3575886165,3575886198,33
1,1087,32785,3575886165,3575886198,33
1,1087,32786,3575886165,3575886199,34
1,1087,32787,3575886165,3575886201,36
1,1087,32788,3575886165,3575886201,36
1,1087,32789,3575886165,3575886201,36
1,1087,32790,3575886165,3575886201,36
1,1087,32791,3575886165,3575886202,37
1,1087,32792,3575886165,3575886202,37
1,1087,32793,3575886165,3575886202,37
1,1087,32794,3575886165,3575886203,38
1,1087,32795,3575886165,3575886204,39
1,1087,32796,3575886165,3575886205,40
1,1087,32797,3575886165,3575886205,40
1,1087,32798,3575886165,3575886205,40
1,1087,32799,3575886165,3575886207,42
1,1087,32800,3575886165,3575886207,42
1,1087,32801,3575886165,3575886208,43
1,1087,32802,3575886165,3575886209,44
1,1087,32803,3575886165,3575886209,44
1,1087,32804,3575886165,3575886210,45
1,1087,32805,3575886165,3575886211,46
1,1087,32806,3575886165,3575886212,47
1,1087,32807,3575886165,3575886214,49
1,1087,32808,3575886165,3575886215,50
1,1088,32809,3575886230,3575886230,0
1,1088,32810,3575886230,3575886231,1
1,1088,32811,3575886230,3575886231,1
1,1088,32812,3575886230,3575886231,1
1,1088,32813,3575886230,3575886231,1
1,1088,32814,3575886230,3575886231,1
1,1088,32815,3575886230,3575886231,1
1,1088,32816,3575886230,3575886231,1
1,1088,32817,3575886230,3575886231,1
1,1088,32818,3575886230,3575886231,1
1,1088,32819,3575886230,3575886231,1
1,1088,32820,3575886230,3575886231,1
1,1088,32821,3575886230,3575886231,1
1,1088,32822,3575886230,3575886231,1
1,1088,32823,3575886230,3575886231,1
1,1088,32824,3575886230,3575886231,1
1,1088,32825,3575886230,3575886231,1
1,1088,32826,3575886230,3575886231,1
1,1088,32827,3575886230,3575886231,1
1,1088,32828,3575886230,3575886231,1
1,1088,32829,3575886230,3575886231,1
1,1088,32830,3575886230,3575886231,1
1,1088,32831,3575886230,3575886231,1
1,1088,32832,3575886230,3575886231,1
1,1088,32833,3575886230,3575886231,1
1,1088,32834,3575886230,3575886231,1
1,1088,32835,3575886230,3575886231,1
1,1088,32836,3575886230,3575886231,1
1,1088,32837,3575886230,3575886232,2
1,1088,32838,3575886230,3575886233,3
1,1088,32839,3575886230,3575886234,4
1,1088,32840,3575886230,3575886234,4
1,1088,32841,3575886230,3575886235,5
1,1088,32842,3575886230,3575886237,7
1,1088,32843,3575886230,3575886241,11
1,1088,32844,3575886230,3575886241,11
1,1088,32845,3575886230,3575886241,11
1,1088,32846,3575886230,3575886243,13
1,1088,32847,3575886230,3575886244,14
1,1088,32848,3575886230,3575886245,15
1,1088,32849,3575886230,3575886245,15
1,1088,32850,3575886230,3575886245,15
1,1088,32851,3575886230,3575886246,16
1,1088,32852,3575886230,3575886246,16
1,1088,32853,3575886230,3575886246,16
1,1088,32854,3575886230,3575886247,17
1,1088,32855,3575886230,3575886248,18
1,1088,32856,3575886230,3575886248,18
1,1088,32857,3575886230,3575886249,19
1,1088,32858,3575886230,3575886249,19
1,1088,32859,3575886230,3575886249,19
1,1088,32860,3575886230,3575886250,20
1,1088,32861,3575886230,3575886252,22
1,1088,32862,3575886230,3575886252,22
1,1088,32863,3575886230,3575886252,22
1,1088,32864,3575886230,3575886253,23
1,1088,32865,3575886230,3575886256,26
1,1088,32866,3575886230,3575886256,26
1,1088,32867,3575886230,3575886256,26
1,1088,32868,3575886230,3575886257,27
1,1088,32869,3575886230,3575886257,27
1,1088,32870,3575886230,3575886258,28
1,1088,32871,3575886230,3575886260,30
1,1088,32872,3575886230,3575886262,32
1,1088,32873,3575886230,3575886266,36
1,1088,32874,3575886230,3575886267,37
1,1088,32875,3575886230,3575886267,37
1,1088,32876,3575886230,3575886268,38
1,1088,32877,3575886230,3575886269,39
1,1088,32878,3575886230,3575886269,39
1,1088,32879,3575886230,3575886270,40
1,1088,32880,3575886230,3575886270,40
1,1089,32881,3575886293,3575886293,0
1,1089,32882,3575886293,3575886293,0
1,1089,32883,3575886293,3575886293,0
1,1089,32884,3575886293,3575886293,0
1,1089,32885,3575886293,3575886293,0
1,1089,32886,3575886293,3575886293,0
1,1089,32887,3575886293,3575886293,0
1,1089,32888,3575886293,3575886293,0
1,1089,32889,3575886293,3575886293,0
1,1089,32890,3575886293,3575886293,0
1,1089,32891,3575886293,3575886293,0
1,1089,32892,3575886293,3575886293,0
1,1089,32893,3575886293,3575886293,0
1,1089,32894,3575886293,3575886294,1
1,1089,32895,3575886293,3575886294,1
1,1089,32896,3575886293,3575886296,3
1,1089,32897,3575886293,3575886297,4
1,1089,32898,3575886293,3575886297,4
1,1089,32899,3575886293,3575886298,5
1,1089,32900,3575886293,3575886298,5
1,1089,32901,3575886293,3575886300,7
1,1089,32902,3575886293,3575886300,7
1,1089,32903,3575886293,3575886300,7
1,1089,32904,3575886293,3575886302,9
1,1089,32905,3575886293,3575886303,10
1,1089,32906,3575886293,3575886303,10
1,1089,32907,3575886293,3575886304,11
1,1089,32908,3575886293,3575886305,12
1,1089,32909,3575886293,3575886306,13
1,1089,32910,3575886293,3575886306,13
1,1089,32911,3575886293,3575886306,13
1,1089,32912,3575886293,3575886306,13
1,1089,32913,3575886293,3575886307,14
1,1089,32914,3575886293,3575886307,14
1,1089,32915,3575886293,3575886308,15
1,1089,32916,3575886293,3575886308,15
1,1089,32917,3575886293,3575886309,16
1,1089,32918,3575886293,3575886312,19
1,1089,32919,3575886293,3575886313,20
1,1089,32920,3575886293,3575886314,21
1,1089,32921,3575886293,3575886314,21
1,1089,32922,3575886293,3575886315,22
1,1089,32923,3575886293,3575886315,22
1,1089,32924,3575886293,3575886315,22
1,1089,32925,3575886293,3575886318,25
1,1089,32926,3575886293,3575886318,25
1,1089,32927,3575886293,3575886319,26
1,1089,32928,3575886293,3575886319,26
1,1089,32929,3575886293,3575886320,27
1,1089,32930,3575886293,3575886322,29
1,1089,32931,3575886293,3575886323,30
1,1089,32932,3575886293,3575886323,30
1,1089,32933,3575886293,3575886325,32
1,1089,32934,3575886293,3575886326,33
1,1089,32935,3575886293,3575886326,33
1,1089,32936,3575886293,3575886327,34
1,1089,32937,3575886293,3575886327,34
1,1089,32938,3575886293,3575886328,35
1,1089,32939,3575886293,3575886328,35
1,1089,32940,3575886293,3575886329,36
1,1089,32941,3575886293,3575886330,37
1,1089,32942,3575886293,3575886330,37
1,1089,32943,3575886293,3575886331,38
1,1089,32944,3575886293,3575886331,38
1,1089,32945,3575886293,3575886332,39
1,1089,32946,3575886293,3575886333,40
1,1089,32947,3575886293,3575886335,42
1,1089,32948,3575886293,3575886335,42
1,1089,32949,3575886293,3575886335,42
1,1089,32950,3575886293,3575886338,45
1,1089,32951,3575886293,3575886339,46
1,1090,32952,3575886357,3575886357,0
1,1090,32953,3575886357,3575886357,0
1,1090,32954,3575886357,3575886357,0
1,1090,32955,3575886357,3575886357,0
1,1090,32956,3575886357,3575886357,0
1,1090,32957,3575886357,3575886357,0
1,1090,32958,3575886357,3575886357,0
1,1090,32959,3575886357,3575886357,0
1,1090,32960,3575886357,3575886357,0
1,1090,32961,3575886357,3575886357,0
1,1090,32962,3575886357,3575886357,0
1,1090,32963,3575886357,3575886357,0
1,1090,32964,3575886357,3575886357,0
1,1090,32965,3575886357,3575886357,0
1,1090,32966,3575886357,3575886357,0
1,1090,32967,3575886357,3575886357,0
1,1090,32968,3575886357,3575886357,0
1,1090,32969,3575886357,3575886357,0
1,1090,32970,3575886357,3575886357,0
1,1090,32971,3575886357,3575886357,0
1,1090,32972,3575886357,3575886357,0
1,1090,32973,3575886357,3575886357,0
1,1090,32974,3575886357,3575886358,1
1,1090,32975,3575886357,3575886358,1
1,1090,32976,3575886357,3575886359,2
1,1090,32977,3575886357,3575886360,3
1,1090,32978,3575886357,3575886362,5
1,1090,32979,3575886357,3575886362,5
1,1090,32980,3575886357,3575886363,6
1,1090,32981,3575886357,3575886363,6
1,1090,32982,3575886357,3575886364,7
1,1090,32983,3575886357,3575886364,7
1,1090,32984,3575886357,3575886365,8
1,1090,32985,3575886357,3575886366,9
1,1090,32986,3575886357,3575886369,12
1,1090,32987,3575886357,3575886370,13
1,1090,32988,3575886357,3575886373,16
1,1090,32989,3575886357,3575886374,17
1,1090,32990,3575886357,3575886374,17
1,1090,32991,3575886357,3575886374,17
1,1090,32992,3575886357,3575886375,18
1,1090,32993,3575886357,3575886376,19
1,1090,32994,3575886357,3575886379,22
1,1090,32995,3575886357,3575886379,22
1,1090,32996,3575886357,3575886381,24
1,1090,32997,3575886357,3575886381,24
1,1090,32998,3575886357,3575886382,25
1,1090,32999,3575886357,3575886383,26
1,1090,33000,3575886357,3575886385,28
1,1090,33001,3575886357,3575886385,28
1,1090,33002,3575886357,3575886386,29
1,1090,33003,3575886357,3575886386,29
1,1090,33004,3575886357,3575886386,29
1,1090,33005,3575886357,3575886386,29
1,1090,33006,3575886357,3575886388,31
1,1090,33007,3575886357,3575886390,33
1,1090,33008,3575886357,3575886390,33
1,1090,33009,3575886357,3575886392,35
1,1090,33010,3575886357,3575886392,35
1,1090,33011,3575886357,3575886392,35
1,1090,33012,3575886357,3575886392,35
1,1090,33013,3575886357,3575886392,35
1,1090,33014,3575886357,3575886393,36
1,1090,33015,3575886357,3575886393,36
1,1090,33016,3575886357,3575886396,39
1,1090,33017,3575886357,3575886397,40
1,1090,33018,3575886357,3575886397,40
1,1090,33019,3575886357,3575886398,41
1,1090,33020,3575886357,3575886398,41
1,1090,33021,3575886357,3575886399,42
1,1090,33022,3575886357,3575886401,44
1,1090,33023,3575886357,3575886402,45
1,1090,33024,3575886357,3575886402,45
1,1090,33025,3575886357,3575886402,45
1,1090,33026,3575886357,3575886402,45
1,1090,33027,3575886357,3575886402,45
1,1090,33028,3575886357,3575886402,45
1,1090,33029,3575886357,3575886403,46
1,1090,33030,3575886357,3575886404,47
1,1090,33031,3575886357,3575886405,48
1,1090,33032,3575886357,3575886405,48
1,1090,33033,3575886357,3575886405,48
1,1090,33034,3575886357,3575886407,50
1,1091,33035,3575886420,3575886420,0
1,1091,33036,3575886420,3575886420,0
1,1091,33037,3575886420,3575886420,0
1,1091,33038,3575886420,3575886420,0
1,1091,33039,3575886420,3575886420,0
1,1091,33040,3575886420,3575886420,0
1,1091,33041,3575886420,3575886420,0
1,1091,33042,3575886420,3575886420,0
1,1091,33043,3575886420,3575886420,0
1,1091,33044,3575886420,3575886420,0
1,1091,33045,3575886420,3575886420,0
1,1091,33046,3575886420,3575886420,0
1,1091,33047,3575886420,3575886420,0
1,1091,33048,3575886420,3575886420,0
1,1091,33049,3575886420,3575886420,0
1,1091,33050,3575886420,3575886420,0
1,1091,33051,3575886420,3575886420,0
1,1091,33052,3575886420,3575886420,0
1,1091,33053,3575886420,3575886420,0
1,1091,33054,3575886420,3575886421,1
1,1091,33055,3575886420,3575886421,1
1,1091,33056,3575886420,3575886422,2
1,1091,33057,3575886420,3575886423,3
1,1091,33058,3575886420,3575886423,3
1,1091,33059,3575886420,3575886424,4
1,1091,33060,3575886420,3575886424,4
1,1091,33061,3575886420,3575886425,5
1,1091,33062,3575886420,3575886426,6
1,1091,33063,3575886420,3575886427,7
1,1091,33064,3575886420,3575886430,10
1,1091,33065,3575886420,3575886430,10
1,1091,33066,3575886420,3575886430,10
1,1091,33067,3575886420,3575886430,10
1,1091,33068,3575886420,3575886431,11
1,1091,33069,3575886420,3575886432,12
1,1091,33070,3575886420,3575886434,14
1,1091,33071,3575886420,3575886435,15
1,1091,33072,3575886420,3575886435,15
1,1091,33073,3575886420,3575886435,15
1,1091,33074,3575886420,3575886436,16
1,1091,33075,3575886420,3575886439,19
1,1091,33076,3575886420,3575886440,20
1,1091,33077,3575886420,3575886441,21
1,1091,33078,3575886420,3575886441,21
1,1091,33079,3575886420,3575886444,24
1,1091,33080,3575886420,3575886445,25
1,1091,33081,3575886420,3575886445,25
1,1091,33082,3575886420,3575886446,26
1,1091,33083,3575886420,3575886446,26
1,1091,33084,3575886420,3575886446,26
1,1091,33085,3575886420,3575886446,26
1,1091,33086,3575886420,3575886446,26
1,1091,33087,3575886420,3575886447,27
1,1091,33088,3575886420,3575886447,27
1,1091,33089,3575886420,3575886448,28
1,1091,33090,3575886420,3575886449,29
1,1091,33091,3575886420,3575886449,29
1,1091,33092,3575886420,3575886450,30
1,1091,33093,3575886420,3575886450,30
1,1091,33094,3575886420,3575886452,32
1,1091,33095,3575886420,3575886453,33
1,1091,33096,3575886420,3575886453,33
1,1091,33097,3575886420,3575886453,33
1,1091,33098,3575886420,3575886454,34
1,1091,33099,3575886420,3575886455,35
1,1091,33100,3575886420,3575886456,36
1,1091,33101,3575886420,3575886457,37
1,1091,33102,3575886420,3575886457,37
1,1091,33103,3575886420,3575886458,38
1,1091,33104,3575886420,3575886458,38
1,1091,33105,3575886420,3575886459,39
1,1091,33106,3575886420,3575886462,42
1,1091,33107,3575886420,3575886466,46
1,1091,33108,3575886420,3575886466,46
1,1091,33109,3575886420,3575886467,47
1,1091,33110,3575886420,3575886468,48
1,1091,33111,3575886420,3575886469,49
1,1091,33112,3575886420,3575886469,49
1,1091,33113,3575886420,3575886470,50
1,1092,33114,3575886483,3575886483,0
1,1092,33115,3575886483,3575886483,0
1,1092,33116,3575886483,3575886483,0
1,1092,33117,3575886483,3575886483,0
1,1092,33118,3575886483,3575886483,0
1,1092,33119,3575886483,3575886483,0
1,1092,33120,3575886483,3575886484,1
1,1092,33121,3575886483,3575886486,3
1,1092,33122,3575886483,3575886486,3
1,1092,33123,3575886483,3575886486,3
1,1092,33124,3575886483,3575886490,7
1,1092,33125,3575886483,3575886490,7
1,1092,33126,3575886483,3575886490,7
1,1092,33127,3575886483,3575886490,7
1,1092,33128,3575886483,3575886491,8
1,1092,33129,3575886483,3575886492,9
1,1092,33130,3575886483,3575886494,11
1,1092,33131,3575886483,3575886495,12
1,1092,33132,3575886483,3575886497,14
1,1092,33133,3575886483,3575886497,14
1,1092,33134,3575886483,3575886497,14
1,1092,33135,3575886483,3575886497,14
1,1092,33136,3575886483,3575886499,16
1,1092,33137,3575886483,3575886501,18
1,1092,33138,3575886483,3575886501,18
1,1092,33139,3575886483,3575886501,18
1,1092,33140,3575886483,3575886502,19
1,1092,33141,3575886483,3575886503,20
1,1092,33142,3575886483,3575886503,20
1,1092,33143,3575886483,3575886504,21
1,1092,33144,3575886483,3575886505,22
1,1092,33145,3575886483,3575886506,23
1,1092,33146,3575886483,3575886506,23
1,1092,33147,3575886483,3575886506,23
1,1092,33148,3575886483,3575886506,23
1,1092,33149,3575886483,3575886507,24
1,1092,33150,3575886483,3575886507,24
1,1092,33151,3575886483,3575886507,24
1,1092,33152,3575886483,3575886508,25
1,1092,33153,3575886483,3575886509,26
1,1092,33154,3575886483,3575886509,26
1,1092,33155,3575886483,3575886511,28
1,1092,33156,3575886483,3575886511,28
1,1092,33157,3575886483,3575886512,29
1,1092,33158,3575886483,3575886514,31
1,1092,33159,3575886483,3575886514,31
1,1092,33160,3575886483,3575886514,31
1,1092,33161,3575886483,3575886515,32
1,1092,33162,3575886483,3575886517,34
1,1092,33163,3575886483,3575886517,34
1,1092,33164,3575886483,3575886518,35
1,1092,33165,3575886483,3575886518,35
1,1092,33166,3575886483,3575886520,37
1,1092,33167,3575886483,3575886521,38
1,1092,33168,3575886483,3575886522,39
1,1092,33169,3575886483,3575886523,40
1,1092,33170,3575886483,3575886524,41
1,1092,33171,3575886483,3575886525,42
1,1092,33172,3575886483,3575886525,42
1,1092,33173,3575886483,3575886526,43
1,1092,33174,3575886483,3575886526,43
1,1092,33175,3575886483,3575886528,45
1,1092,33176,3575886483,3575886528,45
1,1092,33177,3575886483,3575886529,46
1,1092,33178,3575886483,3575886529,46
1,1092,33179,3575886483,3575886529,46
1,1092,33180,3575886483,3575886530,47
1,1092,33181,3575886483,3575886531,48
1,1092,33182,3575886483,3575886532,49
1,1092,33183,3575886483,3575886533,50
1,1093,33184,3575886546,3575886546,0
1,1093,33185,3575886546,3575886546,0
1,1093,33186,3575886546,3575886546,0
1,1093,33187,3575886546,3575886546,0
1,1093,33188,3575886546,3575886546,0
1,1093,33189,3575886546,3575886546,0
1,1093,33190,3575886546,3575886546,0
1,1093,33191,3575886546,3575886546,0
1,1093,33192,3575886546,3575886546,0
1,1093,33193,3575886546,3575886548,2
1,1093,33194,3575886546,3575886548,2
1,1093,33195,3575886546,3575886549,3
1,1093,33196,3575886546,3575886549,3
1,1093,33197,3575886546,3575886549,3
1,1093,33198,3575886546,3575886550,4
1,1093,33199,3575886546,3575886550,4
1,1093,33200,3575886546,3575886552,6
1,1093,33201,3575886546,3575886553,7
1,1093,33202,3575886546,3575886554,8
1,1093,33203,3575886546,3575886554,8
1,1093,33204,3575886546,3575886554,8
1,1093,33205,3575886546,3575886555,9
1,1093,33206,3575886546,3575886556,10
1,1093,33207,3575886546,3575886556,10
1,1093,33208,3575886546,3575886557,11
1,1093,33209,3575886546,3575886557,11
1,1093,33210,3575886546,3575886558,12
1,1093,33211,3575886546,3575886559,13
1,1093,33212,3575886546,3575886560,14
1,1093,33213,3575886546,3575886562,16
1,1093,33214,3575886546,3575886562,16
1,1093,33215,3575886546,3575886562,16
1,1093,33216,3575886546,3575886563,17
1,1093,33217,3575886546,3575886563,17
1,1093,33218,3575886546,3575886565,19
1,1093,33219,3575886546,3575886565,19
1,1093,33220,3575886546,3575886568,22
1,1093,33221,3575886546,3575886569,23
1,1093,33222,3575886546,3575886572,26
1,1093,33223,3575886546,3575886573,27
1,1093,33224,3575886546,3575886573,27
1,1093,33225,3575886546,3575886574,28
1,1093,33226,3575886546,3575886574,28
1,1093,33227,3575886546,3575886574,28
1,1093,33228,3575886546,3575886576,30
1,1093,33229,3575886546,3575886578,32
1,1093,33230,3575886546,3575886578,32
1,1093,33231,3575886546,3575886580,34
1,1093,33232,3575886546,3575886580,34
1,1093,33233,3575886546,3575886582,36
1,1093,33234,3575886546,3575886582,36
1,1093,33235,3575886546,3575886582,36
1,1093,33236,3575886546,3575886583,37
1,1093,33237,3575886546,3575886584,38
1,1093,33238,3575886546,3575886584,38
1,1093,33239,3575886546,3575886584,38
1,1093,33240,3575886546,3575886585,39
1,1093,33241,3575886546,3575886585,39
1,1093,33242,3575886546,3575886585,39
1,1093,33243,3575886546,3575886587,41
1,1093,33244,3575886546,3575886589,43
1,1093,33245,3575886546,3575886590,44
1,1093,33246,3575886546,3575886590,44
1,1093,33247,3575886546,3575886591,45
1,1093,33248,3575886546,3575886591,45
1,1093,33249,3575886546,3575886591,45
1,1093,33250,3575886546,3575886591,45
1,1093,33251,3575886546,3575886592,46
1,1093,33252,3575886546,3575886592,46
1,1093,33253,3575886546,3575886593,47
1,1094,33254,3575886608,3575886608,0
1,1094,33255,3575886608,3575886608,0
1,1094,33256,3575886608,3575886608,0
1,1094,33257,3575886608,3575886608,0
1,1094,33258,3575886608,3575886608,0
1,1094,33259,3575886608,3575886608,0
1,1094,33260,3575886608,3575886608,0
1,1094,33261,3575886608,3575886608,0
1,1094,33262,3575886608,3575886608,0
1,1094,33263,3575886608,3575886608,0
1,1094,33264,3575886608,3575886608,0
1,1094,33265,3575886608,3575886608,0
1,1094,33266,3575886608,3575886608,0
1,1094,33267,3575886608,3575886608,0
1,1094,33268,3575886608,3575886608,0
1,1094,33269,3575886608,3575886608,0
1,1094,33270,3575886608,3575886608,0
1,1094,33271,3575886608,3575886608,0
1,1094,33272,3575886608,3575886608,0
1,1094,33273,3575886608,3575886608,0
1,1094,33274,3575886608,3575886608,0
1,1094,33275,3575886608,3575886609,1
1,1094,33276,3575886608,3575886609,1
1,1094,33277,3575886608,3575886610,2
1,1094,33278,3575886608,3575886612,4
1,1094,33279,3575886608,3575886613,5
1,1094,33280,3575886608,3575886614,6
1,1094,33281,3575886608,3575886614,6
1,1094,33282,3575886608,3575886615,7
1,1094,33283,3575886608,3575886615,7
1,1094,33284,3575886608,3575886615,7
1,1094,33285,3575886608,3575886617,9
1,1094,33286,3575886608,3575886617,9
1,1094,33287,3575886608,3575886617,9
1,1094,33288,3575886608,3575886618,10
1,1094,33289,3575886608,3575886618,10
1,1094,33290,3575886608,3575886620,12
1,1094,33291,3575886608,3575886620,12
1,1094,33292,3575886608,3575886621,13
1,1094,33293,3575886608,3575886621,13
1,1094,33294,3575886608,3575886621,13
1,1094,33295,3575886608,3575886623,15
1,1094,33296,3575886608,3575886623,15
1,1094,33297,3575886608,3575886624,16
1,1094,33298,3575886608,3575886624,16
1,1094,33299,3575886608,3575886625,17
1,1094,33300,3575886608,3575886628,20
1,1094,33301,3575886608,3575886628,20
1,1094,33302,3575886608,3575886628,20
1,1094,33303,3575886608,3575886629,21
1,1094,33304,3575886608,3575886630,22
1,1094,33305,3575886608,3575886631,23
1,1094,33306,3575886608,3575886633,25
1,1094,33307,3575886608,3575886634,26
1,1094,33308,3575886608,3575886634,26
1,1094,33309,3575886608,3575886634,26
1,1094,33310,3575886608,3575886638,30
1,1094,33311,3575886608,3575886639,31
1,1094,33312,3575886608,3575886640,32
1,1094,33313,3575886608,3575886640,32
1,1094,33314,3575886608,3575886644,36
1,1094,33315,3575886608,3575886644,36
1,1094,33316,3575886608,3575886644,36
1,1094,33317,3575886608,3575886645,37
1,1094,33318,3575886608,3575886645,37
1,1094,33319,3575886608,3575886645,37
1,1094,33320,3575886608,3575886645,37
1,1094,33321,3575886608,3575886646,38
1,1094,33322,3575886608,3575886646,38
1,1094,33323,3575886608,3575886646,38
1,1094,33324,3575886608,3575886647,39
1,1094,33325,3575886608,3575886648,40
1,1094,33326,3575886608,3575886649,41
1,1094,33327,3575886608,3575886649,41
1,1094,33328,3575886608,3575886651,43
1,1094,33329,3575886608,3575886651,43
1,1094,33330,3575886608,3575886652,44
1,1094,33331,3575886608,3575886652,44
1,1094,33332,3575886608,3575886652,44
1,1094,33333,3575886608,3575886655,47
1,1094,33334,3575886608,3575886655,47
1,1094,33335,3575886608,3575886656,48
1,1094,33336,3575886608,3575886656,48
1,1094,33337,3575886608,3575886656,48
1,1094,33338,3575886608,3575886657,49
1,1094,33339,3575886608,3575886658,50
1,1094,33340,3575886608,3575886658,50
1,1095,33341,3575886672,3575886672,0
1,1095,33342,3575886672,3575886672,0
1,1095,33343,3575886672,3575886672,0
1,1095,33344,3575886672,3575886672,0
1,1095,33345,3575886672,3575886672,0
1,1095,33346,3575886672,3575886672,0
1,1095,33347,3575886672,3575886672,0
1,1095,33348,3575886672,3575886672,0
1,1095,33349,3575886672,3575886672,0
1,1095,33350,3575886672,3575886678,6
1,1095,33351,3575886672,3575886682,10
1,1095,33352,3575886672,3575886682,10
1,1095,33353,3575886672,3575886683,11
1,1095,33354,3575886672,3575886684,12
1,1095,33355,3575886672,3575886686,14
1,1095,33356,3575886672,3575886686,14
1,1095,33357,3575886672,3575886686,14
1,1095,33358,3575886672,3575886687,15
1,1095,33359,3575886672,3575886690,18
1,1095,33360,3575886672,3575886690,18
1,1095,33361,3575886672,3575886690,18
1,1095,33362,3575886672,3575886690,18
1,1095,33363,3575886672,3575886691,19
1,1095,33364,3575886672,3575886693,21
1,1095,33365,3575886672,3575886694,22
1,1095,33366,3575886672,3575886694,22
1,1095,33367,3575886672,3575886695,23
1,1095,33368,3575886672,3575886697,25
1,1095,33369,3575886672,3575886698,26
1,1095,33370,3575886672,3575886698,26
1,1095,33371,3575886672,3575886698,26
1,1095,33372,3575886672,3575886699,27
1,1095,33373,3575886672,3575886700,28
1,1095,33374,3575886672,3575886701,29
1,1095,33375,3575886672,3575886701,29
1,1095,33376,3575886672,3575886701,29
1,1095,33377,3575886672,3575886702,30
1,1095,33378,3575886672,3575886703,31
1,1095,33379,3575886672,3575886703,31
1,1095,33380,3575886672,3575886704,32
1,1095,33381,3575886672,3575886706,34
1,1095,33382,3575886672,3575886706,34
1,1095,33383,3575886672,3575886706,34
1,1095,33384,3575886672,3575886706,34
1,1095,33385,3575886672,3575886707,35
1,1095,33386,3575886672,3575886707,35
1,1095,33387,3575886672,3575886707,35
1,1095,33388,3575886672,3575886708,36
1,1095,33389,3575886672,3575886708,36
1,1095,33390,3575886672,3575886711,39
1,1095,33391,3575886672,3575886711,39
1,1095,33392,3575886672,3575886712,40
1,1095,33393,3575886672,3575886714,42
1,1095,33394,3575886672,3575886714,42
1,1095,33395,3575886672,3575886715,43
1,1095,33396,3575886672,3575886715,43
1,1095,33397,3575886672,3575886717,45
1,1095,33398,3575886672,3575886718,46
1,1095,33399,3575886672,3575886719,47
1,1095,33400,3575886672,3575886720,48
1,1095,33401,3575886672,3575886721,49
1,1096,33402,3575886735,3575886735,0
1,1096,33403,3575886735,3575886735,0
1,1096,33404,3575886735,3575886735,0
1,1096,33405,3575886735,3575886735,0
1,1096,33406,3575886735,3575886735,0
1,1096,33407,3575886735,3575886735,0
1,1096,33408,3575886735,3575886735,0
1,1096,33409,3575886735,3575886735,0
1,1096,33410,3575886735,3575886735,0
1,1096,33411,3575886735,3575886735,0
1,1096,33412,3575886735,3575886735,0
1,1096,33413,3575886735,3575886735,0
1,1096,33414,3575886735,3575886735,0
1,1096,33415,3575886735,3575886735,0
1,1096,33416,3575886735,3575886735,0
1,1096,33417,3575886735,3575886735,0
1,1096,33418,3575886735,3575886737,2
1,1096,33419,3575886735,3575886740,5
1,1096,33420,3575886735,3575886743,8
1,1096,33421,3575886735,3575886743,8
1,1096,33422,3575886735,3575886744,9
1,1096,33423,3575886735,3575886746,11
1,1096,33424,3575886735,3575886748,13
1,1096,33425,3575886735,3575886749,14
1,1096,33426,3575886735,3575886750,15
1,1096,33427,3575886735,3575886750,15
1,1096,33428,3575886735,3575886750,15
1,1096,33429,3575886735,3575886750,15
1,1096,33430,3575886735,3575886750,15
1,1096,33431,3575886735,3575886752,17
1,1096,33432,3575886735,3575886752,17
1,1096,33433,3575886735,3575886754,19
1,1096,33434,3575886735,3575886754,19
1,1096,33435,3575886735,3575886754,19
1,1096,33436,3575886735,3575886754,19
1,1096,33437,3575886735,3575886755,20
1,1096,33438,3575886735,3575886756,21
1,1096,33439,3575886735,3575886756,21
1,1096,33440,3575886735,3575886757,22
1,1096,33441,3575886735,3575886757,22
1,1096,33442,3575886735,3575886758,23
1,1096,33443,3575886735,3575886759,24
1,1096,33444,3575886735,3575886761,26
1,1096,33445,3575886735,3575886761,26
1,1096,33446,3575886735,3575886762,27
1,1096,33447,3575886735,3575886762,27
1,1096,33448,3575886735,3575886763,28
1,1096,33449,3575886735,3575886763,28
1,1096,33450,3575886735,3575886765,30
1,1096,33451,3575886735,3575886765,30
1,1096,33452,3575886735,3575886768,33
1,1096,33453,3575886735,3575886770,35
1,1096,33454,3575886735,3575886771,36
1,1096,33455,3575886735,3575886773,38
1,1096,33456,3575886735,3575886774,39
1,1096,33457,3575886735,3575886775,40
1,1096,33458,3575886735,3575886776,41
1,1096,33459,3575886735,3575886777,42
1,1096,33460,3575886735,3575886779,44
1,1096,33461,3575886735,3575886780,45
1,1096,33462,3575886735,3575886781,46
1,1096,33463,3575886735,3575886781,46
1,1096,33464,3575886735,3575886782,47
1,1096,33465,3575886735,3575886782,47
1,1096,33466,3575886735,3575886783,48
1,1096,33467,3575886735,3575886783,48
1,1096,33468,3575886735,3575886784,49
1,1097,33469,3575886800,3575886800,0
1,1097,33470,3575886800,3575886800,0
1,1097,33471,3575886800,3575886800,0
1,1097,33472,3575886800,3575886800,0
1,1097,33473,3575886800,3575886800,0
1,1097,33474,3575886800,3575886800,0
1,1097,33475,3575886800,3575886800,0
1,1097,33476,3575886800,3575886800,0
1,1097,33477,3575886800,3575886800,0
1,1097,33478,3575886800,3575886800,0
1,1097,33479,3575886800,3575886800,0
1,1097,33480,3575886800,3575886800,0
1,1097,33481,3575886800,3575886800,0
1,1097,33482,3575886800,3575886800,0
1,1097,33483,3575886800,3575886800,0
1,1097,33484,3575886800,3575886800,0
1,1097,33485,3575886800,3575886800,0
1,1097,33486,3575886800,3575886800,0
1,1097,33487,3575886800,3575886800,0
1,1097,33488,3575886800,3575886800,0
1,1097,33489,3575886800,3575886800,0
1,1097,33490,3575886800,3575886800,0
1,1097,33491,3575886800,3575886801,1
1,1097,33492,3575886800,3575886801,1
1,1097,33493,3575886800,3575886801,1
1,1097,33494,3575886800,3575886801,1
1,1097,33495,3575886800,3575886802,2
1,1097,33496,3575886800,3575886803,3
1,1097,33497,3575886800,3575886804,4
1,1097,33498,3575886800,3575886804,4
1,1097,33499,3575886800,3575886806,6
1,1097,33500,3575886800,3575886806,6
1,1097,33501,3575886800,3575886806,6
1,1097,33502,3575886800,3575886807,7
1,1097,33503,3575886800,3575886809,9
1,1097,33504,3575886800,3575886809,9
1,1097,33505,3575886800,3575886809,9
1,1097,33506,3575886800,3575886810,10
1,1097,33507,3575886800,3575886810,10
1,1097,33508,3575886800,3575886812,12
1,1097,33509,3575886800,3575886813,13
1,1097,33510,3575886800,3575886814,14
1,1097,33511,3575886800,3575886814,14
1,1097,33512,3575886800,3575886814,14
1,1097,33513,3575886800,3575886815,15
1,1097,33514,3575886800,3575886815,15
1,1097,33515,3575886800,3575886816,16
1,1097,33516,3575886800,3575886816,16
1,1097,33517,3575886800,3575886817,17
1,1097,33518,3575886800,3575886817,17
1,1097,33519,3575886800,3575886817,17
1,1097,33520,3575886800,3575886818,18
1,1097,33521,3575886800,3575886818,18
1,1097,33522,3575886800,3575886820,20
1,1097,33523,3575886800,3575886821,21
1,1097,33524,3575886800,3575886821,21
1,1097,33525,3575886800,3575886822,22
1,1097,33526,3575886800,3575886822,22
1,1097,33527,3575886800,3575886822,22
1,1097,33528,3575886800,3575886823,23
1,1097,33529,3575886800,3575886824,24
1,1097,33530,3575886800,3575886824,24
1,1097,33531,3575886800,3575886825,25
1,1097,33532,3575886800,3575886826,26
1,1097,33533,3575886800,3575886828,28
1,1097,33534,3575886800,3575886828,28
1,1097,33535,3575886800,3575886829,29
1,1097,33536,3575886800,3575886829,29
1,1097,33537,3575886800,3575886829,29
1,1097,33538,3575886800,3575886830,30
1,1097,33539,3575886800,3575886831,31
1,1097,33540,3575886800,3575886832,32
1,1097,33541,3575886800,3575886834,34
1,1097,33542,3575886800,3575886834,34
1,1097,33543,3575886800,3575886834,34
1,1097,33544,3575886800,3575886836,36
1,1097,33545,3575886800,3575886837,37
1,1097,33546,3575886800,3575886838,38
1,1097,33547,3575886800,3575886839,39
1,1097,33548,3575886800,3575886839,39
1,1097,33549,3575886800,3575886841,41
1,1097,33550,3575886800,3575886842,42
1,1097,33551,3575886800,3575886844,44
1,1097,33552,3575886800,3575886844,44
1,1097,33553,3575886800,3575886844,44
1,1097,33554,3575886800,3575886844,44
1,1097,33555,3575886800,3575886845,45
1,1097,33556,3575886800,3575886845,45
1,1097,33557,3575886800,3575886845,45
1,1097,33558,3575886800,3575886846,46
1,1097,33559,3575886800,3575886847,47
1,1097,33560,3575886800,3575886847,47
1,1097,33561,3575886800,3575886847,47
1,1097,33562,3575886800,3575886848,48
1,1097,33563,3575886800,3575886848,48
1,1097,33564,3575886800,3575886849,49
1,1097,33565,3575886800,3575886850,50
1,1098,33566,3575886863,3575886863,0
1,1098,33567,3575886863,3575886863,0
1,1098,33568,3575886863,3575886863,0
1,1098,33569,3575886863,3575886863,0
1,1098,33570,3575886863,3575886863,0
1,1098,33571,3575886863,3575886863,0
1,1098,33572,3575886863,3575886863,0
1,1098,33573,3575886863,3575886863,0
1,1098,33574,3575886863,3575886863,0
1,1098,33575,3575886863,3575886863,0
1,1098,33576,3575886863,3575886863,0
1,1098,33577,3575886863,3575886863,0
1,1098,33578,3575886863,3575886863,0
1,1098,33579,3575886863,3575886863,0
1,1098,33580,3575886863,3575886865,2
1,1098,33581,3575886863,3575886865,2
1,1098,33582,3575886863,3575886868,5
1,1098,33583,3575886863,3575886868,5
1,1098,33584,3575886863,3575886869,6
1,1098,33585,3575886863,3575886869,6
1,1098,33586,3575886863,3575886869,6
1,1098,33587,3575886863,3575886870,7
1,1098,33588,3575886863,3575886879,16
1,1098,33589,3575886863,3575886879,16
1,1098,33590,3575886863,3575886882,19
1,1098,33591,3575886863,3575886882,19
1,1098,33592,3575886863,3575886882,19
1,1098,33593,3575886863,3575886883,20
1,1098,33594,3575886863,3575886884,21
1,1098,33595,3575886863,3575886886,23
1,1098,33596,3575886863,3575886886,23
1,1098,33597,3575886863,3575886887,24
1,1098,33598,3575886863,3575886889,26
1,1098,33599,3575886863,3575886890,27
1,1098,33600,3575886863,3575886890,27
1,1098,33601,3575886863,3575886890,27
1,1098,33602,3575886863,3575886891,28
1,1098,33603,3575886863,3575886893,30
1,1098,33604,3575886863,3575886894,31
1,1098,33605,3575886863,3575886894,31
1,1098,33606,3575886863,3575886894,31
1,1098,33607,3575886863,3575886897,34
1,1098,33608,3575886863,3575886898,35
1,1098,33609,3575886863,3575886898,35
1,1098,33610,3575886863,3575886898,35
1,1098,33611,3575886863,3575886898,35
1,1098,33612,3575886863,3575886900,37
1,1098,33613,3575886863,3575886900,37
1,1098,33614,3575886863,3575886900,37
1,1098,33615,3575886863,3575886901,38
1,1098,33616,3575886863,3575886902,39
1,1098,33617,3575886863,3575886903,40
1,1098,33618,3575886863,3575886903,40
1,1098,33619,3575886863,3575886904,41
1,1098,33620,3575886863,3575886906,43
1,1098,33621,3575886863,3575886906,43
1,1098,33622,3575886863,3575886906,43
1,1098,33623,3575886863,3575886907,44
1,1098,33624,3575886863,3575886908,45
1,1098,33625,3575886863,3575886908,45
1,1098,33626,3575886863,3575886909,46
1,1098,33627,3575886863,3575886910,47
1,1098,33628,3575886863,3575886911,48
1,1098,33629,3575886863,3575886911,48
1,1098,33630,3575886863,3575886913,50
1,1099,33631,3575886929,3575886929,0
1,1099,33632,3575886929,3575886929,0
1,1099,33633,3575886929,3575886929,0
1,1099,33634,3575886929,3575886929,0
1,1099,33635,3575886929,3575886929,0
1,1099,33636,3575886929,3575886929,0
1,1099,33637,3575886929,3575886929,0
1,1099,33638,3575886929,3575886929,0
1,1099,33639,3575886929,3575886929,0
1,1099,33640,3575886929,3575886929,0
1,1099,33641,3575886929,3575886929,0
1,1099,33642,3575886929,3575886929,0
1,1099,33643,3575886929,3575886929,0
1,1099,33644,3575886929,3575886929,0
1,1099,33645,3575886929,3575886929,0
1,1099,33646,3575886929,3575886929,0
1,1099,33647,3575886929,3575886929,0
1,1099,33648,3575886929,3575886929,0
1,1099,33649,3575886929,3575886930,1
1,1099,33650,3575886929,3575886931,2
1,1099,33651,3575886929,3575886931,2
1,1099,33652,3575886929,3575886933,4
1,1099,33653,3575886929,3575886933,4
1,1099,33654,3575886929,3575886934,5
1,1099,33655,3575886929,3575886934,5
1,1099,33656,3575886929,3575886935,6
1,1099,33657,3575886929,3575886938,9
1,1099,33658,3575886929,3575886939,10
1,1099,33659,3575886929,3575886943,14
1,1099,33660,3575886929,3575886944,15
1,1099,33661,3575886929,3575886944,15
1,1099,33662,3575886929,3575886946,17
1,1099,33663,3575886929,3575886948,19
1,1099,33664,3575886929,3575886948,19
1,1099,33665,3575886929,3575886949,20
1,1099,33666,3575886929,3575886950,21
1,1099,33667,3575886929,3575886951,22
1,1099,33668,3575886929,3575886951,22
1,1099,33669,3575886929,3575886951,22
1,1099,33670,3575886929,3575886952,23
1,1099,33671,3575886929,3575886952,23
1,1099,33672,3575886929,3575886952,23
1,1099,33673,3575886929,3575886953,24
1,1099,33674,3575886929,3575886953,24
1,1099,33675,3575886929,3575886954,25
1,1099,33676,3575886929,3575886956,27
1,1099,33677,3575886929,3575886956,27
1,1099,33678,3575886929,3575886957,28
1,1099,33679,3575886929,3575886957,28
1,1099,33680,3575886929,3575886958,29
1,1099,33681,3575886929,3575886959,30
1,1099,33682,3575886929,3575886960,31
1,1099,33683,3575886929,3575886961,32
1,1099,33684,3575886929,3575886962,33
1,1099,33685,3575886929,3575886962,33
1,1099,33686,3575886929,3575886963,34
1,1099,33687,3575886929,3575886963,34
1,1099,33688,3575886929,3575886964,35
1,1099,33689,3575886929,3575886965,36
1,1099,33690,3575886929,3575886966,37
1,1099,33691,3575886929,3575886967,38
1,1099,33692,3575886929,3575886970,41
1,1099,33693,3575886929,3575886971,42
1,1099,33694,3575886929,3575886974,45
1,1099,33695,3575886929,3575886974,45
1,1099,33696,3575886929,3575886974,45
1,1099,33697,3575886929,3575886976,47
1,1099,33698,3575886929,3575886978,49
1,1099,33699,3575886929,3575886978,49
1,1100,33700,3575886991,3575886991,0
1,1100,33701,3575886991,3575886991,0
1,1100,33702,3575886991,3575886991,0
1,1100,33703,3575886991,3575886991,0
1,1100,33704,3575886991,3575886991,0
1,1100,33705,3575886991,3575886991,0
1,1100,33706,3575886991,3575886991,0
1,1100,33707,3575886991,3575886991,0
1,1100,33708,3575886991,3575886991,0
1,1100,33709,3575886991,3575886991,0
1,1100,33710,3575886991,3575886991,0
1,1100,33711,3575886991,3575886991,0
1,1100,33712,3575886991,3575886991,0
1,1100,33713,3575886991,3575886991,0
1,1100,33714,3575886991,3575886992,1
1,1100,33715,3575886991,3575886992,1
1,1100,33716,3575886991,3575886992,1
1,1100,33717,3575886991,3575886993,2
1,1100,33718,3575886991,3575886993,2
1,1100,33719,3575886991,3575886993,2
1,1100,33720,3575886991,3575886996,5
1,1100,33721,3575886991,3575886997,6
1,1100,33722,3575886991,3575886998,7
1,1100,33723,3575886991,3575886998,7
1,1100,33724,3575886991,3575886998,7
1,1100,33725,3575886991,3575886999,8
1,1100,33726,3575886991,3575887000,9
1,1100,33727,3575886991,3575887001,10
1,1100,33728,3575886991,3575887002,11
1,1100,33729,3575886991,3575887002,11
1,1100,33730,3575886991,3575887002,11
1,1100,33731,3575886991,3575887002,11
1,1100,33732,3575886991,3575887003,12
1,1100,33733,3575886991,3575887004,13
1,1100,33734,3575886991,3575887005,14
1,1100,33735,3575886991,3575887005,14
1,1100,33736,3575886991,3575887006,15
1,1100,33737,3575886991,3575887007,16
1,1100,33738,3575886991,3575887007,16
1,1100,33739,3575886991,3575887007,16
1,1100,33740,3575886991,3575887008,17
1,1100,33741,3575886991,3575887008,17
1,1100,33742,3575886991,3575887010,19
1,1100,33743,3575886991,3575887011,20
1,1100,33744,3575886991,3575887012,21
1,1100,33745,3575886991,3575887012,21
1,1100,33746,3575886991,3575887013,22
1,1100,33747,3575886991,3575887014,23
1,1100,33748,3575886991,3575887014,23
1,1100,33749,3575886991,3575887014,23
1,1100,33750,3575886991,3575887015,24
1,1100,33751,3575886991,3575887016,25
1,1100,33752,3575886991,3575887016,25
1,1100,33753,3575886991,3575887017,26
1,1100,33754,3575886991,3575887017,26
1,1100,33755,3575886991,3575887017,26
1,1100,33756,3575886991,3575887018,27
1,1100,33757,3575886991,3575887019,28
1,1100,33758,3575886991,3575887020,29
1,1100,33759,3575886991,3575887020,29
1,1100,33760,3575886991,3575887021,30
1,1100,33761,3575886991,3575887022,31
1,1100,33762,3575886991,3575887023,32
1,1100,33763,3575886991,3575887023,32
1,1100,33764,3575886991,3575887023,32
1,1100,33765,3575886991,3575887024,33
1,1100,33766,3575886991,3575887024,33
1,1100,33767,3575886991,3575887025,34
1,1100,33768,3575886991,3575887025,34
1,1100,33769,3575886991,3575887028,37
1,1100,33770,3575886991,3575887029,38
1,1100,33771,3575886991,3575887029,38
1,1100,33772,3575886991,3575887029,38
1,1100,33773,3575886991,3575887029,38
1,1100,33774,3575886991,3575887029,38
1,1100,33775,3575886991,3575887030,39
1,1100,33776,3575886991,3575887031,40
1,1100,33777,3575886991,3575887033,42
1,1100,33778,3575886991,3575887034,43
1,1100,33779,3575886991,3575887034,43
1,1100,33780,3575886991,3575887035,44
1,1100,33781,3575886991,3575887036,45
1,1100,33782,3575886991,3575887038,47
1,1100,33783,3575886991,3575887039,48
1,1100,33784,3575886991,3575887040,49
1,1100,33785,3575886991,3575887041,50
1,1101,33786,3575887056,3575887056,0
1,1101,33787,3575887056,3575887056,0
1,1101,33788,3575887056,3575887056,0
1,1101,33789,3575887056,3575887056,0
1,1101,33790,3575887056,3575887056,0
1,1101,33791,3575887056,3575887056,0
1,1101,33792,3575887056,3575887056,0
1,1101,33793,3575887056,3575887056,0
1,1101,33794,3575887056,3575887056,0
1,1101,33795,3575887056,3575887056,0
1,1101,33796,3575887056,3575887056,0
1,1101,33797,3575887056,3575887056,0
1,1101,33798,3575887056,3575887056,0
1,1101,33799,3575887056,3575887056,0
1,1101,33800,3575887056,3575887056,0
1,1101,33801,3575887056,3575887056,0
1,1101,33802,3575887056,3575887056,0
1,1101,33803,3575887056,3575887056,0
1,1101,33804,3575887056,3575887056,0
1,1101,33805,3575887056,3575887056,0
1,1101,33806,3575887056,3575887056,0
1,1101,33807,3575887056,3575887056,0
1,1101,33808,3575887056,3575887056,0
1,1101,33809,3575887056,3575887056,0
1,1101,33810,3575887056,3575887056,0
1,1101,33811,3575887056,3575887058,2
1,1101,33812,3575887056,3575887058,2
1,1101,33813,3575887056,3575887058,2
1,1101,33814,3575887056,3575887058,2
1,1101,33815,3575887056,3575887062,6
1,1101,33816,3575887056,3575887066,10
1,1101,33817,3575887056,3575887068,12
1,1101,33818,3575887056,3575887069,13
1,1101,33819,3575887056,3575887069,13
1,1101,33820,3575887056,3575887069,13
1,1101,33821,3575887056,3575887070,14
1,1101,33822,3575887056,3575887079,23
1,1101,33823,3575887056,3575887082,26
1,1101,33824,3575887056,3575887082,26
1,1101,33825,3575887056,3575887082,26
1,1101,33826,3575887056,3575887083,27
1,1101,33827,3575887056,3575887084,28
1,1101,33828,3575887056,3575887086,30
1,1101,33829,3575887056,3575887087,31
1,1101,33830,3575887056,3575887087,31
1,1101,33831,3575887056,3575887087,31
1,1101,33832,3575887056,3575887090,34
1,1101,33833,3575887056,3575887090,34
1,1101,33834,3575887056,3575887090,34
1,1101,33835,3575887056,3575887090,34
1,1101,33836,3575887056,3575887091,35
1,1101,33837,3575887056,3575887092,36
1,1101,33838,3575887056,3575887094,38
1,1101,33839,3575887056,3575887095,39
1,1101,33840,3575887056,3575887095,39
1,1101,33841,3575887056,3575887097,41
1,1101,33842,3575887056,3575887098,42
1,1101,33843,3575887056,3575887098,42
1,1101,33844,3575887056,3575887098,42
1,1101,33845,3575887056,3575887098,42
1,1101,33846,3575887056,3575887099,43
1,1101,33847,3575887056,3575887100,44
1,1101,33848,3575887056,3575887101,45
1,1101,33849,3575887056,3575887101,45
1,1101,33850,3575887056,3575887101,45
1,1101,33851,3575887056,3575887102,46
1,1101,33852,3575887056,3575887103,47
1,1101,33853,3575887056,3575887104,48
1,1101,33854,3575887056,3575887105,49
1,1101,33855,3575887056,3575887106,50
1,1102,33856,3575887120,3575887120,0
1,1102,33857,3575887120,3575887120,0
1,1102,33858,3575887120,3575887120,0
1,1102,33859,3575887120,3575887120,0
1,1102,33860,3575887120,3575887120,0
1,1102,33861,3575887120,3575887120,0
1,1102,33862,3575887120,3575887120,0
1,1102,33863,3575887120,3575887120,0
1,1102,33864,3575887120,3575887120,0
1,1102,33865,3575887120,3575887120,0
1,1102,33866,3575887120,3575887120,0
1,1102,33867,3575887120,3575887120,0
1,1102,33868,3575887120,3575887120,0
1,1102,33869,3575887120,3575887120,0
1,1102,33870,3575887120,3575887120,0
1,1102,33871,3575887120,3575887120,0
1,1102,33872,3575887120,3575887120,0
1,1102,33873,3575887120,3575887121,1
1,1102,33874,3575887120,3575887121,1
1,1102,33875,3575887120,3575887123,3
1,1102,33876,3575887120,3575887124,4
1,1102,33877,3575887120,3575887126,6
1,1102,33878,3575887120,3575887127,7
1,1102,33879,3575887120,3575887127,7
1,1102,33880,3575887120,3575887128,8
1,1102,33881,3575887120,3575887129,9
1,1102,33882,3575887120,3575887129,9
1,1102,33883,3575887120,3575887130,10
1,1102,33884,3575887120,3575887131,11
1,1102,33885,3575887120,3575887131,11
1,1102,33886,3575887120,3575887133,13
1,1102,33887,3575887120,3575887133,13
1,1102,33888,3575887120,3575887135,15
1,1102,33889,3575887120,3575887135,15
1,1102,33890,3575887120,3575887135,15
1,1102,33891,3575887120,3575887137,17
1,1102,33892,3575887120,3575887140,20
1,1102,33893,3575887120,3575887143,23
1,1102,33894,3575887120,3575887143,23
1,1102,33895,3575887120,3575887144,24
1,1102,33896,3575887120,3575887145,25
1,1102,33897,3575887120,3575887148,28
1,1102,33898,3575887120,3575887148,28
1,1102,33899,3575887120,3575887150,30
1,1102,33900,3575887120,3575887150,30
1,1102,33901,3575887120,3575887150,30
1,1102,33902,3575887120,3575887151,31
1,1102,33903,3575887120,3575887151,31
1,1102,33904,3575887120,3575887153,33
1,1102,33905,3575887120,3575887153,33
1,1102,33906,3575887120,3575887153,33
1,1102,33907,3575887120,3575887154,34
1,1102,33908,3575887120,3575887154,34
1,1102,33909,3575887120,3575887155,35
1,1102,33910,3575887120,3575887155,35
1,1102,33911,3575887120,3575887156,36
1,1102,33912,3575887120,3575887156,36
1,1102,33913,3575887120,3575887157,37
1,1102,33914,3575887120,3575887157,37
1,1102,33915,3575887120,3575887158,38
1,1102,33916,3575887120,3575887159,39
1,1102,33917,3575887120,3575887161,41
1,1102,33918,3575887120,3575887162,42
1,1102,33919,3575887120,3575887163,43
1,1102,33920,3575887120,3575887163,43
1,1102,33921,3575887120,3575887163,43
1,1102,33922,3575887120,3575887163,43
1,1102,33923,3575887120,3575887164,44
1,1102,33924,3575887120,3575887166,46
1,1102,33925,3575887120,3575887166,46
1,1102,33926,3575887120,3575887168,48
1,1103,33927,3575887184,3575887184,0
1,1103,33928,3575887184,3575887184,0
1,1103,33929,3575887184,3575887184,0
1,1103,33930,3575887184,3575887184,0
1,1103,33931,3575887184,3575887184,0
1,1103,33932,3575887184,3575887184,0
1,1103,33933,3575887184,3575887184,0
1,1103,33934,3575887184,3575887184,0
1,1103,33935,3575887184,3575887184,0
1,1103,33936,3575887184,3575887184,0
1,1103,33937,3575887184,3575887184,0
1,1103,33938,3575887184,3575887184,0
1,1103,33939,3575887184,3575887184,0
1,1103,33940,3575887184,3575887184,0
1,1103,33941,3575887184,3575887184,0
1,1103,33942,3575887184,3575887184,0
1,1103,33943,3575887184,3575887185,1
1,1103,33944,3575887184,3575887185,1
1,1103,33945,3575887184,3575887186,2
1,1103,33946,3575887184,3575887188,4
1,1103,33947,3575887184,3575887189,5
1,1103,33948,3575887184,3575887191,7
1,1103,33949,3575887184,3575887191,7
1,1103,33950,3575887184,3575887192,8
1,1103,33951,3575887184,3575887192,8
1,1103,33952,3575887184,3575887192,8
1,1103,33953,3575887184,3575887193,9
1,1103,33954,3575887184,3575887193,9
1,1103,33955,3575887184,3575887193,9
1,1103,33956,3575887184,3575887196,12
1,1103,33957,3575887184,3575887197,13
1,1103,33958,3575887184,3575887197,13
1,1103,33959,3575887184,3575887197,13
1,1103,33960,3575887184,3575887198,14
1,1103,33961,3575887184,3575887199,15
1,1103,33962,3575887184,3575887200,16
1,1103,33963,3575887184,3575887200,16
1,1103,33964,3575887184,3575887201,17
1,1103,33965,3575887184,3575887202,18
1,1103,33966,3575887184,3575887202,18
1,1103,33967,3575887184,3575887202,18
1,1103,33968,3575887184,3575887204,20
1,1103,33969,3575887184,3575887205,21
1,1103,33970,3575887184,3575887206,22
1,1103,33971,3575887184,3575887208,24
1,1103,33972,3575887184,3575887208,24
1,1103,33973,3575887184,3575887209,25
1,1103,33974,3575887184,3575887209,25
1,1103,33975,3575887184,3575887210,26
1,1103,33976,3575887184,3575887211,27
1,1103,33977,3575887184,3575887212,28
1,1103,33978,3575887184,3575887212,28
1,1103,33979,3575887184,3575887214,30
1,1103,33980,3575887184,3575887214,30
1,1103,33981,3575887184,3575887214,30
1,1103,33982,3575887184,3575887214,30
1,1103,33983,3575887184,3575887215,31
1,1103,33984,3575887184,3575887216,32
1,1103,33985,3575887184,3575887216,32
1,1103,33986,3575887184,3575887217,33
1,1103,33987,3575887184,3575887218,34
1,1103,33988,3575887184,3575887218,34
1,1103,33989,3575887184,3575887219,35
1,1103,33990,3575887184,3575887220,36
1,1103,33991,3575887184,3575887221,37
1,1103,33992,3575887184,3575887222,38
1,1103,33993,3575887184,3575887222,38
1,1103,33994,3575887184,3575887223,39
1,1103,33995,3575887184,3575887223,39
1,1103,33996,3575887184,3575887223,39
1,1103,33997,3575887184,3575887224,40
1,1103,33998,3575887184,3575887224,40
1,1103,33999,3575887184,3575887225,41
1,1103,34000,3575887184,3575887226,42
1,1103,34001,3575887184,3575887228,44
1,1103,34002,3575887184,3575887229,45
1,1103,34003,3575887184,3575887229,45
1,1103,34004,3575887184,3575887229,45
1,1103,34005,3575887184,3575887230,46
1,1103,34006,3575887184,3575887231,47
1,1103,34007,3575887184,3575887232,48
1,1103,34008,3575887184,3575887232,48
1,1103,34009,3575887184,3575887234,50
1,1104,34010,3575887248,3575887248,0
1,1104,34011,3575887248,3575887248,0
1,1104,34012,3575887248,3575887248,0
1,1104,34013,3575887248,3575887248,0
1,1104,34014,3575887248,3575887248,0
1,1104,34015,3575887248,3575887248,0
1,1104,34016,3575887248,3575887248,0
1,1104,34017,3575887248,3575887248,0
1,1104,34018,3575887248,3575887248,0
1,1104,34019,3575887248,3575887248,0
1,1104,34020,3575887248,3575887248,0
1,1104,34021,3575887248,3575887248,0
1,1104,34022,3575887248,3575887248,0
1,1104,34023,3575887248,3575887248,0
1,1104,34024,3575887248,3575887248,0
1,1104,34025,3575887248,3575887248,0
1,1104,34026,3575887248,3575887248,0
1,1104,34027,3575887248,3575887248,0
1,1104,34028,3575887248,3575887249,1
1,1104,34029,3575887248,3575887249,1
1,1104,34030,3575887248,3575887251,3
1,1104,34031,3575887248,3575887251,3
1,1104,34032,3575887248,3575887251,3
1,1104,34033,3575887248,3575887253,5
1,1104,34034,3575887248,3575887254,6
1,1104,34035,3575887248,3575887255,7
1,1104,34036,3575887248,3575887256,8
1,1104,34037,3575887248,3575887256,8
1,1104,34038,3575887248,3575887257,9
1,1104,34039,3575887248,3575887258,10
1,1104,34040,3575887248,3575887258,10
1,1104,34041,3575887248,3575887258,10
1,1104,34042,3575887248,3575887260,12
1,1104,34043,3575887248,3575887263,15
1,1104,34044,3575887248,3575887266,18
1,1104,34045,3575887248,3575887266,18
1,1104,34046,3575887248,3575887268,20
1,1104,34047,3575887248,3575887269,21
1,1104,34048,3575887248,3575887269,21
1,1104,34049,3575887248,3575887269,21
1,1104,34050,3575887248,3575887280,32
1,1104,34051,3575887248,3575887281,33
1,1104,34052,3575887248,3575887282,34
1,1104,34053,3575887248,3575887283,35
1,1104,34054,3575887248,3575887284,36
1,1104,34055,3575887248,3575887284,36
1,1104,34056,3575887248,3575887284,36
1,1104,34057,3575887248,3575887286,38
1,1104,34058,3575887248,3575887286,38
1,1104,34059,3575887248,3575887287,39
1,1104,34060,3575887248,3575887287,39
1,1104,34061,3575887248,3575887288,40
1,1104,34062,3575887248,3575887290,42
1,1104,34063,3575887248,3575887290,42
1,1104,34064,3575887248,3575887290,42
1,1104,34065,3575887248,3575887290,42
1,1104,34066,3575887248,3575887290,42
1,1104,34067,3575887248,3575887292,44
1,1104,34068,3575887248,3575887294,46
1,1104,34069,3575887248,3575887294,46
1,1104,34070,3575887248,3575887298,50
1,1105,34071,3575887310,3575887310,0
1,1105,34072,3575887310,3575887310,0
1,1105,34073,3575887310,3575887310,0
1,1105,34074,3575887310,3575887310,0
1,1105,34075,3575887310,3575887310,0
1,1105,34076,3575887310,3575887310,0
1,1105,34077,3575887310,3575887310,0
1,1105,34078,3575887310,3575887310,0
1,1105,34079,3575887310,3575887310,0
1,1105,34080,3575887310,3575887310,0
1,1105,34081,3575887310,3575887310,0
1,1105,34082,3575887310,3575887310,0
1,1105,34083,3575887310,3575887310,0
1,1105,34084,3575887310,3575887310,0
1,1105,34085,3575887310,3575887310,0
1,1105,34086,3575887310,3575887310,0
1,1105,34087,3575887310,3575887310,0
1,1105,34088,3575887310,3575887310,0
1,1105,34089,3575887310,3575887311,1
1,1105,34090,3575887310,3575887312,2
1,1105,34091,3575887310,3575887312,2
1,1105,34092,3575887310,3575887314,4
1,1105,34093,3575887310,3575887314,4
1,1105,34094,3575887310,3575887315,5
1,1105,34095,3575887310,3575887317,7
1,1105,34096,3575887310,3575887317,7
1,1105,34097,3575887310,3575887318,8
1,1105,34098,3575887310,3575887319,9
1,1105,34099,3575887310,3575887320,10
1,1105,34100,3575887310,3575887322,12
1,1105,34101,3575887310,3575887322,12
1,1105,34102,3575887310,3575887322,12
1,1105,34103,3575887310,3575887325,15
1,1105,34104,3575887310,3575887325,15
1,1105,34105,3575887310,3575887326,16
1,1105,34106,3575887310,3575887327,17
1,1105,34107,3575887310,3575887327,17
1,1105,34108,3575887310,3575887329,19
1,1105,34109,3575887310,3575887329,19
1,1105,34110,3575887310,3575887329,19
1,1105,34111,3575887310,3575887330,20
1,1105,34112,3575887310,3575887331,21
1,1105,34113,3575887310,3575887331,21
1,1105,34114,3575887310,3575887333,23
1,1105,34115,3575887310,3575887333,23
1,1105,34116,3575887310,3575887335,25
1,1105,34117,3575887310,3575887335,25
1,1105,34118,3575887310,3575887337,27
1,1105,34119,3575887310,3575887341,31
1,1105,34120,3575887310,3575887343,33
1,1105,34121,3575887310,3575887344,34
1,1105,34122,3575887310,3575887344,34
1,1105,34123,3575887310,3575887347,37
1,1105,34124,3575887310,3575887348,38
1,1105,34125,3575887310,3575887349,39
1,1105,34126,3575887310,3575887349,39
1,1105,34127,3575887310,3575887350,40
1,1105,34128,3575887310,3575887350,40
1,1105,34129,3575887310,3575887351,41
1,1105,34130,3575887310,3575887353,43
1,1105,34131,3575887310,3575887353,43
1,1105,34132,3575887310,3575887354,44
1,1105,34133,3575887310,3575887354,44
1,1105,34134,3575887310,3575887354,44
1,1105,34135,3575887310,3575887354,44
1,1105,34136,3575887310,3575887356,46
1,1105,34137,3575887310,3575887357,47
1,1105,34138,3575887310,3575887357,47
1,1105,34139,3575887310,3575887357,47
1,1105,34140,3575887310,3575887358,48
1,1105,34141,3575887310,3575887359,49
1,1106,34142,3575887374,3575887374,0
1,1106,34143,3575887374,3575887374,0
1,1106,34144,3575887374,3575887374,0
1,1106,34145,3575887374,3575887374,0
1,1106,34146,3575887374,3575887374,0
1,1106,34147,3575887374,3575887374,0
1,1106,34148,3575887374,3575887374,0
1,1106,34149,3575887374,3575887374,0
1,1106,34150,3575887374,3575887374,0
1,1106,34151,3575887374,3575887374,0
1,1106,34152,3575887374,3575887374,0
1,1106,34153,3575887374,3575887374,0
1,1106,34154,3575887374,3575887374,0
1,1106,34155,3575887374,3575887374,0
1,1106,34156,3575887374,3575887375,1
1,1106,34157,3575887374,3575887375,1
1,1106,34158,3575887374,3575887375,1
1,1106,34159,3575887374,3575887376,2
1,1106,34160,3575887374,3575887379,5
1,1106,34161,3575887374,3575887380,6
1,1106,34162,3575887374,3575887381,7
1,1106,34163,3575887374,3575887382,8
1,1106,34164,3575887374,3575887383,9
1,1106,34165,3575887374,3575887383,9
1,1106,34166,3575887374,3575887384,10
1,1106,34167,3575887374,3575887385,11
1,1106,34168,3575887374,3575887385,11
1,1106,34169,3575887374,3575887386,12
1,1106,34170,3575887374,3575887386,12
1,1106,34171,3575887374,3575887388,14
1,1106,34172,3575887374,3575887389,15
1,1106,34173,3575887374,3575887390,16
1,1106,34174,3575887374,3575887391,17
1,1106,34175,3575887374,3575887392,18
1,1106,34176,3575887374,3575887392,18
1,1106,34177,3575887374,3575887393,19
1,1106,34178,3575887374,3575887393,19
1,1106,34179,3575887374,3575887394,20
1,1106,34180,3575887374,3575887396,22
1,1106,34181,3575887374,3575887397,23
1,1106,34182,3575887374,3575887397,23
1,1106,34183,3575887374,3575887398,24
1,1106,34184,3575887374,3575887398,24
1,1106,34185,3575887374,3575887399,25
1,1106,34186,3575887374,3575887400,26
1,1106,34187,3575887374,3575887400,26
1,1106,34188,3575887374,3575887402,28
1,1106,34189,3575887374,3575887402,28
1,1106,34190,3575887374,3575887402,28
1,1106,34191,3575887374,3575887403,29
1,1106,34192,3575887374,3575887403,29
1,1106,34193,3575887374,3575887403,29
1,1106,34194,3575887374,3575887405,31
1,1106,34195,3575887374,3575887405,31
1,1106,34196,3575887374,3575887406,32
1,1106,34197,3575887374,3575887407,33
1,1106,34198,3575887374,3575887407,33
1,1106,34199,3575887374,3575887408,34
1,1106,34200,3575887374,3575887408,34
1,1106,34201,3575887374,3575887409,35
1,1106,34202,3575887374,3575887409,35
1,1106,34203,3575887374,3575887410,36
1,1106,34204,3575887374,3575887412,38
1,1106,34205,3575887374,3575887413,39
1,1106,34206,3575887374,3575887413,39
1,1106,34207,3575887374,3575887414,40
1,1106,34208,3575887374,3575887414,40
1,1106,34209,3575887374,3575887414,40
1,1106,34210,3575887374,3575887416,42
1,1106,34211,3575887374,3575887416,42
1,1106,34212,3575887374,3575887416,42
1,1106,34213,3575887374,3575887417,43
1,1106,34214,3575887374,3575887417,43
1,1106,34215,3575887374,3575887417,43
1,1106,34216,3575887374,3575887418,44
1,1106,34217,3575887374,3575887418,44
1,1106,34218,3575887374,3575887421,47
1,1106,34219,3575887374,3575887421,47
1,1106,34220,3575887374,3575887421,47
1,1106,34221,3575887374,3575887422,48
1,1106,34222,3575887374,3575887423,49
1,1106,34223,3575887374,3575887423,49
1,1106,34224,3575887374,3575887424,50
1,1107,34225,3575887437,3575887437,0
1,1107,34226,3575887437,3575887437,0
1,1107,34227,3575887437,3575887437,0
1,1107,34228,3575887437,3575887437,0
1,1107,34229,3575887437,3575887437,0
1,1107,34230,3575887437,3575887437,0
1,1107,34231,3575887437,3575887437,0
1,1107,34232,3575887437,3575887437,0
1,1107,34233,3575887437,3575887437,0
1,1107,34234,3575887437,3575887437,0
1,1107,34235,3575887437,3575887437,0
1,1107,34236,3575887437,3575887437,0
1,1107,34237,3575887437,3575887437,0
1,1107,34238,3575887437,3575887437,0
1,1107,34239,3575887437,3575887439,2
1,1107,34240,3575887437,3575887441,4
1,1107,34241,3575887437,3575887441,4
1,1107,34242,3575887437,3575887441,4
1,1107,34243,3575887437,3575887443,6
1,1107,34244,3575887437,3575887443,6
1,1107,34245,3575887437,3575887444,7
1,1107,34246,3575887437,3575887444,7
1,1107,34247,3575887437,3575887446,9
1,1107,34248,3575887437,3575887446,9
1,1107,34249,3575887437,3575887446,9
1,1107,34250,3575887437,3575887448,11
1,1107,34251,3575887437,3575887448,11
1,1107,34252,3575887437,3575887449,12
1,1107,34253,3575887437,3575887449,12
1,1107,34254,3575887437,3575887449,12
1,1107,34255,3575887437,3575887450,13
1,1107,34256,3575887437,3575887450,13
1,1107,34257,3575887437,3575887451,14
1,1107,34258,3575887437,3575887452,15
1,1107,34259,3575887437,3575887452,15
1,1107,34260,3575887437,3575887453,16
1,1107,34261,3575887437,3575887454,17
1,1107,34262,3575887437,3575887455,18
1,1107,34263,3575887437,3575887456,19
1,1107,34264,3575887437,3575887456,19
1,1107,34265,3575887437,3575887459,22
1,1107,34266,3575887437,3575887459,22
1,1107,34267,3575887437,3575887460,23
1,1107,34268,3575887437,3575887462,25
1,1107,34269,3575887437,3575887466,29
1,1107,34270,3575887437,3575887466,29
1,1107,34271,3575887437,3575887468,31
1,1107,34272,3575887437,3575887469,32
1,1107,34273,3575887437,3575887470,33
1,1107,34274,3575887437,3575887470,33
1,1107,34275,3575887437,3575887480,43
1,1107,34276,3575887437,3575887481,44
1,1107,34277,3575887437,3575887481,44
1,1107,34278,3575887437,3575887482,45
1,1107,34279,3575887437,3575887483,46
1,1107,34280,3575887437,3575887483,46
1,1107,34281,3575887437,3575887484,47
1,1107,34282,3575887437,3575887486,49
1,1107,34283,3575887437,3575887486,49
1,1107,34284,3575887437,3575887487,50
1,1108,34285,3575887503,3575887503,0
1,1108,34286,3575887503,3575887503,0
1,1108,34287,3575887503,3575887503,0
1,1108,34288,3575887503,3575887503,0
1,1108,34289,3575887503,3575887503,0
1,1108,34290,3575887503,3575887503,0
1,1108,34291,3575887503,3575887503,0
1,1108,34292,3575887503,3575887503,0
1,1108,34293,3575887503,3575887503,0
1,1108,34294,3575887503,3575887503,0
1,1108,34295,3575887503,3575887503,0
1,1108,34296,3575887503,3575887503,0
1,1108,34297,3575887503,3575887503,0
1,1108,34298,3575887503,3575887503,0
1,1108,34299,3575887503,3575887503,0
1,1108,34300,3575887503,3575887503,0
1,1108,34301,3575887503,3575887503,0
1,1108,34302,3575887503,3575887503,0
1,1108,34303,3575887503,3575887503,0
1,1108,34304,3575887503,3575887503,0
1,1108,34305,3575887503,3575887503,0
1,1108,34306,3575887503,3575887503,0
1,1108,34307,3575887503,3575887503,0
1,1108,34308,3575887503,3575887504,1
1,1108,34309,3575887503,3575887505,2
1,1108,34310,3575887503,3575887505,2
1,1108,34311,3575887503,3575887506,3
1,1108,34312,3575887503,3575887506,3
1,1108,34313,3575887503,3575887507,4
1,1108,34314,3575887503,3575887507,4
1,1108,34315,3575887503,3575887507,4
1,1108,34316,3575887503,3575887508,5
1,1108,34317,3575887503,3575887508,5
1,1108,34318,3575887503,3575887510,7
1,1108,34319,3575887503,3575887511,8
1,1108,34320,3575887503,3575887511,8
1,1108,34321,3575887503,3575887511,8
1,1108,34322,3575887503,3575887513,10
1,1108,34323,3575887503,3575887513,10
1,1108,34324,3575887503,3575887514,11
1,1108,34325,3575887503,3575887515,12
1,1108,34326,3575887503,3575887517,14
1,1108,34327,3575887503,3575887518,15
1,1108,34328,3575887503,3575887518,15
1,1108,34329,3575887503,3575887521,18
1,1108,34330,3575887503,3575887521,18
1,1108,34331,3575887503,3575887521,18
1,1108,34332,3575887503,3575887523,20
1,1108,34333,3575887503,3575887525,22
1,1108,34334,3575887503,3575887525,22
1,1108,34335,3575887503,3575887526,23
1,1108,34336,3575887503,3575887527,24
1,1108,34337,3575887503,3575887528,25
1,1108,34338,3575887503,3575887528,25
1,1108,34339,3575887503,3575887530,27
1,1108,34340,3575887503,3575887530,27
1,1108,34341,3575887503,3575887530,27
1,1108,34342,3575887503,3575887532,29
1,1108,34343,3575887503,3575887532,29
1,1108,34344,3575887503,3575887533,30
1,1108,34345,3575887503,3575887534,31
1,1108,34346,3575887503,3575887536,33
1,1108,34347,3575887503,3575887539,36
1,1108,34348,3575887503,3575887542,39
1,1108,34349,3575887503,3575887542,39
1,1108,34350,3575887503,3575887543,40
1,1108,34351,3575887503,3575887544,41
1,1108,34352,3575887503,3575887546,43
1,1108,34353,3575887503,3575887547,44
1,1108,34354,3575887503,3575887548,45
1,1108,34355,3575887503,3575887549,46
1,1108,34356,3575887503,3575887549,46
1,1108,34357,3575887503,3575887549,46
1,1108,34358,3575887503,3575887550,47
1,1108,34359,3575887503,3575887550,47
1,1108,34360,3575887503,3575887552,49
1,1108,34361,3575887503,3575887552,49
1,1108,34362,3575887503,3575887552,49
1,1108,34363,3575887503,3575887552,49
1,1108,34364,3575887503,3575887553,50
1,1109,34365,3575887566,3575887566,0
1,1109,34366,3575887566,3575887566,0
1,1109,34367,3575887566,3575887566,0
1,1109,34368,3575887566,3575887566,0
1,1109,34369,3575887566,3575887566,0
1,1109,34370,3575887566,3575887566,0
1,1109,34371,3575887566,3575887566,0
1,1109,34372,3575887566,3575887566,0
1,1109,34373,3575887566,3575887566,0
1,1109,34374,3575887566,3575887566,0
1,1109,34375,3575887566,3575887566,0
1,1109,34376,3575887566,3575887566,0
1,1109,34377,3575887566,3575887566,0
1,1109,34378,3575887566,3575887566,0
1,1109,34379,3575887566,3575887567,1
1,1109,34380,3575887566,3575887569,3
1,1109,34381,3575887566,3575887570,4
1,1109,34382,3575887566,3575887572,6
1,1109,34383,3575887566,3575887573,7
1,1109,34384,3575887566,3575887573,7
1,1109,34385,3575887566,3575887574,8
1,1109,34386,3575887566,3575887574,8
1,1109,34387,3575887566,3575887578,12
1,1109,34388,3575887566,3575887578,12
1,1109,34389,3575887566,3575887580,14
1,1109,34390,3575887566,3575887580,14
1,1109,34391,3575887566,3575887581,15
1,1109,34392,3575887566,3575887582,16
1,1109,34393,3575887566,3575887582,16
1,1109,34394,3575887566,3575887583,17
1,1109,34395,3575887566,3575887583,17
1,1109,34396,3575887566,3575887585,19
1,1109,34397,3575887566,3575887585,19
1,1109,34398,3575887566,3575887585,19
1,1109,34399,3575887566,3575887586,20
1,1109,34400,3575887566,3575887587,21
1,1109,34401,3575887566,3575887588,22
1,1109,34402,3575887566,3575887590,24
1,1109,34403,3575887566,3575887590,24
1,1109,34404,3575887566,3575887591,25
1,1109,34405,3575887566,3575887591,25
1,1109,34406,3575887566,3575887592,26
1,1109,34407,3575887566,3575887592,26
1,1109,34408,3575887566,3575887593,27
1,1109,34409,3575887566,3575887594,28
1,1109,34410,3575887566,3575887595,29
1,1109,34411,3575887566,3575887596,30
1,1109,34412,3575887566,3575887597,31
1,1109,34413,3575887566,3575887597,31
1,1109,34414,3575887566,3575887598,32
1,1109,34415,3575887566,3575887599,33
1,1109,34416,3575887566,3575887600,34
1,1109,34417,3575887566,3575887600,34
1,1109,34418,3575887566,3575887601,35
1,1109,34419,3575887566,3575887602,36
1,1109,34420,3575887566,3575887602,36
1,1109,34421,3575887566,3575887602,36
1,1109,34422,3575887566,3575887603,37
1,1109,34423,3575887566,3575887604,38
1,1109,34424,3575887566,3575887604,38
1,1109,34425,3575887566,3575887605,39
1,1109,34426,3575887566,3575887606,40
1,1109,34427,3575887566,3575887607,41
1,1109,34428,3575887566,3575887607,41
1,1109,34429,3575887566,3575887608,42
1,1109,34430,3575887566,3575887608,42
1,1109,34431,3575887566,3575887609,43
1,1109,34432,3575887566,3575887610,44
1,1109,34433,3575887566,3575887612,46
1,1109,34434,3575887566,3575887612,46
1,1109,34435,3575887566,3575887613,47
1,1109,34436,3575887566,3575887613,47
1,1109,34437,3575887566,3575887614,48
1,1109,34438,3575887566,3575887615,49
1,1109,34439,3575887566,3575887615,49
1,1109,34440,3575887566,3575887615,49
1,1109,34441,3575887566,3575887616,50
1,1110,34442,3575887631,3575887631,0
1,1110,34443,3575887631,3575887631,0
1,1110,34444,3575887631,3575887631,0
1,1110,34445,3575887631,3575887631,0
1,1110,34446,3575887631,3575887631,0
1,1110,34447,3575887631,3575887631,0
1,1110,34448,3575887631,3575887631,0
1,1110,34449,3575887631,3575887631,0
1,1110,34450,3575887631,3575887631,0
1,1110,34451,3575887631,3575887631,0
1,1110,34452,3575887631,3575887631,0
1,1110,34453,3575887631,3575887631,0
1,1110,34454,3575887631,3575887631,0
1,1110,34455,3575887631,3575887631,0
1,1110,34456,3575887631,3575887631,0
1,1110,34457,3575887631,3575887631,0
1,1110,34458,3575887631,3575887631,0
1,1110,34459,3575887631,3575887631,0
1,1110,34460,3575887631,3575887631,0
1,1110,34461,3575887631,3575887631,0
1,1110,34462,3575887631,3575887631,0
1,1110,34463,3575887631,3575887631,0
1,1110,34464,3575887631,3575887631,0
1,1110,34465,3575887631,3575887631,0
1,1110,34466,3575887631,3575887633,2
1,1110,34467,3575887631,3575887634,3
1,1110,34468,3575887631,3575887634,3
1,1110,34469,3575887631,3575887635,4
1,1110,34470,3575887631,3575887636,5
1,1110,34471,3575887631,3575887639,8
1,1110,34472,3575887631,3575887639,8
1,1110,34473,3575887631,3575887639,8
1,1110,34474,3575887631,3575887641,10
1,1110,34475,3575887631,3575887642,11
1,1110,34476,3575887631,3575887643,12
1,1110,34477,3575887631,3575887644,13
1,1110,34478,3575887631,3575887644,13
1,1110,34479,3575887631,3575887644,13
1,1110,34480,3575887631,3575887645,14
1,1110,34481,3575887631,3575887645,14
1,1110,34482,3575887631,3575887646,15
1,1110,34483,3575887631,3575887646,15
1,1110,34484,3575887631,3575887647,16
1,1110,34485,3575887631,3575887648,17
1,1110,34486,3575887631,3575887648,17
1,1110,34487,3575887631,3575887648,17
1,1110,34488,3575887631,3575887648,17
1,1110,34489,3575887631,3575887649,18
1,1110,34490,3575887631,3575887652,21
1,1110,34491,3575887631,3575887653,22
1,1110,34492,3575887631,3575887654,23
1,1110,34493,3575887631,3575887655,24
1,1110,34494,3575887631,3575887655,24
1,1110,34495,3575887631,3575887656,25
1,1110,34496,3575887631,3575887656,25
1,1110,34497,3575887631,3575887657,26
1,1110,34498,3575887631,3575887658,27
1,1110,34499,3575887631,3575887658,27
1,1110,34500,3575887631,3575887659,28
1,1110,34501,3575887631,3575887663,32
1,1110,34502,3575887631,3575887666,35
1,1110,34503,3575887631,3575887666,35
1,1110,34504,3575887631,3575887667,36
1,1110,34505,3575887631,3575887668,37
1,1110,34506,3575887631,3575887668,37
1,1110,34507,3575887631,3575887668,37
1,1110,34508,3575887631,3575887670,39
1,1110,34509,3575887631,3575887679,48
1,1110,34510,3575887631,3575887680,49
1,1110,34511,3575887631,3575887681,50
1,1111,34512,3575887696,3575887696,0
1,1111,34513,3575887696,3575887696,0
1,1111,34514,3575887696,3575887696,0
1,1111,34515,3575887696,3575887696,0
1,1111,34516,3575887696,3575887696,0
1,1111,34517,3575887696,3575887696,0
1,1111,34518,3575887696,3575887696,0
1,1111,34519,3575887696,3575887696,0
1,1111,34520,3575887696,3575887696,0
1,1111,34521,3575887696,3575887696,0
1,1111,34522,3575887696,3575887696,0
1,1111,34523,3575887696,3575887696,0
1,1111,34524,3575887696,3575887696,0
1,1111,34525,3575887696,3575887696,0
1,1111,34526,3575887696,3575887696,0
1,1111,34527,3575887696,3575887696,0
1,1111,34528,3575887696,3575887696,0
1,1111,34529,3575887696,3575887697,1
1,1111,34530,3575887696,3575887697,1
1,1111,34531,3575887696,3575887698,2
1,1111,34532,3575887696,3575887698,2
1,1111,34533,3575887696,3575887698,2
1,1111,34534,3575887696,3575887699,3
1,1111,34535,3575887696,3575887699,3
1,1111,34536,3575887696,3575887700,4
1,1111,34537,3575887696,3575887700,4
1,1111,34538,3575887696,3575887701,5
1,1111,34539,3575887696,3575887701,5
1,1111,34540,3575887696,3575887702,6
1,1111,34541,3575887696,3575887703,7
1,1111,34542,3575887696,3575887703,7
1,1111,34543,3575887696,3575887704,8
1,1111,34544,3575887696,3575887705,9
1,1111,34545,3575887696,3575887705,9
1,1111,34546,3575887696,3575887706,10
1,1111,34547,3575887696,3575887706,10
1,1111,34548,3575887696,3575887706,10
1,1111,34549,3575887696,3575887708,12
1,1111,34550,3575887696,3575887708,12
1,1111,34551,3575887696,3575887708,12
1,1111,34552,3575887696,3575887711,15
1,1111,34553,3575887696,3575887711,15
1,1111,34554,3575887696,3575887712,16
1,1111,34555,3575887696,3575887712,16
1,1111,34556,3575887696,3575887713,17
1,1111,34557,3575887696,3575887713,17
1,1111,34558,3575887696,3575887713,17
1,1111,34559,3575887696,3575887716,20
1,1111,34560,3575887696,3575887716,20
1,1111,34561,3575887696,3575887716,20
1,1111,34562,3575887696,3575887718,22
1,1111,34563,3575887696,3575887719,23
1,1111,34564,3575887696,3575887721,25
1,1111,34565,3575887696,3575887721,25
1,1111,34566,3575887696,3575887722,26
1,1111,34567,3575887696,3575887723,27
1,1111,34568,3575887696,3575887725,29
1,1111,34569,3575887696,3575887725,29
1,1111,34570,3575887696,3575887726,30
1,1111,34571,3575887696,3575887727,31
1,1111,34572,3575887696,3575887728,32
1,1111,34573,3575887696,3575887728,32
1,1111,34574,3575887696,3575887729,33
1,1111,34575,3575887696,3575887730,34
1,1111,34576,3575887696,3575887730,34
1,1111,34577,3575887696,3575887731,35
1,1111,34578,3575887696,3575887732,36
1,1111,34579,3575887696,3575887732,36
1,1111,34580,3575887696,3575887733,37
1,1111,34581,3575887696,3575887734,38
1,1111,34582,3575887696,3575887735,39
1,1111,34583,3575887696,3575887736,40
1,1111,34584,3575887696,3575887740,44
1,1111,34585,3575887696,3575887743,47
1,1111,34586,3575887696,3575887743,47
1,1111,34587,3575887696,3575887744,48
1,1111,34588,3575887696,3575887744,48
1,1112,34589,3575887760,3575887760,0
1,1112,34590,3575887760,3575887760,0
1,1112,34591,3575887760,3575887760,0
1,1112,34592,3575887760,3575887760,0
1,1112,34593,3575887760,3575887760,0
1,1112,34594,3575887760,3575887760,0
1,1112,34595,3575887760,3575887761,1
1,1112,34596,3575887760,3575887761,1
1,1112,34597,3575887760,3575887761,1
1,1112,34598,3575887760,3575887761,1
1,1112,34599,3575887760,3575887761,1
1,1112,34600,3575887760,3575887761,1
1,1112,34601,3575887760,3575887761,1
1,1112,34602,3575887760,3575887761,1
1,1112,34603,3575887760,3575887761,1
1,1112,34604,3575887760,3575887761,1
1,1112,34605,3575887760,3575887761,1
1,1112,34606,3575887760,3575887761,1
1,1112,34607,3575887760,3575887761,1
1,1112,34608,3575887760,3575887761,1
1,1112,34609,3575887760,3575887761,1
1,1112,34610,3575887760,3575887761,1
1,1112,34611,3575887760,3575887762,2
1,1112,34612,3575887760,3575887762,2
1,1112,34613,3575887760,3575887762,2
1,1112,34614,3575887760,3575887763,3
1,1112,34615,3575887760,3575887763,3
1,1112,34616,3575887760,3575887763,3
1,1112,34617,3575887760,3575887765,5
1,1112,34618,3575887760,3575887766,6
1,1112,34619,3575887760,3575887767,7
1,1112,34620,3575887760,3575887770,10
1,1112,34621,3575887760,3575887771,11
1,1112,34622,3575887760,3575887772,12
1,1112,34623,3575887760,3575887772,12
1,1112,34624,3575887760,3575887773,13
1,1112,34625,3575887760,3575887773,13
1,1112,34626,3575887760,3575887774,14
1,1112,34627,3575887760,3575887774,14
1,1112,34628,3575887760,3575887778,18
1,1112,34629,3575887760,3575887780,20
1,1112,34630,3575887760,3575887780,20
1,1112,34631,3575887760,3575887781,21
1,1112,34632,3575887760,3575887783,23
1,1112,34633,3575887760,3575887783,23
1,1112,34634,3575887760,3575887784,24
1,1112,34635,3575887760,3575887784,24
1,1112,34636,3575887760,3575887785,25
1,1112,34637,3575887760,3575887785,25
1,1112,34638,3575887760,3575887786,26
1,1112,34639,3575887760,3575887787,27
1,1112,34640,3575887760,3575887788,28
1,1112,34641,3575887760,3575887790,30
1,1112,34642,3575887760,3575887790,30
1,1112,34643,3575887760,3575887791,31
1,1112,34644,3575887760,3575887792,32
1,1112,34645,3575887760,3575887792,32
1,1112,34646,3575887760,3575887792,32
1,1112,34647,3575887760,3575887794,34
1,1112,34648,3575887760,3575887795,35
1,1112,34649,3575887760,3575887797,37
1,1112,34650,3575887760,3575887797,37
1,1112,34651,3575887760,3575887798,38
1,1112,34652,3575887760,3575887798,38
1,1112,34653,3575887760,3575887798,38
1,1112,34654,3575887760,3575887800,40
1,1112,34655,3575887760,3575887800,40
1,1112,34656,3575887760,3575887801,41
1,1112,34657,3575887760,3575887802,42
1,1112,34658,3575887760,3575887803,43
1,1112,34659,3575887760,3575887803,43
1,1112,34660,3575887760,3575887804,44
1,1112,34661,3575887760,3575887804,44
1,1112,34662,3575887760,3575887805,45
1,1112,34663,3575887760,3575887806,46
1,1112,34664,3575887760,3575887807,47
1,1112,34665,3575887760,3575887808,48
1,1112,34666,3575887760,3575887808,48
1,1112,34667,3575887760,3575887809,49
1,1113,34668,3575887825,3575887825,0
1,1113,34669,3575887825,3575887825,0
1,1113,34670,3575887825,3575887825,0
1,1113,34671,3575887825,3575887825,0
1,1113,34672,3575887825,3575887825,0
1,1113,34673,3575887825,3575887825,0
1,1113,34674,3575887825,3575887825,0
1,1113,34675,3575887825,3575887825,0
1,1113,34676,3575887825,3575887825,0
1,1113,34677,3575887825,3575887825,0
1,1113,34678,3575887825,3575887825,0
1,1113,34679,3575887825,3575887825,0
1,1113,34680,3575887825,3575887825,0
1,1113,34681,3575887825,3575887825,0
1,1113,34682,3575887825,3575887825,0
1,1113,34683,3575887825,3575887825,0
1,1113,34684,3575887825,3575887825,0
1,1113,34685,3575887825,3575887825,0
1,1113,34686,3575887825,3575887825,0
1,1113,34687,3575887825,3575887825,0
1,1113,34688,3575887825,3575887825,0
1,1113,34689,3575887825,3575887825,0
1,1113,34690,3575887825,3575887825,0
1,1113,34691,3575887825,3575887825,0
1,1113,34692,3575887825,3575887825,0
1,1113,34693,3575887825,3575887825,0
1,1113,34694,3575887825,3575887825,0
1,1113,34695,3575887825,3575887825,0
1,1113,34696,3575887825,3575887828,3
1,1113,34697,3575887825,3575887828,3
1,1113,34698,3575887825,3575887828,3
1,1113,34699,3575887825,3575887828,3
1,1113,34700,3575887825,3575887828,3
1,1113,34701,3575887825,3575887830,5
1,1113,34702,3575887825,3575887831,6
1,1113,34703,3575887825,3575887832,7
1,1113,34704,3575887825,3575887833,8
1,1113,34705,3575887825,3575887834,9
1,1113,34706,3575887825,3575887834,9
1,1113,34707,3575887825,3575887835,10
1,1113,34708,3575887825,3575887836,11
1,1113,34709,3575887825,3575887838,13
1,1113,34710,3575887825,3575887840,15
1,1113,34711,3575887825,3575887840,15
1,1113,34712,3575887825,3575887841,16
1,1113,34713,3575887825,3575887842,17
1,1113,34714,3575887825,3575887843,18
1,1113,34715,3575887825,3575887844,19
1,1113,34716,3575887825,3575887844,19
1,1113,34717,3575887825,3575887845,20
1,1113,34718,3575887825,3575887845,20
1,1113,34719,3575887825,3575887846,21
1,1113,34720,3575887825,3575887847,22
1,1113,34721,3575887825,3575887848,23
1,1113,34722,3575887825,3575887848,23
1,1113,34723,3575887825,3575887848,23
1,1113,34724,3575887825,3575887848,23
1,1113,34725,3575887825,3575887849,24
1,1113,34726,3575887825,3575887851,26
1,1113,34727,3575887825,3575887853,28
1,1113,34728,3575887825,3575887853,28
1,1113,34729,3575887825,3575887853,28
1,1113,34730,3575887825,3575887854,29
1,1113,34731,3575887825,3575887854,29
1,1113,34732,3575887825,3575887855,30
1,1113,34733,3575887825,3575887855,30
1,1113,34734,3575887825,3575887856,31
1,1113,34735,3575887825,3575887857,32
1,1113,34736,3575887825,3575887858,33
1,1113,34737,3575887825,3575887858,33
1,1113,34738,3575887825,3575887859,34
1,1113,34739,3575887825,3575887863,38
1,1113,34740,3575887825,3575887865,40
1,1113,34741,3575887825,3575887866,41
1,1113,34742,3575887825,3575887867,42
1,1113,34743,3575887825,3575887868,43
1,1113,34744,3575887825,3575887868,43
1,1113,34745,3575887825,3575887870,45
1,1113,34746,3575887825,3575887870,45
1,1114,34747,3575887888,3575887888,0
1,1114,34748,3575887888,3575887888,0
1,1114,34749,3575887888,3575887888,0
1,1114,34750,3575887888,3575887888,0
1,1114,34751,3575887888,3575887888,0
1,1114,34752,3575887888,3575887888,0
1,1114,34753,3575887888,3575887888,0
1,1114,34754,3575887888,3575887888,0
1,1114,34755,3575887888,3575887888,0
1,1114,34756,3575887888,3575887888,0
1,1114,34757,3575887888,3575887888,0
1,1114,34758,3575887888,3575887888,0
1,1114,34759,3575887888,3575887888,0
1,1114,34760,3575887888,3575887889,1
1,1114,34761,3575887888,3575887891,3
1,1114,34762,3575887888,3575887891,3
1,1114,34763,3575887888,3575887891,3
1,1114,34764,3575887888,3575887893,5
1,1114,34765,3575887888,3575887893,5
1,1114,34766,3575887888,3575887894,6
1,1114,34767,3575887888,3575887894,6
1,1114,34768,3575887888,3575887897,9
1,1114,34769,3575887888,3575887897,9
1,1114,34770,3575887888,3575887898,10
1,1114,34771,3575887888,3575887898,10
1,1114,34772,3575887888,3575887898,10
1,1114,34773,3575887888,3575887899,11
1,1114,34774,3575887888,3575887899,11
1,1114,34775,3575887888,3575887900,12
1,1114,34776,3575887888,3575887901,13
1,1114,34777,3575887888,3575887901,13
1,1114,34778,3575887888,3575887902,14
1,1114,34779,3575887888,3575887902,14
1,1114,34780,3575887888,3575887903,15
1,1114,34781,3575887888,3575887905,17
1,1114,34782,3575887888,3575887905,17
1,1114,34783,3575887888,3575887906,18
1,1114,34784,3575887888,3575887907,19
1,1114,34785,3575887888,3575887907,19
1,1114,34786,3575887888,3575887907,19
1,1114,34787,3575887888,3575887907,19
1,1114,34788,3575887888,3575887907,19
1,1114,34789,3575887888,3575887908,20
1,1114,34790,3575887888,3575887911,23
1,1114,34791,3575887888,3575887911,23
1,1114,34792,3575887888,3575887912,24
1,1114,34793,3575887888,3575887914,26
1,1114,34794,3575887888,3575887914,26
1,1114,34795,3575887888,3575887915,27
1,1114,34796,3575887888,3575887916,28
1,1114,34797,3575887888,3575887916,28
1,1114,34798,3575887888,3575887917,29
1,1114,34799,3575887888,3575887919,31
1,1114,34800,3575887888,3575887919,31
1,1114,34801,3575887888,3575887921,33
1,1114,34802,3575887888,3575887921,33
1,1114,34803,3575887888,3575887922,34
1,1114,34804,3575887888,3575887924,36
1,1114,34805,3575887888,3575887925,37
1,1114,34806,3575887888,3575887926,38
1,1114,34807,3575887888,3575887927,39
1,1114,34808,3575887888,3575887927,39
1,1114,34809,3575887888,3575887928,40
1,1114,34810,3575887888,3575887928,40
1,1114,34811,3575887888,3575887929,41
1,1114,34812,3575887888,3575887929,41
1,1114,34813,3575887888,3575887931,43
1,1114,34814,3575887888,3575887931,43
1,1114,34815,3575887888,3575887932,44
1,1114,34816,3575887888,3575887932,44
1,1114,34817,3575887888,3575887933,45
1,1114,34818,3575887888,3575887933,45
1,1114,34819,3575887888,3575887935,47
1,1114,34820,3575887888,3575887936,48
1,1115,34821,3575887952,3575887952,0
1,1115,34822,3575887952,3575887952,0
1,1115,34823,3575887952,3575887952,0
1,1115,34824,3575887952,3575887952,0
1,1115,34825,3575887952,3575887952,0
1,1115,34826,3575887952,3575887952,0
1,1115,34827,3575887952,3575887952,0
1,1115,34828,3575887952,3575887952,0
1,1115,34829,3575887952,3575887952,0
1,1115,34830,3575887952,3575887952,0
1,1115,34831,3575887952,3575887952,0
1,1115,34832,3575887952,3575887952,0
1,1115,34833,3575887952,3575887952,0
1,1115,34834,3575887952,3575887952,0
1,1115,34835,3575887952,3575887952,0
1,1115,34836,3575887952,3575887952,0
1,1115,34837,3575887952,3575887952,0
1,1115,34838,3575887952,3575887954,2
1,1115,34839,3575887952,3575887954,2
1,1115,34840,3575887952,3575887954,2
1,1115,34841,3575887952,3575887955,3
1,1115,34842,3575887952,3575887956,4
1,1115,34843,3575887952,3575887956,4
1,1115,34844,3575887952,3575887957,5
1,1115,34845,3575887952,3575887957,5
1,1115,34846,3575887952,3575887959,7
1,1115,34847,3575887952,3575887962,10
1,1115,34848,3575887952,3575887962,10
1,1115,34849,3575887952,3575887962,10
1,1115,34850,3575887952,3575887963,11
1,1115,34851,3575887952,3575887963,11
1,1115,34852,3575887952,3575887963,11
1,1115,34853,3575887952,3575887963,11
1,1115,34854,3575887952,3575887965,13
1,1115,34855,3575887952,3575887966,14
1,1115,34856,3575887952,3575887968,16
1,1115,34857,3575887952,3575887970,18
1,1115,34858,3575887952,3575887970,18
1,1115,34859,3575887952,3575887972,20
1,1115,34860,3575887952,3575887973,21
1,1115,34861,3575887952,3575887973,21
1,1115,34862,3575887952,3575887973,21
1,1115,34863,3575887952,3575887974,22
1,1115,34864,3575887952,3575887978,26
1,1115,34865,3575887952,3575887978,26
1,1115,34866,3575887952,3575887979,27
1,1115,34867,3575887952,3575887981,29
1,1115,34868,3575887952,3575887981,29
1,1115,34869,3575887952,3575887982,30
1,1115,34870,3575887952,3575887983,31
1,1115,34871,3575887952,3575887984,32
1,1115,34872,3575887952,3575887984,32
1,1115,34873,3575887952,3575887985,33
1,1115,34874,3575887952,3575887985,33
1,1115,34875,3575887952,3575887986,34
1,1115,34876,3575887952,3575887987,35
1,1115,34877,3575887952,3575887988,36
1,1115,34878,3575887952,3575887990,38
1,1115,34879,3575887952,3575887990,38
1,1115,34880,3575887952,3575887992,40
1,1115,34881,3575887952,3575887992,40
1,1115,34882,3575887952,3575887993,41
1,1115,34883,3575887952,3575887993,41
1,1115,34884,3575887952,3575887996,44
1,1115,34885,3575887952,3575887996,44
1,1115,34886,3575887952,3575887997,45
1,1115,34887,3575887952,3575887997,45
1,1115,34888,3575887952,3575887998,46
1,1115,34889,3575887952,3575887999,47
1,1115,34890,3575887952,3575888000,48
1,1115,34891,3575887952,3575888001,49
1,1115,34892,3575887952,3575888001,49
1,1115,34893,3575887952,3575888002,50
1,1116,34894,3575888015,3575888015,0
1,1116,34895,3575888015,3575888015,0
1,1116,34896,3575888015,3575888015,0
1,1116,34897,3575888015,3575888015,0
1,1116,34898,3575888015,3575888015,0
1,1116,34899,3575888015,3575888015,0
1,1116,34900,3575888015,3575888015,0
1,1116,34901,3575888015,3575888015,0
1,1116,34902,3575888015,3575888015,0
1,1116,34903,3575888015,3575888015,0
1,1116,34904,3575888015,3575888015,0
1,1116,34905,3575888015,3575888015,0
1,1116,34906,3575888015,3575888015,0
1,1116,34907,3575888015,3575888015,0
1,1116,34908,3575888015,3575888015,0
1,1116,34909,3575888015,3575888015,0
1,1116,34910,3575888015,3575888015,0
1,1116,34911,3575888015,3575888015,0
1,1116,34912,3575888015,3575888015,0
1,1116,34913,3575888015,3575888015,0
1,1116,34914,3575888015,3575888015,0
1,1116,34915,3575888015,3575888015,0
1,1116,34916,3575888015,3575888016,1
1,1116,34917,3575888015,3575888016,1
1,1116,34918,3575888015,3575888016,1
1,1116,34919,3575888015,3575888017,2
1,1116,34920,3575888015,3575888017,2
1,1116,34921,3575888015,3575888017,2
1,1116,34922,3575888015,3575888019,4
1,1116,34923,3575888015,3575888019,4
1,1116,34924,3575888015,3575888020,5
1,1116,34925,3575888015,3575888020,5
1,1116,34926,3575888015,3575888020,5
1,1116,34927,3575888015,3575888022,7
1,1116,34928,3575888015,3575888023,8
1,1116,34929,3575888015,3575888023,8
1,1116,34930,3575888015,3575888024,9
1,1116,34931,3575888015,3575888024,9
1,1116,34932,3575888015,3575888024,9
1,1116,34933,3575888015,3575888025,10
1,1116,34934,3575888015,3575888026,11
1,1116,34935,3575888015,3575888028,13
1,1116,34936,3575888015,3575888028,13
1,1116,34937,3575888015,3575888028,13
1,1116,34938,3575888015,3575888029,14
1,1116,34939,3575888015,3575888030,15
1,1116,34940,3575888015,3575888030,15
1,1116,34941,3575888015,3575888030,15
1,1116,34942,3575888015,3575888031,16
1,1116,34943,3575888015,3575888033,18
1,1116,34944,3575888015,3575888033,18
1,1116,34945,3575888015,3575888034,19
1,1116,34946,3575888015,3575888034,19
1,1116,34947,3575888015,3575888037,22
1,1116,34948,3575888015,3575888039,24
1,1116,34949,3575888015,3575888040,25
1,1116,34950,3575888015,3575888040,25
1,1116,34951,3575888015,3575888041,26
1,1116,34952,3575888015,3575888042,27
1,1116,34953,3575888015,3575888043,28
1,1116,34954,3575888015,3575888043,28
1,1116,34955,3575888015,3575888044,29
1,1116,34956,3575888015,3575888044,29
1,1116,34957,3575888015,3575888044,29
1,1116,34958,3575888015,3575888044,29
1,1116,34959,3575888015,3575888045,30
1,1116,34960,3575888015,3575888046,31
1,1116,34961,3575888015,3575888047,32
1,1116,34962,3575888015,3575888048,33
1,1116,34963,3575888015,3575888048,33
1,1116,34964,3575888015,3575888048,33
1,1116,34965,3575888015,3575888048,33
1,1116,34966,3575888015,3575888048,33
1,1116,34967,3575888015,3575888049,34
1,1116,34968,3575888015,3575888051,36
1,1116,34969,3575888015,3575888052,37
1,1116,34970,3575888015,3575888053,38
1,1116,34971,3575888015,3575888054,39
1,1116,34972,3575888015,3575888054,39
1,1116,34973,3575888015,3575888055,40
1,1116,34974,3575888015,3575888056,41
1,1116,34975,3575888015,3575888058,43
1,1116,34976,3575888015,3575888058,43
1,1116,34977,3575888015,3575888059,44
1,1116,34978,3575888015,3575888059,44
1,1116,34979,3575888015,3575888063,48
1,1117,34980,3575888081,3575888081,0
1,1117,34981,3575888081,3575888081,0
1,1117,34982,3575888081,3575888081,0
1,1117,34983,3575888081,3575888081,0
1,1117,34984,3575888081,3575888081,0
1,1117,34985,3575888081,3575888081,0
1,1117,34986,3575888081,3575888081,0
1,1117,34987,3575888081,3575888082,1
1,1117,34988,3575888081,3575888082,1
1,1117,34989,3575888081,3575888083,2
1,1117,34990,3575888081,3575888083,2
1,1117,34991,3575888081,3575888084,3
1,1117,34992,3575888081,3575888084,3
1,1117,34993,3575888081,3575888084,3
1,1117,34994,3575888081,3575888086,5
1,1117,34995,3575888081,3575888086,5
1,1117,34996,3575888081,3575888087,6
1,1117,34997,3575888081,3575888088,7
1,1117,34998,3575888081,3575888089,8
1,1117,34999,3575888081,3575888090,9
1,1117,35000,3575888081,3575888091,10
1,1117,35001,3575888081,3575888092,11
1,1117,35002,3575888081,3575888093,12
1,1117,35003,3575888081,3575888093,12
1,1117,35004,3575888081,3575888094,13
1,1117,35005,3575888081,3575888094,13
1,1117,35006,3575888081,3575888097,16
1,1117,35007,3575888081,3575888097,16
1,1117,35008,3575888081,3575888098,17
1,1117,35009,3575888081,3575888098,17
1,1117,35010,3575888081,3575888098,17
1,1117,35011,3575888081,3575888099,18
1,1117,35012,3575888081,3575888100,19
1,1117,35013,3575888081,3575888100,19
1,1117,35014,3575888081,3575888100,19
1,1117,35015,3575888081,3575888102,21
1,1117,35016,3575888081,3575888102,21
1,1117,35017,3575888081,3575888102,21
1,1117,35018,3575888081,3575888103,22
1,1117,35019,3575888081,3575888105,24
1,1117,35020,3575888081,3575888106,25
1,1117,35021,3575888081,3575888106,25
1,1117,35022,3575888081,3575888106,25
1,1117,35023,3575888081,3575888107,26
1,1117,35024,3575888081,3575888107,26
1,1117,35025,3575888081,3575888108,27
1,1117,35026,3575888081,3575888109,28
1,1117,35027,3575888081,3575888111,30
1,1117,35028,3575888081,3575888111,30
1,1117,35029,3575888081,3575888111,30
1,1117,35030,3575888081,3575888114,33
1,1117,35031,3575888081,3575888115,34
1,1117,35032,3575888081,3575888115,34
1,1117,35033,3575888081,3575888115,34
1,1117,35034,3575888081,3575888116,35
1,1117,35035,3575888081,3575888117,36
1,1117,35036,3575888081,3575888119,38
1,1117,35037,3575888081,3575888119,38
1,1117,35038,3575888081,3575888121,40
1,1117,35039,3575888081,3575888121,40
1,1117,35040,3575888081,3575888123,42
1,1117,35041,3575888081,3575888124,43
1,1117,35042,3575888081,3575888125,44
1,1117,35043,3575888081,3575888126,45
1,1117,35044,3575888081,3575888126,45
1,1117,35045,3575888081,3575888127,46
1,1117,35046,3575888081,3575888128,47
1,1117,35047,3575888081,3575888129,48
1,1117,35048,3575888081,3575888129,48
1,1117,35049,3575888081,3575888130,49
1,1117,35050,3575888081,3575888130,49
1,1117,35051,3575888081,3575888131,50
1,1118,35052,3575888143,3575888143,0
1,1118,35053,3575888143,3575888143,0
1,1118,35054,3575888143,3575888143,0
1,1118,35055,3575888143,3575888143,0
1,1118,35056,3575888143,3575888143,0
1,1118,35057,3575888143,3575888143,0
1,1118,35058,3575888143,3575888143,0
1,1118,35059,3575888143,3575888143,0
1,1118,35060,3575888143,3575888143,0
1,1118,35061,3575888143,3575888144,1
1,1118,35062,3575888143,3575888144,1
1,1118,35063,3575888143,3575888144,1
1,1118,35064,3575888143,3575888145,2
1,1118,35065,3575888143,3575888147,4
1,1118,35066,3575888143,3575888148,5
1,1118,35067,3575888143,3575888149,6
1,1118,35068,3575888143,3575888149,6
1,1118,35069,3575888143,3575888150,7
1,1118,35070,3575888143,3575888150,7
1,1118,35071,3575888143,3575888152,9
1,1118,35072,3575888143,3575888153,10
1,1118,35073,3575888143,3575888153,10
1,1118,35074,3575888143,3575888154,11
1,1118,35075,3575888143,3575888154,11
1,1118,35076,3575888143,3575888155,12
1,1118,35077,3575888143,3575888155,12
1,1118,35078,3575888143,3575888157,14
1,1118,35079,3575888143,3575888158,15
1,1118,35080,3575888143,3575888160,17
1,1118,35081,3575888143,3575888161,18
1,1118,35082,3575888143,3575888161,18
1,1118,35083,3575888143,3575888162,19
1,1118,35084,3575888143,3575888163,20
1,1118,35085,3575888143,3575888163,20
1,1118,35086,3575888143,3575888164,21
1,1118,35087,3575888143,3575888165,22
1,1118,35088,3575888143,3575888166,23
1,1118,35089,3575888143,3575888168,25
1,1118,35090,3575888143,3575888170,27
1,1118,35091,3575888143,3575888171,28
1,1118,35092,3575888143,3575888173,30
1,1118,35093,3575888143,3575888174,31
1,1118,35094,3575888143,3575888174,31
1,1118,35095,3575888143,3575888174,31
1,1118,35096,3575888143,3575888178,35
1,1118,35097,3575888143,3575888179,36
1,1118,35098,3575888143,3575888181,38
1,1118,35099,3575888143,3575888182,39
1,1118,35100,3575888143,3575888182,39
1,1118,35101,3575888143,3575888184,41
1,1118,35102,3575888143,3575888185,42
1,1118,35103,3575888143,3575888185,42
1,1118,35104,3575888143,3575888185,42
1,1118,35105,3575888143,3575888186,43
1,1118,35106,3575888143,3575888187,44
1,1118,35107,3575888143,3575888188,45
1,1118,35108,3575888143,3575888189,46
1,1118,35109,3575888143,3575888191,48
1,1118,35110,3575888143,3575888192,49
1,1118,35111,3575888143,3575888192,49
1,1118,35112,3575888143,3575888192,49
1,1118,35113,3575888143,3575888193,50
1,1118,35114,3575888143,3575888193,50
1,1119,35115,3575888207,3575888207,0
1,1119,35116,3575888207,3575888207,0
1,1119,35117,3575888207,3575888207,0
1,1119,35118,3575888207,3575888207,0
1,1119,35119,3575888207,3575888207,0
1,1119,35120,3575888207,3575888207,0
1,1119,35121,3575888207,3575888207,0
1,1119,35122,3575888207,3575888207,0
1,1119,35123,3575888207,3575888207,0
1,1119,35124,3575888207,3575888207,0
1,1119,35125,3575888207,3575888207,0
1,1119,35126,3575888207,3575888207,0
1,1119,35127,3575888207,3575888207,0
1,1119,35128,3575888207,3575888207,0
1,1119,35129,3575888207,3575888207,0
1,1119,35130,3575888207,3575888207,0
1,1119,35131,3575888207,3575888207,0
1,1119,35132,3575888207,3575888207,0
1,1119,35133,3575888207,3575888207,0
1,1119,35134,3575888207,3575888207,0
1,1119,35135,3575888207,3575888207,0
1,1119,35136,3575888207,3575888208,1
1,1119,35137,3575888207,3575888209,2
1,1119,35138,3575888207,3575888210,3
1,1119,35139,3575888207,3575888210,3
1,1119,35140,3575888207,3575888211,4
1,1119,35141,3575888207,3575888212,5
1,1119,35142,3575888207,3575888213,6
1,1119,35143,3575888207,3575888213,6
1,1119,35144,3575888207,3575888213,6
1,1119,35145,3575888207,3575888214,7
1,1119,35146,3575888207,3575888214,7
1,1119,35147,3575888207,3575888215,8
1,1119,35148,3575888207,3575888216,9
1,1119,35149,3575888207,3575888216,9
1,1119,35150,3575888207,3575888217,10
1,1119,35151,3575888207,3575888217,10
1,1119,35152,3575888207,3575888218,11
1,1119,35153,3575888207,3575888218,11
1,1119,35154,3575888207,3575888218,11
1,1119,35155,3575888207,3575888219,12
1,1119,35156,3575888207,3575888219,12
1,1119,35157,3575888207,3575888221,14
1,1119,35158,3575888207,3575888221,14
1,1119,35159,3575888207,3575888222,15
1,1119,35160,3575888207,3575888223,16
1,1119,35161,3575888207,3575888224,17
1,1119,35162,3575888207,3575888224,17
1,1119,35163,3575888207,3575888225,18
1,1119,35164,3575888207,3575888227,20
1,1119,35165,3575888207,3575888227,20
1,1119,35166,3575888207,3575888228,21
1,1119,35167,3575888207,3575888229,22
1,1119,35168,3575888207,3575888229,22
1,1119,35169,3575888207,3575888230,23
1,1119,35170,3575888207,3575888231,24
1,1119,35171,3575888207,3575888233,26
1,1119,35172,3575888207,3575888233,26
1,1119,35173,3575888207,3575888234,27
1,1119,35174,3575888207,3575888234,27
1,1119,35175,3575888207,3575888235,28
1,1119,35176,3575888207,3575888235,28
1,1119,35177,3575888207,3575888237,30
1,1119,35178,3575888207,3575888239,32
1,1119,35179,3575888207,3575888240,33
1,1119,35180,3575888207,3575888241,34
1,1119,35181,3575888207,3575888241,34
1,1119,35182,3575888207,3575888242,35
1,1119,35183,3575888207,3575888243,36
1,1119,35184,3575888207,3575888244,37
1,1119,35185,3575888207,3575888244,37
1,1119,35186,3575888207,3575888245,38
1,1119,35187,3575888207,3575888245,38
1,1119,35188,3575888207,3575888245,38
1,1119,35189,3575888207,3575888245,38
1,1119,35190,3575888207,3575888246,39
1,1119,35191,3575888207,3575888247,40
1,1119,35192,3575888207,3575888248,41
1,1119,35193,3575888207,3575888248,41
1,1119,35194,3575888207,3575888248,41
1,1119,35195,3575888207,3575888248,41
1,1119,35196,3575888207,3575888248,41
1,1119,35197,3575888207,3575888250,43
1,1119,35198,3575888207,3575888250,43
1,1119,35199,3575888207,3575888250,43
1,1119,35200,3575888207,3575888253,46
1,1119,35201,3575888207,3575888253,46
1,1119,35202,3575888207,3575888253,46
1,1119,35203,3575888207,3575888254,47
1,1119,35204,3575888207,3575888255,48
1,1119,35205,3575888207,3575888256,49
1,1120,35206,3575888270,3575888270,0
1,1120,35207,3575888270,3575888270,0
1,1120,35208,3575888270,3575888270,0
1,1120,35209,3575888270,3575888270,0
1,1120,35210,3575888270,3575888270,0
1,1120,35211,3575888270,3575888270,0
1,1120,35212,3575888270,3575888270,0
1,1120,35213,3575888270,3575888270,0
1,1120,35214,3575888270,3575888270,0
1,1120,35215,3575888270,3575888271,1
1,1120,35216,3575888270,3575888271,1
1,1120,35217,3575888270,3575888280,10
1,1120,35218,3575888270,3575888282,12
1,1120,35219,3575888270,3575888282,12
1,1120,35220,3575888270,3575888283,13
1,1120,35221,3575888270,3575888283,13
1,1120,35222,3575888270,3575888284,14
1,1120,35223,3575888270,3575888284,14
1,1120,35224,3575888270,3575888284,14
1,1120,35225,3575888270,3575888286,16
1,1120,35226,3575888270,3575888287,17
1,1120,35227,3575888270,3575888287,17
1,1120,35228,3575888270,3575888288,18
1,1120,35229,3575888270,3575888289,19
1,1120,35230,3575888270,3575888289,19
1,1120,35231,3575888270,3575888289,19
1,1120,35232,3575888270,3575888291,21
1,1120,35233,3575888270,3575888291,21
1,1120,35234,3575888270,3575888292,22
1,1120,35235,3575888270,3575888292,22
1,1120,35236,3575888270,3575888293,23
1,1120,35237,3575888270,3575888294,24
1,1120,35238,3575888270,3575888294,24
1,1120,35239,3575888270,3575888294,24
1,1120,35240,3575888270,3575888297,27
1,1120,35241,3575888270,3575888297,27
1,1120,35242,3575888270,3575888298,28
1,1120,35243,3575888270,3575888298,28
1,1120,35244,3575888270,3575888298,28
1,1120,35245,3575888270,3575888299,29
1,1120,35246,3575888270,3575888300,30
1,1120,35247,3575888270,3575888301,31
1,1120,35248,3575888270,3575888301,31
1,1120,35249,3575888270,3575888301,31
1,1120,35250,3575888270,3575888302,32
1,1120,35251,3575888270,3575888302,32
1,1120,35252,3575888270,3575888302,32
1,1120,35253,3575888270,3575888303,33
1,1120,35254,3575888270,3575888305,35
1,1120,35255,3575888270,3575888305,35
1,1120,35256,3575888270,3575888306,36
1,1120,35257,3575888270,3575888307,37
1,1120,35258,3575888270,3575888307,37
1,1120,35259,3575888270,3575888307,37
1,1120,35260,3575888270,3575888307,37
1,1120,35261,3575888270,3575888308,38
1,1120,35262,3575888270,3575888308,38
1,1120,35263,3575888270,3575888311,41
1,1120,35264,3575888270,3575888311,41
1,1120,35265,3575888270,3575888315,45
1,1120,35266,3575888270,3575888315,45
1,1120,35267,3575888270,3575888315,45
1,1120,35268,3575888270,3575888315,45
1,1120,35269,3575888270,3575888316,46
1,1120,35270,3575888270,3575888317,47
1,1120,35271,3575888270,3575888318,48
1,1120,35272,3575888270,3575888319,49
1,1121,35273,3575888333,3575888333,0
1,1121,35274,3575888333,3575888333,0
1,1121,35275,3575888333,3575888333,0
1,1121,35276,3575888333,3575888333,0
1,1121,35277,3575888333,3575888333,0
1,1121,35278,3575888333,3575888333,0
1,1121,35279,3575888333,3575888333,0
1,1121,35280,3575888333,3575888333,0
1,1121,35281,3575888333,3575888333,0
1,1121,35282,3575888333,3575888333,0
1,1121,35283,3575888333,3575888333,0
1,1121,35284,3575888333,3575888333,0
1,1121,35285,3575888333,3575888333,0
1,1121,35286,3575888333,3575888333,0
1,1121,35287,3575888333,3575888333,0
1,1121,35288,3575888333,3575888333,0
1,1121,35289,3575888333,3575888333,0
1,1121,35290,3575888333,3575888334,1
1,1121,35291,3575888333,3575888334,1
1,1121,35292,3575888333,3575888337,4
1,1121,35293,3575888333,3575888337,4
1,1121,35294,3575888333,3575888340,7
1,1121,35295,3575888333,3575888340,7
1,1121,35296,3575888333,3575888342,9
1,1121,35297,3575888333,3575888343,10
1,1121,35298,3575888333,3575888344,11
1,1121,35299,3575888333,3575888347,14
1,1121,35300,3575888333,3575888348,15
1,1121,35301,3575888333,3575888348,15
1,1121,35302,3575888333,3575888349,16
1,1121,35303,3575888333,3575888350,17
1,1121,35304,3575888333,3575888350,17
1,1121,35305,3575888333,3575888350,17
1,1121,35306,3575888333,3575888352,19
1,1121,35307,3575888333,3575888353,20
1,1121,35308,3575888333,3575888354,21
1,1121,35309,3575888333,3575888354,21
1,1121,35310,3575888333,3575888354,21
1,1121,35311,3575888333,3575888354,21
1,1121,35312,3575888333,3575888357,24
1,1121,35313,3575888333,3575888357,24
1,1121,35314,3575888333,3575888357,24
1,1121,35315,3575888333,3575888358,25
1,1121,35316,3575888333,3575888359,26
1,1121,35317,3575888333,3575888361,28
1,1121,35318,3575888333,3575888361,28
1,1121,35319,3575888333,3575888362,29
1,1121,35320,3575888333,3575888363,30
1,1121,35321,3575888333,3575888364,31
1,1121,35322,3575888333,3575888364,31
1,1121,35323,3575888333,3575888365,32
1,1121,35324,3575888333,3575888366,33
1,1121,35325,3575888333,3575888368,35
1,1121,35326,3575888333,3575888370,37
1,1121,35327,3575888333,3575888372,39
1,1121,35328,3575888333,3575888373,40
1,1121,35329,3575888333,3575888374,41
1,1121,35330,3575888333,3575888374,41
1,1121,35331,3575888333,3575888374,41
1,1121,35332,3575888333,3575888374,41
1,1121,35333,3575888333,3575888379,46
1,1121,35334,3575888333,3575888379,46
1,1121,35335,3575888333,3575888380,47
1,1121,35336,3575888333,3575888381,48
1,1121,35337,3575888333,3575888382,49
1,1121,35338,3575888333,3575888382,49
1,1121,35339,3575888333,3575888383,50
1,1122,35340,3575888396,3575888396,0
1,1122,35341,3575888396,3575888396,0
1,1122,35342,3575888396,3575888396,0
1,1122,35343,3575888396,3575888396,0
1,1122,35344,3575888396,3575888396,0
1,1122,35345,3575888396,3575888396,0
1,1122,35346,3575888396,3575888396,0
1,1122,35347,3575888396,3575888396,0
1,1122,35348,3575888396,3575888396,0
1,1122,35349,3575888396,3575888396,0
1,1122,35350,3575888396,3575888396,0
1,1122,35351,3575888396,3575888396,0
1,1122,35352,3575888396,3575888396,0
1,1122,35353,3575888396,3575888396,0
1,1122,35354,3575888396,3575888396,0
1,1122,35355,3575888396,3575888396,0
1,1122,35356,3575888396,3575888396,0
1,1122,35357,3575888396,3575888397,1
1,1122,35358,3575888396,3575888397,1
1,1122,35359,3575888396,3575888398,2
1,1122,35360,3575888396,3575888399,3
1,1122,35361,3575888396,3575888399,3
1,1122,35362,3575888396,3575888400,4
1,1122,35363,3575888396,3575888402,6
1,1122,35364,3575888396,3575888403,7
1,1122,35365,3575888396,3575888403,7
1,1122,35366,3575888396,3575888403,7
1,1122,35367,3575888396,3575888403,7
1,1122,35368,3575888396,3575888404,8
1,1122,35369,3575888396,3575888404,8
1,1122,35370,3575888396,3575888405,9
1,1122,35371,3575888396,3575888405,9
1,1122,35372,3575888396,3575888407,11
1,1122,35373,3575888396,3575888408,12
1,1122,35374,3575888396,3575888408,12
1,1122,35375,3575888396,3575888408,12
1,1122,35376,3575888396,3575888409,13
1,1122,35377,3575888396,3575888410,14
1,1122,35378,3575888396,3575888411,15
1,1122,35379,3575888396,3575888412,16
1,1122,35380,3575888396,3575888412,16
1,1122,35381,3575888396,3575888413,17
1,1122,35382,3575888396,3575888414,18
1,1122,35383,3575888396,3575888414,18
1,1122,35384,3575888396,3575888414,18
1,1122,35385,3575888396,3575888416,20
1,1122,35386,3575888396,3575888416,20
1,1122,35387,3575888396,3575888417,21
1,1122,35388,3575888396,3575888417,21
1,1122,35389,3575888396,3575888417,21
1,1122,35390,3575888396,3575888417,21
1,1122,35391,3575888396,3575888418,22
1,1122,35392,3575888396,3575888418,22
1,1122,35393,3575888396,3575888419,23
1,1122,35394,3575888396,3575888421,25
1,1122,35395,3575888396,3575888421,25
1,1122,35396,3575888396,3575888422,26
1,1122,35397,3575888396,3575888424,28
1,1122,35398,3575888396,3575888424,28
1,1122,35399,3575888396,3575888424,28
1,1122,35400,3575888396,3575888425,29
1,1122,35401,3575888396,3575888425,29
1,1122,35402,3575888396,3575888427,31
1,1122,35403,3575888396,3575888428,32
1,1122,35404,3575888396,3575888428,32
1,1122,35405,3575888396,3575888429,33
1,1122,35406,3575888396,3575888429,33
1,1122,35407,3575888396,3575888431,35
1,1122,35408,3575888396,3575888431,35
1,1122,35409,3575888396,3575888433,37
1,1122,35410,3575888396,3575888433,37
1,1122,35411,3575888396,3575888434,38
1,1122,35412,3575888396,3575888434,38
1,1122,35413,3575888396,3575888435,39
1,1122,35414,3575888396,3575888436,40
1,1122,35415,3575888396,3575888437,41
1,1122,35416,3575888396,3575888439,43
1,1122,35417,3575888396,3575888440,44
1,1122,35418,3575888396,3575888440,44
1,1122,35419,3575888396,3575888442,46
1,1122,35420,3575888396,3575888442,46
1,1122,35421,3575888396,3575888443,47
1,1122,35422,3575888396,3575888444,48
1,1122,35423,3575888396,3575888444,48
1,1122,35424,3575888396,3575888444,48
1,1122,35425,3575888396,3575888445,49
1,1122,35426,3575888396,3575888445,49
1,1122,35427,3575888396,3575888446,50
1,1123,35428,3575888458,3575888458,0
1,1123,35429,3575888458,3575888458,0
1,1123,35430,3575888458,3575888458,0
1,1123,35431,3575888458,3575888458,0
1,1123,35432,3575888458,3575888458,0
1,1123,35433,3575888458,3575888458,0
1,1123,35434,3575888458,3575888458,0
1,1123,35435,3575888458,3575888458,0
1,1123,35436,3575888458,3575888458,0
1,1123,35437,3575888458,3575888458,0
1,1123,35438,3575888458,3575888458,0
1,1123,35439,3575888458,3575888458,0
1,1123,35440,3575888458,3575888458,0
1,1123,35441,3575888458,3575888458,0
1,1123,35442,3575888458,3575888458,0
1,1123,35443,3575888458,3575888459,1
1,1123,35444,3575888458,3575888459,1
1,1123,35445,3575888458,3575888459,1
1,1123,35446,3575888458,3575888460,2
1,1123,35447,3575888458,3575888462,4
1,1123,35448,3575888458,3575888466,8
1,1123,35449,3575888458,3575888466,8
1,1123,35450,3575888458,3575888467,9
1,1123,35451,3575888458,3575888468,10
1,1123,35452,3575888458,3575888469,11
1,1123,35453,3575888458,3575888471,13
1,1123,35454,3575888458,3575888472,14
1,1123,35455,3575888458,3575888479,21
1,1123,35456,3575888458,3575888482,24
1,1123,35457,3575888458,3575888483,25
1,1123,35458,3575888458,3575888483,25
1,1123,35459,3575888458,3575888483,25
1,1123,35460,3575888458,3575888484,26
1,1123,35461,3575888458,3575888484,26
1,1123,35462,3575888458,3575888484,26
1,1123,35463,3575888458,3575888486,28
1,1123,35464,3575888458,3575888487,29
1,1123,35465,3575888458,3575888488,30
1,1123,35466,3575888458,3575888488,30
1,1123,35467,3575888458,3575888488,30
1,1123,35468,3575888458,3575888489,31
1,1123,35469,3575888458,3575888490,32
1,1123,35470,3575888458,3575888491,33
1,1123,35471,3575888458,3575888491,33
1,1123,35472,3575888458,3575888492,34
1,1123,35473,3575888458,3575888492,34
1,1123,35474,3575888458,3575888492,34
1,1123,35475,3575888458,3575888493,35
1,1123,35476,3575888458,3575888494,36
1,1123,35477,3575888458,3575888495,37
1,1123,35478,3575888458,3575888497,39
1,1123,35479,3575888458,3575888497,39
1,1123,35480,3575888458,3575888498,40
1,1123,35481,3575888458,3575888498,40
1,1123,35482,3575888458,3575888498,40
1,1123,35483,3575888458,3575888499,41
1,1123,35484,3575888458,3575888500,42
1,1123,35485,3575888458,3575888501,43
1,1123,35486,3575888458,3575888501,43
1,1123,35487,3575888458,3575888501,43
1,1123,35488,3575888458,3575888502,44
1,1123,35489,3575888458,3575888502,44
1,1123,35490,3575888458,3575888503,45
1,1123,35491,3575888458,3575888503,45
1,1123,35492,3575888458,3575888504,46
1,1123,35493,3575888458,3575888504,46
1,1123,35494,3575888458,3575888506,48
1,1123,35495,3575888458,3575888506,48
1,1123,35496,3575888458,3575888506,48
1,1123,35497,3575888458,3575888507,49
1,1123,35498,3575888458,3575888507,49
1,1123,35499,3575888458,3575888507,49
1,1124,35500,3575888524,3575888524,0
1,1124,35501,3575888524,3575888524,0
1,1124,35502,3575888524,3575888524,0
1,1124,35503,3575888524,3575888524,0
1,1124,35504,3575888524,3575888524,0
1,1124,35505,3575888524,3575888524,0
1,1124,35506,3575888524,3575888524,0
1,1124,35507,3575888524,3575888524,0
1,1124,35508,3575888524,3575888524,0
1,1124,35509,3575888524,3575888524,0
1,1124,35510,3575888524,3575888524,0
1,1124,35511,3575888524,3575888524,0
1,1124,35512,3575888524,3575888524,0
1,1124,35513,3575888524,3575888524,0
1,1124,35514,3575888524,3575888525,1
1,1124,35515,3575888524,3575888525,1
1,1124,35516,3575888524,3575888526,2
1,1124,35517,3575888524,3575888526,2
1,1124,35518,3575888524,3575888526,2
1,1124,35519,3575888524,3575888528,4
1,1124,35520,3575888524,3575888528,4
1,1124,35521,3575888524,3575888529,5
1,1124,35522,3575888524,3575888530,6
1,1124,35523,3575888524,3575888531,7
1,1124,35524,3575888524,3575888531,7
1,1124,35525,3575888524,3575888532,8
1,1124,35526,3575888524,3575888532,8
1,1124,35527,3575888524,3575888532,8
1,1124,35528,3575888524,3575888533,9
1,1124,35529,3575888524,3575888536,12
1,1124,35530,3575888524,3575888536,12
1,1124,35531,3575888524,3575888538,14
1,1124,35532,3575888524,3575888539,15
1,1124,35533,3575888524,3575888542,18
1,1124,35534,3575888524,3575888543,19
1,1124,35535,3575888524,3575888543,19
1,1124,35536,3575888524,3575888545,21
1,1124,35537,3575888524,3575888546,22
1,1124,35538,3575888524,3575888547,23
1,1124,35539,3575888524,3575888549,25
1,1124,35540,3575888524,3575888549,25
1,1124,35541,3575888524,3575888549,25
1,1124,35542,3575888524,3575888550,26
1,1124,35543,3575888524,3575888551,27
1,1124,35544,3575888524,3575888552,28
1,1124,35545,3575888524,3575888552,28
1,1124,35546,3575888524,3575888553,29
1,1124,35547,3575888524,3575888553,29
1,1124,35548,3575888524,3575888555,31
1,1124,35549,3575888524,3575888556,32
1,1124,35550,3575888524,3575888556,32
1,1124,35551,3575888524,3575888556,32
1,1124,35552,3575888524,3575888556,32
1,1124,35553,3575888524,3575888558,34
1,1124,35554,3575888524,3575888559,35
1,1124,35555,3575888524,3575888561,37
1,1124,35556,3575888524,3575888561,37
1,1124,35557,3575888524,3575888561,37
1,1124,35558,3575888524,3575888562,38
1,1124,35559,3575888524,3575888563,39
1,1124,35560,3575888524,3575888563,39
1,1124,35561,3575888524,3575888564,40
1,1124,35562,3575888524,3575888565,41
1,1124,35563,3575888524,3575888568,44
1,1124,35564,3575888524,3575888570,46
1,1124,35565,3575888524,3575888570,46
1,1124,35566,3575888524,3575888571,47
1,1124,35567,3575888524,3575888573,49
1,1124,35568,3575888524,3575888573,49
1,1124,35569,3575888524,3575888573,49
1,1124,35570,3575888524,3575888574,50
1,1125,35571,3575888588,3575888588,0
1,1125,35572,3575888588,3575888588,0
1,1125,35573,3575888588,3575888588,0
1,1125,35574,3575888588,3575888588,0
1,1125,35575,3575888588,3575888588,0
1,1125,35576,3575888588,3575888588,0
1,1125,35577,3575888588,3575888588,0
1,1125,35578,3575888588,3575888588,0
1,1125,35579,3575888588,3575888588,0
1,1125,35580,3575888588,3575888588,0
1,1125,35581,3575888588,3575888588,0
1,1125,35582,3575888588,3575888588,0
1,1125,35583,3575888588,3575888588,0
1,1125,35584,3575888588,3575888588,0
1,1125,35585,3575888588,3575888588,0
1,1125,35586,3575888588,3575888589,1
1,1125,35587,3575888588,3575888590,2
1,1125,35588,3575888588,3575888591,3
1,1125,35589,3575888588,3575888591,3
1,1125,35590,3575888588,3575888591,3
1,1125,35591,3575888588,3575888592,4
1,1125,35592,3575888588,3575888592,4
1,1125,35593,3575888588,3575888592,4
1,1125,35594,3575888588,3575888593,5
1,1125,35595,3575888588,3575888595,7
1,1125,35596,3575888588,3575888596,8
1,1125,35597,3575888588,3575888597,9
1,1125,35598,3575888588,3575888597,9
1,1125,35599,3575888588,3575888597,9
1,1125,35600,3575888588,3575888598,10
1,1125,35601,3575888588,3575888598,10
1,1125,35602,3575888588,3575888601,13
1,1125,35603,3575888588,3575888602,14
1,1125,35604,3575888588,3575888602,14
1,1125,35605,3575888588,3575888602,14
1,1125,35606,3575888588,3575888603,15
1,1125,35607,3575888588,3575888603,15
1,1125,35608,3575888588,3575888604,16
1,1125,35609,3575888588,3575888604,16
1,1125,35610,3575888588,3575888605,17
1,1125,35611,3575888588,3575888606,18
1,1125,35612,3575888588,3575888606,18
1,1125,35613,3575888588,3575888607,19
1,1125,35614,3575888588,3575888607,19
1,1125,35615,3575888588,3575888608,20
1,1125,35616,3575888588,3575888609,21
1,1125,35617,3575888588,3575888611,23
1,1125,35618,3575888588,3575888611,23
1,1125,35619,3575888588,3575888611,23
1,1125,35620,3575888588,3575888612,24
1,1125,35621,3575888588,3575888612,24
1,1125,35622,3575888588,3575888613,25
1,1125,35623,3575888588,3575888614,26
1,1125,35624,3575888588,3575888614,26
1,1125,35625,3575888588,3575888615,27
1,1125,35626,3575888588,3575888615,27
1,1125,35627,3575888588,3575888615,27
1,1125,35628,3575888588,3575888616,28
1,1125,35629,3575888588,3575888616,28
1,1125,35630,3575888588,3575888617,29
1,1125,35631,3575888588,3575888618,30
1,1125,35632,3575888588,3575888618,30
1,1125,35633,3575888588,3575888620,32
1,1125,35634,3575888588,3575888620,32
1,1125,35635,3575888588,3575888620,32
1,1125,35636,3575888588,3575888621,33
1,1125,35637,3575888588,3575888623,35
1,1125,35638,3575888588,3575888623,35
1,1125,35639,3575888588,3575888624,36
1,1125,35640,3575888588,3575888624,36
1,1125,35641,3575888588,3575888624,36
1,1125,35642,3575888588,3575888626,38
1,1125,35643,3575888588,3575888627,39
1,1125,35644,3575888588,3575888627,39
1,1125,35645,3575888588,3575888627,39
1,1125,35646,3575888588,3575888628,40
1,1125,35647,3575888588,3575888630,42
1,1125,35648,3575888588,3575888631,43
1,1125,35649,3575888588,3575888632,44
1,1125,35650,3575888588,3575888633,45
1,1125,35651,3575888588,3575888633,45
1,1125,35652,3575888588,3575888634,46
1,1125,35653,3575888588,3575888635,47
1,1125,35654,3575888588,3575888636,48
1,1125,35655,3575888588,3575888638,50
1,1126,35656,3575888653,3575888653,0
1,1126,35657,3575888653,3575888653,0
1,1126,35658,3575888653,3575888653,0
1,1126,35659,3575888653,3575888653,0
1,1126,35660,3575888653,3575888653,0
1,1126,35661,3575888653,3575888653,0
1,1126,35662,3575888653,3575888653,0
1,1126,35663,3575888653,3575888653,0
1,1126,35664,3575888653,3575888653,0
1,1126,35665,3575888653,3575888653,0
1,1126,35666,3575888653,3575888653,0
1,1126,35667,3575888653,3575888653,0
1,1126,35668,3575888653,3575888653,0
1,1126,35669,3575888653,3575888653,0
1,1126,35670,3575888653,3575888653,0
1,1126,35671,3575888653,3575888653,0
1,1126,35672,3575888653,3575888653,0
1,1126,35673,3575888653,3575888653,0
1,1126,35674,3575888653,3575888653,0
1,1126,35675,3575888653,3575888653,0
1,1126,35676,3575888653,3575888653,0
1,1126,35677,3575888653,3575888653,0
1,1126,35678,3575888653,3575888653,0
1,1126,35679,3575888653,3575888654,1
1,1126,35680,3575888653,3575888655,2
1,1126,35681,3575888653,3575888656,3
1,1126,35682,3575888653,3575888656,3
1,1126,35683,3575888653,3575888657,4
1,1126,35684,3575888653,3575888658,5
1,1126,35685,3575888653,3575888658,5
1,1126,35686,3575888653,3575888659,6
1,1126,35687,3575888653,3575888665,12
1,1126,35688,3575888653,3575888665,12
1,1126,35689,3575888653,3575888666,13
1,1126,35690,3575888653,3575888666,13
1,1126,35691,3575888653,3575888668,15
1,1126,35692,3575888653,3575888670,17
1,1126,35693,3575888653,3575888672,19
1,1126,35694,3575888653,3575888679,26
1,1126,35695,3575888653,3575888682,29
1,1126,35696,3575888653,3575888683,30
1,1126,35697,3575888653,3575888683,30
1,1126,35698,3575888653,3575888684,31
1,1126,35699,3575888653,3575888686,33
1,1126,35700,3575888653,3575888687,34
1,1126,35701,3575888653,3575888687,34
1,1126,35702,3575888653,3575888688,35
1,1126,35703,3575888653,3575888688,35
1,1126,35704,3575888653,3575888689,36
1,1126,35705,3575888653,3575888690,37
1,1126,35706,3575888653,3575888691,38
1,1126,35707,3575888653,3575888691,38
1,1126,35708,3575888653,3575888692,39
1,1126,35709,3575888653,3575888692,39
1,1126,35710,3575888653,3575888692,39
1,1126,35711,3575888653,3575888693,40
1,1126,35712,3575888653,3575888695,42
1,1126,35713,3575888653,3575888695,42
1,1126,35714,3575888653,3575888697,44
1,1126,35715,3575888653,3575888697,44
1,1126,35716,3575888653,3575888698,45
1,1126,35717,3575888653,3575888698,45
1,1126,35718,3575888653,3575888698,45
1,1126,35719,3575888653,3575888699,46
1,1126,35720,3575888653,3575888700,47
1,1126,35721,3575888653,3575888701,48
1,1126,35722,3575888653,3575888701,48
1,1126,35723,3575888653,3575888701,48
1,1126,35724,3575888653,3575888702,49
1,1126,35725,3575888653,3575888702,49
1,1127,35726,3575888716,3575888716,0
1,1127,35727,3575888716,3575888716,0
1,1127,35728,3575888716,3575888716,0
1,1127,35729,3575888716,3575888716,0
1,1127,35730,3575888716,3575888716,0
1,1127,35731,3575888716,3575888716,0
1,1127,35732,3575888716,3575888716,0
1,1127,35733,3575888716,3575888716,0
1,1127,35734,3575888716,3575888716,0
1,1127,35735,3575888716,3575888716,0
1,1127,35736,3575888716,3575888716,0
1,1127,35737,3575888716,3575888716,0
1,1127,35738,3575888716,3575888716,0
1,1127,35739,3575888716,3575888716,0
1,1127,35740,3575888716,3575888716,0
1,1127,35741,3575888716,3575888716,0
1,1127,35742,3575888716,3575888716,0
1,1127,35743,3575888716,3575888716,0
1,1127,35744,3575888716,3575888716,0
1,1127,35745,3575888716,3575888717,1
1,1127,35746,3575888716,3575888717,1
1,1127,35747,3575888716,3575888718,2
1,1127,35748,3575888716,3575888719,3
1,1127,35749,3575888716,3575888721,5
1,1127,35750,3575888716,3575888721,5
1,1127,35751,3575888716,3575888722,6
1,1127,35752,3575888716,3575888722,6
1,1127,35753,3575888716,3575888723,7
1,1127,35754,3575888716,3575888725,9
1,1127,35755,3575888716,3575888726,10
1,1127,35756,3575888716,3575888726,10
1,1127,35757,3575888716,3575888726,10
1,1127,35758,3575888716,3575888727,11
1,1127,35759,3575888716,3575888728,12
1,1127,35760,3575888716,3575888728,12
1,1127,35761,3575888716,3575888728,12
1,1127,35762,3575888716,3575888730,14
1,1127,35763,3575888716,3575888731,15
1,1127,35764,3575888716,3575888731,15
1,1127,35765,3575888716,3575888732,16
1,1127,35766,3575888716,3575888732,16
1,1127,35767,3575888716,3575888733,17
1,1127,35768,3575888716,3575888733,17
1,1127,35769,3575888716,3575888736,20
1,1127,35770,3575888716,3575888736,20
1,1127,35771,3575888716,3575888740,24
1,1127,35772,3575888716,3575888740,24
1,1127,35773,3575888716,3575888741,25
1,1127,35774,3575888716,3575888743,27
1,1127,35775,3575888716,3575888743,27
1,1127,35776,3575888716,3575888745,29
1,1127,35777,3575888716,3575888746,30
1,1127,35778,3575888716,3575888747,31
1,1127,35779,3575888716,3575888748,32
1,1127,35780,3575888716,3575888748,32
1,1127,35781,3575888716,3575888749,33
1,1127,35782,3575888716,3575888749,33
1,1127,35783,3575888716,3575888749,33
1,1127,35784,3575888716,3575888750,34
1,1127,35785,3575888716,3575888752,36
1,1127,35786,3575888716,3575888752,36
1,1127,35787,3575888716,3575888752,36
1,1127,35788,3575888716,3575888752,36
1,1127,35789,3575888716,3575888753,37
1,1127,35790,3575888716,3575888753,37
1,1127,35791,3575888716,3575888755,39
1,1127,35792,3575888716,3575888756,40
1,1127,35793,3575888716,3575888756,40
1,1127,35794,3575888716,3575888756,40
1,1127,35795,3575888716,3575888756,40
1,1127,35796,3575888716,3575888758,42
1,1127,35797,3575888716,3575888759,43
1,1127,35798,3575888716,3575888762,46
1,1127,35799,3575888716,3575888762,46
1,1127,35800,3575888716,3575888762,46
1,1127,35801,3575888716,3575888762,46
1,1127,35802,3575888716,3575888762,46
1,1127,35803,3575888716,3575888762,46
1,1127,35804,3575888716,3575888763,47
1,1127,35805,3575888716,3575888764,48
1,1127,35806,3575888716,3575888765,49
1,1128,35807,3575888782,3575888782,0
1,1128,35808,3575888782,3575888782,0
1,1128,35809,3575888782,3575888782,0
1,1128,35810,3575888782,3575888782,0
1,1128,35811,3575888782,3575888782,0
1,1128,35812,3575888782,3575888782,0
1,1128,35813,3575888782,3575888782,0
1,1128,35814,3575888782,3575888782,0
1,1128,35815,3575888782,3575888782,0
1,1128,35816,3575888782,3575888782,0
1,1128,35817,3575888782,3575888782,0
1,1128,35818,3575888782,3575888782,0
1,1128,35819,3575888782,3575888782,0
1,1128,35820,3575888782,3575888782,0
1,1128,35821,3575888782,3575888782,0
1,1128,35822,3575888782,3575888782,0
1,1128,35823,3575888782,3575888783,1
1,1128,35824,3575888782,3575888784,2
1,1128,35825,3575888782,3575888784,2
1,1128,35826,3575888782,3575888784,2
1,1128,35827,3575888782,3575888784,2
1,1128,35828,3575888782,3575888785,3
1,1128,35829,3575888782,3575888786,4
1,1128,35830,3575888782,3575888787,5
1,1128,35831,3575888782,3575888789,7
1,1128,35832,3575888782,3575888790,8
1,1128,35833,3575888782,3575888791,9
1,1128,35834,3575888782,3575888791,9
1,1128,35835,3575888782,3575888791,9
1,1128,35836,3575888782,3575888791,9
1,1128,35837,3575888782,3575888792,10
1,1128,35838,3575888782,3575888792,10
1,1128,35839,3575888782,3575888792,10
1,1128,35840,3575888782,3575888795,13
1,1128,35841,3575888782,3575888797,15
1,1128,35842,3575888782,3575888797,15
1,1128,35843,3575888782,3575888797,15
1,1128,35844,3575888782,3575888797,15
1,1128,35845,3575888782,3575888799,17
1,1128,35846,3575888782,3575888801,19
1,1128,35847,3575888782,3575888801,19
1,1128,35848,3575888782,3575888802,20
1,1128,35849,3575888782,3575888802,20
1,1128,35850,3575888782,3575888802,20
1,1128,35851,3575888782,3575888803,21
1,1128,35852,3575888782,3575888804,22
1,1128,35853,3575888782,3575888805,23
1,1128,35854,3575888782,3575888805,23
1,1128,35855,3575888782,3575888805,23
1,1128,35856,3575888782,3575888806,24
1,1128,35857,3575888782,3575888807,25
1,1128,35858,3575888782,3575888809,27
1,1128,35859,3575888782,3575888809,27
1,1128,35860,3575888782,3575888809,27
1,1128,35861,3575888782,3575888810,28
1,1128,35862,3575888782,3575888811,29
1,1128,35863,3575888782,3575888811,29
1,1128,35864,3575888782,3575888811,29
1,1128,35865,3575888782,3575888812,30
1,1128,35866,3575888782,3575888814,32
1,1128,35867,3575888782,3575888814,32
1,1128,35868,3575888782,3575888814,32
1,1128,35869,3575888782,3575888815,33
1,1128,35870,3575888782,3575888816,34
1,1128,35871,3575888782,3575888816,34
1,1128,35872,3575888782,3575888817,35
1,1128,35873,3575888782,3575888818,36
1,1128,35874,3575888782,3575888820,38
1,1128,35875,3575888782,3575888820,38
1,1128,35876,3575888782,3575888820,38
1,1128,35877,3575888782,3575888822,40
1,1128,35878,3575888782,3575888822,40
1,1128,35879,3575888782,3575888823,41
1,1128,35880,3575888782,3575888824,42
1,1128,35881,3575888782,3575888824,42
1,1128,35882,3575888782,3575888824,42
1,1128,35883,3575888782,3575888824,42
1,1128,35884,3575888782,3575888827,45
1,1128,35885,3575888782,3575888827,45
1,1128,35886,3575888782,3575888828,46
1,1128,35887,3575888782,3575888828,46
1,1128,35888,3575888782,3575888828,46
1,1128,35889,3575888782,3575888830,48
1,1128,35890,3575888782,3575888830,48
1,1128,35891,3575888782,3575888832,50
1,1129,35892,3575888844,3575888844,0
1,1129,35893,3575888844,3575888844,0
1,1129,35894,3575888844,3575888844,0
1,1129,35895,3575888844,3575888844,0
1,1129,35896,3575888844,3575888844,0
1,1129,35897,3575888844,3575888844,0
1,1129,35898,3575888844,3575888844,0
1,1129,35899,3575888844,3575888844,0
1,1129,35900,3575888844,3575888844,0
1,1129,35901,3575888844,3575888844,0
1,1129,35902,3575888844,3575888844,0
1,1129,35903,3575888844,3575888844,0
1,1129,35904,3575888844,3575888844,0
1,1129,35905,3575888844,3575888844,0
1,1129,35906,3575888844,3575888844,0
1,1129,35907,3575888844,3575888845,1
1,1129,35908,3575888844,3575888845,1
1,1129,35909,3575888844,3575888846,2
1,1129,35910,3575888844,3575888846,2
1,1129,35911,3575888844,3575888847,3
1,1129,35912,3575888844,3575888847,3
1,1129,35913,3575888844,3575888848,4
1,1129,35914,3575888844,3575888848,4
1,1129,35915,3575888844,3575888848,4
1,1129,35916,3575888844,3575888849,5
1,1129,35917,3575888844,3575888849,5
1,1129,35918,3575888844,3575888850,6
1,1129,35919,3575888844,3575888850,6
1,1129,35920,3575888844,3575888852,8
1,1129,35921,3575888844,3575888853,9
1,1129,35922,3575888844,3575888853,9
1,1129,35923,3575888844,3575888854,10
1,1129,35924,3575888844,3575888854,10
1,1129,35925,3575888844,3575888856,12
1,1129,35926,3575888844,3575888856,12
1,1129,35927,3575888844,3575888857,13
1,1129,35928,3575888844,3575888858,14
1,1129,35929,3575888844,3575888859,15
1,1129,35930,3575888844,3575888862,18
1,1129,35931,3575888844,3575888864,20
1,1129,35932,3575888844,3575888865,21
1,1129,35933,3575888844,3575888865,21
1,1129,35934,3575888844,3575888866,22
1,1129,35935,3575888844,3575888869,25
1,1129,35936,3575888844,3575888869,25
1,1129,35937,3575888844,3575888871,27
1,1129,35938,3575888844,3575888879,35
1,1129,35939,3575888844,3575888882,38
1,1129,35940,3575888844,3575888883,39
1,1129,35941,3575888844,3575888884,40
1,1129,35942,3575888844,3575888884,40
1,1129,35943,3575888844,3575888885,41
1,1129,35944,3575888844,3575888886,42
1,1129,35945,3575888844,3575888887,43
1,1129,35946,3575888844,3575888887,43
1,1129,35947,3575888844,3575888888,44
1,1129,35948,3575888844,3575888888,44
1,1129,35949,3575888844,3575888889,45
1,1129,35950,3575888844,3575888890,46
1,1129,35951,3575888844,3575888890,46
1,1129,35952,3575888844,3575888891,47
1,1129,35953,3575888844,3575888892,48
1,1129,35954,3575888844,3575888892,48
1,1129,35955,3575888844,3575888892,48
1,1129,35956,3575888844,3575888893,49
1,1129,35957,3575888844,3575888894,50
1,1130,35958,3575888908,3575888908,0
1,1130,35959,3575888908,3575888908,0
1,1130,35960,3575888908,3575888908,0
1,1130,35961,3575888908,3575888908,0
1,1130,35962,3575888908,3575888908,0
1,1130,35963,3575888908,3575888908,0
1,1130,35964,3575888908,3575888908,0
1,1130,35965,3575888908,3575888908,0
1,1130,35966,3575888908,3575888908,0
1,1130,35967,3575888908,3575888908,0
1,1130,35968,3575888908,3575888908,0
1,1130,35969,3575888908,3575888908,0
1,1130,35970,3575888908,3575888908,0
1,1130,35971,3575888908,3575888908,0
1,1130,35972,3575888908,3575888908,0
1,1130,35973,3575888908,3575888908,0
1,1130,35974,3575888908,3575888908,0
1,1130,35975,3575888908,3575888908,0
1,1130,35976,3575888908,3575888908,0
1,1130,35977,3575888908,3575888908,0
1,1130,35978,3575888908,3575888908,0
1,1130,35979,3575888908,3575888908,0
1,1130,35980,3575888908,3575888908,0
1,1130,35981,3575888908,3575888908,0
1,1130,35982,3575888908,3575888911,3
1,1130,35983,3575888908,3575888912,4
1,1130,35984,3575888908,3575888913,5
1,1130,35985,3575888908,3575888913,5
1,1130,35986,3575888908,3575888915,7
1,1130,35987,3575888908,3575888915,7
1,1130,35988,3575888908,3575888915,7
1,1130,35989,3575888908,3575888915,7
1,1130,35990,3575888908,3575888917,9
1,1130,35991,3575888908,3575888918,10
1,1130,35992,3575888908,3575888918,10
1,1130,35993,3575888908,3575888919,11
1,1130,35994,3575888908,3575888920,12
1,1130,35995,3575888908,3575888921,13
1,1130,35996,3575888908,3575888922,14
1,1130,35997,3575888908,3575888923,15
1,1130,35998,3575888908,3575888923,15
1,1130,35999,3575888908,3575888925,17
1,1130,36000,3575888908,3575888926,18
1,1130,36001,3575888908,3575888926,18
1,1130,36002,3575888908,3575888927,19
1,1130,36003,3575888908,3575888927,19
1,1130,36004,3575888908,3575888928,20
1,1130,36005,3575888908,3575888928,20
1,1130,36006,3575888908,3575888931,23
1,1130,36007,3575888908,3575888931,23
1,1130,36008,3575888908,3575888932,24
1,1130,36009,3575888908,3575888932,24
1,1130,36010,3575888908,3575888932,24
1,1130,36011,3575888908,3575888932,24
1,1130,36012,3575888908,3575888933,25
1,1130,36013,3575888908,3575888936,28
1,1130,36014,3575888908,3575888936,28
1,1130,36015,3575888908,3575888940,32
1,1130,36016,3575888908,3575888940,32
1,1130,36017,3575888908,3575888941,33
1,1130,36018,3575888908,3575888943,35
1,1130,36019,3575888908,3575888945,37
1,1130,36020,3575888908,3575888946,38
1,1130,36021,3575888908,3575888947,39
1,1130,36022,3575888908,3575888949,41
1,1130,36023,3575888908,3575888949,41
1,1130,36024,3575888908,3575888949,41
1,1130,36025,3575888908,3575888949,41
1,1130,36026,3575888908,3575888950,42
1,1130,36027,3575888908,3575888950,42
1,1130,36028,3575888908,3575888951,43
1,1130,36029,3575888908,3575888952,44
1,1130,36030,3575888908,3575888952,44
1,1130,36031,3575888908,3575888953,45
1,1130,36032,3575888908,3575888954,46
1,1130,36033,3575888908,3575888955,47
1,1130,36034,3575888908,3575888956,48
1,1130,36035,3575888908,3575888956,48
1,1130,36036,3575888908,3575888956,48
1,1130,36037,3575888908,3575888957,49
1,1131,36038,3575888972,3575888972,0
1,1131,36039,3575888972,3575888972,0
1,1131,36040,3575888972,3575888972,0
1,1131,36041,3575888972,3575888972,0
1,1131,36042,3575888972,3575888972,0
1,1131,36043,3575888972,3575888972,0
1,1131,36044,3575888972,3575888972,0
1,1131,36045,3575888972,3575888972,0
1,1131,36046,3575888972,3575888972,0
1,1131,36047,3575888972,3575888972,0
1,1131,36048,3575888972,3575888972,0
1,1131,36049,3575888972,3575888972,0
1,1131,36050,3575888972,3575888972,0
1,1131,36051,3575888972,3575888972,0
1,1131,36052,3575888972,3575888972,0
1,1131,36053,3575888972,3575888973,1
1,1131,36054,3575888972,3575888973,1
1,1131,36055,3575888972,3575888973,1
1,1131,36056,3575888972,3575888974,2
1,1131,36057,3575888972,3575888975,3
1,1131,36058,3575888972,3575888978,6
1,1131,36059,3575888972,3575888979,7
1,1131,36060,3575888972,3575888980,8
1,1131,36061,3575888972,3575888980,8
1,1131,36062,3575888972,3575888981,9
1,1131,36063,3575888972,3575888981,9
1,1131,36064,3575888972,3575888982,10
1,1131,36065,3575888972,3575888982,10
1,1131,36066,3575888972,3575888983,11
1,1131,36067,3575888972,3575888984,12
1,1131,36068,3575888972,3575888985,13
1,1131,36069,3575888972,3575888985,13
1,1131,36070,3575888972,3575888985,13
1,1131,36071,3575888972,3575888987,15
1,1131,36072,3575888972,3575888987,15
1,1131,36073,3575888972,3575888990,18
1,1131,36074,3575888972,3575888991,19
1,1131,36075,3575888972,3575888991,19
1,1131,36076,3575888972,3575888991,19
1,1131,36077,3575888972,3575888992,20
1,1131,36078,3575888972,3575888992,20
1,1131,36079,3575888972,3575888993,21
1,1131,36080,3575888972,3575888993,21
1,1131,36081,3575888972,3575888993,21
1,1131,36082,3575888972,3575888996,24
1,1131,36083,3575888972,3575888996,24
1,1131,36084,3575888972,3575888997,25
1,1131,36085,3575888972,3575888997,25
1,1131,36086,3575888972,3575888997,25
1,1131,36087,3575888972,3575889000,28
1,1131,36088,3575888972,3575889000,28
1,1131,36089,3575888972,3575889001,29
1,1131,36090,3575888972,3575889001,29
1,1131,36091,3575888972,3575889002,30
1,1131,36092,3575888972,3575889002,30
1,1131,36093,3575888972,3575889004,32
1,1131,36094,3575888972,3575889005,33
1,1131,36095,3575888972,3575889005,33
1,1131,36096,3575888972,3575889007,35
1,1131,36097,3575888972,3575889007,35
1,1131,36098,3575888972,3575889007,35
1,1131,36099,3575888972,3575889009,37
1,1131,36100,3575888972,3575889010,38
1,1131,36101,3575888972,3575889010,38
1,1131,36102,3575888972,3575889010,38
1,1131,36103,3575888972,3575889011,39
1,1131,36104,3575888972,3575889012,40
1,1131,36105,3575888972,3575889012,40
1,1131,36106,3575888972,3575889013,41
1,1131,36107,3575888972,3575889014,42
1,1131,36108,3575888972,3575889014,42
1,1131,36109,3575888972,3575889014,42
1,1131,36110,3575888972,3575889015,43
1,1131,36111,3575888972,3575889016,44
1,1131,36112,3575888972,3575889016,44
1,1131,36113,3575888972,3575889016,44
1,1131,36114,3575888972,3575889017,45
1,1131,36115,3575888972,3575889017,45
1,1131,36116,3575888972,3575889018,46
1,1131,36117,3575888972,3575889018,46
1,1131,36118,3575888972,3575889019,47
1,1131,36119,3575888972,3575889020,48
1,1131,36120,3575888972,3575889021,49
1,1131,36121,3575888972,3575889022,50
1,1132,36122,3575889034,3575889034,0
1,1132,36123,3575889034,3575889034,0
1,1132,36124,3575889034,3575889034,0
1,1132,36125,3575889034,3575889034,0
1,1132,36126,3575889034,3575889034,0
1,1132,36127,3575889034,3575889034,0
1,1132,36128,3575889034,3575889034,0
1,1132,36129,3575889034,3575889034,0
1,1132,36130,3575889034,3575889034,0
1,1132,36131,3575889034,3575889034,0
1,1132,36132,3575889034,3575889034,0
1,1132,36133,3575889034,3575889034,0
1,1132,36134,3575889034,3575889034,0
1,1132,36135,3575889034,3575889034,0
1,1132,36136,3575889034,3575889034,0
1,1132,36137,3575889034,3575889034,0
1,1132,36138,3575889034,3575889034,0
1,1132,36139,3575889034,3575889034,0
1,1132,36140,3575889034,3575889035,1
1,1132,36141,3575889034,3575889036,2
1,1132,36142,3575889034,3575889036,2
1,1132,36143,3575889034,3575889038,4
1,1132,36144,3575889034,3575889039,5
1,1132,36145,3575889034,3575889040,6
1,1132,36146,3575889034,3575889042,8
1,1132,36147,3575889034,3575889042,8
1,1132,36148,3575889034,3575889043,9
1,1132,36149,3575889034,3575889044,10
1,1132,36150,3575889034,3575889044,10
1,1132,36151,3575889034,3575889045,11
1,1132,36152,3575889034,3575889045,11
1,1132,36153,3575889034,3575889045,11
1,1132,36154,3575889034,3575889046,12
1,1132,36155,3575889034,3575889047,13
1,1132,36156,3575889034,3575889047,13
1,1132,36157,3575889034,3575889047,13
1,1132,36158,3575889034,3575889048,14
1,1132,36159,3575889034,3575889048,14
1,1132,36160,3575889034,3575889049,15
1,1132,36161,3575889034,3575889050,16
1,1132,36162,3575889034,3575889050,16
1,1132,36163,3575889034,3575889051,17
1,1132,36164,3575889034,3575889052,18
1,1132,36165,3575889034,3575889053,19
1,1132,36166,3575889034,3575889053,19
1,1132,36167,3575889034,3575889053,19
1,1132,36168,3575889034,3575889054,20
1,1132,36169,3575889034,3575889055,21
1,1132,36170,3575889034,3575889056,22
1,1132,36171,3575889034,3575889056,22
1,1132,36172,3575889034,3575889058,24
1,1132,36173,3575889034,3575889058,24
1,1132,36174,3575889034,3575889058,24
1,1132,36175,3575889034,3575889059,25
1,1132,36176,3575889034,3575889062,28
1,1132,36177,3575889034,3575889065,31
1,1132,36178,3575889034,3575889066,32
1,1132,36179,3575889034,3575889066,32
1,1132,36180,3575889034,3575889069,35
1,1132,36181,3575889034,3575889070,36
1,1132,36182,3575889034,3575889071,37
1,1132,36183,3575889034,3575889079,45
1,1132,36184,3575889034,3575889079,45
1,1132,36185,3575889034,3575889082,48
1,1132,36186,3575889034,3575889083,49
1,1132,36187,3575889034,3575889083,49
1,1132,36188,3575889034,3575889084,50
1,1133,36189,3575889098,3575889098,0
1,1133,36190,3575889098,3575889098,0
1,1133,36191,3575889098,3575889098,0
1,1133,36192,3575889098,3575889098,0
1,1133,36193,3575889098,3575889098,0
1,1133,36194,3575889098,3575889098,0
1,1133,36195,3575889098,3575889098,0
1,1133,36196,3575889098,3575889098,0
1,1133,36197,3575889098,3575889098,0
1,1133,36198,3575889098,3575889098,0
1,1133,36199,3575889098,3575889098,0
1,1133,36200,3575889098,3575889098,0
1,1133,36201,3575889098,3575889098,0
1,1133,36202,3575889098,3575889098,0
1,1133,36203,3575889098,3575889098,0
1,1133,36204,3575889098,3575889098,0
1,1133,36205,3575889098,3575889098,0
1,1133,36206,3575889098,3575889098,0
1,1133,36207,3575889098,3575889098,0
1,1133,36208,3575889098,3575889098,0
1,1133,36209,3575889098,3575889099,1
1,1133,36210,3575889098,3575889099,1
1,1133,36211,3575889098,3575889100,2
1,1133,36212,3575889098,3575889101,3
1,1133,36213,3575889098,3575889101,3
1,1133,36214,3575889098,3575889102,4
1,1133,36215,3575889098,3575889102,4
1,1133,36216,3575889098,3575889103,5
1,1133,36217,3575889098,3575889103,5
1,1133,36218,3575889098,3575889104,6
1,1133,36219,3575889098,3575889105,7
1,1133,36220,3575889098,3575889106,8
1,1133,36221,3575889098,3575889106,8
1,1133,36222,3575889098,3575889106,8
1,1133,36223,3575889098,3575889106,8
1,1133,36224,3575889098,3575889107,9
1,1133,36225,3575889098,3575889107,9
1,1133,36226,3575889098,3575889108,10
1,1133,36227,3575889098,3575889108,10
1,1133,36228,3575889098,3575889111,13
1,1133,36229,3575889098,3575889112,14
1,1133,36230,3575889098,3575889112,14
1,1133,36231,3575889098,3575889113,15
1,1133,36232,3575889098,3575889114,16
1,1133,36233,3575889098,3575889115,17
1,1133,36234,3575889098,3575889115,17
1,1133,36235,3575889098,3575889116,18
1,1133,36236,3575889098,3575889117,19
1,1133,36237,3575889098,3575889117,19
1,1133,36238,3575889098,3575889118,20
1,1133,36239,3575889098,3575889119,21
1,1133,36240,3575889098,3575889120,22
1,1133,36241,3575889098,3575889122,24
1,1133,36242,3575889098,3575889122,24
1,1133,36243,3575889098,3575889122,24
1,1133,36244,3575889098,3575889123,25
1,1133,36245,3575889098,3575889125,27
1,1133,36246,3575889098,3575889125,27
1,1133,36247,3575889098,3575889126,28
1,1133,36248,3575889098,3575889127,29
1,1133,36249,3575889098,3575889127,29
1,1133,36250,3575889098,3575889128,30
1,1133,36251,3575889098,3575889129,31
1,1133,36252,3575889098,3575889130,32
1,1133,36253,3575889098,3575889130,32
1,1133,36254,3575889098,3575889131,33
1,1133,36255,3575889098,3575889131,33
1,1133,36256,3575889098,3575889133,35
1,1133,36257,3575889098,3575889133,35
1,1133,36258,3575889098,3575889133,35
1,1133,36259,3575889098,3575889135,37
1,1133,36260,3575889098,3575889136,38
1,1133,36261,3575889098,3575889136,38
1,1133,36262,3575889098,3575889139,41
1,1133,36263,3575889098,3575889140,42
1,1133,36264,3575889098,3575889142,44
1,1133,36265,3575889098,3575889144,46
1,1133,36266,3575889098,3575889146,48
1,1133,36267,3575889098,3575889147,49
1,1134,36268,3575889162,3575889162,0
1,1134,36269,3575889162,3575889162,0
1,1134,36270,3575889162,3575889162,0
1,1134,36271,3575889162,3575889162,0
1,1134,36272,3575889162,3575889162,0
1,1134,36273,3575889162,3575889162,0
1,1134,36274,3575889162,3575889162,0
1,1134,36275,3575889162,3575889162,0
1,1134,36276,3575889162,3575889162,0
1,1134,36277,3575889162,3575889162,0
1,1134,36278,3575889162,3575889162,0
1,1134,36279,3575889162,3575889162,0
1,1134,36280,3575889162,3575889162,0
1,1134,36281,3575889162,3575889162,0
1,1134,36282,3575889162,3575889162,0
1,1134,36283,3575889162,3575889162,0
1,1134,36284,3575889162,3575889162,0
1,1134,36285,3575889162,3575889162,0
1,1134,36286,3575889162,3575889162,0
1,1134,36287,3575889162,3575889163,1
1,1134,36288,3575889162,3575889163,1
1,1134,36289,3575889162,3575889163,1
1,1134,36290,3575889162,3575889163,1
1,1134,36291,3575889162,3575889165,3
1,1134,36292,3575889162,3575889165,3
1,1134,36293,3575889162,3575889169,7
1,1134,36294,3575889162,3575889170,8
1,1134,36295,3575889162,3575889172,10
1,1134,36296,3575889162,3575889173,11
1,1134,36297,3575889162,3575889173,11
1,1134,36298,3575889162,3575889173,11
1,1134,36299,3575889162,3575889174,12
1,1134,36300,3575889162,3575889175,13
1,1134,36301,3575889162,3575889178,16
1,1134,36302,3575889162,3575889179,17
1,1134,36303,3575889162,3575889180,18
1,1134,36304,3575889162,3575889181,19
1,1134,36305,3575889162,3575889181,19
1,1134,36306,3575889162,3575889182,20
1,1134,36307,3575889162,3575889182,20
1,1134,36308,3575889162,3575889183,21
1,1134,36309,3575889162,3575889184,22
1,1134,36310,3575889162,3575889185,23
1,1134,36311,3575889162,3575889185,23
1,1134,36312,3575889162,3575889185,23
1,1134,36313,3575889162,3575889186,24
1,1134,36314,3575889162,3575889186,24
1,1134,36315,3575889162,3575889187,25
1,1134,36316,3575889162,3575889191,29
1,1134,36317,3575889162,3575889191,29
1,1134,36318,3575889162,3575889191,29
1,1134,36319,3575889162,3575889191,29
1,1134,36320,3575889162,3575889192,30
1,1134,36321,3575889162,3575889192,30
1,1134,36322,3575889162,3575889192,30
1,1134,36323,3575889162,3575889193,31
1,1134,36324,3575889162,3575889196,34
1,1134,36325,3575889162,3575889197,35
1,1134,36326,3575889162,3575889197,35
1,1134,36327,3575889162,3575889197,35
1,1134,36328,3575889162,3575889197,35
1,1134,36329,3575889162,3575889199,37
1,1134,36330,3575889162,3575889200,38
1,1134,36331,3575889162,3575889201,39
1,1134,36332,3575889162,3575889202,40
1,1134,36333,3575889162,3575889202,40
1,1134,36334,3575889162,3575889202,40
1,1134,36335,3575889162,3575889203,41
1,1134,36336,3575889162,3575889204,42
1,1134,36337,3575889162,3575889205,43
1,1134,36338,3575889162,3575889205,43
1,1134,36339,3575889162,3575889205,43
1,1134,36340,3575889162,3575889206,44
1,1134,36341,3575889162,3575889207,45
1,1134,36342,3575889162,3575889208,46
1,1134,36343,3575889162,3575889209,47
1,1134,36344,3575889162,3575889209,47
1,1134,36345,3575889162,3575889210,48
1,1134,36346,3575889162,3575889211,49
1,1134,36347,3575889162,3575889212,50
1,1135,36348,3575889226,3575889227,1
1,1135,36349,3575889226,3575889227,1
1,1135,36350,3575889226,3575889227,1
1,1135,36351,3575889226,3575889227,1
1,1135,36352,3575889226,3575889227,1
1,1135,36353,3575889226,3575889227,1
1,1135,36354,3575889226,3575889227,1
1,1135,36355,3575889226,3575889227,1
1,1135,36356,3575889226,3575889227,1
1,1135,36357,3575889226,3575889227,1
1,1135,36358,3575889226,3575889227,1
1,1135,36359,3575889226,3575889227,1
1,1135,36360,3575889226,3575889227,1
1,1135,36361,3575889226,3575889227,1
1,1135,36362,3575889226,3575889227,1
1,1135,36363,3575889226,3575889227,1
1,1135,36364,3575889226,3575889227,1
1,1135,36365,3575889226,3575889227,1
1,1135,36366,3575889226,3575889227,1
1,1135,36367,3575889226,3575889227,1
1,1135,36368,3575889226,3575889227,1
1,1135,36369,3575889226,3575889227,1
1,1135,36370,3575889226,3575889227,1
1,1135,36371,3575889226,3575889228,2
1,1135,36372,3575889226,3575889228,2
1,1135,36373,3575889226,3575889228,2
1,1135,36374,3575889226,3575889229,3
1,1135,36375,3575889226,3575889229,3
1,1135,36376,3575889226,3575889230,4
1,1135,36377,3575889226,3575889231,5
1,1135,36378,3575889226,3575889232,6
1,1135,36379,3575889226,3575889233,7
1,1135,36380,3575889226,3575889233,7
1,1135,36381,3575889226,3575889233,7
1,1135,36382,3575889226,3575889235,9
1,1135,36383,3575889226,3575889235,9
1,1135,36384,3575889226,3575889236,10
1,1135,36385,3575889226,3575889237,11
1,1135,36386,3575889226,3575889238,12
1,1135,36387,3575889226,3575889240,14
1,1135,36388,3575889226,3575889240,14
1,1135,36389,3575889226,3575889242,16
1,1135,36390,3575889226,3575889242,16
1,1135,36391,3575889226,3575889243,17
1,1135,36392,3575889226,3575889243,17
1,1135,36393,3575889226,3575889244,18
1,1135,36394,3575889226,3575889244,18
1,1135,36395,3575889226,3575889245,19
1,1135,36396,3575889226,3575889246,20
1,1135,36397,3575889226,3575889247,21
1,1135,36398,3575889226,3575889247,21
1,1135,36399,3575889226,3575889247,21
1,1135,36400,3575889226,3575889247,21
1,1135,36401,3575889226,3575889248,22
1,1135,36402,3575889226,3575889248,22
1,1135,36403,3575889226,3575889249,23
1,1135,36404,3575889226,3575889249,23
1,1135,36405,3575889226,3575889250,24
1,1135,36406,3575889226,3575889251,25
1,1135,36407,3575889226,3575889252,26
1,1135,36408,3575889226,3575889253,27
1,1135,36409,3575889226,3575889254,28
1,1135,36410,3575889226,3575889254,28
1,1135,36411,3575889226,3575889256,30
1,1135,36412,3575889226,3575889256,30
1,1135,36413,3575889226,3575889256,30
1,1135,36414,3575889226,3575889257,31
1,1135,36415,3575889226,3575889258,32
1,1135,36416,3575889226,3575889259,33
1,1135,36417,3575889226,3575889260,34
1,1135,36418,3575889226,3575889263,37
1,1135,36419,3575889226,3575889264,38
1,1135,36420,3575889226,3575889265,39
1,1135,36421,3575889226,3575889265,39
1,1135,36422,3575889226,3575889267,41
1,1135,36423,3575889226,3575889269,43
1,1135,36424,3575889226,3575889269,43
1,1135,36425,3575889226,3575889271,45
1,1136,36426,3575889289,3575889289,0
1,1136,36427,3575889289,3575889289,0
1,1136,36428,3575889289,3575889289,0
1,1136,36429,3575889289,3575889289,0
1,1136,36430,3575889289,3575889289,0
1,1136,36431,3575889289,3575889289,0
1,1136,36432,3575889289,3575889289,0
1,1136,36433,3575889289,3575889289,0
1,1136,36434,3575889289,3575889289,0
1,1136,36435,3575889289,3575889289,0
1,1136,36436,3575889289,3575889289,0
1,1136,36437,3575889289,3575889289,0
1,1136,36438,3575889289,3575889289,0
1,1136,36439,3575889289,3575889289,0
1,1136,36440,3575889289,3575889289,0
1,1136,36441,3575889289,3575889290,1
1,1136,36442,3575889289,3575889291,2
1,1136,36443,3575889289,3575889291,2
1,1136,36444,3575889289,3575889292,3
1,1136,36445,3575889289,3575889293,4
1,1136,36446,3575889289,3575889294,5
1,1136,36447,3575889289,3575889294,5
1,1136,36448,3575889289,3575889294,5
1,1136,36449,3575889289,3575889296,7
1,1136,36450,3575889289,3575889298,9
1,1136,36451,3575889289,3575889298,9
1,1136,36452,3575889289,3575889298,9
1,1136,36453,3575889289,3575889299,10
1,1136,36454,3575889289,3575889299,10
1,1136,36455,3575889289,3575889300,11
1,1136,36456,3575889289,3575889301,12
1,1136,36457,3575889289,3575889301,12
1,1136,36458,3575889289,3575889302,13
1,1136,36459,3575889289,3575889302,13
1,1136,36460,3575889289,3575889303,14
1,1136,36461,3575889289,3575889303,14
1,1136,36462,3575889289,3575889304,15
1,1136,36463,3575889289,3575889306,17
1,1136,36464,3575889289,3575889306,17
1,1136,36465,3575889289,3575889306,17
1,1136,36466,3575889289,3575889306,17
1,1136,36467,3575889289,3575889307,18
1,1136,36468,3575889289,3575889307,18
1,1136,36469,3575889289,3575889307,18
1,1136,36470,3575889289,3575889308,19
1,1136,36471,3575889289,3575889309,20
1,1136,36472,3575889289,3575889311,22
1,1136,36473,3575889289,3575889311,22
1,1136,36474,3575889289,3575889313,24
1,1136,36475,3575889289,3575889313,24
1,1136,36476,3575889289,3575889315,26
1,1136,36477,3575889289,3575889315,26
1,1136,36478,3575889289,3575889315,26
1,1136,36479,3575889289,3575889315,26
1,1136,36480,3575889289,3575889317,28
1,1136,36481,3575889289,3575889317,28
1,1136,36482,3575889289,3575889318,29
1,1136,36483,3575889289,3575889319,30
1,1136,36484,3575889289,3575889320,31
1,1136,36485,3575889289,3575889322,33
1,1136,36486,3575889289,3575889322,33
1,1136,36487,3575889289,3575889323,34
1,1136,36488,3575889289,3575889325,36
1,1136,36489,3575889289,3575889326,37
1,1136,36490,3575889289,3575889327,38
1,1136,36491,3575889289,3575889328,39
1,1136,36492,3575889289,3575889329,40
1,1136,36493,3575889289,3575889329,40
1,1136,36494,3575889289,3575889330,41
1,1136,36495,3575889289,3575889331,42
1,1136,36496,3575889289,3575889331,42
1,1136,36497,3575889289,3575889332,43
1,1136,36498,3575889289,3575889332,43
1,1136,36499,3575889289,3575889332,43
1,1136,36500,3575889289,3575889333,44
1,1136,36501,3575889289,3575889334,45
1,1136,36502,3575889289,3575889336,47
1,1136,36503,3575889289,3575889336,47
1,1136,36504,3575889289,3575889339,50
1,1137,36505,3575889352,3575889352,0
1,1137,36506,3575889352,3575889352,0
1,1137,36507,3575889352,3575889352,0
1,1137,36508,3575889352,3575889352,0
1,1137,36509,3575889352,3575889352,0
1,1137,36510,3575889352,3575889352,0
1,1137,36511,3575889352,3575889352,0
1,1137,36512,3575889352,3575889352,0
1,1137,36513,3575889352,3575889352,0
1,1137,36514,3575889352,3575889352,0
1,1137,36515,3575889352,3575889352,0
1,1137,36516,3575889352,3575889352,0
1,1137,36517,3575889352,3575889353,1
1,1137,36518,3575889352,3575889353,1
1,1137,36519,3575889352,3575889353,1
1,1137,36520,3575889352,3575889353,1
1,1137,36521,3575889352,3575889354,2
1,1137,36522,3575889352,3575889355,3
1,1137,36523,3575889352,3575889356,4
1,1137,36524,3575889352,3575889357,5
1,1137,36525,3575889352,3575889357,5
1,1137,36526,3575889352,3575889358,6
1,1137,36527,3575889352,3575889358,6
1,1137,36528,3575889352,3575889361,9
1,1137,36529,3575889352,3575889362,10
1,1137,36530,3575889352,3575889363,11
1,1137,36531,3575889352,3575889363,11
1,1137,36532,3575889352,3575889364,12
1,1137,36533,3575889352,3575889364,12
1,1137,36534,3575889352,3575889365,13
1,1137,36535,3575889352,3575889365,13
1,1137,36536,3575889352,3575889370,18
1,1137,36537,3575889352,3575889371,19
1,1137,36538,3575889352,3575889373,21
1,1137,36539,3575889352,3575889374,22
1,1137,36540,3575889352,3575889374,22
1,1137,36541,3575889352,3575889374,22
1,1137,36542,3575889352,3575889375,23
1,1137,36543,3575889352,3575889376,24
1,1137,36544,3575889352,3575889379,27
1,1137,36545,3575889352,3575889380,28
1,1137,36546,3575889352,3575889381,29
1,1137,36547,3575889352,3575889381,29
1,1137,36548,3575889352,3575889381,29
1,1137,36549,3575889352,3575889383,31
1,1137,36550,3575889352,3575889383,31
1,1137,36551,3575889352,3575889385,33
1,1137,36552,3575889352,3575889385,33
1,1137,36553,3575889352,3575889386,34
1,1137,36554,3575889352,3575889386,34
1,1137,36555,3575889352,3575889387,35
1,1137,36556,3575889352,3575889387,35
1,1137,36557,3575889352,3575889391,39
1,1137,36558,3575889352,3575889391,39
1,1137,36559,3575889352,3575889391,39
1,1137,36560,3575889352,3575889392,40
1,1137,36561,3575889352,3575889392,40
1,1137,36562,3575889352,3575889393,41
1,1137,36563,3575889352,3575889393,41
1,1137,36564,3575889352,3575889396,44
1,1137,36565,3575889352,3575889397,45
1,1137,36566,3575889352,3575889398,46
1,1137,36567,3575889352,3575889398,46
1,1137,36568,3575889352,3575889398,46
1,1137,36569,3575889352,3575889398,46
1,1137,36570,3575889352,3575889400,48
1,1137,36571,3575889352,3575889400,48
1,1137,36572,3575889352,3575889402,50
1,1138,36573,3575889415,3575889415,0
1,1138,36574,3575889415,3575889415,0
1,1138,36575,3575889415,3575889415,0
1,1138,36576,3575889415,3575889415,0
1,1138,36577,3575889415,3575889415,0
1,1138,36578,3575889415,3575889415,0
1,1138,36579,3575889415,3575889415,0
1,1138,36580,3575889415,3575889415,0
1,1138,36581,3575889415,3575889415,0
1,1138,36582,3575889415,3575889415,0
1,1138,36583,3575889415,3575889415,0
1,1138,36584,3575889415,3575889415,0
1,1138,36585,3575889415,3575889415,0
1,1138,36586,3575889415,3575889415,0
1,1138,36587,3575889415,3575889415,0
1,1138,36588,3575889415,3575889415,0
1,1138,36589,3575889415,3575889415,0
1,1138,36590,3575889415,3575889415,0
1,1138,36591,3575889415,3575889415,0
1,1138,36592,3575889415,3575889415,0
1,1138,36593,3575889415,3575889415,0
1,1138,36594,3575889415,3575889415,0
1,1138,36595,3575889415,3575889416,1
1,1138,36596,3575889415,3575889416,1
1,1138,36597,3575889415,3575889417,2
1,1138,36598,3575889415,3575889417,2
1,1138,36599,3575889415,3575889418,3
1,1138,36600,3575889415,3575889418,3
1,1138,36601,3575889415,3575889418,3
1,1138,36602,3575889415,3575889420,5
1,1138,36603,3575889415,3575889421,6
1,1138,36604,3575889415,3575889422,7
1,1138,36605,3575889415,3575889422,7
1,1138,36606,3575889415,3575889423,8
1,1138,36607,3575889415,3575889424,9
1,1138,36608,3575889415,3575889424,9
1,1138,36609,3575889415,3575889424,9
1,1138,36610,3575889415,3575889428,13
1,1138,36611,3575889415,3575889428,13
1,1138,36612,3575889415,3575889428,13
1,1138,36613,3575889415,3575889428,13
1,1138,36614,3575889415,3575889428,13
1,1138,36615,3575889415,3575889430,15
1,1138,36616,3575889415,3575889430,15
1,1138,36617,3575889415,3575889431,16
1,1138,36618,3575889415,3575889432,17
1,1138,36619,3575889415,3575889433,18
1,1138,36620,3575889415,3575889433,18
1,1138,36621,3575889415,3575889434,19
1,1138,36622,3575889415,3575889436,21
1,1138,36623,3575889415,3575889436,21
1,1138,36624,3575889415,3575889437,22
1,1138,36625,3575889415,3575889439,24
1,1138,36626,3575889415,3575889440,25
1,1138,36627,3575889415,3575889442,27
1,1138,36628,3575889415,3575889442,27
1,1138,36629,3575889415,3575889444,29
1,1138,36630,3575889415,3575889444,29
1,1138,36631,3575889415,3575889444,29
1,1138,36632,3575889415,3575889444,29
1,1138,36633,3575889415,3575889445,30
1,1138,36634,3575889415,3575889445,30
1,1138,36635,3575889415,3575889446,31
1,1138,36636,3575889415,3575889446,31
1,1138,36637,3575889415,3575889447,32
1,1138,36638,3575889415,3575889447,32
1,1138,36639,3575889415,3575889447,32
1,1138,36640,3575889415,3575889448,33
1,1138,36641,3575889415,3575889448,33
1,1138,36642,3575889415,3575889449,34
1,1138,36643,3575889415,3575889449,34
1,1138,36644,3575889415,3575889449,34
1,1138,36645,3575889415,3575889449,34
1,1138,36646,3575889415,3575889450,35
1,1138,36647,3575889415,3575889452,37
1,1138,36648,3575889415,3575889453,38
1,1138,36649,3575889415,3575889453,38
1,1138,36650,3575889415,3575889454,39
1,1138,36651,3575889415,3575889454,39
1,1138,36652,3575889415,3575889456,41
1,1138,36653,3575889415,3575889456,41
1,1138,36654,3575889415,3575889456,41
1,1138,36655,3575889415,3575889458,43
1,1138,36656,3575889415,3575889459,44
1,1138,36657,3575889415,3575889459,44
1,1138,36658,3575889415,3575889460,45
1,1138,36659,3575889415,3575889462,47
1,1138,36660,3575889415,3575889464,49
1,1138,36661,3575889415,3575889465,50
1,1139,36662,3575889478,3575889478,0
1,1139,36663,3575889478,3575889478,0
1,1139,36664,3575889478,3575889478,0
1,1139,36665,3575889478,3575889478,0
1,1139,36666,3575889478,3575889478,0
1,1139,36667,3575889478,3575889478,0
1,1139,36668,3575889478,3575889479,1
1,1139,36669,3575889478,3575889482,4
1,1139,36670,3575889478,3575889482,4
1,1139,36671,3575889478,3575889482,4
1,1139,36672,3575889478,3575889483,5
1,1139,36673,3575889478,3575889484,6
1,1139,36674,3575889478,3575889484,6
1,1139,36675,3575889478,3575889485,7
1,1139,36676,3575889478,3575889486,8
1,1139,36677,3575889478,3575889488,10
1,1139,36678,3575889478,3575889488,10
1,1139,36679,3575889478,3575889489,11
1,1139,36680,3575889478,3575889489,11
1,1139,36681,3575889478,3575889490,12
1,1139,36682,3575889478,3575889491,13
1,1139,36683,3575889478,3575889492,14
1,1139,36684,3575889478,3575889492,14
1,1139,36685,3575889478,3575889492,14
1,1139,36686,3575889478,3575889493,15
1,1139,36687,3575889478,3575889494,16
1,1139,36688,3575889478,3575889494,16
1,1139,36689,3575889478,3575889494,16
1,1139,36690,3575889478,3575889497,19
1,1139,36691,3575889478,3575889498,20
1,1139,36692,3575889478,3575889498,20
1,1139,36693,3575889478,3575889499,21
1,1139,36694,3575889478,3575889499,21
1,1139,36695,3575889478,3575889500,22
1,1139,36696,3575889478,3575889500,22
1,1139,36697,3575889478,3575889500,22
1,1139,36698,3575889478,3575889502,24
1,1139,36699,3575889478,3575889502,24
1,1139,36700,3575889478,3575889502,24
1,1139,36701,3575889478,3575889503,25
1,1139,36702,3575889478,3575889503,25
1,1139,36703,3575889478,3575889505,27
1,1139,36704,3575889478,3575889505,27
1,1139,36705,3575889478,3575889506,28
1,1139,36706,3575889478,3575889506,28
1,1139,36707,3575889478,3575889507,29
1,1139,36708,3575889478,3575889507,29
1,1139,36709,3575889478,3575889507,29
1,1139,36710,3575889478,3575889507,29
1,1139,36711,3575889478,3575889509,31
1,1139,36712,3575889478,3575889510,32
1,1139,36713,3575889478,3575889511,33
1,1139,36714,3575889478,3575889511,33
1,1139,36715,3575889478,3575889512,34
1,1139,36716,3575889478,3575889514,36
1,1139,36717,3575889478,3575889515,37
1,1139,36718,3575889478,3575889515,37
1,1139,36719,3575889478,3575889515,37
1,1139,36720,3575889478,3575889516,38
1,1139,36721,3575889478,3575889516,38
1,1139,36722,3575889478,3575889518,40
1,1139,36723,3575889478,3575889519,41
1,1139,36724,3575889478,3575889519,41
1,1139,36725,3575889478,3575889521,43
1,1139,36726,3575889478,3575889522,44
1,1139,36727,3575889478,3575889522,44
1,1139,36728,3575889478,3575889523,45
1,1139,36729,3575889478,3575889524,46
1,1139,36730,3575889478,3575889525,47
1,1139,36731,3575889478,3575889526,48
1,1139,36732,3575889478,3575889526,48
1,1140,36733,3575889640,3575889640,0
1,1140,36734,3575889640,3575889640,0
1,1140,36735,3575889640,3575889640,0
1,1140,36736,3575889640,3575889640,0
1,1140,36737,3575889640,3575889640,0
1,1140,36738,3575889640,3575889640,0
1,1140,36739,3575889640,3575889640,0
1,1140,36740,3575889640,3575889640,0
1,1140,36741,3575889640,3575889640,0
1,1140,36742,3575889640,3575889640,0
1,1140,36743,3575889640,3575889640,0
1,1140,36744,3575889640,3575889640,0
1,1140,36745,3575889640,3575889640,0
1,1140,36746,3575889640,3575889640,0
1,1140,36747,3575889640,3575889640,0
1,1140,36748,3575889640,3575889640,0
1,1140,36749,3575889640,3575889640,0
1,1140,36750,3575889640,3575889640,0
1,1140,36751,3575889640,3575889640,0
1,1140,36752,3575889640,3575889640,0
1,1140,36753,3575889640,3575889640,0
1,1140,36754,3575889640,3575889640,0
1,1140,36755,3575889640,3575889640,0
1,1140,36756,3575889640,3575889640,0
1,1140,36757,3575889640,3575889640,0
1,1140,36758,3575889640,3575889640,0
1,1140,36759,3575889640,3575889640,0
1,1140,36760,3575889640,3575889640,0
1,1140,36761,3575889640,3575889640,0
1,1140,36762,3575889640,3575889640,0
1,1140,36763,3575889640,3575889640,0
1,1140,36764,3575889640,3575889640,0
1,1140,36765,3575889640,3575889640,0
1,1140,36766,3575889640,3575889640,0
1,1140,36767,3575889640,3575889640,0
1,1140,36768,3575889640,3575889640,0
1,1140,36769,3575889640,3575889640,0
1,1140,36770,3575889640,3575889640,0
1,1140,36771,3575889640,3575889640,0
1,1140,36772,3575889640,3575889640,0
1,1140,36773,3575889640,3575889640,0
1,1140,36774,3575889640,3575889640,0
1,1140,36775,3575889640,3575889640,0
1,1140,36776,3575889640,3575889640,0
1,1140,36777,3575889640,3575889640,0
1,1140,36778,3575889640,3575889640,0
1,1140,36779,3575889640,3575889640,0
1,1140,36780,3575889640,3575889640,0
1,1140,36781,3575889640,3575889640,0
1,1140,36782,3575889640,3575889640,0
1,1140,36783,3575889640,3575889640,0
1,1140,36784,3575889640,3575889641,1
1,1140,36785,3575889640,3575889641,1
1,1140,36786,3575889640,3575889641,1
1,1140,36787,3575889640,3575889641,1
1,1140,36788,3575889640,3575889641,1
1,1140,36789,3575889640,3575889641,1
1,1140,36790,3575889640,3575889641,1
1,1140,36791,3575889640,3575889641,1
1,1140,36792,3575889640,3575889641,1
1,1140,36793,3575889640,3575889641,1
1,1140,36794,3575889640,3575889641,1
1,1140,36795,3575889640,3575889641,1
1,1140,36796,3575889640,3575889641,1
1,1140,36797,3575889640,3575889641,1
1,1140,36798,3575889640,3575889641,1
1,1140,36799,3575889640,3575889641,1
1,1140,36800,3575889640,3575889641,1
1,1140,36801,3575889640,3575889641,1
1,1140,36802,3575889640,3575889641,1
1,1140,36803,3575889640,3575889641,1
1,1140,36804,3575889640,3575889641,1
1,1140,36805,3575889640,3575889641,1
1,1140,36806,3575889640,3575889641,1
1,1140,36807,3575889640,3575889641,1
1,1140,36808,3575889640,3575889641,1
1,1140,36809,3575889640,3575889641,1
1,1140,36810,3575889640,3575889641,1
1,1140,36811,3575889640,3575889641,1
1,1140,36812,3575889640,3575889641,1
1,1140,36813,3575889640,3575889641,1
1,1140,36814,3575889640,3575889641,1
1,1140,36815,3575889640,3575889641,1
1,1140,36816,3575889640,3575889641,1
1,1140,36817,3575889640,3575889641,1
1,1140,36818,3575889640,3575889641,1
1,1140,36819,3575889640,3575889641,1
1,1140,36820,3575889640,3575889641,1
1,1140,36821,3575889640,3575889641,1
1,1140,36822,3575889640,3575889641,1
1,1140,36823,3575889640,3575889641,1
1,1140,36824,3575889640,3575889641,1
1,1140,36825,3575889640,3575889641,1
1,1140,36826,3575889640,3575889641,1
1,1140,36827,3575889640,3575889641,1
1,1140,36828,3575889640,3575889641,1
1,1140,36829,3575889640,3575889641,1
1,1140,36830,3575889640,3575889641,1
1,1140,36831,3575889640,3575889641,1
1,1140,36832,3575889640,3575889641,1
1,1140,36833,3575889640,3575889641,1
1,1140,36834,3575889640,3575889641,1
1,1140,36835,3575889640,3575889641,1
1,1140,36836,3575889640,3575889641,1
1,1140,36837,3575889640,3575889641,1
1,1140,36838,3575889640,3575889641,1
1,1140,36839,3575889640,3575889641,1
1,1140,36840,3575889640,3575889641,1
1,1140,36841,3575889640,3575889641,1
1,1140,36842,3575889640,3575889641,1
1,1140,36843,3575889640,3575889641,1
1,1140,36844,3575889640,3575889641,1
1,1140,36845,3575889640,3575889641,1
1,1140,36846,3575889640,3575889641,1
1,1140,36847,3575889640,3575889641,1
1,1140,36848,3575889640,3575889641,1
1,1140,36849,3575889640,3575889641,1
1,1140,36850,3575889640,3575889641,1
1,1140,36851,3575889640,3575889641,1
1,1140,36852,3575889640,3575889641,1
1,1140,36853,3575889640,3575889641,1
1,1140,36854,3575889640,3575889641,1
1,1140,36855,3575889640,3575889641,1
1,1140,36856,3575889640,3575889641,1
1,1140,36857,3575889640,3575889641,1
1,1140,36858,3575889640,3575889641,1
1,1140,36859,3575889640,3575889641,1
1,1140,36860,3575889640,3575889641,1
1,1140,36861,3575889640,3575889641,1
1,1140,36862,3575889640,3575889641,1
1,1140,36863,3575889640,3575889641,1
1,1140,36864,3575889640,3575889641,1
1,1140,36865,3575889640,3575889641,1
1,1140,36866,3575889640,3575889641,1
1,1140,36867,3575889640,3575889641,1
1,1140,36868,3575889640,3575889641,1
1,1140,36869,3575889640,3575889641,1
1,1140,36870,3575889640,3575889641,1
1,1140,36871,3575889640,3575889641,1
1,1140,36872,3575889640,3575889641,1
1,1140,36873,3575889640,3575889643,3
1,1140,36874,3575889640,3575889643,3
1,1140,36875,3575889640,3575889644,4
1,1140,36876,3575889640,3575889644,4
1,1140,36877,3575889640,3575889644,4
1,1140,36878,3575889640,3575889644,4
1,1140,36879,3575889640,3575889645,5
1,1140,36880,3575889640,3575889646,6
1,1140,36881,3575889640,3575889646,6
1,1140,36882,3575889640,3575889646,6
1,1140,36883,3575889640,3575889646,6
1,1140,36884,3575889640,3575889647,7
1,1140,36885,3575889640,3575889648,8
1,1140,36886,3575889640,3575889648,8
1,1140,36887,3575889640,3575889648,8
1,1140,36888,3575889640,3575889649,9
1,1140,36889,3575889640,3575889649,9
1,1140,36890,3575889640,3575889650,10
1,1140,36891,3575889640,3575889651,11
1,1140,36892,3575889640,3575889652,12
1,1140,36893,3575889640,3575889653,13
1,1140,36894,3575889640,3575889653,13
1,1140,36895,3575889640,3575889653,13
1,1140,36896,3575889640,3575889655,15
1,1140,36897,3575889640,3575889655,15
1,1140,36898,3575889640,3575889656,16
1,1140,36899,3575889640,3575889657,17
1,1140,36900,3575889640,3575889658,18
1,1140,36901,3575889640,3575889658,18
1,1140,36902,3575889640,3575889660,20
1,1140,36903,3575889640,3575889662,22
1,1140,36904,3575889640,3575889663,23
1,1140,36905,3575889640,3575889665,25
1,1140,36906,3575889640,3575889665,25
1,1140,36907,3575889640,3575889665,25
1,1140,36908,3575889640,3575889667,27
1,1140,36909,3575889640,3575889668,28
1,1140,36910,3575889640,3575889669,29
1,1140,36911,3575889640,3575889670,30
1,1140,36912,3575889640,3575889679,39
1,1140,36913,3575889640,3575889680,40
1,1140,36914,3575889640,3575889681,41
1,1140,36915,3575889640,3575889682,42
1,1140,36916,3575889640,3575889684,44
1,1140,36917,3575889640,3575889684,44
1,1140,36918,3575889640,3575889685,45
1,1140,36919,3575889640,3575889686,46
1,1140,36920,3575889640,3575889688,48
1,1140,36921,3575889640,3575889688,48
1,1140,36922,3575889640,3575889688,48
1,1140,36923,3575889640,3575889688,48
1,1140,36924,3575889640,3575889689,49
1,1140,36925,3575889640,3575889690,50
1,1141,36926,3575889702,3575889702,0
1,1141,36927,3575889702,3575889702,0
1,1141,36928,3575889702,3575889702,0
1,1141,36929,3575889702,3575889702,0
1,1141,36930,3575889702,3575889702,0
1,1141,36931,3575889702,3575889702,0
1,1141,36932,3575889702,3575889702,0
1,1141,36933,3575889702,3575889702,0
1,1141,36934,3575889702,3575889702,0
1,1141,36935,3575889702,3575889702,0
1,1141,36936,3575889702,3575889702,0
1,1141,36937,3575889702,3575889702,0
1,1141,36938,3575889702,3575889702,0
1,1141,36939,3575889702,3575889702,0
1,1141,36940,3575889702,3575889702,0
1,1141,36941,3575889702,3575889702,0
1,1141,36942,3575889702,3575889703,1
1,1141,36943,3575889702,3575889703,1
1,1141,36944,3575889702,3575889703,1
1,1141,36945,3575889702,3575889705,3
1,1141,36946,3575889702,3575889705,3
1,1141,36947,3575889702,3575889705,3
1,1141,36948,3575889702,3575889705,3
1,1141,36949,3575889702,3575889706,4
1,1141,36950,3575889702,3575889706,4
1,1141,36951,3575889702,3575889707,5
1,1141,36952,3575889702,3575889709,7
1,1141,36953,3575889702,3575889710,8
1,1141,36954,3575889702,3575889711,9
1,1141,36955,3575889702,3575889712,10
1,1141,36956,3575889702,3575889713,11
1,1141,36957,3575889702,3575889714,12
1,1141,36958,3575889702,3575889715,13
1,1141,36959,3575889702,3575889715,13
1,1141,36960,3575889702,3575889716,14
1,1141,36961,3575889702,3575889716,14
1,1141,36962,3575889702,3575889716,14
1,1141,36963,3575889702,3575889718,16
1,1141,36964,3575889702,3575889719,17
1,1141,36965,3575889702,3575889719,17
1,1141,36966,3575889702,3575889721,19
1,1141,36967,3575889702,3575889722,20
1,1141,36968,3575889702,3575889722,20
1,1141,36969,3575889702,3575889722,20
1,1141,36970,3575889702,3575889724,22
1,1141,36971,3575889702,3575889725,23
1,1141,36972,3575889702,3575889728,26
1,1141,36973,3575889702,3575889729,27
1,1141,36974,3575889702,3575889729,27
1,1141,36975,3575889702,3575889729,27
1,1141,36976,3575889702,3575889730,28
1,1141,36977,3575889702,3575889730,28
1,1141,36978,3575889702,3575889731,29
1,1141,36979,3575889702,3575889731,29
1,1141,36980,3575889702,3575889731,29
1,1141,36981,3575889702,3575889732,30
1,1141,36982,3575889702,3575889732,30
1,1141,36983,3575889702,3575889732,30
1,1141,36984,3575889702,3575889734,32
1,1141,36985,3575889702,3575889735,33
1,1141,36986,3575889702,3575889735,33
1,1141,36987,3575889702,3575889739,37
1,1141,36988,3575889702,3575889741,39
1,1141,36989,3575889702,3575889743,41
1,1141,36990,3575889702,3575889743,41
1,1141,36991,3575889702,3575889746,44
1,1141,36992,3575889702,3575889747,45
1,1141,36993,3575889702,3575889748,46
1,1141,36994,3575889702,3575889749,47
1,1141,36995,3575889702,3575889749,47
1,1141,36996,3575889702,3575889749,47
1,1141,36997,3575889702,3575889749,47
1,1141,36998,3575889702,3575889751,49
1,1141,36999,3575889702,3575889752,50
1,1142,37000,3575889769,3575889769,0
1,1142,37001,3575889769,3575889769,0
1,1142,37002,3575889769,3575889769,0
1,1142,37003,3575889769,3575889769,0
1,1142,37004,3575889769,3575889769,0
1,1142,37005,3575889769,3575889769,0
1,1142,37006,3575889769,3575889769,0
1,1142,37007,3575889769,3575889769,0
1,1142,37008,3575889769,3575889769,0
1,1142,37009,3575889769,3575889769,0
1,1142,37010,3575889769,3575889769,0
1,1142,37011,3575889769,3575889769,0
1,1142,37012,3575889769,3575889769,0
1,1142,37013,3575889769,3575889769,0
1,1142,37014,3575889769,3575889769,0
1,1142,37015,3575889769,3575889769,0
1,1142,37016,3575889769,3575889769,0
1,1142,37017,3575889769,3575889769,0
1,1142,37018,3575889769,3575889769,0
1,1142,37019,3575889769,3575889769,0
1,1142,37020,3575889769,3575889769,0
1,1142,37021,3575889769,3575889770,1
1,1142,37022,3575889769,3575889772,3
1,1142,37023,3575889769,3575889772,3
1,1142,37024,3575889769,3575889774,5
1,1142,37025,3575889769,3575889774,5
1,1142,37026,3575889769,3575889775,6
1,1142,37027,3575889769,3575889775,6
1,1142,37028,3575889769,3575889776,7
1,1142,37029,3575889769,3575889778,9
1,1142,37030,3575889769,3575889779,10
1,1142,37031,3575889769,3575889780,11
1,1142,37032,3575889769,3575889780,11
1,1142,37033,3575889769,3575889781,12
1,1142,37034,3575889769,3575889781,12
1,1142,37035,3575889769,3575889782,13
1,1142,37036,3575889769,3575889782,13
1,1142,37037,3575889769,3575889783,14
1,1142,37038,3575889769,3575889783,14
1,1142,37039,3575889769,3575889784,15
1,1142,37040,3575889769,3575889784,15
1,1142,37041,3575889769,3575889786,17
1,1142,37042,3575889769,3575889786,17
1,1142,37043,3575889769,3575889787,18
1,1142,37044,3575889769,3575889790,21
1,1142,37045,3575889769,3575889790,21
1,1142,37046,3575889769,3575889791,22
1,1142,37047,3575889769,3575889791,22
1,1142,37048,3575889769,3575889792,23
1,1142,37049,3575889769,3575889792,23
1,1142,37050,3575889769,3575889792,23
1,1142,37051,3575889769,3575889792,23
1,1142,37052,3575889769,3575889795,26
1,1142,37053,3575889769,3575889796,27
1,1142,37054,3575889769,3575889796,27
1,1142,37055,3575889769,3575889796,27
1,1142,37056,3575889769,3575889798,29
1,1142,37057,3575889769,3575889798,29
1,1142,37058,3575889769,3575889799,30
1,1142,37059,3575889769,3575889800,31
1,1142,37060,3575889769,3575889801,32
1,1142,37061,3575889769,3575889801,32
1,1142,37062,3575889769,3575889801,32
1,1142,37063,3575889769,3575889802,33
1,1142,37064,3575889769,3575889804,35
1,1142,37065,3575889769,3575889804,35
1,1142,37066,3575889769,3575889804,35
1,1142,37067,3575889769,3575889805,36
1,1142,37068,3575889769,3575889806,37
1,1142,37069,3575889769,3575889806,37
1,1142,37070,3575889769,3575889807,38
1,1142,37071,3575889769,3575889809,40
1,1142,37072,3575889769,3575889809,40
1,1142,37073,3575889769,3575889809,40
1,1142,37074,3575889769,3575889810,41
1,1142,37075,3575889769,3575889810,41
1,1142,37076,3575889769,3575889812,43
1,1142,37077,3575889769,3575889812,43
1,1142,37078,3575889769,3575889813,44
1,1142,37079,3575889769,3575889813,44
1,1142,37080,3575889769,3575889814,45
1,1142,37081,3575889769,3575889814,45
1,1142,37082,3575889769,3575889815,46
1,1142,37083,3575889769,3575889815,46
1,1142,37084,3575889769,3575889816,47
1,1142,37085,3575889769,3575889816,47
1,1142,37086,3575889769,3575889817,48
1,1142,37087,3575889769,3575889818,49
1,1142,37088,3575889769,3575889818,49
1,1142,37089,3575889769,3575889819,50
1,1143,37090,3575889831,3575889831,0
1,1143,37091,3575889831,3575889831,0
1,1143,37092,3575889831,3575889831,0
1,1143,37093,3575889831,3575889831,0
1,1143,37094,3575889831,3575889831,0
1,1143,37095,3575889831,3575889831,0
1,1143,37096,3575889831,3575889831,0
1,1143,37097,3575889831,3575889831,0
1,1143,37098,3575889831,3575889831,0
1,1143,37099,3575889831,3575889831,0
1,1143,37100,3575889831,3575889831,0
1,1143,37101,3575889831,3575889831,0
1,1143,37102,3575889831,3575889831,0
1,1143,37103,3575889831,3575889831,0
1,1143,37104,3575889831,3575889831,0
1,1143,37105,3575889831,3575889832,1
1,1143,37106,3575889831,3575889832,1
1,1143,37107,3575889831,3575889832,1
1,1143,37108,3575889831,3575889833,2
1,1143,37109,3575889831,3575889834,3
1,1143,37110,3575889831,3575889835,4
1,1143,37111,3575889831,3575889835,4
1,1143,37112,3575889831,3575889837,6
1,1143,37113,3575889831,3575889838,7
1,1143,37114,3575889831,3575889839,8
1,1143,37115,3575889831,3575889841,10
1,1143,37116,3575889831,3575889843,12
1,1143,37117,3575889831,3575889843,12
1,1143,37118,3575889831,3575889843,12
1,1143,37119,3575889831,3575889844,13
1,1143,37120,3575889831,3575889844,13
1,1143,37121,3575889831,3575889844,13
1,1143,37122,3575889831,3575889845,14
1,1143,37123,3575889831,3575889846,15
1,1143,37124,3575889831,3575889846,15
1,1143,37125,3575889831,3575889847,16
1,1143,37126,3575889831,3575889847,16
1,1143,37127,3575889831,3575889848,17
1,1143,37128,3575889831,3575889848,17
1,1143,37129,3575889831,3575889848,17
1,1143,37130,3575889831,3575889849,18
1,1143,37131,3575889831,3575889849,18
1,1143,37132,3575889831,3575889849,18
1,1143,37133,3575889831,3575889850,19
1,1143,37134,3575889831,3575889852,21
1,1143,37135,3575889831,3575889853,22
1,1143,37136,3575889831,3575889853,22
1,1143,37137,3575889831,3575889854,23
1,1143,37138,3575889831,3575889854,23
1,1143,37139,3575889831,3575889855,24
1,1143,37140,3575889831,3575889855,24
1,1143,37141,3575889831,3575889856,25
1,1143,37142,3575889831,3575889858,27
1,1143,37143,3575889831,3575889858,27
1,1143,37144,3575889831,3575889858,27
1,1143,37145,3575889831,3575889862,31
1,1143,37146,3575889831,3575889863,32
1,1143,37147,3575889831,3575889865,34
1,1143,37148,3575889831,3575889865,34
1,1143,37149,3575889831,3575889868,37
1,1143,37150,3575889831,3575889868,37
1,1143,37151,3575889831,3575889869,38
1,1143,37152,3575889831,3575889870,39
1,1143,37153,3575889831,3575889879,48
1,1143,37154,3575889831,3575889880,49
1,1144,37155,3575889898,3575889898,0
1,1144,37156,3575889898,3575889898,0
1,1144,37157,3575889898,3575889898,0
1,1144,37158,3575889898,3575889898,0
1,1144,37159,3575889898,3575889898,0
1,1144,37160,3575889898,3575889898,0
1,1144,37161,3575889898,3575889898,0
1,1144,37162,3575889898,3575889898,0
1,1144,37163,3575889898,3575889898,0
1,1144,37164,3575889898,3575889898,0
1,1144,37165,3575889898,3575889898,0
1,1144,37166,3575889898,3575889898,0
1,1144,37167,3575889898,3575889898,0
1,1144,37168,3575889898,3575889898,0
1,1144,37169,3575889898,3575889898,0
1,1144,37170,3575889898,3575889898,0
1,1144,37171,3575889898,3575889898,0
1,1144,37172,3575889898,3575889898,0
1,1144,37173,3575889898,3575889898,0
1,1144,37174,3575889898,3575889898,0
1,1144,37175,3575889898,3575889898,0
1,1144,37176,3575889898,3575889898,0
1,1144,37177,3575889898,3575889898,0
1,1144,37178,3575889898,3575889898,0
1,1144,37179,3575889898,3575889898,0
1,1144,37180,3575889898,3575889899,1
1,1144,37181,3575889898,3575889900,2
1,1144,37182,3575889898,3575889901,3
1,1144,37183,3575889898,3575889902,4
1,1144,37184,3575889898,3575889902,4
1,1144,37185,3575889898,3575889902,4
1,1144,37186,3575889898,3575889903,5
1,1144,37187,3575889898,3575889903,5
1,1144,37188,3575889898,3575889905,7
1,1144,37189,3575889898,3575889905,7
1,1144,37190,3575889898,3575889906,8
1,1144,37191,3575889898,3575889906,8
1,1144,37192,3575889898,3575889906,8
1,1144,37193,3575889898,3575889906,8
1,1144,37194,3575889898,3575889907,9
1,1144,37195,3575889898,3575889909,11
1,1144,37196,3575889898,3575889911,13
1,1144,37197,3575889898,3575889911,13
1,1144,37198,3575889898,3575889912,14
1,1144,37199,3575889898,3575889913,15
1,1144,37200,3575889898,3575889914,16
1,1144,37201,3575889898,3575889914,16
1,1144,37202,3575889898,3575889915,17
1,1144,37203,3575889898,3575889915,17
1,1144,37204,3575889898,3575889915,17
1,1144,37205,3575889898,3575889916,18
1,1144,37206,3575889898,3575889916,18
1,1144,37207,3575889898,3575889919,21
1,1144,37208,3575889898,3575889919,21
1,1144,37209,3575889898,3575889919,21
1,1144,37210,3575889898,3575889922,24
1,1144,37211,3575889898,3575889922,24
1,1144,37212,3575889898,3575889923,25
1,1144,37213,3575889898,3575889924,26
1,1144,37214,3575889898,3575889926,28
1,1144,37215,3575889898,3575889926,28
1,1144,37216,3575889898,3575889928,30
1,1144,37217,3575889898,3575889929,31
1,1144,37218,3575889898,3575889929,31
1,1144,37219,3575889898,3575889930,32
1,1144,37220,3575889898,3575889931,33
1,1144,37221,3575889898,3575889931,33
1,1144,37222,3575889898,3575889931,33
1,1144,37223,3575889898,3575889931,33
1,1144,37224,3575889898,3575889932,34
1,1144,37225,3575889898,3575889932,34
1,1144,37226,3575889898,3575889933,35
1,1144,37227,3575889898,3575889933,35
1,1144,37228,3575889898,3575889935,37
1,1144,37229,3575889898,3575889935,37
1,1144,37230,3575889898,3575889941,43
1,1144,37231,3575889898,3575889943,45
1,1144,37232,3575889898,3575889944,46
1,1144,37233,3575889898,3575889946,48
1,1144,37234,3575889898,3575889947,49
1,1144,37235,3575889898,3575889948,50
1,1145,37236,3575889961,3575889961,0
1,1145,37237,3575889961,3575889961,0
1,1145,37238,3575889961,3575889961,0
1,1145,37239,3575889961,3575889961,0
1,1145,37240,3575889961,3575889961,0
1,1145,37241,3575889961,3575889961,0
1,1145,37242,3575889961,3575889961,0
1,1145,37243,3575889961,3575889961,0
1,1145,37244,3575889961,3575889961,0
1,1145,37245,3575889961,3575889961,0
1,1145,37246,3575889961,3575889961,0
1,1145,37247,3575889961,3575889961,0
1,1145,37248,3575889961,3575889961,0
1,1145,37249,3575889961,3575889961,0
1,1145,37250,3575889961,3575889961,0
1,1145,37251,3575889961,3575889961,0
1,1145,37252,3575889961,3575889961,0
1,1145,37253,3575889961,3575889962,1
1,1145,37254,3575889961,3575889962,1
1,1145,37255,3575889961,3575889963,2
1,1145,37256,3575889961,3575889963,2
1,1145,37257,3575889961,3575889964,3
1,1145,37258,3575889961,3575889965,4
1,1145,37259,3575889961,3575889965,4
1,1145,37260,3575889961,3575889969,8
1,1145,37261,3575889961,3575889970,9
1,1145,37262,3575889961,3575889972,11
1,1145,37263,3575889961,3575889973,12
1,1145,37264,3575889961,3575889974,13
1,1145,37265,3575889961,3575889975,14
1,1145,37266,3575889961,3575889975,14
1,1145,37267,3575889961,3575889975,14
1,1145,37268,3575889961,3575889975,14
1,1145,37269,3575889961,3575889976,15
1,1145,37270,3575889961,3575889978,17
1,1145,37271,3575889961,3575889978,17
1,1145,37272,3575889961,3575889980,19
1,1145,37273,3575889961,3575889980,19
1,1145,37274,3575889961,3575889981,20
1,1145,37275,3575889961,3575889982,21
1,1145,37276,3575889961,3575889982,21
1,1145,37277,3575889961,3575889982,21
1,1145,37278,3575889961,3575889983,22
1,1145,37279,3575889961,3575889984,23
1,1145,37280,3575889961,3575889984,23
1,1145,37281,3575889961,3575889985,24
1,1145,37282,3575889961,3575889986,25
1,1145,37283,3575889961,3575889986,25
1,1145,37284,3575889961,3575889987,26
1,1145,37285,3575889961,3575889990,29
1,1145,37286,3575889961,3575889991,30
1,1145,37287,3575889961,3575889991,30
1,1145,37288,3575889961,3575889991,30
1,1145,37289,3575889961,3575889992,31
1,1145,37290,3575889961,3575889992,31
1,1145,37291,3575889961,3575889992,31
1,1145,37292,3575889961,3575889993,32
1,1145,37293,3575889961,3575889996,35
1,1145,37294,3575889961,3575889996,35
1,1145,37295,3575889961,3575889996,35
1,1145,37296,3575889961,3575889997,36
1,1145,37297,3575889961,3575889998,37
1,1145,37298,3575889961,3575889998,37
1,1145,37299,3575889961,3575890000,39
1,1145,37300,3575889961,3575890001,40
1,1145,37301,3575889961,3575890002,41
1,1145,37302,3575889961,3575890002,41
1,1145,37303,3575889961,3575890002,41
1,1145,37304,3575889961,3575890002,41
1,1145,37305,3575889961,3575890004,43
1,1145,37306,3575889961,3575890004,43
1,1145,37307,3575889961,3575890005,44
1,1145,37308,3575889961,3575890006,45
1,1145,37309,3575889961,3575890006,45
1,1145,37310,3575889961,3575890007,46
1,1145,37311,3575889961,3575890007,46
1,1145,37312,3575889961,3575890009,48
1,1145,37313,3575889961,3575890009,48
1,1145,37314,3575889961,3575890010,49
1,1145,37315,3575889961,3575890010,49
1,1145,37316,3575889961,3575890011,50
1,1146,37317,3575890025,3575890025,0
1,1146,37318,3575890025,3575890025,0
1,1146,37319,3575890025,3575890025,0
1,1146,37320,3575890025,3575890025,0
1,1146,37321,3575890025,3575890025,0
1,1146,37322,3575890025,3575890025,0
1,1146,37323,3575890025,3575890025,0
1,1146,37324,3575890025,3575890025,0
1,1146,37325,3575890025,3575890025,0
1,1146,37326,3575890025,3575890025,0
1,1146,37327,3575890025,3575890025,0
1,1146,37328,3575890025,3575890025,0
1,1146,37329,3575890025,3575890025,0
1,1146,37330,3575890025,3575890025,0
1,1146,37331,3575890025,3575890025,0
1,1146,37332,3575890025,3575890025,0
1,1146,37333,3575890025,3575890025,0
1,1146,37334,3575890025,3575890025,0
1,1146,37335,3575890025,3575890025,0
1,1146,37336,3575890025,3575890025,0
1,1146,37337,3575890025,3575890025,0
1,1146,37338,3575890025,3575890025,0
1,1146,37339,3575890025,3575890025,0
1,1146,37340,3575890025,3575890026,1
1,1146,37341,3575890025,3575890027,2
1,1146,37342,3575890025,3575890028,3
1,1146,37343,3575890025,3575890029,4
1,1146,37344,3575890025,3575890029,4
1,1146,37345,3575890025,3575890030,5
1,1146,37346,3575890025,3575890032,7
1,1146,37347,3575890025,3575890032,7
1,1146,37348,3575890025,3575890032,7
1,1146,37349,3575890025,3575890033,8
1,1146,37350,3575890025,3575890034,9
1,1146,37351,3575890025,3575890035,10
1,1146,37352,3575890025,3575890035,10
1,1146,37353,3575890025,3575890038,13
1,1146,37354,3575890025,3575890038,13
1,1146,37355,3575890025,3575890039,14
1,1146,37356,3575890025,3575890042,17
1,1146,37357,3575890025,3575890043,18
1,1146,37358,3575890025,3575890043,18
1,1146,37359,3575890025,3575890044,19
1,1146,37360,3575890025,3575890044,19
1,1146,37361,3575890025,3575890044,19
1,1146,37362,3575890025,3575890045,20
1,1146,37363,3575890025,3575890045,20
1,1146,37364,3575890025,3575890045,20
1,1146,37365,3575890025,3575890046,21
1,1146,37366,3575890025,3575890046,21
1,1146,37367,3575890025,3575890047,22
1,1146,37368,3575890025,3575890047,22
1,1146,37369,3575890025,3575890048,23
1,1146,37370,3575890025,3575890048,23
1,1146,37371,3575890025,3575890049,24
1,1146,37372,3575890025,3575890049,24
1,1146,37373,3575890025,3575890049,24
1,1146,37374,3575890025,3575890049,24
1,1146,37375,3575890025,3575890050,25
1,1146,37376,3575890025,3575890052,27
1,1146,37377,3575890025,3575890053,28
1,1146,37378,3575890025,3575890053,28
1,1146,37379,3575890025,3575890054,29
1,1146,37380,3575890025,3575890054,29
1,1146,37381,3575890025,3575890055,30
1,1146,37382,3575890025,3575890055,30
1,1146,37383,3575890025,3575890056,31
1,1146,37384,3575890025,3575890057,32
1,1146,37385,3575890025,3575890058,33
1,1146,37386,3575890025,3575890058,33
1,1146,37387,3575890025,3575890062,37
1,1146,37388,3575890025,3575890063,38
1,1146,37389,3575890025,3575890064,39
1,1146,37390,3575890025,3575890065,40
1,1146,37391,3575890025,3575890066,41
1,1146,37392,3575890025,3575890067,42
1,1146,37393,3575890025,3575890068,43
1,1146,37394,3575890025,3575890068,43
1,1146,37395,3575890025,3575890070,45
1,1147,37396,3575890089,3575890089,0
1,1147,37397,3575890089,3575890089,0
1,1147,37398,3575890089,3575890089,0
1,1147,37399,3575890089,3575890089,0
1,1147,37400,3575890089,3575890089,0
1,1147,37401,3575890089,3575890089,0
1,1147,37402,3575890089,3575890089,0
1,1147,37403,3575890089,3575890089,0
1,1147,37404,3575890089,3575890089,0
1,1147,37405,3575890089,3575890089,0
1,1147,37406,3575890089,3575890089,0
1,1147,37407,3575890089,3575890089,0
1,1147,37408,3575890089,3575890089,0
1,1147,37409,3575890089,3575890090,1
1,1147,37410,3575890089,3575890090,1
1,1147,37411,3575890089,3575890091,2
1,1147,37412,3575890089,3575890091,2
1,1147,37413,3575890089,3575890092,3
1,1147,37414,3575890089,3575890092,3
1,1147,37415,3575890089,3575890093,4
1,1147,37416,3575890089,3575890093,4
1,1147,37417,3575890089,3575890094,5
1,1147,37418,3575890089,3575890094,5
1,1147,37419,3575890089,3575890094,5
1,1147,37420,3575890089,3575890097,8
1,1147,37421,3575890089,3575890098,9
1,1147,37422,3575890089,3575890099,10
1,1147,37423,3575890089,3575890099,10
1,1147,37424,3575890089,3575890099,10
1,1147,37425,3575890089,3575890099,10
1,1147,37426,3575890089,3575890100,11
1,1147,37427,3575890089,3575890101,12
1,1147,37428,3575890089,3575890101,12
1,1147,37429,3575890089,3575890102,13
1,1147,37430,3575890089,3575890102,13
1,1147,37431,3575890089,3575890102,13
1,1147,37432,3575890089,3575890103,14
1,1147,37433,3575890089,3575890103,14
1,1147,37434,3575890089,3575890105,16
1,1147,37435,3575890089,3575890105,16
1,1147,37436,3575890089,3575890106,17
1,1147,37437,3575890089,3575890106,17
1,1147,37438,3575890089,3575890107,18
1,1147,37439,3575890089,3575890107,18
1,1147,37440,3575890089,3575890107,18
1,1147,37441,3575890089,3575890110,21
1,1147,37442,3575890089,3575890110,21
1,1147,37443,3575890089,3575890111,22
1,1147,37444,3575890089,3575890112,23
1,1147,37445,3575890089,3575890113,24
1,1147,37446,3575890089,3575890113,24
1,1147,37447,3575890089,3575890114,25
1,1147,37448,3575890089,3575890115,26
1,1147,37449,3575890089,3575890115,26
1,1147,37450,3575890089,3575890116,27
1,1147,37451,3575890089,3575890116,27
1,1147,37452,3575890089,3575890117,28
1,1147,37453,3575890089,3575890118,29
1,1147,37454,3575890089,3575890119,30
1,1147,37455,3575890089,3575890119,30
1,1147,37456,3575890089,3575890122,33
1,1147,37457,3575890089,3575890122,33
1,1147,37458,3575890089,3575890123,34
1,1147,37459,3575890089,3575890123,34
1,1147,37460,3575890089,3575890123,34
1,1147,37461,3575890089,3575890124,35
1,1147,37462,3575890089,3575890126,37
1,1147,37463,3575890089,3575890126,37
1,1147,37464,3575890089,3575890129,40
1,1147,37465,3575890089,3575890129,40
1,1147,37466,3575890089,3575890129,40
1,1147,37467,3575890089,3575890130,41
1,1147,37468,3575890089,3575890130,41
1,1147,37469,3575890089,3575890130,41
1,1147,37470,3575890089,3575890131,42
1,1147,37471,3575890089,3575890131,42
1,1147,37472,3575890089,3575890132,43
1,1147,37473,3575890089,3575890132,43
1,1147,37474,3575890089,3575890134,45
1,1147,37475,3575890089,3575890135,46
1,1147,37476,3575890089,3575890135,46
1,1147,37477,3575890089,3575890136,47
1,1148,37478,3575890151,3575890151,0
1,1148,37479,3575890151,3575890151,0
1,1148,37480,3575890151,3575890151,0
1,1148,37481,3575890151,3575890151,0
1,1148,37482,3575890151,3575890151,0
1,1148,37483,3575890151,3575890151,0
1,1148,37484,3575890151,3575890151,0
1,1148,37485,3575890151,3575890151,0
1,1148,37486,3575890151,3575890151,0
1,1148,37487,3575890151,3575890151,0
1,1148,37488,3575890151,3575890151,0
1,1148,37489,3575890151,3575890151,0
1,1148,37490,3575890151,3575890152,1
1,1148,37491,3575890151,3575890153,2
1,1148,37492,3575890151,3575890154,3
1,1148,37493,3575890151,3575890154,3
1,1148,37494,3575890151,3575890155,4
1,1148,37495,3575890151,3575890156,5
1,1148,37496,3575890151,3575890156,5
1,1148,37497,3575890151,3575890157,6
1,1148,37498,3575890151,3575890158,7
1,1148,37499,3575890151,3575890159,8
1,1148,37500,3575890151,3575890160,9
1,1148,37501,3575890151,3575890160,9
1,1148,37502,3575890151,3575890161,10
1,1148,37503,3575890151,3575890163,12
1,1148,37504,3575890151,3575890163,12
1,1148,37505,3575890151,3575890163,12
1,1148,37506,3575890151,3575890163,12
1,1148,37507,3575890151,3575890164,13
1,1148,37508,3575890151,3575890165,14
1,1148,37509,3575890151,3575890165,14
1,1148,37510,3575890151,3575890168,17
1,1148,37511,3575890151,3575890170,19
1,1148,37512,3575890151,3575890171,20
1,1148,37513,3575890151,3575890173,22
1,1148,37514,3575890151,3575890173,22
1,1148,37515,3575890151,3575890174,23
1,1148,37516,3575890151,3575890174,23
1,1148,37517,3575890151,3575890175,24
1,1148,37518,3575890151,3575890175,24
1,1148,37519,3575890151,3575890175,24
1,1148,37520,3575890151,3575890178,27
1,1148,37521,3575890151,3575890179,28
1,1148,37522,3575890151,3575890180,29
1,1148,37523,3575890151,3575890180,29
1,1148,37524,3575890151,3575890181,30
1,1148,37525,3575890151,3575890182,31
1,1148,37526,3575890151,3575890182,31
1,1148,37527,3575890151,3575890183,32
1,1148,37528,3575890151,3575890184,33
1,1148,37529,3575890151,3575890184,33
1,1148,37530,3575890151,3575890186,35
1,1148,37531,3575890151,3575890186,35
1,1148,37532,3575890151,3575890186,35
1,1148,37533,3575890151,3575890187,36
1,1148,37534,3575890151,3575890190,39
1,1148,37535,3575890151,3575890191,40
1,1148,37536,3575890151,3575890191,40
1,1148,37537,3575890151,3575890191,40
1,1148,37538,3575890151,3575890192,41
1,1148,37539,3575890151,3575890192,41
1,1148,37540,3575890151,3575890192,41
1,1148,37541,3575890151,3575890193,42
1,1148,37542,3575890151,3575890193,42
1,1148,37543,3575890151,3575890196,45
1,1148,37544,3575890151,3575890196,45
1,1148,37545,3575890151,3575890196,45
1,1148,37546,3575890151,3575890198,47
1,1148,37547,3575890151,3575890198,47
1,1148,37548,3575890151,3575890199,48
1,1148,37549,3575890151,3575890201,50
1,1149,37550,3575890215,3575890215,0
1,1149,37551,3575890215,3575890215,0
1,1149,37552,3575890215,3575890215,0
1,1149,37553,3575890215,3575890216,1
1,1149,37554,3575890215,3575890216,1
1,1149,37555,3575890215,3575890216,1
1,1149,37556,3575890215,3575890216,1
1,1149,37557,3575890215,3575890216,1
1,1149,37558,3575890215,3575890216,1
1,1149,37559,3575890215,3575890216,1
1,1149,37560,3575890215,3575890216,1
1,1149,37561,3575890215,3575890216,1
1,1149,37562,3575890215,3575890216,1
1,1149,37563,3575890215,3575890216,1
1,1149,37564,3575890215,3575890216,1
1,1149,37565,3575890215,3575890216,1
1,1149,37566,3575890215,3575890216,1
1,1149,37567,3575890215,3575890216,1
1,1149,37568,3575890215,3575890216,1
1,1149,37569,3575890215,3575890216,1
1,1149,37570,3575890215,3575890216,1
1,1149,37571,3575890215,3575890216,1
1,1149,37572,3575890215,3575890216,1
1,1149,37573,3575890215,3575890217,2
1,1149,37574,3575890215,3575890217,2
1,1149,37575,3575890215,3575890217,2
1,1149,37576,3575890215,3575890218,3
1,1149,37577,3575890215,3575890218,3
1,1149,37578,3575890215,3575890220,5
1,1149,37579,3575890215,3575890222,7
1,1149,37580,3575890215,3575890223,8
1,1149,37581,3575890215,3575890224,9
1,1149,37582,3575890215,3575890224,9
1,1149,37583,3575890215,3575890224,9
1,1149,37584,3575890215,3575890225,10
1,1149,37585,3575890215,3575890227,12
1,1149,37586,3575890215,3575890228,13
1,1149,37587,3575890215,3575890228,13
1,1149,37588,3575890215,3575890229,14
1,1149,37589,3575890215,3575890229,14
1,1149,37590,3575890215,3575890229,14
1,1149,37591,3575890215,3575890231,16
1,1149,37592,3575890215,3575890232,17
1,1149,37593,3575890215,3575890232,17
1,1149,37594,3575890215,3575890233,18
1,1149,37595,3575890215,3575890235,20
1,1149,37596,3575890215,3575890235,20
1,1149,37597,3575890215,3575890235,20
1,1149,37598,3575890215,3575890237,22
1,1149,37599,3575890215,3575890238,23
1,1149,37600,3575890215,3575890238,23
1,1149,37601,3575890215,3575890242,27
1,1149,37602,3575890215,3575890243,28
1,1149,37603,3575890215,3575890244,29
1,1149,37604,3575890215,3575890244,29
1,1149,37605,3575890215,3575890245,30
1,1149,37606,3575890215,3575890245,30
1,1149,37607,3575890215,3575890246,31
1,1149,37608,3575890215,3575890246,31
1,1149,37609,3575890215,3575890246,31
1,1149,37610,3575890215,3575890248,33
1,1149,37611,3575890215,3575890248,33
1,1149,37612,3575890215,3575890248,33
1,1149,37613,3575890215,3575890249,34
1,1149,37614,3575890215,3575890249,34
1,1149,37615,3575890215,3575890250,35
1,1149,37616,3575890215,3575890250,35
1,1149,37617,3575890215,3575890250,35
1,1149,37618,3575890215,3575890252,37
1,1149,37619,3575890215,3575890253,38
1,1149,37620,3575890215,3575890254,39
1,1149,37621,3575890215,3575890254,39
1,1149,37622,3575890215,3575890254,39
1,1149,37623,3575890215,3575890255,40
1,1149,37624,3575890215,3575890256,41
1,1149,37625,3575890215,3575890257,42
1,1149,37626,3575890215,3575890258,43
1,1149,37627,3575890215,3575890259,44
1,1149,37628,3575890215,3575890263,48
1,1149,37629,3575890215,3575890263,48
1,1149,37630,3575890215,3575890264,49
1,1150,37631,3575890277,3575890277,0
1,1150,37632,3575890277,3575890277,0
1,1150,37633,3575890277,3575890277,0
1,1150,37634,3575890277,3575890277,0
1,1150,37635,3575890277,3575890277,0
1,1150,37636,3575890277,3575890277,0
1,1150,37637,3575890277,3575890279,2
1,1150,37638,3575890277,3575890280,3
1,1150,37639,3575890277,3575890282,5
1,1150,37640,3575890277,3575890282,5
1,1150,37641,3575890277,3575890283,6
1,1150,37642,3575890277,3575890283,6
1,1150,37643,3575890277,3575890285,8
1,1150,37644,3575890277,3575890285,8
1,1150,37645,3575890277,3575890285,8
1,1150,37646,3575890277,3575890286,9
1,1150,37647,3575890277,3575890288,11
1,1150,37648,3575890277,3575890288,11
1,1150,37649,3575890277,3575890288,11
1,1150,37650,3575890277,3575890289,12
1,1150,37651,3575890277,3575890289,12
1,1150,37652,3575890277,3575890291,14
1,1150,37653,3575890277,3575890291,14
1,1150,37654,3575890277,3575890292,15
1,1150,37655,3575890277,3575890293,16
1,1150,37656,3575890277,3575890293,16
1,1150,37657,3575890277,3575890294,17
1,1150,37658,3575890277,3575890294,17
1,1150,37659,3575890277,3575890294,17
1,1150,37660,3575890277,3575890297,20
1,1150,37661,3575890277,3575890298,21
1,1150,37662,3575890277,3575890299,22
1,1150,37663,3575890277,3575890299,22
1,1150,37664,3575890277,3575890299,22
1,1150,37665,3575890277,3575890300,23
1,1150,37666,3575890277,3575890301,24
1,1150,37667,3575890277,3575890301,24
1,1150,37668,3575890277,3575890302,25
1,1150,37669,3575890277,3575890302,25
1,1150,37670,3575890277,3575890302,25
1,1150,37671,3575890277,3575890302,25
1,1150,37672,3575890277,3575890303,26
1,1150,37673,3575890277,3575890303,26
1,1150,37674,3575890277,3575890305,28
1,1150,37675,3575890277,3575890306,29
1,1150,37676,3575890277,3575890306,29
1,1150,37677,3575890277,3575890306,29
1,1150,37678,3575890277,3575890307,30
1,1150,37679,3575890277,3575890307,30
1,1150,37680,3575890277,3575890307,30
1,1150,37681,3575890277,3575890308,31
1,1150,37682,3575890277,3575890310,33
1,1150,37683,3575890277,3575890310,33
1,1150,37684,3575890277,3575890311,34
1,1150,37685,3575890277,3575890312,35
1,1150,37686,3575890277,3575890313,36
1,1150,37687,3575890277,3575890314,37
1,1150,37688,3575890277,3575890315,38
1,1150,37689,3575890277,3575890316,39
1,1150,37690,3575890277,3575890316,39
1,1150,37691,3575890277,3575890316,39
1,1150,37692,3575890277,3575890316,39
1,1150,37693,3575890277,3575890318,41
1,1150,37694,3575890277,3575890319,42
1,1150,37695,3575890277,3575890320,43
1,1150,37696,3575890277,3575890322,45
1,1150,37697,3575890277,3575890322,45
1,1150,37698,3575890277,3575890323,46
1,1150,37699,3575890277,3575890323,46
1,1150,37700,3575890277,3575890323,46
1,1150,37701,3575890277,3575890324,47
1,1150,37702,3575890277,3575890325,48
1,1150,37703,3575890277,3575890326,49
1,1150,37704,3575890277,3575890327,50
1,1151,37705,3575890342,3575890342,0
1,1151,37706,3575890342,3575890342,0
1,1151,37707,3575890342,3575890342,0
1,1151,37708,3575890342,3575890342,0
1,1151,37709,3575890342,3575890342,0
1,1151,37710,3575890342,3575890342,0
1,1151,37711,3575890342,3575890342,0
1,1151,37712,3575890342,3575890342,0
1,1151,37713,3575890342,3575890342,0
1,1151,37714,3575890342,3575890342,0
1,1151,37715,3575890342,3575890342,0
1,1151,37716,3575890342,3575890342,0
1,1151,37717,3575890342,3575890342,0
1,1151,37718,3575890342,3575890342,0
1,1151,37719,3575890342,3575890342,0
1,1151,37720,3575890342,3575890342,0
1,1151,37721,3575890342,3575890344,2
1,1151,37722,3575890342,3575890345,3
1,1151,37723,3575890342,3575890347,5
1,1151,37724,3575890342,3575890347,5
1,1151,37725,3575890342,3575890349,7
1,1151,37726,3575890342,3575890349,7
1,1151,37727,3575890342,3575890350,8
1,1151,37728,3575890342,3575890350,8
1,1151,37729,3575890342,3575890350,8
1,1151,37730,3575890342,3575890352,10
1,1151,37731,3575890342,3575890353,11
1,1151,37732,3575890342,3575890354,12
1,1151,37733,3575890342,3575890354,12
1,1151,37734,3575890342,3575890354,12
1,1151,37735,3575890342,3575890355,13
1,1151,37736,3575890342,3575890356,14
1,1151,37737,3575890342,3575890357,15
1,1151,37738,3575890342,3575890357,15
1,1151,37739,3575890342,3575890358,16
1,1151,37740,3575890342,3575890360,18
1,1151,37741,3575890342,3575890360,18
1,1151,37742,3575890342,3575890360,18
1,1151,37743,3575890342,3575890362,20
1,1151,37744,3575890342,3575890363,21
1,1151,37745,3575890342,3575890363,21
1,1151,37746,3575890342,3575890363,21
1,1151,37747,3575890342,3575890364,22
1,1151,37748,3575890342,3575890364,22
1,1151,37749,3575890342,3575890365,23
1,1151,37750,3575890342,3575890365,23
1,1151,37751,3575890342,3575890368,26
1,1151,37752,3575890342,3575890370,28
1,1151,37753,3575890342,3575890370,28
1,1151,37754,3575890342,3575890373,31
1,1151,37755,3575890342,3575890373,31
1,1151,37756,3575890342,3575890374,32
1,1151,37757,3575890342,3575890374,32
1,1151,37758,3575890342,3575890375,33
1,1151,37759,3575890342,3575890375,33
1,1151,37760,3575890342,3575890379,37
1,1151,37761,3575890342,3575890380,38
1,1151,37762,3575890342,3575890380,38
1,1151,37763,3575890342,3575890381,39
1,1151,37764,3575890342,3575890382,40
1,1151,37765,3575890342,3575890382,40
1,1151,37766,3575890342,3575890382,40
1,1151,37767,3575890342,3575890383,41
1,1151,37768,3575890342,3575890385,43
1,1151,37769,3575890342,3575890385,43
1,1151,37770,3575890342,3575890385,43
1,1151,37771,3575890342,3575890385,43
1,1151,37772,3575890342,3575890385,43
1,1151,37773,3575890342,3575890387,45
1,1151,37774,3575890342,3575890391,49
1,1151,37775,3575890342,3575890391,49
1,1151,37776,3575890342,3575890392,50
1,1152,37777,3575890405,3575890405,0
1,1152,37778,3575890405,3575890405,0
1,1152,37779,3575890405,3575890405,0
1,1152,37780,3575890405,3575890405,0
1,1152,37781,3575890405,3575890405,0
1,1152,37782,3575890405,3575890405,0
1,1152,37783,3575890405,3575890405,0
1,1152,37784,3575890405,3575890405,0
1,1152,37785,3575890405,3575890405,0
1,1152,37786,3575890405,3575890405,0
1,1152,37787,3575890405,3575890405,0
1,1152,37788,3575890405,3575890405,0
1,1152,37789,3575890405,3575890405,0
1,1152,37790,3575890405,3575890405,0
1,1152,37791,3575890405,3575890405,0
1,1152,37792,3575890405,3575890405,0
1,1152,37793,3575890405,3575890405,0
1,1152,37794,3575890405,3575890406,1
1,1152,37795,3575890405,3575890407,2
1,1152,37796,3575890405,3575890407,2
1,1152,37797,3575890405,3575890407,2
1,1152,37798,3575890405,3575890408,3
1,1152,37799,3575890405,3575890410,5
1,1152,37800,3575890405,3575890410,5
1,1152,37801,3575890405,3575890411,6
1,1152,37802,3575890405,3575890411,6
1,1152,37803,3575890405,3575890411,6
1,1152,37804,3575890405,3575890412,7
1,1152,37805,3575890405,3575890415,10
1,1152,37806,3575890405,3575890415,10
1,1152,37807,3575890405,3575890415,10
1,1152,37808,3575890405,3575890416,11
1,1152,37809,3575890405,3575890416,11
1,1152,37810,3575890405,3575890416,11
1,1152,37811,3575890405,3575890417,12
1,1152,37812,3575890405,3575890417,12
1,1152,37813,3575890405,3575890417,12
1,1152,37814,3575890405,3575890418,13
1,1152,37815,3575890405,3575890421,16
1,1152,37816,3575890405,3575890421,16
1,1152,37817,3575890405,3575890422,17
1,1152,37818,3575890405,3575890423,18
1,1152,37819,3575890405,3575890423,18
1,1152,37820,3575890405,3575890424,19
1,1152,37821,3575890405,3575890424,19
1,1152,37822,3575890405,3575890425,20
1,1152,37823,3575890405,3575890425,20
1,1152,37824,3575890405,3575890427,22
1,1152,37825,3575890405,3575890428,23
1,1152,37826,3575890405,3575890428,23
1,1152,37827,3575890405,3575890428,23
1,1152,37828,3575890405,3575890428,23
1,1152,37829,3575890405,3575890429,24
1,1152,37830,3575890405,3575890431,26
1,1152,37831,3575890405,3575890432,27
1,1152,37832,3575890405,3575890432,27
1,1152,37833,3575890405,3575890432,27
1,1152,37834,3575890405,3575890432,27
1,1152,37835,3575890405,3575890433,28
1,1152,37836,3575890405,3575890433,28
1,1152,37837,3575890405,3575890435,30
1,1152,37838,3575890405,3575890435,30
1,1152,37839,3575890405,3575890436,31
1,1152,37840,3575890405,3575890439,34
1,1152,37841,3575890405,3575890439,34
1,1152,37842,3575890405,3575890442,37
1,1152,37843,3575890405,3575890443,38
1,1152,37844,3575890405,3575890444,39
1,1152,37845,3575890405,3575890444,39
1,1152,37846,3575890405,3575890445,40
1,1152,37847,3575890405,3575890445,40
1,1152,37848,3575890405,3575890446,41
1,1152,37849,3575890405,3575890446,41
1,1152,37850,3575890405,3575890447,42
1,1152,37851,3575890405,3575890448,43
1,1152,37852,3575890405,3575890448,43
1,1152,37853,3575890405,3575890449,44
1,1152,37854,3575890405,3575890449,44
1,1152,37855,3575890405,3575890449,44
1,1152,37856,3575890405,3575890450,45
1,1152,37857,3575890405,3575890450,45
1,1152,37858,3575890405,3575890450,45
1,1152,37859,3575890405,3575890452,47
1,1152,37860,3575890405,3575890453,48
1,1152,37861,3575890405,3575890453,48
1,1152,37862,3575890405,3575890453,48
1,1152,37863,3575890405,3575890454,49
1,1152,37864,3575890405,3575890455,50
1,1153,37865,3575890473,3575890473,0
1,1153,37866,3575890473,3575890473,0
1,1153,37867,3575890473,3575890473,0
1,1153,37868,3575890473,3575890473,0
1,1153,37869,3575890473,3575890473,0
1,1153,37870,3575890473,3575890473,0
1,1153,37871,3575890473,3575890473,0
1,1153,37872,3575890473,3575890473,0
1,1153,37873,3575890473,3575890473,0
1,1153,37874,3575890473,3575890473,0
1,1153,37875,3575890473,3575890473,0
1,1153,37876,3575890473,3575890473,0
1,1153,37877,3575890473,3575890478,5
1,1153,37878,3575890473,3575890480,7
1,1153,37879,3575890473,3575890481,8
1,1153,37880,3575890473,3575890482,9
1,1153,37881,3575890473,3575890484,11
1,1153,37882,3575890473,3575890484,11
1,1153,37883,3575890473,3575890484,11
1,1153,37884,3575890473,3575890484,11
1,1153,37885,3575890473,3575890485,12
1,1153,37886,3575890473,3575890486,13
1,1153,37887,3575890473,3575890487,14
1,1153,37888,3575890473,3575890488,15
1,1153,37889,3575890473,3575890489,16
1,1153,37890,3575890473,3575890489,16
1,1153,37891,3575890473,3575890490,17
1,1153,37892,3575890473,3575890491,18
1,1153,37893,3575890473,3575890492,19
1,1153,37894,3575890473,3575890492,19
1,1153,37895,3575890473,3575890492,19
1,1153,37896,3575890473,3575890493,20
1,1153,37897,3575890473,3575890493,20
1,1153,37898,3575890473,3575890494,21
1,1153,37899,3575890473,3575890494,21
1,1153,37900,3575890473,3575890497,24
1,1153,37901,3575890473,3575890498,25
1,1153,37902,3575890473,3575890499,26
1,1153,37903,3575890473,3575890500,27
1,1153,37904,3575890473,3575890500,27
1,1153,37905,3575890473,3575890500,27
1,1153,37906,3575890473,3575890501,28
1,1153,37907,3575890473,3575890502,29
1,1153,37908,3575890473,3575890502,29
1,1153,37909,3575890473,3575890502,29
1,1153,37910,3575890473,3575890503,30
1,1153,37911,3575890473,3575890503,30
1,1153,37912,3575890473,3575890503,30
1,1153,37913,3575890473,3575890504,31
1,1153,37914,3575890473,3575890505,32
1,1153,37915,3575890473,3575890506,33
1,1153,37916,3575890473,3575890506,33
1,1153,37917,3575890473,3575890506,33
1,1153,37918,3575890473,3575890506,33
1,1153,37919,3575890473,3575890507,34
1,1153,37920,3575890473,3575890509,36
1,1153,37921,3575890473,3575890510,37
1,1153,37922,3575890473,3575890510,37
1,1153,37923,3575890473,3575890512,39
1,1153,37924,3575890473,3575890513,40
1,1153,37925,3575890473,3575890514,41
1,1153,37926,3575890473,3575890515,42
1,1153,37927,3575890473,3575890515,42
1,1153,37928,3575890473,3575890516,43
1,1153,37929,3575890473,3575890516,43
1,1153,37930,3575890473,3575890516,43
1,1153,37931,3575890473,3575890518,45
1,1153,37932,3575890473,3575890519,46
1,1153,37933,3575890473,3575890519,46
1,1153,37934,3575890473,3575890522,49
1,1153,37935,3575890473,3575890522,49
1,1153,37936,3575890473,3575890523,50
1,1154,37937,3575890535,3575890535,0
1,1154,37938,3575890535,3575890535,0
1,1154,37939,3575890535,3575890535,0
1,1154,37940,3575890535,3575890535,0
1,1154,37941,3575890535,3575890535,0
1,1154,37942,3575890535,3575890535,0
1,1154,37943,3575890535,3575890535,0
1,1154,37944,3575890535,3575890535,0
1,1154,37945,3575890535,3575890535,0
1,1154,37946,3575890535,3575890535,0
1,1154,37947,3575890535,3575890535,0
1,1154,37948,3575890535,3575890535,0
1,1154,37949,3575890535,3575890535,0
1,1154,37950,3575890535,3575890535,0
1,1154,37951,3575890535,3575890535,0
1,1154,37952,3575890535,3575890535,0
1,1154,37953,3575890535,3575890535,0
1,1154,37954,3575890535,3575890535,0
1,1154,37955,3575890535,3575890538,3
1,1154,37956,3575890535,3575890539,4
1,1154,37957,3575890535,3575890539,4
1,1154,37958,3575890535,3575890540,5
1,1154,37959,3575890535,3575890541,6
1,1154,37960,3575890535,3575890543,8
1,1154,37961,3575890535,3575890543,8
1,1154,37962,3575890535,3575890545,10
1,1154,37963,3575890535,3575890547,12
1,1154,37964,3575890535,3575890547,12
1,1154,37965,3575890535,3575890547,12
1,1154,37966,3575890535,3575890549,14
1,1154,37967,3575890535,3575890549,14
1,1154,37968,3575890535,3575890552,17
1,1154,37969,3575890535,3575890552,17
1,1154,37970,3575890535,3575890553,18
1,1154,37971,3575890535,3575890553,18
1,1154,37972,3575890535,3575890553,18
1,1154,37973,3575890535,3575890554,19
1,1154,37974,3575890535,3575890556,21
1,1154,37975,3575890535,3575890556,21
1,1154,37976,3575890535,3575890556,21
1,1154,37977,3575890535,3575890557,22
1,1154,37978,3575890535,3575890558,23
1,1154,37979,3575890535,3575890560,25
1,1154,37980,3575890535,3575890560,25
1,1154,37981,3575890535,3575890561,26
1,1154,37982,3575890535,3575890561,26
1,1154,37983,3575890535,3575890562,27
1,1154,37984,3575890535,3575890562,27
1,1154,37985,3575890535,3575890562,27
1,1154,37986,3575890535,3575890562,27
1,1154,37987,3575890535,3575890564,29
1,1154,37988,3575890535,3575890565,30
1,1154,37989,3575890535,3575890568,33
1,1154,37990,3575890535,3575890569,34
1,1154,37991,3575890535,3575890569,34
1,1154,37992,3575890535,3575890571,36
1,1154,37993,3575890535,3575890572,37
1,1154,37994,3575890535,3575890573,38
1,1154,37995,3575890535,3575890574,39
1,1154,37996,3575890535,3575890574,39
1,1154,37997,3575890535,3575890574,39
1,1154,37998,3575890535,3575890575,40
1,1154,37999,3575890535,3575890578,43
1,1154,38000,3575890535,3575890579,44
1,1154,38001,3575890535,3575890579,44
1,1154,38002,3575890535,3575890580,45
1,1154,38003,3575890535,3575890580,45
1,1154,38004,3575890535,3575890580,45
1,1154,38005,3575890535,3575890582,47
1,1154,38006,3575890535,3575890582,47
1,1154,38007,3575890535,3575890582,47
1,1154,38008,3575890535,3575890583,48
1,1154,38009,3575890535,3575890584,49
1,1154,38010,3575890535,3575890584,49
1,1154,38011,3575890535,3575890585,50
1,1155,38012,3575890597,3575890597,0
1,1155,38013,3575890597,3575890597,0
1,1155,38014,3575890597,3575890597,0
1,1155,38015,3575890597,3575890597,0
1,1155,38016,3575890597,3575890597,0
1,1155,38017,3575890597,3575890597,0
1,1155,38018,3575890597,3575890597,0
1,1155,38019,3575890597,3575890597,0
1,1155,38020,3575890597,3575890597,0
1,1155,38021,3575890597,3575890597,0
1,1155,38022,3575890597,3575890597,0
1,1155,38023,3575890597,3575890597,0
1,1155,38024,3575890597,3575890597,0
1,1155,38025,3575890597,3575890597,0
1,1155,38026,3575890597,3575890597,0
1,1155,38027,3575890597,3575890598,1
1,1155,38028,3575890597,3575890598,1
1,1155,38029,3575890597,3575890600,3
1,1155,38030,3575890597,3575890600,3
1,1155,38031,3575890597,3575890601,4
1,1155,38032,3575890597,3575890602,5
1,1155,38033,3575890597,3575890604,7
1,1155,38034,3575890597,3575890604,7
1,1155,38035,3575890597,3575890606,9
1,1155,38036,3575890597,3575890606,9
1,1155,38037,3575890597,3575890606,9
1,1155,38038,3575890597,3575890607,10
1,1155,38039,3575890597,3575890607,10
1,1155,38040,3575890597,3575890609,12
1,1155,38041,3575890597,3575890609,12
1,1155,38042,3575890597,3575890610,13
1,1155,38043,3575890597,3575890612,15
1,1155,38044,3575890597,3575890613,16
1,1155,38045,3575890597,3575890613,16
1,1155,38046,3575890597,3575890613,16
1,1155,38047,3575890597,3575890614,17
1,1155,38048,3575890597,3575890615,18
1,1155,38049,3575890597,3575890615,18
1,1155,38050,3575890597,3575890615,18
1,1155,38051,3575890597,3575890615,18
1,1155,38052,3575890597,3575890616,19
1,1155,38053,3575890597,3575890616,19
1,1155,38054,3575890597,3575890618,21
1,1155,38055,3575890597,3575890618,21
1,1155,38056,3575890597,3575890620,23
1,1155,38057,3575890597,3575890620,23
1,1155,38058,3575890597,3575890621,24
1,1155,38059,3575890597,3575890623,26
1,1155,38060,3575890597,3575890623,26
1,1155,38061,3575890597,3575890623,26
1,1155,38062,3575890597,3575890624,27
1,1155,38063,3575890597,3575890624,27
1,1155,38064,3575890597,3575890625,28
1,1155,38065,3575890597,3575890625,28
1,1155,38066,3575890597,3575890625,28
1,1155,38067,3575890597,3575890627,30
1,1155,38068,3575890597,3575890627,30
1,1155,38069,3575890597,3575890627,30
1,1155,38070,3575890597,3575890628,31
1,1155,38071,3575890597,3575890629,32
1,1155,38072,3575890597,3575890630,33
1,1155,38073,3575890597,3575890631,34
1,1155,38074,3575890597,3575890631,34
1,1155,38075,3575890597,3575890632,35
1,1155,38076,3575890597,3575890632,35
1,1155,38077,3575890597,3575890632,35
1,1155,38078,3575890597,3575890633,36
1,1155,38079,3575890597,3575890634,37
1,1155,38080,3575890597,3575890635,38
1,1155,38081,3575890597,3575890635,38
1,1155,38082,3575890597,3575890637,40
1,1155,38083,3575890597,3575890638,41
1,1155,38084,3575890597,3575890641,44
1,1155,38085,3575890597,3575890643,46
1,1155,38086,3575890597,3575890644,47
1,1155,38087,3575890597,3575890644,47
1,1155,38088,3575890597,3575890644,47
1,1155,38089,3575890597,3575890644,47
1,1155,38090,3575890597,3575890645,48
1,1155,38091,3575890597,3575890646,49
1,1155,38092,3575890597,3575890646,49
1,1155,38093,3575890597,3575890647,50
1,1156,38094,3575890661,3575890661,0
1,1156,38095,3575890661,3575890661,0
1,1156,38096,3575890661,3575890661,0
1,1156,38097,3575890661,3575890661,0
1,1156,38098,3575890661,3575890661,0
1,1156,38099,3575890661,3575890661,0
1,1156,38100,3575890661,3575890661,0
1,1156,38101,3575890661,3575890661,0
1,1156,38102,3575890661,3575890661,0
1,1156,38103,3575890661,3575890661,0
1,1156,38104,3575890661,3575890661,0
1,1156,38105,3575890661,3575890661,0
1,1156,38106,3575890661,3575890661,0
1,1156,38107,3575890661,3575890661,0
1,1156,38108,3575890661,3575890661,0
1,1156,38109,3575890661,3575890661,0
1,1156,38110,3575890661,3575890663,2
1,1156,38111,3575890661,3575890664,3
1,1156,38112,3575890661,3575890665,4
1,1156,38113,3575890661,3575890666,5
1,1156,38114,3575890661,3575890667,6
1,1156,38115,3575890661,3575890668,7
1,1156,38116,3575890661,3575890668,7
1,1156,38117,3575890661,3575890678,17
1,1156,38118,3575890661,3575890680,19
1,1156,38119,3575890661,3575890682,21
1,1156,38120,3575890661,3575890684,23
1,1156,38121,3575890661,3575890684,23
1,1156,38122,3575890661,3575890684,23
1,1156,38123,3575890661,3575890685,24
1,1156,38124,3575890661,3575890686,25
1,1156,38125,3575890661,3575890686,25
1,1156,38126,3575890661,3575890687,26
1,1156,38127,3575890661,3575890688,27
1,1156,38128,3575890661,3575890689,28
1,1156,38129,3575890661,3575890690,29
1,1156,38130,3575890661,3575890690,29
1,1156,38131,3575890661,3575890691,30
1,1156,38132,3575890661,3575890692,31
1,1156,38133,3575890661,3575890692,31
1,1156,38134,3575890661,3575890692,31
1,1156,38135,3575890661,3575890694,33
1,1156,38136,3575890661,3575890694,33
1,1156,38137,3575890661,3575890694,33
1,1156,38138,3575890661,3575890695,34
1,1156,38139,3575890661,3575890697,36
1,1156,38140,3575890661,3575890698,37
1,1156,38141,3575890661,3575890699,38
1,1156,38142,3575890661,3575890699,38
1,1156,38143,3575890661,3575890699,38
1,1156,38144,3575890661,3575890700,39
1,1156,38145,3575890661,3575890700,39
1,1156,38146,3575890661,3575890701,40
1,1156,38147,3575890661,3575890701,40
1,1156,38148,3575890661,3575890702,41
1,1156,38149,3575890661,3575890702,41
1,1156,38150,3575890661,3575890702,41
1,1156,38151,3575890661,3575890703,42
1,1156,38152,3575890661,3575890703,42
1,1156,38153,3575890661,3575890703,42
1,1156,38154,3575890661,3575890703,42
1,1156,38155,3575890661,3575890705,44
1,1156,38156,3575890661,3575890706,45
1,1156,38157,3575890661,3575890706,45
1,1156,38158,3575890661,3575890707,46
1,1156,38159,3575890661,3575890707,46
1,1156,38160,3575890661,3575890707,46
1,1156,38161,3575890661,3575890710,49
1,1156,38162,3575890661,3575890710,49
1,1156,38163,3575890661,3575890710,49
1,1157,38164,3575890724,3575890724,0
1,1157,38165,3575890724,3575890724,0
1,1157,38166,3575890724,3575890724,0
1,1157,38167,3575890724,3575890724,0
1,1157,38168,3575890724,3575890724,0
1,1157,38169,3575890724,3575890724,0
1,1157,38170,3575890724,3575890724,0
1,1157,38171,3575890724,3575890724,0
1,1157,38172,3575890724,3575890724,0
1,1157,38173,3575890724,3575890724,0
1,1157,38174,3575890724,3575890724,0
1,1157,38175,3575890724,3575890724,0
1,1157,38176,3575890724,3575890724,0
1,1157,38177,3575890724,3575890724,0
1,1157,38178,3575890724,3575890724,0
1,1157,38179,3575890724,3575890724,0
1,1157,38180,3575890724,3575890726,2
1,1157,38181,3575890724,3575890726,2
1,1157,38182,3575890724,3575890727,3
1,1157,38183,3575890724,3575890728,4
1,1157,38184,3575890724,3575890728,4
1,1157,38185,3575890724,3575890729,5
1,1157,38186,3575890724,3575890730,6
1,1157,38187,3575890724,3575890730,6
1,1157,38188,3575890724,3575890731,7
1,1157,38189,3575890724,3575890732,8
1,1157,38190,3575890724,3575890732,8
1,1157,38191,3575890724,3575890732,8
1,1157,38192,3575890724,3575890732,8
1,1157,38193,3575890724,3575890733,9
1,1157,38194,3575890724,3575890734,10
1,1157,38195,3575890724,3575890735,11
1,1157,38196,3575890724,3575890739,15
1,1157,38197,3575890724,3575890739,15
1,1157,38198,3575890724,3575890740,16
1,1157,38199,3575890724,3575890740,16
1,1157,38200,3575890724,3575890743,19
1,1157,38201,3575890724,3575890744,20
1,1157,38202,3575890724,3575890744,20
1,1157,38203,3575890724,3575890745,21
1,1157,38204,3575890724,3575890746,22
1,1157,38205,3575890724,3575890748,24
1,1157,38206,3575890724,3575890748,24
1,1157,38207,3575890724,3575890748,24
1,1157,38208,3575890724,3575890748,24
1,1157,38209,3575890724,3575890749,25
1,1157,38210,3575890724,3575890752,28
1,1157,38211,3575890724,3575890752,28
1,1157,38212,3575890724,3575890753,29
1,1157,38213,3575890724,3575890754,30
1,1157,38214,3575890724,3575890754,30
1,1157,38215,3575890724,3575890756,32
1,1157,38216,3575890724,3575890756,32
1,1157,38217,3575890724,3575890757,33
1,1157,38218,3575890724,3575890757,33
1,1157,38219,3575890724,3575890758,34
1,1157,38220,3575890724,3575890759,35
1,1157,38221,3575890724,3575890761,37
1,1157,38222,3575890724,3575890761,37
1,1157,38223,3575890724,3575890762,38
1,1157,38224,3575890724,3575890762,38
1,1157,38225,3575890724,3575890763,39
1,1157,38226,3575890724,3575890763,39
1,1157,38227,3575890724,3575890764,40
1,1157,38228,3575890724,3575890764,40
1,1157,38229,3575890724,3575890765,41
1,1157,38230,3575890724,3575890768,44
1,1157,38231,3575890724,3575890769,45
1,1157,38232,3575890724,3575890769,45
1,1157,38233,3575890724,3575890772,48
1,1157,38234,3575890724,3575890772,48
1,1157,38235,3575890724,3575890773,49
1,1157,38236,3575890724,3575890774,50
1,1158,38237,3575890786,3575890786,0
1,1158,38238,3575890786,3575890786,0
1,1158,38239,3575890786,3575890786,0
1,1158,38240,3575890786,3575890786,0
1,1158,38241,3575890786,3575890786,0
1,1158,38242,3575890786,3575890786,0
1,1158,38243,3575890786,3575890786,0
1,1158,38244,3575890786,3575890786,0
1,1158,38245,3575890786,3575890786,0
1,1158,38246,3575890786,3575890786,0
1,1158,38247,3575890786,3575890786,0
1,1158,38248,3575890786,3575890786,0
1,1158,38249,3575890786,3575890786,0
1,1158,38250,3575890786,3575890786,0
1,1158,38251,3575890786,3575890786,0
1,1158,38252,3575890786,3575890786,0
1,1158,38253,3575890786,3575890786,0
1,1158,38254,3575890786,3575890786,0
1,1158,38255,3575890786,3575890787,1
1,1158,38256,3575890786,3575890789,3
1,1158,38257,3575890786,3575890790,4
1,1158,38258,3575890786,3575890790,4
1,1158,38259,3575890786,3575890790,4
1,1158,38260,3575890786,3575890791,5
1,1158,38261,3575890786,3575890791,5
1,1158,38262,3575890786,3575890791,5
1,1158,38263,3575890786,3575890792,6
1,1158,38264,3575890786,3575890792,6
1,1158,38265,3575890786,3575890795,9
1,1158,38266,3575890786,3575890795,9
1,1158,38267,3575890786,3575890795,9
1,1158,38268,3575890786,3575890797,11
1,1158,38269,3575890786,3575890797,11
1,1158,38270,3575890786,3575890798,12
1,1158,38271,3575890786,3575890798,12
1,1158,38272,3575890786,3575890799,13
1,1158,38273,3575890786,3575890799,13
1,1158,38274,3575890786,3575890800,14
1,1158,38275,3575890786,3575890802,16
1,1158,38276,3575890786,3575890802,16
1,1158,38277,3575890786,3575890803,17
1,1158,38278,3575890786,3575890803,17
1,1158,38279,3575890786,3575890803,17
1,1158,38280,3575890786,3575890805,19
1,1158,38281,3575890786,3575890805,19
1,1158,38282,3575890786,3575890806,20
1,1158,38283,3575890786,3575890806,20
1,1158,38284,3575890786,3575890807,21
1,1158,38285,3575890786,3575890809,23
1,1158,38286,3575890786,3575890809,23
1,1158,38287,3575890786,3575890810,24
1,1158,38288,3575890786,3575890811,25
1,1158,38289,3575890786,3575890811,25
1,1158,38290,3575890786,3575890812,26
1,1158,38291,3575890786,3575890812,26
1,1158,38292,3575890786,3575890814,28
1,1158,38293,3575890786,3575890814,28
1,1158,38294,3575890786,3575890814,28
1,1158,38295,3575890786,3575890814,28
1,1158,38296,3575890786,3575890815,29
1,1158,38297,3575890786,3575890816,30
1,1158,38298,3575890786,3575890816,30
1,1158,38299,3575890786,3575890816,30
1,1158,38300,3575890786,3575890816,30
1,1158,38301,3575890786,3575890817,31
1,1158,38302,3575890786,3575890818,32
1,1158,38303,3575890786,3575890818,32
1,1158,38304,3575890786,3575890820,34
1,1158,38305,3575890786,3575890820,34
1,1158,38306,3575890786,3575890822,36
1,1158,38307,3575890786,3575890823,37
1,1158,38308,3575890786,3575890823,37
1,1158,38309,3575890786,3575890823,37
1,1158,38310,3575890786,3575890823,37
1,1158,38311,3575890786,3575890824,38
1,1158,38312,3575890786,3575890824,38
1,1158,38313,3575890786,3575890825,39
1,1158,38314,3575890786,3575890827,41
1,1158,38315,3575890786,3575890828,42
1,1158,38316,3575890786,3575890828,42
1,1158,38317,3575890786,3575890828,42
1,1158,38318,3575890786,3575890829,43
1,1158,38319,3575890786,3575890830,44
1,1158,38320,3575890786,3575890831,45
1,1158,38321,3575890786,3575890831,45
1,1158,38322,3575890786,3575890832,46
1,1158,38323,3575890786,3575890832,46
1,1158,38324,3575890786,3575890833,47
1,1158,38325,3575890786,3575890833,47
1,1158,38326,3575890786,3575890833,47
1,1159,38327,3575890850,3575890850,0
1,1159,38328,3575890850,3575890850,0
1,1159,38329,3575890850,3575890850,0
1,1159,38330,3575890850,3575890850,0
1,1159,38331,3575890850,3575890850,0
1,1159,38332,3575890850,3575890850,0
1,1159,38333,3575890850,3575890850,0
1,1159,38334,3575890850,3575890850,0
1,1159,38335,3575890850,3575890850,0
1,1159,38336,3575890850,3575890850,0
1,1159,38337,3575890850,3575890850,0
1,1159,38338,3575890850,3575890850,0
1,1159,38339,3575890850,3575890850,0
1,1159,38340,3575890850,3575890850,0
1,1159,38341,3575890850,3575890850,0
1,1159,38342,3575890850,3575890850,0
1,1159,38343,3575890850,3575890850,0
1,1159,38344,3575890850,3575890850,0
1,1159,38345,3575890850,3575890850,0
1,1159,38346,3575890850,3575890850,0
1,1159,38347,3575890850,3575890850,0
1,1159,38348,3575890850,3575890850,0
1,1159,38349,3575890850,3575890851,1
1,1159,38350,3575890850,3575890853,3
1,1159,38351,3575890850,3575890853,3
1,1159,38352,3575890850,3575890853,3
1,1159,38353,3575890850,3575890854,4
1,1159,38354,3575890850,3575890854,4
1,1159,38355,3575890850,3575890855,5
1,1159,38356,3575890850,3575890855,5
1,1159,38357,3575890850,3575890857,7
1,1159,38358,3575890850,3575890858,8
1,1159,38359,3575890850,3575890858,8
1,1159,38360,3575890850,3575890862,12
1,1159,38361,3575890850,3575890863,13
1,1159,38362,3575890850,3575890864,14
1,1159,38363,3575890850,3575890865,15
1,1159,38364,3575890850,3575890867,17
1,1159,38365,3575890850,3575890867,17
1,1159,38366,3575890850,3575890868,18
1,1159,38367,3575890850,3575890879,29
1,1159,38368,3575890850,3575890880,30
1,1159,38369,3575890850,3575890882,32
1,1159,38370,3575890850,3575890882,32
1,1159,38371,3575890850,3575890884,34
1,1159,38372,3575890850,3575890884,34
1,1159,38373,3575890850,3575890884,34
1,1159,38374,3575890850,3575890885,35
1,1159,38375,3575890850,3575890885,35
1,1159,38376,3575890850,3575890886,36
1,1159,38377,3575890850,3575890887,37
1,1159,38378,3575890850,3575890888,38
1,1159,38379,3575890850,3575890888,38
1,1159,38380,3575890850,3575890890,40
1,1159,38381,3575890850,3575890890,40
1,1159,38382,3575890850,3575890891,41
1,1159,38383,3575890850,3575890892,42
1,1159,38384,3575890850,3575890892,42
1,1159,38385,3575890850,3575890892,42
1,1159,38386,3575890850,3575890894,44
1,1159,38387,3575890850,3575890894,44
1,1159,38388,3575890850,3575890894,44
1,1159,38389,3575890850,3575890895,45
1,1159,38390,3575890850,3575890898,48
1,1159,38391,3575890850,3575890898,48
1,1159,38392,3575890850,3575890899,49
1,1159,38393,3575890850,3575890899,49
1,1159,38394,3575890850,3575890899,49
1,1159,38395,3575890850,3575890900,50
1,1160,38396,3575890914,3575890914,0
1,1160,38397,3575890914,3575890914,0
1,1160,38398,3575890914,3575890914,0
1,1160,38399,3575890914,3575890914,0
1,1160,38400,3575890914,3575890914,0
1,1160,38401,3575890914,3575890914,0
1,1160,38402,3575890914,3575890914,0
1,1160,38403,3575890914,3575890914,0
1,1160,38404,3575890914,3575890914,0
1,1160,38405,3575890914,3575890914,0
1,1160,38406,3575890914,3575890914,0
1,1160,38407,3575890914,3575890914,0
1,1160,38408,3575890914,3575890914,0
1,1160,38409,3575890914,3575890914,0
1,1160,38410,3575890914,3575890914,0
1,1160,38411,3575890914,3575890914,0
1,1160,38412,3575890914,3575890914,0
1,1160,38413,3575890914,3575890914,0
1,1160,38414,3575890914,3575890914,0
1,1160,38415,3575890914,3575890914,0
1,1160,38416,3575890914,3575890914,0
1,1160,38417,3575890914,3575890914,0
1,1160,38418,3575890914,3575890914,0
1,1160,38419,3575890914,3575890914,0
1,1160,38420,3575890914,3575890914,0
1,1160,38421,3575890914,3575890915,1
1,1160,38422,3575890914,3575890916,2
1,1160,38423,3575890914,3575890916,2
1,1160,38424,3575890914,3575890917,3
1,1160,38425,3575890914,3575890919,5
1,1160,38426,3575890914,3575890919,5
1,1160,38427,3575890914,3575890920,6
1,1160,38428,3575890914,3575890922,8
1,1160,38429,3575890914,3575890922,8
1,1160,38430,3575890914,3575890923,9
1,1160,38431,3575890914,3575890923,9
1,1160,38432,3575890914,3575890923,9
1,1160,38433,3575890914,3575890924,10
1,1160,38434,3575890914,3575890927,13
1,1160,38435,3575890914,3575890927,13
1,1160,38436,3575890914,3575890928,14
1,1160,38437,3575890914,3575890929,15
1,1160,38438,3575890914,3575890929,15
1,1160,38439,3575890914,3575890930,16
1,1160,38440,3575890914,3575890931,17
1,1160,38441,3575890914,3575890931,17
1,1160,38442,3575890914,3575890932,18
1,1160,38443,3575890914,3575890932,18
1,1160,38444,3575890914,3575890933,19
1,1160,38445,3575890914,3575890933,19
1,1160,38446,3575890914,3575890933,19
1,1160,38447,3575890914,3575890934,20
1,1160,38448,3575890914,3575890935,21
1,1160,38449,3575890914,3575890938,24
1,1160,38450,3575890914,3575890939,25
1,1160,38451,3575890914,3575890939,25
1,1160,38452,3575890914,3575890939,25
1,1160,38453,3575890914,3575890940,26
1,1160,38454,3575890914,3575890943,29
1,1160,38455,3575890914,3575890943,29
1,1160,38456,3575890914,3575890944,30
1,1160,38457,3575890914,3575890946,32
1,1160,38458,3575890914,3575890947,33
1,1160,38459,3575890914,3575890948,34
1,1160,38460,3575890914,3575890948,34
1,1160,38461,3575890914,3575890948,34
1,1160,38462,3575890914,3575890948,34
1,1160,38463,3575890914,3575890949,35
1,1160,38464,3575890914,3575890952,38
1,1160,38465,3575890914,3575890952,38
1,1160,38466,3575890914,3575890953,39
1,1160,38467,3575890914,3575890954,40
1,1160,38468,3575890914,3575890954,40
1,1160,38469,3575890914,3575890956,42
1,1160,38470,3575890914,3575890957,43
1,1160,38471,3575890914,3575890957,43
1,1160,38472,3575890914,3575890957,43
1,1160,38473,3575890914,3575890958,44
1,1160,38474,3575890914,3575890959,45
1,1160,38475,3575890914,3575890960,46
1,1160,38476,3575890914,3575890962,48
1,1160,38477,3575890914,3575890962,48
1,1160,38478,3575890914,3575890963,49
1,1160,38479,3575890914,3575890963,49
1,1160,38480,3575890914,3575890964,50
1,1161,38481,3575890977,3575890977,0
1,1161,38482,3575890977,3575890977,0
1,1161,38483,3575890977,3575890977,0
1,1161,38484,3575890977,3575890977,0
1,1161,38485,3575890977,3575890977,0
1,1161,38486,3575890977,3575890977,0
1,1161,38487,3575890977,3575890977,0
1,1161,38488,3575890977,3575890977,0
1,1161,38489,3575890977,3575890977,0
1,1161,38490,3575890977,3575890977,0
1,1161,38491,3575890977,3575890977,0
1,1161,38492,3575890977,3575890978,1
1,1161,38493,3575890977,3575890979,2
1,1161,38494,3575890977,3575890979,2
1,1161,38495,3575890977,3575890980,3
1,1161,38496,3575890977,3575890980,3
1,1161,38497,3575890977,3575890981,4
1,1161,38498,3575890977,3575890982,5
1,1161,38499,3575890977,3575890982,5
1,1161,38500,3575890977,3575890983,6
1,1161,38501,3575890977,3575890984,7
1,1161,38502,3575890977,3575890984,7
1,1161,38503,3575890977,3575890985,8
1,1161,38504,3575890977,3575890985,8
1,1161,38505,3575890977,3575890987,10
1,1161,38506,3575890977,3575890989,12
1,1161,38507,3575890977,3575890990,13
1,1161,38508,3575890977,3575890990,13
1,1161,38509,3575890977,3575890991,14
1,1161,38510,3575890977,3575890991,14
1,1161,38511,3575890977,3575890992,15
1,1161,38512,3575890977,3575890992,15
1,1161,38513,3575890977,3575890993,16
1,1161,38514,3575890977,3575890995,18
1,1161,38515,3575890977,3575890996,19
1,1161,38516,3575890977,3575890996,19
1,1161,38517,3575890977,3575890997,20
1,1161,38518,3575890977,3575890997,20
1,1161,38519,3575890977,3575890998,21
1,1161,38520,3575890977,3575890998,21
1,1161,38521,3575890977,3575890999,22
1,1161,38522,3575890977,3575891000,23
1,1161,38523,3575890977,3575891001,24
1,1161,38524,3575890977,3575891002,25
1,1161,38525,3575890977,3575891002,25
1,1161,38526,3575890977,3575891003,26
1,1161,38527,3575890977,3575891005,28
1,1161,38528,3575890977,3575891005,28
1,1161,38529,3575890977,3575891005,28
1,1161,38530,3575890977,3575891007,30
1,1161,38531,3575890977,3575891007,30
1,1161,38532,3575890977,3575891007,30
1,1161,38533,3575890977,3575891009,32
1,1161,38534,3575890977,3575891010,33
1,1161,38535,3575890977,3575891011,34
1,1161,38536,3575890977,3575891012,35
1,1161,38537,3575890977,3575891012,35
1,1161,38538,3575890977,3575891012,35
1,1161,38539,3575890977,3575891013,36
1,1161,38540,3575890977,3575891014,37
1,1161,38541,3575890977,3575891014,37
1,1161,38542,3575890977,3575891014,37
1,1161,38543,3575890977,3575891015,38
1,1161,38544,3575890977,3575891016,39
1,1161,38545,3575890977,3575891016,39
1,1161,38546,3575890977,3575891016,39
1,1161,38547,3575890977,3575891016,39
1,1161,38548,3575890977,3575891017,40
1,1161,38549,3575890977,3575891018,41
1,1161,38550,3575890977,3575891018,41
1,1161,38551,3575890977,3575891020,43
1,1161,38552,3575890977,3575891020,43
1,1161,38553,3575890977,3575891022,45
1,1161,38554,3575890977,3575891022,45
1,1161,38555,3575890977,3575891023,46
1,1161,38556,3575890977,3575891023,46
1,1161,38557,3575890977,3575891023,46
1,1161,38558,3575890977,3575891024,47
1,1161,38559,3575890977,3575891026,49
1,1161,38560,3575890977,3575891026,49
1,1161,38561,3575890977,3575891027,50
1,1162,38562,3575891041,3575891041,0
1,1162,38563,3575891041,3575891041,0
1,1162,38564,3575891041,3575891041,0
1,1162,38565,3575891041,3575891041,0
1,1162,38566,3575891041,3575891041,0
1,1162,38567,3575891041,3575891041,0
1,1162,38568,3575891041,3575891041,0
1,1162,38569,3575891041,3575891041,0
1,1162,38570,3575891041,3575891041,0
1,1162,38571,3575891041,3575891041,0
1,1162,38572,3575891041,3575891041,0
1,1162,38573,3575891041,3575891041,0
1,1162,38574,3575891041,3575891041,0
1,1162,38575,3575891041,3575891041,0
1,1162,38576,3575891041,3575891041,0
1,1162,38577,3575891041,3575891041,0
1,1162,38578,3575891041,3575891041,0
1,1162,38579,3575891041,3575891043,2
1,1162,38580,3575891041,3575891043,2
1,1162,38581,3575891041,3575891044,3
1,1162,38582,3575891041,3575891044,3
1,1162,38583,3575891041,3575891045,4
1,1162,38584,3575891041,3575891045,4
1,1162,38585,3575891041,3575891046,5
1,1162,38586,3575891041,3575891046,5
1,1162,38587,3575891041,3575891047,6
1,1162,38588,3575891041,3575891047,6
1,1162,38589,3575891041,3575891047,6
1,1162,38590,3575891041,3575891048,7
1,1162,38591,3575891041,3575891049,8
1,1162,38592,3575891041,3575891049,8
1,1162,38593,3575891041,3575891050,9
1,1162,38594,3575891041,3575891050,9
1,1162,38595,3575891041,3575891050,9
1,1162,38596,3575891041,3575891051,10
1,1162,38597,3575891041,3575891053,12
1,1162,38598,3575891041,3575891053,12
1,1162,38599,3575891041,3575891053,12
1,1162,38600,3575891041,3575891053,12
1,1162,38601,3575891041,3575891054,13
1,1162,38602,3575891041,3575891055,14
1,1162,38603,3575891041,3575891056,15
1,1162,38604,3575891041,3575891056,15
1,1162,38605,3575891041,3575891058,17
1,1162,38606,3575891041,3575891058,17
1,1162,38607,3575891041,3575891058,17
1,1162,38608,3575891041,3575891063,22
1,1162,38609,3575891041,3575891063,22
1,1162,38610,3575891041,3575891064,23
1,1162,38611,3575891041,3575891065,24
1,1162,38612,3575891041,3575891066,25
1,1162,38613,3575891041,3575891067,26
1,1162,38614,3575891041,3575891067,26
1,1162,38615,3575891041,3575891069,28
1,1162,38616,3575891041,3575891079,38
1,1162,38617,3575891041,3575891080,39
1,1162,38618,3575891041,3575891082,41
1,1162,38619,3575891041,3575891083,42
1,1162,38620,3575891041,3575891084,43
1,1162,38621,3575891041,3575891084,43
1,1162,38622,3575891041,3575891084,43
1,1162,38623,3575891041,3575891085,44
1,1162,38624,3575891041,3575891086,45
1,1162,38625,3575891041,3575891087,46
1,1162,38626,3575891041,3575891087,46
1,1162,38627,3575891041,3575891090,49
1,1162,38628,3575891041,3575891091,50
1,1163,38629,3575891103,3575891103,0
1,1163,38630,3575891103,3575891103,0
1,1163,38631,3575891103,3575891103,0
1,1163,38632,3575891103,3575891103,0
1,1163,38633,3575891103,3575891103,0
1,1163,38634,3575891103,3575891103,0
1,1163,38635,3575891103,3575891103,0
1,1163,38636,3575891103,3575891103,0
1,1163,38637,3575891103,3575891103,0
1,1163,38638,3575891103,3575891103,0
1,1163,38639,3575891103,3575891103,0
1,1163,38640,3575891103,3575891103,0
1,1163,38641,3575891103,3575891103,0
1,1163,38642,3575891103,3575891103,0
1,1163,38643,3575891103,3575891103,0
1,1163,38644,3575891103,3575891103,0
1,1163,38645,3575891103,3575891103,0
1,1163,38646,3575891103,3575891103,0
1,1163,38647,3575891103,3575891103,0
1,1163,38648,3575891103,3575891103,0
1,1163,38649,3575891103,3575891104,1
1,1163,38650,3575891103,3575891104,1
1,1163,38651,3575891103,3575891105,2
1,1163,38652,3575891103,3575891106,3
1,1163,38653,3575891103,3575891106,3
1,1163,38654,3575891103,3575891107,4
1,1163,38655,3575891103,3575891108,5
1,1163,38656,3575891103,3575891108,5
1,1163,38657,3575891103,3575891110,7
1,1163,38658,3575891103,3575891110,7
1,1163,38659,3575891103,3575891110,7
1,1163,38660,3575891103,3575891112,9
1,1163,38661,3575891103,3575891113,10
1,1163,38662,3575891103,3575891114,11
1,1163,38663,3575891103,3575891114,11
1,1163,38664,3575891103,3575891115,12
1,1163,38665,3575891103,3575891115,12
1,1163,38666,3575891103,3575891116,13
1,1163,38667,3575891103,3575891116,13
1,1163,38668,3575891103,3575891117,14
1,1163,38669,3575891103,3575891119,16
1,1163,38670,3575891103,3575891120,17
1,1163,38671,3575891103,3575891120,17
1,1163,38672,3575891103,3575891121,18
1,1163,38673,3575891103,3575891122,19
1,1163,38674,3575891103,3575891123,20
1,1163,38675,3575891103,3575891123,20
1,1163,38676,3575891103,3575891123,20
1,1163,38677,3575891103,3575891124,21
1,1163,38678,3575891103,3575891126,23
1,1163,38679,3575891103,3575891127,24
1,1163,38680,3575891103,3575891128,25
1,1163,38681,3575891103,3575891129,26
1,1163,38682,3575891103,3575891129,26
1,1163,38683,3575891103,3575891130,27
1,1163,38684,3575891103,3575891131,28
1,1163,38685,3575891103,3575891131,28
1,1163,38686,3575891103,3575891131,28
1,1163,38687,3575891103,3575891132,29
1,1163,38688,3575891103,3575891133,30
1,1163,38689,3575891103,3575891133,30
1,1163,38690,3575891103,3575891133,30
1,1163,38691,3575891103,3575891135,32
1,1163,38692,3575891103,3575891135,32
1,1163,38693,3575891103,3575891136,33
1,1163,38694,3575891103,3575891138,35
1,1163,38695,3575891103,3575891139,36
1,1163,38696,3575891103,3575891140,37
1,1163,38697,3575891103,3575891140,37
1,1163,38698,3575891103,3575891140,37
1,1163,38699,3575891103,3575891140,37
1,1163,38700,3575891103,3575891144,41
1,1163,38701,3575891103,3575891144,41
1,1163,38702,3575891103,3575891144,41
1,1163,38703,3575891103,3575891146,43
1,1163,38704,3575891103,3575891147,44
1,1163,38705,3575891103,3575891148,45
1,1163,38706,3575891103,3575891148,45
1,1163,38707,3575891103,3575891148,45
1,1163,38708,3575891103,3575891149,46
1,1163,38709,3575891103,3575891150,47
1,1163,38710,3575891103,3575891153,50
1,1164,38711,3575891169,3575891169,0
1,1164,38712,3575891169,3575891169,0
1,1164,38713,3575891169,3575891169,0
1,1164,38714,3575891169,3575891169,0
1,1164,38715,3575891169,3575891169,0
1,1164,38716,3575891169,3575891169,0
1,1164,38717,3575891169,3575891169,0
1,1164,38718,3575891169,3575891169,0
1,1164,38719,3575891169,3575891169,0
1,1164,38720,3575891169,3575891169,0
1,1164,38721,3575891169,3575891169,0
1,1164,38722,3575891169,3575891169,0
1,1164,38723,3575891169,3575891169,0
1,1164,38724,3575891169,3575891169,0
1,1164,38725,3575891169,3575891169,0
1,1164,38726,3575891169,3575891169,0
1,1164,38727,3575891169,3575891169,0
1,1164,38728,3575891169,3575891169,0
1,1164,38729,3575891169,3575891169,0
1,1164,38730,3575891169,3575891171,2
1,1164,38731,3575891169,3575891172,3
1,1164,38732,3575891169,3575891173,4
1,1164,38733,3575891169,3575891173,4
1,1164,38734,3575891169,3575891174,5
1,1164,38735,3575891169,3575891174,5
1,1164,38736,3575891169,3575891175,6
1,1164,38737,3575891169,3575891178,9
1,1164,38738,3575891169,3575891180,11
1,1164,38739,3575891169,3575891180,11
1,1164,38740,3575891169,3575891180,11
1,1164,38741,3575891169,3575891180,11
1,1164,38742,3575891169,3575891181,12
1,1164,38743,3575891169,3575891181,12
1,1164,38744,3575891169,3575891183,14
1,1164,38745,3575891169,3575891183,14
1,1164,38746,3575891169,3575891184,15
1,1164,38747,3575891169,3575891185,16
1,1164,38748,3575891169,3575891185,16
1,1164,38749,3575891169,3575891186,17
1,1164,38750,3575891169,3575891187,18
1,1164,38751,3575891169,3575891189,20
1,1164,38752,3575891169,3575891190,21
1,1164,38753,3575891169,3575891190,21
1,1164,38754,3575891169,3575891191,22
1,1164,38755,3575891169,3575891191,22
1,1164,38756,3575891169,3575891191,22
1,1164,38757,3575891169,3575891192,23
1,1164,38758,3575891169,3575891192,23
1,1164,38759,3575891169,3575891193,24
1,1164,38760,3575891169,3575891195,26
1,1164,38761,3575891169,3575891196,27
1,1164,38762,3575891169,3575891197,28
1,1164,38763,3575891169,3575891197,28
1,1164,38764,3575891169,3575891198,29
1,1164,38765,3575891169,3575891199,30
1,1164,38766,3575891169,3575891199,30
1,1164,38767,3575891169,3575891201,32
1,1164,38768,3575891169,3575891201,32
1,1164,38769,3575891169,3575891202,33
1,1164,38770,3575891169,3575891203,34
1,1164,38771,3575891169,3575891205,36
1,1164,38772,3575891169,3575891205,36
1,1164,38773,3575891169,3575891205,36
1,1164,38774,3575891169,3575891206,37
1,1164,38775,3575891169,3575891207,38
1,1164,38776,3575891169,3575891208,39
1,1164,38777,3575891169,3575891209,40
1,1164,38778,3575891169,3575891209,40
1,1164,38779,3575891169,3575891210,41
1,1164,38780,3575891169,3575891210,41
1,1164,38781,3575891169,3575891211,42
1,1164,38782,3575891169,3575891212,43
1,1164,38783,3575891169,3575891213,44
1,1164,38784,3575891169,3575891213,44
1,1164,38785,3575891169,3575891213,44
1,1164,38786,3575891169,3575891214,45
1,1164,38787,3575891169,3575891214,45
1,1164,38788,3575891169,3575891215,46
1,1164,38789,3575891169,3575891215,46
1,1164,38790,3575891169,3575891216,47
1,1164,38791,3575891169,3575891216,47
1,1164,38792,3575891169,3575891217,48
1,1164,38793,3575891169,3575891217,48
1,1164,38794,3575891169,3575891218,49
1,1164,38795,3575891169,3575891218,49
1,1165,38796,3575891233,3575891234,1
1,1165,38797,3575891233,3575891234,1
1,1165,38798,3575891233,3575891234,1
1,1165,38799,3575891233,3575891234,1
1,1165,38800,3575891233,3575891234,1
1,1165,38801,3575891233,3575891234,1
1,1165,38802,3575891233,3575891234,1
1,1165,38803,3575891233,3575891234,1
1,1165,38804,3575891233,3575891234,1
1,1165,38805,3575891233,3575891234,1
1,1165,38806,3575891233,3575891234,1
1,1165,38807,3575891233,3575891234,1
1,1165,38808,3575891233,3575891234,1
1,1165,38809,3575891233,3575891234,1
1,1165,38810,3575891233,3575891234,1
1,1165,38811,3575891233,3575891234,1
1,1165,38812,3575891233,3575891234,1
1,1165,38813,3575891233,3575891234,1
1,1165,38814,3575891233,3575891234,1
1,1165,38815,3575891233,3575891234,1
1,1165,38816,3575891233,3575891235,2
1,1165,38817,3575891233,3575891236,3
1,1165,38818,3575891233,3575891236,3
1,1165,38819,3575891233,3575891237,4
1,1165,38820,3575891233,3575891239,6
1,1165,38821,3575891233,3575891239,6
1,1165,38822,3575891233,3575891241,8
1,1165,38823,3575891233,3575891243,10
1,1165,38824,3575891233,3575891243,10
1,1165,38825,3575891233,3575891244,11
1,1165,38826,3575891233,3575891244,11
1,1165,38827,3575891233,3575891246,13
1,1165,38828,3575891233,3575891246,13
1,1165,38829,3575891233,3575891247,14
1,1165,38830,3575891233,3575891247,14
1,1165,38831,3575891233,3575891247,14
1,1165,38832,3575891233,3575891248,15
1,1165,38833,3575891233,3575891248,15
1,1165,38834,3575891233,3575891249,16
1,1165,38835,3575891233,3575891249,16
1,1165,38836,3575891233,3575891250,17
1,1165,38837,3575891233,3575891251,18
1,1165,38838,3575891233,3575891253,20
1,1165,38839,3575891233,3575891253,20
1,1165,38840,3575891233,3575891254,21
1,1165,38841,3575891233,3575891254,21
1,1165,38842,3575891233,3575891255,22
1,1165,38843,3575891233,3575891255,22
1,1165,38844,3575891233,3575891256,23
1,1165,38845,3575891233,3575891258,25
1,1165,38846,3575891233,3575891259,26
1,1165,38847,3575891233,3575891259,26
1,1165,38848,3575891233,3575891263,30
1,1165,38849,3575891233,3575891263,30
1,1165,38850,3575891233,3575891264,31
1,1165,38851,3575891233,3575891266,33
1,1165,38852,3575891233,3575891267,34
1,1165,38853,3575891233,3575891267,34
1,1165,38854,3575891233,3575891268,35
1,1165,38855,3575891233,3575891269,36
1,1165,38856,3575891233,3575891279,46
1,1165,38857,3575891233,3575891280,47
1,1165,38858,3575891233,3575891282,49
1,1166,38859,3575891295,3575891296,1
1,1166,38860,3575891295,3575891296,1
1,1166,38861,3575891295,3575891296,1
1,1166,38862,3575891295,3575891296,1
1,1166,38863,3575891295,3575891296,1
1,1166,38864,3575891295,3575891296,1
1,1166,38865,3575891295,3575891296,1
1,1166,38866,3575891295,3575891296,1
1,1166,38867,3575891295,3575891296,1
1,1166,38868,3575891295,3575891296,1
1,1166,38869,3575891295,3575891296,1
1,1166,38870,3575891295,3575891296,1
1,1166,38871,3575891295,3575891296,1
1,1166,38872,3575891295,3575891296,1
1,1166,38873,3575891295,3575891296,1
1,1166,38874,3575891295,3575891296,1
1,1166,38875,3575891295,3575891296,1
1,1166,38876,3575891295,3575891296,1
1,1166,38877,3575891295,3575891296,1
1,1166,38878,3575891295,3575891298,3
1,1166,38879,3575891295,3575891298,3
1,1166,38880,3575891295,3575891299,4
1,1166,38881,3575891295,3575891300,5
1,1166,38882,3575891295,3575891300,5
1,1166,38883,3575891295,3575891301,6
1,1166,38884,3575891295,3575891301,6
1,1166,38885,3575891295,3575891302,7
1,1166,38886,3575891295,3575891302,7
1,1166,38887,3575891295,3575891302,7
1,1166,38888,3575891295,3575891302,7
1,1166,38889,3575891295,3575891303,8
1,1166,38890,3575891295,3575891303,8
1,1166,38891,3575891295,3575891304,9
1,1166,38892,3575891295,3575891304,9
1,1166,38893,3575891295,3575891304,9
1,1166,38894,3575891295,3575891306,11
1,1166,38895,3575891295,3575891306,11
1,1166,38896,3575891295,3575891306,11
1,1166,38897,3575891295,3575891306,11
1,1166,38898,3575891295,3575891309,14
1,1166,38899,3575891295,3575891309,14
1,1166,38900,3575891295,3575891310,15
1,1166,38901,3575891295,3575891310,15
1,1166,38902,3575891295,3575891311,16
1,1166,38903,3575891295,3575891311,16
1,1166,38904,3575891295,3575891313,18
1,1166,38905,3575891295,3575891313,18
1,1166,38906,3575891295,3575891314,19
1,1166,38907,3575891295,3575891314,19
1,1166,38908,3575891295,3575891315,20
1,1166,38909,3575891295,3575891315,20
1,1166,38910,3575891295,3575891316,21
1,1166,38911,3575891295,3575891317,22
1,1166,38912,3575891295,3575891320,25
1,1166,38913,3575891295,3575891320,25
1,1166,38914,3575891295,3575891320,25
1,1166,38915,3575891295,3575891322,27
1,1166,38916,3575891295,3575891322,27
1,1166,38917,3575891295,3575891322,27
1,1166,38918,3575891295,3575891323,28
1,1166,38919,3575891295,3575891324,29
1,1166,38920,3575891295,3575891324,29
1,1166,38921,3575891295,3575891327,32
1,1166,38922,3575891295,3575891328,33
1,1166,38923,3575891295,3575891328,33
1,1166,38924,3575891295,3575891329,34
1,1166,38925,3575891295,3575891329,34
1,1166,38926,3575891295,3575891331,36
1,1166,38927,3575891295,3575891331,36
1,1166,38928,3575891295,3575891331,36
1,1166,38929,3575891295,3575891331,36
1,1166,38930,3575891295,3575891331,36
1,1166,38931,3575891295,3575891332,37
1,1166,38932,3575891295,3575891332,37
1,1166,38933,3575891295,3575891332,37
1,1166,38934,3575891295,3575891333,38
1,1166,38935,3575891295,3575891335,40
1,1166,38936,3575891295,3575891335,40
1,1166,38937,3575891295,3575891337,42
1,1166,38938,3575891295,3575891339,44
1,1166,38939,3575891295,3575891339,44
1,1166,38940,3575891295,3575891340,45
1,1166,38941,3575891295,3575891340,45
1,1166,38942,3575891295,3575891340,45
1,1166,38943,3575891295,3575891341,46
1,1166,38944,3575891295,3575891344,49
1,1166,38945,3575891295,3575891344,49
1,1167,38946,3575891357,3575891357,0
1,1167,38947,3575891357,3575891357,0
1,1167,38948,3575891357,3575891357,0
1,1167,38949,3575891357,3575891357,0
1,1167,38950,3575891357,3575891357,0
1,1167,38951,3575891357,3575891357,0
1,1167,38952,3575891357,3575891357,0
1,1167,38953,3575891357,3575891357,0
1,1167,38954,3575891357,3575891357,0
1,1167,38955,3575891357,3575891357,0
1,1167,38956,3575891357,3575891357,0
1,1167,38957,3575891357,3575891357,0
1,1167,38958,3575891357,3575891357,0
1,1167,38959,3575891357,3575891357,0
1,1167,38960,3575891357,3575891358,1
1,1167,38961,3575891357,3575891359,2
1,1167,38962,3575891357,3575891359,2
1,1167,38963,3575891357,3575891360,3
1,1167,38964,3575891357,3575891361,4
1,1167,38965,3575891357,3575891361,4
1,1167,38966,3575891357,3575891363,6
1,1167,38967,3575891357,3575891363,6
1,1167,38968,3575891357,3575891365,8
1,1167,38969,3575891357,3575891365,8
1,1167,38970,3575891357,3575891365,8
1,1167,38971,3575891357,3575891367,10
1,1167,38972,3575891357,3575891369,12
1,1167,38973,3575891357,3575891371,14
1,1167,38974,3575891357,3575891372,15
1,1167,38975,3575891357,3575891373,16
1,1167,38976,3575891357,3575891373,16
1,1167,38977,3575891357,3575891374,17
1,1167,38978,3575891357,3575891374,17
1,1167,38979,3575891357,3575891375,18
1,1167,38980,3575891357,3575891379,22
1,1167,38981,3575891357,3575891379,22
1,1167,38982,3575891357,3575891380,23
1,1167,38983,3575891357,3575891381,24
1,1167,38984,3575891357,3575891381,24
1,1167,38985,3575891357,3575891382,25
1,1167,38986,3575891357,3575891382,25
1,1167,38987,3575891357,3575891383,26
1,1167,38988,3575891357,3575891384,27
1,1167,38989,3575891357,3575891385,28
1,1167,38990,3575891357,3575891385,28
1,1167,38991,3575891357,3575891385,28
1,1167,38992,3575891357,3575891387,30
1,1167,38993,3575891357,3575891390,33
1,1167,38994,3575891357,3575891390,33
1,1167,38995,3575891357,3575891390,33
1,1167,38996,3575891357,3575891390,33
1,1167,38997,3575891357,3575891391,34
1,1167,38998,3575891357,3575891391,34
1,1167,38999,3575891357,3575891391,34
1,1167,39000,3575891357,3575891393,36
1,1167,39001,3575891357,3575891393,36
1,1167,39002,3575891357,3575891395,38
1,1167,39003,3575891357,3575891396,39
1,1167,39004,3575891357,3575891397,40
1,1167,39005,3575891357,3575891398,41
1,1167,39006,3575891357,3575891398,41
1,1167,39007,3575891357,3575891399,42
1,1167,39008,3575891357,3575891400,43
1,1167,39009,3575891357,3575891401,44
1,1167,39010,3575891357,3575891402,45
1,1167,39011,3575891357,3575891402,45
1,1167,39012,3575891357,3575891403,46
1,1167,39013,3575891357,3575891405,48
1,1167,39014,3575891357,3575891405,48
1,1167,39015,3575891357,3575891406,49
1,1168,39016,3575891421,3575891421,0
1,1168,39017,3575891421,3575891421,0
1,1168,39018,3575891421,3575891421,0
1,1168,39019,3575891421,3575891421,0
1,1168,39020,3575891421,3575891421,0
1,1168,39021,3575891421,3575891421,0
1,1168,39022,3575891421,3575891421,0
1,1168,39023,3575891421,3575891421,0
1,1168,39024,3575891421,3575891421,0
1,1168,39025,3575891421,3575891421,0
1,1168,39026,3575891421,3575891421,0
1,1168,39027,3575891421,3575891421,0
1,1168,39028,3575891421,3575891421,0
1,1168,39029,3575891421,3575891421,0
1,1168,39030,3575891421,3575891421,0
1,1168,39031,3575891421,3575891421,0
1,1168,39032,3575891421,3575891421,0
1,1168,39033,3575891421,3575891421,0
1,1168,39034,3575891421,3575891421,0
1,1168,39035,3575891421,3575891421,0
1,1168,39036,3575891421,3575891421,0
1,1168,39037,3575891421,3575891421,0
1,1168,39038,3575891421,3575891422,1
1,1168,39039,3575891421,3575891423,2
1,1168,39040,3575891421,3575891423,2
1,1168,39041,3575891421,3575891423,2
1,1168,39042,3575891421,3575891424,3
1,1168,39043,3575891421,3575891424,3
1,1168,39044,3575891421,3575891426,5
1,1168,39045,3575891421,3575891426,5
1,1168,39046,3575891421,3575891426,5
1,1168,39047,3575891421,3575891427,6
1,1168,39048,3575891421,3575891427,6
1,1168,39049,3575891421,3575891428,7
1,1168,39050,3575891421,3575891429,8
1,1168,39051,3575891421,3575891429,8
1,1168,39052,3575891421,3575891431,10
1,1168,39053,3575891421,3575891431,10
1,1168,39054,3575891421,3575891432,11
1,1168,39055,3575891421,3575891433,12
1,1168,39056,3575891421,3575891434,13
1,1168,39057,3575891421,3575891435,14
1,1168,39058,3575891421,3575891436,15
1,1168,39059,3575891421,3575891436,15
1,1168,39060,3575891421,3575891436,15
1,1168,39061,3575891421,3575891440,19
1,1168,39062,3575891421,3575891440,19
1,1168,39063,3575891421,3575891441,20
1,1168,39064,3575891421,3575891443,22
1,1168,39065,3575891421,3575891444,23
1,1168,39066,3575891421,3575891445,24
1,1168,39067,3575891421,3575891445,24
1,1168,39068,3575891421,3575891445,24
1,1168,39069,3575891421,3575891446,25
1,1168,39070,3575891421,3575891447,26
1,1168,39071,3575891421,3575891447,26
1,1168,39072,3575891421,3575891449,28
1,1168,39073,3575891421,3575891449,28
1,1168,39074,3575891421,3575891450,29
1,1168,39075,3575891421,3575891450,29
1,1168,39076,3575891421,3575891451,30
1,1168,39077,3575891421,3575891451,30
1,1168,39078,3575891421,3575891453,32
1,1168,39079,3575891421,3575891453,32
1,1168,39080,3575891421,3575891454,33
1,1168,39081,3575891421,3575891454,33
1,1168,39082,3575891421,3575891456,35
1,1168,39083,3575891421,3575891456,35
1,1168,39084,3575891421,3575891456,35
1,1168,39085,3575891421,3575891458,37
1,1168,39086,3575891421,3575891459,38
1,1168,39087,3575891421,3575891459,38
1,1168,39088,3575891421,3575891463,42
1,1168,39089,3575891421,3575891464,43
1,1168,39090,3575891421,3575891464,43
1,1168,39091,3575891421,3575891467,46
1,1168,39092,3575891421,3575891467,46
1,1168,39093,3575891421,3575891467,46
1,1168,39094,3575891421,3575891468,47
1,1168,39095,3575891421,3575891469,48
1,1169,39096,3575891484,3575891484,0
1,1169,39097,3575891484,3575891484,0
1,1169,39098,3575891484,3575891484,0
1,1169,39099,3575891484,3575891484,0
1,1169,39100,3575891484,3575891484,0
1,1169,39101,3575891484,3575891484,0
1,1169,39102,3575891484,3575891484,0
1,1169,39103,3575891484,3575891484,0
1,1169,39104,3575891484,3575891484,0
1,1169,39105,3575891484,3575891486,2
1,1169,39106,3575891484,3575891486,2
1,1169,39107,3575891484,3575891487,3
1,1169,39108,3575891484,3575891488,4
1,1169,39109,3575891484,3575891489,5
1,1169,39110,3575891484,3575891491,7
1,1169,39111,3575891484,3575891491,7
1,1169,39112,3575891484,3575891491,7
1,1169,39113,3575891484,3575891491,7
1,1169,39114,3575891484,3575891493,9
1,1169,39115,3575891484,3575891493,9
1,1169,39116,3575891484,3575891494,10
1,1169,39117,3575891484,3575891494,10
1,1169,39118,3575891484,3575891494,10
1,1169,39119,3575891484,3575891494,10
1,1169,39120,3575891484,3575891498,14
1,1169,39121,3575891484,3575891498,14
1,1169,39122,3575891484,3575891499,15
1,1169,39123,3575891484,3575891499,15
1,1169,39124,3575891484,3575891500,16
1,1169,39125,3575891484,3575891500,16
1,1169,39126,3575891484,3575891500,16
1,1169,39127,3575891484,3575891501,17
1,1169,39128,3575891484,3575891501,17
1,1169,39129,3575891484,3575891501,17
1,1169,39130,3575891484,3575891502,18
1,1169,39131,3575891484,3575891502,18
1,1169,39132,3575891484,3575891503,19
1,1169,39133,3575891484,3575891503,19
1,1169,39134,3575891484,3575891504,20
1,1169,39135,3575891484,3575891505,21
1,1169,39136,3575891484,3575891505,21
1,1169,39137,3575891484,3575891505,21
1,1169,39138,3575891484,3575891505,21
1,1169,39139,3575891484,3575891508,24
1,1169,39140,3575891484,3575891509,25
1,1169,39141,3575891484,3575891509,25
1,1169,39142,3575891484,3575891509,25
1,1169,39143,3575891484,3575891510,26
1,1169,39144,3575891484,3575891512,28
1,1169,39145,3575891484,3575891512,28
1,1169,39146,3575891484,3575891513,29
1,1169,39147,3575891484,3575891514,30
1,1169,39148,3575891484,3575891514,30
1,1169,39149,3575891484,3575891514,30
1,1169,39150,3575891484,3575891514,30
1,1169,39151,3575891484,3575891515,31
1,1169,39152,3575891484,3575891516,32
1,1169,39153,3575891484,3575891519,35
1,1169,39154,3575891484,3575891519,35
1,1169,39155,3575891484,3575891520,36
1,1169,39156,3575891484,3575891521,37
1,1169,39157,3575891484,3575891522,38
1,1169,39158,3575891484,3575891523,39
1,1169,39159,3575891484,3575891523,39
1,1169,39160,3575891484,3575891523,39
1,1169,39161,3575891484,3575891525,41
1,1169,39162,3575891484,3575891525,41
1,1169,39163,3575891484,3575891526,42
1,1169,39164,3575891484,3575891528,44
1,1169,39165,3575891484,3575891528,44
1,1169,39166,3575891484,3575891528,44
1,1169,39167,3575891484,3575891528,44
1,1169,39168,3575891484,3575891529,45
1,1169,39169,3575891484,3575891529,45
1,1169,39170,3575891484,3575891530,46
1,1169,39171,3575891484,3575891530,46
1,1169,39172,3575891484,3575891530,46
1,1169,39173,3575891484,3575891531,47
1,1169,39174,3575891484,3575891531,47
1,1169,39175,3575891484,3575891531,47
1,1169,39176,3575891484,3575891534,50
1,1169,39177,3575891484,3575891534,50
1,1170,39178,3575891547,3575891547,0
1,1170,39179,3575891547,3575891547,0
1,1170,39180,3575891547,3575891547,0
1,1170,39181,3575891547,3575891547,0
1,1170,39182,3575891547,3575891547,0
1,1170,39183,3575891547,3575891547,0
1,1170,39184,3575891547,3575891547,0
1,1170,39185,3575891547,3575891547,0
1,1170,39186,3575891547,3575891547,0
1,1170,39187,3575891547,3575891547,0
1,1170,39188,3575891547,3575891547,0
1,1170,39189,3575891547,3575891547,0
1,1170,39190,3575891547,3575891548,1
1,1170,39191,3575891547,3575891549,2
1,1170,39192,3575891547,3575891549,2
1,1170,39193,3575891547,3575891550,3
1,1170,39194,3575891547,3575891551,4
1,1170,39195,3575891547,3575891552,5
1,1170,39196,3575891547,3575891553,6
1,1170,39197,3575891547,3575891555,8
1,1170,39198,3575891547,3575891555,8
1,1170,39199,3575891547,3575891556,9
1,1170,39200,3575891547,3575891557,10
1,1170,39201,3575891547,3575891557,10
1,1170,39202,3575891547,3575891559,12
1,1170,39203,3575891547,3575891560,13
1,1170,39204,3575891547,3575891561,14
1,1170,39205,3575891547,3575891561,14
1,1170,39206,3575891547,3575891561,14
1,1170,39207,3575891547,3575891562,15
1,1170,39208,3575891547,3575891563,16
1,1170,39209,3575891547,3575891564,17
1,1170,39210,3575891547,3575891567,20
1,1170,39211,3575891547,3575891568,21
1,1170,39212,3575891547,3575891570,23
1,1170,39213,3575891547,3575891571,24
1,1170,39214,3575891547,3575891572,25
1,1170,39215,3575891547,3575891572,25
1,1170,39216,3575891547,3575891573,26
1,1170,39217,3575891547,3575891574,27
1,1170,39218,3575891547,3575891575,28
1,1170,39219,3575891547,3575891577,30
1,1170,39220,3575891547,3575891579,32
1,1170,39221,3575891547,3575891579,32
1,1170,39222,3575891547,3575891579,32
1,1170,39223,3575891547,3575891580,33
1,1170,39224,3575891547,3575891580,33
1,1170,39225,3575891547,3575891582,35
1,1170,39226,3575891547,3575891582,35
1,1170,39227,3575891547,3575891582,35
1,1170,39228,3575891547,3575891583,36
1,1170,39229,3575891547,3575891584,37
1,1170,39230,3575891547,3575891584,37
1,1170,39231,3575891547,3575891585,38
1,1170,39232,3575891547,3575891585,38
1,1170,39233,3575891547,3575891589,42
1,1170,39234,3575891547,3575891590,43
1,1170,39235,3575891547,3575891590,43
1,1170,39236,3575891547,3575891591,44
1,1170,39237,3575891547,3575891591,44
1,1170,39238,3575891547,3575891591,44
1,1170,39239,3575891547,3575891594,47
1,1170,39240,3575891547,3575891594,47
1,1170,39241,3575891547,3575891595,48
1,1170,39242,3575891547,3575891596,49
1,1170,39243,3575891547,3575891597,50
1,1171,39244,3575891612,3575891612,0
1,1171,39245,3575891612,3575891612,0
1,1171,39246,3575891612,3575891612,0
1,1171,39247,3575891612,3575891612,0
1,1171,39248,3575891612,3575891612,0
1,1171,39249,3575891612,3575891612,0
1,1171,39250,3575891612,3575891612,0
1,1171,39251,3575891612,3575891612,0
1,1171,39252,3575891612,3575891612,0
1,1171,39253,3575891612,3575891612,0
1,1171,39254,3575891612,3575891612,0
1,1171,39255,3575891612,3575891612,0
1,1171,39256,3575891612,3575891612,0
1,1171,39257,3575891612,3575891612,0
1,1171,39258,3575891612,3575891612,0
1,1171,39259,3575891612,3575891612,0
1,1171,39260,3575891612,3575891612,0
1,1171,39261,3575891612,3575891612,0
1,1171,39262,3575891612,3575891612,0
1,1171,39263,3575891612,3575891613,1
1,1171,39264,3575891612,3575891613,1
1,1171,39265,3575891612,3575891613,1
1,1171,39266,3575891612,3575891613,1
1,1171,39267,3575891612,3575891616,4
1,1171,39268,3575891612,3575891616,4
1,1171,39269,3575891612,3575891617,5
1,1171,39270,3575891612,3575891617,5
1,1171,39271,3575891612,3575891618,6
1,1171,39272,3575891612,3575891620,8
1,1171,39273,3575891612,3575891621,9
1,1171,39274,3575891612,3575891622,10
1,1171,39275,3575891612,3575891622,10
1,1171,39276,3575891612,3575891623,11
1,1171,39277,3575891612,3575891623,11
1,1171,39278,3575891612,3575891624,12
1,1171,39279,3575891612,3575891624,12
1,1171,39280,3575891612,3575891625,13
1,1171,39281,3575891612,3575891626,14
1,1171,39282,3575891612,3575891627,15
1,1171,39283,3575891612,3575891627,15
1,1171,39284,3575891612,3575891628,16
1,1171,39285,3575891612,3575891628,16
1,1171,39286,3575891612,3575891629,17
1,1171,39287,3575891612,3575891631,19
1,1171,39288,3575891612,3575891631,19
1,1171,39289,3575891612,3575891631,19
1,1171,39290,3575891612,3575891631,19
1,1171,39291,3575891612,3575891632,20
1,1171,39292,3575891612,3575891633,21
1,1171,39293,3575891612,3575891633,21
1,1171,39294,3575891612,3575891635,23
1,1171,39295,3575891612,3575891635,23
1,1171,39296,3575891612,3575891638,26
1,1171,39297,3575891612,3575891641,29
1,1171,39298,3575891612,3575891643,31
1,1171,39299,3575891612,3575891644,32
1,1171,39300,3575891612,3575891644,32
1,1171,39301,3575891612,3575891644,32
1,1171,39302,3575891612,3575891644,32
1,1171,39303,3575891612,3575891645,33
1,1171,39304,3575891612,3575891646,34
1,1171,39305,3575891612,3575891646,34
1,1171,39306,3575891612,3575891648,36
1,1171,39307,3575891612,3575891648,36
1,1171,39308,3575891612,3575891649,37
1,1171,39309,3575891612,3575891649,37
1,1171,39310,3575891612,3575891649,37
1,1171,39311,3575891612,3575891650,38
1,1171,39312,3575891612,3575891650,38
1,1171,39313,3575891612,3575891650,38
1,1171,39314,3575891612,3575891652,40
1,1171,39315,3575891612,3575891652,40
1,1171,39316,3575891612,3575891653,41
1,1171,39317,3575891612,3575891653,41
1,1171,39318,3575891612,3575891653,41
1,1171,39319,3575891612,3575891655,43
1,1171,39320,3575891612,3575891655,43
1,1171,39321,3575891612,3575891656,44
1,1171,39322,3575891612,3575891657,45
1,1171,39323,3575891612,3575891658,46
1,1171,39324,3575891612,3575891662,50
1,1172,39325,3575891674,3575891674,0
1,1172,39326,3575891674,3575891674,0
1,1172,39327,3575891674,3575891674,0
1,1172,39328,3575891674,3575891674,0
1,1172,39329,3575891674,3575891674,0
1,1172,39330,3575891674,3575891674,0
1,1172,39331,3575891674,3575891680,6
1,1172,39332,3575891674,3575891682,8
1,1172,39333,3575891674,3575891683,9
1,1172,39334,3575891674,3575891683,9
1,1172,39335,3575891674,3575891684,10
1,1172,39336,3575891674,3575891684,10
1,1172,39337,3575891674,3575891684,10
1,1172,39338,3575891674,3575891685,11
1,1172,39339,3575891674,3575891686,12
1,1172,39340,3575891674,3575891687,13
1,1172,39341,3575891674,3575891688,14
1,1172,39342,3575891674,3575891689,15
1,1172,39343,3575891674,3575891690,16
1,1172,39344,3575891674,3575891692,18
1,1172,39345,3575891674,3575891692,18
1,1172,39346,3575891674,3575891692,18
1,1172,39347,3575891674,3575891692,18
1,1172,39348,3575891674,3575891693,19
1,1172,39349,3575891674,3575891694,20
1,1172,39350,3575891674,3575891694,20
1,1172,39351,3575891674,3575891695,21
1,1172,39352,3575891674,3575891695,21
1,1172,39353,3575891674,3575891697,23
1,1172,39354,3575891674,3575891698,24
1,1172,39355,3575891674,3575891699,25
1,1172,39356,3575891674,3575891699,25
1,1172,39357,3575891674,3575891700,26
1,1172,39358,3575891674,3575891700,26
1,1172,39359,3575891674,3575891700,26
1,1172,39360,3575891674,3575891700,26
1,1172,39361,3575891674,3575891701,27
1,1172,39362,3575891674,3575891702,28
1,1172,39363,3575891674,3575891702,28
1,1172,39364,3575891674,3575891702,28
1,1172,39365,3575891674,3575891702,28
1,1172,39366,3575891674,3575891703,29
1,1172,39367,3575891674,3575891704,30
1,1172,39368,3575891674,3575891705,31
1,1172,39369,3575891674,3575891705,31
1,1172,39370,3575891674,3575891705,31
1,1172,39371,3575891674,3575891705,31
1,1172,39372,3575891674,3575891706,32
1,1172,39373,3575891674,3575891707,33
1,1172,39374,3575891674,3575891708,34
1,1172,39375,3575891674,3575891709,35
1,1172,39376,3575891674,3575891709,35
1,1172,39377,3575891674,3575891710,36
1,1172,39378,3575891674,3575891711,37
1,1172,39379,3575891674,3575891711,37
1,1172,39380,3575891674,3575891713,39
1,1172,39381,3575891674,3575891713,39
1,1172,39382,3575891674,3575891714,40
1,1172,39383,3575891674,3575891714,40
1,1172,39384,3575891674,3575891714,40
1,1172,39385,3575891674,3575891716,42
1,1172,39386,3575891674,3575891718,44
1,1172,39387,3575891674,3575891719,45
1,1172,39388,3575891674,3575891720,46
1,1172,39389,3575891674,3575891720,46
1,1172,39390,3575891674,3575891722,48
1,1172,39391,3575891674,3575891722,48
1,1172,39392,3575891674,3575891723,49
1,1172,39393,3575891674,3575891723,49
1,1172,39394,3575891674,3575891723,49
1,1172,39395,3575891674,3575891733,59
1,1172,39396,3575891674,3575891733,59
1,1172,39397,3575891674,3575891733,59
1,1172,39398,3575891674,3575891733,59
1,1172,39399,3575891674,3575891733,59
1,1172,39400,3575891674,3575891733,59
1,1172,39401,3575891674,3575891733,59
1,1172,39402,3575891674,3575891733,59
1,1172,39403,3575891674,3575891733,59
1,1172,39404,3575891674,3575891733,59
1,1172,39405,3575891674,3575891733,59
1,1172,39406,3575891674,3575891733,59
1,1172,39407,3575891674,3575891733,59
1,1173,39408,3575891751,3575891751,0
1,1173,39409,3575891751,3575891751,0
1,1173,39410,3575891751,3575891751,0
1,1173,39411,3575891751,3575891751,0
1,1173,39412,3575891751,3575891751,0
1,1173,39413,3575891751,3575891751,0
1,1173,39414,3575891751,3575891751,0
1,1173,39415,3575891751,3575891751,0
1,1173,39416,3575891751,3575891751,0
1,1173,39417,3575891751,3575891751,0
1,1173,39418,3575891751,3575891751,0
1,1173,39419,3575891751,3575891751,0
1,1173,39420,3575891751,3575891751,0
1,1173,39421,3575891751,3575891751,0
1,1173,39422,3575891751,3575891751,0
1,1173,39423,3575891751,3575891751,0
1,1173,39424,3575891751,3575891751,0
1,1173,39425,3575891751,3575891751,0
1,1173,39426,3575891751,3575891751,0
1,1173,39427,3575891751,3575891753,2
1,1173,39428,3575891751,3575891753,2
1,1173,39429,3575891751,3575891754,3
1,1173,39430,3575891751,3575891756,5
1,1173,39431,3575891751,3575891757,6
1,1173,39432,3575891751,3575891758,7
1,1173,39433,3575891751,3575891759,8
1,1173,39434,3575891751,3575891759,8
1,1173,39435,3575891751,3575891761,10
1,1173,39436,3575891751,3575891761,10
1,1173,39437,3575891751,3575891761,10
1,1173,39438,3575891751,3575891762,11
1,1173,39439,3575891751,3575891763,12
1,1173,39440,3575891751,3575891764,13
1,1173,39441,3575891751,3575891764,13
1,1173,39442,3575891751,3575891766,15
1,1173,39443,3575891751,3575891768,17
1,1173,39444,3575891751,3575891770,19
1,1173,39445,3575891751,3575891772,21
1,1173,39446,3575891751,3575891772,21
1,1173,39447,3575891751,3575891773,22
1,1173,39448,3575891751,3575891774,23
1,1173,39449,3575891751,3575891775,24
1,1173,39450,3575891751,3575891778,27
1,1173,39451,3575891751,3575891778,27
1,1173,39452,3575891751,3575891779,28
1,1173,39453,3575891751,3575891780,29
1,1173,39454,3575891751,3575891780,29
1,1173,39455,3575891751,3575891780,29
1,1173,39456,3575891751,3575891782,31
1,1173,39457,3575891751,3575891782,31
1,1173,39458,3575891751,3575891783,32
1,1173,39459,3575891751,3575891783,32
1,1173,39460,3575891751,3575891783,32
1,1173,39461,3575891751,3575891784,33
1,1173,39462,3575891751,3575891784,33
1,1173,39463,3575891751,3575891785,34
1,1173,39464,3575891751,3575891788,37
1,1173,39465,3575891751,3575891789,38
1,1173,39466,3575891751,3575891789,38
1,1173,39467,3575891751,3575891789,38
1,1173,39468,3575891751,3575891791,40
1,1173,39469,3575891751,3575891791,40
1,1173,39470,3575891751,3575891792,41
1,1173,39471,3575891751,3575891792,41
1,1173,39472,3575891751,3575891792,41
1,1173,39473,3575891751,3575891793,42
1,1173,39474,3575891751,3575891794,43
1,1173,39475,3575891751,3575891795,44
1,1173,39476,3575891751,3575891795,44
1,1173,39477,3575891751,3575891797,46
1,1173,39478,3575891751,3575891797,46
1,1173,39479,3575891751,3575891798,47
1,1173,39480,3575891751,3575891799,48
1,1173,39481,3575891751,3575891799,48
1,1173,39482,3575891751,3575891800,49
1,1173,39483,3575891751,3575891800,49
1,1174,39484,3575891815,3575891815,0
1,1174,39485,3575891815,3575891815,0
1,1174,39486,3575891815,3575891815,0
1,1174,39487,3575891815,3575891815,0
1,1174,39488,3575891815,3575891815,0
1,1174,39489,3575891815,3575891815,0
1,1174,39490,3575891815,3575891815,0
1,1174,39491,3575891815,3575891815,0
1,1174,39492,3575891815,3575891815,0
1,1174,39493,3575891815,3575891815,0
1,1174,39494,3575891815,3575891815,0
1,1174,39495,3575891815,3575891815,0
1,1174,39496,3575891815,3575891815,0
1,1174,39497,3575891815,3575891815,0
1,1174,39498,3575891815,3575891815,0
1,1174,39499,3575891815,3575891815,0
1,1174,39500,3575891815,3575891815,0
1,1174,39501,3575891815,3575891815,0
1,1174,39502,3575891815,3575891815,0
1,1174,39503,3575891815,3575891816,1
1,1174,39504,3575891815,3575891816,1
1,1174,39505,3575891815,3575891817,2
1,1174,39506,3575891815,3575891817,2
1,1174,39507,3575891815,3575891818,3
1,1174,39508,3575891815,3575891820,5
1,1174,39509,3575891815,3575891821,6
1,1174,39510,3575891815,3575891821,6
1,1174,39511,3575891815,3575891822,7
1,1174,39512,3575891815,3575891823,8
1,1174,39513,3575891815,3575891823,8
1,1174,39514,3575891815,3575891824,9
1,1174,39515,3575891815,3575891825,10
1,1174,39516,3575891815,3575891825,10
1,1174,39517,3575891815,3575891825,10
1,1174,39518,3575891815,3575891826,11
1,1174,39519,3575891815,3575891827,12
1,1174,39520,3575891815,3575891827,12
1,1174,39521,3575891815,3575891828,13
1,1174,39522,3575891815,3575891830,15
1,1174,39523,3575891815,3575891831,16
1,1174,39524,3575891815,3575891831,16
1,1174,39525,3575891815,3575891831,16
1,1174,39526,3575891815,3575891832,17
1,1174,39527,3575891815,3575891832,17
1,1174,39528,3575891815,3575891833,18
1,1174,39529,3575891815,3575891834,19
1,1174,39530,3575891815,3575891835,20
1,1174,39531,3575891815,3575891836,21
1,1174,39532,3575891815,3575891837,22
1,1174,39533,3575891815,3575891838,23
1,1174,39534,3575891815,3575891839,24
1,1174,39535,3575891815,3575891841,26
1,1174,39536,3575891815,3575891843,28
1,1174,39537,3575891815,3575891843,28
1,1174,39538,3575891815,3575891844,29
1,1174,39539,3575891815,3575891844,29
1,1174,39540,3575891815,3575891845,30
1,1174,39541,3575891815,3575891846,31
1,1174,39542,3575891815,3575891846,31
1,1174,39543,3575891815,3575891846,31
1,1174,39544,3575891815,3575891847,32
1,1174,39545,3575891815,3575891847,32
1,1174,39546,3575891815,3575891848,33
1,1174,39547,3575891815,3575891849,34
1,1174,39548,3575891815,3575891850,35
1,1174,39549,3575891815,3575891850,35
1,1174,39550,3575891815,3575891850,35
1,1174,39551,3575891815,3575891851,36
1,1174,39552,3575891815,3575891852,37
1,1174,39553,3575891815,3575891853,38
1,1174,39554,3575891815,3575891853,38
1,1174,39555,3575891815,3575891853,38
1,1174,39556,3575891815,3575891853,38
1,1174,39557,3575891815,3575891855,40
1,1174,39558,3575891815,3575891856,41
1,1174,39559,3575891815,3575891856,41
1,1174,39560,3575891815,3575891858,43
1,1174,39561,3575891815,3575891858,43
1,1174,39562,3575891815,3575891862,47
1,1174,39563,3575891815,3575891862,47
1,1174,39564,3575891815,3575891863,48
1,1174,39565,3575891815,3575891865,50
1,1175,39566,3575891878,3575891878,0
1,1175,39567,3575891878,3575891878,0
1,1175,39568,3575891878,3575891878,0
1,1175,39569,3575891878,3575891879,1
1,1175,39570,3575891878,3575891879,1
1,1175,39571,3575891878,3575891881,3
1,1175,39572,3575891878,3575891883,5
1,1175,39573,3575891878,3575891884,6
1,1175,39574,3575891878,3575891884,6
1,1175,39575,3575891878,3575891884,6
1,1175,39576,3575891878,3575891884,6
1,1175,39577,3575891878,3575891885,7
1,1175,39578,3575891878,3575891886,8
1,1175,39579,3575891878,3575891887,9
1,1175,39580,3575891878,3575891888,10
1,1175,39581,3575891878,3575891889,11
1,1175,39582,3575891878,3575891891,13
1,1175,39583,3575891878,3575891892,14
1,1175,39584,3575891878,3575891892,14
1,1175,39585,3575891878,3575891892,14
1,1175,39586,3575891878,3575891894,16
1,1175,39587,3575891878,3575891894,16
1,1175,39588,3575891878,3575891895,17
1,1175,39589,3575891878,3575891895,17
1,1175,39590,3575891878,3575891895,17
1,1175,39591,3575891878,3575891897,19
1,1175,39592,3575891878,3575891898,20
1,1175,39593,3575891878,3575891898,20
1,1175,39594,3575891878,3575891899,21
1,1175,39595,3575891878,3575891900,22
1,1175,39596,3575891878,3575891900,22
1,1175,39597,3575891878,3575891900,22
1,1175,39598,3575891878,3575891901,23
1,1175,39599,3575891878,3575891901,23
1,1175,39600,3575891878,3575891902,24
1,1175,39601,3575891878,3575891902,24
1,1175,39602,3575891878,3575891903,25
1,1175,39603,3575891878,3575891904,26
1,1175,39604,3575891878,3575891905,27
1,1175,39605,3575891878,3575891905,27
1,1175,39606,3575891878,3575891905,27
1,1175,39607,3575891878,3575891906,28
1,1175,39608,3575891878,3575891906,28
1,1175,39609,3575891878,3575891907,29
1,1175,39610,3575891878,3575891909,31
1,1175,39611,3575891878,3575891909,31
1,1175,39612,3575891878,3575891910,32
1,1175,39613,3575891878,3575891910,32
1,1175,39614,3575891878,3575891910,32
1,1175,39615,3575891878,3575891911,33
1,1175,39616,3575891878,3575891912,34
1,1175,39617,3575891878,3575891913,35
1,1175,39618,3575891878,3575891914,36
1,1175,39619,3575891878,3575891914,36
1,1175,39620,3575891878,3575891915,37
1,1175,39621,3575891878,3575891915,37
1,1175,39622,3575891878,3575891916,38
1,1175,39623,3575891878,3575891916,38
1,1175,39624,3575891878,3575891918,40
1,1175,39625,3575891878,3575891919,41
1,1175,39626,3575891878,3575891920,42
1,1175,39627,3575891878,3575891920,42
1,1175,39628,3575891878,3575891922,44
1,1175,39629,3575891878,3575891923,45
1,1175,39630,3575891878,3575891923,45
1,1175,39631,3575891878,3575891923,45
1,1175,39632,3575891878,3575891923,45
1,1175,39633,3575891878,3575891926,48
1,1176,39634,3575891944,3575891944,0
1,1176,39635,3575891944,3575891944,0
1,1176,39636,3575891944,3575891944,0
1,1176,39637,3575891944,3575891944,0
1,1176,39638,3575891944,3575891944,0
1,1176,39639,3575891944,3575891944,0
1,1176,39640,3575891944,3575891944,0
1,1176,39641,3575891944,3575891944,0
1,1176,39642,3575891944,3575891944,0
1,1176,39643,3575891944,3575891944,0
1,1176,39644,3575891944,3575891944,0
1,1176,39645,3575891944,3575891944,0
1,1176,39646,3575891944,3575891944,0
1,1176,39647,3575891944,3575891944,0
1,1176,39648,3575891944,3575891944,0
1,1176,39649,3575891944,3575891944,0
1,1176,39650,3575891944,3575891944,0
1,1176,39651,3575891944,3575891944,0
1,1176,39652,3575891944,3575891944,0
1,1176,39653,3575891944,3575891944,0
1,1176,39654,3575891944,3575891944,0
1,1176,39655,3575891944,3575891944,0
1,1176,39656,3575891944,3575891946,2
1,1176,39657,3575891944,3575891946,2
1,1176,39658,3575891944,3575891947,3
1,1176,39659,3575891944,3575891948,4
1,1176,39660,3575891944,3575891948,4
1,1176,39661,3575891944,3575891949,5
1,1176,39662,3575891944,3575891950,6
1,1176,39663,3575891944,3575891951,7
1,1176,39664,3575891944,3575891953,9
1,1176,39665,3575891944,3575891953,9
1,1176,39666,3575891944,3575891953,9
1,1176,39667,3575891944,3575891953,9
1,1176,39668,3575891944,3575891954,10
1,1176,39669,3575891944,3575891956,12
1,1176,39670,3575891944,3575891956,12
1,1176,39671,3575891944,3575891958,14
1,1176,39672,3575891944,3575891958,14
1,1176,39673,3575891944,3575891959,15
1,1176,39674,3575891944,3575891959,15
1,1176,39675,3575891944,3575891960,16
1,1176,39676,3575891944,3575891961,17
1,1176,39677,3575891944,3575891962,18
1,1176,39678,3575891944,3575891963,19
1,1176,39679,3575891944,3575891964,20
1,1176,39680,3575891944,3575891965,21
1,1176,39681,3575891944,3575891965,21
1,1176,39682,3575891944,3575891966,22
1,1176,39683,3575891944,3575891969,25
1,1176,39684,3575891944,3575891970,26
1,1176,39685,3575891944,3575891972,28
1,1176,39686,3575891944,3575891973,29
1,1176,39687,3575891944,3575891973,29
1,1176,39688,3575891944,3575891974,30
1,1176,39689,3575891944,3575891975,31
1,1176,39690,3575891944,3575891978,34
1,1176,39691,3575891944,3575891978,34
1,1176,39692,3575891944,3575891979,35
1,1176,39693,3575891944,3575891979,35
1,1176,39694,3575891944,3575891979,35
1,1176,39695,3575891944,3575891980,36
1,1176,39696,3575891944,3575891982,38
1,1176,39697,3575891944,3575891982,38
1,1176,39698,3575891944,3575891983,39
1,1176,39699,3575891944,3575891983,39
1,1176,39700,3575891944,3575891984,40
1,1176,39701,3575891944,3575891984,40
1,1176,39702,3575891944,3575891984,40
1,1176,39703,3575891944,3575891985,41
1,1176,39704,3575891944,3575891988,44
1,1176,39705,3575891944,3575891988,44
1,1176,39706,3575891944,3575891989,45
1,1176,39707,3575891944,3575891990,46
1,1176,39708,3575891944,3575891991,47
1,1176,39709,3575891944,3575891991,47
1,1176,39710,3575891944,3575891991,47
1,1176,39711,3575891944,3575891992,48
1,1176,39712,3575891944,3575891992,48
1,1176,39713,3575891944,3575891993,49
1,1176,39714,3575891944,3575891994,50
1,1177,39715,3575892008,3575892008,0
1,1177,39716,3575892008,3575892008,0
1,1177,39717,3575892008,3575892008,0
1,1177,39718,3575892008,3575892008,0
1,1177,39719,3575892008,3575892008,0
1,1177,39720,3575892008,3575892008,0
1,1177,39721,3575892008,3575892008,0
1,1177,39722,3575892008,3575892008,0
1,1177,39723,3575892008,3575892008,0
1,1177,39724,3575892008,3575892008,0
1,1177,39725,3575892008,3575892008,0
1,1177,39726,3575892008,3575892008,0
1,1177,39727,3575892008,3575892008,0
1,1177,39728,3575892008,3575892008,0
1,1177,39729,3575892008,3575892008,0
1,1177,39730,3575892008,3575892008,0
1,1177,39731,3575892008,3575892008,0
1,1177,39732,3575892008,3575892009,1
1,1177,39733,3575892008,3575892011,3
1,1177,39734,3575892008,3575892011,3
1,1177,39735,3575892008,3575892011,3
1,1177,39736,3575892008,3575892012,4
1,1177,39737,3575892008,3575892012,4
1,1177,39738,3575892008,3575892013,5
1,1177,39739,3575892008,3575892013,5
1,1177,39740,3575892008,3575892014,6
1,1177,39741,3575892008,3575892015,7
1,1177,39742,3575892008,3575892016,8
1,1177,39743,3575892008,3575892017,9
1,1177,39744,3575892008,3575892017,9
1,1177,39745,3575892008,3575892017,9
1,1177,39746,3575892008,3575892018,10
1,1177,39747,3575892008,3575892018,10
1,1177,39748,3575892008,3575892020,12
1,1177,39749,3575892008,3575892022,14
1,1177,39750,3575892008,3575892022,14
1,1177,39751,3575892008,3575892023,15
1,1177,39752,3575892008,3575892023,15
1,1177,39753,3575892008,3575892024,16
1,1177,39754,3575892008,3575892025,17
1,1177,39755,3575892008,3575892025,17
1,1177,39756,3575892008,3575892025,17
1,1177,39757,3575892008,3575892026,18
1,1177,39758,3575892008,3575892027,19
1,1177,39759,3575892008,3575892028,20
1,1177,39760,3575892008,3575892029,21
1,1177,39761,3575892008,3575892029,21
1,1177,39762,3575892008,3575892030,22
1,1177,39763,3575892008,3575892031,23
1,1177,39764,3575892008,3575892031,23
1,1177,39765,3575892008,3575892032,24
1,1177,39766,3575892008,3575892032,24
1,1177,39767,3575892008,3575892033,25
1,1177,39768,3575892008,3575892035,27
1,1177,39769,3575892008,3575892036,28
1,1177,39770,3575892008,3575892037,29
1,1177,39771,3575892008,3575892039,31
1,1177,39772,3575892008,3575892039,31
1,1177,39773,3575892008,3575892041,33
1,1177,39774,3575892008,3575892043,35
1,1177,39775,3575892008,3575892043,35
1,1177,39776,3575892008,3575892044,36
1,1177,39777,3575892008,3575892045,37
1,1177,39778,3575892008,3575892045,37
1,1177,39779,3575892008,3575892045,37
1,1177,39780,3575892008,3575892045,37
1,1177,39781,3575892008,3575892046,38
1,1177,39782,3575892008,3575892047,39
1,1177,39783,3575892008,3575892047,39
1,1177,39784,3575892008,3575892049,41
1,1177,39785,3575892008,3575892049,41
1,1177,39786,3575892008,3575892050,42
1,1177,39787,3575892008,3575892050,42
1,1177,39788,3575892008,3575892052,44
1,1177,39789,3575892008,3575892053,45
1,1177,39790,3575892008,3575892053,45
1,1177,39791,3575892008,3575892053,45
1,1177,39792,3575892008,3575892054,46
1,1177,39793,3575892008,3575892055,47
1,1177,39794,3575892008,3575892056,48
1,1177,39795,3575892008,3575892056,48
1,1177,39796,3575892008,3575892058,50
1,1178,39797,3575892080,3575892080,0
1,1178,39798,3575892080,3575892080,0
1,1178,39799,3575892080,3575892080,0
1,1178,39800,3575892080,3575892080,0
1,1178,39801,3575892080,3575892080,0
1,1178,39802,3575892080,3575892080,0
1,1178,39803,3575892080,3575892080,0
1,1178,39804,3575892080,3575892080,0
1,1178,39805,3575892080,3575892080,0
1,1178,39806,3575892080,3575892080,0
1,1178,39807,3575892080,3575892080,0
1,1178,39808,3575892080,3575892080,0
1,1178,39809,3575892080,3575892082,2
1,1178,39810,3575892080,3575892083,3
1,1178,39811,3575892080,3575892083,3
1,1178,39812,3575892080,3575892084,4
1,1178,39813,3575892080,3575892084,4
1,1178,39814,3575892080,3575892084,4
1,1178,39815,3575892080,3575892086,6
1,1178,39816,3575892080,3575892086,6
1,1178,39817,3575892080,3575892087,7
1,1178,39818,3575892080,3575892088,8
1,1178,39819,3575892080,3575892089,9
1,1178,39820,3575892080,3575892091,11
1,1178,39821,3575892080,3575892092,12
1,1178,39822,3575892080,3575892092,12
1,1178,39823,3575892080,3575892092,12
1,1178,39824,3575892080,3575892094,14
1,1178,39825,3575892080,3575892094,14
1,1178,39826,3575892080,3575892094,14
1,1178,39827,3575892080,3575892095,15
1,1178,39828,3575892080,3575892096,16
1,1178,39829,3575892080,3575892097,17
1,1178,39830,3575892080,3575892098,18
1,1178,39831,3575892080,3575892099,19
1,1178,39832,3575892080,3575892099,19
1,1178,39833,3575892080,3575892100,20
1,1178,39834,3575892080,3575892100,20
1,1178,39835,3575892080,3575892100,20
1,1178,39836,3575892080,3575892100,20
1,1178,39837,3575892080,3575892102,22
1,1178,39838,3575892080,3575892102,22
1,1178,39839,3575892080,3575892102,22
1,1178,39840,3575892080,3575892102,22
1,1178,39841,3575892080,3575892103,23
1,1178,39842,3575892080,3575892104,24
1,1178,39843,3575892080,3575892104,24
1,1178,39844,3575892080,3575892104,24
1,1178,39845,3575892080,3575892105,25
1,1178,39846,3575892080,3575892106,26
1,1178,39847,3575892080,3575892106,26
1,1178,39848,3575892080,3575892107,27
1,1178,39849,3575892080,3575892109,29
1,1178,39850,3575892080,3575892109,29
1,1178,39851,3575892080,3575892109,29
1,1178,39852,3575892080,3575892110,30
1,1178,39853,3575892080,3575892111,31
1,1178,39854,3575892080,3575892112,32
1,1178,39855,3575892080,3575892114,34
1,1178,39856,3575892080,3575892114,34
1,1178,39857,3575892080,3575892115,35
1,1178,39858,3575892080,3575892115,35
1,1178,39859,3575892080,3575892116,36
1,1178,39860,3575892080,3575892117,37
1,1178,39861,3575892080,3575892119,39
1,1178,39862,3575892080,3575892119,39
1,1178,39863,3575892080,3575892120,40
1,1178,39864,3575892080,3575892122,42
1,1178,39865,3575892080,3575892122,42
1,1178,39866,3575892080,3575892122,42
1,1178,39867,3575892080,3575892123,43
1,1178,39868,3575892080,3575892123,43
1,1178,39869,3575892080,3575892123,43
1,1178,39870,3575892080,3575892126,46
1,1178,39871,3575892080,3575892128,48
1,1178,39872,3575892080,3575892129,49
1,1178,39873,3575892080,3575892129,49
1,1178,39874,3575892080,3575892129,49
1,1178,39875,3575892080,3575892130,50
1,1179,39876,3575892145,3575892145,0
1,1179,39877,3575892145,3575892145,0
1,1179,39878,3575892145,3575892145,0
1,1179,39879,3575892145,3575892145,0
1,1179,39880,3575892145,3575892145,0
1,1179,39881,3575892145,3575892145,0
1,1179,39882,3575892145,3575892145,0
1,1179,39883,3575892145,3575892145,0
1,1179,39884,3575892145,3575892145,0
1,1179,39885,3575892145,3575892145,0
1,1179,39886,3575892145,3575892145,0
1,1179,39887,3575892145,3575892145,0
1,1179,39888,3575892145,3575892145,0
1,1179,39889,3575892145,3575892145,0
1,1179,39890,3575892145,3575892145,0
1,1179,39891,3575892145,3575892145,0
1,1179,39892,3575892145,3575892146,1
1,1179,39893,3575892145,3575892146,1
1,1179,39894,3575892145,3575892148,3
1,1179,39895,3575892145,3575892149,4
1,1179,39896,3575892145,3575892149,4
1,1179,39897,3575892145,3575892150,5
1,1179,39898,3575892145,3575892150,5
1,1179,39899,3575892145,3575892153,8
1,1179,39900,3575892145,3575892153,8
1,1179,39901,3575892145,3575892153,8
1,1179,39902,3575892145,3575892154,9
1,1179,39903,3575892145,3575892154,9
1,1179,39904,3575892145,3575892155,10
1,1179,39905,3575892145,3575892156,11
1,1179,39906,3575892145,3575892156,11
1,1179,39907,3575892145,3575892157,12
1,1179,39908,3575892145,3575892158,13
1,1179,39909,3575892145,3575892159,14
1,1179,39910,3575892145,3575892159,14
1,1179,39911,3575892145,3575892161,16
1,1179,39912,3575892145,3575892161,16
1,1179,39913,3575892145,3575892162,17
1,1179,39914,3575892145,3575892164,19
1,1179,39915,3575892145,3575892165,20
1,1179,39916,3575892145,3575892165,20
1,1179,39917,3575892145,3575892167,22
1,1179,39918,3575892145,3575892168,23
1,1179,39919,3575892145,3575892170,25
1,1179,39920,3575892145,3575892172,27
1,1179,39921,3575892145,3575892173,28
1,1179,39922,3575892145,3575892173,28
1,1179,39923,3575892145,3575892174,29
1,1179,39924,3575892145,3575892175,30
1,1179,39925,3575892145,3575892178,33
1,1179,39926,3575892145,3575892178,33
1,1179,39927,3575892145,3575892179,34
1,1179,39928,3575892145,3575892179,34
1,1179,39929,3575892145,3575892180,35
1,1179,39930,3575892145,3575892181,36
1,1179,39931,3575892145,3575892181,36
1,1179,39932,3575892145,3575892182,37
1,1179,39933,3575892145,3575892182,37
1,1179,39934,3575892145,3575892183,38
1,1179,39935,3575892145,3575892184,39
1,1179,39936,3575892145,3575892184,39
1,1179,39937,3575892145,3575892184,39
1,1179,39938,3575892145,3575892185,40
1,1179,39939,3575892145,3575892186,41
1,1179,39940,3575892145,3575892188,43
1,1179,39941,3575892145,3575892190,45
1,1179,39942,3575892145,3575892190,45
1,1179,39943,3575892145,3575892190,45
1,1179,39944,3575892145,3575892191,46
1,1179,39945,3575892145,3575892191,46
1,1179,39946,3575892145,3575892191,46
1,1179,39947,3575892145,3575892192,47
1,1179,39948,3575892145,3575892193,48
1,1179,39949,3575892145,3575892193,48
1,1179,39950,3575892145,3575892194,49
1,1179,39951,3575892145,3575892195,50
1,1180,39952,3575892209,3575892209,0
1,1180,39953,3575892209,3575892209,0
1,1180,39954,3575892209,3575892209,0
1,1180,39955,3575892209,3575892209,0
1,1180,39956,3575892209,3575892209,0
1,1180,39957,3575892209,3575892209,0
1,1180,39958,3575892209,3575892209,0
1,1180,39959,3575892209,3575892209,0
1,1180,39960,3575892209,3575892209,0
1,1180,39961,3575892209,3575892209,0
1,1180,39962,3575892209,3575892209,0
1,1180,39963,3575892209,3575892209,0
1,1180,39964,3575892209,3575892209,0
1,1180,39965,3575892209,3575892209,0
1,1180,39966,3575892209,3575892209,0
1,1180,39967,3575892209,3575892209,0
1,1180,39968,3575892209,3575892209,0
1,1180,39969,3575892209,3575892211,2
1,1180,39970,3575892209,3575892212,3
1,1180,39971,3575892209,3575892212,3
1,1180,39972,3575892209,3575892212,3
1,1180,39973,3575892209,3575892212,3
1,1180,39974,3575892209,3575892213,4
1,1180,39975,3575892209,3575892213,4
1,1180,39976,3575892209,3575892213,4
1,1180,39977,3575892209,3575892215,6
1,1180,39978,3575892209,3575892216,7
1,1180,39979,3575892209,3575892216,7
1,1180,39980,3575892209,3575892217,8
1,1180,39981,3575892209,3575892217,8
1,1180,39982,3575892209,3575892217,8
1,1180,39983,3575892209,3575892218,9
1,1180,39984,3575892209,3575892219,10
1,1180,39985,3575892209,3575892221,12
1,1180,39986,3575892209,3575892223,14
1,1180,39987,3575892209,3575892223,14
1,1180,39988,3575892209,3575892223,14
1,1180,39989,3575892209,3575892223,14
1,1180,39990,3575892209,3575892224,15
1,1180,39991,3575892209,3575892225,16
1,1180,39992,3575892209,3575892226,17
1,1180,39993,3575892209,3575892227,18
1,1180,39994,3575892209,3575892228,19
1,1180,39995,3575892209,3575892228,19
1,1180,39996,3575892209,3575892229,20
1,1180,39997,3575892209,3575892229,20
1,1180,39998,3575892209,3575892230,21
1,1180,39999,3575892209,3575892230,21
1,1180,40000,3575892209,3575892231,22
1,1180,40001,3575892209,3575892231,22
1,1180,40002,3575892209,3575892232,23
1,1180,40003,3575892209,3575892232,23
1,1180,40004,3575892209,3575892233,24
1,1180,40005,3575892209,3575892235,26
1,1180,40006,3575892209,3575892235,26
1,1180,40007,3575892209,3575892237,28
1,1180,40008,3575892209,3575892237,28
1,1180,40009,3575892209,3575892239,30
1,1180,40010,3575892209,3575892239,30
1,1180,40011,3575892209,3575892241,32
1,1180,40012,3575892209,3575892243,34
1,1180,40013,3575892209,3575892243,34
1,1180,40014,3575892209,3575892244,35
1,1180,40015,3575892209,3575892244,35
1,1180,40016,3575892209,3575892244,35
1,1180,40017,3575892209,3575892245,36
1,1180,40018,3575892209,3575892245,36
1,1180,40019,3575892209,3575892246,37
1,1180,40020,3575892209,3575892246,37
1,1180,40021,3575892209,3575892248,39
1,1180,40022,3575892209,3575892249,40
1,1180,40023,3575892209,3575892249,40
1,1180,40024,3575892209,3575892250,41
1,1180,40025,3575892209,3575892250,41
1,1180,40026,3575892209,3575892252,43
1,1180,40027,3575892209,3575892253,44
1,1180,40028,3575892209,3575892253,44
1,1180,40029,3575892209,3575892254,45
1,1180,40030,3575892209,3575892255,46
1,1180,40031,3575892209,3575892255,46
1,1180,40032,3575892209,3575892256,47
1,1180,40033,3575892209,3575892257,48
1,1180,40034,3575892209,3575892259,50
1,1181,40035,3575892273,3575892273,0
1,1181,40036,3575892273,3575892273,0
1,1181,40037,3575892273,3575892273,0
1,1181,40038,3575892273,3575892273,0
1,1181,40039,3575892273,3575892273,0
1,1181,40040,3575892273,3575892273,0
1,1181,40041,3575892273,3575892273,0
1,1181,40042,3575892273,3575892273,0
1,1181,40043,3575892273,3575892273,0
1,1181,40044,3575892273,3575892278,5
1,1181,40045,3575892273,3575892282,9
1,1181,40046,3575892273,3575892282,9
1,1181,40047,3575892273,3575892283,10
1,1181,40048,3575892273,3575892283,10
1,1181,40049,3575892273,3575892284,11
1,1181,40050,3575892273,3575892284,11
1,1181,40051,3575892273,3575892285,12
1,1181,40052,3575892273,3575892286,13
1,1181,40053,3575892273,3575892286,13
1,1181,40054,3575892273,3575892287,14
1,1181,40055,3575892273,3575892288,15
1,1181,40056,3575892273,3575892288,15
1,1181,40057,3575892273,3575892290,17
1,1181,40058,3575892273,3575892292,19
1,1181,40059,3575892273,3575892292,19
1,1181,40060,3575892273,3575892294,21
1,1181,40061,3575892273,3575892295,22
1,1181,40062,3575892273,3575892295,22
1,1181,40063,3575892273,3575892295,22
1,1181,40064,3575892273,3575892295,22
1,1181,40065,3575892273,3575892297,24
1,1181,40066,3575892273,3575892297,24
1,1181,40067,3575892273,3575892298,25
1,1181,40068,3575892273,3575892299,26
1,1181,40069,3575892273,3575892300,27
1,1181,40070,3575892273,3575892301,28
1,1181,40071,3575892273,3575892301,28
1,1181,40072,3575892273,3575892301,28
1,1181,40073,3575892273,3575892302,29
1,1181,40074,3575892273,3575892302,29
1,1181,40075,3575892273,3575892303,30
1,1181,40076,3575892273,3575892303,30
1,1181,40077,3575892273,3575892304,31
1,1181,40078,3575892273,3575892305,32
1,1181,40079,3575892273,3575892305,32
1,1181,40080,3575892273,3575892306,33
1,1181,40081,3575892273,3575892306,33
1,1181,40082,3575892273,3575892307,34
1,1181,40083,3575892273,3575892309,36
1,1181,40084,3575892273,3575892309,36
1,1181,40085,3575892273,3575892310,37
1,1181,40086,3575892273,3575892310,37
1,1181,40087,3575892273,3575892311,38
1,1181,40088,3575892273,3575892311,38
1,1181,40089,3575892273,3575892312,39
1,1181,40090,3575892273,3575892313,40
1,1181,40091,3575892273,3575892314,41
1,1181,40092,3575892273,3575892314,41
1,1181,40093,3575892273,3575892315,42
1,1181,40094,3575892273,3575892316,43
1,1181,40095,3575892273,3575892317,44
1,1181,40096,3575892273,3575892317,44
1,1181,40097,3575892273,3575892319,46
1,1181,40098,3575892273,3575892320,47
1,1181,40099,3575892273,3575892321,48
1,1181,40100,3575892273,3575892322,49
1,1181,40101,3575892273,3575892322,49
1,1181,40102,3575892273,3575892323,50
1,1182,40103,3575892337,3575892337,0
1,1182,40104,3575892337,3575892337,0
1,1182,40105,3575892337,3575892337,0
1,1182,40106,3575892337,3575892337,0
1,1182,40107,3575892337,3575892337,0
1,1182,40108,3575892337,3575892337,0
1,1182,40109,3575892337,3575892337,0
1,1182,40110,3575892337,3575892337,0
1,1182,40111,3575892337,3575892337,0
1,1182,40112,3575892337,3575892337,0
1,1182,40113,3575892337,3575892337,0
1,1182,40114,3575892337,3575892337,0
1,1182,40115,3575892337,3575892337,0
1,1182,40116,3575892337,3575892337,0
1,1182,40117,3575892337,3575892337,0
1,1182,40118,3575892337,3575892337,0
1,1182,40119,3575892337,3575892337,0
1,1182,40120,3575892337,3575892337,0
1,1182,40121,3575892337,3575892337,0
1,1182,40122,3575892337,3575892337,0
1,1182,40123,3575892337,3575892337,0
1,1182,40124,3575892337,3575892337,0
1,1182,40125,3575892337,3575892339,2
1,1182,40126,3575892337,3575892340,3
1,1182,40127,3575892337,3575892340,3
1,1182,40128,3575892337,3575892340,3
1,1182,40129,3575892337,3575892340,3
1,1182,40130,3575892337,3575892341,4
1,1182,40131,3575892337,3575892344,7
1,1182,40132,3575892337,3575892344,7
1,1182,40133,3575892337,3575892347,10
1,1182,40134,3575892337,3575892347,10
1,1182,40135,3575892337,3575892348,11
1,1182,40136,3575892337,3575892350,13
1,1182,40137,3575892337,3575892350,13
1,1182,40138,3575892337,3575892350,13
1,1182,40139,3575892337,3575892350,13
1,1182,40140,3575892337,3575892353,16
1,1182,40141,3575892337,3575892354,17
1,1182,40142,3575892337,3575892354,17
1,1182,40143,3575892337,3575892354,17
1,1182,40144,3575892337,3575892355,18
1,1182,40145,3575892337,3575892357,20
1,1182,40146,3575892337,3575892357,20
1,1182,40147,3575892337,3575892358,21
1,1182,40148,3575892337,3575892358,21
1,1182,40149,3575892337,3575892359,22
1,1182,40150,3575892337,3575892359,22
1,1182,40151,3575892337,3575892361,24
1,1182,40152,3575892337,3575892361,24
1,1182,40153,3575892337,3575892363,26
1,1182,40154,3575892337,3575892363,26
1,1182,40155,3575892337,3575892365,28
1,1182,40156,3575892337,3575892365,28
1,1182,40157,3575892337,3575892367,30
1,1182,40158,3575892337,3575892369,32
1,1182,40159,3575892337,3575892371,34
1,1182,40160,3575892337,3575892373,36
1,1182,40161,3575892337,3575892373,36
1,1182,40162,3575892337,3575892373,36
1,1182,40163,3575892337,3575892374,37
1,1182,40164,3575892337,3575892374,37
1,1182,40165,3575892337,3575892375,38
1,1182,40166,3575892337,3575892379,42
1,1182,40167,3575892337,3575892379,42
1,1182,40168,3575892337,3575892379,42
1,1182,40169,3575892337,3575892379,42
1,1182,40170,3575892337,3575892380,43
1,1182,40171,3575892337,3575892380,43
1,1182,40172,3575892337,3575892381,44
1,1182,40173,3575892337,3575892382,45
1,1182,40174,3575892337,3575892382,45
1,1182,40175,3575892337,3575892383,46
1,1182,40176,3575892337,3575892383,46
1,1182,40177,3575892337,3575892385,48
1,1182,40178,3575892337,3575892385,48
1,1182,40179,3575892337,3575892385,48
1,1182,40180,3575892337,3575892385,48
1,1183,40181,3575892405,3575892405,0
1,1183,40182,3575892405,3575892405,0
1,1183,40183,3575892405,3575892405,0
1,1183,40184,3575892405,3575892405,0
1,1183,40185,3575892405,3575892405,0
1,1183,40186,3575892405,3575892405,0
1,1183,40187,3575892405,3575892405,0
1,1183,40188,3575892405,3575892405,0
1,1183,40189,3575892405,3575892405,0
1,1183,40190,3575892405,3575892405,0
1,1183,40191,3575892405,3575892405,0
1,1183,40192,3575892405,3575892405,0
1,1183,40193,3575892405,3575892405,0
1,1183,40194,3575892405,3575892405,0
1,1183,40195,3575892405,3575892405,0
1,1183,40196,3575892405,3575892405,0
1,1183,40197,3575892405,3575892405,0
1,1183,40198,3575892405,3575892405,0
1,1183,40199,3575892405,3575892405,0
1,1183,40200,3575892405,3575892405,0
1,1183,40201,3575892405,3575892405,0
1,1183,40202,3575892405,3575892405,0
1,1183,40203,3575892405,3575892406,1
1,1183,40204,3575892405,3575892407,2
1,1183,40205,3575892405,3575892407,2
1,1183,40206,3575892405,3575892408,3
1,1183,40207,3575892405,3575892408,3
1,1183,40208,3575892405,3575892408,3
1,1183,40209,3575892405,3575892409,4
1,1183,40210,3575892405,3575892411,6
1,1183,40211,3575892405,3575892412,7
1,1183,40212,3575892405,3575892412,7
1,1183,40213,3575892405,3575892412,7
1,1183,40214,3575892405,3575892413,8
1,1183,40215,3575892405,3575892413,8
1,1183,40216,3575892405,3575892414,9
1,1183,40217,3575892405,3575892415,10
1,1183,40218,3575892405,3575892416,11
1,1183,40219,3575892405,3575892417,12
1,1183,40220,3575892405,3575892417,12
1,1183,40221,3575892405,3575892417,12
1,1183,40222,3575892405,3575892418,13
1,1183,40223,3575892405,3575892418,13
1,1183,40224,3575892405,3575892418,13
1,1183,40225,3575892405,3575892420,15
1,1183,40226,3575892405,3575892421,16
1,1183,40227,3575892405,3575892422,17
1,1183,40228,3575892405,3575892423,18
1,1183,40229,3575892405,3575892423,18
1,1183,40230,3575892405,3575892424,19
1,1183,40231,3575892405,3575892424,19
1,1183,40232,3575892405,3575892425,20
1,1183,40233,3575892405,3575892425,20
1,1183,40234,3575892405,3575892425,20
1,1183,40235,3575892405,3575892426,21
1,1183,40236,3575892405,3575892427,22
1,1183,40237,3575892405,3575892428,23
1,1183,40238,3575892405,3575892429,24
1,1183,40239,3575892405,3575892429,24
1,1183,40240,3575892405,3575892430,25
1,1183,40241,3575892405,3575892431,26
1,1183,40242,3575892405,3575892432,27
1,1183,40243,3575892405,3575892432,27
1,1183,40244,3575892405,3575892432,27
1,1183,40245,3575892405,3575892433,28
1,1183,40246,3575892405,3575892433,28
1,1183,40247,3575892405,3575892435,30
1,1183,40248,3575892405,3575892435,30
1,1183,40249,3575892405,3575892436,31
1,1183,40250,3575892405,3575892436,31
1,1183,40251,3575892405,3575892439,34
1,1183,40252,3575892405,3575892439,34
1,1183,40253,3575892405,3575892441,36
1,1183,40254,3575892405,3575892444,39
1,1183,40255,3575892405,3575892444,39
1,1183,40256,3575892405,3575892444,39
1,1183,40257,3575892405,3575892445,40
1,1183,40258,3575892405,3575892445,40
1,1183,40259,3575892405,3575892445,40
1,1183,40260,3575892405,3575892446,41
1,1183,40261,3575892405,3575892446,41
1,1183,40262,3575892405,3575892448,43
1,1183,40263,3575892405,3575892449,44
1,1183,40264,3575892405,3575892450,45
1,1183,40265,3575892405,3575892450,45
1,1183,40266,3575892405,3575892450,45
1,1183,40267,3575892405,3575892450,45
1,1183,40268,3575892405,3575892453,48
1,1183,40269,3575892405,3575892453,48
1,1183,40270,3575892405,3575892453,48
1,1183,40271,3575892405,3575892453,48
1,1183,40272,3575892405,3575892454,49
1,1184,40273,3575892469,3575892469,0
1,1184,40274,3575892469,3575892469,0
1,1184,40275,3575892469,3575892469,0
1,1184,40276,3575892469,3575892469,0
1,1184,40277,3575892469,3575892469,0
1,1184,40278,3575892469,3575892469,0
1,1184,40279,3575892469,3575892469,0
1,1184,40280,3575892469,3575892469,0
1,1184,40281,3575892469,3575892469,0
1,1184,40282,3575892469,3575892469,0
1,1184,40283,3575892469,3575892469,0
1,1184,40284,3575892469,3575892469,0
1,1184,40285,3575892469,3575892469,0
1,1184,40286,3575892469,3575892480,11
1,1184,40287,3575892469,3575892481,12
1,1184,40288,3575892469,3575892482,13
1,1184,40289,3575892469,3575892483,14
1,1184,40290,3575892469,3575892484,15
1,1184,40291,3575892469,3575892484,15
1,1184,40292,3575892469,3575892484,15
1,1184,40293,3575892469,3575892485,16
1,1184,40294,3575892469,3575892485,16
1,1184,40295,3575892469,3575892486,17
1,1184,40296,3575892469,3575892487,18
1,1184,40297,3575892469,3575892488,19
1,1184,40298,3575892469,3575892489,20
1,1184,40299,3575892469,3575892491,22
1,1184,40300,3575892469,3575892492,23
1,1184,40301,3575892469,3575892492,23
1,1184,40302,3575892469,3575892492,23
1,1184,40303,3575892469,3575892493,24
1,1184,40304,3575892469,3575892494,25
1,1184,40305,3575892469,3575892495,26
1,1184,40306,3575892469,3575892495,26
1,1184,40307,3575892469,3575892495,26
1,1184,40308,3575892469,3575892496,27
1,1184,40309,3575892469,3575892497,28
1,1184,40310,3575892469,3575892498,29
1,1184,40311,3575892469,3575892499,30
1,1184,40312,3575892469,3575892499,30
1,1184,40313,3575892469,3575892500,31
1,1184,40314,3575892469,3575892501,32
1,1184,40315,3575892469,3575892502,33
1,1184,40316,3575892469,3575892502,33
1,1184,40317,3575892469,3575892502,33
1,1184,40318,3575892469,3575892502,33
1,1184,40319,3575892469,3575892503,34
1,1184,40320,3575892469,3575892504,35
1,1184,40321,3575892469,3575892504,35
1,1184,40322,3575892469,3575892504,35
1,1184,40323,3575892469,3575892505,36
1,1184,40324,3575892469,3575892505,36
1,1184,40325,3575892469,3575892505,36
1,1184,40326,3575892469,3575892506,37
1,1184,40327,3575892469,3575892507,38
1,1184,40328,3575892469,3575892507,38
1,1184,40329,3575892469,3575892509,40
1,1184,40330,3575892469,3575892509,40
1,1184,40331,3575892469,3575892509,40
1,1184,40332,3575892469,3575892510,41
1,1184,40333,3575892469,3575892511,42
1,1184,40334,3575892469,3575892512,43
1,1184,40335,3575892469,3575892512,43
1,1184,40336,3575892469,3575892513,44
1,1184,40337,3575892469,3575892514,45
1,1184,40338,3575892469,3575892515,46
1,1184,40339,3575892469,3575892515,46
1,1184,40340,3575892469,3575892517,48
1,1184,40341,3575892469,3575892517,48
1,1184,40342,3575892469,3575892517,48
1,1185,40343,3575892531,3575892531,0
1,1185,40344,3575892531,3575892531,0
1,1185,40345,3575892531,3575892531,0
1,1185,40346,3575892531,3575892531,0
1,1185,40347,3575892531,3575892531,0
1,1185,40348,3575892531,3575892531,0
1,1185,40349,3575892531,3575892531,0
1,1185,40350,3575892531,3575892531,0
1,1185,40351,3575892531,3575892531,0
1,1185,40352,3575892531,3575892531,0
1,1185,40353,3575892531,3575892531,0
1,1185,40354,3575892531,3575892531,0
1,1185,40355,3575892531,3575892531,0
1,1185,40356,3575892531,3575892531,0
1,1185,40357,3575892531,3575892531,0
1,1185,40358,3575892531,3575892531,0
1,1185,40359,3575892531,3575892531,0
1,1185,40360,3575892531,3575892531,0
1,1185,40361,3575892531,3575892531,0
1,1185,40362,3575892531,3575892531,0
1,1185,40363,3575892531,3575892532,1
1,1185,40364,3575892531,3575892532,1
1,1185,40365,3575892531,3575892532,1
1,1185,40366,3575892531,3575892533,2
1,1185,40367,3575892531,3575892534,3
1,1185,40368,3575892531,3575892535,4
1,1185,40369,3575892531,3575892535,4
1,1185,40370,3575892531,3575892536,5
1,1185,40371,3575892531,3575892538,7
1,1185,40372,3575892531,3575892539,8
1,1185,40373,3575892531,3575892539,8
1,1185,40374,3575892531,3575892539,8
1,1185,40375,3575892531,3575892539,8
1,1185,40376,3575892531,3575892543,12
1,1185,40377,3575892531,3575892543,12
1,1185,40378,3575892531,3575892546,15
1,1185,40379,3575892531,3575892547,16
1,1185,40380,3575892531,3575892547,16
1,1185,40381,3575892531,3575892548,17
1,1185,40382,3575892531,3575892549,18
1,1185,40383,3575892531,3575892549,18
1,1185,40384,3575892531,3575892550,19
1,1185,40385,3575892531,3575892552,21
1,1185,40386,3575892531,3575892552,21
1,1185,40387,3575892531,3575892552,21
1,1185,40388,3575892531,3575892554,23
1,1185,40389,3575892531,3575892555,24
1,1185,40390,3575892531,3575892556,25
1,1185,40391,3575892531,3575892557,26
1,1185,40392,3575892531,3575892557,26
1,1185,40393,3575892531,3575892557,26
1,1185,40394,3575892531,3575892559,28
1,1185,40395,3575892531,3575892559,28
1,1185,40396,3575892531,3575892560,29
1,1185,40397,3575892531,3575892560,29
1,1185,40398,3575892531,3575892562,31
1,1185,40399,3575892531,3575892562,31
1,1185,40400,3575892531,3575892562,31
1,1185,40401,3575892531,3575892563,32
1,1185,40402,3575892531,3575892564,33
1,1185,40403,3575892531,3575892565,34
1,1185,40404,3575892531,3575892566,35
1,1185,40405,3575892531,3575892568,37
1,1185,40406,3575892531,3575892569,38
1,1185,40407,3575892531,3575892571,40
1,1185,40408,3575892531,3575892572,41
1,1185,40409,3575892531,3575892572,41
1,1185,40410,3575892531,3575892573,42
1,1185,40411,3575892531,3575892574,43
1,1185,40412,3575892531,3575892574,43
1,1185,40413,3575892531,3575892578,47
1,1185,40414,3575892531,3575892578,47
1,1185,40415,3575892531,3575892578,47
1,1185,40416,3575892531,3575892578,47
1,1185,40417,3575892531,3575892579,48
1,1185,40418,3575892531,3575892581,50
1,1186,40419,3575892595,3575892595,0
1,1186,40420,3575892595,3575892595,0
1,1186,40421,3575892595,3575892595,0
1,1186,40422,3575892595,3575892595,0
1,1186,40423,3575892595,3575892595,0
1,1186,40424,3575892595,3575892595,0
1,1186,40425,3575892595,3575892595,0
1,1186,40426,3575892595,3575892595,0
1,1186,40427,3575892595,3575892595,0
1,1186,40428,3575892595,3575892595,0
1,1186,40429,3575892595,3575892595,0
1,1186,40430,3575892595,3575892595,0
1,1186,40431,3575892595,3575892595,0
1,1186,40432,3575892595,3575892595,0
1,1186,40433,3575892595,3575892595,0
1,1186,40434,3575892595,3575892595,0
1,1186,40435,3575892595,3575892595,0
1,1186,40436,3575892595,3575892595,0
1,1186,40437,3575892595,3575892595,0
1,1186,40438,3575892595,3575892597,2
1,1186,40439,3575892595,3575892597,2
1,1186,40440,3575892595,3575892597,2
1,1186,40441,3575892595,3575892598,3
1,1186,40442,3575892595,3575892599,4
1,1186,40443,3575892595,3575892600,5
1,1186,40444,3575892595,3575892601,6
1,1186,40445,3575892595,3575892603,8
1,1186,40446,3575892595,3575892603,8
1,1186,40447,3575892595,3575892603,8
1,1186,40448,3575892595,3575892605,10
1,1186,40449,3575892595,3575892606,11
1,1186,40450,3575892595,3575892606,11
1,1186,40451,3575892595,3575892607,12
1,1186,40452,3575892595,3575892607,12
1,1186,40453,3575892595,3575892607,12
1,1186,40454,3575892595,3575892607,12
1,1186,40455,3575892595,3575892609,14
1,1186,40456,3575892595,3575892610,15
1,1186,40457,3575892595,3575892611,16
1,1186,40458,3575892595,3575892612,17
1,1186,40459,3575892595,3575892612,17
1,1186,40460,3575892595,3575892612,17
1,1186,40461,3575892595,3575892612,17
1,1186,40462,3575892595,3575892612,17
1,1186,40463,3575892595,3575892614,19
1,1186,40464,3575892595,3575892615,20
1,1186,40465,3575892595,3575892615,20
1,1186,40466,3575892595,3575892616,21
1,1186,40467,3575892595,3575892616,21
1,1186,40468,3575892595,3575892616,21
1,1186,40469,3575892595,3575892617,22
1,1186,40470,3575892595,3575892618,23
1,1186,40471,3575892595,3575892618,23
1,1186,40472,3575892595,3575892620,25
1,1186,40473,3575892595,3575892621,26
1,1186,40474,3575892595,3575892622,27
1,1186,40475,3575892595,3575892623,28
1,1186,40476,3575892595,3575892623,28
1,1186,40477,3575892595,3575892623,28
1,1186,40478,3575892595,3575892624,29
1,1186,40479,3575892595,3575892625,30
1,1186,40480,3575892595,3575892625,30
1,1186,40481,3575892595,3575892625,30
1,1186,40482,3575892595,3575892626,31
1,1186,40483,3575892595,3575892627,32
1,1186,40484,3575892595,3575892627,32
1,1186,40485,3575892595,3575892628,33
1,1186,40486,3575892595,3575892630,35
1,1186,40487,3575892595,3575892630,35
1,1186,40488,3575892595,3575892630,35
1,1186,40489,3575892595,3575892631,36
1,1186,40490,3575892595,3575892631,36
1,1186,40491,3575892595,3575892632,37
1,1186,40492,3575892595,3575892632,37
1,1186,40493,3575892595,3575892634,39
1,1186,40494,3575892595,3575892635,40
1,1186,40495,3575892595,3575892635,40
1,1186,40496,3575892595,3575892638,43
1,1186,40497,3575892595,3575892639,44
1,1186,40498,3575892595,3575892641,46
1,1186,40499,3575892595,3575892643,48
1,1186,40500,3575892595,3575892643,48
1,1186,40501,3575892595,3575892644,49
1,1186,40502,3575892595,3575892644,49
1,1186,40503,3575892595,3575892644,49
1,1186,40504,3575892595,3575892644,49
1,1186,40505,3575892595,3575892645,50
1,1186,40506,3575892595,3575892645,50
1,1187,40507,3575892658,3575892658,0
1,1187,40508,3575892658,3575892658,0
1,1187,40509,3575892658,3575892658,0
1,1187,40510,3575892658,3575892658,0
1,1187,40511,3575892658,3575892658,0
1,1187,40512,3575892658,3575892658,0
1,1187,40513,3575892658,3575892658,0
1,1187,40514,3575892658,3575892658,0
1,1187,40515,3575892658,3575892658,0
1,1187,40516,3575892658,3575892658,0
1,1187,40517,3575892658,3575892658,0
1,1187,40518,3575892658,3575892658,0
1,1187,40519,3575892658,3575892658,0
1,1187,40520,3575892658,3575892658,0
1,1187,40521,3575892658,3575892658,0
1,1187,40522,3575892658,3575892658,0
1,1187,40523,3575892658,3575892663,5
1,1187,40524,3575892658,3575892663,5
1,1187,40525,3575892658,3575892664,6
1,1187,40526,3575892658,3575892665,7
1,1187,40527,3575892658,3575892666,8
1,1187,40528,3575892658,3575892666,8
1,1187,40529,3575892658,3575892667,9
1,1187,40530,3575892658,3575892668,10
1,1187,40531,3575892658,3575892680,22
1,1187,40532,3575892658,3575892681,23
1,1187,40533,3575892658,3575892682,24
1,1187,40534,3575892658,3575892683,25
1,1187,40535,3575892658,3575892684,26
1,1187,40536,3575892658,3575892684,26
1,1187,40537,3575892658,3575892685,27
1,1187,40538,3575892658,3575892685,27
1,1187,40539,3575892658,3575892685,27
1,1187,40540,3575892658,3575892686,28
1,1187,40541,3575892658,3575892687,29
1,1187,40542,3575892658,3575892689,31
1,1187,40543,3575892658,3575892689,31
1,1187,40544,3575892658,3575892691,33
1,1187,40545,3575892658,3575892691,33
1,1187,40546,3575892658,3575892692,34
1,1187,40547,3575892658,3575892692,34
1,1187,40548,3575892658,3575892693,35
1,1187,40549,3575892658,3575892693,35
1,1187,40550,3575892658,3575892695,37
1,1187,40551,3575892658,3575892695,37
1,1187,40552,3575892658,3575892695,37
1,1187,40553,3575892658,3575892696,38
1,1187,40554,3575892658,3575892696,38
1,1187,40555,3575892658,3575892697,39
1,1187,40556,3575892658,3575892698,40
1,1187,40557,3575892658,3575892699,41
1,1187,40558,3575892658,3575892699,41
1,1187,40559,3575892658,3575892701,43
1,1187,40560,3575892658,3575892701,43
1,1187,40561,3575892658,3575892701,43
1,1187,40562,3575892658,3575892701,43
1,1187,40563,3575892658,3575892702,44
1,1187,40564,3575892658,3575892702,44
1,1187,40565,3575892658,3575892702,44
1,1187,40566,3575892658,3575892703,45
1,1187,40567,3575892658,3575892704,46
1,1187,40568,3575892658,3575892704,46
1,1187,40569,3575892658,3575892705,47
1,1187,40570,3575892658,3575892705,47
1,1187,40571,3575892658,3575892705,47
1,1187,40572,3575892658,3575892707,49
1,1187,40573,3575892658,3575892707,49
1,1187,40574,3575892658,3575892708,50
1,1188,40575,3575892726,3575892726,0
1,1188,40576,3575892726,3575892726,0
1,1188,40577,3575892726,3575892726,0
1,1188,40578,3575892726,3575892726,0
1,1188,40579,3575892726,3575892726,0
1,1188,40580,3575892726,3575892726,0
1,1188,40581,3575892726,3575892726,0
1,1188,40582,3575892726,3575892726,0
1,1188,40583,3575892726,3575892726,0
1,1188,40584,3575892726,3575892726,0
1,1188,40585,3575892726,3575892726,0
1,1188,40586,3575892726,3575892726,0
1,1188,40587,3575892726,3575892726,0
1,1188,40588,3575892726,3575892726,0
1,1188,40589,3575892726,3575892726,0
1,1188,40590,3575892726,3575892726,0
1,1188,40591,3575892726,3575892726,0
1,1188,40592,3575892726,3575892726,0
1,1188,40593,3575892726,3575892726,0
1,1188,40594,3575892726,3575892726,0
1,1188,40595,3575892726,3575892726,0
1,1188,40596,3575892726,3575892726,0
1,1188,40597,3575892726,3575892726,0
1,1188,40598,3575892726,3575892726,0
1,1188,40599,3575892726,3575892727,1
1,1188,40600,3575892726,3575892727,1
1,1188,40601,3575892726,3575892727,1
1,1188,40602,3575892726,3575892728,2
1,1188,40603,3575892726,3575892728,2
1,1188,40604,3575892726,3575892729,3
1,1188,40605,3575892726,3575892730,4
1,1188,40606,3575892726,3575892731,5
1,1188,40607,3575892726,3575892731,5
1,1188,40608,3575892726,3575892731,5
1,1188,40609,3575892726,3575892731,5
1,1188,40610,3575892726,3575892732,6
1,1188,40611,3575892726,3575892733,7
1,1188,40612,3575892726,3575892734,8
1,1188,40613,3575892726,3575892734,8
1,1188,40614,3575892726,3575892735,9
1,1188,40615,3575892726,3575892736,10
1,1188,40616,3575892726,3575892736,10
1,1188,40617,3575892726,3575892738,12
1,1188,40618,3575892726,3575892738,12
1,1188,40619,3575892726,3575892739,13
1,1188,40620,3575892726,3575892740,14
1,1188,40621,3575892726,3575892740,14
1,1188,40622,3575892726,3575892741,15
1,1188,40623,3575892726,3575892743,17
1,1188,40624,3575892726,3575892746,20
1,1188,40625,3575892726,3575892747,21
1,1188,40626,3575892726,3575892748,22
1,1188,40627,3575892726,3575892749,23
1,1188,40628,3575892726,3575892749,23
1,1188,40629,3575892726,3575892750,24
1,1188,40630,3575892726,3575892750,24
1,1188,40631,3575892726,3575892752,26
1,1188,40632,3575892726,3575892753,27
1,1188,40633,3575892726,3575892753,27
1,1188,40634,3575892726,3575892755,29
1,1188,40635,3575892726,3575892756,30
1,1188,40636,3575892726,3575892757,31
1,1188,40637,3575892726,3575892757,31
1,1188,40638,3575892726,3575892757,31
1,1188,40639,3575892726,3575892759,33
1,1188,40640,3575892726,3575892759,33
1,1188,40641,3575892726,3575892761,35
1,1188,40642,3575892726,3575892762,36
1,1188,40643,3575892726,3575892762,36
1,1188,40644,3575892726,3575892763,37
1,1188,40645,3575892726,3575892763,37
1,1188,40646,3575892726,3575892764,38
1,1188,40647,3575892726,3575892765,39
1,1188,40648,3575892726,3575892766,40
1,1188,40649,3575892726,3575892769,43
1,1188,40650,3575892726,3575892769,43
1,1188,40651,3575892726,3575892771,45
1,1188,40652,3575892726,3575892772,46
1,1188,40653,3575892726,3575892772,46
1,1188,40654,3575892726,3575892773,47
1,1188,40655,3575892726,3575892774,48
1,1188,40656,3575892726,3575892775,49
1,1189,40657,3575892790,3575892791,1
1,1189,40658,3575892790,3575892791,1
1,1189,40659,3575892790,3575892791,1
1,1189,40660,3575892790,3575892791,1
1,1189,40661,3575892790,3575892791,1
1,1189,40662,3575892790,3575892791,1
1,1189,40663,3575892790,3575892791,1
1,1189,40664,3575892790,3575892791,1
1,1189,40665,3575892790,3575892791,1
1,1189,40666,3575892790,3575892791,1
1,1189,40667,3575892790,3575892791,1
1,1189,40668,3575892790,3575892791,1
1,1189,40669,3575892790,3575892791,1
1,1189,40670,3575892790,3575892791,1
1,1189,40671,3575892790,3575892791,1
1,1189,40672,3575892790,3575892791,1
1,1189,40673,3575892790,3575892791,1
1,1189,40674,3575892790,3575892791,1
1,1189,40675,3575892790,3575892791,1
1,1189,40676,3575892790,3575892792,2
1,1189,40677,3575892790,3575892792,2
1,1189,40678,3575892790,3575892792,2
1,1189,40679,3575892790,3575892794,4
1,1189,40680,3575892790,3575892795,5
1,1189,40681,3575892790,3575892795,5
1,1189,40682,3575892790,3575892796,6
1,1189,40683,3575892790,3575892797,7
1,1189,40684,3575892790,3575892798,8
1,1189,40685,3575892790,3575892798,8
1,1189,40686,3575892790,3575892799,9
1,1189,40687,3575892790,3575892799,9
1,1189,40688,3575892790,3575892802,12
1,1189,40689,3575892790,3575892802,12
1,1189,40690,3575892790,3575892802,12
1,1189,40691,3575892790,3575892803,13
1,1189,40692,3575892790,3575892803,13
1,1189,40693,3575892790,3575892803,13
1,1189,40694,3575892790,3575892805,15
1,1189,40695,3575892790,3575892805,15
1,1189,40696,3575892790,3575892806,16
1,1189,40697,3575892790,3575892807,17
1,1189,40698,3575892790,3575892808,18
1,1189,40699,3575892790,3575892809,19
1,1189,40700,3575892790,3575892809,19
1,1189,40701,3575892790,3575892809,19
1,1189,40702,3575892790,3575892810,20
1,1189,40703,3575892790,3575892811,21
1,1189,40704,3575892790,3575892811,21
1,1189,40705,3575892790,3575892811,21
1,1189,40706,3575892790,3575892812,22
1,1189,40707,3575892790,3575892812,22
1,1189,40708,3575892790,3575892814,24
1,1189,40709,3575892790,3575892815,25
1,1189,40710,3575892790,3575892816,26
1,1189,40711,3575892790,3575892816,26
1,1189,40712,3575892790,3575892817,27
1,1189,40713,3575892790,3575892817,27
1,1189,40714,3575892790,3575892817,27
1,1189,40715,3575892790,3575892818,28
1,1189,40716,3575892790,3575892818,28
1,1189,40717,3575892790,3575892820,30
1,1189,40718,3575892790,3575892822,32
1,1189,40719,3575892790,3575892822,32
1,1189,40720,3575892790,3575892823,33
1,1189,40721,3575892790,3575892823,33
1,1189,40722,3575892790,3575892824,34
1,1189,40723,3575892790,3575892824,34
1,1189,40724,3575892790,3575892824,34
1,1189,40725,3575892790,3575892826,36
1,1189,40726,3575892790,3575892826,36
1,1189,40727,3575892790,3575892827,37
1,1189,40728,3575892790,3575892829,39
1,1189,40729,3575892790,3575892829,39
1,1189,40730,3575892790,3575892830,40
1,1189,40731,3575892790,3575892830,40
1,1189,40732,3575892790,3575892831,41
1,1189,40733,3575892790,3575892831,41
1,1189,40734,3575892790,3575892832,42
1,1189,40735,3575892790,3575892832,42
1,1189,40736,3575892790,3575892834,44
1,1189,40737,3575892790,3575892835,45
1,1189,40738,3575892790,3575892836,46
1,1189,40739,3575892790,3575892838,48
1,1189,40740,3575892790,3575892839,49
1,1189,40741,3575892790,3575892839,49
1,1190,40742,3575892860,3575892860,0
1,1190,40743,3575892860,3575892860,0
1,1190,40744,3575892860,3575892860,0
1,1190,40745,3575892860,3575892860,0
1,1190,40746,3575892860,3575892860,0
1,1190,40747,3575892860,3575892860,0
1,1190,40748,3575892860,3575892860,0
1,1190,40749,3575892860,3575892860,0
1,1190,40750,3575892860,3575892860,0
1,1190,40751,3575892860,3575892860,0
1,1190,40752,3575892860,3575892860,0
1,1190,40753,3575892860,3575892860,0
1,1190,40754,3575892860,3575892860,0
1,1190,40755,3575892860,3575892860,0
1,1190,40756,3575892860,3575892860,0
1,1190,40757,3575892860,3575892860,0
1,1190,40758,3575892860,3575892860,0
1,1190,40759,3575892860,3575892860,0
1,1190,40760,3575892860,3575892860,0
1,1190,40761,3575892860,3575892860,0
1,1190,40762,3575892860,3575892860,0
1,1190,40763,3575892860,3575892860,0
1,1190,40764,3575892860,3575892860,0
1,1190,40765,3575892860,3575892860,0
1,1190,40766,3575892860,3575892860,0
1,1190,40767,3575892860,3575892863,3
1,1190,40768,3575892860,3575892863,3
1,1190,40769,3575892860,3575892864,4
1,1190,40770,3575892860,3575892865,5
1,1190,40771,3575892860,3575892866,6
1,1190,40772,3575892860,3575892867,7
1,1190,40773,3575892860,3575892867,7
1,1190,40774,3575892860,3575892879,19
1,1190,40775,3575892860,3575892880,20
1,1190,40776,3575892860,3575892882,22
1,1190,40777,3575892860,3575892882,22
1,1190,40778,3575892860,3575892884,24
1,1190,40779,3575892860,3575892884,24
1,1190,40780,3575892860,3575892884,24
1,1190,40781,3575892860,3575892885,25
1,1190,40782,3575892860,3575892885,25
1,1190,40783,3575892860,3575892886,26
1,1190,40784,3575892860,3575892887,27
1,1190,40785,3575892860,3575892889,29
1,1190,40786,3575892860,3575892889,29
1,1190,40787,3575892860,3575892890,30
1,1190,40788,3575892860,3575892892,32
1,1190,40789,3575892860,3575892892,32
1,1190,40790,3575892860,3575892892,32
1,1190,40791,3575892860,3575892895,35
1,1190,40792,3575892860,3575892895,35
1,1190,40793,3575892860,3575892895,35
1,1190,40794,3575892860,3575892896,36
1,1190,40795,3575892860,3575892896,36
1,1190,40796,3575892860,3575892897,37
1,1190,40797,3575892860,3575892898,38
1,1190,40798,3575892860,3575892899,39
1,1190,40799,3575892860,3575892901,41
1,1190,40800,3575892860,3575892901,41
1,1190,40801,3575892860,3575892902,42
1,1190,40802,3575892860,3575892902,42
1,1190,40803,3575892860,3575892903,43
1,1190,40804,3575892860,3575892903,43
1,1190,40805,3575892860,3575892903,43
1,1190,40806,3575892860,3575892904,44
1,1190,40807,3575892860,3575892904,44
1,1190,40808,3575892860,3575892905,45
1,1190,40809,3575892860,3575892905,45
1,1190,40810,3575892860,3575892905,45
1,1190,40811,3575892860,3575892906,46
1,1190,40812,3575892860,3575892907,47
1,1190,40813,3575892860,3575892909,49
1,1190,40814,3575892860,3575892909,49
1,1190,40815,3575892860,3575892910,50
1,1191,40816,3575892926,3575892926,0
1,1191,40817,3575892926,3575892926,0
1,1191,40818,3575892926,3575892926,0
1,1191,40819,3575892926,3575892926,0
1,1191,40820,3575892926,3575892926,0
1,1191,40821,3575892926,3575892926,0
1,1191,40822,3575892926,3575892926,0
1,1191,40823,3575892926,3575892926,0
1,1191,40824,3575892926,3575892926,0
1,1191,40825,3575892926,3575892926,0
1,1191,40826,3575892926,3575892926,0
1,1191,40827,3575892926,3575892926,0
1,1191,40828,3575892926,3575892926,0
1,1191,40829,3575892926,3575892926,0
1,1191,40830,3575892926,3575892926,0
1,1191,40831,3575892926,3575892926,0
1,1191,40832,3575892926,3575892926,0
1,1191,40833,3575892926,3575892927,1
1,1191,40834,3575892926,3575892927,1
1,1191,40835,3575892926,3575892928,2
1,1191,40836,3575892926,3575892928,2
1,1191,40837,3575892926,3575892928,2
1,1191,40838,3575892926,3575892929,3
1,1191,40839,3575892926,3575892929,3
1,1191,40840,3575892926,3575892930,4
1,1191,40841,3575892926,3575892931,5
1,1191,40842,3575892926,3575892931,5
1,1191,40843,3575892926,3575892931,5
1,1191,40844,3575892926,3575892931,5
1,1191,40845,3575892926,3575892933,7
1,1191,40846,3575892926,3575892933,7
1,1191,40847,3575892926,3575892933,7
1,1191,40848,3575892926,3575892933,7
1,1191,40849,3575892926,3575892935,9
1,1191,40850,3575892926,3575892936,10
1,1191,40851,3575892926,3575892936,10
1,1191,40852,3575892926,3575892938,12
1,1191,40853,3575892926,3575892939,13
1,1191,40854,3575892926,3575892939,13
1,1191,40855,3575892926,3575892940,14
1,1191,40856,3575892926,3575892940,14
1,1191,40857,3575892926,3575892943,17
1,1191,40858,3575892926,3575892947,21
1,1191,40859,3575892926,3575892948,22
1,1191,40860,3575892926,3575892948,22
1,1191,40861,3575892926,3575892948,22
1,1191,40862,3575892926,3575892948,22
1,1191,40863,3575892926,3575892949,23
1,1191,40864,3575892926,3575892950,24
1,1191,40865,3575892926,3575892950,24
1,1191,40866,3575892926,3575892951,25
1,1191,40867,3575892926,3575892952,26
1,1191,40868,3575892926,3575892952,26
1,1191,40869,3575892926,3575892953,27
1,1191,40870,3575892926,3575892954,28
1,1191,40871,3575892926,3575892956,30
1,1191,40872,3575892926,3575892957,31
1,1191,40873,3575892926,3575892957,31
1,1191,40874,3575892926,3575892959,33
1,1191,40875,3575892926,3575892959,33
1,1191,40876,3575892926,3575892961,35
1,1191,40877,3575892926,3575892962,36
1,1191,40878,3575892926,3575892962,36
1,1191,40879,3575892926,3575892963,37
1,1191,40880,3575892926,3575892963,37
1,1191,40881,3575892926,3575892963,37
1,1191,40882,3575892926,3575892966,40
1,1191,40883,3575892926,3575892970,44
1,1191,40884,3575892926,3575892971,45
1,1191,40885,3575892926,3575892972,46
1,1191,40886,3575892926,3575892972,46
1,1191,40887,3575892926,3575892972,46
1,1191,40888,3575892926,3575892973,47
1,1191,40889,3575892926,3575892974,48
1,1192,40890,3575892997,3575892997,0
1,1192,40891,3575892997,3575892997,0
1,1192,40892,3575892997,3575892997,0
1,1192,40893,3575892997,3575892997,0
1,1192,40894,3575892997,3575892997,0
1,1192,40895,3575892997,3575892997,0
1,1192,40896,3575892997,3575892997,0
1,1192,40897,3575892997,3575892997,0
1,1192,40898,3575892997,3575892997,0
1,1192,40899,3575892997,3575892997,0
1,1192,40900,3575892997,3575892997,0
1,1192,40901,3575892997,3575892997,0
1,1192,40902,3575892997,3575892997,0
1,1192,40903,3575892997,3575892997,0
1,1192,40904,3575892997,3575892997,0
1,1192,40905,3575892997,3575892997,0
1,1192,40906,3575892997,3575892997,0
1,1192,40907,3575892997,3575892997,0
1,1192,40908,3575892997,3575892997,0
1,1192,40909,3575892997,3575892997,0
1,1192,40910,3575892997,3575892997,0
1,1192,40911,3575892997,3575892997,0
1,1192,40912,3575892997,3575892997,0
1,1192,40913,3575892997,3575892997,0
1,1192,40914,3575892997,3575892997,0
1,1192,40915,3575892997,3575892998,1
1,1192,40916,3575892997,3575892998,1
1,1192,40917,3575892997,3575893001,4
1,1192,40918,3575892997,3575893002,5
1,1192,40919,3575892997,3575893002,5
1,1192,40920,3575892997,3575893003,6
1,1192,40921,3575892997,3575893004,7
1,1192,40922,3575892997,3575893005,8
1,1192,40923,3575892997,3575893005,8
1,1192,40924,3575892997,3575893006,9
1,1192,40925,3575892997,3575893006,9
1,1192,40926,3575892997,3575893007,10
1,1192,40927,3575892997,3575893008,11
1,1192,40928,3575892997,3575893008,11
1,1192,40929,3575892997,3575893009,12
1,1192,40930,3575892997,3575893010,13
1,1192,40931,3575892997,3575893010,13
1,1192,40932,3575892997,3575893011,14
1,1192,40933,3575892997,3575893012,15
1,1192,40934,3575892997,3575893012,15
1,1192,40935,3575892997,3575893013,16
1,1192,40936,3575892997,3575893013,16
1,1192,40937,3575892997,3575893013,16
1,1192,40938,3575892997,3575893013,16
1,1192,40939,3575892997,3575893014,17
1,1192,40940,3575892997,3575893015,18
1,1192,40941,3575892997,3575893015,18
1,1192,40942,3575892997,3575893016,19
1,1192,40943,3575892997,3575893016,19
1,1192,40944,3575892997,3575893016,19
1,1192,40945,3575892997,3575893017,20
1,1192,40946,3575892997,3575893018,21
1,1192,40947,3575892997,3575893018,21
1,1192,40948,3575892997,3575893020,23
1,1192,40949,3575892997,3575893022,25
1,1192,40950,3575892997,3575893023,26
1,1192,40951,3575892997,3575893023,26
1,1192,40952,3575892997,3575893024,27
1,1192,40953,3575892997,3575893024,27
1,1192,40954,3575892997,3575893025,28
1,1192,40955,3575892997,3575893026,29
1,1192,40956,3575892997,3575893026,29
1,1192,40957,3575892997,3575893027,30
1,1192,40958,3575892997,3575893027,30
1,1192,40959,3575892997,3575893028,31
1,1192,40960,3575892997,3575893029,32
1,1192,40961,3575892997,3575893030,33
1,1192,40962,3575892997,3575893030,33
1,1192,40963,3575892997,3575893030,33
1,1192,40964,3575892997,3575893031,34
1,1192,40965,3575892997,3575893032,35
1,1192,40966,3575892997,3575893032,35
1,1192,40967,3575892997,3575893033,36
1,1192,40968,3575892997,3575893033,36
1,1192,40969,3575892997,3575893035,38
1,1192,40970,3575892997,3575893035,38
1,1192,40971,3575892997,3575893037,40
1,1192,40972,3575892997,3575893037,40
1,1192,40973,3575892997,3575893039,42
1,1192,40974,3575892997,3575893041,44
1,1192,40975,3575892997,3575893044,47
1,1192,40976,3575892997,3575893044,47
1,1192,40977,3575892997,3575893045,48
1,1192,40978,3575892997,3575893045,48
1,1192,40979,3575892997,3575893045,48
1,1192,40980,3575892997,3575893045,48
1,1192,40981,3575892997,3575893047,50
1,1193,40982,3575893065,3575893065,0
1,1193,40983,3575893065,3575893065,0
1,1193,40984,3575893065,3575893065,0
1,1193,40985,3575893065,3575893065,0
1,1193,40986,3575893065,3575893065,0
1,1193,40987,3575893065,3575893065,0
1,1193,40988,3575893065,3575893065,0
1,1193,40989,3575893065,3575893065,0
1,1193,40990,3575893065,3575893065,0
1,1193,40991,3575893065,3575893065,0
1,1193,40992,3575893065,3575893065,0
1,1193,40993,3575893065,3575893065,0
1,1193,40994,3575893065,3575893065,0
1,1193,40995,3575893065,3575893065,0
1,1193,40996,3575893065,3575893065,0
1,1193,40997,3575893065,3575893065,0
1,1193,40998,3575893065,3575893065,0
1,1193,40999,3575893065,3575893065,0
1,1193,41000,3575893065,3575893065,0
1,1193,41001,3575893065,3575893065,0
1,1193,41002,3575893065,3575893065,0
1,1193,41003,3575893065,3575893066,1
1,1193,41004,3575893065,3575893067,2
1,1193,41005,3575893065,3575893069,4
1,1193,41006,3575893065,3575893079,14
1,1193,41007,3575893065,3575893079,14
1,1193,41008,3575893065,3575893081,16
1,1193,41009,3575893065,3575893083,18
1,1193,41010,3575893065,3575893083,18
1,1193,41011,3575893065,3575893084,19
1,1193,41012,3575893065,3575893084,19
1,1193,41013,3575893065,3575893086,21
1,1193,41014,3575893065,3575893086,21
1,1193,41015,3575893065,3575893087,22
1,1193,41016,3575893065,3575893089,24
1,1193,41017,3575893065,3575893090,25
1,1193,41018,3575893065,3575893090,25
1,1193,41019,3575893065,3575893092,27
1,1193,41020,3575893065,3575893092,27
1,1193,41021,3575893065,3575893092,27
1,1193,41022,3575893065,3575893093,28
1,1193,41023,3575893065,3575893093,28
1,1193,41024,3575893065,3575893095,30
1,1193,41025,3575893065,3575893095,30
1,1193,41026,3575893065,3575893096,31
1,1193,41027,3575893065,3575893097,32
1,1193,41028,3575893065,3575893097,32
1,1193,41029,3575893065,3575893098,33
1,1193,41030,3575893065,3575893098,33
1,1193,41031,3575893065,3575893099,34
1,1193,41032,3575893065,3575893101,36
1,1193,41033,3575893065,3575893101,36
1,1193,41034,3575893065,3575893102,37
1,1193,41035,3575893065,3575893102,37
1,1193,41036,3575893065,3575893102,37
1,1193,41037,3575893065,3575893102,37
1,1193,41038,3575893065,3575893103,38
1,1193,41039,3575893065,3575893103,38
1,1193,41040,3575893065,3575893104,39
1,1193,41041,3575893065,3575893104,39
1,1193,41042,3575893065,3575893105,40
1,1193,41043,3575893065,3575893106,41
1,1193,41044,3575893065,3575893108,43
1,1193,41045,3575893065,3575893109,44
1,1193,41046,3575893065,3575893110,45
1,1193,41047,3575893065,3575893110,45
1,1193,41048,3575893065,3575893110,45
1,1193,41049,3575893065,3575893111,46
1,1193,41050,3575893065,3575893111,46
1,1193,41051,3575893065,3575893111,46
1,1193,41052,3575893065,3575893115,50
1,1194,41053,3575893129,3575893129,0
1,1194,41054,3575893129,3575893129,0
1,1194,41055,3575893129,3575893129,0
1,1194,41056,3575893129,3575893129,0
1,1194,41057,3575893129,3575893129,0
1,1194,41058,3575893129,3575893129,0
1,1194,41059,3575893129,3575893129,0
1,1194,41060,3575893129,3575893129,0
1,1194,41061,3575893129,3575893129,0
1,1194,41062,3575893129,3575893129,0
1,1194,41063,3575893129,3575893129,0
1,1194,41064,3575893129,3575893129,0
1,1194,41065,3575893129,3575893129,0
1,1194,41066,3575893129,3575893129,0
1,1194,41067,3575893129,3575893129,0
1,1194,41068,3575893129,3575893129,0
1,1194,41069,3575893129,3575893129,0
1,1194,41070,3575893129,3575893129,0
1,1194,41071,3575893129,3575893129,0
1,1194,41072,3575893129,3575893130,1
1,1194,41073,3575893129,3575893130,1
1,1194,41074,3575893129,3575893130,1
1,1194,41075,3575893129,3575893131,2
1,1194,41076,3575893129,3575893131,2
1,1194,41077,3575893129,3575893132,3
1,1194,41078,3575893129,3575893133,4
1,1194,41079,3575893129,3575893134,5
1,1194,41080,3575893129,3575893134,5
1,1194,41081,3575893129,3575893137,8
1,1194,41082,3575893129,3575893139,10
1,1194,41083,3575893129,3575893139,10
1,1194,41084,3575893129,3575893139,10
1,1194,41085,3575893129,3575893140,11
1,1194,41086,3575893129,3575893140,11
1,1194,41087,3575893129,3575893140,11
1,1194,41088,3575893129,3575893144,15
1,1194,41089,3575893129,3575893144,15
1,1194,41090,3575893129,3575893147,18
1,1194,41091,3575893129,3575893147,18
1,1194,41092,3575893129,3575893148,19
1,1194,41093,3575893129,3575893149,20
1,1194,41094,3575893129,3575893149,20
1,1194,41095,3575893129,3575893149,20
1,1194,41096,3575893129,3575893151,22
1,1194,41097,3575893129,3575893151,22
1,1194,41098,3575893129,3575893153,24
1,1194,41099,3575893129,3575893153,24
1,1194,41100,3575893129,3575893154,25
1,1194,41101,3575893129,3575893154,25
1,1194,41102,3575893129,3575893156,27
1,1194,41103,3575893129,3575893156,27
1,1194,41104,3575893129,3575893157,28
1,1194,41105,3575893129,3575893157,28
1,1194,41106,3575893129,3575893159,30
1,1194,41107,3575893129,3575893159,30
1,1194,41108,3575893129,3575893160,31
1,1194,41109,3575893129,3575893161,32
1,1194,41110,3575893129,3575893163,34
1,1194,41111,3575893129,3575893163,34
1,1194,41112,3575893129,3575893164,35
1,1194,41113,3575893129,3575893164,35
1,1194,41114,3575893129,3575893165,36
1,1194,41115,3575893129,3575893166,37
1,1194,41116,3575893129,3575893170,41
1,1194,41117,3575893129,3575893171,42
1,1194,41118,3575893129,3575893171,42
1,1194,41119,3575893129,3575893173,44
1,1194,41120,3575893129,3575893174,45
1,1194,41121,3575893129,3575893177,48
1,1194,41122,3575893129,3575893178,49
1,1194,41123,3575893129,3575893179,50
1,1195,41124,3575893192,3575893192,0
1,1195,41125,3575893192,3575893192,0
1,1195,41126,3575893192,3575893192,0
1,1195,41127,3575893192,3575893193,1
1,1195,41128,3575893192,3575893193,1
1,1195,41129,3575893192,3575893193,1
1,1195,41130,3575893192,3575893193,1
1,1195,41131,3575893192,3575893193,1
1,1195,41132,3575893192,3575893193,1
1,1195,41133,3575893192,3575893193,1
1,1195,41134,3575893192,3575893193,1
1,1195,41135,3575893192,3575893193,1
1,1195,41136,3575893192,3575893193,1
1,1195,41137,3575893192,3575893193,1
1,1195,41138,3575893192,3575893193,1
1,1195,41139,3575893192,3575893193,1
1,1195,41140,3575893192,3575893193,1
1,1195,41141,3575893192,3575893193,1
1,1195,41142,3575893192,3575893193,1
1,1195,41143,3575893192,3575893193,1
1,1195,41144,3575893192,3575893195,3
1,1195,41145,3575893192,3575893195,3
1,1195,41146,3575893192,3575893196,4
1,1195,41147,3575893192,3575893197,5
1,1195,41148,3575893192,3575893197,5
1,1195,41149,3575893192,3575893198,6
1,1195,41150,3575893192,3575893200,8
1,1195,41151,3575893192,3575893200,8
1,1195,41152,3575893192,3575893201,9
1,1195,41153,3575893192,3575893202,10
1,1195,41154,3575893192,3575893202,10
1,1195,41155,3575893192,3575893204,12
1,1195,41156,3575893192,3575893205,13
1,1195,41157,3575893192,3575893205,13
1,1195,41158,3575893192,3575893205,13
1,1195,41159,3575893192,3575893208,16
1,1195,41160,3575893192,3575893208,16
1,1195,41161,3575893192,3575893209,17
1,1195,41162,3575893192,3575893209,17
1,1195,41163,3575893192,3575893210,18
1,1195,41164,3575893192,3575893211,19
1,1195,41165,3575893192,3575893212,20
1,1195,41166,3575893192,3575893213,21
1,1195,41167,3575893192,3575893214,22
1,1195,41168,3575893192,3575893214,22
1,1195,41169,3575893192,3575893214,22
1,1195,41170,3575893192,3575893215,23
1,1195,41171,3575893192,3575893216,24
1,1195,41172,3575893192,3575893216,24
1,1195,41173,3575893192,3575893216,24
1,1195,41174,3575893192,3575893217,25
1,1195,41175,3575893192,3575893217,25
1,1195,41176,3575893192,3575893218,26
1,1195,41177,3575893192,3575893219,27
1,1195,41178,3575893192,3575893221,29
1,1195,41179,3575893192,3575893222,30
1,1195,41180,3575893192,3575893223,31
1,1195,41181,3575893192,3575893223,31
1,1195,41182,3575893192,3575893223,31
1,1195,41183,3575893192,3575893224,32
1,1195,41184,3575893192,3575893226,34
1,1195,41185,3575893192,3575893226,34
1,1195,41186,3575893192,3575893227,35
1,1195,41187,3575893192,3575893228,36
1,1195,41188,3575893192,3575893229,37
1,1195,41189,3575893192,3575893229,37
1,1195,41190,3575893192,3575893230,38
1,1195,41191,3575893192,3575893231,39
1,1195,41192,3575893192,3575893231,39
1,1195,41193,3575893192,3575893232,40
1,1195,41194,3575893192,3575893232,40
1,1195,41195,3575893192,3575893233,41
1,1195,41196,3575893192,3575893233,41
1,1195,41197,3575893192,3575893234,42
1,1195,41198,3575893192,3575893235,43
1,1195,41199,3575893192,3575893236,44
1,1195,41200,3575893192,3575893237,45
1,1195,41201,3575893192,3575893238,46
1,1195,41202,3575893192,3575893240,48
1,1195,41203,3575893192,3575893240,48
1,1195,41204,3575893192,3575893242,50
1,1196,41205,3575893258,3575893258,0
1,1196,41206,3575893258,3575893258,0
1,1196,41207,3575893258,3575893258,0
1,1196,41208,3575893258,3575893258,0
1,1196,41209,3575893258,3575893258,0
1,1196,41210,3575893258,3575893258,0
1,1196,41211,3575893258,3575893258,0
1,1196,41212,3575893258,3575893258,0
1,1196,41213,3575893258,3575893258,0
1,1196,41214,3575893258,3575893258,0
1,1196,41215,3575893258,3575893258,0
1,1196,41216,3575893258,3575893258,0
1,1196,41217,3575893258,3575893258,0
1,1196,41218,3575893258,3575893258,0
1,1196,41219,3575893258,3575893258,0
1,1196,41220,3575893258,3575893258,0
1,1196,41221,3575893258,3575893258,0
1,1196,41222,3575893258,3575893258,0
1,1196,41223,3575893258,3575893258,0
1,1196,41224,3575893258,3575893259,1
1,1196,41225,3575893258,3575893262,4
1,1196,41226,3575893258,3575893263,5
1,1196,41227,3575893258,3575893263,5
1,1196,41228,3575893258,3575893264,6
1,1196,41229,3575893258,3575893266,8
1,1196,41230,3575893258,3575893266,8
1,1196,41231,3575893258,3575893267,9
1,1196,41232,3575893258,3575893268,10
1,1196,41233,3575893258,3575893270,12
1,1196,41234,3575893258,3575893279,21
1,1196,41235,3575893258,3575893280,22
1,1196,41236,3575893258,3575893282,24
1,1196,41237,3575893258,3575893283,25
1,1196,41238,3575893258,3575893284,26
1,1196,41239,3575893258,3575893284,26
1,1196,41240,3575893258,3575893285,27
1,1196,41241,3575893258,3575893285,27
1,1196,41242,3575893258,3575893286,28
1,1196,41243,3575893258,3575893287,29
1,1196,41244,3575893258,3575893288,30
1,1196,41245,3575893258,3575893290,32
1,1196,41246,3575893258,3575893292,34
1,1196,41247,3575893258,3575893292,34
1,1196,41248,3575893258,3575893293,35
1,1196,41249,3575893258,3575893293,35
1,1196,41250,3575893258,3575893294,36
1,1196,41251,3575893258,3575893295,37
1,1196,41252,3575893258,3575893295,37
1,1196,41253,3575893258,3575893295,37
1,1196,41254,3575893258,3575893296,38
1,1196,41255,3575893258,3575893297,39
1,1196,41256,3575893258,3575893297,39
1,1196,41257,3575893258,3575893298,40
1,1196,41258,3575893258,3575893299,41
1,1196,41259,3575893258,3575893299,41
1,1196,41260,3575893258,3575893301,43
1,1196,41261,3575893258,3575893301,43
1,1196,41262,3575893258,3575893302,44
1,1196,41263,3575893258,3575893302,44
1,1196,41264,3575893258,3575893303,45
1,1196,41265,3575893258,3575893303,45
1,1196,41266,3575893258,3575893303,45
1,1196,41267,3575893258,3575893303,45
1,1196,41268,3575893258,3575893303,45
1,1196,41269,3575893258,3575893304,46
1,1196,41270,3575893258,3575893304,46
1,1196,41271,3575893258,3575893305,47
1,1196,41272,3575893258,3575893306,48
1,1196,41273,3575893258,3575893307,49
1,1196,41274,3575893258,3575893307,49
1,1196,41275,3575893258,3575893308,50
1,1197,41276,3575893321,3575893321,0
1,1197,41277,3575893321,3575893321,0
1,1197,41278,3575893321,3575893321,0
1,1197,41279,3575893321,3575893321,0
1,1197,41280,3575893321,3575893321,0
1,1197,41281,3575893321,3575893321,0
1,1197,41282,3575893321,3575893321,0
1,1197,41283,3575893321,3575893321,0
1,1197,41284,3575893321,3575893321,0
1,1197,41285,3575893321,3575893321,0
1,1197,41286,3575893321,3575893321,0
1,1197,41287,3575893321,3575893321,0
1,1197,41288,3575893321,3575893321,0
1,1197,41289,3575893321,3575893321,0
1,1197,41290,3575893321,3575893321,0
1,1197,41291,3575893321,3575893321,0
1,1197,41292,3575893321,3575893322,1
1,1197,41293,3575893321,3575893323,2
1,1197,41294,3575893321,3575893324,3
1,1197,41295,3575893321,3575893324,3
1,1197,41296,3575893321,3575893324,3
1,1197,41297,3575893321,3575893324,3
1,1197,41298,3575893321,3575893325,4
1,1197,41299,3575893321,3575893325,4
1,1197,41300,3575893321,3575893327,6
1,1197,41301,3575893321,3575893328,7
1,1197,41302,3575893321,3575893329,8
1,1197,41303,3575893321,3575893329,8
1,1197,41304,3575893321,3575893330,9
1,1197,41305,3575893321,3575893330,9
1,1197,41306,3575893321,3575893331,10
1,1197,41307,3575893321,3575893332,11
1,1197,41308,3575893321,3575893332,11
1,1197,41309,3575893321,3575893332,11
1,1197,41310,3575893321,3575893333,12
1,1197,41311,3575893321,3575893333,12
1,1197,41312,3575893321,3575893334,13
1,1197,41313,3575893321,3575893335,14
1,1197,41314,3575893321,3575893335,14
1,1197,41315,3575893321,3575893337,16
1,1197,41316,3575893321,3575893338,17
1,1197,41317,3575893321,3575893339,18
1,1197,41318,3575893321,3575893340,19
1,1197,41319,3575893321,3575893340,19
1,1197,41320,3575893321,3575893341,20
1,1197,41321,3575893321,3575893341,20
1,1197,41322,3575893321,3575893344,23
1,1197,41323,3575893321,3575893344,23
1,1197,41324,3575893321,3575893347,26
1,1197,41325,3575893321,3575893348,27
1,1197,41326,3575893321,3575893349,28
1,1197,41327,3575893321,3575893349,28
1,1197,41328,3575893321,3575893349,28
1,1197,41329,3575893321,3575893350,29
1,1197,41330,3575893321,3575893351,30
1,1197,41331,3575893321,3575893353,32
1,1197,41332,3575893321,3575893353,32
1,1197,41333,3575893321,3575893353,32
1,1197,41334,3575893321,3575893354,33
1,1197,41335,3575893321,3575893357,36
1,1197,41336,3575893321,3575893357,36
1,1197,41337,3575893321,3575893357,36
1,1197,41338,3575893321,3575893358,37
1,1197,41339,3575893321,3575893359,38
1,1197,41340,3575893321,3575893359,38
1,1197,41341,3575893321,3575893362,41
1,1197,41342,3575893321,3575893362,41
1,1197,41343,3575893321,3575893363,42
1,1197,41344,3575893321,3575893364,43
1,1197,41345,3575893321,3575893365,44
1,1197,41346,3575893321,3575893366,45
1,1197,41347,3575893321,3575893366,45
1,1197,41348,3575893321,3575893371,50
1,1198,41349,3575893388,3575893388,0
1,1198,41350,3575893388,3575893388,0
1,1198,41351,3575893388,3575893388,0
1,1198,41352,3575893388,3575893388,0
1,1198,41353,3575893388,3575893388,0
1,1198,41354,3575893388,3575893388,0
1,1198,41355,3575893388,3575893388,0
1,1198,41356,3575893388,3575893388,0
1,1198,41357,3575893388,3575893388,0
1,1198,41358,3575893388,3575893388,0
1,1198,41359,3575893388,3575893388,0
1,1198,41360,3575893388,3575893388,0
1,1198,41361,3575893388,3575893388,0
1,1198,41362,3575893388,3575893388,0
1,1198,41363,3575893388,3575893388,0
1,1198,41364,3575893388,3575893388,0
1,1198,41365,3575893388,3575893388,0
1,1198,41366,3575893388,3575893388,0
1,1198,41367,3575893388,3575893390,2
1,1198,41368,3575893388,3575893391,3
1,1198,41369,3575893388,3575893391,3
1,1198,41370,3575893388,3575893391,3
1,1198,41371,3575893388,3575893391,3
1,1198,41372,3575893388,3575893392,4
1,1198,41373,3575893388,3575893392,4
1,1198,41374,3575893388,3575893393,5
1,1198,41375,3575893388,3575893394,6
1,1198,41376,3575893388,3575893394,6
1,1198,41377,3575893388,3575893395,7
1,1198,41378,3575893388,3575893396,8
1,1198,41379,3575893388,3575893397,9
1,1198,41380,3575893388,3575893398,10
1,1198,41381,3575893388,3575893398,10
1,1198,41382,3575893388,3575893398,10
1,1198,41383,3575893388,3575893399,11
1,1198,41384,3575893388,3575893400,12
1,1198,41385,3575893388,3575893402,14
1,1198,41386,3575893388,3575893402,14
1,1198,41387,3575893388,3575893403,15
1,1198,41388,3575893388,3575893404,16
1,1198,41389,3575893388,3575893405,17
1,1198,41390,3575893388,3575893405,17
1,1198,41391,3575893388,3575893405,17
1,1198,41392,3575893388,3575893407,19
1,1198,41393,3575893388,3575893407,19
1,1198,41394,3575893388,3575893407,19
1,1198,41395,3575893388,3575893408,20
1,1198,41396,3575893388,3575893409,21
1,1198,41397,3575893388,3575893410,22
1,1198,41398,3575893388,3575893411,23
1,1198,41399,3575893388,3575893413,25
1,1198,41400,3575893388,3575893413,25
1,1198,41401,3575893388,3575893413,25
1,1198,41402,3575893388,3575893414,26
1,1198,41403,3575893388,3575893414,26
1,1198,41404,3575893388,3575893414,26
1,1198,41405,3575893388,3575893416,28
1,1198,41406,3575893388,3575893417,29
1,1198,41407,3575893388,3575893417,29
1,1198,41408,3575893388,3575893417,29
1,1198,41409,3575893388,3575893418,30
1,1198,41410,3575893388,3575893418,30
1,1198,41411,3575893388,3575893421,33
1,1198,41412,3575893388,3575893421,33
1,1198,41413,3575893388,3575893422,34
1,1198,41414,3575893388,3575893422,34
1,1198,41415,3575893388,3575893423,35
1,1198,41416,3575893388,3575893423,35
1,1198,41417,3575893388,3575893424,36
1,1198,41418,3575893388,3575893424,36
1,1198,41419,3575893388,3575893425,37
1,1198,41420,3575893388,3575893426,38
1,1198,41421,3575893388,3575893426,38
1,1198,41422,3575893388,3575893426,38
1,1198,41423,3575893388,3575893429,41
1,1198,41424,3575893388,3575893430,42
1,1198,41425,3575893388,3575893430,42
1,1198,41426,3575893388,3575893430,42
1,1198,41427,3575893388,3575893431,43
1,1198,41428,3575893388,3575893431,43
1,1198,41429,3575893388,3575893432,44
1,1198,41430,3575893388,3575893432,44
1,1198,41431,3575893388,3575893432,44
1,1198,41432,3575893388,3575893433,45
1,1198,41433,3575893388,3575893433,45
1,1198,41434,3575893388,3575893434,46
1,1198,41435,3575893388,3575893435,47
1,1198,41436,3575893388,3575893436,48
1,1198,41437,3575893388,3575893437,49
1,1198,41438,3575893388,3575893438,50
1,1199,41439,3575893451,3575893452,1
1,1199,41440,3575893451,3575893452,1
1,1199,41441,3575893451,3575893452,1
1,1199,41442,3575893451,3575893452,1
1,1199,41443,3575893451,3575893452,1
1,1199,41444,3575893451,3575893452,1
1,1199,41445,3575893451,3575893452,1
1,1199,41446,3575893451,3575893452,1
1,1199,41447,3575893451,3575893452,1
1,1199,41448,3575893451,3575893452,1
1,1199,41449,3575893451,3575893452,1
1,1199,41450,3575893451,3575893452,1
1,1199,41451,3575893451,3575893452,1
1,1199,41452,3575893451,3575893452,1
1,1199,41453,3575893451,3575893453,2
1,1199,41454,3575893451,3575893454,3
1,1199,41455,3575893451,3575893455,4
1,1199,41456,3575893451,3575893456,5
1,1199,41457,3575893451,3575893456,5
1,1199,41458,3575893451,3575893457,6
1,1199,41459,3575893451,3575893459,8
1,1199,41460,3575893451,3575893460,9
1,1199,41461,3575893451,3575893463,12
1,1199,41462,3575893451,3575893464,13
1,1199,41463,3575893451,3575893464,13
1,1199,41464,3575893451,3575893465,14
1,1199,41465,3575893451,3575893466,15
1,1199,41466,3575893451,3575893467,16
1,1199,41467,3575893451,3575893467,16
1,1199,41468,3575893451,3575893471,20
1,1199,41469,3575893451,3575893479,28
1,1199,41470,3575893451,3575893480,29
1,1199,41471,3575893451,3575893482,31
1,1199,41472,3575893451,3575893482,31
1,1199,41473,3575893451,3575893483,32
1,1199,41474,3575893451,3575893485,34
1,1199,41475,3575893451,3575893485,34
1,1199,41476,3575893451,3575893485,34
1,1199,41477,3575893451,3575893485,34
1,1199,41478,3575893451,3575893486,35
1,1199,41479,3575893451,3575893487,36
1,1199,41480,3575893451,3575893488,37
1,1199,41481,3575893451,3575893490,39
1,1199,41482,3575893451,3575893491,40
1,1199,41483,3575893451,3575893492,41
1,1199,41484,3575893451,3575893492,41
1,1199,41485,3575893451,3575893493,42
1,1199,41486,3575893451,3575893493,42
1,1199,41487,3575893451,3575893494,43
1,1199,41488,3575893451,3575893496,45
1,1199,41489,3575893451,3575893496,45
1,1199,41490,3575893451,3575893497,46
1,1199,41491,3575893451,3575893497,46
1,1199,41492,3575893451,3575893499,48
1,1199,41493,3575893451,3575893500,49
1,1199,41494,3575893451,3575893500,49
1,1199,41495,3575893451,3575893501,50
1,1200,41496,3575893518,3575893518,0
1,1200,41497,3575893518,3575893518,0
1,1200,41498,3575893518,3575893518,0
1,1200,41499,3575893518,3575893518,0
1,1200,41500,3575893518,3575893518,0
1,1200,41501,3575893518,3575893518,0
1,1200,41502,3575893518,3575893518,0
1,1200,41503,3575893518,3575893518,0
1,1200,41504,3575893518,3575893518,0
1,1200,41505,3575893518,3575893518,0
1,1200,41506,3575893518,3575893518,0
1,1200,41507,3575893518,3575893518,0
1,1200,41508,3575893518,3575893518,0
1,1200,41509,3575893518,3575893518,0
1,1200,41510,3575893518,3575893518,0
1,1200,41511,3575893518,3575893518,0
1,1200,41512,3575893518,3575893518,0
1,1200,41513,3575893518,3575893518,0
1,1200,41514,3575893518,3575893518,0
1,1200,41515,3575893518,3575893518,0
1,1200,41516,3575893518,3575893518,0
1,1200,41517,3575893518,3575893518,0
1,1200,41518,3575893518,3575893518,0
1,1200,41519,3575893518,3575893518,0
1,1200,41520,3575893518,3575893518,0
1,1200,41521,3575893518,3575893518,0
1,1200,41522,3575893518,3575893518,0
1,1200,41523,3575893518,3575893518,0
1,1200,41524,3575893518,3575893519,1
1,1200,41525,3575893518,3575893521,3
1,1200,41526,3575893518,3575893522,4
1,1200,41527,3575893518,3575893522,4
1,1200,41528,3575893518,3575893522,4
1,1200,41529,3575893518,3575893522,4
1,1200,41530,3575893518,3575893522,4
1,1200,41531,3575893518,3575893523,5
1,1200,41532,3575893518,3575893524,6
1,1200,41533,3575893518,3575893526,8
1,1200,41534,3575893518,3575893527,9
1,1200,41535,3575893518,3575893528,10
1,1200,41536,3575893518,3575893528,10
1,1200,41537,3575893518,3575893529,11
1,1200,41538,3575893518,3575893529,11
1,1200,41539,3575893518,3575893530,12
1,1200,41540,3575893518,3575893530,12
1,1200,41541,3575893518,3575893530,12
1,1200,41542,3575893518,3575893531,13
1,1200,41543,3575893518,3575893532,14
1,1200,41544,3575893518,3575893532,14
1,1200,41545,3575893518,3575893532,14
1,1200,41546,3575893518,3575893533,15
1,1200,41547,3575893518,3575893534,16
1,1200,41548,3575893518,3575893537,19
1,1200,41549,3575893518,3575893537,19
1,1200,41550,3575893518,3575893538,20
1,1200,41551,3575893518,3575893539,21
1,1200,41552,3575893518,3575893540,22
1,1200,41553,3575893518,3575893543,25
1,1200,41554,3575893518,3575893545,27
1,1200,41555,3575893518,3575893546,28
1,1200,41556,3575893518,3575893547,29
1,1200,41557,3575893518,3575893547,29
1,1200,41558,3575893518,3575893548,30
1,1200,41559,3575893518,3575893549,31
1,1200,41560,3575893518,3575893550,32
1,1200,41561,3575893518,3575893552,34
1,1200,41562,3575893518,3575893552,34
1,1200,41563,3575893518,3575893553,35
1,1200,41564,3575893518,3575893553,35
1,1200,41565,3575893518,3575893554,36
1,1200,41566,3575893518,3575893556,38
1,1200,41567,3575893518,3575893557,39
1,1200,41568,3575893518,3575893557,39
1,1200,41569,3575893518,3575893558,40
1,1200,41570,3575893518,3575893559,41
1,1200,41571,3575893518,3575893560,42
1,1200,41572,3575893518,3575893561,43
1,1200,41573,3575893518,3575893561,43
1,1200,41574,3575893518,3575893562,44
1,1200,41575,3575893518,3575893563,45
1,1200,41576,3575893518,3575893563,45
1,1200,41577,3575893518,3575893564,46
1,1200,41578,3575893518,3575893565,47
1,1200,41579,3575893518,3575893566,48
1,1201,41580,3575893581,3575893581,0
1,1201,41581,3575893581,3575893581,0
1,1201,41582,3575893581,3575893581,0
1,1201,41583,3575893581,3575893581,0
1,1201,41584,3575893581,3575893581,0
1,1201,41585,3575893581,3575893581,0
1,1201,41586,3575893581,3575893581,0
1,1201,41587,3575893581,3575893581,0
1,1201,41588,3575893581,3575893581,0
1,1201,41589,3575893581,3575893581,0
1,1201,41590,3575893581,3575893581,0
1,1201,41591,3575893581,3575893581,0
1,1201,41592,3575893581,3575893581,0
1,1201,41593,3575893581,3575893581,0
1,1201,41594,3575893581,3575893582,1
1,1201,41595,3575893581,3575893583,2
1,1201,41596,3575893581,3575893584,3
1,1201,41597,3575893581,3575893585,4
1,1201,41598,3575893581,3575893585,4
1,1201,41599,3575893581,3575893585,4
1,1201,41600,3575893581,3575893589,8
1,1201,41601,3575893581,3575893589,8
1,1201,41602,3575893581,3575893590,9
1,1201,41603,3575893581,3575893591,10
1,1201,41604,3575893581,3575893591,10
1,1201,41605,3575893581,3575893591,10
1,1201,41606,3575893581,3575893592,11
1,1201,41607,3575893581,3575893593,12
1,1201,41608,3575893581,3575893594,13
1,1201,41609,3575893581,3575893595,14
1,1201,41610,3575893581,3575893595,14
1,1201,41611,3575893581,3575893596,15
1,1201,41612,3575893581,3575893596,15
1,1201,41613,3575893581,3575893596,15
1,1201,41614,3575893581,3575893597,16
1,1201,41615,3575893581,3575893599,18
1,1201,41616,3575893581,3575893599,18
1,1201,41617,3575893581,3575893601,20
1,1201,41618,3575893581,3575893601,20
1,1201,41619,3575893581,3575893602,21
1,1201,41620,3575893581,3575893603,22
1,1201,41621,3575893581,3575893603,22
1,1201,41622,3575893581,3575893604,23
1,1201,41623,3575893581,3575893604,23
1,1201,41624,3575893581,3575893606,25
1,1201,41625,3575893581,3575893606,25
1,1201,41626,3575893581,3575893606,25
1,1201,41627,3575893581,3575893607,26
1,1201,41628,3575893581,3575893609,28
1,1201,41629,3575893581,3575893609,28
1,1201,41630,3575893581,3575893611,30
1,1201,41631,3575893581,3575893611,30
1,1201,41632,3575893581,3575893612,31
1,1201,41633,3575893581,3575893613,32
1,1201,41634,3575893581,3575893613,32
1,1201,41635,3575893581,3575893613,32
1,1201,41636,3575893581,3575893613,32
1,1201,41637,3575893581,3575893615,34
1,1201,41638,3575893581,3575893616,35
1,1201,41639,3575893581,3575893616,35
1,1201,41640,3575893581,3575893616,35
1,1201,41641,3575893581,3575893617,36
1,1201,41642,3575893581,3575893617,36
1,1201,41643,3575893581,3575893617,36
1,1201,41644,3575893581,3575893618,37
1,1201,41645,3575893581,3575893621,40
1,1201,41646,3575893581,3575893621,40
1,1201,41647,3575893581,3575893622,41
1,1201,41648,3575893581,3575893622,41
1,1201,41649,3575893581,3575893622,41
1,1201,41650,3575893581,3575893624,43
1,1201,41651,3575893581,3575893625,44
1,1201,41652,3575893581,3575893625,44
1,1201,41653,3575893581,3575893625,44
1,1201,41654,3575893581,3575893628,47
1,1201,41655,3575893581,3575893628,47
1,1201,41656,3575893581,3575893629,48
1,1201,41657,3575893581,3575893630,49
1,1201,41658,3575893581,3575893630,49
1,1201,41659,3575893581,3575893630,49
1,1201,41660,3575893581,3575893630,49
1,1201,41661,3575893581,3575893631,50
1,1202,41662,3575893646,3575893646,0
1,1202,41663,3575893646,3575893646,0
1,1202,41664,3575893646,3575893646,0
1,1202,41665,3575893646,3575893646,0
1,1202,41666,3575893646,3575893646,0
1,1202,41667,3575893646,3575893646,0
1,1202,41668,3575893646,3575893646,0
1,1202,41669,3575893646,3575893646,0
1,1202,41670,3575893646,3575893646,0
1,1202,41671,3575893646,3575893646,0
1,1202,41672,3575893646,3575893646,0
1,1202,41673,3575893646,3575893646,0
1,1202,41674,3575893646,3575893646,0
1,1202,41675,3575893646,3575893646,0
1,1202,41676,3575893646,3575893647,1
1,1202,41677,3575893646,3575893648,2
1,1202,41678,3575893646,3575893649,3
1,1202,41679,3575893646,3575893649,3
1,1202,41680,3575893646,3575893649,3
1,1202,41681,3575893646,3575893651,5
1,1202,41682,3575893646,3575893652,6
1,1202,41683,3575893646,3575893654,8
1,1202,41684,3575893646,3575893654,8
1,1202,41685,3575893646,3575893655,9
1,1202,41686,3575893646,3575893656,10
1,1202,41687,3575893646,3575893658,12
1,1202,41688,3575893646,3575893662,16
1,1202,41689,3575893646,3575893663,17
1,1202,41690,3575893646,3575893663,17
1,1202,41691,3575893646,3575893666,20
1,1202,41692,3575893646,3575893667,21
1,1202,41693,3575893646,3575893667,21
1,1202,41694,3575893646,3575893667,21
1,1202,41695,3575893646,3575893670,24
1,1202,41696,3575893646,3575893679,33
1,1202,41697,3575893646,3575893679,33
1,1202,41698,3575893646,3575893682,36
1,1202,41699,3575893646,3575893682,36
1,1202,41700,3575893646,3575893684,38
1,1202,41701,3575893646,3575893684,38
1,1202,41702,3575893646,3575893685,39
1,1202,41703,3575893646,3575893685,39
1,1202,41704,3575893646,3575893685,39
1,1202,41705,3575893646,3575893685,39
1,1202,41706,3575893646,3575893686,40
1,1202,41707,3575893646,3575893686,40
1,1202,41708,3575893646,3575893689,43
1,1202,41709,3575893646,3575893690,44
1,1202,41710,3575893646,3575893692,46
1,1202,41711,3575893646,3575893692,46
1,1202,41712,3575893646,3575893693,47
1,1202,41713,3575893646,3575893695,49
1,1202,41714,3575893646,3575893696,50
1,1203,41715,3575893711,3575893711,0
1,1203,41716,3575893711,3575893711,0
1,1203,41717,3575893711,3575893711,0
1,1203,41718,3575893711,3575893711,0
1,1203,41719,3575893711,3575893711,0
1,1203,41720,3575893711,3575893711,0
1,1203,41721,3575893711,3575893711,0
1,1203,41722,3575893711,3575893711,0
1,1203,41723,3575893711,3575893711,0
1,1203,41724,3575893711,3575893711,0
1,1203,41725,3575893711,3575893711,0
1,1203,41726,3575893711,3575893711,0
1,1203,41727,3575893711,3575893711,0
1,1203,41728,3575893711,3575893711,0
1,1203,41729,3575893711,3575893711,0
1,1203,41730,3575893711,3575893711,0
1,1203,41731,3575893711,3575893711,0
1,1203,41732,3575893711,3575893711,0
1,1203,41733,3575893711,3575893711,0
1,1203,41734,3575893711,3575893711,0
1,1203,41735,3575893711,3575893711,0
1,1203,41736,3575893711,3575893711,0
1,1203,41737,3575893711,3575893711,0
1,1203,41738,3575893711,3575893711,0
1,1203,41739,3575893711,3575893711,0
1,1203,41740,3575893711,3575893712,1
1,1203,41741,3575893711,3575893713,2
1,1203,41742,3575893711,3575893714,3
1,1203,41743,3575893711,3575893714,3
1,1203,41744,3575893711,3575893715,4
1,1203,41745,3575893711,3575893715,4
1,1203,41746,3575893711,3575893716,5
1,1203,41747,3575893711,3575893716,5
1,1203,41748,3575893711,3575893719,8
1,1203,41749,3575893711,3575893722,11
1,1203,41750,3575893711,3575893722,11
1,1203,41751,3575893711,3575893722,11
1,1203,41752,3575893711,3575893722,11
1,1203,41753,3575893711,3575893723,12
1,1203,41754,3575893711,3575893723,12
1,1203,41755,3575893711,3575893725,14
1,1203,41756,3575893711,3575893725,14
1,1203,41757,3575893711,3575893726,15
1,1203,41758,3575893711,3575893727,16
1,1203,41759,3575893711,3575893728,17
1,1203,41760,3575893711,3575893728,17
1,1203,41761,3575893711,3575893729,18
1,1203,41762,3575893711,3575893729,18
1,1203,41763,3575893711,3575893729,18
1,1203,41764,3575893711,3575893729,18
1,1203,41765,3575893711,3575893730,19
1,1203,41766,3575893711,3575893731,20
1,1203,41767,3575893711,3575893732,21
1,1203,41768,3575893711,3575893732,21
1,1203,41769,3575893711,3575893733,22
1,1203,41770,3575893711,3575893734,23
1,1203,41771,3575893711,3575893735,24
1,1203,41772,3575893711,3575893737,26
1,1203,41773,3575893711,3575893738,27
1,1203,41774,3575893711,3575893739,28
1,1203,41775,3575893711,3575893739,28
1,1203,41776,3575893711,3575893740,29
1,1203,41777,3575893711,3575893742,31
1,1203,41778,3575893711,3575893743,32
1,1203,41779,3575893711,3575893745,34
1,1203,41780,3575893711,3575893747,36
1,1203,41781,3575893711,3575893748,37
1,1203,41782,3575893711,3575893748,37
1,1203,41783,3575893711,3575893749,38
1,1203,41784,3575893711,3575893750,39
1,1203,41785,3575893711,3575893751,40
1,1203,41786,3575893711,3575893751,40
1,1203,41787,3575893711,3575893752,41
1,1203,41788,3575893711,3575893753,42
1,1203,41789,3575893711,3575893753,42
1,1203,41790,3575893711,3575893753,42
1,1203,41791,3575893711,3575893756,45
1,1203,41792,3575893711,3575893756,45
1,1203,41793,3575893711,3575893757,46
1,1203,41794,3575893711,3575893757,46
1,1203,41795,3575893711,3575893759,48
1,1203,41796,3575893711,3575893761,50
1,1204,41797,3575893775,3575893775,0
1,1204,41798,3575893775,3575893775,0
1,1204,41799,3575893775,3575893775,0
1,1204,41800,3575893775,3575893775,0
1,1204,41801,3575893775,3575893775,0
1,1204,41802,3575893775,3575893775,0
1,1204,41803,3575893775,3575893775,0
1,1204,41804,3575893775,3575893775,0
1,1204,41805,3575893775,3575893775,0
1,1204,41806,3575893775,3575893775,0
1,1204,41807,3575893775,3575893775,0
1,1204,41808,3575893775,3575893775,0
1,1204,41809,3575893775,3575893775,0
1,1204,41810,3575893775,3575893775,0
1,1204,41811,3575893775,3575893775,0
1,1204,41812,3575893775,3575893775,0
1,1204,41813,3575893775,3575893776,1
1,1204,41814,3575893775,3575893778,3
1,1204,41815,3575893775,3575893778,3
1,1204,41816,3575893775,3575893779,4
1,1204,41817,3575893775,3575893780,5
1,1204,41818,3575893775,3575893781,6
1,1204,41819,3575893775,3575893781,6
1,1204,41820,3575893775,3575893782,7
1,1204,41821,3575893775,3575893782,7
1,1204,41822,3575893775,3575893783,8
1,1204,41823,3575893775,3575893784,9
1,1204,41824,3575893775,3575893784,9
1,1204,41825,3575893775,3575893785,10
1,1204,41826,3575893775,3575893785,10
1,1204,41827,3575893775,3575893789,14
1,1204,41828,3575893775,3575893791,16
1,1204,41829,3575893775,3575893791,16
1,1204,41830,3575893775,3575893791,16
1,1204,41831,3575893775,3575893791,16
1,1204,41832,3575893775,3575893792,17
1,1204,41833,3575893775,3575893792,17
1,1204,41834,3575893775,3575893794,19
1,1204,41835,3575893775,3575893795,20
1,1204,41836,3575893775,3575893796,21
1,1204,41837,3575893775,3575893796,21
1,1204,41838,3575893775,3575893796,21
1,1204,41839,3575893775,3575893798,23
1,1204,41840,3575893775,3575893798,23
1,1204,41841,3575893775,3575893799,24
1,1204,41842,3575893775,3575893801,26
1,1204,41843,3575893775,3575893802,27
1,1204,41844,3575893775,3575893803,28
1,1204,41845,3575893775,3575893803,28
1,1204,41846,3575893775,3575893803,28
1,1204,41847,3575893775,3575893806,31
1,1204,41848,3575893775,3575893807,32
1,1204,41849,3575893775,3575893807,32
1,1204,41850,3575893775,3575893807,32
1,1204,41851,3575893775,3575893809,34
1,1204,41852,3575893775,3575893809,34
1,1204,41853,3575893775,3575893810,35
1,1204,41854,3575893775,3575893810,35
1,1204,41855,3575893775,3575893810,35
1,1204,41856,3575893775,3575893811,36
1,1204,41857,3575893775,3575893811,36
1,1204,41858,3575893775,3575893812,37
1,1204,41859,3575893775,3575893813,38
1,1204,41860,3575893775,3575893813,38
1,1204,41861,3575893775,3575893813,38
1,1204,41862,3575893775,3575893814,39
1,1204,41863,3575893775,3575893815,40
1,1204,41864,3575893775,3575893816,41
1,1204,41865,3575893775,3575893816,41
1,1204,41866,3575893775,3575893817,42
1,1204,41867,3575893775,3575893818,43
1,1204,41868,3575893775,3575893818,43
1,1204,41869,3575893775,3575893818,43
1,1204,41870,3575893775,3575893820,45
1,1204,41871,3575893775,3575893821,46
1,1204,41872,3575893775,3575893822,47
1,1204,41873,3575893775,3575893822,47
1,1204,41874,3575893775,3575893823,48
1,1204,41875,3575893775,3575893823,48
1,1204,41876,3575893775,3575893824,49
1,1204,41877,3575893775,3575893824,49
1,1204,41878,3575893775,3575893825,50
1,1205,41879,3575893842,3575893842,0
1,1205,41880,3575893842,3575893842,0
1,1205,41881,3575893842,3575893842,0
1,1205,41882,3575893842,3575893842,0
1,1205,41883,3575893842,3575893842,0
1,1205,41884,3575893842,3575893842,0
1,1205,41885,3575893842,3575893842,0
1,1205,41886,3575893842,3575893842,0
1,1205,41887,3575893842,3575893842,0
1,1205,41888,3575893842,3575893842,0
1,1205,41889,3575893842,3575893842,0
1,1205,41890,3575893842,3575893842,0
1,1205,41891,3575893842,3575893842,0
1,1205,41892,3575893842,3575893842,0
1,1205,41893,3575893842,3575893842,0
1,1205,41894,3575893842,3575893842,0
1,1205,41895,3575893842,3575893842,0
1,1205,41896,3575893842,3575893842,0
1,1205,41897,3575893842,3575893842,0
1,1205,41898,3575893842,3575893842,0
1,1205,41899,3575893842,3575893843,1
1,1205,41900,3575893842,3575893844,2
1,1205,41901,3575893842,3575893844,2
1,1205,41902,3575893842,3575893845,3
1,1205,41903,3575893842,3575893845,3
1,1205,41904,3575893842,3575893848,6
1,1205,41905,3575893842,3575893848,6
1,1205,41906,3575893842,3575893848,6
1,1205,41907,3575893842,3575893848,6
1,1205,41908,3575893842,3575893849,7
1,1205,41909,3575893842,3575893849,7
1,1205,41910,3575893842,3575893849,7
1,1205,41911,3575893842,3575893850,8
1,1205,41912,3575893842,3575893851,9
1,1205,41913,3575893842,3575893852,10
1,1205,41914,3575893842,3575893853,11
1,1205,41915,3575893842,3575893854,12
1,1205,41916,3575893842,3575893858,16
1,1205,41917,3575893842,3575893858,16
1,1205,41918,3575893842,3575893863,21
1,1205,41919,3575893842,3575893863,21
1,1205,41920,3575893842,3575893863,21
1,1205,41921,3575893842,3575893864,22
1,1205,41922,3575893842,3575893866,24
1,1205,41923,3575893842,3575893867,25
1,1205,41924,3575893842,3575893868,26
1,1205,41925,3575893842,3575893868,26
1,1205,41926,3575893842,3575893870,28
1,1205,41927,3575893842,3575893879,37
1,1205,41928,3575893842,3575893880,38
1,1205,41929,3575893842,3575893883,41
1,1205,41930,3575893842,3575893884,42
1,1205,41931,3575893842,3575893884,42
1,1205,41932,3575893842,3575893885,43
1,1205,41933,3575893842,3575893885,43
1,1205,41934,3575893842,3575893886,44
1,1205,41935,3575893842,3575893886,44
1,1205,41936,3575893842,3575893886,44
1,1205,41937,3575893842,3575893887,45
1,1205,41938,3575893842,3575893888,46
1,1205,41939,3575893842,3575893890,48
1,1205,41940,3575893842,3575893890,48
1,1205,41941,3575893842,3575893892,50
1,1206,41942,3575893904,3575893905,1
1,1206,41943,3575893904,3575893905,1
1,1206,41944,3575893904,3575893905,1
1,1206,41945,3575893904,3575893905,1
1,1206,41946,3575893904,3575893905,1
1,1206,41947,3575893904,3575893905,1
1,1206,41948,3575893904,3575893905,1
1,1206,41949,3575893904,3575893905,1
1,1206,41950,3575893904,3575893905,1
1,1206,41951,3575893904,3575893905,1
1,1206,41952,3575893904,3575893905,1
1,1206,41953,3575893904,3575893905,1
1,1206,41954,3575893904,3575893905,1
1,1206,41955,3575893904,3575893905,1
1,1206,41956,3575893904,3575893905,1
1,1206,41957,3575893904,3575893905,1
1,1206,41958,3575893904,3575893905,1
1,1206,41959,3575893904,3575893905,1
1,1206,41960,3575893904,3575893905,1
1,1206,41961,3575893904,3575893905,1
1,1206,41962,3575893904,3575893905,1
1,1206,41963,3575893904,3575893905,1
1,1206,41964,3575893904,3575893905,1
1,1206,41965,3575893904,3575893906,2
1,1206,41966,3575893904,3575893906,2
1,1206,41967,3575893904,3575893907,3
1,1206,41968,3575893904,3575893907,3
1,1206,41969,3575893904,3575893909,5
1,1206,41970,3575893904,3575893909,5
1,1206,41971,3575893904,3575893910,6
1,1206,41972,3575893904,3575893910,6
1,1206,41973,3575893904,3575893911,7
1,1206,41974,3575893904,3575893912,8
1,1206,41975,3575893904,3575893914,10
1,1206,41976,3575893904,3575893914,10
1,1206,41977,3575893904,3575893915,11
1,1206,41978,3575893904,3575893916,12
1,1206,41979,3575893904,3575893918,14
1,1206,41980,3575893904,3575893920,16
1,1206,41981,3575893904,3575893922,18
1,1206,41982,3575893904,3575893922,18
1,1206,41983,3575893904,3575893923,19
1,1206,41984,3575893904,3575893923,19
1,1206,41985,3575893904,3575893923,19
1,1206,41986,3575893904,3575893923,19
1,1206,41987,3575893904,3575893925,21
1,1206,41988,3575893904,3575893926,22
1,1206,41989,3575893904,3575893926,22
1,1206,41990,3575893904,3575893927,23
1,1206,41991,3575893904,3575893928,24
1,1206,41992,3575893904,3575893928,24
1,1206,41993,3575893904,3575893928,24
1,1206,41994,3575893904,3575893929,25
1,1206,41995,3575893904,3575893929,25
1,1206,41996,3575893904,3575893930,26
1,1206,41997,3575893904,3575893931,27
1,1206,41998,3575893904,3575893931,27
1,1206,41999,3575893904,3575893931,27
1,1206,42000,3575893904,3575893932,28
1,1206,42001,3575893904,3575893933,29
1,1206,42002,3575893904,3575893934,30
1,1206,42003,3575893904,3575893938,34
1,1206,42004,3575893904,3575893938,34
1,1206,42005,3575893904,3575893938,34
1,1206,42006,3575893904,3575893939,35
1,1206,42007,3575893904,3575893939,35
1,1206,42008,3575893904,3575893940,36
1,1206,42009,3575893904,3575893942,38
1,1206,42010,3575893904,3575893943,39
1,1206,42011,3575893904,3575893945,41
1,1206,42012,3575893904,3575893946,42
1,1206,42013,3575893904,3575893947,43
1,1206,42014,3575893904,3575893947,43
1,1206,42015,3575893904,3575893947,43
1,1206,42016,3575893904,3575893948,44
1,1206,42017,3575893904,3575893949,45
1,1206,42018,3575893904,3575893949,45
1,1206,42019,3575893904,3575893950,46
1,1206,42020,3575893904,3575893951,47
1,1206,42021,3575893904,3575893952,48
1,1206,42022,3575893904,3575893953,49
1,1206,42023,3575893904,3575893953,49
1,1206,42024,3575893904,3575893954,50
1,1207,42025,3575893970,3575893970,0
1,1207,42026,3575893970,3575893970,0
1,1207,42027,3575893970,3575893970,0
1,1207,42028,3575893970,3575893970,0
1,1207,42029,3575893970,3575893970,0
1,1207,42030,3575893970,3575893970,0
1,1207,42031,3575893970,3575893970,0
1,1207,42032,3575893970,3575893970,0
1,1207,42033,3575893970,3575893970,0
1,1207,42034,3575893970,3575893970,0
1,1207,42035,3575893970,3575893970,0
1,1207,42036,3575893970,3575893970,0
1,1207,42037,3575893970,3575893970,0
1,1207,42038,3575893970,3575893970,0
1,1207,42039,3575893970,3575893972,2
1,1207,42040,3575893970,3575893972,2
1,1207,42041,3575893970,3575893973,3
1,1207,42042,3575893970,3575893974,4
1,1207,42043,3575893970,3575893975,5
1,1207,42044,3575893970,3575893975,5
1,1207,42045,3575893970,3575893975,5
1,1207,42046,3575893970,3575893977,7
1,1207,42047,3575893970,3575893978,8
1,1207,42048,3575893970,3575893978,8
1,1207,42049,3575893970,3575893979,9
1,1207,42050,3575893970,3575893980,10
1,1207,42051,3575893970,3575893981,11
1,1207,42052,3575893970,3575893981,11
1,1207,42053,3575893970,3575893981,11
1,1207,42054,3575893970,3575893982,12
1,1207,42055,3575893970,3575893983,13
1,1207,42056,3575893970,3575893984,14
1,1207,42057,3575893970,3575893984,14
1,1207,42058,3575893970,3575893985,15
1,1207,42059,3575893970,3575893985,15
1,1207,42060,3575893970,3575893989,19
1,1207,42061,3575893970,3575893989,19
1,1207,42062,3575893970,3575893991,21
1,1207,42063,3575893970,3575893991,21
1,1207,42064,3575893970,3575893991,21
1,1207,42065,3575893970,3575893991,21
1,1207,42066,3575893970,3575893992,22
1,1207,42067,3575893970,3575893992,22
1,1207,42068,3575893970,3575893992,22
1,1207,42069,3575893970,3575893993,23
1,1207,42070,3575893970,3575893994,24
1,1207,42071,3575893970,3575893994,24
1,1207,42072,3575893970,3575893996,26
1,1207,42073,3575893970,3575893997,27
1,1207,42074,3575893970,3575893997,27
1,1207,42075,3575893970,3575893999,29
1,1207,42076,3575893970,3575893999,29
1,1207,42077,3575893970,3575894002,32
1,1207,42078,3575893970,3575894002,32
1,1207,42079,3575893970,3575894003,33
1,1207,42080,3575893970,3575894003,33
1,1207,42081,3575893970,3575894004,34
1,1207,42082,3575893970,3575894005,35
1,1207,42083,3575893970,3575894006,36
1,1207,42084,3575893970,3575894007,37
1,1207,42085,3575893970,3575894007,37
1,1207,42086,3575893970,3575894007,37
1,1207,42087,3575893970,3575894009,39
1,1207,42088,3575893970,3575894009,39
1,1207,42089,3575893970,3575894010,40
1,1207,42090,3575893970,3575894011,41
1,1207,42091,3575893970,3575894011,41
1,1207,42092,3575893970,3575894011,41
1,1207,42093,3575893970,3575894012,42
1,1207,42094,3575893970,3575894012,42
1,1207,42095,3575893970,3575894013,43
1,1207,42096,3575893970,3575894014,44
1,1207,42097,3575893970,3575894014,44
1,1207,42098,3575893970,3575894014,44
1,1207,42099,3575893970,3575894015,45
1,1207,42100,3575893970,3575894015,45
1,1207,42101,3575893970,3575894016,46
1,1207,42102,3575893970,3575894016,46
1,1207,42103,3575893970,3575894018,48
1,1207,42104,3575893970,3575894019,49
1,1208,42105,3575894033,3575894033,0
1,1208,42106,3575894033,3575894033,0
1,1208,42107,3575894033,3575894033,0
1,1208,42108,3575894033,3575894033,0
1,1208,42109,3575894033,3575894033,0
1,1208,42110,3575894033,3575894033,0
1,1208,42111,3575894033,3575894033,0
1,1208,42112,3575894033,3575894033,0
1,1208,42113,3575894033,3575894033,0
1,1208,42114,3575894033,3575894033,0
1,1208,42115,3575894033,3575894033,0
1,1208,42116,3575894033,3575894033,0
1,1208,42117,3575894033,3575894033,0
1,1208,42118,3575894033,3575894033,0
1,1208,42119,3575894033,3575894033,0
1,1208,42120,3575894033,3575894033,0
1,1208,42121,3575894033,3575894033,0
1,1208,42122,3575894033,3575894033,0
1,1208,42123,3575894033,3575894034,1
1,1208,42124,3575894033,3575894035,2
1,1208,42125,3575894033,3575894036,3
1,1208,42126,3575894033,3575894037,4
1,1208,42127,3575894033,3575894037,4
1,1208,42128,3575894033,3575894039,6
1,1208,42129,3575894033,3575894040,7
1,1208,42130,3575894033,3575894041,8
1,1208,42131,3575894033,3575894044,11
1,1208,42132,3575894033,3575894045,12
1,1208,42133,3575894033,3575894045,12
1,1208,42134,3575894033,3575894045,12
1,1208,42135,3575894033,3575894046,13
1,1208,42136,3575894033,3575894047,14
1,1208,42137,3575894033,3575894047,14
1,1208,42138,3575894033,3575894048,15
1,1208,42139,3575894033,3575894048,15
1,1208,42140,3575894033,3575894049,16
1,1208,42141,3575894033,3575894050,17
1,1208,42142,3575894033,3575894050,17
1,1208,42143,3575894033,3575894051,18
1,1208,42144,3575894033,3575894052,19
1,1208,42145,3575894033,3575894054,21
1,1208,42146,3575894033,3575894055,22
1,1208,42147,3575894033,3575894059,26
1,1208,42148,3575894033,3575894059,26
1,1208,42149,3575894033,3575894063,30
1,1208,42150,3575894033,3575894063,30
1,1208,42151,3575894033,3575894063,30
1,1208,42152,3575894033,3575894063,30
1,1208,42153,3575894033,3575894066,33
1,1208,42154,3575894033,3575894067,34
1,1208,42155,3575894033,3575894067,34
1,1208,42156,3575894033,3575894068,35
1,1208,42157,3575894033,3575894070,37
1,1208,42158,3575894033,3575894080,47
1,1208,42159,3575894033,3575894081,48
1,1208,42160,3575894033,3575894082,49
1,1208,42161,3575894033,3575894083,50
1,1209,42162,3575894097,3575894097,0
1,1209,42163,3575894097,3575894097,0
1,1209,42164,3575894097,3575894097,0
1,1209,42165,3575894097,3575894097,0
1,1209,42166,3575894097,3575894097,0
1,1209,42167,3575894097,3575894097,0
1,1209,42168,3575894097,3575894097,0
1,1209,42169,3575894097,3575894097,0
1,1209,42170,3575894097,3575894097,0
1,1209,42171,3575894097,3575894097,0
1,1209,42172,3575894097,3575894097,0
1,1209,42173,3575894097,3575894097,0
1,1209,42174,3575894097,3575894097,0
1,1209,42175,3575894097,3575894097,0
1,1209,42176,3575894097,3575894097,0
1,1209,42177,3575894097,3575894098,1
1,1209,42178,3575894097,3575894098,1
1,1209,42179,3575894097,3575894100,3
1,1209,42180,3575894097,3575894100,3
1,1209,42181,3575894097,3575894100,3
1,1209,42182,3575894097,3575894101,4
1,1209,42183,3575894097,3575894102,5
1,1209,42184,3575894097,3575894102,5
1,1209,42185,3575894097,3575894102,5
1,1209,42186,3575894097,3575894102,5
1,1209,42187,3575894097,3575894103,6
1,1209,42188,3575894097,3575894104,7
1,1209,42189,3575894097,3575894104,7
1,1209,42190,3575894097,3575894105,8
1,1209,42191,3575894097,3575894105,8
1,1209,42192,3575894097,3575894106,9
1,1209,42193,3575894097,3575894106,9
1,1209,42194,3575894097,3575894106,9
1,1209,42195,3575894097,3575894107,10
1,1209,42196,3575894097,3575894107,10
1,1209,42197,3575894097,3575894108,11
1,1209,42198,3575894097,3575894109,12
1,1209,42199,3575894097,3575894110,13
1,1209,42200,3575894097,3575894112,15
1,1209,42201,3575894097,3575894112,15
1,1209,42202,3575894097,3575894113,16
1,1209,42203,3575894097,3575894114,17
1,1209,42204,3575894097,3575894115,18
1,1209,42205,3575894097,3575894115,18
1,1209,42206,3575894097,3575894117,20
1,1209,42207,3575894097,3575894118,21
1,1209,42208,3575894097,3575894119,22
1,1209,42209,3575894097,3575894122,25
1,1209,42210,3575894097,3575894122,25
1,1209,42211,3575894097,3575894123,26
1,1209,42212,3575894097,3575894123,26
1,1209,42213,3575894097,3575894123,26
1,1209,42214,3575894097,3575894123,26
1,1209,42215,3575894097,3575894125,28
1,1209,42216,3575894097,3575894126,29
1,1209,42217,3575894097,3575894126,29
1,1209,42218,3575894097,3575894127,30
1,1209,42219,3575894097,3575894128,31
1,1209,42220,3575894097,3575894128,31
1,1209,42221,3575894097,3575894128,31
1,1209,42222,3575894097,3575894129,32
1,1209,42223,3575894097,3575894129,32
1,1209,42224,3575894097,3575894129,32
1,1209,42225,3575894097,3575894130,33
1,1209,42226,3575894097,3575894131,34
1,1209,42227,3575894097,3575894131,34
1,1209,42228,3575894097,3575894131,34
1,1209,42229,3575894097,3575894132,35
1,1209,42230,3575894097,3575894133,36
1,1209,42231,3575894097,3575894134,37
1,1209,42232,3575894097,3575894135,38
1,1209,42233,3575894097,3575894135,38
1,1209,42234,3575894097,3575894139,42
1,1209,42235,3575894097,3575894139,42
1,1209,42236,3575894097,3575894139,42
1,1209,42237,3575894097,3575894140,43
1,1209,42238,3575894097,3575894143,46
1,1209,42239,3575894097,3575894144,47
1,1209,42240,3575894097,3575894144,47
1,1209,42241,3575894097,3575894147,50
1,1210,42242,3575894160,3575894160,0
1,1210,42243,3575894160,3575894160,0
1,1210,42244,3575894160,3575894160,0
1,1210,42245,3575894160,3575894160,0
1,1210,42246,3575894160,3575894160,0
1,1210,42247,3575894160,3575894160,0
1,1210,42248,3575894160,3575894160,0
1,1210,42249,3575894160,3575894160,0
1,1210,42250,3575894160,3575894160,0
1,1210,42251,3575894160,3575894160,0
1,1210,42252,3575894160,3575894160,0
1,1210,42253,3575894160,3575894160,0
1,1210,42254,3575894160,3575894160,0
1,1210,42255,3575894160,3575894160,0
1,1210,42256,3575894160,3575894160,0
1,1210,42257,3575894160,3575894160,0
1,1210,42258,3575894160,3575894163,3
1,1210,42259,3575894160,3575894163,3
1,1210,42260,3575894160,3575894163,3
1,1210,42261,3575894160,3575894164,4
1,1210,42262,3575894160,3575894165,5
1,1210,42263,3575894160,3575894165,5
1,1210,42264,3575894160,3575894167,7
1,1210,42265,3575894160,3575894169,9
1,1210,42266,3575894160,3575894172,12
1,1210,42267,3575894160,3575894173,13
1,1210,42268,3575894160,3575894174,14
1,1210,42269,3575894160,3575894174,14
1,1210,42270,3575894160,3575894175,15
1,1210,42271,3575894160,3575894175,15
1,1210,42272,3575894160,3575894177,17
1,1210,42273,3575894160,3575894178,18
1,1210,42274,3575894160,3575894178,18
1,1210,42275,3575894160,3575894180,20
1,1210,42276,3575894160,3575894180,20
1,1210,42277,3575894160,3575894181,21
1,1210,42278,3575894160,3575894181,21
1,1210,42279,3575894160,3575894181,21
1,1210,42280,3575894160,3575894182,22
1,1210,42281,3575894160,3575894183,23
1,1210,42282,3575894160,3575894183,23
1,1210,42283,3575894160,3575894184,24
1,1210,42284,3575894160,3575894185,25
1,1210,42285,3575894160,3575894185,25
1,1210,42286,3575894160,3575894189,29
1,1210,42287,3575894160,3575894189,29
1,1210,42288,3575894160,3575894191,31
1,1210,42289,3575894160,3575894191,31
1,1210,42290,3575894160,3575894191,31
1,1210,42291,3575894160,3575894192,32
1,1210,42292,3575894160,3575894192,32
1,1210,42293,3575894160,3575894192,32
1,1210,42294,3575894160,3575894192,32
1,1210,42295,3575894160,3575894192,32
1,1210,42296,3575894160,3575894193,33
1,1210,42297,3575894160,3575894194,34
1,1210,42298,3575894160,3575894194,34
1,1210,42299,3575894160,3575894196,36
1,1210,42300,3575894160,3575894197,37
1,1210,42301,3575894160,3575894197,37
1,1210,42302,3575894160,3575894197,37
1,1210,42303,3575894160,3575894199,39
1,1210,42304,3575894160,3575894201,41
1,1210,42305,3575894160,3575894202,42
1,1210,42306,3575894160,3575894203,43
1,1210,42307,3575894160,3575894204,44
1,1210,42308,3575894160,3575894204,44
1,1210,42309,3575894160,3575894205,45
1,1210,42310,3575894160,3575894206,46
1,1210,42311,3575894160,3575894206,46
1,1210,42312,3575894160,3575894208,48
1,1210,42313,3575894160,3575894209,49
1,1210,42314,3575894160,3575894209,49
1,1210,42315,3575894160,3575894210,50
1,1211,42316,3575894224,3575894224,0
1,1211,42317,3575894224,3575894224,0
1,1211,42318,3575894224,3575894224,0
1,1211,42319,3575894224,3575894224,0
1,1211,42320,3575894224,3575894224,0
1,1211,42321,3575894224,3575894224,0
1,1211,42322,3575894224,3575894224,0
1,1211,42323,3575894224,3575894224,0
1,1211,42324,3575894224,3575894224,0
1,1211,42325,3575894224,3575894224,0
1,1211,42326,3575894224,3575894224,0
1,1211,42327,3575894224,3575894224,0
1,1211,42328,3575894224,3575894224,0
1,1211,42329,3575894224,3575894224,0
1,1211,42330,3575894224,3575894224,0
1,1211,42331,3575894224,3575894224,0
1,1211,42332,3575894224,3575894224,0
1,1211,42333,3575894224,3575894224,0
1,1211,42334,3575894224,3575894224,0
1,1211,42335,3575894224,3575894224,0
1,1211,42336,3575894224,3575894224,0
1,1211,42337,3575894224,3575894226,2
1,1211,42338,3575894224,3575894227,3
1,1211,42339,3575894224,3575894228,4
1,1211,42340,3575894224,3575894229,5
1,1211,42341,3575894224,3575894230,6
1,1211,42342,3575894224,3575894230,6
1,1211,42343,3575894224,3575894231,7
1,1211,42344,3575894224,3575894231,7
1,1211,42345,3575894224,3575894232,8
1,1211,42346,3575894224,3575894232,8
1,1211,42347,3575894224,3575894233,9
1,1211,42348,3575894224,3575894234,10
1,1211,42349,3575894224,3575894234,10
1,1211,42350,3575894224,3575894235,11
1,1211,42351,3575894224,3575894236,12
1,1211,42352,3575894224,3575894237,13
1,1211,42353,3575894224,3575894237,13
1,1211,42354,3575894224,3575894239,15
1,1211,42355,3575894224,3575894241,17
1,1211,42356,3575894224,3575894241,17
1,1211,42357,3575894224,3575894241,17
1,1211,42358,3575894224,3575894244,20
1,1211,42359,3575894224,3575894245,21
1,1211,42360,3575894224,3575894245,21
1,1211,42361,3575894224,3575894246,22
1,1211,42362,3575894224,3575894247,23
1,1211,42363,3575894224,3575894247,23
1,1211,42364,3575894224,3575894248,24
1,1211,42365,3575894224,3575894248,24
1,1211,42366,3575894224,3575894249,25
1,1211,42367,3575894224,3575894249,25
1,1211,42368,3575894224,3575894249,25
1,1211,42369,3575894224,3575894251,27
1,1211,42370,3575894224,3575894251,27
1,1211,42371,3575894224,3575894252,28
1,1211,42372,3575894224,3575894254,30
1,1211,42373,3575894224,3575894255,31
1,1211,42374,3575894224,3575894255,31
1,1211,42375,3575894224,3575894255,31
1,1211,42376,3575894224,3575894259,35
1,1211,42377,3575894224,3575894259,35
1,1211,42378,3575894224,3575894262,38
1,1211,42379,3575894224,3575894263,39
1,1211,42380,3575894224,3575894264,40
1,1211,42381,3575894224,3575894264,40
1,1211,42382,3575894224,3575894267,43
1,1211,42383,3575894224,3575894268,44
1,1211,42384,3575894224,3575894268,44
1,1212,42385,3575894290,3575894290,0
1,1212,42386,3575894290,3575894290,0
1,1212,42387,3575894290,3575894290,0
1,1212,42388,3575894290,3575894290,0
1,1212,42389,3575894290,3575894290,0
1,1212,42390,3575894290,3575894290,0
1,1212,42391,3575894290,3575894290,0
1,1212,42392,3575894290,3575894290,0
1,1212,42393,3575894290,3575894290,0
1,1212,42394,3575894290,3575894290,0
1,1212,42395,3575894290,3575894290,0
1,1212,42396,3575894290,3575894290,0
1,1212,42397,3575894290,3575894290,0
1,1212,42398,3575894290,3575894292,2
1,1212,42399,3575894290,3575894293,3
1,1212,42400,3575894290,3575894293,3
1,1212,42401,3575894290,3575894294,4
1,1212,42402,3575894290,3575894295,5
1,1212,42403,3575894290,3575894297,7
1,1212,42404,3575894290,3575894297,7
1,1212,42405,3575894290,3575894299,9
1,1212,42406,3575894290,3575894299,9
1,1212,42407,3575894290,3575894300,10
1,1212,42408,3575894290,3575894301,11
1,1212,42409,3575894290,3575894301,11
1,1212,42410,3575894290,3575894302,12
1,1212,42411,3575894290,3575894302,12
1,1212,42412,3575894290,3575894302,12
1,1212,42413,3575894290,3575894302,12
1,1212,42414,3575894290,3575894303,13
1,1212,42415,3575894290,3575894303,13
1,1212,42416,3575894290,3575894304,14
1,1212,42417,3575894290,3575894305,15
1,1212,42418,3575894290,3575894306,16
1,1212,42419,3575894290,3575894306,16
1,1212,42420,3575894290,3575894307,17
1,1212,42421,3575894290,3575894307,17
1,1212,42422,3575894290,3575894307,17
1,1212,42423,3575894290,3575894308,18
1,1212,42424,3575894290,3575894308,18
1,1212,42425,3575894290,3575894309,19
1,1212,42426,3575894290,3575894309,19
1,1212,42427,3575894290,3575894310,20
1,1212,42428,3575894290,3575894311,21
1,1212,42429,3575894290,3575894311,21
1,1212,42430,3575894290,3575894311,21
1,1212,42431,3575894290,3575894312,22
1,1212,42432,3575894290,3575894313,23
1,1212,42433,3575894290,3575894314,24
1,1212,42434,3575894290,3575894315,25
1,1212,42435,3575894290,3575894317,27
1,1212,42436,3575894290,3575894318,28
1,1212,42437,3575894290,3575894319,29
1,1212,42438,3575894290,3575894322,32
1,1212,42439,3575894290,3575894322,32
1,1212,42440,3575894290,3575894322,32
1,1212,42441,3575894290,3575894323,33
1,1212,42442,3575894290,3575894323,33
1,1212,42443,3575894290,3575894323,33
1,1212,42444,3575894290,3575894325,35
1,1212,42445,3575894290,3575894326,36
1,1212,42446,3575894290,3575894326,36
1,1212,42447,3575894290,3575894328,38
1,1212,42448,3575894290,3575894328,38
1,1212,42449,3575894290,3575894329,39
1,1212,42450,3575894290,3575894329,39
1,1212,42451,3575894290,3575894329,39
1,1212,42452,3575894290,3575894329,39
1,1212,42453,3575894290,3575894331,41
1,1212,42454,3575894290,3575894331,41
1,1212,42455,3575894290,3575894331,41
1,1212,42456,3575894290,3575894331,41
1,1212,42457,3575894290,3575894333,43
1,1212,42458,3575894290,3575894333,43
1,1212,42459,3575894290,3575894334,44
1,1212,42460,3575894290,3575894335,45
1,1212,42461,3575894290,3575894339,49
1,1212,42462,3575894290,3575894339,49
1,1212,42463,3575894290,3575894339,49
1,1212,42464,3575894290,3575894340,50
1,1213,42465,3575894353,3575894353,0
1,1213,42466,3575894353,3575894353,0
1,1213,42467,3575894353,3575894353,0
1,1213,42468,3575894353,3575894353,0
1,1213,42469,3575894353,3575894353,0
1,1213,42470,3575894353,3575894353,0
1,1213,42471,3575894353,3575894353,0
1,1213,42472,3575894353,3575894353,0
1,1213,42473,3575894353,3575894353,0
1,1213,42474,3575894353,3575894353,0
1,1213,42475,3575894353,3575894353,0
1,1213,42476,3575894353,3575894353,0
1,1213,42477,3575894353,3575894354,1
1,1213,42478,3575894353,3575894354,1
1,1213,42479,3575894353,3575894355,2
1,1213,42480,3575894353,3575894355,2
1,1213,42481,3575894353,3575894357,4
1,1213,42482,3575894353,3575894358,5
1,1213,42483,3575894353,3575894358,5
1,1213,42484,3575894353,3575894360,7
1,1213,42485,3575894353,3575894361,8
1,1213,42486,3575894353,3575894361,8
1,1213,42487,3575894353,3575894363,10
1,1213,42488,3575894353,3575894363,10
1,1213,42489,3575894353,3575894363,10
1,1213,42490,3575894353,3575894364,11
1,1213,42491,3575894353,3575894366,13
1,1213,42492,3575894353,3575894367,14
1,1213,42493,3575894353,3575894370,17
1,1213,42494,3575894353,3575894372,19
1,1213,42495,3575894353,3575894373,20
1,1213,42496,3575894353,3575894374,21
1,1213,42497,3575894353,3575894374,21
1,1213,42498,3575894353,3575894375,22
1,1213,42499,3575894353,3575894375,22
1,1213,42500,3575894353,3575894378,25
1,1213,42501,3575894353,3575894379,26
1,1213,42502,3575894353,3575894379,26
1,1213,42503,3575894353,3575894379,26
1,1213,42504,3575894353,3575894380,27
1,1213,42505,3575894353,3575894381,28
1,1213,42506,3575894353,3575894382,29
1,1213,42507,3575894353,3575894382,29
1,1213,42508,3575894353,3575894382,29
1,1213,42509,3575894353,3575894383,30
1,1213,42510,3575894353,3575894384,31
1,1213,42511,3575894353,3575894384,31
1,1213,42512,3575894353,3575894385,32
1,1213,42513,3575894353,3575894385,32
1,1213,42514,3575894353,3575894385,32
1,1213,42515,3575894353,3575894389,36
1,1213,42516,3575894353,3575894389,36
1,1213,42517,3575894353,3575894391,38
1,1213,42518,3575894353,3575894391,38
1,1213,42519,3575894353,3575894391,38
1,1213,42520,3575894353,3575894392,39
1,1213,42521,3575894353,3575894392,39
1,1213,42522,3575894353,3575894392,39
1,1213,42523,3575894353,3575894392,39
1,1213,42524,3575894353,3575894392,39
1,1213,42525,3575894353,3575894393,40
1,1213,42526,3575894353,3575894394,41
1,1213,42527,3575894353,3575894396,43
1,1213,42528,3575894353,3575894397,44
1,1213,42529,3575894353,3575894397,44
1,1213,42530,3575894353,3575894398,45
1,1213,42531,3575894353,3575894399,46
1,1213,42532,3575894353,3575894399,46
1,1213,42533,3575894353,3575894400,47
1,1213,42534,3575894353,3575894401,48
1,1213,42535,3575894353,3575894402,49
1,1214,42536,3575894418,3575894418,0
1,1214,42537,3575894418,3575894418,0
1,1214,42538,3575894418,3575894418,0
1,1214,42539,3575894418,3575894418,0
1,1214,42540,3575894418,3575894418,0
1,1214,42541,3575894418,3575894418,0
1,1214,42542,3575894418,3575894418,0
1,1214,42543,3575894418,3575894418,0
1,1214,42544,3575894418,3575894418,0
1,1214,42545,3575894418,3575894418,0
1,1214,42546,3575894418,3575894418,0
1,1214,42547,3575894418,3575894418,0
1,1214,42548,3575894418,3575894418,0
1,1214,42549,3575894418,3575894418,0
1,1214,42550,3575894418,3575894418,0
1,1214,42551,3575894418,3575894418,0
1,1214,42552,3575894418,3575894418,0
1,1214,42553,3575894418,3575894418,0
1,1214,42554,3575894418,3575894418,0
1,1214,42555,3575894418,3575894418,0
1,1214,42556,3575894418,3575894418,0
1,1214,42557,3575894418,3575894418,0
1,1214,42558,3575894418,3575894418,0
1,1214,42559,3575894418,3575894421,3
1,1214,42560,3575894418,3575894421,3
1,1214,42561,3575894418,3575894421,3
1,1214,42562,3575894418,3575894422,4
1,1214,42563,3575894418,3575894423,5
1,1214,42564,3575894418,3575894423,5
1,1214,42565,3575894418,3575894423,5
1,1214,42566,3575894418,3575894424,6
1,1214,42567,3575894418,3575894425,7
1,1214,42568,3575894418,3575894427,9
1,1214,42569,3575894418,3575894427,9
1,1214,42570,3575894418,3575894427,9
1,1214,42571,3575894418,3575894430,12
1,1214,42572,3575894418,3575894430,12
1,1214,42573,3575894418,3575894430,12
1,1214,42574,3575894418,3575894432,14
1,1214,42575,3575894418,3575894433,15
1,1214,42576,3575894418,3575894433,15
1,1214,42577,3575894418,3575894434,16
1,1214,42578,3575894418,3575894435,17
1,1214,42579,3575894418,3575894436,18
1,1214,42580,3575894418,3575894437,19
1,1214,42581,3575894418,3575894437,19
1,1214,42582,3575894418,3575894437,19
1,1214,42583,3575894418,3575894440,22
1,1214,42584,3575894418,3575894440,22
1,1214,42585,3575894418,3575894441,23
1,1214,42586,3575894418,3575894442,24
1,1214,42587,3575894418,3575894444,26
1,1214,42588,3575894418,3575894445,27
1,1214,42589,3575894418,3575894445,27
1,1214,42590,3575894418,3575894445,27
1,1214,42591,3575894418,3575894446,28
1,1214,42592,3575894418,3575894448,30
1,1214,42593,3575894418,3575894448,30
1,1214,42594,3575894418,3575894449,31
1,1214,42595,3575894418,3575894450,32
1,1214,42596,3575894418,3575894450,32
1,1214,42597,3575894418,3575894451,33
1,1214,42598,3575894418,3575894453,35
1,1214,42599,3575894418,3575894453,35
1,1214,42600,3575894418,3575894454,36
1,1214,42601,3575894418,3575894455,37
1,1214,42602,3575894418,3575894455,37
1,1214,42603,3575894418,3575894456,38
1,1214,42604,3575894418,3575894456,38
1,1214,42605,3575894418,3575894459,41
1,1214,42606,3575894418,3575894459,41
1,1214,42607,3575894418,3575894460,42
1,1214,42608,3575894418,3575894463,45
1,1214,42609,3575894418,3575894464,46
1,1214,42610,3575894418,3575894464,46
1,1214,42611,3575894418,3575894467,49
1,1215,42612,3575894480,3575894481,1
1,1215,42613,3575894480,3575894481,1
1,1215,42614,3575894480,3575894481,1
1,1215,42615,3575894480,3575894481,1
1,1215,42616,3575894480,3575894481,1
1,1215,42617,3575894480,3575894481,1
1,1215,42618,3575894480,3575894481,1
1,1215,42619,3575894480,3575894483,3
1,1215,42620,3575894480,3575894484,4
1,1215,42621,3575894480,3575894484,4
1,1215,42622,3575894480,3575894484,4
1,1215,42623,3575894480,3575894485,5
1,1215,42624,3575894480,3575894485,5
1,1215,42625,3575894480,3575894485,5
1,1215,42626,3575894480,3575894488,8
1,1215,42627,3575894480,3575894491,11
1,1215,42628,3575894480,3575894492,12
1,1215,42629,3575894480,3575894492,12
1,1215,42630,3575894480,3575894494,14
1,1215,42631,3575894480,3575894494,14
1,1215,42632,3575894480,3575894494,14
1,1215,42633,3575894480,3575894495,15
1,1215,42634,3575894480,3575894495,15
1,1215,42635,3575894480,3575894495,15
1,1215,42636,3575894480,3575894497,17
1,1215,42637,3575894480,3575894497,17
1,1215,42638,3575894480,3575894498,18
1,1215,42639,3575894480,3575894499,19
1,1215,42640,3575894480,3575894499,19
1,1215,42641,3575894480,3575894500,20
1,1215,42642,3575894480,3575894500,20
1,1215,42643,3575894480,3575894501,21
1,1215,42644,3575894480,3575894501,21
1,1215,42645,3575894480,3575894502,22
1,1215,42646,3575894480,3575894503,23
1,1215,42647,3575894480,3575894504,24
1,1215,42648,3575894480,3575894504,24
1,1215,42649,3575894480,3575894505,25
1,1215,42650,3575894480,3575894505,25
1,1215,42651,3575894480,3575894505,25
1,1215,42652,3575894480,3575894505,25
1,1215,42653,3575894480,3575894506,26
1,1215,42654,3575894480,3575894506,26
1,1215,42655,3575894480,3575894507,27
1,1215,42656,3575894480,3575894507,27
1,1215,42657,3575894480,3575894509,29
1,1215,42658,3575894480,3575894509,29
1,1215,42659,3575894480,3575894510,30
1,1215,42660,3575894480,3575894510,30
1,1215,42661,3575894480,3575894511,31
1,1215,42662,3575894480,3575894512,32
1,1215,42663,3575894480,3575894513,33
1,1215,42664,3575894480,3575894513,33
1,1215,42665,3575894480,3575894514,34
1,1215,42666,3575894480,3575894515,35
1,1215,42667,3575894480,3575894515,35
1,1215,42668,3575894480,3575894516,36
1,1215,42669,3575894480,3575894517,37
1,1215,42670,3575894480,3575894517,37
1,1215,42671,3575894480,3575894519,39
1,1215,42672,3575894480,3575894520,40
1,1215,42673,3575894480,3575894522,42
1,1215,42674,3575894480,3575894523,43
1,1215,42675,3575894480,3575894523,43
1,1215,42676,3575894480,3575894523,43
1,1215,42677,3575894480,3575894523,43
1,1215,42678,3575894480,3575894525,45
1,1215,42679,3575894480,3575894525,45
1,1215,42680,3575894480,3575894526,46
1,1215,42681,3575894480,3575894527,47
1,1215,42682,3575894480,3575894527,47
1,1215,42683,3575894480,3575894528,48
1,1215,42684,3575894480,3575894528,48
1,1215,42685,3575894480,3575894528,48
1,1215,42686,3575894480,3575894528,48
1,1215,42687,3575894480,3575894530,50
1,1216,42688,3575894550,3575894550,0
1,1216,42689,3575894550,3575894550,0
1,1216,42690,3575894550,3575894550,0
1,1216,42691,3575894550,3575894550,0
1,1216,42692,3575894550,3575894550,0
1,1216,42693,3575894550,3575894550,0
1,1216,42694,3575894550,3575894550,0
1,1216,42695,3575894550,3575894550,0
1,1216,42696,3575894550,3575894550,0
1,1216,42697,3575894550,3575894550,0
1,1216,42698,3575894550,3575894550,0
1,1216,42699,3575894550,3575894550,0
1,1216,42700,3575894550,3575894550,0
1,1216,42701,3575894550,3575894550,0
1,1216,42702,3575894550,3575894550,0
1,1216,42703,3575894550,3575894550,0
1,1216,42704,3575894550,3575894550,0
1,1216,42705,3575894550,3575894550,0
1,1216,42706,3575894550,3575894550,0
1,1216,42707,3575894550,3575894550,0
1,1216,42708,3575894550,3575894550,0
1,1216,42709,3575894550,3575894550,0
1,1216,42710,3575894550,3575894550,0
1,1216,42711,3575894550,3575894550,0
1,1216,42712,3575894550,3575894552,2
1,1216,42713,3575894550,3575894552,2
1,1216,42714,3575894550,3575894552,2
1,1216,42715,3575894550,3575894553,3
1,1216,42716,3575894550,3575894554,4
1,1216,42717,3575894550,3575894555,5
1,1216,42718,3575894550,3575894556,6
1,1216,42719,3575894550,3575894557,7
1,1216,42720,3575894550,3575894557,7
1,1216,42721,3575894550,3575894559,9
1,1216,42722,3575894550,3575894559,9
1,1216,42723,3575894550,3575894560,10
1,1216,42724,3575894550,3575894562,12
1,1216,42725,3575894550,3575894562,12
1,1216,42726,3575894550,3575894563,13
1,1216,42727,3575894550,3575894565,15
1,1216,42728,3575894550,3575894565,15
1,1216,42729,3575894550,3575894567,17
1,1216,42730,3575894550,3575894570,20
1,1216,42731,3575894550,3575894572,22
1,1216,42732,3575894550,3575894572,22
1,1216,42733,3575894550,3575894573,23
1,1216,42734,3575894550,3575894574,24
1,1216,42735,3575894550,3575894574,24
1,1216,42736,3575894550,3575894574,24
1,1216,42737,3575894550,3575894575,25
1,1216,42738,3575894550,3575894578,28
1,1216,42739,3575894550,3575894578,28
1,1216,42740,3575894550,3575894578,28
1,1216,42741,3575894550,3575894578,28
1,1216,42742,3575894550,3575894580,30
1,1216,42743,3575894550,3575894580,30
1,1216,42744,3575894550,3575894581,31
1,1216,42745,3575894550,3575894582,32
1,1216,42746,3575894550,3575894582,32
1,1216,42747,3575894550,3575894582,32
1,1216,42748,3575894550,3575894584,34
1,1216,42749,3575894550,3575894584,34
1,1216,42750,3575894550,3575894584,34
1,1216,42751,3575894550,3575894585,35
1,1216,42752,3575894550,3575894588,38
1,1216,42753,3575894550,3575894590,40
1,1216,42754,3575894550,3575894590,40
1,1216,42755,3575894550,3575894591,41
1,1216,42756,3575894550,3575894591,41
1,1216,42757,3575894550,3575894591,41
1,1216,42758,3575894550,3575894591,41
1,1216,42759,3575894550,3575894591,41
1,1216,42760,3575894550,3575894591,41
1,1216,42761,3575894550,3575894592,42
1,1216,42762,3575894550,3575894593,43
1,1216,42763,3575894550,3575894595,45
1,1216,42764,3575894550,3575894596,46
1,1216,42765,3575894550,3575894597,47
1,1216,42766,3575894550,3575894597,47
1,1216,42767,3575894550,3575894598,48
1,1216,42768,3575894550,3575894599,49
1,1216,42769,3575894550,3575894599,49
1,1217,42770,3575894613,3575894613,0
1,1217,42771,3575894613,3575894613,0
1,1217,42772,3575894613,3575894613,0
1,1217,42773,3575894613,3575894613,0
1,1217,42774,3575894613,3575894613,0
1,1217,42775,3575894613,3575894613,0
1,1217,42776,3575894613,3575894613,0
1,1217,42777,3575894613,3575894613,0
1,1217,42778,3575894613,3575894613,0
1,1217,42779,3575894613,3575894613,0
1,1217,42780,3575894613,3575894613,0
1,1217,42781,3575894613,3575894613,0
1,1217,42782,3575894613,3575894613,0
1,1217,42783,3575894613,3575894613,0
1,1217,42784,3575894613,3575894613,0
1,1217,42785,3575894613,3575894613,0
1,1217,42786,3575894613,3575894613,0
1,1217,42787,3575894613,3575894613,0
1,1217,42788,3575894613,3575894613,0
1,1217,42789,3575894613,3575894613,0
1,1217,42790,3575894613,3575894614,1
1,1217,42791,3575894613,3575894616,3
1,1217,42792,3575894613,3575894617,4
1,1217,42793,3575894613,3575894617,4
1,1217,42794,3575894613,3575894618,5
1,1217,42795,3575894613,3575894620,7
1,1217,42796,3575894613,3575894620,7
1,1217,42797,3575894613,3575894621,8
1,1217,42798,3575894613,3575894621,8
1,1217,42799,3575894613,3575894622,9
1,1217,42800,3575894613,3575894622,9
1,1217,42801,3575894613,3575894622,9
1,1217,42802,3575894613,3575894622,9
1,1217,42803,3575894613,3575894626,13
1,1217,42804,3575894613,3575894626,13
1,1217,42805,3575894613,3575894626,13
1,1217,42806,3575894613,3575894627,14
1,1217,42807,3575894613,3575894628,15
1,1217,42808,3575894613,3575894629,16
1,1217,42809,3575894613,3575894629,16
1,1217,42810,3575894613,3575894630,17
1,1217,42811,3575894613,3575894630,17
1,1217,42812,3575894613,3575894631,18
1,1217,42813,3575894613,3575894632,19
1,1217,42814,3575894613,3575894632,19
1,1217,42815,3575894613,3575894633,20
1,1217,42816,3575894613,3575894634,21
1,1217,42817,3575894613,3575894636,23
1,1217,42818,3575894613,3575894636,23
1,1217,42819,3575894613,3575894636,23
1,1217,42820,3575894613,3575894638,25
1,1217,42821,3575894613,3575894639,26
1,1217,42822,3575894613,3575894639,26
1,1217,42823,3575894613,3575894641,28
1,1217,42824,3575894613,3575894641,28
1,1217,42825,3575894613,3575894643,30
1,1217,42826,3575894613,3575894644,31
1,1217,42827,3575894613,3575894644,31
1,1217,42828,3575894613,3575894645,32
1,1217,42829,3575894613,3575894645,32
1,1217,42830,3575894613,3575894646,33
1,1217,42831,3575894613,3575894646,33
1,1217,42832,3575894613,3575894647,34
1,1217,42833,3575894613,3575894648,35
1,1217,42834,3575894613,3575894648,35
1,1217,42835,3575894613,3575894648,35
1,1217,42836,3575894613,3575894649,36
1,1217,42837,3575894613,3575894649,36
1,1217,42838,3575894613,3575894650,37
1,1217,42839,3575894613,3575894650,37
1,1217,42840,3575894613,3575894651,38
1,1217,42841,3575894613,3575894652,39
1,1217,42842,3575894613,3575894652,39
1,1217,42843,3575894613,3575894654,41
1,1217,42844,3575894613,3575894655,42
1,1217,42845,3575894613,3575894655,42
1,1217,42846,3575894613,3575894656,43
1,1217,42847,3575894613,3575894658,45
1,1217,42848,3575894613,3575894658,45
1,1217,42849,3575894613,3575894659,46
1,1217,42850,3575894613,3575894662,49
1,1217,42851,3575894613,3575894663,50
1,1218,42852,3575894678,3575894678,0
1,1218,42853,3575894678,3575894678,0
1,1218,42854,3575894678,3575894678,0
1,1218,42855,3575894678,3575894678,0
1,1218,42856,3575894678,3575894678,0
1,1218,42857,3575894678,3575894678,0
1,1218,42858,3575894678,3575894678,0
1,1218,42859,3575894678,3575894679,1
1,1218,42860,3575894678,3575894680,2
1,1218,42861,3575894678,3575894681,3
1,1218,42862,3575894678,3575894684,6
1,1218,42863,3575894678,3575894684,6
1,1218,42864,3575894678,3575894684,6
1,1218,42865,3575894678,3575894685,7
1,1218,42866,3575894678,3575894685,7
1,1218,42867,3575894678,3575894685,7
1,1218,42868,3575894678,3575894688,10
1,1218,42869,3575894678,3575894689,11
1,1218,42870,3575894678,3575894691,13
1,1218,42871,3575894678,3575894692,14
1,1218,42872,3575894678,3575894692,14
1,1218,42873,3575894678,3575894693,15
1,1218,42874,3575894678,3575894694,16
1,1218,42875,3575894678,3575894694,16
1,1218,42876,3575894678,3575894694,16
1,1218,42877,3575894678,3575894695,17
1,1218,42878,3575894678,3575894696,18
1,1218,42879,3575894678,3575894697,19
1,1218,42880,3575894678,3575894697,19
1,1218,42881,3575894678,3575894699,21
1,1218,42882,3575894678,3575894700,22
1,1218,42883,3575894678,3575894700,22
1,1218,42884,3575894678,3575894700,22
1,1218,42885,3575894678,3575894701,23
1,1218,42886,3575894678,3575894701,23
1,1218,42887,3575894678,3575894702,24
1,1218,42888,3575894678,3575894702,24
1,1218,42889,3575894678,3575894703,25
1,1218,42890,3575894678,3575894705,27
1,1218,42891,3575894678,3575894705,27
1,1218,42892,3575894678,3575894705,27
1,1218,42893,3575894678,3575894706,28
1,1218,42894,3575894678,3575894708,30
1,1218,42895,3575894678,3575894708,30
1,1218,42896,3575894678,3575894708,30
1,1218,42897,3575894678,3575894710,32
1,1218,42898,3575894678,3575894710,32
1,1218,42899,3575894678,3575894710,32
1,1218,42900,3575894678,3575894710,32
1,1218,42901,3575894678,3575894711,33
1,1218,42902,3575894678,3575894713,35
1,1218,42903,3575894678,3575894713,35
1,1218,42904,3575894678,3575894715,37
1,1218,42905,3575894678,3575894715,37
1,1218,42906,3575894678,3575894716,38
1,1218,42907,3575894678,3575894717,39
1,1218,42908,3575894678,3575894719,41
1,1218,42909,3575894678,3575894720,42
1,1218,42910,3575894678,3575894721,43
1,1218,42911,3575894678,3575894723,45
1,1218,42912,3575894678,3575894723,45
1,1218,42913,3575894678,3575894723,45
1,1218,42914,3575894678,3575894723,45
1,1218,42915,3575894678,3575894724,46
1,1218,42916,3575894678,3575894725,47
1,1218,42917,3575894678,3575894726,48
1,1218,42918,3575894678,3575894726,48
1,1218,42919,3575894678,3575894727,49
1,1218,42920,3575894678,3575894727,49
1,1218,42921,3575894678,3575894728,50
1,1219,42922,3575894745,3575894745,0
1,1219,42923,3575894745,3575894745,0
1,1219,42924,3575894745,3575894745,0
1,1219,42925,3575894745,3575894745,0
1,1219,42926,3575894745,3575894745,0
1,1219,42927,3575894745,3575894745,0
1,1219,42928,3575894745,3575894745,0
1,1219,42929,3575894745,3575894745,0
1,1219,42930,3575894745,3575894745,0
1,1219,42931,3575894745,3575894745,0
1,1219,42932,3575894745,3575894745,0
1,1219,42933,3575894745,3575894745,0
1,1219,42934,3575894745,3575894745,0
1,1219,42935,3575894745,3575894745,0
1,1219,42936,3575894745,3575894745,0
1,1219,42937,3575894745,3575894745,0
1,1219,42938,3575894745,3575894745,0
1,1219,42939,3575894745,3575894745,0
1,1219,42940,3575894745,3575894745,0
1,1219,42941,3575894745,3575894745,0
1,1219,42942,3575894745,3575894746,1
1,1219,42943,3575894745,3575894747,2
1,1219,42944,3575894745,3575894748,3
1,1219,42945,3575894745,3575894748,3
1,1219,42946,3575894745,3575894749,4
1,1219,42947,3575894745,3575894749,4
1,1219,42948,3575894745,3575894751,6
1,1219,42949,3575894745,3575894751,6
1,1219,42950,3575894745,3575894752,7
1,1219,42951,3575894745,3575894752,7
1,1219,42952,3575894745,3575894754,9
1,1219,42953,3575894745,3575894755,10
1,1219,42954,3575894745,3575894755,10
1,1219,42955,3575894745,3575894756,11
1,1219,42956,3575894745,3575894757,12
1,1219,42957,3575894745,3575894758,13
1,1219,42958,3575894745,3575894759,14
1,1219,42959,3575894745,3575894761,16
1,1219,42960,3575894745,3575894763,18
1,1219,42961,3575894745,3575894764,19
1,1219,42962,3575894745,3575894765,20
1,1219,42963,3575894745,3575894767,22
1,1219,42964,3575894745,3575894769,24
1,1219,42965,3575894745,3575894772,27
1,1219,42966,3575894745,3575894772,27
1,1219,42967,3575894745,3575894773,28
1,1219,42968,3575894745,3575894773,28
1,1219,42969,3575894745,3575894774,29
1,1219,42970,3575894745,3575894775,30
1,1219,42971,3575894745,3575894776,31
1,1219,42972,3575894745,3575894778,33
1,1219,42973,3575894745,3575894778,33
1,1219,42974,3575894745,3575894779,34
1,1219,42975,3575894745,3575894779,34
1,1219,42976,3575894745,3575894780,35
1,1219,42977,3575894745,3575894780,35
1,1219,42978,3575894745,3575894781,36
1,1219,42979,3575894745,3575894781,36
1,1219,42980,3575894745,3575894783,38
1,1219,42981,3575894745,3575894783,38
1,1219,42982,3575894745,3575894783,38
1,1219,42983,3575894745,3575894784,39
1,1219,42984,3575894745,3575894784,39
1,1219,42985,3575894745,3575894785,40
1,1219,42986,3575894745,3575894786,41
1,1219,42987,3575894745,3575894790,45
1,1219,42988,3575894745,3575894791,46
1,1219,42989,3575894745,3575894791,46
1,1219,42990,3575894745,3575894791,46
1,1219,42991,3575894745,3575894792,47
1,1219,42992,3575894745,3575894792,47
1,1219,42993,3575894745,3575894792,47
1,1219,42994,3575894745,3575894793,48
1,1219,42995,3575894745,3575894793,48
1,1219,42996,3575894745,3575894794,49
1,1219,42997,3575894745,3575894795,50
1,1220,42998,3575894809,3575894809,0
1,1220,42999,3575894809,3575894809,0
1,1220,43000,3575894809,3575894809,0
1,1220,43001,3575894809,3575894809,0
1,1220,43002,3575894809,3575894809,0
1,1220,43003,3575894809,3575894809,0
1,1220,43004,3575894809,3575894809,0
1,1220,43005,3575894809,3575894809,0
1,1220,43006,3575894809,3575894809,0
1,1220,43007,3575894809,3575894809,0
1,1220,43008,3575894809,3575894809,0
1,1220,43009,3575894809,3575894809,0
1,1220,43010,3575894809,3575894809,0
1,1220,43011,3575894809,3575894809,0
1,1220,43012,3575894809,3575894809,0
1,1220,43013,3575894809,3575894809,0
1,1220,43014,3575894809,3575894809,0
1,1220,43015,3575894809,3575894810,1
1,1220,43016,3575894809,3575894811,2
1,1220,43017,3575894809,3575894811,2
1,1220,43018,3575894809,3575894812,3
1,1220,43019,3575894809,3575894812,3
1,1220,43020,3575894809,3575894812,3
1,1220,43021,3575894809,3575894812,3
1,1220,43022,3575894809,3575894813,4
1,1220,43023,3575894809,3575894814,5
1,1220,43024,3575894809,3575894814,5
1,1220,43025,3575894809,3575894814,5
1,1220,43026,3575894809,3575894816,7
1,1220,43027,3575894809,3575894816,7
1,1220,43028,3575894809,3575894816,7
1,1220,43029,3575894809,3575894818,9
1,1220,43030,3575894809,3575894818,9
1,1220,43031,3575894809,3575894818,9
1,1220,43032,3575894809,3575894820,11
1,1220,43033,3575894809,3575894820,11
1,1220,43034,3575894809,3575894821,12
1,1220,43035,3575894809,3575894821,12
1,1220,43036,3575894809,3575894821,12
1,1220,43037,3575894809,3575894822,13
1,1220,43038,3575894809,3575894822,13
1,1220,43039,3575894809,3575894823,14
1,1220,43040,3575894809,3575894823,14
1,1220,43041,3575894809,3575894825,16
1,1220,43042,3575894809,3575894827,18
1,1220,43043,3575894809,3575894827,18
1,1220,43044,3575894809,3575894827,18
1,1220,43045,3575894809,3575894828,19
1,1220,43046,3575894809,3575894829,20
1,1220,43047,3575894809,3575894829,20
1,1220,43048,3575894809,3575894830,21
1,1220,43049,3575894809,3575894830,21
1,1220,43050,3575894809,3575894832,23
1,1220,43051,3575894809,3575894832,23
1,1220,43052,3575894809,3575894832,23
1,1220,43053,3575894809,3575894834,25
1,1220,43054,3575894809,3575894836,27
1,1220,43055,3575894809,3575894837,28
1,1220,43056,3575894809,3575894837,28
1,1220,43057,3575894809,3575894838,29
1,1220,43058,3575894809,3575894839,30
1,1220,43059,3575894809,3575894839,30
1,1220,43060,3575894809,3575894840,31
1,1220,43061,3575894809,3575894844,35
1,1220,43062,3575894809,3575894844,35
1,1220,43063,3575894809,3575894844,35
1,1220,43064,3575894809,3575894844,35
1,1220,43065,3575894809,3575894845,36
1,1220,43066,3575894809,3575894846,37
1,1220,43067,3575894809,3575894847,38
1,1220,43068,3575894809,3575894847,38
1,1220,43069,3575894809,3575894848,39
1,1220,43070,3575894809,3575894849,40
1,1220,43071,3575894809,3575894849,40
1,1220,43072,3575894809,3575894849,40
1,1220,43073,3575894809,3575894850,41
1,1220,43074,3575894809,3575894851,42
1,1220,43075,3575894809,3575894853,44
1,1220,43076,3575894809,3575894855,46
1,1220,43077,3575894809,3575894855,46
1,1220,43078,3575894809,3575894855,46
1,1220,43079,3575894809,3575894856,47
1,1220,43080,3575894809,3575894858,49
1,1221,43081,3575894874,3575894874,0
1,1221,43082,3575894874,3575894874,0
1,1221,43083,3575894874,3575894874,0
1,1221,43084,3575894874,3575894874,0
1,1221,43085,3575894874,3575894874,0
1,1221,43086,3575894874,3575894874,0
1,1221,43087,3575894874,3575894874,0
1,1221,43088,3575894874,3575894874,0
1,1221,43089,3575894874,3575894874,0
1,1221,43090,3575894874,3575894874,0
1,1221,43091,3575894874,3575894874,0
1,1221,43092,3575894874,3575894879,5
1,1221,43093,3575894874,3575894880,6
1,1221,43094,3575894874,3575894883,9
1,1221,43095,3575894874,3575894884,10
1,1221,43096,3575894874,3575894885,11
1,1221,43097,3575894874,3575894885,11
1,1221,43098,3575894874,3575894885,11
1,1221,43099,3575894874,3575894885,11
1,1221,43100,3575894874,3575894888,14
1,1221,43101,3575894874,3575894893,19
1,1221,43102,3575894874,3575894893,19
1,1221,43103,3575894874,3575894893,19
1,1221,43104,3575894874,3575894893,19
1,1221,43105,3575894874,3575894894,20
1,1221,43106,3575894874,3575894895,21
1,1221,43107,3575894874,3575894895,21
1,1221,43108,3575894874,3575894896,22
1,1221,43109,3575894874,3575894896,22
1,1221,43110,3575894874,3575894897,23
1,1221,43111,3575894874,3575894897,23
1,1221,43112,3575894874,3575894899,25
1,1221,43113,3575894874,3575894899,25
1,1221,43114,3575894874,3575894900,26
1,1221,43115,3575894874,3575894901,27
1,1221,43116,3575894874,3575894902,28
1,1221,43117,3575894874,3575894902,28
1,1221,43118,3575894874,3575894903,29
1,1221,43119,3575894874,3575894903,29
1,1221,43120,3575894874,3575894903,29
1,1221,43121,3575894874,3575894904,30
1,1221,43122,3575894874,3575894905,31
1,1221,43123,3575894874,3575894905,31
1,1221,43124,3575894874,3575894905,31
1,1221,43125,3575894874,3575894905,31
1,1221,43126,3575894874,3575894905,31
1,1221,43127,3575894874,3575894906,32
1,1221,43128,3575894874,3575894907,33
1,1221,43129,3575894874,3575894909,35
1,1221,43130,3575894874,3575894909,35
1,1221,43131,3575894874,3575894910,36
1,1221,43132,3575894874,3575894910,36
1,1221,43133,3575894874,3575894912,38
1,1221,43134,3575894874,3575894912,38
1,1221,43135,3575894874,3575894913,39
1,1221,43136,3575894874,3575894914,40
1,1221,43137,3575894874,3575894914,40
1,1221,43138,3575894874,3575894916,42
1,1221,43139,3575894874,3575894916,42
1,1221,43140,3575894874,3575894917,43
1,1221,43141,3575894874,3575894917,43
1,1221,43142,3575894874,3575894920,46
1,1221,43143,3575894874,3575894921,47
1,1221,43144,3575894874,3575894922,48
1,1221,43145,3575894874,3575894923,49
1,1221,43146,3575894874,3575894923,49
1,1221,43147,3575894874,3575894924,50
1,1222,43148,3575894937,3575894937,0
1,1222,43149,3575894937,3575894937,0
1,1222,43150,3575894937,3575894937,0
1,1222,43151,3575894937,3575894937,0
1,1222,43152,3575894937,3575894937,0
1,1222,43153,3575894937,3575894937,0
1,1222,43154,3575894937,3575894937,0
1,1222,43155,3575894937,3575894937,0
1,1222,43156,3575894937,3575894937,0
1,1222,43157,3575894937,3575894937,0
1,1222,43158,3575894937,3575894937,0
1,1222,43159,3575894937,3575894937,0
1,1222,43160,3575894937,3575894937,0
1,1222,43161,3575894937,3575894937,0
1,1222,43162,3575894937,3575894937,0
1,1222,43163,3575894937,3575894937,0
1,1222,43164,3575894937,3575894937,0
1,1222,43165,3575894937,3575894937,0
1,1222,43166,3575894937,3575894937,0
1,1222,43167,3575894937,3575894938,1
1,1222,43168,3575894937,3575894938,1
1,1222,43169,3575894937,3575894939,2
1,1222,43170,3575894937,3575894939,2
1,1222,43171,3575894937,3575894940,3
1,1222,43172,3575894937,3575894940,3
1,1222,43173,3575894937,3575894943,6
1,1222,43174,3575894937,3575894943,6
1,1222,43175,3575894937,3575894943,6
1,1222,43176,3575894937,3575894946,9
1,1222,43177,3575894937,3575894947,10
1,1222,43178,3575894937,3575894948,11
1,1222,43179,3575894937,3575894948,11
1,1222,43180,3575894937,3575894949,12
1,1222,43181,3575894937,3575894949,12
1,1222,43182,3575894937,3575894951,14
1,1222,43183,3575894937,3575894951,14
1,1222,43184,3575894937,3575894951,14
1,1222,43185,3575894937,3575894953,16
1,1222,43186,3575894937,3575894954,17
1,1222,43187,3575894937,3575894954,17
1,1222,43188,3575894937,3575894955,18
1,1222,43189,3575894937,3575894955,18
1,1222,43190,3575894937,3575894956,19
1,1222,43191,3575894937,3575894957,20
1,1222,43192,3575894937,3575894958,21
1,1222,43193,3575894937,3575894959,22
1,1222,43194,3575894937,3575894960,23
1,1222,43195,3575894937,3575894961,24
1,1222,43196,3575894937,3575894962,25
1,1222,43197,3575894937,3575894963,26
1,1222,43198,3575894937,3575894963,26
1,1222,43199,3575894937,3575894964,27
1,1222,43200,3575894937,3575894965,28
1,1222,43201,3575894937,3575894965,28
1,1222,43202,3575894937,3575894965,28
1,1222,43203,3575894937,3575894967,30
1,1222,43204,3575894937,3575894969,32
1,1222,43205,3575894937,3575894972,35
1,1222,43206,3575894937,3575894972,35
1,1222,43207,3575894937,3575894973,36
1,1222,43208,3575894937,3575894974,37
1,1222,43209,3575894937,3575894974,37
1,1222,43210,3575894937,3575894975,38
1,1222,43211,3575894937,3575894977,40
1,1222,43212,3575894937,3575894977,40
1,1222,43213,3575894937,3575894978,41
1,1222,43214,3575894937,3575894978,41
1,1222,43215,3575894937,3575894979,42
1,1222,43216,3575894937,3575894979,42
1,1222,43217,3575894937,3575894980,43
1,1222,43218,3575894937,3575894981,44
1,1222,43219,3575894937,3575894982,45
1,1222,43220,3575894937,3575894982,45
1,1222,43221,3575894937,3575894983,46
1,1222,43222,3575894937,3575894984,47
1,1222,43223,3575894937,3575894984,47
1,1222,43224,3575894937,3575894984,47
1,1222,43225,3575894937,3575894985,48
1,1222,43226,3575894937,3575894986,49
1,1223,43227,3575895001,3575895001,0
1,1223,43228,3575895001,3575895001,0
1,1223,43229,3575895001,3575895001,0
1,1223,43230,3575895001,3575895001,0
1,1223,43231,3575895001,3575895001,0
1,1223,43232,3575895001,3575895001,0
1,1223,43233,3575895001,3575895001,0
1,1223,43234,3575895001,3575895001,0
1,1223,43235,3575895001,3575895001,0
1,1223,43236,3575895001,3575895001,0
1,1223,43237,3575895001,3575895001,0
1,1223,43238,3575895001,3575895001,0
1,1223,43239,3575895001,3575895001,0
1,1223,43240,3575895001,3575895001,0
1,1223,43241,3575895001,3575895001,0
1,1223,43242,3575895001,3575895001,0
1,1223,43243,3575895001,3575895001,0
1,1223,43244,3575895001,3575895001,0
1,1223,43245,3575895001,3575895002,1
1,1223,43246,3575895001,3575895003,2
1,1223,43247,3575895001,3575895004,3
1,1223,43248,3575895001,3575895005,4
1,1223,43249,3575895001,3575895005,4
1,1223,43250,3575895001,3575895006,5
1,1223,43251,3575895001,3575895007,6
1,1223,43252,3575895001,3575895008,7
1,1223,43253,3575895001,3575895008,7
1,1223,43254,3575895001,3575895009,8
1,1223,43255,3575895001,3575895009,8
1,1223,43256,3575895001,3575895011,10
1,1223,43257,3575895001,3575895011,10
1,1223,43258,3575895001,3575895011,10
1,1223,43259,3575895001,3575895012,11
1,1223,43260,3575895001,3575895012,11
1,1223,43261,3575895001,3575895012,11
1,1223,43262,3575895001,3575895013,12
1,1223,43263,3575895001,3575895014,13
1,1223,43264,3575895001,3575895015,14
1,1223,43265,3575895001,3575895016,15
1,1223,43266,3575895001,3575895016,15
1,1223,43267,3575895001,3575895017,16
1,1223,43268,3575895001,3575895018,17
1,1223,43269,3575895001,3575895018,17
1,1223,43270,3575895001,3575895020,19
1,1223,43271,3575895001,3575895021,20
1,1223,43272,3575895001,3575895021,20
1,1223,43273,3575895001,3575895021,20
1,1223,43274,3575895001,3575895022,21
1,1223,43275,3575895001,3575895022,21
1,1223,43276,3575895001,3575895023,22
1,1223,43277,3575895001,3575895024,23
1,1223,43278,3575895001,3575895026,25
1,1223,43279,3575895001,3575895026,25
1,1223,43280,3575895001,3575895027,26
1,1223,43281,3575895001,3575895028,27
1,1223,43282,3575895001,3575895029,28
1,1223,43283,3575895001,3575895029,28
1,1223,43284,3575895001,3575895030,29
1,1223,43285,3575895001,3575895030,29
1,1223,43286,3575895001,3575895030,29
1,1223,43287,3575895001,3575895032,31
1,1223,43288,3575895001,3575895032,31
1,1223,43289,3575895001,3575895033,32
1,1223,43290,3575895001,3575895033,32
1,1223,43291,3575895001,3575895033,32
1,1223,43292,3575895001,3575895036,35
1,1223,43293,3575895001,3575895036,35
1,1223,43294,3575895001,3575895037,36
1,1223,43295,3575895001,3575895037,36
1,1223,43296,3575895001,3575895039,38
1,1223,43297,3575895001,3575895039,38
1,1223,43298,3575895001,3575895041,40
1,1223,43299,3575895001,3575895042,41
1,1223,43300,3575895001,3575895044,43
1,1223,43301,3575895001,3575895044,43
1,1223,43302,3575895001,3575895044,43
1,1223,43303,3575895001,3575895044,43
1,1223,43304,3575895001,3575895045,44
1,1223,43305,3575895001,3575895047,46
1,1223,43306,3575895001,3575895048,47
1,1223,43307,3575895001,3575895048,47
1,1223,43308,3575895001,3575895048,47
1,1223,43309,3575895001,3575895049,48
1,1223,43310,3575895001,3575895049,48
1,1223,43311,3575895001,3575895050,49
1,1223,43312,3575895001,3575895051,50
1,1224,43313,3575895066,3575895066,0
1,1224,43314,3575895066,3575895066,0
1,1224,43315,3575895066,3575895066,0
1,1224,43316,3575895066,3575895066,0
1,1224,43317,3575895066,3575895066,0
1,1224,43318,3575895066,3575895066,0
1,1224,43319,3575895066,3575895066,0
1,1224,43320,3575895066,3575895066,0
1,1224,43321,3575895066,3575895066,0
1,1224,43322,3575895066,3575895066,0
1,1224,43323,3575895066,3575895066,0
1,1224,43324,3575895066,3575895066,0
1,1224,43325,3575895066,3575895066,0
1,1224,43326,3575895066,3575895067,1
1,1224,43327,3575895066,3575895068,2
1,1224,43328,3575895066,3575895068,2
1,1224,43329,3575895066,3575895069,3
1,1224,43330,3575895066,3575895069,3
1,1224,43331,3575895066,3575895079,13
1,1224,43332,3575895066,3575895081,15
1,1224,43333,3575895066,3575895084,18
1,1224,43334,3575895066,3575895084,18
1,1224,43335,3575895066,3575895084,18
1,1224,43336,3575895066,3575895084,18
1,1224,43337,3575895066,3575895085,19
1,1224,43338,3575895066,3575895089,23
1,1224,43339,3575895066,3575895090,24
1,1224,43340,3575895066,3575895091,25
1,1224,43341,3575895066,3575895092,26
1,1224,43342,3575895066,3575895092,26
1,1224,43343,3575895066,3575895093,27
1,1224,43344,3575895066,3575895094,28
1,1224,43345,3575895066,3575895094,28
1,1224,43346,3575895066,3575895094,28
1,1224,43347,3575895066,3575895096,30
1,1224,43348,3575895066,3575895096,30
1,1224,43349,3575895066,3575895097,31
1,1224,43350,3575895066,3575895098,32
1,1224,43351,3575895066,3575895098,32
1,1224,43352,3575895066,3575895098,32
1,1224,43353,3575895066,3575895100,34
1,1224,43354,3575895066,3575895100,34
1,1224,43355,3575895066,3575895101,35
1,1224,43356,3575895066,3575895101,35
1,1224,43357,3575895066,3575895102,36
1,1224,43358,3575895066,3575895102,36
1,1224,43359,3575895066,3575895103,37
1,1224,43360,3575895066,3575895103,37
1,1224,43361,3575895066,3575895103,37
1,1224,43362,3575895066,3575895105,39
1,1224,43363,3575895066,3575895105,39
1,1224,43364,3575895066,3575895105,39
1,1224,43365,3575895066,3575895105,39
1,1224,43366,3575895066,3575895105,39
1,1224,43367,3575895066,3575895106,40
1,1224,43368,3575895066,3575895106,40
1,1224,43369,3575895066,3575895108,42
1,1224,43370,3575895066,3575895108,42
1,1224,43371,3575895066,3575895108,42
1,1224,43372,3575895066,3575895110,44
1,1224,43373,3575895066,3575895110,44
1,1224,43374,3575895066,3575895111,45
1,1224,43375,3575895066,3575895112,46
1,1224,43376,3575895066,3575895112,46
1,1224,43377,3575895066,3575895114,48
1,1224,43378,3575895066,3575895114,48
1,1224,43379,3575895066,3575895115,49
1,1224,43380,3575895066,3575895115,49
1,1224,43381,3575895066,3575895116,50
1,1225,43382,3575895132,3575895132,0
1,1225,43383,3575895132,3575895132,0
1,1225,43384,3575895132,3575895132,0
1,1225,43385,3575895132,3575895132,0
1,1225,43386,3575895132,3575895132,0
1,1225,43387,3575895132,3575895132,0
1,1225,43388,3575895132,3575895132,0
1,1225,43389,3575895132,3575895132,0
1,1225,43390,3575895132,3575895132,0
1,1225,43391,3575895132,3575895132,0
1,1225,43392,3575895132,3575895132,0
1,1225,43393,3575895132,3575895132,0
1,1225,43394,3575895132,3575895132,0
1,1225,43395,3575895132,3575895132,0
1,1225,43396,3575895132,3575895132,0
1,1225,43397,3575895132,3575895132,0
1,1225,43398,3575895132,3575895132,0
1,1225,43399,3575895132,3575895132,0
1,1225,43400,3575895132,3575895132,0
1,1225,43401,3575895132,3575895132,0
1,1225,43402,3575895132,3575895132,0
1,1225,43403,3575895132,3575895133,1
1,1225,43404,3575895132,3575895133,1
1,1225,43405,3575895132,3575895134,2
1,1225,43406,3575895132,3575895135,3
1,1225,43407,3575895132,3575895135,3
1,1225,43408,3575895132,3575895135,3
1,1225,43409,3575895132,3575895138,6
1,1225,43410,3575895132,3575895138,6
1,1225,43411,3575895132,3575895139,7
1,1225,43412,3575895132,3575895140,8
1,1225,43413,3575895132,3575895140,8
1,1225,43414,3575895132,3575895140,8
1,1225,43415,3575895132,3575895143,11
1,1225,43416,3575895132,3575895144,12
1,1225,43417,3575895132,3575895144,12
1,1225,43418,3575895132,3575895145,13
1,1225,43419,3575895132,3575895148,16
1,1225,43420,3575895132,3575895148,16
1,1225,43421,3575895132,3575895149,17
1,1225,43422,3575895132,3575895149,17
1,1225,43423,3575895132,3575895149,17
1,1225,43424,3575895132,3575895150,18
1,1225,43425,3575895132,3575895151,19
1,1225,43426,3575895132,3575895153,21
1,1225,43427,3575895132,3575895153,21
1,1225,43428,3575895132,3575895154,22
1,1225,43429,3575895132,3575895155,23
1,1225,43430,3575895132,3575895157,25
1,1225,43431,3575895132,3575895159,27
1,1225,43432,3575895132,3575895160,28
1,1225,43433,3575895132,3575895160,28
1,1225,43434,3575895132,3575895162,30
1,1225,43435,3575895132,3575895163,31
1,1225,43436,3575895132,3575895163,31
1,1225,43437,3575895132,3575895164,32
1,1225,43438,3575895132,3575895164,32
1,1225,43439,3575895132,3575895165,33
1,1225,43440,3575895132,3575895165,33
1,1225,43441,3575895132,3575895167,35
1,1225,43442,3575895132,3575895170,38
1,1225,43443,3575895132,3575895172,40
1,1225,43444,3575895132,3575895172,40
1,1225,43445,3575895132,3575895174,42
1,1225,43446,3575895132,3575895174,42
1,1225,43447,3575895132,3575895175,43
1,1225,43448,3575895132,3575895176,44
1,1225,43449,3575895132,3575895177,45
1,1225,43450,3575895132,3575895178,46
1,1225,43451,3575895132,3575895178,46
1,1225,43452,3575895132,3575895178,46
1,1225,43453,3575895132,3575895180,48
1,1225,43454,3575895132,3575895180,48
1,1225,43455,3575895132,3575895180,48
1,1225,43456,3575895132,3575895181,49
1,1225,43457,3575895132,3575895181,49
1,1226,43458,3575895195,3575895195,0
1,1226,43459,3575895195,3575895195,0
1,1226,43460,3575895195,3575895195,0
1,1226,43461,3575895195,3575895195,0
1,1226,43462,3575895195,3575895195,0
1,1226,43463,3575895195,3575895195,0
1,1226,43464,3575895195,3575895195,0
1,1226,43465,3575895195,3575895195,0
1,1226,43466,3575895195,3575895195,0
1,1226,43467,3575895195,3575895195,0
1,1226,43468,3575895195,3575895195,0
1,1226,43469,3575895195,3575895195,0
1,1226,43470,3575895195,3575895195,0
1,1226,43471,3575895195,3575895195,0
1,1226,43472,3575895195,3575895195,0
1,1226,43473,3575895195,3575895195,0
1,1226,43474,3575895195,3575895195,0
1,1226,43475,3575895195,3575895196,1
1,1226,43476,3575895195,3575895197,2
1,1226,43477,3575895195,3575895197,2
1,1226,43478,3575895195,3575895198,3
1,1226,43479,3575895195,3575895199,4
1,1226,43480,3575895195,3575895199,4
1,1226,43481,3575895195,3575895200,5
1,1226,43482,3575895195,3575895202,7
1,1226,43483,3575895195,3575895203,8
1,1226,43484,3575895195,3575895204,9
1,1226,43485,3575895195,3575895205,10
1,1226,43486,3575895195,3575895205,10
1,1226,43487,3575895195,3575895205,10
1,1226,43488,3575895195,3575895207,12
1,1226,43489,3575895195,3575895208,13
1,1226,43490,3575895195,3575895208,13
1,1226,43491,3575895195,3575895208,13
1,1226,43492,3575895195,3575895209,14
1,1226,43493,3575895195,3575895211,16
1,1226,43494,3575895195,3575895212,17
1,1226,43495,3575895195,3575895212,17
1,1226,43496,3575895195,3575895212,17
1,1226,43497,3575895195,3575895212,17
1,1226,43498,3575895195,3575895212,17
1,1226,43499,3575895195,3575895213,18
1,1226,43500,3575895195,3575895213,18
1,1226,43501,3575895195,3575895214,19
1,1226,43502,3575895195,3575895215,20
1,1226,43503,3575895195,3575895215,20
1,1226,43504,3575895195,3575895217,22
1,1226,43505,3575895195,3575895217,22
1,1226,43506,3575895195,3575895217,22
1,1226,43507,3575895195,3575895218,23
1,1226,43508,3575895195,3575895220,25
1,1226,43509,3575895195,3575895221,26
1,1226,43510,3575895195,3575895222,27
1,1226,43511,3575895195,3575895222,27
1,1226,43512,3575895195,3575895224,29
1,1226,43513,3575895195,3575895224,29
1,1226,43514,3575895195,3575895226,31
1,1226,43515,3575895195,3575895226,31
1,1226,43516,3575895195,3575895227,32
1,1226,43517,3575895195,3575895229,34
1,1226,43518,3575895195,3575895229,34
1,1226,43519,3575895195,3575895229,34
1,1226,43520,3575895195,3575895230,35
1,1226,43521,3575895195,3575895230,35
1,1226,43522,3575895195,3575895233,38
1,1226,43523,3575895195,3575895233,38
1,1226,43524,3575895195,3575895234,39
1,1226,43525,3575895195,3575895236,41
1,1226,43526,3575895195,3575895236,41
1,1226,43527,3575895195,3575895237,42
1,1226,43528,3575895195,3575895238,43
1,1226,43529,3575895195,3575895240,45
1,1226,43530,3575895195,3575895240,45
1,1226,43531,3575895195,3575895241,46
1,1226,43532,3575895195,3575895243,48
1,1226,43533,3575895195,3575895244,49
1,1226,43534,3575895195,3575895244,49
1,1226,43535,3575895195,3575895244,49
1,1226,43536,3575895195,3575895244,49
1,1227,43537,3575895258,3575895258,0
1,1227,43538,3575895258,3575895258,0
1,1227,43539,3575895258,3575895258,0
1,1227,43540,3575895258,3575895258,0
1,1227,43541,3575895258,3575895258,0
1,1227,43542,3575895258,3575895258,0
1,1227,43543,3575895258,3575895258,0
1,1227,43544,3575895258,3575895258,0
1,1227,43545,3575895258,3575895258,0
1,1227,43546,3575895258,3575895258,0
1,1227,43547,3575895258,3575895258,0
1,1227,43548,3575895258,3575895258,0
1,1227,43549,3575895258,3575895258,0
1,1227,43550,3575895258,3575895258,0
1,1227,43551,3575895258,3575895259,1
1,1227,43552,3575895258,3575895259,1
1,1227,43553,3575895258,3575895262,4
1,1227,43554,3575895258,3575895263,5
1,1227,43555,3575895258,3575895264,6
1,1227,43556,3575895258,3575895265,7
1,1227,43557,3575895258,3575895266,8
1,1227,43558,3575895258,3575895267,9
1,1227,43559,3575895258,3575895268,10
1,1227,43560,3575895258,3575895269,11
1,1227,43561,3575895258,3575895269,11
1,1227,43562,3575895258,3575895270,12
1,1227,43563,3575895258,3575895280,22
1,1227,43564,3575895258,3575895280,22
1,1227,43565,3575895258,3575895282,24
1,1227,43566,3575895258,3575895284,26
1,1227,43567,3575895258,3575895284,26
1,1227,43568,3575895258,3575895284,26
1,1227,43569,3575895258,3575895284,26
1,1227,43570,3575895258,3575895285,27
1,1227,43571,3575895258,3575895290,32
1,1227,43572,3575895258,3575895291,33
1,1227,43573,3575895258,3575895292,34
1,1227,43574,3575895258,3575895293,35
1,1227,43575,3575895258,3575895294,36
1,1227,43576,3575895258,3575895295,37
1,1227,43577,3575895258,3575895295,37
1,1227,43578,3575895258,3575895296,38
1,1227,43579,3575895258,3575895296,38
1,1227,43580,3575895258,3575895297,39
1,1227,43581,3575895258,3575895297,39
1,1227,43582,3575895258,3575895298,40
1,1227,43583,3575895258,3575895299,41
1,1227,43584,3575895258,3575895300,42
1,1227,43585,3575895258,3575895301,43
1,1227,43586,3575895258,3575895302,44
1,1227,43587,3575895258,3575895302,44
1,1227,43588,3575895258,3575895302,44
1,1227,43589,3575895258,3575895302,44
1,1227,43590,3575895258,3575895303,45
1,1227,43591,3575895258,3575895305,47
1,1227,43592,3575895258,3575895305,47
1,1227,43593,3575895258,3575895305,47
1,1227,43594,3575895258,3575895306,48
1,1227,43595,3575895258,3575895306,48
1,1227,43596,3575895258,3575895307,49
1,1227,43597,3575895258,3575895307,49
1,1227,43598,3575895258,3575895308,50
1,1228,43599,3575895327,3575895327,0
1,1228,43600,3575895327,3575895327,0
1,1228,43601,3575895327,3575895327,0
1,1228,43602,3575895327,3575895327,0
1,1228,43603,3575895327,3575895327,0
1,1228,43604,3575895327,3575895327,0
1,1228,43605,3575895327,3575895327,0
1,1228,43606,3575895327,3575895327,0
1,1228,43607,3575895327,3575895327,0
1,1228,43608,3575895327,3575895327,0
1,1228,43609,3575895327,3575895327,0
1,1228,43610,3575895327,3575895327,0
1,1228,43611,3575895327,3575895327,0
1,1228,43612,3575895327,3575895327,0
1,1228,43613,3575895327,3575895327,0
1,1228,43614,3575895327,3575895327,0
1,1228,43615,3575895327,3575895327,0
1,1228,43616,3575895327,3575895327,0
1,1228,43617,3575895327,3575895327,0
1,1228,43618,3575895327,3575895327,0
1,1228,43619,3575895327,3575895327,0
1,1228,43620,3575895327,3575895327,0
1,1228,43621,3575895327,3575895327,0
1,1228,43622,3575895327,3575895327,0
1,1228,43623,3575895327,3575895327,0
1,1228,43624,3575895327,3575895328,1
1,1228,43625,3575895327,3575895329,2
1,1228,43626,3575895327,3575895329,2
1,1228,43627,3575895327,3575895330,3
1,1228,43628,3575895327,3575895331,4
1,1228,43629,3575895327,3575895331,4
1,1228,43630,3575895327,3575895332,5
1,1228,43631,3575895327,3575895333,6
1,1228,43632,3575895327,3575895334,7
1,1228,43633,3575895327,3575895334,7
1,1228,43634,3575895327,3575895335,8
1,1228,43635,3575895327,3575895335,8
1,1228,43636,3575895327,3575895338,11
1,1228,43637,3575895327,3575895339,12
1,1228,43638,3575895327,3575895340,13
1,1228,43639,3575895327,3575895340,13
1,1228,43640,3575895327,3575895340,13
1,1228,43641,3575895327,3575895344,17
1,1228,43642,3575895327,3575895344,17
1,1228,43643,3575895327,3575895344,17
1,1228,43644,3575895327,3575895348,21
1,1228,43645,3575895327,3575895348,21
1,1228,43646,3575895327,3575895348,21
1,1228,43647,3575895327,3575895349,22
1,1228,43648,3575895327,3575895350,23
1,1228,43649,3575895327,3575895350,23
1,1228,43650,3575895327,3575895351,24
1,1228,43651,3575895327,3575895353,26
1,1228,43652,3575895327,3575895353,26
1,1228,43653,3575895327,3575895354,27
1,1228,43654,3575895327,3575895354,27
1,1228,43655,3575895327,3575895355,28
1,1228,43656,3575895327,3575895357,30
1,1228,43657,3575895327,3575895359,32
1,1228,43658,3575895327,3575895360,33
1,1228,43659,3575895327,3575895360,33
1,1228,43660,3575895327,3575895363,36
1,1228,43661,3575895327,3575895363,36
1,1228,43662,3575895327,3575895363,36
1,1228,43663,3575895327,3575895364,37
1,1228,43664,3575895327,3575895364,37
1,1228,43665,3575895327,3575895365,38
1,1228,43666,3575895327,3575895365,38
1,1228,43667,3575895327,3575895367,40
1,1228,43668,3575895327,3575895370,43
1,1228,43669,3575895327,3575895373,46
1,1228,43670,3575895327,3575895373,46
1,1228,43671,3575895327,3575895374,47
1,1228,43672,3575895327,3575895374,47
1,1228,43673,3575895327,3575895376,49
1,1228,43674,3575895327,3575895377,50
1,1229,43675,3575895390,3575895390,0
1,1229,43676,3575895390,3575895390,0
1,1229,43677,3575895390,3575895390,0
1,1229,43678,3575895390,3575895390,0
1,1229,43679,3575895390,3575895390,0
1,1229,43680,3575895390,3575895390,0
1,1229,43681,3575895390,3575895390,0
1,1229,43682,3575895390,3575895390,0
1,1229,43683,3575895390,3575895390,0
1,1229,43684,3575895390,3575895390,0
1,1229,43685,3575895390,3575895390,0
1,1229,43686,3575895390,3575895390,0
1,1229,43687,3575895390,3575895390,0
1,1229,43688,3575895390,3575895390,0
1,1229,43689,3575895390,3575895390,0
1,1229,43690,3575895390,3575895390,0
1,1229,43691,3575895390,3575895390,0
1,1229,43692,3575895390,3575895390,0
1,1229,43693,3575895390,3575895390,0
1,1229,43694,3575895390,3575895391,1
1,1229,43695,3575895390,3575895391,1
1,1229,43696,3575895390,3575895391,1
1,1229,43697,3575895390,3575895392,2
1,1229,43698,3575895390,3575895392,2
1,1229,43699,3575895390,3575895393,3
1,1229,43700,3575895390,3575895393,3
1,1229,43701,3575895390,3575895393,3
1,1229,43702,3575895390,3575895394,4
1,1229,43703,3575895390,3575895395,5
1,1229,43704,3575895390,3575895396,6
1,1229,43705,3575895390,3575895396,6
1,1229,43706,3575895390,3575895398,8
1,1229,43707,3575895390,3575895398,8
1,1229,43708,3575895390,3575895399,9
1,1229,43709,3575895390,3575895399,9
1,1229,43710,3575895390,3575895399,9
1,1229,43711,3575895390,3575895401,11
1,1229,43712,3575895390,3575895402,12
1,1229,43713,3575895390,3575895403,13
1,1229,43714,3575895390,3575895404,14
1,1229,43715,3575895390,3575895405,15
1,1229,43716,3575895390,3575895405,15
1,1229,43717,3575895390,3575895405,15
1,1229,43718,3575895390,3575895405,15
1,1229,43719,3575895390,3575895406,16
1,1229,43720,3575895390,3575895407,17
1,1229,43721,3575895390,3575895408,18
1,1229,43722,3575895390,3575895408,18
1,1229,43723,3575895390,3575895408,18
1,1229,43724,3575895390,3575895409,19
1,1229,43725,3575895390,3575895411,21
1,1229,43726,3575895390,3575895411,21
1,1229,43727,3575895390,3575895412,22
1,1229,43728,3575895390,3575895412,22
1,1229,43729,3575895390,3575895413,23
1,1229,43730,3575895390,3575895413,23
1,1229,43731,3575895390,3575895413,23
1,1229,43732,3575895390,3575895414,24
1,1229,43733,3575895390,3575895415,25
1,1229,43734,3575895390,3575895416,26
1,1229,43735,3575895390,3575895416,26
1,1229,43736,3575895390,3575895417,27
1,1229,43737,3575895390,3575895418,28
1,1229,43738,3575895390,3575895418,28
1,1229,43739,3575895390,3575895418,28
1,1229,43740,3575895390,3575895419,29
1,1229,43741,3575895390,3575895421,31
1,1229,43742,3575895390,3575895422,32
1,1229,43743,3575895390,3575895422,32
1,1229,43744,3575895390,3575895422,32
1,1229,43745,3575895390,3575895423,33
1,1229,43746,3575895390,3575895424,34
1,1229,43747,3575895390,3575895424,34
1,1229,43748,3575895390,3575895426,36
1,1229,43749,3575895390,3575895428,38
1,1229,43750,3575895390,3575895428,38
1,1229,43751,3575895390,3575895428,38
1,1229,43752,3575895390,3575895429,39
1,1229,43753,3575895390,3575895429,39
1,1229,43754,3575895390,3575895429,39
1,1229,43755,3575895390,3575895430,40
1,1229,43756,3575895390,3575895430,40
1,1229,43757,3575895390,3575895431,41
1,1229,43758,3575895390,3575895432,42
1,1229,43759,3575895390,3575895433,43
1,1229,43760,3575895390,3575895433,43
1,1229,43761,3575895390,3575895435,45
1,1229,43762,3575895390,3575895436,46
1,1229,43763,3575895390,3575895437,47
1,1229,43764,3575895390,3575895438,48
1,1229,43765,3575895390,3575895438,48
1,1229,43766,3575895390,3575895439,49
1,1229,43767,3575895390,3575895439,49
1,1229,43768,3575895390,3575895440,50
1,1230,43769,3575895457,3575895457,0
1,1230,43770,3575895457,3575895457,0
1,1230,43771,3575895457,3575895457,0
1,1230,43772,3575895457,3575895457,0
1,1230,43773,3575895457,3575895457,0
1,1230,43774,3575895457,3575895457,0
1,1230,43775,3575895457,3575895457,0
1,1230,43776,3575895457,3575895457,0
1,1230,43777,3575895457,3575895457,0
1,1230,43778,3575895457,3575895457,0
1,1230,43779,3575895457,3575895457,0
1,1230,43780,3575895457,3575895457,0
1,1230,43781,3575895457,3575895457,0
1,1230,43782,3575895457,3575895457,0
1,1230,43783,3575895457,3575895457,0
1,1230,43784,3575895457,3575895457,0
1,1230,43785,3575895457,3575895457,0
1,1230,43786,3575895457,3575895457,0
1,1230,43787,3575895457,3575895457,0
1,1230,43788,3575895457,3575895457,0
1,1230,43789,3575895457,3575895457,0
1,1230,43790,3575895457,3575895457,0
1,1230,43791,3575895457,3575895459,2
1,1230,43792,3575895457,3575895459,2
1,1230,43793,3575895457,3575895459,2
1,1230,43794,3575895457,3575895463,6
1,1230,43795,3575895457,3575895464,7
1,1230,43796,3575895457,3575895465,8
1,1230,43797,3575895457,3575895467,10
1,1230,43798,3575895457,3575895467,10
1,1230,43799,3575895457,3575895468,11
1,1230,43800,3575895457,3575895469,12
1,1230,43801,3575895457,3575895470,13
1,1230,43802,3575895457,3575895479,22
1,1230,43803,3575895457,3575895480,23
1,1230,43804,3575895457,3575895481,24
1,1230,43805,3575895457,3575895482,25
1,1230,43806,3575895457,3575895484,27
1,1230,43807,3575895457,3575895485,28
1,1230,43808,3575895457,3575895485,28
1,1230,43809,3575895457,3575895485,28
1,1230,43810,3575895457,3575895486,29
1,1230,43811,3575895457,3575895489,32
1,1230,43812,3575895457,3575895492,35
1,1230,43813,3575895457,3575895492,35
1,1230,43814,3575895457,3575895493,36
1,1230,43815,3575895457,3575895494,37
1,1230,43816,3575895457,3575895495,38
1,1230,43817,3575895457,3575895495,38
1,1230,43818,3575895457,3575895496,39
1,1230,43819,3575895457,3575895497,40
1,1230,43820,3575895457,3575895498,41
1,1230,43821,3575895457,3575895498,41
1,1230,43822,3575895457,3575895499,42
1,1230,43823,3575895457,3575895499,42
1,1230,43824,3575895457,3575895500,43
1,1230,43825,3575895457,3575895501,44
1,1230,43826,3575895457,3575895501,44
1,1230,43827,3575895457,3575895501,44
1,1230,43828,3575895457,3575895502,45
1,1230,43829,3575895457,3575895502,45
1,1230,43830,3575895457,3575895503,46
1,1230,43831,3575895457,3575895503,46
1,1230,43832,3575895457,3575895504,47
1,1230,43833,3575895457,3575895505,48
1,1230,43834,3575895457,3575895505,48
1,1230,43835,3575895457,3575895505,48
1,1230,43836,3575895457,3575895506,49
1,1230,43837,3575895457,3575895506,49
1,1230,43838,3575895457,3575895507,50
1,1231,43839,3575895520,3575895520,0
1,1231,43840,3575895520,3575895520,0
1,1231,43841,3575895520,3575895520,0
1,1231,43842,3575895520,3575895520,0
1,1231,43843,3575895520,3575895521,1
1,1231,43844,3575895520,3575895521,1
1,1231,43845,3575895520,3575895521,1
1,1231,43846,3575895520,3575895521,1
1,1231,43847,3575895520,3575895521,1
1,1231,43848,3575895520,3575895521,1
1,1231,43849,3575895520,3575895521,1
1,1231,43850,3575895520,3575895521,1
1,1231,43851,3575895520,3575895521,1
1,1231,43852,3575895520,3575895521,1
1,1231,43853,3575895520,3575895521,1
1,1231,43854,3575895520,3575895521,1
1,1231,43855,3575895520,3575895521,1
1,1231,43856,3575895520,3575895521,1
1,1231,43857,3575895520,3575895522,2
1,1231,43858,3575895520,3575895522,2
1,1231,43859,3575895520,3575895522,2
1,1231,43860,3575895520,3575895524,4
1,1231,43861,3575895520,3575895524,4
1,1231,43862,3575895520,3575895525,5
1,1231,43863,3575895520,3575895525,5
1,1231,43864,3575895520,3575895525,5
1,1231,43865,3575895520,3575895528,8
1,1231,43866,3575895520,3575895528,8
1,1231,43867,3575895520,3575895528,8
1,1231,43868,3575895520,3575895529,9
1,1231,43869,3575895520,3575895529,9
1,1231,43870,3575895520,3575895530,10
1,1231,43871,3575895520,3575895530,10
1,1231,43872,3575895520,3575895530,10
1,1231,43873,3575895520,3575895533,13
1,1231,43874,3575895520,3575895533,13
1,1231,43875,3575895520,3575895533,13
1,1231,43876,3575895520,3575895534,14
1,1231,43877,3575895520,3575895534,14
1,1231,43878,3575895520,3575895534,14
1,1231,43879,3575895520,3575895535,15
1,1231,43880,3575895520,3575895535,15
1,1231,43881,3575895520,3575895537,17
1,1231,43882,3575895520,3575895537,17
1,1231,43883,3575895520,3575895539,19
1,1231,43884,3575895520,3575895540,20
1,1231,43885,3575895520,3575895542,22
1,1231,43886,3575895520,3575895543,23
1,1231,43887,3575895520,3575895546,26
1,1231,43888,3575895520,3575895547,27
1,1231,43889,3575895520,3575895547,27
1,1231,43890,3575895520,3575895548,28
1,1231,43891,3575895520,3575895548,28
1,1231,43892,3575895520,3575895549,29
1,1231,43893,3575895520,3575895550,30
1,1231,43894,3575895520,3575895550,30
1,1231,43895,3575895520,3575895550,30
1,1231,43896,3575895520,3575895553,33
1,1231,43897,3575895520,3575895553,33
1,1231,43898,3575895520,3575895554,34
1,1231,43899,3575895520,3575895555,35
1,1231,43900,3575895520,3575895556,36
1,1231,43901,3575895520,3575895556,36
1,1231,43902,3575895520,3575895559,39
1,1231,43903,3575895520,3575895559,39
1,1231,43904,3575895520,3575895562,42
1,1231,43905,3575895520,3575895562,42
1,1231,43906,3575895520,3575895563,43
1,1231,43907,3575895520,3575895563,43
1,1231,43908,3575895520,3575895563,43
1,1231,43909,3575895520,3575895564,44
1,1231,43910,3575895520,3575895565,45
1,1231,43911,3575895520,3575895569,49
1,1232,43912,3575895584,3575895584,0
1,1232,43913,3575895584,3575895584,0
1,1232,43914,3575895584,3575895584,0
1,1232,43915,3575895584,3575895584,0
1,1232,43916,3575895584,3575895584,0
1,1232,43917,3575895584,3575895584,0
1,1232,43918,3575895584,3575895584,0
1,1232,43919,3575895584,3575895584,0
1,1232,43920,3575895584,3575895584,0
1,1232,43921,3575895584,3575895584,0
1,1232,43922,3575895584,3575895584,0
1,1232,43923,3575895584,3575895584,0
1,1232,43924,3575895584,3575895584,0
1,1232,43925,3575895584,3575895584,0
1,1232,43926,3575895584,3575895584,0
1,1232,43927,3575895584,3575895584,0
1,1232,43928,3575895584,3575895584,0
1,1232,43929,3575895584,3575895584,0
1,1232,43930,3575895584,3575895584,0
1,1232,43931,3575895584,3575895584,0
1,1232,43932,3575895584,3575895584,0
1,1232,43933,3575895584,3575895585,1
1,1232,43934,3575895584,3575895585,1
1,1232,43935,3575895584,3575895587,3
1,1232,43936,3575895584,3575895588,4
1,1232,43937,3575895584,3575895589,5
1,1232,43938,3575895584,3575895589,5
1,1232,43939,3575895584,3575895591,7
1,1232,43940,3575895584,3575895591,7
1,1232,43941,3575895584,3575895591,7
1,1232,43942,3575895584,3575895592,8
1,1232,43943,3575895584,3575895592,8
1,1232,43944,3575895584,3575895593,9
1,1232,43945,3575895584,3575895593,9
1,1232,43946,3575895584,3575895596,12
1,1232,43947,3575895584,3575895596,12
1,1232,43948,3575895584,3575895597,13
1,1232,43949,3575895584,3575895598,14
1,1232,43950,3575895584,3575895598,14
1,1232,43951,3575895584,3575895599,15
1,1232,43952,3575895584,3575895599,15
1,1232,43953,3575895584,3575895599,15
1,1232,43954,3575895584,3575895600,16
1,1232,43955,3575895584,3575895602,18
1,1232,43956,3575895584,3575895602,18
1,1232,43957,3575895584,3575895603,19
1,1232,43958,3575895584,3575895603,19
1,1232,43959,3575895584,3575895604,20
1,1232,43960,3575895584,3575895605,21
1,1232,43961,3575895584,3575895605,21
1,1232,43962,3575895584,3575895607,23
1,1232,43963,3575895584,3575895608,24
1,1232,43964,3575895584,3575895608,24
1,1232,43965,3575895584,3575895610,26
1,1232,43966,3575895584,3575895610,26
1,1232,43967,3575895584,3575895610,26
1,1232,43968,3575895584,3575895611,27
1,1232,43969,3575895584,3575895612,28
1,1232,43970,3575895584,3575895612,28
1,1232,43971,3575895584,3575895613,29
1,1232,43972,3575895584,3575895613,29
1,1232,43973,3575895584,3575895613,29
1,1232,43974,3575895584,3575895613,29
1,1232,43975,3575895584,3575895614,30
1,1232,43976,3575895584,3575895616,32
1,1232,43977,3575895584,3575895616,32
1,1232,43978,3575895584,3575895616,32
1,1232,43979,3575895584,3575895617,33
1,1232,43980,3575895584,3575895618,34
1,1232,43981,3575895584,3575895618,34
1,1232,43982,3575895584,3575895618,34
1,1232,43983,3575895584,3575895618,34
1,1232,43984,3575895584,3575895621,37
1,1232,43985,3575895584,3575895621,37
1,1232,43986,3575895584,3575895622,38
1,1232,43987,3575895584,3575895622,38
1,1232,43988,3575895584,3575895622,38
1,1232,43989,3575895584,3575895625,41
1,1232,43990,3575895584,3575895626,42
1,1232,43991,3575895584,3575895626,42
1,1232,43992,3575895584,3575895628,44
1,1232,43993,3575895584,3575895628,44
1,1232,43994,3575895584,3575895628,44
1,1232,43995,3575895584,3575895629,45
1,1232,43996,3575895584,3575895629,45
1,1232,43997,3575895584,3575895631,47
1,1232,43998,3575895584,3575895632,48
1,1232,43999,3575895584,3575895632,48
1,1232,44000,3575895584,3575895633,49
1,1232,44001,3575895584,3575895634,50
1,1233,44002,3575895650,3575895650,0
1,1233,44003,3575895650,3575895650,0
1,1233,44004,3575895650,3575895650,0
1,1233,44005,3575895650,3575895650,0
1,1233,44006,3575895650,3575895650,0
1,1233,44007,3575895650,3575895650,0
1,1233,44008,3575895650,3575895650,0
1,1233,44009,3575895650,3575895650,0
1,1233,44010,3575895650,3575895650,0
1,1233,44011,3575895650,3575895650,0
1,1233,44012,3575895650,3575895650,0
1,1233,44013,3575895650,3575895650,0
1,1233,44014,3575895650,3575895650,0
1,1233,44015,3575895650,3575895650,0
1,1233,44016,3575895650,3575895650,0
1,1233,44017,3575895650,3575895650,0
1,1233,44018,3575895650,3575895650,0
1,1233,44019,3575895650,3575895650,0
1,1233,44020,3575895650,3575895650,0
1,1233,44021,3575895650,3575895650,0
1,1233,44022,3575895650,3575895651,1
1,1233,44023,3575895650,3575895652,2
1,1233,44024,3575895650,3575895652,2
1,1233,44025,3575895650,3575895653,3
1,1233,44026,3575895650,3575895658,8
1,1233,44027,3575895650,3575895659,9
1,1233,44028,3575895650,3575895662,12
1,1233,44029,3575895650,3575895662,12
1,1233,44030,3575895650,3575895664,14
1,1233,44031,3575895650,3575895664,14
1,1233,44032,3575895650,3575895666,16
1,1233,44033,3575895650,3575895666,16
1,1233,44034,3575895650,3575895669,19
1,1233,44035,3575895650,3575895680,30
1,1233,44036,3575895650,3575895680,30
1,1233,44037,3575895650,3575895680,30
1,1233,44038,3575895650,3575895682,32
1,1233,44039,3575895650,3575895684,34
1,1233,44040,3575895650,3575895685,35
1,1233,44041,3575895650,3575895685,35
1,1233,44042,3575895650,3575895685,35
1,1233,44043,3575895650,3575895685,35
1,1233,44044,3575895650,3575895686,36
1,1233,44045,3575895650,3575895689,39
1,1233,44046,3575895650,3575895692,42
1,1233,44047,3575895650,3575895693,43
1,1233,44048,3575895650,3575895694,44
1,1233,44049,3575895650,3575895695,45
1,1233,44050,3575895650,3575895695,45
1,1233,44051,3575895650,3575895696,46
1,1233,44052,3575895650,3575895696,46
1,1233,44053,3575895650,3575895697,47
1,1233,44054,3575895650,3575895698,48
1,1233,44055,3575895650,3575895699,49
1,1233,44056,3575895650,3575895699,49
1,1233,44057,3575895650,3575895699,49
1,1234,44058,3575895713,3575895713,0
1,1234,44059,3575895713,3575895713,0
1,1234,44060,3575895713,3575895713,0
1,1234,44061,3575895713,3575895713,0
1,1234,44062,3575895713,3575895713,0
1,1234,44063,3575895713,3575895713,0
1,1234,44064,3575895713,3575895713,0
1,1234,44065,3575895713,3575895713,0
1,1234,44066,3575895713,3575895713,0
1,1234,44067,3575895713,3575895713,0
1,1234,44068,3575895713,3575895713,0
1,1234,44069,3575895713,3575895713,0
1,1234,44070,3575895713,3575895713,0
1,1234,44071,3575895713,3575895713,0
1,1234,44072,3575895713,3575895713,0
1,1234,44073,3575895713,3575895713,0
1,1234,44074,3575895713,3575895713,0
1,1234,44075,3575895713,3575895713,0
1,1234,44076,3575895713,3575895713,0
1,1234,44077,3575895713,3575895713,0
1,1234,44078,3575895713,3575895713,0
1,1234,44079,3575895713,3575895714,1
1,1234,44080,3575895713,3575895715,2
1,1234,44081,3575895713,3575895716,3
1,1234,44082,3575895713,3575895716,3
1,1234,44083,3575895713,3575895719,6
1,1234,44084,3575895713,3575895721,8
1,1234,44085,3575895713,3575895722,9
1,1234,44086,3575895713,3575895722,9
1,1234,44087,3575895713,3575895722,9
1,1234,44088,3575895713,3575895722,9
1,1234,44089,3575895713,3575895724,11
1,1234,44090,3575895713,3575895725,12
1,1234,44091,3575895713,3575895725,12
1,1234,44092,3575895713,3575895726,13
1,1234,44093,3575895713,3575895726,13
1,1234,44094,3575895713,3575895727,14
1,1234,44095,3575895713,3575895728,15
1,1234,44096,3575895713,3575895728,15
1,1234,44097,3575895713,3575895729,16
1,1234,44098,3575895713,3575895730,17
1,1234,44099,3575895713,3575895730,17
1,1234,44100,3575895713,3575895731,18
1,1234,44101,3575895713,3575895731,18
1,1234,44102,3575895713,3575895731,18
1,1234,44103,3575895713,3575895733,20
1,1234,44104,3575895713,3575895733,20
1,1234,44105,3575895713,3575895734,21
1,1234,44106,3575895713,3575895734,21
1,1234,44107,3575895713,3575895734,21
1,1234,44108,3575895713,3575895735,22
1,1234,44109,3575895713,3575895736,23
1,1234,44110,3575895713,3575895737,24
1,1234,44111,3575895713,3575895737,24
1,1234,44112,3575895713,3575895739,26
1,1234,44113,3575895713,3575895739,26
1,1234,44114,3575895713,3575895741,28
1,1234,44115,3575895713,3575895743,30
1,1234,44116,3575895713,3575895744,31
1,1234,44117,3575895713,3575895747,34
1,1234,44118,3575895713,3575895748,35
1,1234,44119,3575895713,3575895748,35
1,1234,44120,3575895713,3575895748,35
1,1234,44121,3575895713,3575895749,36
1,1234,44122,3575895713,3575895749,36
1,1234,44123,3575895713,3575895750,37
1,1234,44124,3575895713,3575895750,37
1,1234,44125,3575895713,3575895752,39
1,1234,44126,3575895713,3575895752,39
1,1234,44127,3575895713,3575895753,40
1,1234,44128,3575895713,3575895754,41
1,1234,44129,3575895713,3575895754,41
1,1234,44130,3575895713,3575895754,41
1,1234,44131,3575895713,3575895756,43
1,1234,44132,3575895713,3575895756,43
1,1234,44133,3575895713,3575895759,46
1,1234,44134,3575895713,3575895759,46
1,1234,44135,3575895713,3575895760,47
1,1234,44136,3575895713,3575895760,47
1,1234,44137,3575895713,3575895761,48
1,1234,44138,3575895713,3575895762,49
1,1234,44139,3575895713,3575895762,49
1,1234,44140,3575895713,3575895763,50
1,1235,44141,3575895780,3575895780,0
1,1235,44142,3575895780,3575895780,0
1,1235,44143,3575895780,3575895780,0
1,1235,44144,3575895780,3575895780,0
1,1235,44145,3575895780,3575895780,0
1,1235,44146,3575895780,3575895780,0
1,1235,44147,3575895780,3575895780,0
1,1235,44148,3575895780,3575895780,0
1,1235,44149,3575895780,3575895780,0
1,1235,44150,3575895780,3575895780,0
1,1235,44151,3575895780,3575895780,0
1,1235,44152,3575895780,3575895780,0
1,1235,44153,3575895780,3575895780,0
1,1235,44154,3575895780,3575895780,0
1,1235,44155,3575895780,3575895780,0
1,1235,44156,3575895780,3575895780,0
1,1235,44157,3575895780,3575895780,0
1,1235,44158,3575895780,3575895780,0
1,1235,44159,3575895780,3575895781,1
1,1235,44160,3575895780,3575895782,2
1,1235,44161,3575895780,3575895783,3
1,1235,44162,3575895780,3575895784,4
1,1235,44163,3575895780,3575895784,4
1,1235,44164,3575895780,3575895784,4
1,1235,44165,3575895780,3575895784,4
1,1235,44166,3575895780,3575895785,5
1,1235,44167,3575895780,3575895786,6
1,1235,44168,3575895780,3575895788,8
1,1235,44169,3575895780,3575895789,9
1,1235,44170,3575895780,3575895791,11
1,1235,44171,3575895780,3575895791,11
1,1235,44172,3575895780,3575895792,12
1,1235,44173,3575895780,3575895792,12
1,1235,44174,3575895780,3575895792,12
1,1235,44175,3575895780,3575895792,12
1,1235,44176,3575895780,3575895793,13
1,1235,44177,3575895780,3575895794,14
1,1235,44178,3575895780,3575895796,16
1,1235,44179,3575895780,3575895796,16
1,1235,44180,3575895780,3575895797,17
1,1235,44181,3575895780,3575895798,18
1,1235,44182,3575895780,3575895798,18
1,1235,44183,3575895780,3575895799,19
1,1235,44184,3575895780,3575895799,19
1,1235,44185,3575895780,3575895799,19
1,1235,44186,3575895780,3575895801,21
1,1235,44187,3575895780,3575895801,21
1,1235,44188,3575895780,3575895803,23
1,1235,44189,3575895780,3575895803,23
1,1235,44190,3575895780,3575895804,24
1,1235,44191,3575895780,3575895804,24
1,1235,44192,3575895780,3575895805,25
1,1235,44193,3575895780,3575895806,26
1,1235,44194,3575895780,3575895806,26
1,1235,44195,3575895780,3575895807,27
1,1235,44196,3575895780,3575895808,28
1,1235,44197,3575895780,3575895808,28
1,1235,44198,3575895780,3575895808,28
1,1235,44199,3575895780,3575895810,30
1,1235,44200,3575895780,3575895811,31
1,1235,44201,3575895780,3575895811,31
1,1235,44202,3575895780,3575895812,32
1,1235,44203,3575895780,3575895812,32
1,1235,44204,3575895780,3575895813,33
1,1235,44205,3575895780,3575895813,33
1,1235,44206,3575895780,3575895813,33
1,1235,44207,3575895780,3575895814,34
1,1235,44208,3575895780,3575895815,35
1,1235,44209,3575895780,3575895816,36
1,1235,44210,3575895780,3575895817,37
1,1235,44211,3575895780,3575895817,37
1,1235,44212,3575895780,3575895817,37
1,1235,44213,3575895780,3575895818,38
1,1235,44214,3575895780,3575895818,38
1,1235,44215,3575895780,3575895819,39
1,1235,44216,3575895780,3575895821,41
1,1235,44217,3575895780,3575895821,41
1,1235,44218,3575895780,3575895821,41
1,1235,44219,3575895780,3575895822,42
1,1235,44220,3575895780,3575895822,42
1,1235,44221,3575895780,3575895822,42
1,1235,44222,3575895780,3575895822,42
1,1235,44223,3575895780,3575895823,43
1,1235,44224,3575895780,3575895825,45
1,1235,44225,3575895780,3575895827,47
1,1235,44226,3575895780,3575895827,47
1,1235,44227,3575895780,3575895828,48
1,1235,44228,3575895780,3575895829,49
1,1235,44229,3575895780,3575895829,49
1,1235,44230,3575895780,3575895829,49
1,1235,44231,3575895780,3575895829,49
1,1236,44232,3575895843,3575895843,0
1,1236,44233,3575895843,3575895843,0
1,1236,44234,3575895843,3575895843,0
1,1236,44235,3575895843,3575895843,0
1,1236,44236,3575895843,3575895843,0
1,1236,44237,3575895843,3575895843,0
1,1236,44238,3575895843,3575895843,0
1,1236,44239,3575895843,3575895843,0
1,1236,44240,3575895843,3575895843,0
1,1236,44241,3575895843,3575895843,0
1,1236,44242,3575895843,3575895843,0
1,1236,44243,3575895843,3575895843,0
1,1236,44244,3575895843,3575895843,0
1,1236,44245,3575895843,3575895843,0
1,1236,44246,3575895843,3575895843,0
1,1236,44247,3575895843,3575895843,0
1,1236,44248,3575895843,3575895844,1
1,1236,44249,3575895843,3575895844,1
1,1236,44250,3575895843,3575895846,3
1,1236,44251,3575895843,3575895847,4
1,1236,44252,3575895843,3575895847,4
1,1236,44253,3575895843,3575895847,4
1,1236,44254,3575895843,3575895847,4
1,1236,44255,3575895843,3575895847,4
1,1236,44256,3575895843,3575895848,5
1,1236,44257,3575895843,3575895848,5
1,1236,44258,3575895843,3575895848,5
1,1236,44259,3575895843,3575895850,7
1,1236,44260,3575895843,3575895851,8
1,1236,44261,3575895843,3575895851,8
1,1236,44262,3575895843,3575895852,9
1,1236,44263,3575895843,3575895853,10
1,1236,44264,3575895843,3575895854,11
1,1236,44265,3575895843,3575895855,12
1,1236,44266,3575895843,3575895856,13
1,1236,44267,3575895843,3575895856,13
1,1236,44268,3575895843,3575895857,14
1,1236,44269,3575895843,3575895858,15
1,1236,44270,3575895843,3575895862,19
1,1236,44271,3575895843,3575895862,19
1,1236,44272,3575895843,3575895865,22
1,1236,44273,3575895843,3575895865,22
1,1236,44274,3575895843,3575895866,23
1,1236,44275,3575895843,3575895866,23
1,1236,44276,3575895843,3575895867,24
1,1236,44277,3575895843,3575895869,26
1,1236,44278,3575895843,3575895880,37
1,1236,44279,3575895843,3575895880,37
1,1236,44280,3575895843,3575895881,38
1,1236,44281,3575895843,3575895883,40
1,1236,44282,3575895843,3575895884,41
1,1236,44283,3575895843,3575895884,41
1,1236,44284,3575895843,3575895885,42
1,1236,44285,3575895843,3575895889,46
1,1236,44286,3575895843,3575895892,49
1,1236,44287,3575895843,3575895892,49
1,1237,44288,3575895909,3575895909,0
1,1237,44289,3575895909,3575895909,0
1,1237,44290,3575895909,3575895909,0
1,1237,44291,3575895909,3575895909,0
1,1237,44292,3575895909,3575895909,0
1,1237,44293,3575895909,3575895909,0
1,1237,44294,3575895909,3575895909,0
1,1237,44295,3575895909,3575895909,0
1,1237,44296,3575895909,3575895909,0
1,1237,44297,3575895909,3575895909,0
1,1237,44298,3575895909,3575895909,0
1,1237,44299,3575895909,3575895909,0
1,1237,44300,3575895909,3575895909,0
1,1237,44301,3575895909,3575895909,0
1,1237,44302,3575895909,3575895909,0
1,1237,44303,3575895909,3575895909,0
1,1237,44304,3575895909,3575895909,0
1,1237,44305,3575895909,3575895909,0
1,1237,44306,3575895909,3575895909,0
1,1237,44307,3575895909,3575895909,0
1,1237,44308,3575895909,3575895909,0
1,1237,44309,3575895909,3575895909,0
1,1237,44310,3575895909,3575895909,0
1,1237,44311,3575895909,3575895909,0
1,1237,44312,3575895909,3575895909,0
1,1237,44313,3575895909,3575895909,0
1,1237,44314,3575895909,3575895909,0
1,1237,44315,3575895909,3575895909,0
1,1237,44316,3575895909,3575895909,0
1,1237,44317,3575895909,3575895910,1
1,1237,44318,3575895909,3575895910,1
1,1237,44319,3575895909,3575895912,3
1,1237,44320,3575895909,3575895912,3
1,1237,44321,3575895909,3575895913,4
1,1237,44322,3575895909,3575895914,5
1,1237,44323,3575895909,3575895914,5
1,1237,44324,3575895909,3575895915,6
1,1237,44325,3575895909,3575895915,6
1,1237,44326,3575895909,3575895915,6
1,1237,44327,3575895909,3575895916,7
1,1237,44328,3575895909,3575895917,8
1,1237,44329,3575895909,3575895918,9
1,1237,44330,3575895909,3575895919,10
1,1237,44331,3575895909,3575895921,12
1,1237,44332,3575895909,3575895922,13
1,1237,44333,3575895909,3575895922,13
1,1237,44334,3575895909,3575895923,14
1,1237,44335,3575895909,3575895924,15
1,1237,44336,3575895909,3575895926,17
1,1237,44337,3575895909,3575895926,17
1,1237,44338,3575895909,3575895926,17
1,1237,44339,3575895909,3575895927,18
1,1237,44340,3575895909,3575895927,18
1,1237,44341,3575895909,3575895928,19
1,1237,44342,3575895909,3575895929,20
1,1237,44343,3575895909,3575895930,21
1,1237,44344,3575895909,3575895930,21
1,1237,44345,3575895909,3575895930,21
1,1237,44346,3575895909,3575895931,22
1,1237,44347,3575895909,3575895931,22
1,1237,44348,3575895909,3575895931,22
1,1237,44349,3575895909,3575895932,23
1,1237,44350,3575895909,3575895933,24
1,1237,44351,3575895909,3575895934,25
1,1237,44352,3575895909,3575895934,25
1,1237,44353,3575895909,3575895935,26
1,1237,44354,3575895909,3575895935,26
1,1237,44355,3575895909,3575895935,26
1,1237,44356,3575895909,3575895935,26
1,1237,44357,3575895909,3575895937,28
1,1237,44358,3575895909,3575895937,28
1,1237,44359,3575895909,3575895939,30
1,1237,44360,3575895909,3575895940,31
1,1237,44361,3575895909,3575895940,31
1,1237,44362,3575895909,3575895940,31
1,1237,44363,3575895909,3575895943,34
1,1237,44364,3575895909,3575895944,35
1,1237,44365,3575895909,3575895945,36
1,1237,44366,3575895909,3575895947,38
1,1237,44367,3575895909,3575895947,38
1,1237,44368,3575895909,3575895948,39
1,1237,44369,3575895909,3575895948,39
1,1237,44370,3575895909,3575895948,39
1,1237,44371,3575895909,3575895949,40
1,1237,44372,3575895909,3575895950,41
1,1237,44373,3575895909,3575895950,41
1,1237,44374,3575895909,3575895950,41
1,1237,44375,3575895909,3575895951,42
1,1237,44376,3575895909,3575895952,43
1,1237,44377,3575895909,3575895953,44
1,1237,44378,3575895909,3575895954,45
1,1237,44379,3575895909,3575895954,45
1,1237,44380,3575895909,3575895957,48
1,1237,44381,3575895909,3575895959,50
1,1238,44382,3575895974,3575895974,0
1,1238,44383,3575895974,3575895974,0
1,1238,44384,3575895974,3575895974,0
1,1238,44385,3575895974,3575895974,0
1,1238,44386,3575895974,3575895974,0
1,1238,44387,3575895974,3575895974,0
1,1238,44388,3575895974,3575895974,0
1,1238,44389,3575895974,3575895974,0
1,1238,44390,3575895974,3575895974,0
1,1238,44391,3575895974,3575895974,0
1,1238,44392,3575895974,3575895974,0
1,1238,44393,3575895974,3575895974,0
1,1238,44394,3575895974,3575895974,0
1,1238,44395,3575895974,3575895974,0
1,1238,44396,3575895974,3575895974,0
1,1238,44397,3575895974,3575895975,1
1,1238,44398,3575895974,3575895976,2
1,1238,44399,3575895974,3575895977,3
1,1238,44400,3575895974,3575895977,3
1,1238,44401,3575895974,3575895978,4
1,1238,44402,3575895974,3575895978,4
1,1238,44403,3575895974,3575895978,4
1,1238,44404,3575895974,3575895978,4
1,1238,44405,3575895974,3575895979,5
1,1238,44406,3575895974,3575895980,6
1,1238,44407,3575895974,3575895982,8
1,1238,44408,3575895974,3575895982,8
1,1238,44409,3575895974,3575895984,10
1,1238,44410,3575895974,3575895984,10
1,1238,44411,3575895974,3575895984,10
1,1238,44412,3575895974,3575895985,11
1,1238,44413,3575895974,3575895985,11
1,1238,44414,3575895974,3575895987,13
1,1238,44415,3575895974,3575895989,15
1,1238,44416,3575895974,3575895989,15
1,1238,44417,3575895974,3575895990,16
1,1238,44418,3575895974,3575895991,17
1,1238,44419,3575895974,3575895991,17
1,1238,44420,3575895974,3575895992,18
1,1238,44421,3575895974,3575895992,18
1,1238,44422,3575895974,3575895993,19
1,1238,44423,3575895974,3575895994,20
1,1238,44424,3575895974,3575895996,22
1,1238,44425,3575895974,3575895997,23
1,1238,44426,3575895974,3575895997,23
1,1238,44427,3575895974,3575895998,24
1,1238,44428,3575895974,3575895999,25
1,1238,44429,3575895974,3575896000,26
1,1238,44430,3575895974,3575896000,26
1,1238,44431,3575895974,3575896000,26
1,1238,44432,3575895974,3575896001,27
1,1238,44433,3575895974,3575896002,28
1,1238,44434,3575895974,3575896003,29
1,1238,44435,3575895974,3575896004,30
1,1238,44436,3575895974,3575896004,30
1,1238,44437,3575895974,3575896005,31
1,1238,44438,3575895974,3575896006,32
1,1238,44439,3575895974,3575896007,33
1,1238,44440,3575895974,3575896007,33
1,1238,44441,3575895974,3575896008,34
1,1238,44442,3575895974,3575896009,35
1,1238,44443,3575895974,3575896009,35
1,1238,44444,3575895974,3575896010,36
1,1238,44445,3575895974,3575896010,36
1,1238,44446,3575895974,3575896012,38
1,1238,44447,3575895974,3575896012,38
1,1238,44448,3575895974,3575896013,39
1,1238,44449,3575895974,3575896013,39
1,1238,44450,3575895974,3575896013,39
1,1238,44451,3575895974,3575896014,40
1,1238,44452,3575895974,3575896014,40
1,1238,44453,3575895974,3575896014,40
1,1238,44454,3575895974,3575896016,42
1,1238,44455,3575895974,3575896017,43
1,1238,44456,3575895974,3575896017,43
1,1238,44457,3575895974,3575896017,43
1,1238,44458,3575895974,3575896017,43
1,1238,44459,3575895974,3575896018,44
1,1238,44460,3575895974,3575896018,44
1,1238,44461,3575895974,3575896019,45
1,1238,44462,3575895974,3575896021,47
1,1238,44463,3575895974,3575896021,47
1,1238,44464,3575895974,3575896022,48
1,1238,44465,3575895974,3575896022,48
1,1238,44466,3575895974,3575896022,48
1,1238,44467,3575895974,3575896023,49
1,1238,44468,3575895974,3575896023,49
1,1238,44469,3575895974,3575896023,49
1,1238,44470,3575895974,3575896023,49
1,1239,44471,3575896040,3575896040,0
1,1239,44472,3575896040,3575896040,0
1,1239,44473,3575896040,3575896040,0
1,1239,44474,3575896040,3575896040,0
1,1239,44475,3575896040,3575896040,0
1,1239,44476,3575896040,3575896040,0
1,1239,44477,3575896040,3575896040,0
1,1239,44478,3575896040,3575896040,0
1,1239,44479,3575896040,3575896040,0
1,1239,44480,3575896040,3575896040,0
1,1239,44481,3575896040,3575896040,0
1,1239,44482,3575896040,3575896040,0
1,1239,44483,3575896040,3575896040,0
1,1239,44484,3575896040,3575896040,0
1,1239,44485,3575896040,3575896040,0
1,1239,44486,3575896040,3575896040,0
1,1239,44487,3575896040,3575896040,0
1,1239,44488,3575896040,3575896040,0
1,1239,44489,3575896040,3575896041,1
1,1239,44490,3575896040,3575896044,4
1,1239,44491,3575896040,3575896044,4
1,1239,44492,3575896040,3575896049,9
1,1239,44493,3575896040,3575896049,9
1,1239,44494,3575896040,3575896049,9
1,1239,44495,3575896040,3575896049,9
1,1239,44496,3575896040,3575896049,9
1,1239,44497,3575896040,3575896049,9
1,1239,44498,3575896040,3575896049,9
1,1239,44499,3575896040,3575896049,9
1,1239,44500,3575896040,3575896049,9
1,1239,44501,3575896040,3575896049,9
1,1239,44502,3575896040,3575896049,9
1,1239,44503,3575896040,3575896051,11
1,1239,44504,3575896040,3575896053,13
1,1239,44505,3575896040,3575896053,13
1,1239,44506,3575896040,3575896053,13
1,1239,44507,3575896040,3575896055,15
1,1239,44508,3575896040,3575896055,15
1,1239,44509,3575896040,3575896056,16
1,1239,44510,3575896040,3575896058,18
1,1239,44511,3575896040,3575896059,19
1,1239,44512,3575896040,3575896060,20
1,1239,44513,3575896040,3575896062,22
1,1239,44514,3575896040,3575896062,22
1,1239,44515,3575896040,3575896065,25
1,1239,44516,3575896040,3575896065,25
1,1239,44517,3575896040,3575896066,26
1,1239,44518,3575896040,3575896066,26
1,1239,44519,3575896040,3575896068,28
1,1239,44520,3575896040,3575896069,29
1,1239,44521,3575896040,3575896070,30
1,1239,44522,3575896040,3575896080,40
1,1239,44523,3575896040,3575896081,41
1,1239,44524,3575896040,3575896083,43
1,1239,44525,3575896040,3575896084,44
1,1239,44526,3575896040,3575896084,44
1,1239,44527,3575896040,3575896084,44
1,1239,44528,3575896040,3575896085,45
1,1239,44529,3575896040,3575896085,45
1,1239,44530,3575896040,3575896085,45
1,1239,44531,3575896040,3575896086,46
1,1239,44532,3575896040,3575896089,49
1,1239,44533,3575896040,3575896089,49
1,1240,44534,3575896106,3575896106,0
1,1240,44535,3575896106,3575896106,0
1,1240,44536,3575896106,3575896106,0
1,1240,44537,3575896106,3575896106,0
1,1240,44538,3575896106,3575896106,0
1,1240,44539,3575896106,3575896106,0
1,1240,44540,3575896106,3575896106,0
1,1240,44541,3575896106,3575896106,0
1,1240,44542,3575896106,3575896106,0
1,1240,44543,3575896106,3575896106,0
1,1240,44544,3575896106,3575896106,0
1,1240,44545,3575896106,3575896106,0
1,1240,44546,3575896106,3575896106,0
1,1240,44547,3575896106,3575896106,0
1,1240,44548,3575896106,3575896106,0
1,1240,44549,3575896106,3575896106,0
1,1240,44550,3575896106,3575896106,0
1,1240,44551,3575896106,3575896106,0
1,1240,44552,3575896106,3575896106,0
1,1240,44553,3575896106,3575896106,0
1,1240,44554,3575896106,3575896106,0
1,1240,44555,3575896106,3575896106,0
1,1240,44556,3575896106,3575896107,1
1,1240,44557,3575896106,3575896108,2
1,1240,44558,3575896106,3575896108,2
1,1240,44559,3575896106,3575896108,2
1,1240,44560,3575896106,3575896109,3
1,1240,44561,3575896106,3575896110,4
1,1240,44562,3575896106,3575896110,4
1,1240,44563,3575896106,3575896112,6
1,1240,44564,3575896106,3575896113,7
1,1240,44565,3575896106,3575896115,9
1,1240,44566,3575896106,3575896115,9
1,1240,44567,3575896106,3575896115,9
1,1240,44568,3575896106,3575896116,10
1,1240,44569,3575896106,3575896116,10
1,1240,44570,3575896106,3575896119,13
1,1240,44571,3575896106,3575896121,15
1,1240,44572,3575896106,3575896122,16
1,1240,44573,3575896106,3575896122,16
1,1240,44574,3575896106,3575896122,16
1,1240,44575,3575896106,3575896122,16
1,1240,44576,3575896106,3575896123,17
1,1240,44577,3575896106,3575896124,18
1,1240,44578,3575896106,3575896126,20
1,1240,44579,3575896106,3575896126,20
1,1240,44580,3575896106,3575896126,20
1,1240,44581,3575896106,3575896126,20
1,1240,44582,3575896106,3575896127,21
1,1240,44583,3575896106,3575896128,22
1,1240,44584,3575896106,3575896129,23
1,1240,44585,3575896106,3575896130,24
1,1240,44586,3575896106,3575896130,24
1,1240,44587,3575896106,3575896130,24
1,1240,44588,3575896106,3575896131,25
1,1240,44589,3575896106,3575896133,27
1,1240,44590,3575896106,3575896134,28
1,1240,44591,3575896106,3575896136,30
1,1240,44592,3575896106,3575896137,31
1,1240,44593,3575896106,3575896137,31
1,1240,44594,3575896106,3575896138,32
1,1240,44595,3575896106,3575896139,33
1,1240,44596,3575896106,3575896139,33
1,1240,44597,3575896106,3575896140,34
1,1240,44598,3575896106,3575896140,34
1,1240,44599,3575896106,3575896141,35
1,1240,44600,3575896106,3575896144,38
1,1240,44601,3575896106,3575896144,38
1,1240,44602,3575896106,3575896148,42
1,1240,44603,3575896106,3575896148,42
1,1240,44604,3575896106,3575896148,42
1,1240,44605,3575896106,3575896149,43
1,1240,44606,3575896106,3575896149,43
1,1240,44607,3575896106,3575896153,47
1,1240,44608,3575896106,3575896153,47
1,1240,44609,3575896106,3575896153,47
1,1240,44610,3575896106,3575896153,47
1,1240,44611,3575896106,3575896153,47
1,1240,44612,3575896106,3575896154,48
1,1241,44613,3575896173,3575896173,0
1,1241,44614,3575896173,3575896173,0
1,1241,44615,3575896173,3575896173,0
1,1241,44616,3575896173,3575896173,0
1,1241,44617,3575896173,3575896173,0
1,1241,44618,3575896173,3575896173,0
1,1241,44619,3575896173,3575896173,0
1,1241,44620,3575896173,3575896173,0
1,1241,44621,3575896173,3575896173,0
1,1241,44622,3575896173,3575896173,0
1,1241,44623,3575896173,3575896173,0
1,1241,44624,3575896173,3575896173,0
1,1241,44625,3575896173,3575896173,0
1,1241,44626,3575896173,3575896173,0
1,1241,44627,3575896173,3575896173,0
1,1241,44628,3575896173,3575896173,0
1,1241,44629,3575896173,3575896173,0
1,1241,44630,3575896173,3575896174,1
1,1241,44631,3575896173,3575896176,3
1,1241,44632,3575896173,3575896176,3
1,1241,44633,3575896173,3575896176,3
1,1241,44634,3575896173,3575896177,4
1,1241,44635,3575896173,3575896177,4
1,1241,44636,3575896173,3575896178,5
1,1241,44637,3575896173,3575896178,5
1,1241,44638,3575896173,3575896179,6
1,1241,44639,3575896173,3575896180,7
1,1241,44640,3575896173,3575896180,7
1,1241,44641,3575896173,3575896182,9
1,1241,44642,3575896173,3575896182,9
1,1241,44643,3575896173,3575896184,11
1,1241,44644,3575896173,3575896184,11
1,1241,44645,3575896173,3575896184,11
1,1241,44646,3575896173,3575896185,12
1,1241,44647,3575896173,3575896185,12
1,1241,44648,3575896173,3575896186,13
1,1241,44649,3575896173,3575896187,14
1,1241,44650,3575896173,3575896189,16
1,1241,44651,3575896173,3575896189,16
1,1241,44652,3575896173,3575896190,17
1,1241,44653,3575896173,3575896191,18
1,1241,44654,3575896173,3575896191,18
1,1241,44655,3575896173,3575896192,19
1,1241,44656,3575896173,3575896192,19
1,1241,44657,3575896173,3575896192,19
1,1241,44658,3575896173,3575896193,20
1,1241,44659,3575896173,3575896193,20
1,1241,44660,3575896173,3575896193,20
1,1241,44661,3575896173,3575896194,21
1,1241,44662,3575896173,3575896197,24
1,1241,44663,3575896173,3575896197,24
1,1241,44664,3575896173,3575896198,25
1,1241,44665,3575896173,3575896199,26
1,1241,44666,3575896173,3575896199,26
1,1241,44667,3575896173,3575896200,27
1,1241,44668,3575896173,3575896200,27
1,1241,44669,3575896173,3575896201,28
1,1241,44670,3575896173,3575896202,29
1,1241,44671,3575896173,3575896204,31
1,1241,44672,3575896173,3575896205,32
1,1241,44673,3575896173,3575896205,32
1,1241,44674,3575896173,3575896205,32
1,1241,44675,3575896173,3575896206,33
1,1241,44676,3575896173,3575896207,34
1,1241,44677,3575896173,3575896208,35
1,1241,44678,3575896173,3575896208,35
1,1241,44679,3575896173,3575896209,36
1,1241,44680,3575896173,3575896210,37
1,1241,44681,3575896173,3575896211,38
1,1241,44682,3575896173,3575896212,39
1,1241,44683,3575896173,3575896212,39
1,1241,44684,3575896173,3575896213,40
1,1241,44685,3575896173,3575896213,40
1,1241,44686,3575896173,3575896213,40
1,1241,44687,3575896173,3575896213,40
1,1241,44688,3575896173,3575896214,41
1,1241,44689,3575896173,3575896214,41
1,1241,44690,3575896173,3575896216,43
1,1241,44691,3575896173,3575896216,43
1,1241,44692,3575896173,3575896218,45
1,1241,44693,3575896173,3575896219,46
1,1241,44694,3575896173,3575896221,48
1,1241,44695,3575896173,3575896221,48
1,1241,44696,3575896173,3575896221,48
1,1241,44697,3575896173,3575896222,49
1,1241,44698,3575896173,3575896223,50
1,1242,44699,3575896239,3575896239,0
1,1242,44700,3575896239,3575896239,0
1,1242,44701,3575896239,3575896239,0
1,1242,44702,3575896239,3575896239,0
1,1242,44703,3575896239,3575896239,0
1,1242,44704,3575896239,3575896239,0
1,1242,44705,3575896239,3575896239,0
1,1242,44706,3575896239,3575896239,0
1,1242,44707,3575896239,3575896239,0
1,1242,44708,3575896239,3575896239,0
1,1242,44709,3575896239,3575896239,0
1,1242,44710,3575896239,3575896239,0
1,1242,44711,3575896239,3575896239,0
1,1242,44712,3575896239,3575896239,0
1,1242,44713,3575896239,3575896239,0
1,1242,44714,3575896239,3575896239,0
1,1242,44715,3575896239,3575896239,0
1,1242,44716,3575896239,3575896239,0
1,1242,44717,3575896239,3575896239,0
1,1242,44718,3575896239,3575896239,0
1,1242,44719,3575896239,3575896239,0
1,1242,44720,3575896239,3575896239,0
1,1242,44721,3575896239,3575896239,0
1,1242,44722,3575896239,3575896240,1
1,1242,44723,3575896239,3575896241,2
1,1242,44724,3575896239,3575896243,4
1,1242,44725,3575896239,3575896243,4
1,1242,44726,3575896239,3575896244,5
1,1242,44727,3575896239,3575896245,6
1,1242,44728,3575896239,3575896245,6
1,1242,44729,3575896239,3575896245,6
1,1242,44730,3575896239,3575896246,7
1,1242,44731,3575896239,3575896247,8
1,1242,44732,3575896239,3575896247,8
1,1242,44733,3575896239,3575896248,9
1,1242,44734,3575896239,3575896248,9
1,1242,44735,3575896239,3575896249,10
1,1242,44736,3575896239,3575896249,10
1,1242,44737,3575896239,3575896249,10
1,1242,44738,3575896239,3575896251,12
1,1242,44739,3575896239,3575896253,14
1,1242,44740,3575896239,3575896253,14
1,1242,44741,3575896239,3575896254,15
1,1242,44742,3575896239,3575896254,15
1,1242,44743,3575896239,3575896255,16
1,1242,44744,3575896239,3575896256,17
1,1242,44745,3575896239,3575896257,18
1,1242,44746,3575896239,3575896258,19
1,1242,44747,3575896239,3575896260,21
1,1242,44748,3575896239,3575896262,23
1,1242,44749,3575896239,3575896263,24
1,1242,44750,3575896239,3575896265,26
1,1242,44751,3575896239,3575896266,27
1,1242,44752,3575896239,3575896267,28
1,1242,44753,3575896239,3575896267,28
1,1242,44754,3575896239,3575896267,28
1,1242,44755,3575896239,3575896268,29
1,1242,44756,3575896239,3575896269,30
1,1242,44757,3575896239,3575896270,31
1,1242,44758,3575896239,3575896280,41
1,1242,44759,3575896239,3575896281,42
1,1242,44760,3575896239,3575896281,42
1,1242,44761,3575896239,3575896284,45
1,1242,44762,3575896239,3575896285,46
1,1242,44763,3575896239,3575896285,46
1,1242,44764,3575896239,3575896285,46
1,1242,44765,3575896239,3575896286,47
1,1242,44766,3575896239,3575896289,50
1,1243,44767,3575896302,3575896302,0
1,1243,44768,3575896302,3575896302,0
1,1243,44769,3575896302,3575896302,0
1,1243,44770,3575896302,3575896303,1
1,1243,44771,3575896302,3575896303,1
1,1243,44772,3575896302,3575896303,1
1,1243,44773,3575896302,3575896303,1
1,1243,44774,3575896302,3575896303,1
1,1243,44775,3575896302,3575896303,1
1,1243,44776,3575896302,3575896303,1
1,1243,44777,3575896302,3575896303,1
1,1243,44778,3575896302,3575896303,1
1,1243,44779,3575896302,3575896303,1
1,1243,44780,3575896302,3575896303,1
1,1243,44781,3575896302,3575896303,1
1,1243,44782,3575896302,3575896303,1
1,1243,44783,3575896302,3575896303,1
1,1243,44784,3575896302,3575896303,1
1,1243,44785,3575896302,3575896303,1
1,1243,44786,3575896302,3575896304,2
1,1243,44787,3575896302,3575896305,3
1,1243,44788,3575896302,3575896305,3
1,1243,44789,3575896302,3575896305,3
1,1243,44790,3575896302,3575896307,5
1,1243,44791,3575896302,3575896307,5
1,1243,44792,3575896302,3575896308,6
1,1243,44793,3575896302,3575896309,7
1,1243,44794,3575896302,3575896311,9
1,1243,44795,3575896302,3575896311,9
1,1243,44796,3575896302,3575896311,9
1,1243,44797,3575896302,3575896312,10
1,1243,44798,3575896302,3575896313,11
1,1243,44799,3575896302,3575896314,12
1,1243,44800,3575896302,3575896314,12
1,1243,44801,3575896302,3575896315,13
1,1243,44802,3575896302,3575896315,13
1,1243,44803,3575896302,3575896315,13
1,1243,44804,3575896302,3575896316,14
1,1243,44805,3575896302,3575896317,15
1,1243,44806,3575896302,3575896319,17
1,1243,44807,3575896302,3575896320,18
1,1243,44808,3575896302,3575896321,19
1,1243,44809,3575896302,3575896321,19
1,1243,44810,3575896302,3575896322,20
1,1243,44811,3575896302,3575896322,20
1,1243,44812,3575896302,3575896322,20
1,1243,44813,3575896302,3575896322,20
1,1243,44814,3575896302,3575896322,20
1,1243,44815,3575896302,3575896324,22
1,1243,44816,3575896302,3575896326,24
1,1243,44817,3575896302,3575896326,24
1,1243,44818,3575896302,3575896326,24
1,1243,44819,3575896302,3575896327,25
1,1243,44820,3575896302,3575896328,26
1,1243,44821,3575896302,3575896328,26
1,1243,44822,3575896302,3575896329,27
1,1243,44823,3575896302,3575896329,27
1,1243,44824,3575896302,3575896330,28
1,1243,44825,3575896302,3575896331,29
1,1243,44826,3575896302,3575896333,31
1,1243,44827,3575896302,3575896334,32
1,1243,44828,3575896302,3575896335,33
1,1243,44829,3575896302,3575896335,33
1,1243,44830,3575896302,3575896335,33
1,1243,44831,3575896302,3575896336,34
1,1243,44832,3575896302,3575896337,35
1,1243,44833,3575896302,3575896337,35
1,1243,44834,3575896302,3575896338,36
1,1243,44835,3575896302,3575896339,37
1,1243,44836,3575896302,3575896340,38
1,1243,44837,3575896302,3575896340,38
1,1243,44838,3575896302,3575896341,39
1,1243,44839,3575896302,3575896342,40
1,1243,44840,3575896302,3575896344,42
1,1243,44841,3575896302,3575896344,42
1,1243,44842,3575896302,3575896344,42
1,1243,44843,3575896302,3575896348,46
1,1243,44844,3575896302,3575896348,46
1,1243,44845,3575896302,3575896348,46
1,1243,44846,3575896302,3575896348,46
1,1243,44847,3575896302,3575896349,47
1,1243,44848,3575896302,3575896349,47
1,1243,44849,3575896302,3575896349,47
1,1243,44850,3575896302,3575896351,49
1,1244,44851,3575896366,3575896366,0
1,1244,44852,3575896366,3575896366,0
1,1244,44853,3575896366,3575896366,0
1,1244,44854,3575896366,3575896366,0
1,1244,44855,3575896366,3575896366,0
1,1244,44856,3575896366,3575896366,0
1,1244,44857,3575896366,3575896366,0
1,1244,44858,3575896366,3575896366,0
1,1244,44859,3575896366,3575896366,0
1,1244,44860,3575896366,3575896366,0
1,1244,44861,3575896366,3575896367,1
1,1244,44862,3575896366,3575896367,1
1,1244,44863,3575896366,3575896367,1
1,1244,44864,3575896366,3575896367,1
1,1244,44865,3575896366,3575896367,1
1,1244,44866,3575896366,3575896367,1
1,1244,44867,3575896366,3575896367,1
1,1244,44868,3575896366,3575896372,6
1,1244,44869,3575896366,3575896373,7
1,1244,44870,3575896366,3575896374,8
1,1244,44871,3575896366,3575896374,8
1,1244,44872,3575896366,3575896376,10
1,1244,44873,3575896366,3575896376,10
1,1244,44874,3575896366,3575896376,10
1,1244,44875,3575896366,3575896377,11
1,1244,44876,3575896366,3575896378,12
1,1244,44877,3575896366,3575896379,13
1,1244,44878,3575896366,3575896379,13
1,1244,44879,3575896366,3575896379,13
1,1244,44880,3575896366,3575896380,14
1,1244,44881,3575896366,3575896380,14
1,1244,44882,3575896366,3575896381,15
1,1244,44883,3575896366,3575896382,16
1,1244,44884,3575896366,3575896383,17
1,1244,44885,3575896366,3575896384,18
1,1244,44886,3575896366,3575896385,19
1,1244,44887,3575896366,3575896386,20
1,1244,44888,3575896366,3575896386,20
1,1244,44889,3575896366,3575896388,22
1,1244,44890,3575896366,3575896389,23
1,1244,44891,3575896366,3575896390,24
1,1244,44892,3575896366,3575896390,24
1,1244,44893,3575896366,3575896391,25
1,1244,44894,3575896366,3575896391,25
1,1244,44895,3575896366,3575896393,27
1,1244,44896,3575896366,3575896393,27
1,1244,44897,3575896366,3575896393,27
1,1244,44898,3575896366,3575896394,28
1,1244,44899,3575896366,3575896394,28
1,1244,44900,3575896366,3575896397,31
1,1244,44901,3575896366,3575896398,32
1,1244,44902,3575896366,3575896398,32
1,1244,44903,3575896366,3575896398,32
1,1244,44904,3575896366,3575896400,34
1,1244,44905,3575896366,3575896400,34
1,1244,44906,3575896366,3575896401,35
1,1244,44907,3575896366,3575896402,36
1,1244,44908,3575896366,3575896402,36
1,1244,44909,3575896366,3575896404,38
1,1244,44910,3575896366,3575896405,39
1,1244,44911,3575896366,3575896405,39
1,1244,44912,3575896366,3575896405,39
1,1244,44913,3575896366,3575896406,40
1,1244,44914,3575896366,3575896406,40
1,1244,44915,3575896366,3575896407,41
1,1244,44916,3575896366,3575896408,42
1,1244,44917,3575896366,3575896408,42
1,1244,44918,3575896366,3575896410,44
1,1244,44919,3575896366,3575896411,45
1,1244,44920,3575896366,3575896412,46
1,1244,44921,3575896366,3575896413,47
1,1244,44922,3575896366,3575896413,47
1,1244,44923,3575896366,3575896413,47
1,1244,44924,3575896366,3575896413,47
1,1244,44925,3575896366,3575896413,47
1,1244,44926,3575896366,3575896413,47
1,1244,44927,3575896366,3575896414,48
1,1244,44928,3575896366,3575896416,50
1,1245,44929,3575896432,3575896432,0
1,1245,44930,3575896432,3575896432,0
1,1245,44931,3575896432,3575896432,0
1,1245,44932,3575896432,3575896432,0
1,1245,44933,3575896432,3575896432,0
1,1245,44934,3575896432,3575896432,0
1,1245,44935,3575896432,3575896432,0
1,1245,44936,3575896432,3575896432,0
1,1245,44937,3575896432,3575896432,0
1,1245,44938,3575896432,3575896432,0
1,1245,44939,3575896432,3575896432,0
1,1245,44940,3575896432,3575896432,0
1,1245,44941,3575896432,3575896432,0
1,1245,44942,3575896432,3575896432,0
1,1245,44943,3575896432,3575896432,0
1,1245,44944,3575896432,3575896432,0
1,1245,44945,3575896432,3575896432,0
1,1245,44946,3575896432,3575896432,0
1,1245,44947,3575896432,3575896432,0
1,1245,44948,3575896432,3575896432,0
1,1245,44949,3575896432,3575896432,0
1,1245,44950,3575896432,3575896432,0
1,1245,44951,3575896432,3575896432,0
1,1245,44952,3575896432,3575896432,0
1,1245,44953,3575896432,3575896434,2
1,1245,44954,3575896432,3575896434,2
1,1245,44955,3575896432,3575896435,3
1,1245,44956,3575896432,3575896436,4
1,1245,44957,3575896432,3575896437,5
1,1245,44958,3575896432,3575896438,6
1,1245,44959,3575896432,3575896440,8
1,1245,44960,3575896432,3575896440,8
1,1245,44961,3575896432,3575896441,9
1,1245,44962,3575896432,3575896442,10
1,1245,44963,3575896432,3575896444,12
1,1245,44964,3575896432,3575896444,12
1,1245,44965,3575896432,3575896444,12
1,1245,44966,3575896432,3575896444,12
1,1245,44967,3575896432,3575896445,13
1,1245,44968,3575896432,3575896445,13
1,1245,44969,3575896432,3575896447,15
1,1245,44970,3575896432,3575896447,15
1,1245,44971,3575896432,3575896448,16
1,1245,44972,3575896432,3575896448,16
1,1245,44973,3575896432,3575896448,16
1,1245,44974,3575896432,3575896449,17
1,1245,44975,3575896432,3575896450,18
1,1245,44976,3575896432,3575896453,21
1,1245,44977,3575896432,3575896453,21
1,1245,44978,3575896432,3575896453,21
1,1245,44979,3575896432,3575896454,22
1,1245,44980,3575896432,3575896455,23
1,1245,44981,3575896432,3575896456,24
1,1245,44982,3575896432,3575896459,27
1,1245,44983,3575896432,3575896459,27
1,1245,44984,3575896432,3575896462,30
1,1245,44985,3575896432,3575896463,31
1,1245,44986,3575896432,3575896466,34
1,1245,44987,3575896432,3575896467,35
1,1245,44988,3575896432,3575896467,35
1,1245,44989,3575896432,3575896468,36
1,1245,44990,3575896432,3575896468,36
1,1245,44991,3575896432,3575896470,38
1,1245,44992,3575896432,3575896471,39
1,1245,44993,3575896432,3575896480,48
1,1245,44994,3575896432,3575896480,48
1,1245,44995,3575896432,3575896481,49
1,1246,44996,3575896494,3575896494,0
1,1246,44997,3575896494,3575896494,0
1,1246,44998,3575896494,3575896494,0
1,1246,44999,3575896494,3575896494,0
1,1246,45000,3575896494,3575896494,0
1,1246,45001,3575896494,3575896494,0
1,1246,45002,3575896494,3575896494,0
1,1246,45003,3575896494,3575896494,0
1,1246,45004,3575896494,3575896494,0
1,1246,45005,3575896494,3575896494,0
1,1246,45006,3575896494,3575896494,0
1,1246,45007,3575896494,3575896494,0
1,1246,45008,3575896494,3575896494,0
1,1246,45009,3575896494,3575896495,1
1,1246,45010,3575896494,3575896495,1
1,1246,45011,3575896494,3575896495,1
1,1246,45012,3575896494,3575896495,1
1,1246,45013,3575896494,3575896496,2
1,1246,45014,3575896494,3575896497,3
1,1246,45015,3575896494,3575896498,4
1,1246,45016,3575896494,3575896499,5
1,1246,45017,3575896494,3575896499,5
1,1246,45018,3575896494,3575896499,5
1,1246,45019,3575896494,3575896500,6
1,1246,45020,3575896494,3575896501,7
1,1246,45021,3575896494,3575896502,8
1,1246,45022,3575896494,3575896502,8
1,1246,45023,3575896494,3575896502,8
1,1246,45024,3575896494,3575896504,10
1,1246,45025,3575896494,3575896504,10
1,1246,45026,3575896494,3575896506,12
1,1246,45027,3575896494,3575896507,13
1,1246,45028,3575896494,3575896507,13
1,1246,45029,3575896494,3575896507,13
1,1246,45030,3575896494,3575896509,15
1,1246,45031,3575896494,3575896510,16
1,1246,45032,3575896494,3575896510,16
1,1246,45033,3575896494,3575896511,17
1,1246,45034,3575896494,3575896512,18
1,1246,45035,3575896494,3575896513,19
1,1246,45036,3575896494,3575896514,20
1,1246,45037,3575896494,3575896514,20
1,1246,45038,3575896494,3575896515,21
1,1246,45039,3575896494,3575896515,21
1,1246,45040,3575896494,3575896517,23
1,1246,45041,3575896494,3575896520,26
1,1246,45042,3575896494,3575896520,26
1,1246,45043,3575896494,3575896521,27
1,1246,45044,3575896494,3575896521,27
1,1246,45045,3575896494,3575896521,27
1,1246,45046,3575896494,3575896521,27
1,1246,45047,3575896494,3575896522,28
1,1246,45048,3575896494,3575896523,29
1,1246,45049,3575896494,3575896523,29
1,1246,45050,3575896494,3575896524,30
1,1246,45051,3575896494,3575896525,31
1,1246,45052,3575896494,3575896526,32
1,1246,45053,3575896494,3575896527,33
1,1246,45054,3575896494,3575896527,33
1,1246,45055,3575896494,3575896527,33
1,1246,45056,3575896494,3575896528,34
1,1246,45057,3575896494,3575896529,35
1,1246,45058,3575896494,3575896530,36
1,1246,45059,3575896494,3575896530,36
1,1246,45060,3575896494,3575896532,38
1,1246,45061,3575896494,3575896532,38
1,1246,45062,3575896494,3575896534,40
1,1246,45063,3575896494,3575896535,41
1,1246,45064,3575896494,3575896536,42
1,1246,45065,3575896494,3575896537,43
1,1246,45066,3575896494,3575896538,44
1,1246,45067,3575896494,3575896539,45
1,1246,45068,3575896494,3575896539,45
1,1246,45069,3575896494,3575896540,46
1,1246,45070,3575896494,3575896541,47
1,1246,45071,3575896494,3575896542,48
1,1246,45072,3575896494,3575896543,49
1,1246,45073,3575896494,3575896543,49
1,1247,45074,3575896562,3575896562,0
1,1247,45075,3575896562,3575896562,0
1,1247,45076,3575896562,3575896562,0
1,1247,45077,3575896562,3575896562,0
1,1247,45078,3575896562,3575896562,0
1,1247,45079,3575896562,3575896562,0
1,1247,45080,3575896562,3575896562,0
1,1247,45081,3575896562,3575896562,0
1,1247,45082,3575896562,3575896562,0
1,1247,45083,3575896562,3575896562,0
1,1247,45084,3575896562,3575896562,0
1,1247,45085,3575896562,3575896562,0
1,1247,45086,3575896562,3575896562,0
1,1247,45087,3575896562,3575896562,0
1,1247,45088,3575896562,3575896562,0
1,1247,45089,3575896562,3575896562,0
1,1247,45090,3575896562,3575896562,0
1,1247,45091,3575896562,3575896562,0
1,1247,45092,3575896562,3575896562,0
1,1247,45093,3575896562,3575896562,0
1,1247,45094,3575896562,3575896562,0
1,1247,45095,3575896562,3575896562,0
1,1247,45096,3575896562,3575896562,0
1,1247,45097,3575896562,3575896563,1
1,1247,45098,3575896562,3575896563,1
1,1247,45099,3575896562,3575896565,3
1,1247,45100,3575896562,3575896565,3
1,1247,45101,3575896562,3575896571,9
1,1247,45102,3575896562,3575896571,9
1,1247,45103,3575896562,3575896573,11
1,1247,45104,3575896562,3575896573,11
1,1247,45105,3575896562,3575896573,11
1,1247,45106,3575896562,3575896574,12
1,1247,45107,3575896562,3575896575,13
1,1247,45108,3575896562,3575896575,13
1,1247,45109,3575896562,3575896576,14
1,1247,45110,3575896562,3575896576,14
1,1247,45111,3575896562,3575896577,15
1,1247,45112,3575896562,3575896578,16
1,1247,45113,3575896562,3575896578,16
1,1247,45114,3575896562,3575896578,16
1,1247,45115,3575896562,3575896579,17
1,1247,45116,3575896562,3575896579,17
1,1247,45117,3575896562,3575896582,20
1,1247,45118,3575896562,3575896582,20
1,1247,45119,3575896562,3575896584,22
1,1247,45120,3575896562,3575896585,23
1,1247,45121,3575896562,3575896585,23
1,1247,45122,3575896562,3575896585,23
1,1247,45123,3575896562,3575896586,24
1,1247,45124,3575896562,3575896587,25
1,1247,45125,3575896562,3575896589,27
1,1247,45126,3575896562,3575896589,27
1,1247,45127,3575896562,3575896589,27
1,1247,45128,3575896562,3575896591,29
1,1247,45129,3575896562,3575896591,29
1,1247,45130,3575896562,3575896591,29
1,1247,45131,3575896562,3575896592,30
1,1247,45132,3575896562,3575896592,30
1,1247,45133,3575896562,3575896592,30
1,1247,45134,3575896562,3575896592,30
1,1247,45135,3575896562,3575896593,31
1,1247,45136,3575896562,3575896596,34
1,1247,45137,3575896562,3575896596,34
1,1247,45138,3575896562,3575896597,35
1,1247,45139,3575896562,3575896598,36
1,1247,45140,3575896562,3575896599,37
1,1247,45141,3575896562,3575896600,38
1,1247,45142,3575896562,3575896601,39
1,1247,45143,3575896562,3575896601,39
1,1247,45144,3575896562,3575896604,42
1,1247,45145,3575896562,3575896604,42
1,1247,45146,3575896562,3575896604,42
1,1247,45147,3575896562,3575896605,43
1,1247,45148,3575896562,3575896605,43
1,1247,45149,3575896562,3575896606,44
1,1247,45150,3575896562,3575896606,44
1,1247,45151,3575896562,3575896607,45
1,1247,45152,3575896562,3575896608,46
1,1247,45153,3575896562,3575896608,46
1,1247,45154,3575896562,3575896608,46
1,1247,45155,3575896562,3575896610,48
1,1247,45156,3575896562,3575896612,50
1,1248,45157,3575896626,3575896626,0
1,1248,45158,3575896626,3575896626,0
1,1248,45159,3575896626,3575896626,0
1,1248,45160,3575896626,3575896626,0
1,1248,45161,3575896626,3575896626,0
1,1248,45162,3575896626,3575896626,0
1,1248,45163,3575896626,3575896626,0
1,1248,45164,3575896626,3575896626,0
1,1248,45165,3575896626,3575896626,0
1,1248,45166,3575896626,3575896626,0
1,1248,45167,3575896626,3575896626,0
1,1248,45168,3575896626,3575896626,0
1,1248,45169,3575896626,3575896626,0
1,1248,45170,3575896626,3575896626,0
1,1248,45171,3575896626,3575896626,0
1,1248,45172,3575896626,3575896626,0
1,1248,45173,3575896626,3575896626,0
1,1248,45174,3575896626,3575896626,0
1,1248,45175,3575896626,3575896626,0
1,1248,45176,3575896626,3575896626,0
1,1248,45177,3575896626,3575896626,0
1,1248,45178,3575896626,3575896626,0
1,1248,45179,3575896626,3575896626,0
1,1248,45180,3575896626,3575896626,0
1,1248,45181,3575896626,3575896627,1
1,1248,45182,3575896626,3575896627,1
1,1248,45183,3575896626,3575896628,2
1,1248,45184,3575896626,3575896629,3
1,1248,45185,3575896626,3575896629,3
1,1248,45186,3575896626,3575896629,3
1,1248,45187,3575896626,3575896630,4
1,1248,45188,3575896626,3575896631,5
1,1248,45189,3575896626,3575896632,6
1,1248,45190,3575896626,3575896635,9
1,1248,45191,3575896626,3575896635,9
1,1248,45192,3575896626,3575896635,9
1,1248,45193,3575896626,3575896636,10
1,1248,45194,3575896626,3575896636,10
1,1248,45195,3575896626,3575896638,12
1,1248,45196,3575896626,3575896639,13
1,1248,45197,3575896626,3575896641,15
1,1248,45198,3575896626,3575896642,16
1,1248,45199,3575896626,3575896643,17
1,1248,45200,3575896626,3575896644,18
1,1248,45201,3575896626,3575896645,19
1,1248,45202,3575896626,3575896645,19
1,1248,45203,3575896626,3575896646,20
1,1248,45204,3575896626,3575896646,20
1,1248,45205,3575896626,3575896647,21
1,1248,45206,3575896626,3575896648,22
1,1248,45207,3575896626,3575896648,22
1,1248,45208,3575896626,3575896648,22
1,1248,45209,3575896626,3575896648,22
1,1248,45210,3575896626,3575896649,23
1,1248,45211,3575896626,3575896650,24
1,1248,45212,3575896626,3575896652,26
1,1248,45213,3575896626,3575896653,27
1,1248,45214,3575896626,3575896653,27
1,1248,45215,3575896626,3575896654,28
1,1248,45216,3575896626,3575896655,29
1,1248,45217,3575896626,3575896656,30
1,1248,45218,3575896626,3575896658,32
1,1248,45219,3575896626,3575896658,32
1,1248,45220,3575896626,3575896659,33
1,1248,45221,3575896626,3575896662,36
1,1248,45222,3575896626,3575896662,36
1,1248,45223,3575896626,3575896665,39
1,1248,45224,3575896626,3575896666,40
1,1248,45225,3575896626,3575896666,40
1,1248,45226,3575896626,3575896667,41
1,1248,45227,3575896626,3575896667,41
1,1248,45228,3575896626,3575896669,43
1,1248,45229,3575896626,3575896669,43
1,1249,45230,3575896690,3575896690,0
1,1249,45231,3575896690,3575896690,0
1,1249,45232,3575896690,3575896690,0
1,1249,45233,3575896690,3575896690,0
1,1249,45234,3575896690,3575896690,0
1,1249,45235,3575896690,3575896690,0
1,1249,45236,3575896690,3575896690,0
1,1249,45237,3575896690,3575896690,0
1,1249,45238,3575896690,3575896690,0
1,1249,45239,3575896690,3575896690,0
1,1249,45240,3575896690,3575896690,0
1,1249,45241,3575896690,3575896691,1
1,1249,45242,3575896690,3575896692,2
1,1249,45243,3575896690,3575896692,2
1,1249,45244,3575896690,3575896695,5
1,1249,45245,3575896690,3575896695,5
1,1249,45246,3575896690,3575896695,5
1,1249,45247,3575896690,3575896696,6
1,1249,45248,3575896690,3575896696,6
1,1249,45249,3575896690,3575896696,6
1,1249,45250,3575896690,3575896698,8
1,1249,45251,3575896690,3575896698,8
1,1249,45252,3575896690,3575896699,9
1,1249,45253,3575896690,3575896699,9
1,1249,45254,3575896690,3575896700,10
1,1249,45255,3575896690,3575896701,11
1,1249,45256,3575896690,3575896701,11
1,1249,45257,3575896690,3575896701,11
1,1249,45258,3575896690,3575896702,12
1,1249,45259,3575896690,3575896703,13
1,1249,45260,3575896690,3575896703,13
1,1249,45261,3575896690,3575896703,13
1,1249,45262,3575896690,3575896703,13
1,1249,45263,3575896690,3575896704,14
1,1249,45264,3575896690,3575896704,14
1,1249,45265,3575896690,3575896705,15
1,1249,45266,3575896690,3575896705,15
1,1249,45267,3575896690,3575896706,16
1,1249,45268,3575896690,3575896707,17
1,1249,45269,3575896690,3575896707,17
1,1249,45270,3575896690,3575896707,17
1,1249,45271,3575896690,3575896707,17
1,1249,45272,3575896690,3575896709,19
1,1249,45273,3575896690,3575896710,20
1,1249,45274,3575896690,3575896711,21
1,1249,45275,3575896690,3575896711,21
1,1249,45276,3575896690,3575896713,23
1,1249,45277,3575896690,3575896713,23
1,1249,45278,3575896690,3575896715,25
1,1249,45279,3575896690,3575896715,25
1,1249,45280,3575896690,3575896715,25
1,1249,45281,3575896690,3575896715,25
1,1249,45282,3575896690,3575896715,25
1,1249,45283,3575896690,3575896716,26
1,1249,45284,3575896690,3575896718,28
1,1249,45285,3575896690,3575896720,30
1,1249,45286,3575896690,3575896721,31
1,1249,45287,3575896690,3575896721,31
1,1249,45288,3575896690,3575896721,31
1,1249,45289,3575896690,3575896721,31
1,1249,45290,3575896690,3575896722,32
1,1249,45291,3575896690,3575896722,32
1,1249,45292,3575896690,3575896723,33
1,1249,45293,3575896690,3575896725,35
1,1249,45294,3575896690,3575896726,36
1,1249,45295,3575896690,3575896726,36
1,1249,45296,3575896690,3575896727,37
1,1249,45297,3575896690,3575896728,38
1,1249,45298,3575896690,3575896728,38
1,1249,45299,3575896690,3575896728,38
1,1249,45300,3575896690,3575896728,38
1,1249,45301,3575896690,3575896729,39
1,1249,45302,3575896690,3575896730,40
1,1249,45303,3575896690,3575896731,41
1,1249,45304,3575896690,3575896731,41
1,1249,45305,3575896690,3575896732,42
1,1249,45306,3575896690,3575896732,42
1,1249,45307,3575896690,3575896732,42
1,1249,45308,3575896690,3575896733,43
1,1249,45309,3575896690,3575896734,44
1,1249,45310,3575896690,3575896735,45
1,1249,45311,3575896690,3575896735,45
1,1249,45312,3575896690,3575896736,46
1,1249,45313,3575896690,3575896736,46
1,1249,45314,3575896690,3575896737,47
1,1249,45315,3575896690,3575896739,49
1,1249,45316,3575896690,3575896739,49
1,1249,45317,3575896690,3575896739,49
1,1249,45318,3575896690,3575896740,50
1,1250,45319,3575896755,3575896755,0
1,1250,45320,3575896755,3575896755,0
1,1250,45321,3575896755,3575896755,0
1,1250,45322,3575896755,3575896755,0
1,1250,45323,3575896755,3575896755,0
1,1250,45324,3575896755,3575896755,0
1,1250,45325,3575896755,3575896755,0
1,1250,45326,3575896755,3575896755,0
1,1250,45327,3575896755,3575896755,0
1,1250,45328,3575896755,3575896755,0
1,1250,45329,3575896755,3575896755,0
1,1250,45330,3575896755,3575896755,0
1,1250,45331,3575896755,3575896755,0
1,1250,45332,3575896755,3575896755,0
1,1250,45333,3575896755,3575896755,0
1,1250,45334,3575896755,3575896755,0
1,1250,45335,3575896755,3575896755,0
1,1250,45336,3575896755,3575896755,0
1,1250,45337,3575896755,3575896756,1
1,1250,45338,3575896755,3575896758,3
1,1250,45339,3575896755,3575896758,3
1,1250,45340,3575896755,3575896759,4
1,1250,45341,3575896755,3575896760,5
1,1250,45342,3575896755,3575896760,5
1,1250,45343,3575896755,3575896761,6
1,1250,45344,3575896755,3575896762,7
1,1250,45345,3575896755,3575896762,7
1,1250,45346,3575896755,3575896762,7
1,1250,45347,3575896755,3575896763,8
1,1250,45348,3575896755,3575896764,9
1,1250,45349,3575896755,3575896765,10
1,1250,45350,3575896755,3575896770,15
1,1250,45351,3575896755,3575896771,16
1,1250,45352,3575896755,3575896773,18
1,1250,45353,3575896755,3575896773,18
1,1250,45354,3575896755,3575896774,19
1,1250,45355,3575896755,3575896775,20
1,1250,45356,3575896755,3575896775,20
1,1250,45357,3575896755,3575896775,20
1,1250,45358,3575896755,3575896776,21
1,1250,45359,3575896755,3575896778,23
1,1250,45360,3575896755,3575896778,23
1,1250,45361,3575896755,3575896779,24
1,1250,45362,3575896755,3575896779,24
1,1250,45363,3575896755,3575896779,24
1,1250,45364,3575896755,3575896780,25
1,1250,45365,3575896755,3575896781,26
1,1250,45366,3575896755,3575896782,27
1,1250,45367,3575896755,3575896782,27
1,1250,45368,3575896755,3575896783,28
1,1250,45369,3575896755,3575896785,30
1,1250,45370,3575896755,3575896785,30
1,1250,45371,3575896755,3575896785,30
1,1250,45372,3575896755,3575896785,30
1,1250,45373,3575896755,3575896788,33
1,1250,45374,3575896755,3575896789,34
1,1250,45375,3575896755,3575896789,34
1,1250,45376,3575896755,3575896789,34
1,1250,45377,3575896755,3575896790,35
1,1250,45378,3575896755,3575896791,36
1,1250,45379,3575896755,3575896791,36
1,1250,45380,3575896755,3575896792,37
1,1250,45381,3575896755,3575896792,37
1,1250,45382,3575896755,3575896792,37
1,1250,45383,3575896755,3575896793,38
1,1250,45384,3575896755,3575896794,39
1,1250,45385,3575896755,3575896796,41
1,1250,45386,3575896755,3575896796,41
1,1250,45387,3575896755,3575896797,42
1,1250,45388,3575896755,3575896797,42
1,1250,45389,3575896755,3575896799,44
1,1250,45390,3575896755,3575896799,44
1,1250,45391,3575896755,3575896801,46
1,1250,45392,3575896755,3575896801,46
1,1250,45393,3575896755,3575896804,49
1,1250,45394,3575896755,3575896804,49
1,1250,45395,3575896755,3575896805,50
1,1251,45396,3575896818,3575896818,0
1,1251,45397,3575896818,3575896818,0
1,1251,45398,3575896818,3575896818,0
1,1251,45399,3575896818,3575896818,0
1,1251,45400,3575896818,3575896818,0
1,1251,45401,3575896818,3575896818,0
1,1251,45402,3575896818,3575896818,0
1,1251,45403,3575896818,3575896818,0
1,1251,45404,3575896818,3575896818,0
1,1251,45405,3575896818,3575896818,0
1,1251,45406,3575896818,3575896818,0
1,1251,45407,3575896818,3575896818,0
1,1251,45408,3575896818,3575896818,0
1,1251,45409,3575896818,3575896818,0
1,1251,45410,3575896818,3575896818,0
1,1251,45411,3575896818,3575896818,0
1,1251,45412,3575896818,3575896818,0
1,1251,45413,3575896818,3575896818,0
1,1251,45414,3575896818,3575896818,0
1,1251,45415,3575896818,3575896818,0
1,1251,45416,3575896818,3575896818,0
1,1251,45417,3575896818,3575896820,2
1,1251,45418,3575896818,3575896821,3
1,1251,45419,3575896818,3575896821,3
1,1251,45420,3575896818,3575896821,3
1,1251,45421,3575896818,3575896822,4
1,1251,45422,3575896818,3575896823,5
1,1251,45423,3575896818,3575896823,5
1,1251,45424,3575896818,3575896823,5
1,1251,45425,3575896818,3575896823,5
1,1251,45426,3575896818,3575896824,6
1,1251,45427,3575896818,3575896826,8
1,1251,45428,3575896818,3575896827,9
1,1251,45429,3575896818,3575896827,9
1,1251,45430,3575896818,3575896828,10
1,1251,45431,3575896818,3575896828,10
1,1251,45432,3575896818,3575896829,11
1,1251,45433,3575896818,3575896829,11
1,1251,45434,3575896818,3575896830,12
1,1251,45435,3575896818,3575896831,13
1,1251,45436,3575896818,3575896835,17
1,1251,45437,3575896818,3575896835,17
1,1251,45438,3575896818,3575896836,18
1,1251,45439,3575896818,3575896837,19
1,1251,45440,3575896818,3575896838,20
1,1251,45441,3575896818,3575896839,21
1,1251,45442,3575896818,3575896839,21
1,1251,45443,3575896818,3575896840,22
1,1251,45444,3575896818,3575896840,22
1,1251,45445,3575896818,3575896841,23
1,1251,45446,3575896818,3575896842,24
1,1251,45447,3575896818,3575896843,25
1,1251,45448,3575896818,3575896843,25
1,1251,45449,3575896818,3575896844,26
1,1251,45450,3575896818,3575896845,27
1,1251,45451,3575896818,3575896845,27
1,1251,45452,3575896818,3575896847,29
1,1251,45453,3575896818,3575896847,29
1,1251,45454,3575896818,3575896848,30
1,1251,45455,3575896818,3575896848,30
1,1251,45456,3575896818,3575896848,30
1,1251,45457,3575896818,3575896848,30
1,1251,45458,3575896818,3575896849,31
1,1251,45459,3575896818,3575896851,33
1,1251,45460,3575896818,3575896853,35
1,1251,45461,3575896818,3575896853,35
1,1251,45462,3575896818,3575896854,36
1,1251,45463,3575896818,3575896856,38
1,1251,45464,3575896818,3575896856,38
1,1251,45465,3575896818,3575896856,38
1,1251,45466,3575896818,3575896858,40
1,1251,45467,3575896818,3575896859,41
1,1251,45468,3575896818,3575896861,43
1,1251,45469,3575896818,3575896862,44
1,1251,45470,3575896818,3575896864,46
1,1251,45471,3575896818,3575896866,48
1,1251,45472,3575896818,3575896866,48
1,1251,45473,3575896818,3575896867,49
1,1251,45474,3575896818,3575896867,49
1,1251,45475,3575896818,3575896867,49
1,1252,45476,3575896884,3575896884,0
1,1252,45477,3575896884,3575896884,0
1,1252,45478,3575896884,3575896884,0
1,1252,45479,3575896884,3575896884,0
1,1252,45480,3575896884,3575896884,0
1,1252,45481,3575896884,3575896884,0
1,1252,45482,3575896884,3575896885,1
1,1252,45483,3575896884,3575896885,1
1,1252,45484,3575896884,3575896886,2
1,1252,45485,3575896884,3575896886,2
1,1252,45486,3575896884,3575896886,2
1,1252,45487,3575896884,3575896888,4
1,1252,45488,3575896884,3575896888,4
1,1252,45489,3575896884,3575896892,8
1,1252,45490,3575896884,3575896892,8
1,1252,45491,3575896884,3575896895,11
1,1252,45492,3575896884,3575896896,12
1,1252,45493,3575896884,3575896896,12
1,1252,45494,3575896884,3575896896,12
1,1252,45495,3575896884,3575896896,12
1,1252,45496,3575896884,3575896898,14
1,1252,45497,3575896884,3575896898,14
1,1252,45498,3575896884,3575896900,16
1,1252,45499,3575896884,3575896900,16
1,1252,45500,3575896884,3575896901,17
1,1252,45501,3575896884,3575896902,18
1,1252,45502,3575896884,3575896902,18
1,1252,45503,3575896884,3575896903,19
1,1252,45504,3575896884,3575896903,19
1,1252,45505,3575896884,3575896903,19
1,1252,45506,3575896884,3575896903,19
1,1252,45507,3575896884,3575896904,20
1,1252,45508,3575896884,3575896904,20
1,1252,45509,3575896884,3575896905,21
1,1252,45510,3575896884,3575896905,21
1,1252,45511,3575896884,3575896905,21
1,1252,45512,3575896884,3575896908,24
1,1252,45513,3575896884,3575896908,24
1,1252,45514,3575896884,3575896908,24
1,1252,45515,3575896884,3575896908,24
1,1252,45516,3575896884,3575896910,26
1,1252,45517,3575896884,3575896913,29
1,1252,45518,3575896884,3575896913,29
1,1252,45519,3575896884,3575896914,30
1,1252,45520,3575896884,3575896915,31
1,1252,45521,3575896884,3575896915,31
1,1252,45522,3575896884,3575896916,32
1,1252,45523,3575896884,3575896916,32
1,1252,45524,3575896884,3575896917,33
1,1252,45525,3575896884,3575896919,35
1,1252,45526,3575896884,3575896921,37
1,1252,45527,3575896884,3575896921,37
1,1252,45528,3575896884,3575896922,38
1,1252,45529,3575896884,3575896922,38
1,1252,45530,3575896884,3575896922,38
1,1252,45531,3575896884,3575896922,38
1,1252,45532,3575896884,3575896923,39
1,1252,45533,3575896884,3575896926,42
1,1252,45534,3575896884,3575896926,42
1,1252,45535,3575896884,3575896927,43
1,1252,45536,3575896884,3575896928,44
1,1252,45537,3575896884,3575896928,44
1,1252,45538,3575896884,3575896928,44
1,1252,45539,3575896884,3575896929,45
1,1252,45540,3575896884,3575896929,45
1,1252,45541,3575896884,3575896930,46
1,1252,45542,3575896884,3575896931,47
1,1252,45543,3575896884,3575896932,48
1,1252,45544,3575896884,3575896932,48
1,1252,45545,3575896884,3575896932,48
1,1252,45546,3575896884,3575896932,48
1,1252,45547,3575896884,3575896933,49
1,1253,45548,3575896946,3575896946,0
1,1253,45549,3575896946,3575896946,0
1,1253,45550,3575896946,3575896946,0
1,1253,45551,3575896946,3575896946,0
1,1253,45552,3575896946,3575896946,0
1,1253,45553,3575896946,3575896946,0
1,1253,45554,3575896946,3575896946,0
1,1253,45555,3575896946,3575896946,0
1,1253,45556,3575896946,3575896946,0
1,1253,45557,3575896946,3575896946,0
1,1253,45558,3575896946,3575896946,0
1,1253,45559,3575896946,3575896946,0
1,1253,45560,3575896946,3575896946,0
1,1253,45561,3575896946,3575896947,1
1,1253,45562,3575896946,3575896947,1
1,1253,45563,3575896946,3575896947,1
1,1253,45564,3575896946,3575896948,2
1,1253,45565,3575896946,3575896948,2
1,1253,45566,3575896946,3575896949,3
1,1253,45567,3575896946,3575896950,4
1,1253,45568,3575896946,3575896950,4
1,1253,45569,3575896946,3575896951,5
1,1253,45570,3575896946,3575896953,7
1,1253,45571,3575896946,3575896953,7
1,1253,45572,3575896946,3575896953,7
1,1253,45573,3575896946,3575896953,7
1,1253,45574,3575896946,3575896955,9
1,1253,45575,3575896946,3575896956,10
1,1253,45576,3575896946,3575896959,13
1,1253,45577,3575896946,3575896959,13
1,1253,45578,3575896946,3575896960,14
1,1253,45579,3575896946,3575896960,14
1,1253,45580,3575896946,3575896961,15
1,1253,45581,3575896946,3575896962,16
1,1253,45582,3575896946,3575896963,17
1,1253,45583,3575896946,3575896963,17
1,1253,45584,3575896946,3575896963,17
1,1253,45585,3575896946,3575896966,20
1,1253,45586,3575896946,3575896966,20
1,1253,45587,3575896946,3575896971,25
1,1253,45588,3575896946,3575896972,26
1,1253,45589,3575896946,3575896973,27
1,1253,45590,3575896946,3575896973,27
1,1253,45591,3575896946,3575896975,29
1,1253,45592,3575896946,3575896975,29
1,1253,45593,3575896946,3575896975,29
1,1253,45594,3575896946,3575896976,30
1,1253,45595,3575896946,3575896977,31
1,1253,45596,3575896946,3575896978,32
1,1253,45597,3575896946,3575896978,32
1,1253,45598,3575896946,3575896978,32
1,1253,45599,3575896946,3575896979,33
1,1253,45600,3575896946,3575896980,34
1,1253,45601,3575896946,3575896982,36
1,1253,45602,3575896946,3575896984,38
1,1253,45603,3575896946,3575896985,39
1,1253,45604,3575896946,3575896985,39
1,1253,45605,3575896946,3575896986,40
1,1253,45606,3575896946,3575896987,41
1,1253,45607,3575896946,3575896989,43
1,1253,45608,3575896946,3575896989,43
1,1253,45609,3575896946,3575896990,44
1,1253,45610,3575896946,3575896991,45
1,1253,45611,3575896946,3575896991,45
1,1253,45612,3575896946,3575896992,46
1,1253,45613,3575896946,3575896993,47
1,1253,45614,3575896946,3575896993,47
1,1253,45615,3575896946,3575896993,47
1,1253,45616,3575896946,3575896993,47
1,1253,45617,3575896946,3575896994,48
1,1253,45618,3575896946,3575896996,50
1,1254,45619,3575897014,3575897014,0
1,1254,45620,3575897014,3575897014,0
1,1254,45621,3575897014,3575897014,0
1,1254,45622,3575897014,3575897014,0
1,1254,45623,3575897014,3575897014,0
1,1254,45624,3575897014,3575897014,0
1,1254,45625,3575897014,3575897014,0
1,1254,45626,3575897014,3575897014,0
1,1254,45627,3575897014,3575897014,0
1,1254,45628,3575897014,3575897014,0
1,1254,45629,3575897014,3575897014,0
1,1254,45630,3575897014,3575897014,0
1,1254,45631,3575897014,3575897014,0
1,1254,45632,3575897014,3575897014,0
1,1254,45633,3575897014,3575897014,0
1,1254,45634,3575897014,3575897014,0
1,1254,45635,3575897014,3575897014,0
1,1254,45636,3575897014,3575897014,0
1,1254,45637,3575897014,3575897014,0
1,1254,45638,3575897014,3575897014,0
1,1254,45639,3575897014,3575897014,0
1,1254,45640,3575897014,3575897014,0
1,1254,45641,3575897014,3575897014,0
1,1254,45642,3575897014,3575897015,1
1,1254,45643,3575897014,3575897016,2
1,1254,45644,3575897014,3575897016,2
1,1254,45645,3575897014,3575897017,3
1,1254,45646,3575897014,3575897017,3
1,1254,45647,3575897014,3575897017,3
1,1254,45648,3575897014,3575897018,4
1,1254,45649,3575897014,3575897021,7
1,1254,45650,3575897014,3575897021,7
1,1254,45651,3575897014,3575897022,8
1,1254,45652,3575897014,3575897022,8
1,1254,45653,3575897014,3575897023,9
1,1254,45654,3575897014,3575897023,9
1,1254,45655,3575897014,3575897024,10
1,1254,45656,3575897014,3575897026,12
1,1254,45657,3575897014,3575897028,14
1,1254,45658,3575897014,3575897028,14
1,1254,45659,3575897014,3575897028,14
1,1254,45660,3575897014,3575897029,15
1,1254,45661,3575897014,3575897029,15
1,1254,45662,3575897014,3575897029,15
1,1254,45663,3575897014,3575897029,15
1,1254,45664,3575897014,3575897030,16
1,1254,45665,3575897014,3575897032,18
1,1254,45666,3575897014,3575897035,21
1,1254,45667,3575897014,3575897035,21
1,1254,45668,3575897014,3575897036,22
1,1254,45669,3575897014,3575897036,22
1,1254,45670,3575897014,3575897036,22
1,1254,45671,3575897014,3575897039,25
1,1254,45672,3575897014,3575897039,25
1,1254,45673,3575897014,3575897039,25
1,1254,45674,3575897014,3575897040,26
1,1254,45675,3575897014,3575897040,26
1,1254,45676,3575897014,3575897040,26
1,1254,45677,3575897014,3575897042,28
1,1254,45678,3575897014,3575897043,29
1,1254,45679,3575897014,3575897044,30
1,1254,45680,3575897014,3575897044,30
1,1254,45681,3575897014,3575897045,31
1,1254,45682,3575897014,3575897045,31
1,1254,45683,3575897014,3575897047,33
1,1254,45684,3575897014,3575897047,33
1,1254,45685,3575897014,3575897047,33
1,1254,45686,3575897014,3575897047,33
1,1254,45687,3575897014,3575897048,34
1,1254,45688,3575897014,3575897048,34
1,1254,45689,3575897014,3575897049,35
1,1254,45690,3575897014,3575897049,35
1,1254,45691,3575897014,3575897050,36
1,1254,45692,3575897014,3575897051,37
1,1254,45693,3575897014,3575897053,39
1,1254,45694,3575897014,3575897053,39
1,1254,45695,3575897014,3575897053,39
1,1254,45696,3575897014,3575897054,40
1,1254,45697,3575897014,3575897055,41
1,1254,45698,3575897014,3575897056,42
1,1254,45699,3575897014,3575897057,43
1,1254,45700,3575897014,3575897058,44
1,1254,45701,3575897014,3575897060,46
1,1254,45702,3575897014,3575897062,48
1,1254,45703,3575897014,3575897062,48
1,1255,45704,3575897078,3575897078,0
1,1255,45705,3575897078,3575897078,0
1,1255,45706,3575897078,3575897078,0
1,1255,45707,3575897078,3575897078,0
1,1255,45708,3575897078,3575897078,0
1,1255,45709,3575897078,3575897078,0
1,1255,45710,3575897078,3575897078,0
1,1255,45711,3575897078,3575897080,2
1,1255,45712,3575897078,3575897081,3
1,1255,45713,3575897078,3575897081,3
1,1255,45714,3575897078,3575897083,5
1,1255,45715,3575897078,3575897084,6
1,1255,45716,3575897078,3575897085,7
1,1255,45717,3575897078,3575897085,7
1,1255,45718,3575897078,3575897086,8
1,1255,45719,3575897078,3575897086,8
1,1255,45720,3575897078,3575897088,10
1,1255,45721,3575897078,3575897091,13
1,1255,45722,3575897078,3575897092,14
1,1255,45723,3575897078,3575897094,16
1,1255,45724,3575897078,3575897096,18
1,1255,45725,3575897078,3575897096,18
1,1255,45726,3575897078,3575897096,18
1,1255,45727,3575897078,3575897096,18
1,1255,45728,3575897078,3575897096,18
1,1255,45729,3575897078,3575897097,19
1,1255,45730,3575897078,3575897098,20
1,1255,45731,3575897078,3575897100,22
1,1255,45732,3575897078,3575897100,22
1,1255,45733,3575897078,3575897101,23
1,1255,45734,3575897078,3575897102,24
1,1255,45735,3575897078,3575897102,24
1,1255,45736,3575897078,3575897102,24
1,1255,45737,3575897078,3575897103,25
1,1255,45738,3575897078,3575897103,25
1,1255,45739,3575897078,3575897103,25
1,1255,45740,3575897078,3575897104,26
1,1255,45741,3575897078,3575897104,26
1,1255,45742,3575897078,3575897104,26
1,1255,45743,3575897078,3575897105,27
1,1255,45744,3575897078,3575897105,27
1,1255,45745,3575897078,3575897105,27
1,1255,45746,3575897078,3575897107,29
1,1255,45747,3575897078,3575897107,29
1,1255,45748,3575897078,3575897108,30
1,1255,45749,3575897078,3575897108,30
1,1255,45750,3575897078,3575897108,30
1,1255,45751,3575897078,3575897111,33
1,1255,45752,3575897078,3575897113,35
1,1255,45753,3575897078,3575897114,36
1,1255,45754,3575897078,3575897114,36
1,1255,45755,3575897078,3575897115,37
1,1255,45756,3575897078,3575897116,38
1,1255,45757,3575897078,3575897117,39
1,1255,45758,3575897078,3575897121,43
1,1255,45759,3575897078,3575897121,43
1,1255,45760,3575897078,3575897121,43
1,1255,45761,3575897078,3575897122,44
1,1255,45762,3575897078,3575897122,44
1,1255,45763,3575897078,3575897122,44
1,1255,45764,3575897078,3575897123,45
1,1255,45765,3575897078,3575897123,45
1,1255,45766,3575897078,3575897125,47
1,1255,45767,3575897078,3575897126,48
1,1255,45768,3575897078,3575897128,50
1,1256,45769,3575897142,3575897142,0
1,1256,45770,3575897142,3575897142,0
1,1256,45771,3575897142,3575897142,0
1,1256,45772,3575897142,3575897142,0
1,1256,45773,3575897142,3575897142,0
1,1256,45774,3575897142,3575897142,0
1,1256,45775,3575897142,3575897142,0
1,1256,45776,3575897142,3575897142,0
1,1256,45777,3575897142,3575897142,0
1,1256,45778,3575897142,3575897142,0
1,1256,45779,3575897142,3575897142,0
1,1256,45780,3575897142,3575897142,0
1,1256,45781,3575897142,3575897142,0
1,1256,45782,3575897142,3575897142,0
1,1256,45783,3575897142,3575897142,0
1,1256,45784,3575897142,3575897142,0
1,1256,45785,3575897142,3575897142,0
1,1256,45786,3575897142,3575897142,0
1,1256,45787,3575897142,3575897142,0
1,1256,45788,3575897142,3575897142,0
1,1256,45789,3575897142,3575897142,0
1,1256,45790,3575897142,3575897144,2
1,1256,45791,3575897142,3575897144,2
1,1256,45792,3575897142,3575897145,3
1,1256,45793,3575897142,3575897147,5
1,1256,45794,3575897142,3575897147,5
1,1256,45795,3575897142,3575897147,5
1,1256,45796,3575897142,3575897148,6
1,1256,45797,3575897142,3575897149,7
1,1256,45798,3575897142,3575897149,7
1,1256,45799,3575897142,3575897150,8
1,1256,45800,3575897142,3575897150,8
1,1256,45801,3575897142,3575897150,8
1,1256,45802,3575897142,3575897153,11
1,1256,45803,3575897142,3575897153,11
1,1256,45804,3575897142,3575897154,12
1,1256,45805,3575897142,3575897154,12
1,1256,45806,3575897142,3575897154,12
1,1256,45807,3575897142,3575897156,14
1,1256,45808,3575897142,3575897159,17
1,1256,45809,3575897142,3575897159,17
1,1256,45810,3575897142,3575897160,18
1,1256,45811,3575897142,3575897160,18
1,1256,45812,3575897142,3575897162,20
1,1256,45813,3575897142,3575897163,21
1,1256,45814,3575897142,3575897163,21
1,1256,45815,3575897142,3575897164,22
1,1256,45816,3575897142,3575897164,22
1,1256,45817,3575897142,3575897167,25
1,1256,45818,3575897142,3575897172,30
1,1256,45819,3575897142,3575897173,31
1,1256,45820,3575897142,3575897173,31
1,1256,45821,3575897142,3575897174,32
1,1256,45822,3575897142,3575897175,33
1,1256,45823,3575897142,3575897175,33
1,1256,45824,3575897142,3575897176,34
1,1256,45825,3575897142,3575897176,34
1,1256,45826,3575897142,3575897176,34
1,1256,45827,3575897142,3575897178,36
1,1256,45828,3575897142,3575897178,36
1,1256,45829,3575897142,3575897179,37
1,1256,45830,3575897142,3575897179,37
1,1256,45831,3575897142,3575897180,38
1,1256,45832,3575897142,3575897181,39
1,1256,45833,3575897142,3575897182,40
1,1256,45834,3575897142,3575897185,43
1,1256,45835,3575897142,3575897185,43
1,1256,45836,3575897142,3575897185,43
1,1256,45837,3575897142,3575897185,43
1,1256,45838,3575897142,3575897187,45
1,1256,45839,3575897142,3575897189,47
1,1256,45840,3575897142,3575897189,47
1,1256,45841,3575897142,3575897190,48
1,1256,45842,3575897142,3575897192,50
1,1256,45843,3575897142,3575897192,50
1,1257,45844,3575897209,3575897209,0
1,1257,45845,3575897209,3575897210,1
1,1257,45846,3575897209,3575897210,1
1,1257,45847,3575897209,3575897210,1
1,1257,45848,3575897209,3575897210,1
1,1257,45849,3575897209,3575897210,1
1,1257,45850,3575897209,3575897210,1
1,1257,45851,3575897209,3575897210,1
1,1257,45852,3575897209,3575897210,1
1,1257,45853,3575897209,3575897210,1
1,1257,45854,3575897209,3575897210,1
1,1257,45855,3575897209,3575897210,1
1,1257,45856,3575897209,3575897210,1
1,1257,45857,3575897209,3575897210,1
1,1257,45858,3575897209,3575897210,1
1,1257,45859,3575897209,3575897210,1
1,1257,45860,3575897209,3575897210,1
1,1257,45861,3575897209,3575897210,1
1,1257,45862,3575897209,3575897210,1
1,1257,45863,3575897209,3575897210,1
1,1257,45864,3575897209,3575897210,1
1,1257,45865,3575897209,3575897210,1
1,1257,45866,3575897209,3575897210,1
1,1257,45867,3575897209,3575897212,3
1,1257,45868,3575897209,3575897212,3
1,1257,45869,3575897209,3575897212,3
1,1257,45870,3575897209,3575897213,4
1,1257,45871,3575897209,3575897213,4
1,1257,45872,3575897209,3575897213,4
1,1257,45873,3575897209,3575897214,5
1,1257,45874,3575897209,3575897215,6
1,1257,45875,3575897209,3575897215,6
1,1257,45876,3575897209,3575897215,6
1,1257,45877,3575897209,3575897216,7
1,1257,45878,3575897209,3575897216,7
1,1257,45879,3575897209,3575897217,8
1,1257,45880,3575897209,3575897217,8
1,1257,45881,3575897209,3575897218,9
1,1257,45882,3575897209,3575897218,9
1,1257,45883,3575897209,3575897219,10
1,1257,45884,3575897209,3575897220,11
1,1257,45885,3575897209,3575897221,12
1,1257,45886,3575897209,3575897221,12
1,1257,45887,3575897209,3575897222,13
1,1257,45888,3575897209,3575897223,14
1,1257,45889,3575897209,3575897223,14
1,1257,45890,3575897209,3575897223,14
1,1257,45891,3575897209,3575897224,15
1,1257,45892,3575897209,3575897225,16
1,1257,45893,3575897209,3575897227,18
1,1257,45894,3575897209,3575897228,19
1,1257,45895,3575897209,3575897228,19
1,1257,45896,3575897209,3575897228,19
1,1257,45897,3575897209,3575897229,20
1,1257,45898,3575897209,3575897229,20
1,1257,45899,3575897209,3575897230,21
1,1257,45900,3575897209,3575897231,22
1,1257,45901,3575897209,3575897231,22
1,1257,45902,3575897209,3575897232,23
1,1257,45903,3575897209,3575897234,25
1,1257,45904,3575897209,3575897235,26
1,1257,45905,3575897209,3575897236,27
1,1257,45906,3575897209,3575897236,27
1,1257,45907,3575897209,3575897237,28
1,1257,45908,3575897209,3575897238,29
1,1257,45909,3575897209,3575897239,30
1,1257,45910,3575897209,3575897240,31
1,1257,45911,3575897209,3575897241,32
1,1257,45912,3575897209,3575897241,32
1,1257,45913,3575897209,3575897243,34
1,1257,45914,3575897209,3575897244,35
1,1257,45915,3575897209,3575897244,35
1,1257,45916,3575897209,3575897245,36
1,1257,45917,3575897209,3575897245,36
1,1257,45918,3575897209,3575897245,36
1,1257,45919,3575897209,3575897247,38
1,1257,45920,3575897209,3575897247,38
1,1257,45921,3575897209,3575897248,39
1,1257,45922,3575897209,3575897248,39
1,1257,45923,3575897209,3575897248,39
1,1257,45924,3575897209,3575897249,40
1,1257,45925,3575897209,3575897249,40
1,1257,45926,3575897209,3575897249,40
1,1257,45927,3575897209,3575897249,40
1,1257,45928,3575897209,3575897251,42
1,1257,45929,3575897209,3575897253,44
1,1257,45930,3575897209,3575897253,44
1,1257,45931,3575897209,3575897253,44
1,1257,45932,3575897209,3575897254,45
1,1257,45933,3575897209,3575897255,46
1,1257,45934,3575897209,3575897256,47
1,1257,45935,3575897209,3575897257,48
1,1258,45936,3575897271,3575897272,1
1,1258,45937,3575897271,3575897272,1
1,1258,45938,3575897271,3575897272,1
1,1258,45939,3575897271,3575897272,1
1,1258,45940,3575897271,3575897272,1
1,1258,45941,3575897271,3575897272,1
1,1258,45942,3575897271,3575897272,1
1,1258,45943,3575897271,3575897272,1
1,1258,45944,3575897271,3575897272,1
1,1258,45945,3575897271,3575897272,1
1,1258,45946,3575897271,3575897280,9
1,1258,45947,3575897271,3575897280,9
1,1258,45948,3575897271,3575897281,10
1,1258,45949,3575897271,3575897284,13
1,1258,45950,3575897271,3575897284,13
1,1258,45951,3575897271,3575897285,14
1,1258,45952,3575897271,3575897285,14
1,1258,45953,3575897271,3575897285,14
1,1258,45954,3575897271,3575897286,15
1,1258,45955,3575897271,3575897286,15
1,1258,45956,3575897271,3575897286,15
1,1258,45957,3575897271,3575897287,16
1,1258,45958,3575897271,3575897288,17
1,1258,45959,3575897271,3575897292,21
1,1258,45960,3575897271,3575897292,21
1,1258,45961,3575897271,3575897293,22
1,1258,45962,3575897271,3575897295,24
1,1258,45963,3575897271,3575897295,24
1,1258,45964,3575897271,3575897296,25
1,1258,45965,3575897271,3575897296,25
1,1258,45966,3575897271,3575897296,25
1,1258,45967,3575897271,3575897297,26
1,1258,45968,3575897271,3575897299,28
1,1258,45969,3575897271,3575897299,28
1,1258,45970,3575897271,3575897300,29
1,1258,45971,3575897271,3575897301,30
1,1258,45972,3575897271,3575897301,30
1,1258,45973,3575897271,3575897301,30
1,1258,45974,3575897271,3575897302,31
1,1258,45975,3575897271,3575897302,31
1,1258,45976,3575897271,3575897303,32
1,1258,45977,3575897271,3575897303,32
1,1258,45978,3575897271,3575897304,33
1,1258,45979,3575897271,3575897304,33
1,1258,45980,3575897271,3575897304,33
1,1258,45981,3575897271,3575897304,33
1,1258,45982,3575897271,3575897305,34
1,1258,45983,3575897271,3575897306,35
1,1258,45984,3575897271,3575897307,36
1,1258,45985,3575897271,3575897307,36
1,1258,45986,3575897271,3575897309,38
1,1258,45987,3575897271,3575897309,38
1,1258,45988,3575897271,3575897310,39
1,1258,45989,3575897271,3575897310,39
1,1258,45990,3575897271,3575897311,40
1,1258,45991,3575897271,3575897312,41
1,1258,45992,3575897271,3575897314,43
1,1258,45993,3575897271,3575897314,43
1,1258,45994,3575897271,3575897315,44
1,1258,45995,3575897271,3575897317,46
1,1258,45996,3575897271,3575897317,46
1,1258,45997,3575897271,3575897317,46
1,1258,45998,3575897271,3575897318,47
1,1258,45999,3575897271,3575897321,50
1,1259,46000,3575897337,3575897337,0
1,1259,46001,3575897337,3575897337,0
1,1259,46002,3575897337,3575897337,0
1,1259,46003,3575897337,3575897337,0
1,1259,46004,3575897337,3575897337,0
1,1259,46005,3575897337,3575897337,0
1,1259,46006,3575897337,3575897337,0
1,1259,46007,3575897337,3575897337,0
1,1259,46008,3575897337,3575897337,0
1,1259,46009,3575897337,3575897337,0
1,1259,46010,3575897337,3575897337,0
1,1259,46011,3575897337,3575897337,0
1,1259,46012,3575897337,3575897337,0
1,1259,46013,3575897337,3575897337,0
1,1259,46014,3575897337,3575897337,0
1,1259,46015,3575897337,3575897337,0
1,1259,46016,3575897337,3575897337,0
1,1259,46017,3575897337,3575897337,0
1,1259,46018,3575897337,3575897337,0
1,1259,46019,3575897337,3575897337,0
1,1259,46020,3575897337,3575897337,0
1,1259,46021,3575897337,3575897337,0
1,1259,46022,3575897337,3575897337,0
1,1259,46023,3575897337,3575897337,0
1,1259,46024,3575897337,3575897337,0
1,1259,46025,3575897337,3575897338,1
1,1259,46026,3575897337,3575897339,2
1,1259,46027,3575897337,3575897340,3
1,1259,46028,3575897337,3575897340,3
1,1259,46029,3575897337,3575897340,3
1,1259,46030,3575897337,3575897341,4
1,1259,46031,3575897337,3575897341,4
1,1259,46032,3575897337,3575897344,7
1,1259,46033,3575897337,3575897345,8
1,1259,46034,3575897337,3575897345,8
1,1259,46035,3575897337,3575897347,10
1,1259,46036,3575897337,3575897348,11
1,1259,46037,3575897337,3575897348,11
1,1259,46038,3575897337,3575897349,12
1,1259,46039,3575897337,3575897350,13
1,1259,46040,3575897337,3575897350,13
1,1259,46041,3575897337,3575897350,13
1,1259,46042,3575897337,3575897353,16
1,1259,46043,3575897337,3575897353,16
1,1259,46044,3575897337,3575897353,16
1,1259,46045,3575897337,3575897354,17
1,1259,46046,3575897337,3575897354,17
1,1259,46047,3575897337,3575897355,18
1,1259,46048,3575897337,3575897357,20
1,1259,46049,3575897337,3575897358,21
1,1259,46050,3575897337,3575897359,22
1,1259,46051,3575897337,3575897359,22
1,1259,46052,3575897337,3575897360,23
1,1259,46053,3575897337,3575897362,25
1,1259,46054,3575897337,3575897362,25
1,1259,46055,3575897337,3575897363,26
1,1259,46056,3575897337,3575897364,27
1,1259,46057,3575897337,3575897364,27
1,1259,46058,3575897337,3575897366,29
1,1259,46059,3575897337,3575897366,29
1,1259,46060,3575897337,3575897366,29
1,1259,46061,3575897337,3575897372,35
1,1259,46062,3575897337,3575897373,36
1,1259,46063,3575897337,3575897374,37
1,1259,46064,3575897337,3575897374,37
1,1259,46065,3575897337,3575897375,38
1,1259,46066,3575897337,3575897375,38
1,1259,46067,3575897337,3575897376,39
1,1259,46068,3575897337,3575897376,39
1,1259,46069,3575897337,3575897377,40
1,1259,46070,3575897337,3575897378,41
1,1259,46071,3575897337,3575897378,41
1,1259,46072,3575897337,3575897379,42
1,1259,46073,3575897337,3575897381,44
1,1259,46074,3575897337,3575897382,45
1,1259,46075,3575897337,3575897382,45
1,1259,46076,3575897337,3575897384,47
1,1259,46077,3575897337,3575897385,48
1,1259,46078,3575897337,3575897385,48
1,1259,46079,3575897337,3575897385,48
1,1259,46080,3575897337,3575897386,49
1,1260,46081,3575897402,3575897402,0
1,1260,46082,3575897402,3575897402,0
1,1260,46083,3575897402,3575897402,0
1,1260,46084,3575897402,3575897402,0
1,1260,46085,3575897402,3575897402,0
1,1260,46086,3575897402,3575897402,0
1,1260,46087,3575897402,3575897402,0
1,1260,46088,3575897402,3575897402,0
1,1260,46089,3575897402,3575897402,0
1,1260,46090,3575897402,3575897402,0
1,1260,46091,3575897402,3575897402,0
1,1260,46092,3575897402,3575897402,0
1,1260,46093,3575897402,3575897402,0
1,1260,46094,3575897402,3575897402,0
1,1260,46095,3575897402,3575897402,0
1,1260,46096,3575897402,3575897402,0
1,1260,46097,3575897402,3575897402,0
1,1260,46098,3575897402,3575897402,0
1,1260,46099,3575897402,3575897403,1
1,1260,46100,3575897402,3575897405,3
1,1260,46101,3575897402,3575897405,3
1,1260,46102,3575897402,3575897405,3
1,1260,46103,3575897402,3575897406,4
1,1260,46104,3575897402,3575897406,4
1,1260,46105,3575897402,3575897406,4
1,1260,46106,3575897402,3575897407,5
1,1260,46107,3575897402,3575897408,6
1,1260,46108,3575897402,3575897409,7
1,1260,46109,3575897402,3575897409,7
1,1260,46110,3575897402,3575897410,8
1,1260,46111,3575897402,3575897412,10
1,1260,46112,3575897402,3575897413,11
1,1260,46113,3575897402,3575897413,11
1,1260,46114,3575897402,3575897413,11
1,1260,46115,3575897402,3575897414,12
1,1260,46116,3575897402,3575897414,12
1,1260,46117,3575897402,3575897416,14
1,1260,46118,3575897402,3575897416,14
1,1260,46119,3575897402,3575897416,14
1,1260,46120,3575897402,3575897416,14
1,1260,46121,3575897402,3575897417,15
1,1260,46122,3575897402,3575897417,15
1,1260,46123,3575897402,3575897417,15
1,1260,46124,3575897402,3575897418,16
1,1260,46125,3575897402,3575897421,19
1,1260,46126,3575897402,3575897421,19
1,1260,46127,3575897402,3575897422,20
1,1260,46128,3575897402,3575897423,21
1,1260,46129,3575897402,3575897423,21
1,1260,46130,3575897402,3575897424,22
1,1260,46131,3575897402,3575897424,22
1,1260,46132,3575897402,3575897425,23
1,1260,46133,3575897402,3575897425,23
1,1260,46134,3575897402,3575897427,25
1,1260,46135,3575897402,3575897429,27
1,1260,46136,3575897402,3575897429,27
1,1260,46137,3575897402,3575897429,27
1,1260,46138,3575897402,3575897429,27
1,1260,46139,3575897402,3575897430,28
1,1260,46140,3575897402,3575897430,28
1,1260,46141,3575897402,3575897431,29
1,1260,46142,3575897402,3575897432,30
1,1260,46143,3575897402,3575897433,31
1,1260,46144,3575897402,3575897435,33
1,1260,46145,3575897402,3575897435,33
1,1260,46146,3575897402,3575897435,33
1,1260,46147,3575897402,3575897436,34
1,1260,46148,3575897402,3575897437,35
1,1260,46149,3575897402,3575897438,36
1,1260,46150,3575897402,3575897440,38
1,1260,46151,3575897402,3575897441,39
1,1260,46152,3575897402,3575897442,40
1,1260,46153,3575897402,3575897443,41
1,1260,46154,3575897402,3575897444,42
1,1260,46155,3575897402,3575897444,42
1,1260,46156,3575897402,3575897444,42
1,1260,46157,3575897402,3575897445,43
1,1260,46158,3575897402,3575897445,43
1,1260,46159,3575897402,3575897447,45
1,1260,46160,3575897402,3575897448,46
1,1260,46161,3575897402,3575897448,46
1,1260,46162,3575897402,3575897448,46
1,1260,46163,3575897402,3575897448,46
1,1260,46164,3575897402,3575897449,47
1,1260,46165,3575897402,3575897450,48
1,1260,46166,3575897402,3575897450,48
1,1260,46167,3575897402,3575897451,49
1,1260,46168,3575897402,3575897451,49
1,1261,46169,3575897468,3575897468,0
1,1261,46170,3575897468,3575897468,0
1,1261,46171,3575897468,3575897468,0
1,1261,46172,3575897468,3575897468,0
1,1261,46173,3575897468,3575897468,0
1,1261,46174,3575897468,3575897468,0
1,1261,46175,3575897468,3575897468,0
1,1261,46176,3575897468,3575897468,0
1,1261,46177,3575897468,3575897468,0
1,1261,46178,3575897468,3575897468,0
1,1261,46179,3575897468,3575897468,0
1,1261,46180,3575897468,3575897468,0
1,1261,46181,3575897468,3575897468,0
1,1261,46182,3575897468,3575897468,0
1,1261,46183,3575897468,3575897468,0
1,1261,46184,3575897468,3575897468,0
1,1261,46185,3575897468,3575897468,0
1,1261,46186,3575897468,3575897468,0
1,1261,46187,3575897468,3575897468,0
1,1261,46188,3575897468,3575897471,3
1,1261,46189,3575897468,3575897472,4
1,1261,46190,3575897468,3575897480,12
1,1261,46191,3575897468,3575897481,13
1,1261,46192,3575897468,3575897484,16
1,1261,46193,3575897468,3575897485,17
1,1261,46194,3575897468,3575897485,17
1,1261,46195,3575897468,3575897485,17
1,1261,46196,3575897468,3575897485,17
1,1261,46197,3575897468,3575897487,19
1,1261,46198,3575897468,3575897488,20
1,1261,46199,3575897468,3575897491,23
1,1261,46200,3575897468,3575897493,25
1,1261,46201,3575897468,3575897494,26
1,1261,46202,3575897468,3575897495,27
1,1261,46203,3575897468,3575897496,28
1,1261,46204,3575897468,3575897496,28
1,1261,46205,3575897468,3575897496,28
1,1261,46206,3575897468,3575897496,28
1,1261,46207,3575897468,3575897498,30
1,1261,46208,3575897468,3575897500,32
1,1261,46209,3575897468,3575897500,32
1,1261,46210,3575897468,3575897501,33
1,1261,46211,3575897468,3575897501,33
1,1261,46212,3575897468,3575897502,34
1,1261,46213,3575897468,3575897503,35
1,1261,46214,3575897468,3575897503,35
1,1261,46215,3575897468,3575897503,35
1,1261,46216,3575897468,3575897504,36
1,1261,46217,3575897468,3575897504,36
1,1261,46218,3575897468,3575897505,37
1,1261,46219,3575897468,3575897505,37
1,1261,46220,3575897468,3575897505,37
1,1261,46221,3575897468,3575897505,37
1,1261,46222,3575897468,3575897507,39
1,1261,46223,3575897468,3575897507,39
1,1261,46224,3575897468,3575897507,39
1,1261,46225,3575897468,3575897508,40
1,1261,46226,3575897468,3575897509,41
1,1261,46227,3575897468,3575897510,42
1,1261,46228,3575897468,3575897510,42
1,1261,46229,3575897468,3575897510,42
1,1261,46230,3575897468,3575897511,43
1,1261,46231,3575897468,3575897512,44
1,1261,46232,3575897468,3575897514,46
1,1261,46233,3575897468,3575897515,47
1,1261,46234,3575897468,3575897517,49
1,1261,46235,3575897468,3575897517,49
1,1262,46236,3575897531,3575897531,0
1,1262,46237,3575897531,3575897531,0
1,1262,46238,3575897531,3575897531,0
1,1262,46239,3575897531,3575897531,0
1,1262,46240,3575897531,3575897531,0
1,1262,46241,3575897531,3575897531,0
1,1262,46242,3575897531,3575897531,0
1,1262,46243,3575897531,3575897531,0
1,1262,46244,3575897531,3575897531,0
1,1262,46245,3575897531,3575897531,0
1,1262,46246,3575897531,3575897531,0
1,1262,46247,3575897531,3575897531,0
1,1262,46248,3575897531,3575897531,0
1,1262,46249,3575897531,3575897531,0
1,1262,46250,3575897531,3575897531,0
1,1262,46251,3575897531,3575897531,0
1,1262,46252,3575897531,3575897531,0
1,1262,46253,3575897531,3575897531,0
1,1262,46254,3575897531,3575897531,0
1,1262,46255,3575897531,3575897531,0
1,1262,46256,3575897531,3575897531,0
1,1262,46257,3575897531,3575897531,0
1,1262,46258,3575897531,3575897531,0
1,1262,46259,3575897531,3575897531,0
1,1262,46260,3575897531,3575897532,1
1,1262,46261,3575897531,3575897532,1
1,1262,46262,3575897531,3575897533,2
1,1262,46263,3575897531,3575897534,3
1,1262,46264,3575897531,3575897535,4
1,1262,46265,3575897531,3575897537,6
1,1262,46266,3575897531,3575897538,7
1,1262,46267,3575897531,3575897538,7
1,1262,46268,3575897531,3575897539,8
1,1262,46269,3575897531,3575897539,8
1,1262,46270,3575897531,3575897539,8
1,1262,46271,3575897531,3575897540,9
1,1262,46272,3575897531,3575897543,12
1,1262,46273,3575897531,3575897544,13
1,1262,46274,3575897531,3575897545,14
1,1262,46275,3575897531,3575897547,16
1,1262,46276,3575897531,3575897548,17
1,1262,46277,3575897531,3575897549,18
1,1262,46278,3575897531,3575897549,18
1,1262,46279,3575897531,3575897550,19
1,1262,46280,3575897531,3575897550,19
1,1262,46281,3575897531,3575897552,21
1,1262,46282,3575897531,3575897552,21
1,1262,46283,3575897531,3575897552,21
1,1262,46284,3575897531,3575897553,22
1,1262,46285,3575897531,3575897555,24
1,1262,46286,3575897531,3575897558,27
1,1262,46287,3575897531,3575897558,27
1,1262,46288,3575897531,3575897558,27
1,1262,46289,3575897531,3575897559,28
1,1262,46290,3575897531,3575897560,29
1,1262,46291,3575897531,3575897560,29
1,1262,46292,3575897531,3575897560,29
1,1262,46293,3575897531,3575897562,31
1,1262,46294,3575897531,3575897562,31
1,1262,46295,3575897531,3575897563,32
1,1262,46296,3575897531,3575897564,33
1,1262,46297,3575897531,3575897565,34
1,1262,46298,3575897531,3575897566,35
1,1262,46299,3575897531,3575897571,40
1,1262,46300,3575897531,3575897571,40
1,1262,46301,3575897531,3575897573,42
1,1262,46302,3575897531,3575897573,42
1,1262,46303,3575897531,3575897574,43
1,1262,46304,3575897531,3575897574,43
1,1262,46305,3575897531,3575897575,44
1,1262,46306,3575897531,3575897575,44
1,1262,46307,3575897531,3575897575,44
1,1262,46308,3575897531,3575897575,44
1,1262,46309,3575897531,3575897578,47
1,1262,46310,3575897531,3575897578,47
1,1262,46311,3575897531,3575897579,48
1,1263,46312,3575897597,3575897597,0
1,1263,46313,3575897597,3575897597,0
1,1263,46314,3575897597,3575897597,0
1,1263,46315,3575897597,3575897597,0
1,1263,46316,3575897597,3575897597,0
1,1263,46317,3575897597,3575897597,0
1,1263,46318,3575897597,3575897597,0
1,1263,46319,3575897597,3575897597,0
1,1263,46320,3575897597,3575897597,0
1,1263,46321,3575897597,3575897597,0
1,1263,46322,3575897597,3575897597,0
1,1263,46323,3575897597,3575897597,0
1,1263,46324,3575897597,3575897597,0
1,1263,46325,3575897597,3575897597,0
1,1263,46326,3575897597,3575897597,0
1,1263,46327,3575897597,3575897597,0
1,1263,46328,3575897597,3575897597,0
1,1263,46329,3575897597,3575897597,0
1,1263,46330,3575897597,3575897597,0
1,1263,46331,3575897597,3575897597,0
1,1263,46332,3575897597,3575897597,0
1,1263,46333,3575897597,3575897597,0
1,1263,46334,3575897597,3575897600,3
1,1263,46335,3575897597,3575897600,3
1,1263,46336,3575897597,3575897601,4
1,1263,46337,3575897597,3575897602,5
1,1263,46338,3575897597,3575897602,5
1,1263,46339,3575897597,3575897604,7
1,1263,46340,3575897597,3575897604,7
1,1263,46341,3575897597,3575897605,8
1,1263,46342,3575897597,3575897605,8
1,1263,46343,3575897597,3575897606,9
1,1263,46344,3575897597,3575897606,9
1,1263,46345,3575897597,3575897607,10
1,1263,46346,3575897597,3575897607,10
1,1263,46347,3575897597,3575897608,11
1,1263,46348,3575897597,3575897608,11
1,1263,46349,3575897597,3575897609,12
1,1263,46350,3575897597,3575897610,13
1,1263,46351,3575897597,3575897612,15
1,1263,46352,3575897597,3575897612,15
1,1263,46353,3575897597,3575897612,15
1,1263,46354,3575897597,3575897613,16
1,1263,46355,3575897597,3575897613,16
1,1263,46356,3575897597,3575897613,16
1,1263,46357,3575897597,3575897614,17
1,1263,46358,3575897597,3575897615,18
1,1263,46359,3575897597,3575897615,18
1,1263,46360,3575897597,3575897616,19
1,1263,46361,3575897597,3575897616,19
1,1263,46362,3575897597,3575897616,19
1,1263,46363,3575897597,3575897618,21
1,1263,46364,3575897597,3575897618,21
1,1263,46365,3575897597,3575897621,24
1,1263,46366,3575897597,3575897621,24
1,1263,46367,3575897597,3575897622,25
1,1263,46368,3575897597,3575897622,25
1,1263,46369,3575897597,3575897622,25
1,1263,46370,3575897597,3575897623,26
1,1263,46371,3575897597,3575897624,27
1,1263,46372,3575897597,3575897624,27
1,1263,46373,3575897597,3575897625,28
1,1263,46374,3575897597,3575897626,29
1,1263,46375,3575897597,3575897627,30
1,1263,46376,3575897597,3575897627,30
1,1263,46377,3575897597,3575897627,30
1,1263,46378,3575897597,3575897628,31
1,1263,46379,3575897597,3575897628,31
1,1263,46380,3575897597,3575897629,32
1,1263,46381,3575897597,3575897630,33
1,1263,46382,3575897597,3575897630,33
1,1263,46383,3575897597,3575897633,36
1,1263,46384,3575897597,3575897634,37
1,1263,46385,3575897597,3575897634,37
1,1263,46386,3575897597,3575897635,38
1,1263,46387,3575897597,3575897636,39
1,1263,46388,3575897597,3575897636,39
1,1263,46389,3575897597,3575897637,40
1,1263,46390,3575897597,3575897639,42
1,1263,46391,3575897597,3575897639,42
1,1263,46392,3575897597,3575897640,43
1,1263,46393,3575897597,3575897640,43
1,1263,46394,3575897597,3575897642,45
1,1263,46395,3575897597,3575897642,45
1,1263,46396,3575897597,3575897644,47
1,1263,46397,3575897597,3575897644,47
1,1263,46398,3575897597,3575897644,47
1,1263,46399,3575897597,3575897644,47
1,1263,46400,3575897597,3575897647,50
1,1264,46401,3575897661,3575897661,0
1,1264,46402,3575897661,3575897661,0
1,1264,46403,3575897661,3575897661,0
1,1264,46404,3575897661,3575897661,0
1,1264,46405,3575897661,3575897661,0
1,1264,46406,3575897661,3575897661,0
1,1264,46407,3575897661,3575897661,0
1,1264,46408,3575897661,3575897661,0
1,1264,46409,3575897661,3575897661,0
1,1264,46410,3575897661,3575897661,0
1,1264,46411,3575897661,3575897661,0
1,1264,46412,3575897661,3575897661,0
1,1264,46413,3575897661,3575897661,0
1,1264,46414,3575897661,3575897661,0
1,1264,46415,3575897661,3575897661,0
1,1264,46416,3575897661,3575897661,0
1,1264,46417,3575897661,3575897661,0
1,1264,46418,3575897661,3575897661,0
1,1264,46419,3575897661,3575897662,1
1,1264,46420,3575897661,3575897663,2
1,1264,46421,3575897661,3575897665,4
1,1264,46422,3575897661,3575897665,4
1,1264,46423,3575897661,3575897666,5
1,1264,46424,3575897661,3575897666,5
1,1264,46425,3575897661,3575897667,6
1,1264,46426,3575897661,3575897672,11
1,1264,46427,3575897661,3575897680,19
1,1264,46428,3575897661,3575897685,24
1,1264,46429,3575897661,3575897685,24
1,1264,46430,3575897661,3575897685,24
1,1264,46431,3575897661,3575897685,24
1,1264,46432,3575897661,3575897686,25
1,1264,46433,3575897661,3575897686,25
1,1264,46434,3575897661,3575897687,26
1,1264,46435,3575897661,3575897687,26
1,1264,46436,3575897661,3575897689,28
1,1264,46437,3575897661,3575897691,30
1,1264,46438,3575897661,3575897694,33
1,1264,46439,3575897661,3575897695,34
1,1264,46440,3575897661,3575897695,34
1,1264,46441,3575897661,3575897696,35
1,1264,46442,3575897661,3575897696,35
1,1264,46443,3575897661,3575897696,35
1,1264,46444,3575897661,3575897696,35
1,1264,46445,3575897661,3575897698,37
1,1264,46446,3575897661,3575897699,38
1,1264,46447,3575897661,3575897700,39
1,1264,46448,3575897661,3575897700,39
1,1264,46449,3575897661,3575897701,40
1,1264,46450,3575897661,3575897701,40
1,1264,46451,3575897661,3575897701,40
1,1264,46452,3575897661,3575897702,41
1,1264,46453,3575897661,3575897703,42
1,1264,46454,3575897661,3575897703,42
1,1264,46455,3575897661,3575897704,43
1,1264,46456,3575897661,3575897704,43
1,1264,46457,3575897661,3575897704,43
1,1264,46458,3575897661,3575897705,44
1,1264,46459,3575897661,3575897705,44
1,1264,46460,3575897661,3575897706,45
1,1264,46461,3575897661,3575897707,46
1,1264,46462,3575897661,3575897708,47
1,1264,46463,3575897661,3575897708,47
1,1264,46464,3575897661,3575897709,48
1,1264,46465,3575897661,3575897710,49
1,1264,46466,3575897661,3575897710,49
1,1264,46467,3575897661,3575897710,49
1,1264,46468,3575897661,3575897711,50
1,1265,46469,3575897725,3575897725,0
1,1265,46470,3575897725,3575897725,0
1,1265,46471,3575897725,3575897725,0
1,1265,46472,3575897725,3575897725,0
1,1265,46473,3575897725,3575897725,0
1,1265,46474,3575897725,3575897725,0
1,1265,46475,3575897725,3575897725,0
1,1265,46476,3575897725,3575897725,0
1,1265,46477,3575897725,3575897725,0
1,1265,46478,3575897725,3575897725,0
1,1265,46479,3575897725,3575897725,0
1,1265,46480,3575897725,3575897725,0
1,1265,46481,3575897725,3575897725,0
1,1265,46482,3575897725,3575897725,0
1,1265,46483,3575897725,3575897725,0
1,1265,46484,3575897725,3575897725,0
1,1265,46485,3575897725,3575897725,0
1,1265,46486,3575897725,3575897725,0
1,1265,46487,3575897725,3575897726,1
1,1265,46488,3575897725,3575897728,3
1,1265,46489,3575897725,3575897728,3
1,1265,46490,3575897725,3575897729,4
1,1265,46491,3575897725,3575897729,4
1,1265,46492,3575897725,3575897729,4
1,1265,46493,3575897725,3575897729,4
1,1265,46494,3575897725,3575897730,5
1,1265,46495,3575897725,3575897730,5
1,1265,46496,3575897725,3575897730,5
1,1265,46497,3575897725,3575897731,6
1,1265,46498,3575897725,3575897731,6
1,1265,46499,3575897725,3575897731,6
1,1265,46500,3575897725,3575897731,6
1,1265,46501,3575897725,3575897732,7
1,1265,46502,3575897725,3575897734,9
1,1265,46503,3575897725,3575897735,10
1,1265,46504,3575897725,3575897735,10
1,1265,46505,3575897725,3575897736,11
1,1265,46506,3575897725,3575897738,13
1,1265,46507,3575897725,3575897738,13
1,1265,46508,3575897725,3575897739,14
1,1265,46509,3575897725,3575897740,15
1,1265,46510,3575897725,3575897740,15
1,1265,46511,3575897725,3575897740,15
1,1265,46512,3575897725,3575897740,15
1,1265,46513,3575897725,3575897743,18
1,1265,46514,3575897725,3575897744,19
1,1265,46515,3575897725,3575897746,21
1,1265,46516,3575897725,3575897746,21
1,1265,46517,3575897725,3575897748,23
1,1265,46518,3575897725,3575897748,23
1,1265,46519,3575897725,3575897748,23
1,1265,46520,3575897725,3575897749,24
1,1265,46521,3575897725,3575897750,25
1,1265,46522,3575897725,3575897751,26
1,1265,46523,3575897725,3575897752,27
1,1265,46524,3575897725,3575897753,28
1,1265,46525,3575897725,3575897753,28
1,1265,46526,3575897725,3575897753,28
1,1265,46527,3575897725,3575897753,28
1,1265,46528,3575897725,3575897755,30
1,1265,46529,3575897725,3575897758,33
1,1265,46530,3575897725,3575897758,33
1,1265,46531,3575897725,3575897758,33
1,1265,46532,3575897725,3575897759,34
1,1265,46533,3575897725,3575897760,35
1,1265,46534,3575897725,3575897761,36
1,1265,46535,3575897725,3575897763,38
1,1265,46536,3575897725,3575897763,38
1,1265,46537,3575897725,3575897763,38
1,1265,46538,3575897725,3575897763,38
1,1265,46539,3575897725,3575897765,40
1,1265,46540,3575897725,3575897765,40
1,1265,46541,3575897725,3575897767,42
1,1265,46542,3575897725,3575897772,47
1,1265,46543,3575897725,3575897772,47
1,1265,46544,3575897725,3575897773,48
1,1265,46545,3575897725,3575897774,49
1,1265,46546,3575897725,3575897774,49
1,1265,46547,3575897725,3575897775,50
1,1266,46548,3575897791,3575897791,0
1,1266,46549,3575897791,3575897791,0
1,1266,46550,3575897791,3575897791,0
1,1266,46551,3575897791,3575897791,0
1,1266,46552,3575897791,3575897791,0
1,1266,46553,3575897791,3575897791,0
1,1266,46554,3575897791,3575897791,0
1,1266,46555,3575897791,3575897791,0
1,1266,46556,3575897791,3575897791,0
1,1266,46557,3575897791,3575897791,0
1,1266,46558,3575897791,3575897791,0
1,1266,46559,3575897791,3575897791,0
1,1266,46560,3575897791,3575897791,0
1,1266,46561,3575897791,3575897791,0
1,1266,46562,3575897791,3575897791,0
1,1266,46563,3575897791,3575897791,0
1,1266,46564,3575897791,3575897791,0
1,1266,46565,3575897791,3575897791,0
1,1266,46566,3575897791,3575897791,0
1,1266,46567,3575897791,3575897791,0
1,1266,46568,3575897791,3575897791,0
1,1266,46569,3575897791,3575897791,0
1,1266,46570,3575897791,3575897792,1
1,1266,46571,3575897791,3575897793,2
1,1266,46572,3575897791,3575897793,2
1,1266,46573,3575897791,3575897794,3
1,1266,46574,3575897791,3575897794,3
1,1266,46575,3575897791,3575897795,4
1,1266,46576,3575897791,3575897797,6
1,1266,46577,3575897791,3575897797,6
1,1266,46578,3575897791,3575897798,7
1,1266,46579,3575897791,3575897800,9
1,1266,46580,3575897791,3575897802,11
1,1266,46581,3575897791,3575897802,11
1,1266,46582,3575897791,3575897804,13
1,1266,46583,3575897791,3575897804,13
1,1266,46584,3575897791,3575897804,13
1,1266,46585,3575897791,3575897805,14
1,1266,46586,3575897791,3575897807,16
1,1266,46587,3575897791,3575897807,16
1,1266,46588,3575897791,3575897807,16
1,1266,46589,3575897791,3575897807,16
1,1266,46590,3575897791,3575897808,17
1,1266,46591,3575897791,3575897809,18
1,1266,46592,3575897791,3575897810,19
1,1266,46593,3575897791,3575897810,19
1,1266,46594,3575897791,3575897812,21
1,1266,46595,3575897791,3575897812,21
1,1266,46596,3575897791,3575897813,22
1,1266,46597,3575897791,3575897813,22
1,1266,46598,3575897791,3575897814,23
1,1266,46599,3575897791,3575897814,23
1,1266,46600,3575897791,3575897815,24
1,1266,46601,3575897791,3575897816,25
1,1266,46602,3575897791,3575897816,25
1,1266,46603,3575897791,3575897816,25
1,1266,46604,3575897791,3575897816,25
1,1266,46605,3575897791,3575897816,25
1,1266,46606,3575897791,3575897818,27
1,1266,46607,3575897791,3575897818,27
1,1266,46608,3575897791,3575897821,30
1,1266,46609,3575897791,3575897822,31
1,1266,46610,3575897791,3575897822,31
1,1266,46611,3575897791,3575897823,32
1,1266,46612,3575897791,3575897823,32
1,1266,46613,3575897791,3575897826,35
1,1266,46614,3575897791,3575897827,36
1,1266,46615,3575897791,3575897827,36
1,1266,46616,3575897791,3575897827,36
1,1266,46617,3575897791,3575897828,37
1,1266,46618,3575897791,3575897828,37
1,1266,46619,3575897791,3575897828,37
1,1266,46620,3575897791,3575897829,38
1,1266,46621,3575897791,3575897829,38
1,1266,46622,3575897791,3575897830,39
1,1266,46623,3575897791,3575897830,39
1,1266,46624,3575897791,3575897831,40
1,1266,46625,3575897791,3575897834,43
1,1266,46626,3575897791,3575897834,43
1,1266,46627,3575897791,3575897834,43
1,1266,46628,3575897791,3575897835,44
1,1266,46629,3575897791,3575897836,45
1,1266,46630,3575897791,3575897836,45
1,1266,46631,3575897791,3575897838,47
1,1266,46632,3575897791,3575897839,48
1,1266,46633,3575897791,3575897840,49
1,1266,46634,3575897791,3575897841,50
1,1267,46635,3575897855,3575897855,0
1,1267,46636,3575897855,3575897855,0
1,1267,46637,3575897855,3575897855,0
1,1267,46638,3575897855,3575897855,0
1,1267,46639,3575897855,3575897855,0
1,1267,46640,3575897855,3575897855,0
1,1267,46641,3575897855,3575897855,0
1,1267,46642,3575897855,3575897855,0
1,1267,46643,3575897855,3575897855,0
1,1267,46644,3575897855,3575897855,0
1,1267,46645,3575897855,3575897855,0
1,1267,46646,3575897855,3575897855,0
1,1267,46647,3575897855,3575897855,0
1,1267,46648,3575897855,3575897855,0
1,1267,46649,3575897855,3575897855,0
1,1267,46650,3575897855,3575897855,0
1,1267,46651,3575897855,3575897855,0
1,1267,46652,3575897855,3575897855,0
1,1267,46653,3575897855,3575897856,1
1,1267,46654,3575897855,3575897856,1
1,1267,46655,3575897855,3575897856,1
1,1267,46656,3575897855,3575897856,1
1,1267,46657,3575897855,3575897856,1
1,1267,46658,3575897855,3575897859,4
1,1267,46659,3575897855,3575897859,4
1,1267,46660,3575897855,3575897861,6
1,1267,46661,3575897855,3575897862,7
1,1267,46662,3575897855,3575897863,8
1,1267,46663,3575897855,3575897865,10
1,1267,46664,3575897855,3575897865,10
1,1267,46665,3575897855,3575897865,10
1,1267,46666,3575897855,3575897866,11
1,1267,46667,3575897855,3575897867,12
1,1267,46668,3575897855,3575897868,13
1,1267,46669,3575897855,3575897872,17
1,1267,46670,3575897855,3575897880,25
1,1267,46671,3575897855,3575897880,25
1,1267,46672,3575897855,3575897884,29
1,1267,46673,3575897855,3575897885,30
1,1267,46674,3575897855,3575897885,30
1,1267,46675,3575897855,3575897886,31
1,1267,46676,3575897855,3575897886,31
1,1267,46677,3575897855,3575897886,31
1,1267,46678,3575897855,3575897886,31
1,1267,46679,3575897855,3575897888,33
1,1267,46680,3575897855,3575897892,37
1,1267,46681,3575897855,3575897893,38
1,1267,46682,3575897855,3575897894,39
1,1267,46683,3575897855,3575897895,40
1,1267,46684,3575897855,3575897896,41
1,1267,46685,3575897855,3575897896,41
1,1267,46686,3575897855,3575897897,42
1,1267,46687,3575897855,3575897899,44
1,1267,46688,3575897855,3575897900,45
1,1267,46689,3575897855,3575897900,45
1,1267,46690,3575897855,3575897901,46
1,1267,46691,3575897855,3575897901,46
1,1267,46692,3575897855,3575897902,47
1,1267,46693,3575897855,3575897902,47
1,1267,46694,3575897855,3575897903,48
1,1267,46695,3575897855,3575897903,48
1,1267,46696,3575897855,3575897904,49
1,1267,46697,3575897855,3575897904,49
1,1268,46698,3575897922,3575897922,0
1,1268,46699,3575897922,3575897922,0
1,1268,46700,3575897922,3575897922,0
1,1268,46701,3575897922,3575897922,0
1,1268,46702,3575897922,3575897922,0
1,1268,46703,3575897922,3575897922,0
1,1268,46704,3575897922,3575897922,0
1,1268,46705,3575897922,3575897922,0
1,1268,46706,3575897922,3575897922,0
1,1268,46707,3575897922,3575897922,0
1,1268,46708,3575897922,3575897922,0
1,1268,46709,3575897922,3575897922,0
1,1268,46710,3575897922,3575897922,0
1,1268,46711,3575897922,3575897922,0
1,1268,46712,3575897922,3575897922,0
1,1268,46713,3575897922,3575897922,0
1,1268,46714,3575897922,3575897922,0
1,1268,46715,3575897922,3575897922,0
1,1268,46716,3575897922,3575897922,0
1,1268,46717,3575897922,3575897922,0
1,1268,46718,3575897922,3575897922,0
1,1268,46719,3575897922,3575897923,1
1,1268,46720,3575897922,3575897923,1
1,1268,46721,3575897922,3575897923,1
1,1268,46722,3575897922,3575897924,2
1,1268,46723,3575897922,3575897926,4
1,1268,46724,3575897922,3575897926,4
1,1268,46725,3575897922,3575897927,5
1,1268,46726,3575897922,3575897927,5
1,1268,46727,3575897922,3575897928,6
1,1268,46728,3575897922,3575897930,8
1,1268,46729,3575897922,3575897930,8
1,1268,46730,3575897922,3575897930,8
1,1268,46731,3575897922,3575897930,8
1,1268,46732,3575897922,3575897930,8
1,1268,46733,3575897922,3575897930,8
1,1268,46734,3575897922,3575897930,8
1,1268,46735,3575897922,3575897931,9
1,1268,46736,3575897922,3575897931,9
1,1268,46737,3575897922,3575897931,9
1,1268,46738,3575897922,3575897932,10
1,1268,46739,3575897922,3575897932,10
1,1268,46740,3575897922,3575897933,11
1,1268,46741,3575897922,3575897935,13
1,1268,46742,3575897922,3575897935,13
1,1268,46743,3575897922,3575897937,15
1,1268,46744,3575897922,3575897938,16
1,1268,46745,3575897922,3575897939,17
1,1268,46746,3575897922,3575897939,17
1,1268,46747,3575897922,3575897939,17
1,1268,46748,3575897922,3575897940,18
1,1268,46749,3575897922,3575897941,19
1,1268,46750,3575897922,3575897943,21
1,1268,46751,3575897922,3575897944,22
1,1268,46752,3575897922,3575897944,22
1,1268,46753,3575897922,3575897945,23
1,1268,46754,3575897922,3575897947,25
1,1268,46755,3575897922,3575897948,26
1,1268,46756,3575897922,3575897948,26
1,1268,46757,3575897922,3575897949,27
1,1268,46758,3575897922,3575897950,28
1,1268,46759,3575897922,3575897952,30
1,1268,46760,3575897922,3575897952,30
1,1268,46761,3575897922,3575897952,30
1,1268,46762,3575897922,3575897952,30
1,1268,46763,3575897922,3575897953,31
1,1268,46764,3575897922,3575897954,32
1,1268,46765,3575897922,3575897956,34
1,1268,46766,3575897922,3575897958,36
1,1268,46767,3575897922,3575897958,36
1,1268,46768,3575897922,3575897959,37
1,1268,46769,3575897922,3575897959,37
1,1268,46770,3575897922,3575897960,38
1,1268,46771,3575897922,3575897960,38
1,1268,46772,3575897922,3575897961,39
1,1268,46773,3575897922,3575897963,41
1,1268,46774,3575897922,3575897964,42
1,1268,46775,3575897922,3575897964,42
1,1268,46776,3575897922,3575897964,42
1,1268,46777,3575897922,3575897964,42
1,1268,46778,3575897922,3575897965,43
1,1268,46779,3575897922,3575897967,45
1,1269,46780,3575897986,3575897986,0
1,1269,46781,3575897986,3575897986,0
1,1269,46782,3575897986,3575897986,0
1,1269,46783,3575897986,3575897986,0
1,1269,46784,3575897986,3575897986,0
1,1269,46785,3575897986,3575897986,0
1,1269,46786,3575897986,3575897986,0
1,1269,46787,3575897986,3575897986,0
1,1269,46788,3575897986,3575897986,0
1,1269,46789,3575897986,3575897986,0
1,1269,46790,3575897986,3575897986,0
1,1269,46791,3575897986,3575897986,0
1,1269,46792,3575897986,3575897986,0
1,1269,46793,3575897986,3575897986,0
1,1269,46794,3575897986,3575897986,0
1,1269,46795,3575897986,3575897986,0
1,1269,46796,3575897986,3575897986,0
1,1269,46797,3575897986,3575897986,0
1,1269,46798,3575897986,3575897986,0
1,1269,46799,3575897986,3575897986,0
1,1269,46800,3575897986,3575897986,0
1,1269,46801,3575897986,3575897986,0
1,1269,46802,3575897986,3575897987,1
1,1269,46803,3575897986,3575897989,3
1,1269,46804,3575897986,3575897989,3
1,1269,46805,3575897986,3575897990,4
1,1269,46806,3575897986,3575897991,5
1,1269,46807,3575897986,3575897991,5
1,1269,46808,3575897986,3575897991,5
1,1269,46809,3575897986,3575897992,6
1,1269,46810,3575897986,3575897992,6
1,1269,46811,3575897986,3575897992,6
1,1269,46812,3575897986,3575897992,6
1,1269,46813,3575897986,3575897994,8
1,1269,46814,3575897986,3575897996,10
1,1269,46815,3575897986,3575897997,11
1,1269,46816,3575897986,3575897997,11
1,1269,46817,3575897986,3575897998,12
1,1269,46818,3575897986,3575898000,14
1,1269,46819,3575897986,3575898001,15
1,1269,46820,3575897986,3575898002,16
1,1269,46821,3575897986,3575898003,17
1,1269,46822,3575897986,3575898004,18
1,1269,46823,3575897986,3575898004,18
1,1269,46824,3575897986,3575898005,19
1,1269,46825,3575897986,3575898005,19
1,1269,46826,3575897986,3575898007,21
1,1269,46827,3575897986,3575898007,21
1,1269,46828,3575897986,3575898007,21
1,1269,46829,3575897986,3575898007,21
1,1269,46830,3575897986,3575898008,22
1,1269,46831,3575897986,3575898009,23
1,1269,46832,3575897986,3575898010,24
1,1269,46833,3575897986,3575898010,24
1,1269,46834,3575897986,3575898011,25
1,1269,46835,3575897986,3575898012,26
1,1269,46836,3575897986,3575898014,28
1,1269,46837,3575897986,3575898015,29
1,1269,46838,3575897986,3575898015,29
1,1269,46839,3575897986,3575898015,29
1,1269,46840,3575897986,3575898016,30
1,1269,46841,3575897986,3575898016,30
1,1269,46842,3575897986,3575898017,31
1,1269,46843,3575897986,3575898017,31
1,1269,46844,3575897986,3575898017,31
1,1269,46845,3575897986,3575898018,32
1,1269,46846,3575897986,3575898018,32
1,1269,46847,3575897986,3575898019,33
1,1269,46848,3575897986,3575898021,35
1,1269,46849,3575897986,3575898021,35
1,1269,46850,3575897986,3575898022,36
1,1269,46851,3575897986,3575898023,37
1,1269,46852,3575897986,3575898023,37
1,1269,46853,3575897986,3575898024,38
1,1269,46854,3575897986,3575898024,38
1,1269,46855,3575897986,3575898025,39
1,1269,46856,3575897986,3575898026,40
1,1269,46857,3575897986,3575898027,41
1,1269,46858,3575897986,3575898027,41
1,1269,46859,3575897986,3575898028,42
1,1269,46860,3575897986,3575898028,42
1,1269,46861,3575897986,3575898028,42
1,1269,46862,3575897986,3575898029,43
1,1269,46863,3575897986,3575898030,44
1,1269,46864,3575897986,3575898030,44
1,1269,46865,3575897986,3575898034,48
1,1269,46866,3575897986,3575898034,48
1,1269,46867,3575897986,3575898035,49
1,1269,46868,3575897986,3575898035,49
1,1270,46869,3575898052,3575898052,0
1,1270,46870,3575898052,3575898052,0
1,1270,46871,3575898052,3575898052,0
1,1270,46872,3575898052,3575898052,0
1,1270,46873,3575898052,3575898052,0
1,1270,46874,3575898052,3575898052,0
1,1270,46875,3575898052,3575898052,0
1,1270,46876,3575898052,3575898052,0
1,1270,46877,3575898052,3575898052,0
1,1270,46878,3575898052,3575898052,0
1,1270,46879,3575898052,3575898052,0
1,1270,46880,3575898052,3575898052,0
1,1270,46881,3575898052,3575898052,0
1,1270,46882,3575898052,3575898052,0
1,1270,46883,3575898052,3575898052,0
1,1270,46884,3575898052,3575898052,0
1,1270,46885,3575898052,3575898052,0
1,1270,46886,3575898052,3575898052,0
1,1270,46887,3575898052,3575898052,0
1,1270,46888,3575898052,3575898052,0
1,1270,46889,3575898052,3575898053,1
1,1270,46890,3575898052,3575898053,1
1,1270,46891,3575898052,3575898053,1
1,1270,46892,3575898052,3575898053,1
1,1270,46893,3575898052,3575898053,1
1,1270,46894,3575898052,3575898054,2
1,1270,46895,3575898052,3575898055,3
1,1270,46896,3575898052,3575898056,4
1,1270,46897,3575898052,3575898056,4
1,1270,46898,3575898052,3575898059,7
1,1270,46899,3575898052,3575898059,7
1,1270,46900,3575898052,3575898062,10
1,1270,46901,3575898052,3575898062,10
1,1270,46902,3575898052,3575898065,13
1,1270,46903,3575898052,3575898066,14
1,1270,46904,3575898052,3575898067,15
1,1270,46905,3575898052,3575898067,15
1,1270,46906,3575898052,3575898067,15
1,1270,46907,3575898052,3575898072,20
1,1270,46908,3575898052,3575898080,28
1,1270,46909,3575898052,3575898081,29
1,1270,46910,3575898052,3575898081,29
1,1270,46911,3575898052,3575898085,33
1,1270,46912,3575898052,3575898086,34
1,1270,46913,3575898052,3575898086,34
1,1270,46914,3575898052,3575898086,34
1,1270,46915,3575898052,3575898087,35
1,1270,46916,3575898052,3575898087,35
1,1270,46917,3575898052,3575898088,36
1,1270,46918,3575898052,3575898089,37
1,1270,46919,3575898052,3575898091,39
1,1270,46920,3575898052,3575898094,42
1,1270,46921,3575898052,3575898094,42
1,1270,46922,3575898052,3575898094,42
1,1270,46923,3575898052,3575898096,44
1,1270,46924,3575898052,3575898096,44
1,1270,46925,3575898052,3575898096,44
1,1270,46926,3575898052,3575898097,45
1,1270,46927,3575898052,3575898098,46
1,1270,46928,3575898052,3575898098,46
1,1270,46929,3575898052,3575898099,47
1,1270,46930,3575898052,3575898100,48
1,1270,46931,3575898052,3575898100,48
1,1270,46932,3575898052,3575898101,49
1,1270,46933,3575898052,3575898101,49
1,1270,46934,3575898052,3575898102,50
1,1271,46935,3575898115,3575898115,0
1,1271,46936,3575898115,3575898115,0
1,1271,46937,3575898115,3575898115,0
1,1271,46938,3575898115,3575898115,0
1,1271,46939,3575898115,3575898115,0
1,1271,46940,3575898115,3575898115,0
1,1271,46941,3575898115,3575898115,0
1,1271,46942,3575898115,3575898115,0
1,1271,46943,3575898115,3575898115,0
1,1271,46944,3575898115,3575898115,0
1,1271,46945,3575898115,3575898115,0
1,1271,46946,3575898115,3575898115,0
1,1271,46947,3575898115,3575898115,0
1,1271,46948,3575898115,3575898115,0
1,1271,46949,3575898115,3575898115,0
1,1271,46950,3575898115,3575898115,0
1,1271,46951,3575898115,3575898115,0
1,1271,46952,3575898115,3575898115,0
1,1271,46953,3575898115,3575898115,0
1,1271,46954,3575898115,3575898115,0
1,1271,46955,3575898115,3575898115,0
1,1271,46956,3575898115,3575898115,0
1,1271,46957,3575898115,3575898116,1
1,1271,46958,3575898115,3575898116,1
1,1271,46959,3575898115,3575898118,3
1,1271,46960,3575898115,3575898119,4
1,1271,46961,3575898115,3575898119,4
1,1271,46962,3575898115,3575898121,6
1,1271,46963,3575898115,3575898121,6
1,1271,46964,3575898115,3575898122,7
1,1271,46965,3575898115,3575898122,7
1,1271,46966,3575898115,3575898123,8
1,1271,46967,3575898115,3575898123,8
1,1271,46968,3575898115,3575898124,9
1,1271,46969,3575898115,3575898126,11
1,1271,46970,3575898115,3575898126,11
1,1271,46971,3575898115,3575898127,12
1,1271,46972,3575898115,3575898127,12
1,1271,46973,3575898115,3575898128,13
1,1271,46974,3575898115,3575898130,15
1,1271,46975,3575898115,3575898130,15
1,1271,46976,3575898115,3575898130,15
1,1271,46977,3575898115,3575898130,15
1,1271,46978,3575898115,3575898130,15
1,1271,46979,3575898115,3575898131,16
1,1271,46980,3575898115,3575898131,16
1,1271,46981,3575898115,3575898131,16
1,1271,46982,3575898115,3575898132,17
1,1271,46983,3575898115,3575898132,17
1,1271,46984,3575898115,3575898133,18
1,1271,46985,3575898115,3575898134,19
1,1271,46986,3575898115,3575898135,20
1,1271,46987,3575898115,3575898136,21
1,1271,46988,3575898115,3575898137,22
1,1271,46989,3575898115,3575898137,22
1,1271,46990,3575898115,3575898139,24
1,1271,46991,3575898115,3575898139,24
1,1271,46992,3575898115,3575898140,25
1,1271,46993,3575898115,3575898140,25
1,1271,46994,3575898115,3575898141,26
1,1271,46995,3575898115,3575898141,26
1,1271,46996,3575898115,3575898144,29
1,1271,46997,3575898115,3575898144,29
1,1271,46998,3575898115,3575898144,29
1,1271,46999,3575898115,3575898146,31
1,1271,47000,3575898115,3575898147,32
1,1271,47001,3575898115,3575898148,33
1,1271,47002,3575898115,3575898149,34
1,1271,47003,3575898115,3575898150,35
1,1271,47004,3575898115,3575898153,38
1,1271,47005,3575898115,3575898153,38
1,1271,47006,3575898115,3575898153,38
1,1271,47007,3575898115,3575898154,39
1,1271,47008,3575898115,3575898154,39
1,1271,47009,3575898115,3575898155,40
1,1271,47010,3575898115,3575898156,41
1,1271,47011,3575898115,3575898158,43
1,1271,47012,3575898115,3575898158,43
1,1271,47013,3575898115,3575898159,44
1,1271,47014,3575898115,3575898160,45
1,1271,47015,3575898115,3575898160,45
1,1271,47016,3575898115,3575898161,46
1,1271,47017,3575898115,3575898162,47
1,1271,47018,3575898115,3575898164,49
1,1271,47019,3575898115,3575898164,49
1,1271,47020,3575898115,3575898164,49
1,1271,47021,3575898115,3575898164,49
1,1271,47022,3575898115,3575898165,50
1,1272,47023,3575898178,3575898178,0
1,1272,47024,3575898178,3575898178,0
1,1272,47025,3575898178,3575898178,0
1,1272,47026,3575898178,3575898178,0
1,1272,47027,3575898178,3575898178,0
1,1272,47028,3575898178,3575898178,0
1,1272,47029,3575898178,3575898178,0
1,1272,47030,3575898178,3575898178,0
1,1272,47031,3575898178,3575898178,0
1,1272,47032,3575898178,3575898178,0
1,1272,47033,3575898178,3575898178,0
1,1272,47034,3575898178,3575898178,0
1,1272,47035,3575898178,3575898179,1
1,1272,47036,3575898178,3575898179,1
1,1272,47037,3575898178,3575898179,1
1,1272,47038,3575898178,3575898182,4
1,1272,47039,3575898178,3575898182,4
1,1272,47040,3575898178,3575898183,5
1,1272,47041,3575898178,3575898184,6
1,1272,47042,3575898178,3575898185,7
1,1272,47043,3575898178,3575898186,8
1,1272,47044,3575898178,3575898187,9
1,1272,47045,3575898178,3575898189,11
1,1272,47046,3575898178,3575898189,11
1,1272,47047,3575898178,3575898191,13
1,1272,47048,3575898178,3575898191,13
1,1272,47049,3575898178,3575898191,13
1,1272,47050,3575898178,3575898191,13
1,1272,47051,3575898178,3575898191,13
1,1272,47052,3575898178,3575898192,14
1,1272,47053,3575898178,3575898192,14
1,1272,47054,3575898178,3575898193,15
1,1272,47055,3575898178,3575898194,16
1,1272,47056,3575898178,3575898196,18
1,1272,47057,3575898178,3575898196,18
1,1272,47058,3575898178,3575898198,20
1,1272,47059,3575898178,3575898198,20
1,1272,47060,3575898178,3575898201,23
1,1272,47061,3575898178,3575898202,24
1,1272,47062,3575898178,3575898202,24
1,1272,47063,3575898178,3575898202,24
1,1272,47064,3575898178,3575898204,26
1,1272,47065,3575898178,3575898205,27
1,1272,47066,3575898178,3575898205,27
1,1272,47067,3575898178,3575898207,29
1,1272,47068,3575898178,3575898207,29
1,1272,47069,3575898178,3575898207,29
1,1272,47070,3575898178,3575898208,30
1,1272,47071,3575898178,3575898208,30
1,1272,47072,3575898178,3575898210,32
1,1272,47073,3575898178,3575898211,33
1,1272,47074,3575898178,3575898212,34
1,1272,47075,3575898178,3575898213,35
1,1272,47076,3575898178,3575898213,35
1,1272,47077,3575898178,3575898213,35
1,1272,47078,3575898178,3575898215,37
1,1272,47079,3575898178,3575898215,37
1,1272,47080,3575898178,3575898215,37
1,1272,47081,3575898178,3575898216,38
1,1272,47082,3575898178,3575898216,38
1,1272,47083,3575898178,3575898217,39
1,1272,47084,3575898178,3575898217,39
1,1272,47085,3575898178,3575898217,39
1,1272,47086,3575898178,3575898218,40
1,1272,47087,3575898178,3575898219,41
1,1272,47088,3575898178,3575898219,41
1,1272,47089,3575898178,3575898221,43
1,1272,47090,3575898178,3575898221,43
1,1272,47091,3575898178,3575898223,45
1,1272,47092,3575898178,3575898223,45
1,1272,47093,3575898178,3575898223,45
1,1272,47094,3575898178,3575898224,46
1,1272,47095,3575898178,3575898226,48
1,1272,47096,3575898178,3575898226,48
1,1272,47097,3575898178,3575898228,50
1,1273,47098,3575898243,3575898243,0
1,1273,47099,3575898243,3575898243,0
1,1273,47100,3575898243,3575898243,0
1,1273,47101,3575898243,3575898243,0
1,1273,47102,3575898243,3575898243,0
1,1273,47103,3575898243,3575898243,0
1,1273,47104,3575898243,3575898243,0
1,1273,47105,3575898243,3575898243,0
1,1273,47106,3575898243,3575898243,0
1,1273,47107,3575898243,3575898243,0
1,1273,47108,3575898243,3575898243,0
1,1273,47109,3575898243,3575898243,0
1,1273,47110,3575898243,3575898243,0
1,1273,47111,3575898243,3575898243,0
1,1273,47112,3575898243,3575898243,0
1,1273,47113,3575898243,3575898243,0
1,1273,47114,3575898243,3575898243,0
1,1273,47115,3575898243,3575898243,0
1,1273,47116,3575898243,3575898243,0
1,1273,47117,3575898243,3575898243,0
1,1273,47118,3575898243,3575898244,1
1,1273,47119,3575898243,3575898244,1
1,1273,47120,3575898243,3575898244,1
1,1273,47121,3575898243,3575898245,2
1,1273,47122,3575898243,3575898245,2
1,1273,47123,3575898243,3575898246,3
1,1273,47124,3575898243,3575898247,4
1,1273,47125,3575898243,3575898247,4
1,1273,47126,3575898243,3575898248,5
1,1273,47127,3575898243,3575898248,5
1,1273,47128,3575898243,3575898248,5
1,1273,47129,3575898243,3575898248,5
1,1273,47130,3575898243,3575898250,7
1,1273,47131,3575898243,3575898251,8
1,1273,47132,3575898243,3575898252,9
1,1273,47133,3575898243,3575898252,9
1,1273,47134,3575898243,3575898252,9
1,1273,47135,3575898243,3575898254,11
1,1273,47136,3575898243,3575898254,11
1,1273,47137,3575898243,3575898254,11
1,1273,47138,3575898243,3575898255,12
1,1273,47139,3575898243,3575898257,14
1,1273,47140,3575898243,3575898257,14
1,1273,47141,3575898243,3575898259,16
1,1273,47142,3575898243,3575898260,17
1,1273,47143,3575898243,3575898261,18
1,1273,47144,3575898243,3575898263,20
1,1273,47145,3575898243,3575898263,20
1,1273,47146,3575898243,3575898266,23
1,1273,47147,3575898243,3575898266,23
1,1273,47148,3575898243,3575898267,24
1,1273,47149,3575898243,3575898267,24
1,1273,47150,3575898243,3575898267,24
1,1273,47151,3575898243,3575898268,25
1,1273,47152,3575898243,3575898270,27
1,1273,47153,3575898243,3575898272,29
1,1273,47154,3575898243,3575898280,37
1,1273,47155,3575898243,3575898280,37
1,1273,47156,3575898243,3575898281,38
1,1273,47157,3575898243,3575898284,41
1,1273,47158,3575898243,3575898285,42
1,1273,47159,3575898243,3575898285,42
1,1273,47160,3575898243,3575898286,43
1,1273,47161,3575898243,3575898286,43
1,1273,47162,3575898243,3575898286,43
1,1273,47163,3575898243,3575898286,43
1,1273,47164,3575898243,3575898288,45
1,1273,47165,3575898243,3575898292,49
1,1274,47166,3575898306,3575898306,0
1,1274,47167,3575898306,3575898306,0
1,1274,47168,3575898306,3575898306,0
1,1274,47169,3575898306,3575898306,0
1,1274,47170,3575898306,3575898306,0
1,1274,47171,3575898306,3575898306,0
1,1274,47172,3575898306,3575898306,0
1,1274,47173,3575898306,3575898306,0
1,1274,47174,3575898306,3575898306,0
1,1274,47175,3575898306,3575898306,0
1,1274,47176,3575898306,3575898306,0
1,1274,47177,3575898306,3575898306,0
1,1274,47178,3575898306,3575898306,0
1,1274,47179,3575898306,3575898306,0
1,1274,47180,3575898306,3575898306,0
1,1274,47181,3575898306,3575898306,0
1,1274,47182,3575898306,3575898306,0
1,1274,47183,3575898306,3575898306,0
1,1274,47184,3575898306,3575898306,0
1,1274,47185,3575898306,3575898306,0
1,1274,47186,3575898306,3575898306,0
1,1274,47187,3575898306,3575898306,0
1,1274,47188,3575898306,3575898307,1
1,1274,47189,3575898306,3575898307,1
1,1274,47190,3575898306,3575898307,1
1,1274,47191,3575898306,3575898308,2
1,1274,47192,3575898306,3575898308,2
1,1274,47193,3575898306,3575898308,2
1,1274,47194,3575898306,3575898309,3
1,1274,47195,3575898306,3575898311,5
1,1274,47196,3575898306,3575898311,5
1,1274,47197,3575898306,3575898312,6
1,1274,47198,3575898306,3575898313,7
1,1274,47199,3575898306,3575898313,7
1,1274,47200,3575898306,3575898313,7
1,1274,47201,3575898306,3575898315,9
1,1274,47202,3575898306,3575898315,9
1,1274,47203,3575898306,3575898316,10
1,1274,47204,3575898306,3575898316,10
1,1274,47205,3575898306,3575898319,13
1,1274,47206,3575898306,3575898320,14
1,1274,47207,3575898306,3575898321,15
1,1274,47208,3575898306,3575898321,15
1,1274,47209,3575898306,3575898322,16
1,1274,47210,3575898306,3575898322,16
1,1274,47211,3575898306,3575898323,17
1,1274,47212,3575898306,3575898324,18
1,1274,47213,3575898306,3575898324,18
1,1274,47214,3575898306,3575898326,20
1,1274,47215,3575898306,3575898326,20
1,1274,47216,3575898306,3575898327,21
1,1274,47217,3575898306,3575898328,22
1,1274,47218,3575898306,3575898330,24
1,1274,47219,3575898306,3575898330,24
1,1274,47220,3575898306,3575898330,24
1,1274,47221,3575898306,3575898330,24
1,1274,47222,3575898306,3575898331,25
1,1274,47223,3575898306,3575898331,25
1,1274,47224,3575898306,3575898331,25
1,1274,47225,3575898306,3575898332,26
1,1274,47226,3575898306,3575898332,26
1,1274,47227,3575898306,3575898333,27
1,1274,47228,3575898306,3575898334,28
1,1274,47229,3575898306,3575898335,29
1,1274,47230,3575898306,3575898336,30
1,1274,47231,3575898306,3575898337,31
1,1274,47232,3575898306,3575898337,31
1,1274,47233,3575898306,3575898338,32
1,1274,47234,3575898306,3575898340,34
1,1274,47235,3575898306,3575898340,34
1,1274,47236,3575898306,3575898340,34
1,1274,47237,3575898306,3575898340,34
1,1274,47238,3575898306,3575898340,34
1,1274,47239,3575898306,3575898343,37
1,1274,47240,3575898306,3575898344,38
1,1274,47241,3575898306,3575898344,38
1,1274,47242,3575898306,3575898347,41
1,1274,47243,3575898306,3575898347,41
1,1274,47244,3575898306,3575898348,42
1,1274,47245,3575898306,3575898350,44
1,1274,47246,3575898306,3575898351,45
1,1274,47247,3575898306,3575898353,47
1,1274,47248,3575898306,3575898353,47
1,1274,47249,3575898306,3575898353,47
1,1274,47250,3575898306,3575898354,48
1,1274,47251,3575898306,3575898354,48
1,1275,47252,3575898374,3575898374,0
1,1275,47253,3575898374,3575898374,0
1,1275,47254,3575898374,3575898374,0
1,1275,47255,3575898374,3575898374,0
1,1275,47256,3575898374,3575898374,0
1,1275,47257,3575898374,3575898374,0
1,1275,47258,3575898374,3575898374,0
1,1275,47259,3575898374,3575898374,0
1,1275,47260,3575898374,3575898374,0
1,1275,47261,3575898374,3575898374,0
1,1275,47262,3575898374,3575898374,0
1,1275,47263,3575898374,3575898374,0
1,1275,47264,3575898374,3575898374,0
1,1275,47265,3575898374,3575898374,0
1,1275,47266,3575898374,3575898374,0
1,1275,47267,3575898374,3575898374,0
1,1275,47268,3575898374,3575898374,0
1,1275,47269,3575898374,3575898374,0
1,1275,47270,3575898374,3575898374,0
1,1275,47271,3575898374,3575898375,1
1,1275,47272,3575898374,3575898377,3
1,1275,47273,3575898374,3575898377,3
1,1275,47274,3575898374,3575898377,3
1,1275,47275,3575898374,3575898378,4
1,1275,47276,3575898374,3575898379,5
1,1275,47277,3575898374,3575898379,5
1,1275,47278,3575898374,3575898381,7
1,1275,47279,3575898374,3575898381,7
1,1275,47280,3575898374,3575898382,8
1,1275,47281,3575898374,3575898383,9
1,1275,47282,3575898374,3575898384,10
1,1275,47283,3575898374,3575898385,11
1,1275,47284,3575898374,3575898385,11
1,1275,47285,3575898374,3575898387,13
1,1275,47286,3575898374,3575898387,13
1,1275,47287,3575898374,3575898389,15
1,1275,47288,3575898374,3575898389,15
1,1275,47289,3575898374,3575898391,17
1,1275,47290,3575898374,3575898391,17
1,1275,47291,3575898374,3575898391,17
1,1275,47292,3575898374,3575898391,17
1,1275,47293,3575898374,3575898392,18
1,1275,47294,3575898374,3575898392,18
1,1275,47295,3575898374,3575898392,18
1,1275,47296,3575898374,3575898394,20
1,1275,47297,3575898374,3575898395,21
1,1275,47298,3575898374,3575898396,22
1,1275,47299,3575898374,3575898397,23
1,1275,47300,3575898374,3575898399,25
1,1275,47301,3575898374,3575898402,28
1,1275,47302,3575898374,3575898402,28
1,1275,47303,3575898374,3575898403,29
1,1275,47304,3575898374,3575898404,30
1,1275,47305,3575898374,3575898405,31
1,1275,47306,3575898374,3575898405,31
1,1275,47307,3575898374,3575898407,33
1,1275,47308,3575898374,3575898407,33
1,1275,47309,3575898374,3575898407,33
1,1275,47310,3575898374,3575898408,34
1,1275,47311,3575898374,3575898409,35
1,1275,47312,3575898374,3575898410,36
1,1275,47313,3575898374,3575898412,38
1,1275,47314,3575898374,3575898412,38
1,1275,47315,3575898374,3575898413,39
1,1275,47316,3575898374,3575898415,41
1,1275,47317,3575898374,3575898415,41
1,1275,47318,3575898374,3575898416