t_id, iteration_count, request_count, request_start_time, request_end_time, request_processing_time
1,406,1,-721643373,-721643354,19
1,410,2,-721643171,-721643154,17
1,412,3,-721643070,-721643049,21
1,414,4,-721642970,-721642954,16
1,416,5,-721642869,-721642850,19
1,418,6,-721642768,-721642754,14
1,420,7,-721642668,-721642651,17
1,422,8,-721642567,-721642554,13
1,424,9,-721642466,-721642450,16
1,426,10,-721642366,-721642354,12
1,428,11,-721642265,-721642251,14
1,430,12,-721642165,-721642153,12
1,432,13,-721642064,-721642051,13
1,434,14,-721641963,-721641953,10
1,436,15,-721641862,-721641850,12
1,438,16,-721641762,-721641754,8
1,440,17,-721641661,-721641651,10
1,442,18,-721641561,-721641553,8
1,444,19,-721641460,-721641451,9
1,446,20,-721641360,-721641353,7
1,448,21,-721641259,-721641251,8
1,450,22,-721641158,-721641153,5
1,452,23,-721641057,-721641050,7
1,454,24,-721640957,-721640953,4
1,456,25,-721640856,-721640850,6
1,458,26,-721640756,-721640753,3
1,460,27,-721640655,-721640652,3
1,462,28,-721640554,-721640552,2
1,464,29,-721640454,-721640452,2
1,466,30,-721640353,-721640352,1
1,468,31,-721640253,-721640251,2
1,469,32,-721640202,-721640152,50
1,472,33,-721640051,-721640050,1
1,473,34,-721640001,-721639952,49
1,476,35,-721639850,-721639850,0
1,477,36,-721639800,-721639753,47
1,479,37,-721639699,-721639651,48
1,481,38,-721639599,-721639553,46
1,483,39,-721639498,-721639451,47
1,485,40,-721639398,-721639353,45
1,487,41,-721639297,-721639251,46
1,489,42,-721639197,-721639152,45
1,491,43,-721639096,-721639051,45
1,493,44,-721638995,-721638952,43
1,495,45,-721638895,-721638851,44
1,497,46,-721638794,-721638753,41
1,499,47,-721638693,-721638651,42
1,501,48,-721638593,-721638553,40
1,503,49,-721638492,-721638452,40
1,505,50,-721638391,-721638352,39
1,507,51,-721638291,-721638251,40
1,509,52,-721638190,-721638152,38
1,511,53,-721638089,-721638050,39
1,513,54,-721637989,-721637953,36
1,515,55,-721637888,-721637851,37
1,517,56,-721637787,-721637753,34
1,519,57,-721637687,-721637652,35
1,521,58,-721637586,-721637553,33
1,523,59,-721637485,-721637451,34
1,525,60,-721637385,-721637354,31
1,527,61,-721637284,-721637251,33
1,529,62,-721637183,-721637153,30
1,531,63,-721637083,-721637051,32
1,533,64,-721636982,-721636953,29
1,535,65,-721636881,-721636850,31
1,537,66,-721636781,-721636754,27
1,539,67,-721636680,-721636652,28
1,541,68,-721636579,-721636554,25
1,543,69,-721636478,-721636451,27
1,545,70,-721636377,-721636354,23
1,547,71,-721636277,-721636251,26
1,549,72,-721636176,-721636154,22
1,551,73,-721636075,-721636050,25
1,553,74,-721635975,-721635955,20
1,555,75,-721635874,-721635851,23
1,557,76,-721635773,-721635755,18
1,559,77,-721635672,-721635651,21
1,561,78,-721635570,-721635555,15
1,563,79,-721635469,-721635450,19
1,565,80,-721635369,-721635355,14
1,567,81,-721635268,-721635250,18
1,569,82,-721635168,-721635156,12
1,571,83,-721635067,-721635050,17
1,573,84,-721634967,-721634956,11
1,575,85,-721634866,-721634850,16
1,577,86,-721634765,-721634756,9
1,579,87,-721634665,-721634651,14
1,581,88,-721634564,-721634555,9
1,583,89,-721634463,-721634450,13
1,585,90,-721634363,-721634355,8
1,587,91,-721634262,-721634250,12
1,589,92,-721634161,-721634155,6
1,591,93,-721634060,-721634049,11
1,593,94,-721633960,-721633955,5
1,595,95,-721633859,-721633850,9
1,597,96,-721633758,-721633755,3
1,599,97,-721633658,-721633651,7
1,601,98,-721633557,-721633555,2
1,603,99,-721633456,-721633450,6
1,605,100,-721633356,-721633355,1
1,607,101,-721633255,-721633251,4
1,609,102,-721633155,-721633155,0
1,611,103,-721633054,-721633051,3
1,612,104,-721633004,-721632955,49
1,615,105,-721632853,-721632851,2
1,616,106,-721632802,-721632755,47
1,618,107,-721632702,-721632652,50
1,620,108,-721632601,-721632555,46
1,622,109,-721632500,-721632451,49
1,624,110,-721632400,-721632355,45
1,626,111,-721632299,-721632251,48
1,628,112,-721632198,-721632154,44
1,630,113,-721632098,-721632051,47
1,632,114,-721631997,-721631954,43
1,634,115,-721631896,-721631850,46
1,636,116,-721631796,-721631756,40
1,638,117,-721631695,-721631652,43
1,640,118,-721631595,-721631555,40
1,642,119,-721631494,-721631452,42
1,644,120,-721631393,-721631355,38
1,646,121,-721631293,-721631250,43
1,648,122,-721631192,-721631155,37
1,650,123,-721631091,-721631050,41
1,652,124,-721630991,-721630955,36
1,654,125,-721630890,-721630851,39
1,656,126,-721630789,-721630756,33
1,658,127,-721630689,-721630651,38
1,660,128,-721630588,-721630555,33
1,662,129,-721630487,-721630451,36
1,664,130,-721630387,-721630356,31
1,666,131,-721630286,-721630251,35
1,668,132,-721630185,-721630155,30
1,670,133,-721630084,-721630050,34
1,672,134,-721629984,-721629956,28
1,674,135,-721629883,-721629851,32
1,676,136,-721629782,-721629756,26
1,678,137,-721629682,-721629652,30
1,680,138,-721629581,-721629555,26
1,682,139,-721629481,-721629452,29
1,684,140,-721629380,-721629355,25
1,686,141,-721629279,-721629250,29
1,688,142,-721629179,-721629155,24
1,690,143,-721629078,-721629051,27
1,692,144,-721628977,-721628954,23
1,694,145,-721628877,-721628851,26
1,696,146,-721628776,-721628755,21
1,698,147,-721628675,-721628651,24
1,700,148,-721628575,-721628556,19
1,702,149,-721628474,-721628452,22
1,704,150,-721628373,-721628355,18
1,706,151,-721628273,-721628251,22
1,708,152,-721628172,-721628155,17
1,710,153,-721628071,-721628050,21
1,712,154,-721627970,-721627955,15
1,714,155,-721627870,-721627851,19
1,716,156,-721627769,-721627756,13
1,718,157,-721627668,-721627652,16
1,720,158,-721627567,-721627555,12
1,722,159,-721627467,-721627451,16
1,724,160,-721627366,-721627355,11
1,726,161,-721627265,-721627250,15
1,728,162,-721627164,-721627154,10
1,730,163,-721627064,-721627050,14
1,732,164,-721626963,-721626954,9
1,734,165,-721626863,-721626849,14
1,736,166,-721626762,-721626755,7
1,738,167,-721626661,-721626650,11
1,740,168,-721626561,-721626556,5
1,742,169,-721626460,-721626451,9
1,744,170,-721626359,-721626355,4
1,746,171,-721626259,-721626251,8
1,748,172,-721626158,-721626155,3
1,750,173,-721626057,-721626050,7
1,752,174,-721625957,-721625955,2
1,754,175,-721625856,-721625851,5
1,756,176,-721625756,-721625756,0
1,758,177,-721625655,-721625652,3
1,760,178,-721625554,-721625554,0
1,762,179,-721625454,-721625452,2
1,763,180,-721625404,-721625355,49
1,766,181,-721625253,-721625251,2
1,767,182,-721625202,-721625154,48
1,770,183,-721625051,-721625050,1
1,771,184,-721625001,-721624954,47
1,774,185,-721624850,-721624850,0
1,775,186,-721624800,-721624756,44
1,777,187,-721624699,-721624651,48
1,779,188,-721624598,-721624555,43
1,781,189,-721624497,-721624450,47
1,783,190,-721624397,-721624356,41
1,785,191,-721624296,-721624251,45
1,787,192,-721624195,-721624155,40
1,789,193,-721624095,-721624051,44
1,791,194,-721623994,-721623955,39
1,793,195,-721623893,-721623850,43
1,795,196,-721623793,-721623757,36
1,797,197,-721623692,-721623652,40
1,799,198,-721623591,-721623555,36
1,799,199,-721623591,-721623553,38
1,801,200,-721623491,-721623452,39
1,803,201,-721623390,-721623355,35
1,803,202,-721623390,-721623353,37
1,804,203,-721623340,-721623301,39
1,805,204,-721623289,-721623250,39
1,807,205,-721623189,-721623156,33
1,807,206,-721623189,-721623153,36
1,808,207,-721623138,-721623100,38
1,809,208,-721623088,-721623051,37
1,811,209,-721622988,-721622955,33
1,811,210,-721622988,-721622952,36
1,812,211,-721622937,-721622900,37
1,813,212,-721622887,-721622851,36
1,815,213,-721622786,-721622756,30
1,815,214,-721622786,-721622753,33
1,816,215,-721622736,-721622701,35
1,817,216,-721622686,-721622652,34
1,819,217,-721622585,-721622555,30
1,819,218,-721622585,-721622553,32
1,820,219,-721622535,-721622502,33
1,821,220,-721622485,-721622451,34
1,823,221,-721622384,-721622355,29
1,823,222,-721622384,-721622352,32
1,824,223,-721622333,-721622301,32
1,825,224,-721622283,-721622251,32
1,827,225,-721622182,-721622155,27
1,827,226,-721622182,-721622151,31
1,828,227,-721622132,-721622101,31
1,829,228,-721622081,-721622050,31
1,831,229,-721621981,-721621955,26
1,831,230,-721621981,-721621952,29
1,832,231,-721621931,-721621901,30
1,833,232,-721621880,-721621850,30
1,835,233,-721621780,-721621756,24
1,835,234,-721621780,-721621753,27
1,836,235,-721621729,-721621702,27
1,837,236,-721621679,-721621652,27
1,839,237,-721621578,-721621555,23
1,839,238,-721621578,-721621552,26
1,840,239,-721621528,-721621502,26
1,841,240,-721621478,-721621452,26
1,843,241,-721621377,-721621355,22
1,843,242,-721621377,-721621352,25
1,844,243,-721621327,-721621302,25
1,845,244,-721621276,-721621250,26
1,847,245,-721621175,-721621155,20
1,847,246,-721621175,-721621151,24
1,848,247,-721621125,-721621101,24
1,849,248,-721621075,-721621051,24
1,851,249,-721620974,-721620955,19
1,851,250,-721620974,-721620952,22
1,852,251,-721620923,-721620901,22
1,853,252,-721620873,-721620851,22
1,855,253,-721620771,-721620755,16
1,855,254,-721620771,-721620752,19
1,856,255,-721620721,-721620702,19
1,857,256,-721620671,-721620652,19
1,859,257,-721620570,-721620555,15
1,859,258,-721620570,-721620552,18
1,860,259,-721620520,-721620503,17
1,861,260,-721620470,-721620451,19
1,863,261,-721620369,-721620355,14
1,863,262,-721620369,-721620353,16
1,864,263,-721620318,-721620301,17
1,865,264,-721620268,-721620250,18
1,867,265,-721620167,-721620154,13
1,867,266,-721620167,-721620152,15
1,868,267,-721620117,-721620102,15
1,869,268,-721620067,-721620050,17
1,871,269,-721619966,-721619954,12
1,872,270,-721619916,-721619902,14
1,873,271,-721619865,-721619849,16
1,875,272,-721619765,-721619755,10
1,876,273,-721619714,-721619702,12
1,877,274,-721619664,-721619651,13
1,879,275,-721619563,-721619554,9
1,880,276,-721619513,-721619502,11
1,881,277,-721619463,-721619451,12
1,883,278,-721619362,-721619354,8
1,884,279,-721619312,-721619302,10
1,885,280,-721619261,-721619250,11
1,887,281,-721619161,-721619155,6
1,888,282,-721619110,-721619101,9
1,889,283,-721619060,-721619051,9
1,891,284,-721618959,-721618954,5
1,892,285,-721618909,-721618901,8
1,895,286,-721618758,-721618755,3
1,896,287,-721618708,-721618703,5
1,897,288,-721618657,-721618651,6
1,899,289,-721618557,-721618555,2
1,900,290,-721618506,-721618502,4
1,901,291,-721618456,-721618451,5
1,903,292,-721618355,-721618355,0
1,904,293,-721618305,-721618301,4
1,905,294,-721618255,-721618251,4
1,906,295,-721618205,-721618155,50
1,908,296,-721618104,-721618101,3
1,909,297,-721618054,-721618051,3
1,910,298,-721618003,-721617955,48
1,912,299,-721617903,-721617901,2
1,913,300,-721617852,-721617850,2
1,914,301,-721617802,-721617756,46
1,916,302,-721617702,-721617702,0
1,917,303,-721617651,-721617651,0
1,918,304,-721617601,-721617555,46
1,919,305,-721617551,-721617502,49
1,920,306,-721617500,-721617451,49
1,922,307,-721617400,-721617356,44
1,924,308,-721617299,-721617251,48
1,926,309,-721617198,-721617155,43
1,927,310,-721617148,-721617101,47
1,928,311,-721617098,-721617051,47
1,930,312,-721616997,-721616955,42
1,931,313,-721616947,-721616901,46
1,932,314,-721616896,-721616850,46
1,934,315,-721616796,-721616756,40
1,935,316,-721616745,-721616701,44
1,936,317,-721616695,-721616651,44
1,938,318,-721616594,-721616555,39
1,939,319,-721616544,-721616502,42
1,940,320,-721616494,-721616450,44
1,942,321,-721616393,-721616355,38
1,943,322,-721616343,-721616302,41
1,944,323,-721616292,-721616250,42
1,946,324,-721616192,-721616156,36
1,947,325,-721616141,-721616101,40
1,948,326,-721616091,-721616051,40
1,950,327,-721615990,-721615955,35
1,951,328,-721615940,-721615901,39
1,954,329,-721615789,-721615756,33
1,955,330,-721615739,-721615702,37
1,956,331,-721615689,-721615651,38
1,958,332,-721615588,-721615555,33
1,959,333,-721615538,-721615503,35
1,960,334,-721615487,-721615451,36
1,962,335,-721615387,-721615355,32
1,963,336,-721615336,-721615301,35
1,964,337,-721615286,-721615251,35
1,966,338,-721615185,-721615155,30
1,967,339,-721615135,-721615101,34
1,968,340,-721615085,-721615051,34
1,970,341,-721614984,-721614955,29
1,971,342,-721614933,-721614901,32
1,972,343,-721614883,-721614851,32
1,974,344,-721614782,-721614756,26
1,975,345,-721614732,-721614702,30
1,976,346,-721614682,-721614652,30
1,978,347,-721614581,-721614555,26
1,979,348,-721614531,-721614503,28
1,980,349,-721614480,-721614451,29
1,982,350,-721614380,-721614355,25
1,983,351,-721614329,-721614301,28
1,984,352,-721614279,-721614251,28
1,986,353,-721614178,-721614154,24
1,987,354,-721614128,-721614101,27
1,988,355,-721614078,-721614051,27
1,991,356,-721613927,-721613902,25
1,992,357,-721613876,-721613850,26
1,994,358,-721613775,-721613755,20
1,995,359,-721613725,-721613702,23
1,996,360,-721613675,-721613651,24
1,998,361,-721613574,-721613555,19
1,999,362,-721613524,-721613502,22
1,1000,363,-721613473,-721613451,22
1,1002,364,-721613373,-721613356,17
1,1003,365,-721613322,-721613301,21
1,1004,366,-721613272,-721613251,21
1,1006,367,-721613171,-721613155,16
1,1007,368,-721613121,-721613101,20
1,1008,369,-721613071,-721613051,20
1,1010,370,-721612970,-721612955,15
1,1011,371,-721612920,-721612901,19
1,1012,372,-721612870,-721612851,19
1,1014,373,-721612769,-721612756,13
1,1015,374,-721612719,-721612702,17
1,1016,375,-721612667,-721612651,16
1,1018,376,-721612567,-721612555,12
1,1019,377,-721612517,-721612501,16
1,1020,378,-721612466,-721612452,14
1,1022,379,-721612366,-721612354,12
1,1023,380,-721612315,-721612301,14
1,1024,381,-721612265,-721612251,14
1,1026,382,-721612164,-721612154,10
1,1027,383,-721612114,-721612102,12
1,1028,384,-721612064,-721612051,13
1,1030,385,-721611963,-721611954,9
1,1031,386,-721611913,-721611901,12
1,1032,387,-721611862,-721611850,12
1,1034,388,-721611761,-721611755,6
1,1035,389,-721611711,-721611702,9
1,1036,390,-721611661,-721611652,9
1,1038,391,-721611560,-721611555,5
1,1039,392,-721611509,-721611501,8
1,1040,393,-721611459,-721611452,7
1,1042,394,-721611358,-721611355,3
1,1043,395,-721611308,-721611301,7
1,1044,396,-721611258,-721611251,7
1,1046,397,-721611157,-721611155,2
1,1047,398,-721611107,-721611101,6
1,1048,399,-721611056,-721611050,6
1,1050,400,-721610956,-721610956,0
1,1051,401,-721610905,-721610900,5
1,1052,402,-721610855,-721610851,4
1,1053,403,-721610805,-721610757,48
1,1055,404,-721610704,-721610701,3
1,1056,405,-721610654,-721610652,2
1,1057,406,-721610603,-721610555,48
1,1059,407,-721610502,-721610500,2
1,1060,408,-721610452,-721610452,0
1,1061,409,-721610401,-721610355,46
1,1063,410,-721610300,-721610300,0
1,1063,411,-721610300,-721610251,49
1,1065,412,-721610199,-721610155,44
1,1066,413,-721610149,-721610100,49
1,1067,414,-721610098,-721610050,48
1,1069,415,-721609997,-721609955,42
1,1070,416,-721609947,-721609900,47
1,1071,417,-721609896,-721609849,47
1,1073,418,-721609796,-721609756,40
1,1074,419,-721609746,-721609701,45
1,1075,420,-721609695,-721609650,45
1,1077,421,-721609595,-721609556,39
1,1078,422,-721609544,-721609501,43
1,1079,423,-721609494,-721609451,43
1,1081,424,-721609393,-721609355,38
1,1082,425,-721609343,-721609301,42
1,1083,426,-721609293,-721609251,42
1,1085,427,-721609192,-721609155,37
1,1086,428,-721609142,-721609102,40
1,1087,429,-721609091,-721609050,41
1,1089,430,-721608991,-721608956,35
1,1090,431,-721608940,-721608901,39
1,1091,432,-721608890,-721608851,39
1,1093,433,-721608789,-721608756,33
1,1094,434,-721608739,-721608702,37
1,1095,435,-721608689,-721608652,37
1,1097,436,-721608588,-721608555,33
1,1098,437,-721608537,-721608502,35
1,1099,438,-721608487,-721608452,35
1,1101,439,-721608385,-721608355,30
1,1102,440,-721608335,-721608301,34
1,1103,441,-721608285,-721608251,34
1,1105,442,-721608184,-721608155,29
1,1106,443,-721608134,-721608101,33
1,1107,444,-721608084,-721608051,33
1,1109,445,-721607983,-721607955,28
1,1110,446,-721607932,-721607900,32
1,1111,447,-721607882,-721607851,31
1,1113,448,-721607781,-721607756,25
1,1114,449,-721607731,-721607701,30
1,1115,450,-721607681,-721607652,29
1,1117,451,-721607580,-721607555,25
1,1118,452,-721607530,-721607502,28
1,1119,453,-721607480,-721607451,29
1,1121,454,-721607379,-721607355,24
1,1122,455,-721607329,-721607302,27
1,1123,456,-721607278,-721607250,28
1,1125,457,-721607178,-721607155,23
1,1126,458,-721607127,-721607101,26
1,1127,459,-721607077,-721607051,26
1,1129,460,-721606976,-721606955,21
1,1130,461,-721606926,-721606902,24
1,1131,462,-721606876,-721606851,25
1,1133,463,-721606775,-721606756,19
1,1134,464,-721606725,-721606703,22
1,1135,465,-721606674,-721606651,23
1,1137,466,-721606573,-721606555,18
1,1138,467,-721606523,-721606502,21
1,1139,468,-721606473,-721606452,21
1,1141,469,-721606372,-721606355,17
1,1142,470,-721606322,-721606302,20
1,1143,471,-721606271,-721606250,21
1,1145,472,-721606171,-721606155,16
1,1146,473,-721606120,-721606101,19
1,1147,474,-721606070,-721606050,20
1,1149,475,-721605969,-721605955,14
1,1150,476,-721605919,-721605901,18
1,1151,477,-721605869,-721605850,19
1,1153,478,-721605768,-721605756,12
1,1154,479,-721605718,-721605703,15
1,1155,480,-721605667,-721605650,17
1,1157,481,-721605567,-721605555,12
1,1158,482,-721605516,-721605502,14
1,1159,483,-721605466,-721605451,15
1,1161,484,-721605365,-721605354,11
1,1162,485,-721605315,-721605301,14
1,1163,486,-721605265,-721605251,14
1,1165,487,-721605164,-721605154,10
1,1166,488,-721605114,-721605102,12
1,1167,489,-721605063,-721605050,13
1,1169,490,-721604963,-721604954,9
1,1170,491,-721604912,-721604901,11
1,1171,492,-721604862,-721604851,11
1,1173,493,-721604761,-721604754,7
1,1173,494,-721604761,-721604751,10
1,1174,495,-721604711,-721604702,9
1,1177,496,-721604560,-721604554,6
1,1177,497,-721604560,-721604551,9
1,1178,498,-721604510,-721604503,7
1,1179,499,-721604459,-721604451,8
1,1181,500,-721604359,-721604355,4
1,1181,501,-721604359,-721604351,8
1,1182,502,-721604308,-721604301,7
1,1183,503,-721604258,-721604251,7
1,1185,504,-721604157,-721604151,6
1,1186,505,-721604107,-721604101,6
1,1187,506,-721604057,-721604051,6
1,1189,507,-721603956,-721603954,2
1,1189,508,-721603956,-721603951,5
1,1190,509,-721603906,-721603902,4
1,1191,510,-721603855,-721603850,5
1,1193,511,-721603754,-721603753,1
1,1193,512,-721603754,-721603751,3
1,1194,513,-721603702,-721603702,0
1,1194,514,-721603702,-721603652,50
1,1196,515,-721603601,-721603600,1
1,1196,516,-721603601,-721603553,48
1,1196,517,-721603601,-721603551,50
1,1197,518,-721603551,-721603502,49
1,1198,519,-721603501,-721603452,49
1,1199,520,-721603450,-721603400,50
1,1200,521,-721603400,-721603353,47
1,1200,522,-721603400,-721603351,49
1,1201,523,-721603350,-721603302,48
1,1202,524,-721603299,-721603250,49
1,1203,525,-721603249,-721603200,49
1,1204,526,-721603199,-721603154,45
1,1204,527,-721603199,-721603152,47
1,1205,528,-721603148,-721603101,47
1,1206,529,-721603098,-721603051,47
1,1207,530,-721603048,-721603001,47
1,1208,531,-721602997,-721602953,44
1,1208,532,-721602997,-721602951,46
1,1209,533,-721602947,-721602901,46
1,1210,534,-721602897,-721602851,46
1,1211,535,-721602846,-721602800,46
1,1212,536,-721602796,-721602754,42
1,1214,537,-721602695,-721602651,44
1,1215,538,-721602645,-721602600,45
1,1216,539,-721602594,-721602554,40
1,1216,540,-721602594,-721602552,42
1,1217,541,-721602544,-721602502,42
1,1218,542,-721602493,-721602451,42
1,1219,543,-721602443,-721602400,43
1,1220,544,-721602393,-721602354,39
1,1220,545,-721602393,-721602353,40
1,1221,546,-721602342,-721602301,41
1,1222,547,-721602292,-721602251,41
1,1223,548,-721602242,-721602201,41
1,1224,549,-721602191,-721602153,38
1,1224,550,-721602191,-721602152,39
1,1225,551,-721602141,-721602101,40
1,1227,552,-721602040,-721602000,40
1,1228,553,-721601990,-721601953,37
1,1228,554,-721601990,-721601953,37
1,1229,555,-721601940,-721601901,39
1,1231,556,-721601839,-721601800,39
1,1232,557,-721601789,-721601755,34
1,1232,558,-721601789,-721601754,35
1,1233,559,-721601738,-721601702,36
1,1235,560,-721601638,-721601601,37
1,1236,561,-721601587,-721601554,33
1,1236,562,-721601587,-721601553,34
1,1237,563,-721601537,-721601502,35
1,1239,564,-721601436,-721601400,36
1,1240,565,-721601386,-721601354,32
1,1240,566,-721601386,-721601352,34
1,1241,567,-721601336,-721601302,34
1,1243,568,-721601235,-721601200,35
1,1244,569,-721601185,-721601154,31
1,1244,570,-721601185,-721601153,32
1,1245,571,-721601135,-721601102,33
1,1247,572,-721601034,-721601000,34
1,1248,573,-721600984,-721600954,30
1,1248,574,-721600984,-721600952,32
1,1249,575,-721600933,-721600901,32
1,1251,576,-721600832,-721600799,33
1,1252,577,-721600782,-721600753,29
1,1253,578,-721600732,-721600703,29
1,1255,579,-721600631,-721600599,32
1,1256,580,-721600580,-721600555,25
1,1256,581,-721600580,-721600553,27
1,1257,582,-721600530,-721600502,28
1,1259,583,-721600430,-721600400,30
1,1260,584,-721600379,-721600355,24
1,1260,585,-721600379,-721600352,27
1,1261,586,-721600329,-721600301,28
1,1263,587,-721600228,-721600199,29
1,1264,588,-721600178,-721600155,23
1,1264,589,-721600178,-721600152,26
1,1265,590,-721600128,-721600101,27
1,1267,591,-721600027,-721599999,28
1,1268,592,-721599977,-721599955,22
1,1268,593,-721599977,-721599952,25
1,1269,594,-721599927,-721599901,26
1,1271,595,-721599826,-721599799,27
1,1272,596,-721599776,-721599756,20
1,1272,597,-721599776,-721599753,23
1,1273,598,-721599725,-721599701,24
1,1275,599,-721599625,-721599599,26
1,1276,600,-721599574,-721599555,19
1,1276,601,-721599574,-721599552,22
1,1277,602,-721599524,-721599501,23
1,1279,603,-721599423,-721599399,24
1,1280,604,-721599373,-721599355,18
1,1280,605,-721599373,-721599352,21
1,1281,606,-721599323,-721599301,22
1,1284,607,-721599172,-721599156,16
1,1284,608,-721599172,-721599152,20
1,1285,609,-721599121,-721599100,21
1,1287,610,-721599021,-721598999,22
1,1288,611,-721598970,-721598955,15
1,1288,612,-721598970,-721598951,19
1,1289,613,-721598920,-721598900,20
1,1291,614,-721598819,-721598799,20
1,1292,615,-721598769,-721598756,13
1,1292,616,-721598769,-721598752,17
1,1293,617,-721598719,-721598702,17
1,1295,618,-721598618,-721598599,19
1,1296,619,-721598568,-721598555,13
1,1296,620,-721598568,-721598552,16
1,1297,621,-721598517,-721598501,16
1,1299,622,-721598417,-721598400,17
1,1300,623,-721598367,-721598355,12
1,1300,624,-721598367,-721598352,15
1,1303,625,-721598216,-721598200,16
1,1304,626,-721598165,-721598154,11
1,1304,627,-721598165,-721598151,14
1,1307,628,-721598014,-721597999,15
1,1308,629,-721597964,-721597954,10
1,1308,630,-721597964,-721597951,13
1,1311,631,-721597813,-721597800,13
1,1312,632,-721597763,-721597755,8
1,1315,633,-721597612,-721597601,11
1,1316,634,-721597561,-721597555,6
1,1316,635,-721597561,-721597552,9
1,1319,636,-721597410,-721597401,9
1,1320,637,-721597359,-721597355,4
1,1320,638,-721597359,-721597351,8
1,1323,639,-721597208,-721597200,8
1,1324,640,-721597157,-721597155,2
1,1324,641,-721597157,-721597151,6
1,1327,642,-721597007,-721597001,6
1,1328,643,-721596956,-721596955,1
1,1328,644,-721596956,-721596951,5
1,1331,645,-721596805,-721596801,4
1,1331,646,-721596805,-721596756,49
1,1332,647,-721596755,-721596753,2
1,1335,648,-721596604,-721596601,3
1,1335,649,-721596604,-721596555,49
1,1336,650,-721596554,-721596552,2
1,1339,651,-721596403,-721596401,2
1,1339,652,-721596403,-721596353,50
1,1343,653,-721596202,-721596201,1
1,1343,654,-721596202,-721596155,47
1,1343,655,-721596202,-721596153,49
1,1347,656,-721596000,-721596000,0
1,1347,657,-721596000,-721595954,46
1,1347,658,-721596000,-721595952,48
1,1350,659,-721595849,-721595800,49
1,1351,660,-721595799,-721595756,43
1,1351,661,-721595799,-721595753,46
1,1354,662,-721595648,-721595600,48
1,1355,663,-721595598,-721595556,42
1,1355,664,-721595598,-721595553,45
1,1358,665,-721595446,-721595399,47
1,1359,666,-721595396,-721595355,41
1,1359,667,-721595396,-721595352,44
1,1362,668,-721595245,-721595200,45
1,1363,669,-721595195,-721595155,40
1,1363,670,-721595195,-721595152,43
1,1366,671,-721595044,-721595000,44
1,1367,672,-721594993,-721594955,38
1,1367,673,-721594993,-721594952,41
1,1370,674,-721594842,-721594799,43
1,1371,675,-721594792,-721594756,36
1,1371,676,-721594792,-721594754,38
1,1374,677,-721594641,-721594599,42
1,1375,678,-721594591,-721594556,35
1,1375,679,-721594591,-721594554,37
1,1378,680,-721594439,-721594399,40
1,1379,681,-721594389,-721594355,34
1,1379,682,-721594389,-721594352,37
1,1382,683,-721594238,-721594199,39
1,1383,684,-721594187,-721594155,32
1,1383,685,-721594187,-721594151,36
1,1386,686,-721594036,-721593998,38
1,1387,687,-721593986,-721593955,31
1,1387,688,-721593986,-721593951,35
1,1390,689,-721593835,-721593798,37
1,1391,690,-721593785,-721593756,29
1,1391,691,-721593785,-721593753,32
1,1394,692,-721593634,-721593598,36
1,1395,693,-721593584,-721593556,28
1,1395,694,-721593584,-721593553,31
1,1398,695,-721593433,-721593398,35
1,1399,696,-721593382,-721593352,30
1,1402,697,-721593231,-721593197,34
1,1403,698,-721593181,-721593155,26
1,1403,699,-721593181,-721593152,29
1,1406,700,-721593030,-721592997,33
1,1407,701,-721592980,-721592956,24
1,1407,702,-721592980,-721592952,28
1,1410,703,-721592829,-721592798,31
1,1411,704,-721592778,-721592756,22
1,1411,705,-721592778,-721592752,26
1,1414,706,-721592627,-721592597,30
1,1415,707,-721592577,-721592555,22
1,1415,708,-721592577,-721592553,24
1,1418,709,-721592426,-721592397,29
1,1419,710,-721592376,-721592356,20
1,1419,711,-721592376,-721592353,23
1,1422,712,-721592224,-721592197,27
1,1423,713,-721592174,-721592155,19
1,1423,714,-721592174,-721592152,22
1,1426,715,-721592023,-721591997,26
1,1427,716,-721591973,-721591956,17
1,1427,717,-721591973,-721591953,20
1,1430,718,-721591821,-721591797,24
1,1431,719,-721591771,-721591753,18
1,1434,720,-721591619,-721591597,22
1,1435,721,-721591569,-721591553,16
1,1438,722,-721591418,-721591397,21
1,1439,723,-721591368,-721591353,15
1,1442,724,-721591217,-721591197,20
1,1443,725,-721591167,-721591155,12
1,1443,726,-721591167,-721591152,15
1,1446,727,-721591016,-721590997,19
1,1447,728,-721590965,-721590955,10
1,1447,729,-721590965,-721590952,13
1,1450,730,-721590814,-721590797,17
1,1451,731,-721590764,-721590756,8
1,1451,732,-721590764,-721590754,10
1,1454,733,-721590613,-721590597,16
1,1455,734,-721590563,-721590556,7
1,1455,735,-721590563,-721590554,9
1,1458,736,-721590412,-721590396,16
1,1459,737,-721590361,-721590355,6
1,1459,738,-721590361,-721590352,9
1,1462,739,-721590209,-721590196,13
1,1463,740,-721590159,-721590155,4
1,1463,741,-721590159,-721590153,6
1,1466,742,-721590008,-721589996,12
1,1467,743,-721589958,-721589955,3
1,1467,744,-721589958,-721589953,5
1,1470,745,-721589807,-721589797,10
1,1471,746,-721589757,-721589757,0
1,1471,747,-721589757,-721589754,3
1,1474,748,-721589606,-721589598,8
1,1475,749,-721589556,-721589556,0
1,1475,750,-721589556,-721589554,2
1,1478,751,-721589405,-721589398,7
1,1478,752,-721589405,-721589356,49
1,1479,753,-721589354,-721589352,2
1,1482,754,-721589203,-721589197,6
1,1482,755,-721589203,-721589155,48
1,1483,756,-721589153,-721589152,1
1,1486,757,-721589002,-721588997,5
1,1486,758,-721589002,-721588955,47
1,1486,759,-721589002,-721588952,50
1,1490,760,-721588801,-721588798,3
1,1490,761,-721588801,-721588756,45
1,1490,762,-721588801,-721588753,48
1,1494,763,-721588600,-721588599,1
1,1494,764,-721588600,-721588555,45
1,1494,765,-721588600,-721588554,46
1,1497,766,-721588449,-721588399,50
1,1498,767,-721588398,-721588354,44
1,1498,768,-721588398,-721588352,46
1,1502,769,-721588197,-721588154,43
1,1502,770,-721588197,-721588152,45
1,1505,771,-721588046,-721587998,48
1,1506,772,-721587996,-721587954,42
1,1506,773,-721587996,-721587953,43
1,1509,774,-721587845,-721587799,46
1,1510,775,-721587794,-721587754,40
1,1510,776,-721587794,-721587753,41
1,1513,777,-721587643,-721587599,44
1,1514,778,-721587592,-721587553,39
1,1517,779,-721587441,-721587398,43
1,1518,780,-721587391,-721587354,37
1,1518,781,-721587391,-721587352,39
1,1521,782,-721587239,-721587199,40
1,1522,783,-721587188,-721587154,34
1,1522,784,-721587188,-721587152,36
1,1525,785,-721587038,-721586999,39
1,1526,786,-721586987,-721586954,33
1,1526,787,-721586987,-721586952,35
1,1529,788,-721586835,-721586798,37
1,1530,789,-721586785,-721586755,30
1,1530,790,-721586785,-721586753,32
1,1533,791,-721586634,-721586598,36
1,1534,792,-721586584,-721586556,28
1,1534,793,-721586584,-721586553,31
1,1537,794,-721586433,-721586399,34
1,1538,795,-721586382,-721586355,27
1,1538,796,-721586382,-721586352,30
1,1541,797,-721586231,-721586198,33
1,1542,798,-721586181,-721586155,26
1,1542,799,-721586181,-721586152,29
1,1545,800,-721586030,-721585998,32
1,1546,801,-721585980,-721585955,25
1,1549,802,-721585829,-721585798,31
1,1550,803,-721585779,-721585756,23
1,1553,804,-721585628,-721585598,30
1,1554,805,-721585577,-721585555,22
1,1557,806,-721585427,-721585398,29
1,1558,807,-721585376,-721585355,21
1,1561,808,-721585225,-721585197,28
1,1562,809,-721585175,-721585155,20
1,1565,810,-721585024,-721584997,27
1,1566,811,-721584974,-721584954,20
1,1569,812,-721584823,-721584799,24
1,1570,813,-721584772,-721584755,17
1,1573,814,-721584621,-721584598,23
1,1574,815,-721584571,-721584555,16
1,1577,816,-721584420,-721584398,22
1,1578,817,-721584370,-721584355,15
1,1581,818,-721584219,-721584199,20
1,1582,819,-721584168,-721584154,14
1,1585,820,-721584017,-721583998,19
1,1586,821,-721583967,-721583954,13
1,1589,822,-721583816,-721583800,16
1,1590,823,-721583765,-721583754,11
1,1593,824,-721583614,-721583599,15
1,1594,825,-721583564,-721583554,10
1,1598,826,-721583363,-721583354,9
1,1601,827,-721583211,-721583199,12
1,1602,828,-721583161,-721583155,6
1,1605,829,-721583010,-721582999,11
1,1606,830,-721582959,-721582954,5
1,1609,831,-721582808,-721582799,9
1,1610,832,-721582758,-721582755,3
1,1613,833,-721582607,-721582600,7
1,1614,834,-721582556,-721582555,1
1,1617,835,-721582405,-721582399,6
1,1617,836,-721582405,-721582355,50
1,1621,837,-721582204,-721582198,6
1,1621,838,-721582204,-721582155,49
1,1625,839,-721582003,-721581997,6
1,1625,840,-721582003,-721581955,48
1,1629,841,-721581802,-721581799,3
1,1633,842,-721581600,-721581598,2
1,1633,843,-721581600,-721581555,45
1,1637,844,-721581399,-721581398,1
1,1637,845,-721581399,-721581356,43
1,1641,846,-721581197,-721581197,0
1,1641,847,-721581197,-721581155,42
1,1644,848,-721581046,-721580997,49
1,1645,849,-721580996,-721580955,41
1,1648,850,-721580844,-721580797,47
1,1649,851,-721580794,-721580756,38
1,1650,852,-721580744,-721580706,38
1,1652,853,-721580643,-721580597,46
1,1653,854,-721580593,-721580555,38
1,1654,855,-721580543,-721580505,38
1,1656,856,-721580442,-721580397,45
1,1657,857,-721580392,-721580356,36
1,1658,858,-721580341,-721580304,37
1,1660,859,-721580241,-721580198,43
1,1661,860,-721580190,-721580155,35
1,1662,861,-721580140,-721580105,35
1,1664,862,-721580039,-721579997,42
1,1665,863,-721579989,-721579955,34
1,1666,864,-721579939,-721579905,34
1,1668,865,-721579838,-721579797,41
1,1669,866,-721579788,-721579756,32
1,1670,867,-721579737,-721579705,32
1,1672,868,-721579637,-721579598,39
1,1673,869,-721579586,-721579555,31
1,1674,870,-721579536,-721579505,31
1,1676,871,-721579436,-721579397,39
1,1677,872,-721579385,-721579355,30
1,1678,873,-721579335,-721579305,30
1,1680,874,-721579234,-721579197,37
1,1681,875,-721579184,-721579155,29
1,1682,876,-721579134,-721579105,29
1,1684,877,-721579033,-721578997,36
1,1685,878,-721578983,-721578956,27
1,1688,879,-721578832,-721578798,34
1,1689,880,-721578781,-721578756,25
1,1690,881,-721578731,-721578705,26
1,1692,882,-721578630,-721578597,33
1,1693,883,-721578580,-721578555,25
1,1694,884,-721578530,-721578505,25
1,1696,885,-721578429,-721578397,32
1,1697,886,-721578379,-721578355,24
1,1698,887,-721578328,-721578304,24
1,1700,888,-721578228,-721578197,31
1,1701,889,-721578177,-721578155,22
1,1702,890,-721578127,-721578105,22
1,1705,891,-721577976,-721577955,21
1,1706,892,-721577926,-721577905,21
1,1708,893,-721577825,-721577796,29
1,1710,894,-721577724,-721577705,19
1,1712,895,-721577624,-721577597,27
1,1714,896,-721577523,-721577505,18
1,1716,897,-721577422,-721577396,26
1,1718,898,-721577322,-721577305,17
1,1720,899,-721577221,-721577196,25
1,1722,900,-721577121,-721577105,16
1,1724,901,-721577020,-721576996,24
1,1726,902,-721576919,-721576904,15
1,1728,903,-721576819,-721576798,21
1,1730,904,-721576718,-721576706,12
1,1732,905,-721576617,-721576597,20
1,1734,906,-721576517,-721576505,12
1,1736,907,-721576416,-721576397,19
1,1738,908,-721576316,-721576304,12
1,1740,909,-721576215,-721576197,18
1,1742,910,-721576114,-721576104,10
1,1744,911,-721576014,-721575998,16
1,1746,912,-721575913,-721575904,9
1,1748,913,-721575812,-721575798,14
1,1750,914,-721575712,-721575705,7
1,1752,915,-721575611,-721575599,12
1,1754,916,-721575510,-721575504,6
1,1756,917,-721575410,-721575399,11
1,1758,918,-721575309,-721575305,4
1,1760,919,-721575208,-721575198,10
1,1762,920,-721575108,-721575105,3
1,1764,921,-721575007,-721574998,9
1,1766,922,-721574907,-721574905,2
1,1768,923,-721574806,-721574799,7
1,1770,924,-721574706,-721574706,0
1,1772,925,-721574605,-721574599,6
1,1773,926,-721574555,-721574505,50
1,1776,927,-721574404,-721574399,5
1,1777,928,-721574354,-721574305,49
1,1780,929,-721574203