t_id, iteration_count, request_count, request_start_time, request_end_time, request_processing_time
1,270,1,3578692125,3578692163,38
1,274,2,3578692327,3578692363,36
1,275,3,3578692378,3578692417,39
1,278,4,3578692530,3578692563,33
1,278,5,3578692530,3578692568,38
1,279,6,3578692580,3578692616,36
1,282,7,3578692732,3578692763,31
1,282,8,3578692732,3578692768,36
1,283,9,3578692783,3578692817,34
1,285,10,3578692885,3578692923,38
1,286,11,3578692935,3578692964,29
1,286,12,3578692935,3578692968,33
1,287,13,3578692986,3578693018,32
1,289,14,3578693087,3578693123,36
1,290,15,3578693138,3578693164,26
1,290,16,3578693138,3578693169,31
1,290,17,3578693138,3578693176,38
1,291,18,3578693188,3578693217,29
1,293,19,3578693290,3578693324,34
1,294,20,3578693341,3578693364,23
1,294,21,3578693341,3578693370,29
1,294,22,3578693341,3578693376,35
1,295,23,3578693391,3578693417,26
1,297,24,3578693492,3578693523,31
1,297,25,3578693492,3578693531,39
1,298,26,3578693543,3578693563,20
1,298,27,3578693543,3578693570,27
1,298,28,3578693543,3578693575,32
1,299,29,3578693593,3578693617,24
1,299,30,3578693593,3578693632,39
1,301,31,3578693695,3578693723,28
1,301,32,3578693695,3578693731,36
1,302,33,3578693746,3578693763,17
1,302,34,3578693746,3578693771,25
1,302,35,3578693746,3578693776,30
1,303,36,3578693797,3578693817,20
1,303,37,3578693797,3578693831,34
1,304,38,3578693848,3578693886,38
1,305,39,3578693898,3578693924,26
1,305,40,3578693898,3578693931,33
1,306,41,3578693949,3578693964,15
1,306,42,3578693949,3578693971,22
1,306,43,3578693949,3578693975,26
1,307,44,3578694000,3578694017,17
1,307,45,3578694000,3578694031,31
1,308,46,3578694051,3578694087,36
1,309,47,3578694101,3578694124,23
1,309,48,3578694101,3578694132,31
1,310,49,3578694152,3578694164,12
1,310,50,3578694152,3578694172,20
1,310,51,3578694152,3578694175,23
1,311,52,3578694202,3578694217,15
1,311,53,3578694202,3578694232,30
1,311,54,3578694202,3578694240,38
1,312,55,3578694253,3578694287,34
1,313,56,3578694304,3578694324,20
1,313,57,3578694304,3578694333,29
1,314,58,3578694355,3578694364,9
1,314,59,3578694355,3578694373,18
1,314,60,3578694355,3578694376,21
1,315,61,3578694405,3578694416,11
1,315,62,3578694405,3578694431,26
1,315,63,3578694405,3578694440,35
1,316,64,3578694456,3578694488,32
1,316,65,3578694456,3578694494,38
1,317,66,3578694507,3578694523,16
1,317,67,3578694507,3578694532,25
1,318,68,3578694558,3578694563,5
1,318,69,3578694558,3578694572,14
1,318,70,3578694558,3578694575,17
1,318,71,3578694558,3578694594,36
1,319,72,3578694609,3578694615,6
1,319,73,3578694609,3578694630,21
1,319,74,3578694609,3578694639,30
1,319,75,3578694609,3578694644,35
1,320,76,3578694659,3578694687,28
1,320,77,3578694659,3578694694,35
1,321,78,3578694710,3578694723,13
1,321,79,3578694710,3578694733,23
1,322,80,3578694761,3578694763,2
1,322,81,3578694761,3578694772,11
1,322,82,3578694761,3578694775,14
1,322,83,3578694761,3578694794,33
1,323,84,3578694812,3578694816,4
1,323,85,3578694812,3578694830,18
1,323,86,3578694812,3578694839,27
1,323,87,3578694812,3578694845,33
1,324,88,3578694863,3578694888,25
1,324,89,3578694863,3578694894,31
1,325,90,3578694914,3578694923,9
1,325,91,3578694914,3578694933,19
1,325,92,3578694914,3578694949,35
1,325,93,3578694914,3578694963,49
1,326,94,3578694965,3578694972,7
1,326,95,3578694965,3578694975,10
1,326,96,3578694965,3578694994,29
1,326,97,3578694965,3578695000,35
1,327,98,3578695016,3578695016,0
1,327,99,3578695016,3578695031,15
1,327,100,3578695016,3578695040,24
1,327,101,3578695016,3578695044,28
1,328,102,3578695067,3578695088,21
1,328,103,3578695067,3578695095,28
1,329,104,3578695117,3578695123,6
1,329,105,3578695117,3578695133,16
1,329,106,3578695117,3578695150,33
1,329,107,3578695117,3578695163,46
1,330,108,3578695168,3578695173,5
1,330,109,3578695168,3578695175,7
1,330,110,3578695168,3578695194,26
1,330,111,3578695168,3578695200,32
1,330,112,3578695168,3578695215,47
1,331,113,3578695219,3578695231,12
1,331,114,3578695219,3578695240,21
1,331,115,3578695219,3578695245,26
1,332,116,3578695270,3578695287,17
1,332,117,3578695270,3578695295,25
1,333,118,3578695321,3578695323,2
1,333,119,3578695321,3578695334,13
1,333,120,3578695321,3578695350,29
1,333,121,3578695321,3578695355,34
1,333,122,3578695321,3578695362,41
1,334,123,3578695372,3578695373,1
1,334,124,3578695372,3578695375,3
1,334,125,3578695372,3578695394,22
1,334,126,3578695372,3578695400,28
1,334,127,3578695372,3578695415,43
1,335,128,3578695423,3578695432,9
1,335,129,3578695423,3578695441,18
1,335,130,3578695423,3578695445,22
1,335,131,3578695423,3578695456,33
1,336,132,3578695474,3578695486,12
1,336,133,3578695474,3578695494,20
1,336,134,3578695474,3578695522,48
1,337,135,3578695525,3578695533,8
1,337,136,3578695525,3578695549,24
1,337,137,3578695525,3578695554,29
1,337,138,3578695525,3578695562,37
1,337,139,3578695525,3578695573,48
1,337,140,3578695525,3578695574,49
1,338,141,3578695576,3578695593,17
1,338,142,3578695576,3578695599,23
1,338,143,3578695576,3578695615,39
1,339,144,3578695627,3578695631,4
1,339,145,3578695627,3578695640,13
1,339,146,3578695627,3578695644,17
1,339,147,3578695627,3578695655,28
1,339,148,3578695627,3578695658,31
1,340,149,3578695678,3578695687,9
1,340,150,3578695678,3578695694,16
1,340,151,3578695678,3578695723,45
1,341,152,3578695728,3578695733,5
1,341,153,3578695728,3578695749,21
1,341,154,3578695728,3578695753,25
1,341,155,3578695728,3578695762,34
1,341,156,3578695728,3578695773,45
1,341,157,3578695728,3578695774,46
1,342,158,3578695779,3578695793,14
1,342,159,3578695779,3578695799,20
1,342,160,3578695779,3578695815,36
1,343,161,3578695830,3578695831,1
1,343,162,3578695830,3578695840,10
1,343,163,3578695830,3578695844,14
1,343,164,3578695830,3578695855,25
1,343,165,3578695830,3578695858,28
1,344,166,3578695881,3578695887,6
1,344,167,3578695881,3578695895,14
1,344,168,3578695881,3578695922,41
1,345,169,3578695931,3578695933,2
1,345,170,3578695931,3578695949,18
1,345,171,3578695931,3578695953,22
1,345,172,3578695931,3578695962,31
1,345,173,3578695931,3578695973,42
1,345,174,3578695931,3578695975,44
1,346,175,3578695982,3578695993,11
1,346,176,3578695982,3578695999,17
1,346,177,3578695982,3578696013,31
1,346,178,3578695982,3578696014,32
1,346,179,3578695982,3578696031,49
1,347,180,3578696033,3578696040,7
1,347,181,3578696033,3578696045,12
1,347,182,3578696033,3578696055,22
1,347,183,3578696033,3578696059,26
1,348,184,3578696083,3578696086,3
1,348,185,3578696083,3578696094,11
1,348,186,3578696083,3578696122,39
1,348,187,3578696083,3578696133,50
1,349,188,3578696134,3578696149,15
1,349,189,3578696134,3578696153,19
1,349,190,3578696134,3578696162,28
1,349,191,3578696134,3578696174,40
1,349,192,3578696134,3578696175,41
1,350,193,3578696185,3578696193,8
1,350,194,3578696185,3578696199,14
1,350,195,3578696185,3578696213,28
1,350,196,3578696185,3578696215,30
1,350,197,3578696185,3578696231,46
1,351,198,3578696236,3578696240,4
1,351,199,3578696236,3578696246,10
1,351,200,3578696236,3578696255,19
1,351,201,3578696236,3578696259,23
1,351,202,3578696236,3578696266,30
1,352,203,3578696287,3578696287,0
1,352,204,3578696287,3578696294,7
1,352,205,3578696287,3578696322,35
1,352,206,3578696287,3578696333,46
1,353,207,3578696338,3578696349,11
1,353,208,3578696338,3578696354,16
1,353,209,3578696338,3578696362,24
1,353,210,3578696338,3578696374,36
1,353,211,3578696338,3578696375,37
1,354,212,3578696389,3578696394,5
1,354,213,3578696389,3578696399,10
1,354,214,3578696389,3578696413,24
1,354,215,3578696389,3578696416,27
1,354,216,3578696389,3578696419,30
1,354,217,3578696389,3578696432,43
1,355,218,3578696440,3578696440,0
1,355,219,3578696440,3578696445,5
1,355,220,3578696440,3578696454,14
1,355,221,3578696440,3578696458,18
1,355,222,3578696440,3578696466,26
1,355,223,3578696440,3578696486,46
1,356,224,3578696491,3578696494,3
1,356,225,3578696491,3578696518,27
1,356,226,3578696491,3578696521,30
1,356,227,3578696491,3578696532,41
1,357,228,3578696542,3578696548,6
1,357,229,3578696542,3578696553,11
1,357,230,3578696542,3578696561,19
1,357,231,3578696542,3578696573,31
1,357,232,3578696542,3578696575,33
1,358,233,3578696593,3578696593,0
1,358,234,3578696593,3578696598,5
1,358,235,3578696593,3578696612,19
1,358,236,3578696593,3578696615,22
1,358,237,3578696593,3578696618,25
1,358,238,3578696593,3578696619,26
1,358,239,3578696593,3578696630,37
1,358,240,3578696593,3578696639,46
1,359,241,3578696644,3578696644,0
1,359,242,3578696644,3578696654,10
1,359,243,3578696644,3578696657,13
1,359,244,3578696644,3578696665,21
1,359,245,3578696644,3578696686,42
1,359,246,3578696644,3578696694,50
1,360,247,3578696695,3578696719,24
1,360,248,3578696695,3578696722,27
1,360,249,3578696695,3578696722,27
1,360,250,3578696695,3578696732,37
1,361,251,3578696746,3578696748,2
1,361,252,3578696746,3578696753,7
1,361,253,3578696746,3578696760,14
1,361,254,3578696746,3578696772,26
1,361,255,3578696746,3578696773,27
1,361,256,3578696746,3578696775,29
1,361,257,3578696746,3578696793,47
1,362,258,3578696797,3578696799,2
1,362,259,3578696797,3578696811,14
1,362,260,3578696797,3578696815,18
1,362,261,3578696797,3578696817,20
1,362,262,3578696797,3578696820,23
1,362,263,3578696797,3578696824,27
1,362,264,3578696797,3578696830,33
1,362,265,3578696797,3578696839,42
1,362,266,3578696797,3578696845,48
1,363,267,3578696848,3578696854,6
1,363,268,3578696848,3578696857,9
1,363,269,3578696848,3578696866,18
1,363,270,3578696848,3578696886,38
1,363,271,3578696848,3578696895,47
1,364,272,3578696899,3578696919,20
1,364,273,3578696899,3578696922,23
1,364,274,3578696899,3578696922,23
1,364,275,3578696899,3578696924,25
1,364,276,3578696899,3578696932,33
1,364,277,3578696899,3578696948,49
1,365,278,3578696950,3578696953,3
1,365,279,3578696950,3578696962,12
1,365,280,3578696950,3578696972,22
1,365,281,3578696950,3578696973,23
1,365,282,3578696950,3578696976,26
1,365,283,3578696950,3578696993,43
1,365,284,3578696950,3578696999,49
1,366,285,3578697001,3578697012,11
1,366,286,3578697001,3578697014,13
1,366,287,3578697001,3578697017,16
1,366,288,3578697001,3578697020,19
1,366,289,3578697001,3578697023,22
1,366,290,3578697001,3578697026,25
1,366,291,3578697001,3578697030,29
1,366,292,3578697001,3578697039,38
1,366,293,3578697001,3578697045,44
1,367,294,3578697052,3578697054,2
1,367,295,3578697052,3578697057,5
1,367,296,3578697052,3578697067,15
1,367,297,3578697052,3578697086,34
1,367,298,3578697052,3578697095,43
1,368,299,3578697103,3578697120,17
1,368,300,3578697103,3578697122,19
1,368,301,3578697103,3578697122,19
1,368,302,3578697103,3578697125,22
1,368,303,3578697103,3578697127,24
1,368,304,3578697103,3578697132,29
1,368,305,3578697103,3578697148,45
1,369,306,3578697154,3578697154,0
1,369,307,3578697154,3578697163,9
1,369,308,3578697154,3578697172,18
1,369,309,3578697154,3578697173,19
1,369,310,3578697154,3578697177,23
1,369,311,3578697154,3578697193,39
1,369,312,3578697154,3578697199,45
1,370,313,3578697205,3578697212,7
1,370,314,3578697205,3578697215,10
1,370,315,3578697205,3578697217,12
1,370,316,3578697205,3578697221,16
1,370,317,3578697205,3578697223,18
1,370,318,3578697205,3578697227,22
1,370,319,3578697205,3578697230,25
1,370,320,3578697205,3578697239,34
1,370,321,3578697205,3578697245,40
1,370,322,3578697205,3578697255,50
1,371,323,3578697256,3578697258,2
1,371,324,3578697256,3578697266,10
1,371,325,3578697256,3578697279,23
1,371,326,3578697256,3578697287,31
1,371,327,3578697256,3578697296,40
1,372,328,3578697307,3578697319,12
1,372,329,3578697307,3578697322,15
1,372,330,3578697307,3578697322,15
1,372,331,3578697307,3578697324,17
1,372,332,3578697307,3578697328,21
1,372,333,3578697307,3578697330,23
1,372,334,3578697307,3578697332,25
1,372,335,3578697307,3578697348,41
1,372,336,3578697307,3578697354,47
1,373,337,3578697358,3578697363,5
1,373,338,3578697358,3578697372,14
1,373,339,3578697358,3578697373,15
1,373,340,3578697358,3578697377,19
1,373,341,3578697358,3578697394,36
1,373,342,3578697358,3578697399,41
1,374,343,3578697409,3578697412,3
1,374,344,3578697409,3578697415,6
1,374,345,3578697409,3578697417,8
1,374,346,3578697409,3578697421,12
1,374,347,3578697409,3578697423,14
1,374,348,3578697409,3578697427,18
1,374,349,3578697409,3578697431,22
1,374,350,3578697409,3578697439,30
1,374,351,3578697409,3578697445,36
1,374,352,3578697409,3578697455,46
1,374,353,3578697409,3578697457,48
1,375,354,3578697460,3578697466,6
1,375,355,3578697460,3578697479,19
1,375,356,3578697460,3578697481,21
1,375,357,3578697460,3578697487,27
1,375,358,3578697460,3578697495,35
1,376,359,3578697511,3578697518,7
1,376,360,3578697511,3578697520,9
1,376,361,3578697511,3578697521,10
1,376,362,3578697511,3578697523,12
1,376,363,3578697511,3578697527,16
1,376,364,3578697511,3578697529,18
1,376,365,3578697511,3578697530,19
1,376,366,3578697511,3578697531,20
1,376,367,3578697511,3578697547,36
1,376,368,3578697511,3578697553,42
1,377,369,3578697562,3578697562,0
1,377,370,3578697562,3578697571,9
1,377,371,3578697562,3578697572,10
1,377,372,3578697562,3578697575,13
1,377,373,3578697562,3578697592,30
1,377,374,3578697562,3578697598,36
1,377,375,3578697562,3578697611,49
1,378,376,3578697613,3578697614,1
1,378,377,3578697613,3578697616,3
1,378,378,3578697613,3578697621,8
1,378,379,3578697613,3578697623,10
1,378,380,3578697613,3578697627,14
1,378,381,3578697613,3578697630,17
1,378,382,3578697613,3578697638,25
1,378,383,3578697613,3578697645,32
1,378,384,3578697613,3578697654,41
1,378,385,3578697613,3578697656,43
1,379,386,3578697664,3578697666,2
1,379,387,3578697664,3578697679,15
1,379,388,3578697664,3578697681,17
1,379,389,3578697664,3578697687,23
1,379,390,3578697664,3578697695,31
1,380,391,3578697715,3578697718,3
1,380,392,3578697715,3578697721,6
1,380,393,3578697715,3578697722,7
1,380,394,3578697715,3578697723,8
1,380,395,3578697715,3578697727,12
1,380,396,3578697715,3578697729,14
1,380,397,3578697715,3578697731,16
1,380,398,3578697715,3578697731,16
1,380,399,3578697715,3578697748,33
1,380,400,3578697715,3578697753,38
1,380,401,3578697715,3578697762,47
1,381,402,3578697766,3578697771,5
1,381,403,3578697766,3578697772,6
1,381,404,3578697766,3578697775,9
1,381,405,3578697766,3578697793,27
1,381,406,3578697766,3578697799,33
1,381,407,3578697766,3578697812,46
1,381,408,3578697766,3578697814,48
1,381,409,3578697766,3578697816,50
1,382,410,3578697817,3578697821,4
1,382,411,3578697817,3578697822,5
1,382,412,3578697817,3578697827,10
1,382,413,3578697817,3578697830,13
1,382,414,3578697817,3578697838,21
1,382,415,3578697817,3578697845,28
1,382,416,3578697817,3578697855,38
1,382,417,3578697817,3578697856,39
1,382,418,3578697817,3578697866,49
1,383,419,3578697868,3578697879,11
1,383,420,3578697868,3578697881,13
1,383,421,3578697868,3578697887,19
1,383,422,3578697868,3578697896,28
1,384,423,3578697919,3578697919,0
1,384,424,3578697919,3578697921,2
1,384,425,3578697919,3578697922,3
1,384,426,3578697919,3578697924,5
1,384,427,3578697919,3578697927,8
1,384,428,3578697919,3578697929,10
1,384,429,3578697919,3578697931,12
1,384,430,3578697919,3578697931,12
1,384,431,3578697919,3578697948,29
1,384,432,3578697919,3578697953,34
1,384,433,3578697919,3578697963,44
1,385,434,3578697970,3578697971,1
1,385,435,3578697970,3578697971,1
1,385,436,3578697970,3578697975,5
1,385,437,3578697970,3578697993,23
1,385,438,3578697970,3578697999,29
1,385,439,3578697970,3578698012,42
1,385,440,3578697970,3578698014,44
1,385,441,3578697970,3578698016,46
1,386,442,3578698021,3578698021,0
1,386,443,3578698021,3578698022,1
1,386,444,3578698021,3578698027,6
1,386,445,3578698021,3578698030,9
1,386,446,3578698021,3578698039,18
1,386,447,3578698021,3578698045,24
1,386,448,3578698021,3578698055,34
1,386,449,3578698021,3578698057,36
1,386,450,3578698021,3578698066,45
1,387,451,3578698072,3578698079,7
1,387,452,3578698072,3578698081,9
1,387,453,3578698072,3578698087,15
1,387,454,3578698072,3578698095,23
1,387,455,3578698072,3578698118,46
1,387,456,3578698072,3578698121,49
1,388,457,3578698123,3578698123,0
1,388,458,3578698123,3578698124,1
1,388,459,3578698123,3578698127,4
1,388,460,3578698123,3578698129,6
1,388,461,3578698123,3578698131,8
1,388,462,3578698123,3578698131,8
1,388,463,3578698123,3578698148,25
1,388,464,3578698123,3578698154,31
1,388,465,3578698123,3578698162,39
1,388,466,3578698123,3578698171,48
1,388,467,3578698123,3578698171,48
1,389,468,3578698174,3578698175,1
1,389,469,3578698174,3578698190,16
1,389,470,3578698174,3578698194,20
1,389,471,3578698174,3578698199,25
1,389,472,3578698174,3578698212,38
1,389,473,3578698174,3578698215,41
1,389,474,3578698174,3578698217,43
1,389,475,3578698174,3578698220,46
1,389,476,3578698174,3578698222,48
1,390,477,3578698225,3578698227,2
1,390,478,3578698225,3578698230,5
1,390,479,3578698225,3578698239,14
1,390,480,3578698225,3578698246,21
1,390,481,3578698225,3578698255,30
1,390,482,3578698225,3578698257,32
1,390,483,3578698225,3578698266,41
1,391,484,3578698276,3578698279,3
1,391,485,3578698276,3578698281,5
1,391,486,3578698276,3578698287,11
1,391,487,3578698276,3578698296,20
1,391,488,3578698276,3578698318,42
1,391,489,3578698276,3578698321,45
1,391,490,3578698276,3578698322,46
1,391,491,3578698276,3578698324,48
1,392,492,3578698327,3578698327,0
1,392,493,3578698327,3578698329,2
1,392,494,3578698327,3578698331,4
1,392,495,3578698327,3578698331,4
1,392,496,3578698327,3578698341,14
1,392,497,3578698327,3578698348,21
1,392,498,3578698327,3578698353,26
1,392,499,3578698327,3578698362,35
1,392,500,3578698327,3578698371,44
1,392,501,3578698327,3578698372,45
1,392,502,3578698327,3578698375,48
1,393,503,3578698379,3578698390,11
1,393,504,3578698379,3578698394,15
1,393,505,3578698379,3578698398,19
1,393,506,3578698379,3578698412,33
1,393,507,3578698379,3578698415,36
1,393,508,3578698379,3578698417,38
1,393,509,3578698379,3578698420,41
1,393,510,3578698379,3578698422,43
1,393,511,3578698379,3578698426,47
1,394,512,3578698430,3578698431,1
1,394,513,3578698430,3578698439,9
1,394,514,3578698430,3578698445,15
1,394,515,3578698430,3578698455,25
1,394,516,3578698430,3578698457,27
1,394,517,3578698430,3578698467,37
1,394,518,3578698430,3578698479,49
1,395,519,3578698481,3578698481,0
1,395,520,3578698481,3578698486,5
1,395,521,3578698481,3578698494,13
1,395,522,3578698481,3578698517,36
1,395,523,3578698481,3578698520,39
1,395,524,3578698481,3578698521,40
1,395,525,3578698481,3578698522,41
1,395,526,3578698481,3578698526,45
1,395,527,3578698481,3578698529,48
1,395,528,3578698481,3578698530,49
1,395,529,3578698481,3578698531,50
1,396,530,3578698532,3578698541,9
1,396,531,3578698532,3578698548,16
1,396,532,3578698532,3578698552,20
1,396,533,3578698532,3578698562,30
1,396,534,3578698532,3578698570,38
1,396,535,3578698532,3578698571,39
1,396,536,3578698532,3578698575,43
1,397,537,3578698583,3578698593,10
1,397,538,3578698583,3578698598,15
1,397,539,3578698583,3578698610,27
1,397,540,3578698583,3578698615,32
1,397,541,3578698583,3578698617,34
1,397,542,3578698583,3578698620,37
1,397,543,3578698583,3578698622,39
1,397,544,3578698583,3578698626,43
1,397,545,3578698583,3578698630,47
1,398,546,3578698634,3578698639,5
1,398,547,3578698634,3578698644,10
1,398,548,3578698634,3578698644,10
1,398,549,3578698634,3578698654,20
1,398,550,3578698634,3578698656,22
1,398,551,3578698634,3578698666,32
1,398,552,3578698634,3578698679,45
1,398,553,3578698634,3578698681,47
1,399,554,3578698685,3578698687,2
1,399,555,3578698685,3578698694,9
1,399,556,3578698685,3578698717,32
1,399,557,3578698685,3578698720,35
1,399,558,3578698685,3578698722,37
1,399,559,3578698685,3578698724,39
1,399,560,3578698685,3578698726,41
1,399,561,3578698685,3578698729,44
1,399,562,3578698685,3578698731,46
1,399,563,3578698685,3578698731,46
1,400,564,3578698736,3578698741,5
1,400,565,3578698736,3578698746,10
1,400,566,3578698736,3578698748,12
1,400,567,3578698736,3578698753,17
1,400,568,3578698736,3578698762,26
1,400,569,3578698736,3578698770,34
1,400,570,3578698736,3578698771,35
1,400,571,3578698736,3578698774,38
1,401,572,3578698787,3578698793,6
1,401,573,3578698787,3578698799,12
1,401,574,3578698787,3578698812,25
1,401,575,3578698787,3578698814,27
1,401,576,3578698787,3578698816,29
1,401,577,3578698787,3578698820,33
1,401,578,3578698787,3578698823,36
1,401,579,3578698787,3578698826,39
1,401,580,3578698787,3578698830,43
1,402,581,3578698838,3578698840,2
1,402,582,3578698838,3578698844,6
1,402,583,3578698838,3578698844,6
1,402,584,3578698838,3578698854,16
1,402,585,3578698838,3578698856,18
1,402,586,3578698838,3578698867,29
1,402,587,3578698838,3578698879,41
1,402,588,3578698838,3578698881,43
1,402,589,3578698838,3578698886,48
1,403,590,3578698889,3578698895,6
1,403,591,3578698889,3578698899,10
1,403,592,3578698889,3578698917,28
1,403,593,3578698889,3578698920,31
1,403,594,3578698889,3578698922,33
1,403,595,3578698889,3578698924,35
1,403,596,3578698889,3578698926,37
1,403,597,3578698889,3578698929,40
1,403,598,3578698889,3578698931,42
1,403,599,3578698889,3578698931,42
1,404,600,3578698940,3578698941,1
1,404,601,3578698940,3578698947,7
1,404,602,3578698940,3578698948,8
1,404,603,3578698940,3578698954,14
1,404,604,3578698940,3578698962,22
1,404,605,3578698940,3578698970,30
1,404,606,3578698940,3578698970,30
1,404,607,3578698940,3578698975,35
1,404,608,3578698940,3578698989,49
1,405,609,3578698991,3578698993,2
1,405,610,3578698991,3578698999,8
1,405,611,3578698991,3578698999,8
1,405,612,3578698991,3578699012,21
1,405,613,3578698991,3578699014,23
1,405,614,3578698991,3578699016,25
1,405,615,3578698991,3578699020,29
1,405,616,3578698991,3578699023,32
1,405,617,3578698991,3578699026,35
1,405,618,3578698991,3578699031,40
1,405,619,3578698991,3578699039,48
1,406,620,3578699042,3578699044,2
1,406,621,3578699042,3578699044,2
1,406,622,3578699042,3578699050,8
1,406,623,3578699042,3578699053,11
1,406,624,3578699042,3578699056,14
1,406,625,3578699042,3578699066,24
1,406,626,3578699042,3578699079,37
1,406,627,3578699042,3578699081,39
1,406,628,3578699042,3578699086,44
1,407,629,3578699093,3578699095,2
1,407,630,3578699093,3578699099,6
1,407,631,3578699093,3578699117,24
1,407,632,3578699093,3578699120,27
1,407,633,3578699093,3578699122,29
1,407,634,3578699093,3578699123,30
1,407,635,3578699093,3578699126,33
1,407,636,3578699093,3578699129,36
1,407,637,3578699093,3578699131,38
1,407,638,3578699093,3578699131,38
1,407,639,3578699093,3578699140,47
1,408,640,3578699144,3578699146,2
1,408,641,3578699144,3578699148,4
1,408,642,3578699144,3578699155,11
1,408,643,3578699144,3578699162,18
1,408,644,3578699144,3578699170,26
1,408,645,3578699144,3578699171,27
1,408,646,3578699144,3578699175,31
1,408,647,3578699144,3578699189,45
1,408,648,3578699144,3578699192,48
1,409,649,3578699195,3578699199,4
1,409,650,3578699195,3578699199,4
1,409,651,3578699195,3578699212,17
1,409,652,3578699195,3578699216,21
1,409,653,3578699195,3578699217,22
1,409,654,3578699195,3578699219,24
1,409,655,3578699195,3578699223,28
1,409,656,3578699195,3578699225,30
1,409,657,3578699195,3578699230,35
1,409,658,3578699195,3578699239,44
1,409,659,3578699195,3578699244,49
1,409,660,3578699195,3578699245,50
1,410,661,3578699246,3578699250,4
1,410,662,3578699246,3578699254,8
1,410,663,3578699246,3578699256,10
1,410,664,3578699246,3578699266,20
1,410,665,3578699246,3578699279,33
1,410,666,3578699246,3578699281,35
1,410,667,3578699246,3578699286,40
1,410,668,3578699246,3578699295,49
1,411,669,3578699297,3578699298,1
1,411,670,3578699297,3578699318,21
1,411,671,3578699297,3578699319,22
1,411,672,3578699297,3578699322,25
1,411,673,3578699297,3578699323,26
1,411,674,3578699297,3578699326,29
1,411,675,3578699297,3578699329,32
1,411,676,3578699297,3578699331,34
1,411,677,3578699297,3578699331,34
1,411,678,3578699297,3578699341,44
1,411,679,3578699297,3578699346,49
1,412,680,3578699348,3578699348,0
1,412,681,3578699348,3578699356,8
1,412,682,3578699348,3578699362,14
1,412,683,3578699348,3578699370,22
1,412,684,3578699348,3578699370,22
1,412,685,3578699348,3578699375,27
1,412,686,3578699348,3578699389,41
1,412,687,3578699348,3578699394,46
1,413,688,3578699399,3578699399,0
1,413,689,3578699399,3578699399,0
1,413,690,3578699399,3578699412,13
1,413,691,3578699399,3578699418,19
1,413,692,3578699399,3578699419,20
1,413,693,3578699399,3578699423,24
1,413,694,3578699399,3578699425,26
1,413,695,3578699399,3578699432,33
1,413,696,3578699399,3578699439,40
1,413,697,3578699399,3578699444,45
1,413,698,3578699399,3578699444,45
1,414,699,3578699451,3578699451,0
1,414,700,3578699451,3578699455,4
1,414,701,3578699451,3578699455,4
1,414,702,3578699451,3578699457,6
1,414,703,3578699451,3578699466,15
1,414,704,3578699451,3578699479,28
1,414,705,3578699451,3578699481,30
1,414,706,3578699451,3578699486,35
1,414,707,3578699451,3578699495,44
1,414,708,3578699451,3578699499,48
1,415,709,3578699502,3578699504,2
1,415,710,3578699502,3578699518,16
1,415,711,3578699502,3578699519,17
1,415,712,3578699502,3578699522,20
1,415,713,3578699502,3578699522,20
1,415,714,3578699502,3578699525,23
1,415,715,3578699502,3578699528,26
1,415,716,3578699502,3578699529,27
1,415,717,3578699502,3578699530,28
1,415,718,3578699502,3578699539,37
1,415,719,3578699502,3578699546,44
1,415,720,3578699502,3578699547,45
1,416,721,3578699553,3578699555,2
1,416,722,3578699553,3578699561,8
1,416,723,3578699553,3578699569,16
1,416,724,3578699553,3578699570,17
1,416,725,3578699553,3578699574,21
1,416,726,3578699553,3578699588,35
1,416,727,3578699553,3578699593,40
1,416,728,3578699553,3578699598,45
1,416,729,3578699553,3578699599,46
1,417,730,3578699604,3578699611,7
1,417,731,3578699604,3578699617,13
1,417,732,3578699604,3578699619,15
1,417,733,3578699604,3578699623,19
1,417,734,3578699604,3578699625,21
1,417,735,3578699604,3578699631,27
1,417,736,3578699604,3578699638,34
1,417,737,3578699604,3578699643,39
1,417,738,3578699604,3578699644,40
1,417,739,3578699604,3578699649,45
1,417,740,3578699604,3578699654,50
1,418,741,3578699655,3578699655,0
1,418,742,3578699655,3578699656,1
1,418,743,3578699655,3578699657,2
1,418,744,3578699655,3578699665,10
1,418,745,3578699655,3578699679,24
1,418,746,3578699655,3578699681,26
1,418,747,3578699655,3578699686,31
1,418,748,3578699655,3578699696,41
1,418,749,3578699655,3578699699,44
1,418,750,3578699655,3578699704,49
1,419,751,3578699706,3578699718,12
1,419,752,3578699706,3578699719,13
1,419,753,3578699706,3578699722,16
1,419,754,3578699706,3578699723,17
1,419,755,3578699706,3578699725,19
1,419,756,3578699706,3578699727,21
1,419,757,3578699706,3578699729,23
1,419,758,3578699706,3578699730,24
1,419,759,3578699706,3578699740,34
1,419,760,3578699706,3578699746,40
1,419,761,3578699706,3578699748,42
1,419,762,3578699706,3578699755,49
1,420,763,3578699757,3578699761,4
1,420,764,3578699757,3578699770,13
1,420,765,3578699757,3578699770,13
1,420,766,3578699757,3578699775,18
1,420,767,3578699757,3578699789,32
1,420,768,3578699757,3578699793,36
1,420,769,3578699757,3578699799,42
1,420,770,3578699757,3578699799,42
1,421,771,3578699808,3578699812,4
1,421,772,3578699808,3578699817,9
1,421,773,3578699808,3578699818,10
1,421,774,3578699808,3578699822,14
1,421,775,3578699808,3578699824,16
1,421,776,3578699808,3578699830,22
1,421,777,3578699808,3578699838,30
1,421,778,3578699808,3578699843,35
1,421,779,3578699808,3578699843,35
1,421,780,3578699808,3578699849,41
1,421,781,3578699808,3578699854,46
1,421,782,3578699808,3578699855,47
1,421,783,3578699808,3578699856,48
1,421,784,3578699808,3578699856,48
1,422,785,3578699860,3578699860,0
1,422,786,3578699860,3578699865,5
1,422,787,3578699860,3578699879,19
1,422,788,3578699860,3578699881,21
1,422,789,3578699860,3578699886,26
1,422,790,3578699860,3578699896,36
1,422,791,3578699860,3578699899,39
1,422,792,3578699860,3578699904,44
1,422,793,3578699860,3578699910,50
1,423,794,3578699912,3578699917,5
1,423,795,3578699912,3578699920,8
1,423,796,3578699912,3578699923,11
1,423,797,3578699912,3578699923,11
1,423,798,3578699912,3578699926,14
1,423,799,3578699912,3578699928,16
1,423,800,3578699912,3578699930,18
1,423,801,3578699912,3578699930,18
1,423,802,3578699912,3578699940,28
1,423,803,3578699912,3578699945,33
1,423,804,3578699912,3578699949,37
1,423,805,3578699912,3578699954,42
1,423,806,3578699912,3578699960,48
1,423,807,3578699912,3578699962,50
1,424,808,3578699963,3578699969,6
1,424,809,3578699963,3578699970,7
1,424,810,3578699963,3578699975,12
1,424,811,3578699963,3578699989,26
1,424,812,3578699963,3578699992,29
1,424,813,3578699963,3578699998,35
1,424,814,3578699963,3578699999,36
1,424,815,3578699963,3578700012,49
1,425,816,3578700014,3578700017,3
1,425,817,3578700014,3578700019,5
1,425,818,3578700014,3578700023,9
1,425,819,3578700014,3578700025,11
1,425,820,3578700014,3578700030,16
1,425,821,3578700014,3578700039,25
1,425,822,3578700014,3578700043,29
1,425,823,3578700014,3578700043,29
1,425,824,3578700014,3578700049,35
1,425,825,3578700014,3578700054,40
1,425,826,3578700014,3578700055,41
1,425,827,3578700014,3578700056,42
1,425,828,3578700014,3578700057,43
1,425,829,3578700014,3578700060,46
1,426,830,3578700065,3578700066,1
1,426,831,3578700065,3578700079,14
1,426,832,3578700065,3578700081,16
1,426,833,3578700065,3578700086,21
1,426,834,3578700065,3578700095,30
1,426,835,3578700065,3578700099,34
1,426,836,3578700065,3578700104,39
1,426,837,3578700065,3578700110,45
1,427,838,3578700117,3578700118,1
1,427,839,3578700117,3578700120,3
1,427,840,3578700117,3578700123,6
1,427,841,3578700117,3578700123,6
1,427,842,3578700117,3578700126,9
1,427,843,3578700117,3578700128,11
1,427,844,3578700117,3578700130,13
1,427,845,3578700117,3578700140,23
1,427,846,3578700117,3578700146,29
1,427,847,3578700117,3578700149,32
1,427,848,3578700117,3578700154,37
1,427,849,3578700117,3578700161,44
1,427,850,3578700117,3578700162,45
1,428,851,3578700168,3578700170,2
1,428,852,3578700168,3578700170,2
1,428,853,3578700168,3578700175,7
1,428,854,3578700168,3578700189,21
1,428,855,3578700168,3578700192,24
1,428,856,3578700168,3578700199,31
1,428,857,3578700168,3578700199,31
1,428,858,3578700168,3578700212,44
1,428,859,3578700168,3578700213,45
1,428,860,3578700168,3578700218,50
1,429,861,3578700219,3578700219,0
1,429,862,3578700219,3578700222,3
1,429,863,3578700219,3578700225,6
1,429,864,3578700219,3578700230,11
1,429,865,3578700219,3578700239,20
1,429,866,3578700219,3578700243,24
1,429,867,3578700219,3578700244,25
1,429,868,3578700219,3578700249,30
1,429,869,3578700219,3578700254,35
1,429,870,3578700219,3578700255,36
1,429,871,3578700219,3578700256,37
1,429,872,3578700219,3578700257,38
1,429,873,3578700219,3578700260,41
1,429,874,3578700219,3578700265,46
1,430,875,3578700271,3578700279,8
1,430,876,3578700271,3578700281,10
1,430,877,3578700271,3578700286,15
1,430,878,3578700271,3578700295,24
1,430,879,3578700271,3578700299,28
1,430,880,3578700271,3578700304,33
1,430,881,3578700271,3578700310,39
1,430,882,3578700271,3578700317,46
1,430,883,3578700271,3578700318,47
1,430,884,3578700271,3578700320,49
1,431,885,3578700322,3578700323,1
1,431,886,3578700322,3578700324,2
1,431,887,3578700322,3578700326,4
1,431,888,3578700322,3578700329,7
1,431,889,3578700322,3578700330,8
1,431,890,3578700322,3578700340,18
1,431,891,3578700322,3578700346,24
1,431,892,3578700322,3578700348,26
1,431,893,3578700322,3578700354,32
1,431,894,3578700322,3578700361,39
1,431,895,3578700322,3578700361,39
1,431,896,3578700322,3578700370,48
1,431,897,3578700322,3578700370,48
1,432,898,3578700373,3578700375,2
1,432,899,3578700373,3578700389,16
1,432,900,3578700373,3578700393,20
1,432,901,3578700373,3578700399,26
1,432,902,3578700373,3578700400,27
1,432,903,3578700373,3578700412,39
1,432,904,3578700373,3578700414,41
1,432,905,3578700373,3578700417,44
1,432,906,3578700373,3578700419,46
1,432,907,3578700373,3578700422,49
1,433,908,3578700424,3578700424,0
1,433,909,3578700424,3578700431,7
1,433,910,3578700424,3578700439,15
1,433,911,3578700424,3578700444,20
1,433,912,3578700424,3578700445,21
1,433,913,3578700424,3578700449,25
1,433,914,3578700424,3578700454,30
1,433,915,3578700424,3578700455,31
1,433,916,3578700424,3578700456,32
1,433,917,3578700424,3578700458,34
1,433,918,3578700424,3578700459,35
1,433,919,3578700424,3578700465,41
1,433,920,3578700424,3578700467,43
1,434,921,3578700475,3578700478,3
1,434,922,3578700475,3578700481,6
1,434,923,3578700475,3578700486,11
1,434,924,3578700475,3578700494,19
1,434,925,3578700475,3578700498,23
1,434,926,3578700475,3578700503,28
1,434,927,3578700475,3578700509,34
1,434,928,3578700475,3578700516,41
1,434,929,3578700475,3578700517,42
1,434,930,3578700475,3578700520,45
1,434,931,3578700475,3578700522,47
1,434,932,3578700475,3578700522,47
1,434,933,3578700475,3578700525,50
1,435,934,3578700526,3578700527,1
1,435,935,3578700526,3578700529,3
1,435,936,3578700526,3578700539,13
1,435,937,3578700526,3578700545,19
1,435,938,3578700526,3578700547,21
1,435,939,3578700526,3578700553,27
1,435,940,3578700526,3578700560,34
1,435,941,3578700526,3578700561,35
1,435,942,3578700526,3578700570,44
1,435,943,3578700526,3578700571,45
1,435,944,3578700526,3578700575,49
1,436,945,3578700577,3578700588,11
1,436,946,3578700577,3578700592,15
1,436,947,3578700577,3578700598,21
1,436,948,3578700577,3578700598,21
1,436,949,3578700577,3578700611,34
1,436,950,3578700577,3578700613,36
1,436,951,3578700577,3578700616,39
1,436,952,3578700577,3578700617,40
1,436,953,3578700577,3578700618,41
1,436,954,3578700577,3578700621,44
1,436,955,3578700577,3578700623,46
1,437,956,3578700629,3578700630,1
1,437,957,3578700629,3578700638,9
1,437,958,3578700629,3578700643,14
1,437,959,3578700629,3578700644,15
1,437,960,3578700629,3578700648,19
1,437,961,3578700629,3578700653,24
1,437,962,3578700629,3578700653,24
1,437,963,3578700629,3578700656,27
1,437,964,3578700629,3578700656,27
1,437,965,3578700629,3578700659,30
1,437,966,3578700629,3578700664,35
1,437,967,3578700629,3578700667,38
1,437,968,3578700629,3578700678,49
1,438,969,3578700680,3578700680,0
1,438,970,3578700680,3578700686,6
1,438,971,3578700680,3578700694,14
1,438,972,3578700680,3578700698,18
1,438,973,3578700680,3578700703,23
1,438,974,3578700680,3578700709,29
1,438,975,3578700680,3578700716,36
1,438,976,3578700680,3578700717,37
1,438,977,3578700680,3578700720,40
1,438,978,3578700680,3578700722,42
1,438,979,3578700680,3578700723,43
1,438,980,3578700680,3578700725,45
1,438,981,3578700680,3578700727,47
1,438,982,3578700680,3578700729,49
1,439,983,3578700732,3578700740,8
1,439,984,3578700732,3578700745,13
1,439,985,3578700732,3578700749,17
1,439,986,3578700732,3578700753,21
1,439,987,3578700732,3578700760,28
1,439,988,3578700732,3578700770,38
1,439,989,3578700732,3578700770,38
1,439,990,3578700732,3578700775,43
1,440,991,3578700783,3578700788,5
1,440,992,3578700783,3578700793,10
1,440,993,3578700783,3578700799,16
1,440,994,3578700783,3578700799,16
1,440,995,3578700783,3578700812,29
1,440,996,3578700783,3578700813,30
1,440,997,3578700783,3578700816,33
1,440,998,3578700783,3578700818,35
1,440,999,3578700783,3578700819,36
1,440,1000,3578700783,3578700822,39
1,440,1001,3578700783,3578700825,42
1,440,1002,3578700783,3578700830,47
1,441,1003,3578700834,3578700838,4
1,441,1004,3578700834,3578700843,9
1,441,1005,3578700834,3578700844,10
1,441,1006,3578700834,3578700850,16
1,441,1007,3578700834,3578700853,19
1,441,1008,3578700834,3578700853,19
1,441,1009,3578700834,3578700855,21
1,441,1010,3578700834,3578700856,22
1,441,1011,3578700834,3578700858,24
1,441,1012,3578700834,3578700864,30
1,441,1013,3578700834,3578700878,44
1,441,1014,3578700834,3578700881,47
1,442,1015,3578700885,3578700886,1
1,442,1016,3578700885,3578700894,9
1,442,1017,3578700885,3578700898,13
1,442,1018,3578700885,3578700903,18
1,442,1019,3578700885,3578700909,24
1,442,1020,3578700885,3578700917,32
1,442,1021,3578700885,3578700917,32
1,442,1022,3578700885,3578700920,35
1,442,1023,3578700885,3578700922,37
1,442,1024,3578700885,3578700924,39
1,442,1025,3578700885,3578700926,41
1,442,1026,3578700885,3578700928,43
1,442,1027,3578700885,3578700928,43
1,443,1028,3578700937,3578700940,3
1,443,1029,3578700937,3578700944,7
1,443,1030,3578700937,3578700948,11
1,443,1031,3578700937,3578700954,17
1,443,1032,3578700937,3578700960,23
1,443,1033,3578700937,3578700969,32
1,443,1034,3578700937,3578700971,34
1,443,1035,3578700937,3578700975,38
1,444,1036,3578700989,3578700989,0
1,444,1037,3578700989,3578700993,4
1,444,1038,3578700989,3578700999,10
1,444,1039,3578700989,3578700999,10
1,444,1040,3578700989,3578701011,22
1,444,1041,3578700989,3578701012,23
1,444,1042,3578700989,3578701017,28
1,444,1043,3578700989,3578701018,29
1,444,1044,3578700989,3578701018,29
1,444,1045,3578700989,3578701022,33
1,444,1046,3578700989,3578701024,35
1,444,1047,3578700989,3578701024,35
1,444,1048,3578700989,3578701031,42
1,445,1049,3578701041,3578701041,0
1,445,1050,3578701041,3578701044,3
1,445,1051,3578701041,3578701044,3
1,445,1052,3578701041,3578701050,9
1,445,1053,3578701041,3578701053,12
1,445,1054,3578701041,3578701054,13
1,445,1055,3578701041,3578701055,14
1,445,1056,3578701041,3578701056,15
1,445,1057,3578701041,3578701058,17
1,445,1058,3578701041,3578701065,24
1,445,1059,3578701041,3578701078,37
1,445,1060,3578701041,3578701080,39
1,445,1061,3578701041,3578701086,45
1,446,1062,3578701093,3578701095,2
1,446,1063,3578701093,3578701098,5
1,446,1064,3578701093,3578701103,10
1,446,1065,3578701093,3578701109,16
1,446,1066,3578701093,3578701117,24
1,446,1067,3578701093,3578701117,24
1,446,1068,3578701093,3578701120,27
1,446,1069,3578701093,3578701122,29
1,446,1070,3578701093,3578701124,31
1,446,1071,3578701093,3578701125,32
1,446,1072,3578701093,3578701126,33
1,446,1073,3578701093,3578701129,36
1,446,1074,3578701093,3578701129,36
1,446,1075,3578701093,3578701141,48
1,447,1076,3578701145,3578701145,0
1,447,1077,3578701145,3578701148,3
1,447,1078,3578701145,3578701154,9
1,447,1079,3578701145,3578701159,14
1,447,1080,3578701145,3578701162,17
1,447,1081,3578701145,3578701169,24
1,447,1082,3578701145,3578701171,26
1,447,1083,3578701145,3578701175,30
1,447,1084,3578701145,3578701189,44
1,447,1085,3578701145,3578701193,48
1,448,1086,3578701197,3578701198,1
1,448,1087,3578701197,3578701199,2
1,448,1088,3578701197,3578701212,15
1,448,1089,3578701197,3578701213,16
1,448,1090,3578701197,3578701217,20
1,448,1091,3578701197,3578701218,21
1,448,1092,3578701197,3578701221,24
1,448,1093,3578701197,3578701224,27
1,448,1094,3578701197,3578701224,27
1,448,1095,3578701197,3578701230,33
1,448,1096,3578701197,3578701239,42
1,448,1097,3578701197,3578701243,46
1,448,1098,3578701197,3578701243,46
1,449,1099,3578701249,3578701251,2
1,449,1100,3578701249,3578701254,5
1,449,1101,3578701249,3578701255,6
1,449,1102,3578701249,3578701255,6
1,449,1103,3578701249,3578701256,7
1,449,1104,3578701249,3578701258,9
1,449,1105,3578701249,3578701265,16
1,449,1106,3578701249,3578701267,18
1,449,1107,3578701249,3578701277,28
1,449,1108,3578701249,3578701278,29
1,449,1109,3578701249,3578701280,31
1,449,1110,3578701249,3578701286,37
1,449,1111,3578701249,3578701294,45
1,449,1112,3578701249,3578701298,49
1,450,1113,3578701300,3578701304,4
1,450,1114,3578701300,3578701310,10
1,450,1115,3578701300,3578701317,17
1,450,1116,3578701300,3578701318,18
1,450,1117,3578701300,3578701320,20
1,450,1118,3578701300,3578701322,22
1,450,1119,3578701300,3578701324,24
1,450,1120,3578701300,3578701326,26
1,450,1121,3578701300,3578701326,26
1,450,1122,3578701300,3578701329,29
1,450,1123,3578701300,3578701330,30
1,450,1124,3578701300,3578701340,40
1,450,1125,3578701300,3578701345,45
1,450,1126,3578701300,3578701348,48
1,451,1127,3578701352,3578701354,2
1,451,1128,3578701352,3578701359,7
1,451,1129,3578701352,3578701362,10
1,451,1130,3578701352,3578701369,17
1,451,1131,3578701352,3578701371,19
1,451,1132,3578701352,3578701375,23
1,451,1133,3578701352,3578701389,37
1,451,1134,3578701352,3578701393,41
1,451,1135,3578701352,3578701398,46
1,451,1136,3578701352,3578701399,47
1,452,1137,3578701404,3578701412,8
1,452,1138,3578701404,3578701413,9
1,452,1139,3578701404,3578701417,13
1,452,1140,3578701404,3578701419,15
1,452,1141,3578701404,3578701421,17
1,452,1142,3578701404,3578701424,20
1,452,1143,3578701404,3578701425,21
1,452,1144,3578701404,3578701431,27
1,452,1145,3578701404,3578701439,35
1,452,1146,3578701404,3578701444,40
1,452,1147,3578701404,3578701445,41
1,452,1148,3578701404,3578701451,47
1,453,1149,3578701455,3578701455,0
1,453,1150,3578701455,3578701455,0
1,453,1151,3578701455,3578701456,1
1,453,1152,3578701455,3578701458,3
1,453,1153,3578701455,3578701458,3
1,453,1154,3578701455,3578701465,10
1,453,1155,3578701455,3578701466,11
1,453,1156,3578701455,3578701476,21
1,453,1157,3578701455,3578701478,23
1,453,1158,3578701455,3578701480,25
1,453,1159,3578701455,3578701486,31
1,453,1160,3578701455,3578701494,39
1,453,1161,3578701455,3578701498,43
1,453,1162,3578701455,3578701504,49
1,454,1163,3578701507,3578701508,1
1,454,1164,3578701507,3578701515,8
1,454,1165,3578701507,3578701517,10
1,454,1166,3578701507,3578701520,13
1,454,1167,3578701507,3578701521,14
1,454,1168,3578701507,3578701522,15
1,454,1169,3578701507,3578701525,18
1,454,1170,3578701507,3578701527,20
1,454,1171,3578701507,3578701529,22
1,454,1172,3578701507,3578701529,22
1,454,1173,3578701507,3578701540,33
1,454,1174,3578701507,3578701544,37
1,454,1175,3578701507,3578701548,41
1,454,1176,3578701507,3578701553,46
1,455,1177,3578701559,3578701559,0
1,455,1178,3578701559,3578701561,2
1,455,1179,3578701559,3578701569,10
1,455,1180,3578701559,3578701571,12
1,455,1181,3578701559,3578701574,15
1,455,1182,3578701559,3578701578,19
1,455,1183,3578701559,3578701588,29
1,455,1184,3578701559,3578701592,33
1,455,1185,3578701559,3578701597,38
1,455,1186,3578701559,3578701598,39
1,456,1187,3578701611,3578701611,0
1,456,1188,3578701611,3578701611,0
1,456,1189,3578701611,3578701616,5
1,456,1190,3578701611,3578701617,6
1,456,1191,3578701611,3578701619,8
1,456,1192,3578701611,3578701621,10
1,456,1193,3578701611,3578701624,13
1,456,1194,3578701611,3578701624,13
1,456,1195,3578701611,3578701630,19
1,456,1196,3578701611,3578701630,19
1,456,1197,3578701611,3578701638,27
1,456,1198,3578701611,3578701643,32
1,456,1199,3578701611,3578701643,32
1,456,1200,3578701611,3578701650,39
1,456,1201,3578701611,3578701653,42
1,456,1202,3578701611,3578701654,43
1,456,1203,3578701611,3578701655,44
1,456,1204,3578701611,3578701656,45
1,456,1205,3578701611,3578701658,47
1,457,1206,3578701662,3578701664,2
1,457,1207,3578701662,3578701665,3
1,457,1208,3578701662,3578701676,14
1,457,1209,3578701662,3578701678,16
1,457,1210,3578701662,3578701681,19
1,457,1211,3578701662,3578701681,19
1,457,1212,3578701662,3578701687,25
1,457,1213,3578701662,3578701694,32
1,457,1214,3578701662,3578701699,37
1,457,1215,3578701662,3578701705,43
1,457,1216,3578701662,3578701709,47
1,458,1217,3578701714,3578701716,2
1,458,1218,3578701714,3578701717,3
1,458,1219,3578701714,3578701720,6
1,458,1220,3578701714,3578701722,8
1,458,1221,3578701714,3578701723,9
1,458,1222,3578701714,3578701725,11
1,458,1223,3578701714,3578701727,13
1,458,1224,3578701714,3578701729,15
1,458,1225,3578701714,3578701729,15
1,458,1226,3578701714,3578701740,26
1,458,1227,3578701714,3578701744,30
1,458,1228,3578701714,3578701748,34
1,458,1229,3578701714,3578701754,40
1,458,1230,3578701714,3578701759,45
1,458,1231,3578701714,3578701760,46
1,459,1232,3578701766,3578701768,2
1,459,1233,3578701766,3578701771,5
1,459,1234,3578701766,3578701774,8
1,459,1235,3578701766,3578701778,12
1,459,1236,3578701766,3578701788,22
1,459,1237,3578701766,3578701792,26
1,459,1238,3578701766,3578701798,32
1,459,1239,3578701766,3578701799,33
1,459,1240,3578701766,3578701812,46
1,459,1241,3578701766,3578701812,46
1,460,1242,3578701817,3578701817,0
1,460,1243,3578701817,3578701817,0
1,460,1244,3578701817,3578701819,2
1,460,1245,3578701817,3578701822,5
1,460,1246,3578701817,3578701823,6
1,460,1247,3578701817,3578701825,8
1,460,1248,3578701817,3578701829,12
1,460,1249,3578701817,3578701830,13
1,460,1250,3578701817,3578701838,21
1,460,1251,3578701817,3578701843,26
1,460,1252,3578701817,3578701844,27
1,460,1253,3578701817,3578701850,33
1,460,1254,3578701817,3578701854,37
1,460,1255,3578701817,3578701855,38
1,460,1256,3578701817,3578701855,38
1,460,1257,3578701817,3578701857,40
1,460,1258,3578701817,3578701858,41
1,460,1259,3578701817,3578701864,47
1,460,1260,3578701817,3578701865,48
1,461,1261,3578701869,3578701876,7
1,461,1262,3578701869,3578701878,9
1,461,1263,3578701869,3578701880,11
1,461,1264,3578701869,3578701881,12
1,461,1265,3578701869,3578701886,17
1,461,1266,3578701869,3578701894,25
1,461,1267,3578701869,3578701899,30
1,461,1268,3578701869,3578701905,36
1,461,1269,3578701869,3578701909,40
1,461,1270,3578701869,3578701916,47
1,461,1271,3578701869,3578701917,48
1,462,1272,3578701921,3578701921,0
1,462,1273,3578701921,3578701922,1
1,462,1274,3578701921,3578701923,2
1,462,1275,3578701921,3578701924,3
1,462,1276,3578701921,3578701926,5
1,462,1277,3578701921,3578701928,7
1,462,1278,3578701921,3578701929,8
1,462,1279,3578701921,3578701930,9
1,462,1280,3578701921,3578701940,19
1,462,1281,3578701921,3578701945,24
1,462,1282,3578701921,3578701949,28
1,462,1283,3578701921,3578701953,32
1,462,1284,3578701921,3578701959,38
1,462,1285,3578701921,3578701961,40
1,462,1286,3578701921,3578701969,48
1,463,1287,3578701973,3578701973,0
1,463,1288,3578701973,3578701975,2
1,463,1289,3578701973,3578701979,6
1,463,1290,3578701973,3578701984,11
1,463,1291,3578701973,3578701989,16
1,463,1292,3578701973,3578701992,19
1,463,1293,3578701973,3578701998,25
1,463,1294,3578701973,3578701999,26
1,463,1295,3578701973,3578702011,38
1,463,1296,3578701973,3578702012,39
1,463,1297,3578701973,3578702016,43
1,463,1298,3578701973,3578702017,44
1,463,1299,3578701973,3578702018,45
1,463,1300,3578701973,3578702021,48
1,464,1301,3578702024,3578702024,0
1,464,1302,3578702024,3578702025,1
1,464,1303,3578702024,3578702029,5
1,464,1304,3578702024,3578702030,6
1,464,1305,3578702024,3578702035,11
1,464,1306,3578702024,3578702039,15
1,464,1307,3578702024,3578702043,19
1,464,1308,3578702024,3578702044,20
1,464,1309,3578702024,3578702050,26
1,464,1310,3578702024,3578702054,30
1,464,1311,3578702024,3578702055,31
1,464,1312,3578702024,3578702055,31
1,464,1313,3578702024,3578702057,33
1,464,1314,3578702024,3578702057,33
1,464,1315,3578702024,3578702065,41
1,464,1316,3578702024,3578702065,41
1,465,1317,3578702076,3578702077,1
1,465,1318,3578702076,3578702078,2
1,465,1319,3578702076,3578702080,4
1,465,1320,3578702076,3578702081,5
1,465,1321,3578702076,3578702087,11
1,465,1322,3578702076,3578702095,19
1,465,1323,3578702076,3578702099,23
1,465,1324,3578702076,3578702104,28
1,465,1325,3578702076,3578702109,33
1,465,1326,3578702076,3578702117,41
1,465,1327,3578702076,3578702117,41
1,465,1328,3578702076,3578702120,44
1,465,1329,3578702076,3578702122,46
1,465,1330,3578702076,3578702124,48
1,465,1331,3578702076,3578702125,49
1,466,1332,3578702127,3578702127,0
1,466,1333,3578702127,3578702128,1
1,466,1334,3578702127,3578702129,2
1,466,1335,3578702127,3578702129,2
1,466,1336,3578702127,3578702141,14
1,466,1337,3578702127,3578702145,18
1,466,1338,3578702127,3578702148,21
1,466,1339,3578702127,3578702153,26
1,466,1340,3578702127,3578702160,33
1,466,1341,3578702127,3578702162,35
1,466,1342,3578702127,3578702168,41
1,466,1343,3578702127,3578702171,44
1,466,1344,3578702127,3578702175,48
1,467,1345,3578702179,3578702180,1
1,467,1346,3578702179,3578702185,6
1,467,1347,3578702179,3578702187,8
1,467,1348,3578702179,3578702189,10
1,467,1349,3578702179,3578702193,14
1,467,1350,3578702179,3578702198,19
1,467,1351,3578702179,3578702199,20
1,467,1352,3578702179,3578702212,33
1,467,1353,3578702179,3578702213,34
1,467,1354,3578702179,3578702217,38
1,467,1355,3578702179,3578702217,38
1,467,1356,3578702179,3578702219,40
1,467,1357,3578702179,3578702221,42
1,467,1358,3578702179,3578702224,45
1,467,1359,3578702179,3578702225,46
1,468,1360,3578702230,3578702230,0
1,468,1361,3578702230,3578702230,0
1,468,1362,3578702230,3578702235,5
1,468,1363,3578702230,3578702239,9
1,468,1364,3578702230,3578702243,13
1,468,1365,3578702230,3578702243,13
1,468,1366,3578702230,3578702250,20
1,468,1367,3578702230,3578702255,25
1,468,1368,3578702230,3578702255,25
1,468,1369,3578702230,3578702255,25
1,468,1370,3578702230,3578702256,26
1,468,1371,3578702230,3578702257,27
1,468,1372,3578702230,3578702265,35
1,468,1373,3578702230,3578702267,37
1,468,1374,3578702230,3578702277,47
1,468,1375,3578702230,3578702278,48
1,469,1376,3578702282,3578702282,0
1,469,1377,3578702282,3578702282,0
1,469,1378,3578702282,3578702286,4
1,469,1379,3578702282,3578702295,13
1,469,1380,3578702282,3578702299,17
1,469,1381,3578702282,3578702304,22
1,469,1382,3578702282,3578702309,27
1,469,1383,3578702282,3578702317,35
1,469,1384,3578702282,3578702319,37
1,469,1385,3578702282,3578702320,38
1,469,1386,3578702282,3578702322,40
1,469,1387,3578702282,3578702323,41
1,469,1388,3578702282,3578702325,43
1,469,1389,3578702282,3578702326,44
1,469,1390,3578702282,3578702329,47
1,469,1391,3578702282,3578702329,47
1,469,1392,3578702282,3578702330,48
1,470,1393,3578702334,3578702341,7
1,470,1394,3578702334,3578702344,10
1,470,1395,3578702334,3578702348,14
1,470,1396,3578702334,3578702354,20
1,470,1397,3578702334,3578702356,22
1,470,1398,3578702334,3578702360,26
1,470,1399,3578702334,3578702362,28
1,470,1400,3578702334,3578702368,34
1,470,1401,3578702334,3578702370,36
1,470,1402,3578702334,3578702375,41
1,470,1403,3578702334,3578702379,45
1,471,1404,3578702386,3578702386,0
1,471,1405,3578702386,3578702387,1
1,471,1406,3578702386,3578702389,3
1,471,1407,3578702386,3578702393,7
1,471,1408,3578702386,3578702399,13
1,471,1409,3578702386,3578702399,13
1,471,1410,3578702386,3578702412,26
1,471,1411,3578702386,3578702412,26
1,471,1412,3578702386,3578702417,31
1,471,1413,3578702386,3578702417,31
1,471,1414,3578702386,3578702419,33
1,471,1415,3578702386,3578702421,35
1,471,1416,3578702386,3578702425,39
1,471,1417,3578702386,3578702425,39
1,471,1418,3578702386,3578702430,44
1,471,1419,3578702386,3578702431,45
1,471,1420,3578702386,3578702435,49
1,472,1421,3578702438,3578702439,1
1,472,1422,3578702438,3578702444,6
1,472,1423,3578702438,3578702444,6
1,472,1424,3578702438,3578702450,12
1,472,1425,3578702438,3578702455,17
1,472,1426,3578702438,3578702455,17
1,472,1427,3578702438,3578702457,19
1,472,1428,3578702438,3578702457,19
1,472,1429,3578702438,3578702457,19
1,472,1430,3578702438,3578702465,27
1,472,1431,3578702438,3578702477,39
1,472,1432,3578702438,3578702478,40
1,472,1433,3578702438,3578702480,42
1,472,1434,3578702438,3578702481,43
1,472,1435,3578702438,3578702486,48
1,473,1436,3578702489,3578702489,0
1,473,1437,3578702489,3578702495,6
1,473,1438,3578702489,3578702497,8
1,473,1439,3578702489,3578702503,14
1,473,1440,3578702489,3578702509,20
1,473,1441,3578702489,3578702517,28
1,473,1442,3578702489,3578702517,28
1,473,1443,3578702489,3578702520,31
1,473,1444,3578702489,3578702521,32
1,473,1445,3578702489,3578702523,34
1,473,1446,3578702489,3578702525,36
1,473,1447,3578702489,3578702525,36
1,473,1448,3578702489,3578702528,39
1,473,1449,3578702489,3578702528,39
1,473,1450,3578702489,3578702529,40
1,474,1451,3578702541,3578702541,0
1,474,1452,3578702541,3578702545,4
1,474,1453,3578702541,3578702547,6
1,474,1454,3578702541,3578702552,11
1,474,1455,3578702541,3578702555,14
1,474,1456,3578702541,3578702560,19
1,474,1457,3578702541,3578702561,20
1,474,1458,3578702541,3578702567,26
1,474,1459,3578702541,3578702570,29
1,474,1460,3578702541,3578702574,33
1,474,1461,3578702541,3578702579,38
1,474,1462,3578702541,3578702583,42
1,474,1463,3578702541,3578702586,45
1,475,1464,3578702593,3578702593,0
1,475,1465,3578702593,3578702597,4
1,475,1466,3578702593,3578702598,5
1,475,1467,3578702593,3578702611,18
1,475,1468,3578702593,3578702612,19
1,475,1469,3578702593,3578702616,23
1,475,1470,3578702593,3578702616,23
1,475,1471,3578702593,3578702618,25
1,475,1472,3578702593,3578702622,29
1,475,1473,3578702593,3578702623,30
1,475,1474,3578702593,3578702624,31
1,475,1475,3578702593,3578702628,35
1,475,1476,3578702593,3578702630,37
1,475,1477,3578702593,3578702634,41
1,475,1478,3578702593,3578702639,46
1,476,1479,3578702645,3578702645,0
1,476,1480,3578702645,3578702645,0
1,476,1481,3578702645,3578702649,4
1,476,1482,3578702645,3578702654,9
1,476,1483,3578702645,3578702654,9
1,476,1484,3578702645,3578702655,10
1,476,1485,3578702645,3578702656,11
1,476,1486,3578702645,3578702657,12
1,476,1487,3578702645,3578702665,20
1,476,1488,3578702645,3578702677,32
1,476,1489,3578702645,3578702679,34
1,476,1490,3578702645,3578702680,35
1,476,1491,3578702645,3578702681,36
1,476,1492,3578702645,3578702686,41
1,476,1493,3578702645,3578702690,45
1,476,1494,3578702645,3578702695,50
1,477,1495,3578702697,3578702698,1
1,477,1496,3578702697,3578702703,6
1,477,1497,3578702697,3578702710,13
1,477,1498,3578702697,3578702716,19
1,477,1499,3578702697,3578702717,20
1,477,1500,3578702697,3578702720,23
1,477,1501,3578702697,3578702722,25
1,477,1502,3578702697,3578702724,27
1,477,1503,3578702697,3578702724,27
1,477,1504,3578702697,3578702726,29
1,477,1505,3578702697,3578702728,31
1,477,1506,3578702697,3578702728,31
1,477,1507,3578702697,3578702729,32
1,477,1508,3578702697,3578702740,43
1,477,1509,3578702697,3578702743,46
1,477,1510,3578702697,3578702744,47
1,478,1511,3578702749,3578702749,0
1,478,1512,3578702749,3578702752,3
1,478,1513,3578702749,3578702755,6
1,478,1514,3578702749,3578702759,10
1,478,1515,3578702749,3578702761,12
1,478,1516,3578702749,3578702768,19
1,478,1517,3578702749,3578702770,21
1,478,1518,3578702749,3578702774,25
1,478,1519,3578702749,3578702778,29
1,478,1520,3578702749,3578702783,34
1,478,1521,3578702749,3578702787,38
1,478,1522,3578702749,3578702792,43
1,478,1523,3578702749,3578702798,49
1,478,1524,3578702749,3578702799,50
1,479,1525,3578702801,3578702811,10
1,479,1526,3578702801,3578702811,10
1,479,1527,3578702801,3578702816,15
1,479,1528,3578702801,3578702816,15
1,479,1529,3578702801,3578702818,17
1,479,1530,3578702801,3578702821,20
1,479,1531,3578702801,3578702824,23
1,479,1532,3578702801,3578702825,24
1,479,1533,3578702801,3578702828,27
1,479,1534,3578702801,3578702831,30
1,479,1535,3578702801,3578702834,33
1,479,1536,3578702801,3578702839,38
1,479,1537,3578702801,3578702843,42
1,479,1538,3578702801,3578702843,42
1,479,1539,3578702801,3578702850,49
1,480,1540,3578702853,3578702853,0
1,480,1541,3578702853,3578702854,1
1,480,1542,3578702853,3578702855,2
1,480,1543,3578702853,3578702856,3
1,480,1544,3578702853,3578702858,5
1,480,1545,3578702853,3578702864,11
1,480,1546,3578702853,3578702877,24
1,480,1547,3578702853,3578702879,26
1,480,1548,3578702853,3578702881,28
1,480,1549,3578702853,3578702881,28
1,480,1550,3578702853,3578702887,34
1,480,1551,3578702853,3578702889,36
1,480,1552,3578702853,3578702894,41
1,480,1553,3578702853,3578702898,45
1,481,1554,3578702904,3578702905,1
1,481,1555,3578702904,3578702910,6
1,481,1556,3578702904,3578702916,12
1,481,1557,3578702904,3578702917,13
1,481,1558,3578702904,3578702920,16
1,481,1559,3578702904,3578702922,18
1,481,1560,3578702904,3578702925,21
1,481,1561,3578702904,3578702926,22
1,481,1562,3578702904,3578702928,24
1,481,1563,3578702904,3578702929,25
1,481,1564,3578702904,3578702940,36
1,481,1565,3578702904,3578702943,39
1,481,1566,3578702904,3578702944,40
1,481,1567,3578702904,3578702950,46
1,481,1568,3578702904,3578702953,49
1,482,1569,3578702956,3578702956,0
1,482,1570,3578702956,3578702960,4
1,482,1571,3578702956,3578702962,6
1,482,1572,3578702956,3578702968,12
1,482,1573,3578702956,3578702971,15
1,482,1574,3578702956,3578702976,20
1,482,1575,3578702956,3578702979,23
1,482,1576,3578702956,3578702984,28
1,482,1577,3578702956,3578702987,31
1,482,1578,3578702956,3578702990,34
1,482,1579,3578702956,3578702993,37
1,482,1580,3578702956,3578702999,43
1,482,1581,3578702956,3578702999,43
1,483,1582,3578703008,3578703012,4
1,483,1583,3578703008,3578703013,5
1,483,1584,3578703008,3578703016,8
1,483,1585,3578703008,3578703017,9
1,483,1586,3578703008,3578703019,11
1,483,1587,3578703008,3578703021,13
1,483,1588,3578703008,3578703024,16
1,483,1589,3578703008,3578703025,17
1,483,1590,3578703008,3578703029,21
1,483,1591,3578703008,3578703030,22
1,483,1592,3578703008,3578703034,26
1,483,1593,3578703008,3578703039,31
1,483,1594,3578703008,3578703043,35
1,483,1595,3578703008,3578703044,36
1,483,1596,3578703008,3578703049,41
1,483,1597,3578703008,3578703049,41
1,483,1598,3578703008,3578703053,45
1,483,1599,3578703008,3578703054,46
1,483,1600,3578703008,3578703055,47
1,483,1601,3578703008,3578703057,49
1,484,1602,3578703060,3578703060,0
1,484,1603,3578703060,3578703065,5
1,484,1604,3578703060,3578703078,18
1,484,1605,3578703060,3578703079,19
1,484,1606,3578703060,3578703081,21
1,484,1607,3578703060,3578703081,21
1,484,1608,3578703060,3578703087,27
1,484,1609,3578703060,3578703089,29
1,484,1610,3578703060,3578703094,34
1,484,1611,3578703060,3578703097,37
1,484,1612,3578703060,3578703104,44
1,485,1613,3578703112,3578703112,0
1,485,1614,3578703112,3578703117,5
1,485,1615,3578703112,3578703118,6
1,485,1616,3578703112,3578703120,8
1,485,1617,3578703112,3578703122,10
1,485,1618,3578703112,3578703125,13
1,485,1619,3578703112,3578703126,14
1,485,1620,3578703112,3578703129,17
1,485,1621,3578703112,3578703129,17
1,485,1622,3578703112,3578703141,29
1,485,1623,3578703112,3578703144,32
1,485,1624,3578703112,3578703145,33
1,485,1625,3578703112,3578703149,37
1,485,1626,3578703112,3578703153,41
1,485,1627,3578703112,3578703155,43
1,485,1628,3578703112,3578703160,48
1,485,1629,3578703112,3578703162,50
1,486,1630,3578703164,3578703168,4
1,486,1631,3578703164,3578703170,6
1,486,1632,3578703164,3578703175,11
1,486,1633,3578703164,3578703178,14
1,486,1634,3578703164,3578703184,20
1,486,1635,3578703164,3578703187,23
1,486,1636,3578703164,3578703189,25
1,486,1637,3578703164,3578703192,28
1,486,1638,3578703164,3578703198,34
1,486,1639,3578703164,3578703199,35
1,486,1640,3578703164,3578703212,48
1,486,1641,3578703164,3578703212,48
1,487,1642,3578703216,3578703217,1
1,487,1643,3578703216,3578703217,1
1,487,1644,3578703216,3578703219,3
1,487,1645,3578703216,3578703222,6
1,487,1646,3578703216,3578703224,8
1,487,1647,3578703216,3578703224,8
1,487,1648,3578703216,3578703228,12
1,487,1649,3578703216,3578703230,14
1,487,1650,3578703216,3578703234,18
1,487,1651,3578703216,3578703239,23
1,487,1652,3578703216,3578703244,28
1,487,1653,3578703216,3578703244,28
1,487,1654,3578703216,3578703249,33
1,487,1655,3578703216,3578703255,39
1,487,1656,3578703216,3578703255,39
1,487,1657,3578703216,3578703255,39
1,487,1658,3578703216,3578703257,41
1,487,1659,3578703216,3578703265,49
1,488,1660,3578703269,3578703278,9
1,488,1661,3578703269,3578703279,10
1,488,1662,3578703269,3578703281,12
1,488,1663,3578703269,3578703281,12
1,488,1664,3578703269,3578703286,17
1,488,1665,3578703269,3578703289,20
1,488,1666,3578703269,3578703295,26
1,488,1667,3578703269,3578703298,29
1,488,1668,3578703269,3578703302,33
1,488,1669,3578703269,3578703304,35
1,488,1670,3578703269,3578703310,41
1,488,1671,3578703269,3578703316,47
1,488,1672,3578703269,3578703318,49
1,489,1673,3578703321,3578703321,0
1,489,1674,3578703321,3578703322,1
1,489,1675,3578703321,3578703324,3
1,489,1676,3578703321,3578703325,4
1,489,1677,3578703321,3578703326,5
1,489,1678,3578703321,3578703328,7
1,489,1679,3578703321,3578703329,8
1,489,1680,3578703321,3578703330,9
1,489,1681,3578703321,3578703341,20
1,489,1682,3578703321,3578703344,23
1,489,1683,3578703321,3578703345,24
1,489,1684,3578703321,3578703349,28
1,489,1685,3578703321,3578703353,32
1,489,1686,3578703321,3578703356,35
1,489,1687,3578703321,3578703360,39
1,489,1688,3578703321,3578703361,40
1,489,1689,3578703321,3578703362,41
1,489,1690,3578703321,3578703368,47
1,489,1691,3578703321,3578703370,49
1,490,1692,3578703373,3578703375,2
1,490,1693,3578703373,3578703379,6
1,490,1694,3578703373,3578703384,11
1,490,1695,3578703373,3578703387,14
1,490,1696,3578703373,3578703390,17
1,490,1697,3578703373,3578703394,21
1,490,1698,3578703373,3578703398,25
1,490,1699,3578703373,3578703398,25
1,490,1700,3578703373,3578703413,40
1,490,1701,3578703373,3578703413,40
1,490,1702,3578703373,3578703417,44
1,490,1703,3578703373,3578703417,44
1,490,1704,3578703373,3578703420,47
1,490,1705,3578703373,3578703421,48
1,491,1706,3578703425,3578703425,0
1,491,1707,3578703425,3578703425,0
1,491,1708,3578703425,3578703429,4
1,491,1709,3578703425,3578703431,6
1,491,1710,3578703425,3578703434,9
1,491,1711,3578703425,3578703439,14
1,491,1712,3578703425,3578703444,19
1,491,1713,3578703425,3578703445,20
1,491,1714,3578703425,3578703449,24
1,491,1715,3578703425,3578703455,30
1,491,1716,3578703425,3578703455,30
1,491,1717,3578703425,3578703456,31
1,491,1718,3578703425,3578703466,41
1,492,1719,3578703477,3578703478,1
1,492,1720,3578703477,3578703478,1
1,492,1721,3578703477,3578703479,2
1,492,1722,3578703477,3578703480,3
1,492,1723,3578703477,3578703485,8
1,492,1724,3578703477,3578703489,12
1,492,1725,3578703477,3578703497,20
1,492,1726,3578703477,3578703502,25
1,492,1727,3578703477,3578703503,26
1,492,1728,3578703477,3578703509,32
1,492,1729,3578703477,3578703516,39
1,492,1730,3578703477,3578703517,40
1,492,1731,3578703477,3578703520,43
1,492,1732,3578703477,3578703521,44
1,492,1733,3578703477,3578703525,48
1,492,1734,3578703477,3578703525,48
1,493,1735,3578703529,3578703529,0
1,493,1736,3578703529,3578703529,0
1,493,1737,3578703529,3578703529,0
1,493,1738,3578703529,3578703540,11
1,493,1739,3578703529,3578703542,13
1,493,1740,3578703529,3578703544,15
1,493,1741,3578703529,3578703553,24
1,493,1742,3578703529,3578703555,26
1,493,1743,3578703529,3578703559,30
1,493,1744,3578703529,3578703561,32
1,493,1745,3578703529,3578703561,32
1,493,1746,3578703529,3578703566,37
1,493,1747,3578703529,3578703570,41
1,493,1748,3578703529,3578703574,45
1,493,1749,3578703529,3578703578,49
1,494,1750,3578703581,3578703582,1
1,494,1751,3578703581,3578703585,4
1,494,1752,3578703581,3578703588,7
1,494,1753,3578703581,3578703593,12
1,494,1754,3578703581,3578703598,17
1,494,1755,3578703581,3578703598,17
1,494,1756,3578703581,3578703611,30
1,494,1757,3578703581,3578703611,30
1,494,1758,3578703581,3578703617,36
1,494,1759,3578703581,3578703617,36
1,494,1760,3578703581,3578703618,37
1,494,1761,3578703581,3578703621,40
1,494,1762,3578703581,3578703623,42
1,494,1763,3578703581,3578703623,42
1,494,1764,3578703581,3578703628,47
1,494,1765,3578703581,3578703629,48
1,494,1766,3578703581,3578703630,49
1,495,1767,3578703633,3578703633,0
1,495,1768,3578703633,3578703638,5
1,495,1769,3578703633,3578703644,11
1,495,1770,3578703633,3578703644,11
1,495,1771,3578703633,3578703649,16
1,495,1772,3578703633,3578703654,21
1,495,1773,3578703633,3578703654,21
1,495,1774,3578703633,3578703656,23
1,495,1775,3578703633,3578703664,31
1,495,1776,3578703633,3578703678,45
1,495,1777,3578703633,3578703678,45
1,495,1778,3578703633,3578703679,46
1,495,1779,3578703633,3578703681,48
1,496,1780,3578703685,3578703685,0
1,496,1781,3578703685,3578703689,4
1,496,1782,3578703685,3578703698,13
1,496,1783,3578703685,3578703702,17
1,496,1784,3578703685,3578703703,18
1,496,1785,3578703685,3578703707,22
1,496,1786,3578703685,3578703709,24
1,496,1787,3578703685,3578703717,32
1,496,1788,3578703685,3578703717,32
1,496,1789,3578703685,3578703720,35
1,496,1790,3578703685,3578703722,37
1,496,1791,3578703685,3578703725,40
1,496,1792,3578703685,3578703725,40
1,496,1793,3578703685,3578703727,42
1,496,1794,3578703685,3578703728,43
1,496,1795,3578703685,3578703729,44
1,497,1796,3578703737,3578703740,3
1,497,1797,3578703737,3578703743,6
1,497,1798,3578703737,3578703745,8
1,497,1799,3578703737,3578703752,15
1,497,1800,3578703737,3578703755,18
1,497,1801,3578703737,3578703760,23
1,497,1802,3578703737,3578703761,24
1,497,1803,3578703737,3578703762,25
1,497,1804,3578703737,3578703767,30
1,497,1805,3578703737,3578703770,33
1,497,1806,3578703737,3578703775,38
1,497,1807,3578703737,3578703778,41
1,497,1808,3578703737,3578703784,47
1,497,1809,3578703737,3578703786,49
1,498,1810,3578703789,3578703789,0
1,498,1811,3578703789,3578703793,4
1,498,1812,3578703789,3578703798,9
1,498,1813,3578703789,3578703799,10
1,498,1814,3578703789,3578703812,23
1,498,1815,3578703789,3578703812,23
1,498,1816,3578703789,3578703816,27
1,498,1817,3578703789,3578703817,28
1,498,1818,3578703789,3578703818,29
1,498,1819,3578703789,3578703821,32
1,498,1820,3578703789,3578703824,35
1,498,1821,3578703789,3578703825,36
1,498,1822,3578703789,3578703829,40
1,498,1823,3578703789,3578703830,41
1,498,1824,3578703789,3578703830,41
1,498,1825,3578703789,3578703834,45
1,498,1826,3578703789,3578703838,49
1,499,1827,3578703840,3578703843,3
1,499,1828,3578703840,3578703844,4
1,499,1829,3578703840,3578703849,9
1,499,1830,3578703840,3578703854,14
1,499,1831,3578703840,3578703855,15
1,499,1832,3578703840,3578703855,15
1,499,1833,3578703840,3578703858,18
1,499,1834,3578703840,3578703864,24
1,499,1835,3578703840,3578703878,38
1,499,1836,3578703840,3578703878,38
1,499,1837,3578703840,3578703879,39
1,499,1838,3578703840,3578703881,41
1,499,1839,3578703840,3578703885,45
1,499,1840,3578703840,3578703889,49
1,500,1841,3578703892,3578703894,2
1,500,1842,3578703892,3578703897,5
1,500,1843,3578703892,3578703902,10
1,500,1844,3578703892,3578703904,12
1,500,1845,3578703892,3578703907,15
1,500,1846,3578703892,3578703909,17
1,500,1847,3578703892,3578703917,25
1,500,1848,3578703892,3578703917,25
1,500,1849,3578703892,3578703920,28
1,500,1850,3578703892,3578703922,30
1,500,1851,3578703892,3578703925,33
1,500,1852,3578703892,3578703926,34
1,500,1853,3578703892,3578703927,35
1,500,1854,3578703892,3578703928,36
1,500,1855,3578703892,3578703929,37
1,500,1856,3578703892,3578703940,48
1,501,1857,3578703943,3578703943,0
1,501,1858,3578703943,3578703945,2
1,501,1859,3578703943,3578703948,5
1,501,1860,3578703943,3578703952,9
1,501,1861,3578703943,3578703955,12
1,501,1862,3578703943,3578703960,17
1,501,1863,3578703943,3578703962,19
1,501,1864,3578703943,3578703962,19
1,501,1865,3578703943,3578703967,24
1,501,1866,3578703943,3578703971,28
1,501,1867,3578703943,3578703976,33
1,501,1868,3578703943,3578703978,35
1,501,1869,3578703943,3578703984,41
1,501,1870,3578703943,3578703986,43
1,501,1871,3578703943,3578703990,47
1,502,1872,3578703995,3578703995,0
1,502,1873,3578703995,3578703998,3
1,502,1874,3578703995,3578703999,4
1,502,1875,3578703995,3578704012,17
1,502,1876,3578703995,3578704013,18
1,502,1877,3578703995,3578704016,21
1,502,1878,3578703995,3578704017,22
1,502,1879,3578703995,3578704018,23
1,502,1880,3578703995,3578704021,26
1,502,1881,3578703995,3578704025,30
1,502,1882,3578703995,3578704025,30
1,502,1883,3578703995,3578704028,33
1,502,1884,3578703995,3578704029,34
1,502,1885,3578703995,3578704031,36
1,502,1886,3578703995,3578704034,39
1,502,1887,3578703995,3578704040,45
1,502,1888,3578703995,3578704044,49
1,502,1889,3578703995,3578704044,49
1,503,1890,3578704047,3578704049,2
1,503,1891,3578704047,3578704054,7
1,503,1892,3578704047,3578704055,8
1,503,1893,3578704047,3578704056,9
1,503,1894,3578704047,3578704058,11
1,503,1895,3578704047,3578704066,19
1,503,1896,3578704047,3578704078,31
1,503,1897,3578704047,3578704079,32
1,503,1898,3578704047,3578704080,33
1,503,1899,3578704047,3578704081,34
1,503,1900,3578704047,3578704086,39
1,503,1901,3578704047,3578704089,42
1,503,1902,3578704047,3578704094,47
1,504,1903,3578704098,3578704098,0
1,504,1904,3578704098,3578704102,4
1,504,1905,3578704098,3578704104,6
1,504,1906,3578704098,3578704106,8
1,504,1907,3578704098,3578704109,11
1,504,1908,3578704098,3578704117,19
1,504,1909,3578704098,3578704117,19
1,504,1910,3578704098,3578704120,22
1,504,1911,3578704098,3578704122,24
1,504,1912,3578704098,3578704123,25
1,504,1913,3578704098,3578704124,26
1,504,1914,3578704098,3578704126,28
1,504,1915,3578704098,3578704127,29
1,504,1916,3578704098,3578704129,31
1,504,1917,3578704098,3578704129,31
1,504,1918,3578704098,3578704141,43
1,504,1919,3578704098,3578704144,46
1,504,1920,3578704098,3578704144,46
1,504,1921,3578704098,3578704148,50
1,505,1922,3578704150,3578704154,4
1,505,1923,3578704150,3578704155,5
1,505,1924,3578704150,3578704160,10
1,505,1925,3578704150,3578704162,12
1,505,1926,3578704150,3578704162,12
1,505,1927,3578704150,3578704167,17
1,505,1928,3578704150,3578704171,21
1,505,1929,3578704150,3578704176,26
1,505,1930,3578704150,3578704178,28
1,505,1931,3578704150,3578704183,33
1,505,1932,3578704150,3578704185,35
1,505,1933,3578704150,3578704190,40
1,505,1934,3578704150,3578704194,44
1,505,1935,3578704150,3578704199,49
1,505,1936,3578704150,3578704199,49
1,506,1937,3578704202,3578704212,10
1,506,1938,3578704202,3578704212,10
1,506,1939,3578704202,3578704217,15
1,506,1940,3578704202,3578704217,15
1,506,1941,3578704202,3578704218,16
1,506,1942,3578704202,3578704221,19
1,506,1943,3578704202,3578704224,22
1,506,1944,3578704202,3578704225,23
1,506,1945,3578704202,3578704228,26
1,506,1946,3578704202,3578704229,27
1,506,1947,3578704202,3578704231,29
1,506,1948,3578704202,3578704234,32
1,506,1949,3578704202,3578704240,38
1,506,1950,3578704202,3578704244,42
1,506,1951,3578704202,3578704244,42
1,506,1952,3578704202,3578704249,47
1,507,1953,3578704254,3578704254,0
1,507,1954,3578704254,3578704255,1
1,507,1955,3578704254,3578704255,1
1,507,1956,3578704254,3578704257,3
1,507,1957,3578704254,3578704263,9
1,507,1958,3578704254,3578704267,13
1,507,1959,3578704254,3578704278,24
1,507,1960,3578704254,3578704278,24
1,507,1961,3578704254,3578704280,26
1,507,1962,3578704254,3578704281,27
1,507,1963,3578704254,3578704285,31
1,507,1964,3578704254,3578704290,36
1,507,1965,3578704254,3578704295,41
1,507,1966,3578704254,3578704298,44
1,508,1967,3578704306,3578704306,0
1,508,1968,3578704306,3578704307,1
1,508,1969,3578704306,3578704310,4
1,508,1970,3578704306,3578704317,11
1,508,1971,3578704306,3578704318,12
1,508,1972,3578704306,3578704320,14
1,508,1973,3578704306,3578704322,16
1,508,1974,3578704306,3578704324,18
1,508,1975,3578704306,3578704324,18
1,508,1976,3578704306,3578704326,20
1,508,1977,3578704306,3578704328,22
1,508,1978,3578704306,3578704328,22
1,508,1979,3578704306,3578704329,23
1,508,1980,3578704306,3578704341,35
1,508,1981,3578704306,3578704343,37
1,508,1982,3578704306,3578704345,39
1,508,1983,3578704306,3578704348,42
1,508,1984,3578704306,3578704354,48
1,509,1985,3578704358,3578704358,0
1,509,1986,3578704358,3578704361,3
1,509,1987,3578704358,3578704361,3
1,509,1988,3578704358,3578704362,4
1,509,1989,3578704358,3578704365,7
1,509,1990,3578704358,3578704367,9
1,509,1991,3578704358,3578704372,14
1,509,1992,3578704358,3578704376,18
1,509,1993,3578704358,3578704379,21
1,509,1994,3578704358,3578704383,25
1,509,1995,3578704358,3578704386,28
1,509,1996,3578704358,3578704391,33
1,509,1997,3578704358,3578704395,37
1,509,1998,3578704358,3578704399,41
1,509,1999,3578704358,3578704399,41
1,510,2000,3578704410,3578704411,1
1,510,2001,3578704410,3578704413,3
1,510,2002,3578704410,3578704417,7
1,510,2003,3578704410,3578704417,7
1,510,2004,3578704410,3578704420,10
1,510,2005,3578704410,3578704421,11
1,510,2006,3578704410,3578704424,14
1,510,2007,3578704410,3578704425,15
1,510,2008,3578704410,3578704429,19
1,510,2009,3578704410,3578704430,20
1,510,2010,3578704410,3578704431,21
1,510,2011,3578704410,3578704434,24
1,510,2012,3578704410,3578704441,31
1,510,2013,3578704410,3578704444,34
1,510,2014,3578704410,3578704444,34
1,510,2015,3578704410,3578704449,39
1,510,2016,3578704410,3578704454,44
1,510,2017,3578704410,3578704454,44
1,510,2018,3578704410,3578704456,46
1,510,2019,3578704410,3578704458,48
1,511,2020,3578704462,3578704464,2
1,511,2021,3578704462,3578704466,4
1,511,2022,3578704462,3578704478,16
1,511,2023,3578704462,3578704479,17
1,511,2024,3578704462,3578704480,18
1,511,2025,3578704462,3578704481,19
1,511,2026,3578704462,3578704486,24
1,511,2027,3578704462,3578704489,27
1,511,2028,3578704462,3578704495,33
1,511,2029,3578704462,3578704499,37
1,511,2030,3578704462,3578704505,43
1,511,2031,3578704462,3578704507,45
1,511,2032,3578704462,3578704509,47
1,512,2033,3578704514,3578704516,2
1,512,2034,3578704514,3578704517,3
1,512,2035,3578704514,3578704520,6
1,512,2036,3578704514,3578704521,7
1,512,2037,3578704514,3578704522,8
1,512,2038,3578704514,3578704525,11
1,512,2039,3578704514,3578704527,13
1,512,2040,3578704514,3578704527,13
1,512,2041,3578704514,3578704529,15
1,512,2042,3578704514,3578704540,26
1,512,2043,3578704514,3578704543,29
1,512,2044,3578704514,3578704545,31
1,512,2045,3578704514,3578704547,33
1,512,2046,3578704514,3578704553,39
1,512,2047,3578704514,3578704555,41
1,512,2048,3578704514,3578704560,46
1,512,2049,3578704514,3578704561,47
1,512,2050,3578704514,3578704561,47
1,513,2051,3578704566,3578704566,0
1,513,2052,3578704566,3578704566,0
1,513,2053,3578704566,3578704567,1
1,513,2054,3578704566,3578704570,4
1,513,2055,3578704566,3578704576,10
1,513,2056,3578704566,3578704578,12
1,513,2057,3578704566,3578704583,17
1,513,2058,3578704566,3578704585,19
1,513,2059,3578704566,3578704590,24
1,513,2060,3578704566,3578704594,28
1,513,2061,3578704566,3578704597,31
1,513,2062,3578704566,3578704598,32
1,513,2063,3578704566,3578704610,44
1,513,2064,3578704566,3578704611,45
1,513,2065,3578704566,3578704616,50
1,514,2066,3578704618,3578704618,0
1,514,2067,3578704618,3578704619,1
1,514,2068,3578704618,3578704621,3
1,514,2069,3578704618,3578704623,5
1,514,2070,3578704618,3578704624,6
1,514,2071,3578704618,3578704628,10
1,514,2072,3578704618,3578704629,11
1,514,2073,3578704618,3578704630,12
1,514,2074,3578704618,3578704633,15
1,514,2075,3578704618,3578704640,22
1,514,2076,3578704618,3578704643,25
1,514,2077,3578704618,3578704643,25
1,514,2078,3578704618,3578704648,30
1,514,2079,3578704618,3578704654,36
1,514,2080,3578704618,3578704654,36
1,514,2081,3578704618,3578704655,37
1,514,2082,3578704618,3578704658,40
1,514,2083,3578704618,3578704662,44
1,514,2084,3578704618,3578704665,47
1,515,2085,3578704671,3578704678,7
1,515,2086,3578704671,3578704679,8
1,515,2087,3578704671,3578704680,9
1,515,2088,3578704671,3578704681,10
1,515,2089,3578704671,3578704686,15
1,515,2090,3578704671,3578704689,18
1,515,2091,3578704671,3578704695,24
1,515,2092,3578704671,3578704699,28
1,515,2093,3578704671,3578704703,32
1,515,2094,3578704671,3578704704,33
1,515,2095,3578704671,3578704707,36
1,515,2096,3578704671,3578704709,38
1,515,2097,3578704671,3578704716,45
1,515,2098,3578704671,3578704717,46
1,515,2099,3578704671,3578704720,49
1,516,2100,3578704723,3578704723,0
1,516,2101,3578704723,3578704723,0
1,516,2102,3578704723,3578704725,2
1,516,2103,3578704723,3578704728,5
1,516,2104,3578704723,3578704728,5
1,516,2105,3578704723,3578704729,6
1,516,2106,3578704723,3578704740,17
1,516,2107,3578704723,3578704743,20
1,516,2108,3578704723,3578704744,21
1,516,2109,3578704723,3578704749,26
1,516,2110,3578704723,3578704753,30
1,516,2111,3578704723,3578704755,32
1,516,2112,3578704723,3578704759,36
1,516,2113,3578704723,3578704760,37
1,516,2114,3578704723,3578704761,38
1,516,2115,3578704723,3578704763,40
1,516,2116,3578704723,3578704767,44
1,516,2117,3578704723,3578704767,44
1,516,2118,3578704723,3578704770,47
1,517,2119,3578704775,3578704776,1
1,517,2120,3578704775,3578704778,3
1,517,2121,3578704775,3578704784,9
1,517,2122,3578704775,3578704785,10
1,517,2123,3578704775,3578704790,15
1,517,2124,3578704775,3578704794,19
1,517,2125,3578704775,3578704799,24
1,517,2126,3578704775,3578704799,24
1,517,2127,3578704775,3578704811,36
1,517,2128,3578704775,3578704812,37
1,517,2129,3578704775,3578704816,41
1,517,2130,3578704775,3578704816,41
1,517,2131,3578704775,3578704819,44
1,517,2132,3578704775,3578704822,47
1,517,2133,3578704775,3578704823,48
1,517,2134,3578704775,3578704825,50
1,518,2135,3578704827,3578704828,1
1,518,2136,3578704827,3578704828,1
1,518,2137,3578704827,3578704830,3
1,518,2138,3578704827,3578704834,7
1,518,2139,3578704827,3578704839,12
1,518,2140,3578704827,3578704843,16
1,518,2141,3578704827,3578704843,16
1,518,2142,3578704827,3578704848,21
1,518,2143,3578704827,3578704854,27
1,518,2144,3578704827,3578704854,27
1,518,2145,3578704827,3578704855,28
1,518,2146,3578704827,3578704857,30
1,518,2147,3578704827,3578704862,35
1,518,2148,3578704827,3578704865,38
1,519,2149,3578704879,3578704880,1
1,519,2150,3578704879,3578704881,2
1,519,2151,3578704879,3578704881,2
1,519,2152,3578704879,3578704881,2
1,519,2153,3578704879,3578704885,6
1,519,2154,3578704879,3578704889,10
1,519,2155,3578704879,3578704895,16
1,519,2156,3578704879,3578704899,20
1,519,2157,3578704879,3578704903,24
1,519,2158,3578704879,3578704904,25
1,519,2159,3578704879,3578704908,29
1,519,2160,3578704879,3578704909,30
1,519,2161,3578704879,3578704915,36
1,519,2162,3578704879,3578704917,38
1,519,2163,3578704879,3578704920,41
1,519,2164,3578704879,3578704922,43
1,519,2165,3578704879,3578704924,45
1,519,2166,3578704879,3578704926,47
1,519,2167,3578704879,3578704927,48
1,519,2168,3578704879,3578704927,48
1,519,2169,3578704879,3578704929,50
1,520,2170,3578704931,3578704940,9
1,520,2171,3578704931,3578704942,11
1,520,2172,3578704931,3578704944,13
1,520,2173,3578704931,3578704949,18
1,520,2174,3578704931,3578704953,22
1,520,2175,3578704931,3578704960,29
1,520,2176,3578704931,3578704962,31
1,520,2177,3578704931,3578704962,31
1,520,2178,3578704931,3578704964,33
1,520,2179,3578704931,3578704966,35
1,520,2180,3578704931,3578704966,35
1,520,2181,3578704931,3578704970,39
1,520,2182,3578704931,3578704977,46
1,520,2183,3578704931,3578704977,46
1,521,2184,3578704983,3578704984,1
1,521,2185,3578704983,3578704986,3
1,521,2186,3578704983,3578704990,7
1,521,2187,3578704983,3578704994,11
1,521,2188,3578704983,3578704998,15
1,521,2189,3578704983,3578704999,16
1,521,2190,3578704983,3578705012,29
1,521,2191,3578704983,3578705012,29
1,521,2192,3578704983,3578705016,33
1,521,2193,3578704983,3578705016,33
1,521,2194,3578704983,3578705019,36
1,521,2195,3578704983,3578705021,38
1,521,2196,3578704983,3578705024,41
1,521,2197,3578704983,3578705025,42
1,521,2198,3578704983,3578705029,46
1,521,2199,3578704983,3578705029,46
1,521,2200,3578704983,3578705031,48
1,522,2201,3578705035,3578705035,0
1,522,2202,3578705035,3578705039,4
1,522,2203,3578705035,3578705043,8
1,522,2204,3578705035,3578705044,9
1,522,2205,3578705035,3578705048,13
1,522,2206,3578705035,3578705054,19
1,522,2207,3578705035,3578705054,19
1,522,2208,3578705035,3578705056,21
1,522,2209,3578705035,3578705058,23
1,522,2210,3578705035,3578705063,28
1,522,2211,3578705035,3578705066,31
1,522,2212,3578705035,3578705080,45
1,522,2213,3578705035,3578705081,46
1,522,2214,3578705035,3578705081,46
1,522,2215,3578705035,3578705081,46
1,522,2216,3578705035,3578705085,50
1,523,2217,3578705087,3578705089,2
1,523,2218,3578705087,3578705095,8
1,523,2219,3578705087,3578705099,12
1,523,2220,3578705087,3578705103,16
1,523,2221,3578705087,3578705104,17
1,523,2222,3578705087,3578705108,21
1,523,2223,3578705087,3578705109,22
1,523,2224,3578705087,3578705115,28
1,523,2225,3578705087,3578705117,30
1,523,2226,3578705087,3578705120,33
1,523,2227,3578705087,3578705123,36
1,523,2228,3578705087,3578705123,36
1,523,2229,3578705087,3578705126,39
1,523,2230,3578705087,3578705126,39
1,523,2231,3578705087,3578705127,40
1,523,2232,3578705087,3578705128,41
1,523,2233,3578705087,3578705129,42
1,524,2234,3578705139,3578705141,2
1,524,2235,3578705139,3578705143,4
1,524,2236,3578705139,3578705145,6
1,524,2237,3578705139,3578705148,9
1,524,2238,3578705139,3578705154,15
1,524,2239,3578705139,3578705161,22
1,524,2240,3578705139,3578705162,23
1,524,2241,3578705139,3578705162,23
1,524,2242,3578705139,3578705164,25
1,524,2243,3578705139,3578705166,27
1,524,2244,3578705139,3578705167,28
1,524,2245,3578705139,3578705170,31
1,524,2246,3578705139,3578705177,38
1,524,2247,3578705139,3578705178,39
1,524,2248,3578705139,3578705184,45
1,524,2249,3578705139,3578705186,47
1,525,2250,3578705191,3578705191,0
1,525,2251,3578705191,3578705193,2
1,525,2252,3578705191,3578705198,7
1,525,2253,3578705191,3578705199,8
1,525,2254,3578705191,3578705212,21
1,525,2255,3578705191,3578705212,21
1,525,2256,3578705191,3578705217,26
1,525,2257,3578705191,3578705217,26
1,525,2258,3578705191,3578705219,28
1,525,2259,3578705191,3578705222,31
1,525,2260,3578705191,3578705223,32
1,525,2261,3578705191,3578705225,34
1,525,2262,3578705191,3578705229,38
1,525,2263,3578705191,3578705230,39
1,525,2264,3578705191,3578705230,39
1,525,2265,3578705191,3578705234,43
1,525,2266,3578705191,3578705239,48
1,526,2267,3578705244,3578705244,0
1,526,2268,3578705244,3578705244,0
1,526,2269,3578705244,3578705249,5
1,526,2270,3578705244,3578705254,10
1,526,2271,3578705244,3578705255,11
1,526,2272,3578705244,3578705256,12
1,526,2273,3578705244,3578705258,14
1,526,2274,3578705244,3578705262,18
1,526,2275,3578705244,3578705265,21
1,526,2276,3578705244,3578705280,36
1,526,2277,3578705244,3578705280,36
1,526,2278,3578705244,3578705281,37
1,526,2279,3578705244,3578705282,38
1,526,2280,3578705244,3578705285,41
1,526,2281,3578705244,3578705289,45
1,527,2282,3578705296,3578705296,0
1,527,2283,3578705296,3578705299,3
1,527,2284,3578705296,3578705303,7
1,527,2285,3578705296,3578705304,8
1,527,2286,3578705296,3578705308,12
1,527,2287,3578705296,3578705309,13
1,527,2288,3578705296,3578705316,20
1,527,2289,3578705296,3578705318,22
1,527,2290,3578705296,3578705320,24
1,527,2291,3578705296,3578705323,27
1,527,2292,3578705296,3578705324,28
1,527,2293,3578705296,3578705326,30
1,527,2294,3578705296,3578705326,30
1,527,2295,3578705296,3578705328,32
1,527,2296,3578705296,3578705330,34
1,527,2297,3578705296,3578705330,34
1,527,2298,3578705296,3578705341,45
1,527,2299,3578705296,3578705343,47
1,527,2300,3578705296,3578705344,48
1,528,2301,3578705349,3578705349,0
1,528,2302,3578705349,3578705353,4
1,528,2303,3578705349,3578705360,11
1,528,2304,3578705349,3578705362,13
1,528,2305,3578705349,3578705362,13
1,528,2306,3578705349,3578705364,15
1,528,2307,3578705349,3578705366,17
1,528,2308,3578705349,3578705367,18
1,528,2309,3578705349,3578705371,22
1,528,2310,3578705349,3578705376,27
1,528,2311,3578705349,3578705377,28
1,528,2312,3578705349,3578705379,30
1,528,2313,3578705349,3578705383,34
1,528,2314,3578705349,3578705386,37
1,528,2315,3578705349,3578705391,42
1,528,2316,3578705349,3578705394,45
1,528,2317,3578705349,3578705398,49
1,529,2318,3578705401,3578705401,0
1,529,2319,3578705401,3578705411,10
1,529,2320,3578705401,3578705412,11
1,529,2321,3578705401,3578705417,16
1,529,2322,3578705401,3578705417,16
1,529,2323,3578705401,3578705419,18
1,529,2324,3578705401,3578705421,20
1,529,2325,3578705401,3578705424,23
1,529,2326,3578705401,3578705424,23
1,529,2327,3578705401,3578705430,29
1,529,2328,3578705401,3578705430,29
1,529,2329,3578705401,3578705432,31
1,529,2330,3578705401,3578705434,33
1,529,2331,3578705401,3578705439,38
1,529,2332,3578705401,3578705444,43
1,529,2333,3578705401,3578705445,44
1,529,2334,3578705401,3578705449,48
1,530,2335,3578705454,3578705454,0
1,530,2336,3578705454,3578705454,0
1,530,2337,3578705454,3578705456,2
1,530,2338,3578705454,3578705458,4
1,530,2339,3578705454,3578705463,9
1,530,2340,3578705454,3578705465,11
1,530,2341,3578705454,3578705480,26
1,530,2342,3578705454,3578705481,27
1,530,2343,3578705454,3578705482,28
1,530,2344,3578705454,3578705482,28
1,530,2345,3578705454,3578705485,31
1,530,2346,3578705454,3578705489,35
1,530,2347,3578705454,3578705496,42
1,530,2348,3578705454,3578705499,45
1,530,2349,3578705454,3578705503,49
1,531,2350,3578705506,3578705506,0
1,531,2351,3578705506,3578705507,1
1,531,2352,3578705506,3578705508,2
1,531,2353,3578705506,3578705514,8
1,531,2354,3578705506,3578705517,11
1,531,2355,3578705506,3578705520,14
1,531,2356,3578705506,3578705521,15
1,531,2357,3578705506,3578705522,16
1,531,2358,3578705506,3578705522,16
1,531,2359,3578705506,3578705525,19
1,531,2360,3578705506,3578705525,19
1,531,2361,3578705506,3578705528,22
1,531,2362,3578705506,3578705528,22
1,531,2363,3578705506,3578705529,23
1,531,2364,3578705506,3578705529,23
1,531,2365,3578705506,3578705540,34
1,531,2366,3578705506,3578705542,36
1,531,2367,3578705506,3578705544,38
1,531,2368,3578705506,3578705548,42
1,531,2369,3578705506,3578705552,46
1,532,2370,3578705558,3578705560,2
1,532,2371,3578705558,3578705561,3
1,532,2372,3578705558,3578705561,3
1,532,2373,3578705558,3578705563,5
1,532,2374,3578705558,3578705565,7
1,532,2375,3578705558,3578705567,9
1,532,2376,3578705558,3578705571,13
1,532,2377,3578705558,3578705575,17
1,532,2378,3578705558,3578705576,18
1,532,2379,3578705558,3578705577,19
1,532,2380,3578705558,3578705583,25
1,532,2381,3578705558,3578705585,27
1,532,2382,3578705558,3578705590,32
1,532,2383,3578705558,3578705592,34
1,532,2384,3578705558,3578705597,39
1,532,2385,3578705558,3578705598,40
1,533,2386,3578705610,3578705611,1
1,533,2387,3578705610,3578705611,1
1,533,2388,3578705610,3578705616,6
1,533,2389,3578705610,3578705616,6
1,533,2390,3578705610,3578705618,8
1,533,2391,3578705610,3578705623,13
1,533,2392,3578705610,3578705624,14
1,533,2393,3578705610,3578705629,19
1,533,2394,3578705610,3578705631,21
1,533,2395,3578705610,3578705633,23
1,533,2396,3578705610,3578705638,28
1,533,2397,3578705610,3578705644,34
1,533,2398,3578705610,3578705644,34
1,533,2399,3578705610,3578705648,38
1,533,2400,3578705610,3578705653,43
1,533,2401,3578705610,3578705654,44
1,533,2402,3578705610,3578705656,46
1,533,2403,3578705610,3578705658,48
1,534,2404,3578705661,3578705662,1
1,534,2405,3578705661,3578705664,3
1,534,2406,3578705661,3578705680,19
1,534,2407,3578705661,3578705680,19
1,534,2408,3578705661,3578705681,20
1,534,2409,3578705661,3578705681,20
1,534,2410,3578705661,3578705682,21
1,534,2411,3578705661,3578705686,25
1,534,2412,3578705661,3578705690,29
1,534,2413,3578705661,3578705696,35
1,534,2414,3578705661,3578705699,38
1,534,2415,3578705661,3578705703,42
1,534,2416,3578705661,3578705704,43
1,534,2417,3578705661,3578705707,46
1,534,2418,3578705661,3578705709,48
1,535,2419,3578705713,3578705714,1
1,535,2420,3578705713,3578705717,4
1,535,2421,3578705713,3578705720,7
1,535,2422,3578705713,3578705722,9
1,535,2423,3578705713,3578705722,9
1,535,2424,3578705713,3578705723,10
1,535,2425,3578705713,3578705725,12
1,535,2426,3578705713,3578705725,12
1,535,2427,3578705713,3578705728,15
1,535,2428,3578705713,3578705728,15
1,535,2429,3578705713,3578705729,16
1,535,2430,3578705713,3578705729,16
1,535,2431,3578705713,3578705740,27
1,535,2432,3578705713,3578705742,29
1,535,2433,3578705713,3578705744,31
1,535,2434,3578705713,3578705749,36
1,535,2435,3578705713,3578705752,39
1,535,2436,3578705713,3578705760,47
1,535,2437,3578705713,3578705761,48
1,535,2438,3578705713,3578705761,48
1,536,2439,3578705765,3578705765,0
1,536,2440,3578705765,3578705766,1
1,536,2441,3578705765,3578705766,1
1,536,2442,3578705765,3578705770,5
1,536,2443,3578705765,3578705775,10
1,536,2444,3578705765,3578705776,11
1,536,2445,3578705765,3578705778,13
1,536,2446,3578705765,3578705783,18
1,536,2447,3578705765,3578705784,19
1,536,2448,3578705765,3578705790,25
1,536,2449,3578705765,3578705793,28
1,536,2450,3578705765,3578705799,34
1,536,2451,3578705765,3578705799,34
1,536,2452,3578705765,3578705811,46
1,536,2453,3578705765,3578705812,47
1,537,2454,3578705817,3578705817,0
1,537,2455,3578705817,3578705817,0
1,537,2456,3578705817,3578705819,2
1,537,2457,3578705817,3578705822,5
1,537,2458,3578705817,3578705825,8
1,537,2459,3578705817,3578705829,12
1,537,2460,3578705817,3578705831,14
1,537,2461,3578705817,3578705834,17
1,537,2462,3578705817,3578705838,21
1,537,2463,3578705817,3578705843,26
1,537,2464,3578705817,3578705844,27
1,537,2465,3578705817,3578705848,31
1,537,2466,3578705817,3578705853,36
1,537,2467,3578705817,3578705853,36
1,537,2468,3578705817,3578705856,39
1,537,2469,3578705817,3578705858,41
1,537,2470,3578705817,3578705862,45
1,537,2471,3578705817,3578705864,47
1,538,2472,3578705869,3578705880,11
1,538,2473,3578705869,3578705880,11
1,538,2474,3578705869,3578705881,12
1,538,2475,3578705869,3578705881,12
1,538,2476,3578705869,3578705881,12
1,538,2477,3578705869,3578705886,17
1,538,2478,3578705869,3578705890,21
1,538,2479,3578705869,3578705896,27
1,538,2480,3578705869,3578705898,29
1,538,2481,3578705869,3578705903,34
1,538,2482,3578705869,3578705904,35
1,538,2483,3578705869,3578705907,38
1,538,2484,3578705869,3578705910,41
1,538,2485,3578705869,3578705915,46
1,538,2486,3578705869,3578705918,49
1,539,2487,3578705921,3578705921,0
1,539,2488,3578705921,3578705922,1
1,539,2489,3578705921,3578705924,3
1,539,2490,3578705921,3578705924,3
1,539,2491,3578705921,3578705925,4
1,539,2492,3578705921,3578705927,6
1,539,2493,3578705921,3578705927,6
1,539,2494,3578705921,3578705929,8
1,539,2495,3578705921,3578705929,8
1,539,2496,3578705921,3578705930,9
1,539,2497,3578705921,3578705935,14
1,539,2498,3578705921,3578705940,19
1,539,2499,3578705921,3578705942,21
1,539,2500,3578705921,3578705944,23
1,539,2501,3578705921,3578705948,27
1,539,2502,3578705921,3578705953,32
1,539,2503,3578705921,3578705961,40
1,539,2504,3578705921,3578705961,40
1,539,2505,3578705921,3578705962,41
1,539,2506,3578705921,3578705963,42
1,539,2507,3578705921,3578705966,45
1,539,2508,3578705921,3578705966,45
1,539,2509,3578705921,3578705970,49
1,540,2510,3578705973,3578705975,2
1,540,2511,3578705973,3578705976,3
1,540,2512,3578705973,3578705978,5
1,540,2513,3578705973,3578705983,10
1,540,2514,3578705973,3578705986,13
1,540,2515,3578705973,3578705990,17
1,540,2516,3578705973,3578705993,20
1,540,2517,3578705973,3578705998,25
1,540,2518,3578705973,3578705999,26
1,540,2519,3578705973,3578706012,39
1,540,2520,3578705973,3578706013,40
1,540,2521,3578705973,3578706016,43
1,540,2522,3578705973,3578706017,44
1,540,2523,3578705973,3578706019,46
1,540,2524,3578705973,3578706022,49
1,541,2525,3578706025,3578706025,0
1,541,2526,3578706025,3578706029,4
1,541,2527,3578706025,3578706029,4
1,541,2528,3578706025,3578706031,6
1,541,2529,3578706025,3578706034,9
1,541,2530,3578706025,3578706040,15
1,541,2531,3578706025,3578706043,18
1,541,2532,3578706025,3578706044,19
1,541,2533,3578706025,3578706048,23
1,541,2534,3578706025,3578706053,28
1,541,2535,3578706025,3578706054,29
1,541,2536,3578706025,3578706056,31
1,541,2537,3578706025,3578706058,33
1,541,2538,3578706025,3578706063,38
1,541,2539,3578706025,3578706065,40
1,542,2540,3578706077,3578706080,3
1,542,2541,3578706077,3578706080,3
1,542,2542,3578706077,3578706081,4
1,542,2543,3578706077,3578706081,4
1,542,2544,3578706077,3578706082,5
1,542,2545,3578706077,3578706086,9
1,542,2546,3578706077,3578706089,12
1,542,2547,3578706077,3578706096,19
1,542,2548,3578706077,3578706098,21
1,542,2549,3578706077,3578706103,26
1,542,2550,3578706077,3578706104,27
1,542,2551,3578706077,3578706107,30
1,542,2552,3578706077,3578706110,33
1,542,2553,3578706077,3578706115,38
1,542,2554,3578706077,3578706118,41
1,542,2555,3578706077,3578706119,42
1,542,2556,3578706077,3578706122,45
1,542,2557,3578706077,3578706124,47
1,542,2558,3578706077,3578706124,47
1,542,2559,3578706077,3578706125,48
1,543,2560,3578706130,3578706130,0
1,543,2561,3578706130,3578706130,0
1,543,2562,3578706130,3578706130,0
1,543,2563,3578706130,3578706130,0
1,543,2564,3578706130,3578706130,0
1,543,2565,3578706130,3578706134,4
1,543,2566,3578706130,3578706136,6
1,543,2567,3578706130,3578706141,11
1,543,2568,3578706130,3578706142,12
1,543,2569,3578706130,3578706145,15
1,543,2570,3578706130,3578706148,18
1,543,2571,3578706130,3578706153,23
1,543,2572,3578706130,3578706162,32
1,543,2573,3578706130,3578706162,32
1,543,2574,3578706130,3578706162,32
1,543,2575,3578706130,3578706164,34
1,543,2576,3578706130,3578706165,35
1,543,2577,3578706130,3578706166,36
1,543,2578,3578706130,3578706171,41
1,543,2579,3578706130,3578706175,45
1,543,2580,3578706130,3578706176,46
1,543,2581,3578706130,3578706179,49
1,544,2582,3578706182,3578706183,1
1,544,2583,3578706182,3578706185,3
1,544,2584,3578706182,3578706190,8
1,544,2585,3578706182,3578706194,12
1,544,2586,3578706182,3578706199,17
1,544,2587,3578706182,3578706199,17
1,544,2588,3578706182,3578706212,30
1,544,2589,3578706182,3578706212,30
1,544,2590,3578706182,3578706217,35
1,544,2591,3578706182,3578706217,35
1,544,2592,3578706182,3578706218,36
1,544,2593,3578706182,3578706222,40
1,544,2594,3578706182,3578706224,42
1,544,2595,3578706182,3578706229,47
1,544,2596,3578706182,3578706229,47
1,544,2597,3578706182,3578706231,49
1,545,2598,3578706234,3578706234,0
1,545,2599,3578706234,3578706238,4
1,545,2600,3578706234,3578706239,5
1,545,2601,3578706234,3578706243,9
1,545,2602,3578706234,3578706244,10
1,545,2603,3578706234,3578706248,14
1,545,2604,3578706234,3578706254,20
1,545,2605,3578706234,3578706254,20
1,545,2606,3578706234,3578706256,22
1,545,2607,3578706234,3578706258,24
1,545,2608,3578706234,3578706263,29
1,545,2609,3578706234,3578706266,32
1,545,2610,3578706234,3578706280,46
1,545,2611,3578706234,3578706280,46
1,545,2612,3578706234,3578706281,47
1,545,2613,3578706234,3578706281,47
1,545,2614,3578706234,3578706282,48
1,546,2615,3578706286,3578706286,0
1,546,2616,3578706286,3578706289,3
1,546,2617,3578706286,3578706296,10
1,546,2618,3578706286,3578706299,13
1,546,2619,3578706286,3578706303,17
1,546,2620,3578706286,3578706305,19
1,546,2621,3578706286,3578706307,21
1,546,2622,3578706286,3578706309,23
1,546,2623,3578706286,3578706315,29
1,546,2624,3578706286,3578706319,33
1,546,2625,3578706286,3578706320,34
1,546,2626,3578706286,3578706322,36
1,546,2627,3578706286,3578706323,37
1,546,2628,3578706286,3578706323,37
1,546,2629,3578706286,3578706326,40
1,546,2630,3578706286,3578706328,42
1,546,2631,3578706286,3578706329,43
1,546,2632,3578706286,3578706330,44
1,546,2633,3578706286,3578706334,48
1,547,2634,3578706339,3578706339,0
1,547,2635,3578706339,3578706341,2
1,547,2636,3578706339,3578706342,3
1,547,2637,3578706339,3578706344,5
1,547,2638,3578706339,3578706349,10
1,547,2639,3578706339,3578706354,15
1,547,2640,3578706339,3578706361,22
1,547,2641,3578706339,3578706362,23
1,547,2642,3578706339,3578706362,23
1,547,2643,3578706339,3578706364,25
1,547,2644,3578706339,3578706366,27
1,547,2645,3578706339,3578706368,29
1,547,2646,3578706339,3578706371,32
1,547,2647,3578706339,3578706375,36
1,547,2648,3578706339,3578706377,38
1,547,2649,3578706339,3578706378,39
1,547,2650,3578706339,3578706383,44
1,547,2651,3578706339,3578706386,47
1,548,2652,3578706392,3578706392,0
1,548,2653,3578706392,3578706393,1
1,548,2654,3578706392,3578706399,7
1,548,2655,3578706392,3578706399,7
1,548,2656,3578706392,3578706412,20
1,548,2657,3578706392,3578706412,20
1,548,2658,3578706392,3578706417,25
1,548,2659,3578706392,3578706417,25
1,548,2660,3578706392,3578706419,27
1,548,2661,3578706392,3578706423,31
1,548,2662,3578706392,3578706424,32
1,548,2663,3578706392,3578706429,37
1,548,2664,3578706392,3578706429,37
1,548,2665,3578706392,3578706432,40
1,548,2666,3578706392,3578706434,42
1,548,2667,3578706392,3578706438,46
1,548,2668,3578706392,3578706439,47
1,548,2669,3578706392,3578706441,49
1,549,2670,3578706445,3578706445,0
1,549,2671,3578706445,3578706445,0
1,549,2672,3578706445,3578706448,3
1,549,2673,3578706445,3578706454,9
1,549,2674,3578706445,3578706455,10
1,549,2675,3578706445,3578706456,11
1,549,2676,3578706445,3578706458,13
1,549,2677,3578706445,3578706463,18
1,549,2678,3578706445,3578706465,20
1,549,2679,3578706445,3578706480,35
1,549,2680,3578706445,3578706480,35
1,549,2681,3578706445,3578706481,36
1,549,2682,3578706445,3578706482,37
1,549,2683,3578706445,3578706482,37
1,549,2684,3578706445,3578706485,40
1,549,2685,3578706445,3578706489,44
1,549,2686,3578706445,3578706492,47
1,550,2687,3578706498,3578706498,0
1,550,2688,3578706498,3578706498,0
1,550,2689,3578706498,3578706502,4
1,550,2690,3578706498,3578706504,6
1,550,2691,3578706498,3578706507,9
1,550,2692,3578706498,3578706508,10
1,550,2693,3578706498,3578706513,15
1,550,2694,3578706498,3578706517,19
1,550,2695,3578706498,3578706520,22
1,550,2696,3578706498,3578706521,23
1,550,2697,3578706498,3578706522,24
1,550,2698,3578706498,3578706522,24
1,550,2699,3578706498,3578706525,27
1,550,2700,3578706498,3578706527,29
1,550,2701,3578706498,3578706528,30
1,550,2702,3578706498,3578706529,31
1,550,2703,3578706498,3578706533,35
1,550,2704,3578706498,3578706536,38
1,550,2705,3578706498,3578706539,41
1,550,2706,3578706498,3578706542,44
1,550,2707,3578706498,3578706545,47
1,550,2708,3578706498,3578706547,49
1,551,2709,3578706551,3578706553,2
1,551,2710,3578706551,3578706560,9
1,551,2711,3578706551,3578706561,10
1,551,2712,3578706551,3578706561,10
1,551,2713,3578706551,3578706563,12
1,551,2714,3578706551,3578706565,14
1,551,2715,3578706551,3578706566,15
1,551,2716,3578706551,3578706571,20
1,551,2717,3578706551,3578706574,23
1,551,2718,3578706551,3578706576,25
1,551,2719,3578706551,3578706577,26
1,551,2720,3578706551,3578706582,31
1,551,2721,3578706551,3578706585,34
1,551,2722,3578706551,3578706589,38
1,551,2723,3578706551,3578706592,41
1,551,2724,3578706551,3578706598,47
1,551,2725,3578706551,3578706598,47
1,552,2726,3578706603,3578706611,8
1,552,2727,3578706603,3578706612,9
1,552,2728,3578706603,3578706616,13
1,552,2729,3578706603,3578706616,13
1,552,2730,3578706603,3578706619,16
1,552,2731,3578706603,3578706622,19
1,552,2732,3578706603,3578706624,21
1,552,2733,3578706603,3578706629,26
1,552,2734,3578706603,3578706629,26
1,552,2735,3578706603,3578706630,27
1,552,2736,3578706603,3578706633,30
1,552,2737,3578706603,3578706638,35
1,552,2738,3578706603,3578706639,36
1,552,2739,3578706603,3578706639,36
1,552,2740,3578706603,3578706643,40
1,552,2741,3578706603,3578706647,44
1,553,2742,3578706655,3578706655,0
1,553,2743,3578706655,3578706655,0
1,553,2744,3578706655,3578706656,1
1,553,2745,3578706655,3578706657,2
1,553,2746,3578706655,3578706661,6
1,553,2747,3578706655,3578706665,10
1,553,2748,3578706655,3578706680,25
1,553,2749,3578706655,3578706681,26
1,553,2750,3578706655,3578706681,26
1,553,2751,3578706655,3578706681,26
1,553,2752,3578706655,3578706682,27
1,553,2753,3578706655,3578706685,30
1,553,2754,3578706655,3578706690,35
1,553,2755,3578706655,3578706692,37
1,553,2756,3578706655,3578706697,42
1,553,2757,3578706655,3578706698,43
1,553,2758,3578706655,3578706702,47
1,553,2759,3578706655,3578706703,48
1,554,2760,3578706708,3578706708,0
1,554,2761,3578706708,3578706709,1
1,554,2762,3578706708,3578706713,5
1,554,2763,3578706708,3578706717,9
1,554,2764,3578706708,3578706720,12
1,554,2765,3578706708,3578706722,14
1,554,2766,3578706708,3578706722,14
1,554,2767,3578706708,3578706723,15
1,554,2768,3578706708,3578706724,16
1,554,2769,3578706708,3578706726,18
1,554,2770,3578706708,3578706728,20
1,554,2771,3578706708,3578706728,20
1,554,2772,3578706708,3578706728,20
1,554,2773,3578706708,3578706729,21
1,554,2774,3578706708,3578706734,26
1,554,2775,3578706708,3578706736,28
1,554,2776,3578706708,3578706740,32
1,554,2777,3578706708,3578706742,34
1,554,2778,3578706708,3578706745,37
1,554,2779,3578706708,3578706749,41
1,554,2780,3578706708,3578706752,44
1,555,2781,3578706761,3578706761,0
1,555,2782,3578706761,3578706761,0
1,555,2783,3578706761,3578706761,0
1,555,2784,3578706761,3578706763,2
1,555,2785,3578706761,3578706765,4
1,555,2786,3578706761,3578706767,6
1,555,2787,3578706761,3578706770,9
1,555,2788,3578706761,3578706775,14
1,555,2789,3578706761,3578706775,14
1,555,2790,3578706761,3578706778,17
1,555,2791,3578706761,3578706784,23
1,555,2792,3578706761,3578706785,24
1,555,2793,3578706761,3578706789,28
1,555,2794,3578706761,3578706793,32
1,555,2795,3578706761,3578706799,38
1,555,2796,3578706761,3578706799,38
1,556,2797,3578706814,3578706814,0
1,556,2798,3578706814,3578706814,0
1,556,2799,3578706814,3578706817,3
1,556,2800,3578706814,3578706817,3
1,556,2801,3578706814,3578706819,5
1,556,2802,3578706814,3578706822,8
1,556,2803,3578706814,3578706825,11
1,556,2804,3578706814,3578706828,14
1,556,2805,3578706814,3578706829,15
1,556,2806,3578706814,3578706830,16
1,556,2807,3578706814,3578706834,20
1,556,2808,3578706814,3578706838,24
1,556,2809,3578706814,3578706839,25
1,556,2810,3578706814,3578706840,26
1,556,2811,3578706814,3578706843,29
1,556,2812,3578706814,3578706847,33
1,556,2813,3578706814,3578706849,35
1,556,2814,3578706814,3578706853,39
1,556,2815,3578706814,3578706854,40
1,556,2816,3578706814,3578706855,41
1,556,2817,3578706814,3578706857,43
1,556,2818,3578706814,3578706862,48
1,557,2819,3578706867,3578706867,0
1,557,2820,3578706867,3578706880,13
1,557,2821,3578706867,3578706881,14
1,557,2822,3578706867,3578706881,14
1,557,2823,3578706867,3578706882,15
1,557,2824,3578706867,3578706882,15
1,557,2825,3578706867,3578706885,18
1,557,2826,3578706867,3578706890,23
1,557,2827,3578706867,3578706892,25
1,557,2828,3578706867,3578706896,29
1,557,2829,3578706867,3578706899,32
1,557,2830,3578706867,3578706902,35
1,557,2831,3578706867,3578706904,37
1,557,2832,3578706867,3578706907,40
1,557,2833,3578706867,3578706910,43
1,557,2834,3578706867,3578706914,47
1,558,2835,3578706919,3578706919,0
1,558,2836,3578706919,3578706919,0
1,558,2837,3578706919,3578706922,3
1,558,2838,3578706919,3578706923,4
1,558,2839,3578706919,3578706924,5
1,558,2840,3578706919,3578706924,5
1,558,2841,3578706919,3578706926,7
1,558,2842,3578706919,3578706928,9
1,558,2843,3578706919,3578706929,10
1,558,2844,3578706919,3578706929,10
1,558,2845,3578706919,3578706929,10
1,558,2846,3578706919,3578706933,14
1,558,2847,3578706919,3578706937,18
1,558,2848,3578706919,3578706940,21
1,558,2849,3578706919,3578706942,23
1,558,2850,3578706919,3578706944,25
1,558,2851,3578706919,3578706945,26
1,558,2852,3578706919,3578706948,29
1,558,2853,3578706919,3578706953,34
1,558,2854,3578706919,3578706961,42
1,558,2855,3578706919,3578706962,43
1,558,2856,3578706919,3578706963,44
1,558,2857,3578706919,3578706965,46
1,558,2858,3578706919,3578706966,47
1,559,2859,3578706971,3578706971,0
1,559,2860,3578706971,3578706975,4
1,559,2861,3578706971,3578706976,5
1,559,2862,3578706971,3578706977,6
1,559,2863,3578706971,3578706983,12
1,559,2864,3578706971,3578706986,15
1,559,2865,3578706971,3578706989,18
1,559,2866,3578706971,3578706993,22
1,559,2867,3578706971,3578706998,27
1,559,2868,3578706971,3578706999,28
1,559,2869,3578706971,3578707012,41
1,559,2870,3578706971,3578707013,42
1,559,2871,3578706971,3578707016,45
1,559,2872,3578706971,3578707017,46
1,559,2873,3578706971,3578707020,49
1,560,2874,3578707023,3578707023,0
1,560,2875,3578707023,3578707026,3
1,560,2876,3578707023,3578707029,6
1,560,2877,3578707023,3578707030,7
1,560,2878,3578707023,3578707030,7
1,560,2879,3578707023,3578707034,11
1,560,2880,3578707023,3578707038,15
1,560,2881,3578707023,3578707039,16
1,560,2882,3578707023,3578707040,17
1,560,2883,3578707023,3578707043,20
1,560,2884,3578707023,3578707048,25
1,560,2885,3578707023,3578707049,26
1,560,2886,3578707023,3578707050,27
1,560,2887,3578707023,3578707053,30
1,560,2888,3578707023,3578707054,31
1,560,2889,3578707023,3578707055,32
1,560,2890,3578707023,3578707058,35
1,560,2891,3578707023,3578707062,39
1,560,2892,3578707023,3578707065,42
1,561,2893,3578707076,3578707080,4
1,561,2894,3578707076,3578707081,5
1,561,2895,3578707076,3578707081,5
1,561,2896,3578707076,3578707081,5
1,561,2897,3578707076,3578707082,6
1,561,2898,3578707076,3578707086,10
1,561,2899,3578707076,3578707089,13
1,561,2900,3578707076,3578707092,16
1,561,2901,3578707076,3578707099,23
1,561,2902,3578707076,3578707100,24
1,561,2903,3578707076,3578707102,26
1,561,2904,3578707076,3578707104,28
1,561,2905,3578707076,3578707107,31
1,561,2906,3578707076,3578707110,34
1,561,2907,3578707076,3578707115,39
1,561,2908,3578707076,3578707118,42
1,561,2909,3578707076,3578707120,44
1,561,2910,3578707076,3578707122,46
1,561,2911,3578707076,3578707123,47
1,561,2912,3578707076,3578707123,47
1,561,2913,3578707076,3578707125,49
1,562,2914,3578707129,3578707129,0
1,562,2915,3578707129,3578707129,0
1,562,2916,3578707129,3578707129,0
1,562,2917,3578707129,3578707129,0
1,562,2918,3578707129,3578707129,0
1,562,2919,3578707129,3578707133,4
1,562,2920,3578707129,3578707137,8
1,562,2921,3578707129,3578707141,12
1,562,2922,3578707129,3578707142,13
1,562,2923,3578707129,3578707145,16
1,562,2924,3578707129,3578707146,17
1,562,2925,3578707129,3578707148,19
1,562,2926,3578707129,3578707153,24
1,562,2927,3578707129,3578707161,32
1,562,2928,3578707129,3578707162,33
1,562,2929,3578707129,3578707162,33
1,562,2930,3578707129,3578707164,35
1,562,2931,3578707129,3578707165,36
1,562,2932,3578707129,3578707167,38
1,562,2933,3578707129,3578707171,42
1,562,2934,3578707129,3578707175,46
1,562,2935,3578707129,3578707176,47
1,562,2936,3578707129,3578707178,49
1,563,2937,3578707182,3578707184,2
1,563,2938,3578707182,3578707186,4
1,563,2939,3578707182,3578707189,7
1,563,2940,3578707182,3578707192,10
1,563,2941,3578707182,3578707198,16
1,563,2942,3578707182,3578707199,17
1,563,2943,3578707182,3578707202,20
1,563,2944,3578707182,3578707212,30
1,563,2945,3578707182,3578707213,31
1,563,2946,3578707182,3578707216,34
1,563,2947,3578707182,3578707217,35
1,563,2948,3578707182,3578707220,38
1,563,2949,3578707182,3578707222,40
1,563,2950,3578707182,3578707226,44
1,563,2951,3578707182,3578707230,48
1,563,2952,3578707182,3578707230,48
1,563,2953,3578707182,3578707230,48
1,564,2954,3578707234,3578707234,0
1,564,2955,3578707234,3578707238,4
1,564,2956,3578707234,3578707239,5
1,564,2957,3578707234,3578707240,6
1,564,2958,3578707234,3578707244,10
1,564,2959,3578707234,3578707248,14
1,564,2960,3578707234,3578707250,16
1,564,2961,3578707234,3578707250,16
1,564,2962,3578707234,3578707253,19
1,564,2963,3578707234,3578707254,20
1,564,2964,3578707234,3578707255,21
1,564,2965,3578707234,3578707255,21
1,564,2966,3578707234,3578707258,24
1,564,2967,3578707234,3578707263,29
1,564,2968,3578707234,3578707266,32
1,564,2969,3578707234,3578707280,46
1,564,2970,3578707234,3578707281,47
1,564,2971,3578707234,3578707281,47
1,564,2972,3578707234,3578707282,48
1,564,2973,3578707234,3578707282,48
1,565,2974,3578707287,3578707287,0
1,565,2975,3578707287,3578707291,4
1,565,2976,3578707287,3578707292,5
1,565,2977,3578707287,3578707299,12
1,565,2978,3578707287,3578707300,13
1,565,2979,3578707287,3578707302,15
1,565,2980,3578707287,3578707308,21
1,565,2981,3578707287,3578707310,23
1,565,2982,3578707287,3578707314,27
1,565,2983,3578707287,3578707318,31
1,565,2984,3578707287,3578707320,33
1,565,2985,3578707287,3578707322,35
1,565,2986,3578707287,3578707323,36
1,565,2987,3578707287,3578707324,37
1,565,2988,3578707287,3578707324,37
1,565,2989,3578707287,3578707326,39
1,565,2990,3578707287,3578707329,42
1,565,2991,3578707287,3578707329,42
1,565,2992,3578707287,3578707330,43
1,565,2993,3578707287,3578707330,43
1,565,2994,3578707287,3578707334,47
1,566,2995,3578707340,3578707340,0
1,566,2996,3578707340,3578707341,1
1,566,2997,3578707340,3578707342,2
1,566,2998,3578707340,3578707345,5
1,566,2999,3578707340,3578707346,6
1,566,3000,3578707340,3578707349,9
1,566,3001,3578707340,3578707354,14
1,566,3002,3578707340,3578707360,20
1,566,3003,3578707340,3578707361,21
1,566,3004,3578707340,3578707362,22
1,566,3005,3578707340,3578707364,24
1,566,3006,3578707340,3578707366,26
1,566,3007,3578707340,3578707367,27
1,566,3008,3578707340,3578707370,30
1,566,3009,3578707340,3578707375,35
1,566,3010,3578707340,3578707377,37
1,566,3011,3578707340,3578707379,39
1,566,3012,3578707340,3578707383,43
1,566,3013,3578707340,3578707386,46
1,566,3014,3578707340,3578707389,49
1,567,3015,3578707392,3578707394,2
1,567,3016,3578707392,3578707399,7
1,567,3017,3578707392,3578707399,7
1,567,3018,3578707392,3578707402,10
1,567,3019,3578707392,3578707411,19
1,567,3020,3578707392,3578707412,20
1,567,3021,3578707392,3578707417,25
1,567,3022,3578707392,3578707418,26
1,567,3023,3578707392,3578707419,27
1,567,3024,3578707392,3578707425,33
1,567,3025,3578707392,3578707430,38
1,567,3026,3578707392,3578707430,38
1,567,3027,3578707392,3578707431,39
1,567,3028,3578707392,3578707434,42
1,567,3029,3578707392,3578707438,46
1,567,3030,3578707392,3578707439,47
1,567,3031,3578707392,3578707440,48
1,568,3032,3578707445,3578707445,0
1,568,3033,3578707445,3578707448,3
1,568,3034,3578707445,3578707449,4
1,568,3035,3578707445,3578707450,5
1,568,3036,3578707445,3578707453,8
1,568,3037,3578707445,3578707454,9
1,568,3038,3578707445,3578707455,10
1,568,3039,3578707445,3578707456,11
1,568,3040,3578707445,3578707458,13
1,568,3041,3578707445,3578707463,18
1,568,3042,3578707445,3578707465,20
1,568,3043,3578707445,3578707480,35
1,568,3044,3578707445,3578707481,36
1,568,3045,3578707445,3578707481,36
1,568,3046,3578707445,3578707481,36
1,568,3047,3578707445,3578707482,37
1,568,3048,3578707445,3578707487,42
1,568,3049,3578707445,3578707490,45
1,568,3050,3578707445,3578707492,47
1,569,3051,3578707497,3578707497,0
1,569,3052,3578707497,3578707498,1
1,569,3053,3578707497,3578707500,3
1,569,3054,3578707497,3578707501,4
1,569,3055,3578707497,3578707503,6
1,569,3056,3578707497,3578707507,10
1,569,3057,3578707497,3578707509,12
1,569,3058,3578707497,3578707514,17
1,569,3059,3578707497,3578707517,20
1,569,3060,3578707497,3578707520,23
1,569,3061,3578707497,3578707521,24
1,569,3062,3578707497,3578707522,25
1,569,3063,3578707497,3578707523,26
1,569,3064,3578707497,3578707524,27
1,569,3065,3578707497,3578707525,28
1,569,3066,3578707497,3578707528,31
1,569,3067,3578707497,3578707528,31
1,569,3068,3578707497,3578707528,31
1,569,3069,3578707497,3578707529,32
1,569,3070,3578707497,3578707531,34
1,569,3071,3578707497,3578707532,35
1,569,3072,3578707497,3578707536,39
1,569,3073,3578707497,3578707541,44
1,569,3074,3578707497,3578707545,48
1,569,3075,3578707497,3578707546,49
1,570,3076,3578707549,3578707549,0
1,570,3077,3578707549,3578707553,4
1,570,3078,3578707549,3578707560,11
1,570,3079,3578707549,3578707561,12
1,570,3080,3578707549,3578707561,12
1,570,3081,3578707549,3578707563,14
1,570,3082,3578707549,3578707565,16
1,570,3083,3578707549,3578707566,17
1,570,3084,3578707549,3578707570,21
1,570,3085,3578707549,3578707574,25
1,570,3086,3578707549,3578707575,26
1,570,3087,3578707549,3578707579,30
1,570,3088,3578707549,3578707582,33
1,570,3089,3578707549,3578707584,35
1,570,3090,3578707549,3578707588,39
1,570,3091,3578707549,3578707593,44
1,570,3092,3578707549,3578707598,49
1,570,3093,3578707549,3578707599,50
1,571,3094,3578707602,3578707602,0
1,571,3095,3578707602,3578707611,9
1,571,3096,3578707602,3578707612,10
1,571,3097,3578707602,3578707616,14
1,571,3098,3578707602,3578707616,14
1,571,3099,3578707602,3578707618,16
1,571,3100,3578707602,3578707625,23
1,571,3101,3578707602,3578707629,27
1,571,3102,3578707602,3578707629,27
1,571,3103,3578707602,3578707631,29
1,571,3104,3578707602,3578707633,31
1,571,3105,3578707602,3578707637,35
1,571,3106,3578707602,3578707638,36
1,571,3107,3578707602,3578707639,37
1,571,3108,3578707602,3578707644,42
1,571,3109,3578707602,3578707647,45
1,571,3110,3578707602,3578707648,46
1,571,3111,3578707602,3578707650,48
1,572,3112,3578707654,3578707654,0
1,572,3113,3578707654,3578707654,0
1,572,3114,3578707654,3578707655,1
1,572,3115,3578707654,3578707655,1
1,572,3116,3578707654,3578707657,3
1,572,3117,3578707654,3578707657,3
1,572,3118,3578707654,3578707661,7
1,572,3119,3578707654,3578707665,11
1,572,3120,3578707654,3578707680,26
1,572,3121,3578707654,3578707681,27
1,572,3122,3578707654,3578707681,27
1,572,3123,3578707654,3578707681,27
1,572,3124,3578707654,3578707682,28
1,572,3125,3578707654,3578707686,32
1,572,3126,3578707654,3578707691,37
1,572,3127,3578707654,3578707692,38
1,572,3128,3578707654,3578707697,43
1,572,3129,3578707654,3578707698,44
1,572,3130,3578707654,3578707700,46
1,572,3131,3578707654,3578707701,47
1,572,3132,3578707654,3578707703,49
1,573,3133,3578707707,3578707707,0
1,573,3134,3578707707,3578707709,2
1,573,3135,3578707707,3578707714,7
1,573,3136,3578707707,3578707717,10
1,573,3137,3578707707,3578707720,13
1,573,3138,3578707707,3578707722,15
1,573,3139,3578707707,3578707722,15
1,573,3140,3578707707,3578707723,16
1,573,3141,3578707707,3578707725,18
1,573,3142,3578707707,3578707725,18
1,573,3143,3578707707,3578707728,21
1,573,3144,3578707707,3578707728,21
1,573,3145,3578707707,3578707728,21
1,573,3146,3578707707,3578707729,22
1,573,3147,3578707707,3578707731,24
1,573,3148,3578707707,3578707733,26
1,573,3149,3578707707,3578707736,29
1,573,3150,3578707707,3578707742,35
1,573,3151,3578707707,3578707744,37
1,573,3152,3578707707,3578707746,39
1,573,3153,3578707707,3578707748,41
1,573,3154,3578707707,3578707753,46
1,574,3155,3578707760,3578707760,0
1,574,3156,3578707760,3578707761,1
1,574,3157,3578707760,3578707761,1
1,574,3158,3578707760,3578707763,3
1,574,3159,3578707760,3578707765,5
1,574,3160,3578707760,3578707767,7
1,574,3161,3578707760,3578707770,10
1,574,3162,3578707760,3578707774,14
1,574,3163,3578707760,3578707775,15
1,574,3164,3578707760,3578707779,19
1,574,3165,3578707760,3578707784,24
1,574,3166,3578707760,3578707785,25
1,574,3167,3578707760,3578707788,28
1,574,3168,3578707760,3578707793,33
1,574,3169,3578707760,3578707798,38
1,574,3170,3578707760,3578707799,39
1,574,3171,3578707760,3578707801,41
1,575,3172,3578707813,3578707813,0
1,575,3173,3578707813,3578707813,0
1,575,3174,3578707813,3578707816,3
1,575,3175,3578707813,3578707816,3
1,575,3176,3578707813,3578707819,6
1,575,3177,3578707813,3578707822,9
1,575,3178,3578707813,3578707825,12
1,575,3179,3578707813,3578707829,16
1,575,3180,3578707813,3578707829,16
1,575,3181,3578707813,3578707830,17
1,575,3182,3578707813,3578707834,21
1,575,3183,3578707813,3578707837,24
1,575,3184,3578707813,3578707838,25
1,575,3185,3578707813,3578707840,27
1,575,3186,3578707813,3578707843,30
1,575,3187,3578707813,3578707848,35
1,575,3188,3578707813,3578707849,36
1,575,3189,3578707813,3578707849,36
1,575,3190,3578707813,3578707854,41
1,575,3191,3578707813,3578707854,41
1,575,3192,3578707813,3578707855,42
1,575,3193,3578707813,3578707855,42
1,575,3194,3578707813,3578707856,43
1,575,3195,3578707813,3578707858,45
1,575,3196,3578707813,3578707860,47
1,575,3197,3578707813,3578707862,49
1,576,3198,3578707866,3578707866,0
1,576,3199,3578707866,3578707880,14
1,576,3200,3578707866,3578707881,15
1,576,3201,3578707866,3578707881,15
1,576,3202,3578707866,3578707882,16
1,576,3203,3578707866,3578707882,16
1,576,3204,3578707866,3578707886,20
1,576,3205,3578707866,3578707891,25
1,576,3206,3578707866,3578707892,26
1,576,3207,3578707866,3578707896,30
1,576,3208,3578707866,3578707898,32
1,576,3209,3578707866,3578707900,34
1,576,3210,3578707866,3578707901,35
1,576,3211,3578707866,3578707903,37
1,576,3212,3578707866,3578707908,42
1,576,3213,3578707866,3578707911,45
1,576,3214,3578707866,3578707914,48
1,577,3215,3578707918,3578707918,0
1,577,3216,3578707918,3578707920,2
1,577,3217,3578707918,3578707923,5
1,577,3218,3578707918,3578707923,5
1,577,3219,3578707918,3578707923,5
1,577,3220,3578707918,3578707924,6
1,577,3221,3578707918,3578707926,8
1,577,3222,3578707918,3578707928,10
1,577,3223,3578707918,3578707928,10
1,577,3224,3578707918,3578707928,10
1,577,3225,3578707918,3578707929,11
1,577,3226,3578707918,3578707931,13
1,577,3227,3578707918,3578707933,15
1,577,3228,3578707918,3578707936,18
1,577,3229,3578707918,3578707941,23
1,577,3230,3578707918,3578707945,27
1,577,3231,3578707918,3578707946,28
1,577,3232,3578707918,3578707948,30
1,577,3233,3578707918,3578707953,35
1,577,3234,3578707918,3578707960,42
1,577,3235,3578707918,3578707961,43
1,577,3236,3578707918,3578707962,44
1,577,3237,3578707918,3578707963,45
1,577,3238,3578707918,3578707965,47
1,577,3239,3578707918,3578707967,49
1,578,3240,3578707971,3578707971,0
1,578,3241,3578707971,3578707975,4
1,578,3242,3578707971,3578707976,5
1,578,3243,3578707971,3578707978,7
1,578,3244,3578707971,3578707983,12
1,578,3245,3578707971,3578707986,15
1,578,3246,3578707971,3578707989,18
1,578,3247,3578707971,3578707992,21
1,578,3248,3578707971,3578707999,28
1,578,3249,3578707971,3578707999,28
1,578,3250,3578707971,3578708002,31
1,578,3251,3578707971,3578708012,41
1,578,3252,3578707971,3578708012,41
1,578,3253,3578707971,3578708012,41
1,578,3254,3578707971,3578708016,45
1,578,3255,3578707971,3578708016,45
1,578,3256,3578707971,3578708018,47
1,579,3257,3578708024,3578708024,0
1,579,3258,3578708024,3578708025,1
1,579,3259,3578708024,3578708029,5
1,579,3260,3578708024,3578708029,5
1,579,3261,3578708024,3578708030,6
1,579,3262,3578708024,3578708034,10
1,579,3263,3578708024,3578708037,13
1,579,3264,3578708024,3578708039,15
1,579,3265,3578708024,3578708039,15
1,579,3266,3578708024,3578708043,19
1,579,3267,3578708024,3578708048,24
1,579,3268,3578708024,3578708049,25
1,579,3269,3578708024,3578708049,25
1,579,3270,3578708024,3578708053,29
1,579,3271,3578708024,3578708054,30
1,579,3272,3578708024,3578708055,31
1,579,3273,3578708024,3578708055,31
1,579,3274,3578708024,3578708057,33
1,579,3275,3578708024,3578708058,34
1,579,3276,3578708024,3578708060,36
1,579,3277,3578708024,3578708063,39
1,579,3278,3578708024,3578708066,42
1,580,3279,3578708077,3578708080,3
1,580,3280,3578708077,3578708081,4
1,580,3281,3578708077,3578708081,4
1,580,3282,3578708077,3578708082,5
1,580,3283,3578708077,3578708086,9
1,580,3284,3578708077,3578708090,13
1,580,3285,3578708077,3578708092,15
1,580,3286,3578708077,3578708097,20
1,580,3287,3578708077,3578708098,21
1,580,3288,3578708077,3578708100,23
1,580,3289,3578708077,3578708101,24
1,580,3290,3578708077,3578708104,27
1,580,3291,3578708077,3578708108,31
1,580,3292,3578708077,3578708109,32
1,580,3293,3578708077,3578708111,34
1,580,3294,3578708077,3578708114,37
1,580,3295,3578708077,3578708117,40
1,580,3296,3578708077,3578708120,43
1,580,3297,3578708077,3578708123,46
1,580,3298,3578708077,3578708123,46
1,580,3299,3578708077,3578708124,47
1,580,3300,3578708077,3578708125,48
1,580,3301,3578708077,3578708126,49
1,581,3302,3578708130,3578708130,0
1,581,3303,3578708130,3578708130,0
1,581,3304,3578708130,3578708130,0
1,581,3305,3578708130,3578708130,0
1,581,3306,3578708130,3578708131,1
1,581,3307,3578708130,3578708133,3
1,581,3308,3578708130,3578708135,5
1,581,3309,3578708130,3578708142,12
1,581,3310,3578708130,3578708142,12
1,581,3311,3578708130,3578708144,14
1,581,3312,3578708130,3578708147,17
1,581,3313,3578708130,3578708148,18
1,581,3314,3578708130,3578708154,24
1,581,3315,3578708130,3578708160,30
1,581,3316,3578708130,3578708162,32
1,581,3317,3578708130,3578708164,34
1,581,3318,3578708130,3578708165,35
1,581,3319,3578708130,3578708168,38
1,581,3320,3578708130,3578708171,41
1,581,3321,3578708130,3578708175,45
1,581,3322,3578708130,3578708176,46
1,581,3323,3578708130,3578708179,49
1,582,3324,3578708184,3578708184,0
1,582,3325,3578708184,3578708186,2
1,582,3326,3578708184,3578708189,5
1,582,3327,3578708184,3578708193,9
1,582,3328,3578708184,3578708199,15
1,582,3329,3578708184,3578708200,16
1,582,3330,3578708184,3578708202,18
1,582,3331,3578708184,3578708212,28
1,582,3332,3578708184,3578708212,28
1,582,3333,3578708184,3578708213,29
1,582,3334,3578708184,3578708217,33
1,582,3335,3578708184,3578708217,33
1,582,3336,3578708184,3578708218,34
1,582,3337,3578708184,3578708222,38
1,582,3338,3578708184,3578708224,40
1,582,3339,3578708184,3578708229,45
1,582,3340,3578708184,3578708230,46
1,582,3341,3578708184,3578708230,46
1,582,3342,3578708184,3578708234,50
1,583,3343,3578708236,3578708237,1
1,583,3344,3578708236,3578708240,4
1,583,3345,3578708236,3578708240,4
1,583,3346,3578708236,3578708244,8
1,583,3347,3578708236,3578708248,12
1,583,3348,3578708236,3578708249,13
1,583,3349,3578708236,3578708250,14
1,583,3350,3578708236,3578708254,18
1,583,3351,3578708236,3578708254,18
1,583,3352,3578708236,3578708255,19
1,583,3353,3578708236,3578708256,20
1,583,3354,3578708236,3578708256,20
1,583,3355,3578708236,3578708258,22
1,583,3356,3578708236,3578708261,25
1,583,3357,3578708236,3578708263,27
1,583,3358,3578708236,3578708266,30
1,583,3359,3578708236,3578708280,44
1,583,3360,3578708236,3578708281,45
1,583,3361,3578708236,3578708282,46
1,583,3362,3578708236,3578708282,46
1,584,3363,3578708289,3578708289,0
1,584,3364,3578708289,3578708291,2
1,584,3365,3578708289,3578708292,3
1,584,3366,3578708289,3578708297,8
1,584,3367,3578708289,3578708297,8
1,584,3368,3578708289,3578708300,11
1,584,3369,3578708289,3578708301,12
1,584,3370,3578708289,3578708304,15
1,584,3371,3578708289,3578708308,19
1,584,3372,3578708289,3578708309,20
1,584,3373,3578708289,3578708311,22
1,584,3374,3578708289,3578708315,26
1,584,3375,3578708289,3578708318,29
1,584,3376,3578708289,3578708320,31
1,584,3377,3578708289,3578708323,34
1,584,3378,3578708289,3578708324,35
1,584,3379,3578708289,3578708324,35
1,584,3380,3578708289,3578708324,35
1,584,3381,3578708289,3578708326,37
1,584,3382,3578708289,3578708328,39
1,584,3383,3578708289,3578708329,40
1,584,3384,3578708289,3578708329,40
1,584,3385,3578708289,3578708330,41
1,584,3386,3578708289,3578708331,42
1,584,3387,3578708289,3578708334,45
1,584,3388,3578708289,3578708336,47
1,585,3389,3578708342,3578708342,0
1,585,3390,3578708342,3578708342,0
1,585,3391,3578708342,3578708345,3
1,585,3392,3578708342,3578708347,5
1,585,3393,3578708342,3578708348,6
1,585,3394,3578708342,3578708353,11
1,585,3395,3578708342,3578708360,18
1,585,3396,3578708342,3578708362,20
1,585,3397,3578708342,3578708364,22
1,585,3398,3578708342,3578708366,24
1,585,3399,3578708342,3578708367,25
1,585,3400,3578708342,3578708371,29
1,585,3401,3578708342,3578708375,33
1,585,3402,3578708342,3578708376,34
1,585,3403,3578708342,3578708379,37
1,585,3404,3578708342,3578708383,41
1,585,3405,3578708342,3578708385,43
1,585,3406,3578708342,3578708389,47
1,586,3407,3578708395,3578708395,0
1,586,3408,3578708395,3578708399,4
1,586,3409,3578708395,3578708400,5
1,586,3410,3578708395,3578708402,7
1,586,3411,3578708395,3578708412,17
1,586,3412,3578708395,3578708412,17
1,586,3413,3578708395,3578708413,18
1,586,3414,3578708395,3578708417,22
1,586,3415,3578708395,3578708418,23
1,586,3416,3578708395,3578708420,25
1,586,3417,3578708395,3578708422,27
1,586,3418,3578708395,3578708424,29
1,586,3419,3578708395,3578708429,34
1,586,3420,3578708395,3578708429,34
1,586,3421,3578708395,3578708431,36
1,586,3422,3578708395,3578708434,39
1,586,3423,3578708395,3578708437,42
1,586,3424,3578708395,3578708439,44
1,586,3425,3578708395,3578708440,45
1,586,3426,3578708395,3578708445,50
1,587,3427,3578708447,3578708448,1
1,587,3428,3578708447,3578708449,2
1,587,3429,3578708447,3578708450,3
1,587,3430,3578708447,3578708454,7
1,587,3431,3578708447,3578708454,7
1,587,3432,3578708447,3578708456,9
1,587,3433,3578708447,3578708456,9
1,587,3434,3578708447,3578708456,9
1,587,3435,3578708447,3578708457,10
1,587,3436,3578708447,3578708461,14
1,587,3437,3578708447,3578708463,16
1,587,3438,3578708447,3578708480,33
1,587,3439,3578708447,3578708481,34
1,587,3440,3578708447,3578708481,34
1,587,3441,3578708447,3578708482,35
1,587,3442,3578708447,3578708486,39
1,587,3443,3578708447,3578708491,44
1,587,3444,3578708447,3578708493,46
1,587,3445,3578708447,3578708496,49
1,588,3446,3578708500,3578708500,0
1,588,3447,3578708500,3578708500,0
1,588,3448,3578708500,3578708500,0
1,588,3449,3578708500,3578708507,7
1,588,3450,3578708500,3578708508,8
1,588,3451,3578708500,3578708509,9
1,588,3452,3578708500,3578708514,14
1,588,3453,3578708500,3578708517,17
1,588,3454,3578708500,3578708517,17
1,588,3455,3578708500,3578708520,20
1,588,3456,3578708500,3578708522,22
1,588,3457,3578708500,3578708522,22
1,588,3458,3578708500,3578708523,23
1,588,3459,3578708500,3578708524,24
1,588,3460,3578708500,3578708527,27
1,588,3461,3578708500,3578708527,27
1,588,3462,3578708500,3578708529,29
1,588,3463,3578708500,3578708529,29
1,588,3464,3578708500,3578708530,30
1,588,3465,3578708500,3578708533,33
1,588,3466,3578708500,3578708535,35
1,588,3467,3578708500,3578708541,41
1,588,3468,3578708500,3578708542,42
1,588,3469,3578708500,3578708544,44
1,588,3470,3578708500,3578708546,46
1,588,3471,3578708500,3578708547,47
1,589,3472,3578708553,3578708553,0
1,589,3473,3578708553,3578708559,6
1,589,3474,3578708553,3578708561,8
1,589,3475,3578708553,3578708563,10
1,589,3476,3578708553,3578708565,12
1,589,3477,3578708553,3578708566,13
1,589,3478,3578708553,3578708570,17
1,589,3479,3578708553,3578708574,21
1,589,3480,3578708553,3578708576,23
1,589,3481,3578708553,3578708577,24
1,589,3482,3578708553,3578708582,29
1,589,3483,3578708553,3578708585,32
1,589,3484,3578708553,3578708588,35
1,589,3485,3578708553,3578708592,39
1,589,3486,3578708553,3578708598,45
1,589,3487,3578708553,3578708599,46
1,589,3488,3578708553,3578708602,49
1,590,3489,3578708606,3578708611,5
1,590,3490,3578708606,3578708611,5
1,590,3491,3578708606,3578708612,6
1,590,3492,3578708606,3578708616,10
1,590,3493,3578708606,3578708616,10
1,590,3494,3578708606,3578708620,14
1,590,3495,3578708606,3578708621,15
1,590,3496,3578708606,3578708624,18
1,590,3497,3578708606,3578708629,23
1,590,3498,3578708606,3578708629,23
1,590,3499,3578708606,3578708630,24
1,590,3500,3578708606,3578708633,27
1,590,3501,3578708606,3578708636,30
1,590,3502,3578708606,3578708638,32
1,590,3503,3578708606,3578708640,34
1,590,3504,3578708606,3578708643,37
1,590,3505,3578708606,3578708647,41
1,590,3506,3578708606,3578708648,42
1,590,3507,3578708606,3578708649,43
1,590,3508,3578708606,3578708653,47
1,590,3509,3578708606,3578708653,47
1,590,3510,3578708606,3578708654,48
1,590,3511,3578708606,3578708655,49
1,590,3512,3578708606,3578708655,49
1,591,3513,3578708659,3578708659,0
1,591,3514,3578708659,3578708659,0
1,591,3515,3578708659,3578708662,3
1,591,3516,3578708659,3578708680,21
1,591,3517,3578708659,3578708681,22
1,591,3518,3578708659,3578708681,22
1,591,3519,3578708659,3578708681,22
1,591,3520,3578708659,3578708682,23
1,591,3521,3578708659,3578708686,27
1,591,3522,3578708659,3578708691,32
1,591,3523,3578708659,3578708693,34
1,591,3524,3578708659,3578708696,37
1,591,3525,3578708659,3578708698,39
1,591,3526,3578708659,3578708699,40
1,591,3527,3578708659,3578708700,41
1,591,3528,3578708659,3578708704,45
1,591,3529,3578708659,3578708707,48
1,592,3530,3578708712,3578708712,0
1,592,3531,3578708712,3578708712,0
1,592,3532,3578708712,3578708714,2
1,592,3533,3578708712,3578708717,5
1,592,3534,3578708712,3578708718,6
1,592,3535,3578708712,3578708720,8
1,592,3536,3578708712,3578708722,10
1,592,3537,3578708712,3578708723,11
1,592,3538,3578708712,3578708724,12
1,592,3539,3578708712,3578708727,15
1,592,3540,3578708712,3578708727,15
1,592,3541,3578708712,3578708728,16
1,592,3542,3578708712,3578708729,17
1,592,3543,3578708712,3578708730,18
1,592,3544,3578708712,3578708733,21
1,592,3545,3578708712,3578708735,23
1,592,3546,3578708712,3578708741,29
1,592,3547,3578708712,3578708741,29
1,592,3548,3578708712,3578708744,32
1,592,3549,3578708712,3578708746,34
1,592,3550,3578708712,3578708748,36
1,592,3551,3578708712,3578708752,40
1,592,3552,3578708712,3578708760,48
1,592,3553,3578708712,3578708761,49
1,592,3554,3578708712,3578708761,49
1,593,3555,3578708765,3578708765,0
1,593,3556,3578708765,3578708765,0
1,593,3557,3578708765,3578708766,1
1,593,3558,3578708765,3578708770,5
1,593,3559,3578708765,3578708774,9
1,593,3560,3578708765,3578708775,10
1,593,3561,3578708765,3578708778,13
1,593,3562,3578708765,3578708783,18
1,593,3563,3578708765,3578708784,19
1,593,3564,3578708765,3578708789,24
1,593,3565,3578708765,3578708793,28
1,593,3566,3578708765,3578708799,34
1,593,3567,3578708765,3578708799,34
1,593,3568,3578708765,3578708802,37
1,593,3569,3578708765,3578708811,46
1,593,3570,3578708765,3578708812,47
1,593,3571,3578708765,3578708812,47
1,594,3572,3578708817,3578708817,0
1,594,3573,3578708817,3578708817,0
1,594,3574,3578708817,3578708820,3
1,594,3575,3578708817,3578708823,6
1,594,3576,3578708817,3578708823,6
1,594,3577,3578708817,3578708825,8
1,594,3578,3578708817,3578708828,11
1,594,3579,3578708817,3578708829,12
1,594,3580,3578708817,3578708830,13
1,594,3581,3578708817,3578708834,17
1,594,3582,3578708817,3578708836,19
1,594,3583,3578708817,3578708838,21
1,594,3584,3578708817,3578708840,23
1,594,3585,3578708817,3578708843,26
1,594,3586,3578708817,3578708848,31
1,594,3587,3578708817,3578708849,32
1,594,3588,3578708817,3578708849,32
1,594,3589,3578708817,3578708853,36
1,594,3590,3578708817,3578708853,36
1,594,3591,3578708817,3578708855,38
1,594,3592,3578708817,3578708855,38
1,594,3593,3578708817,3578708856,39
1,594,3594,3578708817,3578708857,40
1,594,3595,3578708817,3578708860,43
1,594,3596,3578708817,3578708861,44
1,594,3597,3578708817,3578708865,48
1,595,3598,3578708870,3578708880,10
1,595,3599,3578708870,3578708881,11
1,595,3600,3578708870,3578708881,11
1,595,3601,3578708870,3578708881,11
1,595,3602,3578708870,3578708882,12
1,595,3603,3578708870,3578708886,16
1,595,3604,3578708870,3578708889,19
1,595,3605,3578708870,3578708891,21
1,595,3606,3578708870,3578708893,23
1,595,3607,3578708870,3578708896,26
1,595,3608,3578708870,3578708898,28
1,595,3609,3578708870,3578708900,30
1,595,3610,3578708870,3578708900,30
1,595,3611,3578708870,3578708903,33
1,595,3612,3578708870,3578708907,37
1,595,3613,3578708870,3578708909,39
1,595,3614,3578708870,3578708910,40
1,595,3615,3578708870,3578708914,44
1,595,3616,3578708870,3578708917,47
1,595,3617,3578708870,3578708917,47
1,595,3618,3578708870,3578708920,50
1,596,3619,3578708923,3578708923,0
1,596,3620,3578708923,3578708923,0
1,596,3621,3578708923,3578708923,0
1,596,3622,3578708923,3578708924,1
1,596,3623,3578708923,3578708925,2
1,596,3624,3578708923,3578708926,3
1,596,3625,3578708923,3578708927,4
1,596,3626,3578708923,3578708927,4
1,596,3627,3578708923,3578708928,5
1,596,3628,3578708923,3578708929,6
1,596,3629,3578708923,3578708930,7
1,596,3630,3578708923,3578708933,10
1,596,3631,3578708923,3578708936,13
1,596,3632,3578708923,3578708941,18
1,596,3633,3578708923,3578708941,18
1,596,3634,3578708923,3578708944,21
1,596,3635,3578708923,3578708946,23
1,596,3636,3578708923,3578708948,25
1,596,3637,3578708923,3578708952,29
1,596,3638,3578708923,3578708960,37
1,596,3639,3578708923,3578708962,39
1,596,3640,3578708923,3578708962,39
1,596,3641,3578708923,3578708963,40
1,596,3642,3578708923,3578708965,42
1,596,3643,3578708923,3578708966,43
1,596,3644,3578708923,3578708970,47
1,597,3645,3578708976,3578708976,0
1,597,3646,3578708976,3578708976,0
1,597,3647,3578708976,3578708978,2
1,597,3648,3578708976,3578708984,8
1,597,3649,3578708976,3578708986,10
1,597,3650,3578708976,3578708989,13
1,597,3651,3578708976,3578708993,17
1,597,3652,3578708976,3578708998,22
1,597,3653,3578708976,3578708999,23
1,597,3654,3578708976,3578709011,35
1,597,3655,3578708976,3578709012,36
1,597,3656,3578708976,3578709013,37
1,597,3657,3578708976,3578709017,41
1,597,3658,3578708976,3578709017,41
1,597,3659,3578708976,3578709020,44
1,597,3660,3578708976,3578709023,47
1,597,3661,3578708976,3578709024,48
1,598,3662,3578709029,3578709029,0
1,598,3663,3578709029,3578709029,0
1,598,3664,3578709029,3578709029,0
1,598,3665,3578709029,3578709030,1
1,598,3666,3578709029,3578709034,5
1,598,3667,3578709029,3578709037,8
1,598,3668,3578709029,3578709038,9
1,598,3669,3578709029,3578709040,11
1,598,3670,3578709029,3578709043,14
1,598,3671,3578709029,3578709048,19
1,598,3672,3578709029,3578709049,20
1,598,3673,3578709029,3578709050,21
1,598,3674,3578709029,3578709053,24
1,598,3675,3578709029,3578709053,24
1,598,3676,3578709029,3578709055,26
1,598,3677,3578709029,3578709055,26
1,598,3678,3578709029,3578709056,27
1,598,3679,3578709029,3578709058,29
1,598,3680,3578709029,3578709060,31
1,598,3681,3578709029,3578709063,34
1,598,3682,3578709029,3578709065,36
1,599,3683,3578709082,3578709082,0
1,599,3684,3578709082,3578709082,0
1,599,3685,3578709082,3578709082,0
1,599,3686,3578709082,3578709082,0
1,599,3687,3578709082,3578709083,1
1,599,3688,3578709082,3578709086,4
1,599,3689,3578709082,3578709089,7
1,599,3690,3578709082,3578709091,9
1,599,3691,3578709082,3578709093,11
1,599,3692,3578709082,3578709096,14
1,599,3693,3578709082,3578709098,16
1,599,3694,3578709082,3578709100,18
1,599,3695,3578709082,3578709102,20
1,599,3696,3578709082,3578709103,21
1,599,3697,3578709082,3578709107,25
1,599,3698,3578709082,3578709109,27
1,599,3699,3578709082,3578709110,28
1,599,3700,3578709082,3578709115,33
1,599,3701,3578709082,3578709117,35
1,599,3702,3578709082,3578709117,35
1,599,3703,3578709082,3578709120,38
1,599,3704,3578709082,3578709123,41
1,599,3705,3578709082,3578709123,41
1,599,3706,3578709082,3578709123,41
1,599,3707,3578709082,3578709123,41
1,599,3708,3578709082,3578709125,43
1,599,3709,3578709082,3578709126,44
1,599,3710,3578709082,3578709127,45
1,599,3711,3578709082,3578709128,46
1,599,3712,3578709082,3578709128,46
1,599,3713,3578709082,3578709129,47
1,599,3714,3578709082,3578709130,48
1,600,3715,3578709135,3578709135,0
1,600,3716,3578709135,3578709136,1
1,600,3717,3578709135,3578709141,6
1,600,3718,3578709135,3578709142,7
1,600,3719,3578709135,3578709144,9
1,600,3720,3578709135,3578709145,10
1,600,3721,3578709135,3578709148,13
1,600,3722,3578709135,3578709154,19
1,600,3723,3578709135,3578709160,25
1,600,3724,3578709135,3578709162,27
1,600,3725,3578709135,3578709162,27
1,600,3726,3578709135,3578709164,29
1,600,3727,3578709135,3578709165,30
1,600,3728,3578709135,3578709166,31
1,600,3729,3578709135,3578709170,35
1,600,3730,3578709135,3578709175,40
1,600,3731,3578709135,3578709176,41
1,600,3732,3578709135,3578709178,43
1,600,3733,3578709135,3578709184,49
1,601,3734,3578709188,3578709188,0
1,601,3735,3578709188,3578709189,1
1,601,3736,3578709188,3578709192,4
1,601,3737,3578709188,3578709199,11
1,601,3738,3578709188,3578709199,11
1,601,3739,3578709188,3578709202,14
1,601,3740,3578709188,3578709211,23
1,601,3741,3578709188,3578709212,24
1,601,3742,3578709188,3578709213,25
1,601,3743,3578709188,3578709218,30
1,601,3744,3578709188,3578709219,31
1,601,3745,3578709188,3578709223,35
1,601,3746,3578709188,3578709224,36
1,601,3747,3578709188,3578709226,38
1,601,3748,3578709188,3578709228,40
1,601,3749,3578709188,3578709230,42
1,601,3750,3578709188,3578709230,42
1,601,3751,3578709188,3578709234,46
1,601,3752,3578709188,3578709237,49
1,602,3753,3578709241,3578709241,0
1,602,3754,3578709241,3578709241,0
1,602,3755,3578709241,3578709244,3
1,602,3756,3578709241,3578709248,7
1,602,3757,3578709241,3578709250,9
1,602,3758,3578709241,3578709250,9
1,602,3759,3578709241,3578709253,12
1,602,3760,3578709241,3578709254,13
1,602,3761,3578709241,3578709255,14
1,602,3762,3578709241,3578709255,14
1,602,3763,3578709241,3578709256,15
1,602,3764,3578709241,3578709257,16
1,602,3765,3578709241,3578709260,19
1,602,3766,3578709241,3578709262,21
1,602,3767,3578709241,3578709265,24
1,602,3768,3578709241,3578709280,39
1,602,3769,3578709241,3578709281,40
1,602,3770,3578709241,3578709281,40
1,602,3771,3578709241,3578709282,41
1,602,3772,3578709241,3578709283,42
1,602,3773,3578709241,3578709286,45
1,602,3774,3578709241,3578709289,48
1,602,3775,3578709241,3578709291,50
1,603,3776,3578709294,3578709294,0
1,603,3777,3578709294,3578709296,2
1,603,3778,3578709294,3578709298,4
1,603,3779,3578709294,3578709301,7
1,603,3780,3578709294,3578709302,8
1,603,3781,3578709294,3578709304,10
1,603,3782,3578709294,3578709306,12
1,603,3783,3578709294,3578709309,15
1,603,3784,3578709294,3578709310,16
1,603,3785,3578709294,3578709315,21
1,603,3786,3578709294,3578709317,23
1,603,3787,3578709294,3578709318,24
1,603,3788,3578709294,3578709320,26
1,603,3789,3578709294,3578709323,29
1,603,3790,3578709294,3578709323,29
1,603,3791,3578709294,3578709323,29
1,603,3792,3578709294,3578709323,29
1,603,3793,3578709294,3578709326,32
1,603,3794,3578709294,3578709326,32
1,603,3795,3578709294,3578709328,34
1,603,3796,3578709294,3578709328,34
1,603,3797,3578709294,3578709328,34
1,603,3798,3578709294,3578709329,35
1,603,3799,3578709294,3578709330,36
1,603,3800,3578709294,3578709331,37
1,603,3801,3578709294,3578709333,39
1,603,3802,3578709294,3578709336,42
1,603,3803,3578709294,3578709341,47
1,603,3804,3578709294,3578709341,47
1,603,3805,3578709294,3578709344,50
1,604,3806,3578709347,3578709347,0
1,604,3807,3578709347,3578709354,7
1,604,3808,3578709347,3578709359,12
1,604,3809,3578709347,3578709362,15
1,604,3810,3578709347,3578709362,15
1,604,3811,3578709347,3578709364,17
1,604,3812,3578709347,3578709366,19
1,604,3813,3578709347,3578709368,21
1,604,3814,3578709347,3578709371,24
1,604,3815,3578709347,3578709376,29
1,604,3816,3578709347,3578709376,29
1,604,3817,3578709347,3578709379,32
1,604,3818,3578709347,3578709384,37
1,604,3819,3578709347,3578709387,40
1,604,3820,3578709347,3578709389,42
1,604,3821,3578709347,3578709394,47
1,605,3822,3578709400,3578709400,0
1,605,3823,3578709400,3578709400,0
1,605,3824,3578709400,3578709402,2
1,605,3825,3578709400,3578709411,11
1,605,3826,3578709400,3578709412,12
1,605,3827,3578709400,3578709412,12
1,605,3828,3578709400,3578709418,18
1,605,3829,3578709400,3578709420,20
1,605,3830,3578709400,3578709422,22
1,605,3831,3578709400,3578709425,25
1,605,3832,3578709400,3578709426,26
1,605,3833,3578709400,3578709430,30
1,605,3834,3578709400,3578709430,30
1,605,3835,3578709400,3578709431,31
1,605,3836,3578709400,3578709433,33
1,605,3837,3578709400,3578709434,34
1,605,3838,3578709400,3578709437,37
1,605,3839,3578709400,3578709440,40
1,605,3840,3578709400,3578709441,41
1,605,3841,3578709400,3578709444,44
1,605,3842,3578709400,3578709448,48
1,605,3843,3578709400,3578709449,49
1,606,3844,3578709453,3578709453,0
1,606,3845,3578709453,3578709454,1
1,606,3846,3578709453,3578709454,1
1,606,3847,3578709453,3578709455,2
1,606,3848,3578709453,3578709456,3
1,606,3849,3578709453,3578709456,3
1,606,3850,3578709453,3578709458,5
1,606,3851,3578709453,3578709459,6
1,606,3852,3578709453,3578709462,9
1,606,3853,3578709453,3578709465,12
1,606,3854,3578709453,3578709480,27
1,606,3855,3578709453,3578709481,28
1,606,3856,3578709453,3578709481,28
1,606,3857,3578709453,3578709481,28
1,606,3858,3578709453,3578709484,31
1,606,3859,3578709453,3578709486,33
1,606,3860,3578709453,3578709489,36
1,606,3861,3578709453,3578709491,38
1,606,3862,3578709453,3578709493,40
1,606,3863,3578709453,3578709496,43
1,606,3864,3578709453,3578709498,45
1,606,3865,3578709453,3578709500,47
1,607,3866,3578709506,3578709506,0
1,607,3867,3578709506,3578709506,0
1,607,3868,3578709506,3578709509,3
1,607,3869,3578709506,3578709509,3
1,607,3870,3578709506,3578709513,7
1,607,3871,3578709506,3578709517,11
1,607,3872,3578709506,3578709517,11
1,607,3873,3578709506,3578709520,14
1,607,3874,3578709506,3578709522,16
1,607,3875,3578709506,3578709522,16
1,607,3876,3578709506,3578709523,17
1,607,3877,3578709506,3578709523,17
1,607,3878,3578709506,3578709525,19
1,607,3879,3578709506,3578709525,19
1,607,3880,3578709506,3578709527,21
1,607,3881,3578709506,3578709528,22
1,607,3882,3578709506,3578709528,22
1,607,3883,3578709506,3578709529,23
1,607,3884,3578709506,3578709530,24
1,607,3885,3578709506,3578709532,26
1,607,3886,3578709506,3578709535,29
1,607,3887,3578709506,3578709540,34
1,607,3888,3578709506,3578709542,36
1,607,3889,3578709506,3578709543,37
1,607,3890,3578709506,3578709548,42
1,607,3891,3578709506,3578709554,48
1,608,3892,3578709559,3578709559,0
1,608,3893,3578709559,3578709561,2
1,608,3894,3578709559,3578709561,2
1,608,3895,3578709559,3578709563,4
1,608,3896,3578709559,3578709566,7
1,608,3897,3578709559,3578709567,8
1,608,3898,3578709559,3578709570,11
1,608,3899,3578709559,3578709575,16
1,608,3900,3578709559,3578709575,16
1,608,3901,3578709559,3578709578,19
1,608,3902,3578709559,3578709583,24
1,608,3903,3578709559,3578709586,27
1,608,3904,3578709559,3578709588,29
1,608,3905,3578709559,3578709593,34
1,608,3906,3578709559,3578709596,37
1,608,3907,3578709559,3578709597,38
1,608,3908,3578709559,3578709598,39
1,608,3909,3578709559,3578709601,42
1,608,3910,3578709559,3578709607,48
1,609,3911,3578709612,3578709612,0
1,609,3912,3578709612,3578709612,0
1,609,3913,3578709612,3578709612,0
1,609,3914,3578709612,3578709617,5
1,609,3915,3578709612,3578709617,5
1,609,3916,3578709612,3578709619,7
1,609,3917,3578709612,3578709622,10
1,609,3918,3578709612,3578709624,12
1,609,3919,3578709612,3578709625,13
1,609,3920,3578709612,3578709628,16
1,609,3921,3578709612,3578709629,17
1,609,3922,3578709612,3578709630,18
1,609,3923,3578709612,3578709633,21
1,609,3924,3578709612,3578709633,21
1,609,3925,3578709612,3578709636,24
1,609,3926,3578709612,3578709638,26
1,609,3927,3578709612,3578709640,28
1,609,3928,3578709612,3578709643,31
1,609,3929,3578709612,3578709647,35
1,609,3930,3578709612,3578709648,36
1,609,3931,3578709612,3578709650,38
1,609,3932,3578709612,3578709652,40
1,609,3933,3578709612,3578709652,40
1,609,3934,3578709612,3578709653,41
1,609,3935,3578709612,3578709655,43
1,609,3936,3578709612,3578709656,44
1,609,3937,3578709612,3578709658,46
1,609,3938,3578709612,3578709658,46
1,609,3939,3578709612,3578709662,50
1,610,3940,3578709665,3578709665,0
1,610,3941,3578709665,3578709680,15
1,610,3942,3578709665,3578709681,16
1,610,3943,3578709665,3578709681,16
1,610,3944,3578709665,3578709682,17
1,610,3945,3578709665,3578709684,19
1,610,3946,3578709665,3578709686,21
1,610,3947,3578709665,3578709687,22
1,610,3948,3578709665,3578709690,25
1,610,3949,3578709665,3578709693,28
1,610,3950,3578709665,3578709696,31
1,610,3951,3578709665,3578709697,32
1,610,3952,3578709665,3578709701,36
1,610,3953,3578709665,3578709702,37
1,610,3954,3578709665,3578709705,40
1,610,3955,3578709665,3578709705,40
1,610,3956,3578709665,3578709709,44
1,610,3957,3578709665,3578709710,45
1,611,3958,3578709718,3578709718,0
1,611,3959,3578709718,3578709718,0
1,611,3960,3578709718,3578709720,2
1,611,3961,3578709718,3578709722,4
1,611,3962,3578709718,3578709722,4
1,611,3963,3578709718,3578709723,5
1,611,3964,3578709718,3578709723,5
1,611,3965,3578709718,3578709725,7
1,611,3966,3578709718,3578709726,8
1,611,3967,3578709718,3578709727,9
1,611,3968,3578709718,3578709727,9
1,611,3969,3578709718,3578709727,9
1,611,3970,3578709718,3578709728,10
1,611,3971,3578709718,3578709729,11
1,611,3972,3578709718,3578709731,13
1,611,3973,3578709718,3578709734,16
1,611,3974,3578709718,3578709734,16
1,611,3975,3578709718,3578709740,22
1,611,3976,3578709718,3578709742,24
1,611,3977,3578709718,3578709744,26
1,611,3978,3578709718,3578709746,28
1,611,3979,3578709718,3578709748,30
1,611,3980,3578709718,3578709753,35
1,611,3981,3578709718,3578709760,42
1,611,3982,3578709718,3578709761,43
1,611,3983,3578709718,3578709761,43
1,611,3984,3578709718,3578709762,44
1,611,3985,3578709718,3578709765,47
1,611,3986,3578709718,3578709767,49
1,612,3987,3578709771,3578709771,0
1,612,3988,3578709771,3578709774,3
1,612,3989,3578709771,3578709776,5
1,612,3990,3578709771,3578709778,7
1,612,3991,3578709771,3578709783,12
1,612,3992,3578709771,3578709785,14
1,612,3993,3578709771,3578709787,16
1,612,3994,3578709771,3578709788,17
1,612,3995,3578709771,3578709793,22
1,612,3996,3578709771,3578709797,26
1,612,3997,3578709771,3578709799,28
1,612,3998,3578709771,3578709799,28
1,612,3999,3578709771,3578709801,30
1,612,4000,3578709771,3578709807,36
1,612,4001,3578709771,3578709811,40
1,612,4002,3578709771,3578709812,41
1,612,4003,3578709771,3578709812,41
1,612,4004,3578709771,3578709817,46
1,612,4005,3578709771,3578709817,46
1,612,4006,3578709771,3578709818,47
1,613,4007,3578709824,3578709824,0
1,613,4008,3578709824,3578709824,0
1,613,4009,3578709824,3578709825,1
1,613,4010,3578709824,3578709829,5
1,613,4011,3578709824,3578709829,5
1,613,4012,3578709824,3578709830,6
1,613,4013,3578709824,3578709832,8
1,613,4014,3578709824,3578709834,10
1,613,4015,3578709824,3578709836,12
1,613,4016,3578709824,3578709838,14
1,613,4017,3578709824,3578709841,17
1,613,4018,3578709824,3578709843,19
1,613,4019,3578709824,3578709848,24
1,613,4020,3578709824,3578709848,24
1,613,4021,3578709824,3578709849,25
1,613,4022,3578709824,3578709852,28
1,613,4023,3578709824,3578709853,29
1,613,4024,3578709824,3578709853,29
1,613,4025,3578709824,3578709855,31
1,613,4026,3578709824,3578709856,32
1,613,4027,3578709824,3578709858,34
1,613,4028,3578709824,3578709859,35
1,613,4029,3578709824,3578709861,37
1,613,4030,3578709824,3578709864,40
1,614,4031,3578709877,3578709880,3
1,614,4032,3578709877,3578709881,4
1,614,4033,3578709877,3578709882,5
1,614,4034,3578709877,3578709882,5
1,614,4035,3578709877,3578709884,7
1,614,4036,3578709877,3578709886,9
1,614,4037,3578709877,3578709886,9
1,614,4038,3578709877,3578709889,12
1,614,4039,3578709877,3578709890,13
1,614,4040,3578709877,3578709893,16
1,614,4041,3578709877,3578709898,21
1,614,4042,3578709877,3578709901,24
1,614,4043,3578709877,3578709902,25
1,614,4044,3578709877,3578709905,28
1,614,4045,3578709877,3578709905,28
1,614,4046,3578709877,3578709909,32
1,614,4047,3578709877,3578709910,33
1,614,4048,3578709877,3578709916,39
1,614,4049,3578709877,3578709918,41
1,614,4050,3578709877,3578709920,43
1,614,4051,3578709877,3578709922,45
1,614,4052,3578709877,3578709923,46
1,614,4053,3578709877,3578709923,46
1,614,4054,3578709877,3578709923,46
1,614,4055,3578709877,3578709926,49
1,614,4056,3578709877,3578709926,49
1,615,4057,3578709930,3578709930,0
1,615,4058,3578709930,3578709930,0
1,615,4059,3578709930,3578709930,0
1,615,4060,3578709930,3578709930,0
1,615,4061,3578709930,3578709930,0
1,615,4062,3578709930,3578709931,1
1,615,4063,3578709930,3578709933,3
1,615,4064,3578709930,3578709936,6
1,615,4065,3578709930,3578709940,10
1,615,4066,3578709930,3578709941,11
1,615,4067,3578709930,3578709944,14
1,615,4068,3578709930,3578709946,16
1,615,4069,3578709930,3578709948,18
1,615,4070,3578709930,3578709954,24
1,615,4071,3578709930,3578709960,30
1,615,4072,3578709930,3578709962,32
1,615,4073,3578709930,3578709963,33
1,615,4074,3578709930,3578709965,35
1,615,4075,3578709930,3578709966,36
1,615,4076,3578709930,3578709966,36
1,615,4077,3578709930,3578709971,41
1,615,4078,3578709930,3578709975,45
1,615,4079,3578709930,3578709976,46
1,615,4080,3578709930,3578709979,49
1,616,4081,3578709983,3578709983,0
1,616,4082,3578709983,3578709986,3
1,616,4083,3578709983,3578709989,6
1,616,4084,3578709983,3578709994,11
1,616,4085,3578709983,3578709996,13
1,616,4086,3578709983,3578709999,16
1,616,4087,3578709983,3578709999,16
1,616,4088,3578709983,3578710007,24
1,616,4089,3578709983,3578710012,29
1,616,4090,3578709983,3578710012,29
1,616,4091,3578709983,3578710013,30
1,616,4092,3578709983,3578710017,34
1,616,4093,3578709983,3578710017,34
1,616,4094,3578709983,3578710019,36
1,616,4095,3578709983,3578710022,39
1,616,4096,3578709983,3578710023,40
1,616,4097,3578709983,3578710025,42
1,616,4098,3578709983,3578710028,45
1,616,4099,3578709983,3578710029,46
1,616,4100,3578709983,3578710030,47
1,616,4101,3578709983,3578710033,50
1,617,4102,3578710036,3578710036,0
1,617,4103,3578710036,3578710037,1
1,617,4104,3578710036,3578710038,2
1,617,4105,3578710036,3578710040,4
1,617,4106,3578710036,3578710043,7
1,617,4107,3578710036,3578710048,12
1,617,4108,3578710036,3578710048,12
1,617,4109,3578710036,3578710049,13
1,617,4110,3578710036,3578710052,16
1,617,4111,3578710036,3578710053,17
1,617,4112,3578710036,3578710053,17
1,617,4113,3578710036,3578710055,19
1,617,4114,3578710036,3578710056,20
1,617,4115,3578710036,3578710059,23
1,617,4116,3578710036,3578710059,23
1,617,4117,3578710036,3578710062,26
1,617,4118,3578710036,3578710065,29
1,617,4119,3578710036,3578710081,45
1,617,4120,3578710036,3578710081,45
1,617,4121,3578710036,3578710082,46
1,617,4122,3578710036,3578710084,48
1,617,4123,3578710036,3578710086,50
1,618,4124,3578710088,3578710088,0
1,618,4125,3578710088,3578710090,2
1,618,4126,3578710088,3578710093,5
1,618,4127,3578710088,3578710097,9
1,618,4128,3578710088,3578710101,13
1,618,4129,3578710088,3578710102,14
1,618,4130,3578710088,3578710106,18
1,618,4131,3578710088,3578710106,18
1,618,4132,3578710088,3578710109,21
1,618,4133,3578710088,3578710109,21
1,618,4134,3578710088,3578710115,27
1,618,4135,3578710088,3578710117,29
1,618,4136,3578710088,3578710118,30
1,618,4137,3578710088,3578710120,32
1,618,4138,3578710088,3578710122,34
1,618,4139,3578710088,3578710123,35
1,618,4140,3578710088,3578710123,35
1,618,4141,3578710088,3578710124,36
1,618,4142,3578710088,3578710126,38
1,618,4143,3578710088,3578710126,38
1,618,4144,3578710088,3578710127,39
1,618,4145,3578710088,3578710127,39
1,618,4146,3578710088,3578710128,40
1,618,4147,3578710088,3578710129,41
1,618,4148,3578710088,3578710129,41
1,618,4149,3578710088,3578710131,43
1,618,4150,3578710088,3578710133,45
1,618,4151,3578710088,3578710136,48
1,619,4152,3578710141,3578710141,0
1,619,4153,3578710141,3578710141,0
1,619,4154,3578710141,3578710145,4
1,619,4155,3578710141,3578710146,5
1,619,4156,3578710141,3578710149,8
1,619,4157,3578710141,3578710154,13
1,619,4158,3578710141,3578710159,18
1,619,4159,3578710141,3578710163,22
1,619,4160,3578710141,3578710163,22
1,619,4161,3578710141,3578710165,24
1,619,4162,3578710141,3578710166,25
1,619,4163,3578710141,3578710167,26
1,619,4164,3578710141,3578710170,29
1,619,4165,3578710141,3578710175,34
1,619,4166,3578710141,3578710177,36
1,619,4167,3578710141,3578710178,37
1,619,4168,3578710141,3578710184,43
1,619,4169,3578710141,3578710186,45
1,619,4170,3578710141,3578710189,48
1,620,4171,3578710194,3578710194,0
1,620,4172,3578710194,3578710194,0
1,620,4173,3578710194,3578710196,2
1,620,4174,3578710194,3578710198,4
1,620,4175,3578710194,3578710199,5
1,620,4176,3578710194,3578710208,14
1,620,4177,3578710194,3578710211,17
1,620,4178,3578710194,3578710212,18
1,620,4179,3578710194,3578710212,18
1,620,4180,3578710194,3578710216,22
1,620,4181,3578710194,3578710217,23
1,620,4182,3578710194,3578710219,25
1,620,4183,3578710194,3578710223,29
1,620,4184,3578710194,3578710224,30
1,620,4185,3578710194,3578710225,31
1,620,4186,3578710194,3578710229,35
1,620,4187,3578710194,3578710230,36
1,620,4188,3578710194,3578710230,36
1,620,4189,3578710194,3578710232,38
1,620,4190,3578710194,3578710234,40
1,620,4191,3578710194,3578710237,43
1,620,4192,3578710194,3578710240,46
1,620,4193,3578710194,3578710240,46
1,620,4194,3578710194,3578710243,49
1,621,4195,3578710247,3578710248,1
1,621,4196,3578710247,3578710248,1
1,621,4197,3578710247,3578710249,2
1,621,4198,3578710247,3578710253,6
1,621,4199,3578710247,3578710254,7
1,621,4200,3578710247,3578710255,8
1,621,4201,3578710247,3578710255,8
1,621,4202,3578710247,3578710255,8
1,621,4203,3578710247,3578710259,12
1,621,4204,3578710247,3578710259,12
1,621,4205,3578710247,3578710262,15
1,621,4206,3578710247,3578710265,18
1,621,4207,3578710247,3578710281,34
1,621,4208,3578710247,3578710282,35
1,621,4209,3578710247,3578710282,35
1,621,4210,3578710247,3578710283,36
1,621,4211,3578710247,3578710284,37
1,621,4212,3578710247,3578710285,38
1,621,4213,3578710247,3578710286,39
1,621,4214,3578710247,3578710291,44
1,621,4215,3578710247,3578710294,47
1,621,4216,3578710247,3578710296,49
1,622,4217,3578710301,3578710301,0
1,622,4218,3578710301,3578710301,0
1,622,4219,3578710301,3578710302,1
1,622,4220,3578710301,3578710305,4
1,622,4221,3578710301,3578710306,5
1,622,4222,3578710301,3578710309,8
1,622,4223,3578710301,3578710310,9
1,622,4224,3578710301,3578710315,14
1,622,4225,3578710301,3578710317,16
1,622,4226,3578710301,3578710318,17
1,622,4227,3578710301,3578710319,18
1,622,4228,3578710301,3578710322,21
1,622,4229,3578710301,3578710323,22
1,622,4230,3578710301,3578710323,22
1,622,4231,3578710301,3578710323,22
1,622,4232,3578710301,3578710325,24
1,622,4233,3578710301,3578710326,25
1,622,4234,3578710301,3578710327,26
1,622,4235,3578710301,3578710328,27
1,622,4236,3578710301,3578710328,27
1,622,4237,3578710301,3578710329,28
1,622,4238,3578710301,3578710330,29
1,622,4239,3578710301,3578710331,30
1,622,4240,3578710301,3578710333,32
1,622,4241,3578710301,3578710336,35
1,622,4242,3578710301,3578710341,40
1,622,4243,3578710301,3578710341,40
1,622,4244,3578710301,3578710344,43
1,622,4245,3578710301,3578710346,45
1,622,4246,3578710301,3578710350,49
1,623,4247,3578710354,3578710354,0
1,623,4248,3578710354,3578710359,5
1,623,4249,3578710354,3578710363,9
1,623,4250,3578710354,3578710363,9
1,623,4251,3578710354,3578710366,12
1,623,4252,3578710354,3578710366,12
1,623,4253,3578710354,3578710368,14
1,623,4254,3578710354,3578710371,17
1,623,4255,3578710354,3578710375,21
1,623,4256,3578710354,3578710377,23
1,623,4257,3578710354,3578710378,24
1,623,4258,3578710354,3578710385,31
1,623,4259,3578710354,3578710386,32
1,623,4260,3578710354,3578710389,35
1,623,4261,3578710354,3578710394,40
1,623,4262,3578710354,3578710394,40
1,623,4263,3578710354,3578710396,42
1,623,4264,3578710354,3578710399,45
1,623,4265,3578710354,3578710399,45
1,623,4266,3578710354,3578710401,47
1,624,4267,3578710406,3578710408,2
1,624,4268,3578710406,3578710411,5
1,624,4269,3578710406,3578710411,5
1,624,4270,3578710406,3578710413,7
1,624,4271,3578710406,3578710417,11
1,624,4272,3578710406,3578710418,12
1,624,4273,3578710406,3578710420,14
1,624,4274,3578710406,3578710422,16
1,624,4275,3578710406,3578710424,18
1,624,4276,3578710406,3578710425,19
1,624,4277,3578710406,3578710430,24
1,624,4278,3578710406,3578710430,24
1,624,4279,3578710406,3578710432,26
1,624,4280,3578710406,3578710433,27
1,624,4281,3578710406,3578710434,28
1,624,4282,3578710406,3578710437,31
1,624,4283,3578710406,3578710440,34
1,624,4284,3578710406,3578710440,34
1,624,4285,3578710406,3578710444,38
1,624,4286,3578710406,3578710448,42
1,624,4287,3578710406,3578710448,42
1,624,4288,3578710406,3578710449,43
1,624,4289,3578710406,3578710453,47
1,624,4290,3578710406,3578710454,48
1,624,4291,3578710406,3578710454,48
1,624,4292,3578710406,3578710456,50
1,625,4293,3578710459,3578710459,0
1,625,4294,3578710459,3578710459,0
1,625,4295,3578710459,3578710459,0
1,625,4296,3578710459,3578710463,4
1,625,4297,3578710459,3578710465,6
1,625,4298,3578710459,3578710481,22
1,625,4299,3578710459,3578710482,23
1,625,4300,3578710459,3578710482,23
1,625,4301,3578710459,3578710482,23
1,625,4302,3578710459,3578710484,25
1,625,4303,3578710459,3578710485,26
1,625,4304,3578710459,3578710486,27
1,625,4305,3578710459,3578710490,31
1,625,4306,3578710459,3578710494,35
1,625,4307,3578710459,3578710496,37
1,625,4308,3578710459,3578710496,37
1,625,4309,3578710459,3578710498,39
1,625,4310,3578710459,3578710500,41
1,625,4311,3578710459,3578710502,43
1,625,4312,3578710459,3578710505,46
1,625,4313,3578710459,3578710505,46
1,625,4314,3578710459,3578710509,50
1,626,4315,3578710513,3578710513,0
1,626,4316,3578710513,3578710514,1
1,626,4317,3578710513,3578710516,3
1,626,4318,3578710513,3578710518,5
1,626,4319,3578710513,3578710520,7
1,626,4320,3578710513,3578710522,9
1,626,4321,3578710513,3578710522,9
1,626,4322,3578710513,3578710522,9
1,626,4323,3578710513,3578710522,9
1,626,4324,3578710513,3578710525,12
1,626,4325,3578710513,3578710525,12
1,626,4326,3578710513,3578710526,13
1,626,4327,3578710513,3578710527,14
1,626,4328,3578710513,3578710527,14
1,626,4329,3578710513,3578710528,15
1,626,4330,3578710513,3578710529,16
1,626,4331,3578710513,3578710530,17
1,626,4332,3578710513,3578710532,19
1,626,4333,3578710513,3578710535,22
1,626,4334,3578710513,3578710540,27
1,626,4335,3578710513,3578710541,28
1,626,4336,3578710513,3578710544,31
1,626,4337,3578710513,3578710546,33
1,626,4338,3578710513,3578710548,35
1,626,4339,3578710513,3578710553,40
1,626,4340,3578710513,3578710559,46
1,626,4341,3578710513,3578710561,48
1,626,4342,3578710513,3578710562,49
1,626,4343,3578710513,3578710563,50
1,627,4344,3578710567,3578710567,0
1,627,4345,3578710567,3578710567,0
1,627,4346,3578710567,3578710567,0
1,627,4347,3578710567,3578710570,3
1,627,4348,3578710567,3578710574,7
1,627,4349,3578710567,3578710577,10
1,627,4350,3578710567,3578710578,11
1,627,4351,3578710567,3578710583,16
1,627,4352,3578710567,3578710585,18
1,627,4353,3578710567,3578710586,19
1,627,4354,3578710567,3578710589,22
1,627,4355,3578710567,3578710592,25
1,627,4356,3578710567,3578710593,26
1,627,4357,3578710567,3578710596,29
1,627,4358,3578710567,3578710597,30
1,627,4359,3578710567,3578710597,30
1,627,4360,3578710567,3578710598,31
1,627,4361,3578710567,3578710607,40
1,627,4362,3578710567,3578710610,43
1,627,4363,3578710567,3578710611,44
1,627,4364,3578710567,3578710617,50
1,628,4365,3578710620,3578710620,0
1,628,4366,3578710620,3578710620,0
1,628,4367,3578710620,3578710621,1
1,628,4368,3578710620,3578710622,2
1,628,4369,3578710620,3578710622,2
1,628,4370,3578710620,3578710623,3
1,628,4371,3578710620,3578710628,8
1,628,4372,3578710620,3578710628,8
1,628,4373,3578710620,3578710630,10
1,628,4374,3578710620,3578710632,12
1,628,4375,3578710620,3578710633,13
1,628,4376,3578710620,3578710636,16
1,628,4377,3578710620,3578710639,19
1,628,4378,3578710620,3578710643,23
1,628,4379,3578710620,3578710647,27
1,628,4380,3578710620,3578710647,27
1,628,4381,3578710620,3578710648,28
1,628,4382,3578710620,3578710652,32
1,628,4383,3578710620,3578710653,33
1,628,4384,3578710620,3578710654,34
1,628,4385,3578710620,3578710655,35
1,628,4386,3578710620,3578710656,36
1,628,4387,3578710620,3578710658,38
1,628,4388,3578710620,3578710658,38
1,628,4389,3578710620,3578710662,42
1,628,4390,3578710620,3578710665,45
1,629,4391,3578710673,3578710681,8
1,629,4392,3578710673,3578710682,9
1,629,4393,3578710673,3578710682,9
1,629,4394,3578710673,3578710683,10
1,629,4395,3578710673,3578710684,11
1,629,4396,3578710673,3578710686,13
1,629,4397,3578710673,3578710687,14
1,629,4398,3578710673,3578710690,17
1,629,4399,3578710673,3578710694,21
1,629,4400,3578710673,3578710696,23
1,629,4401,3578710673,3578710696,23
1,629,4402,3578710673,3578710698,25
1,629,4403,3578710673,3578710701,28
1,629,4404,3578710673,3578710701,28
1,629,4405,3578710673,3578710702,29
1,629,4406,3578710673,3578710705,32
1,629,4407,3578710673,3578710709,36
1,629,4408,3578710673,3578710711,38
1,629,4409,3578710673,3578710714,41
1,629,4410,3578710673,3578710716,43
1,629,4411,3578710673,3578710719,46
1,629,4412,3578710673,3578710720,47
1,629,4413,3578710673,3578710722,49
1,629,4414,3578710673,3578710722,49
1,629,4415,3578710673,3578710723,50
1,630,4416,3578710727,3578710727,0
1,630,4417,3578710727,3578710727,0
1,630,4418,3578710727,3578710727,0
1,630,4419,3578710727,3578710727,0
1,630,4420,3578710727,3578710727,0
1,630,4421,3578710727,3578710727,0
1,630,4422,3578710727,3578710728,1
1,630,4423,3578710727,3578710729,2
1,630,4424,3578710727,3578710730,3
1,630,4425,3578710727,3578710734,7
1,630,4426,3578710727,3578710735,8
1,630,4427,3578710727,3578710740,13
1,630,4428,3578710727,3578710741,14
1,630,4429,3578710727,3578710744,17
1,630,4430,3578710727,3578710745,18
1,630,4431,3578710727,3578710749,22
1,630,4432,3578710727,3578710750,23
1,630,4433,3578710727,3578710753,26
1,630,4434,3578710727,3578710760,33
1,630,4435,3578710727,3578710761,34
1,630,4436,3578710727,3578710762,35
1,630,4437,3578710727,3578710762,35
1,630,4438,3578710727,3578710765,38
1,630,4439,3578710727,3578710766,39
1,630,4440,3578710727,3578710766,39
1,630,4441,3578710727,3578710771,44
1,630,4442,3578710727,3578710774,47
1,630,4443,3578710727,3578710777,50
1,631,4444,3578710780,3578710780,0
1,631,4445,3578710780,3578710784,4
1,631,4446,3578710780,3578710785,5
1,631,4447,3578710780,3578710786,6
1,631,4448,3578710780,3578710788,8
1,631,4449,3578710780,3578710792,12
1,631,4450,3578710780,3578710793,13
1,631,4451,3578710780,3578710796,16
1,631,4452,3578710780,3578710798,18
1,631,4453,3578710780,3578710798,18
1,631,4454,3578710780,3578710799,19
1,631,4455,3578710780,3578710801,21
1,631,4456,3578710780,3578710807,27
1,631,4457,3578710780,3578710811,31
1,631,4458,3578710780,3578710812,32
1,631,4459,3578710780,3578710813,33
1,631,4460,3578710780,3578710817,37
1,631,4461,3578710780,3578710817,37
1,631,4462,3578710780,3578710819,39
1,631,4463,3578710780,3578710821,41
1,631,4464,3578710780,3578710822,42
1,631,4465,3578710780,3578710822,42
1,631,4466,3578710780,3578710825,45
1,631,4467,3578710780,3578710828,48
1,631,4468,3578710780,3578710829,49
1,632,4469,3578710833,3578710833,0
1,632,4470,3578710833,3578710833,0
1,632,4471,3578710833,3578710834,1
1,632,4472,3578710833,3578710836,3
1,632,4473,3578710833,3578710839,6
1,632,4474,3578710833,3578710840,7
1,632,4475,3578710833,3578710843,10
1,632,4476,3578710833,3578710847,14
1,632,4477,3578710833,3578710848,15
1,632,4478,3578710833,3578710849,16
1,632,4479,3578710833,3578710852,19
1,632,4480,3578710833,3578710853,20
1,632,4481,3578710833,3578710853,20
1,632,4482,3578710833,3578710855,22
1,632,4483,3578710833,3578710856,23
1,632,4484,3578710833,3578710858,25
1,632,4485,3578710833,3578710859,26
1,632,4486,3578710833,3578710861,28
1,632,4487,3578710833,3578710865,32
1,632,4488,3578710833,3578710881,48
1,632,4489,3578710833,3578710882,49
1,632,4490,3578710833,3578710882,49
1,632,4491,3578710833,3578710883,50
1,633,4492,3578710886,3578710886,0
1,633,4493,3578710886,3578710886,0
1,633,4494,3578710886,3578710887,1
1,633,4495,3578710886,3578710890,4
1,633,4496,3578710886,3578710894,8
1,633,4497,3578710886,3578710896,10
1,633,4498,3578710886,3578710897,11
1,633,4499,3578710886,3578710898,12
1,633,4500,3578710886,3578710900,14
1,633,4501,3578710886,3578710902,16
1,633,4502,3578710886,3578710906,20
1,633,4503,3578710886,3578710906,20
1,633,4504,3578710886,3578710909,23
1,633,4505,3578710886,3578710910,24
1,633,4506,3578710886,3578710913,27
1,633,4507,3578710886,3578710917,31
1,633,4508,3578710886,3578710918,32
1,633,4509,3578710886,3578710920,34
1,633,4510,3578710886,3578710922,36
1,633,4511,3578710886,3578710923,37
1,633,4512,3578710886,3578710923,37
1,633,4513,3578710886,3578710924,38
1,633,4514,3578710886,3578710926,40
1,633,4515,3578710886,3578710926,40
1,633,4516,3578710886,3578710927,41
1,633,4517,3578710886,3578710927,41
1,633,4518,3578710886,3578710928,42
1,633,4519,3578710886,3578710929,43
1,633,4520,3578710886,3578710930,44
1,633,4521,3578710886,3578710933,47
1,633,4522,3578710886,3578710935,49
1,634,4523,3578710939,3578710940,1
1,634,4524,3578710939,3578710942,3
1,634,4525,3578710939,3578710943,4
1,634,4526,3578710939,3578710946,7
1,634,4527,3578710939,3578710948,9
1,634,4528,3578710939,3578710951,12
1,634,4529,3578710939,3578710952,13
1,634,4530,3578710939,3578710959,20
1,634,4531,3578710939,3578710962,23
1,634,4532,3578710939,3578710962,23
1,634,4533,3578710939,3578710963,24
1,634,4534,3578710939,3578710965,26
1,634,4535,3578710939,3578710967,28
1,634,4536,3578710939,3578710967,28
1,634,4537,3578710939,3578710971,32
1,634,4538,3578710939,3578710975,36
1,634,4539,3578710939,3578710976,37
1,634,4540,3578710939,3578710979,40
1,634,4541,3578710939,3578710984,45
1,634,4542,3578710939,3578710986,47
1,634,4543,3578710939,3578710986,47
1,634,4544,3578710939,3578710989,50
1,635,4545,3578710992,3578710992,0
1,635,4546,3578710992,3578710993,1
1,635,4547,3578710992,3578710995,3
1,635,4548,3578710992,3578710998,6
1,635,4549,3578710992,3578710999,7
1,635,4550,3578710992,3578711000,8
1,635,4551,3578710992,3578711002,10
1,635,4552,3578710992,3578711007,15
1,635,4553,3578710992,3578711012,20
1,635,4554,3578710992,3578711012,20
1,635,4555,3578710992,3578711016,24
1,635,4556,3578710992,3578711017,25
1,635,4557,3578710992,3578711019,27
1,635,4558,3578710992,3578711021,29
1,635,4559,3578710992,3578711022,30
1,635,4560,3578710992,3578711022,30
1,635,4561,3578710992,3578711025,33
1,635,4562,3578710992,3578711029,37
1,635,4563,3578710992,3578711029,37
1,635,4564,3578710992,3578711030,38
1,635,4565,3578710992,3578711031,39
1,635,4566,3578710992,3578711035,43
1,635,4567,3578710992,3578711037,45
1,635,4568,3578710992,3578711039,47
1,635,4569,3578710992,3578711040,48
1,636,4570,3578711045,3578711045,0
1,636,4571,3578711045,3578711047,2
1,636,4572,3578711045,3578711048,3
1,636,4573,3578711045,3578711049,4
1,636,4574,3578711045,3578711052,7
1,636,4575,3578711045,3578711053,8
1,636,4576,3578711045,3578711054,9
1,636,4577,3578711045,3578711055,10
1,636,4578,3578711045,3578711056,11
1,636,4579,3578711045,3578711058,13
1,636,4580,3578711045,3578711059,14
1,636,4581,3578711045,3578711063,18
1,636,4582,3578711045,3578711066,21
1,636,4583,3578711045,3578711081,36
1,636,4584,3578711045,3578711082,37
1,636,4585,3578711045,3578711083,38
1,636,4586,3578711045,3578711083,38
1,636,4587,3578711045,3578711086,41
1,636,4588,3578711045,3578711086,41
1,636,4589,3578711045,3578711088,43
1,636,4590,3578711045,3578711090,45
1,636,4591,3578711045,3578711094,49
1,637,4592,3578711098,3578711098,0
1,637,4593,3578711098,3578711098,0
1,637,4594,3578711098,3578711098,0
1,637,4595,3578711098,3578711100,2
1,637,4596,3578711098,3578711101,3
1,637,4597,3578711098,3578711105,7
1,637,4598,3578711098,3578711106,8
1,637,4599,3578711098,3578711110,12
1,637,4600,3578711098,3578711110,12
1,637,4601,3578711098,3578711115,17
1,637,4602,3578711098,3578711117,19
1,637,4603,3578711098,3578711119,21
1,637,4604,3578711098,3578711119,21
1,637,4605,3578711098,3578711122,24
1,637,4606,3578711098,3578711123,25
1,637,4607,3578711098,3578711124,26
1,637,4608,3578711098,3578711124,26
1,637,4609,3578711098,3578711126,28
1,637,4610,3578711098,3578711126,28
1,637,4611,3578711098,3578711127,29
1,637,4612,3578711098,3578711128,30
1,637,4613,3578711098,3578711128,30
1,637,4614,3578711098,3578711129,31
1,637,4615,3578711098,3578711130,32
1,637,4616,3578711098,3578711133,35
1,637,4617,3578711098,3578711136,38
1,637,4618,3578711098,3578711141,43
1,637,4619,3578711098,3578711141,43
1,637,4620,3578711098,3578711143,45
1,637,4621,3578711098,3578711146,48
1,638,4622,3578711151,3578711151,0
1,638,4623,3578711151,3578711154,3
1,638,4624,3578711151,3578711156,5
1,638,4625,3578711151,3578711160,9
1,638,4626,3578711151,3578711162,11
1,638,4627,3578711151,3578711162,11
1,638,4628,3578711151,3578711164,13
1,638,4629,3578711151,3578711165,14
1,638,4630,3578711151,3578711166,15
1,638,4631,3578711151,3578711167,16
1,638,4632,3578711151,3578711171,20
1,638,4633,3578711151,3578711175,24
1,638,4634,3578711151,3578711176,25
1,638,4635,3578711151,3578711180,29
1,638,4636,3578711151,3578711184,33
1,638,4637,3578711151,3578711186,35
1,638,4638,3578711151,3578711186,35
1,638,4639,3578711151,3578711189,38
1,638,4640,3578711151,3578711192,41
1,638,4641,3578711151,3578711193,42
1,638,4642,3578711151,3578711195,44
1,638,4643,3578711151,3578711198,47
1,638,4644,3578711151,3578711200,49
1,638,4645,3578711151,3578711200,49
1,639,4646,3578711204,3578711204,0
1,639,4647,3578711204,3578711204,0
1,639,4648,3578711204,3578711207,3
1,639,4649,3578711204,3578711211,7
1,639,4650,3578711204,3578711212,8
1,639,4651,3578711204,3578711213,9
1,639,4652,3578711204,3578711217,13
1,639,4653,3578711204,3578711217,13
1,639,4654,3578711204,3578711219,15
1,639,4655,3578711204,3578711221,17
1,639,4656,3578711204,3578711222,18
1,639,4657,3578711204,3578711223,19
1,639,4658,3578711204,3578711225,21
1,639,4659,3578711204,3578711229,25
1,639,4660,3578711204,3578711229,25
1,639,4661,3578711204,3578711231,27
1,639,4662,3578711204,3578711232,28
1,639,4663,3578711204,3578711235,31
1,639,4664,3578711204,3578711237,33
1,639,4665,3578711204,3578711239,35
1,639,4666,3578711204,3578711240,36
1,639,4667,3578711204,3578711244,40
1,639,4668,3578711204,3578711247,43
1,639,4669,3578711204,3578711248,44
1,639,4670,3578711204,3578711249,45
1,639,4671,3578711204,3578711252,48
1,640,4672,3578711257,3578711257,0
1,640,4673,3578711257,3578711257,0
1,640,4674,3578711257,3578711257,0
1,640,4675,3578711257,3578711257,0
1,640,4676,3578711257,3578711258,1
1,640,4677,3578711257,3578711258,1
1,640,4678,3578711257,3578711260,3
1,640,4679,3578711257,3578711262,5
1,640,4680,3578711257,3578711266,9
1,640,4681,3578711257,3578711282,25
1,640,4682,3578711257,3578711282,25
1,640,4683,3578711257,3578711282,25
1,640,4684,3578711257,3578711283,26
1,640,4685,3578711257,3578711285,28
1,640,4686,3578711257,3578711286,29
1,640,4687,3578711257,3578711287,30
1,640,4688,3578711257,3578711291,34
1,640,4689,3578711257,3578711294,37
1,640,4690,3578711257,3578711297,40
1,640,4691,3578711257,3578711297,40
1,640,4692,3578711257,3578711298,41
1,640,4693,3578711257,3578711300,43
1,640,4694,3578711257,3578711302,45
1,640,4695,3578711257,3578711306,49
1,640,4696,3578711257,3578711306,49
1,641,4697,3578711310,3578711310,0
1,641,4698,3578711310,3578711310,0
1,641,4699,3578711310,3578711315,5
1,641,4700,3578711310,3578711318,8
1,641,4701,3578711310,3578711318,8
1,641,4702,3578711310,3578711320,10
1,641,4703,3578711310,3578711322,12
1,641,4704,3578711310,3578711323,13
1,641,4705,3578711310,3578711323,13
1,641,4706,3578711310,3578711324,14
1,641,4707,3578711310,3578711326,16
1,641,4708,3578711310,3578711326,16
1,641,4709,3578711310,3578711328,18
1,641,4710,3578711310,3578711328,18
1,641,4711,3578711310,3578711329,19
1,641,4712,3578711310,3578711330,20
1,641,4713,3578711310,3578711331,21
1,641,4714,3578711310,3578711334,24
1,641,4715,3578711310,3578711335,25
1,641,4716,3578711310,3578711341,31
1,641,4717,3578711310,3578711342,32
1,641,4718,3578711310,3578711344,34
1,641,4719,3578711310,3578711346,36
1,641,4720,3578711310,3578711352,42
1,641,4721,3578711310,3578711353,43
1,641,4722,3578711310,3578711356,46
1,641,4723,3578711310,3578711360,50
1,642,4724,3578711364,3578711364,0
1,642,4725,3578711364,3578711364,0
1,642,4726,3578711364,3578711364,0
1,642,4727,3578711364,3578711366,2
1,642,4728,3578711364,3578711366,2
1,642,4729,3578711364,3578711368,4
1,642,4730,3578711364,3578711372,8
1,642,4731,3578711364,3578711375,11
1,642,4732,3578711364,3578711377,13
1,642,4733,3578711364,3578711379,15
1,642,4734,3578711364,3578711383,19
1,642,4735,3578711364,3578711386,22
1,642,4736,3578711364,3578711386,22
1,642,4737,3578711364,3578711389,25
1,642,4738,3578711364,3578711393,29
1,642,4739,3578711364,3578711393,29
1,642,4740,3578711364,3578711395,31
1,642,4741,3578711364,3578711398,34
1,642,4742,3578711364,3578711399,35
1,642,4743,3578711364,3578711400,36
1,642,4744,3578711364,3578711401,37
1,642,4745,3578711364,3578711402,38
1,642,4746,3578711364,3578711407,43
1,642,4747,3578711364,3578711411,47
1,642,4748,3578711364,3578711411,47
1,642,4749,3578711364,3578711413,49
1,643,4750,3578711418,3578711418,0
1,643,4751,3578711418,3578711418,0
1,643,4752,3578711418,3578711419,1
1,643,4753,3578711418,3578711421,3
1,643,4754,3578711418,3578711422,4
1,643,4755,3578711418,3578711422,4
1,643,4756,3578711418,3578711424,6
1,643,4757,3578711418,3578711429,11
1,643,4758,3578711418,3578711430,12
1,643,4759,3578711418,3578711431,13
1,643,4760,3578711418,3578711433,15
1,643,4761,3578711418,3578711435,17
1,643,4762,3578711418,3578711437,19
1,643,4763,3578711418,3578711439,21
1,643,4764,3578711418,3578711440,22
1,643,4765,3578711418,3578711445,27
1,643,4766,3578711418,3578711447,29
1,643,4767,3578711418,3578711448,30
1,643,4768,3578711418,3578711449,31
1,643,4769,3578711418,3578711453,35
1,643,4770,3578711418,3578711455,37
1,643,4771,3578711418,3578711456,38
1,643,4772,3578711418,3578711456,38
1,643,4773,3578711418,3578711457,39
1,643,4774,3578711418,3578711457,39
1,643,4775,3578711418,3578711459,41
1,643,4776,3578711418,3578711459,41
1,643,4777,3578711418,3578711463,45
1,643,4778,3578711418,3578711465,47
1,644,4779,3578711471,3578711482,11
1,644,4780,3578711471,3578711482,11
1,644,4781,3578711471,3578711482,11
1,644,4782,3578711471,3578711483,12
1,644,4783,3578711471,3578711486,15
1,644,4784,3578711471,3578711486,15
1,644,4785,3578711471,3578711488,17
1,644,4786,3578711471,3578711491,20
1,644,4787,3578711471,3578711494,23
1,644,4788,3578711471,3578711496,25
1,644,4789,3578711471,3578711497,26
1,644,4790,3578711471,3578711498,27
1,644,4791,3578711471,3578711500,29
1,644,4792,3578711471,3578711502,31
1,644,4793,3578711471,3578711502,31
1,644,4794,3578711471,3578711506,35
1,644,4795,3578711471,3578711506,35
1,644,4796,3578711471,3578711509,38
1,644,4797,3578711471,3578711510,39
1,644,4798,3578711471,3578711514,43
1,644,4799,3578711471,3578711518,47
1,644,4800,3578711471,3578711518,47
1,644,4801,3578711471,3578711521,50
1,645,4802,3578711524,3578711524,0
1,645,4803,3578711524,3578711524,0
1,645,4804,3578711524,3578711524,0
1,645,4805,3578711524,3578711524,0
1,645,4806,3578711524,3578711525,1
1,645,4807,3578711524,3578711525,1
1,645,4808,3578711524,3578711527,3
1,645,4809,3578711524,3578711527,3
1,645,4810,3578711524,3578711527,3
1,645,4811,3578711524,3578711528,4
1,645,4812,3578711524,3578711529,5
1,645,4813,3578711524,3578711530,6
1,645,4814,3578711524,3578711533,9
1,645,4815,3578711524,3578711534,10
1,645,4816,3578711524,3578711540,16
1,645,4817,3578711524,3578711542,18
1,645,4818,3578711524,3578711543,19
1,645,4819,3578711524,3578711545,21
1,645,4820,3578711524,3578711550,26
1,645,4821,3578711524,3578711552,28
1,645,4822,3578711524,3578711555,31
1,645,4823,3578711524,3578711559,35
1,645,4824,3578711524,3578711560,36
1,645,4825,3578711524,3578711561,37
1,645,4826,3578711524,3578711563,39
1,645,4827,3578711524,3578711565,41
1,645,4828,3578711524,3578711565,41
1,645,4829,3578711524,3578711567,43
1,645,4830,3578711524,3578711570,46
1,646,4831,3578711578,3578711578,0
1,646,4832,3578711578,3578711578,0
1,646,4833,3578711578,3578711578,0
1,646,4834,3578711578,3578711582,4
1,646,4835,3578711578,3578711585,7
1,646,4836,3578711578,3578711585,7
1,646,4837,3578711578,3578711588,10
1,646,4838,3578711578,3578711592,14
1,646,4839,3578711578,3578711592,14
1,646,4840,3578711578,3578711594,16
1,646,4841,3578711578,3578711597,19
1,646,4842,3578711578,3578711599,21
1,646,4843,3578711578,3578711599,21
1,646,4844,3578711578,3578711600,22
1,646,4845,3578711578,3578711601,23
1,646,4846,3578711578,3578711607,29
1,646,4847,3578711578,3578711610,32
1,646,4848,3578711578,3578711611,33
1,646,4849,3578711578,3578711613,35
1,646,4850,3578711578,3578711616,38
1,646,4851,3578711578,3578711616,38
1,646,4852,3578711578,3578711618,40
1,646,4853,3578711578,3578711621,43
1,646,4854,3578711578,3578711621,43
1,646,4855,3578711578,3578711621,43
1,646,4856,3578711578,3578711624,46
1,647,4857,3578711631,3578711631,0
1,647,4858,3578711631,3578711631,0
1,647,4859,3578711631,3578711631,0
1,647,4860,3578711631,3578711633,2
1,647,4861,3578711631,3578711634,3
1,647,4862,3578711631,3578711636,5
1,647,4863,3578711631,3578711638,7
1,647,4864,3578711631,3578711639,8
1,647,4865,3578711631,3578711644,13
1,647,4866,3578711631,3578711647,16
1,647,4867,3578711631,3578711648,17
1,647,4868,3578711631,3578711648,17
1,647,4869,3578711631,3578711651,20
1,647,4870,3578711631,3578711654,23
1,647,4871,3578711631,3578711655,24
1,647,4872,3578711631,3578711655,24
1,647,4873,3578711631,3578711656,25
1,647,4874,3578711631,3578711656,25
1,647,4875,3578711631,3578711659,28
1,647,4876,3578711631,3578711659,28
1,647,4877,3578711631,3578711661,30
1,647,4878,3578711631,3578711661,30
1,647,4879,3578711631,3578711664,33
1,648,4880,3578711685,3578711685,0
1,648,4881,3578711685,3578711685,0
1,648,4882,3578711685,3578711685,0
1,648,4883,3578711685,3578711685,0
1,648,4884,3578711685,3578711686,1
1,648,4885,3578711685,3578711686,1
1,648,4886,3578711685,3578711688,3
1,648,4887,3578711685,3578711691,6
1,648,4888,3578711685,3578711694,9
1,648,4889,3578711685,3578711697,12
1,648,4890,3578711685,3578711697,12
1,648,4891,3578711685,3578711698,13
1,648,4892,3578711685,3578711700,15
1,648,4893,3578711685,3578711702,17
1,648,4894,3578711685,3578711706,21
1,648,4895,3578711685,3578711706,21
1,648,4896,3578711685,3578711709,24
1,648,4897,3578711685,3578711710,25
1,648,4898,3578711685,3578711715,30
1,648,4899,3578711685,3578711718,33
1,648,4900,3578711685,3578711719,34
1,648,4901,3578711685,3578711721,36
1,648,4902,3578711685,3578711722,37
1,648,4903,3578711685,3578711723,38
1,648,4904,3578711685,3578711724,39
1,648,4905,3578711685,3578711724,39
1,648,4906,3578711685,3578711725,40
1,648,4907,3578711685,3578711725,40
1,648,4908,3578711685,3578711727,42
1,648,4909,3578711685,3578711727,42
1,648,4910,3578711685,3578711728,43
1,648,4911,3578711685,3578711728,43
1,648,4912,3578711685,3578711729,44
1,648,4913,3578711685,3578711731,46
1,648,4914,3578711685,3578711733,48
1,648,4915,3578711685,3578711734,49
1,649,4916,3578711738,3578711740,2
1,649,4917,3578711738,3578711741,3
1,649,4918,3578711738,3578711742,4
1,649,4919,3578711738,3578711744,6
1,649,4920,3578711738,3578711748,10
1,649,4921,3578711738,3578711751,13
1,649,4922,3578711738,3578711753,15
1,649,4923,3578711738,3578711754,16
1,649,4924,3578711738,3578711760,22
1,649,4925,3578711738,3578711761,23
1,649,4926,3578711738,3578711761,23
1,649,4927,3578711738,3578711762,24
1,649,4928,3578711738,3578711765,27
1,649,4929,3578711738,3578711766,28
1,649,4930,3578711738,3578711766,28
1,649,4931,3578711738,3578711771,33
1,649,4932,3578711738,3578711774,36
1,649,4933,3578711738,3578711776,38
1,649,4934,3578711738,3578711779,41
1,649,4935,3578711738,3578711784,46
1,649,4936,3578711738,3578711785,47
1,649,4937,3578711738,3578711785,47
1,649,4938,3578711738,3578711788,50
1,650,4939,3578711791,3578711792,1
1,650,4940,3578711791,3578711792,1
1,650,4941,3578711791,3578711794,3
1,650,4942,3578711791,3578711797,6
1,650,4943,3578711791,3578711798,7
1,650,4944,3578711791,3578711799,8
1,650,4945,3578711791,3578711801,10
1,650,4946,3578711791,3578711807,16
1,650,4947,3578711791,3578711811,20
1,650,4948,3578711791,3578711812,21
1,650,4949,3578711791,3578711813,22
1,650,4950,3578711791,3578711816,25
1,650,4951,3578711791,3578711817,26
1,650,4952,3578711791,3578711817,26
1,650,4953,3578711791,3578711819,28
1,650,4954,3578711791,3578711821,30
1,650,4955,3578711791,3578711822,31
1,650,4956,3578711791,3578711822,31
1,650,4957,3578711791,3578711824,33
1,650,4958,3578711791,3578711829,38
1,650,4959,3578711791,3578711829,38
1,650,4960,3578711791,3578711831,40
1,650,4961,3578711791,3578711832,41
1,650,4962,3578711791,3578711834,43
1,650,4963,3578711791,3578711836,45
1,650,4964,3578711791,3578711839,48
1,650,4965,3578711791,3578711839,48
1,651,4966,3578711844,3578711844,0
1,651,4967,3578711844,3578711847,3
1,651,4968,3578711844,3578711848,4
1,651,4969,3578711844,3578711849,5
1,651,4970,3578711844,3578711851,7
1,651,4971,3578711844,3578711854,10
1,651,4972,3578711844,3578711855,11
1,651,4973,3578711844,3578711855,11
1,651,4974,3578711844,3578711856,12
1,651,4975,3578711844,3578711856,12
1,651,4976,3578711844,3578711858,14
1,651,4977,3578711844,3578711859,15
1,651,4978,3578711844,3578711861,17
1,651,4979,3578711844,3578711861,17
1,651,4980,3578711844,3578711864,20
1,651,4981,3578711844,3578711882,38
1,651,4982,3578711844,3578711883,39
1,651,4983,3578711844,3578711883,39
1,651,4984,3578711844,3578711886,42
1,651,4985,3578711844,3578711886,42
1,651,4986,3578711844,3578711888,44
1,651,4987,3578711844,3578711891,47
1,651,4988,3578711844,3578711894,50
1,652,4989,3578711898,3578711898,0
1,652,4990,3578711898,3578711898,0
1,652,4991,3578711898,3578711899,1
1,652,4992,3578711898,3578711900,2
1,652,4993,3578711898,3578711902,4
1,652,4994,3578711898,3578711906,8
1,652,4995,3578711898,3578711906,8
1,652,4996,3578711898,3578711909,11
1,652,4997,3578711898,3578711910,12
1,652,4998,3578711898,3578711914,16
1,652,4999,3578711898,3578711918,20
1,652,5000,3578711898,3578711918,20
1,652,5001,3578711898,3578711920,22
1,652,5002,3578711898,3578711922,24
1,652,5003,3578711898,3578711923,25
1,652,5004,3578711898,3578711923,25
1,652,5005,3578711898,3578711924,26
1,652,5006,3578711898,3578711924,26
1,652,5007,3578711898,3578711926,28
1,652,5008,3578711898,3578711927,29
1,652,5009,3578711898,3578711927,29
1,652,5010,3578711898,3578711927,29
1,652,5011,3578711898,3578711928,30
1,652,5012,3578711898,3578711929,31
1,652,5013,3578711898,3578711931,33
1,652,5014,3578711898,3578711933,35
1,652,5015,3578711898,3578711936,38
1,652,5016,3578711898,3578711940,42
1,652,5017,3578711898,3578711942,44
1,652,5018,3578711898,3578711943,45
1,652,5019,3578711898,3578711945,47
1,653,5020,3578711951,3578711951,0
1,653,5021,3578711951,3578711951,0
1,653,5022,3578711951,3578711953,2
1,653,5023,3578711951,3578711955,4
1,653,5024,3578711951,3578711960,9
1,653,5025,3578711951,3578711962,11
1,653,5026,3578711951,3578711962,11
1,653,5027,3578711951,3578711963,12
1,653,5028,3578711951,3578711966,15
1,653,5029,3578711951,3578711967,16
1,653,5030,3578711951,3578711969,18
1,653,5031,3578711951,3578711971,20
1,653,5032,3578711951,3578711975,24
1,653,5033,3578711951,3578711976,25
1,653,5034,3578711951,3578711978,27
1,653,5035,3578711951,3578711985,34
1,653,5036,3578711951,3578711985,34
1,653,5037,3578711951,3578711986,35
1,653,5038,3578711951,3578711989,38
1,653,5039,3578711951,3578711992,41
1,653,5040,3578711951,3578711993,42
1,653,5041,3578711951,3578711994,43
1,653,5042,3578711951,3578711997,46
1,653,5043,3578711951,3578711998,47
1,653,5044,3578711951,3578711999,48
1,653,5045,3578711951,3578712001,50
1,654,5046,3578712004,3578712007,3
1,654,5047,3578712004,3578712011,7
1,654,5048,3578712004,3578712011,7
1,654,5049,3578712004,3578712013,9
1,654,5050,3578712004,3578712016,12
1,654,5051,3578712004,3578712017,13
1,654,5052,3578712004,3578712018,14
1,654,5053,3578712004,3578712019,15
1,654,5054,3578712004,3578712021,17
1,654,5055,3578712004,3578712022,18
1,654,5056,3578712004,3578712022,18
1,654,5057,3578712004,3578712025,21
1,654,5058,3578712004,3578712029,25
1,654,5059,3578712004,3578712029,25
1,654,5060,3578712004,3578712031,27
1,654,5061,3578712004,3578712032,28
1,654,5062,3578712004,3578712034,30
1,654,5063,3578712004,3578712037,33
1,654,5064,3578712004,3578712039,35
1,654,5065,3578712004,3578712039,35
1,654,5066,3578712004,3578712044,40
1,654,5067,3578712004,3578712047,43
1,654,5068,3578712004,3578712048,44
1,654,5069,3578712004,3578712049,45
1,654,5070,3578712004,3578712052,48
1,655,5071,3578712057,3578712057,0
1,655,5072,3578712057,3578712057,0
1,655,5073,3578712057,3578712057,0
1,655,5074,3578712057,3578712057,0
1,655,5075,3578712057,3578712057,0
1,655,5076,3578712057,3578712058,1
1,655,5077,3578712057,3578712059,2
1,655,5078,3578712057,3578712061,4
1,655,5079,3578712057,3578712062,5
1,655,5080,3578712057,3578712065,8
1,655,5081,3578712057,3578712083,26
1,655,5082,3578712057,3578712083,26
1,655,5083,3578712057,3578712083,26
1,655,5084,3578712057,3578712083,26
1,655,5085,3578712057,3578712085,28
1,655,5086,3578712057,3578712086,29
1,655,5087,3578712057,3578712087,30
1,655,5088,3578712057,3578712092,35
1,655,5089,3578712057,3578712094,37
1,655,5090,3578712057,3578712097,40
1,655,5091,3578712057,3578712097,40
1,655,5092,3578712057,3578712099,42
1,655,5093,3578712057,3578712100,43
1,655,5094,3578712057,3578712101,44
1,655,5095,3578712057,3578712102,45
1,655,5096,3578712057,3578712105,48
1,655,5097,3578712057,3578712106,49
1,656,5098,3578712110,3578712110,0
1,656,5099,3578712110,3578712111,1
1,656,5100,3578712110,3578712115,5
1,656,5101,3578712110,3578712118,8
1,656,5102,3578712110,3578712119,9
1,656,5103,3578712110,3578712121,11
1,656,5104,3578712110,3578712122,12
1,656,5105,3578712110,3578712123,13
1,656,5106,3578712110,3578712123,13
1,656,5107,3578712110,3578712124,14
1,656,5108,3578712110,3578712125,15
1,656,5109,3578712110,3578712126,16
1,656,5110,3578712110,3578712127,17
1,656,5111,3578712110,3578712128,18
1,656,5112,3578712110,3578712128,18
1,656,5113,3578712110,3578712128,18
1,656,5114,3578712110,3578712129,19
1,656,5115,3578712110,3578712131,21
1,656,5116,3578712110,3578712133,23
1,656,5117,3578712110,3578712137,27
1,656,5118,3578712110,3578712141,31
1,656,5119,3578712110,3578712144,34
1,656,5120,3578712110,3578712145,35
1,656,5121,3578712110,3578712148,38
1,656,5122,3578712110,3578712150,40
1,656,5123,3578712110,3578712154,44
1,656,5124,3578712110,3578712154,44
1,656,5125,3578712110,3578712160,50
1,657,5126,3578712163,3578712163,0
1,657,5127,3578712163,3578712163,0
1,657,5128,3578712163,3578712164,1
1,657,5129,3578712163,3578712166,3
1,657,5130,3578712163,3578712166,3
1,657,5131,3578712163,3578712169,6
1,657,5132,3578712163,3578712171,8
1,657,5133,3578712163,3578712175,12
1,657,5134,3578712163,3578712176,13
1,657,5135,3578712163,3578712178,15
1,657,5136,3578712163,3578712185,22
1,657,5137,3578712163,3578712185,22
1,657,5138,3578712163,3578712186,23
1,657,5139,3578712163,3578712189,26
1,657,5140,3578712163,3578712192,29
1,657,5141,3578712163,3578712192,29
1,657,5142,3578712163,3578712194,31
1,657,5143,3578712163,3578712198,35
1,657,5144,3578712163,3578712198,35
1,657,5145,3578712163,3578712199,36
1,657,5146,3578712163,3578712201,38
1,657,5147,3578712163,3578712201,38
1,657,5148,3578712163,3578712207,44
1,657,5149,3578712163,3578712211,48
1,657,5150,3578712163,3578712212,49
1,657,5151,3578712163,3578712213,50
1,658,5152,3578712217,3578712217,0
1,658,5153,3578712217,3578712217,0
1,658,5154,3578712217,3578712219,2
1,658,5155,3578712217,3578712219,2
1,658,5156,3578712217,3578712221,4
1,658,5157,3578712217,3578712221,4
1,658,5158,3578712217,3578712223,6
1,658,5159,3578712217,3578712225,8
1,658,5160,3578712217,3578712229,12
1,658,5161,3578712217,3578712230,13
1,658,5162,3578712217,3578712231,14
1,658,5163,3578712217,3578712232,15
1,658,5164,3578712217,3578712234,17
1,658,5165,3578712217,3578712237,20
1,658,5166,3578712217,3578712239,22
1,658,5167,3578712217,3578712240,23
1,658,5168,3578712217,3578712245,28
1,658,5169,3578712217,3578712248,31
1,658,5170,3578712217,3578712248,31
1,658,5171,3578712217,3578712249,32
1,658,5172,3578712217,3578712252,35
1,658,5173,3578712217,3578712255,38
1,658,5174,3578712217,3578712255,38
1,658,5175,3578712217,3578712256,39
1,658,5176,3578712217,3578712256,39
1,658,5177,3578712217,3578712256,39
1,658,5178,3578712217,3578712258,41
1,658,5179,3578712217,3578712259,42
1,658,5180,3578712217,3578712262,45
1,658,5181,3578712217,3578712263,46
1,658,5182,3578712217,3578712265,48
1,659,5183,3578712271,3578712273,2
1,659,5184,3578712271,3578712282,11
1,659,5185,3578712271,3578712283,12
1,659,5186,3578712271,3578712283,12
1,659,5187,3578712271,3578712283,12
1,659,5188,3578712271,3578712285,14
1,659,5189,3578712271,3578712286,15
1,659,5190,3578712271,3578712287,16
1,659,5191,3578712271,3578712292,21
1,659,5192,3578712271,3578712294,23
1,659,5193,3578712271,3578712297,26
1,659,5194,3578712271,3578712297,26
1,659,5195,3578712271,3578712299,28
1,659,5196,3578712271,3578712300,29
1,659,5197,3578712271,3578712301,30
1,659,5198,3578712271,3578712302,31
1,659,5199,3578712271,3578712306,35
1,659,5200,3578712271,3578712309,38
1,659,5201,3578712271,3578712311,40
1,659,5202,3578712271,3578712314,43
1,659,5203,3578712271,3578712318,47
1,659,5204,3578712271,3578712319,48
1,660,5205,3578712324,3578712324,0
1,660,5206,3578712324,3578712324,0
1,660,5207,3578712324,3578712324,0
1,660,5208,3578712324,3578712324,0
1,660,5209,3578712324,3578712324,0
1,660,5210,3578712324,3578712324,0
1,660,5211,3578712324,3578712326,2
1,660,5212,3578712324,3578712328,4
1,660,5213,3578712324,3578712328,4
1,660,5214,3578712324,3578712328,4
1,660,5215,3578712324,3578712329,5
1,660,5216,3578712324,3578712330,6
1,660,5217,3578712324,3578712331,7
1,660,5218,3578712324,3578712333,9
1,660,5219,3578712324,3578712337,13
1,660,5220,3578712324,3578712342,18
1,660,5221,3578712324,3578712344,20
1,660,5222,3578712324,3578712345,21
1,660,5223,3578712324,3578712348,24
1,660,5224,3578712324,3578712350,26
1,660,5225,3578712324,3578712354,30
1,660,5226,3578712324,3578712354,30
1,660,5227,3578712324,3578712360,36
1,660,5228,3578712324,3578712361,37
1,660,5229,3578712324,3578712363,39
1,660,5230,3578712324,3578712364,40
1,660,5231,3578712324,3578712366,42
1,660,5232,3578712324,3578712366,42
1,660,5233,3578712324,3578712367,43
1,660,5234,3578712324,3578712369,45
1,660,5235,3578712324,3578712370,46
1,661,5236,3578712379,3578712379,0
1,661,5237,3578712379,3578712379,0
1,661,5238,3578712379,3578712379,0
1,661,5239,3578712379,3578712384,5
1,661,5240,3578712379,3578712385,6
1,661,5241,3578712379,3578712386,7
1,661,5242,3578712379,3578712389,10
1,661,5243,3578712379,3578712392,13
1,661,5244,3578712379,3578712394,15
1,661,5245,3578712379,3578712395,16
1,661,5246,3578712379,3578712397,18
1,661,5247,3578712379,3578712399,20
1,661,5248,3578712379,3578712399,20
1,661,5249,3578712379,3578712400,21
1,661,5250,3578712379,3578712401,22
1,661,5251,3578712379,3578712407,28
1,661,5252,3578712379,3578712411,32
1,661,5253,3578712379,3578712412,33
1,661,5254,3578712379,3578712412,33
1,661,5255,3578712379,3578712418,39
1,661,5256,3578712379,3578712418,39
1,661,5257,3578712379,3578712418,39
1,661,5258,3578712379,3578712419,40
1,661,5259,3578712379,3578712421,42
1,661,5260,3578712379,3578712422,43
1,661,5261,3578712379,3578712422,43
1,661,5262,3578712379,3578712424,45
1,662,5263,3578712432,3578712432,0
1,662,5264,3578712432,3578712432,0
1,662,5265,3578712432,3578712433,1
1,662,5266,3578712432,3578712434,2
1,662,5267,3578712432,3578712437,5
1,662,5268,3578712432,3578712440,8
1,662,5269,3578712432,3578712445,13
1,662,5270,3578712432,3578712448,16
1,662,5271,3578712432,3578712449,17
1,662,5272,3578712432,3578712451,19
1,662,5273,3578712432,3578712456,24
1,662,5274,3578712432,3578712456,24
1,662,5275,3578712432,3578712456,24
1,662,5276,3578712432,3578712456,24
1,662,5277,3578712432,3578712457,25
1,662,5278,3578712432,3578712458,26
1,662,5279,3578712432,3578712458,26
1,662,5280,3578712432,3578712462,30
1,662,5281,3578712432,3578712462,30
1,662,5282,3578712432,3578712465,33
1,662,5283,3578712432,3578712474,42
1,663,5284,3578712486,3578712486,0
1,663,5285,3578712486,3578712486,0
1,663,5286,3578712486,3578712486,0
1,663,5287,3578712486,3578712486,0
1,663,5288,3578712486,3578712486,0
1,663,5289,3578712486,3578712486,0
1,663,5290,3578712486,3578712487,1
1,663,5291,3578712486,3578712490,4
1,663,5292,3578712486,3578712494,8
1,663,5293,3578712486,3578712496,10
1,663,5294,3578712486,3578712496,10
1,663,5295,3578712486,3578712498,12
1,663,5296,3578712486,3578712500,14
1,663,5297,3578712486,3578712501,15
1,663,5298,3578712486,3578712501,15
1,663,5299,3578712486,3578712504,18
1,663,5300,3578712486,3578712508,22
1,663,5301,3578712486,3578712510,24
1,663,5302,3578712486,3578712514,28
1,663,5303,3578712486,3578712517,31
1,663,5304,3578712486,3578712519,33
1,663,5305,3578712486,3578712521,35
1,663,5306,3578712486,3578712521,35
1,663,5307,3578712486,3578712522,36
1,663,5308,3578712486,3578712523,37
1,663,5309,3578712486,3578712524,38
1,663,5310,3578712486,3578712525,39
1,663,5311,3578712486,3578712525,39
1,663,5312,3578712486,3578712527,41
1,663,5313,3578712486,3578712527,41
1,663,5314,3578712486,3578712527,41
1,663,5315,3578712486,3578712529,43
1,663,5316,3578712486,3578712529,43
1,663,5317,3578712486,3578712530,44
1,663,5318,3578712486,3578712532,46
1,663,5319,3578712486,3578712536,50
1,664,5320,3578712539,3578712541,2
1,664,5321,3578712539,3578712541,2
1,664,5322,3578712539,3578712543,4
1,664,5323,3578712539,3578712544,5
1,664,5324,3578712539,3578712548,9
1,664,5325,3578712539,3578712550,11
1,664,5326,3578712539,3578712554,15
1,664,5327,3578712539,3578712554,15
1,664,5328,3578712539,3578712559,20
1,664,5329,3578712539,3578712561,22
1,664,5330,3578712539,3578712562,23
1,664,5331,3578712539,3578712565,26
1,664,5332,3578712539,3578712566,27
1,664,5333,3578712539,3578712566,27
1,664,5334,3578712539,3578712567,28
1,664,5335,3578712539,3578712571,32
1,664,5336,3578712539,3578712574,35
1,664,5337,3578712539,3578712575,36
1,664,5338,3578712539,3578712576,37
1,664,5339,3578712539,3578712578,39
1,664,5340,3578712539,3578712583,44
1,664,5341,3578712539,3578712585,46
1,664,5342,3578712539,3578712585,46
1,664,5343,3578712539,3578712588,49
1,665,5344,3578712593,3578712593,0
1,665,5345,3578712593,3578712593,0
1,665,5346,3578712593,3578712597,4
1,665,5347,3578712593,3578712597,4
1,665,5348,3578712593,3578712598,5
1,665,5349,3578712593,3578712599,6
1,665,5350,3578712593,3578712601,8
1,665,5351,3578712593,3578712607,14
1,665,5352,3578712593,3578712610,17
1,665,5353,3578712593,3578712611,18
1,665,5354,3578712593,3578712612,19
1,665,5355,3578712593,3578712616,23
1,665,5356,3578712593,3578712617,24
1,665,5357,3578712593,3578712618,25
1,665,5358,3578712593,3578712619,26
1,665,5359,3578712593,3578712620,27
1,665,5360,3578712593,3578712621,28
1,665,5361,3578712593,3578712621,28
1,665,5362,3578712593,3578712624,31
1,665,5363,3578712593,3578712627,34
1,665,5364,3578712593,3578712629,36
1,665,5365,3578712593,3578712630,37
1,665,5366,3578712593,3578712632,39
1,665,5367,3578712593,3578712633,40
1,665,5368,3578712593,3578712636,43
1,665,5369,3578712593,3578712639,46
1,665,5370,3578712593,3578712640,47
1,666,5371,3578712647,3578712647,0
1,666,5372,3578712647,3578712647,0
1,666,5373,3578712647,3578712648,1
1,666,5374,3578712647,3578712650,3
1,666,5375,3578712647,3578712655,8
1,666,5376,3578712647,3578712655,8
1,666,5377,3578712647,3578712655,8
1,666,5378,3578712647,3578712655,8
1,666,5379,3578712647,3578712655,8
1,666,5380,3578712647,3578712658,11
1,666,5381,3578712647,3578712658,11
1,666,5382,3578712647,3578712661,14
1,666,5383,3578712647,3578712662,15
1,666,5384,3578712647,3578712664,17
1,666,5385,3578712647,3578712674,27
1,666,5386,3578712647,3578712682,35
1,666,5387,3578712647,3578712682,35
1,666,5388,3578712647,3578712683,36
1,666,5389,3578712647,3578712683,36
1,666,5390,3578712647,3578712684,37
1,666,5391,3578712647,3578712685,38
1,666,5392,3578712647,3578712686,39
1,666,5393,3578712647,3578712691,44
1,666,5394,3578712647,3578712693,46
1,666,5395,3578712647,3578712696,49
1,666,5396,3578712647,3578712696,49
1,667,5397,3578712701,3578712701,0
1,667,5398,3578712701,3578712701,0
1,667,5399,3578712701,3578712701,0
1,667,5400,3578712701,3578712702,1
1,667,5401,3578712701,3578712705,4
1,667,5402,3578712701,3578712710,9
1,667,5403,3578712701,3578712710,9
1,667,5404,3578712701,3578712713,12
1,667,5405,3578712701,3578712718,17
1,667,5406,3578712701,3578712719,18
1,667,5407,3578712701,3578712720,19
1,667,5408,3578712701,3578712722,21
1,667,5409,3578712701,3578712723,22
1,667,5410,3578712701,3578712724,23
1,667,5411,3578712701,3578712724,23
1,667,5412,3578712701,3578712724,23
1,667,5413,3578712701,3578712725,24
1,667,5414,3578712701,3578712726,25
1,667,5415,3578712701,3578712727,26
1,667,5416,3578712701,3578712727,26
1,667,5417,3578712701,3578712728,27
1,667,5418,3578712701,3578712729,28
1,667,5419,3578712701,3578712729,28
1,667,5420,3578712701,3578712730,29
1,667,5421,3578712701,3578712733,32
1,667,5422,3578712701,3578712736,35
1,667,5423,3578712701,3578712741,40
1,667,5424,3578712701,3578712742,41
1,667,5425,3578712701,3578712744,43
1,667,5426,3578712701,3578712744,43
1,667,5427,3578712701,3578712748,47
1,667,5428,3578712701,3578712750,49
1,668,5429,3578712754,3578712754,0
1,668,5430,3578712754,3578712754,0
1,668,5431,3578712754,3578712759,5
1,668,5432,3578712754,3578712761,7
1,668,5433,3578712754,3578712763,9
1,668,5434,3578712754,3578712765,11
1,668,5435,3578712754,3578712766,12
1,668,5436,3578712754,3578712767,13
1,668,5437,3578712754,3578712767,13
1,668,5438,3578712754,3578712770,16
1,668,5439,3578712754,3578712775,21
1,668,5440,3578712754,3578712775,21
1,668,5441,3578712754,3578712775,21
1,668,5442,3578712754,3578712778,24
1,668,5443,3578712754,3578712784,30
1,668,5444,3578712754,3578712785,31
1,668,5445,3578712754,3578712785,31
1,668,5446,3578712754,3578712788,34
1,668,5447,3578712754,3578712792,38
1,668,5448,3578712754,3578712792,38
1,668,5449,3578712754,3578712796,42
1,668,5450,3578712754,3578712799,45
1,668,5451,3578712754,3578712799,45
1,668,5452,3578712754,3578712800,46
1,669,5453,3578712808,3578712808,0
1,669,5454,3578712808,3578712811,3
1,669,5455,3578712808,3578712812,4
1,669,5456,3578712808,3578712812,4
1,669,5457,3578712808,3578712816,8
1,669,5458,3578712808,3578712819,11
1,669,5459,3578712808,3578712820,12
1,669,5460,3578712808,3578712820,12
1,669,5461,3578712808,3578712821,13
1,669,5462,3578712808,3578712822,14
1,669,5463,3578712808,3578712824,16
1,669,5464,3578712808,3578712826,18
1,669,5465,3578712808,3578712828,20
1,669,5466,3578712808,3578712829,21
1,669,5467,3578712808,3578712830,22
1,669,5468,3578712808,3578712830,22
1,669,5469,3578712808,3578712831,23
1,669,5470,3578712808,3578712834,26
1,669,5471,3578712808,3578712836,28
1,669,5472,3578712808,3578712839,31
1,669,5473,3578712808,3578712845,37
1,669,5474,3578712808,3578712848,40
1,669,5475,3578712808,3578712848,40
1,669,5476,3578712808,3578712849,41
1,669,5477,3578712808,3578712851,43
1,669,5478,3578712808,3578712855,47
1,669,5479,3578712808,3578712855,47
1,669,5480,3578712808,3578712856,48
1,669,5481,3578712808,3578712856,48
1,669,5482,3578712808,3578712856,48
1,669,5483,3578712808,3578712857,49
1,669,5484,3578712808,3578712858,50
1,670,5485,3578712862,3578712862,0
1,670,5486,3578712862,3578712862,0
1,670,5487,3578712862,3578712863,1
1,670,5488,3578712862,3578712864,2
1,670,5489,3578712862,3578712874,12
1,670,5490,3578712862,3578712881,19
1,670,5491,3578712862,3578712882,20
1,670,5492,3578712862,3578712883,21
1,670,5493,3578712862,3578712883,21
1,670,5494,3578712862,3578712883,21
1,670,5495,3578712862,3578712884,22
1,670,5496,3578712862,3578712885,23
1,670,5497,3578712862,3578712887,25
1,670,5498,3578712862,3578712891,29
1,670,5499,3578712862,3578712893,31
1,670,5500,3578712862,3578712896,34
1,670,5501,3578712862,3578712896,34
1,670,5502,3578712862,3578712898,36
1,670,5503,3578712862,3578712900,38
1,670,5504,3578712862,3578712901,39
1,670,5505,3578712862,3578712902,40
1,670,5506,3578712862,3578712905,43
1,670,5507,3578712862,3578712905,43
1,670,5508,3578712862,3578712910,48
1,670,5509,3578712862,3578712910,48
1,671,5510,3578712915,3578712915,0
1,671,5511,3578712915,3578712917,2
1,671,5512,3578712915,3578712919,4
1,671,5513,3578712915,3578712921,6
1,671,5514,3578712915,3578712922,7
1,671,5515,3578712915,3578712923,8
1,671,5516,3578712915,3578712923,8
1,671,5517,3578712915,3578712923,8
1,671,5518,3578712915,3578712925,10
1,671,5519,3578712915,3578712925,10
1,671,5520,3578712915,3578712926,11
1,671,5521,3578712915,3578712926,11
1,671,5522,3578712915,3578712927,12
1,671,5523,3578712915,3578712927,12
1,671,5524,3578712915,3578712929,14
1,671,5525,3578712915,3578712930,15
1,671,5526,3578712915,3578712930,15
1,671,5527,3578712915,3578712933,18
1,671,5528,3578712915,3578712937,22
1,671,5529,3578712915,3578712941,26
1,671,5530,3578712915,3578712942,27
1,671,5531,3578712915,3578712945,30
1,671,5532,3578712915,3578712945,30
1,671,5533,3578712915,3578712948,33
1,671,5534,3578712915,3578712950,35
1,671,5535,3578712915,3578712953,38
1,671,5536,3578712915,3578712960,45
1,671,5537,3578712915,3578712962,47
1,671,5538,3578712915,3578712963,48
1,671,5539,3578712915,3578712965,50
1,672,5540,3578712968,3578712968,0
1,672,5541,3578712968,3578712968,0
1,672,5542,3578712968,3578712968,0
1,672,5543,3578712968,3578712970,2
1,672,5544,3578712968,3578712975,7
1,672,5545,3578712968,3578712975,7
1,672,5546,3578712968,3578712976,8
1,672,5547,3578712968,3578712979,11
1,672,5548,3578712968,3578712982,14
1,672,5549,3578712968,3578712983,15
1,672,5550,3578712968,3578712984,16
1,672,5551,3578712968,3578712986,18
1,672,5552,3578712968,3578712990,22
1,672,5553,3578712968,3578712992,24
1,672,5554,3578712968,3578712993,25
1,672,5555,3578712968,3578712996,28
1,672,5556,3578712968,3578712998,30
1,672,5557,3578712968,3578712999,31
1,672,5558,3578712968,3578712999,31
1,672,5559,3578712968,3578713007,39
1,672,5560,3578712968,3578713011,43
1,672,5561,3578712968,3578713012,44
1,672,5562,3578712968,3578713013,45
1,672,5563,3578712968,3578713016,48
1,672,5564,3578712968,3578713017,49
1,673,5565,3578713022,3578713022,0
1,673,5566,3578713022,3578713022,0
1,673,5567,3578713022,3578713022,0
1,673,5568,3578713022,3578713022,0
1,673,5569,3578713022,3578713022,0
1,673,5570,3578713022,3578713025,3
1,673,5571,3578713022,3578713027,5
1,673,5572,3578713022,3578713028,6
1,673,5573,3578713022,3578713029,7
1,673,5574,3578713022,3578713030,8
1,673,5575,3578713022,3578713031,9
1,673,5576,3578713022,3578713032,10
1,673,5577,3578713022,3578713033,11
1,673,5578,3578713022,3578713034,12
1,673,5579,3578713022,3578713037,15
1,673,5580,3578713022,3578713039,17
1,673,5581,3578713022,3578713044,22
1,673,5582,3578713022,3578713047,25
1,673,5583,3578713022,3578713048,26
1,673,5584,3578713022,3578713050,28
1,673,5585,3578713022,3578713051,29
1,673,5586,3578713022,3578713055,33
1,673,5587,3578713022,3578713056,34
1,673,5588,3578713022,3578713056,34
1,673,5589,3578713022,3578713056,34
1,673,5590,3578713022,3578713057,35
1,673,5591,3578713022,3578713057,35
1,673,5592,3578713022,3578713058,36
1,673,5593,3578713022,3578713062,40
1,673,5594,3578713022,3578713063,41
1,673,5595,3578713022,3578713063,41
1,673,5596,3578713022,3578713065,43
1,674,5597,3578713076,3578713076,0
1,674,5598,3578713076,3578713081,5
1,674,5599,3578713076,3578713082,6
1,674,5600,3578713076,3578713082,6
1,674,5601,3578713076,3578713083,7
1,674,5602,3578713076,3578713083,7
1,674,5603,3578713076,3578713085,9
1,674,5604,3578713076,3578713085,9
1,674,5605,3578713076,3578713086,10
1,674,5606,3578713076,3578713091,15
1,674,5607,3578713076,3578713093,17
1,674,5608,3578713076,3578713096,20
1,674,5609,3578713076,3578713097,21
1,674,5610,3578713076,3578713098,22
1,674,5611,3578713076,3578713100,24
1,674,5612,3578713076,3578713100,24
1,674,5613,3578713076,3578713102,26
1,674,5614,3578713076,3578713105,29
1,674,5615,3578713076,3578713105,29
1,674,5616,3578713076,3578713110,34
1,674,5617,3578713076,3578713111,35
1,674,5618,3578713076,3578713114,38
1,674,5619,3578713076,3578713118,42
1,674,5620,3578713076,3578713118,42
1,674,5621,3578713076,3578713121,45
1,674,5622,3578713076,3578713122,46
1,674,5623,3578713076,3578713123,47
1,674,5624,3578713076,3578713124,48
1,674,5625,3578713076,3578713124,48
1,674,5626,3578713076,3578713124,48
1,674,5627,3578713076,3578713124,48
1,674,5628,3578713076,3578713126,50
1,675,5629,3578713129,3578713129,0
1,675,5630,3578713129,3578713129,0
1,675,5631,3578713129,3578713129,0
1,675,5632,3578713129,3578713129,0
1,675,5633,3578713129,3578713130,1
1,675,5634,3578713129,3578713130,1
1,675,5635,3578713129,3578713133,4
1,675,5636,3578713129,3578713137,8
1,675,5637,3578713129,3578713140,11
1,675,5638,3578713129,3578713141,12
1,675,5639,3578713129,3578713145,16
1,675,5640,3578713129,3578713145,16
1,675,5641,3578713129,3578713148,19
1,675,5642,3578713129,3578713149,20
1,675,5643,3578713129,3578713153,24
1,675,5644,3578713129,3578713160,31
1,675,5645,3578713129,3578713162,33
1,675,5646,3578713129,3578713163,34
1,675,5647,3578713129,3578713165,36
1,675,5648,3578713129,3578713167,38
1,675,5649,3578713129,3578713168,39
1,675,5650,3578713129,3578713171,42
1,675,5651,3578713129,3578713175,46
1,675,5652,3578713129,3578713176,47
1,675,5653,3578713129,3578713176,47
1,675,5654,3578713129,3578713179,50
1,676,5655,3578713182,3578713182,0
1,676,5656,3578713182,3578713184,2
1,676,5657,3578713182,3578713185,3
1,676,5658,3578713182,3578713187,5
1,676,5659,3578713182,3578713189,7
1,676,5660,3578713182,3578713192,10
1,676,5661,3578713182,3578713193,11
1,676,5662,3578713182,3578713196,14
1,676,5663,3578713182,3578713198,16
1,676,5664,3578713182,3578713199,17
1,676,5665,3578713182,3578713199,17
1,676,5666,3578713182,3578713201,19
1,676,5667,3578713182,3578713207,25
1,676,5668,3578713182,3578713211,29
1,676,5669,3578713182,3578713212,30
1,676,5670,3578713182,3578713213,31
1,676,5671,3578713182,3578713216,34
1,676,5672,3578713182,3578713218,36
1,676,5673,3578713182,3578713219,37
1,676,5674,3578713182,3578713220,38
1,676,5675,3578713182,3578713221,39
1,676,5676,3578713182,3578713221,39
1,676,5677,3578713182,3578713223,41
1,676,5678,3578713182,3578713225,43
1,676,5679,3578713182,3578713227,45
1,676,5680,3578713182,3578713229,47
1,676,5681,3578713182,3578713230,48
1,676,5682,3578713182,3578713230,48
1,676,5683,3578713182,3578713231,49
1,677,5684,3578713235,3578713235,0
1,677,5685,3578713235,3578713235,0
1,677,5686,3578713235,3578713235,0
1,677,5687,3578713235,3578713237,2
1,677,5688,3578713235,3578713239,4
1,677,5689,3578713235,3578713244,9
1,677,5690,3578713235,3578713247,12
1,677,5691,3578713235,3578713249,14
1,677,5692,3578713235,3578713251,16
1,677,5693,3578713235,3578713255,20
1,677,5694,3578713235,3578713256,21
1,677,5695,3578713235,3578713256,21
1,677,5696,3578713235,3578713256,21
1,677,5697,3578713235,3578713257,22
1,677,5698,3578713235,3578713257,22
1,677,5699,3578713235,3578713261,26
1,677,5700,3578713235,3578713262,27
1,677,5701,3578713235,3578713263,28
1,677,5702,3578713235,3578713265,30
1,677,5703,3578713235,3578713274,39
1,677,5704,3578713235,3578713281,46
1,677,5705,3578713235,3578713282,47
1,677,5706,3578713235,3578713283,48
1,677,5707,3578713235,3578713283,48
1,678,5708,3578713289,3578713289,0
1,678,5709,3578713289,3578713289,0
1,678,5710,3578713289,3578713289,0
1,678,5711,3578713289,3578713291,2
1,678,5712,3578713289,3578713293,4
1,678,5713,3578713289,3578713296,7
1,678,5714,3578713289,3578713296,7
1,678,5715,3578713289,3578713298,9
1,678,5716,3578713289,3578713301,12
1,678,5717,3578713289,3578713302,13
1,678,5718,3578713289,3578713304,15
1,678,5719,3578713289,3578713305,16
1,678,5720,3578713289,3578713310,21
1,678,5721,3578713289,3578713312,23
1,678,5722,3578713289,3578713315,26
1,678,5723,3578713289,3578713318,29
1,678,5724,3578713289,3578713318,29
1,678,5725,3578713289,3578713321,32
1,678,5726,3578713289,3578713323,34
1,678,5727,3578713289,3578713323,34
1,678,5728,3578713289,3578713323,34
1,678,5729,3578713289,3578713324,35
1,678,5730,3578713289,3578713325,36
1,678,5731,3578713289,3578713326,37
1,678,5732,3578713289,3578713328,39
1,678,5733,3578713289,3578713328,39
1,678,5734,3578713289,3578713329,40
1,678,5735,3578713289,3578713329,40
1,678,5736,3578713289,3578713330,41
1,678,5737,3578713289,3578713331,42
1,678,5738,3578713289,3578713333,44
1,678,5739,3578713289,3578713337,48
1,679,5740,3578713342,3578713342,0
1,679,5741,3578713342,3578713342,0
1,679,5742,3578713342,3578713345,3
1,679,5743,3578713342,3578713345,3
1,679,5744,3578713342,3578713348,6
1,679,5745,3578713342,3578713350,8
1,679,5746,3578713342,3578713353,11
1,679,5747,3578713342,3578713355,13
1,679,5748,3578713342,3578713360,18
1,679,5749,3578713342,3578713362,20
1,679,5750,3578713342,3578713363,21
1,679,5751,3578713342,3578713366,24
1,679,5752,3578713342,3578713368,26
1,679,5753,3578713342,3578713368,26
1,679,5754,3578713342,3578713370,28
1,679,5755,3578713342,3578713375,33
1,679,5756,3578713342,3578713376,34
1,679,5757,3578713342,3578713376,34
1,679,5758,3578713342,3578713379,37
1,679,5759,3578713342,3578713382,40
1,679,5760,3578713342,3578713384,42
1,679,5761,3578713342,3578713385,43
1,679,5762,3578713342,3578713387,45
1,679,5763,3578713342,3578713389,47
1,679,5764,3578713342,3578713392,50
1,680,5765,3578713395,3578713395,0
1,680,5766,3578713395,3578713398,3
1,680,5767,3578713395,3578713398,3
1,680,5768,3578713395,3578713399,4
1,680,5769,3578713395,3578713399,4
1,680,5770,3578713395,3578713401,6
1,680,5771,3578713395,3578713407,12
1,680,5772,3578713395,3578713411,16
1,680,5773,3578713395,3578713412,17
1,680,5774,3578713395,3578713413,18
1,680,5775,3578713395,3578713417,22
1,680,5776,3578713395,3578713418,23
1,680,5777,3578713395,3578713419,24
1,680,5778,3578713395,3578713420,25
1,680,5779,3578713395,3578713420,25
1,680,5780,3578713395,3578713421,26
1,680,5781,3578713395,3578713422,27
1,680,5782,3578713395,3578713425,30
1,680,5783,3578713395,3578713426,31
1,680,5784,3578713395,3578713429,34
1,680,5785,3578713395,3578713430,35
1,680,5786,3578713395,3578713431,36
1,680,5787,3578713395,3578713431,36
1,680,5788,3578713395,3578713433,38
1,680,5789,3578713395,3578713433,38
1,680,5790,3578713395,3578713434,39
1,680,5791,3578713395,3578713437,42
1,680,5792,3578713395,3578713440,45
1,680,5793,3578713395,3578713440,45
1,680,5794,3578713395,3578713444,49
1,681,5795,3578713449,3578713449,0
1,681,5796,3578713449,3578713450,1
1,681,5797,3578713449,3578713451,2
1,681,5798,3578713449,3578713455,6
1,681,5799,3578713449,3578713455,6
1,681,5800,3578713449,3578713456,7
1,681,5801,3578713449,3578713456,7
1,681,5802,3578713449,3578713457,8
1,681,5803,3578713449,3578713457,8
1,681,5804,3578713449,3578713461,12
1,681,5805,3578713449,3578713463,14
1,681,5806,3578713449,3578713463,14
1,681,5807,3578713449,3578713465,16
1,681,5808,3578713449,3578713474,25
1,681,5809,3578713449,3578713481,32
1,681,5810,3578713449,3578713482,33
1,681,5811,3578713449,3578713483,34
1,681,5812,3578713449,3578713483,34
1,681,5813,3578713449,3578713485,36
1,681,5814,3578713449,3578713485,36
1,681,5815,3578713449,3578713487,38
1,681,5816,3578713449,3578713490,41
1,681,5817,3578713449,3578713493,44
1,681,5818,3578713449,3578713496,47
1,681,5819,3578713449,3578713497,48
1,681,5820,3578713449,3578713497,48
1,682,5821,3578713502,3578713502,0
1,682,5822,3578713502,3578713502,0
1,682,5823,3578713502,3578713504,2
1,682,5824,3578713502,3578713505,3
1,682,5825,3578713502,3578713508,6
1,682,5826,3578713502,3578713510,8
1,682,5827,3578713502,3578713514,12
1,682,5828,3578713502,3578713517,15
1,682,5829,3578713502,3578713517,15
1,682,5830,3578713502,3578713520,18
1,682,5831,3578713502,3578713522,20
1,682,5832,3578713502,3578713522,20
1,682,5833,3578713502,3578713524,22
1,682,5834,3578713502,3578713525,23
1,682,5835,3578713502,3578713525,23
1,682,5836,3578713502,3578713527,25
1,682,5837,3578713502,3578713527,25
1,682,5838,3578713502,3578713528,26
1,682,5839,3578713502,3578713528,26
1,682,5840,3578713502,3578713529,27
1,682,5841,3578713502,3578713530,28
1,682,5842,3578713502,3578713533,31
1,682,5843,3578713502,3578713535,33
1,682,5844,3578713502,3578713539,37
1,682,5845,3578713502,3578713541,39
1,682,5846,3578713502,3578713543,41
1,682,5847,3578713502,3578713545,43
1,682,5848,3578713502,3578713547,45
1,682,5849,3578713502,3578713548,46
1,682,5850,3578713502,3578713552,50
1,683,5851,3578713555,3578713555,0
1,683,5852,3578713555,3578713559,4
1,683,5853,3578713555,3578713561,6
1,683,5854,3578713555,3578713563,8
1,683,5855,3578713555,3578713565,10
1,683,5856,3578713555,3578713566,11
1,683,5857,3578713555,3578713567,12
1,683,5858,3578713555,3578713570,15
1,683,5859,3578713555,3578713574,19
1,683,5860,3578713555,3578713575,20
1,683,5861,3578713555,3578713575,20
1,683,5862,3578713555,3578713578,23
1,683,5863,3578713555,3578713581,26
1,683,5864,3578713555,3578713583,28
1,683,5865,3578713555,3578713585,30
1,683,5866,3578713555,3578713586,31
1,683,5867,3578713555,3578713588,33
1,683,5868,3578713555,3578713591,36
1,683,5869,3578713555,3578713593,38
1,683,5870,3578713555,3578713596,41
1,683,5871,3578713555,3578713598,43
1,683,5872,3578713555,3578713598,43
1,683,5873,3578713555,3578713599,44
1,683,5874,3578713555,3578713600,45
1,684,5875,3578713609,3578713609,0
1,684,5876,3578713609,3578713610,1
1,684,5877,3578713609,3578713611,2
1,684,5878,3578713609,3578713612,3
1,684,5879,3578713609,3578713616,7
1,684,5880,3578713609,3578713616,7
1,684,5881,3578713609,3578713618,9
1,684,5882,3578713609,3578713619,10
1,684,5883,3578713609,3578713620,11
1,684,5884,3578713609,3578713621,12
1,684,5885,3578713609,3578713622,13
1,684,5886,3578713609,3578713624,15
1,684,5887,3578713609,3578713626,17
1,684,5888,3578713609,3578713628,19
1,684,5889,3578713609,3578713629,20
1,684,5890,3578713609,3578713631,22
1,684,5891,3578713609,3578713631,22
1,684,5892,3578713609,3578713631,22
1,684,5893,3578713609,3578713632,23
1,684,5894,3578713609,3578713633,24
1,684,5895,3578713609,3578713636,27
1,684,5896,3578713609,3578713638,29
1,684,5897,3578713609,3578713640,31
1,684,5898,3578713609,3578713643,34
1,684,5899,3578713609,3578713647,38
1,684,5900,3578713609,3578713648,39
1,684,5901,3578713609,3578713651,42
1,684,5902,3578713609,3578713655,46
1,684,5903,3578713609,3578713655,46
1,684,5904,3578713609,3578713655,46
1,684,5905,3578713609,3578713655,46
1,684,5906,3578713609,3578713656,47
1,684,5907,3578713609,3578713658,49
1,684,5908,3578713609,3578713658,49
1,685,5909,3578713664,3578713664,0
1,685,5910,3578713664,3578713664,0
1,685,5911,3578713664,3578713664,0
1,685,5912,3578713664,3578713664,0
1,685,5913,3578713664,3578713674,10
1,685,5914,3578713664,3578713681,17
1,685,5915,3578713664,3578713683,19
1,685,5916,3578713664,3578713683,19
1,685,5917,3578713664,3578713684,20
1,685,5918,3578713664,3578713685,21
1,685,5919,3578713664,3578713686,22
1,685,5920,3578713664,3578713691,27
1,685,5921,3578713664,3578713693,29
1,685,5922,3578713664,3578713693,29
1,685,5923,3578713664,3578713696,32
1,685,5924,3578713664,3578713696,32
1,685,5925,3578713664,3578713697,33
1,685,5926,3578713664,3578713701,37
1,685,5927,3578713664,3578713701,37
1,685,5928,3578713664,3578713701,37
1,685,5929,3578713664,3578713704,40
1,685,5930,3578713664,3578713705,41
1,685,5931,3578713664,3578713710,46
1,685,5932,3578713664,3578713710,46
1,685,5933,3578713664,3578713714,50
1,686,5934,3578713718,3578713718,0
1,686,5935,3578713718,3578713718,0
1,686,5936,3578713718,3578713719,1
1,686,5937,3578713718,3578713722,4
1,686,5938,3578713718,3578713723,5
1,686,5939,3578713718,3578713723,5
1,686,5940,3578713718,3578713723,5
1,686,5941,3578713718,3578713725,7
1,686,5942,3578713718,3578713725,7
1,686,5943,3578713718,3578713726,8
1,686,5944,3578713718,3578713727,9
1,686,5945,3578713718,3578713728,10
1,686,5946,3578713718,3578713729,11
1,686,5947,3578713718,3578713729,11
1,686,5948,3578713718,3578713730,12
1,686,5949,3578713718,3578713733,15
1,686,5950,3578713718,3578713736,18
1,686,5951,3578713718,3578713740,22
1,686,5952,3578713718,3578713742,24
1,686,5953,3578713718,3578713744,26
1,686,5954,3578713718,3578713744,26
1,686,5955,3578713718,3578713748,30
1,686,5956,3578713718,3578713749,31
1,686,5957,3578713718,3578713753,35
1,686,5958,3578713718,3578713755,37
1,686,5959,3578713718,3578713760,42
1,686,5960,3578713718,3578713761,43
1,686,5961,3578713718,3578713763,45
1,686,5962,3578713718,3578713767,49
1,686,5963,3578713718,3578713767,49
1,687,5964,3578713772,3578713772,0
1,687,5965,3578713772,3578713774,2
1,687,5966,3578713772,3578713775,3
1,687,5967,3578713772,3578713776,4
1,687,5968,3578713772,3578713778,6
1,687,5969,3578713772,3578713781,9
1,687,5970,3578713772,3578713783,11
1,687,5971,3578713772,3578713785,13
1,687,5972,3578713772,3578713786,14
1,687,5973,3578713772,3578713788,16
1,687,5974,3578713772,3578713791,19
1,687,5975,3578713772,3578713793,21
1,687,5976,3578713772,3578713796,24
1,687,5977,3578713772,3578713798,26
1,687,5978,3578713772,3578713799,27
1,687,5979,3578713772,3578713799,27
1,687,5980,3578713772,3578713800,28
1,687,5981,3578713772,3578713807,35
1,687,5982,3578713772,3578713811,39
1,687,5983,3578713772,3578713812,40
1,687,5984,3578713772,3578713812,40
1,687,5985,3578713772,3578713816,44
1,687,5986,3578713772,3578713817,45
1,687,5987,3578713772,3578713818,46
1,687,5988,3578713772,3578713857,85
1,687,5989,3578713772,3578713857,85
1,687,5990,3578713772,3578713857,85
1,687,5991,3578713772,3578713857,85
1,687,5992,3578713772,3578713857,85
1,687,5993,3578713772,3578713857,85
1,687,5994,3578713772,3578713857,85
1,687,5995,3578713772,3578713857,85
1,687,5996,3578713772,3578713857,85
1,687,5997,3578713772,3578713857,85
1,687,5998,3578713772,3578713857,85
1,687,5999,3578713772,3578713857,85
1,687,6000,3578713772,3578713857,85
1,687,6001,3578713772,3578713857,85
1,687,6002,3578713772,3578713857,85
1,687,6003,3578713772,3578713857,85
1,687,6004,3578713772,3578713857,85
1,687,6005,3578713772,3578713857,85
1,687,6006,3578713772,3578713857,85
1,687,6007,3578713772,3578713857,85
1,687,6008,3578713772,3578713857,85
1,687,6009,3578713772,3578713857,85
1,687,6010,3578713772,3578713857,85
1,687,6011,3578713772,3578713857,85
1,687,6012,3578713772,3578713857,85
1,687,6013,3578713772,3578713857,85
1,687,6014,3578713772,3578713857,85
1,688,6015,3578713861,3578713861,0
1,688,6016,3578713861,3578713861,0
1,688,6017,3578713861,3578713862,1
1,688,6018,3578713861,3578713863,2
1,688,6019,3578713861,3578713864,3
1,688,6020,3578713861,3578713874,13
1,688,6021,3578713861,3578713881,20
1,688,6022,3578713861,3578713883,22
1,688,6023,3578713861,3578713883,22
1,688,6024,3578713861,3578713883,22
1,688,6025,3578713861,3578713885,24
1,688,6026,3578713861,3578713886,25
1,688,6027,3578713861,3578713891,30
1,688,6028,3578713861,3578713893,32
1,688,6029,3578713861,3578713893,32
1,688,6030,3578713861,3578713896,35
1,688,6031,3578713861,3578713897,36
1,688,6032,3578713861,3578713897,36
1,688,6033,3578713861,3578713901,40
1,688,6034,3578713861,3578713901,40
1,688,6035,3578713861,3578713902,41
1,688,6036,3578713861,3578713904,43
1,688,6037,3578713861,3578713905,44
1,688,6038,3578713861,3578713910,49
1,688,6039,3578713861,3578713910,49
1,689,6040,3578713916,3578713916,0
1,689,6041,3578713916,3578713916,0
1,689,6042,3578713916,3578713918,2
1,689,6043,3578713916,3578713919,3
1,689,6044,3578713916,3578713922,6
1,689,6045,3578713916,3578713922,6
1,689,6046,3578713916,3578713923,7
1,689,6047,3578713916,3578713924,8
1,689,6048,3578713916,3578713924,8
1,689,6049,3578713916,3578713926,10
1,689,6050,3578713916,3578713927,11
1,689,6051,3578713916,3578713927,11
1,689,6052,3578713916,3578713928,12
1,689,6053,3578713916,3578713928,12
1,689,6054,3578713916,3578713928,12
1,689,6055,3578713916,3578713930,14
1,689,6056,3578713916,3578713933,17
1,689,6057,3578713916,3578713937,21
1,689,6058,3578713916,3578713940,24
1,689,6059,3578713916,3578713941,25
1,689,6060,3578713916,3578713945,29
1,689,6061,3578713916,3578713945,29
1,689,6062,3578713916,3578713948,32
1,689,6063,3578713916,3578713948,32
1,689,6064,3578713916,3578713952,36
1,689,6065,3578713916,3578713954,38
1,689,6066,3578713916,3578713960,44
1,689,6067,3578713916,3578713962,46
1,689,6068,3578713916,3578713963,47
1,689,6069,3578713916,3578713963,47
1,689,6070,3578713916,3578713965,49
1,689,6071,3578713916,3578713966,50
1,690,6072,3578713969,3578713969,0
1,690,6073,3578713969,3578713971,2
1,690,6074,3578713969,3578713975,6
1,690,6075,3578713969,3578713975,6
1,690,6076,3578713969,3578713976,7
1,690,6077,3578713969,3578713978,9
1,690,6078,3578713969,3578713981,12
1,690,6079,3578713969,3578713984,15
1,690,6080,3578713969,3578713986,17
1,690,6081,3578713969,3578713989,20
1,690,6082,3578713969,3578713991,22
1,690,6083,3578713969,3578713993,24
1,690,6084,3578713969,3578713996,27
1,690,6085,3578713969,3578713999,30
1,690,6086,3578713969,3578713999,30
1,690,6087,3578713969,3578713999,30
1,690,6088,3578713969,3578714001,32
1,690,6089,3578713969,3578714007,38
1,690,6090,3578713969,3578714012,43
1,690,6091,3578713969,3578714012,43
1,690,6092,3578713969,3578714013,44
1,690,6093,3578713969,3578714016,47
1,690,6094,3578713969,3578714018,49
1,690,6095,3578713969,3578714019,50
1,691,6096,3578714022,3578714022,0
1,691,6097,3578714022,3578714022,0
1,691,6098,3578714022,3578714022,0
1,691,6099,3578714022,3578714025,3
1,691,6100,3578714022,3578714026,4
1,691,6101,3578714022,3578714028,6
1,691,6102,3578714022,3578714029,7
1,691,6103,3578714022,3578714030,8
1,691,6104,3578714022,3578714030,8
1,691,6105,3578714022,3578714032,10
1,691,6106,3578714022,3578714032,10
1,691,6107,3578714022,3578714035,13
1,691,6108,3578714022,3578714037,15
1,691,6109,3578714022,3578714039,17
1,691,6110,3578714022,3578714039,17
1,691,6111,3578714022,3578714043,21
1,691,6112,3578714022,3578714047,25
1,691,6113,3578714022,3578714050,28
1,691,6114,3578714022,3578714051,29
1,691,6115,3578714022,3578714055,33
1,691,6116,3578714022,3578714055,33
1,691,6117,3578714022,3578714055,33
1,691,6118,3578714022,3578714056,34
1,691,6119,3578714022,3578714056,34
1,691,6120,3578714022,3578714058,36
1,691,6121,3578714022,3578714059,37
1,691,6122,3578714022,3578714060,38
1,691,6123,3578714022,3578714063,41
1,691,6124,3578714022,3578714063,41
1,691,6125,3578714022,3578714065,43
1,692,6126,3578714075,3578714081,6
1,692,6127,3578714075,3578714082,7
1,692,6128,3578714075,3578714083,8
1,692,6129,3578714075,3578714083,8
1,692,6130,3578714075,3578714084,9
1,692,6131,3578714075,3578714087,12
1,692,6132,3578714075,3578714090,15
1,692,6133,3578714075,3578714093,18
1,692,6134,3578714075,3578714093,18
1,692,6135,3578714075,3578714096,21
1,692,6136,3578714075,3578714097,22
1,692,6137,3578714075,3578714098,23
1,692,6138,3578714075,3578714101,26
1,692,6139,3578714075,3578714101,26
1,692,6140,3578714075,3578714101,26
1,692,6141,3578714075,3578714105,30
1,692,6142,3578714075,3578714105,30
1,692,6143,3578714075,3578714109,34
1,692,6144,3578714075,3578714110,35
1,692,6145,3578714075,3578714115,40
1,692,6146,3578714075,3578714116,41
1,692,6147,3578714075,3578714118,43
1,692,6148,3578714075,3578714120,45
1,692,6149,3578714075,3578714123,48
1,692,6150,3578714075,3578714123,48
1,692,6151,3578714075,3578714123,48
1,692,6152,3578714075,3578714124,49
1,692,6153,3578714075,3578714125,50
1,693,6154,3578714128,3578714128,0
1,693,6155,3578714128,3578714128,0
1,693,6156,3578714128,3578714128,0
1,693,6157,3578714128,3578714128,0
1,693,6158,3578714128,3578714129,1
1,693,6159,3578714128,3578714129,1
1,693,6160,3578714128,3578714130,2
1,693,6161,3578714128,3578714133,5
1,693,6162,3578714128,3578714136,8
1,693,6163,3578714128,3578714141,13
1,693,6164,3578714128,3578714142,14
1,693,6165,3578714128,3578714144,16
1,693,6166,3578714128,3578714145,17
1,693,6167,3578714128,3578714148,20
1,693,6168,3578714128,3578714149,21
1,693,6169,3578714128,3578714153,25
1,693,6170,3578714128,3578714155,27
1,693,6171,3578714128,3578714160,32
1,693,6172,3578714128,3578714162,34
1,693,6173,3578714128,3578714163,35
1,693,6174,3578714128,3578714163,35
1,693,6175,3578714128,3578714166,38
1,693,6176,3578714128,3578714166,38
1,693,6177,3578714128,3578714168,40
1,693,6178,3578714128,3578714170,42
1,693,6179,3578714128,3578714174,46
1,693,6180,3578714128,3578714176,48
1,693,6181,3578714128,3578714177,49
1,693,6182,3578714128,3578714178,50
1,694,6183,3578714182,3578714182,0
1,694,6184,3578714182,3578714182,0
1,694,6185,3578714182,3578714184,2
1,694,6186,3578714182,3578714186,4
1,694,6187,3578714182,3578714189,7
1,694,6188,3578714182,3578714191,9
1,694,6189,3578714182,3578714193,11
1,694,6190,3578714182,3578714196,14
1,694,6191,3578714182,3578714199,17
1,694,6192,3578714182,3578714199,17
1,694,6193,3578714182,3578714199,17
1,694,6194,3578714182,3578714200,18
1,694,6195,3578714182,3578714201,19
1,694,6196,3578714182,3578714207,25
1,694,6197,3578714182,3578714211,29
1,694,6198,3578714182,3578714211,29
1,694,6199,3578714182,3578714212,30
1,694,6200,3578714182,3578714216,34
1,694,6201,3578714182,3578714217,35
1,694,6202,3578714182,3578714219,37
1,694,6203,3578714182,3578714220,38
1,694,6204,3578714182,3578714221,39
1,694,6205,3578714182,3578714222,40
1,694,6206,3578714182,3578714225,43
1,694,6207,3578714182,3578714225,43
1,694,6208,3578714182,3578714228,46
1,694,6209,3578714182,3578714230,48
1,694,6210,3578714182,3578714231,49
1,694,6211,3578714182,3578714231,49
1,695,6212,3578714236,3578714236,0
1,695,6213,3578714236,3578714236,0
1,695,6214,3578714236,3578714237,1
1,695,6215,3578714236,3578714239,3
1,695,6216,3578714236,3578714240,4
1,695,6217,3578714236,3578714243,7
1,695,6218,3578714236,3578714247,11
1,695,6219,3578714236,3578714250,14
1,695,6220,3578714236,3578714252,16
1,695,6221,3578714236,3578714254,18
1,695,6222,3578714236,3578714255,19
1,695,6223,3578714236,3578714255,19
1,695,6224,3578714236,3578714256,20
1,695,6225,3578714236,3578714256,20
1,695,6226,3578714236,3578714258,22
1,695,6227,3578714236,3578714261,25
1,695,6228,3578714236,3578714263,27
1,695,6229,3578714236,3578714263,27
1,695,6230,3578714236,3578714266,30
1,695,6231,3578714236,3578714274,38
1,695,6232,3578714236,3578714281,45
1,695,6233,3578714236,3578714282,46
1,695,6234,3578714236,3578714283,47
1,695,6235,3578714236,3578714283,47
1,695,6236,3578714236,3578714283,47
1,695,6237,3578714236,3578714285,49
1,696,6238,3578714290,3578714290,0
1,696,6239,3578714290,3578714290,0
1,696,6240,3578714290,3578714293,3
1,696,6241,3578714290,3578714294,4
1,696,6242,3578714290,3578714296,6
1,696,6243,3578714290,3578714297,7
1,696,6244,3578714290,3578714297,7
1,696,6245,3578714290,3578714301,11
1,696,6246,3578714290,3578714301,11
1,696,6247,3578714290,3578714305,15
1,696,6248,3578714290,3578714306,16
1,696,6249,3578714290,3578714310,20
1,696,6250,3578714290,3578714310,20
1,696,6251,3578714290,3578714315,25
1,696,6252,3578714290,3578714318,28
1,696,6253,3578714290,3578714319,29
1,696,6254,3578714290,3578714320,30
1,696,6255,3578714290,3578714323,33
1,696,6256,3578714290,3578714323,33
1,696,6257,3578714290,3578714324,34
1,696,6258,3578714290,3578714324,34
1,696,6259,3578714290,3578714325,35
1,696,6260,3578714290,3578714326,36
1,696,6261,3578714290,3578714327,37
1,696,6262,3578714290,3578714328,38
1,696,6263,3578714290,3578714328,38
1,696,6264,3578714290,3578714329,39
1,696,6265,3578714290,3578714331,41
1,696,6266,3578714290,3578714333,43
1,696,6267,3578714290,3578714336,46
1,697,6268,3578714344,3578714344,0
1,697,6269,3578714344,3578714344,0
1,697,6270,3578714344,3578714344,0
1,697,6271,3578714344,3578714345,1
1,697,6272,3578714344,3578714348,4
1,697,6273,3578714344,3578714349,5
1,697,6274,3578714344,3578714352,8
1,697,6275,3578714344,3578714354,10
1,697,6276,3578714344,3578714355,11
1,697,6277,3578714344,3578714360,16
1,697,6278,3578714344,3578714362,18
1,697,6279,3578714344,3578714363,19
1,697,6280,3578714344,3578714367,23
1,697,6281,3578714344,3578714368,24
1,697,6282,3578714344,3578714368,24
1,697,6283,3578714344,3578714371,27
1,697,6284,3578714344,3578714375,31
1,697,6285,3578714344,3578714375,31
1,697,6286,3578714344,3578714376,32
1,697,6287,3578714344,3578714379,35
1,697,6288,3578714344,3578714381,37
1,697,6289,3578714344,3578714382,38
1,697,6290,3578714344,3578714384,40
1,697,6291,3578714344,3578714386,42
1,697,6292,3578714344,3578714389,45
1,697,6293,3578714344,3578714391,47
1,697,6294,3578714344,3578714394,50
1,698,6295,3578714398,3578714398,0
1,698,6296,3578714398,3578714399,1
1,698,6297,3578714398,3578714399,1
1,698,6298,3578714398,3578714400,2
1,698,6299,3578714398,3578714400,2
1,698,6300,3578714398,3578714401,3
1,698,6301,3578714398,3578714407,9
1,698,6302,3578714398,3578714411,13
1,698,6303,3578714398,3578714412,14
1,698,6304,3578714398,3578714413,15
1,698,6305,3578714398,3578714416,18
1,698,6306,3578714398,3578714417,19
1,698,6307,3578714398,3578714418,20
1,698,6308,3578714398,3578714419,21
1,698,6309,3578714398,3578714420,22
1,698,6310,3578714398,3578714420,22
1,698,6311,3578714398,3578714423,25
1,698,6312,3578714398,3578714424,26
1,698,6313,3578714398,3578714426,28
1,698,6314,3578714398,3578714430,32
1,698,6315,3578714398,3578714430,32
1,698,6316,3578714398,3578714430,32
1,698,6317,3578714398,3578714431,33
1,698,6318,3578714398,3578714432,34
1,698,6319,3578714398,3578714435,37
1,698,6320,3578714398,3578714437,39
1,698,6321,3578714398,3578714439,41
1,698,6322,3578714398,3578714441,43
1,698,6323,3578714398,3578714445,47
1,698,6324,3578714398,3578714448,50
1,699,6325,3578714452,3578714452,0
1,699,6326,3578714452,3578714452,0
1,699,6327,3578714452,3578714455,3
1,699,6328,3578714452,3578714455,3
1,699,6329,3578714452,3578714456,4
1,699,6330,3578714452,3578714457,5
1,699,6331,3578714452,3578714457,5
1,699,6332,3578714452,3578714457,5
1,699,6333,3578714452,3578714459,7
1,699,6334,3578714452,3578714462,10
1,699,6335,3578714452,3578714463,11
1,699,6336,3578714452,3578714464,12
1,699,6337,3578714452,3578714465,13
1,699,6338,3578714452,3578714473,21
1,699,6339,3578714452,3578714481,29
1,699,6340,3578714452,3578714483,31
1,699,6341,3578714452,3578714483,31
1,699,6342,3578714452,3578714483,31
1,699,6343,3578714452,3578714483,31
1,699,6344,3578714452,3578714485,33
1,699,6345,3578714452,3578714487,35
1,699,6346,3578714452,3578714487,35
1,699,6347,3578714452,3578714491,39
1,699,6348,3578714452,3578714493,41
1,699,6349,3578714452,3578714493,41
1,699,6350,3578714452,3578714496,44
1,699,6351,3578714452,3578714497,45
1,699,6352,3578714452,3578714498,46
1,699,6353,3578714452,3578714500,48
1,699,6354,3578714452,3578714501,49
1,699,6355,3578714452,3578714501,49
1,700,6356,3578714506,3578714506,0
1,700,6357,3578714506,3578714506,0
1,700,6358,3578714506,3578714509,3
1,700,6359,3578714506,3578714509,3
1,700,6360,3578714506,3578714514,8
1,700,6361,3578714506,3578714516,10
1,700,6362,3578714506,3578714519,13
1,700,6363,3578714506,3578714520,14
1,700,6364,3578714506,3578714522,16
1,700,6365,3578714506,3578714522,16
1,700,6366,3578714506,3578714522,16
1,700,6367,3578714506,3578714524,18
1,700,6368,3578714506,3578714524,18
1,700,6369,3578714506,3578714525,19
1,700,6370,3578714506,3578714527,21
1,700,6371,3578714506,3578714527,21
1,700,6372,3578714506,3578714527,21
1,700,6373,3578714506,3578714527,21
1,700,6374,3578714506,3578714529,23
1,700,6375,3578714506,3578714530,24
1,700,6376,3578714506,3578714532,26
1,700,6377,3578714506,3578714536,30
1,700,6378,3578714506,3578714541,35
1,700,6379,3578714506,3578714544,38
1,700,6380,3578714506,3578714545,39
1,700,6381,3578714506,3578714548,42
1,700,6382,3578714506,3578714549,43
1,700,6383,3578714506,3578714550,44
1,700,6384,3578714506,3578714552,46
1,700,6385,3578714506,3578714553,47
1,701,6386,3578714559,3578714559,0
1,701,6387,3578714559,3578714561,2
1,701,6388,3578714559,3578714562,3
1,701,6389,3578714559,3578714563,4
1,701,6390,3578714559,3578714566,7
1,701,6391,3578714559,3578714566,7
1,701,6392,3578714559,3578714566,7
1,701,6393,3578714559,3578714566,7
1,701,6394,3578714559,3578714567,8
1,701,6395,3578714559,3578714570,11
1,701,6396,3578714559,3578714574,15
1,701,6397,3578714559,3578714575,16
1,701,6398,3578714559,3578714576,17
1,701,6399,3578714559,3578714578,19
1,701,6400,3578714559,3578714580,21
1,701,6401,3578714559,3578714580,21
1,701,6402,3578714559,3578714582,23
1,701,6403,3578714559,3578714584,25
1,701,6404,3578714559,3578714588,29
1,701,6405,3578714559,3578714590,31
1,701,6406,3578714559,3578714593,34
1,701,6407,3578714559,3578714596,37
1,701,6408,3578714559,3578714596,37
1,701,6409,3578714559,3578714598,39
1,701,6410,3578714559,3578714599,40
1,701,6411,3578714559,3578714599,40
1,701,6412,3578714559,3578714599,40
1,701,6413,3578714559,3578714600,41
1,701,6414,3578714559,3578714607,48
1,702,6415,3578714613,3578714613,0
1,702,6416,3578714613,3578714613,0
1,702,6417,3578714613,3578714613,0
1,702,6418,3578714613,3578714614,1
1,702,6419,3578714613,3578714616,3
1,702,6420,3578714613,3578714618,5
1,702,6421,3578714613,3578714619,6
1,702,6422,3578714613,3578714620,7
1,702,6423,3578714613,3578714621,8
1,702,6424,3578714613,3578714622,9
1,702,6425,3578714613,3578714624,11
1,702,6426,3578714613,3578714625,12
1,702,6427,3578714613,3578714628,15
1,702,6428,3578714613,3578714629,16
1,702,6429,3578714613,3578714629,16
1,702,6430,3578714613,3578714630,17
1,702,6431,3578714613,3578714631,18
1,702,6432,3578714613,3578714634,21
1,702,6433,3578714613,3578714636,23
1,702,6434,3578714613,3578714638,25
1,702,6435,3578714613,3578714639,26
1,702,6436,3578714613,3578714643,30
1,702,6437,3578714613,3578714647,34
1,702,6438,3578714613,3578714647,34
1,702,6439,3578714613,3578714650,37
1,702,6440,3578714613,3578714650,37
1,702,6441,3578714613,3578714654,41
1,702,6442,3578714613,3578714654,41
1,702,6443,3578714613,3578714655,42
1,702,6444,3578714613,3578714655,42
1,702,6445,3578714613,3578714657,44
1,702,6446,3578714613,3578714658,45
1,702,6447,3578714613,3578714659,46
1,702,6448,3578714613,3578714661,48
1,702,6449,3578714613,3578714661,48
1,702,6450,3578714613,3578714662,49
1,703,6451,3578714667,3578714667,0
1,703,6452,3578714667,3578714674,7
1,703,6453,3578714667,3578714681,14
1,703,6454,3578714667,3578714683,16
1,703,6455,3578714667,3578714683,16
1,703,6456,3578714667,3578714683,16
1,703,6457,3578714667,3578714683,16
1,703,6458,3578714667,3578714686,19
1,703,6459,3578714667,3578714687,20
1,703,6460,3578714667,3578714687,20
1,703,6461,3578714667,3578714691,24
1,703,6462,3578714667,3578714693,26
1,703,6463,3578714667,3578714693,26
1,703,6464,3578714667,3578714696,29
1,703,6465,3578714667,3578714697,30
1,703,6466,3578714667,3578714698,31
1,703,6467,3578714667,3578714701,34
1,703,6468,3578714667,3578714702,35
1,703,6469,3578714667,3578714704,37
1,703,6470,3578714667,3578714705,38
1,703,6471,3578714667,3578714707,40
1,703,6472,3578714667,3578714709,42
1,703,6473,3578714667,3578714710,43
1,703,6474,3578714667,3578714714,47
1,703,6475,3578714667,3578714716,49
1,704,6476,3578714721,3578714721,0
1,704,6477,3578714721,3578714721,0
1,704,6478,3578714721,3578714722,1
1,704,6479,3578714721,3578714722,1
1,704,6480,3578714721,3578714723,2
1,704,6481,3578714721,3578714723,2
1,704,6482,3578714721,3578714723,2
1,704,6483,3578714721,3578714724,3
1,704,6484,3578714721,3578714725,4
1,704,6485,3578714721,3578714727,6
1,704,6486,3578714721,3578714728,7
1,704,6487,3578714721,3578714728,7
1,704,6488,3578714721,3578714728,7
1,704,6489,3578714721,3578714729,8
1,704,6490,3578714721,3578714730,9
1,704,6491,3578714721,3578714733,12
1,704,6492,3578714721,3578714736,15
1,704,6493,3578714721,3578714742,21
1,704,6494,3578714721,3578714744,23
1,704,6495,3578714721,3578714744,23
1,704,6496,3578714721,3578714748,27
1,704,6497,3578714721,3578714749,28
1,704,6498,3578714721,3578714751,30
1,704,6499,3578714721,3578714753,32
1,704,6500,3578714721,3578714754,33
1,704,6501,3578714721,3578714760,39
1,704,6502,3578714721,3578714761,40
1,704,6503,3578714721,3578714762,41
1,704,6504,3578714721,3578714762,41
1,704,6505,3578714721,3578714765,44
1,704,6506,3578714721,3578714765,44
1,704,6507,3578714721,3578714766,45
1,704,6508,3578714721,3578714767,46
1,704,6509,3578714721,3578714768,47
1,704,6510,3578714721,3578714771,50
1,705,6511,3578714776,3578714776,0
1,705,6512,3578714776,3578714776,0
1,705,6513,3578714776,3578714776,0
1,705,6514,3578714776,3578714777,1
1,705,6515,3578714776,3578714780,4
1,705,6516,3578714776,3578714782,6
1,705,6517,3578714776,3578714783,7
1,705,6518,3578714776,3578714785,9
1,705,6519,3578714776,3578714788,12
1,705,6520,3578714776,3578714791,15
1,705,6521,3578714776,3578714792,16
1,705,6522,3578714776,3578714795,19
1,705,6523,3578714776,3578714796,20
1,705,6524,3578714776,3578714799,23
1,705,6525,3578714776,3578714799,23
1,705,6526,3578714776,3578714799,23
1,705,6527,3578714776,3578714799,23
1,705,6528,3578714776,3578714800,24
1,705,6529,3578714776,3578714807,31
1,705,6530,3578714776,3578714808,32
1,705,6531,3578714776,3578714811,35
1,705,6532,3578714776,3578714812,36
1,705,6533,3578714776,3578714812,36
1,705,6534,3578714776,3578714816,40
1,705,6535,3578714776,3578714817,41
1,705,6536,3578714776,3578714818,42
1,705,6537,3578714776,3578714820,44
1,705,6538,3578714776,3578714822,46
1,705,6539,3578714776,3578714823,47
1,705,6540,3578714776,3578714824,48
1,705,6541,3578714776,3578714826,50
1,706,6542,3578714831,3578714831,0
1,706,6543,3578714831,3578714831,0
1,706,6544,3578714831,3578714831,0
1,706,6545,3578714831,3578714831,0
1,706,6546,3578714831,3578714832,1
1,706,6547,3578714831,3578714834,3
1,706,6548,3578714831,3578714836,5
1,706,6549,3578714831,3578714838,7
1,706,6550,3578714831,3578714839,8
1,706,6551,3578714831,3578714843,12
1,706,6552,3578714831,3578714848,17
1,706,6553,3578714831,3578714848,17
1,706,6554,3578714831,3578714850,19
1,706,6555,3578714831,3578714851,20
1,706,6556,3578714831,3578714854,23
1,706,6557,3578714831,3578714854,23
1,706,6558,3578714831,3578714855,24
1,706,6559,3578714831,3578714855,24
1,706,6560,3578714831,3578714857,26
1,706,6561,3578714831,3578714857,26
1,706,6562,3578714831,3578714858,27
1,706,6563,3578714831,3578714859,28
1,706,6564,3578714831,3578714862,31
1,706,6565,3578714831,3578714865,34
1,706,6566,3578714831,3578714874,43
1,706,6567,3578714831,3578714881,50
1,707,6568,3578714885,3578714885,0
1,707,6569,3578714885,3578714885,0
1,707,6570,3578714885,3578714885,0
1,707,6571,3578714885,3578714885,0
1,707,6572,3578714885,3578714886,1
1,707,6573,3578714885,3578714888,3
1,707,6574,3578714885,3578714888,3
1,707,6575,3578714885,3578714890,5
1,707,6576,3578714885,3578714893,8
1,707,6577,3578714885,3578714893,8
1,707,6578,3578714885,3578714897,12
1,707,6579,3578714885,3578714897,12
1,707,6580,3578714885,3578714897,12
1,707,6581,3578714885,3578714901,16
1,707,6582,3578714885,3578714901,16
1,707,6583,3578714885,3578714902,17
1,707,6584,3578714885,3578714904,19
1,707,6585,3578714885,3578714904,19
1,707,6586,3578714885,3578714907,22
1,707,6587,3578714885,3578714909,24
1,707,6588,3578714885,3578714910,25
1,707,6589,3578714885,3578714915,30
1,707,6590,3578714885,3578714916,31
1,707,6591,3578714885,3578714919,34
1,707,6592,3578714885,3578714921,36
1,707,6593,3578714885,3578714922,37
1,707,6594,3578714885,3578714923,38
1,707,6595,3578714885,3578714923,38
1,707,6596,3578714885,3578714924,39
1,707,6597,3578714885,3578714924,39
1,707,6598,3578714885,3578714924,39
1,707,6599,3578714885,3578714926,41
1,707,6600,3578714885,3578714927,42
1,707,6601,3578714885,3578714927,42
1,707,6602,3578714885,3578714928,43
1,707,6603,3578714885,3578714928,43
1,707,6604,3578714885,3578714929,44
1,707,6605,3578714885,3578714930,45
1,707,6606,3578714885,3578714934,49
1,708,6607,3578714939,3578714939,0
1,708,6608,3578714939,3578714940,1
1,708,6609,3578714939,3578714942,3
1,708,6610,3578714939,3578714944,5
1,708,6611,3578714939,3578714944,5
1,708,6612,3578714939,3578714949,10
1,708,6613,3578714939,3578714949,10
1,708,6614,3578714939,3578714951,12
1,708,6615,3578714939,3578714953,14
1,708,6616,3578714939,3578714955,16
1,708,6617,3578714939,3578714961,22
1,708,6618,3578714939,3578714962,23
1,708,6619,3578714939,3578714962,23
1,708,6620,3578714939,3578714963,24
1,708,6621,3578714939,3578714965,26
1,708,6622,3578714939,3578714965,26
1,708,6623,3578714939,3578714966,27
1,708,6624,3578714939,3578714967,28
1,708,6625,3578714939,3578714968,29
1,708,6626,3578714939,3578714970,31
1,708,6627,3578714939,3578714974,35
1,708,6628,3578714939,3578714975,36
1,708,6629,3578714939,3578714976,37
1,708,6630,3578714939,3578714977,38
1,708,6631,3578714939,3578714981,42
1,708,6632,3578714939,3578714982,43
1,708,6633,3578714939,3578714983,44
1,708,6634,3578714939,3578714986,47
1,709,6635,3578714993,3578714993,0
1,709,6636,3578714993,3578714993,0
1,709,6637,3578714993,3578714993,0
1,709,6638,3578714993,3578714996,3
1,709,6639,3578714993,3578714996,3
1,709,6640,3578714993,3578714999,6
1,709,6641,3578714993,3578714999,6
1,709,6642,3578714993,3578714999,6
1,709,6643,3578714993,3578714999,6
1,709,6644,3578714993,3578715001,8
1,709,6645,3578714993,3578715008,15
1,709,6646,3578714993,3578715008,15
1,709,6647,3578714993,3578715011,18
1,709,6648,3578714993,3578715012,19
1,709,6649,3578714993,3578715013,20
1,709,6650,3578714993,3578715016,23
1,709,6651,3578714993,3578715017,24
1,709,6652,3578714993,3578715018,25
1,709,6653,3578714993,3578715021,28
1,709,6654,3578714993,3578715022,29
1,709,6655,3578714993,3578715023,30
1,709,6656,3578714993,3578715025,32
1,709,6657,3578714993,3578715026,33
1,709,6658,3578714993,3578715029,36
1,709,6659,3578714993,3578715029,36
1,709,6660,3578714993,3578715029,36
1,709,6661,3578714993,3578715031,38
1,709,6662,3578714993,3578715031,38
1,709,6663,3578714993,3578715034,41
1,709,6664,3578714993,3578715037,44
1,709,6665,3578714993,3578715039,46
1,709,6666,3578714993,3578715040,47
1,710,6667,3578715047,3578715047,0
1,710,6668,3578715047,3578715048,1
1,710,6669,3578715047,3578715050,3
1,710,6670,3578715047,3578715052,5
1,710,6671,3578715047,3578715054,7
1,710,6672,3578715047,3578715055,8
1,710,6673,3578715047,3578715056,9
1,710,6674,3578715047,3578715058,11
1,710,6675,3578715047,3578715058,11
1,710,6676,3578715047,3578715059,12
1,710,6677,3578715047,3578715059,12
1,710,6678,3578715047,3578715063,16
1,710,6679,3578715047,3578715065,18
1,710,6680,3578715047,3578715074,27
1,710,6681,3578715047,3578715081,34
1,710,6682,3578715047,3578715083,36
1,710,6683,3578715047,3578715084,37
1,710,6684,3578715047,3578715085,38
1,710,6685,3578715047,3578715085,38
1,710,6686,3578715047,3578715086,39
1,710,6687,3578715047,3578715088,41
1,710,6688,3578715047,3578715089,42
1,710,6689,3578715047,3578715090,43
1,710,6690,3578715047,3578715093,46
1,710,6691,3578715047,3578715094,47
1,710,6692,3578715047,3578715097,50
1,711,6693,3578715101,3578715101,0
1,711,6694,3578715101,3578715101,0
1,711,6695,3578715101,3578715101,0
1,711,6696,3578715101,3578715101,0
1,711,6697,3578715101,3578715105,4
1,711,6698,3578715101,3578715105,4
1,711,6699,3578715101,3578715107,6
1,711,6700,3578715101,3578715109,8
1,711,6701,3578715101,3578715109,8
1,711,6702,3578715101,3578715114,13
1,711,6703,3578715101,3578715116,15
1,711,6704,3578715101,3578715117,16
1,711,6705,3578715101,3578715120,19
1,711,6706,3578715101,3578715121,20
1,711,6707,3578715101,3578715122,21
1,711,6708,3578715101,3578715123,22
1,711,6709,3578715101,3578715123,22
1,711,6710,3578715101,3578715124,23
1,711,6711,3578715101,3578715124,23
1,711,6712,3578715101,3578715125,24
1,711,6713,3578715101,3578715126,25
1,711,6714,3578715101,3578715127,26
1,711,6715,3578715101,3578715127,26
1,711,6716,3578715101,3578715128,27
1,711,6717,3578715101,3578715129,28
1,711,6718,3578715101,3578715129,28
1,711,6719,3578715101,3578715130,29
1,711,6720,3578715101,3578715136,35
1,711,6721,3578715101,3578715140,39
1,711,6722,3578715101,3578715141,40
1,711,6723,3578715101,3578715143,42
1,711,6724,3578715101,3578715145,44
1,711,6725,3578715101,3578715148,47
1,711,6726,3578715101,3578715148,47
1,711,6727,3578715101,3578715151,50
1,712,6728,3578715155,3578715155,0
1,712,6729,3578715155,3578715155,0
1,712,6730,3578715155,3578715161,6
1,712,6731,3578715155,3578715162,7
1,712,6732,3578715155,3578715162,7
1,712,6733,3578715155,3578715164,9
1,712,6734,3578715155,3578715165,10
1,712,6735,3578715155,3578715166,11
1,712,6736,3578715155,3578715167,12
1,712,6737,3578715155,3578715167,12
1,712,6738,3578715155,3578715168,13
1,712,6739,3578715155,3578715171,16
1,712,6740,3578715155,3578715175,20
1,712,6741,3578715155,3578715175,20
1,712,6742,3578715155,3578715177,22
1,712,6743,3578715155,3578715178,23
1,712,6744,3578715155,3578715181,26
1,712,6745,3578715155,3578715181,26
1,712,6746,3578715155,3578715183,28
1,712,6747,3578715155,3578715186,31
1,712,6748,3578715155,3578715189,34
1,712,6749,3578715155,3578715193,38
1,712,6750,3578715155,3578715193,38
1,712,6751,3578715155,3578715195,40
1,712,6752,3578715155,3578715196,41
1,712,6753,3578715155,3578715198,43
1,712,6754,3578715155,3578715198,43
1,712,6755,3578715155,3578715199,44
1,712,6756,3578715155,3578715199,44
1,712,6757,3578715155,3578715201,46
1,713,6758,3578715209,3578715209,0
1,713,6759,3578715209,3578715209,0
1,713,6760,3578715209,3578715211,2
1,713,6761,3578715209,3578715212,3
1,713,6762,3578715209,3578715212,3
1,713,6763,3578715209,3578715217,8
1,713,6764,3578715209,3578715217,8
1,713,6765,3578715209,3578715218,9
1,713,6766,3578715209,3578715220,11
1,713,6767,3578715209,3578715222,13
1,713,6768,3578715209,3578715223,14
1,713,6769,3578715209,3578715225,16
1,713,6770,3578715209,3578715226,17
1,713,6771,3578715209,3578715229,20
1,713,6772,3578715209,3578715229,20
1,713,6773,3578715209,3578715230,21
1,713,6774,3578715209,3578715230,21
1,713,6775,3578715209,3578715232,23
1,713,6776,3578715209,3578715234,25
1,713,6777,3578715209,3578715237,28
1,713,6778,3578715209,3578715239,30
1,713,6779,3578715209,3578715244,35
1,713,6780,3578715209,3578715248,39
1,713,6781,3578715209,3578715251,42
1,713,6782,3578715209,3578715251,42
1,713,6783,3578715209,3578715254,45
1,713,6784,3578715209,3578715255,46
1,713,6785,3578715209,3578715256,47
1,713,6786,3578715209,3578715257,48
1,713,6787,3578715209,3578715257,48
1,714,6788,3578715263,3578715263,0
1,714,6789,3578715263,3578715263,0
1,714,6790,3578715263,3578715264,1
1,714,6791,3578715263,3578715265,2
1,714,6792,3578715263,3578715266,3
1,714,6793,3578715263,3578715274,11
1,714,6794,3578715263,3578715281,18
1,714,6795,3578715263,3578715284,21
1,714,6796,3578715263,3578715285,22
1,714,6797,3578715263,3578715285,22
1,714,6798,3578715263,3578715285,22
1,714,6799,3578715263,3578715288,25
1,714,6800,3578715263,3578715288,25
1,714,6801,3578715263,3578715293,30
1,714,6802,3578715263,3578715293,30
1,714,6803,3578715263,3578715297,34
1,714,6804,3578715263,3578715297,34
1,714,6805,3578715263,3578715300,37
1,714,6806,3578715263,3578715301,38
1,714,6807,3578715263,3578715301,38
1,714,6808,3578715263,3578715302,39
1,714,6809,3578715263,3578715303,40
1,714,6810,3578715263,3578715305,42
1,714,6811,3578715263,3578715305,42
1,714,6812,3578715263,3578715306,43
1,714,6813,3578715263,3578715309,46
1,714,6814,3578715263,3578715309,46
1,714,6815,3578715263,3578715313,50
1,715,6816,3578715317,3578715317,0
1,715,6817,3578715317,3578715317,0
1,715,6818,3578715317,3578715317,0
1,715,6819,3578715317,3578715319,2
1,715,6820,3578715317,3578715321,4
1,715,6821,3578715317,3578715322,5
1,715,6822,3578715317,3578715323,6
1,715,6823,3578715317,3578715323,6
1,715,6824,3578715317,3578715324,7
1,715,6825,3578715317,3578715324,7
1,715,6826,3578715317,3578715325,8
1,715,6827,3578715317,3578715326,9
1,715,6828,3578715317,3578715327,10
1,715,6829,3578715317,3578715328,11
1,715,6830,3578715317,3578715328,11
1,715,6831,3578715317,3578715328,11
1,715,6832,3578715317,3578715330,13
1,715,6833,3578715317,3578715331,14
1,715,6834,3578715317,3578715333,16
1,715,6835,3578715317,3578715336,19
1,715,6836,3578715317,3578715341,24
1,715,6837,3578715317,3578715341,24
1,715,6838,3578715317,3578715344,27
1,715,6839,3578715317,3578715348,31
1,715,6840,3578715317,3578715349,32
1,715,6841,3578715317,3578715351,34
1,715,6842,3578715317,3578715354,37
1,715,6843,3578715317,3578715354,37
1,715,6844,3578715317,3578715361,44
1,715,6845,3578715317,3578715362,45
1,715,6846,3578715317,3578715362,45
1,715,6847,3578715317,3578715364,47
1,715,6848,3578715317,3578715366,49
1,715,6849,3578715317,3578715366,49
1,715,6850,3578715317,3578715367,50
1,716,6851,3578715370,3578715371,1
1,716,6852,3578715370,3578715371,1
1,716,6853,3578715370,3578715371,1
1,716,6854,3578715370,3578715371,1
1,716,6855,3578715370,3578715376,6
1,716,6856,3578715370,3578715376,6
1,716,6857,3578715370,3578715376,6
1,716,6858,3578715370,3578715379,9
1,716,6859,3578715370,3578715381,11
1,716,6860,3578715370,3578715382,12
1,716,6861,3578715370,3578715384,14
1,716,6862,3578715370,3578715386,16
1,716,6863,3578715370,3578715389,19
1,716,6864,3578715370,3578715392,22
1,716,6865,3578715370,3578715394,24
1,716,6866,3578715370,3578715395,25
1,716,6867,3578715370,3578715398,28
1,716,6868,3578715370,3578715399,29
1,716,6869,3578715370,3578715399,29
1,716,6870,3578715370,3578715399,29
1,716,6871,3578715370,3578715399,29
1,716,6872,3578715370,3578715401,31
1,716,6873,3578715370,3578715408,38
1,716,6874,3578715370,3578715409,39
1,716,6875,3578715370,3578715411,41
1,716,6876,3578715370,3578715412,42
1,716,6877,3578715370,3578715413,43
1,716,6878,3578715370,3578715417,47
1,716,6879,3578715370,3578715418,48
1,716,6880,3578715370,3578715418,48
1,717,6881,3578715425,3578715425,0
1,717,6882,3578715425,3578715425,0
1,717,6883,3578715425,3578715425,0
1,717,6884,3578715425,3578715425,0
1,717,6885,3578715425,3578715425,0
1,717,6886,3578715425,3578715426,1
1,717,6887,3578715425,3578715429,4
1,717,6888,3578715425,3578715429,4
1,717,6889,3578715425,3578715430,5
1,717,6890,3578715425,3578715431,6
1,717,6891,3578715425,3578715431,6
1,717,6892,3578715425,3578715434,9
1,717,6893,3578715425,3578715437,12
1,717,6894,3578715425,3578715439,14
1,717,6895,3578715425,3578715440,15
1,717,6896,3578715425,3578715444,19
1,717,6897,3578715425,3578715448,23
1,717,6898,3578715425,3578715448,23
1,717,6899,3578715425,3578715451,26
1,717,6900,3578715425,3578715451,26
1,717,6901,3578715425,3578715454,29
1,717,6902,3578715425,3578715455,30
1,717,6903,3578715425,3578715456,31
1,717,6904,3578715425,3578715456,31
1,717,6905,3578715425,3578715457,32
1,717,6906,3578715425,3578715458,33
1,717,6907,3578715425,3578715458,33
1,717,6908,3578715425,3578715460,35
1,717,6909,3578715425,3578715463,38
1,717,6910,3578715425,3578715464,39
1,717,6911,3578715425,3578715464,39
1,717,6912,3578715425,3578715466,41
1,717,6913,3578715425,3578715466,41
1,718,6914,3578715479,3578715479,0
1,718,6915,3578715479,3578715480,1
1,718,6916,3578715479,3578715484,5
1,718,6917,3578715479,3578715484,5
1,718,6918,3578715479,3578715485,6
1,718,6919,3578715479,3578715487,8
1,718,6920,3578715479,3578715487,8
1,718,6921,3578715479,3578715492,13
1,718,6922,3578715479,3578715492,13
1,718,6923,3578715479,3578715496,17
1,718,6924,3578715479,3578715496,17
1,718,6925,3578715479,3578715499,20
1,718,6926,3578715479,3578715500,21
1,718,6927,3578715479,3578715500,21
1,718,6928,3578715479,3578715502,23
1,718,6929,3578715479,3578715504,25
1,718,6930,3578715479,3578715505,26
1,718,6931,3578715479,3578715506,27
1,718,6932,3578715479,3578715508,29
1,718,6933,3578715479,3578715509,30
1,718,6934,3578715479,3578715512,33
1,718,6935,3578715479,3578715516,37
1,718,6936,3578715479,3578715517,38
1,718,6937,3578715479,3578715517,38
1,718,6938,3578715479,3578715518,39
1,718,6939,3578715479,3578715520,41
1,718,6940,3578715479,3578715521,42
1,718,6941,3578715479,3578715522,43
1,718,6942,3578715479,3578715522,43
1,718,6943,3578715479,3578715523,44
1,718,6944,3578715479,3578715524,45
1,718,6945,3578715479,3578715524,45
1,718,6946,3578715479,3578715525,46
1,718,6947,3578715479,3578715526,47
1,718,6948,3578715479,3578715527,48
1,718,6949,3578715479,3578715527,48
1,718,6950,3578715479,3578715528,49
1,719,6951,3578715533,3578715533,0
1,719,6952,3578715533,3578715533,0
1,719,6953,3578715533,3578715534,1
1,719,6954,3578715533,3578715540,7
1,719,6955,3578715533,3578715541,8
1,719,6956,3578715533,3578715543,10
1,719,6957,3578715533,3578715548,15
1,719,6958,3578715533,3578715548,15
1,719,6959,3578715533,3578715550,17
1,719,6960,3578715533,3578715553,20
1,719,6961,3578715533,3578715554,21
1,719,6962,3578715533,3578715561,28
1,719,6963,3578715533,3578715561,28
1,719,6964,3578715533,3578715561,28
1,719,6965,3578715533,3578715563,30
1,719,6966,3578715533,3578715565,32
1,719,6967,3578715533,3578715566,33
1,719,6968,3578715533,3578715566,33
1,719,6969,3578715533,3578715566,33
1,719,6970,3578715533,3578715566,33
1,719,6971,3578715533,3578715568,35
1,719,6972,3578715533,3578715570,37
1,719,6973,3578715533,3578715574,41
1,719,6974,3578715533,3578715575,42
1,719,6975,3578715533,3578715576,43
1,719,6976,3578715533,3578715578,45
1,719,6977,3578715533,3578715580,47
1,719,6978,3578715533,3578715581,48
1,719,6979,3578715533,3578715582,49
1,720,6980,3578715587,3578715587,0
1,720,6981,3578715587,3578715589,2
1,720,6982,3578715587,3578715591,4
1,720,6983,3578715587,3578715593,6
1,720,6984,3578715587,3578715595,8
1,720,6985,3578715587,3578715596,9
1,720,6986,3578715587,3578715597,10
1,720,6987,3578715587,3578715598,11
1,720,6988,3578715587,3578715598,11
1,720,6989,3578715587,3578715600,13
1,720,6990,3578715587,3578715607,20
1,720,6991,3578715587,3578715609,22
1,720,6992,3578715587,3578715610,23
1,720,6993,3578715587,3578715611,24
1,720,6994,3578715587,3578715612,25
1,720,6995,3578715587,3578715615,28
1,720,6996,3578715587,3578715616,29
1,720,6997,3578715587,3578715617,30
1,720,6998,3578715587,3578715617,30
1,720,6999,3578715587,3578715619,32
1,720,7000,3578715587,3578715620,33
1,720,7001,3578715587,3578715621,34
1,720,7002,3578715587,3578715622,35
1,720,7003,3578715587,3578715624,37
1,720,7004,3578715587,3578715626,39
1,720,7005,3578715587,3578715629,42
1,720,7006,3578715587,3578715629,42
1,720,7007,3578715587,3578715629,42
1,720,7008,3578715587,3578715630,43
1,720,7009,3578715587,3578715631,44
1,720,7010,3578715587,3578715633,46
1,720,7011,3578715587,3578715636,49
1,721,7012,3578715642,3578715642,0
1,721,7013,3578715642,3578715642,0
1,721,7014,3578715642,3578715643,1
1,721,7015,3578715642,3578715647,5
1,721,7016,3578715642,3578715647,5
1,721,7017,3578715642,3578715650,8
1,721,7018,3578715642,3578715650,8
1,721,7019,3578715642,3578715653,11
1,721,7020,3578715642,3578715655,13
1,721,7021,3578715642,3578715655,13
1,721,7022,3578715642,3578715655,13
1,721,7023,3578715642,3578715657,15
1,721,7024,3578715642,3578715657,15
1,721,7025,3578715642,3578715658,16
1,721,7026,3578715642,3578715661,19
1,721,7027,3578715642,3578715663,21
1,721,7028,3578715642,3578715663,21
1,721,7029,3578715642,3578715664,22
1,721,7030,3578715642,3578715665,23
1,721,7031,3578715642,3578715675,33
1,721,7032,3578715642,3578715680,38
1,721,7033,3578715642,3578715682,40
1,721,7034,3578715642,3578715683,41
1,721,7035,3578715642,3578715684,42
1,721,7036,3578715642,3578715684,42
1,721,7037,3578715642,3578715685,43
1,721,7038,3578715642,3578715687,45
1,721,7039,3578715642,3578715687,45
1,721,7040,3578715642,3578715690,48
1,722,7041,3578715696,3578715696,0
1,722,7042,3578715696,3578715696,0
1,722,7043,3578715696,3578715696,0
1,722,7044,3578715696,3578715697,1
1,722,7045,3578715696,3578715699,3
1,722,7046,3578715696,3578715700,4
1,722,7047,3578715696,3578715701,5
1,722,7048,3578715696,3578715701,5
1,722,7049,3578715696,3578715702,6
1,722,7050,3578715696,3578715704,8
1,722,7051,3578715696,3578715705,9
1,722,7052,3578715696,3578715706,10
1,722,7053,3578715696,3578715709,13
1,722,7054,3578715696,3578715710,14
1,722,7055,3578715696,3578715712,16
1,722,7056,3578715696,3578715716,20
1,722,7057,3578715696,3578715717,21
1,722,7058,3578715696,3578715718,22
1,722,7059,3578715696,3578715719,23
1,722,7060,3578715696,3578715721,25
1,722,7061,3578715696,3578715722,26
1,722,7062,3578715696,3578715723,27
1,722,7063,3578715696,3578715723,27
1,722,7064,3578715696,3578715723,27
1,722,7065,3578715696,3578715723,27
1,722,7066,3578715696,3578715725,29
1,722,7067,3578715696,3578715727,31
1,722,7068,3578715696,3578715727,31
1,722,7069,3578715696,3578715727,31
1,722,7070,3578715696,3578715728,32
1,722,7071,3578715696,3578715730,34
1,722,7072,3578715696,3578715730,34
1,722,7073,3578715696,3578715733,37
1,722,7074,3578715696,3578715735,39
1,722,7075,3578715696,3578715742,46
1,722,7076,3578715696,3578715743,47
1,723,7077,3578715751,3578715751,0
1,723,7078,3578715751,3578715751,0
1,723,7079,3578715751,3578715751,0
1,723,7080,3578715751,3578715753,2
1,723,7081,3578715751,3578715753,2
1,723,7082,3578715751,3578715761,10
1,723,7083,3578715751,3578715761,10
1,723,7084,3578715751,3578715762,11
1,723,7085,3578715751,3578715763,12
1,723,7086,3578715751,3578715765,14
1,723,7087,3578715751,3578715766,15
1,723,7088,3578715751,3578715766,15
1,723,7089,3578715751,3578715767,16
1,723,7090,3578715751,3578715767,16
1,723,7091,3578715751,3578715767,16
1,723,7092,3578715751,3578715771,20
1,723,7093,3578715751,3578715774,23
1,723,7094,3578715751,3578715774,23
1,723,7095,3578715751,3578715775,24
1,723,7096,3578715751,3578715779,28
1,723,7097,3578715751,3578715781,30
1,723,7098,3578715751,3578715781,30
1,723,7099,3578715751,3578715784,33
1,723,7100,3578715751,3578715785,34
1,723,7101,3578715751,3578715788,37
1,723,7102,3578715751,3578715791,40
1,723,7103,3578715751,3578715793,42
1,723,7104,3578715751,3578715794,43
1,723,7105,3578715751,3578715798,47
1,723,7106,3578715751,3578715798,47
1,723,7107,3578715751,3578715799,48
1,723,7108,3578715751,3578715799,48
1,723,7109,3578715751,3578715800,49
1,724,7110,3578715805,3578715807,2
1,724,7111,3578715805,3578715809,4
1,724,7112,3578715805,3578715811,6
1,724,7113,3578715805,3578715812,7
1,724,7114,3578715805,3578715812,7
1,724,7115,3578715805,3578715815,10
1,724,7116,3578715805,3578715817,12
1,724,7117,3578715805,3578715817,12
1,724,7118,3578715805,3578715817,12
1,724,7119,3578715805,3578715819,14
1,724,7120,3578715805,3578715820,15
1,724,7121,3578715805,3578715822,17
1,724,7122,3578715805,3578715822,17
1,724,7123,3578715805,3578715825,20
1,724,7124,3578715805,3578715825,20
1,724,7125,3578715805,3578715826,21
1,724,7126,3578715805,3578715828,23
1,724,7127,3578715805,3578715829,24
1,724,7128,3578715805,3578715829,24
1,724,7129,3578715805,3578715830,25
1,724,7130,3578715805,3578715832,27
1,724,7131,3578715805,3578715834,29
1,724,7132,3578715805,3578715836,31
1,724,7133,3578715805,3578715838,33
1,724,7134,3578715805,3578715839,34
1,724,7135,3578715805,3578715843,38
1,724,7136,3578715805,3578715847,42
1,724,7137,3578715805,3578715848,43
1,724,7138,3578715805,3578715850,45
1,724,7139,3578715805,3578715851,46
1,724,7140,3578715805,3578715853,48
1,724,7141,3578715805,3578715854,49
1,724,7142,3578715805,3578715855,50
1,725,7143,3578715859,3578715859,0
1,725,7144,3578715859,3578715859,0
1,725,7145,3578715859,3578715859,0
1,725,7146,3578715859,3578715859,0
1,725,7147,3578715859,3578715862,3
1,725,7148,3578715859,3578715864,5
1,725,7149,3578715859,3578715864,5
1,725,7150,3578715859,3578715865,6
1,725,7151,3578715859,3578715875,16
1,725,7152,3578715859,3578715880,21
1,725,7153,3578715859,3578715883,24
1,725,7154,3578715859,3578715883,24
1,725,7155,3578715859,3578715884,25
1,725,7156,3578715859,3578715885,26
1,725,7157,3578715859,3578715885,26
1,725,7158,3578715859,3578715887,28
1,725,7159,3578715859,3578715888,29
1,725,7160,3578715859,3578715889,30
1,725,7161,3578715859,3578715892,33
1,725,7162,3578715859,3578715893,34
1,725,7163,3578715859,3578715896,37
1,725,7164,3578715859,3578715897,38
1,725,7165,3578715859,3578715899,40
1,725,7166,3578715859,3578715900,41
1,725,7167,3578715859,3578715901,42
1,725,7168,3578715859,3578715902,43
1,725,7169,3578715859,3578715904,45
1,725,7170,3578715859,3578715906,47
1,725,7171,3578715859,3578715906,47
1,725,7172,3578715859,3578715909,50
1,726,7173,3578715913,3578715913,0
1,726,7174,3578715913,3578715913,0
1,726,7175,3578715913,3578715916,3
1,726,7176,3578715913,3578715917,4
1,726,7177,3578715913,3578715919,6
1,726,7178,3578715913,3578715919,6
1,726,7179,3578715913,3578715921,8
1,726,7180,3578715913,3578715922,9
1,726,7181,3578715913,3578715923,10
1,726,7182,3578715913,3578715923,10
1,726,7183,3578715913,3578715923,10
1,726,7184,3578715913,3578715924,11
1,726,7185,3578715913,3578715926,13
1,726,7186,3578715913,3578715926,13
1,726,7187,3578715913,3578715927,14
1,726,7188,3578715913,3578715927,14
1,726,7189,3578715913,3578715928,15
1,726,7190,3578715913,3578715930,17
1,726,7191,3578715913,3578715930,17
1,726,7192,3578715913,3578715934,21
1,726,7193,3578715913,3578715935,22
1,726,7194,3578715913,3578715942,29
1,726,7195,3578715913,3578715946,33
1,726,7196,3578715913,3578715949,36
1,726,7197,3578715913,3578715949,36
1,726,7198,3578715913,3578715950,37
1,726,7199,3578715913,3578715953,40
1,726,7200,3578715913,3578715955,42
1,726,7201,3578715913,3578715962,49
1,726,7202,3578715913,3578715962,49
1,726,7203,3578715913,3578715962,49
1,727,7204,3578715967,3578715967,0
1,727,7205,3578715967,3578715967,0
1,727,7206,3578715967,3578715967,0
1,727,7207,3578715967,3578715967,0
1,727,7208,3578715967,3578715967,0
1,727,7209,3578715967,3578715967,0
1,727,7210,3578715967,3578715968,1
1,727,7211,3578715967,3578715971,4
1,727,7212,3578715967,3578715974,7
1,727,7213,3578715967,3578715975,8
1,727,7214,3578715967,3578715975,8
1,727,7215,3578715967,3578715978,11
1,727,7216,3578715967,3578715981,14
1,727,7217,3578715967,3578715981,14
1,727,7218,3578715967,3578715984,17
1,727,7219,3578715967,3578715986,19
1,727,7220,3578715967,3578715989,22
1,727,7221,3578715967,3578715991,24
1,727,7222,3578715967,3578715992,25
1,727,7223,3578715967,3578715996,29
1,727,7224,3578715967,3578715999,32
1,727,7225,3578715967,3578715999,32
1,727,7226,3578715967,3578715999,32
1,727,7227,3578715967,3578716000,33
1,727,7228,3578715967,3578716002,35
1,727,7229,3578715967,3578716007,40
1,727,7230,3578715967,3578716009,42
1,727,7231,3578715967,3578716011,44
1,727,7232,3578715967,3578716012,45
1,727,7233,3578715967,3578716013,46
1,727,7234,3578715967,3578716015,48
1,727,7235,3578715967,3578716016,49
1,727,7236,3578715967,3578716017,50
1,728,7237,3578716021,3578716021,0
1,728,7238,3578716021,3578716021,0
1,728,7239,3578716021,3578716021,0
1,728,7240,3578716021,3578716022,1
1,728,7241,3578716021,3578716022,1
1,728,7242,3578716021,3578716025,4
1,728,7243,3578716021,3578716025,4
1,728,7244,3578716021,3578716026,5
1,728,7245,3578716021,3578716027,6
1,728,7246,3578716021,3578716029,8
1,728,7247,3578716021,3578716029,8
1,728,7248,3578716021,3578716029,8
1,728,7249,3578716021,3578716030,9
1,728,7250,3578716021,3578716032,11
1,728,7251,3578716021,3578716034,13
1,728,7252,3578716021,3578716037,16
1,728,7253,3578716021,3578716039,18
1,728,7254,3578716021,3578716039,18
1,728,7255,3578716021,3578716043,22
1,728,7256,3578716021,3578716047,26
1,728,7257,3578716021,3578716048,27
1,728,7258,3578716021,3578716050,29
1,728,7259,3578716021,3578716052,31
1,728,7260,3578716021,3578716054,33
1,728,7261,3578716021,3578716054,33
1,728,7262,3578716021,3578716055,34
1,728,7263,3578716021,3578716056,35
1,728,7264,3578716021,3578716058,37
1,728,7265,3578716021,3578716058,37
1,728,7266,3578716021,3578716058,37
1,728,7267,3578716021,3578716063,42
1,728,7268,3578716021,3578716063,42
1,728,7269,3578716021,3578716065,44
1,728,7270,3578716021,3578716065,44
1,729,7271,3578716075,3578716075,0
1,729,7272,3578716075,3578716080,5
1,729,7273,3578716075,3578716083,8
1,729,7274,3578716075,3578716083,8
1,729,7275,3578716075,3578716083,8
1,729,7276,3578716075,3578716084,9
1,729,7277,3578716075,3578716085,10
1,729,7278,3578716075,3578716087,12
1,729,7279,3578716075,3578716089,14
1,729,7280,3578716075,3578716092,17
1,729,7281,3578716075,3578716093,18
1,729,7282,3578716075,3578716096,21
1,729,7283,3578716075,3578716096,21
1,729,7284,3578716075,3578716099,24
1,729,7285,3578716075,3578716101,26
1,729,7286,3578716075,3578716101,26
1,729,7287,3578716075,3578716101,26
1,729,7288,3578716075,3578716103,28
1,729,7289,3578716075,3578716105,30
1,729,7290,3578716075,3578716105,30
1,729,7291,3578716075,3578716105,30
1,729,7292,3578716075,3578716109,34
1,729,7293,3578716075,3578716110,35
1,729,7294,3578716075,3578716113,38
1,729,7295,3578716075,3578716116,41
1,729,7296,3578716075,3578716116,41
1,729,7297,3578716075,3578716119,44
1,729,7298,3578716075,3578716119,44
1,729,7299,3578716075,3578716121,46
1,729,7300,3578716075,3578716122,47
1,729,7301,3578716075,3578716123,48
1,729,7302,3578716075,3578716123,48
1,729,7303,3578716075,3578716124,49
1,730,7304,3578716128,3578716128,0
1,730,7305,3578716128,3578716128,0
1,730,7306,3578716128,3578716128,0
1,730,7307,3578716128,3578716128,0
1,730,7308,3578716128,3578716128,0
1,730,7309,3578716128,3578716128,0
1,730,7310,3578716128,3578716128,0
1,730,7311,3578716128,3578716130,2
1,730,7312,3578716128,3578716130,2
1,730,7313,3578716128,3578716133,5
1,730,7314,3578716128,3578716135,7
1,730,7315,3578716128,3578716141,13
1,730,7316,3578716128,3578716142,14
1,730,7317,3578716128,3578716146,18
1,730,7318,3578716128,3578716148,20
1,730,7319,3578716128,3578716149,21
1,730,7320,3578716128,3578716151,23
1,730,7321,3578716128,3578716153,25
1,730,7322,3578716128,3578716154,26
1,730,7323,3578716128,3578716162,34
1,730,7324,3578716128,3578716162,34
1,730,7325,3578716128,3578716162,34
1,730,7326,3578716128,3578716164,36
1,730,7327,3578716128,3578716165,37
1,730,7328,3578716128,3578716165,37
1,730,7329,3578716128,3578716167,39
1,730,7330,3578716128,3578716167,39
1,730,7331,3578716128,3578716167,39
1,730,7332,3578716128,3578716168,40
1,730,7333,3578716128,3578716170,42
1,730,7334,3578716128,3578716174,46
1,730,7335,3578716128,3578716176,48
1,730,7336,3578716128,3578716176,48
1,731,7337,3578716183,3578716183,0
1,731,7338,3578716183,3578716183,0
1,731,7339,3578716183,3578716183,0
1,731,7340,3578716183,3578716183,0
1,731,7341,3578716183,3578716186,3
1,731,7342,3578716183,3578716189,6
1,731,7343,3578716183,3578716191,8
1,731,7344,3578716183,3578716193,10
1,731,7345,3578716183,3578716196,13
1,731,7346,3578716183,3578716199,16
1,731,7347,3578716183,3578716199,16
1,731,7348,3578716183,3578716199,16
1,731,7349,3578716183,3578716199,16
1,731,7350,3578716183,3578716202,19
1,731,7351,3578716183,3578716207,24
1,731,7352,3578716183,3578716209,26
1,731,7353,3578716183,3578716211,28
1,731,7354,3578716183,3578716212,29
1,731,7355,3578716183,3578716216,33
1,731,7356,3578716183,3578716216,33
1,731,7357,3578716183,3578716217,34
1,731,7358,3578716183,3578716219,36
1,731,7359,3578716183,3578716220,37
1,731,7360,3578716183,3578716223,40
1,731,7361,3578716183,3578716223,40
1,731,7362,3578716183,3578716224,41
1,731,7363,3578716183,3578716226,43
1,731,7364,3578716183,3578716226,43
1,731,7365,3578716183,3578716228,45
1,731,7366,3578716183,3578716229,46
1,731,7367,3578716183,3578716229,46
1,731,7368,3578716183,3578716229,46
1,731,7369,3578716183,3578716231,48
1,731,7370,3578716183,3578716232,49
1,732,7371,3578716238,3578716238,0
1,732,7372,3578716238,3578716238,0
1,732,7373,3578716238,3578716239,1
1,732,7374,3578716238,3578716240,2
1,732,7375,3578716238,3578716243,5
1,732,7376,3578716238,3578716247,9
1,732,7377,3578716238,3578716248,10
1,732,7378,3578716238,3578716250,12
1,732,7379,3578716238,3578716251,13
1,732,7380,3578716238,3578716254,16
1,732,7381,3578716238,3578716255,17
1,732,7382,3578716238,3578716255,17
1,732,7383,3578716238,3578716256,18
1,732,7384,3578716238,3578716257,19
1,732,7385,3578716238,3578716258,20
1,732,7386,3578716238,3578716258,20
1,732,7387,3578716238,3578716259,21
1,732,7388,3578716238,3578716262,24
1,732,7389,3578716238,3578716263,25
1,732,7390,3578716238,3578716265,27
1,732,7391,3578716238,3578716266,28
1,732,7392,3578716238,3578716276,38
1,732,7393,3578716238,3578716280,42
1,732,7394,3578716238,3578716281,43
1,732,7395,3578716238,3578716283,45
1,732,7396,3578716238,3578716283,45
1,732,7397,3578716238,3578716284,46
1,732,7398,3578716238,3578716284,46
1,732,7399,3578716238,3578716285,47
1,732,7400,3578716238,3578716287,49
1,733,7401,3578716293,3578716293,0
1,733,7402,3578716293,3578716293,0
1,733,7403,3578716293,3578716293,0
1,733,7404,3578716293,3578716297,4
1,733,7405,3578716293,3578716299,6
1,733,7406,3578716293,3578716300,7
1,733,7407,3578716293,3578716301,8
1,733,7408,3578716293,3578716302,9
1,733,7409,3578716293,3578716303,10
1,733,7410,3578716293,3578716304,11
1,733,7411,3578716293,3578716306,13
1,733,7412,3578716293,3578716307,14
1,733,7413,3578716293,3578716309,16
1,733,7414,3578716293,3578716310,17
1,733,7415,3578716293,3578716313,20
1,733,7416,3578716293,3578716316,23
1,733,7417,3578716293,3578716318,25
1,733,7418,3578716293,3578716319,26
1,733,7419,3578716293,3578716320,27
1,733,7420,3578716293,3578716321,28
1,733,7421,3578716293,3578716322,29
1,733,7422,3578716293,3578716323,30
1,733,7423,3578716293,3578716323,30
1,733,7424,3578716293,3578716324,31
1,733,7425,3578716293,3578716325,32
1,733,7426,3578716293,3578716326,33
1,733,7427,3578716293,3578716328,35
1,733,7428,3578716293,3578716328,35
1,733,7429,3578716293,3578716328,35
1,733,7430,3578716293,3578716328,35
1,733,7431,3578716293,3578716331,38
1,733,7432,3578716293,3578716333,40
1,733,7433,3578716293,3578716336,43
1,733,7434,3578716293,3578716341,48
1,733,7435,3578716293,3578716341,48
1,734,7436,3578716347,3578716347,0
1,734,7437,3578716347,3578716348,1
1,734,7438,3578716347,3578716350,3
1,734,7439,3578716347,3578716351,4
1,734,7440,3578716347,3578716353,6
1,734,7441,3578716347,3578716355,8
1,734,7442,3578716347,3578716362,15
1,734,7443,3578716347,3578716362,15
1,734,7444,3578716347,3578716362,15
1,734,7445,3578716347,3578716364,17
1,734,7446,3578716347,3578716366,19
1,734,7447,3578716347,3578716366,19
1,734,7448,3578716347,3578716367,20
1,734,7449,3578716347,3578716367,20
1,734,7450,3578716347,3578716367,20
1,734,7451,3578716347,3578716368,21
1,734,7452,3578716347,3578716371,24
1,734,7453,3578716347,3578716375,28
1,734,7454,3578716347,3578716376,29
1,734,7455,3578716347,3578716377,30
1,734,7456,3578716347,3578716379,32
1,734,7457,3578716347,3578716381,34
1,734,7458,3578716347,3578716382,35
1,734,7459,3578716347,3578716383,36
1,734,7460,3578716347,3578716386,39
1,734,7461,3578716347,3578716391,44
1,734,7462,3578716347,3578716394,47
1,735,7463,3578716401,3578716401,0
1,735,7464,3578716401,3578716401,0
1,735,7465,3578716401,3578716401,0
1,735,7466,3578716401,3578716401,0
1,735,7467,3578716401,3578716403,2
1,735,7468,3578716401,3578716407,6
1,735,7469,3578716401,3578716409,8
1,735,7470,3578716401,3578716411,10
1,735,7471,3578716401,3578716412,11
1,735,7472,3578716401,3578716413,12
1,735,7473,3578716401,3578716417,16
1,735,7474,3578716401,3578716417,16
1,735,7475,3578716401,3578716418,17
1,735,7476,3578716401,3578716418,17
1,735,7477,3578716401,3578716419,18
1,735,7478,3578716401,3578716422,21
1,735,7479,3578716401,3578716424,23
1,735,7480,3578716401,3578716424,23
1,735,7481,3578716401,3578716426,25
1,735,7482,3578716401,3578716427,26
1,735,7483,3578716401,3578716428,27
1,735,7484,3578716401,3578716428,27
1,735,7485,3578716401,3578716429,28
1,735,7486,3578716401,3578716429,28
1,735,7487,3578716401,3578716431,30
1,735,7488,3578716401,3578716432,31
1,735,7489,3578716401,3578716434,33
1,735,7490,3578716401,3578716438,37
1,735,7491,3578716401,3578716439,38
1,735,7492,3578716401,3578716440,39
1,735,7493,3578716401,3578716447,46
1,735,7494,3578716401,3578716448,47
1,735,7495,3578716401,3578716450,49
1,736,7496,3578716456,3578716456,0
1,736,7497,3578716456,3578716456,0
1,736,7498,3578716456,3578716456,0
1,736,7499,3578716456,3578716456,0
1,736,7500,3578716456,3578716457,1
1,736,7501,3578716456,3578716458,2
1,736,7502,3578716456,3578716458,2
1,736,7503,3578716456,3578716459,3
1,736,7504,3578716456,3578716463,7
1,736,7505,3578716456,3578716463,7
1,736,7506,3578716456,3578716464,8
1,736,7507,3578716456,3578716465,9
1,736,7508,3578716456,3578716466,10
1,736,7509,3578716456,3578716476,20
1,736,7510,3578716456,3578716480,24
1,736,7511,3578716456,3578716481,25
1,736,7512,3578716456,3578716483,27
1,736,7513,3578716456,3578716483,27
1,736,7514,3578716456,3578716484,28
1,736,7515,3578716456,3578716485,29
1,736,7516,3578716456,3578716485,29
1,736,7517,3578716456,3578716487,31
1,736,7518,3578716456,3578716490,34
1,736,7519,3578716456,3578716492,36
1,736,7520,3578716456,3578716494,38
1,736,7521,3578716456,3578716496,40
1,736,7522,3578716456,3578716498,42
1,736,7523,3578716456,3578716498,42
1,736,7524,3578716456,3578716500,44
1,736,7525,3578716456,3578716502,46
1,736,7526,3578716456,3578716503,47
1,736,7527,3578716456,3578716504,48
1,737,7528,3578716513,3578716513,0
1,737,7529,3578716513,3578716513,0
1,737,7530,3578716513,3578716513,0
1,737,7531,3578716513,3578716513,0
1,737,7532,3578716513,3578716513,0
1,737,7533,3578716513,3578716515,2
1,737,7534,3578716513,3578716516,3
1,737,7535,3578716513,3578716518,5
1,737,7536,3578716513,3578716519,6
1,737,7537,3578716513,3578716520,7
1,737,7538,3578716513,3578716520,7
1,737,7539,3578716513,3578716521,8
1,737,7540,3578716513,3578716522,9
1,737,7541,3578716513,3578716522,9
1,737,7542,3578716513,3578716522,9
1,737,7543,3578716513,3578716524,11
1,737,7544,3578716513,3578716525,12
1,737,7545,3578716513,3578716527,14
1,737,7546,3578716513,3578716527,14
1,737,7547,3578716513,3578716527,14
1,737,7548,3578716513,3578716530,17
1,737,7549,3578716513,3578716533,20
1,737,7550,3578716513,3578716534,21
1,737,7551,3578716513,3578716535,22
1,737,7552,3578716513,3578716541,28
1,737,7553,3578716513,3578716541,28
1,737,7554,3578716513,3578716543,30
1,737,7555,3578716513,3578716548,35
1,737,7556,3578716513,3578716548,35
1,737,7557,3578716513,3578716551,38
1,737,7558,3578716513,3578716553,40
1,737,7559,3578716513,3578716553,40
1,737,7560,3578716513,3578716561,48
1,737,7561,3578716513,3578716561,48
1,737,7562,3578716513,3578716561,48
1,737,7563,3578716513,3578716562,49
1,738,7564,3578716567,3578716567,0
1,738,7565,3578716567,3578716567,0
1,738,7566,3578716567,3578716567,0
1,738,7567,3578716567,3578716567,0
1,738,7568,3578716567,3578716567,0
1,738,7569,3578716567,3578716567,0
1,738,7570,3578716567,3578716571,4
1,738,7571,3578716567,3578716574,7
1,738,7572,3578716567,3578716575,8
1,738,7573,3578716567,3578716576,9
1,738,7574,3578716567,3578716578,11
1,738,7575,3578716567,3578716580,13
1,738,7576,3578716567,3578716581,14
1,738,7577,3578716567,3578716582,15
1,738,7578,3578716567,3578716585,18
1,738,7579,3578716567,3578716590,23
1,738,7580,3578716567,3578716593,26
1,738,7581,3578716567,3578716598,31
1,738,7582,3578716567,3578716599,32
1,738,7583,3578716567,3578716599,32
1,738,7584,3578716567,3578716599,32
1,738,7585,3578716567,3578716606,39
1,738,7586,3578716567,3578716608,41
1,738,7587,3578716567,3578716610,43
1,738,7588,3578716567,3578716611,44
1,738,7589,3578716567,3578716616,49
1,738,7590,3578716567,3578716616,49
1,739,7591,3578716621,3578716621,0
1,739,7592,3578716621,3578716621,0
1,739,7593,3578716621,3578716621,0
1,739,7594,3578716621,3578716621,0
1,739,7595,3578716621,3578716622,1
1,739,7596,3578716621,3578716622,1
1,739,7597,3578716621,3578716624,3
1,739,7598,3578716621,3578716625,4
1,739,7599,3578716621,3578716625,4
1,739,7600,3578716621,3578716626,5
1,739,7601,3578716621,3578716628,7
1,739,7602,3578716621,3578716629,8
1,739,7603,3578716621,3578716629,8
1,739,7604,3578716621,3578716631,10
1,739,7605,3578716621,3578716631,10
1,739,7606,3578716621,3578716633,12
1,739,7607,3578716621,3578716637,16
1,739,7608,3578716621,3578716638,17
1,739,7609,3578716621,3578716640,19
1,739,7610,3578716621,3578716646,25
1,739,7611,3578716621,3578716647,26
1,739,7612,3578716621,3578716649,28
1,739,7613,3578716621,3578716651,30
1,739,7614,3578716621,3578716653,32
1,739,7615,3578716621,3578716653,32
1,739,7616,3578716621,3578716655,34
1,739,7617,3578716621,3578716656,35
1,739,7618,3578716621,3578716656,35
1,739,7619,3578716621,3578716658,37
1,739,7620,3578716621,3578716658,37
1,739,7621,3578716621,3578716658,37
1,739,7622,3578716621,3578716661,40
1,739,7623,3578716621,3578716662,41
1,739,7624,3578716621,3578716663,42
1,739,7625,3578716621,3578716664,43
1,739,7626,3578716621,3578716665,44
1,740,7627,3578716675,3578716676,1
1,740,7628,3578716675,3578716680,5
1,740,7629,3578716675,3578716681,6
1,740,7630,3578716675,3578716683,8
1,740,7631,3578716675,3578716683,8
1,740,7632,3578716675,3578716683,8
1,740,7633,3578716675,3578716684,9
1,740,7634,3578716675,3578716685,10
1,740,7635,3578716675,3578716688,13
1,740,7636,3578716675,3578716688,13
1,740,7637,3578716675,3578716690,15
1,740,7638,3578716675,3578716692,17
1,740,7639,3578716675,3578716693,18
1,740,7640,3578716675,3578716696,21
1,740,7641,3578716675,3578716698,23
1,740,7642,3578716675,3578716699,24
1,740,7643,3578716675,3578716700,25
1,740,7644,3578716675,3578716700,25
1,740,7645,3578716675,3578716702,27
1,740,7646,3578716675,3578716704,29
1,740,7647,3578716675,3578716705,30
1,740,7648,3578716675,3578716707,32
1,740,7649,3578716675,3578716707,32
1,740,7650,3578716675,3578716710,35
1,740,7651,3578716675,3578716711,36
1,740,7652,3578716675,3578716712,37
1,740,7653,3578716675,3578716715,40
1,740,7654,3578716675,3578716717,42
1,740,7655,3578716675,3578716718,43
1,740,7656,3578716675,3578716718,43
1,740,7657,3578716675,3578716718,43
1,740,7658,3578716675,3578716719,44
1,740,7659,3578716675,3578716720,45
1,740,7660,3578716675,3578716722,47
1,740,7661,3578716675,3578716722,47
1,740,7662,3578716675,3578716723,48
1,740,7663,3578716675,3578716724,49
1,740,7664,3578716675,3578716724,49
1,740,7665,3578716675,3578716724,49
1,740,7666,3578716675,3578716725,50
1,741,7667,3578716729,3578716729,0
1,741,7668,3578716729,3578716729,0
1,741,7669,3578716729,3578716729,0
1,741,7670,3578716729,3578716729,0
1,741,7671,3578716729,3578716729,0
1,741,7672,3578716729,3578716730,1
1,741,7673,3578716729,3578716733,4
1,741,7674,3578716729,3578716734,5
1,741,7675,3578716729,3578716735,6
1,741,7676,3578716729,3578716741,12
1,741,7677,3578716729,3578716742,13
1,741,7678,3578716729,3578716742,13
1,741,7679,3578716729,3578716744,15
1,741,7680,3578716729,3578716748,19
1,741,7681,3578716729,3578716749,20
1,741,7682,3578716729,3578716751,22
1,741,7683,3578716729,3578716753,24
1,741,7684,3578716729,3578716754,25
1,741,7685,3578716729,3578716761,32
1,741,7686,3578716729,3578716761,32
1,741,7687,3578716729,3578716761,32
1,741,7688,3578716729,3578716763,34
1,741,7689,3578716729,3578716765,36
1,741,7690,3578716729,3578716766,37
1,741,7691,3578716729,3578716766,37
1,741,7692,3578716729,3578716767,38
1,741,7693,3578716729,3578716767,38
1,741,7694,3578716729,3578716767,38
1,741,7695,3578716729,3578716770,41
1,741,7696,3578716729,3578716774,45
1,741,7697,3578716729,3578716774,45
1,741,7698,3578716729,3578716776,47
1,741,7699,3578716729,3578716777,48
1,742,7700,3578716783,3578716783,0
1,742,7701,3578716783,3578716783,0
1,742,7702,3578716783,3578716783,0
1,742,7703,3578716783,3578716785,2
1,742,7704,3578716783,3578716789,6
1,742,7705,3578716783,3578716791,8
1,742,7706,3578716783,3578716793,10
1,742,7707,3578716783,3578716798,15
1,742,7708,3578716783,3578716798,15
1,742,7709,3578716783,3578716799,16
1,742,7710,3578716783,3578716799,16
1,742,7711,3578716783,3578716799,16
1,742,7712,3578716783,3578716802,19
1,742,7713,3578716783,3578716806,23
1,742,7714,3578716783,3578716809,26
1,742,7715,3578716783,3578716811,28
1,742,7716,3578716783,3578716812,29
1,742,7717,3578716783,3578716816,33
1,742,7718,3578716783,3578716816,33
1,742,7719,3578716783,3578716817,34
1,742,7720,3578716783,3578716818,35
1,742,7721,3578716783,3578716819,36
1,742,7722,3578716783,3578716820,37
1,742,7723,3578716783,3578716822,39
1,742,7724,3578716783,3578716822,39
1,742,7725,3578716783,3578716825,42
1,742,7726,3578716783,3578716825,42
1,742,7727,3578716783,3578716826,43
1,742,7728,3578716783,3578716826,43
1,742,7729,3578716783,3578716828,45
1,742,7730,3578716783,3578716829,46
1,742,7731,3578716783,3578716829,46
1,742,7732,3578716783,3578716830,47
1,742,7733,3578716783,3578716832,49
1,743,7734,3578716838,3578716838,0
1,743,7735,3578716838,3578716838,0
1,743,7736,3578716838,3578716838,0
1,743,7737,3578716838,3578716840,2
1,743,7738,3578716838,3578716847,9
1,743,7739,3578716838,3578716848,10
1,743,7740,3578716838,3578716849,11
1,743,7741,3578716838,3578716851,13
1,743,7742,3578716838,3578716853,15
1,743,7743,3578716838,3578716853,15
1,743,7744,3578716838,3578716855,17
1,743,7745,3578716838,3578716856,18
1,743,7746,3578716838,3578716857,19
1,743,7747,3578716838,3578716857,19
1,743,7748,3578716838,3578716857,19
1,743,7749,3578716838,3578716858,20
1,743,7750,3578716838,3578716862,24
1,743,7751,3578716838,3578716864,26
1,743,7752,3578716838,3578716864,26
1,743,7753,3578716838,3578716864,26
1,743,7754,3578716838,3578716876,38
1,743,7755,3578716838,3578716880,42
1,743,7756,3578716838,3578716881,43
1,743,7757,3578716838,3578716883,45
1,743,7758,3578716838,3578716884,46
1,743,7759,3578716838,3578716884,46
1,743,7760,3578716838,3578716885,47
1,743,7761,3578716838,3578716885,47
1,743,7762,3578716838,3578716888,50
1,744,7763,3578716892,3578716892,0
1,744,7764,3578716892,3578716892,0
1,744,7765,3578716892,3578716892,0
1,744,7766,3578716892,3578716892,0
1,744,7767,3578716892,3578716893,1
1,744,7768,3578716892,3578716896,4
1,744,7769,3578716892,3578716898,6
1,744,7770,3578716892,3578716899,7
1,744,7771,3578716892,3578716900,8
1,744,7772,3578716892,3578716900,8
1,744,7773,3578716892,3578716902,10
1,744,7774,3578716892,3578716904,12
1,744,7775,3578716892,3578716907,15
1,744,7776,3578716892,3578716907,15
1,744,7777,3578716892,3578716910,18
1,744,7778,3578716892,3578716910,18
1,744,7779,3578716892,3578716912,20
1,744,7780,3578716892,3578716915,23
1,744,7781,3578716892,3578716917,25
1,744,7782,3578716892,3578716918,26
1,744,7783,3578716892,3578716918,26
1,744,7784,3578716892,3578716919,27
1,744,7785,3578716892,3578716919,27
1,744,7786,3578716892,3578716921,29
1,744,7787,3578716892,3578716922,30
1,744,7788,3578716892,3578716923,31
1,744,7789,3578716892,3578716923,31
1,744,7790,3578716892,3578716923,31
1,744,7791,3578716892,3578716924,32
1,744,7792,3578716892,3578716924,32
1,744,7793,3578716892,3578716926,34
1,744,7794,3578716892,3578716926,34
1,744,7795,3578716892,3578716927,35
1,744,7796,3578716892,3578716928,36
1,744,7797,3578716892,3578716930,38
1,744,7798,3578716892,3578716933,41
1,744,7799,3578716892,3578716934,42
1,744,7800,3578716892,3578716935,43
1,744,7801,3578716892,3578716941,49
1,744,7802,3578716892,3578716942,50
1,745,7803,3578716946,3578716946,0
1,745,7804,3578716946,3578716946,0
1,745,7805,3578716946,3578716948,2
1,745,7806,3578716946,3578716948,2
1,745,7807,3578716946,3578716951,5
1,745,7808,3578716946,3578716952,6
1,745,7809,3578716946,3578716954,8
1,745,7810,3578716946,3578716961,15
1,745,7811,3578716946,3578716961,15
1,745,7812,3578716946,3578716962,16
1,745,7813,3578716946,3578716963,17
1,745,7814,3578716946,3578716965,19
1,745,7815,3578716946,3578716965,19
1,745,7816,3578716946,3578716966,20
1,745,7817,3578716946,3578716967,21
1,745,7818,3578716946,3578716967,21
1,745,7819,3578716946,3578716968,22
1,745,7820,3578716946,3578716970,24
1,745,7821,3578716946,3578716975,29
1,745,7822,3578716946,3578716975,29
1,745,7823,3578716946,3578716975,29
1,745,7824,3578716946,3578716978,32
1,745,7825,3578716946,3578716980,34
1,745,7826,3578716946,3578716981,35
1,745,7827,3578716946,3578716984,38
1,745,7828,3578716946,3578716986,40
1,745,7829,3578716946,3578716989,43
1,745,7830,3578716946,3578716991,45
1,745,7831,3578716946,3578716993,47
1,746,7832,3578717001,3578717001,0
1,746,7833,3578717001,3578717001,0
1,746,7834,3578717001,3578717001,0
1,746,7835,3578717001,3578717001,0
1,746,7836,3578717001,3578717001,0
1,746,7837,3578717001,3578717002,1
1,746,7838,3578717001,3578717006,5
1,746,7839,3578717001,3578717009,8
1,746,7840,3578717001,3578717011,10
1,746,7841,3578717001,3578717012,11
1,746,7842,3578717001,3578717016,15
1,746,7843,3578717001,3578717016,15
1,746,7844,3578717001,3578717016,15
1,746,7845,3578717001,3578717019,18
1,746,7846,3578717001,3578717019,18
1,746,7847,3578717001,3578717021,20
1,746,7848,3578717001,3578717022,21
1,746,7849,3578717001,3578717023,22
1,746,7850,3578717001,3578717025,24
1,746,7851,3578717001,3578717026,25
1,746,7852,3578717001,3578717026,25
1,746,7853,3578717001,3578717026,25
1,746,7854,3578717001,3578717028,27
1,746,7855,3578717001,3578717028,27
1,746,7856,3578717001,3578717029,28
1,746,7857,3578717001,3578717030,29
1,746,7858,3578717001,3578717032,31
1,746,7859,3578717001,3578717034,33
1,746,7860,3578717001,3578717038,37
1,746,7861,3578717001,3578717039,38
1,746,7862,3578717001,3578717039,38
1,746,7863,3578717001,3578717040,39
1,746,7864,3578717001,3578717043,42
1,746,7865,3578717001,3578717047,46
1,746,7866,3578717001,3578717048,47
1,746,7867,3578717001,3578717050,49
1,746,7868,3578717001,3578717051,50
1,747,7869,3578717056,3578717056,0
1,747,7870,3578717056,3578717056,0
1,747,7871,3578717056,3578717056,0
1,747,7872,3578717056,3578717056,0
1,747,7873,3578717056,3578717057,1
1,747,7874,3578717056,3578717057,1
1,747,7875,3578717056,3578717058,2
1,747,7876,3578717056,3578717059,3
1,747,7877,3578717056,3578717062,6
1,747,7878,3578717056,3578717064,8
1,747,7879,3578717056,3578717064,8
1,747,7880,3578717056,3578717075,19
1,747,7881,3578717056,3578717080,24
1,747,7882,3578717056,3578717081,25
1,747,7883,3578717056,3578717084,28
1,747,7884,3578717056,3578717084,28
1,747,7885,3578717056,3578717084,28
1,747,7886,3578717056,3578717084,28
1,747,7887,3578717056,3578717085,29
1,747,7888,3578717056,3578717086,30
1,747,7889,3578717056,3578717088,32
1,747,7890,3578717056,3578717088,32
1,747,7891,3578717056,3578717089,33
1,747,7892,3578717056,3578717090,34
1,747,7893,3578717056,3578717093,37
1,747,7894,3578717056,3578717096,40
1,747,7895,3578717056,3578717098,42
1,747,7896,3578717056,3578717099,43
1,747,7897,3578717056,3578717101,45
1,747,7898,3578717056,3578717101,45
1,747,7899,3578717056,3578717102,46
1,747,7900,3578717056,3578717103,47
1,747,7901,3578717056,3578717104,48
1,748,7902,3578717110,3578717110,0
1,748,7903,3578717110,3578717110,0
1,748,7904,3578717110,3578717110,0
1,748,7905,3578717110,3578717110,0
1,748,7906,3578717110,3578717113,3
1,748,7907,3578717110,3578717116,6
1,748,7908,3578717110,3578717116,6
1,748,7909,3578717110,3578717118,8
1,748,7910,3578717110,3578717119,9
1,748,7911,3578717110,3578717119,9
1,748,7912,3578717110,3578717120,10
1,748,7913,3578717110,3578717120,10
1,748,7914,3578717110,3578717122,12
1,748,7915,3578717110,3578717123,13
1,748,7916,3578717110,3578717123,13
1,748,7917,3578717110,3578717124,14
1,748,7918,3578717110,3578717124,14
1,748,7919,3578717110,3578717125,15
1,748,7920,3578717110,3578717126,16
1,748,7921,3578717110,3578717127,17
1,748,7922,3578717110,3578717127,17
1,748,7923,3578717110,3578717128,18
1,748,7924,3578717110,3578717130,20
1,748,7925,3578717110,3578717133,23
1,748,7926,3578717110,3578717134,24
1,748,7927,3578717110,3578717136,26
1,748,7928,3578717110,3578717141,31
1,748,7929,3578717110,3578717141,31
1,748,7930,3578717110,3578717143,33
1,748,7931,3578717110,3578717145,35
1,748,7932,3578717110,3578717145,35
1,748,7933,3578717110,3578717149,39
1,748,7934,3578717110,3578717149,39
1,748,7935,3578717110,3578717150,40
1,748,7936,3578717110,3578717151,41
1,748,7937,3578717110,3578717154,44
1,748,7938,3578717110,3578717155,45
1,749,7939,3578717165,3578717165,0
1,749,7940,3578717165,3578717165,0
1,749,7941,3578717165,3578717165,0
1,749,7942,3578717165,3578717165,0
1,749,7943,3578717165,3578717165,0
1,749,7944,3578717165,3578717165,0
1,749,7945,3578717165,3578717166,1
1,749,7946,3578717165,3578717167,2
1,749,7947,3578717165,3578717167,2
1,749,7948,3578717165,3578717167,2
1,749,7949,3578717165,3578717170,5
1,749,7950,3578717165,3578717175,10
1,749,7951,3578717165,3578717176,11
1,749,7952,3578717165,3578717177,12
1,749,7953,3578717165,3578717178,13
1,749,7954,3578717165,3578717181,16
1,749,7955,3578717165,3578717181,16
1,749,7956,3578717165,3578717183,18
1,749,7957,3578717165,3578717186,21
1,749,7958,3578717165,3578717189,24
1,749,7959,3578717165,3578717192,27
1,749,7960,3578717165,3578717193,28
1,749,7961,3578717165,3578717197,32
1,749,7962,3578717165,3578717199,34
1,749,7963,3578717165,3578717199,34
1,749,7964,3578717165,3578717199,34
1,749,7965,3578717165,3578717199,34
1,749,7966,3578717165,3578717200,35
1,749,7967,3578717165,3578717202,37
1,749,7968,3578717165,3578717206,41
1,749,7969,3578717165,3578717210,45
1,749,7970,3578717165,3578717212,47
1,749,7971,3578717165,3578717212,47
1,749,7972,3578717165,3578717213,48
1,750,7973,3578717221,3578717221,0
1,750,7974,3578717221,3578717221,0
1,750,7975,3578717221,3578717221,0
1,750,7976,3578717221,3578717221,0
1,750,7977,3578717221,3578717221,0
1,750,7978,3578717221,3578717221,0
1,750,7979,3578717221,3578717222,1
1,750,7980,3578717221,3578717222,1
1,750,7981,3578717221,3578717224,3
1,750,7982,3578717221,3578717226,5
1,750,7983,3578717221,3578717227,6
1,750,7984,3578717221,3578717227,6
1,750,7985,3578717221,3578717228,7
1,750,7986,3578717221,3578717229,8
1,750,7987,3578717221,3578717229,8
1,750,7988,3578717221,3578717230,9
1,750,7989,3578717221,3578717233,12
1,750,7990,3578717221,3578717234,13
1,750,7991,3578717221,3578717238,17
1,750,7992,3578717221,3578717239,18
1,750,7993,3578717221,3578717239,18
1,750,7994,3578717221,3578717240,19
1,750,7995,3578717221,3578717244,23
1,750,7996,3578717221,3578717247,26
1,750,7997,3578717221,3578717248,27
1,750,7998,3578717221,3578717251,30
1,750,7999,3578717221,3578717251,30
1,750,8000,3578717221,3578717254,33
1,750,8001,3578717221,3578717255,34
1,750,8002,3578717221,3578717256,35
1,750,8003,3578717221,3578717256,35
1,750,8004,3578717221,3578717256,35
1,750,8005,3578717221,3578717257,36
1,750,8006,3578717221,3578717258,37
1,750,8007,3578717221,3578717258,37
1,750,8008,3578717221,3578717262,41
1,750,8009,3578717221,3578717263,42
1,750,8010,3578717221,3578717263,42
1,750,8011,3578717221,3578717265,44
1,751,8012,3578717275,3578717276,1
1,751,8013,3578717275,3578717280,5
1,751,8014,3578717275,3578717283,8
1,751,8015,3578717275,3578717284,9
1,751,8016,3578717275,3578717284,9
1,751,8017,3578717275,3578717285,10
1,751,8018,3578717275,3578717286,11
1,751,8019,3578717275,3578717288,13
1,751,8020,3578717275,3578717288,13
1,751,8021,3578717275,3578717289,14
1,751,8022,3578717275,3578717289,14
1,751,8023,3578717275,3578717292,17
1,751,8024,3578717275,3578717296,21
1,751,8025,3578717275,3578717298,23
1,751,8026,3578717275,3578717299,24
1,751,8027,3578717275,3578717300,25
1,751,8028,3578717275,3578717301,26
1,751,8029,3578717275,3578717302,27
1,751,8030,3578717275,3578717304,29
1,751,8031,3578717275,3578717307,32
1,751,8032,3578717275,3578717308,33
1,751,8033,3578717275,3578717309,34
1,751,8034,3578717275,3578717310,35
1,751,8035,3578717275,3578717313,38
1,751,8036,3578717275,3578717315,40
1,751,8037,3578717275,3578717317,42
1,751,8038,3578717275,3578717318,43
1,751,8039,3578717275,3578717318,43
1,751,8040,3578717275,3578717319,44
1,751,8041,3578717275,3578717320,45
1,751,8042,3578717275,3578717320,45
1,751,8043,3578717275,3578717322,47
1,751,8044,3578717275,3578717323,48
1,751,8045,3578717275,3578717323,48
1,751,8046,3578717275,3578717324,49
1,751,8047,3578717275,3578717325,50
1,752,8048,3578717329,3578717329,0
1,752,8049,3578717329,3578717329,0
1,752,8050,3578717329,3578717329,0
1,752,8051,3578717329,3578717329,0
1,752,8052,3578717329,3578717331,2
1,752,8053,3578717329,3578717333,4
1,752,8054,3578717329,3578717334,5
1,752,8055,3578717329,3578717336,7
1,752,8056,3578717329,3578717341,12
1,752,8057,3578717329,3578717342,13
1,752,8058,3578717329,3578717342,13
1,752,8059,3578717329,3578717345,16
1,752,8060,3578717329,3578717346,17
1,752,8061,3578717329,3578717348,19
1,752,8062,3578717329,3578717349,20
1,752,8063,3578717329,3578717350,21
1,752,8064,3578717329,3578717351,22
1,752,8065,3578717329,3578717354,25
1,752,8066,3578717329,3578717355,26
1,752,8067,3578717329,3578717361,32
1,752,8068,3578717329,3578717362,33
1,752,8069,3578717329,3578717362,33
1,752,8070,3578717329,3578717363,34
1,752,8071,3578717329,3578717366,37
1,752,8072,3578717329,3578717366,37
1,752,8073,3578717329,3578717366,37
1,752,8074,3578717329,3578717367,38
1,752,8075,3578717329,3578717368,39
1,752,8076,3578717329,3578717368,39
1,752,8077,3578717329,3578717371,42
1,752,8078,3578717329,3578717375,46
1,752,8079,3578717329,3578717375,46
1,752,8080,3578717329,3578717376,47
1,752,8081,3578717329,3578717379,50
1,753,8082,3578717383,3578717383,0
1,753,8083,3578717383,3578717383,0
1,753,8084,3578717383,3578717384,1
1,753,8085,3578717383,3578717385,2
1,753,8086,3578717383,3578717389,6
1,753,8087,3578717383,3578717391,8
1,753,8088,3578717383,3578717393,10
1,753,8089,3578717383,3578717397,14
1,753,8090,3578717383,3578717398,15
1,753,8091,3578717383,3578717399,16
1,753,8092,3578717383,3578717400,17
1,753,8093,3578717383,3578717402,19
1,753,8094,3578717383,3578717406,23
1,753,8095,3578717383,3578717410,27
1,753,8096,3578717383,3578717412,29
1,753,8097,3578717383,3578717412,29
1,753,8098,3578717383,3578717417,34
1,753,8099,3578717383,3578717417,34
1,753,8100,3578717383,3578717418,35
1,753,8101,3578717383,3578717418,35
1,753,8102,3578717383,3578717419,36
1,753,8103,3578717383,3578717421,38
1,753,8104,3578717383,3578717422,39
1,753,8105,3578717383,3578717422,39
1,753,8106,3578717383,3578717425,42
1,753,8107,3578717383,3578717425,42
1,753,8108,3578717383,3578717427,44
1,753,8109,3578717383,3578717428,45
1,753,8110,3578717383,3578717428,45
1,753,8111,3578717383,3578717429,46
1,753,8112,3578717383,3578717430,47
1,753,8113,3578717383,3578717431,48
1,753,8114,3578717383,3578717433,50
1,754,8115,3578717437,3578717437,0
1,754,8116,3578717437,3578717438,1
1,754,8117,3578717437,3578717439,2
1,754,8118,3578717437,3578717439,2
1,754,8119,3578717437,3578717440,3
1,754,8120,3578717437,3578717444,7
1,754,8121,3578717437,3578717447,10
1,754,8122,3578717437,3578717448,11
1,754,8123,3578717437,3578717450,13
1,754,8124,3578717437,3578717452,15
1,754,8125,3578717437,3578717454,17
1,754,8126,3578717437,3578717455,18
1,754,8127,3578717437,3578717456,19
1,754,8128,3578717437,3578717456,19
1,754,8129,3578717437,3578717456,19
1,754,8130,3578717437,3578717458,21
1,754,8131,3578717437,3578717458,21
1,754,8132,3578717437,3578717458,21
1,754,8133,3578717437,3578717462,25
1,754,8134,3578717437,3578717463,26
1,754,8135,3578717437,3578717463,26
1,754,8136,3578717437,3578717465,28
1,754,8137,3578717437,3578717476,39
1,754,8138,3578717437,3578717480,43
1,754,8139,3578717437,3578717482,45
1,754,8140,3578717437,3578717483,46
1,754,8141,3578717437,3578717483,46
1,754,8142,3578717437,3578717484,47
1,754,8143,3578717437,3578717484,47
1,754,8144,3578717437,3578717485,48
1,754,8145,3578717437,3578717486,49
1,755,8146,3578717491,3578717491,0
1,755,8147,3578717491,3578717491,0
1,755,8148,3578717491,3578717491,0
1,755,8149,3578717491,3578717491,0
1,755,8150,3578717491,3578717492,1
1,755,8151,3578717491,3578717492,1
1,755,8152,3578717491,3578717495,4
1,755,8153,3578717491,3578717497,6
1,755,8154,3578717491,3578717498,7
1,755,8155,3578717491,3578717500,9
1,755,8156,3578717491,3578717501,10
1,755,8157,3578717491,3578717502,11
1,755,8158,3578717491,3578717506,15
1,755,8159,3578717491,3578717506,15
1,755,8160,3578717491,3578717508,17
1,755,8161,3578717491,3578717509,18
1,755,8162,3578717491,3578717512,21
1,755,8163,3578717491,3578717515,24
1,755,8164,3578717491,3578717516,25
1,755,8165,3578717491,3578717517,26
1,755,8166,3578717491,3578717519,28
1,755,8167,3578717491,3578717519,28
1,755,8168,3578717491,3578717520,29
1,755,8169,3578717491,3578717522,31
1,755,8170,3578717491,3578717522,31
1,755,8171,3578717491,3578717522,31
1,755,8172,3578717491,3578717522,31
1,755,8173,3578717491,3578717523,32
1,755,8174,3578717491,3578717526,35
1,755,8175,3578717491,3578717527,36
1,755,8176,3578717491,3578717527,36
1,755,8177,3578717491,3578717527,36
1,755,8178,3578717491,3578717530,39
1,755,8179,3578717491,3578717531,40
1,755,8180,3578717491,3578717532,41
1,755,8181,3578717491,3578717533,42
1,755,8182,3578717491,3578717535,44
1,756,8183,3578717545,3578717545,0
1,756,8184,3578717545,3578717545,0
1,756,8185,3578717545,3578717545,0
1,756,8186,3578717545,3578717545,0
1,756,8187,3578717545,3578717547,2
1,756,8188,3578717545,3578717549,4
1,756,8189,3578717545,3578717550,5
1,756,8190,3578717545,3578717553,8
1,756,8191,3578717545,3578717554,9
1,756,8192,3578717545,3578717560,15
1,756,8193,3578717545,3578717561,16
1,756,8194,3578717545,3578717561,16
1,756,8195,3578717545,3578717563,18
1,756,8196,3578717545,3578717565,20
1,756,8197,3578717545,3578717565,20
1,756,8198,3578717545,3578717566,21
1,756,8199,3578717545,3578717566,21
1,756,8200,3578717545,3578717566,21
1,756,8201,3578717545,3578717567,22
1,756,8202,3578717545,3578717571,26
1,756,8203,3578717545,3578717574,29
1,756,8204,3578717545,3578717575,30
1,756,8205,3578717545,3578717575,30
1,756,8206,3578717545,3578717577,32
1,756,8207,3578717545,3578717581,36
1,756,8208,3578717545,3578717582,37
1,756,8209,3578717545,3578717583,38
1,756,8210,3578717545,3578717585,40
1,756,8211,3578717545,3578717588,43
1,756,8212,3578717545,3578717591,46
1,756,8213,3578717545,3578717592,47
1,757,8214,3578717600,3578717600,0
1,757,8215,3578717600,3578717600,0
1,757,8216,3578717600,3578717600,0
1,757,8217,3578717600,3578717600,0
1,757,8218,3578717600,3578717600,0
1,757,8219,3578717600,3578717606,6
1,757,8220,3578717600,3578717609,9
1,757,8221,3578717600,3578717610,10
1,757,8222,3578717600,3578717611,11
1,757,8223,3578717600,3578717612,12
1,757,8224,3578717600,3578717615,15
1,757,8225,3578717600,3578717617,17
1,757,8226,3578717600,3578717617,17
1,757,8227,3578717600,3578717618,18
1,757,8228,3578717600,3578717618,18
1,757,8229,3578717600,3578717620,20
1,757,8230,3578717600,3578717620,20
1,757,8231,3578717600,3578717621,21
1,757,8232,3578717600,3578717622,22
1,757,8233,3578717600,3578717623,23
1,757,8234,3578717600,3578717624,24
1,757,8235,3578717600,3578717627,27
1,757,8236,3578717600,3578717628,28
1,757,8237,3578717600,3578717628,28
1,757,8238,3578717600,3578717628,28
1,757,8239,3578717600,3578717630,30
1,757,8240,3578717600,3578717632,32
1,757,8241,3578717600,3578717634,34
1,757,8242,3578717600,3578717637,37
1,757,8243,3578717600,3578717638,38
1,757,8244,3578717600,3578717638,38
1,757,8245,3578717600,3578717639,39
1,757,8246,3578717600,3578717643,43
1,757,8247,3578717600,3578717647,47
1,757,8248,3578717600,3578717647,47
1,757,8249,3578717600,3578717649,49
1,758,8250,3578717654,3578717654,0
1,758,8251,3578717654,3578717654,0
1,758,8252,3578717654,3578717654,0
1,758,8253,3578717654,3578717655,1
1,758,8254,3578717654,3578717655,1
1,758,8255,3578717654,3578717656,2
1,758,8256,3578717654,3578717656,2
1,758,8257,3578717654,3578717658,4
1,758,8258,3578717654,3578717658,4
1,758,8259,3578717654,3578717659,5
1,758,8260,3578717654,3578717661,7
1,758,8261,3578717654,3578717663,9
1,758,8262,3578717654,3578717664,10
1,758,8263,3578717654,3578717675,21
1,758,8264,3578717654,3578717680,26
1,758,8265,3578717654,3578717681,27
1,758,8266,3578717654,3578717684,30
1,758,8267,3578717654,3578717684,30
1,758,8268,3578717654,3578717684,30
1,758,8269,3578717654,3578717685,31
1,758,8270,3578717654,3578717685,31
1,758,8271,3578717654,3578717686,32
1,758,8272,3578717654,3578717688,34
1,758,8273,3578717654,3578717689,35
1,758,8274,3578717654,3578717689,35
1,758,8275,3578717654,3578717690,36
1,758,8276,3578717654,3578717691,37
1,758,8277,3578717654,3578717693,39
1,758,8278,3578717654,3578717695,41
1,758,8279,3578717654,3578717697,43
1,758,8280,3578717654,3578717698,44
1,758,8281,3578717654,3578717699,45
1,758,8282,3578717654,3578717699,45
1,758,8283,3578717654,3578717701,47
1,758,8284,3578717654,3578717703,49
1,759,8285,3578717709,3578717709,0
1,759,8286,3578717709,3578717709,0
1,759,8287,3578717709,3578717710,1
1,759,8288,3578717709,3578717711,2
1,759,8289,3578717709,3578717715,6
1,759,8290,3578717709,3578717717,8
1,759,8291,3578717709,3578717718,9
1,759,8292,3578717709,3578717719,10
1,759,8293,3578717709,3578717720,11
1,759,8294,3578717709,3578717720,11
1,759,8295,3578717709,3578717722,13
1,759,8296,3578717709,3578717722,13
1,759,8297,3578717709,3578717723,14
1,759,8298,3578717709,3578717723,14
1,759,8299,3578717709,3578717724,15
1,759,8300,3578717709,3578717726,17
1,759,8301,3578717709,3578717727,18
1,759,8302,3578717709,3578717727,18
1,759,8303,3578717709,3578717727,18
1,759,8304,3578717709,3578717730,21
1,759,8305,3578717709,3578717730,21
1,759,8306,3578717709,3578717733,24
1,759,8307,3578717709,3578717734,25
1,759,8308,3578717709,3578717735,26
1,759,8309,3578717709,3578717742,33
1,759,8310,3578717709,3578717742,33
1,759,8311,3578717709,3578717744,35
1,759,8312,3578717709,3578717745,36
1,759,8313,3578717709,3578717748,39
1,759,8314,3578717709,3578717748,39
1,759,8315,3578717709,3578717749,40
1,759,8316,3578717709,3578717749,40
1,759,8317,3578717709,3578717752,43
1,759,8318,3578717709,3578717754,45
1,760,8319,3578717764,3578717764,0
1,760,8320,3578717764,3578717764,0
1,760,8321,3578717764,3578717764,0
1,760,8322,3578717764,3578717764,0
1,760,8323,3578717764,3578717765,1
1,760,8324,3578717764,3578717765,1
1,760,8325,3578717764,3578717766,2
1,760,8326,3578717764,3578717766,2
1,760,8327,3578717764,3578717766,2
1,760,8328,3578717764,3578717767,3
1,760,8329,3578717764,3578717770,6
1,760,8330,3578717764,3578717774,10
1,760,8331,3578717764,3578717775,11
1,760,8332,3578717764,3578717776,12
1,760,8333,3578717764,3578717778,14
1,760,8334,3578717764,3578717781,17
1,760,8335,3578717764,3578717782,18
1,760,8336,3578717764,3578717783,19
1,760,8337,3578717764,3578717785,21
1,760,8338,3578717764,3578717788,24
1,760,8339,3578717764,3578717791,27
1,760,8340,3578717764,3578717793,29
1,760,8341,3578717764,3578717797,33
1,760,8342,3578717764,3578717798,34
1,760,8343,3578717764,3578717800,36
1,760,8344,3578717764,3578717801,37
1,760,8345,3578717764,3578717806,42
1,760,8346,3578717764,3578717809,45
1,760,8347,3578717764,3578717811,47
1,760,8348,3578717764,3578717812,48
1,760,8349,3578717764,3578717812,48
1,761,8350,3578717818,3578717818,0
1,761,8351,3578717818,3578717818,0
1,761,8352,3578717818,3578717818,0
1,761,8353,3578717818,3578717818,0
1,761,8354,3578717818,3578717821,3
1,761,8355,3578717818,3578717821,3
1,761,8356,3578717818,3578717822,4
1,761,8357,3578717818,3578717822,4
1,761,8358,3578717818,3578717825,7
1,761,8359,3578717818,3578717825,7
1,761,8360,3578717818,3578717826,8
1,761,8361,3578717818,3578717827,9
1,761,8362,3578717818,3578717828,10
1,761,8363,3578717818,3578717829,11
1,761,8364,3578717818,3578717829,11
1,761,8365,3578717818,3578717831,13
1,761,8366,3578717818,3578717831,13
1,761,8367,3578717818,3578717834,16
1,761,8368,3578717818,3578717837,19
1,761,8369,3578717818,3578717838,20
1,761,8370,3578717818,3578717838,20
1,761,8371,3578717818,3578717839,21
1,761,8372,3578717818,3578717843,25
1,761,8373,3578717818,3578717847,29
1,761,8374,3578717818,3578717848,30
1,761,8375,3578717818,3578717850,32
1,761,8376,3578717818,3578717850,32
1,761,8377,3578717818,3578717853,35
1,761,8378,3578717818,3578717854,36
1,761,8379,3578717818,3578717855,37
1,761,8380,3578717818,3578717855,37
1,761,8381,3578717818,3578717856,38
1,761,8382,3578717818,3578717857,39
1,761,8383,3578717818,3578717858,40
1,761,8384,3578717818,3578717858,40
1,761,8385,3578717818,3578717859,41
1,761,8386,3578717818,3578717862,44
1,761,8387,3578717818,3578717862,44
1,761,8388,3578717818,3578717864,46
1,762,8389,3578717873,3578717876,3
1,762,8390,3578717873,3578717880,7
1,762,8391,3578717873,3578717881,8
1,762,8392,3578717873,3578717883,10
1,762,8393,3578717873,3578717884,11
1,762,8394,3578717873,3578717884,11
1,762,8395,3578717873,3578717884,11
1,762,8396,3578717873,3578717885,12
1,762,8397,3578717873,3578717886,13
1,762,8398,3578717873,3578717887,14
1,762,8399,3578717873,3578717889,16
1,762,8400,3578717873,3578717889,16
1,762,8401,3578717873,3578717890,17
1,762,8402,3578717873,3578717891,18
1,762,8403,3578717873,3578717893,20
1,762,8404,3578717873,3578717896,23
1,762,8405,3578717873,3578717897,24
1,762,8406,3578717873,3578717897,24
1,762,8407,3578717873,3578717899,26
1,762,8408,3578717873,3578717900,27
1,762,8409,3578717873,3578717901,28
1,762,8410,3578717873,3578717907,34
1,762,8411,3578717873,3578717909,36
1,762,8412,3578717873,3578717910,37
1,762,8413,3578717873,3578717913,40
1,762,8414,3578717873,3578717914,41
1,762,8415,3578717873,3578717917,44
1,762,8416,3578717873,3578717917,44
1,762,8417,3578717873,3578717917,44
1,762,8418,3578717873,3578717919,46
1,762,8419,3578717873,3578717920,47
1,762,8420,3578717873,3578717920,47
1,762,8421,3578717873,3578717922,49
1,762,8422,3578717873,3578717923,50
1,763,8423,3578717928,3578717928,0
1,763,8424,3578717928,3578717928,0
1,763,8425,3578717928,3578717928,0
1,763,8426,3578717928,3578717928,0
1,763,8427,3578717928,3578717928,0
1,763,8428,3578717928,3578717928,0
1,763,8429,3578717928,3578717929,1
1,763,8430,3578717928,3578717930,2
1,763,8431,3578717928,3578717930,2
1,763,8432,3578717928,3578717933,5
1,763,8433,3578717928,3578717934,6
1,763,8434,3578717928,3578717936,8
1,763,8435,3578717928,3578717942,14
1,763,8436,3578717928,3578717943,15
1,763,8437,3578717928,3578717944,16
1,763,8438,3578717928,3578717945,17
1,763,8439,3578717928,3578717948,20
1,763,8440,3578717928,3578717948,20
1,763,8441,3578717928,3578717949,21
1,763,8442,3578717928,3578717950,22
1,763,8443,3578717928,3578717952,24
1,763,8444,3578717928,3578717955,27
1,763,8445,3578717928,3578717958,30
1,763,8446,3578717928,3578717962,34
1,763,8447,3578717928,3578717962,34
1,763,8448,3578717928,3578717962,34
1,763,8449,3578717928,3578717963,35
1,763,8450,3578717928,3578717965,37
1,763,8451,3578717928,3578717965,37
1,763,8452,3578717928,3578717965,37
1,763,8453,3578717928,3578717965,37
1,763,8454,3578717928,3578717966,38
1,763,8455,3578717928,3578717967,39
1,763,8456,3578717928,3578717970,42
1,763,8457,3578717928,3578717975,47
1,763,8458,3578717928,3578717975,47
1,763,8459,3578717928,3578717975,47
1,764,8460,3578717983,3578717983,0
1,764,8461,3578717983,3578717983,0
1,764,8462,3578717983,3578717983,0
1,764,8463,3578717983,3578717983,0
1,764,8464,3578717983,3578717986,3
1,764,8465,3578717983,3578717989,6
1,764,8466,3578717983,3578717992,9
1,764,8467,3578717983,3578717992,9
1,764,8468,3578717983,3578717997,14
1,764,8469,3578717983,3578717998,15
1,764,8470,3578717983,3578717999,16
1,764,8471,3578717983,3578717999,16
1,764,8472,3578717983,3578717999,16
1,764,8473,3578717983,3578718001,18
1,764,8474,3578717983,3578718006,23
1,764,8475,3578717983,3578718009,26
1,764,8476,3578717983,3578718011,28
1,764,8477,3578717983,3578718012,29
1,764,8478,3578717983,3578718013,30
1,764,8479,3578717983,3578718016,33
1,764,8480,3578717983,3578718016,33
1,764,8481,3578717983,3578718017,34
1,764,8482,3578717983,3578718018,35
1,764,8483,3578717983,3578718019,36
1,764,8484,3578717983,3578718020,37
1,764,8485,3578717983,3578718021,38
1,764,8486,3578717983,3578718021,38
1,764,8487,3578717983,3578718022,39
1,764,8488,3578717983,3578718025,42
1,764,8489,3578717983,3578718025,42
1,764,8490,3578717983,3578718026,43
1,764,8491,3578717983,3578718028,45
1,764,8492,3578717983,3578718029,46
1,764,8493,3578717983,3578718029,46
1,764,8494,3578717983,3578718029,46
1,764,8495,3578717983,3578718030,47
1,764,8496,3578717983,3578718032,49
1,765,8497,3578718037,3578718037,0
1,765,8498,3578718037,3578718037,0
1,765,8499,3578718037,3578718039,2
1,765,8500,3578718037,3578718039,2
1,765,8501,3578718037,3578718040,3
1,765,8502,3578718037,3578718043,6
1,765,8503,3578718037,3578718048,11
1,765,8504,3578718037,3578718051,14
1,765,8505,3578718037,3578718051,14
1,765,8506,3578718037,3578718053,16
1,765,8507,3578718037,3578718055,18
1,765,8508,3578718037,3578718055,18
1,765,8509,3578718037,3578718056,19
1,765,8510,3578718037,3578718056,19
1,765,8511,3578718037,3578718057,20
1,765,8512,3578718037,3578718058,21
1,765,8513,3578718037,3578718059,22
1,765,8514,3578718037,3578718060,23
1,765,8515,3578718037,3578718060,23
1,765,8516,3578718037,3578718062,25
1,765,8517,3578718037,3578718063,26
1,765,8518,3578718037,3578718065,28
1,765,8519,3578718037,3578718076,39
1,765,8520,3578718037,3578718080,43
1,765,8521,3578718037,3578718083,46
1,765,8522,3578718037,3578718083,46
1,765,8523,3578718037,3578718084,47
1,765,8524,3578718037,3578718084,47
1,765,8525,3578718037,3578718085,48
1,765,8526,3578718037,3578718085,48
1,765,8527,3578718037,3578718086,49
1,766,8528,3578718091,3578718091,0
1,766,8529,3578718091,3578718091,0
1,766,8530,3578718091,3578718091,0
1,766,8531,3578718091,3578718091,0
1,766,8532,3578718091,3578718091,0
1,766,8533,3578718091,3578718092,1
1,766,8534,3578718091,3578718096,5
1,766,8535,3578718091,3578718097,6
1,766,8536,3578718091,3578718098,7
1,766,8537,3578718091,3578718099,8
1,766,8538,3578718091,3578718101,10
1,766,8539,3578718091,3578718103,12
1,766,8540,3578718091,3578718107,16
1,766,8541,3578718091,3578718107,16
1,766,8542,3578718091,3578718109,18
1,766,8543,3578718091,3578718110,19
1,766,8544,3578718091,3578718112,21
1,766,8545,3578718091,3578718116,25
1,766,8546,3578718091,3578718117,26
1,766,8547,3578718091,3578718117,26
1,766,8548,3578718091,3578718117,26
1,766,8549,3578718091,3578718120,29
1,766,8550,3578718091,3578718120,29
1,766,8551,3578718091,3578718121,30
1,766,8552,3578718091,3578718122,31
1,766,8553,3578718091,3578718123,32
1,766,8554,3578718091,3578718123,32
1,766,8555,3578718091,3578718124,33
1,766,8556,3578718091,3578718124,33
1,766,8557,3578718091,3578718124,33
1,766,8558,3578718091,3578718126,35
1,766,8559,3578718091,3578718127,36
1,766,8560,3578718091,3578718128,37
1,766,8561,3578718091,3578718130,39
1,766,8562,3578718091,3578718131,40
1,766,8563,3578718091,3578718133,42
1,766,8564,3578718091,3578718134,43
1,766,8565,3578718091,3578718136,45
1,767,8566,3578718145,3578718145,0
1,767,8567,3578718145,3578718145,0
1,767,8568,3578718145,3578718145,0
1,767,8569,3578718145,3578718148,3
1,767,8570,3578718145,3578718148,3
1,767,8571,3578718145,3578718149,4
1,767,8572,3578718145,3578718151,6
1,767,8573,3578718145,3578718153,8
1,767,8574,3578718145,3578718154,9
1,767,8575,3578718145,3578718158,13
1,767,8576,3578718145,3578718161,16
1,767,8577,3578718145,3578718162,17
1,767,8578,3578718145,3578718162,17
1,767,8579,3578718145,3578718164,19
1,767,8580,3578718145,3578718165,20
1,767,8581,3578718145,3578718165,20
1,767,8582,3578718145,3578718166,21
1,767,8583,3578718145,3578718166,21
1,767,8584,3578718145,3578718166,21
1,767,8585,3578718145,3578718167,22
1,767,8586,3578718145,3578718168,23
1,767,8587,3578718145,3578718170,25
1,767,8588,3578718145,3578718175,30
1,767,8589,3578718145,3578718176,31
1,767,8590,3578718145,3578718177,32
1,767,8591,3578718145,3578718178,33
1,767,8592,3578718145,3578718182,37
1,767,8593,3578718145,3578718184,39
1,767,8594,3578718145,3578718186,41
1,767,8595,3578718145,3578718189,44
1,767,8596,3578718145,3578718191,46
1,767,8597,3578718145,3578718193,48
1,768,8598,3578718199,3578718199,0
1,768,8599,3578718199,3578718199,0
1,768,8600,3578718199,3578718199,0
1,768,8601,3578718199,3578718199,0
1,768,8602,3578718199,3578718202,3
1,768,8603,3578718199,3578718206,7
1,768,8604,3578718199,3578718209,10
1,768,8605,3578718199,3578718211,12
1,768,8606,3578718199,3578718212,13
1,768,8607,3578718199,3578718212,13
1,768,8608,3578718199,3578718216,17
1,768,8609,3578718199,3578718217,18
1,768,8610,3578718199,3578718217,18
1,768,8611,3578718199,3578718218,19
1,768,8612,3578718199,3578718219,20
1,768,8613,3578718199,3578718220,21
1,768,8614,3578718199,3578718220,21
1,768,8615,3578718199,3578718222,23
1,768,8616,3578718199,3578718222,23
1,768,8617,3578718199,3578718224,25
1,768,8618,3578718199,3578718224,25
1,768,8619,3578718199,3578718227,28
1,768,8620,3578718199,3578718228,29
1,768,8621,3578718199,3578718228,29
1,768,8622,3578718199,3578718229,30
1,768,8623,3578718199,3578718229,30
1,768,8624,3578718199,3578718231,32
1,768,8625,3578718199,3578718231,32
1,768,8626,3578718199,3578718234,35
1,768,8627,3578718199,3578718237,38
1,768,8628,3578718199,3578718238,39
1,768,8629,3578718199,3578718239,40
1,768,8630,3578718199,3578718240,41
1,768,8631,3578718199,3578718244,45
1,768,8632,3578718199,3578718248,49
1,768,8633,3578718199,3578718249,50
1,769,8634,3578718254,3578718254,0
1,769,8635,3578718254,3578718254,0
1,769,8636,3578718254,3578718254,0
1,769,8637,3578718254,3578718255,1
1,769,8638,3578718254,3578718256,2
1,769,8639,3578718254,3578718257,3
1,769,8640,3578718254,3578718257,3
1,769,8641,3578718254,3578718258,4
1,769,8642,3578718254,3578718259,5
1,769,8643,3578718254,3578718259,5
1,769,8644,3578718254,3578718260,6
1,769,8645,3578718254,3578718263,9
1,769,8646,3578718254,3578718264,10
1,769,8647,3578718254,3578718265,11
1,769,8648,3578718254,3578718276,22
1,769,8649,3578718254,3578718280,26
1,769,8650,3578718254,3578718283,29
1,769,8651,3578718254,3578718283,29
1,769,8652,3578718254,3578718284,30
1,769,8653,3578718254,3578718286,32
1,769,8654,3578718254,3578718286,32
1,769,8655,3578718254,3578718286,32
1,769,8656,3578718254,3578718287,33
1,769,8657,3578718254,3578718290,36
1,769,8658,3578718254,3578718290,36
1,769,8659,3578718254,3578718291,37
1,769,8660,3578718254,3578718291,37
1,769,8661,3578718254,3578718292,38
1,769,8662,3578718254,3578718296,42
1,769,8663,3578718254,3578718298,44
1,769,8664,3578718254,3578718298,44
1,769,8665,3578718254,3578718300,46
1,769,8666,3578718254,3578718301,47
1,769,8667,3578718254,3578718303,49
1,770,8668,3578718309,3578718309,0
1,770,8669,3578718309,3578718309,0
1,770,8670,3578718309,3578718309,0
1,770,8671,3578718309,3578718310,1
1,770,8672,3578718309,3578718313,4
1,770,8673,3578718309,3578718316,7
1,770,8674,3578718309,3578718318,9
1,770,8675,3578718309,3578718318,9
1,770,8676,3578718309,3578718319,10
1,770,8677,3578718309,3578718319,10
1,770,8678,3578718309,3578718320,11
1,770,8679,3578718309,3578718320,11
1,770,8680,3578718309,3578718322,13
1,770,8681,3578718309,3578718323,14
1,770,8682,3578718309,3578718323,14
1,770,8683,3578718309,3578718323,14
1,770,8684,3578718309,3578718325,16
1,770,8685,3578718309,3578718325,16
1,770,8686,3578718309,3578718326,17
1,770,8687,3578718309,3578718328,19
1,770,8688,3578718309,3578718328,19
1,770,8689,3578718309,3578718328,19
1,770,8690,3578718309,3578718331,22
1,770,8691,3578718309,3578718331,22
1,770,8692,3578718309,3578718333,24
1,770,8693,3578718309,3578718334,25
1,770,8694,3578718309,3578718336,27
1,770,8695,3578718309,3578718341,32
1,770,8696,3578718309,3578718344,35
1,770,8697,3578718309,3578718345,36
1,770,8698,3578718309,3578718349,40
1,770,8699,3578718309,3578718349,40
1,770,8700,3578718309,3578718350,41
1,770,8701,3578718309,3578718351,42
1,770,8702,3578718309,3578718354,45
1,770,8703,3578718309,3578718354,45
1,770,8704,3578718309,3578718358,49
1,771,8705,3578718363,3578718363,0
1,771,8706,3578718363,3578718363,0
1,771,8707,3578718363,3578718363,0
1,771,8708,3578718363,3578718364,1
1,771,8709,3578718363,3578718366,3
1,771,8710,3578718363,3578718366,3
1,771,8711,3578718363,3578718366,3
1,771,8712,3578718363,3578718367,4
1,771,8713,3578718363,3578718367,4
1,771,8714,3578718363,3578718367,4
1,771,8715,3578718363,3578718367,4
1,771,8716,3578718363,3578718371,8
1,771,8717,3578718363,3578718375,12
1,771,8718,3578718363,3578718376,13
1,771,8719,3578718363,3578718378,15
1,771,8720,3578718363,3578718379,16
1,771,8721,3578718363,3578718381,18
1,771,8722,3578718363,3578718382,19
1,771,8723,3578718363,3578718383,20
1,771,8724,3578718363,3578718386,23
1,771,8725,3578718363,3578718389,26
1,771,8726,3578718363,3578718391,28
1,771,8727,3578718363,3578718394,31
1,771,8728,3578718363,3578718397,34
1,771,8729,3578718363,3578718399,36
1,771,8730,3578718363,3578718399,36
1,771,8731,3578718363,3578718399,36
1,771,8732,3578718363,3578718399,36
1,771,8733,3578718363,3578718402,39
1,771,8734,3578718363,3578718406,43
1,771,8735,3578718363,3578718410,47
1,771,8736,3578718363,3578718411,48
1,771,8737,3578718363,3578718412,49
1,772,8738,3578718418,3578718418,0
1,772,8739,3578718418,3578718418,0
1,772,8740,3578718418,3578718418,0
1,772,8741,3578718418,3578718418,0
1,772,8742,3578718418,3578718418,0
1,772,8743,3578718418,3578718419,1
1,772,8744,3578718418,3578718420,2
1,772,8745,3578718418,3578718420,2
1,772,8746,3578718418,3578718421,3
1,772,8747,3578718418,3578718422,4
1,772,8748,3578718418,3578718424,6
1,772,8749,3578718418,3578718424,6
1,772,8750,3578718418,3578718427,9
1,772,8751,3578718418,3578718429,11
1,772,8752,3578718418,3578718429,11
1,772,8753,3578718418,3578718430,12
1,772,8754,3578718418,3578718430,12
1,772,8755,3578718418,3578718431,13
1,772,8756,3578718418,3578718432,14
1,772,8757,3578718418,3578718434,16
1,772,8758,3578718418,3578718437,19
1,772,8759,3578718418,3578718439,21
1,772,8760,3578718418,3578718440,22
1,772,8761,3578718418,3578718440,22
1,772,8762,3578718418,3578718445,27
1,772,8763,3578718418,3578718449,31
1,772,8764,3578718418,3578718449,31
1,772,8765,3578718418,3578718451,33
1,772,8766,3578718418,3578718452,34
1,772,8767,3578718418,3578718456,38
1,772,8768,3578718418,3578718457,39
1,772,8769,3578718418,3578718457,39
1,772,8770,3578718418,3578718457,39
1,772,8771,3578718418,3578718457,39
1,772,8772,3578718418,3578718459,41
1,772,8773,3578718418,3578718459,41
1,772,8774,3578718418,3578718462,44
1,772,8775,3578718418,3578718463,45
1,772,8776,3578718418,3578718464,46
1,773,8777,3578718473,3578718473,0
1,773,8778,3578718473,3578718476,3
1,773,8779,3578718473,3578718480,7
1,773,8780,3578718473,3578718482,9
1,773,8781,3578718473,3578718483,10
1,773,8782,3578718473,3578718484,11
1,773,8783,3578718473,3578718485,12
1,773,8784,3578718473,3578718485,12
1,773,8785,3578718473,3578718486,13
1,773,8786,3578718473,3578718486,13
1,773,8787,3578718473,3578718488,15
1,773,8788,3578718473,3578718489,16
1,773,8789,3578718473,3578718491,18
1,773,8790,3578718473,3578718491,18
1,773,8791,3578718473,3578718491,18
1,773,8792,3578718473,3578718492,19
1,773,8793,3578718473,3578718496,23
1,773,8794,3578718473,3578718498,25
1,773,8795,3578718473,3578718498,25
1,773,8796,3578718473,3578718499,26
1,773,8797,3578718473,3578718500,27
1,773,8798,3578718473,3578718501,28
1,773,8799,3578718473,3578718503,30
1,773,8800,3578718473,3578718506,33
1,773,8801,3578718473,3578718507,34
1,773,8802,3578718473,3578718509,36
1,773,8803,3578718473,3578718510,37
1,773,8804,3578718473,3578718513,40
1,773,8805,3578718473,3578718515,42
1,773,8806,3578718473,3578718518,45
1,773,8807,3578718473,3578718518,45
1,773,8808,3578718473,3578718518,45
1,773,8809,3578718473,3578718519,46
1,773,8810,3578718473,3578718519,46
1,773,8811,3578718473,3578718520,47
1,773,8812,3578718473,3578718521,48
1,773,8813,3578718473,3578718522,49
1,774,8814,3578718528,3578718528,0
1,774,8815,3578718528,3578718528,0
1,774,8816,3578718528,3578718528,0
1,774,8817,3578718528,3578718528,0
1,774,8818,3578718528,3578718528,0
1,774,8819,3578718528,3578718528,0
1,774,8820,3578718528,3578718528,0
1,774,8821,3578718528,3578718528,0
1,774,8822,3578718528,3578718528,0
1,774,8823,3578718528,3578718530,2
1,774,8824,3578718528,3578718530,2
1,774,8825,3578718528,3578718533,5
1,774,8826,3578718528,3578718533,5
1,774,8827,3578718528,3578718535,7
1,774,8828,3578718528,3578718542,14
1,774,8829,3578718528,3578718543,15
1,774,8830,3578718528,3578718544,16
1,774,8831,3578718528,3578718544,16
1,774,8832,3578718528,3578718547,19
1,774,8833,3578718528,3578718547,19
1,774,8834,3578718528,3578718549,21
1,774,8835,3578718528,3578718550,22
1,774,8836,3578718528,3578718552,24
1,774,8837,3578718528,3578718554,26
1,774,8838,3578718528,3578718558,30
1,774,8839,3578718528,3578718561,33
1,774,8840,3578718528,3578718561,33
1,774,8841,3578718528,3578718562,34
1,774,8842,3578718528,3578718563,35
1,774,8843,3578718528,3578718565,37
1,774,8844,3578718528,3578718565,37
1,774,8845,3578718528,3578718566,38
1,774,8846,3578718528,3578718566,38
1,774,8847,3578718528,3578718566,38
1,774,8848,3578718528,3578718567,39
1,774,8849,3578718528,3578718567,39
1,774,8850,3578718528,3578718570,42
1,774,8851,3578718528,3578718574,46
1,774,8852,3578718528,3578718575,47
1,774,8853,3578718528,3578718576,48
1,774,8854,3578718528,3578718577,49
1,775,8855,3578718584,3578718584,0
1,775,8856,3578718584,3578718584,0
1,775,8857,3578718584,3578718585,1
1,775,8858,3578718584,3578718588,4
1,775,8859,3578718584,3578718591,7
1,775,8860,3578718584,3578718593,9
1,775,8861,3578718584,3578718596,12
1,775,8862,3578718584,3578718597,13
1,775,8863,3578718584,3578718598,14
1,775,8864,3578718584,3578718599,15
1,775,8865,3578718584,3578718601,17
1,775,8866,3578718584,3578718606,22
1,775,8867,3578718584,3578718609,25
1,775,8868,3578718584,3578718610,26
1,775,8869,3578718584,3578718611,27
1,775,8870,3578718584,3578718612,28
1,775,8871,3578718584,3578718616,32
1,775,8872,3578718584,3578718617,33
1,775,8873,3578718584,3578718617,33
1,775,8874,3578718584,3578718617,33
1,775,8875,3578718584,3578718618,34
1,775,8876,3578718584,3578718619,35
1,775,8877,3578718584,3578718620,36
1,775,8878,3578718584,3578718621,37
1,775,8879,3578718584,3578718621,37
1,775,8880,3578718584,3578718624,40
1,775,8881,3578718584,3578718624,40
1,775,8882,3578718584,3578718627,43
1,775,8883,3578718584,3578718628,44
1,775,8884,3578718584,3578718629,45
1,775,8885,3578718584,3578718629,45
1,775,8886,3578718584,3578718630,46
1,775,8887,3578718584,3578718631,47
1,775,8888,3578718584,3578718633,49
1,776,8889,3578718638,3578718638,0
1,776,8890,3578718638,3578718638,0
1,776,8891,3578718638,3578718639,1
1,776,8892,3578718638,3578718639,1
1,776,8893,3578718638,3578718643,5
1,776,8894,3578718638,3578718648,10
1,776,8895,3578718638,3578718648,10
1,776,8896,3578718638,3578718648,10
1,776,8897,3578718638,3578718651,13
1,776,8898,3578718638,3578718652,14
1,776,8899,3578718638,3578718653,15
1,776,8900,3578718638,3578718655,17
1,776,8901,3578718638,3578718655,17
1,776,8902,3578718638,3578718656,18
1,776,8903,3578718638,3578718656,18
1,776,8904,3578718638,3578718657,19
1,776,8905,3578718638,3578718658,20
1,776,8906,3578718638,3578718659,21
1,776,8907,3578718638,3578718662,24
1,776,8908,3578718638,3578718662,24
1,776,8909,3578718638,3578718663,25
1,776,8910,3578718638,3578718668,30
1,776,8911,3578718638,3578718675,37
1,776,8912,3578718638,3578718680,42
1,776,8913,3578718638,3578718682,44
1,776,8914,3578718638,3578718683,45
1,776,8915,3578718638,3578718684,46
1,776,8916,3578718638,3578718684,46
1,776,8917,3578718638,3578718686,48
1,776,8918,3578718638,3578718686,48
1,776,8919,3578718638,3578718686,48
1,776,8920,3578718638,3578718687,49
1,777,8921,3578718693,3578718693,0
1,777,8922,3578718693,3578718693,0
1,777,8923,3578718693,3578718693,0
1,777,8924,3578718693,3578718693,0
1,777,8925,3578718693,3578718693,0
1,777,8926,3578718693,3578718698,5
1,777,8927,3578718693,3578718698,5
1,777,8928,3578718693,3578718701,8
1,777,8929,3578718693,3578718701,8
1,777,8930,3578718693,3578718704,11
1,777,8931,3578718693,3578718707,14
1,777,8932,3578718693,3578718708,15
1,777,8933,3578718693,3578718709,16
1,777,8934,3578718693,3578718710,17
1,777,8935,3578718693,3578718713,20
1,777,8936,3578718693,3578718715,22
1,777,8937,3578718693,3578718718,25
1,777,8938,3578718693,3578718718,25
1,777,8939,3578718693,3578718719,26
1,777,8940,3578718693,3578718719,26
1,777,8941,3578718693,3578718719,26
1,777,8942,3578718693,3578718720,27
1,777,8943,3578718693,3578718720,27
1,777,8944,3578718693,3578718722,29
1,777,8945,3578718693,3578718723,30
1,777,8946,3578718693,3578718723,30
1,777,8947,3578718693,3578718724,31
1,777,8948,3578718693,3578718725,32
1,777,8949,3578718693,3578718725,32
1,777,8950,3578718693,3578718725,32
1,777,8951,3578718693,3578718727,34
1,777,8952,3578718693,3578718727,34
1,777,8953,3578718693,3578718728,35
1,777,8954,3578718693,3578718730,37
1,777,8955,3578718693,3578718733,40
1,777,8956,3578718693,3578718733,40
1,777,8957,3578718693,3578718735,42
1,777,8958,3578718693,3578718742,49
1,777,8959,3578718693,3578718742,49
1,778,8960,3578718747,3578718747,0
1,778,8961,3578718747,3578718747,0
1,778,8962,3578718747,3578718747,0
1,778,8963,3578718747,3578718748,1
1,778,8964,3578718747,3578718748,1
1,778,8965,3578718747,3578718749,2
1,778,8966,3578718747,3578718753,6
1,778,8967,3578718747,3578718754,7
1,778,8968,3578718747,3578718757,10
1,778,8969,3578718747,3578718761,14
1,778,8970,3578718747,3578718761,14
1,778,8971,3578718747,3578718763,16
1,778,8972,3578718747,3578718764,17
1,778,8973,3578718747,3578718765,18
1,778,8974,3578718747,3578718765,18
1,778,8975,3578718747,3578718766,19
1,778,8976,3578718747,3578718766,19
1,778,8977,3578718747,3578718767,20
1,778,8978,3578718747,3578718768,21
1,778,8979,3578718747,3578718770,23
1,778,8980,3578718747,3578718774,27
1,778,8981,3578718747,3578718775,28
1,778,8982,3578718747,3578718777,30
1,778,8983,3578718747,3578718778,31
1,778,8984,3578718747,3578718780,33
1,778,8985,3578718747,3578718781,34
1,778,8986,3578718747,3578718783,36
1,778,8987,3578718747,3578718785,38
1,778,8988,3578718747,3578718788,41
1,778,8989,3578718747,3578718791,44
1,778,8990,3578718747,3578718793,46
1,778,8991,3578718747,3578718796,49
1,779,8992,3578718803,3578718803,0
1,779,8993,3578718803,3578718803,0
1,779,8994,3578718803,3578718803,0
1,779,8995,3578718803,3578718803,0
1,779,8996,3578718803,3578718803,0
1,779,8997,3578718803,3578718806,3
1,779,8998,3578718803,3578718809,6
1,779,8999,3578718803,3578718811,8
1,779,9000,3578718803,3578718812,9
1,779,9001,3578718803,3578718812,9
1,779,9002,3578718803,3578718816,13
1,779,9003,3578718803,3578718817,14
1,779,9004,3578718803,3578718817,14
1,779,9005,3578718803,3578718817,14
1,779,9006,3578718803,3578718818,15
1,779,9007,3578718803,3578718819,16
1,779,9008,3578718803,3578718819,16
1,779,9009,3578718803,3578718820,17
1,779,9010,3578718803,3578718822,19
1,779,9011,3578718803,3578718824,21
1,779,9012,3578718803,3578718824,21
1,779,9013,3578718803,3578718827,24
1,779,9014,3578718803,3578718828,25
1,779,9015,3578718803,3578718828,25
1,779,9016,3578718803,3578718828,25
1,779,9017,3578718803,3578718830,27
1,779,9018,3578718803,3578718832,29
1,779,9019,3578718803,3578718834,31
1,779,9020,3578718803,3578718836,33
1,779,9021,3578718803,3578718838,35
1,779,9022,3578718803,3578718839,36
1,779,9023,3578718803,3578718839,36
1,779,9024,3578718803,3578718843,40
1,779,9025,3578718803,3578718847,44
1,779,9026,3578718803,3578718848,45
1,779,9027,3578718803,3578718849,46
1,779,9028,3578718803,3578718851,48
1,779,9029,3578718803,3578718852,49
1,780,9030,3578718858,3578718858,0
1,780,9031,3578718858,3578718858,0
1,780,9032,3578718858,3578718858,0
1,780,9033,3578718858,3578718858,0
1,780,9034,3578718858,3578718858,0
1,780,9035,3578718858,3578718858,0
1,780,9036,3578718858,3578718859,1
1,780,9037,3578718858,3578718859,1
1,780,9038,3578718858,3578718860,2
1,780,9039,3578718858,3578718862,4
1,780,9040,3578718858,3578718863,5
1,780,9041,3578718858,3578718864,6
1,780,9042,3578718858,3578718868,10
1,780,9043,3578718858,3578718876,18
1,780,9044,3578718858,3578718880,22
1,780,9045,3578718858,3578718882,24
1,780,9046,3578718858,3578718884,26
1,780,9047,3578718858,3578718885,27
1,780,9048,3578718858,3578718885,27
1,780,9049,3578718858,3578718885,27
1,780,9050,3578718858,3578718886,28
1,780,9051,3578718858,3578718887,29
1,780,9052,3578718858,3578718890,32
1,780,9053,3578718858,3578718891,33
1,780,9054,3578718858,3578718891,33
1,780,9055,3578718858,3578718892,34
1,780,9056,3578718858,3578718892,34
1,780,9057,3578718858,3578718897,39
1,780,9058,3578718858,3578718898,40
1,780,9059,3578718858,3578718898,40
1,780,9060,3578718858,3578718899,41
1,780,9061,3578718858,3578718901,43
1,780,9062,3578718858,3578718901,43
1,780,9063,3578718858,3578718904,46
1,780,9064,3578718858,3578718907,49
1,780,9065,3578718858,3578718908,50
1,781,9066,3578718912,3578718912,0
1,781,9067,3578718912,3578718912,0
1,781,9068,3578718912,3578718912,0
1,781,9069,3578718912,3578718915,3
1,781,9070,3578718912,3578718917,5
1,781,9071,3578718912,3578718918,6
1,781,9072,3578718912,3578718918,6
1,781,9073,3578718912,3578718919,7
1,781,9074,3578718912,3578718919,7
1,781,9075,3578718912,3578718921,9
1,781,9076,3578718912,3578718921,9
1,781,9077,3578718912,3578718922,10
1,781,9078,3578718912,3578718923,11
1,781,9079,3578718912,3578718924,12
1,781,9080,3578718912,3578718924,12
1,781,9081,3578718912,3578718926,14
1,781,9082,3578718912,3578718926,14
1,781,9083,3578718912,3578718927,15
1,781,9084,3578718912,3578718927,15
1,781,9085,3578718912,3578718928,16
1,781,9086,3578718912,3578718930,18
1,781,9087,3578718912,3578718932,20
1,781,9088,3578718912,3578718933,21
1,781,9089,3578718912,3578718933,21
1,781,9090,3578718912,3578718936,24
1,781,9091,3578718912,3578718942,30
1,781,9092,3578718912,3578718943,31
1,781,9093,3578718912,3578718944,32
1,781,9094,3578718912,3578718945,33
1,781,9095,3578718912,3578718948,36
1,781,9096,3578718912,3578718948,36
1,781,9097,3578718912,3578718948,36
1,781,9098,3578718912,3578718950,38
1,781,9099,3578718912,3578718952,40
1,781,9100,3578718912,3578718955,43
1,781,9101,3578718912,3578718957,45
1,781,9102,3578718912,3578718962,50
1,782,9103,3578718967,3578718967,0
1,782,9104,3578718967,3578718967,0
1,782,9105,3578718967,3578718967,0
1,782,9106,3578718967,3578718967,0
1,782,9107,3578718967,3578718967,0
1,782,9108,3578718967,3578718967,0
1,782,9109,3578718967,3578718967,0
1,782,9110,3578718967,3578718968,1
1,782,9111,3578718967,3578718968,1
1,782,9112,3578718967,3578718970,3
1,782,9113,3578718967,3578718974,7
1,782,9114,3578718967,3578718976,9
1,782,9115,3578718967,3578718976,9
1,782,9116,3578718967,3578718979,12
1,782,9117,3578718967,3578718980,13
1,782,9118,3578718967,3578718981,14
1,782,9119,3578718967,3578718984,17
1,782,9120,3578718967,3578718986,19
1,782,9121,3578718967,3578718989,22
1,782,9122,3578718967,3578718991,24
1,782,9123,3578718967,3578718994,27
1,782,9124,3578718967,3578718996,29
1,782,9125,3578718967,3578718996,29
1,782,9126,3578718967,3578718999,32
1,782,9127,3578718967,3578718999,32
1,782,9128,3578718967,3578719000,33
1,782,9129,3578718967,3578719002,35
1,782,9130,3578718967,3578719006,39
1,782,9131,3578718967,3578719010,43
1,782,9132,3578718967,3578719011,44
1,782,9133,3578718967,3578719012,45
1,782,9134,3578718967,3578719013,46
1,782,9135,3578718967,3578719015,48
1,782,9136,3578718967,3578719016,49
1,782,9137,3578718967,3578719017,50
1,783,9138,3578719022,3578719022,0
1,783,9139,3578719022,3578719022,0
1,783,9140,3578719022,3578719022,0
1,783,9141,3578719022,3578719022,0
1,783,9142,3578719022,3578719022,0
1,783,9143,3578719022,3578719022,0
1,783,9144,3578719022,3578719024,2
1,783,9145,3578719022,3578719025,3
1,783,9146,3578719022,3578719027,5
1,783,9147,3578719022,3578719028,6
1,783,9148,3578719022,3578719028,6
1,783,9149,3578719022,3578719029,7
1,783,9150,3578719022,3578719030,8
1,783,9151,3578719022,3578719035,13
1,783,9152,3578719022,3578719037,15
1,783,9153,3578719022,3578719039,17
1,783,9154,3578719022,3578719039,17
1,783,9155,3578719022,3578719039,17
1,783,9156,3578719022,3578719043,21
1,783,9157,3578719022,3578719047,25
1,783,9158,3578719022,3578719048,26
1,783,9159,3578719022,3578719049,27
1,783,9160,3578719022,3578719051,29
1,783,9161,3578719022,3578719053,31
1,783,9162,3578719022,3578719054,32
1,783,9163,3578719022,3578719056,34
1,783,9164,3578719022,3578719057,35
1,783,9165,3578719022,3578719057,35
1,783,9166,3578719022,3578719057,35
1,783,9167,3578719022,3578719057,35
1,783,9168,3578719022,3578719059,37
1,783,9169,3578719022,3578719059,37
1,783,9170,3578719022,3578719063,41
1,783,9171,3578719022,3578719063,41
1,783,9172,3578719022,3578719064,42
1,783,9173,3578719022,3578719068,46
1,784,9174,3578719077,3578719077,0
1,784,9175,3578719077,3578719080,3
1,784,9176,3578719077,3578719083,6
1,784,9177,3578719077,3578719083,6
1,784,9178,3578719077,3578719085,8
1,784,9179,3578719077,3578719085,8
1,784,9180,3578719077,3578719086,9
1,784,9181,3578719077,3578719086,9
1,784,9182,3578719077,3578719086,9
1,784,9183,3578719077,3578719088,11
1,784,9184,3578719077,3578719090,13
1,784,9185,3578719077,3578719092,15
1,784,9186,3578719077,3578719092,15
1,784,9187,3578719077,3578719092,15
1,784,9188,3578719077,3578719096,19
1,784,9189,3578719077,3578719098,21
1,784,9190,3578719077,3578719099,22
1,784,9191,3578719077,3578719099,22
1,784,9192,3578719077,3578719101,24
1,784,9193,3578719077,3578719102,25
1,784,9194,3578719077,3578719103,26
1,784,9195,3578719077,3578719107,30
1,784,9196,3578719077,3578719108,31
1,784,9197,3578719077,3578719109,32
1,784,9198,3578719077,3578719110,33
1,784,9199,3578719077,3578719112,35
1,784,9200,3578719077,3578719116,39
1,784,9201,3578719077,3578719118,41
1,784,9202,3578719077,3578719118,41
1,784,9203,3578719077,3578719119,42
1,784,9204,3578719077,3578719119,42
1,784,9205,3578719077,3578719119,42
1,784,9206,3578719077,3578719120,43
1,784,9207,3578719077,3578719121,44
1,784,9208,3578719077,3578719122,45
1,784,9209,3578719077,3578719124,47
1,784,9210,3578719077,3578719124,47
1,784,9211,3578719077,3578719124,47
1,784,9212,3578719077,3578719125,48
1,784,9213,3578719077,3578719126,49
1,784,9214,3578719077,3578719127,50
1,785,9215,3578719131,3578719131,0
1,785,9216,3578719131,3578719131,0
1,785,9217,3578719131,3578719131,0
1,785,9218,3578719131,3578719131,0
1,785,9219,3578719131,3578719133,2
1,785,9220,3578719131,3578719134,3
1,785,9221,3578719131,3578719136,5
1,785,9222,3578719131,3578719142,11
1,785,9223,3578719131,3578719143,12
1,785,9224,3578719131,3578719144,13
1,785,9225,3578719131,3578719145,14
1,785,9226,3578719131,3578719148,17
1,785,9227,3578719131,3578719148,17
1,785,9228,3578719131,3578719148,17
1,785,9229,3578719131,3578719151,20
1,785,9230,3578719131,3578719153,22
1,785,9231,3578719131,3578719155,24
1,785,9232,3578719131,3578719157,26
1,785,9233,3578719131,3578719162,31
1,785,9234,3578719131,3578719164,33
1,785,9235,3578719131,3578719165,34
1,785,9236,3578719131,3578719165,34
1,785,9237,3578719131,3578719165,34
1,785,9238,3578719131,3578719166,35
1,785,9239,3578719131,3578719167,36
1,785,9240,3578719131,3578719167,36
1,785,9241,3578719131,3578719168,37
1,785,9242,3578719131,3578719169,38
1,785,9243,3578719131,3578719171,40
1,785,9244,3578719131,3578719175,44
1,785,9245,3578719131,3578719175,44
1,785,9246,3578719131,3578719176,45
1,785,9247,3578719131,3578719178,47
1,785,9248,3578719131,3578719181,50
1,786,9249,3578719186,3578719186,0
1,786,9250,3578719186,3578719186,0
1,786,9251,3578719186,3578719186,0
1,786,9252,3578719186,3578719186,0
1,786,9253,3578719186,3578719189,3
1,786,9254,3578719186,3578719191,5
1,786,9255,3578719186,3578719194,8
1,786,9256,3578719186,3578719195,9
1,786,9257,3578719186,3578719196,10
1,786,9258,3578719186,3578719198,12
1,786,9259,3578719186,3578719199,13
1,786,9260,3578719186,3578719199,13
1,786,9261,3578719186,3578719200,14
1,786,9262,3578719186,3578719206,20
1,786,9263,3578719186,3578719210,24
1,786,9264,3578719186,3578719211,25
1,786,9265,3578719186,3578719212,26
1,786,9266,3578719186,3578719216,30
1,786,9267,3578719186,3578719217,31
1,786,9268,3578719186,3578719217,31
1,786,9269,3578719186,3578719218,32
1,786,9270,3578719186,3578719219,33
1,786,9271,3578719186,3578719220,34
1,786,9272,3578719186,3578719220,34
1,786,9273,3578719186,3578719220,34
1,786,9274,3578719186,3578719222,36
1,786,9275,3578719186,3578719224,38
1,786,9276,3578719186,3578719225,39
1,786,9277,3578719186,3578719228,42
1,786,9278,3578719186,3578719228,42
1,786,9279,3578719186,3578719229,43
1,786,9280,3578719186,3578719230,44
1,786,9281,3578719186,3578719236,50
1,787,9282,3578719240,3578719240,0
1,787,9283,3578719240,3578719240,0
1,787,9284,3578719240,3578719240,0
1,787,9285,3578719240,3578719243,3
1,787,9286,3578719240,3578719247,7
1,787,9287,3578719240,3578719249,9
1,787,9288,3578719240,3578719251,11
1,787,9289,3578719240,3578719253,13
1,787,9290,3578719240,3578719256,16
1,787,9291,3578719240,3578719256,16
1,787,9292,3578719240,3578719257,17
1,787,9293,3578719240,3578719257,17
1,787,9294,3578719240,3578719257,17
1,787,9295,3578719240,3578719260,20
1,787,9296,3578719240,3578719262,22
1,787,9297,3578719240,3578719263,23
1,787,9298,3578719240,3578719265,25
1,787,9299,3578719240,3578719268,28
1,787,9300,3578719240,3578719276,36
1,787,9301,3578719240,3578719280,40
1,787,9302,3578719240,3578719282,42
1,787,9303,3578719240,3578719284,44
1,787,9304,3578719240,3578719285,45
1,787,9305,3578719240,3578719285,45
1,787,9306,3578719240,3578719285,45
1,787,9307,3578719240,3578719285,45
1,787,9308,3578719240,3578719286,46
1,787,9309,3578719240,3578719288,48
1,787,9310,3578719240,3578719290,50
1,788,9311,3578719294,3578719294,0
1,788,9312,3578719294,3578719294,0
1,788,9313,3578719294,3578719294,0
1,788,9314,3578719294,3578719296,2
1,788,9315,3578719294,3578719298,4
1,788,9316,3578719294,3578719299,5
1,788,9317,3578719294,3578719299,5
1,788,9318,3578719294,3578719301,7
1,788,9319,3578719294,3578719301,7
1,788,9320,3578719294,3578719304,10
1,788,9321,3578719294,3578719306,12
1,788,9322,3578719294,3578719308,14
1,788,9323,3578719294,3578719309,15
1,788,9324,3578719294,3578719310,16
1,788,9325,3578719294,3578719313,19
1,788,9326,3578719294,3578719315,21
1,788,9327,3578719294,3578719317,23
1,788,9328,3578719294,3578719318,24
1,788,9329,3578719294,3578719319,25
1,788,9330,3578719294,3578719319,25
1,788,9331,3578719294,3578719320,26
1,788,9332,3578719294,3578719321,27
1,788,9333,3578719294,3578719322,28
1,788,9334,3578719294,3578719323,29
1,788,9335,3578719294,3578719323,29
1,788,9336,3578719294,3578719324,30
1,788,9337,3578719294,3578719325,31
1,788,9338,3578719294,3578719326,32
1,788,9339,3578719294,3578719328,34
1,788,9340,3578719294,3578719328,34
1,788,9341,3578719294,3578719328,34
1,788,9342,3578719294,3578719331,37
1,788,9343,3578719294,3578719331,37
1,788,9344,3578719294,3578719333,39
1,788,9345,3578719294,3578719334,40
1,788,9346,3578719294,3578719334,40
1,788,9347,3578719294,3578719335,41
1,788,9348,3578719294,3578719342,48
1,788,9349,3578719294,3578719343,49
1,789,9350,3578719349,3578719349,0
1,789,9351,3578719349,3578719349,0
1,789,9352,3578719349,3578719349,0
1,789,9353,3578719349,3578719349,0
1,789,9354,3578719349,3578719349,0
1,789,9355,3578719349,3578719351,2
1,789,9356,3578719349,3578719354,5
1,789,9357,3578719349,3578719354,5
1,789,9358,3578719349,3578719358,9
1,789,9359,3578719349,3578719362,13
1,789,9360,3578719349,3578719364,15
1,789,9361,3578719349,3578719364,15
1,789,9362,3578719349,3578719365,16
1,789,9363,3578719349,3578719366,17
1,789,9364,3578719349,3578719366,17
1,789,9365,3578719349,3578719366,17
1,789,9366,3578719349,3578719366,17
1,789,9367,3578719349,3578719367,18
1,789,9368,3578719349,3578719368,19
1,789,9369,3578719349,3578719368,19
1,789,9370,3578719349,3578719375,26
1,789,9371,3578719349,3578719375,26
1,789,9372,3578719349,3578719376,27
1,789,9373,3578719349,3578719379,30
1,789,9374,3578719349,3578719381,32
1,789,9375,3578719349,3578719381,32
1,789,9376,3578719349,3578719386,37
1,789,9377,3578719349,3578719387,38
1,789,9378,3578719349,3578719387,38
1,789,9379,3578719349,3578719389,40
1,789,9380,3578719349,3578719391,42
1,789,9381,3578719349,3578719394,45
1,789,9382,3578719349,3578719395,46
1,789,9383,3578719349,3578719396,47
1,789,9384,3578719349,3578719398,49
1,789,9385,3578719349,3578719399,50
1,790,9386,3578719405,3578719405,0
1,790,9387,3578719405,3578719405,0
1,790,9388,3578719405,3578719405,0
1,790,9389,3578719405,3578719410,5
1,790,9390,3578719405,3578719411,6
1,790,9391,3578719405,3578719412,7
1,790,9392,3578719405,3578719413,8
1,790,9393,3578719405,3578719417,12
1,790,9394,3578719405,3578719417,12
1,790,9395,3578719405,3578719417,12
1,790,9396,3578719405,3578719417,12
1,790,9397,3578719405,3578719419,14
1,790,9398,3578719405,3578719420,15
1,790,9399,3578719405,3578719420,15
1,790,9400,3578719405,3578719421,16
1,790,9401,3578719405,3578719422,17
1,790,9402,3578719405,3578719424,19
1,790,9403,3578719405,3578719425,20
1,790,9404,3578719405,3578719428,23
1,790,9405,3578719405,3578719428,23
1,790,9406,3578719405,3578719428,23
1,790,9407,3578719405,3578719430,25
1,790,9408,3578719405,3578719431,26
1,790,9409,3578719405,3578719432,27
1,790,9410,3578719405,3578719436,31
1,790,9411,3578719405,3578719437,32
1,790,9412,3578719405,3578719439,34
1,790,9413,3578719405,3578719440,35
1,790,9414,3578719405,3578719440,35
1,790,9415,3578719405,3578719444,39
1,790,9416,3578719405,3578719448,43
1,790,9417,3578719405,3578719449,44
1,790,9418,3578719405,3578719452,47
1,790,9419,3578719405,3578719453,48
1,791,9420,3578719462,3578719462,0
1,791,9421,3578719462,3578719462,0
1,791,9422,3578719462,3578719462,0
1,791,9423,3578719462,3578719462,0
1,791,9424,3578719462,3578719462,0
1,791,9425,3578719462,3578719462,0
1,791,9426,3578719462,3578719462,0
1,791,9427,3578719462,3578719463,1
1,791,9428,3578719462,3578719463,1
1,791,9429,3578719462,3578719465,3
1,791,9430,3578719462,3578719468,6
1,791,9431,3578719462,3578719476,14
1,791,9432,3578719462,3578719480,18
1,791,9433,3578719462,3578719483,21
1,791,9434,3578719462,3578719485,23
1,791,9435,3578719462,3578719486,24
1,791,9436,3578719462,3578719486,24
1,791,9437,3578719462,3578719486,24
1,791,9438,3578719462,3578719486,24
1,791,9439,3578719462,3578719488,26
1,791,9440,3578719462,3578719489,27
1,791,9441,3578719462,3578719491,29
1,791,9442,3578719462,3578719492,30
1,791,9443,3578719462,3578719493,31
1,791,9444,3578719462,3578719494,32
1,791,9445,3578719462,3578719496,34
1,791,9446,3578719462,3578719498,36
1,791,9447,3578719462,3578719499,37
1,791,9448,3578719462,3578719501,39
1,791,9449,3578719462,3578719501,39
1,791,9450,3578719462,3578719504,42
1,791,9451,3578719462,3578719507,45
1,791,9452,3578719462,3578719509,47
1,791,9453,3578719462,3578719510,48
1,792,9454,3578719518,3578719518,0
1,792,9455,3578719518,3578719518,0
1,792,9456,3578719518,3578719518,0
1,792,9457,3578719518,3578719518,0
1,792,9458,3578719518,3578719518,0
1,792,9459,3578719518,3578719518,0
1,792,9460,3578719518,3578719520,2
1,792,9461,3578719518,3578719520,2
1,792,9462,3578719518,3578719521,3
1,792,9463,3578719518,3578719522,4
1,792,9464,3578719518,3578719522,4
1,792,9465,3578719518,3578719522,4
1,792,9466,3578719518,3578719523,5
1,792,9467,3578719518,3578719525,7
1,792,9468,3578719518,3578719525,7
1,792,9469,3578719518,3578719527,9
1,792,9470,3578719518,3578719527,9
1,792,9471,3578719518,3578719528,10
1,792,9472,3578719518,3578719530,12
1,792,9473,3578719518,3578719530,12
1,792,9474,3578719518,3578719532,14
1,792,9475,3578719518,3578719533,15
1,792,9476,3578719518,3578719534,16
1,792,9477,3578719518,3578719535,17
1,792,9478,3578719518,3578719542,24
1,792,9479,3578719518,3578719543,25
1,792,9480,3578719518,3578719544,26
1,792,9481,3578719518,3578719545,27
1,792,9482,3578719518,3578719547,29
1,792,9483,3578719518,3578719547,29
1,792,9484,3578719518,3578719549,31
1,792,9485,3578719518,3578719550,32
1,792,9486,3578719518,3578719552,34
1,792,9487,3578719518,3578719554,36
1,792,9488,3578719518,3578719556,38
1,792,9489,3578719518,3578719561,43
1,792,9490,3578719518,3578719563,45
1,792,9491,3578719518,3578719564,46
1,792,9492,3578719518,3578719565,47
1,792,9493,3578719518,3578719565,47
1,792,9494,3578719518,3578719565,47
1,792,9495,3578719518,3578719565,47
1,792,9496,3578719518,3578719566,48
1,792,9497,3578719518,3578719566,48
1,792,9498,3578719518,3578719567,49
1,792,9499,3578719518,3578719568,50
1,793,9500,3578719572,3578719572,0
1,793,9501,3578719572,3578719574,2
1,793,9502,3578719572,3578719574,2
1,793,9503,3578719572,3578719575,3
1,793,9504,3578719572,3578719578,6
1,793,9505,3578719572,3578719580,8
1,793,9506,3578719572,3578719586,14
1,793,9507,3578719572,3578719586,14
1,793,9508,3578719572,3578719586,14
1,793,9509,3578719572,3578719588,16
1,793,9510,3578719572,3578719590,18
1,793,9511,3578719572,3578719593,21
1,793,9512,3578719572,3578719595,23
1,793,9513,3578719572,3578719596,24
1,793,9514,3578719572,3578719598,26
1,793,9515,3578719572,3578719598,26
1,793,9516,3578719572,3578719599,27
1,793,9517,3578719572,3578719599,27
1,793,9518,3578719572,3578719601,29
1,793,9519,3578719572,3578719606,34
1,793,9520,3578719572,3578719609,37
1,793,9521,3578719572,3578719610,38
1,793,9522,3578719572,3578719611,39
1,793,9523,3578719572,3578719611,39
1,793,9524,3578719572,3578719616,44
1,793,9525,3578719572,3578719616,44
1,793,9526,3578719572,3578719616,44
1,793,9527,3578719572,3578719618,46
1,793,9528,3578719572,3578719619,47
1,793,9529,3578719572,3578719620,48
1,793,9530,3578719572,3578719621,49
1,793,9531,3578719572,3578719621,49
1,794,9532,3578719628,3578719628,0
1,794,9533,3578719628,3578719628,0
1,794,9534,3578719628,3578719628,0
1,794,9535,3578719628,3578719628,0
1,794,9536,3578719628,3578719628,0
1,794,9537,3578719628,3578719629,1
1,794,9538,3578719628,3578719630,2
1,794,9539,3578719628,3578719631,3
1,794,9540,3578719628,3578719635,7
1,794,9541,3578719628,3578719636,8
1,794,9542,3578719628,3578719639,11
1,794,9543,3578719628,3578719639,11
1,794,9544,3578719628,3578719639,11
1,794,9545,3578719628,3578719647,19
1,794,9546,3578719628,3578719647,19
1,794,9547,3578719628,3578719648,20
1,794,9548,3578719628,3578719650,22
1,794,9549,3578719628,3578719652,24
1,794,9550,3578719628,3578719655,27
1,794,9551,3578719628,3578719656,28
1,794,9552,3578719628,3578719656,28
1,794,9553,3578719628,3578719656,28
1,794,9554,3578719628,3578719657,29
1,794,9555,3578719628,3578719659,31
1,794,9556,3578719628,3578719661,33
1,794,9557,3578719628,3578719661,33
1,794,9558,3578719628,3578719661,33
1,794,9559,3578719628,3578719662,34
1,794,9560,3578719628,3578719664,36
1,794,9561,3578719628,3578719667,39
1,794,9562,3578719628,3578719676,48
1,795,9563,3578719684,3578719684,0
1,795,9564,3578719684,3578719684,0
1,795,9565,3578719684,3578719684,0
1,795,9566,3578719684,3578719685,1
1,795,9567,3578719684,3578719685,1
1,795,9568,3578719684,3578719686,2
1,795,9569,3578719684,3578719686,2
1,795,9570,3578719684,3578719686,2
1,795,9571,3578719684,3578719689,5
1,795,9572,3578719684,3578719690,6
1,795,9573,3578719684,3578719692,8
1,795,9574,3578719684,3578719693,9
1,795,9575,3578719684,3578719693,9
1,795,9576,3578719684,3578719693,9
1,795,9577,3578719684,3578719694,10
1,795,9578,3578719684,3578719696,12
1,795,9579,3578719684,3578719698,14
1,795,9580,3578719684,3578719699,15
1,795,9581,3578719684,3578719700,16
1,795,9582,3578719684,3578719701,17
1,795,9583,3578719684,3578719701,17
1,795,9584,3578719684,3578719707,23
1,795,9585,3578719684,3578719708,24
1,795,9586,3578719684,3578719709,25
1,795,9587,3578719684,3578719709,25
1,795,9588,3578719684,3578719713,29
1,795,9589,3578719684,3578719715,31
1,795,9590,3578719684,3578719717,33
1,795,9591,3578719684,3578719717,33
1,795,9592,3578719684,3578719718,34
1,795,9593,3578719684,3578719718,34
1,795,9594,3578719684,3578719718,34
1,795,9595,3578719684,3578719719,35
1,795,9596,3578719684,3578719720,36
1,795,9597,3578719684,3578719721,37
1,795,9598,3578719684,3578719722,38
1,795,9599,3578719684,3578719723,39
1,795,9600,3578719684,3578719723,39
1,795,9601,3578719684,3578719724,40
1,795,9602,3578719684,3578719725,41
1,795,9603,3578719684,3578719725,41
1,795,9604,3578719684,3578719727,43
1,795,9605,3578719684,3578719728,44
1,795,9606,3578719684,3578719728,44
1,795,9607,3578719684,3578719730,46
1,795,9608,3578719684,3578719730,46
1,795,9609,3578719684,3578719733,49
1,795,9610,3578719684,3578719733,49
1,795,9611,3578719684,3578719733,49
1,796,9612,3578719738,3578719738,0
1,796,9613,3578719738,3578719742,4
1,796,9614,3578719738,3578719743,5
1,796,9615,3578719738,3578719744,6
1,796,9616,3578719738,3578719748,10
1,796,9617,3578719738,3578719748,10
1,796,9618,3578719738,3578719749,11
1,796,9619,3578719738,3578719750,12
1,796,9620,3578719738,3578719753,15
1,796,9621,3578719738,3578719753,15
1,796,9622,3578719738,3578719757,19
1,796,9623,3578719738,3578719761,23
1,796,9624,3578719738,3578719763,25
1,796,9625,3578719738,3578719763,25
1,796,9626,3578719738,3578719764,26
1,796,9627,3578719738,3578719765,27
1,796,9628,3578719738,3578719765,27
1,796,9629,3578719738,3578719765,27
1,796,9630,3578719738,3578719765,27
1,796,9631,3578719738,3578719767,29
1,796,9632,3578719738,3578719768,30
1,796,9633,3578719738,3578719768,30
1,796,9634,3578719738,3578719770,32
1,796,9635,3578719738,3578719774,36
1,796,9636,3578719738,3578719774,36
1,796,9637,3578719738,3578719775,37
1,796,9638,3578719738,3578719777,39
1,796,9639,3578719738,3578719781,43
1,796,9640,3578719738,3578719781,43
1,796,9641,3578719738,3578719787,49
1,796,9642,3578719738,3578719787,49
1,796,9643,3578719738,3578719787,49
1,797,9644,3578719793,3578719793,0
1,797,9645,3578719793,3578719793,0
1,797,9646,3578719793,3578719793,0
1,797,9647,3578719793,3578719796,3
1,797,9648,3578719793,3578719796,3
1,797,9649,3578719793,3578719798,5
1,797,9650,3578719793,3578719799,6
1,797,9651,3578719793,3578719799,6
1,797,9652,3578719793,3578719799,6
1,797,9653,3578719793,3578719801,8
1,797,9654,3578719793,3578719809,16
1,797,9655,3578719793,3578719811,18
1,797,9656,3578719793,3578719812,19
1,797,9657,3578719793,3578719812,19
1,797,9658,3578719793,3578719816,23
1,797,9659,3578719793,3578719817,24
1,797,9660,3578719793,3578719818,25
1,797,9661,3578719793,3578719818,25
1,797,9662,3578719793,3578719819,26
1,797,9663,3578719793,3578719821,28
1,797,9664,3578719793,3578719822,29
1,797,9665,3578719793,3578719824,31
1,797,9666,3578719793,3578719824,31
1,797,9667,3578719793,3578719827,34
1,797,9668,3578719793,3578719828,35
1,797,9669,3578719793,3578719828,35
1,797,9670,3578719793,3578719829,36
1,797,9671,3578719793,3578719830,37
1,797,9672,3578719793,3578719831,38
1,797,9673,3578719793,3578719835,42
1,797,9674,3578719793,3578719836,43
1,797,9675,3578719793,3578719838,45
1,797,9676,3578719793,3578719838,45
1,797,9677,3578719793,3578719839,46
1,798,9678,3578719847,3578719847,0
1,798,9679,3578719847,3578719848,1
1,798,9680,3578719847,3578719849,2
1,798,9681,3578719847,3578719850,3
1,798,9682,3578719847,3578719853,6
1,798,9683,3578719847,3578719853,6
1,798,9684,3578719847,3578719855,8
1,798,9685,3578719847,3578719856,9
1,798,9686,3578719847,3578719856,9
1,798,9687,3578719847,3578719856,9
1,798,9688,3578719847,3578719857,10
1,798,9689,3578719847,3578719858,11
1,798,9690,3578719847,3578719861,14
1,798,9691,3578719847,3578719861,14
1,798,9692,3578719847,3578719862,15
1,798,9693,3578719847,3578719862,15
1,798,9694,3578719847,3578719864,17
1,798,9695,3578719847,3578719867,20
1,798,9696,3578719847,3578719876,29
1,798,9697,3578719847,3578719881,34
1,798,9698,3578719847,3578719882,35
1,798,9699,3578719847,3578719883,36
1,798,9700,3578719847,3578719885,38
1,798,9701,3578719847,3578719885,38
1,798,9702,3578719847,3578719885,38
1,798,9703,3578719847,3578719886,39
1,798,9704,3578719847,3578719886,39
1,798,9705,3578719847,3578719888,41
1,798,9706,3578719847,3578719890,43
1,798,9707,3578719847,3578719892,45
1,798,9708,3578719847,3578719892,45
1,798,9709,3578719847,3578719892,45
1,798,9710,3578719847,3578719896,49
1,799,9711,3578719901,3578719901,0
1,799,9712,3578719901,3578719901,0
1,799,9713,3578719901,3578719901,0
1,799,9714,3578719901,3578719902,1
1,799,9715,3578719901,3578719903,2
1,799,9716,3578719901,3578719907,6
1,799,9717,3578719901,3578719908,7
1,799,9718,3578719901,3578719909,8
1,799,9719,3578719901,3578719909,8
1,799,9720,3578719901,3578719912,11
1,799,9721,3578719901,3578719913,12
1,799,9722,3578719901,3578719916,15
1,799,9723,3578719901,3578719917,16
1,799,9724,3578719901,3578719918,17
1,799,9725,3578719901,3578719918,17
1,799,9726,3578719901,3578719918,17
1,799,9727,3578719901,3578719918,17
1,799,9728,3578719901,3578719919,18
1,799,9729,3578719901,3578719920,19
1,799,9730,3578719901,3578719922,21
1,799,9731,3578719901,3578719923,22
1,799,9732,3578719901,3578719924,23
1,799,9733,3578719901,3578719924,23
1,799,9734,3578719901,3578719924,23
1,799,9735,3578719901,3578719925,24
1,799,9736,3578719901,3578719926,25
1,799,9737,3578719901,3578719927,26
1,799,9738,3578719901,3578719928,27
1,799,9739,3578719901,3578719928,27
1,799,9740,3578719901,3578719930,29
1,799,9741,3578719901,3578719930,29
1,799,9742,3578719901,3578719933,32
1,799,9743,3578719901,3578719933,32
1,799,9744,3578719901,3578719933,32
1,799,9745,3578719901,3578719936,35
1,799,9746,3578719901,3578719942,41
1,799,9747,3578719901,3578719942,41
1,799,9748,3578719901,3578719944,43
1,799,9749,3578719901,3578719948,47
1,799,9750,3578719901,3578719948,47
1,799,9751,3578719901,3578719949,48
1,799,9752,3578719901,3578719950,49
1,800,9753,3578719956,3578719956,0
1,800,9754,3578719956,3578719956,0
1,800,9755,3578719956,3578719957,1
1,800,9756,3578719956,3578719962,6
1,800,9757,3578719956,3578719963,7
1,800,9758,3578719956,3578719965,9
1,800,9759,3578719956,3578719965,9
1,800,9760,3578719956,3578719965,9
1,800,9761,3578719956,3578719966,10
1,800,9762,3578719956,3578719966,10
1,800,9763,3578719956,3578719967,11
1,800,9764,3578719956,3578719968,12
1,800,9765,3578719956,3578719968,12
1,800,9766,3578719956,3578719971,15
1,800,9767,3578719956,3578719975,19
1,800,9768,3578719956,3578719975,19
1,800,9769,3578719956,3578719975,19
1,800,9770,3578719956,3578719977,21
1,800,9771,3578719956,3578719981,25
1,800,9772,3578719956,3578719981,25
1,800,9773,3578719956,3578719987,31
1,800,9774,3578719956,3578719987,31
1,800,9775,3578719956,3578719987,31
1,800,9776,3578719956,3578719989,33
1,800,9777,3578719956,3578719992,36
1,800,9778,3578719956,3578719992,36
1,800,9779,3578719956,3578719996,40
1,800,9780,3578719956,3578719997,41
1,800,9781,3578719956,3578719999,43
1,800,9782,3578719956,3578719999,43
1,800,9783,3578719956,3578719999,43
1,800,9784,3578719956,3578719999,43
1,800,9785,3578719956,3578720001,45
1,801,9786,3578720010,3578720010,0
1,801,9787,3578720010,3578720010,0
1,801,9788,3578720010,3578720011,1
1,801,9789,3578720010,3578720012,2
1,801,9790,3578720010,3578720012,2
1,801,9791,3578720010,3578720016,6
1,801,9792,3578720010,3578720017,7
1,801,9793,3578720010,3578720018,8
1,801,9794,3578720010,3578720019,9
1,801,9795,3578720010,3578720020,10
1,801,9796,3578720010,3578720021,11
1,801,9797,3578720010,3578720022,12
1,801,9798,3578720010,3578720024,14
1,801,9799,3578720010,3578720025,15
1,801,9800,3578720010,3578720027,17
1,801,9801,3578720010,3578720028,18
1,801,9802,3578720010,3578720028,18
1,801,9803,3578720010,3578720028,18
1,801,9804,3578720010,3578720030,20
1,801,9805,3578720010,3578720032,22
1,801,9806,3578720010,3578720035,25
1,801,9807,3578720010,3578720037,27
1,801,9808,3578720010,3578720039,29
1,801,9809,3578720010,3578720039,29
1,801,9810,3578720010,3578720039,29
1,801,9811,3578720010,3578720047,37
1,801,9812,3578720010,3578720048,38
1,801,9813,3578720010,3578720049,39
1,801,9814,3578720010,3578720052,42
1,801,9815,3578720010,3578720053,43
1,801,9816,3578720010,3578720054,44
1,801,9817,3578720010,3578720056,46
1,801,9818,3578720010,3578720056,46
1,801,9819,3578720010,3578720056,46
1,801,9820,3578720010,3578720056,46
1,801,9821,3578720010,3578720056,46
1,801,9822,3578720010,3578720059,49
1,802,9823,3578720065,3578720065,0
1,802,9824,3578720065,3578720065,0
1,802,9825,3578720065,3578720065,0
1,802,9826,3578720065,3578720065,0
1,802,9827,3578720065,3578720065,0
1,802,9828,3578720065,3578720068,3
1,802,9829,3578720065,3578720076,11
1,802,9830,3578720065,3578720081,16
1,802,9831,3578720065,3578720082,17
1,802,9832,3578720065,3578720083,18
1,802,9833,3578720065,3578720085,20
1,802,9834,3578720065,3578720085,20
1,802,9835,3578720065,3578720086,21
1,802,9836,3578720065,3578720086,21
1,802,9837,3578720065,3578720086,21
1,802,9838,3578720065,3578720088,23
1,802,9839,3578720065,3578720090,25
1,802,9840,3578720065,3578720092,27
1,802,9841,3578720065,3578720092,27
1,802,9842,3578720065,3578720092,27
1,802,9843,3578720065,3578720096,31
1,802,9844,3578720065,3578720098,33
1,802,9845,3578720065,3578720099,34
1,802,9846,3578720065,3578720099,34
1,802,9847,3578720065,3578720101,36
1,802,9848,3578720065,3578720101,36
1,802,9849,3578720065,3578720106,41
1,802,9850,3578720065,3578720109,44
1,802,9851,3578720065,3578720109,44
1,802,9852,3578720065,3578720110,45
1,802,9853,3578720065,3578720112,47
1,802,9854,3578720065,3578720112,47
1,803,9855,3578720121,3578720121,0
1,803,9856,3578720121,3578720121,0
1,803,9857,3578720121,3578720121,0
1,803,9858,3578720121,3578720121,0
1,803,9859,3578720121,3578720121,0
1,803,9860,3578720121,3578720121,0
1,803,9861,3578720121,3578720121,0
1,803,9862,3578720121,3578720121,0
1,803,9863,3578720121,3578720121,0
1,803,9864,3578720121,3578720122,1
1,803,9865,3578720121,3578720123,2
1,803,9866,3578720121,3578720124,3
1,803,9867,3578720121,3578720124,3
1,803,9868,3578720121,3578720124,3
1,803,9869,3578720121,3578720125,4
1,803,9870,3578720121,3578720126,5
1,803,9871,3578720121,3578720127,6
1,803,9872,3578720121,3578720128,7
1,803,9873,3578720121,3578720128,7
1,803,9874,3578720121,3578720129,8
1,803,9875,3578720121,3578720130,9
1,803,9876,3578720121,3578720133,12
1,803,9877,3578720121,3578720134,13
1,803,9878,3578720121,3578720136,15
1,803,9879,3578720121,3578720143,22
1,803,9880,3578720121,3578720143,22
1,803,9881,3578720121,3578720145,24
1,803,9882,3578720121,3578720148,27
1,803,9883,3578720121,3578720148,27
1,803,9884,3578720121,3578720150,29
1,803,9885,3578720121,3578720150,29
1,803,9886,3578720121,3578720154,33
1,803,9887,3578720121,3578720155,34
1,803,9888,3578720121,3578720157,36
1,803,9889,3578720121,3578720162,41
1,803,9890,3578720121,3578720164,43
1,803,9891,3578720121,3578720165,44
1,803,9892,3578720121,3578720165,44
1,803,9893,3578720121,3578720167,46
1,803,9894,3578720121,3578720167,46
1,803,9895,3578720121,3578720167,46
1,803,9896,3578720121,3578720167,46
1,803,9897,3578720121,3578720168,47
1,803,9898,3578720121,3578720171,50
1,804,9899,3578720176,3578720176,0
1,804,9900,3578720176,3578720176,0
1,804,9901,3578720176,3578720176,0
1,804,9902,3578720176,3578720178,2
1,804,9903,3578720176,3578720181,5
1,804,9904,3578720176,3578720181,5
1,804,9905,3578720176,3578720186,10
1,804,9906,3578720176,3578720186,10
1,804,9907,3578720176,3578720187,11
1,804,9908,3578720176,3578720187,11
1,804,9909,3578720176,3578720189,13
1,804,9910,3578720176,3578720192,16
1,804,9911,3578720176,3578720193,17
1,804,9912,3578720176,3578720197,21
1,804,9913,3578720176,3578720197,21
1,804,9914,3578720176,3578720198,22
1,804,9915,3578720176,3578720199,23
1,804,9916,3578720176,3578720199,23
1,804,9917,3578720176,3578720201,25
1,804,9918,3578720176,3578720210,34
1,804,9919,3578720176,3578720211,35
1,804,9920,3578720176,3578720212,36
1,804,9921,3578720176,3578720212,36
1,804,9922,3578720176,3578720216,40
1,804,9923,3578720176,3578720217,41
1,804,9924,3578720176,3578720217,41
1,804,9925,3578720176,3578720218,42
1,804,9926,3578720176,3578720219,43
1,804,9927,3578720176,3578720220,44
1,804,9928,3578720176,3578720221,45
1,804,9929,3578720176,3578720223,47
1,804,9930,3578720176,3578720224,48
1,804,9931,3578720176,3578720224,48
1,805,9932,3578720231,3578720231,0
1,805,9933,3578720231,3578720231,0
1,805,9934,3578720231,3578720231,0
1,805,9935,3578720231,3578720231,0
1,805,9936,3578720231,3578720231,0
1,805,9937,3578720231,3578720232,1
1,805,9938,3578720231,3578720235,4
1,805,9939,3578720231,3578720237,6
1,805,9940,3578720231,3578720239,8
1,805,9941,3578720231,3578720240,9
1,805,9942,3578720231,3578720240,9
1,805,9943,3578720231,3578720248,17
1,805,9944,3578720231,3578720248,17
1,805,9945,3578720231,3578720249,18
1,805,9946,3578720231,3578720252,21
1,805,9947,3578720231,3578720254,23
1,805,9948,3578720231,3578720254,23
1,805,9949,3578720231,3578720255,24
1,805,9950,3578720231,3578720255,24
1,805,9951,3578720231,3578720256,25
1,805,9952,3578720231,3578720256,25
1,805,9953,3578720231,3578720257,26
1,805,9954,3578720231,3578720259,28
1,805,9955,3578720231,3578720262,31
1,805,9956,3578720231,3578720263,32
1,805,9957,3578720231,3578720263,32
1,805,9958,3578720231,3578720265,34
1,805,9959,3578720231,3578720266,35
1,805,9960,3578720231,3578720268,37
1,805,9961,3578720231,3578720276,45
1,806,9962,3578720287,3578720287,0
1,806,9963,3578720287,3578720287,0
1,806,9964,3578720287,3578720287,0
1,806,9965,3578720287,3578720287,0
1,806,9966,3578720287,3578720287,0
1,806,9967,3578720287,3578720287,0
1,806,9968,3578720287,3578720287,0
1,806,9969,3578720287,3578720287,0
1,806,9970,3578720287,3578720288,1
1,806,9971,3578720287,3578720290,3
1,806,9972,3578720287,3578720292,5
1,806,9973,3578720287,3578720292,5
1,806,9974,3578720287,3578720292,5
1,806,9975,3578720287,3578720296,9
1,806,9976,3578720287,3578720298,11
1,806,9977,3578720287,3578720299,12
1,806,9978,3578720287,3578720300,13
1,806,9979,3578720287,3578720301,14
1,806,9980,3578720287,3578720301,14
1,806,9981,3578720287,3578720303,16
1,806,9982,3578720287,3578720306,19
1,806,9983,3578720287,3578720309,22
1,806,9984,3578720287,3578720310,23
1,806,9985,3578720287,3578720311,24
1,806,9986,3578720287,3578720313,26
1,806,9987,3578720287,3578720313,26
1,806,9988,3578720287,3578720316,29
1,806,9989,3578720287,3578720318,31
1,806,9990,3578720287,3578720318,31
1,806,9991,3578720287,3578720318,31
1,806,9992,3578720287,3578720318,31
1,806,9993,3578720287,3578720318,31
1,806,9994,3578720287,3578720318,31
1,806,9995,3578720287,3578720320,33
1,806,9996,3578720287,3578720320,33
1,806,9997,3578720287,3578720322,35
1,806,9998,3578720287,3578720324,37
1,806,9999,3578720287,3578720324,37
1,806,10000,3578720287,3578720324,37
1,806,10001,3578720287,3578720324,37
1,806,10002,3578720287,3578720326,39
1,806,10003,3578720287,3578720326,39
1,806,10004,3578720287,3578720328,41
1,806,10005,3578720287,3578720328,41
1,806,10006,3578720287,3578720328,41
1,806,10007,3578720287,3578720330,43
1,806,10008,3578720287,3578720331,44
1,806,10009,3578720287,3578720333,46
1,806,10010,3578720287,3578720334,47
1,806,10011,3578720287,3578720335,48
1,807,10012,3578720343,3578720343,0
1,807,10013,3578720343,3578720344,1
1,807,10014,3578720343,3578720345,2
1,807,10015,3578720343,3578720349,6
1,807,10016,3578720343,3578720349,6
1,807,10017,3578720343,3578720351,8
1,807,10018,3578720343,3578720351,8
1,807,10019,3578720343,3578720354,11
1,807,10020,3578720343,3578720354,11
1,807,10021,3578720343,3578720358,15
1,807,10022,3578720343,3578720362,19
1,807,10023,3578720343,3578720363,20
1,807,10024,3578720343,3578720366,23
1,807,10025,3578720343,3578720366,23
1,807,10026,3578720343,3578720367,24
1,807,10027,3578720343,3578720367,24
1,807,10028,3578720343,3578720367,24
1,807,10029,3578720343,3578720368,25
1,807,10030,3578720343,3578720371,28
1,807,10031,3578720343,3578720375,32
1,807,10032,3578720343,3578720375,32
1,807,10033,3578720343,3578720377,34
1,807,10034,3578720343,3578720379,36
1,807,10035,3578720343,3578720381,38
1,807,10036,3578720343,3578720381,38
1,807,10037,3578720343,3578720386,43
1,807,10038,3578720343,3578720387,44
1,807,10039,3578720343,3578720387,44
1,807,10040,3578720343,3578720388,45
1,807,10041,3578720343,3578720389,46
1,807,10042,3578720343,3578720391,48
1,808,10043,3578720397,3578720397,0
1,808,10044,3578720397,3578720397,0
1,808,10045,3578720397,3578720397,0
1,808,10046,3578720397,3578720399,2
1,808,10047,3578720397,3578720400,3
1,808,10048,3578720397,3578720401,4
1,808,10049,3578720397,3578720406,9
1,808,10050,3578720397,3578720410,13
1,808,10051,3578720397,3578720412,15
1,808,10052,3578720397,3578720412,15
1,808,10053,3578720397,3578720413,16
1,808,10054,3578720397,3578720417,20
1,808,10055,3578720397,3578720417,20
1,808,10056,3578720397,3578720417,20
1,808,10057,3578720397,3578720419,22
1,808,10058,3578720397,3578720419,22
1,808,10059,3578720397,3578720420,23
1,808,10060,3578720397,3578720420,23
1,808,10061,3578720397,3578720422,25
1,808,10062,3578720397,3578720425,28
1,808,10063,3578720397,3578720425,28
1,808,10064,3578720397,3578720429,32
1,808,10065,3578720397,3578720430,33
1,808,10066,3578720397,3578720430,33
1,808,10067,3578720397,3578720431,34
1,808,10068,3578720397,3578720431,34
1,808,10069,3578720397,3578720435,38
1,808,10070,3578720397,3578720437,40
1,808,10071,3578720397,3578720440,43
1,808,10072,3578720397,3578720440,43
1,808,10073,3578720397,3578720440,43
1,809,10074,3578720452,3578720452,0
1,809,10075,3578720452,3578720452,0
1,809,10076,3578720452,3578720452,0
1,809,10077,3578720452,3578720452,0
1,809,10078,3578720452,3578720454,2
1,809,10079,3578720452,3578720455,3
1,809,10080,3578720452,3578720456,4
1,809,10081,3578720452,3578720456,4
1,809,10082,3578720452,3578720456,4
1,809,10083,3578720452,3578720457,5
1,809,10084,3578720452,3578720457,5
1,809,10085,3578720452,3578720459,7
1,809,10086,3578720452,3578720462,10
1,809,10087,3578720452,3578720462,10
1,809,10088,3578720452,3578720464,12
1,809,10089,3578720452,3578720465,13
1,809,10090,3578720452,3578720467,15
1,809,10091,3578720452,3578720467,15
1,809,10092,3578720452,3578720476,24
1,809,10093,3578720452,3578720481,29
1,809,10094,3578720452,3578720482,30
1,809,10095,3578720452,3578720483,31
1,809,10096,3578720452,3578720485,33
1,809,10097,3578720452,3578720486,34
1,809,10098,3578720452,3578720487,35
1,809,10099,3578720452,3578720487,35
1,809,10100,3578720452,3578720487,35
1,809,10101,3578720452,3578720488,36
1,809,10102,3578720452,3578720489,37
1,809,10103,3578720452,3578720491,39
1,809,10104,3578720452,3578720492,40
1,809,10105,3578720452,3578720492,40
1,809,10106,3578720452,3578720493,41
1,809,10107,3578720452,3578720496,44
1,809,10108,3578720452,3578720498,46
1,809,10109,3578720452,3578720500,48
1,809,10110,3578720452,3578720501,49
1,809,10111,3578720452,3578720501,49
1,809,10112,3578720452,3578720501,49
1,810,10113,3578720506,3578720508,2
1,810,10114,3578720506,3578720509,3
1,810,10115,3578720506,3578720509,3
1,810,10116,3578720506,3578720512,6
1,810,10117,3578720506,3578720513,7
1,810,10118,3578720506,3578720513,7
1,810,10119,3578720506,3578720515,9
1,810,10120,3578720506,3578720516,10
1,810,10121,3578720506,3578720517,11
1,810,10122,3578720506,3578720517,11
1,810,10123,3578720506,3578720517,11
1,810,10124,3578720506,3578720518,12
1,810,10125,3578720506,3578720519,13
1,810,10126,3578720506,3578720520,14
1,810,10127,3578720506,3578720521,15
1,810,10128,3578720506,3578720522,16
1,810,10129,3578720506,3578720523,17
1,810,10130,3578720506,3578720523,17
1,810,10131,3578720506,3578720523,17
1,810,10132,3578720506,3578720525,19
1,810,10133,3578720506,3578720526,20
1,810,10134,3578720506,3578720527,21
1,810,10135,3578720506,3578720527,21
1,810,10136,3578720506,3578720528,22
1,810,10137,3578720506,3578720529,23
1,810,10138,3578720506,3578720530,24
1,810,10139,3578720506,3578720533,27
1,810,10140,3578720506,3578720533,27
1,810,10141,3578720506,3578720533,27
1,810,10142,3578720506,3578720534,28
1,810,10143,3578720506,3578720541,35
1,810,10144,3578720506,3578720543,37
1,810,10145,3578720506,3578720543,37
1,810,10146,3578720506,3578720548,42
1,810,10147,3578720506,3578720550,44
1,810,10148,3578720506,3578720550,44
1,810,10149,3578720506,3578720553,47
1,810,10150,3578720506,3578720554,48
1,811,10151,3578720561,3578720561,0
1,811,10152,3578720561,3578720562,1
1,811,10153,3578720561,3578720563,2
1,811,10154,3578720561,3578720565,4
1,811,10155,3578720561,3578720565,4
1,811,10156,3578720561,3578720565,4
1,811,10157,3578720561,3578720566,5
1,811,10158,3578720561,3578720567,6
1,811,10159,3578720561,3578720567,6
1,811,10160,3578720561,3578720567,6
1,811,10161,3578720561,3578720567,6
1,811,10162,3578720561,3578720571,10
1,811,10163,3578720561,3578720574,13
1,811,10164,3578720561,3578720575,14
1,811,10165,3578720561,3578720575,14
1,811,10166,3578720561,3578720578,17
1,811,10167,3578720561,3578720580,19
1,811,10168,3578720561,3578720580,19
1,811,10169,3578720561,3578720585,24
1,811,10170,3578720561,3578720586,25
1,811,10171,3578720561,3578720587,26
1,811,10172,3578720561,3578720588,27
1,811,10173,3578720561,3578720590,29
1,811,10174,3578720561,3578720593,32
1,811,10175,3578720561,3578720595,34
1,811,10176,3578720561,3578720597,36
1,811,10177,3578720561,3578720597,36
1,811,10178,3578720561,3578720598,37
1,811,10179,3578720561,3578720598,37
1,811,10180,3578720561,3578720600,39
1,811,10181,3578720561,3578720600,39
1,811,10182,3578720561,3578720609,48
1,812,10183,3578720616,3578720616,0
1,812,10184,3578720616,3578720616,0
1,812,10185,3578720616,3578720616,0
1,812,10186,3578720616,3578720616,0
1,812,10187,3578720616,3578720616,0
1,812,10188,3578720616,3578720616,0
1,812,10189,3578720616,3578720616,0
1,812,10190,3578720616,3578720618,2
1,812,10191,3578720616,3578720619,3
1,812,10192,3578720616,3578720620,4
1,812,10193,3578720616,3578720620,4
1,812,10194,3578720616,3578720621,5
1,812,10195,3578720616,3578720624,8
1,812,10196,3578720616,3578720624,8
1,812,10197,3578720616,3578720628,12
1,812,10198,3578720616,3578720629,13
1,812,10199,3578720616,3578720629,13
1,812,10200,3578720616,3578720629,13
1,812,10201,3578720616,3578720630,14
1,812,10202,3578720616,3578720630,14
1,812,10203,3578720616,3578720634,18
1,812,10204,3578720616,3578720636,20
1,812,10205,3578720616,3578720639,23
1,812,10206,3578720616,3578720639,23
1,812,10207,3578720616,3578720639,23
1,812,10208,3578720616,3578720647,31
1,812,10209,3578720616,3578720648,32
1,812,10210,3578720616,3578720650,34
1,812,10211,3578720616,3578720650,34
1,812,10212,3578720616,3578720653,37
1,812,10213,3578720616,3578720654,38
1,812,10214,3578720616,3578720655,39
1,812,10215,3578720616,3578720655,39
1,812,10216,3578720616,3578720655,39
1,812,10217,3578720616,3578720655,39
1,812,10218,3578720616,3578720657,41
1,812,10219,3578720616,3578720658,42
1,812,10220,3578720616,3578720660,44
1,812,10221,3578720616,3578720662,46
1,812,10222,3578720616,3578720662,46
1,812,10223,3578720616,3578720665,49
1,812,10224,3578720616,3578720666,50
1,813,10225,3578720671,3578720676,5
1,813,10226,3578720671,3578720681,10
1,813,10227,3578720671,3578720682,11
1,813,10228,3578720671,3578720686,15
1,813,10229,3578720671,3578720686,15
1,813,10230,3578720671,3578720686,15
1,813,10231,3578720671,3578720687,16
1,813,10232,3578720671,3578720687,16
1,813,10233,3578720671,3578720688,17
1,813,10234,3578720671,3578720690,19
1,813,10235,3578720671,3578720692,21
1,813,10236,3578720671,3578720692,21
1,813,10237,3578720671,3578720693,22
1,813,10238,3578720671,3578720694,23
1,813,10239,3578720671,3578720696,25
1,813,10240,3578720671,3578720698,27
1,813,10241,3578720671,3578720699,28
1,813,10242,3578720671,3578720701,30
1,813,10243,3578720671,3578720701,30
1,813,10244,3578720671,3578720701,30
1,813,10245,3578720671,3578720706,35
1,813,10246,3578720671,3578720708,37
1,813,10247,3578720671,3578720709,38
1,813,10248,3578720671,3578720710,39
1,813,10249,3578720671,3578720712,41
1,813,10250,3578720671,3578720712,41
1,813,10251,3578720671,3578720713,42
1,813,10252,3578720671,3578720715,44
1,813,10253,3578720671,3578720716,45
1,813,10254,3578720671,3578720717,46
1,813,10255,3578720671,3578720717,46
1,813,10256,3578720671,3578720717,46
1,813,10257,3578720671,3578720717,46
1,813,10258,3578720671,3578720718,47
1,813,10259,3578720671,3578720719,48
1,814,10260,3578720727,3578720727,0
1,814,10261,3578720727,3578720727,0
1,814,10262,3578720727,3578720727,0
1,814,10263,3578720727,3578720727,0
1,814,10264,3578720727,3578720727,0
1,814,10265,3578720727,3578720727,0
1,814,10266,3578720727,3578720727,0
1,814,10267,3578720727,3578720727,0
1,814,10268,3578720727,3578720727,0
1,814,10269,3578720727,3578720729,2
1,814,10270,3578720727,3578720730,3
1,814,10271,3578720727,3578720733,6
1,814,10272,3578720727,3578720733,6
1,814,10273,3578720727,3578720734,7
1,814,10274,3578720727,3578720735,8
1,814,10275,3578720727,3578720742,15
1,814,10276,3578720727,3578720743,16
1,814,10277,3578720727,3578720743,16
1,814,10278,3578720727,3578720747,20
1,814,10279,3578720727,3578720748,21
1,814,10280,3578720727,3578720749,22
1,814,10281,3578720727,3578720750,23
1,814,10282,3578720727,3578720752,25
1,814,10283,3578720727,3578720754,27
1,814,10284,3578720727,3578720758,31
1,814,10285,3578720727,3578720762,35
1,814,10286,3578720727,3578720763,36
1,814,10287,3578720727,3578720765,38
1,814,10288,3578720727,3578720766,39
1,814,10289,3578720727,3578720766,39
1,814,10290,3578720727,3578720766,39
1,814,10291,3578720727,3578720766,39
1,814,10292,3578720727,3578720767,40
1,814,10293,3578720727,3578720767,40
1,814,10294,3578720727,3578720768,41
1,814,10295,3578720727,3578720771,44
1,814,10296,3578720727,3578720774,47
1,814,10297,3578720727,3578720774,47
1,814,10298,3578720727,3578720775,48
1,815,10299,3578720783,3578720783,0
1,815,10300,3578720783,3578720783,0
1,815,10301,3578720783,3578720783,0
1,815,10302,3578720783,3578720785,2
1,815,10303,3578720783,3578720786,3
1,815,10304,3578720783,3578720788,5
1,815,10305,3578720783,3578720788,5
1,815,10306,3578720783,3578720788,5
1,815,10307,3578720783,3578720790,7
1,815,10308,3578720783,3578720793,10
1,815,10309,3578720783,3578720795,12
1,815,10310,3578720783,3578720797,14
1,815,10311,3578720783,3578720798,15
1,815,10312,3578720783,3578720798,15
1,815,10313,3578720783,3578720798,15
1,815,10314,3578720783,3578720800,17
1,815,10315,3578720783,3578720801,18
1,815,10316,3578720783,3578720806,23
1,815,10317,3578720783,3578720809,26
1,815,10318,3578720783,3578720811,28
1,815,10319,3578720783,3578720812,29
1,815,10320,3578720783,3578720812,29
1,815,10321,3578720783,3578720816,33
1,815,10322,3578720783,3578720816,33
1,815,10323,3578720783,3578720816,33
1,815,10324,3578720783,3578720818,35
1,815,10325,3578720783,3578720819,36
1,815,10326,3578720783,3578720820,37
1,815,10327,3578720783,3578720820,37
1,815,10328,3578720783,3578720823,40
1,815,10329,3578720783,3578720824,41
1,815,10330,3578720783,3578720825,42
1,815,10331,3578720783,3578720829,46
1,815,10332,3578720783,3578720829,46
1,815,10333,3578720783,3578720830,47
1,815,10334,3578720783,3578720830,47
1,815,10335,3578720783,3578720832,49
1,816,10336,3578720838,3578720838,0
1,816,10337,3578720838,3578720838,0
1,816,10338,3578720838,3578720838,0
1,816,10339,3578720838,3578720838,0
1,816,10340,3578720838,3578720839,1
1,816,10341,3578720838,3578720847,9
1,816,10342,3578720838,3578720849,11
1,816,10343,3578720838,3578720850,12
1,816,10344,3578720838,3578720850,12
1,816,10345,3578720838,3578720853,15
1,816,10346,3578720838,3578720855,17
1,816,10347,3578720838,3578720855,17
1,816,10348,3578720838,3578720855,17
1,816,10349,3578720838,3578720855,17
1,816,10350,3578720838,3578720856,18
1,816,10351,3578720838,3578720856,18
1,816,10352,3578720838,3578720858,20
1,816,10353,3578720838,3578720860,22
1,816,10354,3578720838,3578720862,24
1,816,10355,3578720838,3578720862,24
1,816,10356,3578720838,3578720863,25
1,816,10357,3578720838,3578720863,25
1,816,10358,3578720838,3578720865,27
1,816,10359,3578720838,3578720866,28
1,816,10360,3578720838,3578720876,38
1,816,10361,3578720838,3578720881,43
1,816,10362,3578720838,3578720882,44
1,816,10363,3578720838,3578720883,45
1,816,10364,3578720838,3578720885,47
1,816,10365,3578720838,3578720886,48
1,816,10366,3578720838,3578720887,49
1,816,10367,3578720838,3578720887,49
1,816,10368,3578720838,3578720888,50
1,817,10369,3578720893,3578720893,0
1,817,10370,3578720893,3578720893,0
1,817,10371,3578720893,3578720893,0
1,817,10372,3578720893,3578720894,1
1,817,10373,3578720893,3578720894,1
1,817,10374,3578720893,3578720896,3
1,817,10375,3578720893,3578720898,5
1,817,10376,3578720893,3578720899,6
1,817,10377,3578720893,3578720901,8
1,817,10378,3578720893,3578720901,8
1,817,10379,3578720893,3578720901,8
1,817,10380,3578720893,3578720906,13
1,817,10381,3578720893,3578720908,15
1,817,10382,3578720893,3578720909,16
1,817,10383,3578720893,3578720910,17
1,817,10384,3578720893,3578720911,18
1,817,10385,3578720893,3578720912,19
1,817,10386,3578720893,3578720913,20
1,817,10387,3578720893,3578720916,23
1,817,10388,3578720893,3578720916,23
1,817,10389,3578720893,3578720917,24
1,817,10390,3578720893,3578720917,24
1,817,10391,3578720893,3578720917,24
1,817,10392,3578720893,3578720917,24
1,817,10393,3578720893,3578720917,24
1,817,10394,3578720893,3578720918,25
1,817,10395,3578720893,3578720919,26
1,817,10396,3578720893,3578720923,30
1,817,10397,3578720893,3578720923,30
1,817,10398,3578720893,3578720923,30
1,817,10399,3578720893,3578720923,30
1,817,10400,3578720893,3578720925,32
1,817,10401,3578720893,3578720925,32
1,817,10402,3578720893,3578720926,33
1,817,10403,3578720893,3578720927,34
1,817,10404,3578720893,3578720928,35
1,817,10405,3578720893,3578720929,36
1,817,10406,3578720893,3578720931,38
1,817,10407,3578720893,3578720933,40
1,817,10408,3578720893,3578720934,41
1,817,10409,3578720893,3578720936,43
1,817,10410,3578720893,3578720942,49
1,817,10411,3578720893,3578720942,49
1,818,10412,3578720948,3578720948,0
1,818,10413,3578720948,3578720948,0
1,818,10414,3578720948,3578720949,1
1,818,10415,3578720948,3578720950,2
1,818,10416,3578720948,3578720953,5
1,818,10417,3578720948,3578720955,7
1,818,10418,3578720948,3578720958,10
1,818,10419,3578720948,3578720962,14
1,818,10420,3578720948,3578720965,17
1,818,10421,3578720948,3578720965,17
1,818,10422,3578720948,3578720966,18
1,818,10423,3578720948,3578720966,18
1,818,10424,3578720948,3578720967,19
1,818,10425,3578720948,3578720967,19
1,818,10426,3578720948,3578720967,19
1,818,10427,3578720948,3578720967,19
1,818,10428,3578720948,3578720971,23
1,818,10429,3578720948,3578720974,26
1,818,10430,3578720948,3578720975,27
1,818,10431,3578720948,3578720976,28
1,818,10432,3578720948,3578720979,31
1,818,10433,3578720948,3578720980,32
1,818,10434,3578720948,3578720981,33
1,818,10435,3578720948,3578720981,33
1,818,10436,3578720948,3578720985,37
1,818,10437,3578720948,3578720986,38
1,818,10438,3578720948,3578720988,40
1,818,10439,3578720948,3578720988,40
1,818,10440,3578720948,3578720989,41
1,818,10441,3578720948,3578720991,43
1,818,10442,3578720948,3578720993,45
1,818,10443,3578720948,3578720995,47
1,818,10444,3578720948,3578720997,49
1,819,10445,3578721004,3578721004,0
1,819,10446,3578721004,3578721004,0
1,819,10447,3578721004,3578721004,0
1,819,10448,3578721004,3578721004,0
1,819,10449,3578721004,3578721004,0
1,819,10450,3578721004,3578721010,6
1,819,10451,3578721004,3578721011,7
1,819,10452,3578721004,3578721013,9
1,819,10453,3578721004,3578721013,9
1,819,10454,3578721004,3578721015,11
1,819,10455,3578721004,3578721016,12
1,819,10456,3578721004,3578721016,12
1,819,10457,3578721004,3578721017,13
1,819,10458,3578721004,3578721019,15
1,819,10459,3578721004,3578721019,15
1,819,10460,3578721004,3578721019,15
1,819,10461,3578721004,3578721021,17
1,819,10462,3578721004,3578721023,19
1,819,10463,3578721004,3578721024,20
1,819,10464,3578721004,3578721028,24
1,819,10465,3578721004,3578721030,26
1,819,10466,3578721004,3578721030,26
1,819,10467,3578721004,3578721030,26
1,819,10468,3578721004,3578721036,32
1,819,10469,3578721004,3578721038,34
1,819,10470,3578721004,3578721038,34
1,819,10471,3578721004,3578721039,35
1,819,10472,3578721004,3578721039,35
1,819,10473,3578721004,3578721047,43
1,819,10474,3578721004,3578721049,45
1,819,10475,3578721004,3578721050,46
1,819,10476,3578721004,3578721051,47
1,819,10477,3578721004,3578721053,49
1,820,10478,3578721059,3578721059,0
1,820,10479,3578721059,3578721059,0
1,820,10480,3578721059,3578721059,0
1,820,10481,3578721059,3578721059,0
1,820,10482,3578721059,3578721059,0
1,820,10483,3578721059,3578721059,0
1,820,10484,3578721059,3578721059,0
1,820,10485,3578721059,3578721060,1
1,820,10486,3578721059,3578721063,4
1,820,10487,3578721059,3578721064,5
1,820,10488,3578721059,3578721064,5
1,820,10489,3578721059,3578721064,5
1,820,10490,3578721059,3578721066,7
1,820,10491,3578721059,3578721066,7
1,820,10492,3578721059,3578721076,17
1,820,10493,3578721059,3578721080,21
1,820,10494,3578721059,3578721081,22
1,820,10495,3578721059,3578721082,23
1,820,10496,3578721059,3578721083,24
1,820,10497,3578721059,3578721085,26
1,820,10498,3578721059,3578721086,27
1,820,10499,3578721059,3578721086,27
1,820,10500,3578721059,3578721086,27
1,820,10501,3578721059,3578721087,28
1,820,10502,3578721059,3578721087,28
1,820,10503,3578721059,3578721088,29
1,820,10504,3578721059,3578721090,31
1,820,10505,3578721059,3578721092,33
1,820,10506,3578721059,3578721092,33
1,820,10507,3578721059,3578721094,35
1,820,10508,3578721059,3578721094,35
1,820,10509,3578721059,3578721097,38
1,820,10510,3578721059,3578721098,39
1,820,10511,3578721059,3578721100,41
1,820,10512,3578721059,3578721101,42
1,820,10513,3578721059,3578721101,42
1,820,10514,3578721059,3578721102,43
1,820,10515,3578721059,3578721106,47
1,820,10516,3578721059,3578721107,48
1,820,10517,3578721059,3578721108,49
1,821,10518,3578721115,3578721115,0
1,821,10519,3578721115,3578721115,0
1,821,10520,3578721115,3578721115,0
1,821,10521,3578721115,3578721115,0
1,821,10522,3578721115,3578721115,0
1,821,10523,3578721115,3578721116,1
1,821,10524,3578721115,3578721116,1
1,821,10525,3578721115,3578721117,2
1,821,10526,3578721115,3578721117,2
1,821,10527,3578721115,3578721117,2
1,821,10528,3578721115,3578721117,2
1,821,10529,3578721115,3578721117,2
1,821,10530,3578721115,3578721118,3
1,821,10531,3578721115,3578721121,6
1,821,10532,3578721115,3578721123,8
1,821,10533,3578721115,3578721123,8
1,821,10534,3578721115,3578721124,9
1,821,10535,3578721115,3578721125,10
1,821,10536,3578721115,3578721126,11
1,821,10537,3578721115,3578721127,12
1,821,10538,3578721115,3578721127,12
1,821,10539,3578721115,3578721129,14
1,821,10540,3578721115,3578721131,16
1,821,10541,3578721115,3578721132,17
1,821,10542,3578721115,3578721133,18
1,821,10543,3578721115,3578721133,18
1,821,10544,3578721115,3578721135,20
1,821,10545,3578721115,3578721136,21
1,821,10546,3578721115,3578721141,26
1,821,10547,3578721115,3578721146,31
1,821,10548,3578721115,3578721149,34
1,821,10549,3578721115,3578721149,34
1,821,10550,3578721115,3578721151,36
1,821,10551,3578721115,3578721154,39
1,821,10552,3578721115,3578721158,43
1,821,10553,3578721115,3578721162,47
1,821,10554,3578721115,3578721164,49
1,822,10555,3578721171,3578721171,0
1,822,10556,3578721171,3578721171,0
1,822,10557,3578721171,3578721171,0
1,822,10558,3578721171,3578721171,0
1,822,10559,3578721171,3578721171,0
1,822,10560,3578721171,3578721171,0
1,822,10561,3578721171,3578721171,0
1,822,10562,3578721171,3578721171,0
1,822,10563,3578721171,3578721171,0
1,822,10564,3578721171,3578721174,3
1,822,10565,3578721171,3578721175,4
1,822,10566,3578721171,3578721177,6
1,822,10567,3578721171,3578721180,9
1,822,10568,3578721171,3578721180,9
1,822,10569,3578721171,3578721181,10
1,822,10570,3578721171,3578721182,11
1,822,10571,3578721171,3578721185,14
1,822,10572,3578721171,3578721187,16
1,822,10573,3578721171,3578721188,17
1,822,10574,3578721171,3578721189,18
1,822,10575,3578721171,3578721192,21
1,822,10576,3578721171,3578721195,24
1,822,10577,3578721171,3578721197,26
1,822,10578,3578721171,3578721199,28
1,822,10579,3578721171,3578721199,28
1,822,10580,3578721171,3578721199,28
1,822,10581,3578721171,3578721200,29
1,822,10582,3578721171,3578721201,30
1,822,10583,3578721171,3578721206,35
1,822,10584,3578721171,3578721210,39
1,822,10585,3578721171,3578721211,40
1,822,10586,3578721171,3578721213,42
1,822,10587,3578721171,3578721213,42
1,822,10588,3578721171,3578721215,44
1,822,10589,3578721171,3578721216,45
1,822,10590,3578721171,3578721217,46
1,822,10591,3578721171,3578721218,47
1,822,10592,3578721171,3578721218,47
1,822,10593,3578721171,3578721219,48
1,822,10594,3578721171,3578721219,48
1,822,10595,3578721171,3578721220,49
1,823,10596,3578721226,3578721226,0
1,823,10597,3578721226,3578721226,0
1,823,10598,3578721226,3578721228,2
1,823,10599,3578721226,3578721229,3
1,823,10600,3578721226,3578721230,4
1,823,10601,3578721226,3578721230,4
1,823,10602,3578721226,3578721232,6
1,823,10603,3578721226,3578721236,10
1,823,10604,3578721226,3578721238,12
1,823,10605,3578721226,3578721239,13
1,823,10606,3578721226,3578721239,13
1,823,10607,3578721226,3578721240,14
1,823,10608,3578721226,3578721247,21
1,823,10609,3578721226,3578721249,23
1,823,10610,3578721226,3578721250,24
1,823,10611,3578721226,3578721252,26
1,823,10612,3578721226,3578721254,28
1,823,10613,3578721226,3578721255,29
1,823,10614,3578721226,3578721255,29
1,823,10615,3578721226,3578721255,29
1,823,10616,3578721226,3578721256,30
1,823,10617,3578721226,3578721256,30
1,823,10618,3578721226,3578721256,30
1,823,10619,3578721226,3578721257,31
1,823,10620,3578721226,3578721258,32
1,823,10621,3578721226,3578721260,34
1,823,10622,3578721226,3578721263,37
1,823,10623,3578721226,3578721263,37
1,823,10624,3578721226,3578721264,38
1,823,10625,3578721226,3578721264,38
1,823,10626,3578721226,3578721265,39
1,823,10627,3578721226,3578721267,41
1,823,10628,3578721226,3578721276,50
1,824,10629,3578721281,3578721281,0
1,824,10630,3578721281,3578721281,0
1,824,10631,3578721281,3578721282,1
1,824,10632,3578721281,3578721283,2
1,824,10633,3578721281,3578721285,4
1,824,10634,3578721281,3578721286,5
1,824,10635,3578721281,3578721287,6
1,824,10636,3578721281,3578721288,7
1,824,10637,3578721281,3578721288,7
1,824,10638,3578721281,3578721289,8
1,824,10639,3578721281,3578721292,11
1,824,10640,3578721281,3578721293,12
1,824,10641,3578721281,3578721294,13
1,824,10642,3578721281,3578721297,16
1,824,10643,3578721281,3578721298,17
1,824,10644,3578721281,3578721300,19
1,824,10645,3578721281,3578721301,20
1,824,10646,3578721281,3578721301,20
1,824,10647,3578721281,3578721302,21
1,824,10648,3578721281,3578721306,25
1,824,10649,3578721281,3578721308,27
1,824,10650,3578721281,3578721309,28
1,824,10651,3578721281,3578721310,29
1,824,10652,3578721281,3578721311,30
1,824,10653,3578721281,3578721313,32
1,824,10654,3578721281,3578721314,33
1,824,10655,3578721281,3578721315,34
1,824,10656,3578721281,3578721316,35
1,824,10657,3578721281,3578721317,36
1,824,10658,3578721281,3578721318,37
1,824,10659,3578721281,3578721318,37
1,824,10660,3578721281,3578721318,37
1,824,10661,3578721281,3578721318,37
1,824,10662,3578721281,3578721321,40
1,824,10663,3578721281,3578721323,42
1,824,10664,3578721281,3578721323,42
1,824,10665,3578721281,3578721324,43
1,824,10666,3578721281,3578721325,44
1,824,10667,3578721281,3578721326,45
1,824,10668,3578721281,3578721327,46
1,824,10669,3578721281,3578721328,47
1,824,10670,3578721281,3578721328,47
1,824,10671,3578721281,3578721328,47
1,824,10672,3578721281,3578721330,49
1,825,10673,3578721336,3578721336,0
1,825,10674,3578721336,3578721336,0
1,825,10675,3578721336,3578721336,0
1,825,10676,3578721336,3578721336,0
1,825,10677,3578721336,3578721336,0
1,825,10678,3578721336,3578721336,0
1,825,10679,3578721336,3578721336,0
1,825,10680,3578721336,3578721342,6
1,825,10681,3578721336,3578721346,10
1,825,10682,3578721336,3578721348,12
1,825,10683,3578721336,3578721349,13
1,825,10684,3578721336,3578721350,14
1,825,10685,3578721336,3578721354,18
1,825,10686,3578721336,3578721356,20
1,825,10687,3578721336,3578721358,22
1,825,10688,3578721336,3578721362,26
1,825,10689,3578721336,3578721364,28
1,825,10690,3578721336,3578721365,29
1,825,10691,3578721336,3578721368,32
1,825,10692,3578721336,3578721368,32
1,825,10693,3578721336,3578721368,32
1,825,10694,3578721336,3578721368,32
1,825,10695,3578721336,3578721368,32
1,825,10696,3578721336,3578721368,32
1,825,10697,3578721336,3578721371,35
1,825,10698,3578721336,3578721375,39
1,825,10699,3578721336,3578721376,40
1,825,10700,3578721336,3578721377,41
1,825,10701,3578721336,3578721380,44
1,825,10702,3578721336,3578721381,45
1,825,10703,3578721336,3578721382,46
1,825,10704,3578721336,3578721383,47
1,825,10705,3578721336,3578721385,49
1,826,10706,3578721393,3578721393,0
1,826,10707,3578721393,3578721393,0
1,826,10708,3578721393,3578721393,0
1,826,10709,3578721393,3578721393,0
1,826,10710,3578721393,3578721393,0
1,826,10711,3578721393,3578721394,1
1,826,10712,3578721393,3578721395,2
1,826,10713,3578721393,3578721398,5
1,826,10714,3578721393,3578721399,6
1,826,10715,3578721393,3578721399,6
1,826,10716,3578721393,3578721399,6
1,826,10717,3578721393,3578721401,8
1,826,10718,3578721393,3578721401,8
1,826,10719,3578721393,3578721406,13
1,826,10720,3578721393,3578721411,18
1,826,10721,3578721393,3578721411,18
1,826,10722,3578721393,3578721413,20
1,826,10723,3578721393,3578721413,20
1,826,10724,3578721393,3578721417,24
1,826,10725,3578721393,3578721417,24
1,826,10726,3578721393,3578721417,24
1,826,10727,3578721393,3578721419,26
1,826,10728,3578721393,3578721420,27
1,826,10729,3578721393,3578721421,28
1,826,10730,3578721393,3578721423,30
1,826,10731,3578721393,3578721425,32
1,826,10732,3578721393,3578721425,32
1,826,10733,3578721393,3578721428,35
1,826,10734,3578721393,3578721429,36
1,826,10735,3578721393,3578721430,37
1,826,10736,3578721393,3578721430,37
1,826,10737,3578721393,3578721431,38
1,826,10738,3578721393,3578721433,40
1,826,10739,3578721393,3578721437,44
1,826,10740,3578721393,3578721439,46
1,826,10741,3578721393,3578721439,46
1,826,10742,3578721393,3578721439,46
1,827,10743,3578721448,3578721448,0
1,827,10744,3578721448,3578721449,1
1,827,10745,3578721448,3578721451,3
1,827,10746,3578721448,3578721451,3
1,827,10747,3578721448,3578721454,6
1,827,10748,3578721448,3578721455,7
1,827,10749,3578721448,3578721456,8
1,827,10750,3578721448,3578721456,8
1,827,10751,3578721448,3578721456,8
1,827,10752,3578721448,3578721456,8
1,827,10753,3578721448,3578721457,9
1,827,10754,3578721448,3578721457,9
1,827,10755,3578721448,3578721459,11
1,827,10756,3578721448,3578721463,15
1,827,10757,3578721448,3578721463,15
1,827,10758,3578721448,3578721465,17
1,827,10759,3578721448,3578721465,17
1,827,10760,3578721448,3578721466,18
1,827,10761,3578721448,3578721467,19
1,827,10762,3578721448,3578721476,28
1,827,10763,3578721448,3578721480,32
1,827,10764,3578721448,3578721481,33
1,827,10765,3578721448,3578721482,34
1,827,10766,3578721448,3578721483,35
1,827,10767,3578721448,3578721485,37
1,827,10768,3578721448,3578721486,38
1,827,10769,3578721448,3578721487,39
1,827,10770,3578721448,3578721487,39
1,827,10771,3578721448,3578721487,39
1,827,10772,3578721448,3578721489,41
1,827,10773,3578721448,3578721492,44
1,827,10774,3578721448,3578721493,45
1,827,10775,3578721448,3578721493,45
1,827,10776,3578721448,3578721497,49
1,828,10777,3578721504,3578721504,0
1,828,10778,3578721504,3578721504,0
1,828,10779,3578721504,3578721504,0
1,828,10780,3578721504,3578721504,0
1,828,10781,3578721504,3578721504,0
1,828,10782,3578721504,3578721506,2
1,828,10783,3578721504,3578721507,3
1,828,10784,3578721504,3578721508,4
1,828,10785,3578721504,3578721510,6
1,828,10786,3578721504,3578721511,7
1,828,10787,3578721504,3578721512,8
1,828,10788,3578721504,3578721512,8
1,828,10789,3578721504,3578721514,10
1,828,10790,3578721504,3578721515,11
1,828,10791,3578721504,3578721516,12
1,828,10792,3578721504,3578721517,13
1,828,10793,3578721504,3578721517,13
1,828,10794,3578721504,3578721517,13
1,828,10795,3578721504,3578721518,14
1,828,10796,3578721504,3578721520,16
1,828,10797,3578721504,3578721522,18
1,828,10798,3578721504,3578721522,18
1,828,10799,3578721504,3578721522,18
1,828,10800,3578721504,3578721523,19
1,828,10801,3578721504,3578721524,20
1,828,10802,3578721504,3578721525,21
1,828,10803,3578721504,3578721526,22
1,828,10804,3578721504,3578721527,23
1,828,10805,3578721504,3578721527,23
1,828,10806,3578721504,3578721527,23
1,828,10807,3578721504,3578721529,25
1,828,10808,3578721504,3578721530,26
1,828,10809,3578721504,3578721532,28
1,828,10810,3578721504,3578721533,29
1,828,10811,3578721504,3578721534,30
1,828,10812,3578721504,3578721535,31
1,828,10813,3578721504,3578721535,31
1,828,10814,3578721504,3578721536,32
1,828,10815,3578721504,3578721542,38
1,828,10816,3578721504,3578721542,38
1,828,10817,3578721504,3578721545,41
1,828,10818,3578721504,3578721547,43
1,828,10819,3578721504,3578721548,44
1,828,10820,3578721504,3578721549,45
1,828,10821,3578721504,3578721553,49
1,829,10822,3578721560,3578721560,0
1,829,10823,3578721560,3578721560,0
1,829,10824,3578721560,3578721561,1
1,829,10825,3578721560,3578721562,2
1,829,10826,3578721560,3578721565,5
1,829,10827,3578721560,3578721566,6
1,829,10828,3578721560,3578721566,6
1,829,10829,3578721560,3578721566,6
1,829,10830,3578721560,3578721567,7
1,829,10831,3578721560,3578721567,7
1,829,10832,3578721560,3578721567,7
1,829,10833,3578721560,3578721568,8
1,829,10834,3578721560,3578721571,11
1,829,10835,3578721560,3578721574,14
1,829,10836,3578721560,3578721575,15
1,829,10837,3578721560,3578721576,16
1,829,10838,3578721560,3578721579,19
1,829,10839,3578721560,3578721580,20
1,829,10840,3578721560,3578721581,21
1,829,10841,3578721560,3578721583,23
1,829,10842,3578721560,3578721585,25
1,829,10843,3578721560,3578721586,26
1,829,10844,3578721560,3578721589,29
1,829,10845,3578721560,3578721589,29
1,829,10846,3578721560,3578721589,29
1,829,10847,3578721560,3578721590,30
1,829,10848,3578721560,3578721593,33
1,829,10849,3578721560,3578721595,35
1,829,10850,3578721560,3578721597,37
1,829,10851,3578721560,3578721597,37
1,829,10852,3578721560,3578721598,38
1,829,10853,3578721560,3578721599,39
1,829,10854,3578721560,3578721599,39
1,829,10855,3578721560,3578721600,40
1,829,10856,3578721560,3578721606,46
1,829,10857,3578721560,3578721610,50
1,830,10858,3578721615,3578721615,0
1,830,10859,3578721615,3578721615,0
1,830,10860,3578721615,3578721615,0
1,830,10861,3578721615,3578721616,1
1,830,10862,3578721615,3578721616,1
1,830,10863,3578721615,3578721617,2
1,830,10864,3578721615,3578721617,2
1,830,10865,3578721615,3578721618,3
1,830,10866,3578721615,3578721619,4
1,830,10867,3578721615,3578721619,4
1,830,10868,3578721615,3578721620,5
1,830,10869,3578721615,3578721622,7
1,830,10870,3578721615,3578721624,9
1,830,10871,3578721615,3578721624,9
1,830,10872,3578721615,3578721627,12
1,830,10873,3578721615,3578721629,14
1,830,10874,3578721615,3578721629,14
1,830,10875,3578721615,3578721630,15
1,830,10876,3578721615,3578721630,15
1,830,10877,3578721615,3578721636,21
1,830,10878,3578721615,3578721638,23
1,830,10879,3578721615,3578721638,23
1,830,10880,3578721615,3578721639,24
1,830,10881,3578721615,3578721639,24
1,830,10882,3578721615,3578721647,32
1,830,10883,3578721615,3578721649,34
1,830,10884,3578721615,3578721650,35
1,830,10885,3578721615,3578721651,36
1,830,10886,3578721615,3578721653,38
1,830,10887,3578721615,3578721654,39
1,830,10888,3578721615,3578721655,40
1,830,10889,3578721615,3578721655,40
1,830,10890,3578721615,3578721655,40
1,830,10891,3578721615,3578721655,40
1,830,10892,3578721615,3578721655,40
1,830,10893,3578721615,3578721656,41
1,830,10894,3578721615,3578721658,43
1,830,10895,3578721615,3578721662,47
1,830,10896,3578721615,3578721663,48
1,830,10897,3578721615,3578721664,49
1,830,10898,3578721615,3578721664,49
1,830,10899,3578721615,3578721665,50
1,831,10900,3578721670,3578721670,0
1,831,10901,3578721670,3578721676,6
1,831,10902,3578721670,3578721680,10
1,831,10903,3578721670,3578721681,11
1,831,10904,3578721670,3578721684,14
1,831,10905,3578721670,3578721686,16
1,831,10906,3578721670,3578721686,16
1,831,10907,3578721670,3578721687,17
1,831,10908,3578721670,3578721687,17
1,831,10909,3578721670,3578721687,17
1,831,10910,3578721670,3578721689,19
1,831,10911,3578721670,3578721691,21
1,831,10912,3578721670,3578721693,23
1,831,10913,3578721670,3578721693,23
1,831,10914,3578721670,3578721698,28
1,831,10915,3578721670,3578721701,31
1,831,10916,3578721670,3578721701,31
1,831,10917,3578721670,3578721701,31
1,831,10918,3578721670,3578721703,33
1,831,10919,3578721670,3578721705,35
1,831,10920,3578721670,3578721707,37
1,831,10921,3578721670,3578721709,39
1,831,10922,3578721670,3578721710,40
1,831,10923,3578721670,3578721711,41
1,831,10924,3578721670,3578721712,42
1,831,10925,3578721670,3578721713,43
1,831,10926,3578721670,3578721715,45
1,831,10927,3578721670,3578721716,46
1,831,10928,3578721670,3578721717,47
1,831,10929,3578721670,3578721718,48
1,831,10930,3578721670,3578721720,50
1,832,10931,3578721725,3578721725,0
1,832,10932,3578721725,3578721725,0
1,832,10933,3578721725,3578721725,0
1,832,10934,3578721725,3578721725,0
1,832,10935,3578721725,3578721725,0
1,832,10936,3578721725,3578721726,1
1,832,10937,3578721725,3578721727,2
1,832,10938,3578721725,3578721729,4
1,832,10939,3578721725,3578721730,5
1,832,10940,3578721725,3578721731,6
1,832,10941,3578721725,3578721733,8
1,832,10942,3578721725,3578721733,8
1,832,10943,3578721725,3578721734,9
1,832,10944,3578721725,3578721734,9
1,832,10945,3578721725,3578721735,10
1,832,10946,3578721725,3578721737,12
1,832,10947,3578721725,3578721742,17
1,832,10948,3578721725,3578721743,18
1,832,10949,3578721725,3578721744,19
1,832,10950,3578721725,3578721747,22
1,832,10951,3578721725,3578721748,23
1,832,10952,3578721725,3578721750,25
1,832,10953,3578721725,3578721754,29
1,832,10954,3578721725,3578721757,32
1,832,10955,3578721725,3578721757,32
1,832,10956,3578721725,3578721761,36
1,832,10957,3578721725,3578721763,38
1,832,10958,3578721725,3578721765,40
1,832,10959,3578721725,3578721766,41
1,832,10960,3578721725,3578721766,41
1,832,10961,3578721725,3578721767,42
1,832,10962,3578721725,3578721767,42
1,832,10963,3578721725,3578721767,42
1,832,10964,3578721725,3578721767,42
1,832,10965,3578721725,3578721768,43
1,832,10966,3578721725,3578721771,46
1,832,10967,3578721725,3578721774,49
1,832,10968,3578721725,3578721775,50
1,833,10969,3578721780,3578721780,0
1,833,10970,3578721780,3578721780,0
1,833,10971,3578721780,3578721780,0
1,833,10972,3578721780,3578721781,1
1,833,10973,3578721780,3578721783,3
1,833,10974,3578721780,3578721784,4
1,833,10975,3578721780,3578721787,7
1,833,10976,3578721780,3578721789,9
1,833,10977,3578721780,3578721790,10
1,833,10978,3578721780,3578721790,10
1,833,10979,3578721780,3578721791,11
1,833,10980,3578721780,3578721793,13
1,833,10981,3578721780,3578721795,15
1,833,10982,3578721780,3578721795,15
1,833,10983,3578721780,3578721797,17
1,833,10984,3578721780,3578721798,18
1,833,10985,3578721780,3578721798,18
1,833,10986,3578721780,3578721799,19
1,833,10987,3578721780,3578721799,19
1,833,10988,3578721780,3578721800,20
1,833,10989,3578721780,3578721806,26
1,833,10990,3578721780,3578721810,30
1,833,10991,3578721780,3578721811,31
1,833,10992,3578721780,3578721812,32
1,833,10993,3578721780,3578721812,32
1,833,10994,3578721780,3578721816,36
1,833,10995,3578721780,3578721817,37
1,833,10996,3578721780,3578721817,37
1,833,10997,3578721780,3578721818,38
1,833,10998,3578721780,3578721819,39
1,833,10999,3578721780,3578721821,41
1,833,11000,3578721780,3578721822,42
1,833,11001,3578721780,3578721824,44
1,833,11002,3578721780,3578721825,45
1,833,11003,3578721780,3578721828,48
1,833,11004,3578721780,3578721828,48
1,833,11005,3578721780,3578721829,49
1,833,11006,3578721780,3578721830,50
1,834,11007,3578721835,3578721835,0
1,834,11008,3578721835,3578721835,0
1,834,11009,3578721835,3578721835,0
1,834,11010,3578721835,3578721836,1
1,834,11011,3578721835,3578721838,3
1,834,11012,3578721835,3578721838,3
1,834,11013,3578721835,3578721839,4
1,834,11014,3578721835,3578721839,4
1,834,11015,3578721835,3578721847,12
1,834,11016,3578721835,3578721849,14
1,834,11017,3578721835,3578721850,15
1,834,11018,3578721835,3578721850,15
1,834,11019,3578721835,3578721853,18
1,834,11020,3578721835,3578721854,19
1,834,11021,3578721835,3578721855,20
1,834,11022,3578721835,3578721855,20
1,834,11023,3578721835,3578721855,20
1,834,11024,3578721835,3578721855,20
1,834,11025,3578721835,3578721856,21
1,834,11026,3578721835,3578721857,22
1,834,11027,3578721835,3578721858,23
1,834,11028,3578721835,3578721862,27
1,834,11029,3578721835,3578721862,27
1,834,11030,3578721835,3578721863,28
1,834,11031,3578721835,3578721864,29
1,834,11032,3578721835,3578721865,30
1,834,11033,3578721835,3578721866,31
1,834,11034,3578721835,3578721875,40
1,834,11035,3578721835,3578721880,45
1,834,11036,3578721835,3578721881,46
1,834,11037,3578721835,3578721882,47
1,834,11038,3578721835,3578721883,48
1,834,11039,3578721835,3578721885,50
1,835,11040,3578721891,3578721891,0
1,835,11041,3578721891,3578721891,0
1,835,11042,3578721891,3578721891,0
1,835,11043,3578721891,3578721891,0
1,835,11044,3578721891,3578721891,0
1,835,11045,3578721891,3578721891,0
1,835,11046,3578721891,3578721893,2
1,835,11047,3578721891,3578721893,2
1,835,11048,3578721891,3578721894,3
1,835,11049,3578721891,3578721897,6
1,835,11050,3578721891,3578721898,7
1,835,11051,3578721891,3578721900,9
1,835,11052,3578721891,3578721901,10
1,835,11053,3578721891,3578721901,10
1,835,11054,3578721891,3578721903,12
1,835,11055,3578721891,3578721905,14
1,835,11056,3578721891,3578721905,14
1,835,11057,3578721891,3578721907,16
1,835,11058,3578721891,3578721909,18
1,835,11059,3578721891,3578721910,19
1,835,11060,3578721891,3578721912,21
1,835,11061,3578721891,3578721913,22
1,835,11062,3578721891,3578721913,22
1,835,11063,3578721891,3578721915,24
1,835,11064,3578721891,3578721916,25
1,835,11065,3578721891,3578721916,25
1,835,11066,3578721891,3578721916,25
1,835,11067,3578721891,3578721917,26
1,835,11068,3578721891,3578721918,27
1,835,11069,3578721891,3578721920,29
1,835,11070,3578721891,3578721922,31
1,835,11071,3578721891,3578721923,32
1,835,11072,3578721891,3578721923,32
1,835,11073,3578721891,3578721923,32
1,835,11074,3578721891,3578721926,35
1,835,11075,3578721891,3578721927,36
1,835,11076,3578721891,3578721927,36
1,835,11077,3578721891,3578721929,38
1,835,11078,3578721891,3578721930,39
1,835,11079,3578721891,3578721932,41
1,835,11080,3578721891,3578721933,42
1,835,11081,3578721891,3578721935,44
1,835,11082,3578721891,3578721935,44
1,835,11083,3578721891,3578721935,44
1,835,11084,3578721891,3578721936,45
1,835,11085,3578721891,3578721941,50
1,836,11086,3578721946,3578721946,0
1,836,11087,3578721946,3578721946,0
1,836,11088,3578721946,3578721948,2
1,836,11089,3578721946,3578721949,3
1,836,11090,3578721946,3578721950,4
1,836,11091,3578721946,3578721954,8
1,836,11092,3578721946,3578721957,11
1,836,11093,3578721946,3578721957,11
1,836,11094,3578721946,3578721962,16
1,836,11095,3578721946,3578721963,17
1,836,11096,3578721946,3578721966,20
1,836,11097,3578721946,3578721966,20
1,836,11098,3578721946,3578721967,21
1,836,11099,3578721946,3578721967,21
1,836,11100,3578721946,3578721967,21
1,836,11101,3578721946,3578721967,21
1,836,11102,3578721946,3578721969,23
1,836,11103,3578721946,3578721970,24
1,836,11104,3578721946,3578721974,28
1,836,11105,3578721946,3578721976,30
1,836,11106,3578721946,3578721977,31
1,836,11107,3578721946,3578721979,33
1,836,11108,3578721946,3578721981,35
1,836,11109,3578721946,3578721982,36
1,836,11110,3578721946,3578721983,37
1,836,11111,3578721946,3578721987,41
1,836,11112,3578721946,3578721989,43
1,836,11113,3578721946,3578721990,44
1,836,11114,3578721946,3578721990,44
1,836,11115,3578721946,3578721994,48
1,836,11116,3578721946,3578721995,49
1,836,11117,3578721946,3578721995,49
1,837,11118,3578722002,3578722002,0
1,837,11119,3578722002,3578722002,0
1,837,11120,3578722002,3578722002,0
1,837,11121,3578722002,3578722002,0
1,837,11122,3578722002,3578722002,0
1,837,11123,3578722002,3578722006,4
1,837,11124,3578722002,3578722010,8
1,837,11125,3578722002,3578722011,9
1,837,11126,3578722002,3578722012,10
1,837,11127,3578722002,3578722012,10
1,837,11128,3578722002,3578722015,13
1,837,11129,3578722002,3578722016,14
1,837,11130,3578722002,3578722017,15
1,837,11131,3578722002,3578722018,16
1,837,11132,3578722002,3578722018,16
1,837,11133,3578722002,3578722018,16
1,837,11134,3578722002,3578722019,17
1,837,11135,3578722002,3578722020,18
1,837,11136,3578722002,3578722022,20
1,837,11137,3578722002,3578722024,22
1,837,11138,3578722002,3578722024,22
1,837,11139,3578722002,3578722027,25
1,837,11140,3578722002,3578722029,27
1,837,11141,3578722002,3578722030,28
1,837,11142,3578722002,3578722030,28
1,837,11143,3578722002,3578722032,30
1,837,11144,3578722002,3578722036,34
1,837,11145,3578722002,3578722036,34
1,837,11146,3578722002,3578722038,36
1,837,11147,3578722002,3578722039,37
1,837,11148,3578722002,3578722039,37
1,837,11149,3578722002,3578722046,44
1,837,11150,3578722002,3578722048,46
1,837,11151,3578722002,3578722049,47
1,837,11152,3578722002,3578722050,48
1,837,11153,3578722002,3578722052,50
1,838,11154,3578722057,3578722057,0
1,838,11155,3578722057,3578722057,0
1,838,11156,3578722057,3578722057,0
1,838,11157,3578722057,3578722057,0
1,838,11158,3578722057,3578722057,0
1,838,11159,3578722057,3578722057,0
1,838,11160,3578722057,3578722057,0
1,838,11161,3578722057,3578722057,0
1,838,11162,3578722057,3578722058,1
1,838,11163,3578722057,3578722062,5
1,838,11164,3578722057,3578722063,6
1,838,11165,3578722057,3578722063,6
1,838,11166,3578722057,3578722064,7
1,838,11167,3578722057,3578722064,7
1,838,11168,3578722057,3578722065,8
1,838,11169,3578722057,3578722066,9
1,838,11170,3578722057,3578722076,19
1,838,11171,3578722057,3578722081,24
1,838,11172,3578722057,3578722081,24
1,838,11173,3578722057,3578722082,25
1,838,11174,3578722057,3578722083,26
1,838,11175,3578722057,3578722085,28
1,838,11176,3578722057,3578722085,28
1,838,11177,3578722057,3578722086,29
1,838,11178,3578722057,3578722087,30
1,838,11179,3578722057,3578722087,30
1,838,11180,3578722057,3578722088,31
1,838,11181,3578722057,3578722091,34
1,838,11182,3578722057,3578722092,35
1,838,11183,3578722057,3578722092,35
1,838,11184,3578722057,3578722094,37
1,838,11185,3578722057,3578722097,40
1,838,11186,3578722057,3578722098,41
1,838,11187,3578722057,3578722100,43
1,838,11188,3578722057,3578722101,44
1,838,11189,3578722057,3578722103,46
1,838,11190,3578722057,3578722105,48
1,838,11191,3578722057,3578722107,50
1,839,11192,3578722113,3578722113,0
1,839,11193,3578722113,3578722113,0
1,839,11194,3578722113,3578722113,0
1,839,11195,3578722113,3578722113,0
1,839,11196,3578722113,3578722116,3
1,839,11197,3578722113,3578722117,4
1,839,11198,3578722113,3578722117,4
1,839,11199,3578722113,3578722117,4
1,839,11200,3578722113,3578722118,5
1,839,11201,3578722113,3578722119,6
1,839,11202,3578722113,3578722120,7
1,839,11203,3578722113,3578722122,9
1,839,11204,3578722113,3578722123,10
1,839,11205,3578722113,3578722123,10
1,839,11206,3578722113,3578722123,10
1,839,11207,3578722113,3578722124,11
1,839,11208,3578722113,3578722125,12
1,839,11209,3578722113,3578722126,13
1,839,11210,3578722113,3578722127,14
1,839,11211,3578722113,3578722127,14
1,839,11212,3578722113,3578722128,15
1,839,11213,3578722113,3578722130,17
1,839,11214,3578722113,3578722132,19
1,839,11215,3578722113,3578722133,20
1,839,11216,3578722113,3578722133,20
1,839,11217,3578722113,3578722135,22
1,839,11218,3578722113,3578722135,22
1,839,11219,3578722113,3578722136,23
1,839,11220,3578722113,3578722137,24
1,839,11221,3578722113,3578722141,28
1,839,11222,3578722113,3578722143,30
1,839,11223,3578722113,3578722145,32
1,839,11224,3578722113,3578722147,34
1,839,11225,3578722113,3578722148,35
1,839,11226,3578722113,3578722149,36
1,839,11227,3578722113,3578722150,37
1,839,11228,3578722113,3578722153,40
1,839,11229,3578722113,3578722157,44
1,839,11230,3578722113,3578722158,45
1,839,11231,3578722113,3578722162,49
1,840,11232,3578722168,3578722168,0
1,840,11233,3578722168,3578722168,0
1,840,11234,3578722168,3578722168,0
1,840,11235,3578722168,3578722168,0
1,840,11236,3578722168,3578722168,0
1,840,11237,3578722168,3578722168,0
1,840,11238,3578722168,3578722168,0
1,840,11239,3578722168,3578722169,1
1,840,11240,3578722168,3578722171,3
1,840,11241,3578722168,3578722174,6
1,840,11242,3578722168,3578722176,8
1,840,11243,3578722168,3578722177,9
1,840,11244,3578722168,3578722181,13
1,840,11245,3578722168,3578722182,14
1,840,11246,3578722168,3578722184,16
1,840,11247,3578722168,3578722185,17
1,840,11248,3578722168,3578722187,19
1,840,11249,3578722168,3578722189,21
1,840,11250,3578722168,3578722190,22
1,840,11251,3578722168,3578722190,22
1,840,11252,3578722168,3578722194,26
1,840,11253,3578722168,3578722195,27
1,840,11254,3578722168,3578722196,28
1,840,11255,3578722168,3578722198,30
1,840,11256,3578722168,3578722199,31
1,840,11257,3578722168,3578722199,31
1,840,11258,3578722168,3578722199,31
1,840,11259,3578722168,3578722200,32
1,840,11260,3578722168,3578722201,33
1,840,11261,3578722168,3578722202,34
1,840,11262,3578722168,3578722206,38
1,840,11263,3578722168,3578722210,42
1,840,11264,3578722168,3578722211,43
1,840,11265,3578722168,3578722212,44
1,840,11266,3578722168,3578722213,45
1,840,11267,3578722168,3578722217,49
1,841,11268,3578722224,3578722224,0
1,841,11269,3578722224,3578722224,0
1,841,11270,3578722224,3578722224,0
1,841,11271,3578722224,3578722224,0
1,841,11272,3578722224,3578722224,0
1,841,11273,3578722224,3578722225,1
1,841,11274,3578722224,3578722227,3
1,841,11275,3578722224,3578722229,5
1,841,11276,3578722224,3578722230,6
1,841,11277,3578722224,3578722230,6
1,841,11278,3578722224,3578722232,8
1,841,11279,3578722224,3578722236,12
1,841,11280,3578722224,3578722238,14
1,841,11281,3578722224,3578722239,15
1,841,11282,3578722224,3578722240,16
1,841,11283,3578722224,3578722246,22
1,841,11284,3578722224,3578722247,23
1,841,11285,3578722224,3578722249,25
1,841,11286,3578722224,3578722250,26
1,841,11287,3578722224,3578722251,27
1,841,11288,3578722224,3578722253,29
1,841,11289,3578722224,3578722255,31
1,841,11290,3578722224,3578722256,32
1,841,11291,3578722224,3578722256,32
1,841,11292,3578722224,3578722256,32
1,841,11293,3578722224,3578722256,32
1,841,11294,3578722224,3578722256,32
1,841,11295,3578722224,3578722256,32
1,841,11296,3578722224,3578722258,34
1,841,11297,3578722224,3578722261,37
1,841,11298,3578722224,3578722262,38
1,841,11299,3578722224,3578722263,39
1,841,11300,3578722224,3578722265,41
1,841,11301,3578722224,3578722265,41
1,841,11302,3578722224,3578722265,41
1,841,11303,3578722224,3578722268,44
1,842,11304,3578722280,3578722280,0
1,842,11305,3578722280,3578722281,1
1,842,11306,3578722280,3578722281,1
1,842,11307,3578722280,3578722282,2
1,842,11308,3578722280,3578722284,4
1,842,11309,3578722280,3578722286,6
1,842,11310,3578722280,3578722286,6
1,842,11311,3578722280,3578722287,7
1,842,11312,3578722280,3578722288,8
1,842,11313,3578722280,3578722288,8
1,842,11314,3578722280,3578722289,9
1,842,11315,3578722280,3578722290,10
1,842,11316,3578722280,3578722293,13
1,842,11317,3578722280,3578722293,13
1,842,11318,3578722280,3578722297,17
1,842,11319,3578722280,3578722298,18
1,842,11320,3578722280,3578722300,20
1,842,11321,3578722280,3578722301,21
1,842,11322,3578722280,3578722301,21
1,842,11323,3578722280,3578722304,24
1,842,11324,3578722280,3578722304,24
1,842,11325,3578722280,3578722306,26
1,842,11326,3578722280,3578722307,27
1,842,11327,3578722280,3578722309,29
1,842,11328,3578722280,3578722309,29
1,842,11329,3578722280,3578722312,32
1,842,11330,3578722280,3578722314,34
1,842,11331,3578722280,3578722316,36
1,842,11332,3578722280,3578722316,36
1,842,11333,3578722280,3578722317,37
1,842,11334,3578722280,3578722317,37
1,842,11335,3578722280,3578722318,38
1,842,11336,3578722280,3578722318,38
1,842,11337,3578722280,3578722318,38
1,842,11338,3578722280,3578722320,40
1,842,11339,3578722280,3578722322,42
1,842,11340,3578722280,3578722323,43
1,842,11341,3578722280,3578722323,43
1,842,11342,3578722280,3578722324,44
1,842,11343,3578722280,3578722325,45
1,842,11344,3578722280,3578722325,45
1,842,11345,3578722280,3578722326,46
1,842,11346,3578722280,3578722327,47
1,842,11347,3578722280,3578722328,48
1,843,11348,3578722336,3578722336,0
1,843,11349,3578722336,3578722336,0
1,843,11350,3578722336,3578722336,0
1,843,11351,3578722336,3578722336,0
1,843,11352,3578722336,3578722336,0
1,843,11353,3578722336,3578722336,0
1,843,11354,3578722336,3578722336,0
1,843,11355,3578722336,3578722338,2
1,843,11356,3578722336,3578722342,6
1,843,11357,3578722336,3578722343,7
1,843,11358,3578722336,3578722345,9
1,843,11359,3578722336,3578722347,11
1,843,11360,3578722336,3578722349,13
1,843,11361,3578722336,3578722351,15
1,843,11362,3578722336,3578722354,18
1,843,11363,3578722336,3578722358,22
1,843,11364,3578722336,3578722358,22
1,843,11365,3578722336,3578722362,26
1,843,11366,3578722336,3578722364,28
1,843,11367,3578722336,3578722366,30
1,843,11368,3578722336,3578722366,30
1,843,11369,3578722336,3578722367,31
1,843,11370,3578722336,3578722367,31
1,843,11371,3578722336,3578722367,31
1,843,11372,3578722336,3578722368,32
1,843,11373,3578722336,3578722368,32
1,843,11374,3578722336,3578722369,33
1,843,11375,3578722336,3578722371,35
1,843,11376,3578722336,3578722375,39
1,843,11377,3578722336,3578722377,41
1,843,11378,3578722336,3578722378,42
1,843,11379,3578722336,3578722381,45
1,843,11380,3578722336,3578722382,46
1,843,11381,3578722336,3578722385,49
1,843,11382,3578722336,3578722385,49
1,844,11383,3578722392,3578722392,0
1,844,11384,3578722392,3578722392,0
1,844,11385,3578722392,3578722392,0
1,844,11386,3578722392,3578722394,2
1,844,11387,3578722392,3578722395,3
1,844,11388,3578722392,3578722396,4
1,844,11389,3578722392,3578722398,6
1,844,11390,3578722392,3578722399,7
1,844,11391,3578722392,3578722399,7
1,844,11392,3578722392,3578722400,8
1,844,11393,3578722392,3578722402,10
1,844,11394,3578722392,3578722402,10
1,844,11395,3578722392,3578722406,14
1,844,11396,3578722392,3578722410,18
1,844,11397,3578722392,3578722411,19
1,844,11398,3578722392,3578722412,20
1,844,11399,3578722392,3578722413,21
1,844,11400,3578722392,3578722416,24
1,844,11401,3578722392,3578722417,25
1,844,11402,3578722392,3578722418,26
1,844,11403,3578722392,3578722418,26
1,844,11404,3578722392,3578722419,27
1,844,11405,3578722392,3578722420,28
1,844,11406,3578722392,3578722421,29
1,844,11407,3578722392,3578722422,30
1,844,11408,3578722392,3578722424,32
1,844,11409,3578722392,3578722425,33
1,844,11410,3578722392,3578722427,35
1,844,11411,3578722392,3578722429,37
1,844,11412,3578722392,3578722429,37
1,844,11413,3578722392,3578722430,38
1,844,11414,3578722392,3578722431,39
1,844,11415,3578722392,3578722432,40
1,844,11416,3578722392,3578722436,44
1,844,11417,3578722392,3578722436,44
1,844,11418,3578722392,3578722440,48
1,844,11419,3578722392,3578722440,48
1,844,11420,3578722392,3578722440,48
1,845,11421,3578722447,3578722447,0
1,845,11422,3578722447,3578722447,0
1,845,11423,3578722447,3578722449,2
1,845,11424,3578722447,3578722450,3
1,845,11425,3578722447,3578722452,5
1,845,11426,3578722447,3578722453,6
1,845,11427,3578722447,3578722454,7
1,845,11428,3578722447,3578722455,8
1,845,11429,3578722447,3578722456,9
1,845,11430,3578722447,3578722456,9
1,845,11431,3578722447,3578722456,9
1,845,11432,3578722447,3578722456,9
1,845,11433,3578722447,3578722457,10
1,845,11434,3578722447,3578722457,10
1,845,11435,3578722447,3578722459,12
1,845,11436,3578722447,3578722461,14
1,845,11437,3578722447,3578722462,15
1,845,11438,3578722447,3578722462,15
1,845,11439,3578722447,3578722464,17
1,845,11440,3578722447,3578722465,18
1,845,11441,3578722447,3578722466,19
1,845,11442,3578722447,3578722469,22
1,845,11443,3578722447,3578722481,34
1,845,11444,3578722447,3578722481,34
1,845,11445,3578722447,3578722482,35
1,845,11446,3578722447,3578722484,37
1,845,11447,3578722447,3578722486,39
1,845,11448,3578722447,3578722486,39
1,845,11449,3578722447,3578722487,40
1,845,11450,3578722447,3578722489,42
1,845,11451,3578722447,3578722489,42
1,845,11452,3578722447,3578722489,42
1,845,11453,3578722447,3578722490,43
1,845,11454,3578722447,3578722493,46
1,845,11455,3578722447,3578722494,47
1,846,11456,3578722502,3578722502,0
1,846,11457,3578722502,3578722502,0
1,846,11458,3578722502,3578722502,0
1,846,11459,3578722502,3578722502,0
1,846,11460,3578722502,3578722502,0
1,846,11461,3578722502,3578722504,2
1,846,11462,3578722502,3578722504,2
1,846,11463,3578722502,3578722506,4
1,846,11464,3578722502,3578722508,6
1,846,11465,3578722502,3578722509,7
1,846,11466,3578722502,3578722512,10
1,846,11467,3578722502,3578722513,11
1,846,11468,3578722502,3578722515,13
1,846,11469,3578722502,3578722515,13
1,846,11470,3578722502,3578722516,14
1,846,11471,3578722502,3578722517,15
1,846,11472,3578722502,3578722517,15
1,846,11473,3578722502,3578722518,16
1,846,11474,3578722502,3578722520,18
1,846,11475,3578722502,3578722521,19
1,846,11476,3578722502,3578722522,20
1,846,11477,3578722502,3578722522,20
1,846,11478,3578722502,3578722524,22
1,846,11479,3578722502,3578722524,22
1,846,11480,3578722502,3578722526,24
1,846,11481,3578722502,3578722527,25
1,846,11482,3578722502,3578722527,25
1,846,11483,3578722502,3578722527,25
1,846,11484,3578722502,3578722529,27
1,846,11485,3578722502,3578722531,29
1,846,11486,3578722502,3578722532,30
1,846,11487,3578722502,3578722532,30
1,846,11488,3578722502,3578722533,31
1,846,11489,3578722502,3578722533,31
1,846,11490,3578722502,3578722534,32
1,846,11491,3578722502,3578722536,34
1,846,11492,3578722502,3578722542,40
1,846,11493,3578722502,3578722542,40
1,846,11494,3578722502,3578722543,41
1,846,11495,3578722502,3578722546,44
1,846,11496,3578722502,3578722547,45
1,846,11497,3578722502,3578722549,47
1,847,11498,3578722558,3578722558,0
1,847,11499,3578722558,3578722558,0
1,847,11500,3578722558,3578722558,0
1,847,11501,3578722558,3578722558,0
1,847,11502,3578722558,3578722561,3
1,847,11503,3578722558,3578722566,8
1,847,11504,3578722558,3578722566,8
1,847,11505,3578722558,3578722566,8
1,847,11506,3578722558,3578722566,8
1,847,11507,3578722558,3578722567,9
1,847,11508,3578722558,3578722567,9
1,847,11509,3578722558,3578722568,10
1,847,11510,3578722558,3578722568,10
1,847,11511,3578722558,3578722575,17
1,847,11512,3578722558,3578722576,18
1,847,11513,3578722558,3578722577,19
1,847,11514,3578722558,3578722579,21
1,847,11515,3578722558,3578722581,23
1,847,11516,3578722558,3578722583,25
1,847,11517,3578722558,3578722585,27
1,847,11518,3578722558,3578722587,29
1,847,11519,3578722558,3578722588,30
1,847,11520,3578722558,3578722589,31
1,847,11521,3578722558,3578722590,32
1,847,11522,3578722558,3578722590,32
1,847,11523,3578722558,3578722594,36
1,847,11524,3578722558,3578722594,36
1,847,11525,3578722558,3578722595,37
1,847,11526,3578722558,3578722596,38
1,847,11527,3578722558,3578722598,40
1,847,11528,3578722558,3578722600,42
1,847,11529,3578722558,3578722601,43
1,847,11530,3578722558,3578722602,44
1,847,11531,3578722558,3578722604,46
1,847,11532,3578722558,3578722606,48
1,848,11533,3578722614,3578722614,0
1,848,11534,3578722614,3578722614,0
1,848,11535,3578722614,3578722614,0
1,848,11536,3578722614,3578722614,0
1,848,11537,3578722614,3578722616,2
1,848,11538,3578722614,3578722616,2
1,848,11539,3578722614,3578722617,3
1,848,11540,3578722614,3578722617,3
1,848,11541,3578722614,3578722619,5
1,848,11542,3578722614,3578722620,6
1,848,11543,3578722614,3578722621,7
1,848,11544,3578722614,3578722623,9
1,848,11545,3578722614,3578722625,11
1,848,11546,3578722614,3578722628,14
1,848,11547,3578722614,3578722628,14
1,848,11548,3578722614,3578722629,15
1,848,11549,3578722614,3578722629,15
1,848,11550,3578722614,3578722630,16
1,848,11551,3578722614,3578722635,21
1,848,11552,3578722614,3578722635,21
1,848,11553,3578722614,3578722637,23
1,848,11554,3578722614,3578722638,24
1,848,11555,3578722614,3578722638,24
1,848,11556,3578722614,3578722640,26
1,848,11557,3578722614,3578722644,30
1,848,11558,3578722614,3578722647,33
1,848,11559,3578722614,3578722648,34
1,848,11560,3578722614,3578722649,35
1,848,11561,3578722614,3578722650,36
1,848,11562,3578722614,3578722652,38
1,848,11563,3578722614,3578722653,39
1,848,11564,3578722614,3578722654,40
1,848,11565,3578722614,3578722655,41
1,848,11566,3578722614,3578722655,41
1,848,11567,3578722614,3578722656,42
1,848,11568,3578722614,3578722656,42
1,848,11569,3578722614,3578722656,42
1,848,11570,3578722614,3578722657,43
1,848,11571,3578722614,3578722659,45
1,848,11572,3578722614,3578722660,46
1,848,11573,3578722614,3578722661,47
1,848,11574,3578722614,3578722662,48
1,849,11575,3578722669,3578722669,0
1,849,11576,3578722669,3578722669,0
1,849,11577,3578722669,3578722669,0
1,849,11578,3578722669,3578722669,0
1,849,11579,3578722669,3578722676,7
1,849,11580,3578722669,3578722680,11
1,849,11581,3578722669,3578722681,12
1,849,11582,3578722669,3578722682,13
1,849,11583,3578722669,3578722683,14
1,849,11584,3578722669,3578722685,16
1,849,11585,3578722669,3578722686,17
1,849,11586,3578722669,3578722687,18
1,849,11587,3578722669,3578722689,20
1,849,11588,3578722669,3578722689,20
1,849,11589,3578722669,3578722690,21
1,849,11590,3578722669,3578722690,21
1,849,11591,3578722669,3578722692,23
1,849,11592,3578722669,3578722693,24
1,849,11593,3578722669,3578722694,25
1,849,11594,3578722669,3578722698,29
1,849,11595,3578722669,3578722700,31
1,849,11596,3578722669,3578722700,31
1,849,11597,3578722669,3578722701,32
1,849,11598,3578722669,3578722702,33
1,849,11599,3578722669,3578722704,35
1,849,11600,3578722669,3578722704,35
1,849,11601,3578722669,3578722705,36
1,849,11602,3578722669,3578722706,37
1,849,11603,3578722669,3578722709,40
1,849,11604,3578722669,3578722709,40
1,849,11605,3578722669,3578722712,43
1,849,11606,3578722669,3578722713,44
1,849,11607,3578722669,3578722715,46
1,849,11608,3578722669,3578722715,46
1,849,11609,3578722669,3578722716,47
1,849,11610,3578722669,3578722717,48
1,850,11611,3578722725,3578722726,1
1,850,11612,3578722725,3578722726,1
1,850,11613,3578722725,3578722726,1
1,850,11614,3578722725,3578722726,1
1,850,11615,3578722725,3578722726,1
1,850,11616,3578722725,3578722726,1
1,850,11617,3578722725,3578722726,1
1,850,11618,3578722725,3578722727,2
1,850,11619,3578722725,3578722727,2
1,850,11620,3578722725,3578722727,2
1,850,11621,3578722725,3578722729,4
1,850,11622,3578722725,3578722731,6
1,850,11623,3578722725,3578722732,7
1,850,11624,3578722725,3578722734,9
1,850,11625,3578722725,3578722734,9
1,850,11626,3578722725,3578722735,10
1,850,11627,3578722725,3578722737,12
1,850,11628,3578722725,3578722743,18
1,850,11629,3578722725,3578722743,18
1,850,11630,3578722725,3578722743,18
1,850,11631,3578722725,3578722746,21
1,850,11632,3578722725,3578722748,23
1,850,11633,3578722725,3578722750,25
1,850,11634,3578722725,3578722752,27
1,850,11635,3578722725,3578722753,28
1,850,11636,3578722725,3578722756,31
1,850,11637,3578722725,3578722758,33
1,850,11638,3578722725,3578722761,36
1,850,11639,3578722725,3578722766,41
1,850,11640,3578722725,3578722766,41
1,850,11641,3578722725,3578722766,41
1,850,11642,3578722725,3578722766,41
1,850,11643,3578722725,3578722768,43
1,850,11644,3578722725,3578722768,43
1,850,11645,3578722725,3578722768,43
1,850,11646,3578722725,3578722769,44
1,851,11647,3578722782,3578722782,0
1,851,11648,3578722782,3578722782,0
1,851,11649,3578722782,3578722782,0
1,851,11650,3578722782,3578722783,1
1,851,11651,3578722782,3578722783,1
1,851,11652,3578722782,3578722783,1
1,851,11653,3578722782,3578722785,3
1,851,11654,3578722782,3578722787,5
1,851,11655,3578722782,3578722789,7
1,851,11656,3578722782,3578722789,7
1,851,11657,3578722782,3578722790,8
1,851,11658,3578722782,3578722791,9
1,851,11659,3578722782,3578722794,12
1,851,11660,3578722782,3578722794,12
1,851,11661,3578722782,3578722795,13
1,851,11662,3578722782,3578722796,14
1,851,11663,3578722782,3578722798,16
1,851,11664,3578722782,3578722799,17
1,851,11665,3578722782,3578722800,18
1,851,11666,3578722782,3578722801,19
1,851,11667,3578722782,3578722802,20
1,851,11668,3578722782,3578722804,22
1,851,11669,3578722782,3578722809,27
1,851,11670,3578722782,3578722811,29
1,851,11671,3578722782,3578722813,31
1,851,11672,3578722782,3578722813,31
1,851,11673,3578722782,3578722816,34
1,851,11674,3578722782,3578722817,35
1,851,11675,3578722782,3578722818,36
1,851,11676,3578722782,3578722818,36
1,851,11677,3578722782,3578722819,37
1,851,11678,3578722782,3578722820,38
1,851,11679,3578722782,3578722821,39
1,851,11680,3578722782,3578722822,40
1,851,11681,3578722782,3578722824,42
1,851,11682,3578722782,3578722825,43
1,851,11683,3578722782,3578722827,45
1,851,11684,3578722782,3578722829,47
1,851,11685,3578722782,3578722830,48
1,851,11686,3578722782,3578722832,50
1,852,11687,3578722838,3578722838,0
1,852,11688,3578722838,3578722838,0
1,852,11689,3578722838,3578722838,0
1,852,11690,3578722838,3578722839,1
1,852,11691,3578722838,3578722840,2
1,852,11692,3578722838,3578722845,7
1,852,11693,3578722838,3578722847,9
1,852,11694,3578722838,3578722849,11
1,852,11695,3578722838,3578722850,12
1,852,11696,3578722838,3578722850,12
1,852,11697,3578722838,3578722852,14
1,852,11698,3578722838,3578722853,15
1,852,11699,3578722838,3578722854,16
1,852,11700,3578722838,3578722855,17
1,852,11701,3578722838,3578722855,17
1,852,11702,3578722838,3578722856,18
1,852,11703,3578722838,3578722857,19
1,852,11704,3578722838,3578722857,19
1,852,11705,3578722838,3578722857,19
1,852,11706,3578722838,3578722858,20
1,852,11707,3578722838,3578722861,23
1,852,11708,3578722838,3578722861,23
1,852,11709,3578722838,3578722862,24
1,852,11710,3578722838,3578722864,26
1,852,11711,3578722838,3578722867,29
1,852,11712,3578722838,3578722869,31
1,852,11713,3578722838,3578722876,38
1,852,11714,3578722838,3578722881,43
1,852,11715,3578722838,3578722881,43
1,852,11716,3578722838,3578722882,44
1,852,11717,3578722838,3578722883,45
1,852,11718,3578722838,3578722884,46
1,852,11719,3578722838,3578722885,47
1,852,11720,3578722838,3578722886,48
1,852,11721,3578722838,3578722887,49
1,853,11722,3578722894,3578722894,0
1,853,11723,3578722894,3578722894,0
1,853,11724,3578722894,3578722894,0
1,853,11725,3578722894,3578722894,0
1,853,11726,3578722894,3578722894,0
1,853,11727,3578722894,3578722894,0
1,853,11728,3578722894,3578722894,0
1,853,11729,3578722894,3578722898,4
1,853,11730,3578722894,3578722898,4
1,853,11731,3578722894,3578722900,6
1,853,11732,3578722894,3578722901,7
1,853,11733,3578722894,3578722903,9
1,853,11734,3578722894,3578722904,10
1,853,11735,3578722894,3578722905,11
1,853,11736,3578722894,3578722906,12
1,853,11737,3578722894,3578722909,15
1,853,11738,3578722894,3578722910,16
1,853,11739,3578722894,3578722912,18
1,853,11740,3578722894,3578722913,19
1,853,11741,3578722894,3578722915,21
1,853,11742,3578722894,3578722916,22
1,853,11743,3578722894,3578722917,23
1,853,11744,3578722894,3578722918,24
1,853,11745,3578722894,3578722920,26
1,853,11746,3578722894,3578722921,27
1,853,11747,3578722894,3578722922,28
1,853,11748,3578722894,3578722924,30
1,853,11749,3578722894,3578722924,30
1,853,11750,3578722894,3578722924,30
1,853,11751,3578722894,3578722926,32
1,853,11752,3578722894,3578722927,33
1,853,11753,3578722894,3578722927,33
1,853,11754,3578722894,3578722929,35
1,853,11755,3578722894,3578722932,38
1,853,11756,3578722894,3578722932,38
1,853,11757,3578722894,3578722933,39
1,853,11758,3578722894,3578722933,39
1,853,11759,3578722894,3578722934,40
1,853,11760,3578722894,3578722935,41
1,853,11761,3578722894,3578722943,49
1,853,11762,3578722894,3578722943,49
1,854,11763,3578722950,3578722950,0
1,854,11764,3578722950,3578722950,0
1,854,11765,3578722950,3578722953,3
1,854,11766,3578722950,3578722958,8
1,854,11767,3578722950,3578722962,12
1,854,11768,3578722950,3578722966,16
1,854,11769,3578722950,3578722966,16
1,854,11770,3578722950,3578722966,16
1,854,11771,3578722950,3578722967,17
1,854,11772,3578722950,3578722967,17
1,854,11773,3578722950,3578722968,18
1,854,11774,3578722950,3578722968,18
1,854,11775,3578722950,3578722970,20
1,854,11776,3578722950,3578722971,21
1,854,11777,3578722950,3578722976,26
1,854,11778,3578722950,3578722976,26
1,854,11779,3578722950,3578722981,31
1,854,11780,3578722950,3578722983,33
1,854,11781,3578722950,3578722983,33
1,854,11782,3578722950,3578722987,37
1,854,11783,3578722950,3578722988,38
1,854,11784,3578722950,3578722989,39
1,854,11785,3578722950,3578722991,41
1,854,11786,3578722950,3578722992,42
1,854,11787,3578722950,3578722994,44
1,854,11788,3578722950,3578722994,44
1,854,11789,3578722950,3578722995,45
1,854,11790,3578722950,3578722996,46
1,854,11791,3578722950,3578722999,49
1,854,11792,3578722950,3578722999,49
1,854,11793,3578722950,3578722999,49
1,855,11794,3578723007,3578723007,0
1,855,11795,3578723007,3578723007,0
1,855,11796,3578723007,3578723007,0
1,855,11797,3578723007,3578723009,2
1,855,11798,3578723007,3578723012,5
1,855,11799,3578723007,3578723013,6
1,855,11800,3578723007,3578723014,7
1,855,11801,3578723007,3578723014,7
1,855,11802,3578723007,3578723016,9
1,855,11803,3578723007,3578723018,11
1,855,11804,3578723007,3578723018,11
1,855,11805,3578723007,3578723018,11
1,855,11806,3578723007,3578723018,11
1,855,11807,3578723007,3578723020,13
1,855,11808,3578723007,3578723021,14
1,855,11809,3578723007,3578723023,16
1,855,11810,3578723007,3578723024,17
1,855,11811,3578723007,3578723025,18
1,855,11812,3578723007,3578723027,20
1,855,11813,3578723007,3578723028,21
1,855,11814,3578723007,3578723029,22
1,855,11815,3578723007,3578723029,22
1,855,11816,3578723007,3578723030,23
1,855,11817,3578723007,3578723032,25
1,855,11818,3578723007,3578723035,28
1,855,11819,3578723007,3578723038,31
1,855,11820,3578723007,3578723039,32
1,855,11821,3578723007,3578723039,32
1,855,11822,3578723007,3578723040,33
1,855,11823,3578723007,3578723045,38
1,855,11824,3578723007,3578723047,40
1,855,11825,3578723007,3578723049,42
1,855,11826,3578723007,3578723050,43
1,855,11827,3578723007,3578723051,44
1,855,11828,3578723007,3578723052,45
1,855,11829,3578723007,3578723053,46
1,855,11830,3578723007,3578723055,48
1,855,11831,3578723007,3578723055,48
1,855,11832,3578723007,3578723055,48
1,855,11833,3578723007,3578723056,49
1,855,11834,3578723007,3578723057,50
1,856,11835,3578723063,3578723063,0
1,856,11836,3578723063,3578723063,0
1,856,11837,3578723063,3578723063,0
1,856,11838,3578723063,3578723063,0
1,856,11839,3578723063,3578723063,0
1,856,11840,3578723063,3578723063,0
1,856,11841,3578723063,3578723064,1
1,856,11842,3578723063,3578723065,2
1,856,11843,3578723063,3578723068,5
1,856,11844,3578723063,3578723070,7
1,856,11845,3578723063,3578723075,12
1,856,11846,3578723063,3578723080,17
1,856,11847,3578723063,3578723081,18
1,856,11848,3578723063,3578723082,19
1,856,11849,3578723063,3578723083,20
1,856,11850,3578723063,3578723084,21
1,856,11851,3578723063,3578723085,22
1,856,11852,3578723063,3578723086,23
1,856,11853,3578723063,3578723087,24
1,856,11854,3578723063,3578723089,26
1,856,11855,3578723063,3578723090,27
1,856,11856,3578723063,3578723090,27
1,856,11857,3578723063,3578723093,30
1,856,11858,3578723063,3578723094,31
1,856,11859,3578723063,3578723098,35
1,856,11860,3578723063,3578723099,36
1,856,11861,3578723063,3578723100,37
1,856,11862,3578723063,3578723100,37
1,856,11863,3578723063,3578723103,40
1,856,11864,3578723063,3578723104,41
1,856,11865,3578723063,3578723105,42
1,856,11866,3578723063,3578723105,42
1,856,11867,3578723063,3578723106,43
1,856,11868,3578723063,3578723110,47
1,856,11869,3578723063,3578723110,47
1,856,11870,3578723063,3578723112,49
1,856,11871,3578723063,3578723113,50
1,857,11872,3578723117,3578723117,0
1,857,11873,3578723117,3578723117,0
1,857,11874,3578723117,3578723117,0
1,857,11875,3578723117,3578723117,0
1,857,11876,3578723117,3578723117,0
1,857,11877,3578723117,3578723118,1
1,857,11878,3578723117,3578723119,2
1,857,11879,3578723117,3578723119,2
1,857,11880,3578723117,3578723120,3
1,857,11881,3578723117,3578723121,4
1,857,11882,3578723117,3578723122,5
1,857,11883,3578723117,3578723124,7
1,857,11884,3578723117,3578723124,7
1,857,11885,3578723117,3578723124,7
1,857,11886,3578723117,3578723126,9
1,857,11887,3578723117,3578723127,10
1,857,11888,3578723117,3578723127,10
1,857,11889,3578723117,3578723129,12
1,857,11890,3578723117,3578723131,14
1,857,11891,3578723117,3578723133,16
1,857,11892,3578723117,3578723133,16
1,857,11893,3578723117,3578723133,16
1,857,11894,3578723117,3578723133,16
1,857,11895,3578723117,3578723134,17
1,857,11896,3578723117,3578723135,18
1,857,11897,3578723117,3578723138,21
1,857,11898,3578723117,3578723143,26
1,857,11899,3578723117,3578723144,27
1,857,11900,3578723117,3578723147,30
1,857,11901,3578723117,3578723148,31
1,857,11902,3578723117,3578723150,33
1,857,11903,3578723117,3578723153,36
1,857,11904,3578723117,3578723158,41
1,857,11905,3578723117,3578723162,45
1,857,11906,3578723117,3578723164,47
1,857,11907,3578723117,3578723165,48
1,857,11908,3578723117,3578723165,48
1,857,11909,3578723117,3578723166,49
1,857,11910,3578723117,3578723166,49
1,858,11911,3578723173,3578723173,0
1,858,11912,3578723173,3578723173,0
1,858,11913,3578723173,3578723173,0
1,858,11914,3578723173,3578723173,0
1,858,11915,3578723173,3578723173,0
1,858,11916,3578723173,3578723175,2
1,858,11917,3578723173,3578723177,4
1,858,11918,3578723173,3578723181,8
1,858,11919,3578723173,3578723183,10
1,858,11920,3578723173,3578723183,10
1,858,11921,3578723173,3578723186,13
1,858,11922,3578723173,3578723187,14
1,858,11923,3578723173,3578723189,16
1,858,11924,3578723173,3578723190,17
1,858,11925,3578723173,3578723191,18
1,858,11926,3578723173,3578723194,21
1,858,11927,3578723173,3578723195,22
1,858,11928,3578723173,3578723195,22
1,858,11929,3578723173,3578723197,24
1,858,11930,3578723173,3578723199,26
1,858,11931,3578723173,3578723199,26
1,858,11932,3578723173,3578723200,27
1,858,11933,3578723173,3578723202,29
1,858,11934,3578723173,3578723202,29
1,858,11935,3578723173,3578723204,31
1,858,11936,3578723173,3578723206,33
1,858,11937,3578723173,3578723210,37
1,858,11938,3578723173,3578723211,38
1,858,11939,3578723173,3578723214,41
1,858,11940,3578723173,3578723215,42
1,858,11941,3578723173,3578723215,42
1,858,11942,3578723173,3578723215,42
1,858,11943,3578723173,3578723217,44
1,858,11944,3578723173,3578723217,44
1,858,11945,3578723173,3578723218,45
1,858,11946,3578723173,3578723218,45
1,858,11947,3578723173,3578723218,45
1,858,11948,3578723173,3578723219,46
1,858,11949,3578723173,3578723219,46
1,858,11950,3578723173,3578723221,48
1,858,11951,3578723173,3578723223,50
1,859,11952,3578723228,3578723228,0
1,859,11953,3578723228,3578723228,0
1,859,11954,3578723228,3578723228,0
1,859,11955,3578723228,3578723229,1
1,859,11956,3578723228,3578723229,1
1,859,11957,3578723228,3578723230,2
1,859,11958,3578723228,3578723232,4
1,859,11959,3578723228,3578723235,7
1,859,11960,3578723228,3578723238,10
1,859,11961,3578723228,3578723239,11
1,859,11962,3578723228,3578723240,12
1,859,11963,3578723228,3578723241,13
1,859,11964,3578723228,3578723243,15
1,859,11965,3578723228,3578723245,17
1,859,11966,3578723228,3578723247,19
1,859,11967,3578723228,3578723249,21
1,859,11968,3578723228,3578723250,22
1,859,11969,3578723228,3578723251,23
1,859,11970,3578723228,3578723252,24
1,859,11971,3578723228,3578723254,26
1,859,11972,3578723228,3578723255,27
1,859,11973,3578723228,3578723255,27
1,859,11974,3578723228,3578723255,27
1,859,11975,3578723228,3578723256,28
1,859,11976,3578723228,3578723256,28
1,859,11977,3578723228,3578723256,28
1,859,11978,3578723228,3578723258,30
1,859,11979,3578723228,3578723259,31
1,859,11980,3578723228,3578723261,33
1,859,11981,3578723228,3578723262,34
1,859,11982,3578723228,3578723263,35
1,859,11983,3578723228,3578723265,37
1,859,11984,3578723228,3578723266,38
1,859,11985,3578723228,3578723267,39
1,859,11986,3578723228,3578723269,41
1,859,11987,3578723228,3578723276,48
1,860,11988,3578723284,3578723284,0
1,860,11989,3578723284,3578723284,0
1,860,11990,3578723284,3578723284,0
1,860,11991,3578723284,3578723284,0
1,860,11992,3578723284,3578723285,1
1,860,11993,3578723284,3578723286,2
1,860,11994,3578723284,3578723289,5
1,860,11995,3578723284,3578723290,6
1,860,11996,3578723284,3578723290,6
1,860,11997,3578723284,3578723291,7
1,860,11998,3578723284,3578723293,9
1,860,11999,3578723284,3578723294,10
1,860,12000,3578723284,3578723298,14
1,860,12001,3578723284,3578723299,15
1,860,12002,3578723284,3578723300,16
1,860,12003,3578723284,3578723301,17
1,860,12004,3578723284,3578723301,17
1,860,12005,3578723284,3578723304,20
1,860,12006,3578723284,3578723304,20
1,860,12007,3578723284,3578723305,21
1,860,12008,3578723284,3578723306,22
1,860,12009,3578723284,3578723306,22
1,860,12010,3578723284,3578723311,27
1,860,12011,3578723284,3578723311,27
1,860,12012,3578723284,3578723313,29
1,860,12013,3578723284,3578723313,29
1,860,12014,3578723284,3578723315,31
1,860,12015,3578723284,3578723317,33
1,860,12016,3578723284,3578723317,33
1,860,12017,3578723284,3578723318,34
1,860,12018,3578723284,3578723318,34
1,860,12019,3578723284,3578723319,35
1,860,12020,3578723284,3578723319,35
1,860,12021,3578723284,3578723320,36
1,860,12022,3578723284,3578723321,37
1,860,12023,3578723284,3578723322,38
1,860,12024,3578723284,3578723324,40
1,860,12025,3578723284,3578723324,40
1,860,12026,3578723284,3578723324,40
1,860,12027,3578723284,3578723324,40
1,860,12028,3578723284,3578723326,42
1,860,12029,3578723284,3578723328,44
1,860,12030,3578723284,3578723330,46
1,860,12031,3578723284,3578723331,47
1,860,12032,3578723284,3578723333,49
1,860,12033,3578723284,3578723333,49
1,860,12034,3578723284,3578723334,50
1,861,12035,3578723339,3578723340,1
1,861,12036,3578723339,3578723340,1
1,861,12037,3578723339,3578723343,4
1,861,12038,3578723339,3578723344,5
1,861,12039,3578723339,3578723347,8
1,861,12040,3578723339,3578723348,9
1,861,12041,3578723339,3578723349,10
1,861,12042,3578723339,3578723353,14
1,861,12043,3578723339,3578723354,15
1,861,12044,3578723339,3578723359,20
1,861,12045,3578723339,3578723361,22
1,861,12046,3578723339,3578723365,26
1,861,12047,3578723339,3578723366,27
1,861,12048,3578723339,3578723367,28
1,861,12049,3578723339,3578723367,28
1,861,12050,3578723339,3578723367,28
1,861,12051,3578723339,3578723368,29
1,861,12052,3578723339,3578723369,30
1,861,12053,3578723339,3578723370,31
1,861,12054,3578723339,3578723370,31
1,861,12055,3578723339,3578723372,33
1,861,12056,3578723339,3578723376,37
1,861,12057,3578723339,3578723377,38
1,861,12058,3578723339,3578723381,42
1,861,12059,3578723339,3578723383,44
1,861,12060,3578723339,3578723384,45
1,861,12061,3578723339,3578723386,47
1,861,12062,3578723339,3578723387,48
1,862,12063,3578723398,3578723398,0
1,862,12064,3578723398,3578723398,0
1,862,12065,3578723398,3578723398,0
1,862,12066,3578723398,3578723398,0
1,862,12067,3578723398,3578723398,0
1,862,12068,3578723398,3578723398,0
1,862,12069,3578723398,3578723399,1
1,862,12070,3578723398,3578723399,1
1,862,12071,3578723398,3578723399,1
1,862,12072,3578723398,3578723400,2
1,862,12073,3578723398,3578723402,4
1,862,12074,3578723398,3578723402,4
1,862,12075,3578723398,3578723404,6
1,862,12076,3578723398,3578723410,12
1,862,12077,3578723398,3578723412,14
1,862,12078,3578723398,3578723415,17
1,862,12079,3578723398,3578723415,17
1,862,12080,3578723398,3578723415,17
1,862,12081,3578723398,3578723416,18
1,862,12082,3578723398,3578723417,19
1,862,12083,3578723398,3578723417,19
1,862,12084,3578723398,3578723419,21
1,862,12085,3578723398,3578723419,21
1,862,12086,3578723398,3578723419,21
1,862,12087,3578723398,3578723420,22
1,862,12088,3578723398,3578723421,23
1,862,12089,3578723398,3578723423,25
1,862,12090,3578723398,3578723424,26
1,862,12091,3578723398,3578723427,29
1,862,12092,3578723398,3578723427,29
1,862,12093,3578723398,3578723428,30
1,862,12094,3578723398,3578723429,31
1,862,12095,3578723398,3578723430,32
1,862,12096,3578723398,3578723432,34
1,862,12097,3578723398,3578723432,34
1,862,12098,3578723398,3578723435,37
1,862,12099,3578723398,3578723438,40
1,862,12100,3578723398,3578723440,42
1,862,12101,3578723398,3578723440,42
1,862,12102,3578723398,3578723441,43
1,862,12103,3578723398,3578723444,46
1,862,12104,3578723398,3578723447,49
1,863,12105,3578723453,3578723453,0
1,863,12106,3578723453,3578723453,0
1,863,12107,3578723453,3578723453,0
1,863,12108,3578723453,3578723453,0
1,863,12109,3578723453,3578723453,0
1,863,12110,3578723453,3578723455,2
1,863,12111,3578723453,3578723455,2
1,863,12112,3578723453,3578723456,3
1,863,12113,3578723453,3578723456,3
1,863,12114,3578723453,3578723457,4
1,863,12115,3578723453,3578723457,4
1,863,12116,3578723453,3578723459,6
1,863,12117,3578723453,3578723459,6
1,863,12118,3578723453,3578723461,8
1,863,12119,3578723453,3578723461,8
1,863,12120,3578723453,3578723462,9
1,863,12121,3578723453,3578723464,11
1,863,12122,3578723453,3578723464,11
1,863,12123,3578723453,3578723466,13
1,863,12124,3578723453,3578723467,14
1,863,12125,3578723453,3578723469,16
1,863,12126,3578723453,3578723470,17
1,863,12127,3578723453,3578723475,22
1,863,12128,3578723453,3578723481,28
1,863,12129,3578723453,3578723482,29
1,863,12130,3578723453,3578723482,29
1,863,12131,3578723453,3578723485,32
1,863,12132,3578723453,3578723486,33
1,863,12133,3578723453,3578723486,33
1,863,12134,3578723453,3578723487,34
1,863,12135,3578723453,3578723490,37
1,863,12136,3578723453,3578723490,37
1,863,12137,3578723453,3578723490,37
1,863,12138,3578723453,3578723492,39
1,863,12139,3578723453,3578723493,40
1,863,12140,3578723453,3578723494,41
1,863,12141,3578723453,3578723498,45
1,863,12142,3578723453,3578723499,46
1,863,12143,3578723453,3578723500,47
1,863,12144,3578723453,3578723501,48
1,863,12145,3578723453,3578723501,48
1,863,12146,3578723453,3578723503,50
1,864,12147,3578723509,3578723509,0
1,864,12148,3578723509,3578723509,0
1,864,12149,3578723509,3578723509,0
1,864,12150,3578723509,3578723509,0
1,864,12151,3578723509,3578723509,0
1,864,12152,3578723509,3578723511,2
1,864,12153,3578723509,3578723512,3
1,864,12154,3578723509,3578723512,3
1,864,12155,3578723509,3578723514,5
1,864,12156,3578723509,3578723514,5
1,864,12157,3578723509,3578723516,7
1,864,12158,3578723509,3578723517,8
1,864,12159,3578723509,3578723517,8
1,864,12160,3578723509,3578723518,9
1,864,12161,3578723509,3578723518,9
1,864,12162,3578723509,3578723518,9
1,864,12163,3578723509,3578723519,10
1,864,12164,3578723509,3578723520,11
1,864,12165,3578723509,3578723521,12
1,864,12166,3578723509,3578723523,14
1,864,12167,3578723509,3578723524,15
1,864,12168,3578723509,3578723524,15
1,864,12169,3578723509,3578723525,16
1,864,12170,3578723509,3578723527,18
1,864,12171,3578723509,3578723527,18
1,864,12172,3578723509,3578723529,20
1,864,12173,3578723509,3578723532,23
1,864,12174,3578723509,3578723533,24
1,864,12175,3578723509,3578723533,24
1,864,12176,3578723509,3578723533,24
1,864,12177,3578723509,3578723534,25
1,864,12178,3578723509,3578723536,27
1,864,12179,3578723509,3578723537,28
1,864,12180,3578723509,3578723542,33
1,864,12181,3578723509,3578723543,34
1,864,12182,3578723509,3578723546,37
1,864,12183,3578723509,3578723547,38
1,864,12184,3578723509,3578723549,40
1,864,12185,3578723509,3578723552,43
1,864,12186,3578723509,3578723553,44
1,864,12187,3578723509,3578723557,48
1,865,12188,3578723565,3578723565,0
1,865,12189,3578723565,3578723565,0
1,865,12190,3578723565,3578723565,0
1,865,12191,3578723565,3578723566,1
1,865,12192,3578723565,3578723566,1
1,865,12193,3578723565,3578723568,3
1,865,12194,3578723565,3578723569,4
1,865,12195,3578723565,3578723571,6
1,865,12196,3578723565,3578723573,8
1,865,12197,3578723565,3578723575,10
1,865,12198,3578723565,3578723576,11
1,865,12199,3578723565,3578723579,14
1,865,12200,3578723565,3578723582,17
1,865,12201,3578723565,3578723583,18
1,865,12202,3578723565,3578723585,20
1,865,12203,3578723565,3578723587,22
1,865,12204,3578723565,3578723587,22
1,865,12205,3578723565,3578723589,24
1,865,12206,3578723565,3578723591,26
1,865,12207,3578723565,3578723593,28
1,865,12208,3578723565,3578723594,29
1,865,12209,3578723565,3578723595,30
1,865,12210,3578723565,3578723597,32
1,865,12211,3578723565,3578723598,33
1,865,12212,3578723565,3578723601,36
1,865,12213,3578723565,3578723601,36
1,865,12214,3578723565,3578723602,37
1,865,12215,3578723565,3578723609,44
1,865,12216,3578723565,3578723614,49
1,865,12217,3578723565,3578723614,49
1,865,12218,3578723565,3578723614,49
1,865,12219,3578723565,3578723614,49
1,866,12220,3578723621,3578723621,0
1,866,12221,3578723621,3578723621,0
1,866,12222,3578723621,3578723621,0
1,866,12223,3578723621,3578723621,0
1,866,12224,3578723621,3578723621,0
1,866,12225,3578723621,3578723621,0
1,866,12226,3578723621,3578723621,0
1,866,12227,3578723621,3578723622,1
1,866,12228,3578723621,3578723624,3
1,866,12229,3578723621,3578723626,5
1,866,12230,3578723621,3578723626,5
1,866,12231,3578723621,3578723629,8
1,866,12232,3578723621,3578723629,8
1,866,12233,3578723621,3578723630,9
1,866,12234,3578723621,3578723630,9
1,866,12235,3578723621,3578723634,13
1,866,12236,3578723621,3578723637,16
1,866,12237,3578723621,3578723638,17
1,866,12238,3578723621,3578723639,18
1,866,12239,3578723621,3578723639,18
1,866,12240,3578723621,3578723643,22
1,866,12241,3578723621,3578723647,26
1,866,12242,3578723621,3578723649,28
1,866,12243,3578723621,3578723650,29
1,866,12244,3578723621,3578723650,29
1,866,12245,3578723621,3578723651,30
1,866,12246,3578723621,3578723653,32
1,866,12247,3578723621,3578723654,33
1,866,12248,3578723621,3578723655,34
1,866,12249,3578723621,3578723655,34
1,866,12250,3578723621,3578723655,34
1,866,12251,3578723621,3578723656,35
1,866,12252,3578723621,3578723657,36
1,866,12253,3578723621,3578723658,37
1,866,12254,3578723621,3578723658,37
1,866,12255,3578723621,3578723661,40
1,866,12256,3578723621,3578723662,41
1,866,12257,3578723621,3578723665,44
1,866,12258,3578723621,3578723666,45
1,866,12259,3578723621,3578723668,47
1,866,12260,3578723621,3578723669,48
1,867,12261,3578723676,3578723676,0
1,867,12262,3578723676,3578723681,5
1,867,12263,3578723676,3578723682,6
1,867,12264,3578723676,3578723682,6
1,867,12265,3578723676,3578723684,8
1,867,12266,3578723676,3578723685,9
1,867,12267,3578723676,3578723686,10
1,867,12268,3578723676,3578723690,14
1,867,12269,3578723676,3578723690,14
1,867,12270,3578723676,3578723691,15
1,867,12271,3578723676,3578723692,16
1,867,12272,3578723676,3578723692,16
1,867,12273,3578723676,3578723693,17
1,867,12274,3578723676,3578723694,18
1,867,12275,3578723676,3578723698,22
1,867,12276,3578723676,3578723698,22
1,867,12277,3578723676,3578723700,24
1,867,12278,3578723676,3578723700,24
1,867,12279,3578723676,3578723701,25
1,867,12280,3578723676,3578723704,28
1,867,12281,3578723676,3578723705,29
1,867,12282,3578723676,3578723705,29
1,867,12283,3578723676,3578723710,34
1,867,12284,3578723676,3578723711,35
1,867,12285,3578723676,3578723712,36
1,867,12286,3578723676,3578723712,36
1,867,12287,3578723676,3578723714,38
1,867,12288,3578723676,3578723716,40
1,867,12289,3578723676,3578723717,41
1,867,12290,3578723676,3578723717,41
1,867,12291,3578723676,3578723718,42
1,867,12292,3578723676,3578723718,42
1,867,12293,3578723676,3578723720,44
1,867,12294,3578723676,3578723720,44
1,867,12295,3578723676,3578723722,46
1,867,12296,3578723676,3578723723,47
1,867,12297,3578723676,3578723723,47
1,867,12298,3578723676,3578723723,47
1,867,12299,3578723676,3578723725,49
1,868,12300,3578723733,3578723733,0
1,868,12301,3578723733,3578723733,0
1,868,12302,3578723733,3578723733,0
1,868,12303,3578723733,3578723733,0
1,868,12304,3578723733,3578723733,0
1,868,12305,3578723733,3578723733,0
1,868,12306,3578723733,3578723733,0
1,868,12307,3578723733,3578723734,1
1,868,12308,3578723733,3578723734,1
1,868,12309,3578723733,3578723735,2
1,868,12310,3578723733,3578723742,9
1,868,12311,3578723733,3578723742,9
1,868,12312,3578723733,3578723743,10
1,868,12313,3578723733,3578723746,13
1,868,12314,3578723733,3578723748,15
1,868,12315,3578723733,3578723749,16
1,868,12316,3578723733,3578723752,19
1,868,12317,3578723733,3578723754,21
1,868,12318,3578723733,3578723756,23
1,868,12319,3578723733,3578723757,24
1,868,12320,3578723733,3578723763,30
1,868,12321,3578723733,3578723766,33
1,868,12322,3578723733,3578723766,33
1,868,12323,3578723733,3578723767,34
1,868,12324,3578723733,3578723768,35
1,868,12325,3578723733,3578723770,37
1,868,12326,3578723733,3578723771,38
1,868,12327,3578723733,3578723773,40
1,868,12328,3578723733,3578723775,42
1,868,12329,3578723733,3578723776,43
1,868,12330,3578723733,3578723779,46
1,869,12331,3578723791,3578723791,0
1,869,12332,3578723791,3578723791,0
1,869,12333,3578723791,3578723791,0
1,869,12334,3578723791,3578723791,0
1,869,12335,3578723791,3578723791,0
1,869,12336,3578723791,3578723792,1
1,869,12337,3578723791,3578723793,2
1,869,12338,3578723791,3578723794,3
1,869,12339,3578723791,3578723795,4
1,869,12340,3578723791,3578723796,5
1,869,12341,3578723791,3578723798,7
1,869,12342,3578723791,3578723799,8
1,869,12343,3578723791,3578723801,10
1,869,12344,3578723791,3578723801,10
1,869,12345,3578723791,3578723806,15
1,869,12346,3578723791,3578723809,18
1,869,12347,3578723791,3578723814,23
1,869,12348,3578723791,3578723814,23
1,869,12349,3578723791,3578723814,23
1,869,12350,3578723791,3578723815,24
1,869,12351,3578723791,3578723816,25
1,869,12352,3578723791,3578723816,25
1,869,12353,3578723791,3578723818,27
1,869,12354,3578723791,3578723818,27
1,869,12355,3578723791,3578723819,28
1,869,12356,3578723791,3578723819,28
1,869,12357,3578723791,3578723820,29
1,869,12358,3578723791,3578723820,29
1,869,12359,3578723791,3578723822,31
1,869,12360,3578723791,3578723824,33
1,869,12361,3578723791,3578723826,35
1,869,12362,3578723791,3578723826,35
1,869,12363,3578723791,3578723829,38
1,869,12364,3578723791,3578723829,38
1,869,12365,3578723791,3578723829,38
1,869,12366,3578723791,3578723830,39
1,869,12367,3578723791,3578723832,41
1,869,12368,3578723791,3578723834,43
1,869,12369,3578723791,3578723837,46
1,869,12370,3578723791,3578723839,48
1,869,12371,3578723791,3578723839,48
1,870,12372,3578723848,3578723848,0
1,870,12373,3578723848,3578723848,0
1,870,12374,3578723848,3578723848,0
1,870,12375,3578723848,3578723849,1
1,870,12376,3578723848,3578723850,2
1,870,12377,3578723848,3578723850,2
1,870,12378,3578723848,3578723851,3
1,870,12379,3578723848,3578723854,6
1,870,12380,3578723848,3578723855,7
1,870,12381,3578723848,3578723855,7
1,870,12382,3578723848,3578723856,8
1,870,12383,3578723848,3578723857,9
1,870,12384,3578723848,3578723858,10
1,870,12385,3578723848,3578723858,10
1,870,12386,3578723848,3578723860,12
1,870,12387,3578723848,3578723862,14
1,870,12388,3578723848,3578723863,15
1,870,12389,3578723848,3578723864,16
1,870,12390,3578723848,3578723865,17
1,870,12391,3578723848,3578723866,18
1,870,12392,3578723848,3578723868,20
1,870,12393,3578723848,3578723869,21
1,870,12394,3578723848,3578723876,28
1,870,12395,3578723848,3578723880,32
1,870,12396,3578723848,3578723882,34
1,870,12397,3578723848,3578723884,36
1,870,12398,3578723848,3578723886,38
1,870,12399,3578723848,3578723886,38
1,870,12400,3578723848,3578723890,42
1,870,12401,3578723848,3578723890,42
1,870,12402,3578723848,3578723891,43
1,870,12403,3578723848,3578723892,44
1,870,12404,3578723848,3578723893,45
1,870,12405,3578723848,3578723894,46
1,870,12406,3578723848,3578723894,46
1,870,12407,3578723848,3578723898,50
1,871,12408,3578723905,3578723905,0
1,871,12409,3578723905,3578723905,0
1,871,12410,3578723905,3578723905,0
1,871,12411,3578723905,3578723905,0
1,871,12412,3578723905,3578723905,0
1,871,12413,3578723905,3578723905,0
1,871,12414,3578723905,3578723910,5
1,871,12415,3578723905,3578723911,6
1,871,12416,3578723905,3578723911,6
1,871,12417,3578723905,3578723913,8
1,871,12418,3578723905,3578723914,9
1,871,12419,3578723905,3578723915,10
1,871,12420,3578723905,3578723916,11
1,871,12421,3578723905,3578723917,12
1,871,12422,3578723905,3578723917,12
1,871,12423,3578723905,3578723918,13
1,871,12424,3578723905,3578723918,13
1,871,12425,3578723905,3578723920,15
1,871,12426,3578723905,3578723920,15
1,871,12427,3578723905,3578723922,17
1,871,12428,3578723905,3578723923,18
1,871,12429,3578723905,3578723923,18
1,871,12430,3578723905,3578723924,19
1,871,12431,3578723905,3578723924,19
1,871,12432,3578723905,3578723925,20
1,871,12433,3578723905,3578723926,21
1,871,12434,3578723905,3578723927,22
1,871,12435,3578723905,3578723928,23
1,871,12436,3578723905,3578723929,24
1,871,12437,3578723905,3578723929,24
1,871,12438,3578723905,3578723932,27
1,871,12439,3578723905,3578723933,28
1,871,12440,3578723905,3578723933,28
1,871,12441,3578723905,3578723933,28
1,871,12442,3578723905,3578723935,30
1,871,12443,3578723905,3578723935,30
1,871,12444,3578723905,3578723936,31
1,871,12445,3578723905,3578723942,37
1,871,12446,3578723905,3578723943,38
1,871,12447,3578723905,3578723944,39
1,871,12448,3578723905,3578723946,41
1,871,12449,3578723905,3578723946,41
1,871,12450,3578723905,3578723948,43
1,871,12451,3578723905,3578723948,43
1,871,12452,3578723905,3578723952,47
1,871,12453,3578723905,3578723954,49
1,872,12454,3578723961,3578723961,0
1,872,12455,3578723961,3578723961,0
1,872,12456,3578723961,3578723963,2
1,872,12457,3578723961,3578723965,4
1,872,12458,3578723961,3578723966,5
1,872,12459,3578723961,3578723966,5
1,872,12460,3578723961,3578723966,5
1,872,12461,3578723961,3578723969,8
1,872,12462,3578723961,3578723971,10
1,872,12463,3578723961,3578723971,10
1,872,12464,3578723961,3578723973,12
1,872,12465,3578723961,3578723975,14
1,872,12466,3578723961,3578723976,15
1,872,12467,3578723961,3578723980,19
1,872,12468,3578723961,3578723984,23
1,872,12469,3578723961,3578723986,25
1,872,12470,3578723961,3578723987,26
1,872,12471,3578723961,3578723988,27
1,872,12472,3578723961,3578723991,30
1,872,12473,3578723961,3578723991,30
1,872,12474,3578723961,3578723992,31
1,872,12475,3578723961,3578723993,32
1,872,12476,3578723961,3578723994,33
1,872,12477,3578723961,3578723995,34
1,872,12478,3578723961,3578723997,36
1,872,12479,3578723961,3578723998,37
1,872,12480,3578723961,3578723999,38
1,872,12481,3578723961,3578723999,38
1,872,12482,3578723961,3578724001,40
1,872,12483,3578723961,3578724001,40
1,872,12484,3578723961,3578724003,42
1,872,12485,3578723961,3578724009,48
1,873,12486,3578724017,3578724017,0
1,873,12487,3578724017,3578724017,0
1,873,12488,3578724017,3578724017,0
1,873,12489,3578724017,3578724017,0
1,873,12490,3578724017,3578724017,0
1,873,12491,3578724017,3578724017,0
1,873,12492,3578724017,3578724017,0
1,873,12493,3578724017,3578724017,0
1,873,12494,3578724017,3578724018,1
1,873,12495,3578724017,3578724018,1
1,873,12496,3578724017,3578724018,1
1,873,12497,3578724017,3578724019,2
1,873,12498,3578724017,3578724021,4
1,873,12499,3578724017,3578724021,4
1,873,12500,3578724017,3578724022,5
1,873,12501,3578724017,3578724024,7
1,873,12502,3578724017,3578724026,9
1,873,12503,3578724017,3578724026,9
1,873,12504,3578724017,3578724029,12
1,873,12505,3578724017,3578724030,13
1,873,12506,3578724017,3578724030,13
1,873,12507,3578724017,3578724032,15
1,873,12508,3578724017,3578724034,17
1,873,12509,3578724017,3578724037,20
1,873,12510,3578724017,3578724039,22
1,873,12511,3578724017,3578724040,23
1,873,12512,3578724017,3578724043,26
1,873,12513,3578724017,3578724045,28
1,873,12514,3578724017,3578724048,31
1,873,12515,3578724017,3578724050,33
1,873,12516,3578724017,3578724050,33
1,873,12517,3578724017,3578724051,34
1,873,12518,3578724017,3578724052,35
1,873,12519,3578724017,3578724055,38
1,873,12520,3578724017,3578724055,38
1,873,12521,3578724017,3578724055,38
1,873,12522,3578724017,3578724056,39
1,873,12523,3578724017,3578724056,39
1,873,12524,3578724017,3578724058,41
1,873,12525,3578724017,3578724059,42
1,873,12526,3578724017,3578724060,43
1,873,12527,3578724017,3578724060,43
1,873,12528,3578724017,3578724063,46
1,873,12529,3578724017,3578724065,48
1,873,12530,3578724017,3578724065,48
1,873,12531,3578724017,3578724066,49
1,874,12532,3578724073,3578724073,0
1,874,12533,3578724073,3578724073,0
1,874,12534,3578724073,3578724081,8
1,874,12535,3578724073,3578724082,9
1,874,12536,3578724073,3578724082,9
1,874,12537,3578724073,3578724083,10
1,874,12538,3578724073,3578724085,12
1,874,12539,3578724073,3578724086,13
1,874,12540,3578724073,3578724086,13
1,874,12541,3578724073,3578724087,14
1,874,12542,3578724073,3578724090,17
1,874,12543,3578724073,3578724091,18
1,874,12544,3578724073,3578724092,19
1,874,12545,3578724073,3578724093,20
1,874,12546,3578724073,3578724093,20
1,874,12547,3578724073,3578724094,21
1,874,12548,3578724073,3578724094,21
1,874,12549,3578724073,3578724098,25
1,874,12550,3578724073,3578724099,26
1,874,12551,3578724073,3578724100,27
1,874,12552,3578724073,3578724101,28
1,874,12553,3578724073,3578724101,28
1,874,12554,3578724073,3578724105,32
1,874,12555,3578724073,3578724105,32
1,874,12556,3578724073,3578724109,36
1,874,12557,3578724073,3578724110,37
1,874,12558,3578724073,3578724111,38
1,874,12559,3578724073,3578724111,38
1,874,12560,3578724073,3578724113,40
1,874,12561,3578724073,3578724116,43
1,874,12562,3578724073,3578724117,44
1,874,12563,3578724073,3578724117,44
1,874,12564,3578724073,3578724117,44
1,874,12565,3578724073,3578724118,45
1,874,12566,3578724073,3578724119,46
1,874,12567,3578724073,3578724120,47
1,874,12568,3578724073,3578724122,49
1,874,12569,3578724073,3578724123,50
1,875,12570,3578724129,3578724129,0
1,875,12571,3578724129,3578724129,0
1,875,12572,3578724129,3578724129,0
1,875,12573,3578724129,3578724129,0
1,875,12574,3578724129,3578724129,0
1,875,12575,3578724129,3578724129,0
1,875,12576,3578724129,3578724129,0
1,875,12577,3578724129,3578724129,0
1,875,12578,3578724129,3578724129,0
1,875,12579,3578724129,3578724129,0
1,875,12580,3578724129,3578724131,2
1,875,12581,3578724129,3578724134,5
1,875,12582,3578724129,3578724134,5
1,875,12583,3578724129,3578724135,6
1,875,12584,3578724129,3578724136,7
1,875,12585,3578724129,3578724142,13
1,875,12586,3578724129,3578724143,14
1,875,12587,3578724129,3578724145,16
1,875,12588,3578724129,3578724145,16
1,875,12589,3578724129,3578724146,17
1,875,12590,3578724129,3578724148,19
1,875,12591,3578724129,3578724149,20
1,875,12592,3578724129,3578724152,23
1,875,12593,3578724129,3578724155,26
1,875,12594,3578724129,3578724156,27
1,875,12595,3578724129,3578724157,28
1,875,12596,3578724129,3578724163,34
1,875,12597,3578724129,3578724166,37
1,875,12598,3578724129,3578724166,37
1,875,12599,3578724129,3578724166,37
1,875,12600,3578724129,3578724167,38
1,875,12601,3578724129,3578724169,40
1,875,12602,3578724129,3578724171,42
1,875,12603,3578724129,3578724171,42
1,875,12604,3578724129,3578724173,44
1,875,12605,3578724129,3578724175,46
1,875,12606,3578724129,3578724177,48
1,876,12607,3578724186,3578724186,0
1,876,12608,3578724186,3578724186,0
1,876,12609,3578724186,3578724186,0
1,876,12610,3578724186,3578724186,0
1,876,12611,3578724186,3578724192,6
1,876,12612,3578724186,3578724192,6
1,876,12613,3578724186,3578724192,6
1,876,12614,3578724186,3578724193,7
1,876,12615,3578724186,3578724194,8
1,876,12616,3578724186,3578724195,9
1,876,12617,3578724186,3578724198,12
1,876,12618,3578724186,3578724199,13
1,876,12619,3578724186,3578724201,15
1,876,12620,3578724186,3578724201,15
1,876,12621,3578724186,3578724203,17
1,876,12622,3578724186,3578724209,23
1,876,12623,3578724186,3578724212,26
1,876,12624,3578724186,3578724214,28
1,876,12625,3578724186,3578724214,28
1,876,12626,3578724186,3578724214,28
1,876,12627,3578724186,3578724215,29
1,876,12628,3578724186,3578724216,30
1,876,12629,3578724186,3578724217,31
1,876,12630,3578724186,3578724217,31
1,876,12631,3578724186,3578724218,32
1,876,12632,3578724186,3578724218,32
1,876,12633,3578724186,3578724219,33
1,876,12634,3578724186,3578724219,33
1,876,12635,3578724186,3578724220,34
1,876,12636,3578724186,3578724221,35
1,876,12637,3578724186,3578724222,36
1,876,12638,3578724186,3578724224,38
1,876,12639,3578724186,3578724226,40
1,876,12640,3578724186,3578724227,41
1,876,12641,3578724186,3578724229,43
1,876,12642,3578724186,3578724229,43
1,876,12643,3578724186,3578724230,44
1,876,12644,3578724186,3578724230,44
1,876,12645,3578724186,3578724232,46
1,876,12646,3578724186,3578724234,48
1,877,12647,3578724243,3578724243,0
1,877,12648,3578724243,3578724243,0
1,877,12649,3578724243,3578724243,0
1,877,12650,3578724243,3578724248,5
1,877,12651,3578724243,3578724250,7
1,877,12652,3578724243,3578724250,7
1,877,12653,3578724243,3578724252,9
1,877,12654,3578724243,3578724253,10
1,877,12655,3578724243,3578724255,12
1,877,12656,3578724243,3578724256,13
1,877,12657,3578724243,3578724256,13
1,877,12658,3578724243,3578724256,13
1,877,12659,3578724243,3578724257,14
1,877,12660,3578724243,3578724260,17
1,877,12661,3578724243,3578724260,17
1,877,12662,3578724243,3578724260,17
1,877,12663,3578724243,3578724260,17
1,877,12664,3578724243,3578724263,20
1,877,12665,3578724243,3578724263,20
1,877,12666,3578724243,3578724265,22
1,877,12667,3578724243,3578724266,23
1,877,12668,3578724243,3578724268,25
1,877,12669,3578724243,3578724269,26
1,877,12670,3578724243,3578724277,34
1,877,12671,3578724243,3578724282,39
1,877,12672,3578724243,3578724282,39
1,877,12673,3578724243,3578724284,41
1,877,12674,3578724243,3578724284,41
1,877,12675,3578724243,3578724286,43
1,877,12676,3578724243,3578724286,43
1,877,12677,3578724243,3578724287,44
1,877,12678,3578724243,3578724291,48
1,877,12679,3578724243,3578724292,49
1,877,12680,3578724243,3578724292,49
1,878,12681,3578724299,3578724299,0
1,878,12682,3578724299,3578724299,0
1,878,12683,3578724299,3578724299,0
1,878,12684,3578724299,3578724299,0
1,878,12685,3578724299,3578724299,0
1,878,12686,3578724299,3578724301,2
1,878,12687,3578724299,3578724304,5
1,878,12688,3578724299,3578724305,6
1,878,12689,3578724299,3578724305,6
1,878,12690,3578724299,3578724306,7
1,878,12691,3578724299,3578724309,10
1,878,12692,3578724299,3578724310,11
1,878,12693,3578724299,3578724311,12
1,878,12694,3578724299,3578724311,12
1,878,12695,3578724299,3578724312,13
1,878,12696,3578724299,3578724314,15
1,878,12697,3578724299,3578724316,17
1,878,12698,3578724299,3578724317,18
1,878,12699,3578724299,3578724317,18
1,878,12700,3578724299,3578724318,19
1,878,12701,3578724299,3578724318,19
1,878,12702,3578724299,3578724319,20
1,878,12703,3578724299,3578724321,22
1,878,12704,3578724299,3578724322,23
1,878,12705,3578724299,3578724323,24
1,878,12706,3578724299,3578724323,24
1,878,12707,3578724299,3578724324,25
1,878,12708,3578724299,3578724324,25
1,878,12709,3578724299,3578724326,27
1,878,12710,3578724299,3578724328,29
1,878,12711,3578724299,3578724328,29
1,878,12712,3578724299,3578724328,29
1,878,12713,3578724299,3578724330,31
1,878,12714,3578724299,3578724330,31
1,878,12715,3578724299,3578724330,31
1,878,12716,3578724299,3578724333,34
1,878,12717,3578724299,3578724334,35
1,878,12718,3578724299,3578724334,35
1,878,12719,3578724299,3578724334,35
1,878,12720,3578724299,3578724336,37
1,878,12721,3578724299,3578724336,37
1,878,12722,3578724299,3578724336,37
1,878,12723,3578724299,3578724343,44
1,878,12724,3578724299,3578724343,44
1,878,12725,3578724299,3578724345,46
1,878,12726,3578724299,3578724346,47
1,878,12727,3578724299,3578724346,47
1,878,12728,3578724299,3578724348,49
1,879,12729,3578724356,3578724356,0
1,879,12730,3578724356,3578724356,0
1,879,12731,3578724356,3578724356,0
1,879,12732,3578724356,3578724357,1
1,879,12733,3578724356,3578724362,6
1,879,12734,3578724356,3578724363,7
1,879,12735,3578724356,3578724365,9
1,879,12736,3578724356,3578724366,10
1,879,12737,3578724356,3578724366,10
1,879,12738,3578724356,3578724366,10
1,879,12739,3578724356,3578724370,14
1,879,12740,3578724356,3578724371,15
1,879,12741,3578724356,3578724372,16
1,879,12742,3578724356,3578724373,17
1,879,12743,3578724356,3578724375,19
1,879,12744,3578724356,3578724376,20
1,879,12745,3578724356,3578724380,24
1,879,12746,3578724356,3578724383,27
1,879,12747,3578724356,3578724384,28
1,879,12748,3578724356,3578724386,30
1,879,12749,3578724356,3578724387,31
1,879,12750,3578724356,3578724388,32
1,879,12751,3578724356,3578724393,37
1,879,12752,3578724356,3578724393,37
1,879,12753,3578724356,3578724393,37
1,879,12754,3578724356,3578724394,38
1,879,12755,3578724356,3578724396,40
1,879,12756,3578724356,3578724397,41
1,879,12757,3578724356,3578724398,42
1,879,12758,3578724356,3578724400,44
1,879,12759,3578724356,3578724401,45
1,879,12760,3578724356,3578724401,45
1,879,12761,3578724356,3578724406,50
1,880,12762,3578724413,3578724413,0
1,880,12763,3578724413,3578724413,0
1,880,12764,3578724413,3578724414,1
1,880,12765,3578724413,3578724414,1
1,880,12766,3578724413,3578724414,1
1,880,12767,3578724413,3578724415,2
1,880,12768,3578724413,3578724416,3
1,880,12769,3578724413,3578724417,4
1,880,12770,3578724413,3578724418,5
1,880,12771,3578724413,3578724418,5
1,880,12772,3578724413,3578724419,6
1,880,12773,3578724413,3578724420,7
1,880,12774,3578724413,3578724420,7
1,880,12775,3578724413,3578724420,7
1,880,12776,3578724413,3578724421,8
1,880,12777,3578724413,3578724422,9
1,880,12778,3578724413,3578724424,11
1,880,12779,3578724413,3578724425,12
1,880,12780,3578724413,3578724426,13
1,880,12781,3578724413,3578724427,14
1,880,12782,3578724413,3578724429,16
1,880,12783,3578724413,3578724430,17
1,880,12784,3578724413,3578724430,17
1,880,12785,3578724413,3578724431,18
1,880,12786,3578724413,3578724432,19
1,880,12787,3578724413,3578724434,21
1,880,12788,3578724413,3578724440,27
1,880,12789,3578724413,3578724440,27
1,880,12790,3578724413,3578724440,27
1,880,12791,3578724413,3578724444,31
1,880,12792,3578724413,3578724444,31
1,880,12793,3578724413,3578724448,35
1,880,12794,3578724413,3578724450,37
1,880,12795,3578724413,3578724450,37
1,880,12796,3578724413,3578724453,40
1,880,12797,3578724413,3578724454,41
1,880,12798,3578724413,3578724456,43
1,880,12799,3578724413,3578724456,43
1,880,12800,3578724413,3578724456,43
1,880,12801,3578724413,3578724457,44
1,880,12802,3578724413,3578724460,47
1,880,12803,3578724413,3578724461,48
1,880,12804,3578724413,3578724462,49
1,880,12805,3578724413,3578724463,50
1,881,12806,3578724469,3578724470,1
1,881,12807,3578724469,3578724470,1
1,881,12808,3578724469,3578724470,1
1,881,12809,3578724469,3578724470,1
1,881,12810,3578724469,3578724470,1
1,881,12811,3578724469,3578724477,8
1,881,12812,3578724469,3578724480,11
1,881,12813,3578724469,3578724482,13
1,881,12814,3578724469,3578724483,14
1,881,12815,3578724469,3578724484,15
1,881,12816,3578724469,3578724484,15
1,881,12817,3578724469,3578724486,17
1,881,12818,3578724469,3578724486,17
1,881,12819,3578724469,3578724487,18
1,881,12820,3578724469,3578724491,22
1,881,12821,3578724469,3578724491,22
1,881,12822,3578724469,3578724493,24
1,881,12823,3578724469,3578724493,24
1,881,12824,3578724469,3578724494,25
1,881,12825,3578724469,3578724494,25
1,881,12826,3578724469,3578724499,30
1,881,12827,3578724469,3578724500,31
1,881,12828,3578724469,3578724501,32
1,881,12829,3578724469,3578724501,32
1,881,12830,3578724469,3578724502,33
1,881,12831,3578724469,3578724505,36
1,881,12832,3578724469,3578724505,36
1,881,12833,3578724469,3578724506,37
1,881,12834,3578724469,3578724509,40
1,881,12835,3578724469,3578724510,41
1,881,12836,3578724469,3578724511,42
1,881,12837,3578724469,3578724511,42
1,881,12838,3578724469,3578724513,44
1,881,12839,3578724469,3578724517,48
1,881,12840,3578724469,3578724517,48
1,881,12841,3578724469,3578724517,48
1,881,12842,3578724469,3578724518,49
1,881,12843,3578724469,3578724518,49
1,881,12844,3578724469,3578724519,50
1,882,12845,3578724526,3578724526,0
1,882,12846,3578724526,3578724526,0
1,882,12847,3578724526,3578724526,0
1,882,12848,3578724526,3578724526,0
1,882,12849,3578724526,3578724526,0
1,882,12850,3578724526,3578724526,0
1,882,12851,3578724526,3578724526,0
1,882,12852,3578724526,3578724526,0
1,882,12853,3578724526,3578724526,0
1,882,12854,3578724526,3578724527,1
1,882,12855,3578724526,3578724527,1
1,882,12856,3578724526,3578724528,2
1,882,12857,3578724526,3578724529,3
1,882,12858,3578724526,3578724530,4
1,882,12859,3578724526,3578724532,6
1,882,12860,3578724526,3578724533,7
1,882,12861,3578724526,3578724533,7
1,882,12862,3578724526,3578724534,8
1,882,12863,3578724526,3578724534,8
1,882,12864,3578724526,3578724535,9
1,882,12865,3578724526,3578724541,15
1,882,12866,3578724526,3578724543,17
1,882,12867,3578724526,3578724544,18
1,882,12868,3578724526,3578724545,19
1,882,12869,3578724526,3578724545,19
1,882,12870,3578724526,3578724549,23
1,882,12871,3578724526,3578724555,29
1,882,12872,3578724526,3578724555,29
1,882,12873,3578724526,3578724556,30
1,882,12874,3578724526,3578724561,35
1,882,12875,3578724526,3578724562,36
1,882,12876,3578724526,3578724565,39
1,882,12877,3578724526,3578724565,39
1,882,12878,3578724526,3578724566,40
1,882,12879,3578724526,3578724569,43
1,882,12880,3578724526,3578724571,45
1,882,12881,3578724526,3578724572,46
1,882,12882,3578724526,3578724572,46
1,882,12883,3578724526,3578724574,48
1,882,12884,3578724526,3578724576,50
1,883,12885,3578724582,3578724582,0
1,883,12886,3578724582,3578724582,0
1,883,12887,3578724582,3578724584,2
1,883,12888,3578724582,3578724585,3
1,883,12889,3578724582,3578724586,4
1,883,12890,3578724582,3578724591,9
1,883,12891,3578724582,3578724592,10
1,883,12892,3578724582,3578724592,10
1,883,12893,3578724582,3578724593,11
1,883,12894,3578724582,3578724593,11
1,883,12895,3578724582,3578724593,11
1,883,12896,3578724582,3578724595,13
1,883,12897,3578724582,3578724595,13
1,883,12898,3578724582,3578724597,15
1,883,12899,3578724582,3578724598,16
1,883,12900,3578724582,3578724599,17
1,883,12901,3578724582,3578724600,18
1,883,12902,3578724582,3578724600,18
1,883,12903,3578724582,3578724603,21
1,883,12904,3578724582,3578724606,24
1,883,12905,3578724582,3578724609,27
1,883,12906,3578724582,3578724612,30
1,883,12907,3578724582,3578724613,31
1,883,12908,3578724582,3578724613,31
1,883,12909,3578724582,3578724614,32
1,883,12910,3578724582,3578724614,32
1,883,12911,3578724582,3578724615,33
1,883,12912,3578724582,3578724616,34
1,883,12913,3578724582,3578724617,35
1,883,12914,3578724582,3578724617,35
1,883,12915,3578724582,3578724618,36
1,883,12916,3578724582,3578724619,37
1,883,12917,3578724582,3578724619,37
1,883,12918,3578724582,3578724620,38
1,883,12919,3578724582,3578724621,39
1,883,12920,3578724582,3578724622,40
1,883,12921,3578724582,3578724623,41
1,883,12922,3578724582,3578724625,43
1,883,12923,3578724582,3578724625,43
1,883,12924,3578724582,3578724627,45
1,883,12925,3578724582,3578724628,46
1,883,12926,3578724582,3578724629,47
1,883,12927,3578724582,3578724629,47
1,883,12928,3578724582,3578724630,48
1,884,12929,3578724638,3578724638,0
1,884,12930,3578724638,3578724638,0
1,884,12931,3578724638,3578724638,0
1,884,12932,3578724638,3578724640,2
1,884,12933,3578724638,3578724643,5
1,884,12934,3578724638,3578724644,6
1,884,12935,3578724638,3578724649,11
1,884,12936,3578724638,3578724649,11
1,884,12937,3578724638,3578724651,13
1,884,12938,3578724638,3578724653,15
1,884,12939,3578724638,3578724655,17
1,884,12940,3578724638,3578724655,17
1,884,12941,3578724638,3578724656,18
1,884,12942,3578724638,3578724656,18
1,884,12943,3578724638,3578724656,18
1,884,12944,3578724638,3578724659,21
1,884,12945,3578724638,3578724659,21
1,884,12946,3578724638,3578724659,21
1,884,12947,3578724638,3578724662,24
1,884,12948,3578724638,3578724663,25
1,884,12949,3578724638,3578724665,27
1,884,12950,3578724638,3578724665,27
1,884,12951,3578724638,3578724666,28
1,884,12952,3578724638,3578724667,29
1,884,12953,3578724638,3578724668,30
1,884,12954,3578724638,3578724677,39
1,884,12955,3578724638,3578724680,42
1,884,12956,3578724638,3578724683,45
1,884,12957,3578724638,3578724684,46
1,884,12958,3578724638,3578724684,46
1,884,12959,3578724638,3578724686,48
1,884,12960,3578724638,3578724686,48
1,884,12961,3578724638,3578724687,49
1,885,12962,3578724693,3578724693,0
1,885,12963,3578724693,3578724693,0
1,885,12964,3578724693,3578724693,0
1,885,12965,3578724693,3578724693,0
1,885,12966,3578724693,3578724694,1
1,885,12967,3578724693,3578724694,1
1,885,12968,3578724693,3578724699,6
1,885,12969,3578724693,3578724700,7
1,885,12970,3578724693,3578724701,8
1,885,12971,3578724693,3578724701,8
1,885,12972,3578724693,3578724702,9
1,885,12973,3578724693,3578724703,10
1,885,12974,3578724693,3578724705,12
1,885,12975,3578724693,3578724706,13
1,885,12976,3578724693,3578724710,17
1,885,12977,3578724693,3578724711,18
1,885,12978,3578724693,3578724711,18
1,885,12979,3578724693,3578724712,19
1,885,12980,3578724693,3578724713,20
1,885,12981,3578724693,3578724714,21
1,885,12982,3578724693,3578724717,24
1,885,12983,3578724693,3578724717,24
1,885,12984,3578724693,3578724717,24
1,885,12985,3578724693,3578724718,25
1,885,12986,3578724693,3578724718,25
1,885,12987,3578724693,3578724718,25
1,885,12988,3578724693,3578724719,26
1,885,12989,3578724693,3578724720,27
1,885,12990,3578724693,3578724721,28
1,885,12991,3578724693,3578724722,29
1,885,12992,3578724693,3578724723,30
1,885,12993,3578724693,3578724723,30
1,885,12994,3578724693,3578724723,30
1,885,12995,3578724693,3578724723,30
1,885,12996,3578724693,3578724724,31
1,885,12997,3578724693,3578724726,33
1,885,12998,3578724693,3578724727,34
1,885,12999,3578724693,3578724728,35
1,885,13000,3578724693,3578724728,35
1,885,13001,3578724693,3578724728,35
1,885,13002,3578724693,3578724729,36
1,885,13003,3578724693,3578724731,38
1,885,13004,3578724693,3578724732,39
1,885,13005,3578724693,3578724733,40
1,885,13006,3578724693,3578724733,40
1,885,13007,3578724693,3578724734,41
1,885,13008,3578724693,3578724735,42
1,885,13009,3578724693,3578724735,42
1,885,13010,3578724693,3578724735,42
1,885,13011,3578724693,3578724741,48
1,886,13012,3578724749,3578724749,0
1,886,13013,3578724749,3578724749,0
1,886,13014,3578724749,3578724749,0
1,886,13015,3578724749,3578724749,0
1,886,13016,3578724749,3578724755,6
1,886,13017,3578724749,3578724756,7
1,886,13018,3578724749,3578724756,7
1,886,13019,3578724749,3578724761,12
1,886,13020,3578724749,3578724763,14
1,886,13021,3578724749,3578724764,15
1,886,13022,3578724749,3578724765,16
1,886,13023,3578724749,3578724766,17
1,886,13024,3578724749,3578724770,21
1,886,13025,3578724749,3578724772,23
1,886,13026,3578724749,3578724772,23
1,886,13027,3578724749,3578724772,23
1,886,13028,3578724749,3578724774,25
1,886,13029,3578724749,3578724776,27
1,886,13030,3578724749,3578724779,30
1,886,13031,3578724749,3578724783,34
1,886,13032,3578724749,3578724785,36
1,886,13033,3578724749,3578724785,36
1,886,13034,3578724749,3578724785,36
1,886,13035,3578724749,3578724788,39
1,886,13036,3578724749,3578724791,42
1,886,13037,3578724749,3578724791,42
1,886,13038,3578724749,3578724792,43
1,886,13039,3578724749,3578724793,44
1,886,13040,3578724749,3578724793,44
1,886,13041,3578724749,3578724793,44
1,886,13042,3578724749,3578724795,46
1,886,13043,3578724749,3578724796,47
1,886,13044,3578724749,3578724797,48
1,886,13045,3578724749,3578724799,50
1,887,13046,3578724805,3578724805,0
1,887,13047,3578724805,3578724805,0
1,887,13048,3578724805,3578724806,1
1,887,13049,3578724805,3578724806,1
1,887,13050,3578724805,3578724809,4
1,887,13051,3578724805,3578724812,7
1,887,13052,3578724805,3578724813,8
1,887,13053,3578724805,3578724813,8
1,887,13054,3578724805,3578724814,9
1,887,13055,3578724805,3578724815,10
1,887,13056,3578724805,3578724815,10
1,887,13057,3578724805,3578724817,12
1,887,13058,3578724805,3578724817,12
1,887,13059,3578724805,3578724818,13
1,887,13060,3578724805,3578724819,14
1,887,13061,3578724805,3578724820,15
1,887,13062,3578724805,3578724820,15
1,887,13063,3578724805,3578724821,16
1,887,13064,3578724805,3578724822,17
1,887,13065,3578724805,3578724824,19
1,887,13066,3578724805,3578724825,20
1,887,13067,3578724805,3578724826,21
1,887,13068,3578724805,3578724828,23
1,887,13069,3578724805,3578724829,24
1,887,13070,3578724805,3578724829,24
1,887,13071,3578724805,3578724830,25
1,887,13072,3578724805,3578724832,27
1,887,13073,3578724805,3578724835,30
1,887,13074,3578724805,3578724836,31
1,887,13075,3578724805,3578724838,33
1,887,13076,3578724805,3578724840,35
1,887,13077,3578724805,3578724840,35
1,887,13078,3578724805,3578724845,40
1,887,13079,3578724805,3578724849,44
1,887,13080,3578724805,3578724849,44
1,887,13081,3578724805,3578724852,47
1,887,13082,3578724805,3578724853,48
1,887,13083,3578724805,3578724855,50
1,888,13084,3578724862,3578724862,0
1,888,13085,3578724862,3578724862,0
1,888,13086,3578724862,3578724862,0
1,888,13087,3578724862,3578724862,0
1,888,13088,3578724862,3578724862,0
1,888,13089,3578724862,3578724862,0
1,888,13090,3578724862,3578724862,0
1,888,13091,3578724862,3578724862,0
1,888,13092,3578724862,3578724863,1
1,888,13093,3578724862,3578724865,3
1,888,13094,3578724862,3578724866,4
1,888,13095,3578724862,3578724866,4
1,888,13096,3578724862,3578724867,5
1,888,13097,3578724862,3578724868,6
1,888,13098,3578724862,3578724877,15
1,888,13099,3578724862,3578724880,18
1,888,13100,3578724862,3578724882,20
1,888,13101,3578724862,3578724883,21
1,888,13102,3578724862,3578724883,21
1,888,13103,3578724862,3578724884,22
1,888,13104,3578724862,3578724886,24
1,888,13105,3578724862,3578724886,24
1,888,13106,3578724862,3578724887,25
1,888,13107,3578724862,3578724892,30
1,888,13108,3578724862,3578724892,30
1,888,13109,3578724862,3578724893,31
1,888,13110,3578724862,3578724893,31
1,888,13111,3578724862,3578724894,32
1,888,13112,3578724862,3578724894,32
1,888,13113,3578724862,3578724899,37
1,888,13114,3578724862,3578724900,38
1,888,13115,3578724862,3578724901,39
1,888,13116,3578724862,3578724901,39
1,888,13117,3578724862,3578724901,39
1,888,13118,3578724862,3578724904,42
1,888,13119,3578724862,3578724905,43
1,888,13120,3578724862,3578724905,43
1,888,13121,3578724862,3578724911,49
1,888,13122,3578724862,3578724911,49
1,888,13123,3578724862,3578724912,50
1,889,13124,3578724919,3578724919,0
1,889,13125,3578724919,3578724919,0
1,889,13126,3578724919,3578724919,0
1,889,13127,3578724919,3578724919,0
1,889,13128,3578724919,3578724919,0
1,889,13129,3578724919,3578724919,0
1,889,13130,3578724919,3578724919,0
1,889,13131,3578724919,3578724919,0
1,889,13132,3578724919,3578724919,0
1,889,13133,3578724919,3578724920,1
1,889,13134,3578724919,3578724922,3
1,889,13135,3578724919,3578724923,4
1,889,13136,3578724919,3578724923,4
1,889,13137,3578724919,3578724923,4
1,889,13138,3578724919,3578724923,4
1,889,13139,3578724919,3578724924,5
1,889,13140,3578724919,3578724924,5
1,889,13141,3578724919,3578724926,7
1,889,13142,3578724919,3578724927,8
1,889,13143,3578724919,3578724928,9
1,889,13144,3578724919,3578724928,9
1,889,13145,3578724919,3578724928,9
1,889,13146,3578724919,3578724929,10
1,889,13147,3578724919,3578724930,11
1,889,13148,3578724919,3578724932,13
1,889,13149,3578724919,3578724933,14
1,889,13150,3578724919,3578724933,14
1,889,13151,3578724919,3578724935,16
1,889,13152,3578724919,3578724936,17
1,889,13153,3578724919,3578724946,27
1,889,13154,3578724919,3578724946,27
1,889,13155,3578724919,3578724946,27
1,889,13156,3578724919,3578724949,30
1,889,13157,3578724919,3578724952,33
1,889,13158,3578724919,3578724955,36
1,889,13159,3578724919,3578724956,37
1,889,13160,3578724919,3578724956,37
1,889,13161,3578724919,3578724959,40
1,889,13162,3578724919,3578724962,43
1,889,13163,3578724919,3578724963,44
1,889,13164,3578724919,3578724965,46
1,889,13165,3578724919,3578724965,46
1,889,13166,3578724919,3578724966,47
1,890,13167,3578724976,3578724976,0
1,890,13168,3578724976,3578724976,0
1,890,13169,3578724976,3578724976,0
1,890,13170,3578724976,3578724976,0
1,890,13171,3578724976,3578724976,0
1,890,13172,3578724976,3578724976,0
1,890,13173,3578724976,3578724979,3
1,890,13174,3578724976,3578724984,8
1,890,13175,3578724976,3578724985,9
1,890,13176,3578724976,3578724985,9
1,890,13177,3578724976,3578724987,11
1,890,13178,3578724976,3578724992,16
1,890,13179,3578724976,3578724992,16
1,890,13180,3578724976,3578724993,17
1,890,13181,3578724976,3578724993,17
1,890,13182,3578724976,3578724993,17
1,890,13183,3578724976,3578724994,18
1,890,13184,3578724976,3578724996,20
1,890,13185,3578724976,3578724996,20
1,890,13186,3578724976,3578724997,21
1,890,13187,3578724976,3578725001,25
1,890,13188,3578724976,3578725001,25
1,890,13189,3578724976,3578725003,27
1,890,13190,3578724976,3578725007,31
1,890,13191,3578724976,3578725007,31
1,890,13192,3578724976,3578725009,33
1,890,13193,3578724976,3578725013,37
1,890,13194,3578724976,3578725014,38
1,890,13195,3578724976,3578725014,38
1,890,13196,3578724976,3578725016,40
1,890,13197,3578724976,3578725016,40
1,890,13198,3578724976,3578725017,41
1,890,13199,3578724976,3578725017,41
1,890,13200,3578724976,3578725018,42
1,890,13201,3578724976,3578725019,43
1,890,13202,3578724976,3578725019,43
1,890,13203,3578724976,3578725020,44
1,890,13204,3578724976,3578725021,45
1,890,13205,3578724976,3578725021,45
1,890,13206,3578724976,3578725024,48
1,890,13207,3578724976,3578725025,49
1,890,13208,3578724976,3578725026,50
1,891,13209,3578725033,3578725033,0
1,891,13210,3578725033,3578725033,0
1,891,13211,3578725033,3578725033,0
1,891,13212,3578725033,3578725033,0
1,891,13213,3578725033,3578725036,3
1,891,13214,3578725033,3578725037,4
1,891,13215,3578725033,3578725039,6
1,891,13216,3578725033,3578725039,6
1,891,13217,3578725033,3578725043,10
1,891,13218,3578725033,3578725045,12
1,891,13219,3578725033,3578725047,14
1,891,13220,3578725033,3578725049,16
1,891,13221,3578725033,3578725050,17
1,891,13222,3578725033,3578725051,18
1,891,13223,3578725033,3578725052,19
1,891,13224,3578725033,3578725055,22
1,891,13225,3578725033,3578725055,22
1,891,13226,3578725033,3578725055,22
1,891,13227,3578725033,3578725056,23
1,891,13228,3578725033,3578725057,24
1,891,13229,3578725033,3578725058,25
1,891,13230,3578725033,3578725059,26
1,891,13231,3578725033,3578725059,26
1,891,13232,3578725033,3578725060,27
1,891,13233,3578725033,3578725064,31
1,891,13234,3578725033,3578725065,32
1,891,13235,3578725033,3578725065,32
1,891,13236,3578725033,3578725066,33
1,891,13237,3578725033,3578725067,34
1,891,13238,3578725033,3578725068,35
1,891,13239,3578725033,3578725077,44
1,891,13240,3578725033,3578725080,47
1,891,13241,3578725033,3578725083,50
1,892,13242,3578725089,3578725089,0
1,892,13243,3578725089,3578725089,0
1,892,13244,3578725089,3578725089,0
1,892,13245,3578725089,3578725089,0
1,892,13246,3578725089,3578725089,0
1,892,13247,3578725089,3578725089,0
1,892,13248,3578725089,3578725092,3
1,892,13249,3578725089,3578725092,3
1,892,13250,3578725089,3578725093,4
1,892,13251,3578725089,3578725093,4
1,892,13252,3578725089,3578725093,4
1,892,13253,3578725089,3578725094,5
1,892,13254,3578725089,3578725094,5
1,892,13255,3578725089,3578725100,11
1,892,13256,3578725089,3578725100,11
1,892,13257,3578725089,3578725101,12
1,892,13258,3578725089,3578725101,12
1,892,13259,3578725089,3578725101,12
1,892,13260,3578725089,3578725104,15
1,892,13261,3578725089,3578725105,16
1,892,13262,3578725089,3578725106,17
1,892,13263,3578725089,3578725106,17
1,892,13264,3578725089,3578725111,22
1,892,13265,3578725089,3578725112,23
1,892,13266,3578725089,3578725112,23
1,892,13267,3578725089,3578725112,23
1,892,13268,3578725089,3578725113,24
1,892,13269,3578725089,3578725116,27
1,892,13270,3578725089,3578725117,28
1,892,13271,3578725089,3578725117,28
1,892,13272,3578725089,3578725118,29
1,892,13273,3578725089,3578725118,29
1,892,13274,3578725089,3578725119,30
1,892,13275,3578725089,3578725119,30
1,892,13276,3578725089,3578725120,31
1,892,13277,3578725089,3578725122,33
1,892,13278,3578725089,3578725123,34
1,892,13279,3578725089,3578725123,34
1,892,13280,3578725089,3578725124,35
1,892,13281,3578725089,3578725124,35
1,892,13282,3578725089,3578725125,36
1,892,13283,3578725089,3578725126,37
1,892,13284,3578725089,3578725127,38
1,892,13285,3578725089,3578725128,39
1,892,13286,3578725089,3578725129,40
1,892,13287,3578725089,3578725129,40
1,892,13288,3578725089,3578725130,41
1,892,13289,3578725089,3578725132,43
1,892,13290,3578725089,3578725133,44
1,892,13291,3578725089,3578725133,44
1,892,13292,3578725089,3578725136,47
1,892,13293,3578725089,3578725136,47
1,892,13294,3578725089,3578725136,47
1,893,13295,3578725145,3578725145,0
1,893,13296,3578725145,3578725145,0
1,893,13297,3578725145,3578725146,1
1,893,13298,3578725145,3578725147,2
1,893,13299,3578725145,3578725148,3
1,893,13300,3578725145,3578725148,3
1,893,13301,3578725145,3578725152,7
1,893,13302,3578725145,3578725155,10
1,893,13303,3578725145,3578725156,11
1,893,13304,3578725145,3578725156,11
1,893,13305,3578725145,3578725159,14
1,893,13306,3578725145,3578725162,17
1,893,13307,3578725145,3578725163,18
1,893,13308,3578725145,3578725165,20
1,893,13309,3578725145,3578725165,20
1,893,13310,3578725145,3578725170,25
1,893,13311,3578725145,3578725172,27
1,893,13312,3578725145,3578725172,27
1,893,13313,3578725145,3578725174,29
1,893,13314,3578725145,3578725175,30
1,893,13315,3578725145,3578725177,32
1,893,13316,3578725145,3578725180,35
1,893,13317,3578725145,3578725184,39
1,893,13318,3578725145,3578725185,40
1,893,13319,3578725145,3578725185,40
1,893,13320,3578725145,3578725185,40
1,893,13321,3578725145,3578725191,46
1,893,13322,3578725145,3578725192,47
1,893,13323,3578725145,3578725193,48
1,893,13324,3578725145,3578725193,48
1,893,13325,3578725145,3578725194,49
1,893,13326,3578725145,3578725195,50
1,894,13327,3578725201,3578725201,0
1,894,13328,3578725201,3578725201,0
1,894,13329,3578725201,3578725201,0
1,894,13330,3578725201,3578725201,0
1,894,13331,3578725201,3578725201,0
1,894,13332,3578725201,3578725201,0
1,894,13333,3578725201,3578725201,0
1,894,13334,3578725201,3578725206,5
1,894,13335,3578725201,3578725206,5
1,894,13336,3578725201,3578725209,8
1,894,13337,3578725201,3578725212,11
1,894,13338,3578725201,3578725214,13
1,894,13339,3578725201,3578725214,13
1,894,13340,3578725201,3578725214,13
1,894,13341,3578725201,3578725214,13
1,894,13342,3578725201,3578725215,14
1,894,13343,3578725201,3578725215,14
1,894,13344,3578725201,3578725217,16
1,894,13345,3578725201,3578725218,17
1,894,13346,3578725201,3578725218,17
1,894,13347,3578725201,3578725219,18
1,894,13348,3578725201,3578725219,18
1,894,13349,3578725201,3578725219,18
1,894,13350,3578725201,3578725220,19
1,894,13351,3578725201,3578725221,20
1,894,13352,3578725201,3578725222,21
1,894,13353,3578725201,3578725224,23
1,894,13354,3578725201,3578725225,24
1,894,13355,3578725201,3578725225,24
1,894,13356,3578725201,3578725226,25
1,894,13357,3578725201,3578725228,27
1,894,13358,3578725201,3578725229,28
1,894,13359,3578725201,3578725230,29
1,894,13360,3578725201,3578725231,30
1,894,13361,3578725201,3578725236,35
1,894,13362,3578725201,3578725237,36
1,894,13363,3578725201,3578725239,38
1,894,13364,3578725201,3578725239,38
1,894,13365,3578725201,3578725240,39
1,894,13366,3578725201,3578725243,42
1,894,13367,3578725201,3578725248,47
1,894,13368,3578725201,3578725249,48
1,894,13369,3578725201,3578725250,49
1,895,13370,3578725258,3578725258,0
1,895,13371,3578725258,3578725258,0
1,895,13372,3578725258,3578725258,0
1,895,13373,3578725258,3578725258,0
1,895,13374,3578725258,3578725258,0
1,895,13375,3578725258,3578725259,1
1,895,13376,3578725258,3578725259,1
1,895,13377,3578725258,3578725260,2
1,895,13378,3578725258,3578725260,2
1,895,13379,3578725258,3578725262,4
1,895,13380,3578725258,3578725264,6
1,895,13381,3578725258,3578725265,7
1,895,13382,3578725258,3578725266,8
1,895,13383,3578725258,3578725266,8
1,895,13384,3578725258,3578725268,10
1,895,13385,3578725258,3578725268,10
1,895,13386,3578725258,3578725278,20
1,895,13387,3578725258,3578725283,25
1,895,13388,3578725258,3578725283,25
1,895,13389,3578725258,3578725285,27
1,895,13390,3578725258,3578725286,28
1,895,13391,3578725258,3578725287,29
1,895,13392,3578725258,3578725288,30
1,895,13393,3578725258,3578725292,34
1,895,13394,3578725258,3578725292,34
1,895,13395,3578725258,3578725292,34
1,895,13396,3578725258,3578725293,35
1,895,13397,3578725258,3578725294,36
1,895,13398,3578725258,3578725295,37
1,895,13399,3578725258,3578725301,43
1,895,13400,3578725258,3578725301,43
1,895,13401,3578725258,3578725302,44
1,895,13402,3578725258,3578725302,44
1,895,13403,3578725258,3578725304,46
1,895,13404,3578725258,3578725304,46
1,895,13405,3578725258,3578725307,49
1,896,13406,3578725314,3578725314,0
1,896,13407,3578725314,3578725314,0
1,896,13408,3578725314,3578725314,0
1,896,13409,3578725314,3578725314,0
1,896,13410,3578725314,3578725314,0
1,896,13411,3578725314,3578725317,3
1,896,13412,3578725314,3578725318,4
1,896,13413,3578725314,3578725318,4
1,896,13414,3578725314,3578725319,5
1,896,13415,3578725314,3578725319,5
1,896,13416,3578725314,3578725320,6
1,896,13417,3578725314,3578725322,8
1,896,13418,3578725314,3578725323,9
1,896,13419,3578725314,3578725323,9
1,896,13420,3578725314,3578725324,10
1,896,13421,3578725314,3578725325,11
1,896,13422,3578725314,3578725325,11
1,896,13423,3578725314,3578725325,11
1,896,13424,3578725314,3578725326,12
1,896,13425,3578725314,3578725327,13
1,896,13426,3578725314,3578725328,14
1,896,13427,3578725314,3578725328,14
1,896,13428,3578725314,3578725328,14
1,896,13429,3578725314,3578725330,16
1,896,13430,3578725314,3578725331,17
1,896,13431,3578725314,3578725333,19
1,896,13432,3578725314,3578725333,19
1,896,13433,3578725314,3578725334,20
1,896,13434,3578725314,3578725335,21
1,896,13435,3578725314,3578725336,22
1,896,13436,3578725314,3578725337,23
1,896,13437,3578725314,3578725343,29
1,896,13438,3578725314,3578725344,30
1,896,13439,3578725314,3578725346,32
1,896,13440,3578725314,3578725346,32
1,896,13441,3578725314,3578725347,33
1,896,13442,3578725314,3578725349,35
1,896,13443,3578725314,3578725355,41
1,896,13444,3578725314,3578725356,42
1,896,13445,3578725314,3578725356,42
1,896,13446,3578725314,3578725357,43
1,896,13447,3578725314,3578725358,44
1,896,13448,3578725314,3578725359,45
1,896,13449,3578725314,3578725362,48
1,896,13450,3578725314,3578725363,49
1,897,13451,3578725371,3578725371,0
1,897,13452,3578725371,3578725371,0
1,897,13453,3578725371,3578725371,0
1,897,13454,3578725371,3578725371,0
1,897,13455,3578725371,3578725371,0
1,897,13456,3578725371,3578725372,1
1,897,13457,3578725371,3578725375,4
1,897,13458,3578725371,3578725376,5
1,897,13459,3578725371,3578725377,6
1,897,13460,3578725371,3578725379,8
1,897,13461,3578725371,3578725384,13
1,897,13462,3578725371,3578725385,14
1,897,13463,3578725371,3578725386,15
1,897,13464,3578725371,3578725386,15
1,897,13465,3578725371,3578725387,16
1,897,13466,3578725371,3578725392,21
1,897,13467,3578725371,3578725392,21
1,897,13468,3578725371,3578725393,22
1,897,13469,3578725371,3578725394,23
1,897,13470,3578725371,3578725394,23
1,897,13471,3578725371,3578725395,24
1,897,13472,3578725371,3578725397,26
1,897,13473,3578725371,3578725398,27
1,897,13474,3578725371,3578725398,27
1,897,13475,3578725371,3578725399,28
1,897,13476,3578725371,3578725400,29
1,897,13477,3578725371,3578725401,30
1,897,13478,3578725371,3578725401,30
1,897,13479,3578725371,3578725403,32
1,897,13480,3578725371,3578725407,36
1,897,13481,3578725371,3578725407,36
1,897,13482,3578725371,3578725409,38
1,897,13483,3578725371,3578725413,42
1,897,13484,3578725371,3578725414,43
1,897,13485,3578725371,3578725414,43
1,897,13486,3578725371,3578725415,44
1,897,13487,3578725371,3578725415,44
1,897,13488,3578725371,3578725416,45
1,897,13489,3578725371,3578725416,45
1,897,13490,3578725371,3578725417,46
1,897,13491,3578725371,3578725419,48
1,897,13492,3578725371,3578725419,48
1,897,13493,3578725371,3578725420,49
1,897,13494,3578725371,3578725420,49
1,897,13495,3578725371,3578725420,49
1,897,13496,3578725371,3578725420,49
1,897,13497,3578725371,3578725421,50
1,898,13498,3578725429,3578725429,0
1,898,13499,3578725429,3578725429,0
1,898,13500,3578725429,3578725429,0
1,898,13501,3578725429,3578725429,0
1,898,13502,3578725429,3578725429,0
1,898,13503,3578725429,3578725431,2
1,898,13504,3578725429,3578725432,3
1,898,13505,3578725429,3578725436,7
1,898,13506,3578725429,3578725437,8
1,898,13507,3578725429,3578725440,11
1,898,13508,3578725429,3578725440,11
1,898,13509,3578725429,3578725444,15
1,898,13510,3578725429,3578725445,16
1,898,13511,3578725429,3578725448,19
1,898,13512,3578725429,3578725449,20
1,898,13513,3578725429,3578725450,21
1,898,13514,3578725429,3578725451,22
1,898,13515,3578725429,3578725453,24
1,898,13516,3578725429,3578725456,27
1,898,13517,3578725429,3578725457,28
1,898,13518,3578725429,3578725457,28
1,898,13519,3578725429,3578725458,29
1,898,13520,3578725429,3578725458,29
1,898,13521,3578725429,3578725460,31
1,898,13522,3578725429,3578725460,31
1,898,13523,3578725429,3578725460,31
1,898,13524,3578725429,3578725463,34
1,898,13525,3578725429,3578725463,34
1,898,13526,3578725429,3578725465,36
1,898,13527,3578725429,3578725465,36
1,898,13528,3578725429,3578725465,36
1,898,13529,3578725429,3578725468,39
1,898,13530,3578725429,3578725469,40
1,898,13531,3578725429,3578725478,49
1,899,13532,3578725485,3578725485,0
1,899,13533,3578725485,3578725485,0
1,899,13534,3578725485,3578725485,0
1,899,13535,3578725485,3578725486,1
1,899,13536,3578725485,3578725487,2
1,899,13537,3578725485,3578725491,6
1,899,13538,3578725485,3578725492,7
1,899,13539,3578725485,3578725492,7
1,899,13540,3578725485,3578725493,8
1,899,13541,3578725485,3578725494,9
1,899,13542,3578725485,3578725500,15
1,899,13543,3578725485,3578725500,15
1,899,13544,3578725485,3578725501,16
1,899,13545,3578725485,3578725501,16
1,899,13546,3578725485,3578725502,17
1,899,13547,3578725485,3578725503,18
1,899,13548,3578725485,3578725503,18
1,899,13549,3578725485,3578725505,20
1,899,13550,3578725485,3578725507,22
1,899,13551,3578725485,3578725510,25
1,899,13552,3578725485,3578725512,27
1,899,13553,3578725485,3578725512,27
1,899,13554,3578725485,3578725513,28
1,899,13555,3578725485,3578725514,29
1,899,13556,3578725485,3578725516,31
1,899,13557,3578725485,3578725517,32
1,899,13558,3578725485,3578725517,32
1,899,13559,3578725485,3578725517,32
1,899,13560,3578725485,3578725517,32
1,899,13561,3578725485,3578725518,33
1,899,13562,3578725485,3578725518,33
1,899,13563,3578725485,3578725520,35
1,899,13564,3578725485,3578725521,36
1,899,13565,3578725485,3578725523,38
1,899,13566,3578725485,3578725523,38
1,899,13567,3578725485,3578725523,38
1,899,13568,3578725485,3578725523,38
1,899,13569,3578725485,3578725524,39
1,899,13570,3578725485,3578725525,40
1,899,13571,3578725485,3578725527,42
1,899,13572,3578725485,3578725527,42
1,899,13573,3578725485,3578725527,42
1,899,13574,3578725485,3578725528,43
1,899,13575,3578725485,3578725529,44
1,899,13576,3578725485,3578725529,44
1,899,13577,3578725485,3578725533,48
1,899,13578,3578725485,3578725533,48
1,899,13579,3578725485,3578725533,48
1,899,13580,3578725485,3578725533,48
1,899,13581,3578725485,3578725535,50
1,900,13582,3578725542,3578725542,0
1,900,13583,3578725542,3578725542,0
1,900,13584,3578725542,3578725543,1
1,900,13585,3578725542,3578725545,3
1,900,13586,3578725542,3578725546,4
1,900,13587,3578725542,3578725547,5
1,900,13588,3578725542,3578725548,6
1,900,13589,3578725542,3578725555,13
1,900,13590,3578725542,3578725555,13
1,900,13591,3578725542,3578725556,14
1,900,13592,3578725542,3578725556,14
1,900,13593,3578725542,3578725558,16
1,900,13594,3578725542,3578725558,16
1,900,13595,3578725542,3578725561,19
1,900,13596,3578725542,3578725562,20
1,900,13597,3578725542,3578725565,23
1,900,13598,3578725542,3578725565,23
1,900,13599,3578725542,3578725566,24
1,900,13600,3578725542,3578725570,28
1,900,13601,3578725542,3578725571,29
1,900,13602,3578725542,3578725572,30
1,900,13603,3578725542,3578725574,32
1,900,13604,3578725542,3578725574,32
1,900,13605,3578725542,3578725576,34
1,900,13606,3578725542,3578725578,36
1,900,13607,3578725542,3578725583,41
1,900,13608,3578725542,3578725585,43
1,900,13609,3578725542,3578725585,43
1,900,13610,3578725542,3578725585,43
1,900,13611,3578725542,3578725591,49
1,900,13612,3578725542,3578725592,50
1,901,13613,3578725599,3578725599,0
1,901,13614,3578725599,3578725599,0
1,901,13615,3578725599,3578725599,0
1,901,13616,3578725599,3578725599,0
1,901,13617,3578725599,3578725599,0
1,901,13618,3578725599,3578725599,0
1,901,13619,3578725599,3578725599,0
1,901,13620,3578725599,3578725599,0
1,901,13621,3578725599,3578725600,1
1,901,13622,3578725599,3578725600,1
1,901,13623,3578725599,3578725601,2
1,901,13624,3578725599,3578725606,7
1,901,13625,3578725599,3578725607,8
1,901,13626,3578725599,3578725608,9
1,901,13627,3578725599,3578725611,12
1,901,13628,3578725599,3578725613,14
1,901,13629,3578725599,3578725613,14
1,901,13630,3578725599,3578725614,15
1,901,13631,3578725599,3578725614,15
1,901,13632,3578725599,3578725615,16
1,901,13633,3578725599,3578725615,16
1,901,13634,3578725599,3578725616,17
1,901,13635,3578725599,3578725618,19
1,901,13636,3578725599,3578725619,20
1,901,13637,3578725599,3578725619,20
1,901,13638,3578725599,3578725619,20
1,901,13639,3578725599,3578725619,20
1,901,13640,3578725599,3578725620,21
1,901,13641,3578725599,3578725620,21
1,901,13642,3578725599,3578725621,22
1,901,13643,3578725599,3578725624,25
1,901,13644,3578725599,3578725625,26
1,901,13645,3578725599,3578725627,28
1,901,13646,3578725599,3578725628,29
1,901,13647,3578725599,3578725628,29
1,901,13648,3578725599,3578725630,31
1,901,13649,3578725599,3578725631,32
1,901,13650,3578725599,3578725632,33
1,901,13651,3578725599,3578725635,36
1,901,13652,3578725599,3578725637,38
1,901,13653,3578725599,3578725639,40
1,901,13654,3578725599,3578725640,41
1,901,13655,3578725599,3578725643,44
1,901,13656,3578725599,3578725644,45
1,901,13657,3578725599,3578725648,49
1,901,13658,3578725599,3578725649,50
1,902,13659,3578725655,3578725655,0
1,902,13660,3578725655,3578725655,0
1,902,13661,3578725655,3578725655,0
1,902,13662,3578725655,3578725655,0
1,902,13663,3578725655,3578725656,1
1,902,13664,3578725655,3578725657,2
1,902,13665,3578725655,3578725658,3
1,902,13666,3578725655,3578725658,3
1,902,13667,3578725655,3578725658,3
1,902,13668,3578725655,3578725659,4
1,902,13669,3578725655,3578725660,5
1,902,13670,3578725655,3578725661,6
1,902,13671,3578725655,3578725664,9
1,902,13672,3578725655,3578725665,10
1,902,13673,3578725655,3578725665,10
1,902,13674,3578725655,3578725668,13
1,902,13675,3578725655,3578725668,13
1,902,13676,3578725655,3578725672,17
1,902,13677,3578725655,3578725677,22
1,902,13678,3578725655,3578725683,28
1,902,13679,3578725655,3578725683,28
1,902,13680,3578725655,3578725685,30
1,902,13681,3578725655,3578725686,31
1,902,13682,3578725655,3578725686,31
1,902,13683,3578725655,3578725688,33
1,902,13684,3578725655,3578725691,36
1,902,13685,3578725655,3578725692,37
1,902,13686,3578725655,3578725692,37
1,902,13687,3578725655,3578725693,38
1,902,13688,3578725655,3578725695,40
1,902,13689,3578725655,3578725700,45
1,902,13690,3578725655,3578725700,45
1,902,13691,3578725655,3578725701,46
1,902,13692,3578725655,3578725701,46
1,902,13693,3578725655,3578725701,46
1,902,13694,3578725655,3578725703,48
1,902,13695,3578725655,3578725703,48
1,903,13696,3578725712,3578725712,0
1,903,13697,3578725712,3578725712,0
1,903,13698,3578725712,3578725712,0
1,903,13699,3578725712,3578725712,0
1,903,13700,3578725712,3578725713,1
1,903,13701,3578725712,3578725717,5
1,903,13702,3578725712,3578725717,5
1,903,13703,3578725712,3578725717,5
1,903,13704,3578725712,3578725718,6
1,903,13705,3578725712,3578725718,6
1,903,13706,3578725712,3578725718,6
1,903,13707,3578725712,3578725719,7
1,903,13708,3578725712,3578725719,7
1,903,13709,3578725712,3578725721,9
1,903,13710,3578725712,3578725723,11
1,903,13711,3578725712,3578725723,11
1,903,13712,3578725712,3578725723,11
1,903,13713,3578725712,3578725724,12
1,903,13714,3578725712,3578725724,12
1,903,13715,3578725712,3578725725,13
1,903,13716,3578725712,3578725726,14
1,903,13717,3578725712,3578725727,15
1,903,13718,3578725712,3578725727,15
1,903,13719,3578725712,3578725728,16
1,903,13720,3578725712,3578725729,17
1,903,13721,3578725712,3578725729,17
1,903,13722,3578725712,3578725730,18
1,903,13723,3578725712,3578725732,20
1,903,13724,3578725712,3578725733,21
1,903,13725,3578725712,3578725733,21
1,903,13726,3578725712,3578725733,21
1,903,13727,3578725712,3578725735,23
1,903,13728,3578725712,3578725735,23
1,903,13729,3578725712,3578725736,24
1,903,13730,3578725712,3578725742,30
1,903,13731,3578725712,3578725745,33
1,903,13732,3578725712,3578725745,33
1,903,13733,3578725712,3578725746,34
1,903,13734,3578725712,3578725747,35
1,903,13735,3578725712,3578725749,37
1,903,13736,3578725712,3578725755,43
1,903,13737,3578725712,3578725756,44
1,903,13738,3578725712,3578725756,44
1,903,13739,3578725712,3578725756,44
1,903,13740,3578725712,3578725757,45
1,903,13741,3578725712,3578725758,46
1,903,13742,3578725712,3578725761,49
1,903,13743,3578725712,3578725762,50
1,904,13744,3578725769,3578725769,0
1,904,13745,3578725769,3578725769,0
1,904,13746,3578725769,3578725769,0
1,904,13747,3578725769,3578725771,2
1,904,13748,3578725769,3578725771,2
1,904,13749,3578725769,3578725773,4
1,904,13750,3578725769,3578725775,6
1,904,13751,3578725769,3578725775,6
1,904,13752,3578725769,3578725776,7
1,904,13753,3578725769,3578725776,7
1,904,13754,3578725769,3578725779,10
1,904,13755,3578725769,3578725784,15
1,904,13756,3578725769,3578725784,15
1,904,13757,3578725769,3578725784,15
1,904,13758,3578725769,3578725785,16
1,904,13759,3578725769,3578725786,17
1,904,13760,3578725769,3578725791,22
1,904,13761,3578725769,3578725791,22
1,904,13762,3578725769,3578725794,25
1,904,13763,3578725769,3578725794,25
1,904,13764,3578725769,3578725794,25
1,904,13765,3578725769,3578725796,27
1,904,13766,3578725769,3578725797,28
1,904,13767,3578725769,3578725797,28
1,904,13768,3578725769,3578725797,28
1,904,13769,3578725769,3578725799,30
1,904,13770,3578725769,3578725800,31
1,904,13771,3578725769,3578725801,32
1,904,13772,3578725769,3578725803,34
1,904,13773,3578725769,3578725806,37
1,904,13774,3578725769,3578725807,38
1,904,13775,3578725769,3578725808,39
1,904,13776,3578725769,3578725812,43
1,904,13777,3578725769,3578725813,44
1,904,13778,3578725769,3578725814,45
1,904,13779,3578725769,3578725814,45
1,904,13780,3578725769,3578725814,45
1,904,13781,3578725769,3578725815,46
1,904,13782,3578725769,3578725815,46
1,904,13783,3578725769,3578725818,49
1,904,13784,3578725769,3578725819,50
1,905,13785,3578725825,3578725825,0
1,905,13786,3578725825,3578725825,0
1,905,13787,3578725825,3578725825,0
1,905,13788,3578725825,3578725825,0
1,905,13789,3578725825,3578725825,0
1,905,13790,3578725825,3578725825,0
1,905,13791,3578725825,3578725825,0
1,905,13792,3578725825,3578725826,1
1,905,13793,3578725825,3578725828,3
1,905,13794,3578725825,3578725830,5
1,905,13795,3578725825,3578725832,7
1,905,13796,3578725825,3578725832,7
1,905,13797,3578725825,3578725835,10
1,905,13798,3578725825,3578725837,12
1,905,13799,3578725825,3578725839,14
1,905,13800,3578725825,3578725840,15
1,905,13801,3578725825,3578725840,15
1,905,13802,3578725825,3578725843,18
1,905,13803,3578725825,3578725845,20
1,905,13804,3578725825,3578725849,24
1,905,13805,3578725825,3578725850,25
1,905,13806,3578725825,3578725851,26
1,905,13807,3578725825,3578725852,27
1,905,13808,3578725825,3578725855,30
1,905,13809,3578725825,3578725855,30
1,905,13810,3578725825,3578725855,30
1,905,13811,3578725825,3578725857,32
1,905,13812,3578725825,3578725858,33
1,905,13813,3578725825,3578725858,33
1,905,13814,3578725825,3578725859,34
1,905,13815,3578725825,3578725860,35
1,905,13816,3578725825,3578725862,37
1,905,13817,3578725825,3578725865,40
1,905,13818,3578725825,3578725865,40
1,905,13819,3578725825,3578725866,41
1,905,13820,3578725825,3578725868,43
1,905,13821,3578725825,3578725873,48
1,906,13822,3578725882,3578725882,0
1,906,13823,3578725882,3578725882,0
1,906,13824,3578725882,3578725883,1
1,906,13825,3578725882,3578725883,1
1,906,13826,3578725882,3578725883,1
1,906,13827,3578725882,3578725885,3
1,906,13828,3578725882,3578725885,3
1,906,13829,3578725882,3578725886,4
1,906,13830,3578725882,3578725888,6
1,906,13831,3578725882,3578725891,9
1,906,13832,3578725882,3578725892,10
1,906,13833,3578725882,3578725892,10
1,906,13834,3578725882,3578725893,11
1,906,13835,3578725882,3578725893,11
1,906,13836,3578725882,3578725894,12
1,906,13837,3578725882,3578725900,18
1,906,13838,3578725882,3578725900,18
1,906,13839,3578725882,3578725900,18
1,906,13840,3578725882,3578725901,19
1,906,13841,3578725882,3578725902,20
1,906,13842,3578725882,3578725903,21
1,906,13843,3578725882,3578725904,22
1,906,13844,3578725882,3578725906,24
1,906,13845,3578725882,3578725906,24
1,906,13846,3578725882,3578725911,29
1,906,13847,3578725882,3578725912,30
1,906,13848,3578725882,3578725913,31
1,906,13849,3578725882,3578725913,31
1,906,13850,3578725882,3578725915,33
1,906,13851,3578725882,3578725917,35
1,906,13852,3578725882,3578725917,35
1,906,13853,3578725882,3578725918,36
1,906,13854,3578725882,3578725918,36
1,906,13855,3578725882,3578725918,36
1,906,13856,3578725882,3578725918,36
1,906,13857,3578725882,3578725919,37
1,906,13858,3578725882,3578725919,37
1,906,13859,3578725882,3578725921,39
1,906,13860,3578725882,3578725923,41
1,906,13861,3578725882,3578725923,41
1,906,13862,3578725882,3578725923,41
1,906,13863,3578725882,3578725924,42
1,906,13864,3578725882,3578725926,44
1,906,13865,3578725882,3578725926,44
1,906,13866,3578725882,3578725927,45
1,906,13867,3578725882,3578725927,45
1,906,13868,3578725882,3578725928,46
1,906,13869,3578725882,3578725929,47
1,906,13870,3578725882,3578725929,47
1,906,13871,3578725882,3578725930,48
1,906,13872,3578725882,3578725932,50
1,907,13873,3578725940,3578725940,0
1,907,13874,3578725940,3578725940,0
1,907,13875,3578725940,3578725940,0
1,907,13876,3578725940,3578725940,0
1,907,13877,3578725940,3578725940,0
1,907,13878,3578725940,3578725940,0
1,907,13879,3578725940,3578725942,2
1,907,13880,3578725940,3578725945,5
1,907,13881,3578725940,3578725946,6
1,907,13882,3578725940,3578725946,6
1,907,13883,3578725940,3578725948,8
1,907,13884,3578725940,3578725950,10
1,907,13885,3578725940,3578725950,10
1,907,13886,3578725940,3578725952,12
1,907,13887,3578725940,3578725955,15
1,907,13888,3578725940,3578725956,16
1,907,13889,3578725940,3578725956,16
1,907,13890,3578725940,3578725957,17
1,907,13891,3578725940,3578725957,17
1,907,13892,3578725940,3578725958,18
1,907,13893,3578725940,3578725962,22
1,907,13894,3578725940,3578725963,23
1,907,13895,3578725940,3578725965,25
1,907,13896,3578725940,3578725966,26
1,907,13897,3578725940,3578725966,26
1,907,13898,3578725940,3578725971,31
1,907,13899,3578725940,3578725971,31
1,907,13900,3578725940,3578725973,33
1,907,13901,3578725940,3578725974,34
1,907,13902,3578725940,3578725975,35
1,907,13903,3578725940,3578725976,36
1,907,13904,3578725940,3578725977,37
1,907,13905,3578725940,3578725980,40
1,907,13906,3578725940,3578725984,44
1,907,13907,3578725940,3578725984,44
1,907,13908,3578725940,3578725984,44
1,907,13909,3578725940,3578725990,50
1,908,13910,3578725996,3578725996,0
1,908,13911,3578725996,3578725996,0
1,908,13912,3578725996,3578725996,0
1,908,13913,3578725996,3578725996,0
1,908,13914,3578725996,3578725997,1
1,908,13915,3578725996,3578725997,1
1,908,13916,3578725996,3578725997,1
1,908,13917,3578725996,3578725997,1
1,908,13918,3578725996,3578725999,3
1,908,13919,3578725996,3578725999,3
1,908,13920,3578725996,3578726000,4
1,908,13921,3578725996,3578726001,5
1,908,13922,3578725996,3578726006,10
1,908,13923,3578725996,3578726008,12
1,908,13924,3578725996,3578726012,16
1,908,13925,3578725996,3578726013,17
1,908,13926,3578725996,3578726014,18
1,908,13927,3578725996,3578726014,18
1,908,13928,3578725996,3578726015,19
1,908,13929,3578725996,3578726015,19
1,908,13930,3578725996,3578726016,20
1,908,13931,3578725996,3578726019,23
1,908,13932,3578725996,3578726019,23
1,908,13933,3578725996,3578726020,24
1,908,13934,3578725996,3578726020,24
1,908,13935,3578725996,3578726020,24
1,908,13936,3578725996,3578726022,26
1,908,13937,3578725996,3578726024,28
1,908,13938,3578725996,3578726024,28
1,908,13939,3578725996,3578726025,29
1,908,13940,3578725996,3578726027,31
1,908,13941,3578725996,3578726028,32
1,908,13942,3578725996,3578726029,33
1,908,13943,3578725996,3578726030,34
1,908,13944,3578725996,3578726032,36
1,908,13945,3578725996,3578726035,39
1,908,13946,3578725996,3578726037,41
1,908,13947,3578725996,3578726039,43
1,908,13948,3578725996,3578726039,43
1,908,13949,3578725996,3578726043,47
1,908,13950,3578725996,3578726045,49
1,909,13951,3578726054,3578726054,0
1,909,13952,3578726054,3578726054,0
1,909,13953,3578726054,3578726054,0
1,909,13954,3578726054,3578726054,0
1,909,13955,3578726054,3578726056,2
1,909,13956,3578726054,3578726056,2
1,909,13957,3578726054,3578726057,3
1,909,13958,3578726054,3578726058,4
1,909,13959,3578726054,3578726058,4
1,909,13960,3578726054,3578726059,5
1,909,13961,3578726054,3578726061,7
1,909,13962,3578726054,3578726063,9
1,909,13963,3578726054,3578726063,9
1,909,13964,3578726054,3578726064,10
1,909,13965,3578726054,3578726066,12
1,909,13966,3578726054,3578726066,12
1,909,13967,3578726054,3578726067,13
1,909,13968,3578726054,3578726069,15
1,909,13969,3578726054,3578726073,19
1,909,13970,3578726054,3578726079,25
1,909,13971,3578726054,3578726083,29
1,909,13972,3578726054,3578726083,29
1,909,13973,3578726054,3578726085,31
1,909,13974,3578726054,3578726085,31
1,909,13975,3578726054,3578726086,32
1,909,13976,3578726054,3578726088,34
1,909,13977,3578726054,3578726091,37
1,909,13978,3578726054,3578726092,38
1,909,13979,3578726054,3578726092,38
1,909,13980,3578726054,3578726092,38
1,909,13981,3578726054,3578726092,38
1,909,13982,3578726054,3578726094,40
1,909,13983,3578726054,3578726097,43
1,909,13984,3578726054,3578726100,46
1,909,13985,3578726054,3578726100,46
1,909,13986,3578726054,3578726101,47
1,909,13987,3578726054,3578726101,47
1,909,13988,3578726054,3578726103,49
1,909,13989,3578726054,3578726103,49
1,910,13990,3578726111,3578726111,0
1,910,13991,3578726111,3578726111,0
1,910,13992,3578726111,3578726111,0
1,910,13993,3578726111,3578726113,2
1,910,13994,3578726111,3578726113,2
1,910,13995,3578726111,3578726113,2
1,910,13996,3578726111,3578726114,3
1,910,13997,3578726111,3578726117,6
1,910,13998,3578726111,3578726117,6
1,910,13999,3578726111,3578726117,6
1,910,14000,3578726111,3578726117,6
1,910,14001,3578726111,3578726118,7
1,910,14002,3578726111,3578726118,7
1,910,14003,3578726111,3578726119,8
1,910,14004,3578726111,3578726120,9
1,910,14005,3578726111,3578726121,10
1,910,14006,3578726111,3578726123,12
1,910,14007,3578726111,3578726123,12
1,910,14008,3578726111,3578726124,13
1,910,14009,3578726111,3578726124,13
1,910,14010,3578726111,3578726125,14
1,910,14011,3578726111,3578726126,15
1,910,14012,3578726111,3578726127,16
1,910,14013,3578726111,3578726127,16
1,910,14014,3578726111,3578726127,16
1,910,14015,3578726111,3578726128,17
1,910,14016,3578726111,3578726129,18
1,910,14017,3578726111,3578726129,18
1,910,14018,3578726111,3578726129,18
1,910,14019,3578726111,3578726130,19
1,910,14020,3578726111,3578726133,22
1,910,14021,3578726111,3578726133,22
1,910,14022,3578726111,3578726133,22
1,910,14023,3578726111,3578726135,24
1,910,14024,3578726111,3578726135,24
1,910,14025,3578726111,3578726136,25
1,910,14026,3578726111,3578726141,30
1,910,14027,3578726111,3578726143,32
1,910,14028,3578726111,3578726146,35
1,910,14029,3578726111,3578726146,35
1,910,14030,3578726111,3578726147,36
1,910,14031,3578726111,3578726148,37
1,910,14032,3578726111,3578726149,38
1,910,14033,3578726111,3578726150,39
1,910,14034,3578726111,3578726152,41
1,910,14035,3578726111,3578726156,45
1,910,14036,3578726111,3578726156,45
1,910,14037,3578726111,3578726156,45
1,910,14038,3578726111,3578726157,46
1,910,14039,3578726111,3578726158,47
1,910,14040,3578726111,3578726158,47
1,911,14041,3578726168,3578726168,0
1,911,14042,3578726168,3578726168,0
1,911,14043,3578726168,3578726168,0
1,911,14044,3578726168,3578726168,0
1,911,14045,3578726168,3578726168,0
1,911,14046,3578726168,3578726171,3
1,911,14047,3578726168,3578726172,4
1,911,14048,3578726168,3578726174,6
1,911,14049,3578726168,3578726175,7
1,911,14050,3578726168,3578726175,7
1,911,14051,3578726168,3578726177,9
1,911,14052,3578726168,3578726180,12
1,911,14053,3578726168,3578726183,15
1,911,14054,3578726168,3578726184,16
1,911,14055,3578726168,3578726184,16
1,911,14056,3578726168,3578726184,16
1,911,14057,3578726168,3578726186,18
1,911,14058,3578726168,3578726191,23
1,911,14059,3578726168,3578726194,26
1,911,14060,3578726168,3578726194,26
1,911,14061,3578726168,3578726195,27
1,911,14062,3578726168,3578726196,28
1,911,14063,3578726168,3578726196,28
1,911,14064,3578726168,3578726197,29
1,911,14065,3578726168,3578726197,29
1,911,14066,3578726168,3578726197,29
1,911,14067,3578726168,3578726199,31
1,911,14068,3578726168,3578726199,31
1,911,14069,3578726168,3578726200,32
1,911,14070,3578726168,3578726202,34
1,911,14071,3578726168,3578726202,34
1,911,14072,3578726168,3578726208,40
1,911,14073,3578726168,3578726211,43
1,911,14074,3578726168,3578726214,46
1,911,14075,3578726168,3578726214,46
1,911,14076,3578726168,3578726214,46
1,911,14077,3578726168,3578726214,46
1,911,14078,3578726168,3578726215,47
1,911,14079,3578726168,3578726216,48
1,911,14080,3578726168,3578726217,49
1,912,14081,3578726225,3578726225,0
1,912,14082,3578726225,3578726225,0
1,912,14083,3578726225,3578726225,0
1,912,14084,3578726225,3578726225,0
1,912,14085,3578726225,3578726225,0
1,912,14086,3578726225,3578726225,0
1,912,14087,3578726225,3578726225,0
1,912,14088,3578726225,3578726225,0
1,912,14089,3578726225,3578726225,0
1,912,14090,3578726225,3578726225,0
1,912,14091,3578726225,3578726227,2
1,912,14092,3578726225,3578726228,3
1,912,14093,3578726225,3578726230,5
1,912,14094,3578726225,3578726231,6
1,912,14095,3578726225,3578726235,10
1,912,14096,3578726225,3578726237,12
1,912,14097,3578726225,3578726239,14
1,912,14098,3578726225,3578726239,14
1,912,14099,3578726225,3578726240,15
1,912,14100,3578726225,3578726244,19
1,912,14101,3578726225,3578726245,20
1,912,14102,3578726225,3578726249,24
1,912,14103,3578726225,3578726250,25
1,912,14104,3578726225,3578726252,27
1,912,14105,3578726225,3578726252,27
1,912,14106,3578726225,3578726256,31
1,912,14107,3578726225,3578726258,33
1,912,14108,3578726225,3578726258,33
1,912,14109,3578726225,3578726259,34
1,912,14110,3578726225,3578726259,34
1,912,14111,3578726225,3578726260,35
1,912,14112,3578726225,3578726261,36
1,912,14113,3578726225,3578726263,38
1,912,14114,3578726225,3578726264,39
1,912,14115,3578726225,3578726265,40
1,912,14116,3578726225,3578726265,40
1,912,14117,3578726225,3578726266,41
1,912,14118,3578726225,3578726267,42
1,912,14119,3578726225,3578726268,43
1,912,14120,3578726225,3578726273,48
1,913,14121,3578726281,3578726281,0
1,913,14122,3578726281,3578726283,2
1,913,14123,3578726281,3578726283,2
1,913,14124,3578726281,3578726285,4
1,913,14125,3578726281,3578726286,5
1,913,14126,3578726281,3578726288,7
1,913,14127,3578726281,3578726291,10
1,913,14128,3578726281,3578726292,11
1,913,14129,3578726281,3578726293,12
1,913,14130,3578726281,3578726293,12
1,913,14131,3578726281,3578726293,12
1,913,14132,3578726281,3578726294,13
1,913,14133,3578726281,3578726297,16
1,913,14134,3578726281,3578726300,19
1,913,14135,3578726281,3578726300,19
1,913,14136,3578726281,3578726301,20
1,913,14137,3578726281,3578726301,20
1,913,14138,3578726281,3578726303,22
1,913,14139,3578726281,3578726303,22
1,913,14140,3578726281,3578726306,25
1,913,14141,3578726281,3578726307,26
1,913,14142,3578726281,3578726311,30
1,913,14143,3578726281,3578726313,32
1,913,14144,3578726281,3578726314,33
1,913,14145,3578726281,3578726314,33
1,913,14146,3578726281,3578726315,34
1,913,14147,3578726281,3578726317,36
1,913,14148,3578726281,3578726317,36
1,913,14149,3578726281,3578726318,37
1,913,14150,3578726281,3578726318,37
1,913,14151,3578726281,3578726319,38
1,913,14152,3578726281,3578726319,38
1,913,14153,3578726281,3578726319,38
1,913,14154,3578726281,3578726321,40
1,913,14155,3578726281,3578726323,42
1,913,14156,3578726281,3578726323,42
1,913,14157,3578726281,3578726324,43
1,913,14158,3578726281,3578726325,44
1,913,14159,3578726281,3578726325,44
1,913,14160,3578726281,3578726327,46
1,913,14161,3578726281,3578726327,46
1,913,14162,3578726281,3578726327,46
1,913,14163,3578726281,3578726328,47
1,913,14164,3578726281,3578726328,47
1,913,14165,3578726281,3578726328,47
1,913,14166,3578726281,3578726329,48
1,914,14167,3578726337,3578726337,0
1,914,14168,3578726337,3578726337,0
1,914,14169,3578726337,3578726338,1
1,914,14170,3578726337,3578726338,1
1,914,14171,3578726337,3578726338,1
1,914,14172,3578726337,3578726338,1
1,914,14173,3578726337,3578726340,3
1,914,14174,3578726337,3578726342,5
1,914,14175,3578726337,3578726342,5
1,914,14176,3578726337,3578726345,8
1,914,14177,3578726337,3578726346,9
1,914,14178,3578726337,3578726348,11
1,914,14179,3578726337,3578726348,11
1,914,14180,3578726337,3578726350,13
1,914,14181,3578726337,3578726351,14
1,914,14182,3578726337,3578726353,16
1,914,14183,3578726337,3578726356,19
1,914,14184,3578726337,3578726356,19
1,914,14185,3578726337,3578726356,19
1,914,14186,3578726337,3578726357,20
1,914,14187,3578726337,3578726358,21
1,914,14188,3578726337,3578726358,21
1,914,14189,3578726337,3578726362,25
1,914,14190,3578726337,3578726363,26
1,914,14191,3578726337,3578726365,28
1,914,14192,3578726337,3578726366,29
1,914,14193,3578726337,3578726367,30
1,914,14194,3578726337,3578726371,34
1,914,14195,3578726337,3578726371,34
1,914,14196,3578726337,3578726375,38
1,914,14197,3578726337,3578726375,38
1,914,14198,3578726337,3578726375,38
1,914,14199,3578726337,3578726378,41
1,914,14200,3578726337,3578726381,44
1,914,14201,3578726337,3578726383,46
1,914,14202,3578726337,3578726384,47
1,914,14203,3578726337,3578726384,47
1,915,14204,3578726394,3578726394,0
1,915,14205,3578726394,3578726395,1
1,915,14206,3578726394,3578726395,1
1,915,14207,3578726394,3578726396,2
1,915,14208,3578726394,3578726397,3
1,915,14209,3578726394,3578726397,3
1,915,14210,3578726394,3578726397,3
1,915,14211,3578726394,3578726397,3
1,915,14212,3578726394,3578726399,5
1,915,14213,3578726394,3578726399,5
1,915,14214,3578726394,3578726401,7
1,915,14215,3578726394,3578726403,9
1,915,14216,3578726394,3578726404,10
1,915,14217,3578726394,3578726408,14
1,915,14218,3578726394,3578726412,18
1,915,14219,3578726394,3578726413,19
1,915,14220,3578726394,3578726414,20
1,915,14221,3578726394,3578726415,21
1,915,14222,3578726394,3578726415,21
1,915,14223,3578726394,3578726417,23
1,915,14224,3578726394,3578726417,23
1,915,14225,3578726394,3578726419,25
1,915,14226,3578726394,3578726420,26
1,915,14227,3578726394,3578726421,27
1,915,14228,3578726394,3578726421,27
1,915,14229,3578726394,3578726421,27
1,915,14230,3578726394,3578726422,28
1,915,14231,3578726394,3578726424,30
1,915,14232,3578726394,3578726424,30
1,915,14233,3578726394,3578726426,32
1,915,14234,3578726394,3578726427,33
1,915,14235,3578726394,3578726429,35
1,915,14236,3578726394,3578726429,35
1,915,14237,3578726394,3578726431,37
1,915,14238,3578726394,3578726431,37
1,915,14239,3578726394,3578726431,37
1,915,14240,3578726394,3578726435,41
1,915,14241,3578726394,3578726437,43
1,915,14242,3578726394,3578726439,45
1,915,14243,3578726394,3578726440,46
1,915,14244,3578726394,3578726441,47
1,915,14245,3578726394,3578726443,49
1,916,14246,3578726453,3578726453,0
1,916,14247,3578726453,3578726453,0
1,916,14248,3578726453,3578726453,0
1,916,14249,3578726453,3578726453,0
1,916,14250,3578726453,3578726453,0
1,916,14251,3578726453,3578726453,0
1,916,14252,3578726453,3578726454,1
1,916,14253,3578726453,3578726456,3
1,916,14254,3578726453,3578726458,5
1,916,14255,3578726453,3578726459,6
1,916,14256,3578726453,3578726459,6
1,916,14257,3578726453,3578726460,7
1,916,14258,3578726453,3578726461,8
1,916,14259,3578726453,3578726463,10
1,916,14260,3578726453,3578726463,10
1,916,14261,3578726453,3578726465,12
1,916,14262,3578726453,3578726465,12
1,916,14263,3578726453,3578726466,13
1,916,14264,3578726453,3578726468,15
1,916,14265,3578726453,3578726469,16
1,916,14266,3578726453,3578726473,20
1,916,14267,3578726453,3578726479,26
1,916,14268,3578726453,3578726483,30
1,916,14269,3578726453,3578726484,31
1,916,14270,3578726453,3578726485,32
1,916,14271,3578726453,3578726486,33
1,916,14272,3578726453,3578726486,33
1,916,14273,3578726453,3578726488,35
1,916,14274,3578726453,3578726492,39
1,916,14275,3578726453,3578726493,40
1,916,14276,3578726453,3578726493,40
1,916,14277,3578726453,3578726494,41
1,916,14278,3578726453,3578726494,41
1,916,14279,3578726453,3578726497,44
1,916,14280,3578726453,3578726500,47
1,916,14281,3578726453,3578726501,48
1,916,14282,3578726453,3578726501,48
1,917,14283,3578726510,3578726510,0
1,917,14284,3578726510,3578726510,0
1,917,14285,3578726510,3578726510,0
1,917,14286,3578726510,3578726510,0
1,917,14287,3578726510,3578726510,0
1,917,14288,3578726510,3578726512,2
1,917,14289,3578726510,3578726513,3
1,917,14290,3578726510,3578726515,5
1,917,14291,3578726510,3578726516,6
1,917,14292,3578726510,3578726517,7
1,917,14293,3578726510,3578726517,7
1,917,14294,3578726510,3578726518,8
1,917,14295,3578726510,3578726518,8
1,917,14296,3578726510,3578726518,8
1,917,14297,3578726510,3578726519,9
1,917,14298,3578726510,3578726520,10
1,917,14299,3578726510,3578726522,12
1,917,14300,3578726510,3578726522,12
1,917,14301,3578726510,3578726524,14
1,917,14302,3578726510,3578726524,14
1,917,14303,3578726510,3578726525,15
1,917,14304,3578726510,3578726526,16
1,917,14305,3578726510,3578726526,16
1,917,14306,3578726510,3578726527,17
1,917,14307,3578726510,3578726527,17
1,917,14308,3578726510,3578726527,17
1,917,14309,3578726510,3578726527,17
1,917,14310,3578726510,3578726528,18
1,917,14311,3578726510,3578726529,19
1,917,14312,3578726510,3578726530,20
1,917,14313,3578726510,3578726532,22
1,917,14314,3578726510,3578726533,23
1,917,14315,3578726510,3578726535,25
1,917,14316,3578726510,3578726535,25
1,917,14317,3578726510,3578726535,25
1,917,14318,3578726510,3578726539,29
1,917,14319,3578726510,3578726542,32
1,917,14320,3578726510,3578726542,32
1,917,14321,3578726510,3578726544,34
1,917,14322,3578726510,3578726545,35
1,917,14323,3578726510,3578726547,37
1,917,14324,3578726510,3578726548,38
1,917,14325,3578726510,3578726549,39
1,917,14326,3578726510,3578726551,41
1,917,14327,3578726510,3578726555,45
1,917,14328,3578726510,3578726555,45
1,917,14329,3578726510,3578726556,46
1,917,14330,3578726510,3578726556,46
1,917,14331,3578726510,3578726557,47
1,917,14332,3578726510,3578726558,48
1,918,14333,3578726568,3578726568,0
1,918,14334,3578726568,3578726568,0
1,918,14335,3578726568,3578726568,0
1,918,14336,3578726568,3578726568,0
1,918,14337,3578726568,3578726568,0
1,918,14338,3578726568,3578726570,2
1,918,14339,3578726568,3578726574,6
1,918,14340,3578726568,3578726574,6
1,918,14341,3578726568,3578726575,7
1,918,14342,3578726568,3578726576,8
1,918,14343,3578726568,3578726580,12
1,918,14344,3578726568,3578726582,14
1,918,14345,3578726568,3578726583,15
1,918,14346,3578726568,3578726584,16
1,918,14347,3578726568,3578726584,16
1,918,14348,3578726568,3578726585,17
1,918,14349,3578726568,3578726591,23
1,918,14350,3578726568,3578726592,24
1,918,14351,3578726568,3578726593,25
1,918,14352,3578726568,3578726593,25
1,918,14353,3578726568,3578726594,26
1,918,14354,3578726568,3578726595,27
1,918,14355,3578726568,3578726596,28
1,918,14356,3578726568,3578726596,28
1,918,14357,3578726568,3578726596,28
1,918,14358,3578726568,3578726597,29
1,918,14359,3578726568,3578726598,30
1,918,14360,3578726568,3578726599,31
1,918,14361,3578726568,3578726600,32
1,918,14362,3578726568,3578726602,34
1,918,14363,3578726568,3578726603,35
1,918,14364,3578726568,3578726603,35
1,918,14365,3578726568,3578726608,40
1,918,14366,3578726568,3578726612,44
1,918,14367,3578726568,3578726613,45
1,918,14368,3578726568,3578726613,45
1,918,14369,3578726568,3578726615,47
1,918,14370,3578726568,3578726615,47
1,918,14371,3578726568,3578726616,48
1,918,14372,3578726568,3578726617,49
1,919,14373,3578726626,3578726626,0
1,919,14374,3578726626,3578726626,0
1,919,14375,3578726626,3578726626,0
1,919,14376,3578726626,3578726626,0
1,919,14377,3578726626,3578726626,0
1,919,14378,3578726626,3578726626,0
1,919,14379,3578726626,3578726626,0
1,919,14380,3578726626,3578726626,0
1,919,14381,3578726626,3578726626,0
1,919,14382,3578726626,3578726628,2
1,919,14383,3578726626,3578726628,2
1,919,14384,3578726626,3578726630,4
1,919,14385,3578726626,3578726630,4
1,919,14386,3578726626,3578726630,4
1,919,14387,3578726626,3578726634,8
1,919,14388,3578726626,3578726636,10
1,919,14389,3578726626,3578726638,12
1,919,14390,3578726626,3578726639,13
1,919,14391,3578726626,3578726643,17
1,919,14392,3578726626,3578726644,18
1,919,14393,3578726626,3578726647,21
1,919,14394,3578726626,3578726650,24
1,919,14395,3578726626,3578726650,24
1,919,14396,3578726626,3578726651,25
1,919,14397,3578726626,3578726651,25
1,919,14398,3578726626,3578726655,29
1,919,14399,3578726626,3578726655,29
1,919,14400,3578726626,3578726658,32
1,919,14401,3578726626,3578726659,33
1,919,14402,3578726626,3578726659,33
1,919,14403,3578726626,3578726659,33
1,919,14404,3578726626,3578726660,34
1,919,14405,3578726626,3578726662,36
1,919,14406,3578726626,3578726665,39
1,919,14407,3578726626,3578726665,39
1,919,14408,3578726626,3578726666,40
1,919,14409,3578726626,3578726670,44
1,919,14410,3578726626,3578726673,47
1,920,14411,3578726683,3578726683,0
1,920,14412,3578726683,3578726683,0
1,920,14413,3578726683,3578726684,1
1,920,14414,3578726683,3578726684,1
1,920,14415,3578726683,3578726685,2
1,920,14416,3578726683,3578726685,2
1,920,14417,3578726683,3578726686,3
1,920,14418,3578726683,3578726688,5
1,920,14419,3578726683,3578726692,9
1,920,14420,3578726683,3578726693,10
1,920,14421,3578726683,3578726694,11
1,920,14422,3578726683,3578726694,11
1,920,14423,3578726683,3578726695,12
1,920,14424,3578726683,3578726697,14
1,920,14425,3578726683,3578726700,17
1,920,14426,3578726683,3578726701,18
1,920,14427,3578726683,3578726701,18
1,920,14428,3578726683,3578726702,19
1,920,14429,3578726683,3578726703,20
1,920,14430,3578726683,3578726704,21
1,920,14431,3578726683,3578726706,23
1,920,14432,3578726683,3578726706,23
1,920,14433,3578726683,3578726706,23
1,920,14434,3578726683,3578726710,27
1,920,14435,3578726683,3578726711,28
1,920,14436,3578726683,3578726714,31
1,920,14437,3578726683,3578726714,31
1,920,14438,3578726683,3578726715,32
1,920,14439,3578726683,3578726717,34
1,920,14440,3578726683,3578726717,34
1,920,14441,3578726683,3578726717,34
1,920,14442,3578726683,3578726718,35
1,920,14443,3578726683,3578726718,35
1,920,14444,3578726683,3578726719,36
1,920,14445,3578726683,3578726719,36
1,920,14446,3578726683,3578726720,37
1,920,14447,3578726683,3578726723,40
1,920,14448,3578726683,3578726723,40
1,920,14449,3578726683,3578726723,40
1,920,14450,3578726683,3578726726,43
1,920,14451,3578726683,3578726726,43
1,920,14452,3578726683,3578726726,43
1,920,14453,3578726683,3578726726,43
1,920,14454,3578726683,3578726727,44
1,920,14455,3578726683,3578726727,44
1,920,14456,3578726683,3578726728,45
1,920,14457,3578726683,3578726728,45
1,920,14458,3578726683,3578726730,47
1,921,14459,3578726739,3578726739,0
1,921,14460,3578726739,3578726739,0
1,921,14461,3578726739,3578726739,0
1,921,14462,3578726739,3578726739,0
1,921,14463,3578726739,3578726740,1
1,921,14464,3578726739,3578726740,1
1,921,14465,3578726739,3578726740,1
1,921,14466,3578726739,3578726740,1
1,921,14467,3578726739,3578726745,6
1,921,14468,3578726739,3578726746,7
1,921,14469,3578726739,3578726748,9
1,921,14470,3578726739,3578726749,10
1,921,14471,3578726739,3578726752,13
1,921,14472,3578726739,3578726755,16
1,921,14473,3578726739,3578726755,16
1,921,14474,3578726739,3578726756,17
1,921,14475,3578726739,3578726757,18
1,921,14476,3578726739,3578726758,19
1,921,14477,3578726739,3578726758,19
1,921,14478,3578726739,3578726760,21
1,921,14479,3578726739,3578726762,23
1,921,14480,3578726739,3578726765,26
1,921,14481,3578726739,3578726765,26
1,921,14482,3578726739,3578726771,32
1,921,14483,3578726739,3578726771,32
1,921,14484,3578726739,3578726775,36
1,921,14485,3578726739,3578726775,36
1,921,14486,3578726739,3578726775,36
1,921,14487,3578726739,3578726776,37
1,921,14488,3578726739,3578726776,37
1,921,14489,3578726739,3578726779,40
1,921,14490,3578726739,3578726782,43
1,921,14491,3578726739,3578726783,44
1,921,14492,3578726739,3578726784,45
1,921,14493,3578726739,3578726785,46
1,922,14494,3578726796,3578726796,0
1,922,14495,3578726796,3578726796,0
1,922,14496,3578726796,3578726796,0
1,922,14497,3578726796,3578726796,0
1,922,14498,3578726796,3578726796,0
1,922,14499,3578726796,3578726796,0
1,922,14500,3578726796,3578726796,0
1,922,14501,3578726796,3578726796,0
1,922,14502,3578726796,3578726796,0
1,922,14503,3578726796,3578726797,1
1,922,14504,3578726796,3578726799,3
1,922,14505,3578726796,3578726799,3
1,922,14506,3578726796,3578726800,4
1,922,14507,3578726796,3578726803,7
1,922,14508,3578726796,3578726803,7
1,922,14509,3578726796,3578726809,13
1,922,14510,3578726796,3578726811,15
1,922,14511,3578726796,3578726813,17
1,922,14512,3578726796,3578726814,18
1,922,14513,3578726796,3578726814,18
1,922,14514,3578726796,3578726815,19
1,922,14515,3578726796,3578726815,19
1,922,14516,3578726796,3578726816,20
1,922,14517,3578726796,3578726817,21
1,922,14518,3578726796,3578726820,24
1,922,14519,3578726796,3578726821,25
1,922,14520,3578726796,3578726821,25
1,922,14521,3578726796,3578726822,26
1,922,14522,3578726796,3578726823,27
1,922,14523,3578726796,3578726824,28
1,922,14524,3578726796,3578726826,30
1,922,14525,3578726796,3578726827,31
1,922,14526,3578726796,3578726828,32
1,922,14527,3578726796,3578726828,32
1,922,14528,3578726796,3578726830,34
1,922,14529,3578726796,3578726830,34
1,922,14530,3578726796,3578726832,36
1,922,14531,3578726796,3578726834,38
1,922,14532,3578726796,3578726836,40
1,922,14533,3578726796,3578726838,42
1,922,14534,3578726796,3578726839,43
1,922,14535,3578726796,3578726840,44
1,922,14536,3578726796,3578726843,47
1,922,14537,3578726796,3578726844,48
1,922,14538,3578726796,3578726845,49
1,923,14539,3578726853,3578726853,0
1,923,14540,3578726853,3578726853,0
1,923,14541,3578726853,3578726853,0
1,923,14542,3578726853,3578726854,1
1,923,14543,3578726853,3578726855,2
1,923,14544,3578726853,3578726856,3
1,923,14545,3578726853,3578726858,5
1,923,14546,3578726853,3578726859,6
1,923,14547,3578726853,3578726859,6
1,923,14548,3578726853,3578726860,7
1,923,14549,3578726853,3578726861,8
1,923,14550,3578726853,3578726862,9
1,923,14551,3578726853,3578726863,10
1,923,14552,3578726853,3578726864,11
1,923,14553,3578726853,3578726864,11
1,923,14554,3578726853,3578726865,12
1,923,14555,3578726853,3578726868,15
1,923,14556,3578726853,3578726873,20
1,923,14557,3578726853,3578726879,26
1,923,14558,3578726853,3578726884,31
1,923,14559,3578726853,3578726884,31
1,923,14560,3578726853,3578726885,32
1,923,14561,3578726853,3578726885,32
1,923,14562,3578726853,3578726886,33
1,923,14563,3578726853,3578726889,36
1,923,14564,3578726853,3578726892,39
1,923,14565,3578726853,3578726893,40
1,923,14566,3578726853,3578726894,41
1,923,14567,3578726853,3578726895,42
1,923,14568,3578726853,3578726896,43
1,923,14569,3578726853,3578726897,44
1,923,14570,3578726853,3578726900,47
1,923,14571,3578726853,3578726901,48
1,923,14572,3578726853,3578726901,48
1,923,14573,3578726853,3578726902,49
1,924,14574,3578726909,3578726909,0
1,924,14575,3578726909,3578726909,0
1,924,14576,3578726909,3578726909,0
1,924,14577,3578726909,3578726910,1
1,924,14578,3578726909,3578726910,1
1,924,14579,3578726909,3578726910,1
1,924,14580,3578726909,3578726912,3
1,924,14581,3578726909,3578726913,4
1,924,14582,3578726909,3578726914,5
1,924,14583,3578726909,3578726914,5
1,924,14584,3578726909,3578726916,7
1,924,14585,3578726909,3578726917,8
1,924,14586,3578726909,3578726918,9
1,924,14587,3578726909,3578726918,9
1,924,14588,3578726909,3578726918,9
1,924,14589,3578726909,3578726919,10
1,924,14590,3578726909,3578726919,10
1,924,14591,3578726909,3578726920,11
1,924,14592,3578726909,3578726923,14
1,924,14593,3578726909,3578726923,14
1,924,14594,3578726909,3578726925,16
1,924,14595,3578726909,3578726925,16
1,924,14596,3578726909,3578726925,16
1,924,14597,3578726909,3578726926,17
1,924,14598,3578726909,3578726926,17
1,924,14599,3578726909,3578726927,18
1,924,14600,3578726909,3578726927,18
1,924,14601,3578726909,3578726927,18
1,924,14602,3578726909,3578726928,19
1,924,14603,3578726909,3578726930,21
1,924,14604,3578726909,3578726931,22
1,924,14605,3578726909,3578726933,24
1,924,14606,3578726909,3578726933,24
1,924,14607,3578726909,3578726935,26
1,924,14608,3578726909,3578726935,26
1,924,14609,3578726909,3578726936,27
1,924,14610,3578726909,3578726936,27
1,924,14611,3578726909,3578726938,29
1,924,14612,3578726909,3578726940,31
1,924,14613,3578726909,3578726946,37
1,924,14614,3578726909,3578726946,37
1,924,14615,3578726909,3578726948,39
1,924,14616,3578726909,3578726948,39
1,924,14617,3578726909,3578726950,41
1,924,14618,3578726909,3578726951,42
1,924,14619,3578726909,3578726952,43
1,924,14620,3578726909,3578726955,46
1,924,14621,3578726909,3578726955,46
1,924,14622,3578726909,3578726956,47
1,924,14623,3578726909,3578726956,47
1,924,14624,3578726909,3578726957,48
1,924,14625,3578726909,3578726958,49
1,924,14626,3578726909,3578726959,50
1,925,14627,3578726967,3578726967,0
1,925,14628,3578726967,3578726967,0
1,925,14629,3578726967,3578726967,0
1,925,14630,3578726967,3578726970,3
1,925,14631,3578726967,3578726971,4
1,925,14632,3578726967,3578726975,8
1,925,14633,3578726967,3578726975,8
1,925,14634,3578726967,3578726976,9
1,925,14635,3578726967,3578726977,10
1,925,14636,3578726967,3578726980,13
1,925,14637,3578726967,3578726982,15
1,925,14638,3578726967,3578726983,16
1,925,14639,3578726967,3578726984,17
1,925,14640,3578726967,3578726984,17
1,925,14641,3578726967,3578726986,19
1,925,14642,3578726967,3578726991,24
1,925,14643,3578726967,3578726993,26
1,925,14644,3578726967,3578726993,26
1,925,14645,3578726967,3578726993,26
1,925,14646,3578726967,3578726995,28
1,925,14647,3578726967,3578726995,28
1,925,14648,3578726967,3578726996,29
1,925,14649,3578726967,3578726996,29
1,925,14650,3578726967,3578726996,29
1,925,14651,3578726967,3578726997,30
1,925,14652,3578726967,3578726999,32
1,925,14653,3578726967,3578726999,32
1,925,14654,3578726967,3578727000,33
1,925,14655,3578726967,3578727003,36
1,925,14656,3578726967,3578727003,36
1,925,14657,3578726967,3578727003,36
1,925,14658,3578726967,3578727007,40
1,925,14659,3578726967,3578727009,42
1,925,14660,3578726967,3578727012,45
1,925,14661,3578726967,3578727014,47
1,925,14662,3578726967,3578727014,47
1,925,14663,3578726967,3578727014,47
1,925,14664,3578726967,3578727015,48
1,925,14665,3578726967,3578727015,48
1,925,14666,3578726967,3578727016,49
1,926,14667,3578727024,3578727024,0
1,926,14668,3578727024,3578727024,0
1,926,14669,3578727024,3578727024,0
1,926,14670,3578727024,3578727024,0
1,926,14671,3578727024,3578727024,0
1,926,14672,3578727024,3578727024,0
1,926,14673,3578727024,3578727024,0
1,926,14674,3578727024,3578727024,0
1,926,14675,3578727024,3578727024,0
1,926,14676,3578727024,3578727026,2
1,926,14677,3578727024,3578727028,4
1,926,14678,3578727024,3578727029,5
1,926,14679,3578727024,3578727029,5
1,926,14680,3578727024,3578727030,6
1,926,14681,3578727024,3578727030,6
1,926,14682,3578727024,3578727034,10
1,926,14683,3578727024,3578727037,13
1,926,14684,3578727024,3578727039,15
1,926,14685,3578727024,3578727039,15
1,926,14686,3578727024,3578727040,16
1,926,14687,3578727024,3578727043,19
1,926,14688,3578727024,3578727044,20
1,926,14689,3578727024,3578727045,21
1,926,14690,3578727024,3578727048,24
1,926,14691,3578727024,3578727050,26
1,926,14692,3578727024,3578727051,27
1,926,14693,3578727024,3578727052,28
1,926,14694,3578727024,3578727056,32
1,926,14695,3578727024,3578727056,32
1,926,14696,3578727024,3578727058,34
1,926,14697,3578727024,3578727058,34
1,926,14698,3578727024,3578727059,35
1,926,14699,3578727024,3578727059,35
1,926,14700,3578727024,3578727060,36
1,926,14701,3578727024,3578727062,38
1,926,14702,3578727024,3578727063,39
1,926,14703,3578727024,3578727063,39
1,926,14704,3578727024,3578727064,40
1,926,14705,3578727024,3578727064,40
1,926,14706,3578727024,3578727065,41
1,926,14707,3578727024,3578727067,43
1,926,14708,3578727024,3578727068,44
1,926,14709,3578727024,3578727073,49
1,927,14710,3578727080,3578727080,0
1,927,14711,3578727080,3578727083,3
1,927,14712,3578727080,3578727084,4
1,927,14713,3578727080,3578727084,4
1,927,14714,3578727080,3578727086,6
1,927,14715,3578727080,3578727086,6
1,927,14716,3578727080,3578727086,6
1,927,14717,3578727080,3578727090,10
1,927,14718,3578727080,3578727092,12
1,927,14719,3578727080,3578727092,12
1,927,14720,3578727080,3578727093,13
1,927,14721,3578727080,3578727094,14
1,927,14722,3578727080,3578727096,16
1,927,14723,3578727080,3578727097,17
1,927,14724,3578727080,3578727097,17
1,927,14725,3578727080,3578727100,20
1,927,14726,3578727080,3578727101,21
1,927,14727,3578727080,3578727102,22
1,927,14728,3578727080,3578727102,22
1,927,14729,3578727080,3578727103,23
1,927,14730,3578727080,3578727104,24
1,927,14731,3578727080,3578727106,26
1,927,14732,3578727080,3578727106,26
1,927,14733,3578727080,3578727106,26
1,927,14734,3578727080,3578727107,27
1,927,14735,3578727080,3578727110,30
1,927,14736,3578727080,3578727112,32
1,927,14737,3578727080,3578727114,34
1,927,14738,3578727080,3578727115,35
1,927,14739,3578727080,3578727115,35
1,927,14740,3578727080,3578727116,36
1,927,14741,3578727080,3578727117,37
1,927,14742,3578727080,3578727117,37
1,927,14743,3578727080,3578727118,38
1,927,14744,3578727080,3578727118,38
1,927,14745,3578727080,3578727119,39
1,927,14746,3578727080,3578727119,39
1,927,14747,3578727080,3578727120,40
1,927,14748,3578727080,3578727121,41
1,927,14749,3578727080,3578727124,44
1,927,14750,3578727080,3578727124,44
1,927,14751,3578727080,3578727125,45
1,927,14752,3578727080,3578727126,46
1,927,14753,3578727080,3578727126,46
1,927,14754,3578727080,3578727127,47
1,927,14755,3578727080,3578727127,47
1,927,14756,3578727080,3578727127,47
1,927,14757,3578727080,3578727128,48
1,927,14758,3578727080,3578727128,48
1,927,14759,3578727080,3578727129,49
1,928,14760,3578727138,3578727138,0
1,928,14761,3578727138,3578727138,0
1,928,14762,3578727138,3578727138,0
1,928,14763,3578727138,3578727138,0
1,928,14764,3578727138,3578727138,0
1,928,14765,3578727138,3578727138,0
1,928,14766,3578727138,3578727138,0
1,928,14767,3578727138,3578727140,2
1,928,14768,3578727138,3578727142,4
1,928,14769,3578727138,3578727143,5
1,928,14770,3578727138,3578727146,8
1,928,14771,3578727138,3578727148,10
1,928,14772,3578727138,3578727148,10
1,928,14773,3578727138,3578727151,13
1,928,14774,3578727138,3578727151,13
1,928,14775,3578727138,3578727153,15
1,928,14776,3578727138,3578727155,17
1,928,14777,3578727138,3578727155,17
1,928,14778,3578727138,3578727156,18
1,928,14779,3578727138,3578727156,18
1,928,14780,3578727138,3578727157,19
1,928,14781,3578727138,3578727158,20
1,928,14782,3578727138,3578727159,21
1,928,14783,3578727138,3578727162,24
1,928,14784,3578727138,3578727163,25
1,928,14785,3578727138,3578727165,27
1,928,14786,3578727138,3578727167,29
1,928,14787,3578727138,3578727171,33
1,928,14788,3578727138,3578727171,33
1,928,14789,3578727138,3578727175,37
1,928,14790,3578727138,3578727176,38
1,928,14791,3578727138,3578727178,40
1,928,14792,3578727138,3578727178,40
1,928,14793,3578727138,3578727180,42
1,928,14794,3578727138,3578727182,44
1,928,14795,3578727138,3578727184,46
1,928,14796,3578727138,3578727184,46
1,928,14797,3578727138,3578727185,47
1,929,14798,3578727194,3578727194,0
1,929,14799,3578727194,3578727194,0
1,929,14800,3578727194,3578727194,0
1,929,14801,3578727194,3578727194,0
1,929,14802,3578727194,3578727195,1
1,929,14803,3578727194,3578727196,2
1,929,14804,3578727194,3578727196,2
1,929,14805,3578727194,3578727196,2
1,929,14806,3578727194,3578727197,3
1,929,14807,3578727194,3578727197,3
1,929,14808,3578727194,3578727199,5
1,929,14809,3578727194,3578727199,5
1,929,14810,3578727194,3578727200,6
1,929,14811,3578727194,3578727200,6
1,929,14812,3578727194,3578727203,9
1,929,14813,3578727194,3578727203,9
1,929,14814,3578727194,3578727207,13
1,929,14815,3578727194,3578727209,15
1,929,14816,3578727194,3578727211,17
1,929,14817,3578727194,3578727214,20
1,929,14818,3578727194,3578727215,21
1,929,14819,3578727194,3578727215,21
1,929,14820,3578727194,3578727215,21
1,929,14821,3578727194,3578727215,21
1,929,14822,3578727194,3578727217,23
1,929,14823,3578727194,3578727217,23
1,929,14824,3578727194,3578727220,26
1,929,14825,3578727194,3578727221,27
1,929,14826,3578727194,3578727221,27
1,929,14827,3578727194,3578727222,28
1,929,14828,3578727194,3578727223,29
1,929,14829,3578727194,3578727224,30
1,929,14830,3578727194,3578727224,30
1,929,14831,3578727194,3578727225,31
1,929,14832,3578727194,3578727226,32
1,929,14833,3578727194,3578727228,34
1,929,14834,3578727194,3578727229,35
1,929,14835,3578727194,3578727229,35
1,929,14836,3578727194,3578727230,36
1,929,14837,3578727194,3578727230,36
1,929,14838,3578727194,3578727234,40
1,929,14839,3578727194,3578727237,43
1,929,14840,3578727194,3578727239,45
1,929,14841,3578727194,3578727240,46
1,929,14842,3578727194,3578727240,46
1,929,14843,3578727194,3578727243,49
1,930,14844,3578727251,3578727251,0
1,930,14845,3578727251,3578727251,0
1,930,14846,3578727251,3578727251,0
1,930,14847,3578727251,3578727251,0
1,930,14848,3578727251,3578727254,3
1,930,14849,3578727251,3578727255,4
1,930,14850,3578727251,3578727256,5
1,930,14851,3578727251,3578727259,8
1,930,14852,3578727251,3578727259,8
1,930,14853,3578727251,3578727260,9
1,930,14854,3578727251,3578727260,9
1,930,14855,3578727251,3578727262,11
1,930,14856,3578727251,3578727263,12
1,930,14857,3578727251,3578727263,12
1,930,14858,3578727251,3578727265,14
1,930,14859,3578727251,3578727265,14
1,930,14860,3578727251,3578727267,16
1,930,14861,3578727251,3578727269,18
1,930,14862,3578727251,3578727273,22
1,930,14863,3578727251,3578727278,27
1,930,14864,3578727251,3578727283,32
1,930,14865,3578727251,3578727284,33
1,930,14866,3578727251,3578727284,33
1,930,14867,3578727251,3578727285,34
1,930,14868,3578727251,3578727286,35
1,930,14869,3578727251,3578727287,36
1,930,14870,3578727251,3578727291,40
1,930,14871,3578727251,3578727293,42
1,930,14872,3578727251,3578727293,42
1,930,14873,3578727251,3578727293,42
1,930,14874,3578727251,3578727294,43
1,930,14875,3578727251,3578727297,46
1,930,14876,3578727251,3578727297,46
1,930,14877,3578727251,3578727297,46
1,930,14878,3578727251,3578727300,49
1,931,14879,3578727308,3578727308,0
1,931,14880,3578727308,3578727308,0
1,931,14881,3578727308,3578727308,0
1,931,14882,3578727308,3578727308,0
1,931,14883,3578727308,3578727308,0
1,931,14884,3578727308,3578727308,0
1,931,14885,3578727308,3578727308,0
1,931,14886,3578727308,3578727308,0
1,931,14887,3578727308,3578727311,3
1,931,14888,3578727308,3578727313,5
1,931,14889,3578727308,3578727313,5
1,931,14890,3578727308,3578727314,6
1,931,14891,3578727308,3578727315,7
1,931,14892,3578727308,3578727315,7
1,931,14893,3578727308,3578727316,8
1,931,14894,3578727308,3578727317,9
1,931,14895,3578727308,3578727318,10
1,931,14896,3578727308,3578727318,10
1,931,14897,3578727308,3578727319,11
1,931,14898,3578727308,3578727320,12
1,931,14899,3578727308,3578727320,12
1,931,14900,3578727308,3578727320,12
1,931,14901,3578727308,3578727324,16
1,931,14902,3578727308,3578727324,16
1,931,14903,3578727308,3578727325,17
1,931,14904,3578727308,3578727326,18
1,931,14905,3578727308,3578727326,18
1,931,14906,3578727308,3578727326,18
1,931,14907,3578727308,3578727328,20
1,931,14908,3578727308,3578727328,20
1,931,14909,3578727308,3578727328,20
1,931,14910,3578727308,3578727328,20
1,931,14911,3578727308,3578727329,21
1,931,14912,3578727308,3578727330,22
1,931,14913,3578727308,3578727332,24
1,931,14914,3578727308,3578727333,25
1,931,14915,3578727308,3578727334,26
1,931,14916,3578727308,3578727334,26
1,931,14917,3578727308,3578727334,26
1,931,14918,3578727308,3578727335,27
1,931,14919,3578727308,3578727341,33
1,931,14920,3578727308,3578727341,33
1,931,14921,3578727308,3578727343,35
1,931,14922,3578727308,3578727345,37
1,931,14923,3578727308,3578727346,38
1,931,14924,3578727308,3578727348,40
1,931,14925,3578727308,3578727348,40
1,931,14926,3578727308,3578727352,44
1,931,14927,3578727308,3578727352,44
1,931,14928,3578727308,3578727353,45
1,931,14929,3578727308,3578727355,47
1,931,14930,3578727308,3578727356,48
1,931,14931,3578727308,3578727356,48
1,931,14932,3578727308,3578727357,49
1,931,14933,3578727308,3578727357,49
1,932,14934,3578727364,3578727364,0
1,932,14935,3578727364,3578727364,0
1,932,14936,3578727364,3578727364,0
1,932,14937,3578727364,3578727365,1
1,932,14938,3578727364,3578727366,2
1,932,14939,3578727364,3578727366,2
1,932,14940,3578727364,3578727370,6
1,932,14941,3578727364,3578727371,7
1,932,14942,3578727364,3578727376,12
1,932,14943,3578727364,3578727376,12
1,932,14944,3578727364,3578727376,12
1,932,14945,3578727364,3578727378,14
1,932,14946,3578727364,3578727379,15
1,932,14947,3578727364,3578727380,16
1,932,14948,3578727364,3578727382,18
1,932,14949,3578727364,3578727384,20
1,932,14950,3578727364,3578727385,21
1,932,14951,3578727364,3578727385,21
1,932,14952,3578727364,3578727385,21
1,932,14953,3578727364,3578727392,28
1,932,14954,3578727364,3578727392,28
1,932,14955,3578727364,3578727393,29
1,932,14956,3578727364,3578727393,29
1,932,14957,3578727364,3578727394,30
1,932,14958,3578727364,3578727396,32
1,932,14959,3578727364,3578727396,32
1,932,14960,3578727364,3578727397,33
1,932,14961,3578727364,3578727397,33
1,932,14962,3578727364,3578727398,34
1,932,14963,3578727364,3578727399,35
1,932,14964,3578727364,3578727399,35
1,932,14965,3578727364,3578727399,35
1,932,14966,3578727364,3578727400,36
1,932,14967,3578727364,3578727403,39
1,932,14968,3578727364,3578727404,40
1,932,14969,3578727364,3578727407,43
1,932,14970,3578727364,3578727409,45
1,932,14971,3578727364,3578727411,47
1,933,14972,3578727422,3578727422,0
1,933,14973,3578727422,3578727422,0
1,933,14974,3578727422,3578727422,0
1,933,14975,3578727422,3578727422,0
1,933,14976,3578727422,3578727422,0
1,933,14977,3578727422,3578727422,0
1,933,14978,3578727422,3578727422,0
1,933,14979,3578727422,3578727422,0
1,933,14980,3578727422,3578727422,0
1,933,14981,3578727422,3578727422,0
1,933,14982,3578727422,3578727422,0
1,933,14983,3578727422,3578727422,0
1,933,14984,3578727422,3578727423,1
1,933,14985,3578727422,3578727424,2
1,933,14986,3578727422,3578727424,2
1,933,14987,3578727422,3578727424,2
1,933,14988,3578727422,3578727426,4
1,933,14989,3578727422,3578727428,6
1,933,14990,3578727422,3578727429,7
1,933,14991,3578727422,3578727430,8
1,933,14992,3578727422,3578727430,8
1,933,14993,3578727422,3578727431,9
1,933,14994,3578727422,3578727434,12
1,933,14995,3578727422,3578727437,15
1,933,14996,3578727422,3578727439,17
1,933,14997,3578727422,3578727440,18
1,933,14998,3578727422,3578727440,18
1,933,14999,3578727422,3578727443,21
1,933,15000,3578727422,3578727445,23
1,933,15001,3578727422,3578727448,26
1,933,15002,3578727422,3578727451,29
1,933,15003,3578727422,3578727452,30
1,933,15004,3578727422,3578727452,30
1,933,15005,3578727422,3578727456,34
1,933,15006,3578727422,3578727456,34
1,933,15007,3578727422,3578727457,35
1,933,15008,3578727422,3578727457,35
1,933,15009,3578727422,3578727459,37
1,933,15010,3578727422,3578727460,38
1,933,15011,3578727422,3578727460,38
1,933,15012,3578727422,3578727461,39
1,933,15013,3578727422,3578727462,40
1,933,15014,3578727422,3578727463,41
1,933,15015,3578727422,3578727464,42
1,933,15016,3578727422,3578727464,42
1,933,15017,3578727422,3578727465,43
1,933,15018,3578727422,3578727465,43
1,933,15019,3578727422,3578727467,45
1,933,15020,3578727422,3578727469,47
1,934,15021,3578727480,3578727480,0
1,934,15022,3578727480,3578727480,0
1,934,15023,3578727480,3578727482,2
1,934,15024,3578727480,3578727483,3
1,934,15025,3578727480,3578727483,3
1,934,15026,3578727480,3578727484,4
1,934,15027,3578727480,3578727486,6
1,934,15028,3578727480,3578727486,6
1,934,15029,3578727480,3578727490,10
1,934,15030,3578727480,3578727492,12
1,934,15031,3578727480,3578727493,13
1,934,15032,3578727480,3578727493,13
1,934,15033,3578727480,3578727496,16
1,934,15034,3578727480,3578727496,16
1,934,15035,3578727480,3578727499,19
1,934,15036,3578727480,3578727500,20
1,934,15037,3578727480,3578727500,20
1,934,15038,3578727480,3578727501,21
1,934,15039,3578727480,3578727503,23
1,934,15040,3578727480,3578727503,23
1,934,15041,3578727480,3578727505,25
1,934,15042,3578727480,3578727506,26
1,934,15043,3578727480,3578727506,26
1,934,15044,3578727480,3578727509,29
1,934,15045,3578727480,3578727512,32
1,934,15046,3578727480,3578727513,33
1,934,15047,3578727480,3578727513,33
1,934,15048,3578727480,3578727514,34
1,934,15049,3578727480,3578727514,34
1,934,15050,3578727480,3578727515,35
1,934,15051,3578727480,3578727516,36
1,934,15052,3578727480,3578727518,38
1,934,15053,3578727480,3578727519,39
1,934,15054,3578727480,3578727519,39
1,934,15055,3578727480,3578727519,39
1,934,15056,3578727480,3578727520,40
1,934,15057,3578727480,3578727523,43
1,934,15058,3578727480,3578727523,43
1,934,15059,3578727480,3578727524,44
1,934,15060,3578727480,3578727524,44
1,934,15061,3578727480,3578727525,45
1,934,15062,3578727480,3578727525,45
1,934,15063,3578727480,3578727527,47
1,934,15064,3578727480,3578727527,47
1,934,15065,3578727480,3578727527,47
1,934,15066,3578727480,3578727527,47
1,934,15067,3578727480,3578727528,48
1,935,15068,3578727537,3578727537,0
1,935,15069,3578727537,3578727537,0
1,935,15070,3578727537,3578727537,0
1,935,15071,3578727537,3578727537,0
1,935,15072,3578727537,3578727537,0
1,935,15073,3578727537,3578727537,0
1,935,15074,3578727537,3578727537,0
1,935,15075,3578727537,3578727537,0
1,935,15076,3578727537,3578727540,3
1,935,15077,3578727537,3578727541,4
1,935,15078,3578727537,3578727545,8
1,935,15079,3578727537,3578727545,8
1,935,15080,3578727537,3578727547,10
1,935,15081,3578727537,3578727547,10
1,935,15082,3578727537,3578727550,13
1,935,15083,3578727537,3578727551,14
1,935,15084,3578727537,3578727556,19
1,935,15085,3578727537,3578727556,19
1,935,15086,3578727537,3578727556,19
1,935,15087,3578727537,3578727556,19
1,935,15088,3578727537,3578727558,21
1,935,15089,3578727537,3578727558,21
1,935,15090,3578727537,3578727561,24
1,935,15091,3578727537,3578727562,25
1,935,15092,3578727537,3578727565,28
1,935,15093,3578727537,3578727565,28
1,935,15094,3578727537,3578727565,28
1,935,15095,3578727537,3578727571,34
1,935,15096,3578727537,3578727571,34
1,935,15097,3578727537,3578727574,37
1,935,15098,3578727537,3578727575,38
1,935,15099,3578727537,3578727575,38
1,935,15100,3578727537,3578727577,40
1,935,15101,3578727537,3578727577,40
1,935,15102,3578727537,3578727578,41
1,935,15103,3578727537,3578727581,44
1,935,15104,3578727537,3578727583,46
1,935,15105,3578727537,3578727584,47
1,936,15106,3578727595,3578727595,0
1,936,15107,3578727595,3578727595,0
1,936,15108,3578727595,3578727595,0
1,936,15109,3578727595,3578727595,0
1,936,15110,3578727595,3578727595,0
1,936,15111,3578727595,3578727596,1
1,936,15112,3578727595,3578727596,1
1,936,15113,3578727595,3578727597,2
1,936,15114,3578727595,3578727598,3
1,936,15115,3578727595,3578727599,4
1,936,15116,3578727595,3578727599,4
1,936,15117,3578727595,3578727599,4
1,936,15118,3578727595,3578727602,7
1,936,15119,3578727595,3578727603,8
1,936,15120,3578727595,3578727606,11
1,936,15121,3578727595,3578727608,13
1,936,15122,3578727595,3578727611,16
1,936,15123,3578727595,3578727613,18
1,936,15124,3578727595,3578727614,19
1,936,15125,3578727595,3578727615,20
1,936,15126,3578727595,3578727616,21
1,936,15127,3578727595,3578727616,21
1,936,15128,3578727595,3578727616,21
1,936,15129,3578727595,3578727617,22
1,936,15130,3578727595,3578727621,26
1,936,15131,3578727595,3578727621,26
1,936,15132,3578727595,3578727622,27
1,936,15133,3578727595,3578727622,27
1,936,15134,3578727595,3578727623,28
1,936,15135,3578727595,3578727623,28
1,936,15136,3578727595,3578727625,30
1,936,15137,3578727595,3578727625,30
1,936,15138,3578727595,3578727628,33
1,936,15139,3578727595,3578727628,33
1,936,15140,3578727595,3578727628,33
1,936,15141,3578727595,3578727630,35
1,936,15142,3578727595,3578727630,35
1,936,15143,3578727595,3578727633,38
1,936,15144,3578727595,3578727636,41
1,936,15145,3578727595,3578727638,43
1,936,15146,3578727595,3578727638,43
1,936,15147,3578727595,3578727638,43
1,936,15148,3578727595,3578727642,47
1,936,15149,3578727595,3578727644,49
1,937,15150,3578727651,3578727651,0
1,937,15151,3578727651,3578727651,0
1,937,15152,3578727651,3578727651,0
1,937,15153,3578727651,3578727653,2
1,937,15154,3578727651,3578727655,4
1,937,15155,3578727651,3578727655,4
1,937,15156,3578727651,3578727659,8
1,937,15157,3578727651,3578727659,8
1,937,15158,3578727651,3578727660,9
1,937,15159,3578727651,3578727660,9
1,937,15160,3578727651,3578727662,11
1,937,15161,3578727651,3578727662,11
1,937,15162,3578727651,3578727664,13
1,937,15163,3578727651,3578727664,13
1,937,15164,3578727651,3578727665,14
1,937,15165,3578727651,3578727666,15
1,937,15166,3578727651,3578727669,18
1,937,15167,3578727651,3578727672,21
1,937,15168,3578727651,3578727679,28
1,937,15169,3578727651,3578727683,32
1,937,15170,3578727651,3578727683,32
1,937,15171,3578727651,3578727683,32
1,937,15172,3578727651,3578727684,33
1,937,15173,3578727651,3578727686,35
1,937,15174,3578727651,3578727686,35
1,937,15175,3578727651,3578727691,40
1,937,15176,3578727651,3578727692,41
1,937,15177,3578727651,3578727693,42
1,937,15178,3578727651,3578727693,42
1,937,15179,3578727651,3578727696,45
1,937,15180,3578727651,3578727697,46
1,937,15181,3578727651,3578727699,48
1,937,15182,3578727651,3578727700,49
1,938,15183,3578727709,3578727709,0
1,938,15184,3578727709,3578727709,0
1,938,15185,3578727709,3578727709,0
1,938,15186,3578727709,3578727709,0
1,938,15187,3578727709,3578727709,0
1,938,15188,3578727709,3578727709,0
1,938,15189,3578727709,3578727709,0
1,938,15190,3578727709,3578727709,0
1,938,15191,3578727709,3578727712,3
1,938,15192,3578727709,3578727712,3
1,938,15193,3578727709,3578727713,4
1,938,15194,3578727709,3578727713,4
1,938,15195,3578727709,3578727714,5
1,938,15196,3578727709,3578727715,6
1,938,15197,3578727709,3578727716,7
1,938,15198,3578727709,3578727717,8
1,938,15199,3578727709,3578727717,8
1,938,15200,3578727709,3578727717,8
1,938,15201,3578727709,3578727719,10
1,938,15202,3578727709,3578727720,11
1,938,15203,3578727709,3578727720,11
1,938,15204,3578727709,3578727722,13
1,938,15205,3578727709,3578727723,14
1,938,15206,3578727709,3578727724,15
1,938,15207,3578727709,3578727724,15
1,938,15208,3578727709,3578727725,16
1,938,15209,3578727709,3578727725,16
1,938,15210,3578727709,3578727726,17
1,938,15211,3578727709,3578727727,18
1,938,15212,3578727709,3578727727,18
1,938,15213,3578727709,3578727727,18
1,938,15214,3578727709,3578727727,18
1,938,15215,3578727709,3578727727,18
1,938,15216,3578727709,3578727730,21
1,938,15217,3578727709,3578727735,26
1,938,15218,3578727709,3578727735,26
1,938,15219,3578727709,3578727735,26
1,938,15220,3578727709,3578727736,27
1,938,15221,3578727709,3578727736,27
1,938,15222,3578727709,3578727739,30
1,938,15223,3578727709,3578727741,32
1,938,15224,3578727709,3578727743,34
1,938,15225,3578727709,3578727745,36
1,938,15226,3578727709,3578727745,36
1,938,15227,3578727709,3578727747,38
1,938,15228,3578727709,3578727747,38
1,938,15229,3578727709,3578727751,42
1,938,15230,3578727709,3578727751,42
1,938,15231,3578727709,3578727756,47
1,938,15232,3578727709,3578727756,47
1,938,15233,3578727709,3578727756,47
1,938,15234,3578727709,3578727757,48
1,938,15235,3578727709,3578727758,49
1,938,15236,3578727709,3578727759,50
1,939,15237,3578727766,3578727766,0
1,939,15238,3578727766,3578727766,0
1,939,15239,3578727766,3578727766,0
1,939,15240,3578727766,3578727766,0
1,939,15241,3578727766,3578727770,4
1,939,15242,3578727766,3578727771,5
1,939,15243,3578727766,3578727774,8
1,939,15244,3578727766,3578727774,8
1,939,15245,3578727766,3578727775,9
1,939,15246,3578727766,3578727775,9
1,939,15247,3578727766,3578727777,11
1,939,15248,3578727766,3578727778,12
1,939,15249,3578727766,3578727779,13
1,939,15250,3578727766,3578727780,14
1,939,15251,3578727766,3578727783,17
1,939,15252,3578727766,3578727784,18
1,939,15253,3578727766,3578727785,19
1,939,15254,3578727766,3578727792,26
1,939,15255,3578727766,3578727793,27
1,939,15256,3578727766,3578727794,28
1,939,15257,3578727766,3578727794,28
1,939,15258,3578727766,3578727794,28
1,939,15259,3578727766,3578727795,29
1,939,15260,3578727766,3578727796,30
1,939,15261,3578727766,3578727796,30
1,939,15262,3578727766,3578727796,30
1,939,15263,3578727766,3578727797,31
1,939,15264,3578727766,3578727798,32
1,939,15265,3578727766,3578727799,33
1,939,15266,3578727766,3578727799,33
1,939,15267,3578727766,3578727803,37
1,939,15268,3578727766,3578727803,37
1,939,15269,3578727766,3578727803,37
1,939,15270,3578727766,3578727807,41
1,939,15271,3578727766,3578727808,42
1,939,15272,3578727766,3578727810,44
1,939,15273,3578727766,3578727813,47
1,939,15274,3578727766,3578727814,48
1,939,15275,3578727766,3578727816,50
1,940,15276,3578727823,3578727823,0
1,940,15277,3578727823,3578727823,0
1,940,15278,3578727823,3578727823,0
1,940,15279,3578727823,3578727823,0
1,940,15280,3578727823,3578727823,0
1,940,15281,3578727823,3578727823,0
1,940,15282,3578727823,3578727823,0
1,940,15283,3578727823,3578727823,0
1,940,15284,3578727823,3578727823,0
1,940,15285,3578727823,3578727823,0
1,940,15286,3578727823,3578727824,1
1,940,15287,3578727823,3578727824,1
1,940,15288,3578727823,3578727825,2
1,940,15289,3578727823,3578727826,3
1,940,15290,3578727823,3578727828,5
1,940,15291,3578727823,3578727829,6
1,940,15292,3578727823,3578727829,6
1,940,15293,3578727823,3578727830,7
1,940,15294,3578727823,3578727831,8
1,940,15295,3578727823,3578727831,8
1,940,15296,3578727823,3578727834,11
1,940,15297,3578727823,3578727837,14
1,940,15298,3578727823,3578727838,15
1,940,15299,3578727823,3578727842,19
1,940,15300,3578727823,3578727845,22
1,940,15301,3578727823,3578727848,25
1,940,15302,3578727823,3578727851,28
1,940,15303,3578727823,3578727853,30
1,940,15304,3578727823,3578727853,30
1,940,15305,3578727823,3578727855,32
1,940,15306,3578727823,3578727857,34
1,940,15307,3578727823,3578727858,35
1,940,15308,3578727823,3578727859,36
1,940,15309,3578727823,3578727860,37
1,940,15310,3578727823,3578727860,37
1,940,15311,3578727823,3578727862,39
1,940,15312,3578727823,3578727863,40
1,940,15313,3578727823,3578727863,40
1,940,15314,3578727823,3578727864,41
1,940,15315,3578727823,3578727866,43
1,940,15316,3578727823,3578727866,43
1,940,15317,3578727823,3578727869,46
1,940,15318,3578727823,3578727873,50
1,941,15319,3578727881,3578727881,0
1,941,15320,3578727881,3578727882,1
1,941,15321,3578727881,3578727883,2
1,941,15322,3578727881,3578727884,3
1,941,15323,3578727881,3578727885,4
1,941,15324,3578727881,3578727886,5
1,941,15325,3578727881,3578727886,5
1,941,15326,3578727881,3578727891,10
1,941,15327,3578727881,3578727892,11
1,941,15328,3578727881,3578727894,13
1,941,15329,3578727881,3578727895,14
1,941,15330,3578727881,3578727896,15
1,941,15331,3578727881,3578727897,16
1,941,15332,3578727881,3578727897,16
1,941,15333,3578727881,3578727899,18
1,941,15334,3578727881,3578727900,19
1,941,15335,3578727881,3578727901,20
1,941,15336,3578727881,3578727902,21
1,941,15337,3578727881,3578727903,22
1,941,15338,3578727881,3578727905,24
1,941,15339,3578727881,3578727905,24
1,941,15340,3578727881,3578727906,25
1,941,15341,3578727881,3578727906,25
1,941,15342,3578727881,3578727906,25
1,941,15343,3578727881,3578727909,28
1,941,15344,3578727881,3578727912,31
1,941,15345,3578727881,3578727913,32
1,941,15346,3578727881,3578727914,33
1,941,15347,3578727881,3578727914,33
1,941,15348,3578727881,3578727916,35
1,941,15349,3578727881,3578727917,36
1,941,15350,3578727881,3578727917,36
1,941,15351,3578727881,3578727917,36
1,941,15352,3578727881,3578727918,37
1,941,15353,3578727881,3578727919,38
1,941,15354,3578727881,3578727920,39
1,941,15355,3578727881,3578727920,39
1,941,15356,3578727881,3578727923,42
1,941,15357,3578727881,3578727924,43
1,941,15358,3578727881,3578727924,43
1,941,15359,3578727881,3578727925,44
1,941,15360,3578727881,3578727925,44
1,941,15361,3578727881,3578727927,46
1,941,15362,3578727881,3578727927,46
1,941,15363,3578727881,3578727928,47
1,941,15364,3578727881,3578727928,47
1,941,15365,3578727881,3578727928,47
1,941,15366,3578727881,3578727928,47
1,942,15367,3578727939,3578727939,0
1,942,15368,3578727939,3578727939,0
1,942,15369,3578727939,3578727939,0
1,942,15370,3578727939,3578727939,0
1,942,15371,3578727939,3578727939,0
1,942,15372,3578727939,3578727939,0
1,942,15373,3578727939,3578727940,1
1,942,15374,3578727939,3578727941,2
1,942,15375,3578727939,3578727945,6
1,942,15376,3578727939,3578727946,7
1,942,15377,3578727939,3578727948,9
1,942,15378,3578727939,3578727949,10
1,942,15379,3578727939,3578727950,11
1,942,15380,3578727939,3578727952,13
1,942,15381,3578727939,3578727956,17
1,942,15382,3578727939,3578727956,17
1,942,15383,3578727939,3578727956,17
1,942,15384,3578727939,3578727957,18
1,942,15385,3578727939,3578727958,19
1,942,15386,3578727939,3578727959,20
1,942,15387,3578727939,3578727962,23
1,942,15388,3578727939,3578727963,24
1,942,15389,3578727939,3578727965,26
1,942,15390,3578727939,3578727965,26
1,942,15391,3578727939,3578727969,30
1,942,15392,3578727939,3578727971,32
1,942,15393,3578727939,3578727972,33
1,942,15394,3578727939,3578727975,36
1,942,15395,3578727939,3578727975,36
1,942,15396,3578727939,3578727975,36
1,942,15397,3578727939,3578727975,36
1,942,15398,3578727939,3578727977,38
1,942,15399,3578727939,3578727977,38
1,942,15400,3578727939,3578727978,39
1,942,15401,3578727939,3578727982,43
1,942,15402,3578727939,3578727983,44
1,942,15403,3578727939,3578727984,45
1,943,15404,3578727996,3578727996,0
1,943,15405,3578727996,3578727996,0
1,943,15406,3578727996,3578727996,0
1,943,15407,3578727996,3578727996,0
1,943,15408,3578727996,3578727996,0
1,943,15409,3578727996,3578727996,0
1,943,15410,3578727996,3578727996,0
1,943,15411,3578727996,3578727996,0
1,943,15412,3578727996,3578727997,1
1,943,15413,3578727996,3578727997,1
1,943,15414,3578727996,3578727998,2
1,943,15415,3578727996,3578727999,3
1,943,15416,3578727996,3578727999,3
1,943,15417,3578727996,3578727999,3
1,943,15418,3578727996,3578728003,7
1,943,15419,3578727996,3578728003,7
1,943,15420,3578727996,3578728004,8
1,943,15421,3578727996,3578728007,11
1,943,15422,3578727996,3578728008,12
1,943,15423,3578727996,3578728011,15
1,943,15424,3578727996,3578728013,17
1,943,15425,3578727996,3578728014,18
1,943,15426,3578727996,3578728015,19
1,943,15427,3578727996,3578728015,19
1,943,15428,3578727996,3578728015,19
1,943,15429,3578727996,3578728016,20
1,943,15430,3578727996,3578728017,21
1,943,15431,3578727996,3578728017,21
1,943,15432,3578727996,3578728017,21
1,943,15433,3578727996,3578728019,23
1,943,15434,3578727996,3578728020,24
1,943,15435,3578727996,3578728022,26
1,943,15436,3578727996,3578728023,27
1,943,15437,3578727996,3578728023,27
1,943,15438,3578727996,3578728024,28
1,943,15439,3578727996,3578728024,28
1,943,15440,3578727996,3578728024,28
1,943,15441,3578727996,3578728025,29
1,943,15442,3578727996,3578728027,31
1,943,15443,3578727996,3578728028,32
1,943,15444,3578727996,3578728028,32
1,943,15445,3578727996,3578728028,32
1,943,15446,3578727996,3578728031,35
1,943,15447,3578727996,3578728031,35
1,943,15448,3578727996,3578728032,36
1,943,15449,3578727996,3578728034,38
1,943,15450,3578727996,3578728037,41
1,943,15451,3578727996,3578728040,44
1,943,15452,3578727996,3578728042,46
1,943,15453,3578727996,3578728044,48
1,944,15454,3578728056,3578728056,0
1,944,15455,3578728056,3578728056,0
1,944,15456,3578728056,3578728056,0
1,944,15457,3578728056,3578728056,0
1,944,15458,3578728056,3578728057,1
1,944,15459,3578728056,3578728059,3
1,944,15460,3578728056,3578728060,4
1,944,15461,3578728056,3578728060,4
1,944,15462,3578728056,3578728060,4
1,944,15463,3578728056,3578728063,7
1,944,15464,3578728056,3578728064,8
1,944,15465,3578728056,3578728065,9
1,944,15466,3578728056,3578728065,9
1,944,15467,3578728056,3578728066,10
1,944,15468,3578728056,3578728066,10
1,944,15469,3578728056,3578728069,13
1,944,15470,3578728056,3578728073,17
1,944,15471,3578728056,3578728083,27
1,944,15472,3578728056,3578728083,27
1,944,15473,3578728056,3578728085,29
1,944,15474,3578728056,3578728085,29
1,944,15475,3578728056,3578728085,29
1,944,15476,3578728056,3578728086,30
1,944,15477,3578728056,3578728091,35
1,944,15478,3578728056,3578728092,36
1,944,15479,3578728056,3578728092,36
1,944,15480,3578728056,3578728093,37
1,944,15481,3578728056,3578728096,40
1,944,15482,3578728056,3578728096,40
1,944,15483,3578728056,3578728097,41
1,944,15484,3578728056,3578728097,41
1,944,15485,3578728056,3578728099,43
1,944,15486,3578728056,3578728100,44
1,944,15487,3578728056,3578728102,46
1,944,15488,3578728056,3578728102,46
1,944,15489,3578728056,3578728103,47
1,944,15490,3578728056,3578728106,50
1,945,15491,3578728114,3578728114,0
1,945,15492,3578728114,3578728114,0
1,945,15493,3578728114,3578728114,0
1,945,15494,3578728114,3578728114,0
1,945,15495,3578728114,3578728114,0
1,945,15496,3578728114,3578728114,0
1,945,15497,3578728114,3578728114,0
1,945,15498,3578728114,3578728114,0
1,945,15499,3578728114,3578728116,2
1,945,15500,3578728114,3578728116,2
1,945,15501,3578728114,3578728116,2
1,945,15502,3578728114,3578728117,3
1,945,15503,3578728114,3578728119,5
1,945,15504,3578728114,3578728119,5
1,945,15505,3578728114,3578728119,5
1,945,15506,3578728114,3578728120,6
1,945,15507,3578728114,3578728124,10
1,945,15508,3578728114,3578728124,10
1,945,15509,3578728114,3578728124,10
1,945,15510,3578728114,3578728124,10
1,945,15511,3578728114,3578728126,12
1,945,15512,3578728114,3578728127,13
1,945,15513,3578728114,3578728128,14
1,945,15514,3578728114,3578728128,14
1,945,15515,3578728114,3578728129,15
1,945,15516,3578728114,3578728129,15
1,945,15517,3578728114,3578728130,16
1,945,15518,3578728114,3578728130,16
1,945,15519,3578728114,3578728133,19
1,945,15520,3578728114,3578728133,19
1,945,15521,3578728114,3578728135,21
1,945,15522,3578728114,3578728135,21
1,945,15523,3578728114,3578728136,22
1,945,15524,3578728114,3578728137,23
1,945,15525,3578728114,3578728137,23
1,945,15526,3578728114,3578728141,27
1,945,15527,3578728114,3578728141,27
1,945,15528,3578728114,3578728143,29
1,945,15529,3578728114,3578728145,31
1,945,15530,3578728114,3578728146,32
1,945,15531,3578728114,3578728149,35
1,945,15532,3578728114,3578728149,35
1,945,15533,3578728114,3578728151,37
1,945,15534,3578728114,3578728152,38
1,945,15535,3578728114,3578728153,39
1,945,15536,3578728114,3578728156,42
1,945,15537,3578728114,3578728156,42
1,945,15538,3578728114,3578728157,43
1,945,15539,3578728114,3578728157,43
1,945,15540,3578728114,3578728158,44
1,945,15541,3578728114,3578728158,44
1,945,15542,3578728114,3578728159,45
1,945,15543,3578728114,3578728163,49
1,946,15544,3578728170,3578728170,0
1,946,15545,3578728170,3578728170,0
1,946,15546,3578728170,3578728174,4
1,946,15547,3578728170,3578728174,4
1,946,15548,3578728170,3578728175,5
1,946,15549,3578728170,3578728175,5
1,946,15550,3578728170,3578728177,7
1,946,15551,3578728170,3578728177,7
1,946,15552,3578728170,3578728178,8
1,946,15553,3578728170,3578728182,12
1,946,15554,3578728170,3578728183,13
1,946,15555,3578728170,3578728184,14
1,946,15556,3578728170,3578728184,14
1,946,15557,3578728170,3578728185,15
1,946,15558,3578728170,3578728191,21
1,946,15559,3578728170,3578728192,22
1,946,15560,3578728170,3578728193,23
1,946,15561,3578728170,3578728193,23
1,946,15562,3578728170,3578728194,24
1,946,15563,3578728170,3578728195,25
1,946,15564,3578728170,3578728196,26
1,946,15565,3578728170,3578728196,26
1,946,15566,3578728170,3578728197,27
1,946,15567,3578728170,3578728197,27
1,946,15568,3578728170,3578728197,27
1,946,15569,3578728170,3578728199,29
1,946,15570,3578728170,3578728199,29
1,946,15571,3578728170,3578728199,29
1,946,15572,3578728170,3578728200,30
1,946,15573,3578728170,3578728203,33
1,946,15574,3578728170,3578728208,38
1,946,15575,3578728170,3578728212,42
1,946,15576,3578728170,3578728213,43
1,946,15577,3578728170,3578728214,44
1,946,15578,3578728170,3578728215,45
1,946,15579,3578728170,3578728215,45
1,946,15580,3578728170,3578728216,46
1,946,15581,3578728170,3578728217,47
1,946,15582,3578728170,3578728217,47
1,946,15583,3578728170,3578728217,47
1,946,15584,3578728170,3578728217,47
1,946,15585,3578728170,3578728219,49
1,947,15586,3578728227,3578728227,0
1,947,15587,3578728227,3578728227,0
1,947,15588,3578728227,3578728227,0
1,947,15589,3578728227,3578728227,0
1,947,15590,3578728227,3578728227,0
1,947,15591,3578728227,3578728227,0
1,947,15592,3578728227,3578728227,0
1,947,15593,3578728227,3578728227,0
1,947,15594,3578728227,3578728227,0
1,947,15595,3578728227,3578728227,0
1,947,15596,3578728227,3578728228,1
1,947,15597,3578728227,3578728229,2
1,947,15598,3578728227,3578728229,2
1,947,15599,3578728227,3578728231,4
1,947,15600,3578728227,3578728231,4
1,947,15601,3578728227,3578728232,5
1,947,15602,3578728227,3578728234,7
1,947,15603,3578728227,3578728240,13
1,947,15604,3578728227,3578728242,15
1,947,15605,3578728227,3578728248,21
1,947,15606,3578728227,3578728252,25
1,947,15607,3578728227,3578728252,25
1,947,15608,3578728227,3578728255,28
1,947,15609,3578728227,3578728255,28
1,947,15610,3578728227,3578728256,29
1,947,15611,3578728227,3578728256,29
1,947,15612,3578728227,3578728259,32
1,947,15613,3578728227,3578728259,32
1,947,15614,3578728227,3578728260,33
1,947,15615,3578728227,3578728261,34
1,947,15616,3578728227,3578728263,36
1,947,15617,3578728227,3578728263,36
1,947,15618,3578728227,3578728265,38
1,947,15619,3578728227,3578728265,38
1,947,15620,3578728227,3578728265,38
1,947,15621,3578728227,3578728269,42
1,947,15622,3578728227,3578728273,46
1,948,15623,3578728284,3578728284,0
1,948,15624,3578728284,3578728284,0
1,948,15625,3578728284,3578728284,0
1,948,15626,3578728284,3578728286,2
1,948,15627,3578728284,3578728286,2
1,948,15628,3578728284,3578728286,2
1,948,15629,3578728284,3578728292,8
1,948,15630,3578728284,3578728292,8
1,948,15631,3578728284,3578728294,10
1,948,15632,3578728284,3578728296,12
1,948,15633,3578728284,3578728296,12
1,948,15634,3578728284,3578728297,13
1,948,15635,3578728284,3578728297,13
1,948,15636,3578728284,3578728299,15
1,948,15637,3578728284,3578728300,16
1,948,15638,3578728284,3578728301,17
1,948,15639,3578728284,3578728302,18
1,948,15640,3578728284,3578728306,22
1,948,15641,3578728284,3578728306,22
1,948,15642,3578728284,3578728306,22
1,948,15643,3578728284,3578728306,22
1,948,15644,3578728284,3578728307,23
1,948,15645,3578728284,3578728310,26
1,948,15646,3578728284,3578728313,29
1,948,15647,3578728284,3578728313,29
1,948,15648,3578728284,3578728314,30
1,948,15649,3578728284,3578728315,31
1,948,15650,3578728284,3578728316,32
1,948,15651,3578728284,3578728317,33
1,948,15652,3578728284,3578728317,33
1,948,15653,3578728284,3578728318,34
1,948,15654,3578728284,3578728318,34
1,948,15655,3578728284,3578728319,35
1,948,15656,3578728284,3578728319,35
1,948,15657,3578728284,3578728320,36
1,948,15658,3578728284,3578728320,36
1,948,15659,3578728284,3578728324,40
1,948,15660,3578728284,3578728324,40
1,948,15661,3578728284,3578728325,41
1,948,15662,3578728284,3578728325,41
1,948,15663,3578728284,3578728326,42
1,948,15664,3578728284,3578728327,43
1,948,15665,3578728284,3578728328,44
1,948,15666,3578728284,3578728329,45
1,948,15667,3578728284,3578728329,45
1,948,15668,3578728284,3578728329,45
1,948,15669,3578728284,3578728329,45
1,948,15670,3578728284,3578728330,46
1,948,15671,3578728284,3578728330,46
1,948,15672,3578728284,3578728333,49
1,948,15673,3578728284,3578728333,49
1,949,15674,3578728343,3578728343,0
1,949,15675,3578728343,3578728343,0
1,949,15676,3578728343,3578728343,0
1,949,15677,3578728343,3578728343,0
1,949,15678,3578728343,3578728343,0
1,949,15679,3578728343,3578728343,0
1,949,15680,3578728343,3578728343,0
1,949,15681,3578728343,3578728343,0
1,949,15682,3578728343,3578728345,2
1,949,15683,3578728343,3578728346,3
1,949,15684,3578728343,3578728348,5
1,949,15685,3578728343,3578728350,7
1,949,15686,3578728343,3578728351,8
1,949,15687,3578728343,3578728353,10
1,949,15688,3578728343,3578728353,10
1,949,15689,3578728343,3578728356,13
1,949,15690,3578728343,3578728357,14
1,949,15691,3578728343,3578728358,15
1,949,15692,3578728343,3578728358,15
1,949,15693,3578728343,3578728358,15
1,949,15694,3578728343,3578728358,15
1,949,15695,3578728343,3578728364,21
1,949,15696,3578728343,3578728367,24
1,949,15697,3578728343,3578728370,27
1,949,15698,3578728343,3578728371,28
1,949,15699,3578728343,3578728374,31
1,949,15700,3578728343,3578728375,32
1,949,15701,3578728343,3578728375,32
1,949,15702,3578728343,3578728376,33
1,949,15703,3578728343,3578728377,34
1,949,15704,3578728343,3578728377,34
1,949,15705,3578728343,3578728378,35
1,949,15706,3578728343,3578728382,39
1,949,15707,3578728343,3578728383,40
1,949,15708,3578728343,3578728383,40
1,949,15709,3578728343,3578728385,42
1,949,15710,3578728343,3578728388,45
1,949,15711,3578728343,3578728392,49
1,949,15712,3578728343,3578728392,49
1,949,15713,3578728343,3578728393,50
1,949,15714,3578728343,3578728393,50
1,950,15715,3578728401,3578728401,0
1,950,15716,3578728401,3578728401,0
1,950,15717,3578728401,3578728401,0
1,950,15718,3578728401,3578728401,0
1,950,15719,3578728401,3578728401,0
1,950,15720,3578728401,3578728401,0
1,950,15721,3578728401,3578728401,0
1,950,15722,3578728401,3578728401,0
1,950,15723,3578728401,3578728401,0
1,950,15724,3578728401,3578728401,0
1,950,15725,3578728401,3578728401,0
1,950,15726,3578728401,3578728404,3
1,950,15727,3578728401,3578728409,8
1,950,15728,3578728401,3578728414,13
1,950,15729,3578728401,3578728414,13
1,950,15730,3578728401,3578728415,14
1,950,15731,3578728401,3578728415,14
1,950,15732,3578728401,3578728415,14
1,950,15733,3578728401,3578728417,16
1,950,15734,3578728401,3578728417,16
1,950,15735,3578728401,3578728417,16
1,950,15736,3578728401,3578728418,17
1,950,15737,3578728401,3578728420,19
1,950,15738,3578728401,3578728420,19
1,950,15739,3578728401,3578728421,20
1,950,15740,3578728401,3578728423,22
1,950,15741,3578728401,3578728424,23
1,950,15742,3578728401,3578728424,23
1,950,15743,3578728401,3578728424,23
1,950,15744,3578728401,3578728425,24
1,950,15745,3578728401,3578728426,25
1,950,15746,3578728401,3578728427,26
1,950,15747,3578728401,3578728428,27
1,950,15748,3578728401,3578728429,28
1,950,15749,3578728401,3578728429,28
1,950,15750,3578728401,3578728431,30
1,950,15751,3578728401,3578728432,31
1,950,15752,3578728401,3578728433,32
1,950,15753,3578728401,3578728434,33
1,950,15754,3578728401,3578728439,38
1,950,15755,3578728401,3578728440,39
1,950,15756,3578728401,3578728440,39
1,950,15757,3578728401,3578728440,39
1,950,15758,3578728401,3578728442,41
1,950,15759,3578728401,3578728445,44
1,950,15760,3578728401,3578728447,46
1,951,15761,3578728461,3578728461,0
1,951,15762,3578728461,3578728461,0
1,951,15763,3578728461,3578728461,0
1,951,15764,3578728461,3578728461,0
1,951,15765,3578728461,3578728461,0
1,951,15766,3578728461,3578728461,0
1,951,15767,3578728461,3578728461,0
1,951,15768,3578728461,3578728461,0
1,951,15769,3578728461,3578728461,0
1,951,15770,3578728461,3578728462,1
1,951,15771,3578728461,3578728463,2
1,951,15772,3578728461,3578728464,3
1,951,15773,3578728461,3578728465,4
1,951,15774,3578728461,3578728465,4
1,951,15775,3578728461,3578728466,5
1,951,15776,3578728461,3578728469,8
1,951,15777,3578728461,3578728473,12
1,951,15778,3578728461,3578728482,21
1,951,15779,3578728461,3578728483,22
1,951,15780,3578728461,3578728485,24
1,951,15781,3578728461,3578728485,24
1,951,15782,3578728461,3578728486,25
1,951,15783,3578728461,3578728486,25
1,951,15784,3578728461,3578728492,31
1,951,15785,3578728461,3578728494,33
1,951,15786,3578728461,3578728497,36
1,951,15787,3578728461,3578728497,36
1,951,15788,3578728461,3578728497,36
1,951,15789,3578728461,3578728499,38
1,951,15790,3578728461,3578728501,40
1,951,15791,3578728461,3578728502,41
1,951,15792,3578728461,3578728502,41
1,951,15793,3578728461,3578728506,45
1,951,15794,3578728461,3578728506,45
1,951,15795,3578728461,3578728506,45
1,951,15796,3578728461,3578728506,45
1,951,15797,3578728461,3578728509,48
1,952,15798,3578728516,3578728516,0
1,952,15799,3578728516,3578728516,0
1,952,15800,3578728516,3578728516,0
1,952,15801,3578728516,3578728516,0
1,952,15802,3578728516,3578728516,0
1,952,15803,3578728516,3578728516,0
1,952,15804,3578728516,3578728516,0
1,952,15805,3578728516,3578728516,0
1,952,15806,3578728516,3578728516,0
1,952,15807,3578728516,3578728517,1
1,952,15808,3578728516,3578728519,3
1,952,15809,3578728516,3578728520,4
1,952,15810,3578728516,3578728520,4
1,952,15811,3578728516,3578728520,4
1,952,15812,3578728516,3578728523,7
1,952,15813,3578728516,3578728523,7
1,952,15814,3578728516,3578728523,7
1,952,15815,3578728516,3578728524,8
1,952,15816,3578728516,3578728525,9
1,952,15817,3578728516,3578728526,10
1,952,15818,3578728516,3578728526,10
1,952,15819,3578728516,3578728527,11
1,952,15820,3578728516,3578728527,11
1,952,15821,3578728516,3578728528,12
1,952,15822,3578728516,3578728528,12
1,952,15823,3578728516,3578728529,13
1,952,15824,3578728516,3578728529,13
1,952,15825,3578728516,3578728530,14
1,952,15826,3578728516,3578728532,16
1,952,15827,3578728516,3578728533,17
1,952,15828,3578728516,3578728534,18
1,952,15829,3578728516,3578728534,18
1,952,15830,3578728516,3578728534,18
1,952,15831,3578728516,3578728536,20
1,952,15832,3578728516,3578728538,22
1,952,15833,3578728516,3578728539,23
1,952,15834,3578728516,3578728539,23
1,952,15835,3578728516,3578728542,26
1,952,15836,3578728516,3578728545,29
1,952,15837,3578728516,3578728545,29
1,952,15838,3578728516,3578728547,31
1,952,15839,3578728516,3578728549,33
1,952,15840,3578728516,3578728551,35
1,952,15841,3578728516,3578728552,36
1,952,15842,3578728516,3578728552,36
1,952,15843,3578728516,3578728555,39
1,952,15844,3578728516,3578728556,40
1,952,15845,3578728516,3578728556,40
1,952,15846,3578728516,3578728557,41
1,952,15847,3578728516,3578728558,42
1,952,15848,3578728516,3578728558,42
1,952,15849,3578728516,3578728558,42
1,952,15850,3578728516,3578728565,49
1,952,15851,3578728516,3578728566,50
1,953,15852,3578728573,3578728573,0
1,953,15853,3578728573,3578728573,0
1,953,15854,3578728573,3578728574,1
1,953,15855,3578728573,3578728574,1
1,953,15856,3578728573,3578728574,1
1,953,15857,3578728573,3578728576,3
1,953,15858,3578728573,3578728577,4
1,953,15859,3578728573,3578728577,4
1,953,15860,3578728573,3578728579,6
1,953,15861,3578728573,3578728581,8
1,953,15862,3578728573,3578728582,9
1,953,15863,3578728573,3578728584,11
1,953,15864,3578728573,3578728585,12
1,953,15865,3578728573,3578728587,14
1,953,15866,3578728573,3578728591,18
1,953,15867,3578728573,3578728591,18
1,953,15868,3578728573,3578728592,19
1,953,15869,3578728573,3578728593,20
1,953,15870,3578728573,3578728593,20
1,953,15871,3578728573,3578728595,22
1,953,15872,3578728573,3578728595,22
1,953,15873,3578728573,3578728596,23
1,953,15874,3578728573,3578728596,23
1,953,15875,3578728573,3578728596,23
1,953,15876,3578728573,3578728597,24
1,953,15877,3578728573,3578728598,25
1,953,15878,3578728573,3578728598,25
1,953,15879,3578728573,3578728598,25
1,953,15880,3578728573,3578728599,26
1,953,15881,3578728573,3578728602,29
1,953,15882,3578728573,3578728603,30
1,953,15883,3578728573,3578728603,30
1,953,15884,3578728573,3578728606,33
1,953,15885,3578728573,3578728608,35
1,953,15886,3578728573,3578728611,38
1,953,15887,3578728573,3578728613,40
1,953,15888,3578728573,3578728613,40
1,953,15889,3578728573,3578728615,42
1,953,15890,3578728573,3578728615,42
1,953,15891,3578728573,3578728615,42
1,953,15892,3578728573,3578728616,43
1,953,15893,3578728573,3578728617,44
1,953,15894,3578728573,3578728617,44
1,953,15895,3578728573,3578728617,44
1,953,15896,3578728573,3578728620,47
1,953,15897,3578728573,3578728621,48
1,953,15898,3578728573,3578728622,49
1,954,15899,3578728631,3578728631,0
1,954,15900,3578728631,3578728631,0
1,954,15901,3578728631,3578728631,0
1,954,15902,3578728631,3578728631,0
1,954,15903,3578728631,3578728631,0
1,954,15904,3578728631,3578728631,0
1,954,15905,3578728631,3578728631,0
1,954,15906,3578728631,3578728631,0
1,954,15907,3578728631,3578728631,0
1,954,15908,3578728631,3578728631,0
1,954,15909,3578728631,3578728631,0
1,954,15910,3578728631,3578728631,0
1,954,15911,3578728631,3578728632,1
1,954,15912,3578728631,3578728633,2
1,954,15913,3578728631,3578728638,7
1,954,15914,3578728631,3578728639,8
1,954,15915,3578728631,3578728640,9
1,954,15916,3578728631,3578728641,10
1,954,15917,3578728631,3578728644,13
1,954,15918,3578728631,3578728647,16
1,954,15919,3578728631,3578728651,20
1,954,15920,3578728631,3578728652,21
1,954,15921,3578728631,3578728654,23
1,954,15922,3578728631,3578728655,24
1,954,15923,3578728631,3578728655,24
1,954,15924,3578728631,3578728658,27
1,954,15925,3578728631,3578728659,28
1,954,15926,3578728631,3578728661,30
1,954,15927,3578728631,3578728661,30
1,954,15928,3578728631,3578728662,31
1,954,15929,3578728631,3578728664,33
1,954,15930,3578728631,3578728664,33
1,954,15931,3578728631,3578728664,33
1,954,15932,3578728631,3578728665,34
1,954,15933,3578728631,3578728669,38
1,954,15934,3578728631,3578728673,42
1,955,15935,3578728688,3578728688,0
1,955,15936,3578728688,3578728688,0
1,955,15937,3578728688,3578728688,0
1,955,15938,3578728688,3578728688,0
1,955,15939,3578728688,3578728688,0
1,955,15940,3578728688,3578728688,0
1,955,15941,3578728688,3578728692,4
1,955,15942,3578728688,3578728693,5
1,955,15943,3578728688,3578728697,9
1,955,15944,3578728688,3578728697,9
1,955,15945,3578728688,3578728697,9
1,955,15946,3578728688,3578728698,10
1,955,15947,3578728688,3578728700,12
1,955,15948,3578728688,3578728700,12
1,955,15949,3578728688,3578728702,14
1,955,15950,3578728688,3578728706,18
1,955,15951,3578728688,3578728706,18
1,955,15952,3578728688,3578728707,19
1,955,15953,3578728688,3578728708,20
1,955,15954,3578728688,3578728709,21
1,955,15955,3578728688,3578728712,24
1,955,15956,3578728688,3578728715,27
1,955,15957,3578728688,3578728715,27
1,955,15958,3578728688,3578728715,27
1,955,15959,3578728688,3578728716,28
1,955,15960,3578728688,3578728716,28
1,955,15961,3578728688,3578728717,29
1,955,15962,3578728688,3578728717,29
1,955,15963,3578728688,3578728718,30
1,955,15964,3578728688,3578728719,31
1,955,15965,3578728688,3578728720,32
1,955,15966,3578728688,3578728720,32
1,955,15967,3578728688,3578728721,33
1,955,15968,3578728688,3578728722,34
1,955,15969,3578728688,3578728723,35
1,955,15970,3578728688,3578728723,35
1,955,15971,3578728688,3578728724,36
1,955,15972,3578728688,3578728726,38
1,955,15973,3578728688,3578728726,38
1,955,15974,3578728688,3578728727,39
1,955,15975,3578728688,3578728727,39
1,955,15976,3578728688,3578728728,40
1,955,15977,3578728688,3578728728,40
1,955,15978,3578728688,3578728729,41
1,955,15979,3578728688,3578728729,41
1,955,15980,3578728688,3578728729,41
1,955,15981,3578728688,3578728730,42
1,955,15982,3578728688,3578728733,45
1,955,15983,3578728688,3578728733,45
1,955,15984,3578728688,3578728733,45
1,955,15985,3578728688,3578728734,46
1,955,15986,3578728688,3578728735,47
1,955,15987,3578728688,3578728737,49
1,956,15988,3578728745,3578728745,0
1,956,15989,3578728745,3578728745,0
1,956,15990,3578728745,3578728745,0
1,956,15991,3578728745,3578728745,0
1,956,15992,3578728745,3578728745,0
1,956,15993,3578728745,3578728745,0
1,956,15994,3578728745,3578728746,1
1,956,15995,3578728745,3578728747,2
1,956,15996,3578728745,3578728750,5
1,956,15997,3578728745,3578728751,6
1,956,15998,3578728745,3578728752,7
1,956,15999,3578728745,3578728757,12
1,956,16000,3578728745,3578728757,12
1,956,16001,3578728745,3578728757,12
1,956,16002,3578728745,3578728758,13
1,956,16003,3578728745,3578728758,13
1,956,16004,3578728745,3578728758,13
1,956,16005,3578728745,3578728761,16
1,956,16006,3578728745,3578728762,17
1,956,16007,3578728745,3578728764,19
1,956,16008,3578728745,3578728766,21
1,956,16009,3578728745,3578728769,24
1,956,16010,3578728745,3578728773,28
1,956,16011,3578728745,3578728774,29
1,956,16012,3578728745,3578728775,30
1,956,16013,3578728745,3578728775,30
1,956,16014,3578728745,3578728776,31
1,956,16015,3578728745,3578728778,33
1,956,16016,3578728745,3578728778,33
1,956,16017,3578728745,3578728778,33
1,956,16018,3578728745,3578728781,36
1,956,16019,3578728745,3578728782,37
1,956,16020,3578728745,3578728784,39
1,956,16021,3578728745,3578728785,40
1,956,16022,3578728745,3578728786,41
1,956,16023,3578728745,3578728791,46
1,956,16024,3578728745,3578728791,46
1,956,16025,3578728745,3578728792,47
1,956,16026,3578728745,3578728793,48
1,956,16027,3578728745,3578728793,48
1,956,16028,3578728745,3578728795,50
1,957,16029,3578728802,3578728802,0
1,957,16030,3578728802,3578728802,0
1,957,16031,3578728802,3578728802,0
1,957,16032,3578728802,3578728803,1
1,957,16033,3578728802,3578728803,1
1,957,16034,3578728802,3578728803,1
1,957,16035,3578728802,3578728803,1
1,957,16036,3578728802,3578728803,1
1,957,16037,3578728802,3578728803,1
1,957,16038,3578728802,3578728803,1
1,957,16039,3578728802,3578728804,2
1,957,16040,3578728802,3578728807,5
1,957,16041,3578728802,3578728808,6
1,957,16042,3578728802,3578728813,11
1,957,16043,3578728802,3578728813,11
1,957,16044,3578728802,3578728815,13
1,957,16045,3578728802,3578728815,13
1,957,16046,3578728802,3578728815,13
1,957,16047,3578728802,3578728816,14
1,957,16048,3578728802,3578728817,15
1,957,16049,3578728802,3578728817,15
1,957,16050,3578728802,3578728817,15
1,957,16051,3578728802,3578728821,19
1,957,16052,3578728802,3578728823,21
1,957,16053,3578728802,3578728823,21
1,957,16054,3578728802,3578728824,22
1,957,16055,3578728802,3578728824,22
1,957,16056,3578728802,3578728824,22
1,957,16057,3578728802,3578728824,22
1,957,16058,3578728802,3578728825,23
1,957,16059,3578728802,3578728826,24
1,957,16060,3578728802,3578728828,26
1,957,16061,3578728802,3578728828,26
1,957,16062,3578728802,3578728829,27
1,957,16063,3578728802,3578728831,29
1,957,16064,3578728802,3578728832,30
1,957,16065,3578728802,3578728834,32
1,957,16066,3578728802,3578728836,34
1,957,16067,3578728802,3578728838,36
1,957,16068,3578728802,3578728839,37
1,957,16069,3578728802,3578728839,37
1,957,16070,3578728802,3578728841,39
1,957,16071,3578728802,3578728841,39
1,957,16072,3578728802,3578728845,43
1,957,16073,3578728802,3578728847,45
1,957,16074,3578728802,3578728851,49
1,958,16075,3578728862,3578728862,0
1,958,16076,3578728862,3578728862,0
1,958,16077,3578728862,3578728862,0
1,958,16078,3578728862,3578728862,0
1,958,16079,3578728862,3578728862,0
1,958,16080,3578728862,3578728862,0
1,958,16081,3578728862,3578728862,0
1,958,16082,3578728862,3578728862,0
1,958,16083,3578728862,3578728862,0
1,958,16084,3578728862,3578728863,1
1,958,16085,3578728862,3578728864,2
1,958,16086,3578728862,3578728864,2
1,958,16087,3578728862,3578728865,3
1,958,16088,3578728862,3578728865,3
1,958,16089,3578728862,3578728866,4
1,958,16090,3578728862,3578728870,8
1,958,16091,3578728862,3578728873,11
1,958,16092,3578728862,3578728883,21
1,958,16093,3578728862,3578728883,21
1,958,16094,3578728862,3578728883,21
1,958,16095,3578728862,3578728885,23
1,958,16096,3578728862,3578728885,23
1,958,16097,3578728862,3578728886,24
1,958,16098,3578728862,3578728886,24
1,958,16099,3578728862,3578728892,30
1,958,16100,3578728862,3578728892,30
1,958,16101,3578728862,3578728892,30
1,958,16102,3578728862,3578728893,31
1,958,16103,3578728862,3578728897,35
1,958,16104,3578728862,3578728897,35
1,958,16105,3578728862,3578728898,36
1,958,16106,3578728862,3578728898,36
1,958,16107,3578728862,3578728900,38
1,958,16108,3578728862,3578728901,39
1,958,16109,3578728862,3578728901,39
1,958,16110,3578728862,3578728905,43
1,958,16111,3578728862,3578728906,44
1,958,16112,3578728862,3578728907,45
1,958,16113,3578728862,3578728907,45
1,958,16114,3578728862,3578728909,47
1,959,16115,3578728919,3578728919,0
1,959,16116,3578728919,3578728919,0
1,959,16117,3578728919,3578728919,0
1,959,16118,3578728919,3578728919,0
1,959,16119,3578728919,3578728919,0
1,959,16120,3578728919,3578728919,0
1,959,16121,3578728919,3578728919,0
1,959,16122,3578728919,3578728919,0
1,959,16123,3578728919,3578728919,0
1,959,16124,3578728919,3578728919,0
1,959,16125,3578728919,3578728919,0
1,959,16126,3578728919,3578728920,1
1,959,16127,3578728919,3578728921,2
1,959,16128,3578728919,3578728923,4
1,959,16129,3578728919,3578728923,4
1,959,16130,3578728919,3578728924,5
1,959,16131,3578728919,3578728925,6
1,959,16132,3578728919,3578728926,7
1,959,16133,3578728919,3578728927,8
1,959,16134,3578728919,3578728927,8
1,959,16135,3578728919,3578728927,8
1,959,16136,3578728919,3578728928,9
1,959,16137,3578728919,3578728929,10
1,959,16138,3578728919,3578728929,10
1,959,16139,3578728919,3578728930,11
1,959,16140,3578728919,3578728933,14
1,959,16141,3578728919,3578728934,15
1,959,16142,3578728919,3578728934,15
1,959,16143,3578728919,3578728934,15
1,959,16144,3578728919,3578728936,17
1,959,16145,3578728919,3578728936,17
1,959,16146,3578728919,3578728938,19
1,959,16147,3578728919,3578728939,20
1,959,16148,3578728919,3578728940,21
1,959,16149,3578728919,3578728943,24
1,959,16150,3578728919,3578728943,24
1,959,16151,3578728919,3578728946,27
1,959,16152,3578728919,3578728946,27
1,959,16153,3578728919,3578728949,30
1,959,16154,3578728919,3578728950,31
1,959,16155,3578728919,3578728951,32
1,959,16156,3578728919,3578728952,33
1,959,16157,3578728919,3578728956,37
1,959,16158,3578728919,3578728956,37
1,959,16159,3578728919,3578728957,38
1,959,16160,3578728919,3578728958,39
1,959,16161,3578728919,3578728958,39
1,959,16162,3578728919,3578728958,39
1,959,16163,3578728919,3578728958,39
1,959,16164,3578728919,3578728962,43
1,959,16165,3578728919,3578728965,46
1,959,16166,3578728919,3578728966,47
1,960,16167,3578728976,3578728976,0
1,960,16168,3578728976,3578728976,0
1,960,16169,3578728976,3578728976,0
1,960,16170,3578728976,3578728976,0
1,960,16171,3578728976,3578728976,0
1,960,16172,3578728976,3578728976,0
1,960,16173,3578728976,3578728976,0
1,960,16174,3578728976,3578728978,2
1,960,16175,3578728976,3578728978,2
1,960,16176,3578728976,3578728979,3
1,960,16177,3578728976,3578728982,6
1,960,16178,3578728976,3578728982,6
1,960,16179,3578728976,3578728983,7
1,960,16180,3578728976,3578728985,9
1,960,16181,3578728976,3578728985,9
1,960,16182,3578728976,3578728986,10
1,960,16183,3578728976,3578728991,15
1,960,16184,3578728976,3578728992,16
1,960,16185,3578728976,3578728992,16
1,960,16186,3578728976,3578728993,17
1,960,16187,3578728976,3578728993,17
1,960,16188,3578728976,3578728995,19
1,960,16189,3578728976,3578728995,19
1,960,16190,3578728976,3578728997,21
1,960,16191,3578728976,3578728997,21
1,960,16192,3578728976,3578728997,21
1,960,16193,3578728976,3578728998,22
1,960,16194,3578728976,3578728998,22
1,960,16195,3578728976,3578728999,23
1,960,16196,3578728976,3578728999,23
1,960,16197,3578728976,3578729000,24
1,960,16198,3578728976,3578729003,27
1,960,16199,3578728976,3578729003,27
1,960,16200,3578728976,3578729004,28
1,960,16201,3578728976,3578729007,31
1,960,16202,3578728976,3578729008,32
1,960,16203,3578728976,3578729011,35
1,960,16204,3578728976,3578729013,37
1,960,16205,3578728976,3578729014,38
1,960,16206,3578728976,3578729014,38
1,960,16207,3578728976,3578729015,39
1,960,16208,3578728976,3578729015,39
1,960,16209,3578728976,3578729016,40
1,960,16210,3578728976,3578729017,41
1,960,16211,3578728976,3578729017,41
1,960,16212,3578728976,3578729017,41
1,960,16213,3578728976,3578729019,43
1,960,16214,3578728976,3578729020,44
1,960,16215,3578728976,3578729022,46
1,960,16216,3578728976,3578729024,48
1,960,16217,3578728976,3578729024,48
1,960,16218,3578728976,3578729024,48
1,960,16219,3578728976,3578729025,49
1,960,16220,3578728976,3578729025,49
1,960,16221,3578728976,3578729026,50
1,961,16222,3578729035,3578729035,0
1,961,16223,3578729035,3578729035,0
1,961,16224,3578729035,3578729035,0
1,961,16225,3578729035,3578729035,0
1,961,16226,3578729035,3578729035,0
1,961,16227,3578729035,3578729035,0
1,961,16228,3578729035,3578729037,2
1,961,16229,3578729035,3578729038,3
1,961,16230,3578729035,3578729040,5
1,961,16231,3578729035,3578729041,6
1,961,16232,3578729035,3578729047,12
1,961,16233,3578729035,3578729049,14
1,961,16234,3578729035,3578729051,16
1,961,16235,3578729035,3578729052,17
1,961,16236,3578729035,3578729055,20
1,961,16237,3578729035,3578729056,21
1,961,16238,3578729035,3578729056,21
1,961,16239,3578729035,3578729056,21
1,961,16240,3578729035,3578729058,23
1,961,16241,3578729035,3578729058,23
1,961,16242,3578729035,3578729061,26
1,961,16243,3578729035,3578729062,27
1,961,16244,3578729035,3578729064,29
1,961,16245,3578729035,3578729065,30
1,961,16246,3578729035,3578729065,30
1,961,16247,3578729035,3578729066,31
1,961,16248,3578729035,3578729066,31
1,961,16249,3578729035,3578729070,35
1,961,16250,3578729035,3578729073,38
1,961,16251,3578729035,3578729082,47
1,961,16252,3578729035,3578729083,48
1,962,16253,3578729092,3578729092,0
1,962,16254,3578729092,3578729092,0
1,962,16255,3578729092,3578729092,0
1,962,16256,3578729092,3578729092,0
1,962,16257,3578729092,3578729092,0
1,962,16258,3578729092,3578729092,0
1,962,16259,3578729092,3578729093,1
1,962,16260,3578729092,3578729094,2
1,962,16261,3578729092,3578729097,5
1,962,16262,3578729092,3578729097,5
1,962,16263,3578729092,3578729098,6
1,962,16264,3578729092,3578729098,6
1,962,16265,3578729092,3578729100,8
1,962,16266,3578729092,3578729100,8
1,962,16267,3578729092,3578729101,9
1,962,16268,3578729092,3578729102,10
1,962,16269,3578729092,3578729105,13
1,962,16270,3578729092,3578729106,14
1,962,16271,3578729092,3578729107,15
1,962,16272,3578729092,3578729108,16
1,962,16273,3578729092,3578729108,16
1,962,16274,3578729092,3578729109,17
1,962,16275,3578729092,3578729112,20
1,962,16276,3578729092,3578729113,21
1,962,16277,3578729092,3578729115,23
1,962,16278,3578729092,3578729116,24
1,962,16279,3578729092,3578729116,24
1,962,16280,3578729092,3578729116,24
1,962,16281,3578729092,3578729117,25
1,962,16282,3578729092,3578729117,25
1,962,16283,3578729092,3578729117,25
1,962,16284,3578729092,3578729117,25
1,962,16285,3578729092,3578729119,27
1,962,16286,3578729092,3578729120,28
1,962,16287,3578729092,3578729121,29
1,962,16288,3578729092,3578729121,29
1,962,16289,3578729092,3578729123,31
1,962,16290,3578729092,3578729123,31
1,962,16291,3578729092,3578729125,33
1,962,16292,3578729092,3578729125,33
1,962,16293,3578729092,3578729126,34
1,962,16294,3578729092,3578729126,34
1,962,16295,3578729092,3578729127,35
1,962,16296,3578729092,3578729127,35
1,962,16297,3578729092,3578729129,37
1,962,16298,3578729092,3578729129,37
1,962,16299,3578729092,3578729129,37
1,962,16300,3578729092,3578729130,38
1,962,16301,3578729092,3578729133,41
1,962,16302,3578729092,3578729134,42
1,962,16303,3578729092,3578729134,42
1,962,16304,3578729092,3578729135,43
1,962,16305,3578729092,3578729137,45
1,962,16306,3578729092,3578729138,46
1,962,16307,3578729092,3578729139,47
1,962,16308,3578729092,3578729141,49
1,963,16309,3578729150,3578729150,0
1,963,16310,3578729150,3578729150,0
1,963,16311,3578729150,3578729150,0
1,963,16312,3578729150,3578729150,0
1,963,16313,3578729150,3578729150,0
1,963,16314,3578729150,3578729151,1
1,963,16315,3578729150,3578729151,1
1,963,16316,3578729150,3578729152,2
1,963,16317,3578729150,3578729153,3
1,963,16318,3578729150,3578729157,7
1,963,16319,3578729150,3578729157,7
1,963,16320,3578729150,3578729158,8
1,963,16321,3578729150,3578729158,8
1,963,16322,3578729150,3578729158,8
1,963,16323,3578729150,3578729160,10
1,963,16324,3578729150,3578729162,12
1,963,16325,3578729150,3578729165,15
1,963,16326,3578729150,3578729166,16
1,963,16327,3578729150,3578729166,16
1,963,16328,3578729150,3578729170,20
1,963,16329,3578729150,3578729174,24
1,963,16330,3578729150,3578729174,24
1,963,16331,3578729150,3578729175,25
1,963,16332,3578729150,3578729176,26
1,963,16333,3578729150,3578729177,27
1,963,16334,3578729150,3578729178,28
1,963,16335,3578729150,3578729179,29
1,963,16336,3578729150,3578729179,29
1,963,16337,3578729150,3578729182,32
1,963,16338,3578729150,3578729182,32
1,963,16339,3578729150,3578729184,34
1,963,16340,3578729150,3578729185,35
1,963,16341,3578729150,3578729186,36
1,963,16342,3578729150,3578729191,41
1,963,16343,3578729150,3578729191,41
1,963,16344,3578729150,3578729192,42
1,963,16345,3578729150,3578729193,43
1,963,16346,3578729150,3578729193,43
1,963,16347,3578729150,3578729196,46
1,963,16348,3578729150,3578729196,46
1,963,16349,3578729150,3578729197,47
1,963,16350,3578729150,3578729197,47
1,963,16351,3578729150,3578729198,48
1,963,16352,3578729150,3578729198,48
1,963,16353,3578729150,3578729198,48
1,963,16354,3578729150,3578729199,49
1,963,16355,3578729150,3578729199,49
1,963,16356,3578729150,3578729199,49
1,964,16357,3578729208,3578729208,0
1,964,16358,3578729208,3578729208,0
1,964,16359,3578729208,3578729208,0
1,964,16360,3578729208,3578729208,0
1,964,16361,3578729208,3578729214,6
1,964,16362,3578729208,3578729214,6
1,964,16363,3578729208,3578729215,7
1,964,16364,3578729208,3578729215,7
1,964,16365,3578729208,3578729216,8
1,964,16366,3578729208,3578729217,9
1,964,16367,3578729208,3578729217,9
1,964,16368,3578729208,3578729217,9
1,964,16369,3578729208,3578729217,9
1,964,16370,3578729208,3578729218,10
1,964,16371,3578729208,3578729220,12
1,964,16372,3578729208,3578729220,12
1,964,16373,3578729208,3578729222,14
1,964,16374,3578729208,3578729224,16
1,964,16375,3578729208,3578729224,16
1,964,16376,3578729208,3578729225,17
1,964,16377,3578729208,3578729225,17
1,964,16378,3578729208,3578729225,17
1,964,16379,3578729208,3578729226,18
1,964,16380,3578729208,3578729228,20
1,964,16381,3578729208,3578729229,21
1,964,16382,3578729208,3578729229,21
1,964,16383,3578729208,3578729231,23
1,964,16384,3578729208,3578729232,24
1,964,16385,3578729208,3578729233,25
1,964,16386,3578729208,3578729234,26
1,964,16387,3578729208,3578729237,29
1,964,16388,3578729208,3578729238,30
1,964,16389,3578729208,3578729239,31
1,964,16390,3578729208,3578729240,32
1,964,16391,3578729208,3578729241,33
1,964,16392,3578729208,3578729245,37
1,964,16393,3578729208,3578729247,39
1,964,16394,3578729208,3578729249,41
1,964,16395,3578729208,3578729251,43
1,964,16396,3578729208,3578729255,47
1,964,16397,3578729208,3578729255,47
1,964,16398,3578729208,3578729255,47
1,964,16399,3578729208,3578729256,48
1,964,16400,3578729208,3578729257,49
1,965,16401,3578729267,3578729267,0
1,965,16402,3578729267,3578729267,0
1,965,16403,3578729267,3578729267,0
1,965,16404,3578729267,3578729267,0
1,965,16405,3578729267,3578729267,0
1,965,16406,3578729267,3578729267,0
1,965,16407,3578729267,3578729267,0
1,965,16408,3578729267,3578729267,0
1,965,16409,3578729267,3578729267,0
1,965,16410,3578729267,3578729267,0
1,965,16411,3578729267,3578729267,0
1,965,16412,3578729267,3578729267,0
1,965,16413,3578729267,3578729270,3
1,965,16414,3578729267,3578729273,6
1,965,16415,3578729267,3578729282,15
1,965,16416,3578729267,3578729284,17
1,965,16417,3578729267,3578729285,18
1,965,16418,3578729267,3578729286,19
1,965,16419,3578729267,3578729286,19
1,965,16420,3578729267,3578729287,20
1,965,16421,3578729267,3578729291,24
1,965,16422,3578729267,3578729292,25
1,965,16423,3578729267,3578729293,26
1,965,16424,3578729267,3578729297,30
1,965,16425,3578729267,3578729297,30
1,965,16426,3578729267,3578729298,31
1,965,16427,3578729267,3578729299,32
1,965,16428,3578729267,3578729300,33
1,965,16429,3578729267,3578729301,34
1,965,16430,3578729267,3578729301,34
1,965,16431,3578729267,3578729302,35
1,965,16432,3578729267,3578729306,39
1,965,16433,3578729267,3578729306,39
1,965,16434,3578729267,3578729307,40
1,965,16435,3578729267,3578729308,41
1,965,16436,3578729267,3578729309,42
1,965,16437,3578729267,3578729311,44
1,965,16438,3578729267,3578729314,47
1,965,16439,3578729267,3578729314,47
1,965,16440,3578729267,3578729315,48
1,965,16441,3578729267,3578729315,48
1,965,16442,3578729267,3578729316,49
1,966,16443,3578729325,3578729325,0
1,966,16444,3578729325,3578729325,0
1,966,16445,3578729325,3578729325,0
1,966,16446,3578729325,3578729325,0
1,966,16447,3578729325,3578729325,0
1,966,16448,3578729325,3578729325,0
1,966,16449,3578729325,3578729325,0
1,966,16450,3578729325,3578729325,0
1,966,16451,3578729325,3578729325,0
1,966,16452,3578729325,3578729325,0
1,966,16453,3578729325,3578729325,0
1,966,16454,3578729325,3578729326,1
1,966,16455,3578729325,3578729326,1
1,966,16456,3578729325,3578729327,2
1,966,16457,3578729325,3578729327,2
1,966,16458,3578729325,3578729328,3
1,966,16459,3578729325,3578729328,3
1,966,16460,3578729325,3578729329,4
1,966,16461,3578729325,3578729329,4
1,966,16462,3578729325,3578729331,6
1,966,16463,3578729325,3578729331,6
1,966,16464,3578729325,3578729333,8
1,966,16465,3578729325,3578729333,8
1,966,16466,3578729325,3578729334,9
1,966,16467,3578729325,3578729334,9
1,966,16468,3578729325,3578729334,9
1,966,16469,3578729325,3578729336,11
1,966,16470,3578729325,3578729337,12
1,966,16471,3578729325,3578729338,13
1,966,16472,3578729325,3578729339,14
1,966,16473,3578729325,3578729340,15
1,966,16474,3578729325,3578729342,17
1,966,16475,3578729325,3578729343,18
1,966,16476,3578729325,3578729346,21
1,966,16477,3578729325,3578729346,21
1,966,16478,3578729325,3578729348,23
1,966,16479,3578729325,3578729351,26
1,966,16480,3578729325,3578729351,26
1,966,16481,3578729325,3578729352,27
1,966,16482,3578729325,3578729353,28
1,966,16483,3578729325,3578729353,28
1,966,16484,3578729325,3578729356,31
1,966,16485,3578729325,3578729356,31
1,966,16486,3578729325,3578729357,32
1,966,16487,3578729325,3578729357,32
1,966,16488,3578729325,3578729358,33
1,966,16489,3578729325,3578729358,33
1,966,16490,3578729325,3578729360,35
1,966,16491,3578729325,3578729362,37
1,966,16492,3578729325,3578729364,39
1,966,16493,3578729325,3578729365,40
1,966,16494,3578729325,3578729366,41
1,966,16495,3578729325,3578729367,42
1,966,16496,3578729325,3578729371,46
1,966,16497,3578729325,3578729374,49
1,966,16498,3578729325,3578729374,49
1,966,16499,3578729325,3578729375,50
1,967,16500,3578729383,3578729383,0
1,967,16501,3578729383,3578729383,0
1,967,16502,3578729383,3578729383,0
1,967,16503,3578729383,3578729383,0
1,967,16504,3578729383,3578729383,0
1,967,16505,3578729383,3578729383,0
1,967,16506,3578729383,3578729383,0
1,967,16507,3578729383,3578729383,0
1,967,16508,3578729383,3578729384,1
1,967,16509,3578729383,3578729385,2
1,967,16510,3578729383,3578729386,3
1,967,16511,3578729383,3578729391,8
1,967,16512,3578729383,3578729391,8
1,967,16513,3578729383,3578729393,10
1,967,16514,3578729383,3578729393,10
1,967,16515,3578729383,3578729394,11
1,967,16516,3578729383,3578729396,13
1,967,16517,3578729383,3578729396,13
1,967,16518,3578729383,3578729397,14
1,967,16519,3578729383,3578729397,14
1,967,16520,3578729383,3578729398,15
1,967,16521,3578729383,3578729398,15
1,967,16522,3578729383,3578729398,15
1,967,16523,3578729383,3578729399,16
1,967,16524,3578729383,3578729399,16
1,967,16525,3578729383,3578729404,21
1,967,16526,3578729383,3578729404,21
1,967,16527,3578729383,3578729408,25
1,967,16528,3578729383,3578729408,25
1,967,16529,3578729383,3578729412,29
1,967,16530,3578729383,3578729414,31
1,967,16531,3578729383,3578729415,32
1,967,16532,3578729383,3578729415,32
1,967,16533,3578729383,3578729416,33
1,967,16534,3578729383,3578729417,34
1,967,16535,3578729383,3578729418,35
1,967,16536,3578729383,3578729418,35
1,967,16537,3578729383,3578729418,35
1,967,16538,3578729383,3578729420,37
1,967,16539,3578729383,3578729420,37
1,967,16540,3578729383,3578729420,37
1,967,16541,3578729383,3578729422,39
1,967,16542,3578729383,3578729424,41
1,967,16543,3578729383,3578729425,42
1,967,16544,3578729383,3578729425,42
1,967,16545,3578729383,3578729426,43
1,967,16546,3578729383,3578729426,43
1,967,16547,3578729383,3578729427,44
1,967,16548,3578729383,3578729428,45
1,967,16549,3578729383,3578729429,46
1,967,16550,3578729383,3578729429,46
1,967,16551,3578729383,3578729430,47
1,967,16552,3578729383,3578729432,49
1,968,16553,3578729442,3578729442,0
1,968,16554,3578729442,3578729442,0
1,968,16555,3578729442,3578729442,0
1,968,16556,3578729442,3578729442,0
1,968,16557,3578729442,3578729442,0
1,968,16558,3578729442,3578729442,0
1,968,16559,3578729442,3578729445,3
1,968,16560,3578729442,3578729447,5
1,968,16561,3578729442,3578729449,7
1,968,16562,3578729442,3578729451,9
1,968,16563,3578729442,3578729451,9
1,968,16564,3578729442,3578729454,12
1,968,16565,3578729442,3578729455,13
1,968,16566,3578729442,3578729456,14
1,968,16567,3578729442,3578729457,15
1,968,16568,3578729442,3578729458,16
1,968,16569,3578729442,3578729460,18
1,968,16570,3578729442,3578729462,20
1,968,16571,3578729442,3578729462,20
1,968,16572,3578729442,3578729463,21
1,968,16573,3578729442,3578729464,22
1,968,16574,3578729442,3578729464,22
1,968,16575,3578729442,3578729464,22
1,968,16576,3578729442,3578729465,23
1,968,16577,3578729442,3578729465,23
1,968,16578,3578729442,3578729466,24
1,968,16579,3578729442,3578729467,25
1,968,16580,3578729442,3578729468,26
1,968,16581,3578729442,3578729470,28
1,968,16582,3578729442,3578729473,31
1,968,16583,3578729442,3578729483,41
1,968,16584,3578729442,3578729484,42
1,968,16585,3578729442,3578729486,44
1,968,16586,3578729442,3578729486,44
1,968,16587,3578729442,3578729486,44
1,968,16588,3578729442,3578729487,45
1,968,16589,3578729442,3578729492,50
1,969,16590,3578729499,3578729499,0
1,969,16591,3578729499,3578729499,0
1,969,16592,3578729499,3578729499,0
1,969,16593,3578729499,3578729499,0
1,969,16594,3578729499,3578729499,0
1,969,16595,3578729499,3578729499,0
1,969,16596,3578729499,3578729500,1
1,969,16597,3578729499,3578729500,1
1,969,16598,3578729499,3578729500,1
1,969,16599,3578729499,3578729501,2
1,969,16600,3578729499,3578729504,5
1,969,16601,3578729499,3578729505,6
1,969,16602,3578729499,3578729506,7
1,969,16603,3578729499,3578729507,8
1,969,16604,3578729499,3578729507,8
1,969,16605,3578729499,3578729512,13
1,969,16606,3578729499,3578729514,15
1,969,16607,3578729499,3578729514,15
1,969,16608,3578729499,3578729515,16
1,969,16609,3578729499,3578729515,16
1,969,16610,3578729499,3578729515,16
1,969,16611,3578729499,3578729516,17
1,969,16612,3578729499,3578729517,18
1,969,16613,3578729499,3578729517,18
1,969,16614,3578729499,3578729517,18
1,969,16615,3578729499,3578729519,20
1,969,16616,3578729499,3578729519,20
1,969,16617,3578729499,3578729520,21
1,969,16618,3578729499,3578729521,22
1,969,16619,3578729499,3578729522,23
1,969,16620,3578729499,3578729522,23
1,969,16621,3578729499,3578729524,25
1,969,16622,3578729499,3578729524,25
1,969,16623,3578729499,3578729525,26
1,969,16624,3578729499,3578729525,26
1,969,16625,3578729499,3578729526,27
1,969,16626,3578729499,3578729527,28
1,969,16627,3578729499,3578729528,29
1,969,16628,3578729499,3578729528,29
1,969,16629,3578729499,3578729528,29
1,969,16630,3578729499,3578729529,30
1,969,16631,3578729499,3578729530,31
1,969,16632,3578729499,3578729531,32
1,969,16633,3578729499,3578729532,33
1,969,16634,3578729499,3578729532,33
1,969,16635,3578729499,3578729534,35
1,969,16636,3578729499,3578729534,35
1,969,16637,3578729499,3578729537,38
1,969,16638,3578729499,3578729538,39
1,969,16639,3578729499,3578729538,39
1,969,16640,3578729499,3578729539,40
1,969,16641,3578729499,3578729541,42
1,969,16642,3578729499,3578729545,46
1,969,16643,3578729499,3578729545,46
1,970,16644,3578729556,3578729556,0
1,970,16645,3578729556,3578729556,0
1,970,16646,3578729556,3578729556,0
1,970,16647,3578729556,3578729556,0
1,970,16648,3578729556,3578729556,0
1,970,16649,3578729556,3578729556,0
1,970,16650,3578729556,3578729557,1
1,970,16651,3578729556,3578729558,2
1,970,16652,3578729556,3578729559,3
1,970,16653,3578729556,3578729561,5
1,970,16654,3578729556,3578729563,7
1,970,16655,3578729556,3578729564,8
1,970,16656,3578729556,3578729565,9
1,970,16657,3578729556,3578729571,15
1,970,16658,3578729556,3578729573,17
1,970,16659,3578729556,3578729574,18
1,970,16660,3578729556,3578729574,18
1,970,16661,3578729556,3578729575,19
1,970,16662,3578729556,3578729575,19
1,970,16663,3578729556,3578729577,21
1,970,16664,3578729556,3578729577,21
1,970,16665,3578729556,3578729580,24
1,970,16666,3578729556,3578729581,25
1,970,16667,3578729556,3578729581,25
1,970,16668,3578729556,3578729586,30
1,970,16669,3578729556,3578729590,34
1,970,16670,3578729556,3578729591,35
1,970,16671,3578729556,3578729591,35
1,970,16672,3578729556,3578729593,37
1,970,16673,3578729556,3578729593,37
1,970,16674,3578729556,3578729595,39
1,970,16675,3578729556,3578729596,40
1,970,16676,3578729556,3578729597,41
1,970,16677,3578729556,3578729597,41
1,970,16678,3578729556,3578729597,41
1,970,16679,3578729556,3578729597,41
1,970,16680,3578729556,3578729597,41
1,970,16681,3578729556,3578729598,42
1,970,16682,3578729556,3578729599,43
1,970,16683,3578729556,3578729599,43
1,970,16684,3578729556,3578729603,47
1,970,16685,3578729556,3578729603,47
1,971,16686,3578729613,3578729613,0
1,971,16687,3578729613,3578729613,0
1,971,16688,3578729613,3578729613,0
1,971,16689,3578729613,3578729613,0
1,971,16690,3578729613,3578729615,2
1,971,16691,3578729613,3578729615,2
1,971,16692,3578729613,3578729615,2
1,971,16693,3578729613,3578729616,3
1,971,16694,3578729613,3578729617,4
1,971,16695,3578729613,3578729617,4
1,971,16696,3578729613,3578729617,4
1,971,16697,3578729613,3578729618,5
1,971,16698,3578729613,3578729621,8
1,971,16699,3578729613,3578729623,10
1,971,16700,3578729613,3578729624,11
1,971,16701,3578729613,3578729624,11
1,971,16702,3578729613,3578729625,12
1,971,16703,3578729613,3578729625,12
1,971,16704,3578729613,3578729626,13
1,971,16705,3578729613,3578729628,15
1,971,16706,3578729613,3578729628,15
1,971,16707,3578729613,3578729629,16
1,971,16708,3578729613,3578729630,17
1,971,16709,3578729613,3578729631,18
1,971,16710,3578729613,3578729633,20
1,971,16711,3578729613,3578729633,20
1,971,16712,3578729613,3578729636,23
1,971,16713,3578729613,3578729637,24
1,971,16714,3578729613,3578729638,25
1,971,16715,3578729613,3578729639,26
1,971,16716,3578729613,3578729639,26
1,971,16717,3578729613,3578729640,27
1,971,16718,3578729613,3578729648,35
1,971,16719,3578729613,3578729648,35
1,971,16720,3578729613,3578729651,38
1,971,16721,3578729613,3578729654,41
1,971,16722,3578729613,3578729655,42
1,971,16723,3578729613,3578729655,42
1,971,16724,3578729613,3578729656,43
1,971,16725,3578729613,3578729656,43
1,971,16726,3578729613,3578729658,45
1,971,16727,3578729613,3578729659,46
1,971,16728,3578729613,3578729661,48
1,971,16729,3578729613,3578729661,48
1,971,16730,3578729613,3578729662,49
1,972,16731,3578729670,3578729670,0
1,972,16732,3578729670,3578729670,0
1,972,16733,3578729670,3578729670,0
1,972,16734,3578729670,3578729670,0
1,972,16735,3578729670,3578729670,0
1,972,16736,3578729670,3578729670,0
1,972,16737,3578729670,3578729670,0
1,972,16738,3578729670,3578729670,0
1,972,16739,3578729670,3578729670,0
1,972,16740,3578729670,3578729670,0
1,972,16741,3578729670,3578729673,3
1,972,16742,3578729670,3578729683,13
1,972,16743,3578729670,3578729684,14
1,972,16744,3578729670,3578729686,16
1,972,16745,3578729670,3578729686,16
1,972,16746,3578729670,3578729686,16
1,972,16747,3578729670,3578729687,17
1,972,16748,3578729670,3578729692,22
1,972,16749,3578729670,3578729692,22
1,972,16750,3578729670,3578729692,22
1,972,16751,3578729670,3578729693,23
1,972,16752,3578729670,3578729697,27
1,972,16753,3578729670,3578729697,27
1,972,16754,3578729670,3578729698,28
1,972,16755,3578729670,3578729699,29
1,972,16756,3578729670,3578729700,30
1,972,16757,3578729670,3578729700,30
1,972,16758,3578729670,3578729705,35
1,972,16759,3578729670,3578729706,36
1,972,16760,3578729670,3578729708,38
1,972,16761,3578729670,3578729709,39
1,972,16762,3578729670,3578729712,42
1,972,16763,3578729670,3578729713,43
1,972,16764,3578729670,3578729714,44
1,972,16765,3578729670,3578729714,44
1,972,16766,3578729670,3578729715,45
1,972,16767,3578729670,3578729716,46
1,972,16768,3578729670,3578729716,46
1,972,16769,3578729670,3578729717,47
1,972,16770,3578729670,3578729718,48
1,972,16771,3578729670,3578729720,50
1,973,16772,3578729730,3578729730,0
1,973,16773,3578729730,3578729730,0
1,973,16774,3578729730,3578729730,0
1,973,16775,3578729730,3578729730,0
1,973,16776,3578729730,3578729730,0
1,973,16777,3578729730,3578729730,0
1,973,16778,3578729730,3578729730,0
1,973,16779,3578729730,3578729730,0
1,973,16780,3578729730,3578729730,0
1,973,16781,3578729730,3578729730,0
1,973,16782,3578729730,3578729730,0
1,973,16783,3578729730,3578729730,0
1,973,16784,3578729730,3578729730,0
1,973,16785,3578729730,3578729730,0
1,973,16786,3578729730,3578729730,0
1,973,16787,3578729730,3578729731,1
1,973,16788,3578729730,3578729733,3
1,973,16789,3578729730,3578729733,3
1,973,16790,3578729730,3578729734,4
1,973,16791,3578729730,3578729734,4
1,973,16792,3578729730,3578729738,8
1,973,16793,3578729730,3578729738,8
1,973,16794,3578729730,3578729739,9
1,973,16795,3578729730,3578729742,12
1,973,16796,3578729730,3578729744,14
1,973,16797,3578729730,3578729745,15
1,973,16798,3578729730,3578729746,16
1,973,16799,3578729730,3578729748,18
1,973,16800,3578729730,3578729751,21
1,973,16801,3578729730,3578729752,22
1,973,16802,3578729730,3578729753,23
1,973,16803,3578729730,3578729754,24
1,973,16804,3578729730,3578729754,24
1,973,16805,3578729730,3578729755,25
1,973,16806,3578729730,3578729756,26
1,973,16807,3578729730,3578729756,26
1,973,16808,3578729730,3578729757,27
1,973,16809,3578729730,3578729758,28
1,973,16810,3578729730,3578729758,28
1,973,16811,3578729730,3578729759,29
1,973,16812,3578729730,3578729763,33
1,973,16813,3578729730,3578729764,34
1,973,16814,3578729730,3578729765,35
1,973,16815,3578729730,3578729766,36
1,973,16816,3578729730,3578729771,41
1,973,16817,3578729730,3578729773,43
1,973,16818,3578729730,3578729774,44
1,973,16819,3578729730,3578729777,47
1,973,16820,3578729730,3578729778,48
1,973,16821,3578729730,3578729778,48
1,973,16822,3578729730,3578729780,50
1,974,16823,3578729792,3578729792,0
1,974,16824,3578729792,3578729792,0
1,974,16825,3578729792,3578729792,0
1,974,16826,3578729792,3578729792,0
1,974,16827,3578729792,3578729792,0
1,974,16828,3578729792,3578729792,0
1,974,16829,3578729792,3578729792,0
1,974,16830,3578729792,3578729792,0
1,974,16831,3578729792,3578729792,0
1,974,16832,3578729792,3578729793,1
1,974,16833,3578729792,3578729793,1
1,974,16834,3578729792,3578729796,4
1,974,16835,3578729792,3578729797,5
1,974,16836,3578729792,3578729797,5
1,974,16837,3578729792,3578729797,5
1,974,16838,3578729792,3578729797,5
1,974,16839,3578729792,3578729797,5
1,974,16840,3578729792,3578729798,6
1,974,16841,3578729792,3578729798,6
1,974,16842,3578729792,3578729799,7
1,974,16843,3578729792,3578729799,7
1,974,16844,3578729792,3578729803,11
1,974,16845,3578729792,3578729807,15
1,974,16846,3578729792,3578729811,19
1,974,16847,3578729792,3578729811,19
1,974,16848,3578729792,3578729813,21
1,974,16849,3578729792,3578729813,21
1,974,16850,3578729792,3578729815,23
1,974,16851,3578729792,3578729816,24
1,974,16852,3578729792,3578729816,24
1,974,16853,3578729792,3578729816,24
1,974,16854,3578729792,3578729817,25
1,974,16855,3578729792,3578729817,25
1,974,16856,3578729792,3578729818,26
1,974,16857,3578729792,3578729820,28
1,974,16858,3578729792,3578729822,30
1,974,16859,3578729792,3578729824,32
1,974,16860,3578729792,3578729824,32
1,974,16861,3578729792,3578729824,32
1,974,16862,3578729792,3578729825,33
1,974,16863,3578729792,3578729825,33
1,974,16864,3578729792,3578729826,34
1,974,16865,3578729792,3578729829,37
1,974,16866,3578729792,3578729829,37
1,974,16867,3578729792,3578729829,37
1,974,16868,3578729792,3578729830,38
1,974,16869,3578729792,3578729832,40
1,974,16870,3578729792,3578729832,40
1,974,16871,3578729792,3578729834,42
1,974,16872,3578729792,3578729836,44
1,974,16873,3578729792,3578729837,45
1,974,16874,3578729792,3578729839,47
1,974,16875,3578729792,3578729839,47
1,974,16876,3578729792,3578729840,48
1,975,16877,3578729852,3578729852,0
1,975,16878,3578729852,3578729852,0
1,975,16879,3578729852,3578729852,0
1,975,16880,3578729852,3578729852,0
1,975,16881,3578729852,3578729852,0
1,975,16882,3578729852,3578729854,2
1,975,16883,3578729852,3578729855,3
1,975,16884,3578729852,3578729855,3
1,975,16885,3578729852,3578729855,3
1,975,16886,3578729852,3578729855,3
1,975,16887,3578729852,3578729859,7
1,975,16888,3578729852,3578729860,8
1,975,16889,3578729852,3578729861,9
1,975,16890,3578729852,3578729862,10
1,975,16891,3578729852,3578729862,10
1,975,16892,3578729852,3578729863,11
1,975,16893,3578729852,3578729863,11
1,975,16894,3578729852,3578729864,12
1,975,16895,3578729852,3578729864,12
1,975,16896,3578729852,3578729867,15
1,975,16897,3578729852,3578729867,15
1,975,16898,3578729852,3578729867,15
1,975,16899,3578729852,3578729868,16
1,975,16900,3578729852,3578729869,17
1,975,16901,3578729852,3578729869,17
1,975,16902,3578729852,3578729873,21
1,975,16903,3578729852,3578729883,31
1,975,16904,3578729852,3578729884,32
1,975,16905,3578729852,3578729885,33
1,975,16906,3578729852,3578729886,34
1,975,16907,3578729852,3578729887,35
1,975,16908,3578729852,3578729891,39
1,975,16909,3578729852,3578729893,41
1,975,16910,3578729852,3578729893,41
1,975,16911,3578729852,3578729893,41
1,975,16912,3578729852,3578729897,45
1,975,16913,3578729852,3578729898,46
1,975,16914,3578729852,3578729898,46
1,975,16915,3578729852,3578729899,47
1,975,16916,3578729852,3578729900,48
1,975,16917,3578729852,3578729900,48
1,975,16918,3578729852,3578729901,49
1,975,16919,3578729852,3578729901,49
1,976,16920,3578729909,3578729909,0
1,976,16921,3578729909,3578729909,0
1,976,16922,3578729909,3578729909,0
1,976,16923,3578729909,3578729909,0
1,976,16924,3578729909,3578729909,0
1,976,16925,3578729909,3578729909,0
1,976,16926,3578729909,3578729911,2
1,976,16927,3578729909,3578729912,3
1,976,16928,3578729909,3578729914,5
1,976,16929,3578729909,3578729914,5
1,976,16930,3578729909,3578729914,5
1,976,16931,3578729909,3578729915,6
1,976,16932,3578729909,3578729917,8
1,976,16933,3578729909,3578729917,8
1,976,16934,3578729909,3578729917,8
1,976,16935,3578729909,3578729919,10
1,976,16936,3578729909,3578729919,10
1,976,16937,3578729909,3578729920,11
1,976,16938,3578729909,3578729920,11
1,976,16939,3578729909,3578729921,12
1,976,16940,3578729909,3578729922,13
1,976,16941,3578729909,3578729922,13
1,976,16942,3578729909,3578729923,14
1,976,16943,3578729909,3578729924,15
1,976,16944,3578729909,3578729924,15
1,976,16945,3578729909,3578729925,16
1,976,16946,3578729909,3578729925,16
1,976,16947,3578729909,3578729926,17
1,976,16948,3578729909,3578729926,17
1,976,16949,3578729909,3578729928,19
1,976,16950,3578729909,3578729928,19
1,976,16951,3578729909,3578729928,19
1,976,16952,3578729909,3578729928,19
1,976,16953,3578729909,3578729929,20
1,976,16954,3578729909,3578729930,21
1,976,16955,3578729909,3578729932,23
1,976,16956,3578729909,3578729932,23
1,976,16957,3578729909,3578729933,24
1,976,16958,3578729909,3578729933,24
1,976,16959,3578729909,3578729934,25
1,976,16960,3578729909,3578729935,26
1,976,16961,3578729909,3578729936,27
1,976,16962,3578729909,3578729938,29
1,976,16963,3578729909,3578729938,29
1,976,16964,3578729909,3578729940,31
1,976,16965,3578729909,3578729943,34
1,976,16966,3578729909,3578729943,34
1,976,16967,3578729909,3578729945,36
1,976,16968,3578729909,3578729946,37
1,976,16969,3578729909,3578729950,41
1,976,16970,3578729909,3578729952,43
1,976,16971,3578729909,3578729952,43
1,976,16972,3578729909,3578729952,43
1,976,16973,3578729909,3578729954,45
1,976,16974,3578729909,3578729954,45
1,976,16975,3578729909,3578729955,46
1,976,16976,3578729909,3578729956,47
1,976,16977,3578729909,3578729956,47
1,976,16978,3578729909,3578729957,48
1,976,16979,3578729909,3578729957,48
1,976,16980,3578729909,3578729958,49
1,976,16981,3578729909,3578729959,50
1,977,16982,3578729968,3578729968,0
1,977,16983,3578729968,3578729968,0
1,977,16984,3578729968,3578729968,0
1,977,16985,3578729968,3578729968,0
1,977,16986,3578729968,3578729968,0
1,977,16987,3578729968,3578729970,2
1,977,16988,3578729968,3578729973,5
1,977,16989,3578729968,3578729975,7
1,977,16990,3578729968,3578729975,7
1,977,16991,3578729968,3578729975,7
1,977,16992,3578729968,3578729976,8
1,977,16993,3578729968,3578729978,10
1,977,16994,3578729968,3578729978,10
1,977,16995,3578729968,3578729979,11
1,977,16996,3578729968,3578729980,12
1,977,16997,3578729968,3578729981,13
1,977,16998,3578729968,3578729982,14
1,977,16999,3578729968,3578729984,16
1,977,17000,3578729968,3578729985,17
1,977,17001,3578729968,3578729985,17
1,977,17002,3578729968,3578729991,23
1,977,17003,3578729968,3578729991,23
1,977,17004,3578729968,3578729991,23
1,977,17005,3578729968,3578729993,25
1,977,17006,3578729968,3578729994,26
1,977,17007,3578729968,3578729996,28
1,977,17008,3578729968,3578729997,29
1,977,17009,3578729968,3578729997,29
1,977,17010,3578729968,3578729997,29
1,977,17011,3578729968,3578729997,29
1,977,17012,3578729968,3578729997,29
1,977,17013,3578729968,3578729999,31
1,977,17014,3578729968,3578729999,31
1,977,17015,3578729968,3578729999,31
1,977,17016,3578729968,3578730000,32
1,977,17017,3578729968,3578730004,36
1,977,17018,3578729968,3578730008,40
1,977,17019,3578729968,3578730011,43
1,977,17020,3578729968,3578730014,46
1,977,17021,3578729968,3578730014,46
1,977,17022,3578729968,3578730015,47
1,977,17023,3578729968,3578730015,47
1,977,17024,3578729968,3578730016,48
1,977,17025,3578729968,3578730017,49
1,977,17026,3578729968,3578730017,49
1,977,17027,3578729968,3578730017,49
1,978,17028,3578730024,3578730024,0
1,978,17029,3578730024,3578730025,1
1,978,17030,3578730024,3578730025,1
1,978,17031,3578730024,3578730025,1
1,978,17032,3578730024,3578730025,1
1,978,17033,3578730024,3578730027,3
1,978,17034,3578730024,3578730029,5
1,978,17035,3578730024,3578730029,5
1,978,17036,3578730024,3578730029,5
1,978,17037,3578730024,3578730032,8
1,978,17038,3578730024,3578730032,8
1,978,17039,3578730024,3578730034,10
1,978,17040,3578730024,3578730037,13
1,978,17041,3578730024,3578730038,14
1,978,17042,3578730024,3578730038,14
1,978,17043,3578730024,3578730039,15
1,978,17044,3578730024,3578730039,15
1,978,17045,3578730024,3578730040,16
1,978,17046,3578730024,3578730045,21
1,978,17047,3578730024,3578730048,24
1,978,17048,3578730024,3578730052,28
1,978,17049,3578730024,3578730052,28
1,978,17050,3578730024,3578730054,30
1,978,17051,3578730024,3578730055,31
1,978,17052,3578730024,3578730056,32
1,978,17053,3578730024,3578730056,32
1,978,17054,3578730024,3578730057,33
1,978,17055,3578730024,3578730058,34
1,978,17056,3578730024,3578730059,35
1,978,17057,3578730024,3578730061,37
1,978,17058,3578730024,3578730062,38
1,978,17059,3578730024,3578730062,38
1,978,17060,3578730024,3578730063,39
1,978,17061,3578730024,3578730063,39
1,978,17062,3578730024,3578730065,41
1,978,17063,3578730024,3578730066,42
1,978,17064,3578730024,3578730067,43
1,978,17065,3578730024,3578730068,44
1,978,17066,3578730024,3578730068,44
1,978,17067,3578730024,3578730069,45
1,978,17068,3578730024,3578730069,45
1,978,17069,3578730024,3578730073,49
1,979,17070,3578730081,3578730084,3
1,979,17071,3578730081,3578730084,3
1,979,17072,3578730081,3578730086,5
1,979,17073,3578730081,3578730086,5
1,979,17074,3578730081,3578730086,5
1,979,17075,3578730081,3578730088,7
1,979,17076,3578730081,3578730092,11
1,979,17077,3578730081,3578730092,11
1,979,17078,3578730081,3578730093,12
1,979,17079,3578730081,3578730093,12
1,979,17080,3578730081,3578730097,16
1,979,17081,3578730081,3578730098,17
1,979,17082,3578730081,3578730098,17
1,979,17083,3578730081,3578730099,18
1,979,17084,3578730081,3578730100,19
1,979,17085,3578730081,3578730100,19
1,979,17086,3578730081,3578730102,21
1,979,17087,3578730081,3578730105,24
1,979,17088,3578730081,3578730108,27
1,979,17089,3578730081,3578730108,27
1,979,17090,3578730081,3578730109,28
1,979,17091,3578730081,3578730110,29
1,979,17092,3578730081,3578730112,31
1,979,17093,3578730081,3578730114,33
1,979,17094,3578730081,3578730115,34
1,979,17095,3578730081,3578730115,34
1,979,17096,3578730081,3578730115,34
1,979,17097,3578730081,3578730117,36
1,979,17098,3578730081,3578730117,36
1,979,17099,3578730081,3578730118,37
1,979,17100,3578730081,3578730119,38
1,979,17101,3578730081,3578730120,39
1,979,17102,3578730081,3578730120,39
1,979,17103,3578730081,3578730121,40
1,979,17104,3578730081,3578730122,41
1,979,17105,3578730081,3578730123,42
1,979,17106,3578730081,3578730123,42
1,979,17107,3578730081,3578730124,43
1,979,17108,3578730081,3578730124,43
1,979,17109,3578730081,3578730125,44
1,979,17110,3578730081,3578730125,44
1,979,17111,3578730081,3578730126,45
1,979,17112,3578730081,3578730127,46
1,979,17113,3578730081,3578730128,47
1,979,17114,3578730081,3578730128,47
1,979,17115,3578730081,3578730129,48
1,979,17116,3578730081,3578730130,49
1,979,17117,3578730081,3578730131,50
1,980,17118,3578730139,3578730139,0
1,980,17119,3578730139,3578730139,0
1,980,17120,3578730139,3578730139,0
1,980,17121,3578730139,3578730139,0
1,980,17122,3578730139,3578730139,0
1,980,17123,3578730139,3578730139,0
1,980,17124,3578730139,3578730139,0
1,980,17125,3578730139,3578730139,0
1,980,17126,3578730139,3578730140,1
1,980,17127,3578730139,3578730141,2
1,980,17128,3578730139,3578730143,4
1,980,17129,3578730139,3578730144,5
1,980,17130,3578730139,3578730145,6
1,980,17131,3578730139,3578730146,7
1,980,17132,3578730139,3578730149,10
1,980,17133,3578730139,3578730152,13
1,980,17134,3578730139,3578730153,14
1,980,17135,3578730139,3578730153,14
1,980,17136,3578730139,3578730154,15
1,980,17137,3578730139,3578730154,15
1,980,17138,3578730139,3578730155,16
1,980,17139,3578730139,3578730156,17
1,980,17140,3578730139,3578730157,18
1,980,17141,3578730139,3578730157,18
1,980,17142,3578730139,3578730158,19
1,980,17143,3578730139,3578730159,20
1,980,17144,3578730139,3578730162,23
1,980,17145,3578730139,3578730163,24
1,980,17146,3578730139,3578730165,26
1,980,17147,3578730139,3578730166,27
1,980,17148,3578730139,3578730166,27
1,980,17149,3578730139,3578730170,31
1,980,17150,3578730139,3578730173,34
1,980,17151,3578730139,3578730174,35
1,980,17152,3578730139,3578730175,36
1,980,17153,3578730139,3578730177,38
1,980,17154,3578730139,3578730178,39
1,980,17155,3578730139,3578730178,39
1,980,17156,3578730139,3578730179,40
1,980,17157,3578730139,3578730181,42
1,980,17158,3578730139,3578730181,42
1,980,17159,3578730139,3578730182,43
1,980,17160,3578730139,3578730184,45
1,980,17161,3578730139,3578730185,46
1,980,17162,3578730139,3578730186,47
1,981,17163,3578730196,3578730196,0
1,981,17164,3578730196,3578730196,0
1,981,17165,3578730196,3578730196,0
1,981,17166,3578730196,3578730197,1
1,981,17167,3578730196,3578730197,1
1,981,17168,3578730196,3578730197,1
1,981,17169,3578730196,3578730197,1
1,981,17170,3578730196,3578730197,1
1,981,17171,3578730196,3578730197,1
1,981,17172,3578730196,3578730197,1
1,981,17173,3578730196,3578730198,2
1,981,17174,3578730196,3578730199,3
1,981,17175,3578730196,3578730199,3
1,981,17176,3578730196,3578730199,3
1,981,17177,3578730196,3578730201,5
1,981,17178,3578730196,3578730203,7
1,981,17179,3578730196,3578730204,8
1,981,17180,3578730196,3578730204,8
1,981,17181,3578730196,3578730208,12
1,981,17182,3578730196,3578730211,15
1,981,17183,3578730196,3578730212,16
1,981,17184,3578730196,3578730213,17
1,981,17185,3578730196,3578730214,18
1,981,17186,3578730196,3578730215,19
1,981,17187,3578730196,3578730216,20
1,981,17188,3578730196,3578730217,21
1,981,17189,3578730196,3578730217,21
1,981,17190,3578730196,3578730217,21
1,981,17191,3578730196,3578730218,22
1,981,17192,3578730196,3578730218,22
1,981,17193,3578730196,3578730218,22
1,981,17194,3578730196,3578730222,26
1,981,17195,3578730196,3578730224,28
1,981,17196,3578730196,3578730225,29
1,981,17197,3578730196,3578730225,29
1,981,17198,3578730196,3578730225,29
1,981,17199,3578730196,3578730226,30
1,981,17200,3578730196,3578730227,31
1,981,17201,3578730196,3578730229,33
1,981,17202,3578730196,3578730230,34
1,981,17203,3578730196,3578730230,34
1,981,17204,3578730196,3578730232,36
1,981,17205,3578730196,3578730233,37
1,981,17206,3578730196,3578730234,38
1,981,17207,3578730196,3578730237,41
1,981,17208,3578730196,3578730237,41
1,981,17209,3578730196,3578730238,42
1,981,17210,3578730196,3578730239,43
1,981,17211,3578730196,3578730239,43
1,981,17212,3578730196,3578730240,44
1,981,17213,3578730196,3578730240,44
1,981,17214,3578730196,3578730245,49
1,982,17215,3578730254,3578730254,0
1,982,17216,3578730254,3578730254,0
1,982,17217,3578730254,3578730254,0
1,982,17218,3578730254,3578730254,0
1,982,17219,3578730254,3578730254,0
1,982,17220,3578730254,3578730255,1
1,982,17221,3578730254,3578730256,2
1,982,17222,3578730254,3578730256,2
1,982,17223,3578730254,3578730258,4
1,982,17224,3578730254,3578730259,5
1,982,17225,3578730254,3578730262,8
1,982,17226,3578730254,3578730262,8
1,982,17227,3578730254,3578730262,8
1,982,17228,3578730254,3578730263,9
1,982,17229,3578730254,3578730264,10
1,982,17230,3578730254,3578730265,11
1,982,17231,3578730254,3578730268,14
1,982,17232,3578730254,3578730268,14
1,982,17233,3578730254,3578730269,15
1,982,17234,3578730254,3578730269,15
1,982,17235,3578730254,3578730269,15
1,982,17236,3578730254,3578730283,29
1,982,17237,3578730254,3578730284,30
1,982,17238,3578730254,3578730285,31
1,982,17239,3578730254,3578730286,32
1,982,17240,3578730254,3578730287,33
1,982,17241,3578730254,3578730287,33
1,982,17242,3578730254,3578730292,38
1,982,17243,3578730254,3578730293,39
1,982,17244,3578730254,3578730293,39
1,982,17245,3578730254,3578730293,39
1,982,17246,3578730254,3578730297,43
1,982,17247,3578730254,3578730298,44
1,982,17248,3578730254,3578730299,45
1,982,17249,3578730254,3578730299,45
1,982,17250,3578730254,3578730300,46
1,982,17251,3578730254,3578730301,47
1,982,17252,3578730254,3578730301,47
1,982,17253,3578730254,3578730301,47
1,983,17254,3578730314,3578730314,0
1,983,17255,3578730314,3578730314,0
1,983,17256,3578730314,3578730314,0
1,983,17257,3578730314,3578730314,0
1,983,17258,3578730314,3578730314,0
1,983,17259,3578730314,3578730314,0
1,983,17260,3578730314,3578730314,0
1,983,17261,3578730314,3578730314,0
1,983,17262,3578730314,3578730314,0
1,983,17263,3578730314,3578730314,0
1,983,17264,3578730314,3578730315,1
1,983,17265,3578730314,3578730315,1
1,983,17266,3578730314,3578730317,3
1,983,17267,3578730314,3578730317,3
1,983,17268,3578730314,3578730318,4
1,983,17269,3578730314,3578730319,5
1,983,17270,3578730314,3578730320,6
1,983,17271,3578730314,3578730320,6
1,983,17272,3578730314,3578730320,6
1,983,17273,3578730314,3578730321,7
1,983,17274,3578730314,3578730322,8
1,983,17275,3578730314,3578730323,9
1,983,17276,3578730314,3578730324,10
1,983,17277,3578730314,3578730324,10
1,983,17278,3578730314,3578730324,10
1,983,17279,3578730314,3578730325,11
1,983,17280,3578730314,3578730325,11
1,983,17281,3578730314,3578730326,12
1,983,17282,3578730314,3578730328,14
1,983,17283,3578730314,3578730328,14
1,983,17284,3578730314,3578730328,14
1,983,17285,3578730314,3578730328,14
1,983,17286,3578730314,3578730329,15
1,983,17287,3578730314,3578730330,16
1,983,17288,3578730314,3578730330,16
1,983,17289,3578730314,3578730332,18
1,983,17290,3578730314,3578730333,19
1,983,17291,3578730314,3578730334,20
1,983,17292,3578730314,3578730334,20
1,983,17293,3578730314,3578730335,21
1,983,17294,3578730314,3578730336,22
1,983,17295,3578730314,3578730336,22
1,983,17296,3578730314,3578730340,26
1,983,17297,3578730314,3578730341,27
1,983,17298,3578730314,3578730343,29
1,983,17299,3578730314,3578730344,30
1,983,17300,3578730314,3578730346,32
1,983,17301,3578730314,3578730347,33
1,983,17302,3578730314,3578730349,35
1,983,17303,3578730314,3578730351,37
1,983,17304,3578730314,3578730353,39
1,983,17305,3578730314,3578730353,39
1,983,17306,3578730314,3578730354,40
1,983,17307,3578730314,3578730355,41
1,983,17308,3578730314,3578730356,42
1,983,17309,3578730314,3578730357,43
1,983,17310,3578730314,3578730357,43
1,983,17311,3578730314,3578730359,45
1,983,17312,3578730314,3578730359,45
1,983,17313,3578730314,3578730362,48
1,983,17314,3578730314,3578730362,48
1,984,17315,3578730372,3578730372,0
1,984,17316,3578730372,3578730372,0
1,984,17317,3578730372,3578730372,0
1,984,17318,3578730372,3578730373,1
1,984,17319,3578730372,3578730373,1
1,984,17320,3578730372,3578730375,3
1,984,17321,3578730372,3578730377,5
1,984,17322,3578730372,3578730379,7
1,984,17323,3578730372,3578730379,7
1,984,17324,3578730372,3578730380,8
1,984,17325,3578730372,3578730381,9
1,984,17326,3578730372,3578730382,10
1,984,17327,3578730372,3578730382,10
1,984,17328,3578730372,3578730384,12
1,984,17329,3578730372,3578730385,13
1,984,17330,3578730372,3578730387,15
1,984,17331,3578730372,3578730392,20
1,984,17332,3578730372,3578730392,20
1,984,17333,3578730372,3578730392,20
1,984,17334,3578730372,3578730393,21
1,984,17335,3578730372,3578730393,21
1,984,17336,3578730372,3578730397,25
1,984,17337,3578730372,3578730397,25
1,984,17338,3578730372,3578730397,25
1,984,17339,3578730372,3578730397,25
1,984,17340,3578730372,3578730398,26
1,984,17341,3578730372,3578730398,26
1,984,17342,3578730372,3578730399,27
1,984,17343,3578730372,3578730400,28
1,984,17344,3578730372,3578730401,29
1,984,17345,3578730372,3578730403,31
1,984,17346,3578730372,3578730405,33
1,984,17347,3578730372,3578730405,33
1,984,17348,3578730372,3578730408,36
1,984,17349,3578730372,3578730411,39
1,984,17350,3578730372,3578730414,42
1,984,17351,3578730372,3578730414,42
1,984,17352,3578730372,3578730415,43
1,984,17353,3578730372,3578730416,44
1,984,17354,3578730372,3578730416,44
1,984,17355,3578730372,3578730417,45
1,984,17356,3578730372,3578730417,45
1,984,17357,3578730372,3578730417,45
1,984,17358,3578730372,3578730418,46
1,984,17359,3578730372,3578730418,46
1,984,17360,3578730372,3578730419,47
1,985,17361,3578730431,3578730431,0
1,985,17362,3578730431,3578730431,0
1,985,17363,3578730431,3578730431,0
1,985,17364,3578730431,3578730431,0
1,985,17365,3578730431,3578730431,0
1,985,17366,3578730431,3578730431,0
1,985,17367,3578730431,3578730431,0
1,985,17368,3578730431,3578730431,0
1,985,17369,3578730431,3578730431,0
1,985,17370,3578730431,3578730432,1
1,985,17371,3578730431,3578730432,1
1,985,17372,3578730431,3578730434,3
1,985,17373,3578730431,3578730436,5
1,985,17374,3578730431,3578730437,6
1,985,17375,3578730431,3578730438,7
1,985,17376,3578730431,3578730439,8
1,985,17377,3578730431,3578730439,8
1,985,17378,3578730431,3578730440,9
1,985,17379,3578730431,3578730448,17
1,985,17380,3578730431,3578730453,22
1,985,17381,3578730431,3578730453,22
1,985,17382,3578730431,3578730454,23
1,985,17383,3578730431,3578730455,24
1,985,17384,3578730431,3578730456,25
1,985,17385,3578730431,3578730457,26
1,985,17386,3578730431,3578730457,26
1,985,17387,3578730431,3578730458,27
1,985,17388,3578730431,3578730460,29
1,985,17389,3578730431,3578730461,30
1,985,17390,3578730431,3578730464,33
1,985,17391,3578730431,3578730464,33
1,985,17392,3578730431,3578730464,33
1,985,17393,3578730431,3578730465,34
1,985,17394,3578730431,3578730465,34
1,985,17395,3578730431,3578730466,35
1,985,17396,3578730431,3578730467,36
1,985,17397,3578730431,3578730468,37
1,985,17398,3578730431,3578730469,38
1,985,17399,3578730431,3578730469,38
1,985,17400,3578730431,3578730470,39
1,986,17401,3578730489,3578730489,0
1,986,17402,3578730489,3578730489,0
1,986,17403,3578730489,3578730489,0
1,986,17404,3578730489,3578730489,0
1,986,17405,3578730489,3578730489,0
1,986,17406,3578730489,3578730489,0
1,986,17407,3578730489,3578730491,2
1,986,17408,3578730489,3578730492,3
1,986,17409,3578730489,3578730493,4
1,986,17410,3578730489,3578730496,7
1,986,17411,3578730489,3578730498,9
1,986,17412,3578730489,3578730498,9
1,986,17413,3578730489,3578730500,11
1,986,17414,3578730489,3578730500,11
1,986,17415,3578730489,3578730501,12
1,986,17416,3578730489,3578730505,16
1,986,17417,3578730489,3578730507,18
1,986,17418,3578730489,3578730507,18
1,986,17419,3578730489,3578730508,19
1,986,17420,3578730489,3578730508,19
1,986,17421,3578730489,3578730512,23
1,986,17422,3578730489,3578730513,24
1,986,17423,3578730489,3578730513,24
1,986,17424,3578730489,3578730514,25
1,986,17425,3578730489,3578730514,25
1,986,17426,3578730489,3578730516,27
1,986,17427,3578730489,3578730516,27
1,986,17428,3578730489,3578730518,29
1,986,17429,3578730489,3578730518,29
1,986,17430,3578730489,3578730518,29
1,986,17431,3578730489,3578730519,30
1,986,17432,3578730489,3578730520,31
1,986,17433,3578730489,3578730520,31
1,986,17434,3578730489,3578730521,32
1,986,17435,3578730489,3578730522,33
1,986,17436,3578730489,3578730522,33
1,986,17437,3578730489,3578730523,34
1,986,17438,3578730489,3578730523,34
1,986,17439,3578730489,3578730524,35
1,986,17440,3578730489,3578730524,35
1,986,17441,3578730489,3578730525,36
1,986,17442,3578730489,3578730526,37
1,986,17443,3578730489,3578730527,38
1,986,17444,3578730489,3578730527,38
1,986,17445,3578730489,3578730528,39
1,986,17446,3578730489,3578730528,39
1,986,17447,3578730489,3578730528,39
1,986,17448,3578730489,3578730529,40
1,986,17449,3578730489,3578730529,40
1,986,17450,3578730489,3578730531,42
1,986,17451,3578730489,3578730531,42
1,986,17452,3578730489,3578730532,43
1,986,17453,3578730489,3578730533,44
1,986,17454,3578730489,3578730533,44
1,986,17455,3578730489,3578730535,46
1,986,17456,3578730489,3578730535,46
1,986,17457,3578730489,3578730536,47
1,986,17458,3578730489,3578730538,49
1,987,17459,3578730546,3578730546,0
1,987,17460,3578730546,3578730546,0
1,987,17461,3578730546,3578730546,0
1,987,17462,3578730546,3578730546,0
1,987,17463,3578730546,3578730546,0
1,987,17464,3578730546,3578730546,0
1,987,17465,3578730546,3578730548,2
1,987,17466,3578730546,3578730551,5
1,987,17467,3578730546,3578730552,6
1,987,17468,3578730546,3578730552,6
1,987,17469,3578730546,3578730554,8
1,987,17470,3578730546,3578730555,9
1,987,17471,3578730546,3578730555,9
1,987,17472,3578730546,3578730556,10
1,987,17473,3578730546,3578730557,11
1,987,17474,3578730546,3578730557,11
1,987,17475,3578730546,3578730558,12
1,987,17476,3578730546,3578730559,13
1,987,17477,3578730546,3578730561,15
1,987,17478,3578730546,3578730562,16
1,987,17479,3578730546,3578730565,19
1,987,17480,3578730546,3578730565,19
1,987,17481,3578730546,3578730571,25
1,987,17482,3578730546,3578730572,26
1,987,17483,3578730546,3578730573,27
1,987,17484,3578730546,3578730575,29
1,987,17485,3578730546,3578730576,30
1,987,17486,3578730546,3578730578,32
1,987,17487,3578730546,3578730578,32
1,987,17488,3578730546,3578730579,33
1,987,17489,3578730546,3578730580,34
1,987,17490,3578730546,3578730581,35
1,987,17491,3578730546,3578730581,35
1,987,17492,3578730546,3578730584,38
1,987,17493,3578730546,3578730584,38
1,987,17494,3578730546,3578730585,39
1,987,17495,3578730546,3578730585,39
1,987,17496,3578730546,3578730591,45
1,987,17497,3578730546,3578730591,45
1,987,17498,3578730546,3578730592,46
1,987,17499,3578730546,3578730592,46
1,987,17500,3578730546,3578730594,48
1,988,17501,3578730605,3578730605,0
1,988,17502,3578730605,3578730605,0
1,988,17503,3578730605,3578730605,0
1,988,17504,3578730605,3578730605,0
1,988,17505,3578730605,3578730605,0
1,988,17506,3578730605,3578730605,0
1,988,17507,3578730605,3578730605,0
1,988,17508,3578730605,3578730605,0
1,988,17509,3578730605,3578730605,0
1,988,17510,3578730605,3578730605,0
1,988,17511,3578730605,3578730605,0
1,988,17512,3578730605,3578730605,0
1,988,17513,3578730605,3578730606,1
1,988,17514,3578730605,3578730611,6
1,988,17515,3578730605,3578730612,7
1,988,17516,3578730605,3578730613,8
1,988,17517,3578730605,3578730614,9
1,988,17518,3578730605,3578730615,10
1,988,17519,3578730605,3578730616,11
1,988,17520,3578730605,3578730616,11
1,988,17521,3578730605,3578730616,11
1,988,17522,3578730605,3578730616,11
1,988,17523,3578730605,3578730616,11
1,988,17524,3578730605,3578730617,12
1,988,17525,3578730605,3578730617,12
1,988,17526,3578730605,3578730618,13
1,988,17527,3578730605,3578730619,14
1,988,17528,3578730605,3578730621,16
1,988,17529,3578730605,3578730622,17
1,988,17530,3578730605,3578730624,19
1,988,17531,3578730605,3578730625,20
1,988,17532,3578730605,3578730625,20
1,988,17533,3578730605,3578730625,20
1,988,17534,3578730605,3578730626,21
1,988,17535,3578730605,3578730627,22
1,988,17536,3578730605,3578730628,23
1,988,17537,3578730605,3578730628,23
1,988,17538,3578730605,3578730628,23
1,988,17539,3578730605,3578730629,24
1,988,17540,3578730605,3578730631,26
1,988,17541,3578730605,3578730631,26
1,988,17542,3578730605,3578730633,28
1,988,17543,3578730605,3578730636,31
1,988,17544,3578730605,3578730636,31
1,988,17545,3578730605,3578730637,32
1,988,17546,3578730605,3578730638,33
1,988,17547,3578730605,3578730638,33
1,988,17548,3578730605,3578730639,34
1,988,17549,3578730605,3578730647,42
1,988,17550,3578730605,3578730647,42
1,988,17551,3578730605,3578730651,46
1,988,17552,3578730605,3578730653,48
1,988,17553,3578730605,3578730654,49
1,989,17554,3578730664,3578730665,1
1,989,17555,3578730664,3578730665,1
1,989,17556,3578730664,3578730665,1
1,989,17557,3578730664,3578730665,1
1,989,17558,3578730664,3578730665,1
1,989,17559,3578730664,3578730665,1
1,989,17560,3578730664,3578730665,1
1,989,17561,3578730664,3578730665,1
1,989,17562,3578730664,3578730665,1
1,989,17563,3578730664,3578730665,1
1,989,17564,3578730664,3578730665,1
1,989,17565,3578730664,3578730665,1
1,989,17566,3578730664,3578730665,1
1,989,17567,3578730664,3578730665,1
1,989,17568,3578730664,3578730666,2
1,989,17569,3578730664,3578730668,4
1,989,17570,3578730664,3578730669,5
1,989,17571,3578730664,3578730669,5
1,989,17572,3578730664,3578730669,5
1,989,17573,3578730664,3578730673,9
1,989,17574,3578730664,3578730684,20
1,989,17575,3578730664,3578730685,21
1,989,17576,3578730664,3578730686,22
1,989,17577,3578730664,3578730686,22
1,989,17578,3578730664,3578730686,22
1,989,17579,3578730664,3578730688,24
1,989,17580,3578730664,3578730692,28
1,989,17581,3578730664,3578730692,28
1,989,17582,3578730664,3578730693,29
1,989,17583,3578730664,3578730697,33
1,989,17584,3578730664,3578730697,33
1,989,17585,3578730664,3578730698,34
1,989,17586,3578730664,3578730698,34
1,989,17587,3578730664,3578730700,36
1,989,17588,3578730664,3578730700,36
1,989,17589,3578730664,3578730700,36
1,989,17590,3578730664,3578730701,37
1,989,17591,3578730664,3578730705,41
1,989,17592,3578730664,3578730706,42
1,989,17593,3578730664,3578730707,43
1,989,17594,3578730664,3578730707,43
1,989,17595,3578730664,3578730708,44
1,989,17596,3578730664,3578730709,45
1,989,17597,3578730664,3578730712,48
1,989,17598,3578730664,3578730713,49
1,989,17599,3578730664,3578730713,49
1,989,17600,3578730664,3578730713,49
1,989,17601,3578730664,3578730714,50
1,990,17602,3578730723,3578730723,0
1,990,17603,3578730723,3578730723,0
1,990,17604,3578730723,3578730723,0
1,990,17605,3578730723,3578730723,0
1,990,17606,3578730723,3578730723,0
1,990,17607,3578730723,3578730723,0
1,990,17608,3578730723,3578730723,0
1,990,17609,3578730723,3578730723,0
1,990,17610,3578730723,3578730723,0
1,990,17611,3578730723,3578730723,0
1,990,17612,3578730723,3578730723,0
1,990,17613,3578730723,3578730723,0
1,990,17614,3578730723,3578730724,1
1,990,17615,3578730723,3578730724,1
1,990,17616,3578730723,3578730725,2
1,990,17617,3578730723,3578730725,2
1,990,17618,3578730723,3578730726,3
1,990,17619,3578730723,3578730727,4
1,990,17620,3578730723,3578730727,4
1,990,17621,3578730723,3578730728,5
1,990,17622,3578730723,3578730728,5
1,990,17623,3578730723,3578730729,6
1,990,17624,3578730723,3578730729,6
1,990,17625,3578730723,3578730731,8
1,990,17626,3578730723,3578730732,9
1,990,17627,3578730723,3578730732,9
1,990,17628,3578730723,3578730733,10
1,990,17629,3578730723,3578730734,11
1,990,17630,3578730723,3578730735,12
1,990,17631,3578730723,3578730736,13
1,990,17632,3578730723,3578730738,15
1,990,17633,3578730723,3578730740,17
1,990,17634,3578730723,3578730740,17
1,990,17635,3578730723,3578730744,21
1,990,17636,3578730723,3578730744,21
1,990,17637,3578730723,3578730745,22
1,990,17638,3578730723,3578730746,23
1,990,17639,3578730723,3578730749,26
1,990,17640,3578730723,3578730752,29
1,990,17641,3578730723,3578730752,29
1,990,17642,3578730723,3578730752,29
1,990,17643,3578730723,3578730755,32
1,990,17644,3578730723,3578730755,32
1,990,17645,3578730723,3578730756,33
1,990,17646,3578730723,3578730757,34
1,990,17647,3578730723,3578730758,35
1,990,17648,3578730723,3578730759,36
1,990,17649,3578730723,3578730759,36
1,990,17650,3578730723,3578730761,38
1,990,17651,3578730723,3578730761,38
1,990,17652,3578730723,3578730765,42
1,990,17653,3578730723,3578730765,42
1,990,17654,3578730723,3578730765,42
1,990,17655,3578730723,3578730771,48
1,990,17656,3578730723,3578730772,49
1,991,17657,3578730781,3578730781,0
1,991,17658,3578730781,3578730781,0
1,991,17659,3578730781,3578730781,0
1,991,17660,3578730781,3578730781,0
1,991,17661,3578730781,3578730781,0
1,991,17662,3578730781,3578730781,0
1,991,17663,3578730781,3578730781,0
1,991,17664,3578730781,3578730781,0
1,991,17665,3578730781,3578730783,2
1,991,17666,3578730781,3578730784,3
1,991,17667,3578730781,3578730785,4
1,991,17668,3578730781,3578730785,4
1,991,17669,3578730781,3578730791,10
1,991,17670,3578730781,3578730791,10
1,991,17671,3578730781,3578730792,11
1,991,17672,3578730781,3578730793,12
1,991,17673,3578730781,3578730794,13
1,991,17674,3578730781,3578730796,15
1,991,17675,3578730781,3578730796,15
1,991,17676,3578730781,3578730797,16
1,991,17677,3578730781,3578730798,17
1,991,17678,3578730781,3578730798,17
1,991,17679,3578730781,3578730799,18
1,991,17680,3578730781,3578730799,18
1,991,17681,3578730781,3578730801,20
1,991,17682,3578730781,3578730801,20
1,991,17683,3578730781,3578730804,23
1,991,17684,3578730781,3578730805,24
1,991,17685,3578730781,3578730807,26
1,991,17686,3578730781,3578730812,31
1,991,17687,3578730781,3578730813,32
1,991,17688,3578730781,3578730813,32
1,991,17689,3578730781,3578730815,34
1,991,17690,3578730781,3578730816,35
1,991,17691,3578730781,3578730816,35
1,991,17692,3578730781,3578730816,35
1,991,17693,3578730781,3578730817,36
1,991,17694,3578730781,3578730817,36
1,991,17695,3578730781,3578730817,36
1,991,17696,3578730781,3578730818,37
1,991,17697,3578730781,3578730818,37
1,991,17698,3578730781,3578730818,37
1,991,17699,3578730781,3578730821,40
1,991,17700,3578730781,3578730823,42
1,991,17701,3578730781,3578730824,43
1,991,17702,3578730781,3578730825,44
1,991,17703,3578730781,3578730825,44
1,991,17704,3578730781,3578730826,45
1,991,17705,3578730781,3578730827,46
1,991,17706,3578730781,3578730828,47
1,991,17707,3578730781,3578730828,47
1,991,17708,3578730781,3578730828,47
1,991,17709,3578730781,3578730830,49
1,992,17710,3578730839,3578730839,0
1,992,17711,3578730839,3578730839,0
1,992,17712,3578730839,3578730839,0
1,992,17713,3578730839,3578730839,0
1,992,17714,3578730839,3578730839,0
1,992,17715,3578730839,3578730839,0
1,992,17716,3578730839,3578730839,0
1,992,17717,3578730839,3578730839,0
1,992,17718,3578730839,3578730839,0
1,992,17719,3578730839,3578730848,9
1,992,17720,3578730839,3578730852,13
1,992,17721,3578730839,3578730853,14
1,992,17722,3578730839,3578730853,14
1,992,17723,3578730839,3578730854,15
1,992,17724,3578730839,3578730856,17
1,992,17725,3578730839,3578730856,17
1,992,17726,3578730839,3578730858,19
1,992,17727,3578730839,3578730859,20
1,992,17728,3578730839,3578730861,22
1,992,17729,3578730839,3578730862,23
1,992,17730,3578730839,3578730863,24
1,992,17731,3578730839,3578730863,24
1,992,17732,3578730839,3578730864,25
1,992,17733,3578730839,3578730864,25
1,992,17734,3578730839,3578730864,25
1,992,17735,3578730839,3578730866,27
1,992,17736,3578730839,3578730866,27
1,992,17737,3578730839,3578730868,29
1,992,17738,3578730839,3578730869,30
1,992,17739,3578730839,3578730869,30
1,992,17740,3578730839,3578730869,30
1,992,17741,3578730839,3578730870,31
1,992,17742,3578730839,3578730873,34
1,992,17743,3578730839,3578730885,46
1,992,17744,3578730839,3578730886,47
1,992,17745,3578730839,3578730886,47
1,992,17746,3578730839,3578730886,47
1,992,17747,3578730839,3578730887,48
1,993,17748,3578730896,3578730897,1
1,993,17749,3578730896,3578730897,1
1,993,17750,3578730896,3578730897,1
1,993,17751,3578730896,3578730897,1
1,993,17752,3578730896,3578730897,1
1,993,17753,3578730896,3578730898,2
1,993,17754,3578730896,3578730900,4
1,993,17755,3578730896,3578730900,4
1,993,17756,3578730896,3578730900,4
1,993,17757,3578730896,3578730900,4
1,993,17758,3578730896,3578730902,6
1,993,17759,3578730896,3578730905,9
1,993,17760,3578730896,3578730907,11
1,993,17761,3578730896,3578730907,11
1,993,17762,3578730896,3578730908,12
1,993,17763,3578730896,3578730912,16
1,993,17764,3578730896,3578730914,18
1,993,17765,3578730896,3578730914,18
1,993,17766,3578730896,3578730914,18
1,993,17767,3578730896,3578730916,20
1,993,17768,3578730896,3578730916,20
1,993,17769,3578730896,3578730918,22
1,993,17770,3578730896,3578730919,23
1,993,17771,3578730896,3578730919,23
1,993,17772,3578730896,3578730920,24
1,993,17773,3578730896,3578730921,25
1,993,17774,3578730896,3578730922,26
1,993,17775,3578730896,3578730922,26
1,993,17776,3578730896,3578730922,26
1,993,17777,3578730896,3578730923,27
1,993,17778,3578730896,3578730924,28
1,993,17779,3578730896,3578730924,28
1,993,17780,3578730896,3578730925,29
1,993,17781,3578730896,3578730926,30
1,993,17782,3578730896,3578730927,31
1,993,17783,3578730896,3578730927,31
1,993,17784,3578730896,3578730928,32
1,993,17785,3578730896,3578730928,32
1,993,17786,3578730896,3578730929,33
1,993,17787,3578730896,3578730931,35
1,993,17788,3578730896,3578730931,35
1,993,17789,3578730896,3578730931,35
1,993,17790,3578730896,3578730936,40
1,993,17791,3578730896,3578730936,40
1,993,17792,3578730896,3578730940,44
1,993,17793,3578730896,3578730940,44
1,993,17794,3578730896,3578730943,47
1,993,17795,3578730896,3578730944,48
1,993,17796,3578730896,3578730945,49
1,993,17797,3578730896,3578730946,50
1,994,17798,3578730953,3578730953,0
1,994,17799,3578730953,3578730953,0
1,994,17800,3578730953,3578730953,0
1,994,17801,3578730953,3578730953,0
1,994,17802,3578730953,3578730953,0
1,994,17803,3578730953,3578730953,0
1,994,17804,3578730953,3578730955,2
1,994,17805,3578730953,3578730955,2
1,994,17806,3578730953,3578730956,3
1,994,17807,3578730953,3578730957,4
1,994,17808,3578730953,3578730958,5
1,994,17809,3578730953,3578730960,7
1,994,17810,3578730953,3578730960,7
1,994,17811,3578730953,3578730962,9
1,994,17812,3578730953,3578730962,9
1,994,17813,3578730953,3578730964,11
1,994,17814,3578730953,3578730965,12
1,994,17815,3578730953,3578730966,13
1,994,17816,3578730953,3578730966,13
1,994,17817,3578730953,3578730971,18
1,994,17818,3578730953,3578730972,19
1,994,17819,3578730953,3578730973,20
1,994,17820,3578730953,3578730974,21
1,994,17821,3578730953,3578730976,23
1,994,17822,3578730953,3578730976,23
1,994,17823,3578730953,3578730977,24
1,994,17824,3578730953,3578730978,25
1,994,17825,3578730953,3578730981,28
1,994,17826,3578730953,3578730981,28
1,994,17827,3578730953,3578730981,28
1,994,17828,3578730953,3578730982,29
1,994,17829,3578730953,3578730983,30
1,994,17830,3578730953,3578730985,32
1,994,17831,3578730953,3578730986,33
1,994,17832,3578730953,3578730992,39
1,994,17833,3578730953,3578730992,39
1,994,17834,3578730953,3578730992,39
1,994,17835,3578730953,3578730993,40
1,994,17836,3578730953,3578730994,41
1,994,17837,3578730953,3578730996,43
1,994,17838,3578730953,3578730996,43
1,994,17839,3578730953,3578730998,45
1,994,17840,3578730953,3578730998,45
1,994,17841,3578730953,3578730999,46
1,994,17842,3578730953,3578730999,46
1,994,17843,3578730953,3578730999,46
1,994,17844,3578730953,3578731001,48
1,994,17845,3578730953,3578731002,49
1,995,17846,3578731011,3578731011,0
1,995,17847,3578731011,3578731011,0
1,995,17848,3578731011,3578731011,0
1,995,17849,3578731011,3578731012,1
1,995,17850,3578731011,3578731012,1
1,995,17851,3578731011,3578731014,3
1,995,17852,3578731011,3578731014,3
1,995,17853,3578731011,3578731015,4
1,995,17854,3578731011,3578731016,5
1,995,17855,3578731011,3578731016,5
1,995,17856,3578731011,3578731016,5
1,995,17857,3578731011,3578731017,6
1,995,17858,3578731011,3578731018,7
1,995,17859,3578731011,3578731018,7
1,995,17860,3578731011,3578731018,7
1,995,17861,3578731011,3578731018,7
1,995,17862,3578731011,3578731018,7
1,995,17863,3578731011,3578731021,10
1,995,17864,3578731011,3578731024,13
1,995,17865,3578731011,3578731025,14
1,995,17866,3578731011,3578731025,14
1,995,17867,3578731011,3578731025,14
1,995,17868,3578731011,3578731027,16
1,995,17869,3578731011,3578731027,16
1,995,17870,3578731011,3578731028,17
1,995,17871,3578731011,3578731028,17
1,995,17872,3578731011,3578731029,18
1,995,17873,3578731011,3578731030,19
1,995,17874,3578731011,3578731032,21
1,995,17875,3578731011,3578731034,23
1,995,17876,3578731011,3578731034,23
1,995,17877,3578731011,3578731037,26
1,995,17878,3578731011,3578731037,26
1,995,17879,3578731011,3578731037,26
1,995,17880,3578731011,3578731039,28
1,995,17881,3578731011,3578731039,28
1,995,17882,3578731011,3578731039,28
1,995,17883,3578731011,3578731039,28
1,995,17884,3578731011,3578731044,33
1,995,17885,3578731011,3578731047,36
1,995,17886,3578731011,3578731048,37
1,995,17887,3578731011,3578731051,40
1,995,17888,3578731011,3578731052,41
1,995,17889,3578731011,3578731053,42
1,995,17890,3578731011,3578731054,43
1,995,17891,3578731011,3578731056,45
1,995,17892,3578731011,3578731057,46
1,995,17893,3578731011,3578731057,46
1,995,17894,3578731011,3578731059,48
1,995,17895,3578731011,3578731059,48
1,995,17896,3578731011,3578731060,49
1,996,17897,3578731069,3578731069,0
1,996,17898,3578731069,3578731069,0
1,996,17899,3578731069,3578731069,0
1,996,17900,3578731069,3578731069,0
1,996,17901,3578731069,3578731069,0
1,996,17902,3578731069,3578731069,0
1,996,17903,3578731069,3578731069,0
1,996,17904,3578731069,3578731069,0
1,996,17905,3578731069,3578731069,0
1,996,17906,3578731069,3578731069,0
1,996,17907,3578731069,3578731070,1
1,996,17908,3578731069,3578731070,1
1,996,17909,3578731069,3578731073,4
1,996,17910,3578731069,3578731085,16
1,996,17911,3578731069,3578731086,17
1,996,17912,3578731069,3578731087,18
1,996,17913,3578731069,3578731087,18
1,996,17914,3578731069,3578731088,19
1,996,17915,3578731069,3578731091,22
1,996,17916,3578731069,3578731093,24
1,996,17917,3578731069,3578731094,25
1,996,17918,3578731069,3578731096,27
1,996,17919,3578731069,3578731098,29
1,996,17920,3578731069,3578731099,30
1,996,17921,3578731069,3578731100,31
1,996,17922,3578731069,3578731101,32
1,996,17923,3578731069,3578731101,32
1,996,17924,3578731069,3578731101,32
1,996,17925,3578731069,3578731102,33
1,996,17926,3578731069,3578731105,36
1,996,17927,3578731069,3578731106,37
1,996,17928,3578731069,3578731107,38
1,996,17929,3578731069,3578731107,38
1,996,17930,3578731069,3578731109,40
1,996,17931,3578731069,3578731109,40
1,996,17932,3578731069,3578731112,43
1,996,17933,3578731069,3578731113,44
1,996,17934,3578731069,3578731114,45
1,996,17935,3578731069,3578731114,45
1,996,17936,3578731069,3578731114,45
1,996,17937,3578731069,3578731115,46
1,996,17938,3578731069,3578731116,47
1,996,17939,3578731069,3578731117,48
1,996,17940,3578731069,3578731118,49
1,996,17941,3578731069,3578731119,50
1,997,17942,3578731129,3578731129,0
1,997,17943,3578731129,3578731129,0
1,997,17944,3578731129,3578731129,0
1,997,17945,3578731129,3578731129,0
1,997,17946,3578731129,3578731129,0
1,997,17947,3578731129,3578731129,0
1,997,17948,3578731129,3578731129,0
1,997,17949,3578731129,3578731129,0
1,997,17950,3578731129,3578731129,0
1,997,17951,3578731129,3578731129,0
1,997,17952,3578731129,3578731129,0
1,997,17953,3578731129,3578731129,0
1,997,17954,3578731129,3578731129,0
1,997,17955,3578731129,3578731129,0
1,997,17956,3578731129,3578731129,0
1,997,17957,3578731129,3578731129,0
1,997,17958,3578731129,3578731129,0
1,997,17959,3578731129,3578731131,2
1,997,17960,3578731129,3578731131,2
1,997,17961,3578731129,3578731133,4
1,997,17962,3578731129,3578731134,5
1,997,17963,3578731129,3578731135,6
1,997,17964,3578731129,3578731135,6
1,997,17965,3578731129,3578731136,7
1,997,17966,3578731129,3578731138,9
1,997,17967,3578731129,3578731140,11
1,997,17968,3578731129,3578731141,12
1,997,17969,3578731129,3578731143,14
1,997,17970,3578731129,3578731143,14
1,997,17971,3578731129,3578731145,16
1,997,17972,3578731129,3578731146,17
1,997,17973,3578731129,3578731150,21
1,997,17974,3578731129,3578731151,22
1,997,17975,3578731129,3578731151,22
1,997,17976,3578731129,3578731152,23
1,997,17977,3578731129,3578731154,25
1,997,17978,3578731129,3578731155,26
1,997,17979,3578731129,3578731155,26
1,997,17980,3578731129,3578731157,28
1,997,17981,3578731129,3578731157,28
1,997,17982,3578731129,3578731158,29
1,997,17983,3578731129,3578731160,31
1,997,17984,3578731129,3578731160,31
1,997,17985,3578731129,3578731162,33
1,997,17986,3578731129,3578731164,35
1,997,17987,3578731129,3578731165,36
1,997,17988,3578731129,3578731165,36
1,997,17989,3578731129,3578731166,37
1,997,17990,3578731129,3578731170,41
1,997,17991,3578731129,3578731172,43
1,997,17992,3578731129,3578731174,45
1,997,17993,3578731129,3578731176,47
1,997,17994,3578731129,3578731176,47
1,997,17995,3578731129,3578731178,49
1,997,17996,3578731129,3578731179,50
1,998,17997,3578731189,3578731189,0
1,998,17998,3578731189,3578731189,0
1,998,17999,3578731189,3578731189,0
1,998,18000,3578731189,3578731189,0
1,998,18001,3578731189,3578731189,0
1,998,18002,3578731189,3578731189,0
1,998,18003,3578731189,3578731190,1
1,998,18004,3578731189,3578731191,2
1,998,18005,3578731189,3578731192,3
1,998,18006,3578731189,3578731192,3
1,998,18007,3578731189,3578731193,4
1,998,18008,3578731189,3578731194,5
1,998,18009,3578731189,3578731196,7
1,998,18010,3578731189,3578731196,7
1,998,18011,3578731189,3578731197,8
1,998,18012,3578731189,3578731197,8
1,998,18013,3578731189,3578731198,9
1,998,18014,3578731189,3578731199,10
1,998,18015,3578731189,3578731199,10
1,998,18016,3578731189,3578731200,11
1,998,18017,3578731189,3578731201,12
1,998,18018,3578731189,3578731202,13
1,998,18019,3578731189,3578731204,15
1,998,18020,3578731189,3578731205,16
1,998,18021,3578731189,3578731207,18
1,998,18022,3578731189,3578731212,23
1,998,18023,3578731189,3578731214,25
1,998,18024,3578731189,3578731215,26
1,998,18025,3578731189,3578731215,26
1,998,18026,3578731189,3578731216,27
1,998,18027,3578731189,3578731216,27
1,998,18028,3578731189,3578731217,28
1,998,18029,3578731189,3578731217,28
1,998,18030,3578731189,3578731217,28
1,998,18031,3578731189,3578731218,29
1,998,18032,3578731189,3578731218,29
1,998,18033,3578731189,3578731219,30
1,998,18034,3578731189,3578731219,30
1,998,18035,3578731189,3578731221,32
1,998,18036,3578731189,3578731224,35
1,998,18037,3578731189,3578731224,35
1,998,18038,3578731189,3578731225,36
1,998,18039,3578731189,3578731225,36
1,998,18040,3578731189,3578731227,38
1,998,18041,3578731189,3578731227,38
1,998,18042,3578731189,3578731229,40
1,998,18043,3578731189,3578731230,41
1,998,18044,3578731189,3578731231,42
1,998,18045,3578731189,3578731233,44
1,998,18046,3578731189,3578731234,45
1,998,18047,3578731189,3578731236,47
1,998,18048,3578731189,3578731237,48
1,998,18049,3578731189,3578731237,48
1,999,18050,3578731247,3578731247,0
1,999,18051,3578731247,3578731247,0
1,999,18052,3578731247,3578731247,0
1,999,18053,3578731247,3578731247,0
1,999,18054,3578731247,3578731247,0
1,999,18055,3578731247,3578731247,0
1,999,18056,3578731247,3578731252,5
1,999,18057,3578731247,3578731252,5
1,999,18058,3578731247,3578731254,7
1,999,18059,3578731247,3578731254,7
1,999,18060,3578731247,3578731256,9
1,999,18061,3578731247,3578731257,10
1,999,18062,3578731247,3578731258,11
1,999,18063,3578731247,3578731260,13
1,999,18064,3578731247,3578731264,17
1,999,18065,3578731247,3578731264,17
1,999,18066,3578731247,3578731265,18
1,999,18067,3578731247,3578731265,18
1,999,18068,3578731247,3578731265,18
1,999,18069,3578731247,3578731266,19
1,999,18070,3578731247,3578731266,19
1,999,18071,3578731247,3578731268,21
1,999,18072,3578731247,3578731268,21
1,999,18073,3578731247,3578731269,22
1,999,18074,3578731247,3578731269,22
1,999,18075,3578731247,3578731270,23
1,999,18076,3578731247,3578731285,38
1,999,18077,3578731247,3578731286,39
1,999,18078,3578731247,3578731287,40
1,999,18079,3578731247,3578731287,40
1,999,18080,3578731247,3578731288,41
1,999,18081,3578731247,3578731292,45
1,999,18082,3578731247,3578731295,48
1,999,18083,3578731247,3578731296,49
1,1000,18084,3578731305,3578731305,0
1,1000,18085,3578731305,3578731305,0
1,1000,18086,3578731305,3578731305,0
1,1000,18087,3578731305,3578731305,0
1,1000,18088,3578731305,3578731305,0
1,1000,18089,3578731305,3578731305,0
1,1000,18090,3578731305,3578731305,0
1,1000,18091,3578731305,3578731305,0
1,1000,18092,3578731305,3578731307,2
1,1000,18093,3578731305,3578731307,2
1,1000,18094,3578731305,3578731309,4
1,1000,18095,3578731305,3578731309,4
1,1000,18096,3578731305,3578731312,7
1,1000,18097,3578731305,3578731314,9
1,1000,18098,3578731305,3578731314,9
1,1000,18099,3578731305,3578731314,9
1,1000,18100,3578731305,3578731315,10
1,1000,18101,3578731305,3578731316,11
1,1000,18102,3578731305,3578731317,12
1,1000,18103,3578731305,3578731318,13
1,1000,18104,3578731305,3578731319,14
1,1000,18105,3578731305,3578731319,14
1,1000,18106,3578731305,3578731320,15
1,1000,18107,3578731305,3578731321,16
1,1000,18108,3578731305,3578731322,17
1,1000,18109,3578731305,3578731322,17
1,1000,18110,3578731305,3578731323,18
1,1000,18111,3578731305,3578731323,18
1,1000,18112,3578731305,3578731324,19
1,1000,18113,3578731305,3578731325,20
1,1000,18114,3578731305,3578731325,20
1,1000,18115,3578731305,3578731325,20
1,1000,18116,3578731305,3578731326,21
1,1000,18117,3578731305,3578731328,23
1,1000,18118,3578731305,3578731329,24
1,1000,18119,3578731305,3578731329,24
1,1000,18120,3578731305,3578731330,25
1,1000,18121,3578731305,3578731330,25
1,1000,18122,3578731305,3578731330,25
1,1000,18123,3578731305,3578731331,26
1,1000,18124,3578731305,3578731331,26
1,1000,18125,3578731305,3578731333,28
1,1000,18126,3578731305,3578731334,29
1,1000,18127,3578731305,3578731334,29
1,1000,18128,3578731305,3578731335,30
1,1000,18129,3578731305,3578731336,31
1,1000,18130,3578731305,3578731337,32
1,1000,18131,3578731305,3578731339,34
1,1000,18132,3578731305,3578731340,35
1,1000,18133,3578731305,3578731340,35
1,1000,18134,3578731305,3578731344,39
1,1000,18135,3578731305,3578731345,40
1,1000,18136,3578731305,3578731346,41
1,1000,18137,3578731305,3578731350,45
1,1000,18138,3578731305,3578731351,46
1,1000,18139,3578731305,3578731352,47
1,1000,18140,3578731305,3578731352,47
1,1000,18141,3578731305,3578731353,48
1,1000,18142,3578731305,3578731355,50
1,1001,18143,3578731364,3578731364,0
1,1001,18144,3578731364,3578731364,0
1,1001,18145,3578731364,3578731364,0
1,1001,18146,3578731364,3578731364,0
1,1001,18147,3578731364,3578731364,0
1,1001,18148,3578731364,3578731364,0
1,1001,18149,3578731364,3578731364,0
1,1001,18150,3578731364,3578731364,0
1,1001,18151,3578731364,3578731364,0
1,1001,18152,3578731364,3578731366,2
1,1001,18153,3578731364,3578731367,3
1,1001,18154,3578731364,3578731370,6
1,1001,18155,3578731364,3578731371,7
1,1001,18156,3578731364,3578731374,10
1,1001,18157,3578731364,3578731376,12
1,1001,18158,3578731364,3578731376,12
1,1001,18159,3578731364,3578731377,13
1,1001,18160,3578731364,3578731379,15
1,1001,18161,3578731364,3578731379,15
1,1001,18162,3578731364,3578731381,17
1,1001,18163,3578731364,3578731381,17
1,1001,18164,3578731364,3578731382,18
1,1001,18165,3578731364,3578731383,19
1,1001,18166,3578731364,3578731386,22
1,1001,18167,3578731364,3578731386,22
1,1001,18168,3578731364,3578731391,27
1,1001,18169,3578731364,3578731391,27
1,1001,18170,3578731364,3578731391,27
1,1001,18171,3578731364,3578731393,29
1,1001,18172,3578731364,3578731394,30
1,1001,18173,3578731364,3578731395,31
1,1001,18174,3578731364,3578731396,32
1,1001,18175,3578731364,3578731397,33
1,1001,18176,3578731364,3578731397,33
1,1001,18177,3578731364,3578731397,33
1,1001,18178,3578731364,3578731398,34
1,1001,18179,3578731364,3578731399,35
1,1001,18180,3578731364,3578731399,35
1,1001,18181,3578731364,3578731400,36
1,1001,18182,3578731364,3578731400,36
1,1001,18183,3578731364,3578731401,37
1,1001,18184,3578731364,3578731401,37
1,1001,18185,3578731364,3578731405,41
1,1001,18186,3578731364,3578731405,41
1,1001,18187,3578731364,3578731412,48
1,1001,18188,3578731364,3578731412,48
1,1002,18189,3578731423,3578731423,0
1,1002,18190,3578731423,3578731424,1
1,1002,18191,3578731423,3578731424,1
1,1002,18192,3578731423,3578731424,1
1,1002,18193,3578731423,3578731424,1
1,1002,18194,3578731423,3578731424,1
1,1002,18195,3578731423,3578731424,1
1,1002,18196,3578731423,3578731424,1
1,1002,18197,3578731423,3578731424,1
1,1002,18198,3578731423,3578731424,1
1,1002,18199,3578731423,3578731424,1
1,1002,18200,3578731423,3578731424,1
1,1002,18201,3578731423,3578731424,1
1,1002,18202,3578731423,3578731424,1
1,1002,18203,3578731423,3578731425,2
1,1002,18204,3578731423,3578731425,2
1,1002,18205,3578731423,3578731425,2
1,1002,18206,3578731423,3578731427,4
1,1002,18207,3578731423,3578731428,5
1,1002,18208,3578731423,3578731429,6
1,1002,18209,3578731423,3578731429,6
1,1002,18210,3578731423,3578731429,6
1,1002,18211,3578731423,3578731431,8
1,1002,18212,3578731423,3578731433,10
1,1002,18213,3578731423,3578731434,11
1,1002,18214,3578731423,3578731434,11
1,1002,18215,3578731423,3578731437,14
1,1002,18216,3578731423,3578731437,14
1,1002,18217,3578731423,3578731439,16
1,1002,18218,3578731423,3578731440,17
1,1002,18219,3578731423,3578731440,17
1,1002,18220,3578731423,3578731440,17
1,1002,18221,3578731423,3578731443,20
1,1002,18222,3578731423,3578731446,23
1,1002,18223,3578731423,3578731446,23
1,1002,18224,3578731423,3578731447,24
1,1002,18225,3578731423,3578731448,25
1,1002,18226,3578731423,3578731452,29
1,1002,18227,3578731423,3578731452,29
1,1002,18228,3578731423,3578731454,31
1,1002,18229,3578731423,3578731455,32
1,1002,18230,3578731423,3578731456,33
1,1002,18231,3578731423,3578731456,33
1,1002,18232,3578731423,3578731457,34
1,1002,18233,3578731423,3578731458,35
1,1002,18234,3578731423,3578731459,36
1,1002,18235,3578731423,3578731463,40
1,1002,18236,3578731423,3578731465,42
1,1002,18237,3578731423,3578731465,42
1,1002,18238,3578731423,3578731465,42
1,1002,18239,3578731423,3578731465,42
1,1002,18240,3578731423,3578731466,43
1,1002,18241,3578731423,3578731467,44
1,1002,18242,3578731423,3578731468,45
1,1002,18243,3578731423,3578731469,46
1,1002,18244,3578731423,3578731469,46
1,1002,18245,3578731423,3578731470,47
1,1002,18246,3578731423,3578731470,47
1,1003,18247,3578731485,3578731485,0
1,1003,18248,3578731485,3578731485,0
1,1003,18249,3578731485,3578731485,0
1,1003,18250,3578731485,3578731486,1
1,1003,18251,3578731485,3578731486,1
1,1003,18252,3578731485,3578731492,7
1,1003,18253,3578731485,3578731493,8
1,1003,18254,3578731485,3578731495,10
1,1003,18255,3578731485,3578731496,11
1,1003,18256,3578731485,3578731496,11
1,1003,18257,3578731485,3578731497,12
1,1003,18258,3578731485,3578731499,14
1,1003,18259,3578731485,3578731500,15
1,1003,18260,3578731485,3578731500,15
1,1003,18261,3578731485,3578731500,15
1,1003,18262,3578731485,3578731501,16
1,1003,18263,3578731485,3578731502,17
1,1003,18264,3578731485,3578731505,20
1,1003,18265,3578731485,3578731506,21
1,1003,18266,3578731485,3578731506,21
1,1003,18267,3578731485,3578731506,21
1,1003,18268,3578731485,3578731508,23
1,1003,18269,3578731485,3578731508,23
1,1003,18270,3578731485,3578731508,23
1,1003,18271,3578731485,3578731511,26
1,1003,18272,3578731485,3578731512,27
1,1003,18273,3578731485,3578731513,28
1,1003,18274,3578731485,3578731513,28
1,1003,18275,3578731485,3578731513,28
1,1003,18276,3578731485,3578731516,31
1,1003,18277,3578731485,3578731516,31
1,1003,18278,3578731485,3578731517,32
1,1003,18279,3578731485,3578731518,33
1,1003,18280,3578731485,3578731518,33
1,1003,18281,3578731485,3578731520,35
1,1003,18282,3578731485,3578731521,36
1,1003,18283,3578731485,3578731522,37
1,1003,18284,3578731485,3578731522,37
1,1003,18285,3578731485,3578731523,38
1,1003,18286,3578731485,3578731524,39
1,1003,18287,3578731485,3578731524,39
1,1003,18288,3578731485,3578731524,39
1,1003,18289,3578731485,3578731526,41
1,1003,18290,3578731485,3578731526,41
1,1003,18291,3578731485,3578731528,43
1,1003,18292,3578731485,3578731528,43
1,1003,18293,3578731485,3578731528,43
1,1003,18294,3578731485,3578731530,45
1,1003,18295,3578731485,3578731530,45
1,1003,18296,3578731485,3578731530,45
1,1003,18297,3578731485,3578731530,45
1,1003,18298,3578731485,3578731532,47
1,1003,18299,3578731485,3578731533,48
1,1003,18300,3578731485,3578731533,48
1,1003,18301,3578731485,3578731534,49
1,1004,18302,3578731543,3578731543,0
1,1004,18303,3578731543,3578731543,0
1,1004,18304,3578731543,3578731543,0
1,1004,18305,3578731543,3578731543,0
1,1004,18306,3578731543,3578731543,0
1,1004,18307,3578731543,3578731545,2
1,1004,18308,3578731543,3578731545,2
1,1004,18309,3578731543,3578731549,6
1,1004,18310,3578731543,3578731550,7
1,1004,18311,3578731543,3578731551,8
1,1004,18312,3578731543,3578731552,9
1,1004,18313,3578731543,3578731553,10
1,1004,18314,3578731543,3578731556,13
1,1004,18315,3578731543,3578731557,14
1,1004,18316,3578731543,3578731557,14
1,1004,18317,3578731543,3578731559,16
1,1004,18318,3578731543,3578731560,17
1,1004,18319,3578731543,3578731561,18
1,1004,18320,3578731543,3578731562,19
1,1004,18321,3578731543,3578731563,20
1,1004,18322,3578731543,3578731565,22
1,1004,18323,3578731543,3578731565,22
1,1004,18324,3578731543,3578731566,23
1,1004,18325,3578731543,3578731571,28
1,1004,18326,3578731543,3578731572,29
1,1004,18327,3578731543,3578731574,31
1,1004,18328,3578731543,3578731575,32
1,1004,18329,3578731543,3578731577,34
1,1004,18330,3578731543,3578731578,35
1,1004,18331,3578731543,3578731579,36
1,1004,18332,3578731543,3578731580,37
1,1004,18333,3578731543,3578731581,38
1,1004,18334,3578731543,3578731581,38
1,1004,18335,3578731543,3578731582,39
1,1004,18336,3578731543,3578731583,40
1,1004,18337,3578731543,3578731585,42
1,1004,18338,3578731543,3578731586,43
1,1004,18339,3578731543,3578731590,47
1,1004,18340,3578731543,3578731590,47
1,1004,18341,3578731543,3578731591,48
1,1004,18342,3578731543,3578731592,49
1,1004,18343,3578731543,3578731592,49
1,1005,18344,3578731602,3578731602,0
1,1005,18345,3578731602,3578731602,0
1,1005,18346,3578731602,3578731602,0
1,1005,18347,3578731602,3578731602,0
1,1005,18348,3578731602,3578731602,0
1,1005,18349,3578731602,3578731602,0
1,1005,18350,3578731602,3578731602,0
1,1005,18351,3578731602,3578731602,0
1,1005,18352,3578731602,3578731602,0
1,1005,18353,3578731602,3578731602,0
1,1005,18354,3578731602,3578731602,0
1,1005,18355,3578731602,3578731605,3
1,1005,18356,3578731602,3578731606,4
1,1005,18357,3578731602,3578731611,9
1,1005,18358,3578731602,3578731613,11
1,1005,18359,3578731602,3578731615,13
1,1005,18360,3578731602,3578731615,13
1,1005,18361,3578731602,3578731616,14
1,1005,18362,3578731602,3578731616,14
1,1005,18363,3578731602,3578731617,15
1,1005,18364,3578731602,3578731618,16
1,1005,18365,3578731602,3578731618,16
1,1005,18366,3578731602,3578731619,17
1,1005,18367,3578731602,3578731619,17
1,1005,18368,3578731602,3578731620,18
1,1005,18369,3578731602,3578731624,22
1,1005,18370,3578731602,3578731624,22
1,1005,18371,3578731602,3578731624,22
1,1005,18372,3578731602,3578731624,22
1,1005,18373,3578731602,3578731625,23
1,1005,18374,3578731602,3578731627,25
1,1005,18375,3578731602,3578731627,25
1,1005,18376,3578731602,3578731627,25
1,1005,18377,3578731602,3578731630,28
1,1005,18378,3578731602,3578731631,29
1,1005,18379,3578731602,3578731633,31
1,1005,18380,3578731602,3578731634,32
1,1005,18381,3578731602,3578731635,33
1,1005,18382,3578731602,3578731636,34
1,1005,18383,3578731602,3578731636,34
1,1005,18384,3578731602,3578731638,36
1,1005,18385,3578731602,3578731639,37
1,1005,18386,3578731602,3578731639,37
1,1005,18387,3578731602,3578731643,41
1,1005,18388,3578731602,3578731645,43
1,1005,18389,3578731602,3578731645,43
1,1005,18390,3578731602,3578731647,45
1,1005,18391,3578731602,3578731651,49
1,1006,18392,3578731660,3578731660,0
1,1006,18393,3578731660,3578731660,0
1,1006,18394,3578731660,3578731660,0
1,1006,18395,3578731660,3578731660,0
1,1006,18396,3578731660,3578731660,0
1,1006,18397,3578731660,3578731662,2
1,1006,18398,3578731660,3578731664,4
1,1006,18399,3578731660,3578731664,4
1,1006,18400,3578731660,3578731664,4
1,1006,18401,3578731660,3578731665,5
1,1006,18402,3578731660,3578731665,5
1,1006,18403,3578731660,3578731665,5
1,1006,18404,3578731660,3578731666,6
1,1006,18405,3578731660,3578731667,7
1,1006,18406,3578731660,3578731668,8
1,1006,18407,3578731660,3578731669,9
1,1006,18408,3578731660,3578731669,9
1,1006,18409,3578731660,3578731669,9
1,1006,18410,3578731660,3578731669,9
1,1006,18411,3578731660,3578731683,23
1,1006,18412,3578731660,3578731684,24
1,1006,18413,3578731660,3578731685,25
1,1006,18414,3578731660,3578731685,25
1,1006,18415,3578731660,3578731685,25
1,1006,18416,3578731660,3578731686,26
1,1006,18417,3578731660,3578731693,33
1,1006,18418,3578731660,3578731693,33
1,1006,18419,3578731660,3578731695,35
1,1006,18420,3578731660,3578731696,36
1,1006,18421,3578731660,3578731696,36
1,1006,18422,3578731660,3578731696,36
1,1006,18423,3578731660,3578731697,37
1,1006,18424,3578731660,3578731699,39
1,1006,18425,3578731660,3578731699,39
1,1006,18426,3578731660,3578731701,41
1,1006,18427,3578731660,3578731701,41
1,1006,18428,3578731660,3578731701,41
1,1006,18429,3578731660,3578731702,42
1,1006,18430,3578731660,3578731705,45
1,1006,18431,3578731660,3578731706,46
1,1006,18432,3578731660,3578731706,46
1,1006,18433,3578731660,3578731707,47
1,1006,18434,3578731660,3578731709,49
1,1007,18435,3578731718,3578731718,0
1,1007,18436,3578731718,3578731718,0
1,1007,18437,3578731718,3578731718,0
1,1007,18438,3578731718,3578731718,0
1,1007,18439,3578731718,3578731718,0
1,1007,18440,3578731718,3578731718,0
1,1007,18441,3578731718,3578731718,0
1,1007,18442,3578731718,3578731718,0
1,1007,18443,3578731718,3578731718,0
1,1007,18444,3578731718,3578731718,0
1,1007,18445,3578731718,3578731721,3
1,1007,18446,3578731718,3578731721,3
1,1007,18447,3578731718,3578731721,3
1,1007,18448,3578731718,3578731722,4
1,1007,18449,3578731718,3578731723,5
1,1007,18450,3578731718,3578731723,5
1,1007,18451,3578731718,3578731724,6
1,1007,18452,3578731718,3578731725,7
1,1007,18453,3578731718,3578731726,8
1,1007,18454,3578731718,3578731726,8
1,1007,18455,3578731718,3578731727,9
1,1007,18456,3578731718,3578731728,10
1,1007,18457,3578731718,3578731728,10
1,1007,18458,3578731718,3578731728,10
1,1007,18459,3578731718,3578731730,12
1,1007,18460,3578731718,3578731730,12
1,1007,18461,3578731718,3578731731,13
1,1007,18462,3578731718,3578731731,13
1,1007,18463,3578731718,3578731731,13
1,1007,18464,3578731718,3578731732,14
1,1007,18465,3578731718,3578731733,15
1,1007,18466,3578731718,3578731734,16
1,1007,18467,3578731718,3578731736,18
1,1007,18468,3578731718,3578731736,18
1,1007,18469,3578731718,3578731739,21
1,1007,18470,3578731718,3578731739,21
1,1007,18471,3578731718,3578731740,22
1,1007,18472,3578731718,3578731742,24
1,1007,18473,3578731718,3578731743,25
1,1007,18474,3578731718,3578731745,27
1,1007,18475,3578731718,3578731749,31
1,1007,18476,3578731718,3578731750,32
1,1007,18477,3578731718,3578731751,33
1,1007,18478,3578731718,3578731752,34
1,1007,18479,3578731718,3578731752,34
1,1007,18480,3578731718,3578731752,34
1,1007,18481,3578731718,3578731755,37
1,1007,18482,3578731718,3578731756,38
1,1007,18483,3578731718,3578731756,38
1,1007,18484,3578731718,3578731757,39
1,1007,18485,3578731718,3578731758,40
1,1007,18486,3578731718,3578731759,41
1,1007,18487,3578731718,3578731761,43
1,1007,18488,3578731718,3578731762,44
1,1007,18489,3578731718,3578731762,44
1,1007,18490,3578731718,3578731762,44
1,1007,18491,3578731718,3578731765,47
1,1007,18492,3578731718,3578731766,48
1,1007,18493,3578731718,3578731766,48
1,1008,18494,3578731776,3578731776,0
1,1008,18495,3578731776,3578731776,0
1,1008,18496,3578731776,3578731776,0
1,1008,18497,3578731776,3578731776,0
1,1008,18498,3578731776,3578731776,0
1,1008,18499,3578731776,3578731776,0
1,1008,18500,3578731776,3578731776,0
1,1008,18501,3578731776,3578731777,1
1,1008,18502,3578731776,3578731779,3
1,1008,18503,3578731776,3578731781,5
1,1008,18504,3578731776,3578731781,5
1,1008,18505,3578731776,3578731782,6
1,1008,18506,3578731776,3578731784,8
1,1008,18507,3578731776,3578731785,9
1,1008,18508,3578731776,3578731785,9
1,1008,18509,3578731776,3578731789,13
1,1008,18510,3578731776,3578731790,14
1,1008,18511,3578731776,3578731791,15
1,1008,18512,3578731776,3578731792,16
1,1008,18513,3578731776,3578731793,17
1,1008,18514,3578731776,3578731794,18
1,1008,18515,3578731776,3578731795,19
1,1008,18516,3578731776,3578731796,20
1,1008,18517,3578731776,3578731796,20
1,1008,18518,3578731776,3578731797,21
1,1008,18519,3578731776,3578731798,22
1,1008,18520,3578731776,3578731799,23
1,1008,18521,3578731776,3578731800,24
1,1008,18522,3578731776,3578731800,24
1,1008,18523,3578731776,3578731801,25
1,1008,18524,3578731776,3578731801,25
1,1008,18525,3578731776,3578731804,28
1,1008,18526,3578731776,3578731805,29
1,1008,18527,3578731776,3578731806,30
1,1008,18528,3578731776,3578731811,35
1,1008,18529,3578731776,3578731811,35
1,1008,18530,3578731776,3578731813,37
1,1008,18531,3578731776,3578731815,39
1,1008,18532,3578731776,3578731815,39
1,1008,18533,3578731776,3578731816,40
1,1008,18534,3578731776,3578731817,41
1,1008,18535,3578731776,3578731818,42
1,1008,18536,3578731776,3578731818,42
1,1008,18537,3578731776,3578731819,43
1,1008,18538,3578731776,3578731819,43
1,1008,18539,3578731776,3578731819,43
1,1008,18540,3578731776,3578731820,44
1,1008,18541,3578731776,3578731822,46
1,1008,18542,3578731776,3578731824,48
1,1008,18543,3578731776,3578731824,48
1,1008,18544,3578731776,3578731824,48
1,1008,18545,3578731776,3578731825,49
1,1008,18546,3578731776,3578731825,49
1,1009,18547,3578731836,3578731836,0
1,1009,18548,3578731836,3578731836,0
1,1009,18549,3578731836,3578731836,0
1,1009,18550,3578731836,3578731836,0
1,1009,18551,3578731836,3578731836,0
1,1009,18552,3578731836,3578731836,0
1,1009,18553,3578731836,3578731836,0
1,1009,18554,3578731836,3578731836,0
1,1009,18555,3578731836,3578731836,0
1,1009,18556,3578731836,3578731836,0
1,1009,18557,3578731836,3578731838,2
1,1009,18558,3578731836,3578731839,3
1,1009,18559,3578731836,3578731839,3
1,1009,18560,3578731836,3578731839,3
1,1009,18561,3578731836,3578731843,7
1,1009,18562,3578731836,3578731845,9
1,1009,18563,3578731836,3578731847,11
1,1009,18564,3578731836,3578731848,12
1,1009,18565,3578731836,3578731850,14
1,1009,18566,3578731836,3578731852,16
1,1009,18567,3578731836,3578731853,17
1,1009,18568,3578731836,3578731854,18
1,1009,18569,3578731836,3578731855,19
1,1009,18570,3578731836,3578731857,21
1,1009,18571,3578731836,3578731857,21
1,1009,18572,3578731836,3578731859,23
1,1009,18573,3578731836,3578731861,25
1,1009,18574,3578731836,3578731863,27
1,1009,18575,3578731836,3578731864,28
1,1009,18576,3578731836,3578731864,28
1,1009,18577,3578731836,3578731864,28
1,1009,18578,3578731836,3578731865,29
1,1009,18579,3578731836,3578731865,29
1,1009,18580,3578731836,3578731865,29
1,1009,18581,3578731836,3578731867,31
1,1009,18582,3578731836,3578731867,31
1,1009,18583,3578731836,3578731868,32
1,1009,18584,3578731836,3578731868,32
1,1009,18585,3578731836,3578731869,33
1,1009,18586,3578731836,3578731869,33
1,1009,18587,3578731836,3578731873,37
1,1009,18588,3578731836,3578731884,48
1,1009,18589,3578731836,3578731884,48
1,1009,18590,3578731836,3578731885,49
1,1009,18591,3578731836,3578731886,50
1,1010,18592,3578731894,3578731894,0
1,1010,18593,3578731894,3578731894,0
1,1010,18594,3578731894,3578731894,0
1,1010,18595,3578731894,3578731895,1
1,1010,18596,3578731894,3578731896,2
1,1010,18597,3578731894,3578731896,2
1,1010,18598,3578731894,3578731896,2
1,1010,18599,3578731894,3578731897,3
1,1010,18600,3578731894,3578731901,7
1,1010,18601,3578731894,3578731902,8
1,1010,18602,3578731894,3578731903,9
1,1010,18603,3578731894,3578731905,11
1,1010,18604,3578731894,3578731906,12
1,1010,18605,3578731894,3578731907,13
1,1010,18606,3578731894,3578731907,13
1,1010,18607,3578731894,3578731910,16
1,1010,18608,3578731894,3578731911,17
1,1010,18609,3578731894,3578731912,18
1,1010,18610,3578731894,3578731913,19
1,1010,18611,3578731894,3578731913,19
1,1010,18612,3578731894,3578731914,20
1,1010,18613,3578731894,3578731915,21
1,1010,18614,3578731894,3578731916,22
1,1010,18615,3578731894,3578731916,22
1,1010,18616,3578731894,3578731917,23
1,1010,18617,3578731894,3578731917,23
1,1010,18618,3578731894,3578731918,24
1,1010,18619,3578731894,3578731921,27
1,1010,18620,3578731894,3578731922,28
1,1010,18621,3578731894,3578731922,28
1,1010,18622,3578731894,3578731922,28
1,1010,18623,3578731894,3578731923,29
1,1010,18624,3578731894,3578731924,30
1,1010,18625,3578731894,3578731924,30
1,1010,18626,3578731894,3578731924,30
1,1010,18627,3578731894,3578731925,31
1,1010,18628,3578731894,3578731926,32
1,1010,18629,3578731894,3578731926,32
1,1010,18630,3578731894,3578731928,34
1,1010,18631,3578731894,3578731928,34
1,1010,18632,3578731894,3578731929,35
1,1010,18633,3578731894,3578731929,35
1,1010,18634,3578731894,3578731930,36
1,1010,18635,3578731894,3578731930,36
1,1010,18636,3578731894,3578731931,37
1,1010,18637,3578731894,3578731931,37
1,1010,18638,3578731894,3578731931,37
1,1010,18639,3578731894,3578731932,38
1,1010,18640,3578731894,3578731933,39
1,1010,18641,3578731894,3578731933,39
1,1010,18642,3578731894,3578731934,40
1,1010,18643,3578731894,3578731936,42
1,1010,18644,3578731894,3578731936,42
1,1010,18645,3578731894,3578731939,45
1,1010,18646,3578731894,3578731940,46
1,1010,18647,3578731894,3578731943,49
1,1011,18648,3578731954,3578731954,0
1,1011,18649,3578731954,3578731954,0
1,1011,18650,3578731954,3578731954,0
1,1011,18651,3578731954,3578731955,1
1,1011,18652,3578731954,3578731955,1
1,1011,18653,3578731954,3578731955,1
1,1011,18654,3578731954,3578731955,1
1,1011,18655,3578731954,3578731956,2
1,1011,18656,3578731954,3578731956,2
1,1011,18657,3578731954,3578731957,3
1,1011,18658,3578731954,3578731957,3
1,1011,18659,3578731954,3578731959,5
1,1011,18660,3578731954,3578731961,7
1,1011,18661,3578731954,3578731961,7
1,1011,18662,3578731954,3578731962,8
1,1011,18663,3578731954,3578731963,9
1,1011,18664,3578731954,3578731965,11
1,1011,18665,3578731954,3578731966,12
1,1011,18666,3578731954,3578731966,12
1,1011,18667,3578731954,3578731971,17
1,1011,18668,3578731954,3578731972,18
1,1011,18669,3578731954,3578731973,19
1,1011,18670,3578731954,3578731975,21
1,1011,18671,3578731954,3578731976,22
1,1011,18672,3578731954,3578731977,23
1,1011,18673,3578731954,3578731978,24
1,1011,18674,3578731954,3578731981,27
1,1011,18675,3578731954,3578731981,27
1,1011,18676,3578731954,3578731982,28
1,1011,18677,3578731954,3578731983,29
1,1011,18678,3578731954,3578731984,30
1,1011,18679,3578731954,3578731985,31
1,1011,18680,3578731954,3578731986,32
1,1011,18681,3578731954,3578731987,33
1,1011,18682,3578731954,3578731989,35
1,1011,18683,3578731954,3578731991,37
1,1011,18684,3578731954,3578731991,37
1,1011,18685,3578731954,3578731992,38
1,1011,18686,3578731954,3578731993,39
1,1011,18687,3578731954,3578731995,41
1,1011,18688,3578731954,3578731996,42
1,1011,18689,3578731954,3578731997,43
1,1011,18690,3578731954,3578731998,44
1,1011,18691,3578731954,3578731999,45
1,1011,18692,3578731954,3578731999,45
1,1011,18693,3578731954,3578731999,45
1,1011,18694,3578731954,3578732000,46
1,1011,18695,3578731954,3578732001,47
1,1011,18696,3578731954,3578732002,48
1,1011,18697,3578731954,3578732004,50
1,1012,18698,3578732013,3578732013,0
1,1012,18699,3578732013,3578732013,0
1,1012,18700,3578732013,3578732013,0
1,1012,18701,3578732013,3578732014,1
1,1012,18702,3578732013,3578732015,2
1,1012,18703,3578732013,3578732016,3
1,1012,18704,3578732013,3578732016,3
1,1012,18705,3578732013,3578732016,3
1,1012,18706,3578732013,3578732016,3
1,1012,18707,3578732013,3578732018,5
1,1012,18708,3578732013,3578732018,5
1,1012,18709,3578732013,3578732019,6
1,1012,18710,3578732013,3578732020,7
1,1012,18711,3578732013,3578732020,7
1,1012,18712,3578732013,3578732020,7
1,1012,18713,3578732013,3578732024,11
1,1012,18714,3578732013,3578732024,11
1,1012,18715,3578732013,3578732024,11
1,1012,18716,3578732013,3578732025,12
1,1012,18717,3578732013,3578732025,12
1,1012,18718,3578732013,3578732027,14
1,1012,18719,3578732013,3578732028,15
1,1012,18720,3578732013,3578732028,15
1,1012,18721,3578732013,3578732029,16
1,1012,18722,3578732013,3578732033,20
1,1012,18723,3578732013,3578732034,21
1,1012,18724,3578732013,3578732036,23
1,1012,18725,3578732013,3578732036,23
1,1012,18726,3578732013,3578732037,24
1,1012,18727,3578732013,3578732038,25
1,1012,18728,3578732013,3578732039,26
1,1012,18729,3578732013,3578732040,27
1,1012,18730,3578732013,3578732043,30
1,1012,18731,3578732013,3578732045,32
1,1012,18732,3578732013,3578732046,33
1,1012,18733,3578732013,3578732048,35
1,1012,18734,3578732013,3578732050,37
1,1012,18735,3578732013,3578732053,40
1,1012,18736,3578732013,3578732054,41
1,1012,18737,3578732013,3578732057,44
1,1012,18738,3578732013,3578732057,44
1,1012,18739,3578732013,3578732057,44
1,1012,18740,3578732013,3578732060,47
1,1013,18741,3578732072,3578732072,0
1,1013,18742,3578732072,3578732072,0
1,1013,18743,3578732072,3578732072,0
1,1013,18744,3578732072,3578732072,0
1,1013,18745,3578732072,3578732072,0
1,1013,18746,3578732072,3578732072,0
1,1013,18747,3578732072,3578732072,0
1,1013,18748,3578732072,3578732072,0
1,1013,18749,3578732072,3578732072,0
1,1013,18750,3578732072,3578732072,0
1,1013,18751,3578732072,3578732072,0
1,1013,18752,3578732072,3578732072,0
1,1013,18753,3578732072,3578732072,0
1,1013,18754,3578732072,3578732084,12
1,1013,18755,3578732072,3578732085,13
1,1013,18756,3578732072,3578732085,13
1,1013,18757,3578732072,3578732085,13
1,1013,18758,3578732072,3578732086,14
1,1013,18759,3578732072,3578732093,21
1,1013,18760,3578732072,3578732093,21
1,1013,18761,3578732072,3578732095,23
1,1013,18762,3578732072,3578732096,24
1,1013,18763,3578732072,3578732097,25
1,1013,18764,3578732072,3578732098,26
1,1013,18765,3578732072,3578732100,28
1,1013,18766,3578732072,3578732101,29
1,1013,18767,3578732072,3578732102,30
1,1013,18768,3578732072,3578732103,31
1,1013,18769,3578732072,3578732105,33
1,1013,18770,3578732072,3578732106,34
1,1013,18771,3578732072,3578732106,34
1,1013,18772,3578732072,3578732110,38
1,1013,18773,3578732072,3578732112,40
1,1013,18774,3578732072,3578732113,41
1,1013,18775,3578732072,3578732113,41
1,1013,18776,3578732072,3578732113,41
1,1013,18777,3578732072,3578732115,43
1,1013,18778,3578732072,3578732116,44
1,1013,18779,3578732072,3578732116,44
1,1013,18780,3578732072,3578732116,44
1,1013,18781,3578732072,3578732117,45
1,1013,18782,3578732072,3578732117,45
1,1013,18783,3578732072,3578732120,48
1,1013,18784,3578732072,3578732121,49
1,1013,18785,3578732072,3578732122,50
1,1014,18786,3578732129,3578732129,0
1,1014,18787,3578732129,3578732129,0
1,1014,18788,3578732129,3578732129,0
1,1014,18789,3578732129,3578732129,0
1,1014,18790,3578732129,3578732129,0
1,1014,18791,3578732129,3578732129,0
1,1014,18792,3578732129,3578732129,0
1,1014,18793,3578732129,3578732129,0
1,1014,18794,3578732129,3578732129,0
1,1014,18795,3578732129,3578732129,0
1,1014,18796,3578732129,3578732129,0
1,1014,18797,3578732129,3578732129,0
1,1014,18798,3578732129,3578732130,1
1,1014,18799,3578732129,3578732130,1
1,1014,18800,3578732129,3578732131,2
1,1014,18801,3578732129,3578732131,2
1,1014,18802,3578732129,3578732132,3
1,1014,18803,3578732129,3578732132,3
1,1014,18804,3578732129,3578732133,4
1,1014,18805,3578732129,3578732133,4
1,1014,18806,3578732129,3578732133,4
1,1014,18807,3578732129,3578732134,5
1,1014,18808,3578732129,3578732136,7
1,1014,18809,3578732129,3578732139,10
1,1014,18810,3578732129,3578732140,11
1,1014,18811,3578732129,3578732141,12
1,1014,18812,3578732129,3578732143,14
1,1014,18813,3578732129,3578732146,17
1,1014,18814,3578732129,3578732150,21
1,1014,18815,3578732129,3578732151,22
1,1014,18816,3578732129,3578732152,23
1,1014,18817,3578732129,3578732154,25
1,1014,18818,3578732129,3578732155,26
1,1014,18819,3578732129,3578732156,27
1,1014,18820,3578732129,3578732156,27
1,1014,18821,3578732129,3578732156,27
1,1014,18822,3578732129,3578732157,28
1,1014,18823,3578732129,3578732158,29
1,1014,18824,3578732129,3578732159,30
1,1014,18825,3578732129,3578732162,33
1,1014,18826,3578732129,3578732162,33
1,1014,18827,3578732129,3578732162,33
1,1014,18828,3578732129,3578732163,34
1,1014,18829,3578732129,3578732166,37
1,1014,18830,3578732129,3578732166,37
1,1014,18831,3578732129,3578732166,37
1,1014,18832,3578732129,3578732171,42
1,1014,18833,3578732129,3578732173,44
1,1014,18834,3578732129,3578732173,44
1,1014,18835,3578732129,3578732175,46
1,1014,18836,3578732129,3578732175,46
1,1014,18837,3578732129,3578732175,46
1,1014,18838,3578732129,3578732176,47
1,1014,18839,3578732129,3578732178,49
1,1015,18840,3578732186,3578732186,0
1,1015,18841,3578732186,3578732186,0
1,1015,18842,3578732186,3578732186,0
1,1015,18843,3578732186,3578732186,0
1,1015,18844,3578732186,3578732186,0
1,1015,18845,3578732186,3578732186,0
1,1015,18846,3578732186,3578732187,1
1,1015,18847,3578732186,3578732188,2
1,1015,18848,3578732186,3578732190,4
1,1015,18849,3578732186,3578732190,4
1,1015,18850,3578732186,3578732192,6
1,1015,18851,3578732186,3578732192,6
1,1015,18852,3578732186,3578732194,8
1,1015,18853,3578732186,3578732194,8
1,1015,18854,3578732186,3578732196,10
1,1015,18855,3578732186,3578732197,11
1,1015,18856,3578732186,3578732199,13
1,1015,18857,3578732186,3578732199,13
1,1015,18858,3578732186,3578732199,13
1,1015,18859,3578732186,3578732199,13
1,1015,18860,3578732186,3578732200,14
1,1015,18861,3578732186,3578732201,15
1,1015,18862,3578732186,3578732203,17
1,1015,18863,3578732186,3578732204,18
1,1015,18864,3578732186,3578732205,19
1,1015,18865,3578732186,3578732206,20
1,1015,18866,3578732186,3578732211,25
1,1015,18867,3578732186,3578732212,26
1,1015,18868,3578732186,3578732213,27
1,1015,18869,3578732186,3578732215,29
1,1015,18870,3578732186,3578732215,29
1,1015,18871,3578732186,3578732216,30
1,1015,18872,3578732186,3578732217,31
1,1015,18873,3578732186,3578732217,31
1,1015,18874,3578732186,3578732218,32
1,1015,18875,3578732186,3578732219,33
1,1015,18876,3578732186,3578732219,33
1,1015,18877,3578732186,3578732220,34
1,1015,18878,3578732186,3578732220,34
1,1015,18879,3578732186,3578732223,37
1,1015,18880,3578732186,3578732224,38
1,1015,18881,3578732186,3578732224,38
1,1015,18882,3578732186,3578732224,38
1,1015,18883,3578732186,3578732225,39
1,1015,18884,3578732186,3578732226,40
1,1015,18885,3578732186,3578732228,42
1,1015,18886,3578732186,3578732228,42
1,1015,18887,3578732186,3578732228,42
1,1015,18888,3578732186,3578732229,43
1,1015,18889,3578732186,3578732229,43
1,1015,18890,3578732186,3578732233,47
1,1015,18891,3578732186,3578732234,48
1,1015,18892,3578732186,3578732236,50
1,1016,18893,3578732244,3578732244,0
1,1016,18894,3578732244,3578732244,0
1,1016,18895,3578732244,3578732244,0
1,1016,18896,3578732244,3578732244,0
1,1016,18897,3578732244,3578732244,0
1,1016,18898,3578732244,3578732244,0
1,1016,18899,3578732244,3578732244,0
1,1016,18900,3578732244,3578732245,1
1,1016,18901,3578732244,3578732247,3
1,1016,18902,3578732244,3578732248,4
1,1016,18903,3578732244,3578732248,4
1,1016,18904,3578732244,3578732252,8
1,1016,18905,3578732244,3578732254,10
1,1016,18906,3578732244,3578732254,10
1,1016,18907,3578732244,3578732256,12
1,1016,18908,3578732244,3578732257,13
1,1016,18909,3578732244,3578732258,14
1,1016,18910,3578732244,3578732258,14
1,1016,18911,3578732244,3578732260,16
1,1016,18912,3578732244,3578732263,19
1,1016,18913,3578732244,3578732264,20
1,1016,18914,3578732244,3578732264,20
1,1016,18915,3578732244,3578732265,21
1,1016,18916,3578732244,3578732265,21
1,1016,18917,3578732244,3578732265,21
1,1016,18918,3578732244,3578732268,24
1,1016,18919,3578732244,3578732268,24
1,1016,18920,3578732244,3578732268,24
1,1016,18921,3578732244,3578732269,25
1,1016,18922,3578732244,3578732270,26
1,1016,18923,3578732244,3578732270,26
1,1016,18924,3578732244,3578732273,29
1,1016,18925,3578732244,3578732284,40
1,1016,18926,3578732244,3578732285,41
1,1016,18927,3578732244,3578732285,41
1,1016,18928,3578732244,3578732285,41
1,1016,18929,3578732244,3578732285,41
1,1016,18930,3578732244,3578732286,42
1,1016,18931,3578732244,3578732293,49
1,1016,18932,3578732244,3578732293,49
1,1017,18933,3578732303,3578732303,0
1,1017,18934,3578732303,3578732303,0
1,1017,18935,3578732303,3578732303,0
1,1017,18936,3578732303,3578732303,0
1,1017,18937,3578732303,3578732303,0
1,1017,18938,3578732303,3578732303,0
1,1017,18939,3578732303,3578732303,0
1,1017,18940,3578732303,3578732303,0
1,1017,18941,3578732303,3578732303,0
1,1017,18942,3578732303,3578732303,0
1,1017,18943,3578732303,3578732304,1
1,1017,18944,3578732303,3578732304,1
1,1017,18945,3578732303,3578732306,3
1,1017,18946,3578732303,3578732306,3
1,1017,18947,3578732303,3578732307,4
1,1017,18948,3578732303,3578732309,6
1,1017,18949,3578732303,3578732310,7
1,1017,18950,3578732303,3578732312,9
1,1017,18951,3578732303,3578732312,9
1,1017,18952,3578732303,3578732313,10
1,1017,18953,3578732303,3578732313,10
1,1017,18954,3578732303,3578732315,12
1,1017,18955,3578732303,3578732315,12
1,1017,18956,3578732303,3578732317,14
1,1017,18957,3578732303,3578732317,14
1,1017,18958,3578732303,3578732318,15
1,1017,18959,3578732303,3578732318,15
1,1017,18960,3578732303,3578732318,15
1,1017,18961,3578732303,3578732320,17
1,1017,18962,3578732303,3578732322,19
1,1017,18963,3578732303,3578732322,19
1,1017,18964,3578732303,3578732322,19
1,1017,18965,3578732303,3578732323,20
1,1017,18966,3578732303,3578732325,22
1,1017,18967,3578732303,3578732325,22
1,1017,18968,3578732303,3578732325,22
1,1017,18969,3578732303,3578732326,23
1,1017,18970,3578732303,3578732326,23
1,1017,18971,3578732303,3578732326,23
1,1017,18972,3578732303,3578732327,24
1,1017,18973,3578732303,3578732327,24
1,1017,18974,3578732303,3578732328,25
1,1017,18975,3578732303,3578732329,26
1,1017,18976,3578732303,3578732330,27
1,1017,18977,3578732303,3578732330,27
1,1017,18978,3578732303,3578732332,29
1,1017,18979,3578732303,3578732332,29
1,1017,18980,3578732303,3578732333,30
1,1017,18981,3578732303,3578732334,31
1,1017,18982,3578732303,3578732334,31
1,1017,18983,3578732303,3578732336,33
1,1017,18984,3578732303,3578732336,33
1,1017,18985,3578732303,3578732339,36
1,1017,18986,3578732303,3578732339,36
1,1017,18987,3578732303,3578732341,38
1,1017,18988,3578732303,3578732342,39
1,1017,18989,3578732303,3578732344,41
1,1017,18990,3578732303,3578732346,43
1,1017,18991,3578732303,3578732349,46
1,1017,18992,3578732303,3578732350,47
1,1017,18993,3578732303,3578732353,50
1,1018,18994,3578732362,3578732362,0
1,1018,18995,3578732362,3578732362,0
1,1018,18996,3578732362,3578732362,0
1,1018,18997,3578732362,3578732362,0
1,1018,18998,3578732362,3578732362,0
1,1018,18999,3578732362,3578732362,0
1,1018,19000,3578732362,3578732362,0
1,1018,19001,3578732362,3578732362,0
1,1018,19002,3578732362,3578732362,0
1,1018,19003,3578732362,3578732363,1
1,1018,19004,3578732362,3578732364,2
1,1018,19005,3578732362,3578732366,4
1,1018,19006,3578732362,3578732366,4
1,1018,19007,3578732362,3578732367,5
1,1018,19008,3578732362,3578732370,8
1,1018,19009,3578732362,3578732372,10
1,1018,19010,3578732362,3578732373,11
1,1018,19011,3578732362,3578732375,13
1,1018,19012,3578732362,3578732375,13
1,1018,19013,3578732362,3578732376,14
1,1018,19014,3578732362,3578732379,17
1,1018,19015,3578732362,3578732381,19
1,1018,19016,3578732362,3578732382,20
1,1018,19017,3578732362,3578732382,20
1,1018,19018,3578732362,3578732383,21
1,1018,19019,3578732362,3578732383,21
1,1018,19020,3578732362,3578732385,23
1,1018,19021,3578732362,3578732386,24
1,1018,19022,3578732362,3578732386,24
1,1018,19023,3578732362,3578732387,25
1,1018,19024,3578732362,3578732391,29
1,1018,19025,3578732362,3578732391,29
1,1018,19026,3578732362,3578732392,30
1,1018,19027,3578732362,3578732392,30
1,1018,19028,3578732362,3578732392,30
1,1018,19029,3578732362,3578732393,31
1,1018,19030,3578732362,3578732394,32
1,1018,19031,3578732362,3578732395,33
1,1018,19032,3578732362,3578732397,35
1,1018,19033,3578732362,3578732398,36
1,1018,19034,3578732362,3578732398,36
1,1018,19035,3578732362,3578732399,37
1,1018,19036,3578732362,3578732399,37
1,1018,19037,3578732362,3578732399,37
1,1018,19038,3578732362,3578732399,37
1,1018,19039,3578732362,3578732401,39
1,1018,19040,3578732362,3578732401,39
1,1018,19041,3578732362,3578732402,40
1,1018,19042,3578732362,3578732404,42
1,1018,19043,3578732362,3578732405,43
1,1018,19044,3578732362,3578732407,45
1,1018,19045,3578732362,3578732411,49
1,1019,19046,3578732421,3578732421,0
1,1019,19047,3578732421,3578732421,0
1,1019,19048,3578732421,3578732421,0
1,1019,19049,3578732421,3578732421,0
1,1019,19050,3578732421,3578732421,0
1,1019,19051,3578732421,3578732421,0
1,1019,19052,3578732421,3578732421,0
1,1019,19053,3578732421,3578732421,0
1,1019,19054,3578732421,3578732421,0
1,1019,19055,3578732421,3578732421,0
1,1019,19056,3578732421,3578732421,0
1,1019,19057,3578732421,3578732423,2
1,1019,19058,3578732421,3578732424,3
1,1019,19059,3578732421,3578732424,3
1,1019,19060,3578732421,3578732425,4
1,1019,19061,3578732421,3578732426,5
1,1019,19062,3578732421,3578732427,6
1,1019,19063,3578732421,3578732428,7
1,1019,19064,3578732421,3578732428,7
1,1019,19065,3578732421,3578732431,10
1,1019,19066,3578732421,3578732434,13
1,1019,19067,3578732421,3578732434,13
1,1019,19068,3578732421,3578732436,15
1,1019,19069,3578732421,3578732439,18
1,1019,19070,3578732421,3578732439,18
1,1019,19071,3578732421,3578732440,19
1,1019,19072,3578732421,3578732440,19
1,1019,19073,3578732421,3578732441,20
1,1019,19074,3578732421,3578732444,23
1,1019,19075,3578732421,3578732445,24
1,1019,19076,3578732421,3578732448,27
1,1019,19077,3578732421,3578732448,27
1,1019,19078,3578732421,3578732451,30
1,1019,19079,3578732421,3578732454,33
1,1019,19080,3578732421,3578732454,33
1,1019,19081,3578732421,3578732457,36
1,1019,19082,3578732421,3578732458,37
1,1019,19083,3578732421,3578732458,37
1,1019,19084,3578732421,3578732460,39
1,1019,19085,3578732421,3578732464,43
1,1019,19086,3578732421,3578732465,44
1,1019,19087,3578732421,3578732466,45
1,1019,19088,3578732421,3578732466,45
1,1019,19089,3578732421,3578732469,48
1,1019,19090,3578732421,3578732469,48
1,1019,19091,3578732421,3578732469,48
1,1019,19092,3578732421,3578732470,49
1,1019,19093,3578732421,3578732471,50
1,1020,19094,3578732479,3578732479,0
1,1020,19095,3578732479,3578732483,4
1,1020,19096,3578732479,3578732484,5
1,1020,19097,3578732479,3578732484,5
1,1020,19098,3578732479,3578732485,6
1,1020,19099,3578732479,3578732485,6
1,1020,19100,3578732479,3578732486,7
1,1020,19101,3578732479,3578732492,13
1,1020,19102,3578732479,3578732493,14
1,1020,19103,3578732479,3578732495,16
1,1020,19104,3578732479,3578732497,18
1,1020,19105,3578732479,3578732498,19
1,1020,19106,3578732479,3578732498,19
1,1020,19107,3578732479,3578732499,20
1,1020,19108,3578732479,3578732500,21
1,1020,19109,3578732479,3578732502,23
1,1020,19110,3578732479,3578732503,24
1,1020,19111,3578732479,3578732504,25
1,1020,19112,3578732479,3578732505,26
1,1020,19113,3578732479,3578732507,28
1,1020,19114,3578732479,3578732507,28
1,1020,19115,3578732479,3578732509,30
1,1020,19116,3578732479,3578732510,31
1,1020,19117,3578732479,3578732511,32
1,1020,19118,3578732479,3578732512,33
1,1020,19119,3578732479,3578732512,33
1,1020,19120,3578732479,3578732513,34
1,1020,19121,3578732479,3578732515,36
1,1020,19122,3578732479,3578732515,36
1,1020,19123,3578732479,3578732515,36
1,1020,19124,3578732479,3578732516,37
1,1020,19125,3578732479,3578732517,38
1,1020,19126,3578732479,3578732517,38
1,1020,19127,3578732479,3578732517,38
1,1020,19128,3578732479,3578732518,39
1,1020,19129,3578732479,3578732520,41
1,1020,19130,3578732479,3578732520,41
1,1020,19131,3578732479,3578732520,41
1,1020,19132,3578732479,3578732522,43
1,1020,19133,3578732479,3578732523,44
1,1020,19134,3578732479,3578732523,44
1,1020,19135,3578732479,3578732524,45
1,1020,19136,3578732479,3578732525,46
1,1020,19137,3578732479,3578732525,46
1,1020,19138,3578732479,3578732526,47
1,1020,19139,3578732479,3578732526,47
1,1020,19140,3578732479,3578732526,47
1,1020,19141,3578732479,3578732527,48
1,1020,19142,3578732479,3578732528,49
1,1020,19143,3578732479,3578732529,50
1,1021,19144,3578732537,3578732537,0
1,1021,19145,3578732537,3578732537,0
1,1021,19146,3578732537,3578732537,0
1,1021,19147,3578732537,3578732537,0
1,1021,19148,3578732537,3578732537,0
1,1021,19149,3578732537,3578732537,0
1,1021,19150,3578732537,3578732537,0
1,1021,19151,3578732537,3578732537,0
1,1021,19152,3578732537,3578732537,0
1,1021,19153,3578732537,3578732537,0
1,1021,19154,3578732537,3578732538,1
1,1021,19155,3578732537,3578732538,1
1,1021,19156,3578732537,3578732540,3
1,1021,19157,3578732537,3578732541,4
1,1021,19158,3578732537,3578732544,7
1,1021,19159,3578732537,3578732544,7
1,1021,19160,3578732537,3578732545,8
1,1021,19161,3578732537,3578732548,11
1,1021,19162,3578732537,3578732550,13
1,1021,19163,3578732537,3578732552,15
1,1021,19164,3578732537,3578732552,15
1,1021,19165,3578732537,3578732552,15
1,1021,19166,3578732537,3578732554,17
1,1021,19167,3578732537,3578732554,17
1,1021,19168,3578732537,3578732556,19
1,1021,19169,3578732537,3578732556,19
1,1021,19170,3578732537,3578732556,19
1,1021,19171,3578732537,3578732556,19
1,1021,19172,3578732537,3578732558,21
1,1021,19173,3578732537,3578732562,25
1,1021,19174,3578732537,3578732562,25
1,1021,19175,3578732537,3578732563,26
1,1021,19176,3578732537,3578732565,28
1,1021,19177,3578732537,3578732566,29
1,1021,19178,3578732537,3578732570,33
1,1021,19179,3578732537,3578732572,35
1,1021,19180,3578732537,3578732572,35
1,1021,19181,3578732537,3578732574,37
1,1021,19182,3578732537,3578732574,37
1,1021,19183,3578732537,3578732575,38
1,1021,19184,3578732537,3578732576,39
1,1021,19185,3578732537,3578732579,42
1,1021,19186,3578732537,3578732582,45
1,1021,19187,3578732537,3578732582,45
1,1021,19188,3578732537,3578732582,45
1,1021,19189,3578732537,3578732584,47
1,1021,19190,3578732537,3578732584,47
1,1021,19191,3578732537,3578732586,49
1,1021,19192,3578732537,3578732586,49
1,1022,19193,3578732596,3578732596,0
1,1022,19194,3578732596,3578732596,0
1,1022,19195,3578732596,3578732596,0
1,1022,19196,3578732596,3578732596,0
1,1022,19197,3578732596,3578732596,0
1,1022,19198,3578732596,3578732596,0
1,1022,19199,3578732596,3578732596,0
1,1022,19200,3578732596,3578732596,0
1,1022,19201,3578732596,3578732596,0
1,1022,19202,3578732596,3578732596,0
1,1022,19203,3578732596,3578732596,0
1,1022,19204,3578732596,3578732598,2
1,1022,19205,3578732596,3578732598,2
1,1022,19206,3578732596,3578732598,2
1,1022,19207,3578732596,3578732599,3
1,1022,19208,3578732596,3578732601,5
1,1022,19209,3578732596,3578732602,6
1,1022,19210,3578732596,3578732603,7
1,1022,19211,3578732596,3578732604,8
1,1022,19212,3578732596,3578732610,14
1,1022,19213,3578732596,3578732611,15
1,1022,19214,3578732596,3578732614,18
1,1022,19215,3578732596,3578732616,20
1,1022,19216,3578732596,3578732616,20
1,1022,19217,3578732596,3578732617,21
1,1022,19218,3578732596,3578732617,21
1,1022,19219,3578732596,3578732618,22
1,1022,19220,3578732596,3578732618,22
1,1022,19221,3578732596,3578732619,23
1,1022,19222,3578732596,3578732619,23
1,1022,19223,3578732596,3578732621,25
1,1022,19224,3578732596,3578732621,25
1,1022,19225,3578732596,3578732622,26
1,1022,19226,3578732596,3578732623,27
1,1022,19227,3578732596,3578732625,29
1,1022,19228,3578732596,3578732626,30
1,1022,19229,3578732596,3578732626,30
1,1022,19230,3578732596,3578732626,30
1,1022,19231,3578732596,3578732628,32
1,1022,19232,3578732596,3578732633,37
1,1022,19233,3578732596,3578732633,37
1,1022,19234,3578732596,3578732634,38
1,1022,19235,3578732596,3578732635,39
1,1022,19236,3578732596,3578732638,42
1,1022,19237,3578732596,3578732639,43
1,1022,19238,3578732596,3578732639,43
1,1022,19239,3578732596,3578732639,43
1,1022,19240,3578732596,3578732640,44
1,1022,19241,3578732596,3578732643,47
1,1022,19242,3578732596,3578732644,48
1,1023,19243,3578732656,3578732656,0
1,1023,19244,3578732656,3578732656,0
1,1023,19245,3578732656,3578732656,0
1,1023,19246,3578732656,3578732656,0
1,1023,19247,3578732656,3578732656,0
1,1023,19248,3578732656,3578732656,0
1,1023,19249,3578732656,3578732656,0
1,1023,19250,3578732656,3578732656,0
1,1023,19251,3578732656,3578732657,1
1,1023,19252,3578732656,3578732657,1
1,1023,19253,3578732656,3578732659,3
1,1023,19254,3578732656,3578732661,5
1,1023,19255,3578732656,3578732662,6
1,1023,19256,3578732656,3578732663,7
1,1023,19257,3578732656,3578732664,8
1,1023,19258,3578732656,3578732665,9
1,1023,19259,3578732656,3578732665,9
1,1023,19260,3578732656,3578732668,12
1,1023,19261,3578732656,3578732668,12
1,1023,19262,3578732656,3578732669,13
1,1023,19263,3578732656,3578732669,13
1,1023,19264,3578732656,3578732669,13
1,1023,19265,3578732656,3578732670,14
1,1023,19266,3578732656,3578732673,17
1,1023,19267,3578732656,3578732684,28
1,1023,19268,3578732656,3578732684,28
1,1023,19269,3578732656,3578732684,28
1,1023,19270,3578732656,3578732685,29
1,1023,19271,3578732656,3578732685,29
1,1023,19272,3578732656,3578732686,30
1,1023,19273,3578732656,3578732692,36
1,1023,19274,3578732656,3578732693,37
1,1023,19275,3578732656,3578732695,39
1,1023,19276,3578732656,3578732698,42
1,1023,19277,3578732656,3578732698,42
1,1023,19278,3578732656,3578732698,42
1,1023,19279,3578732656,3578732699,43
1,1023,19280,3578732656,3578732700,44
1,1023,19281,3578732656,3578732702,46
1,1023,19282,3578732656,3578732702,46
1,1023,19283,3578732656,3578732704,48
1,1023,19284,3578732656,3578732704,48
1,1023,19285,3578732656,3578732705,49
1,1024,19286,3578732718,3578732718,0
1,1024,19287,3578732718,3578732718,0
1,1024,19288,3578732718,3578732718,0
1,1024,19289,3578732718,3578732718,0
1,1024,19290,3578732718,3578732718,0
1,1024,19291,3578732718,3578732718,0
1,1024,19292,3578732718,3578732718,0
1,1024,19293,3578732718,3578732718,0
1,1024,19294,3578732718,3578732718,0
1,1024,19295,3578732718,3578732718,0
1,1024,19296,3578732718,3578732718,0
1,1024,19297,3578732718,3578732718,0
1,1024,19298,3578732718,3578732718,0
1,1024,19299,3578732718,3578732718,0
1,1024,19300,3578732718,3578732720,2
1,1024,19301,3578732718,3578732720,2
1,1024,19302,3578732718,3578732723,5
1,1024,19303,3578732718,3578732723,5
1,1024,19304,3578732718,3578732724,6
1,1024,19305,3578732718,3578732724,6
1,1024,19306,3578732718,3578732725,7
1,1024,19307,3578732718,3578732726,8
1,1024,19308,3578732718,3578732726,8
1,1024,19309,3578732718,3578732726,8
1,1024,19310,3578732718,3578732726,8
1,1024,19311,3578732718,3578732727,9
1,1024,19312,3578732718,3578732728,10
1,1024,19313,3578732718,3578732728,10
1,1024,19314,3578732718,3578732729,11
1,1024,19315,3578732718,3578732729,11
1,1024,19316,3578732718,3578732730,12
1,1024,19317,3578732718,3578732732,14
1,1024,19318,3578732718,3578732732,14
1,1024,19319,3578732718,3578732732,14
1,1024,19320,3578732718,3578732733,15
1,1024,19321,3578732718,3578732733,15
1,1024,19322,3578732718,3578732734,16
1,1024,19323,3578732718,3578732735,17
1,1024,19324,3578732718,3578732736,18
1,1024,19325,3578732718,3578732737,19
1,1024,19326,3578732718,3578732738,20
1,1024,19327,3578732718,3578732739,21
1,1024,19328,3578732718,3578732740,22
1,1024,19329,3578732718,3578732741,23
1,1024,19330,3578732718,3578732744,26
1,1024,19331,3578732718,3578732745,27
1,1024,19332,3578732718,3578732748,30
1,1024,19333,3578732718,3578732750,32
1,1024,19334,3578732718,3578732751,33
1,1024,19335,3578732718,3578732752,34
1,1024,19336,3578732718,3578732754,36
1,1024,19337,3578732718,3578732755,37
1,1024,19338,3578732718,3578732756,38
1,1024,19339,3578732718,3578732756,38
1,1024,19340,3578732718,3578732758,40
1,1024,19341,3578732718,3578732759,41
1,1024,19342,3578732718,3578732761,43
1,1024,19343,3578732718,3578732762,44
1,1024,19344,3578732718,3578732762,44
1,1024,19345,3578732718,3578732764,46
1,1024,19346,3578732718,3578732765,47
1,1024,19347,3578732718,3578732766,48
1,1025,19348,3578732780,3578732780,0
1,1025,19349,3578732780,3578732780,0
1,1025,19350,3578732780,3578732780,0
1,1025,19351,3578732780,3578732780,0
1,1025,19352,3578732780,3578732780,0
1,1025,19353,3578732780,3578732780,0
1,1025,19354,3578732780,3578732782,2
1,1025,19355,3578732780,3578732782,2
1,1025,19356,3578732780,3578732783,3
1,1025,19357,3578732780,3578732784,4
1,1025,19358,3578732780,3578732784,4
1,1025,19359,3578732780,3578732786,6
1,1025,19360,3578732780,3578732786,6
1,1025,19361,3578732780,3578732790,10
1,1025,19362,3578732780,3578732791,11
1,1025,19363,3578732780,3578732791,11
1,1025,19364,3578732780,3578732792,12
1,1025,19365,3578732780,3578732793,13
1,1025,19366,3578732780,3578732793,13
1,1025,19367,3578732780,3578732794,14
1,1025,19368,3578732780,3578732796,16
1,1025,19369,3578732780,3578732796,16
1,1025,19370,3578732780,3578732797,17
1,1025,19371,3578732780,3578732798,18
1,1025,19372,3578732780,3578732798,18
1,1025,19373,3578732780,3578732801,21
1,1025,19374,3578732780,3578732802,22
1,1025,19375,3578732780,3578732802,22
1,1025,19376,3578732780,3578732802,22
1,1025,19377,3578732780,3578732805,25
1,1025,19378,3578732780,3578732810,30
1,1025,19379,3578732780,3578732813,33
1,1025,19380,3578732780,3578732815,35
1,1025,19381,3578732780,3578732816,36
1,1025,19382,3578732780,3578732816,36
1,1025,19383,3578732780,3578732817,37
1,1025,19384,3578732780,3578732818,38
1,1025,19385,3578732780,3578732818,38
1,1025,19386,3578732780,3578732818,38
1,1025,19387,3578732780,3578732819,39
1,1025,19388,3578732780,3578732819,39
1,1025,19389,3578732780,3578732821,41
1,1025,19390,3578732780,3578732821,41
1,1025,19391,3578732780,3578732823,43
1,1025,19392,3578732780,3578732824,44
1,1025,19393,3578732780,3578732824,44
1,1025,19394,3578732780,3578732825,45
1,1025,19395,3578732780,3578732826,46
1,1025,19396,3578732780,3578732826,46
1,1025,19397,3578732780,3578732827,47
1,1025,19398,3578732780,3578732829,49
1,1026,19399,3578732838,3578732838,0
1,1026,19400,3578732838,3578732838,0
1,1026,19401,3578732838,3578732838,0
1,1026,19402,3578732838,3578732839,1
1,1026,19403,3578732838,3578732839,1
1,1026,19404,3578732838,3578732839,1
1,1026,19405,3578732838,3578732841,3
1,1026,19406,3578732838,3578732843,5
1,1026,19407,3578732838,3578732844,6
1,1026,19408,3578732838,3578732847,9
1,1026,19409,3578732838,3578732848,10
1,1026,19410,3578732838,3578732850,12
1,1026,19411,3578732838,3578732850,12
1,1026,19412,3578732838,3578732853,15
1,1026,19413,3578732838,3578732855,17
1,1026,19414,3578732838,3578732856,18
1,1026,19415,3578732838,3578732858,20
1,1026,19416,3578732838,3578732858,20
1,1026,19417,3578732838,3578732860,22
1,1026,19418,3578732838,3578732860,22
1,1026,19419,3578732838,3578732863,25
1,1026,19420,3578732838,3578732863,25
1,1026,19421,3578732838,3578732864,26
1,1026,19422,3578732838,3578732864,26
1,1026,19423,3578732838,3578732865,27
1,1026,19424,3578732838,3578732866,28
1,1026,19425,3578732838,3578732867,29
1,1026,19426,3578732838,3578732868,30
1,1026,19427,3578732838,3578732868,30
1,1026,19428,3578732838,3578732869,31
1,1026,19429,3578732838,3578732869,31
1,1026,19430,3578732838,3578732870,32
1,1026,19431,3578732838,3578732873,35
1,1026,19432,3578732838,3578732883,45
1,1026,19433,3578732838,3578732884,46
1,1026,19434,3578732838,3578732885,47
1,1026,19435,3578732838,3578732885,47
1,1026,19436,3578732838,3578732886,48
1,1027,19437,3578732897,3578732897,0
1,1027,19438,3578732897,3578732897,0
1,1027,19439,3578732897,3578732897,0
1,1027,19440,3578732897,3578732897,0
1,1027,19441,3578732897,3578732898,1
1,1027,19442,3578732897,3578732898,1
1,1027,19443,3578732897,3578732898,1
1,1027,19444,3578732897,3578732900,3
1,1027,19445,3578732897,3578732900,3
1,1027,19446,3578732897,3578732901,4
1,1027,19447,3578732897,3578732903,6
1,1027,19448,3578732897,3578732905,8
1,1027,19449,3578732897,3578732905,8
1,1027,19450,3578732897,3578732905,8
1,1027,19451,3578732897,3578732906,9
1,1027,19452,3578732897,3578732906,9
1,1027,19453,3578732897,3578732909,12
1,1027,19454,3578732897,3578732912,15
1,1027,19455,3578732897,3578732912,15
1,1027,19456,3578732897,3578732914,17
1,1027,19457,3578732897,3578732914,17
1,1027,19458,3578732897,3578732914,17
1,1027,19459,3578732897,3578732915,18
1,1027,19460,3578732897,3578732915,18
1,1027,19461,3578732897,3578732916,19
1,1027,19462,3578732897,3578732916,19
1,1027,19463,3578732897,3578732918,21
1,1027,19464,3578732897,3578732918,21
1,1027,19465,3578732897,3578732920,23
1,1027,19466,3578732897,3578732920,23
1,1027,19467,3578732897,3578732921,24
1,1027,19468,3578732897,3578732922,25
1,1027,19469,3578732897,3578732924,27
1,1027,19470,3578732897,3578732924,27
1,1027,19471,3578732897,3578732924,27
1,1027,19472,3578732897,3578732925,28
1,1027,19473,3578732897,3578732926,29
1,1027,19474,3578732897,3578732926,29
1,1027,19475,3578732897,3578732927,30
1,1027,19476,3578732897,3578732927,30
1,1027,19477,3578732897,3578732928,31
1,1027,19478,3578732897,3578732929,32
1,1027,19479,3578732897,3578732929,32
1,1027,19480,3578732897,3578732930,33
1,1027,19481,3578732897,3578732931,34
1,1027,19482,3578732897,3578732932,35
1,1027,19483,3578732897,3578732933,36
1,1027,19484,3578732897,3578732933,36
1,1027,19485,3578732897,3578732933,36
1,1027,19486,3578732897,3578732934,37
1,1027,19487,3578732897,3578732934,37
1,1027,19488,3578732897,3578732936,39
1,1027,19489,3578732897,3578732937,40
1,1027,19490,3578732897,3578732938,41
1,1027,19491,3578732897,3578732939,42
1,1027,19492,3578732897,3578732940,43
1,1027,19493,3578732897,3578732943,46
1,1027,19494,3578732897,3578732944,47
1,1027,19495,3578732897,3578732946,49
1,1028,19496,3578732955,3578732955,0
1,1028,19497,3578732955,3578732955,0
1,1028,19498,3578732955,3578732955,0
1,1028,19499,3578732955,3578732955,0
1,1028,19500,3578732955,3578732955,0
1,1028,19501,3578732955,3578732955,0
1,1028,19502,3578732955,3578732955,0
1,1028,19503,3578732955,3578732956,1
1,1028,19504,3578732955,3578732956,1
1,1028,19505,3578732955,3578732957,2
1,1028,19506,3578732955,3578732959,4
1,1028,19507,3578732955,3578732962,7
1,1028,19508,3578732955,3578732964,9
1,1028,19509,3578732955,3578732964,9
1,1028,19510,3578732955,3578732965,10
1,1028,19511,3578732955,3578732966,11
1,1028,19512,3578732955,3578732966,11
1,1028,19513,3578732955,3578732971,16
1,1028,19514,3578732955,3578732972,17
1,1028,19515,3578732955,3578732975,20
1,1028,19516,3578732955,3578732975,20
1,1028,19517,3578732955,3578732976,21
1,1028,19518,3578732955,3578732978,23
1,1028,19519,3578732955,3578732982,27
1,1028,19520,3578732955,3578732982,27
1,1028,19521,3578732955,3578732982,27
1,1028,19522,3578732955,3578732984,29
1,1028,19523,3578732955,3578732985,30
1,1028,19524,3578732955,3578732986,31
1,1028,19525,3578732955,3578732987,32
1,1028,19526,3578732955,3578732990,35
1,1028,19527,3578732955,3578732991,36
1,1028,19528,3578732955,3578732991,36
1,1028,19529,3578732955,3578732992,37
1,1028,19530,3578732955,3578732992,37
1,1028,19531,3578732955,3578732993,38
1,1028,19532,3578732955,3578732994,39
1,1028,19533,3578732955,3578732995,40
1,1028,19534,3578732955,3578732996,41
1,1028,19535,3578732955,3578732997,42
1,1028,19536,3578732955,3578732998,43
1,1028,19537,3578732955,3578732998,43
1,1028,19538,3578732955,3578732999,44
1,1028,19539,3578732955,3578732999,44
1,1028,19540,3578732955,3578733002,47
1,1028,19541,3578732955,3578733002,47
1,1028,19542,3578732955,3578733002,47
1,1028,19543,3578732955,3578733003,48
1,1029,19544,3578733015,3578733015,0
1,1029,19545,3578733015,3578733015,0
1,1029,19546,3578733015,3578733015,0
1,1029,19547,3578733015,3578733015,0
1,1029,19548,3578733015,3578733016,1
1,1029,19549,3578733015,3578733017,2
1,1029,19550,3578733015,3578733017,2
1,1029,19551,3578733015,3578733018,3
1,1029,19552,3578733015,3578733018,3
1,1029,19553,3578733015,3578733018,3
1,1029,19554,3578733015,3578733019,4
1,1029,19555,3578733015,3578733019,4
1,1029,19556,3578733015,3578733022,7
1,1029,19557,3578733015,3578733022,7
1,1029,19558,3578733015,3578733022,7
1,1029,19559,3578733015,3578733024,9
1,1029,19560,3578733015,3578733024,9
1,1029,19561,3578733015,3578733025,10
1,1029,19562,3578733015,3578733027,12
1,1029,19563,3578733015,3578733027,12
1,1029,19564,3578733015,3578733027,12
1,1029,19565,3578733015,3578733029,14
1,1029,19566,3578733015,3578733029,14
1,1029,19567,3578733015,3578733029,14
1,1029,19568,3578733015,3578733034,19
1,1029,19569,3578733015,3578733035,20
1,1029,19570,3578733015,3578733036,21
1,1029,19571,3578733015,3578733038,23
1,1029,19572,3578733015,3578733039,24
1,1029,19573,3578733015,3578733039,24
1,1029,19574,3578733015,3578733039,24
1,1029,19575,3578733015,3578733040,25
1,1029,19576,3578733015,3578733043,28
1,1029,19577,3578733015,3578733047,32
1,1029,19578,3578733015,3578733048,33
1,1029,19579,3578733015,3578733048,33
1,1029,19580,3578733015,3578733048,33
1,1029,19581,3578733015,3578733051,36
1,1029,19582,3578733015,3578733052,37
1,1029,19583,3578733015,3578733053,38
1,1029,19584,3578733015,3578733054,39
1,1029,19585,3578733015,3578733055,40
1,1029,19586,3578733015,3578733056,41
1,1029,19587,3578733015,3578733057,42
1,1029,19588,3578733015,3578733058,43
1,1029,19589,3578733015,3578733060,45
1,1029,19590,3578733015,3578733063,48
1,1029,19591,3578733015,3578733063,48
1,1029,19592,3578733015,3578733063,48
1,1029,19593,3578733015,3578733065,50
1,1030,19594,3578733075,3578733075,0
1,1030,19595,3578733075,3578733075,0
1,1030,19596,3578733075,3578733075,0
1,1030,19597,3578733075,3578733075,0
1,1030,19598,3578733075,3578733075,0
1,1030,19599,3578733075,3578733075,0
1,1030,19600,3578733075,3578733075,0
1,1030,19601,3578733075,3578733075,0
1,1030,19602,3578733075,3578733083,8
1,1030,19603,3578733075,3578733084,9
1,1030,19604,3578733075,3578733085,10
1,1030,19605,3578733075,3578733085,10
1,1030,19606,3578733075,3578733085,10
1,1030,19607,3578733075,3578733086,11
1,1030,19608,3578733075,3578733092,17
1,1030,19609,3578733075,3578733093,18
1,1030,19610,3578733075,3578733094,19
1,1030,19611,3578733075,3578733095,20
1,1030,19612,3578733075,3578733098,23
1,1030,19613,3578733075,3578733098,23
1,1030,19614,3578733075,3578733099,24
1,1030,19615,3578733075,3578733100,25
1,1030,19616,3578733075,3578733101,26
1,1030,19617,3578733075,3578733101,26
1,1030,19618,3578733075,3578733102,27
1,1030,19619,3578733075,3578733103,28
1,1030,19620,3578733075,3578733105,30
1,1030,19621,3578733075,3578733106,31
1,1030,19622,3578733075,3578733106,31
1,1030,19623,3578733075,3578733106,31
1,1030,19624,3578733075,3578733106,31
1,1030,19625,3578733075,3578733107,32
1,1030,19626,3578733075,3578733109,34
1,1030,19627,3578733075,3578733110,35
1,1030,19628,3578733075,3578733112,37
1,1030,19629,3578733075,3578733112,37
1,1030,19630,3578733075,3578733114,39
1,1030,19631,3578733075,3578733114,39
1,1030,19632,3578733075,3578733114,39
1,1030,19633,3578733075,3578733115,40
1,1030,19634,3578733075,3578733117,42
1,1030,19635,3578733075,3578733117,42
1,1030,19636,3578733075,3578733118,43
1,1030,19637,3578733075,3578733120,45
1,1030,19638,3578733075,3578733120,45
1,1030,19639,3578733075,3578733120,45
1,1030,19640,3578733075,3578733121,46
1,1030,19641,3578733075,3578733122,47
1,1030,19642,3578733075,3578733123,48
1,1030,19643,3578733075,3578733124,49
1,1030,19644,3578733075,3578733124,49
1,1030,19645,3578733075,3578733125,50
1,1031,19646,3578733136,3578733136,0
1,1031,19647,3578733136,3578733136,0
1,1031,19648,3578733136,3578733136,0
1,1031,19649,3578733136,3578733136,0
1,1031,19650,3578733136,3578733136,0
1,1031,19651,3578733136,3578733136,0
1,1031,19652,3578733136,3578733136,0
1,1031,19653,3578733136,3578733136,0
1,1031,19654,3578733136,3578733136,0
1,1031,19655,3578733136,3578733136,0
1,1031,19656,3578733136,3578733136,0
1,1031,19657,3578733136,3578733136,0
1,1031,19658,3578733136,3578733136,0
1,1031,19659,3578733136,3578733136,0
1,1031,19660,3578733136,3578733136,0
1,1031,19661,3578733136,3578733136,0
1,1031,19662,3578733136,3578733136,0
1,1031,19663,3578733136,3578733136,0
1,1031,19664,3578733136,3578733137,1
1,1031,19665,3578733136,3578733138,2
1,1031,19666,3578733136,3578733138,2
1,1031,19667,3578733136,3578733141,5
1,1031,19668,3578733136,3578733141,5
1,1031,19669,3578733136,3578733143,7
1,1031,19670,3578733136,3578733144,8
1,1031,19671,3578733136,3578733146,10
1,1031,19672,3578733136,3578733148,12
1,1031,19673,3578733136,3578733151,15
1,1031,19674,3578733136,3578733152,16
1,1031,19675,3578733136,3578733152,16
1,1031,19676,3578733136,3578733154,18
1,1031,19677,3578733136,3578733155,19
1,1031,19678,3578733136,3578733156,20
1,1031,19679,3578733136,3578733157,21
1,1031,19680,3578733136,3578733157,21
1,1031,19681,3578733136,3578733159,23
1,1031,19682,3578733136,3578733164,28
1,1031,19683,3578733136,3578733164,28
1,1031,19684,3578733136,3578733165,29
1,1031,19685,3578733136,3578733165,29
1,1031,19686,3578733136,3578733165,29
1,1031,19687,3578733136,3578733166,30
1,1031,19688,3578733136,3578733171,35
1,1031,19689,3578733136,3578733172,36
1,1031,19690,3578733136,3578733172,36
1,1031,19691,3578733136,3578733176,40
1,1031,19692,3578733136,3578733177,41
1,1031,19693,3578733136,3578733179,43
1,1031,19694,3578733136,3578733182,46
1,1031,19695,3578733136,3578733182,46
1,1031,19696,3578733136,3578733183,47
1,1031,19697,3578733136,3578733184,48
1,1031,19698,3578733136,3578733184,48
1,1031,19699,3578733136,3578733185,49
1,1031,19700,3578733136,3578733186,50
1,1032,19701,3578733195,3578733195,0
1,1032,19702,3578733195,3578733195,0
1,1032,19703,3578733195,3578733195,0
1,1032,19704,3578733195,3578733195,0
1,1032,19705,3578733195,3578733195,0
1,1032,19706,3578733195,3578733195,0
1,1032,19707,3578733195,3578733195,0
1,1032,19708,3578733195,3578733195,0
1,1032,19709,3578733195,3578733195,0
1,1032,19710,3578733195,3578733196,1
1,1032,19711,3578733195,3578733197,2
1,1032,19712,3578733195,3578733199,4
1,1032,19713,3578733195,3578733199,4
1,1032,19714,3578733195,3578733199,4
1,1032,19715,3578733195,3578733201,6
1,1032,19716,3578733195,3578733202,7
1,1032,19717,3578733195,3578733202,7
1,1032,19718,3578733195,3578733203,8
1,1032,19719,3578733195,3578733203,8
1,1032,19720,3578733195,3578733206,11
1,1032,19721,3578733195,3578733207,12
1,1032,19722,3578733195,3578733211,16
1,1032,19723,3578733195,3578733213,18
1,1032,19724,3578733195,3578733214,19
1,1032,19725,3578733195,3578733215,20
1,1032,19726,3578733195,3578733216,21
1,1032,19727,3578733195,3578733217,22
1,1032,19728,3578733195,3578733217,22
1,1032,19729,3578733195,3578733218,23
1,1032,19730,3578733195,3578733218,23
1,1032,19731,3578733195,3578733219,24
1,1032,19732,3578733195,3578733219,24
1,1032,19733,3578733195,3578733219,24
1,1032,19734,3578733195,3578733221,26
1,1032,19735,3578733195,3578733222,27
1,1032,19736,3578733195,3578733222,27
1,1032,19737,3578733195,3578733224,29
1,1032,19738,3578733195,3578733224,29
1,1032,19739,3578733195,3578733225,30
1,1032,19740,3578733195,3578733226,31
1,1032,19741,3578733195,3578733227,32
1,1032,19742,3578733195,3578733227,32
1,1032,19743,3578733195,3578733229,34
1,1032,19744,3578733195,3578733229,34
1,1032,19745,3578733195,3578733236,41
1,1032,19746,3578733195,3578733239,44
1,1032,19747,3578733195,3578733239,44
1,1032,19748,3578733195,3578733239,44
1,1032,19749,3578733195,3578733240,45
1,1032,19750,3578733195,3578733241,46
1,1032,19751,3578733195,3578733243,48
1,1032,19752,3578733195,3578733245,50
1,1033,19753,3578733252,3578733252,0
1,1033,19754,3578733252,3578733252,0
1,1033,19755,3578733252,3578733252,0
1,1033,19756,3578733252,3578733252,0
1,1033,19757,3578733252,3578733254,2
1,1033,19758,3578733252,3578733255,3
1,1033,19759,3578733252,3578733257,5
1,1033,19760,3578733252,3578733261,9
1,1033,19761,3578733252,3578733262,10
1,1033,19762,3578733252,3578733263,11
1,1033,19763,3578733252,3578733264,12
1,1033,19764,3578733252,3578733265,13
1,1033,19765,3578733252,3578733265,13
1,1033,19766,3578733252,3578733266,14
1,1033,19767,3578733252,3578733268,16
1,1033,19768,3578733252,3578733269,17
1,1033,19769,3578733252,3578733269,17
1,1033,19770,3578733252,3578733270,18
1,1033,19771,3578733252,3578733270,18
1,1033,19772,3578733252,3578733284,32
1,1033,19773,3578733252,3578733284,32
1,1033,19774,3578733252,3578733285,33
1,1033,19775,3578733252,3578733285,33
1,1033,19776,3578733252,3578733286,34
1,1033,19777,3578733252,3578733292,40
1,1033,19778,3578733252,3578733292,40
1,1033,19779,3578733252,3578733295,43
1,1033,19780,3578733252,3578733295,43
1,1033,19781,3578733252,3578733298,46
1,1033,19782,3578733252,3578733299,47
1,1033,19783,3578733252,3578733300,48
1,1033,19784,3578733252,3578733300,48
1,1033,19785,3578733252,3578733300,48
1,1033,19786,3578733252,3578733301,49
1,1034,19787,3578733311,3578733311,0
1,1034,19788,3578733311,3578733311,0
1,1034,19789,3578733311,3578733311,0
1,1034,19790,3578733311,3578733311,0
1,1034,19791,3578733311,3578733311,0
1,1034,19792,3578733311,3578733311,0
1,1034,19793,3578733311,3578733311,0
1,1034,19794,3578733311,3578733311,0
1,1034,19795,3578733311,3578733311,0
1,1034,19796,3578733311,3578733311,0
1,1034,19797,3578733311,3578733312,1
1,1034,19798,3578733311,3578733312,1
1,1034,19799,3578733311,3578733314,3
1,1034,19800,3578733311,3578733315,4
1,1034,19801,3578733311,3578733315,4
1,1034,19802,3578733311,3578733315,4
1,1034,19803,3578733311,3578733315,4
1,1034,19804,3578733311,3578733317,6
1,1034,19805,3578733311,3578733318,7
1,1034,19806,3578733311,3578733318,7
1,1034,19807,3578733311,3578733319,8
1,1034,19808,3578733311,3578733320,9
1,1034,19809,3578733311,3578733321,10
1,1034,19810,3578733311,3578733323,12
1,1034,19811,3578733311,3578733324,13
1,1034,19812,3578733311,3578733324,13
1,1034,19813,3578733311,3578733325,14
1,1034,19814,3578733311,3578733325,14
1,1034,19815,3578733311,3578733326,15
1,1034,19816,3578733311,3578733326,15
1,1034,19817,3578733311,3578733327,16
1,1034,19818,3578733311,3578733327,16
1,1034,19819,3578733311,3578733328,17
1,1034,19820,3578733311,3578733329,18
1,1034,19821,3578733311,3578733329,18
1,1034,19822,3578733311,3578733330,19
1,1034,19823,3578733311,3578733330,19
1,1034,19824,3578733311,3578733331,20
1,1034,19825,3578733311,3578733332,21
1,1034,19826,3578733311,3578733333,22
1,1034,19827,3578733311,3578733334,23
1,1034,19828,3578733311,3578733334,23
1,1034,19829,3578733311,3578733334,23
1,1034,19830,3578733311,3578733335,24
1,1034,19831,3578733311,3578733335,24
1,1034,19832,3578733311,3578733336,25
1,1034,19833,3578733311,3578733338,27
1,1034,19834,3578733311,3578733338,27
1,1034,19835,3578733311,3578733339,28
1,1034,19836,3578733311,3578733341,30
1,1034,19837,3578733311,3578733342,31
1,1034,19838,3578733311,3578733344,33
1,1034,19839,3578733311,3578733344,33
1,1034,19840,3578733311,3578733346,35
1,1034,19841,3578733311,3578733348,37
1,1034,19842,3578733311,3578733351,40
1,1034,19843,3578733311,3578733352,41
1,1034,19844,3578733311,3578733352,41
1,1034,19845,3578733311,3578733353,42
1,1034,19846,3578733311,3578733356,45
1,1034,19847,3578733311,3578733356,45
1,1034,19848,3578733311,3578733357,46
1,1034,19849,3578733311,3578733358,47
1,1034,19850,3578733311,3578733358,47
1,1034,19851,3578733311,3578733359,48
1,1035,19852,3578733371,3578733371,0
1,1035,19853,3578733371,3578733371,0
1,1035,19854,3578733371,3578733371,0
1,1035,19855,3578733371,3578733371,0
1,1035,19856,3578733371,3578733371,0
1,1035,19857,3578733371,3578733371,0
1,1035,19858,3578733371,3578733371,0
1,1035,19859,3578733371,3578733371,0
1,1035,19860,3578733371,3578733372,1
1,1035,19861,3578733371,3578733372,1
1,1035,19862,3578733371,3578733374,3
1,1035,19863,3578733371,3578733376,5
1,1035,19864,3578733371,3578733376,5
1,1035,19865,3578733371,3578733377,6
1,1035,19866,3578733371,3578733380,9
1,1035,19867,3578733371,3578733382,11
1,1035,19868,3578733371,3578733382,11
1,1035,19869,3578733371,3578733384,13
1,1035,19870,3578733371,3578733384,13
1,1035,19871,3578733371,3578733385,14
1,1035,19872,3578733371,3578733386,15
1,1035,19873,3578733371,3578733387,16
1,1035,19874,3578733371,3578733391,20
1,1035,19875,3578733371,3578733391,20
1,1035,19876,3578733371,3578733391,20
1,1035,19877,3578733371,3578733392,21
1,1035,19878,3578733371,3578733392,21
1,1035,19879,3578733371,3578733393,22
1,1035,19880,3578733371,3578733396,25
1,1035,19881,3578733371,3578733396,25
1,1035,19882,3578733371,3578733397,26
1,1035,19883,3578733371,3578733397,26
1,1035,19884,3578733371,3578733398,27
1,1035,19885,3578733371,3578733399,28
1,1035,19886,3578733371,3578733399,28
1,1035,19887,3578733371,3578733401,30
1,1035,19888,3578733371,3578733402,31
1,1035,19889,3578733371,3578733402,31
1,1035,19890,3578733371,3578733403,32
1,1035,19891,3578733371,3578733404,33
1,1035,19892,3578733371,3578733406,35
1,1035,19893,3578733371,3578733407,36
1,1035,19894,3578733371,3578733411,40
1,1035,19895,3578733371,3578733413,42
1,1035,19896,3578733371,3578733414,43
1,1035,19897,3578733371,3578733416,45
1,1035,19898,3578733371,3578733418,47
1,1035,19899,3578733371,3578733419,48
1,1035,19900,3578733371,3578733419,48
1,1035,19901,3578733371,3578733419,48
1,1035,19902,3578733371,3578733419,48
1,1035,19903,3578733371,3578733420,49
1,1035,19904,3578733371,3578733420,49
1,1035,19905,3578733371,3578733421,50
1,1036,19906,3578733431,3578733431,0
1,1036,19907,3578733431,3578733431,0
1,1036,19908,3578733431,3578733431,0
1,1036,19909,3578733431,3578733431,0
1,1036,19910,3578733431,3578733431,0
1,1036,19911,3578733431,3578733431,0
1,1036,19912,3578733431,3578733431,0
1,1036,19913,3578733431,3578733431,0
1,1036,19914,3578733431,3578733431,0
1,1036,19915,3578733431,3578733431,0
1,1036,19916,3578733431,3578733435,4
1,1036,19917,3578733431,3578733436,5
1,1036,19918,3578733431,3578733436,5
1,1036,19919,3578733431,3578733439,8
1,1036,19920,3578733431,3578733439,8
1,1036,19921,3578733431,3578733440,9
1,1036,19922,3578733431,3578733440,9
1,1036,19923,3578733431,3578733441,10
1,1036,19924,3578733431,3578733443,12
1,1036,19925,3578733431,3578733445,14
1,1036,19926,3578733431,3578733447,16
1,1036,19927,3578733431,3578733448,17
1,1036,19928,3578733431,3578733448,17
1,1036,19929,3578733431,3578733448,17
1,1036,19930,3578733431,3578733452,21
1,1036,19931,3578733431,3578733454,23
1,1036,19932,3578733431,3578733458,27
1,1036,19933,3578733431,3578733462,31
1,1036,19934,3578733431,3578733463,32
1,1036,19935,3578733431,3578733463,32
1,1036,19936,3578733431,3578733464,33
1,1036,19937,3578733431,3578733464,33
1,1036,19938,3578733431,3578733465,34
1,1036,19939,3578733431,3578733467,36
1,1036,19940,3578733431,3578733468,37
1,1036,19941,3578733431,3578733469,38
1,1036,19942,3578733431,3578733470,39
1,1036,19943,3578733431,3578733470,39
1,1036,19944,3578733431,3578733470,39
1,1036,19945,3578733431,3578733470,39
1,1036,19946,3578733431,3578733471,40
1,1037,19947,3578733492,3578733492,0
1,1037,19948,3578733492,3578733492,0
1,1037,19949,3578733492,3578733492,0
1,1037,19950,3578733492,3578733492,0
1,1037,19951,3578733492,3578733492,0
1,1037,19952,3578733492,3578733492,0
1,1037,19953,3578733492,3578733492,0
1,1037,19954,3578733492,3578733492,0
1,1037,19955,3578733492,3578733495,3
1,1037,19956,3578733492,3578733497,5
1,1037,19957,3578733492,3578733499,7
1,1037,19958,3578733492,3578733499,7
1,1037,19959,3578733492,3578733499,7
1,1037,19960,3578733492,3578733499,7
1,1037,19961,3578733492,3578733500,8
1,1037,19962,3578733492,3578733500,8
1,1037,19963,3578733492,3578733502,10
1,1037,19964,3578733492,3578733502,10
1,1037,19965,3578733492,3578733503,11
1,1037,19966,3578733492,3578733505,13
1,1037,19967,3578733492,3578733505,13
1,1037,19968,3578733492,3578733505,13
1,1037,19969,3578733492,3578733506,14
1,1037,19970,3578733492,3578733506,14
1,1037,19971,3578733492,3578733509,17
1,1037,19972,3578733492,3578733511,19
1,1037,19973,3578733492,3578733511,19
1,1037,19974,3578733492,3578733511,19
1,1037,19975,3578733492,3578733512,20
1,1037,19976,3578733492,3578733513,21
1,1037,19977,3578733492,3578733514,22
1,1037,19978,3578733492,3578733514,22
1,1037,19979,3578733492,3578733515,23
1,1037,19980,3578733492,3578733515,23
1,1037,19981,3578733492,3578733516,24
1,1037,19982,3578733492,3578733517,25
1,1037,19983,3578733492,3578733518,26
1,1037,19984,3578733492,3578733518,26
1,1037,19985,3578733492,3578733519,27
1,1037,19986,3578733492,3578733520,28
1,1037,19987,3578733492,3578733522,30
1,1037,19988,3578733492,3578733523,31
1,1037,19989,3578733492,3578733524,32
1,1037,19990,3578733492,3578733524,32
1,1037,19991,3578733492,3578733524,32
1,1037,19992,3578733492,3578733525,33
1,1037,19993,3578733492,3578733526,34
1,1037,19994,3578733492,3578733526,34
1,1037,19995,3578733492,3578733526,34
1,1037,19996,3578733492,3578733526,34
1,1037,19997,3578733492,3578733528,36
1,1037,19998,3578733492,3578733529,37
1,1037,19999,3578733492,3578733529,37
1,1037,20000,3578733492,3578733530,38
1,1037,20001,3578733492,3578733532,40
1,1037,20002,3578733492,3578733533,41
1,1037,20003,3578733492,3578733533,41
1,1037,20004,3578733492,3578733533,41
1,1037,20005,3578733492,3578733533,41
1,1037,20006,3578733492,3578733534,42
1,1037,20007,3578733492,3578733535,43
1,1037,20008,3578733492,3578733536,44
1,1037,20009,3578733492,3578733536,44
1,1037,20010,3578733492,3578733538,46
1,1037,20011,3578733492,3578733538,46
1,1037,20012,3578733492,3578733540,48
1,1037,20013,3578733492,3578733540,48
1,1037,20014,3578733492,3578733541,49
1,1038,20015,3578733551,3578733551,0
1,1038,20016,3578733551,3578733551,0
1,1038,20017,3578733551,3578733551,0
1,1038,20018,3578733551,3578733551,0
1,1038,20019,3578733551,3578733551,0
1,1038,20020,3578733551,3578733552,1
1,1038,20021,3578733551,3578733556,5
1,1038,20022,3578733551,3578733556,5
1,1038,20023,3578733551,3578733557,6
1,1038,20024,3578733551,3578733558,7
1,1038,20025,3578733551,3578733558,7
1,1038,20026,3578733551,3578733561,10
1,1038,20027,3578733551,3578733561,10
1,1038,20028,3578733551,3578733562,11
1,1038,20029,3578733551,3578733564,13
1,1038,20030,3578733551,3578733564,13
1,1038,20031,3578733551,3578733564,13
1,1038,20032,3578733551,3578733565,14
1,1038,20033,3578733551,3578733571,20
1,1038,20034,3578733551,3578733571,20
1,1038,20035,3578733551,3578733572,21
1,1038,20036,3578733551,3578733574,23
1,1038,20037,3578733551,3578733575,24
1,1038,20038,3578733551,3578733575,24
1,1038,20039,3578733551,3578733579,28
1,1038,20040,3578733551,3578733581,30
1,1038,20041,3578733551,3578733581,30
1,1038,20042,3578733551,3578733583,32
1,1038,20043,3578733551,3578733583,32
1,1038,20044,3578733551,3578733584,33
1,1038,20045,3578733551,3578733585,34
1,1038,20046,3578733551,3578733586,35
1,1038,20047,3578733551,3578733589,38
1,1038,20048,3578733551,3578733591,40
1,1038,20049,3578733551,3578733591,40
1,1038,20050,3578733551,3578733591,40
1,1038,20051,3578733551,3578733592,41
1,1038,20052,3578733551,3578733592,41
1,1038,20053,3578733551,3578733593,42
1,1038,20054,3578733551,3578733594,43
1,1038,20055,3578733551,3578733596,45
1,1038,20056,3578733551,3578733596,45
1,1038,20057,3578733551,3578733597,46
1,1038,20058,3578733551,3578733598,47
1,1038,20059,3578733551,3578733600,49
1,1038,20060,3578733551,3578733601,50
1,1039,20061,3578733610,3578733610,0
1,1039,20062,3578733610,3578733610,0
1,1039,20063,3578733610,3578733610,0
1,1039,20064,3578733610,3578733610,0
1,1039,20065,3578733610,3578733610,0
1,1039,20066,3578733610,3578733612,2
1,1039,20067,3578733610,3578733613,3
1,1039,20068,3578733610,3578733613,3
1,1039,20069,3578733610,3578733616,6
1,1039,20070,3578733610,3578733617,7
1,1039,20071,3578733610,3578733618,8
1,1039,20072,3578733610,3578733619,9
1,1039,20073,3578733610,3578733619,9
1,1039,20074,3578733610,3578733619,9
1,1039,20075,3578733610,3578733619,9
1,1039,20076,3578733610,3578733620,10
1,1039,20077,3578733610,3578733621,11
1,1039,20078,3578733610,3578733622,12
1,1039,20079,3578733610,3578733622,12
1,1039,20080,3578733610,3578733624,14
1,1039,20081,3578733610,3578733624,14
1,1039,20082,3578733610,3578733625,15
1,1039,20083,3578733610,3578733626,16
1,1039,20084,3578733610,3578733627,17
1,1039,20085,3578733610,3578733627,17
1,1039,20086,3578733610,3578733628,18
1,1039,20087,3578733610,3578733628,18
1,1039,20088,3578733610,3578733635,25
1,1039,20089,3578733610,3578733635,25
1,1039,20090,3578733610,3578733638,28
1,1039,20091,3578733610,3578733638,28
1,1039,20092,3578733610,3578733639,29
1,1039,20093,3578733610,3578733640,30
1,1039,20094,3578733610,3578733640,30
1,1039,20095,3578733610,3578733642,32
1,1039,20096,3578733610,3578733644,34
1,1039,20097,3578733610,3578733646,36
1,1039,20098,3578733610,3578733647,37
1,1039,20099,3578733610,3578733648,38
1,1039,20100,3578733610,3578733648,38
1,1039,20101,3578733610,3578733650,40
1,1039,20102,3578733610,3578733653,43
1,1039,20103,3578733610,3578733656,46
1,1039,20104,3578733610,3578733656,46
1,1039,20105,3578733610,3578733660,50
1,1040,20106,3578733669,3578733669,0
1,1040,20107,3578733669,3578733669,0
1,1040,20108,3578733669,3578733669,0
1,1040,20109,3578733669,3578733669,0
1,1040,20110,3578733669,3578733669,0
1,1040,20111,3578733669,3578733669,0
1,1040,20112,3578733669,3578733669,0
1,1040,20113,3578733669,3578733669,0
1,1040,20114,3578733669,3578733669,0
1,1040,20115,3578733669,3578733669,0
1,1040,20116,3578733669,3578733669,0
1,1040,20117,3578733669,3578733669,0
1,1040,20118,3578733669,3578733669,0
1,1040,20119,3578733669,3578733683,14
1,1040,20120,3578733669,3578733685,16
1,1040,20121,3578733669,3578733685,16
1,1040,20122,3578733669,3578733686,17
1,1040,20123,3578733669,3578733688,19
1,1040,20124,3578733669,3578733691,22
1,1040,20125,3578733669,3578733691,22
1,1040,20126,3578733669,3578733695,26
1,1040,20127,3578733669,3578733698,29
1,1040,20128,3578733669,3578733699,30
1,1040,20129,3578733669,3578733699,30
1,1040,20130,3578733669,3578733699,30
1,1040,20131,3578733669,3578733699,30
1,1040,20132,3578733669,3578733700,31
1,1040,20133,3578733669,3578733702,33
1,1040,20134,3578733669,3578733702,33
1,1040,20135,3578733669,3578733704,35
1,1040,20136,3578733669,3578733705,36
1,1040,20137,3578733669,3578733706,37
1,1040,20138,3578733669,3578733706,37
1,1040,20139,3578733669,3578733709,40
1,1040,20140,3578733669,3578733711,42
1,1040,20141,3578733669,3578733711,42
1,1040,20142,3578733669,3578733712,43
1,1040,20143,3578733669,3578733713,44
1,1040,20144,3578733669,3578733714,45
1,1040,20145,3578733669,3578733715,46
1,1040,20146,3578733669,3578733716,47
1,1040,20147,3578733669,3578733717,48
1,1040,20148,3578733669,3578733718,49
1,1040,20149,3578733669,3578733718,49
1,1040,20150,3578733669,3578733719,50
1,1041,20151,3578733727,3578733727,0
1,1041,20152,3578733727,3578733727,0
1,1041,20153,3578733727,3578733727,0
1,1041,20154,3578733727,3578733727,0
1,1041,20155,3578733727,3578733727,0
1,1041,20156,3578733727,3578733727,0
1,1041,20157,3578733727,3578733728,1
1,1041,20158,3578733727,3578733728,1
1,1041,20159,3578733727,3578733728,1
1,1041,20160,3578733727,3578733728,1
1,1041,20161,3578733727,3578733728,1
1,1041,20162,3578733727,3578733728,1
1,1041,20163,3578733727,3578733728,1
1,1041,20164,3578733727,3578733729,2
1,1041,20165,3578733727,3578733729,2
1,1041,20166,3578733727,3578733729,2
1,1041,20167,3578733727,3578733733,6
1,1041,20168,3578733727,3578733733,6
1,1041,20169,3578733727,3578733733,6
1,1041,20170,3578733727,3578733734,7
1,1041,20171,3578733727,3578733734,7
1,1041,20172,3578733727,3578733734,7
1,1041,20173,3578733727,3578733736,9
1,1041,20174,3578733727,3578733736,9
1,1041,20175,3578733727,3578733737,10
1,1041,20176,3578733727,3578733738,11
1,1041,20177,3578733727,3578733738,11
1,1041,20178,3578733727,3578733740,13
1,1041,20179,3578733727,3578733740,13
1,1041,20180,3578733727,3578733742,15
1,1041,20181,3578733727,3578733743,16
1,1041,20182,3578733727,3578733744,17
1,1041,20183,3578733727,3578733745,18
1,1041,20184,3578733727,3578733748,21
1,1041,20185,3578733727,3578733751,24
1,1041,20186,3578733727,3578733751,24
1,1041,20187,3578733727,3578733752,25
1,1041,20188,3578733727,3578733752,25
1,1041,20189,3578733727,3578733756,29
1,1041,20190,3578733727,3578733756,29
1,1041,20191,3578733727,3578733757,30
1,1041,20192,3578733727,3578733758,31
1,1041,20193,3578733727,3578733759,32
1,1041,20194,3578733727,3578733761,34
1,1041,20195,3578733727,3578733762,35
1,1041,20196,3578733727,3578733763,36
1,1041,20197,3578733727,3578733765,38
1,1041,20198,3578733727,3578733765,38
1,1041,20199,3578733727,3578733770,43
1,1041,20200,3578733727,3578733770,43
1,1041,20201,3578733727,3578733771,44
1,1041,20202,3578733727,3578733773,46
1,1041,20203,3578733727,3578733775,48
1,1041,20204,3578733727,3578733775,48
1,1041,20205,3578733727,3578733776,49
1,1042,20206,3578733790,3578733790,0
1,1042,20207,3578733790,3578733790,0
1,1042,20208,3578733790,3578733790,0
1,1042,20209,3578733790,3578733790,0
1,1042,20210,3578733790,3578733790,0
1,1042,20211,3578733790,3578733790,0
1,1042,20212,3578733790,3578733790,0
1,1042,20213,3578733790,3578733790,0
1,1042,20214,3578733790,3578733790,0
1,1042,20215,3578733790,3578733791,1
1,1042,20216,3578733790,3578733791,1
1,1042,20217,3578733790,3578733791,1
1,1042,20218,3578733790,3578733792,2
1,1042,20219,3578733790,3578733792,2
1,1042,20220,3578733790,3578733793,3
1,1042,20221,3578733790,3578733795,5
1,1042,20222,3578733790,3578733796,6
1,1042,20223,3578733790,3578733796,6
1,1042,20224,3578733790,3578733797,7
1,1042,20225,3578733790,3578733799,9
1,1042,20226,3578733790,3578733799,9
1,1042,20227,3578733790,3578733800,10
1,1042,20228,3578733790,3578733800,10
1,1042,20229,3578733790,3578733801,11
1,1042,20230,3578733790,3578733802,12
1,1042,20231,3578733790,3578733803,13
1,1042,20232,3578733790,3578733806,16
1,1042,20233,3578733790,3578733807,17
1,1042,20234,3578733790,3578733808,18
1,1042,20235,3578733790,3578733810,20
1,1042,20236,3578733790,3578733812,22
1,1042,20237,3578733790,3578733813,23
1,1042,20238,3578733790,3578733814,24
1,1042,20239,3578733790,3578733816,26
1,1042,20240,3578733790,3578733816,26
1,1042,20241,3578733790,3578733818,28
1,1042,20242,3578733790,3578733818,28
1,1042,20243,3578733790,3578733818,28
1,1042,20244,3578733790,3578733818,28
1,1042,20245,3578733790,3578733819,29
1,1042,20246,3578733790,3578733820,30
1,1042,20247,3578733790,3578733820,30
1,1042,20248,3578733790,3578733823,33
1,1042,20249,3578733790,3578733824,34
1,1042,20250,3578733790,3578733824,34
1,1042,20251,3578733790,3578733825,35
1,1042,20252,3578733790,3578733826,36
1,1042,20253,3578733790,3578733827,37
1,1042,20254,3578733790,3578733827,37
1,1042,20255,3578733790,3578733828,38
1,1042,20256,3578733790,3578733828,38
1,1042,20257,3578733790,3578733829,39
1,1042,20258,3578733790,3578733831,41
1,1042,20259,3578733790,3578733834,44
1,1042,20260,3578733790,3578733835,45
1,1042,20261,3578733790,3578733836,46
1,1042,20262,3578733790,3578733838,48
1,1042,20263,3578733790,3578733838,48
1,1042,20264,3578733790,3578733838,48
1,1042,20265,3578733790,3578733839,49
1,1043,20266,3578733853,3578733853,0
1,1043,20267,3578733853,3578733853,0
1,1043,20268,3578733853,3578733853,0
1,1043,20269,3578733853,3578733853,0
1,1043,20270,3578733853,3578733853,0
1,1043,20271,3578733853,3578733853,0
1,1043,20272,3578733853,3578733853,0
1,1043,20273,3578733853,3578733853,0
1,1043,20274,3578733853,3578733853,0
1,1043,20275,3578733853,3578733853,0
1,1043,20276,3578733853,3578733853,0
1,1043,20277,3578733853,3578733854,1
1,1043,20278,3578733853,3578733855,2
1,1043,20279,3578733853,3578733857,4
1,1043,20280,3578733853,3578733858,5
1,1043,20281,3578733853,3578733860,7
1,1043,20282,3578733853,3578733860,7
1,1043,20283,3578733853,3578733863,10
1,1043,20284,3578733853,3578733864,11
1,1043,20285,3578733853,3578733864,11
1,1043,20286,3578733853,3578733865,12
1,1043,20287,3578733853,3578733866,13
1,1043,20288,3578733853,3578733867,14
1,1043,20289,3578733853,3578733867,14
1,1043,20290,3578733853,3578733868,15
1,1043,20291,3578733853,3578733868,15
1,1043,20292,3578733853,3578733870,17
1,1043,20293,3578733853,3578733870,17
1,1043,20294,3578733853,3578733871,18
1,1043,20295,3578733853,3578733883,30
1,1043,20296,3578733853,3578733884,31
1,1043,20297,3578733853,3578733886,33
1,1043,20298,3578733853,3578733887,34
1,1043,20299,3578733853,3578733888,35
1,1043,20300,3578733853,3578733891,38
1,1043,20301,3578733853,3578733892,39
1,1043,20302,3578733853,3578733895,42
1,1043,20303,3578733853,3578733898,45
1,1043,20304,3578733853,3578733899,46
1,1043,20305,3578733853,3578733899,46
1,1043,20306,3578733853,3578733899,46
1,1043,20307,3578733853,3578733900,47
1,1043,20308,3578733853,3578733900,47
1,1043,20309,3578733853,3578733901,48
1,1043,20310,3578733853,3578733902,49
1,1043,20311,3578733853,3578733903,50
1,1044,20312,3578734010,3578734010,0
1,1044,20313,3578734010,3578734010,0
1,1044,20314,3578734010,3578734010,0
1,1044,20315,3578734010,3578734010,0
1,1044,20316,3578734010,3578734010,0
1,1044,20317,3578734010,3578734010,0
1,1044,20318,3578734010,3578734010,0
1,1044,20319,3578734010,3578734010,0
1,1044,20320,3578734010,3578734010,0
1,1044,20321,3578734010,3578734010,0
1,1044,20322,3578734010,3578734010,0
1,1044,20323,3578734010,3578734010,0
1,1044,20324,3578734010,3578734010,0
1,1044,20325,3578734010,3578734010,0
1,1044,20326,3578734010,3578734010,0
1,1044,20327,3578734010,3578734010,0
1,1044,20328,3578734010,3578734010,0
1,1044,20329,3578734010,3578734010,0
1,1044,20330,3578734010,3578734010,0
1,1044,20331,3578734010,3578734010,0
1,1044,20332,3578734010,3578734010,0
1,1044,20333,3578734010,3578734010,0
1,1044,20334,3578734010,3578734010,0
1,1044,20335,3578734010,3578734010,0
1,1044,20336,3578734010,3578734010,0
1,1044,20337,3578734010,3578734010,0
1,1044,20338,3578734010,3578734010,0
1,1044,20339,3578734010,3578734010,0
1,1044,20340,3578734010,3578734010,0
1,1044,20341,3578734010,3578734011,1
1,1044,20342,3578734010,3578734011,1
1,1044,20343,3578734010,3578734011,1
1,1044,20344,3578734010,3578734011,1
1,1044,20345,3578734010,3578734011,1
1,1044,20346,3578734010,3578734011,1
1,1044,20347,3578734010,3578734011,1
1,1044,20348,3578734010,3578734011,1
1,1044,20349,3578734010,3578734011,1
1,1044,20350,3578734010,3578734011,1
1,1044,20351,3578734010,3578734011,1
1,1044,20352,3578734010,3578734011,1
1,1044,20353,3578734010,3578734011,1
1,1044,20354,3578734010,3578734011,1
1,1044,20355,3578734010,3578734011,1
1,1044,20356,3578734010,3578734011,1
1,1044,20357,3578734010,3578734011,1
1,1044,20358,3578734010,3578734011,1
1,1044,20359,3578734010,3578734011,1
1,1044,20360,3578734010,3578734011,1
1,1044,20361,3578734010,3578734011,1
1,1044,20362,3578734010,3578734011,1
1,1044,20363,3578734010,3578734011,1
1,1044,20364,3578734010,3578734011,1
1,1044,20365,3578734010,3578734011,1
1,1044,20366,3578734010,3578734011,1
1,1044,20367,3578734010,3578734011,1
1,1044,20368,3578734010,3578734011,1
1,1044,20369,3578734010,3578734011,1
1,1044,20370,3578734010,3578734011,1
1,1044,20371,3578734010,3578734011,1
1,1044,20372,3578734010,3578734011,1
1,1044,20373,3578734010,3578734011,1
1,1044,20374,3578734010,3578734011,1
1,1044,20375,3578734010,3578734011,1
1,1044,20376,3578734010,3578734011,1
1,1044,20377,3578734010,3578734011,1
1,1044,20378,3578734010,3578734011,1
1,1044,20379,3578734010,3578734011,1
1,1044,20380,3578734010,3578734011,1
1,1044,20381,3578734010,3578734011,1
1,1044,20382,3578734010,3578734011,1
1,1044,20383,3578734010,3578734011,1
1,1044,20384,3578734010,3578734011,1
1,1044,20385,3578734010,3578734011,1
1,1044,20386,3578734010,3578734011,1
1,1044,20387,3578734010,3578734011,1
1,1044,20388,3578734010,3578734011,1
1,1044,20389,3578734010,3578734011,1
1,1044,20390,3578734010,3578734011,1
1,1044,20391,3578734010,3578734011,1
1,1044,20392,3578734010,3578734011,1
1,1044,20393,3578734010,3578734011,1
1,1044,20394,3578734010,3578734011,1
1,1044,20395,3578734010,3578734011,1
1,1044,20396,3578734010,3578734011,1
1,1044,20397,3578734010,3578734011,1
1,1044,20398,3578734010,3578734011,1
1,1044,20399,3578734010,3578734011,1
1,1044,20400,3578734010,3578734011,1
1,1044,20401,3578734010,3578734011,1
1,1044,20402,3578734010,3578734011,1
1,1044,20403,3578734010,3578734011,1
1,1044,20404,3578734010,3578734011,1
1,1044,20405,3578734010,3578734011,1
1,1044,20406,3578734010,3578734011,1
1,1044,20407,3578734010,3578734011,1
1,1044,20408,3578734010,3578734011,1
1,1044,20409,3578734010,3578734011,1
1,1044,20410,3578734010,3578734011,1
1,1044,20411,3578734010,3578734011,1
1,1044,20412,3578734010,3578734011,1
1,1044,20413,3578734010,3578734012,2
1,1044,20414,3578734010,3578734013,3
1,1044,20415,3578734010,3578734015,5
1,1044,20416,3578734010,3578734016,6
1,1044,20417,3578734010,3578734018,8
1,1044,20418,3578734010,3578734019,9
1,1044,20419,3578734010,3578734019,9
1,1044,20420,3578734010,3578734019,9
1,1044,20421,3578734010,3578734019,9
1,1044,20422,3578734010,3578734020,10
1,1044,20423,3578734010,3578734022,12
1,1044,20424,3578734010,3578734024,14
1,1044,20425,3578734010,3578734024,14
1,1044,20426,3578734010,3578734026,16
1,1044,20427,3578734010,3578734027,17
1,1044,20428,3578734010,3578734027,17
1,1044,20429,3578734010,3578734027,17
1,1044,20430,3578734010,3578734028,18
1,1044,20431,3578734010,3578734028,18
1,1044,20432,3578734010,3578734030,20
1,1044,20433,3578734010,3578734030,20
1,1044,20434,3578734010,3578734031,21
1,1044,20435,3578734010,3578734035,25
1,1044,20436,3578734010,3578734035,25
1,1044,20437,3578734010,3578734035,25
1,1044,20438,3578734010,3578734038,28
1,1044,20439,3578734010,3578734038,28
1,1044,20440,3578734010,3578734039,29
1,1044,20441,3578734010,3578734039,29
1,1044,20442,3578734010,3578734041,31
1,1044,20443,3578734010,3578734042,32
1,1044,20444,3578734010,3578734047,37
1,1044,20445,3578734010,3578734047,37
1,1044,20446,3578734010,3578734048,38
1,1044,20447,3578734010,3578734048,38
1,1044,20448,3578734010,3578734050,40
1,1044,20449,3578734010,3578734053,43
1,1044,20450,3578734010,3578734053,43
1,1044,20451,3578734010,3578734054,44
1,1044,20452,3578734010,3578734055,45
1,1044,20453,3578734010,3578734057,47
1,1044,20454,3578734010,3578734057,47
1,1044,20455,3578734010,3578734058,48
1,1044,20456,3578734010,3578734060,50
1,1045,20457,3578734070,3578734070,0
1,1045,20458,3578734070,3578734070,0
1,1045,20459,3578734070,3578734070,0
1,1045,20460,3578734070,3578734070,0
1,1045,20461,3578734070,3578734070,0
1,1045,20462,3578734070,3578734070,0
1,1045,20463,3578734070,3578734070,0
1,1045,20464,3578734070,3578734070,0
1,1045,20465,3578734070,3578734070,0
1,1045,20466,3578734070,3578734070,0
1,1045,20467,3578734070,3578734070,0
1,1045,20468,3578734070,3578734070,0
1,1045,20469,3578734070,3578734071,1
1,1045,20470,3578734070,3578734084,14
1,1045,20471,3578734070,3578734086,16
1,1045,20472,3578734070,3578734088,18
1,1045,20473,3578734070,3578734088,18
1,1045,20474,3578734070,3578734091,21
1,1045,20475,3578734070,3578734091,21
1,1045,20476,3578734070,3578734094,24
1,1045,20477,3578734070,3578734095,25
1,1045,20478,3578734070,3578734098,28
1,1045,20479,3578734070,3578734099,29
1,1045,20480,3578734070,3578734099,29
1,1045,20481,3578734070,3578734100,30
1,1045,20482,3578734070,3578734100,30
1,1045,20483,3578734070,3578734101,31
1,1045,20484,3578734070,3578734102,32
1,1045,20485,3578734070,3578734103,33
1,1045,20486,3578734070,3578734104,34
1,1045,20487,3578734070,3578734105,35
1,1045,20488,3578734070,3578734106,36
1,1045,20489,3578734070,3578734106,36
1,1045,20490,3578734070,3578734107,37
1,1045,20491,3578734070,3578734107,37
1,1045,20492,3578734070,3578734109,39
1,1045,20493,3578734070,3578734111,41
1,1045,20494,3578734070,3578734112,42
1,1045,20495,3578734070,3578734112,42
1,1045,20496,3578734070,3578734113,43
1,1045,20497,3578734070,3578734113,43
1,1045,20498,3578734070,3578734114,44
1,1045,20499,3578734070,3578734116,46
1,1045,20500,3578734070,3578734117,47
1,1045,20501,3578734070,3578734117,47
1,1045,20502,3578734070,3578734118,48
1,1045,20503,3578734070,3578734119,49
1,1045,20504,3578734070,3578734119,49
1,1045,20505,3578734070,3578734120,50
1,1046,20506,3578734129,3578734129,0
1,1046,20507,3578734129,3578734129,0
1,1046,20508,3578734129,3578734129,0
1,1046,20509,3578734129,3578734129,0
1,1046,20510,3578734129,3578734129,0
1,1046,20511,3578734129,3578734129,0
1,1046,20512,3578734129,3578734129,0
1,1046,20513,3578734129,3578734129,0
1,1046,20514,3578734129,3578734129,0
1,1046,20515,3578734129,3578734129,0
1,1046,20516,3578734129,3578734129,0
1,1046,20517,3578734129,3578734129,0
1,1046,20518,3578734129,3578734129,0
1,1046,20519,3578734129,3578734131,2
1,1046,20520,3578734129,3578734131,2
1,1046,20521,3578734129,3578734132,3
1,1046,20522,3578734129,3578734133,4
1,1046,20523,3578734129,3578734134,5
1,1046,20524,3578734129,3578734134,5
1,1046,20525,3578734129,3578734134,5
1,1046,20526,3578734129,3578734135,6
1,1046,20527,3578734129,3578734135,6
1,1046,20528,3578734129,3578734136,7
1,1046,20529,3578734129,3578734138,9
1,1046,20530,3578734129,3578734138,9
1,1046,20531,3578734129,3578734138,9
1,1046,20532,3578734129,3578734140,11
1,1046,20533,3578734129,3578734141,12
1,1046,20534,3578734129,3578734143,14
1,1046,20535,3578734129,3578734143,14
1,1046,20536,3578734129,3578734146,17
1,1046,20537,3578734129,3578734148,19
1,1046,20538,3578734129,3578734150,21
1,1046,20539,3578734129,3578734152,23
1,1046,20540,3578734129,3578734153,24
1,1046,20541,3578734129,3578734155,26
1,1046,20542,3578734129,3578734156,27
1,1046,20543,3578734129,3578734156,27
1,1046,20544,3578734129,3578734157,28
1,1046,20545,3578734129,3578734159,30
1,1046,20546,3578734129,3578734159,30
1,1046,20547,3578734129,3578734163,34
1,1046,20548,3578734129,3578734163,34
1,1046,20549,3578734129,3578734166,37
1,1046,20550,3578734129,3578734166,37
1,1046,20551,3578734129,3578734166,37
1,1046,20552,3578734129,3578734167,38
1,1046,20553,3578734129,3578734170,41
1,1046,20554,3578734129,3578734171,42
1,1046,20555,3578734129,3578734171,42
1,1046,20556,3578734129,3578734173,44
1,1046,20557,3578734129,3578734174,45
1,1046,20558,3578734129,3578734174,45
1,1046,20559,3578734129,3578734177,48
1,1047,20560,3578734187,3578734187,0
1,1047,20561,3578734187,3578734187,0
1,1047,20562,3578734187,3578734187,0
1,1047,20563,3578734187,3578734187,0
1,1047,20564,3578734187,3578734187,0
1,1047,20565,3578734187,3578734187,0
1,1047,20566,3578734187,3578734187,0
1,1047,20567,3578734187,3578734187,0
1,1047,20568,3578734187,3578734191,4
1,1047,20569,3578734187,3578734191,4
1,1047,20570,3578734187,3578734192,5
1,1047,20571,3578734187,3578734192,5
1,1047,20572,3578734187,3578734192,5
1,1047,20573,3578734187,3578734193,6
1,1047,20574,3578734187,3578734195,8
1,1047,20575,3578734187,3578734196,9
1,1047,20576,3578734187,3578734196,9
1,1047,20577,3578734187,3578734197,10
1,1047,20578,3578734187,3578734198,11
1,1047,20579,3578734187,3578734199,12
1,1047,20580,3578734187,3578734200,13
1,1047,20581,3578734187,3578734201,14
1,1047,20582,3578734187,3578734201,14
1,1047,20583,3578734187,3578734203,16
1,1047,20584,3578734187,3578734205,18
1,1047,20585,3578734187,3578734207,20
1,1047,20586,3578734187,3578734207,20
1,1047,20587,3578734187,3578734209,22
1,1047,20588,3578734187,3578734211,24
1,1047,20589,3578734187,3578734211,24
1,1047,20590,3578734187,3578734214,27
1,1047,20591,3578734187,3578734216,29
1,1047,20592,3578734187,3578734217,30
1,1047,20593,3578734187,3578734217,30
1,1047,20594,3578734187,3578734218,31
1,1047,20595,3578734187,3578734218,31
1,1047,20596,3578734187,3578734219,32
1,1047,20597,3578734187,3578734220,33
1,1047,20598,3578734187,3578734220,33
1,1047,20599,3578734187,3578734220,33
1,1047,20600,3578734187,3578734223,36
1,1047,20601,3578734187,3578734224,37
1,1047,20602,3578734187,3578734224,37
1,1047,20603,3578734187,3578734226,39
1,1047,20604,3578734187,3578734227,40
1,1047,20605,3578734187,3578734228,41
1,1047,20606,3578734187,3578734228,41
1,1047,20607,3578734187,3578734228,41
1,1047,20608,3578734187,3578734230,43
1,1047,20609,3578734187,3578734230,43
1,1047,20610,3578734187,3578734231,44
1,1047,20611,3578734187,3578734234,47
1,1047,20612,3578734187,3578734235,48
1,1047,20613,3578734187,3578734235,48
1,1048,20614,3578734245,3578734245,0
1,1048,20615,3578734245,3578734245,0
1,1048,20616,3578734245,3578734245,0
1,1048,20617,3578734245,3578734245,0
1,1048,20618,3578734245,3578734245,0
1,1048,20619,3578734245,3578734245,0
1,1048,20620,3578734245,3578734245,0
1,1048,20621,3578734245,3578734247,2
1,1048,20622,3578734245,3578734248,3
1,1048,20623,3578734245,3578734249,4
1,1048,20624,3578734245,3578734252,7
1,1048,20625,3578734245,3578734253,8
1,1048,20626,3578734245,3578734254,9
1,1048,20627,3578734245,3578734254,9
1,1048,20628,3578734245,3578734256,11
1,1048,20629,3578734245,3578734257,12
1,1048,20630,3578734245,3578734259,14
1,1048,20631,3578734245,3578734260,15
1,1048,20632,3578734245,3578734262,17
1,1048,20633,3578734245,3578734265,20
1,1048,20634,3578734245,3578734266,21
1,1048,20635,3578734245,3578734267,22
1,1048,20636,3578734245,3578734268,23
1,1048,20637,3578734245,3578734269,24
1,1048,20638,3578734245,3578734269,24
1,1048,20639,3578734245,3578734269,24
1,1048,20640,3578734245,3578734270,25
1,1048,20641,3578734245,3578734270,25
1,1048,20642,3578734245,3578734271,26
1,1048,20643,3578734245,3578734284,39
1,1048,20644,3578734245,3578734285,40
1,1048,20645,3578734245,3578734285,40
1,1048,20646,3578734245,3578734287,42
1,1048,20647,3578734245,3578734288,43
1,1048,20648,3578734245,3578734291,46
1,1048,20649,3578734245,3578734291,46
1,1048,20650,3578734245,3578734294,49
1,1048,20651,3578734245,3578734294,49
1,1048,20652,3578734245,3578734295,50
1,1049,20653,3578734305,3578734305,0
1,1049,20654,3578734305,3578734305,0
1,1049,20655,3578734305,3578734305,0
1,1049,20656,3578734305,3578734305,0
1,1049,20657,3578734305,3578734305,0
1,1049,20658,3578734305,3578734305,0
1,1049,20659,3578734305,3578734305,0
1,1049,20660,3578734305,3578734305,0
1,1049,20661,3578734305,3578734305,0
1,1049,20662,3578734305,3578734305,0
1,1049,20663,3578734305,3578734305,0
1,1049,20664,3578734305,3578734306,1
1,1049,20665,3578734305,3578734307,2
1,1049,20666,3578734305,3578734307,2
1,1049,20667,3578734305,3578734309,4
1,1049,20668,3578734305,3578734312,7
1,1049,20669,3578734305,3578734312,7
1,1049,20670,3578734305,3578734313,8
1,1049,20671,3578734305,3578734315,10
1,1049,20672,3578734305,3578734315,10
1,1049,20673,3578734305,3578734315,10
1,1049,20674,3578734305,3578734316,11
1,1049,20675,3578734305,3578734317,12
1,1049,20676,3578734305,3578734318,13
1,1049,20677,3578734305,3578734318,13
1,1049,20678,3578734305,3578734319,14
1,1049,20679,3578734305,3578734324,19
1,1049,20680,3578734305,3578734325,20
1,1049,20681,3578734305,3578734325,20
1,1049,20682,3578734305,3578734326,21
1,1049,20683,3578734305,3578734326,21
1,1049,20684,3578734305,3578734327,22
1,1049,20685,3578734305,3578734327,22
1,1049,20686,3578734305,3578734327,22
1,1049,20687,3578734305,3578734327,22
1,1049,20688,3578734305,3578734330,25
1,1049,20689,3578734305,3578734330,25
1,1049,20690,3578734305,3578734331,26
1,1049,20691,3578734305,3578734333,28
1,1049,20692,3578734305,3578734333,28
1,1049,20693,3578734305,3578734334,29
1,1049,20694,3578734305,3578734334,29
1,1049,20695,3578734305,3578734334,29
1,1049,20696,3578734305,3578734334,29
1,1049,20697,3578734305,3578734336,31
1,1049,20698,3578734305,3578734336,31
1,1049,20699,3578734305,3578734337,32
1,1049,20700,3578734305,3578734337,32
1,1049,20701,3578734305,3578734338,33
1,1049,20702,3578734305,3578734338,33
1,1049,20703,3578734305,3578734341,36
1,1049,20704,3578734305,3578734341,36
1,1049,20705,3578734305,3578734343,38
1,1049,20706,3578734305,3578734344,39
1,1049,20707,3578734305,3578734346,41
1,1049,20708,3578734305,3578734348,43
1,1049,20709,3578734305,3578734351,46
1,1049,20710,3578734305,3578734353,48
1,1049,20711,3578734305,3578734353,48
1,1049,20712,3578734305,3578734355,50
1,1050,20713,3578734363,3578734363,0
1,1050,20714,3578734363,3578734363,0
1,1050,20715,3578734363,3578734363,0
1,1050,20716,3578734363,3578734363,0
1,1050,20717,3578734363,3578734363,0
1,1050,20718,3578734363,3578734363,0
1,1050,20719,3578734363,3578734363,0
1,1050,20720,3578734363,3578734363,0
1,1050,20721,3578734363,3578734366,3
1,1050,20722,3578734363,3578734366,3
1,1050,20723,3578734363,3578734369,6
1,1050,20724,3578734363,3578734370,7
1,1050,20725,3578734363,3578734371,8
1,1050,20726,3578734363,3578734373,10
1,1050,20727,3578734363,3578734375,12
1,1050,20728,3578734363,3578734375,12
1,1050,20729,3578734363,3578734377,14
1,1050,20730,3578734363,3578734382,19
1,1050,20731,3578734363,3578734383,20
1,1050,20732,3578734363,3578734383,20
1,1050,20733,3578734363,3578734384,21
1,1050,20734,3578734363,3578734384,21
1,1050,20735,3578734363,3578734384,21
1,1050,20736,3578734363,3578734386,23
1,1050,20737,3578734363,3578734387,24
1,1050,20738,3578734363,3578734391,28
1,1050,20739,3578734363,3578734392,29
1,1050,20740,3578734363,3578734392,29
1,1050,20741,3578734363,3578734392,29
1,1050,20742,3578734363,3578734393,30
1,1050,20743,3578734363,3578734393,30
1,1050,20744,3578734363,3578734393,30
1,1050,20745,3578734363,3578734395,32
1,1050,20746,3578734363,3578734396,33
1,1050,20747,3578734363,3578734397,34
1,1050,20748,3578734363,3578734397,34
1,1050,20749,3578734363,3578734399,36
1,1050,20750,3578734363,3578734401,38
1,1050,20751,3578734363,3578734401,38
1,1050,20752,3578734363,3578734402,39
1,1050,20753,3578734363,3578734402,39
1,1050,20754,3578734363,3578734405,42
1,1050,20755,3578734363,3578734407,44
1,1050,20756,3578734363,3578734407,44
1,1050,20757,3578734363,3578734410,47
1,1050,20758,3578734363,3578734412,49
1,1050,20759,3578734363,3578734412,49
1,1051,20760,3578734425,3578734425,0
1,1051,20761,3578734425,3578734425,0
1,1051,20762,3578734425,3578734425,0
1,1051,20763,3578734425,3578734425,0
1,1051,20764,3578734425,3578734425,0
1,1051,20765,3578734425,3578734425,0
1,1051,20766,3578734425,3578734425,0
1,1051,20767,3578734425,3578734425,0
1,1051,20768,3578734425,3578734425,0
1,1051,20769,3578734425,3578734425,0
1,1051,20770,3578734425,3578734425,0
1,1051,20771,3578734425,3578734425,0
1,1051,20772,3578734425,3578734425,0
1,1051,20773,3578734425,3578734427,2
1,1051,20774,3578734425,3578734427,2
1,1051,20775,3578734425,3578734428,3
1,1051,20776,3578734425,3578734428,3
1,1051,20777,3578734425,3578734428,3
1,1051,20778,3578734425,3578734430,5
1,1051,20779,3578734425,3578734430,5
1,1051,20780,3578734425,3578734430,5
1,1051,20781,3578734425,3578734435,10
1,1051,20782,3578734425,3578734435,10
1,1051,20783,3578734425,3578734435,10
1,1051,20784,3578734425,3578734439,14
1,1051,20785,3578734425,3578734439,14
1,1051,20786,3578734425,3578734441,16
1,1051,20787,3578734425,3578734442,17
1,1051,20788,3578734425,3578734443,18
1,1051,20789,3578734425,3578734445,20
1,1051,20790,3578734425,3578734447,22
1,1051,20791,3578734425,3578734448,23
1,1051,20792,3578734425,3578734450,25
1,1051,20793,3578734425,3578734452,27
1,1051,20794,3578734425,3578734453,28
1,1051,20795,3578734425,3578734454,29
1,1051,20796,3578734425,3578734455,30
1,1051,20797,3578734425,3578734457,32
1,1051,20798,3578734425,3578734458,33
1,1051,20799,3578734425,3578734459,34
1,1051,20800,3578734425,3578734461,36
1,1051,20801,3578734425,3578734462,37
1,1051,20802,3578734425,3578734463,38
1,1051,20803,3578734425,3578734465,40
1,1051,20804,3578734425,3578734465,40
1,1051,20805,3578734425,3578734465,40
1,1051,20806,3578734425,3578734467,42
1,1051,20807,3578734425,3578734468,43
1,1051,20808,3578734425,3578734468,43
1,1051,20809,3578734425,3578734469,44
1,1051,20810,3578734425,3578734470,45
1,1051,20811,3578734425,3578734470,45
1,1051,20812,3578734425,3578734470,45
1,1051,20813,3578734425,3578734472,47
1,1052,20814,3578734484,3578734484,0
1,1052,20815,3578734484,3578734484,0
1,1052,20816,3578734484,3578734485,1
1,1052,20817,3578734484,3578734486,2
1,1052,20818,3578734484,3578734487,3
1,1052,20819,3578734484,3578734492,8
1,1052,20820,3578734484,3578734493,9
1,1052,20821,3578734484,3578734493,9
1,1052,20822,3578734484,3578734494,10
1,1052,20823,3578734484,3578734498,14
1,1052,20824,3578734484,3578734499,15
1,1052,20825,3578734484,3578734499,15
1,1052,20826,3578734484,3578734499,15
1,1052,20827,3578734484,3578734500,16
1,1052,20828,3578734484,3578734501,17
1,1052,20829,3578734484,3578734501,17
1,1052,20830,3578734484,3578734501,17
1,1052,20831,3578734484,3578734502,18
1,1052,20832,3578734484,3578734503,19
1,1052,20833,3578734484,3578734504,20
1,1052,20834,3578734484,3578734505,21
1,1052,20835,3578734484,3578734505,21
1,1052,20836,3578734484,3578734506,22
1,1052,20837,3578734484,3578734507,23
1,1052,20838,3578734484,3578734508,24
1,1052,20839,3578734484,3578734511,27
1,1052,20840,3578734484,3578734511,27
1,1052,20841,3578734484,3578734511,27
1,1052,20842,3578734484,3578734512,28
1,1052,20843,3578734484,3578734513,29
1,1052,20844,3578734484,3578734513,29
1,1052,20845,3578734484,3578734515,31
1,1052,20846,3578734484,3578734515,31
1,1052,20847,3578734484,3578734516,32
1,1052,20848,3578734484,3578734517,33
1,1052,20849,3578734484,3578734517,33
1,1052,20850,3578734484,3578734517,33
1,1052,20851,3578734484,3578734519,35
1,1052,20852,3578734484,3578734520,36
1,1052,20853,3578734484,3578734520,36
1,1052,20854,3578734484,3578734523,39
1,1052,20855,3578734484,3578734523,39
1,1052,20856,3578734484,3578734524,40
1,1052,20857,3578734484,3578734525,41
1,1052,20858,3578734484,3578734525,41
1,1052,20859,3578734484,3578734526,42
1,1052,20860,3578734484,3578734526,42
1,1052,20861,3578734484,3578734526,42
1,1052,20862,3578734484,3578734526,42
1,1052,20863,3578734484,3578734527,43
1,1052,20864,3578734484,3578734528,44
1,1052,20865,3578734484,3578734528,44
1,1052,20866,3578734484,3578734529,45
1,1052,20867,3578734484,3578734530,46
1,1052,20868,3578734484,3578734532,48
1,1052,20869,3578734484,3578734532,48
1,1052,20870,3578734484,3578734533,49
1,1052,20871,3578734484,3578734533,49
1,1052,20872,3578734484,3578734534,50
1,1053,20873,3578734543,3578734543,0
1,1053,20874,3578734543,3578734543,0
1,1053,20875,3578734543,3578734543,0
1,1053,20876,3578734543,3578734543,0
1,1053,20877,3578734543,3578734543,0
1,1053,20878,3578734543,3578734543,0
1,1053,20879,3578734543,3578734543,0
1,1053,20880,3578734543,3578734543,0
1,1053,20881,3578734543,3578734543,0
1,1053,20882,3578734543,3578734543,0
1,1053,20883,3578734543,3578734545,2
1,1053,20884,3578734543,3578734547,4
1,1053,20885,3578734543,3578734550,7
1,1053,20886,3578734543,3578734552,9
1,1053,20887,3578734543,3578734552,9
1,1053,20888,3578734543,3578734553,10
1,1053,20889,3578734543,3578734555,12
1,1053,20890,3578734543,3578734555,12
1,1053,20891,3578734543,3578734556,13
1,1053,20892,3578734543,3578734557,14
1,1053,20893,3578734543,3578734559,16
1,1053,20894,3578734543,3578734560,17
1,1053,20895,3578734543,3578734561,18
1,1053,20896,3578734543,3578734561,18
1,1053,20897,3578734543,3578734563,20
1,1053,20898,3578734543,3578734565,22
1,1053,20899,3578734543,3578734566,23
1,1053,20900,3578734543,3578734568,25
1,1053,20901,3578734543,3578734569,26
1,1053,20902,3578734543,3578734570,27
1,1053,20903,3578734543,3578734571,28
1,1053,20904,3578734543,3578734572,29
1,1053,20905,3578734543,3578734574,31
1,1053,20906,3578734543,3578734574,31
1,1053,20907,3578734543,3578734574,31
1,1053,20908,3578734543,3578734576,33
1,1053,20909,3578734543,3578734581,38
1,1053,20910,3578734543,3578734582,39
1,1053,20911,3578734543,3578734583,40
1,1053,20912,3578734543,3578734583,40
1,1053,20913,3578734543,3578734584,41
1,1053,20914,3578734543,3578734584,41
1,1053,20915,3578734543,3578734586,43
1,1053,20916,3578734543,3578734586,43
1,1053,20917,3578734543,3578734590,47
1,1053,20918,3578734543,3578734591,48
1,1053,20919,3578734543,3578734592,49
1,1053,20920,3578734543,3578734592,49
1,1053,20921,3578734543,3578734592,49
1,1053,20922,3578734543,3578734592,49
1,1054,20923,3578734602,3578734602,0
1,1054,20924,3578734602,3578734602,0
1,1054,20925,3578734602,3578734602,0
1,1054,20926,3578734602,3578734602,0
1,1054,20927,3578734602,3578734602,0
1,1054,20928,3578734602,3578734602,0
1,1054,20929,3578734602,3578734602,0
1,1054,20930,3578734602,3578734602,0
1,1054,20931,3578734602,3578734602,0
1,1054,20932,3578734602,3578734602,0
1,1054,20933,3578734602,3578734602,0
1,1054,20934,3578734602,3578734604,2
1,1054,20935,3578734602,3578734606,4
1,1054,20936,3578734602,3578734607,5
1,1054,20937,3578734602,3578734610,8
1,1054,20938,3578734602,3578734611,9
1,1054,20939,3578734602,3578734613,11
1,1054,20940,3578734602,3578734614,12
1,1054,20941,3578734602,3578734615,13
1,1054,20942,3578734602,3578734615,13
1,1054,20943,3578734602,3578734617,15
1,1054,20944,3578734602,3578734617,15
1,1054,20945,3578734602,3578734618,16
1,1054,20946,3578734602,3578734620,18
1,1054,20947,3578734602,3578734621,19
1,1054,20948,3578734602,3578734621,19
1,1054,20949,3578734602,3578734623,21
1,1054,20950,3578734602,3578734624,22
1,1054,20951,3578734602,3578734624,22
1,1054,20952,3578734602,3578734626,24
1,1054,20953,3578734602,3578734626,24
1,1054,20954,3578734602,3578734627,25
1,1054,20955,3578734602,3578734628,26
1,1054,20956,3578734602,3578734628,26
1,1054,20957,3578734602,3578734628,26
1,1054,20958,3578734602,3578734629,27
1,1054,20959,3578734602,3578734629,27
1,1054,20960,3578734602,3578734629,27
1,1054,20961,3578734602,3578734634,32
1,1054,20962,3578734602,3578734634,32
1,1054,20963,3578734602,3578734635,33
1,1054,20964,3578734602,3578734638,36
1,1054,20965,3578734602,3578734638,36
1,1054,20966,3578734602,3578734641,39
1,1054,20967,3578734602,3578734641,39
1,1054,20968,3578734602,3578734641,39
1,1054,20969,3578734602,3578734644,42
1,1054,20970,3578734602,3578734647,45
1,1054,20971,3578734602,3578734647,45
1,1054,20972,3578734602,3578734647,45
1,1054,20973,3578734602,3578734650,48
1,1054,20974,3578734602,3578734651,49
1,1054,20975,3578734602,3578734652,50
1,1055,20976,3578734663,3578734663,0
1,1055,20977,3578734663,3578734663,0
1,1055,20978,3578734663,3578734663,0
1,1055,20979,3578734663,3578734663,0
1,1055,20980,3578734663,3578734663,0
1,1055,20981,3578734663,3578734663,0
1,1055,20982,3578734663,3578734663,0
1,1055,20983,3578734663,3578734663,0
1,1055,20984,3578734663,3578734663,0
1,1055,20985,3578734663,3578734664,1
1,1055,20986,3578734663,3578734664,1
1,1055,20987,3578734663,3578734665,2
1,1055,20988,3578734663,3578734667,4
1,1055,20989,3578734663,3578734667,4
1,1055,20990,3578734663,3578734668,5
1,1055,20991,3578734663,3578734668,5
1,1055,20992,3578734663,3578734668,5
1,1055,20993,3578734663,3578734669,6
1,1055,20994,3578734663,3578734673,10
1,1055,20995,3578734663,3578734683,20
1,1055,20996,3578734663,3578734684,21
1,1055,20997,3578734663,3578734685,22
1,1055,20998,3578734663,3578734687,24
1,1055,20999,3578734663,3578734687,24
1,1055,21000,3578734663,3578734691,28
1,1055,21001,3578734663,3578734693,30
1,1055,21002,3578734663,3578734693,30
1,1055,21003,3578734663,3578734693,30
1,1055,21004,3578734663,3578734698,35
1,1055,21005,3578734663,3578734699,36
1,1055,21006,3578734663,3578734699,36
1,1055,21007,3578734663,3578734699,36
1,1055,21008,3578734663,3578734700,37
1,1055,21009,3578734663,3578734701,38
1,1055,21010,3578734663,3578734701,38
1,1055,21011,3578734663,3578734702,39
1,1055,21012,3578734663,3578734703,40
1,1055,21013,3578734663,3578734704,41
1,1055,21014,3578734663,3578734705,42
1,1055,21015,3578734663,3578734706,43
1,1055,21016,3578734663,3578734706,43
1,1055,21017,3578734663,3578734707,44
1,1055,21018,3578734663,3578734707,44
1,1055,21019,3578734663,3578734709,46
1,1055,21020,3578734663,3578734711,48
1,1055,21021,3578734663,3578734712,49
1,1055,21022,3578734663,3578734712,49
1,1055,21023,3578734663,3578734713,50
1,1056,21024,3578734724,3578734724,0
1,1056,21025,3578734724,3578734724,0
1,1056,21026,3578734724,3578734724,0
1,1056,21027,3578734724,3578734724,0
1,1056,21028,3578734724,3578734724,0
1,1056,21029,3578734724,3578734724,0
1,1056,21030,3578734724,3578734724,0
1,1056,21031,3578734724,3578734724,0
1,1056,21032,3578734724,3578734724,0
1,1056,21033,3578734724,3578734724,0
1,1056,21034,3578734724,3578734724,0
1,1056,21035,3578734724,3578734724,0
1,1056,21036,3578734724,3578734724,0
1,1056,21037,3578734724,3578734725,1
1,1056,21038,3578734724,3578734725,1
1,1056,21039,3578734724,3578734726,2
1,1056,21040,3578734724,3578734726,2
1,1056,21041,3578734724,3578734727,3
1,1056,21042,3578734724,3578734727,3
1,1056,21043,3578734724,3578734727,3
1,1056,21044,3578734724,3578734727,3
1,1056,21045,3578734724,3578734728,4
1,1056,21046,3578734724,3578734730,6
1,1056,21047,3578734724,3578734732,8
1,1056,21048,3578734724,3578734732,8
1,1056,21049,3578734724,3578734733,9
1,1056,21050,3578734724,3578734733,9
1,1056,21051,3578734724,3578734733,9
1,1056,21052,3578734724,3578734733,9
1,1056,21053,3578734724,3578734735,11
1,1056,21054,3578734724,3578734736,12
1,1056,21055,3578734724,3578734737,13
1,1056,21056,3578734724,3578734739,15
1,1056,21057,3578734724,3578734740,16
1,1056,21058,3578734724,3578734741,17
1,1056,21059,3578734724,3578734742,18
1,1056,21060,3578734724,3578734743,19
1,1056,21061,3578734724,3578734745,21
1,1056,21062,3578734724,3578734747,23
1,1056,21063,3578734724,3578734751,27
1,1056,21064,3578734724,3578734752,28
1,1056,21065,3578734724,3578734753,29
1,1056,21066,3578734724,3578734753,29
1,1056,21067,3578734724,3578734754,30
1,1056,21068,3578734724,3578734755,31
1,1056,21069,3578734724,3578734755,31
1,1056,21070,3578734724,3578734758,34
1,1056,21071,3578734724,3578734758,34
1,1056,21072,3578734724,3578734760,36
1,1056,21073,3578734724,3578734760,36
1,1056,21074,3578734724,3578734761,37
1,1056,21075,3578734724,3578734762,38
1,1056,21076,3578734724,3578734762,38
1,1056,21077,3578734724,3578734764,40
1,1056,21078,3578734724,3578734765,41
1,1056,21079,3578734724,3578734766,42
1,1056,21080,3578734724,3578734768,44
1,1056,21081,3578734724,3578734770,46
1,1056,21082,3578734724,3578734770,46
1,1056,21083,3578734724,3578734771,47
1,1056,21084,3578734724,3578734772,48
1,1057,21085,3578734786,3578734786,0
1,1057,21086,3578734786,3578734786,0
1,1057,21087,3578734786,3578734786,0
1,1057,21088,3578734786,3578734786,0
1,1057,21089,3578734786,3578734786,0
1,1057,21090,3578734786,3578734786,0
1,1057,21091,3578734786,3578734786,0
1,1057,21092,3578734786,3578734786,0
1,1057,21093,3578734786,3578734786,0
1,1057,21094,3578734786,3578734786,0
1,1057,21095,3578734786,3578734786,0
1,1057,21096,3578734786,3578734786,0
1,1057,21097,3578734786,3578734786,0
1,1057,21098,3578734786,3578734789,3
1,1057,21099,3578734786,3578734791,5
1,1057,21100,3578734786,3578734792,6
1,1057,21101,3578734786,3578734793,7
1,1057,21102,3578734786,3578734793,7
1,1057,21103,3578734786,3578734793,7
1,1057,21104,3578734786,3578734796,10
1,1057,21105,3578734786,3578734797,11
1,1057,21106,3578734786,3578734798,12
1,1057,21107,3578734786,3578734799,13
1,1057,21108,3578734786,3578734799,13
1,1057,21109,3578734786,3578734800,14
1,1057,21110,3578734786,3578734800,14
1,1057,21111,3578734786,3578734801,15
1,1057,21112,3578734786,3578734801,15
1,1057,21113,3578734786,3578734804,18
1,1057,21114,3578734786,3578734806,20
1,1057,21115,3578734786,3578734807,21
1,1057,21116,3578734786,3578734810,24
1,1057,21117,3578734786,3578734811,25
1,1057,21118,3578734786,3578734814,28
1,1057,21119,3578734786,3578734815,29
1,1057,21120,3578734786,3578734816,30
1,1057,21121,3578734786,3578734817,31
1,1057,21122,3578734786,3578734817,31
1,1057,21123,3578734786,3578734818,32
1,1057,21124,3578734786,3578734819,33
1,1057,21125,3578734786,3578734819,33
1,1057,21126,3578734786,3578734820,34
1,1057,21127,3578734786,3578734821,35
1,1057,21128,3578734786,3578734821,35
1,1057,21129,3578734786,3578734823,37
1,1057,21130,3578734786,3578734824,38
1,1057,21131,3578734786,3578734826,40
1,1057,21132,3578734786,3578734826,40
1,1057,21133,3578734786,3578734828,42
1,1057,21134,3578734786,3578734828,42
1,1057,21135,3578734786,3578734828,42
1,1057,21136,3578734786,3578734829,43
1,1057,21137,3578734786,3578734830,44
1,1057,21138,3578734786,3578734834,48
1,1057,21139,3578734786,3578734835,49
1,1058,21140,3578734844,3578734844,0
1,1058,21141,3578734844,3578734844,0
1,1058,21142,3578734844,3578734844,0
1,1058,21143,3578734844,3578734844,0
1,1058,21144,3578734844,3578734844,0
1,1058,21145,3578734844,3578734844,0
1,1058,21146,3578734844,3578734845,1
1,1058,21147,3578734844,3578734845,1
1,1058,21148,3578734844,3578734847,3
1,1058,21149,3578734844,3578734847,3
1,1058,21150,3578734844,3578734848,4
1,1058,21151,3578734844,3578734850,6
1,1058,21152,3578734844,3578734850,6
1,1058,21153,3578734844,3578734851,7
1,1058,21154,3578734844,3578734853,9
1,1058,21155,3578734844,3578734854,10
1,1058,21156,3578734844,3578734855,11
1,1058,21157,3578734844,3578734855,11
1,1058,21158,3578734844,3578734858,14
1,1058,21159,3578734844,3578734859,15
1,1058,21160,3578734844,3578734859,15
1,1058,21161,3578734844,3578734861,17
1,1058,21162,3578734844,3578734862,18
1,1058,21163,3578734844,3578734863,19
1,1058,21164,3578734844,3578734864,20
1,1058,21165,3578734844,3578734864,20
1,1058,21166,3578734844,3578734865,21
1,1058,21167,3578734844,3578734867,23
1,1058,21168,3578734844,3578734867,23
1,1058,21169,3578734844,3578734868,24
1,1058,21170,3578734844,3578734868,24
1,1058,21171,3578734844,3578734869,25
1,1058,21172,3578734844,3578734870,26
1,1058,21173,3578734844,3578734873,29
1,1058,21174,3578734844,3578734882,38
1,1058,21175,3578734844,3578734884,40
1,1058,21176,3578734844,3578734885,41
1,1058,21177,3578734844,3578734886,42
1,1058,21178,3578734844,3578734888,44
1,1058,21179,3578734844,3578734890,46
1,1058,21180,3578734844,3578734892,48
1,1058,21181,3578734844,3578734893,49
1,1059,21182,3578734902,3578734902,0
1,1059,21183,3578734902,3578734902,0
1,1059,21184,3578734902,3578734902,0
1,1059,21185,3578734902,3578734902,0
1,1059,21186,3578734902,3578734902,0
1,1059,21187,3578734902,3578734902,0
1,1059,21188,3578734902,3578734902,0
1,1059,21189,3578734902,3578734902,0
1,1059,21190,3578734902,3578734902,0
1,1059,21191,3578734902,3578734904,2
1,1059,21192,3578734902,3578734905,3
1,1059,21193,3578734902,3578734906,4
1,1059,21194,3578734902,3578734906,4
1,1059,21195,3578734902,3578734906,4
1,1059,21196,3578734902,3578734909,7
1,1059,21197,3578734902,3578734909,7
1,1059,21198,3578734902,3578734911,9
1,1059,21199,3578734902,3578734912,10
1,1059,21200,3578734902,3578734913,11
1,1059,21201,3578734902,3578734914,12
1,1059,21202,3578734902,3578734915,13
1,1059,21203,3578734902,3578734916,14
1,1059,21204,3578734902,3578734916,14
1,1059,21205,3578734902,3578734916,14
1,1059,21206,3578734902,3578734916,14
1,1059,21207,3578734902,3578734917,15
1,1059,21208,3578734902,3578734918,16
1,1059,21209,3578734902,3578734919,17
1,1059,21210,3578734902,3578734920,18
1,1059,21211,3578734902,3578734920,18
1,1059,21212,3578734902,3578734921,19
1,1059,21213,3578734902,3578734923,21
1,1059,21214,3578734902,3578734925,23
1,1059,21215,3578734902,3578734925,23
1,1059,21216,3578734902,3578734926,24
1,1059,21217,3578734902,3578734926,24
1,1059,21218,3578734902,3578734926,24
1,1059,21219,3578734902,3578734927,25
1,1059,21220,3578734902,3578734927,25
1,1059,21221,3578734902,3578734927,25
1,1059,21222,3578734902,3578734927,25
1,1059,21223,3578734902,3578734928,26
1,1059,21224,3578734902,3578734928,26
1,1059,21225,3578734902,3578734931,29
1,1059,21226,3578734902,3578734931,29
1,1059,21227,3578734902,3578734932,30
1,1059,21228,3578734902,3578734932,30
1,1059,21229,3578734902,3578734933,31
1,1059,21230,3578734902,3578734933,31
1,1059,21231,3578734902,3578734934,32
1,1059,21232,3578734902,3578734934,32
1,1059,21233,3578734902,3578734935,33
1,1059,21234,3578734902,3578734936,34
1,1059,21235,3578734902,3578734937,35
1,1059,21236,3578734902,3578734937,35
1,1059,21237,3578734902,3578734938,36
1,1059,21238,3578734902,3578734939,37
1,1059,21239,3578734902,3578734940,38
1,1059,21240,3578734902,3578734941,39
1,1059,21241,3578734902,3578734942,40
1,1059,21242,3578734902,3578734946,44
1,1059,21243,3578734902,3578734949,47
1,1059,21244,3578734902,3578734951,49
1,1060,21245,3578734961,3578734961,0
1,1060,21246,3578734961,3578734961,0
1,1060,21247,3578734961,3578734961,0
1,1060,21248,3578734961,3578734961,0
1,1060,21249,3578734961,3578734961,0
1,1060,21250,3578734961,3578734961,0
1,1060,21251,3578734961,3578734961,0
1,1060,21252,3578734961,3578734961,0
1,1060,21253,3578734961,3578734961,0
1,1060,21254,3578734961,3578734962,1
1,1060,21255,3578734961,3578734963,2
1,1060,21256,3578734961,3578734965,4
1,1060,21257,3578734961,3578734966,5
1,1060,21258,3578734961,3578734966,5
1,1060,21259,3578734961,3578734968,7
1,1060,21260,3578734961,3578734970,9
1,1060,21261,3578734961,3578734970,9
1,1060,21262,3578734961,3578734971,10
1,1060,21263,3578734961,3578734975,14
1,1060,21264,3578734961,3578734975,14
1,1060,21265,3578734961,3578734976,15
1,1060,21266,3578734961,3578734977,16
1,1060,21267,3578734961,3578734982,21
1,1060,21268,3578734961,3578734982,21
1,1060,21269,3578734961,3578734983,22
1,1060,21270,3578734961,3578734984,23
1,1060,21271,3578734961,3578734984,23
1,1060,21272,3578734961,3578734986,25
1,1060,21273,3578734961,3578734986,25
1,1060,21274,3578734961,3578734986,25
1,1060,21275,3578734961,3578734990,29
1,1060,21276,3578734961,3578734991,30
1,1060,21277,3578734961,3578734992,31
1,1060,21278,3578734961,3578734992,31
1,1060,21279,3578734961,3578734993,32
1,1060,21280,3578734961,3578734993,32
1,1060,21281,3578734961,3578734996,35
1,1060,21282,3578734961,3578734997,36
1,1060,21283,3578734961,3578734997,36
1,1060,21284,3578734961,3578734997,36
1,1060,21285,3578734961,3578734997,36
1,1060,21286,3578734961,3578734999,38
1,1060,21287,3578734961,3578734999,38
1,1060,21288,3578734961,3578735000,39
1,1060,21289,3578734961,3578735001,40
1,1060,21290,3578734961,3578735001,40
1,1060,21291,3578734961,3578735001,40
1,1060,21292,3578734961,3578735002,41
1,1060,21293,3578734961,3578735004,43
1,1060,21294,3578734961,3578735006,45
1,1060,21295,3578734961,3578735006,45
1,1060,21296,3578734961,3578735010,49
1,1060,21297,3578734961,3578735011,50
1,1061,21298,3578735022,3578735022,0
1,1061,21299,3578735022,3578735022,0
1,1061,21300,3578735022,3578735022,0
1,1061,21301,3578735022,3578735022,0
1,1061,21302,3578735022,3578735022,0
1,1061,21303,3578735022,3578735022,0
1,1061,21304,3578735022,3578735022,0
1,1061,21305,3578735022,3578735022,0
1,1061,21306,3578735022,3578735022,0
1,1061,21307,3578735022,3578735023,1
1,1061,21308,3578735022,3578735024,2
1,1061,21309,3578735022,3578735025,3
1,1061,21310,3578735022,3578735026,4
1,1061,21311,3578735022,3578735028,6
1,1061,21312,3578735022,3578735028,6
1,1061,21313,3578735022,3578735028,6
1,1061,21314,3578735022,3578735029,7
1,1061,21315,3578735022,3578735030,8
1,1061,21316,3578735022,3578735030,8
1,1061,21317,3578735022,3578735035,13
1,1061,21318,3578735022,3578735035,13
1,1061,21319,3578735022,3578735038,16
1,1061,21320,3578735022,3578735040,18
1,1061,21321,3578735022,3578735040,18
1,1061,21322,3578735022,3578735041,19
1,1061,21323,3578735022,3578735041,19
1,1061,21324,3578735022,3578735042,20
1,1061,21325,3578735022,3578735045,23
1,1061,21326,3578735022,3578735045,23
1,1061,21327,3578735022,3578735047,25
1,1061,21328,3578735022,3578735047,25
1,1061,21329,3578735022,3578735048,26
1,1061,21330,3578735022,3578735051,29
1,1061,21331,3578735022,3578735051,29
1,1061,21332,3578735022,3578735053,31
1,1061,21333,3578735022,3578735054,32
1,1061,21334,3578735022,3578735059,37
1,1061,21335,3578735022,3578735059,37
1,1061,21336,3578735022,3578735060,38
1,1061,21337,3578735022,3578735061,39
1,1061,21338,3578735022,3578735063,41
1,1061,21339,3578735022,3578735063,41
1,1061,21340,3578735022,3578735064,42
1,1061,21341,3578735022,3578735065,43
1,1061,21342,3578735022,3578735065,43
1,1061,21343,3578735022,3578735067,45
1,1061,21344,3578735022,3578735067,45
1,1061,21345,3578735022,3578735067,45
1,1061,21346,3578735022,3578735068,46
1,1061,21347,3578735022,3578735069,47
1,1061,21348,3578735022,3578735069,47
1,1061,21349,3578735022,3578735070,48
1,1062,21350,3578735086,3578735086,0
1,1062,21351,3578735086,3578735086,0
1,1062,21352,3578735086,3578735086,0
1,1062,21353,3578735086,3578735086,0
1,1062,21354,3578735086,3578735087,1
1,1062,21355,3578735086,3578735088,2
1,1062,21356,3578735086,3578735091,5
1,1062,21357,3578735086,3578735093,7
1,1062,21358,3578735086,3578735098,12
1,1062,21359,3578735086,3578735099,13
1,1062,21360,3578735086,3578735100,14
1,1062,21361,3578735086,3578735101,15
1,1062,21362,3578735086,3578735101,15
1,1062,21363,3578735086,3578735101,15
1,1062,21364,3578735086,3578735102,16
1,1062,21365,3578735086,3578735103,17
1,1062,21366,3578735086,3578735104,18
1,1062,21367,3578735086,3578735104,18
1,1062,21368,3578735086,3578735105,19
1,1062,21369,3578735086,3578735106,20
1,1062,21370,3578735086,3578735106,20
1,1062,21371,3578735086,3578735106,20
1,1062,21372,3578735086,3578735109,23
1,1062,21373,3578735086,3578735109,23
1,1062,21374,3578735086,3578735111,25
1,1062,21375,3578735086,3578735112,26
1,1062,21376,3578735086,3578735113,27
1,1062,21377,3578735086,3578735114,28
1,1062,21378,3578735086,3578735115,29
1,1062,21379,3578735086,3578735115,29
1,1062,21380,3578735086,3578735116,30
1,1062,21381,3578735086,3578735116,30
1,1062,21382,3578735086,3578735117,31
1,1062,21383,3578735086,3578735117,31
1,1062,21384,3578735086,3578735118,32
1,1062,21385,3578735086,3578735119,33
1,1062,21386,3578735086,3578735119,33
1,1062,21387,3578735086,3578735120,34
1,1062,21388,3578735086,3578735121,35
1,1062,21389,3578735086,3578735123,37
1,1062,21390,3578735086,3578735124,38
1,1062,21391,3578735086,3578735125,39
1,1062,21392,3578735086,3578735126,40
1,1062,21393,3578735086,3578735126,40
1,1062,21394,3578735086,3578735126,40
1,1062,21395,3578735086,3578735127,41
1,1062,21396,3578735086,3578735127,41
1,1062,21397,3578735086,3578735127,41
1,1062,21398,3578735086,3578735128,42
1,1062,21399,3578735086,3578735128,42
1,1062,21400,3578735086,3578735128,42
1,1062,21401,3578735086,3578735128,42
1,1062,21402,3578735086,3578735131,45
1,1062,21403,3578735086,3578735131,45
1,1062,21404,3578735086,3578735132,46
1,1062,21405,3578735086,3578735132,46
1,1062,21406,3578735086,3578735133,47
1,1062,21407,3578735086,3578735134,48
1,1062,21408,3578735086,3578735135,49
1,1063,21409,3578735147,3578735147,0
1,1063,21410,3578735147,3578735147,0
1,1063,21411,3578735147,3578735147,0
1,1063,21412,3578735147,3578735147,0
1,1063,21413,3578735147,3578735147,0
1,1063,21414,3578735147,3578735147,0
1,1063,21415,3578735147,3578735147,0
1,1063,21416,3578735147,3578735147,0
1,1063,21417,3578735147,3578735147,0
1,1063,21418,3578735147,3578735148,1
1,1063,21419,3578735147,3578735152,5
1,1063,21420,3578735147,3578735153,6
1,1063,21421,3578735147,3578735154,7
1,1063,21422,3578735147,3578735155,8
1,1063,21423,3578735147,3578735156,9
1,1063,21424,3578735147,3578735156,9
1,1063,21425,3578735147,3578735157,10
1,1063,21426,3578735147,3578735157,10
1,1063,21427,3578735147,3578735160,13
1,1063,21428,3578735147,3578735161,14
1,1063,21429,3578735147,3578735162,15
1,1063,21430,3578735147,3578735163,16
1,1063,21431,3578735147,3578735164,17
1,1063,21432,3578735147,3578735166,19
1,1063,21433,3578735147,3578735166,19
1,1063,21434,3578735147,3578735166,19
1,1063,21435,3578735147,3578735168,21
1,1063,21436,3578735147,3578735170,23
1,1063,21437,3578735147,3578735171,24
1,1063,21438,3578735147,3578735171,24
1,1063,21439,3578735147,3578735172,25
1,1063,21440,3578735147,3578735175,28
1,1063,21441,3578735147,3578735175,28
1,1063,21442,3578735147,3578735175,28
1,1063,21443,3578735147,3578735176,29
1,1063,21444,3578735147,3578735181,34
1,1063,21445,3578735147,3578735181,34
1,1063,21446,3578735147,3578735182,35
1,1063,21447,3578735147,3578735183,36
1,1063,21448,3578735147,3578735185,38
1,1063,21449,3578735147,3578735185,38
1,1063,21450,3578735147,3578735185,38
1,1063,21451,3578735147,3578735187,40
1,1063,21452,3578735147,3578735187,40
1,1063,21453,3578735147,3578735191,44
1,1063,21454,3578735147,3578735191,44
1,1063,21455,3578735147,3578735192,45
1,1063,21456,3578735147,3578735192,45
1,1063,21457,3578735147,3578735192,45
1,1063,21458,3578735147,3578735193,46
1,1063,21459,3578735147,3578735194,47
1,1063,21460,3578735147,3578735196,49
1,1063,21461,3578735147,3578735197,50
1,1064,21462,3578735207,3578735207,0
1,1064,21463,3578735207,3578735207,0
1,1064,21464,3578735207,3578735207,0
1,1064,21465,3578735207,3578735207,0
1,1064,21466,3578735207,3578735207,0
1,1064,21467,3578735207,3578735207,0
1,1064,21468,3578735207,3578735207,0
1,1064,21469,3578735207,3578735207,0
1,1064,21470,3578735207,3578735207,0
1,1064,21471,3578735207,3578735207,0
1,1064,21472,3578735207,3578735210,3
1,1064,21473,3578735207,3578735211,4
1,1064,21474,3578735207,3578735212,5
1,1064,21475,3578735207,3578735214,7
1,1064,21476,3578735207,3578735217,10
1,1064,21477,3578735207,3578735217,10
1,1064,21478,3578735207,3578735218,11
1,1064,21479,3578735207,3578735218,11
1,1064,21480,3578735207,3578735219,12
1,1064,21481,3578735207,3578735219,12
1,1064,21482,3578735207,3578735221,14
1,1064,21483,3578735207,3578735222,15
1,1064,21484,3578735207,3578735224,17
1,1064,21485,3578735207,3578735224,17
1,1064,21486,3578735207,3578735224,17
1,1064,21487,3578735207,3578735227,20
1,1064,21488,3578735207,3578735228,21
1,1064,21489,3578735207,3578735228,21
1,1064,21490,3578735207,3578735229,22
1,1064,21491,3578735207,3578735230,23
1,1064,21492,3578735207,3578735230,23
1,1064,21493,3578735207,3578735236,29
1,1064,21494,3578735207,3578735238,31
1,1064,21495,3578735207,3578735240,33
1,1064,21496,3578735207,3578735241,34
1,1064,21497,3578735207,3578735242,35
1,1064,21498,3578735207,3578735242,35
1,1064,21499,3578735207,3578735242,35
1,1064,21500,3578735207,3578735244,37
1,1064,21501,3578735207,3578735244,37
1,1064,21502,3578735207,3578735247,40
1,1064,21503,3578735207,3578735248,41
1,1064,21504,3578735207,3578735249,42
1,1064,21505,3578735207,3578735250,43
1,1064,21506,3578735207,3578735252,45
1,1064,21507,3578735207,3578735252,45
1,1064,21508,3578735207,3578735254,47
1,1064,21509,3578735207,3578735256,49
1,1065,21510,3578735266,3578735266,0
1,1065,21511,3578735266,3578735266,0
1,1065,21512,3578735266,3578735266,0
1,1065,21513,3578735266,3578735266,0
1,1065,21514,3578735266,3578735266,0
1,1065,21515,3578735266,3578735266,0
1,1065,21516,3578735266,3578735266,0
1,1065,21517,3578735266,3578735266,0
1,1065,21518,3578735266,3578735266,0
1,1065,21519,3578735266,3578735267,1
1,1065,21520,3578735266,3578735268,2
1,1065,21521,3578735266,3578735268,2
1,1065,21522,3578735266,3578735268,2
1,1065,21523,3578735266,3578735269,3
1,1065,21524,3578735266,3578735270,4
1,1065,21525,3578735266,3578735270,4
1,1065,21526,3578735266,3578735271,5
1,1065,21527,3578735266,3578735277,11
1,1065,21528,3578735266,3578735284,18
1,1065,21529,3578735266,3578735285,19
1,1065,21530,3578735266,3578735285,19
1,1065,21531,3578735266,3578735288,22
1,1065,21532,3578735266,3578735289,23
1,1065,21533,3578735266,3578735293,27
1,1065,21534,3578735266,3578735294,28
1,1065,21535,3578735266,3578735299,33
1,1065,21536,3578735266,3578735299,33
1,1065,21537,3578735266,3578735301,35
1,1065,21538,3578735266,3578735301,35
1,1065,21539,3578735266,3578735301,35
1,1065,21540,3578735266,3578735302,36
1,1065,21541,3578735266,3578735302,36
1,1065,21542,3578735266,3578735303,37
1,1065,21543,3578735266,3578735304,38
1,1065,21544,3578735266,3578735305,39
1,1065,21545,3578735266,3578735306,40
1,1065,21546,3578735266,3578735306,40
1,1065,21547,3578735266,3578735306,40
1,1065,21548,3578735266,3578735306,40
1,1065,21549,3578735266,3578735309,43
1,1065,21550,3578735266,3578735309,43
1,1065,21551,3578735266,3578735311,45
1,1065,21552,3578735266,3578735312,46
1,1065,21553,3578735266,3578735312,46
1,1065,21554,3578735266,3578735313,47
1,1065,21555,3578735266,3578735315,49
1,1065,21556,3578735266,3578735316,50
1,1066,21557,3578735326,3578735326,0
1,1066,21558,3578735326,3578735326,0
1,1066,21559,3578735326,3578735326,0
1,1066,21560,3578735326,3578735326,0
1,1066,21561,3578735326,3578735326,0
1,1066,21562,3578735326,3578735326,0
1,1066,21563,3578735326,3578735326,0
1,1066,21564,3578735326,3578735326,0
1,1066,21565,3578735326,3578735326,0
1,1066,21566,3578735326,3578735326,0
1,1066,21567,3578735326,3578735326,0
1,1066,21568,3578735326,3578735326,0
1,1066,21569,3578735326,3578735326,0
1,1066,21570,3578735326,3578735326,0
1,1066,21571,3578735326,3578735327,1
1,1066,21572,3578735326,3578735327,1
1,1066,21573,3578735326,3578735328,2
1,1066,21574,3578735326,3578735328,2
1,1066,21575,3578735326,3578735328,2
1,1066,21576,3578735326,3578735328,2
1,1066,21577,3578735326,3578735329,3
1,1066,21578,3578735326,3578735329,3
1,1066,21579,3578735326,3578735331,5
1,1066,21580,3578735326,3578735331,5
1,1066,21581,3578735326,3578735332,6
1,1066,21582,3578735326,3578735333,7
1,1066,21583,3578735326,3578735333,7
1,1066,21584,3578735326,3578735334,8
1,1066,21585,3578735326,3578735335,9
1,1066,21586,3578735326,3578735335,9
1,1066,21587,3578735326,3578735337,11
1,1066,21588,3578735326,3578735339,13
1,1066,21589,3578735326,3578735340,14
1,1066,21590,3578735326,3578735340,14
1,1066,21591,3578735326,3578735341,15
1,1066,21592,3578735326,3578735341,15
1,1066,21593,3578735326,3578735342,16
1,1066,21594,3578735326,3578735343,17
1,1066,21595,3578735326,3578735343,17
1,1066,21596,3578735326,3578735344,18
1,1066,21597,3578735326,3578735346,20
1,1066,21598,3578735326,3578735346,20
1,1066,21599,3578735326,3578735352,26
1,1066,21600,3578735326,3578735353,27
1,1066,21601,3578735326,3578735353,27
1,1066,21602,3578735326,3578735354,28
1,1066,21603,3578735326,3578735355,29
1,1066,21604,3578735326,3578735356,30
1,1066,21605,3578735326,3578735356,30
1,1066,21606,3578735326,3578735357,31
1,1066,21607,3578735326,3578735357,31
1,1066,21608,3578735326,3578735362,36
1,1066,21609,3578735326,3578735362,36
1,1066,21610,3578735326,3578735362,36
1,1066,21611,3578735326,3578735362,36
1,1066,21612,3578735326,3578735365,39
1,1066,21613,3578735326,3578735366,40
1,1066,21614,3578735326,3578735367,41
1,1066,21615,3578735326,3578735368,42
1,1066,21616,3578735326,3578735370,44
1,1066,21617,3578735326,3578735370,44
1,1066,21618,3578735326,3578735372,46
1,1066,21619,3578735326,3578735372,46
1,1066,21620,3578735326,3578735375,49
1,1066,21621,3578735326,3578735375,49
1,1066,21622,3578735326,3578735376,50
1,1067,21623,3578735386,3578735386,0
1,1067,21624,3578735386,3578735386,0
1,1067,21625,3578735386,3578735386,0
1,1067,21626,3578735386,3578735386,0
1,1067,21627,3578735386,3578735386,0
1,1067,21628,3578735386,3578735386,0
1,1067,21629,3578735386,3578735386,0
1,1067,21630,3578735386,3578735386,0
1,1067,21631,3578735386,3578735386,0
1,1067,21632,3578735386,3578735388,2
1,1067,21633,3578735386,3578735390,4
1,1067,21634,3578735386,3578735392,6
1,1067,21635,3578735386,3578735392,6
1,1067,21636,3578735386,3578735393,7
1,1067,21637,3578735386,3578735393,7
1,1067,21638,3578735386,3578735393,7
1,1067,21639,3578735386,3578735397,11
1,1067,21640,3578735386,3578735397,11
1,1067,21641,3578735386,3578735397,11
1,1067,21642,3578735386,3578735397,11
1,1067,21643,3578735386,3578735397,11
1,1067,21644,3578735386,3578735398,12
1,1067,21645,3578735386,3578735399,13
1,1067,21646,3578735386,3578735401,15
1,1067,21647,3578735386,3578735401,15
1,1067,21648,3578735386,3578735401,15
1,1067,21649,3578735386,3578735402,16
1,1067,21650,3578735386,3578735407,21
1,1067,21651,3578735386,3578735407,21
1,1067,21652,3578735386,3578735407,21
1,1067,21653,3578735386,3578735410,24
1,1067,21654,3578735386,3578735412,26
1,1067,21655,3578735386,3578735412,26
1,1067,21656,3578735386,3578735414,28
1,1067,21657,3578735386,3578735417,31
1,1067,21658,3578735386,3578735417,31
1,1067,21659,3578735386,3578735419,33
1,1067,21660,3578735386,3578735419,33
1,1067,21661,3578735386,3578735419,33
1,1067,21662,3578735386,3578735420,34
1,1067,21663,3578735386,3578735421,35
1,1067,21664,3578735386,3578735421,35
1,1067,21665,3578735386,3578735422,36
1,1067,21666,3578735386,3578735424,38
1,1067,21667,3578735386,3578735424,38
1,1067,21668,3578735386,3578735424,38
1,1067,21669,3578735386,3578735426,40
1,1067,21670,3578735386,3578735428,42
1,1067,21671,3578735386,3578735428,42
1,1067,21672,3578735386,3578735429,43
1,1067,21673,3578735386,3578735429,43
1,1067,21674,3578735386,3578735429,43
1,1067,21675,3578735386,3578735429,43
1,1067,21676,3578735386,3578735430,44
1,1067,21677,3578735386,3578735430,44
1,1067,21678,3578735386,3578735435,49
1,1068,21679,3578735449,3578735449,0
1,1068,21680,3578735449,3578735449,0
1,1068,21681,3578735449,3578735449,0
1,1068,21682,3578735449,3578735449,0
1,1068,21683,3578735449,3578735449,0
1,1068,21684,3578735449,3578735449,0
1,1068,21685,3578735449,3578735449,0
1,1068,21686,3578735449,3578735449,0
1,1068,21687,3578735449,3578735449,0
1,1068,21688,3578735449,3578735449,0
1,1068,21689,3578735449,3578735450,1
1,1068,21690,3578735449,3578735450,1
1,1068,21691,3578735449,3578735452,3
1,1068,21692,3578735449,3578735452,3
1,1068,21693,3578735449,3578735454,5
1,1068,21694,3578735449,3578735456,7
1,1068,21695,3578735449,3578735459,10
1,1068,21696,3578735449,3578735459,10
1,1068,21697,3578735449,3578735460,11
1,1068,21698,3578735449,3578735461,12
1,1068,21699,3578735449,3578735463,14
1,1068,21700,3578735449,3578735464,15
1,1068,21701,3578735449,3578735465,16
1,1068,21702,3578735449,3578735465,16
1,1068,21703,3578735449,3578735466,17
1,1068,21704,3578735449,3578735468,19
1,1068,21705,3578735449,3578735469,20
1,1068,21706,3578735449,3578735469,20
1,1068,21707,3578735449,3578735469,20
1,1068,21708,3578735449,3578735469,20
1,1068,21709,3578735449,3578735470,21
1,1068,21710,3578735449,3578735470,21
1,1068,21711,3578735449,3578735471,22
1,1068,21712,3578735449,3578735477,28
1,1068,21713,3578735449,3578735483,34
1,1068,21714,3578735449,3578735484,35
1,1068,21715,3578735449,3578735485,36
1,1068,21716,3578735449,3578735485,36
1,1068,21717,3578735449,3578735489,40
1,1068,21718,3578735449,3578735490,41
1,1068,21719,3578735449,3578735492,43
1,1068,21720,3578735449,3578735493,44
1,1068,21721,3578735449,3578735493,44
1,1068,21722,3578735449,3578735494,45
1,1068,21723,3578735449,3578735499,50
1,1069,21724,3578735511,3578735511,0
1,1069,21725,3578735511,3578735511,0
1,1069,21726,3578735511,3578735511,0
1,1069,21727,3578735511,3578735511,0
1,1069,21728,3578735511,3578735511,0
1,1069,21729,3578735511,3578735511,0
1,1069,21730,3578735511,3578735511,0
1,1069,21731,3578735511,3578735511,0
1,1069,21732,3578735511,3578735511,0
1,1069,21733,3578735511,3578735511,0
1,1069,21734,3578735511,3578735511,0
1,1069,21735,3578735511,3578735511,0
1,1069,21736,3578735511,3578735511,0
1,1069,21737,3578735511,3578735511,0
1,1069,21738,3578735511,3578735511,0
1,1069,21739,3578735511,3578735511,0
1,1069,21740,3578735511,3578735511,0
1,1069,21741,3578735511,3578735512,1
1,1069,21742,3578735511,3578735513,2
1,1069,21743,3578735511,3578735515,4
1,1069,21744,3578735511,3578735515,4
1,1069,21745,3578735511,3578735515,4
1,1069,21746,3578735511,3578735516,5
1,1069,21747,3578735511,3578735516,5
1,1069,21748,3578735511,3578735516,5
1,1069,21749,3578735511,3578735518,7
1,1069,21750,3578735511,3578735518,7
1,1069,21751,3578735511,3578735519,8
1,1069,21752,3578735511,3578735520,9
1,1069,21753,3578735511,3578735520,9
1,1069,21754,3578735511,3578735522,11
1,1069,21755,3578735511,3578735524,13
1,1069,21756,3578735511,3578735526,15
1,1069,21757,3578735511,3578735526,15
1,1069,21758,3578735511,3578735527,16
1,1069,21759,3578735511,3578735527,16
1,1069,21760,3578735511,3578735527,16
1,1069,21761,3578735511,3578735527,16
1,1069,21762,3578735511,3578735528,17
1,1069,21763,3578735511,3578735528,17
1,1069,21764,3578735511,3578735528,17
1,1069,21765,3578735511,3578735529,18
1,1069,21766,3578735511,3578735530,19
1,1069,21767,3578735511,3578735531,20
1,1069,21768,3578735511,3578735532,21
1,1069,21769,3578735511,3578735533,22
1,1069,21770,3578735511,3578735534,23
1,1069,21771,3578735511,3578735536,25
1,1069,21772,3578735511,3578735539,28
1,1069,21773,3578735511,3578735539,28
1,1069,21774,3578735511,3578735540,29
1,1069,21775,3578735511,3578735540,29
1,1069,21776,3578735511,3578735541,30
1,1069,21777,3578735511,3578735543,32
1,1069,21778,3578735511,3578735543,32
1,1069,21779,3578735511,3578735543,32
1,1069,21780,3578735511,3578735543,32
1,1069,21781,3578735511,3578735545,34
1,1069,21782,3578735511,3578735545,34
1,1069,21783,3578735511,3578735548,37
1,1069,21784,3578735511,3578735552,41
1,1069,21785,3578735511,3578735552,41
1,1069,21786,3578735511,3578735552,41
1,1069,21787,3578735511,3578735553,42
1,1069,21788,3578735511,3578735554,43
1,1069,21789,3578735511,3578735555,44
1,1069,21790,3578735511,3578735555,44
1,1069,21791,3578735511,3578735555,44
1,1069,21792,3578735511,3578735556,45
1,1069,21793,3578735511,3578735557,46
1,1069,21794,3578735511,3578735561,50
1,1069,21795,3578735511,3578735561,50
1,1070,21796,3578735571,3578735571,0
1,1070,21797,3578735571,3578735571,0
1,1070,21798,3578735571,3578735571,0
1,1070,21799,3578735571,3578735571,0
1,1070,21800,3578735571,3578735571,0
1,1070,21801,3578735571,3578735571,0
1,1070,21802,3578735571,3578735571,0
1,1070,21803,3578735571,3578735572,1
1,1070,21804,3578735571,3578735574,3
1,1070,21805,3578735571,3578735575,4
1,1070,21806,3578735571,3578735577,6
1,1070,21807,3578735571,3578735580,9
1,1070,21808,3578735571,3578735581,10
1,1070,21809,3578735571,3578735582,11
1,1070,21810,3578735571,3578735584,13
1,1070,21811,3578735571,3578735584,13
1,1070,21812,3578735571,3578735584,13
1,1070,21813,3578735571,3578735585,14
1,1070,21814,3578735571,3578735585,14
1,1070,21815,3578735571,3578735586,15
1,1070,21816,3578735571,3578735592,21
1,1070,21817,3578735571,3578735592,21
1,1070,21818,3578735571,3578735592,21
1,1070,21819,3578735571,3578735593,22
1,1070,21820,3578735571,3578735593,22
1,1070,21821,3578735571,3578735596,25
1,1070,21822,3578735571,3578735596,25
1,1070,21823,3578735571,3578735596,25
1,1070,21824,3578735571,3578735597,26
1,1070,21825,3578735571,3578735597,26
1,1070,21826,3578735571,3578735600,29
1,1070,21827,3578735571,3578735600,29
1,1070,21828,3578735571,3578735600,29
1,1070,21829,3578735571,3578735600,29
1,1070,21830,3578735571,3578735601,30
1,1070,21831,3578735571,3578735605,34
1,1070,21832,3578735571,3578735606,35
1,1070,21833,3578735571,3578735607,36
1,1070,21834,3578735571,3578735608,37
1,1070,21835,3578735571,3578735609,38
1,1070,21836,3578735571,3578735611,40
1,1070,21837,3578735571,3578735613,42
1,1070,21838,3578735571,3578735615,44
1,1070,21839,3578735571,3578735615,44
1,1070,21840,3578735571,3578735616,45
1,1070,21841,3578735571,3578735617,46
1,1070,21842,3578735571,3578735618,47
1,1070,21843,3578735571,3578735618,47
1,1070,21844,3578735571,3578735619,48
1,1070,21845,3578735571,3578735619,48
1,1070,21846,3578735571,3578735620,49
1,1070,21847,3578735571,3578735620,49
1,1070,21848,3578735571,3578735621,50
1,1071,21849,3578735630,3578735630,0
1,1071,21850,3578735630,3578735630,0
1,1071,21851,3578735630,3578735630,0
1,1071,21852,3578735630,3578735630,0
1,1071,21853,3578735630,3578735630,0
1,1071,21854,3578735630,3578735630,0
1,1071,21855,3578735630,3578735630,0
1,1071,21856,3578735630,3578735630,0
1,1071,21857,3578735630,3578735630,0
1,1071,21858,3578735630,3578735630,0
1,1071,21859,3578735630,3578735631,1
1,1071,21860,3578735630,3578735634,4
1,1071,21861,3578735630,3578735637,7
1,1071,21862,3578735630,3578735637,7
1,1071,21863,3578735630,3578735639,9
1,1071,21864,3578735630,3578735640,10
1,1071,21865,3578735630,3578735641,11
1,1071,21866,3578735630,3578735641,11
1,1071,21867,3578735630,3578735643,13
1,1071,21868,3578735630,3578735643,13
1,1071,21869,3578735630,3578735644,14
1,1071,21870,3578735630,3578735646,16
1,1071,21871,3578735630,3578735646,16
1,1071,21872,3578735630,3578735649,19
1,1071,21873,3578735630,3578735650,20
1,1071,21874,3578735630,3578735651,21
1,1071,21875,3578735630,3578735651,21
1,1071,21876,3578735630,3578735652,22
1,1071,21877,3578735630,3578735653,23
1,1071,21878,3578735630,3578735654,24
1,1071,21879,3578735630,3578735655,25
1,1071,21880,3578735630,3578735658,28
1,1071,21881,3578735630,3578735658,28
1,1071,21882,3578735630,3578735658,28
1,1071,21883,3578735630,3578735660,30
1,1071,21884,3578735630,3578735664,34
1,1071,21885,3578735630,3578735665,35
1,1071,21886,3578735630,3578735666,36
1,1071,21887,3578735630,3578735666,36
1,1071,21888,3578735630,3578735668,38
1,1071,21889,3578735630,3578735668,38
1,1071,21890,3578735630,3578735668,38
1,1071,21891,3578735630,3578735668,38
1,1071,21892,3578735630,3578735669,39
1,1071,21893,3578735630,3578735669,39
1,1071,21894,3578735630,3578735669,39
1,1071,21895,3578735630,3578735670,40
1,1071,21896,3578735630,3578735677,47
1,1072,21897,3578735688,3578735688,0
1,1072,21898,3578735688,3578735688,0
1,1072,21899,3578735688,3578735688,0
1,1072,21900,3578735688,3578735688,0
1,1072,21901,3578735688,3578735688,0
1,1072,21902,3578735688,3578735689,1
1,1072,21903,3578735688,3578735690,2
1,1072,21904,3578735688,3578735690,2
1,1072,21905,3578735688,3578735691,3
1,1072,21906,3578735688,3578735693,5
1,1072,21907,3578735688,3578735693,5
1,1072,21908,3578735688,3578735695,7
1,1072,21909,3578735688,3578735699,11
1,1072,21910,3578735688,3578735700,12
1,1072,21911,3578735688,3578735701,13
1,1072,21912,3578735688,3578735702,14
1,1072,21913,3578735688,3578735703,15
1,1072,21914,3578735688,3578735704,16
1,1072,21915,3578735688,3578735704,16
1,1072,21916,3578735688,3578735704,16
1,1072,21917,3578735688,3578735704,16
1,1072,21918,3578735688,3578735704,16
1,1072,21919,3578735688,3578735706,18
1,1072,21920,3578735688,3578735707,19
1,1072,21921,3578735688,3578735707,19
1,1072,21922,3578735688,3578735709,21
1,1072,21923,3578735688,3578735709,21
1,1072,21924,3578735688,3578735710,22
1,1072,21925,3578735688,3578735711,23
1,1072,21926,3578735688,3578735711,23
1,1072,21927,3578735688,3578735712,24
1,1072,21928,3578735688,3578735713,25
1,1072,21929,3578735688,3578735714,26
1,1072,21930,3578735688,3578735715,27
1,1072,21931,3578735688,3578735715,27
1,1072,21932,3578735688,3578735716,28
1,1072,21933,3578735688,3578735718,30
1,1072,21934,3578735688,3578735718,30
1,1072,21935,3578735688,3578735719,31
1,1072,21936,3578735688,3578735720,32
1,1072,21937,3578735688,3578735720,32
1,1072,21938,3578735688,3578735723,35
1,1072,21939,3578735688,3578735724,36
1,1072,21940,3578735688,3578735726,38
1,1072,21941,3578735688,3578735727,39
1,1072,21942,3578735688,3578735727,39
1,1072,21943,3578735688,3578735727,39
1,1072,21944,3578735688,3578735728,40
1,1072,21945,3578735688,3578735728,40
1,1072,21946,3578735688,3578735728,40
1,1072,21947,3578735688,3578735729,41
1,1072,21948,3578735688,3578735731,43
1,1072,21949,3578735688,3578735732,44
1,1072,21950,3578735688,3578735732,44
1,1072,21951,3578735688,3578735733,45
1,1072,21952,3578735688,3578735733,45
1,1072,21953,3578735688,3578735734,46
1,1072,21954,3578735688,3578735737,49
1,1073,21955,3578735748,3578735749,1
1,1073,21956,3578735748,3578735749,1
1,1073,21957,3578735748,3578735749,1
1,1073,21958,3578735748,3578735749,1
1,1073,21959,3578735748,3578735749,1
1,1073,21960,3578735748,3578735749,1
1,1073,21961,3578735748,3578735749,1
1,1073,21962,3578735748,3578735749,1
1,1073,21963,3578735748,3578735749,1
1,1073,21964,3578735748,3578735749,1
1,1073,21965,3578735748,3578735749,1
1,1073,21966,3578735748,3578735753,5
1,1073,21967,3578735748,3578735753,5
1,1073,21968,3578735748,3578735754,6
1,1073,21969,3578735748,3578735755,7
1,1073,21970,3578735748,3578735755,7
1,1073,21971,3578735748,3578735755,7
1,1073,21972,3578735748,3578735756,8
1,1073,21973,3578735748,3578735762,14
1,1073,21974,3578735748,3578735762,14
1,1073,21975,3578735748,3578735762,14
1,1073,21976,3578735748,3578735764,16
1,1073,21977,3578735748,3578735764,16
1,1073,21978,3578735748,3578735765,17
1,1073,21979,3578735748,3578735766,18
1,1073,21980,3578735748,3578735768,20
1,1073,21981,3578735748,3578735770,22
1,1073,21982,3578735748,3578735771,23
1,1073,21983,3578735748,3578735773,25
1,1073,21984,3578735748,3578735774,26
1,1073,21985,3578735748,3578735775,27
1,1073,21986,3578735748,3578735777,29
1,1073,21987,3578735748,3578735781,33
1,1073,21988,3578735748,3578735782,34
1,1073,21989,3578735748,3578735783,35
1,1073,21990,3578735748,3578735784,36
1,1073,21991,3578735748,3578735784,36
1,1073,21992,3578735748,3578735785,37
1,1073,21993,3578735748,3578735785,37
1,1073,21994,3578735748,3578735786,38
1,1073,21995,3578735748,3578735791,43
1,1073,21996,3578735748,3578735791,43
1,1073,21997,3578735748,3578735792,44
1,1073,21998,3578735748,3578735793,45
1,1073,21999,3578735748,3578735796,48
1,1073,22000,3578735748,3578735796,48
1,1073,22001,3578735748,3578735796,48
1,1073,22002,3578735748,3578735797,49
1,1073,22003,3578735748,3578735798,50
1,1074,22004,3578735807,3578735807,0
1,1074,22005,3578735807,3578735807,0
1,1074,22006,3578735807,3578735807,0
1,1074,22007,3578735807,3578735807,0
1,1074,22008,3578735807,3578735807,0
1,1074,22009,3578735807,3578735807,0
1,1074,22010,3578735807,3578735807,0
1,1074,22011,3578735807,3578735808,1
1,1074,22012,3578735807,3578735809,2
1,1074,22013,3578735807,3578735810,3
1,1074,22014,3578735807,3578735812,5
1,1074,22015,3578735807,3578735813,6
1,1074,22016,3578735807,3578735815,8
1,1074,22017,3578735807,3578735815,8
1,1074,22018,3578735807,3578735816,9
1,1074,22019,3578735807,3578735818,11
1,1074,22020,3578735807,3578735818,11
1,1074,22021,3578735807,3578735818,11
1,1074,22022,3578735807,3578735819,12
1,1074,22023,3578735807,3578735820,13
1,1074,22024,3578735807,3578735821,14
1,1074,22025,3578735807,3578735821,14
1,1074,22026,3578735807,3578735824,17
1,1074,22027,3578735807,3578735824,17
1,1074,22028,3578735807,3578735825,18
1,1074,22029,3578735807,3578735826,19
1,1074,22030,3578735807,3578735828,21
1,1074,22031,3578735807,3578735828,21
1,1074,22032,3578735807,3578735829,22
1,1074,22033,3578735807,3578735829,22
1,1074,22034,3578735807,3578735829,22
1,1074,22035,3578735807,3578735829,22
1,1074,22036,3578735807,3578735831,24
1,1074,22037,3578735807,3578735835,28
1,1074,22038,3578735807,3578735837,30
1,1074,22039,3578735807,3578735837,30
1,1074,22040,3578735807,3578735840,33
1,1074,22041,3578735807,3578735840,33
1,1074,22042,3578735807,3578735841,34
1,1074,22043,3578735807,3578735841,34
1,1074,22044,3578735807,3578735843,36
1,1074,22045,3578735807,3578735844,37
1,1074,22046,3578735807,3578735845,38
1,1074,22047,3578735807,3578735848,41
1,1074,22048,3578735807,3578735849,42
1,1074,22049,3578735807,3578735849,42
1,1074,22050,3578735807,3578735850,43
1,1074,22051,3578735807,3578735851,44
1,1074,22052,3578735807,3578735853,46
1,1074,22053,3578735807,3578735855,48
1,1075,22054,3578735870,3578735870,0
1,1075,22055,3578735870,3578735870,0
1,1075,22056,3578735870,3578735870,0
1,1075,22057,3578735870,3578735870,0
1,1075,22058,3578735870,3578735870,0
1,1075,22059,3578735870,3578735870,0
1,1075,22060,3578735870,3578735870,0
1,1075,22061,3578735870,3578735870,0
1,1075,22062,3578735870,3578735870,0
1,1075,22063,3578735870,3578735870,0
1,1075,22064,3578735870,3578735870,0
1,1075,22065,3578735870,3578735870,0
1,1075,22066,3578735870,3578735870,0
1,1075,22067,3578735870,3578735870,0
1,1075,22068,3578735870,3578735870,0
1,1075,22069,3578735870,3578735870,0
1,1075,22070,3578735870,3578735877,7
1,1075,22071,3578735870,3578735884,14
1,1075,22072,3578735870,3578735884,14
1,1075,22073,3578735870,3578735885,15
1,1075,22074,3578735870,3578735885,15
1,1075,22075,3578735870,3578735886,16
1,1075,22076,3578735870,3578735890,20
1,1075,22077,3578735870,3578735890,20
1,1075,22078,3578735870,3578735890,20
1,1075,22079,3578735870,3578735891,21
1,1075,22080,3578735870,3578735893,23
1,1075,22081,3578735870,3578735894,24
1,1075,22082,3578735870,3578735895,25
1,1075,22083,3578735870,3578735899,29
1,1075,22084,3578735870,3578735900,30
1,1075,22085,3578735870,3578735901,31
1,1075,22086,3578735870,3578735902,32
1,1075,22087,3578735870,3578735903,33
1,1075,22088,3578735870,3578735904,34
1,1075,22089,3578735870,3578735904,34
1,1075,22090,3578735870,3578735904,34
1,1075,22091,3578735870,3578735905,35
1,1075,22092,3578735870,3578735905,35
1,1075,22093,3578735870,3578735906,36
1,1075,22094,3578735870,3578735906,36
1,1075,22095,3578735870,3578735907,37
1,1075,22096,3578735870,3578735907,37
1,1075,22097,3578735870,3578735909,39
1,1075,22098,3578735870,3578735909,39
1,1075,22099,3578735870,3578735910,40
1,1075,22100,3578735870,3578735911,41
1,1075,22101,3578735870,3578735911,41
1,1075,22102,3578735870,3578735914,44
1,1075,22103,3578735870,3578735914,44
1,1075,22104,3578735870,3578735915,45
1,1075,22105,3578735870,3578735915,45
1,1075,22106,3578735870,3578735916,46
1,1075,22107,3578735870,3578735916,46
1,1075,22108,3578735870,3578735917,47
1,1075,22109,3578735870,3578735918,48
1,1075,22110,3578735870,3578735918,48
1,1075,22111,3578735870,3578735919,49
1,1075,22112,3578735870,3578735920,50
1,1076,22113,3578735928,3578735928,0
1,1076,22114,3578735928,3578735928,0
1,1076,22115,3578735928,3578735928,0
1,1076,22116,3578735928,3578735929,1
1,1076,22117,3578735928,3578735929,1
1,1076,22118,3578735928,3578735929,1
1,1076,22119,3578735928,3578735929,1
1,1076,22120,3578735928,3578735929,1
1,1076,22121,3578735928,3578735929,1
1,1076,22122,3578735928,3578735929,1
1,1076,22123,3578735928,3578735929,1
1,1076,22124,3578735928,3578735929,1
1,1076,22125,3578735928,3578735929,1
1,1076,22126,3578735928,3578735929,1
1,1076,22127,3578735928,3578735930,2
1,1076,22128,3578735928,3578735932,4
1,1076,22129,3578735928,3578735933,5
1,1076,22130,3578735928,3578735933,5
1,1076,22131,3578735928,3578735937,9
1,1076,22132,3578735928,3578735939,11
1,1076,22133,3578735928,3578735942,14
1,1076,22134,3578735928,3578735942,14
1,1076,22135,3578735928,3578735942,14
1,1076,22136,3578735928,3578735943,15
1,1076,22137,3578735928,3578735943,15
1,1076,22138,3578735928,3578735943,15
1,1076,22139,3578735928,3578735943,15
1,1076,22140,3578735928,3578735944,16
1,1076,22141,3578735928,3578735946,18
1,1076,22142,3578735928,3578735946,18
1,1076,22143,3578735928,3578735949,21
1,1076,22144,3578735928,3578735954,26
1,1076,22145,3578735928,3578735954,26
1,1076,22146,3578735928,3578735955,27
1,1076,22147,3578735928,3578735955,27
1,1076,22148,3578735928,3578735955,27
1,1076,22149,3578735928,3578735955,27
1,1076,22150,3578735928,3578735956,28
1,1076,22151,3578735928,3578735961,33
1,1076,22152,3578735928,3578735962,34
1,1076,22153,3578735928,3578735962,34
1,1076,22154,3578735928,3578735962,34
1,1076,22155,3578735928,3578735963,35
1,1076,22156,3578735928,3578735965,37
1,1076,22157,3578735928,3578735965,37
1,1076,22158,3578735928,3578735965,37
1,1076,22159,3578735928,3578735967,39
1,1076,22160,3578735928,3578735968,40
1,1076,22161,3578735928,3578735970,42
1,1076,22162,3578735928,3578735971,43
1,1076,22163,3578735928,3578735973,45
1,1076,22164,3578735928,3578735974,46
1,1076,22165,3578735928,3578735975,47
1,1076,22166,3578735928,3578735975,47
1,1076,22167,3578735928,3578735977,49
1,1077,22168,3578735990,3578735990,0
1,1077,22169,3578735990,3578735990,0
1,1077,22170,3578735990,3578735990,0
1,1077,22171,3578735990,3578735990,0
1,1077,22172,3578735990,3578735990,0
1,1077,22173,3578735990,3578735990,0
1,1077,22174,3578735990,3578735990,0
1,1077,22175,3578735990,3578735990,0
1,1077,22176,3578735990,3578735990,0
1,1077,22177,3578735990,3578735991,1
1,1077,22178,3578735990,3578735992,2
1,1077,22179,3578735990,3578735993,3
1,1077,22180,3578735990,3578735993,3
1,1077,22181,3578735990,3578735994,4
1,1077,22182,3578735990,3578735996,6
1,1077,22183,3578735990,3578735996,6
1,1077,22184,3578735990,3578735997,7
1,1077,22185,3578735990,3578735998,8
1,1077,22186,3578735990,3578735999,9
1,1077,22187,3578735990,3578736000,10
1,1077,22188,3578735990,3578736000,10
1,1077,22189,3578735990,3578736001,11
1,1077,22190,3578735990,3578736006,16
1,1077,22191,3578735990,3578736007,17
1,1077,22192,3578735990,3578736008,18
1,1077,22193,3578735990,3578736009,19
1,1077,22194,3578735990,3578736011,21
1,1077,22195,3578735990,3578736012,22
1,1077,22196,3578735990,3578736013,23
1,1077,22197,3578735990,3578736014,24
1,1077,22198,3578735990,3578736015,25
1,1077,22199,3578735990,3578736015,25
1,1077,22200,3578735990,3578736016,26
1,1077,22201,3578735990,3578736018,28
1,1077,22202,3578735990,3578736018,28
1,1077,22203,3578735990,3578736018,28
1,1077,22204,3578735990,3578736019,29
1,1077,22205,3578735990,3578736020,30
1,1077,22206,3578735990,3578736021,31
1,1077,22207,3578735990,3578736021,31
1,1077,22208,3578735990,3578736024,34
1,1077,22209,3578735990,3578736024,34
1,1077,22210,3578735990,3578736026,36
1,1077,22211,3578735990,3578736026,36
1,1077,22212,3578735990,3578736028,38
1,1077,22213,3578735990,3578736028,38
1,1077,22214,3578735990,3578736029,39
1,1077,22215,3578735990,3578736029,39
1,1077,22216,3578735990,3578736030,40
1,1077,22217,3578735990,3578736030,40
1,1077,22218,3578735990,3578736031,41
1,1077,22219,3578735990,3578736031,41
1,1077,22220,3578735990,3578736035,45
1,1077,22221,3578735990,3578736037,47
1,1077,22222,3578735990,3578736037,47
1,1077,22223,3578735990,3578736040,50
1,1078,22224,3578736051,3578736051,0
1,1078,22225,3578736051,3578736051,0
1,1078,22226,3578736051,3578736051,0
1,1078,22227,3578736051,3578736051,0
1,1078,22228,3578736051,3578736051,0
1,1078,22229,3578736051,3578736051,0
1,1078,22230,3578736051,3578736051,0
1,1078,22231,3578736051,3578736051,0
1,1078,22232,3578736051,3578736051,0
1,1078,22233,3578736051,3578736051,0
1,1078,22234,3578736051,3578736052,1
1,1078,22235,3578736051,3578736053,2
1,1078,22236,3578736051,3578736056,5
1,1078,22237,3578736051,3578736059,8
1,1078,22238,3578736051,3578736059,8
1,1078,22239,3578736051,3578736063,12
1,1078,22240,3578736051,3578736063,12
1,1078,22241,3578736051,3578736064,13
1,1078,22242,3578736051,3578736067,16
1,1078,22243,3578736051,3578736067,16
1,1078,22244,3578736051,3578736067,16
1,1078,22245,3578736051,3578736068,17
1,1078,22246,3578736051,3578736068,17
1,1078,22247,3578736051,3578736068,17
1,1078,22248,3578736051,3578736069,18
1,1078,22249,3578736051,3578736069,18
1,1078,22250,3578736051,3578736070,19
1,1078,22251,3578736051,3578736071,20
1,1078,22252,3578736051,3578736077,26
1,1078,22253,3578736051,3578736083,32
1,1078,22254,3578736051,3578736085,34
1,1078,22255,3578736051,3578736085,34
1,1078,22256,3578736051,3578736086,35
1,1078,22257,3578736051,3578736090,39
1,1078,22258,3578736051,3578736091,40
1,1078,22259,3578736051,3578736091,40
1,1078,22260,3578736051,3578736091,40
1,1078,22261,3578736051,3578736094,43
1,1078,22262,3578736051,3578736094,43
1,1078,22263,3578736051,3578736094,43
1,1078,22264,3578736051,3578736095,44
1,1078,22265,3578736051,3578736100,49
1,1078,22266,3578736051,3578736101,50
1,1079,22267,3578736111,3578736111,0
1,1079,22268,3578736111,3578736111,0
1,1079,22269,3578736111,3578736111,0
1,1079,22270,3578736111,3578736111,0
1,1079,22271,3578736111,3578736111,0
1,1079,22272,3578736111,3578736111,0
1,1079,22273,3578736111,3578736111,0
1,1079,22274,3578736111,3578736111,0
1,1079,22275,3578736111,3578736111,0
1,1079,22276,3578736111,3578736111,0
1,1079,22277,3578736111,3578736111,0
1,1079,22278,3578736111,3578736111,0
1,1079,22279,3578736111,3578736111,0
1,1079,22280,3578736111,3578736111,0
1,1079,22281,3578736111,3578736113,2
1,1079,22282,3578736111,3578736115,4
1,1079,22283,3578736111,3578736115,4
1,1079,22284,3578736111,3578736115,4
1,1079,22285,3578736111,3578736117,6
1,1079,22286,3578736111,3578736118,7
1,1079,22287,3578736111,3578736118,7
1,1079,22288,3578736111,3578736119,8
1,1079,22289,3578736111,3578736119,8
1,1079,22290,3578736111,3578736119,8
1,1079,22291,3578736111,3578736119,8
1,1079,22292,3578736111,3578736121,10
1,1079,22293,3578736111,3578736123,12
1,1079,22294,3578736111,3578736124,13
1,1079,22295,3578736111,3578736124,13
1,1079,22296,3578736111,3578736127,16
1,1079,22297,3578736111,3578736127,16
1,1079,22298,3578736111,3578736128,17
1,1079,22299,3578736111,3578736128,17
1,1079,22300,3578736111,3578736128,17
1,1079,22301,3578736111,3578736129,18
1,1079,22302,3578736111,3578736129,18
1,1079,22303,3578736111,3578736129,18
1,1079,22304,3578736111,3578736129,18
1,1079,22305,3578736111,3578736129,18
1,1079,22306,3578736111,3578736130,19
1,1079,22307,3578736111,3578736133,22
1,1079,22308,3578736111,3578736133,22
1,1079,22309,3578736111,3578736133,22
1,1079,22310,3578736111,3578736134,23
1,1079,22311,3578736111,3578736134,23
1,1079,22312,3578736111,3578736134,23
1,1079,22313,3578736111,3578736138,27
1,1079,22314,3578736111,3578736139,28
1,1079,22315,3578736111,3578736142,31
1,1079,22316,3578736111,3578736142,31
1,1079,22317,3578736111,3578736142,31
1,1079,22318,3578736111,3578736142,31
1,1079,22319,3578736111,3578736143,32
1,1079,22320,3578736111,3578736143,32
1,1079,22321,3578736111,3578736144,33
1,1079,22322,3578736111,3578736146,35
1,1079,22323,3578736111,3578736146,35
1,1079,22324,3578736111,3578736149,38
1,1079,22325,3578736111,3578736153,42
1,1079,22326,3578736111,3578736154,43
1,1079,22327,3578736111,3578736155,44
1,1079,22328,3578736111,3578736155,44
1,1079,22329,3578736111,3578736156,45
1,1079,22330,3578736111,3578736156,45
1,1080,22331,3578736172,3578736172,0
1,1080,22332,3578736172,3578736172,0
1,1080,22333,3578736172,3578736172,0
1,1080,22334,3578736172,3578736172,0
1,1080,22335,3578736172,3578736172,0
1,1080,22336,3578736172,3578736172,0
1,1080,22337,3578736172,3578736172,0
1,1080,22338,3578736172,3578736172,0
1,1080,22339,3578736172,3578736172,0
1,1080,22340,3578736172,3578736172,0
1,1080,22341,3578736172,3578736172,0
1,1080,22342,3578736172,3578736174,2
1,1080,22343,3578736172,3578736174,2
1,1080,22344,3578736172,3578736175,3
1,1080,22345,3578736172,3578736177,5
1,1080,22346,3578736172,3578736181,9
1,1080,22347,3578736172,3578736182,10
1,1080,22348,3578736172,3578736182,10
1,1080,22349,3578736172,3578736183,11
1,1080,22350,3578736172,3578736184,12
1,1080,22351,3578736172,3578736185,13
1,1080,22352,3578736172,3578736186,14
1,1080,22353,3578736172,3578736186,14
1,1080,22354,3578736172,3578736191,19
1,1080,22355,3578736172,3578736191,19
1,1080,22356,3578736172,3578736191,19
1,1080,22357,3578736172,3578736192,20
1,1080,22358,3578736172,3578736193,21
1,1080,22359,3578736172,3578736194,22
1,1080,22360,3578736172,3578736195,23
1,1080,22361,3578736172,3578736196,24
1,1080,22362,3578736172,3578736197,25
1,1080,22363,3578736172,3578736197,25
1,1080,22364,3578736172,3578736198,26
1,1080,22365,3578736172,3578736199,27
1,1080,22366,3578736172,3578736200,28
1,1080,22367,3578736172,3578736201,29
1,1080,22368,3578736172,3578736202,30
1,1080,22369,3578736172,3578736205,33
1,1080,22370,3578736172,3578736207,35
1,1080,22371,3578736172,3578736208,36
1,1080,22372,3578736172,3578736208,36
1,1080,22373,3578736172,3578736211,39
1,1080,22374,3578736172,3578736211,39
1,1080,22375,3578736172,3578736212,40
1,1080,22376,3578736172,3578736215,43
1,1080,22377,3578736172,3578736216,44
1,1080,22378,3578736172,3578736217,45
1,1080,22379,3578736172,3578736217,45
1,1080,22380,3578736172,3578736218,46
1,1080,22381,3578736172,3578736220,48
1,1080,22382,3578736172,3578736220,48
1,1080,22383,3578736172,3578736220,48
1,1080,22384,3578736172,3578736220,48
1,1080,22385,3578736172,3578736221,49
1,1080,22386,3578736172,3578736221,49
1,1081,22387,3578736233,3578736233,0
1,1081,22388,3578736233,3578736233,0
1,1081,22389,3578736233,3578736233,0
1,1081,22390,3578736233,3578736233,0
1,1081,22391,3578736233,3578736233,0
1,1081,22392,3578736233,3578736233,0
1,1081,22393,3578736233,3578736233,0
1,1081,22394,3578736233,3578736233,0
1,1081,22395,3578736233,3578736233,0
1,1081,22396,3578736233,3578736233,0
1,1081,22397,3578736233,3578736233,0
1,1081,22398,3578736233,3578736233,0
1,1081,22399,3578736233,3578736233,0
1,1081,22400,3578736233,3578736233,0
1,1081,22401,3578736233,3578736236,3
1,1081,22402,3578736233,3578736237,4
1,1081,22403,3578736233,3578736237,4
1,1081,22404,3578736233,3578736240,7
1,1081,22405,3578736233,3578736240,7
1,1081,22406,3578736233,3578736242,9
1,1081,22407,3578736233,3578736243,10
1,1081,22408,3578736233,3578736244,11
1,1081,22409,3578736233,3578736246,13
1,1081,22410,3578736233,3578736247,14
1,1081,22411,3578736233,3578736248,15
1,1081,22412,3578736233,3578736248,15
1,1081,22413,3578736233,3578736248,15
1,1081,22414,3578736233,3578736249,16
1,1081,22415,3578736233,3578736250,17
1,1081,22416,3578736233,3578736250,17
1,1081,22417,3578736233,3578736251,18
1,1081,22418,3578736233,3578736252,19
1,1081,22419,3578736233,3578736253,20
1,1081,22420,3578736233,3578736256,23
1,1081,22421,3578736233,3578736258,25
1,1081,22422,3578736233,3578736259,26
1,1081,22423,3578736233,3578736263,30
1,1081,22424,3578736233,3578736264,31
1,1081,22425,3578736233,3578736264,31
1,1081,22426,3578736233,3578736265,32
1,1081,22427,3578736233,3578736267,34
1,1081,22428,3578736233,3578736267,34
1,1081,22429,3578736233,3578736267,34
1,1081,22430,3578736233,3578736268,35
1,1081,22431,3578736233,3578736268,35
1,1081,22432,3578736233,3578736269,36
1,1081,22433,3578736233,3578736270,37
1,1081,22434,3578736233,3578736271,38
1,1081,22435,3578736233,3578736274,41
1,1081,22436,3578736233,3578736277,44
1,1082,22437,3578736292,3578736292,0
1,1082,22438,3578736292,3578736292,0
1,1082,22439,3578736292,3578736292,0
1,1082,22440,3578736292,3578736292,0
1,1082,22441,3578736292,3578736292,0
1,1082,22442,3578736292,3578736292,0
1,1082,22443,3578736292,3578736292,0
1,1082,22444,3578736292,3578736292,0
1,1082,22445,3578736292,3578736293,1
1,1082,22446,3578736292,3578736295,3
1,1082,22447,3578736292,3578736295,3
1,1082,22448,3578736292,3578736296,4
1,1082,22449,3578736292,3578736300,8
1,1082,22450,3578736292,3578736300,8
1,1082,22451,3578736292,3578736301,9
1,1082,22452,3578736292,3578736302,10
1,1082,22453,3578736292,3578736304,12
1,1082,22454,3578736292,3578736305,13
1,1082,22455,3578736292,3578736305,13
1,1082,22456,3578736292,3578736306,14
1,1082,22457,3578736292,3578736306,14
1,1082,22458,3578736292,3578736307,15
1,1082,22459,3578736292,3578736307,15
1,1082,22460,3578736292,3578736307,15
1,1082,22461,3578736292,3578736307,15
1,1082,22462,3578736292,3578736309,17
1,1082,22463,3578736292,3578736310,18
1,1082,22464,3578736292,3578736311,19
1,1082,22465,3578736292,3578736311,19
1,1082,22466,3578736292,3578736312,20
1,1082,22467,3578736292,3578736313,21
1,1082,22468,3578736292,3578736314,22
1,1082,22469,3578736292,3578736315,23
1,1082,22470,3578736292,3578736315,23
1,1082,22471,3578736292,3578736316,24
1,1082,22472,3578736292,3578736317,25
1,1082,22473,3578736292,3578736318,26
1,1082,22474,3578736292,3578736318,26
1,1082,22475,3578736292,3578736319,27
1,1082,22476,3578736292,3578736319,27
1,1082,22477,3578736292,3578736320,28
1,1082,22478,3578736292,3578736320,28
1,1082,22479,3578736292,3578736320,28
1,1082,22480,3578736292,3578736321,29
1,1082,22481,3578736292,3578736323,31
1,1082,22482,3578736292,3578736324,32
1,1082,22483,3578736292,3578736325,33
1,1082,22484,3578736292,3578736327,35
1,1082,22485,3578736292,3578736328,36
1,1082,22486,3578736292,3578736328,36
1,1082,22487,3578736292,3578736328,36
1,1082,22488,3578736292,3578736328,36
1,1082,22489,3578736292,3578736329,37
1,1082,22490,3578736292,3578736329,37
1,1082,22491,3578736292,3578736330,38
1,1082,22492,3578736292,3578736330,38
1,1082,22493,3578736292,3578736330,38
1,1082,22494,3578736292,3578736330,38
1,1082,22495,3578736292,3578736333,41
1,1082,22496,3578736292,3578736333,41
1,1082,22497,3578736292,3578736334,42
1,1082,22498,3578736292,3578736334,42
1,1082,22499,3578736292,3578736337,45
1,1082,22500,3578736292,3578736339,47
1,1082,22501,3578736292,3578736341,49
1,1083,22502,3578736352,3578736352,0
1,1083,22503,3578736352,3578736352,0
1,1083,22504,3578736352,3578736352,0
1,1083,22505,3578736352,3578736352,0
1,1083,22506,3578736352,3578736352,0
1,1083,22507,3578736352,3578736352,0
1,1083,22508,3578736352,3578736352,0
1,1083,22509,3578736352,3578736352,0
1,1083,22510,3578736352,3578736352,0
1,1083,22511,3578736352,3578736352,0
1,1083,22512,3578736352,3578736353,1
1,1083,22513,3578736352,3578736353,1
1,1083,22514,3578736352,3578736353,1
1,1083,22515,3578736352,3578736355,3
1,1083,22516,3578736352,3578736355,3
1,1083,22517,3578736352,3578736355,3
1,1083,22518,3578736352,3578736356,4
1,1083,22519,3578736352,3578736356,4
1,1083,22520,3578736352,3578736356,4
1,1083,22521,3578736352,3578736358,6
1,1083,22522,3578736352,3578736361,9
1,1083,22523,3578736352,3578736362,10
1,1083,22524,3578736352,3578736363,11
1,1083,22525,3578736352,3578736363,11
1,1083,22526,3578736352,3578736364,12
1,1083,22527,3578736352,3578736365,13
1,1083,22528,3578736352,3578736365,13
1,1083,22529,3578736352,3578736367,15
1,1083,22530,3578736352,3578736368,16
1,1083,22531,3578736352,3578736368,16
1,1083,22532,3578736352,3578736370,18
1,1083,22533,3578736352,3578736371,19
1,1083,22534,3578736352,3578736373,21
1,1083,22535,3578736352,3578736374,22
1,1083,22536,3578736352,3578736375,23
1,1083,22537,3578736352,3578736376,24
1,1083,22538,3578736352,3578736378,26
1,1083,22539,3578736352,3578736382,30
1,1083,22540,3578736352,3578736383,31
1,1083,22541,3578736352,3578736384,32
1,1083,22542,3578736352,3578736384,32
1,1083,22543,3578736352,3578736384,32
1,1083,22544,3578736352,3578736385,33
1,1083,22545,3578736352,3578736385,33
1,1083,22546,3578736352,3578736386,34
1,1083,22547,3578736352,3578736392,40
1,1083,22548,3578736352,3578736392,40
1,1083,22549,3578736352,3578736392,40
1,1083,22550,3578736352,3578736393,41
1,1083,22551,3578736352,3578736393,41
1,1083,22552,3578736352,3578736394,42
1,1083,22553,3578736352,3578736396,44
1,1083,22554,3578736352,3578736396,44
1,1083,22555,3578736352,3578736397,45
1,1083,22556,3578736352,3578736399,47
1,1083,22557,3578736352,3578736399,47
1,1083,22558,3578736352,3578736399,47
1,1083,22559,3578736352,3578736401,49
1,1083,22560,3578736352,3578736401,49
1,1083,22561,3578736352,3578736401,49
1,1083,22562,3578736352,3578736402,50
1,1084,22563,3578736414,3578736414,0
1,1084,22564,3578736414,3578736414,0
1,1084,22565,3578736414,3578736414,0
1,1084,22566,3578736414,3578736414,0
1,1084,22567,3578736414,3578736414,0
1,1084,22568,3578736414,3578736414,0
1,1084,22569,3578736414,3578736414,0
1,1084,22570,3578736414,3578736414,0
1,1084,22571,3578736414,3578736415,1
1,1084,22572,3578736414,3578736416,2
1,1084,22573,3578736414,3578736417,3
1,1084,22574,3578736414,3578736418,4
1,1084,22575,3578736414,3578736418,4
1,1084,22576,3578736414,3578736419,5
1,1084,22577,3578736414,3578736419,5
1,1084,22578,3578736414,3578736420,6
1,1084,22579,3578736414,3578736420,6
1,1084,22580,3578736414,3578736421,7
1,1084,22581,3578736414,3578736422,8
1,1084,22582,3578736414,3578736424,10
1,1084,22583,3578736414,3578736425,11
1,1084,22584,3578736414,3578736425,11
1,1084,22585,3578736414,3578736426,12
1,1084,22586,3578736414,3578736426,12
1,1084,22587,3578736414,3578736428,14
1,1084,22588,3578736414,3578736428,14
1,1084,22589,3578736414,3578736429,15
1,1084,22590,3578736414,3578736429,15
1,1084,22591,3578736414,3578736431,17
1,1084,22592,3578736414,3578736432,18
1,1084,22593,3578736414,3578736432,18
1,1084,22594,3578736414,3578736435,21
1,1084,22595,3578736414,3578736437,23
1,1084,22596,3578736414,3578736440,26
1,1084,22597,3578736414,3578736440,26
1,1084,22598,3578736414,3578736442,28
1,1084,22599,3578736414,3578736442,28
1,1084,22600,3578736414,3578736445,31
1,1084,22601,3578736414,3578736446,32
1,1084,22602,3578736414,3578736447,33
1,1084,22603,3578736414,3578736447,33
1,1084,22604,3578736414,3578736448,34
1,1084,22605,3578736414,3578736448,34
1,1084,22606,3578736414,3578736449,35
1,1084,22607,3578736414,3578736450,36
1,1084,22608,3578736414,3578736450,36
1,1084,22609,3578736414,3578736452,38
1,1084,22610,3578736414,3578736452,38
1,1084,22611,3578736414,3578736456,42
1,1084,22612,3578736414,3578736456,42
1,1084,22613,3578736414,3578736458,44
1,1084,22614,3578736414,3578736460,46
1,1084,22615,3578736414,3578736462,48
1,1084,22616,3578736414,3578736463,49
1,1084,22617,3578736414,3578736463,49
1,1085,22618,3578736476,3578736476,0
1,1085,22619,3578736476,3578736476,0
1,1085,22620,3578736476,3578736476,0
1,1085,22621,3578736476,3578736476,0
1,1085,22622,3578736476,3578736476,0
1,1085,22623,3578736476,3578736476,0
1,1085,22624,3578736476,3578736476,0
1,1085,22625,3578736476,3578736476,0
1,1085,22626,3578736476,3578736476,0
1,1085,22627,3578736476,3578736476,0
1,1085,22628,3578736476,3578736476,0
1,1085,22629,3578736476,3578736476,0
1,1085,22630,3578736476,3578736476,0
1,1085,22631,3578736476,3578736477,1
1,1085,22632,3578736476,3578736485,9
1,1085,22633,3578736476,3578736485,9
1,1085,22634,3578736476,3578736486,10
1,1085,22635,3578736476,3578736487,11
1,1085,22636,3578736476,3578736490,14
1,1085,22637,3578736476,3578736491,15
1,1085,22638,3578736476,3578736491,15
1,1085,22639,3578736476,3578736492,16
1,1085,22640,3578736476,3578736493,17
1,1085,22641,3578736476,3578736494,18
1,1085,22642,3578736476,3578736495,19
1,1085,22643,3578736476,3578736497,21
1,1085,22644,3578736476,3578736500,24
1,1085,22645,3578736476,3578736500,24
1,1085,22646,3578736476,3578736501,25
1,1085,22647,3578736476,3578736503,27
1,1085,22648,3578736476,3578736504,28
1,1085,22649,3578736476,3578736505,29
1,1085,22650,3578736476,3578736505,29
1,1085,22651,3578736476,3578736505,29
1,1085,22652,3578736476,3578736506,30
1,1085,22653,3578736476,3578736507,31
1,1085,22654,3578736476,3578736507,31
1,1085,22655,3578736476,3578736508,32
1,1085,22656,3578736476,3578736508,32
1,1085,22657,3578736476,3578736508,32
1,1085,22658,3578736476,3578736510,34
1,1085,22659,3578736476,3578736510,34
1,1085,22660,3578736476,3578736511,35
1,1085,22661,3578736476,3578736511,35
1,1085,22662,3578736476,3578736511,35
1,1085,22663,3578736476,3578736513,37
1,1085,22664,3578736476,3578736514,38
1,1085,22665,3578736476,3578736515,39
1,1085,22666,3578736476,3578736515,39
1,1085,22667,3578736476,3578736516,40
1,1085,22668,3578736476,3578736518,42
1,1085,22669,3578736476,3578736518,42
1,1085,22670,3578736476,3578736519,43
1,1085,22671,3578736476,3578736519,43
1,1085,22672,3578736476,3578736520,44
1,1085,22673,3578736476,3578736521,45
1,1085,22674,3578736476,3578736521,45
1,1085,22675,3578736476,3578736523,47
1,1086,22676,3578736537,3578736537,0
1,1086,22677,3578736537,3578736537,0
1,1086,22678,3578736537,3578736537,0
1,1086,22679,3578736537,3578736537,0
1,1086,22680,3578736537,3578736537,0
1,1086,22681,3578736537,3578736537,0
1,1086,22682,3578736537,3578736537,0
1,1086,22683,3578736537,3578736537,0
1,1086,22684,3578736537,3578736537,0
1,1086,22685,3578736537,3578736537,0
1,1086,22686,3578736537,3578736537,0
1,1086,22687,3578736537,3578736537,0
1,1086,22688,3578736537,3578736537,0
1,1086,22689,3578736537,3578736537,0
1,1086,22690,3578736537,3578736537,0
1,1086,22691,3578736537,3578736537,0
1,1086,22692,3578736537,3578736537,0
1,1086,22693,3578736537,3578736537,0
1,1086,22694,3578736537,3578736538,1
1,1086,22695,3578736537,3578736541,4
1,1086,22696,3578736537,3578736541,4
1,1086,22697,3578736537,3578736542,5
1,1086,22698,3578736537,3578736542,5
1,1086,22699,3578736537,3578736542,5
1,1086,22700,3578736537,3578736543,6
1,1086,22701,3578736537,3578736545,8
1,1086,22702,3578736537,3578736545,8
1,1086,22703,3578736537,3578736548,11
1,1086,22704,3578736537,3578736550,13
1,1086,22705,3578736537,3578736552,15
1,1086,22706,3578736537,3578736552,15
1,1086,22707,3578736537,3578736552,15
1,1086,22708,3578736537,3578736554,17
1,1086,22709,3578736537,3578736555,18
1,1086,22710,3578736537,3578736555,18
1,1086,22711,3578736537,3578736555,18
1,1086,22712,3578736537,3578736555,18
1,1086,22713,3578736537,3578736556,19
1,1086,22714,3578736537,3578736557,20
1,1086,22715,3578736537,3578736557,20
1,1086,22716,3578736537,3578736561,24
1,1086,22717,3578736537,3578736562,25
1,1086,22718,3578736537,3578736563,26
1,1086,22719,3578736537,3578736564,27
1,1086,22720,3578736537,3578736564,27
1,1086,22721,3578736537,3578736565,28
1,1086,22722,3578736537,3578736565,28
1,1086,22723,3578736537,3578736567,30
1,1086,22724,3578736537,3578736568,31
1,1086,22725,3578736537,3578736569,32
1,1086,22726,3578736537,3578736570,33
1,1086,22727,3578736537,3578736571,34
1,1086,22728,3578736537,3578736572,35
1,1086,22729,3578736537,3578736575,38
1,1086,22730,3578736537,3578736575,38
1,1086,22731,3578736537,3578736578,41
1,1086,22732,3578736537,3578736581,44
1,1086,22733,3578736537,3578736582,45
1,1086,22734,3578736537,3578736583,46
1,1086,22735,3578736537,3578736584,47
1,1086,22736,3578736537,3578736584,47
1,1086,22737,3578736537,3578736584,47
1,1086,22738,3578736537,3578736585,48
1,1086,22739,3578736537,3578736585,48
1,1086,22740,3578736537,3578736586,49
1,1087,22741,3578736597,3578736597,0
1,1087,22742,3578736597,3578736597,0
1,1087,22743,3578736597,3578736597,0
1,1087,22744,3578736597,3578736597,0
1,1087,22745,3578736597,3578736597,0
1,1087,22746,3578736597,3578736597,0
1,1087,22747,3578736597,3578736597,0
1,1087,22748,3578736597,3578736597,0
1,1087,22749,3578736597,3578736597,0
1,1087,22750,3578736597,3578736598,1
1,1087,22751,3578736597,3578736598,1
1,1087,22752,3578736597,3578736600,3
1,1087,22753,3578736597,3578736600,3
1,1087,22754,3578736597,3578736601,4
1,1087,22755,3578736597,3578736601,4
1,1087,22756,3578736597,3578736601,4
1,1087,22757,3578736597,3578736604,7
1,1087,22758,3578736597,3578736606,9
1,1087,22759,3578736597,3578736609,12
1,1087,22760,3578736597,3578736609,12
1,1087,22761,3578736597,3578736610,13
1,1087,22762,3578736597,3578736611,14
1,1087,22763,3578736597,3578736613,16
1,1087,22764,3578736597,3578736614,17
1,1087,22765,3578736597,3578736615,18
1,1087,22766,3578736597,3578736616,19
1,1087,22767,3578736597,3578736616,19
1,1087,22768,3578736597,3578736617,20
1,1087,22769,3578736597,3578736617,20
1,1087,22770,3578736597,3578736618,21
1,1087,22771,3578736597,3578736618,21
1,1087,22772,3578736597,3578736619,22
1,1087,22773,3578736597,3578736619,22
1,1087,22774,3578736597,3578736621,24
1,1087,22775,3578736597,3578736624,27
1,1087,22776,3578736597,3578736624,27
1,1087,22777,3578736597,3578736624,27
1,1087,22778,3578736597,3578736625,28
1,1087,22779,3578736597,3578736626,29
1,1087,22780,3578736597,3578736627,30
1,1087,22781,3578736597,3578736628,31
1,1087,22782,3578736597,3578736628,31
1,1087,22783,3578736597,3578736628,31
1,1087,22784,3578736597,3578736629,32
1,1087,22785,3578736597,3578736630,33
1,1087,22786,3578736597,3578736631,34
1,1087,22787,3578736597,3578736632,35
1,1087,22788,3578736597,3578736634,37
1,1087,22789,3578736597,3578736636,39
1,1087,22790,3578736597,3578736638,41
1,1087,22791,3578736597,3578736639,42
1,1087,22792,3578736597,3578736641,44
1,1087,22793,3578736597,3578736641,44
1,1087,22794,3578736597,3578736644,47
1,1087,22795,3578736597,3578736646,49
1,1087,22796,3578736597,3578736646,49
1,1087,22797,3578736597,3578736647,50
1,1088,22798,3578736658,3578736658,0
1,1088,22799,3578736658,3578736658,0
1,1088,22800,3578736658,3578736658,0
1,1088,22801,3578736658,3578736658,0
1,1088,22802,3578736658,3578736658,0
1,1088,22803,3578736658,3578736658,0
1,1088,22804,3578736658,3578736658,0
1,1088,22805,3578736658,3578736658,0
1,1088,22806,3578736658,3578736658,0
1,1088,22807,3578736658,3578736658,0
1,1088,22808,3578736658,3578736658,0
1,1088,22809,3578736658,3578736659,1
1,1088,22810,3578736658,3578736660,2
1,1088,22811,3578736658,3578736661,3
1,1088,22812,3578736658,3578736662,4
1,1088,22813,3578736658,3578736663,5
1,1088,22814,3578736658,3578736664,6
1,1088,22815,3578736658,3578736664,6
1,1088,22816,3578736658,3578736666,8
1,1088,22817,3578736658,3578736666,8
1,1088,22818,3578736658,3578736667,9
1,1088,22819,3578736658,3578736667,9
1,1088,22820,3578736658,3578736667,9
1,1088,22821,3578736658,3578736668,10
1,1088,22822,3578736658,3578736668,10
1,1088,22823,3578736658,3578736670,12
1,1088,22824,3578736658,3578736671,13
1,1088,22825,3578736658,3578736674,16
1,1088,22826,3578736658,3578736677,19
1,1088,22827,3578736658,3578736684,26
1,1088,22828,3578736658,3578736685,27
1,1088,22829,3578736658,3578736685,27
1,1088,22830,3578736658,3578736690,32
1,1088,22831,3578736658,3578736691,33
1,1088,22832,3578736658,3578736691,33
1,1088,22833,3578736658,3578736692,34
1,1088,22834,3578736658,3578736693,35
1,1088,22835,3578736658,3578736695,37
1,1088,22836,3578736658,3578736695,37
1,1088,22837,3578736658,3578736698,40
1,1088,22838,3578736658,3578736700,42
1,1088,22839,3578736658,3578736700,42
1,1088,22840,3578736658,3578736701,43
1,1088,22841,3578736658,3578736702,44
1,1088,22842,3578736658,3578736705,47
1,1088,22843,3578736658,3578736705,47
1,1088,22844,3578736658,3578736705,47
1,1088,22845,3578736658,3578736706,48
1,1088,22846,3578736658,3578736707,49
1,1088,22847,3578736658,3578736707,49
1,1088,22848,3578736658,3578736707,49
1,1088,22849,3578736658,3578736707,49
1,1088,22850,3578736658,3578736708,50
1,1089,22851,3578736720,3578736720,0
1,1089,22852,3578736720,3578736720,0
1,1089,22853,3578736720,3578736720,0
1,1089,22854,3578736720,3578736720,0
1,1089,22855,3578736720,3578736720,0
1,1089,22856,3578736720,3578736720,0
1,1089,22857,3578736720,3578736720,0
1,1089,22858,3578736720,3578736720,0
1,1089,22859,3578736720,3578736720,0
1,1089,22860,3578736720,3578736720,0
1,1089,22861,3578736720,3578736720,0
1,1089,22862,3578736720,3578736720,0
1,1089,22863,3578736720,3578736720,0
1,1089,22864,3578736720,3578736720,0
1,1089,22865,3578736720,3578736720,0
1,1089,22866,3578736720,3578736720,0
1,1089,22867,3578736720,3578736720,0
1,1089,22868,3578736720,3578736720,0
1,1089,22869,3578736720,3578736721,1
1,1089,22870,3578736720,3578736721,1
1,1089,22871,3578736720,3578736723,3
1,1089,22872,3578736720,3578736725,5
1,1089,22873,3578736720,3578736726,6
1,1089,22874,3578736720,3578736727,7
1,1089,22875,3578736720,3578736728,8
1,1089,22876,3578736720,3578736728,8
1,1089,22877,3578736720,3578736728,8
1,1089,22878,3578736720,3578736728,8
1,1089,22879,3578736720,3578736729,9
1,1089,22880,3578736720,3578736729,9
1,1089,22881,3578736720,3578736729,9
1,1089,22882,3578736720,3578736730,10
1,1089,22883,3578736720,3578736730,10
1,1089,22884,3578736720,3578736731,11
1,1089,22885,3578736720,3578736731,11
1,1089,22886,3578736720,3578736732,12
1,1089,22887,3578736720,3578736733,13
1,1089,22888,3578736720,3578736734,14
1,1089,22889,3578736720,3578736734,14
1,1089,22890,3578736720,3578736735,15
1,1089,22891,3578736720,3578736738,18
1,1089,22892,3578736720,3578736738,18
1,1089,22893,3578736720,3578736742,22
1,1089,22894,3578736720,3578736742,22
1,1089,22895,3578736720,3578736742,22
1,1089,22896,3578736720,3578736742,22
1,1089,22897,3578736720,3578736743,23
1,1089,22898,3578736720,3578736743,23
1,1089,22899,3578736720,3578736743,23
1,1089,22900,3578736720,3578736743,23
1,1089,22901,3578736720,3578736745,25
1,1089,22902,3578736720,3578736745,25
1,1089,22903,3578736720,3578736748,28
1,1089,22904,3578736720,3578736751,31
1,1089,22905,3578736720,3578736751,31
1,1089,22906,3578736720,3578736752,32
1,1089,22907,3578736720,3578736752,32
1,1089,22908,3578736720,3578736755,35
1,1089,22909,3578736720,3578736755,35
1,1089,22910,3578736720,3578736755,35
1,1089,22911,3578736720,3578736755,35
1,1089,22912,3578736720,3578736756,36
1,1089,22913,3578736720,3578736756,36
1,1089,22914,3578736720,3578736756,36
1,1089,22915,3578736720,3578736757,37
1,1089,22916,3578736720,3578736761,41
1,1089,22917,3578736720,3578736762,42
1,1089,22918,3578736720,3578736762,42
1,1089,22919,3578736720,3578736762,42
1,1089,22920,3578736720,3578736763,43
1,1089,22921,3578736720,3578736764,44
1,1089,22922,3578736720,3578736765,45
1,1089,22923,3578736720,3578736766,46
1,1089,22924,3578736720,3578736768,48
1,1089,22925,3578736720,3578736769,49
1,1089,22926,3578736720,3578736770,50
1,1090,22927,3578736783,3578736783,0
1,1090,22928,3578736783,3578736783,0
1,1090,22929,3578736783,3578736783,0
1,1090,22930,3578736783,3578736783,0
1,1090,22931,3578736783,3578736783,0
1,1090,22932,3578736783,3578736783,0
1,1090,22933,3578736783,3578736783,0
1,1090,22934,3578736783,3578736783,0
1,1090,22935,3578736783,3578736783,0
1,1090,22936,3578736783,3578736784,1
1,1090,22937,3578736783,3578736784,1
1,1090,22938,3578736783,3578736784,1
1,1090,22939,3578736783,3578736784,1
1,1090,22940,3578736783,3578736785,2
1,1090,22941,3578736783,3578736786,3
1,1090,22942,3578736783,3578736790,7
1,1090,22943,3578736783,3578736790,7
1,1090,22944,3578736783,3578736792,9
1,1090,22945,3578736783,3578736792,9
1,1090,22946,3578736783,3578736793,10
1,1090,22947,3578736783,3578736794,11
1,1090,22948,3578736783,3578736795,12
1,1090,22949,3578736783,3578736796,13
1,1090,22950,3578736783,3578736796,13
1,1090,22951,3578736783,3578736797,14
1,1090,22952,3578736783,3578736797,14
1,1090,22953,3578736783,3578736798,15
1,1090,22954,3578736783,3578736799,16
1,1090,22955,3578736783,3578736800,17
1,1090,22956,3578736783,3578736800,17
1,1090,22957,3578736783,3578736801,18
1,1090,22958,3578736783,3578736802,19
1,1090,22959,3578736783,3578736805,22
1,1090,22960,3578736783,3578736806,23
1,1090,22961,3578736783,3578736809,26
1,1090,22962,3578736783,3578736809,26
1,1090,22963,3578736783,3578736811,28
1,1090,22964,3578736783,3578736811,28
1,1090,22965,3578736783,3578736813,30
1,1090,22966,3578736783,3578736813,30
1,1090,22967,3578736783,3578736813,30
1,1090,22968,3578736783,3578736814,31
1,1090,22969,3578736783,3578736815,32
1,1090,22970,3578736783,3578736815,32
1,1090,22971,3578736783,3578736815,32
1,1090,22972,3578736783,3578736817,34
1,1090,22973,3578736783,3578736818,35
1,1090,22974,3578736783,3578736818,35
1,1090,22975,3578736783,3578736818,35
1,1090,22976,3578736783,3578736819,36
1,1090,22977,3578736783,3578736820,37
1,1090,22978,3578736783,3578736821,38
1,1090,22979,3578736783,3578736821,38
1,1090,22980,3578736783,3578736824,41
1,1090,22981,3578736783,3578736824,41
1,1090,22982,3578736783,3578736824,41
1,1090,22983,3578736783,3578736825,42
1,1090,22984,3578736783,3578736826,43
1,1090,22985,3578736783,3578736827,44
1,1090,22986,3578736783,3578736829,46
1,1090,22987,3578736783,3578736829,46
1,1090,22988,3578736783,3578736829,46
1,1090,22989,3578736783,3578736829,46
1,1090,22990,3578736783,3578736830,47
1,1090,22991,3578736783,3578736832,49
1,1091,22992,3578736845,3578736845,0
1,1091,22993,3578736845,3578736845,0
1,1091,22994,3578736845,3578736845,0
1,1091,22995,3578736845,3578736845,0
1,1091,22996,3578736845,3578736845,0
1,1091,22997,3578736845,3578736845,0
1,1091,22998,3578736845,3578736845,0
1,1091,22999,3578736845,3578736845,0
1,1091,23000,3578736845,3578736846,1
1,1091,23001,3578736845,3578736847,2
1,1091,23002,3578736845,3578736847,2
1,1091,23003,3578736845,3578736847,2
1,1091,23004,3578736845,3578736848,3
1,1091,23005,3578736845,3578736849,4
1,1091,23006,3578736845,3578736850,5
1,1091,23007,3578736845,3578736851,6
1,1091,23008,3578736845,3578736851,6
1,1091,23009,3578736845,3578736852,7
1,1091,23010,3578736845,3578736855,10
1,1091,23011,3578736845,3578736859,14
1,1091,23012,3578736845,3578736859,14
1,1091,23013,3578736845,3578736861,16
1,1091,23014,3578736845,3578736862,17
1,1091,23015,3578736845,3578736863,18
1,1091,23016,3578736845,3578736863,18
1,1091,23017,3578736845,3578736864,19
1,1091,23018,3578736845,3578736864,19
1,1091,23019,3578736845,3578736865,20
1,1091,23020,3578736845,3578736866,21
1,1091,23021,3578736845,3578736867,22
1,1091,23022,3578736845,3578736867,22
1,1091,23023,3578736845,3578736867,22
1,1091,23024,3578736845,3578736869,24
1,1091,23025,3578736845,3578736869,24
1,1091,23026,3578736845,3578736870,25
1,1091,23027,3578736845,3578736871,26
1,1091,23028,3578736845,3578736874,29
1,1091,23029,3578736845,3578736877,32
1,1091,23030,3578736845,3578736883,38
1,1091,23031,3578736845,3578736885,40
1,1091,23032,3578736845,3578736886,41
1,1091,23033,3578736845,3578736887,42
1,1091,23034,3578736845,3578736891,46
1,1091,23035,3578736845,3578736891,46
1,1091,23036,3578736845,3578736891,46
1,1091,23037,3578736845,3578736892,47
1,1091,23038,3578736845,3578736893,48
1,1091,23039,3578736845,3578736895,50
1,1092,23040,3578736905,3578736905,0
1,1092,23041,3578736905,3578736905,0
1,1092,23042,3578736905,3578736905,0
1,1092,23043,3578736905,3578736905,0
1,1092,23044,3578736905,3578736905,0
1,1092,23045,3578736905,3578736905,0
1,1092,23046,3578736905,3578736905,0
1,1092,23047,3578736905,3578736906,1
1,1092,23048,3578736905,3578736906,1
1,1092,23049,3578736905,3578736907,2
1,1092,23050,3578736905,3578736907,2
1,1092,23051,3578736905,3578736907,2
1,1092,23052,3578736905,3578736907,2
1,1092,23053,3578736905,3578736908,3
1,1092,23054,3578736905,3578736910,5
1,1092,23055,3578736905,3578736911,6
1,1092,23056,3578736905,3578736912,7
1,1092,23057,3578736905,3578736912,7
1,1092,23058,3578736905,3578736913,8
1,1092,23059,3578736905,3578736913,8
1,1092,23060,3578736905,3578736913,8
1,1092,23061,3578736905,3578736914,9
1,1092,23062,3578736905,3578736915,10
1,1092,23063,3578736905,3578736915,10
1,1092,23064,3578736905,3578736916,11
1,1092,23065,3578736905,3578736917,12
1,1092,23066,3578736905,3578736918,13
1,1092,23067,3578736905,3578736919,14
1,1092,23068,3578736905,3578736920,15
1,1092,23069,3578736905,3578736920,15
1,1092,23070,3578736905,3578736921,16
1,1092,23071,3578736905,3578736921,16
1,1092,23072,3578736905,3578736922,17
1,1092,23073,3578736905,3578736923,18
1,1092,23074,3578736905,3578736925,20
1,1092,23075,3578736905,3578736927,22
1,1092,23076,3578736905,3578736927,22
1,1092,23077,3578736905,3578736928,23
1,1092,23078,3578736905,3578736929,24
1,1092,23079,3578736905,3578736929,24
1,1092,23080,3578736905,3578736929,24
1,1092,23081,3578736905,3578736929,24
1,1092,23082,3578736905,3578736930,25
1,1092,23083,3578736905,3578736931,26
1,1092,23084,3578736905,3578736931,26
1,1092,23085,3578736905,3578736932,27
1,1092,23086,3578736905,3578736933,28
1,1092,23087,3578736905,3578736933,28
1,1092,23088,3578736905,3578736934,29
1,1092,23089,3578736905,3578736935,30
1,1092,23090,3578736905,3578736935,30
1,1092,23091,3578736905,3578736938,33
1,1092,23092,3578736905,3578736938,33
1,1092,23093,3578736905,3578736942,37
1,1092,23094,3578736905,3578736942,37
1,1092,23095,3578736905,3578736942,37
1,1092,23096,3578736905,3578736943,38
1,1092,23097,3578736905,3578736945,40
1,1092,23098,3578736905,3578736946,41
1,1092,23099,3578736905,3578736948,43
1,1092,23100,3578736905,3578736950,45
1,1092,23101,3578736905,3578736952,47
1,1092,23102,3578736905,3578736953,48
1,1092,23103,3578736905,3578736955,50
1,1093,23104,3578736966,3578736966,0
1,1093,23105,3578736966,3578736966,0
1,1093,23106,3578736966,3578736966,0
1,1093,23107,3578736966,3578736966,0
1,1093,23108,3578736966,3578736966,0
1,1093,23109,3578736966,3578736966,0
1,1093,23110,3578736966,3578736966,0
1,1093,23111,3578736966,3578736966,0
1,1093,23112,3578736966,3578736966,0
1,1093,23113,3578736966,3578736966,0
1,1093,23114,3578736966,3578736966,0
1,1093,23115,3578736966,3578736966,0
1,1093,23116,3578736966,3578736966,0
1,1093,23117,3578736966,3578736967,1
1,1093,23118,3578736966,3578736968,2
1,1093,23119,3578736966,3578736969,3
1,1093,23120,3578736966,3578736971,5
1,1093,23121,3578736966,3578736972,6
1,1093,23122,3578736966,3578736972,6
1,1093,23123,3578736966,3578736974,8
1,1093,23124,3578736966,3578736976,10
1,1093,23125,3578736966,3578736979,13
1,1093,23126,3578736966,3578736981,15
1,1093,23127,3578736966,3578736982,16
1,1093,23128,3578736966,3578736982,16
1,1093,23129,3578736966,3578736983,17
1,1093,23130,3578736966,3578736985,19
1,1093,23131,3578736966,3578736985,19
1,1093,23132,3578736966,3578736986,20
1,1093,23133,3578736966,3578736986,20
1,1093,23134,3578736966,3578736987,21
1,1093,23135,3578736966,3578736991,25
1,1093,23136,3578736966,3578736991,25
1,1093,23137,3578736966,3578736992,26
1,1093,23138,3578736966,3578736993,27
1,1093,23139,3578736966,3578736995,29
1,1093,23140,3578736966,3578736995,29
1,1093,23141,3578736966,3578736996,30
1,1093,23142,3578736966,3578736996,30
1,1093,23143,3578736966,3578736997,31
1,1093,23144,3578736966,3578736997,31
1,1093,23145,3578736966,3578736998,32
1,1093,23146,3578736966,3578736998,32
1,1093,23147,3578736966,3578737001,35
1,1093,23148,3578736966,3578737001,35
1,1093,23149,3578736966,3578737001,35
1,1093,23150,3578736966,3578737002,36
1,1093,23151,3578736966,3578737002,36
1,1093,23152,3578736966,3578737005,39
1,1093,23153,3578736966,3578737009,43
1,1093,23154,3578736966,3578737009,43
1,1093,23155,3578736966,3578737012,46
1,1093,23156,3578736966,3578737012,46
1,1093,23157,3578736966,3578737013,47
1,1093,23158,3578736966,3578737014,48
1,1093,23159,3578736966,3578737014,48
1,1093,23160,3578736966,3578737014,48
1,1093,23161,3578736966,3578737015,49
1,1093,23162,3578736966,3578737015,49
1,1093,23163,3578736966,3578737016,50
1,1094,23164,3578737028,3578737028,0
1,1094,23165,3578737028,3578737028,0
1,1094,23166,3578737028,3578737028,0
1,1094,23167,3578737028,3578737028,0
1,1094,23168,3578737028,3578737028,0
1,1094,23169,3578737028,3578737028,0
1,1094,23170,3578737028,3578737028,0
1,1094,23171,3578737028,3578737028,0
1,1094,23172,3578737028,3578737028,0
1,1094,23173,3578737028,3578737028,0
1,1094,23174,3578737028,3578737028,0
1,1094,23175,3578737028,3578737028,0
1,1094,23176,3578737028,3578737028,0
1,1094,23177,3578737028,3578737029,1
1,1094,23178,3578737028,3578737029,1
1,1094,23179,3578737028,3578737030,2
1,1094,23180,3578737028,3578737030,2
1,1094,23181,3578737028,3578737030,2
1,1094,23182,3578737028,3578737031,3
1,1094,23183,3578737028,3578737032,4
1,1094,23184,3578737028,3578737036,8
1,1094,23185,3578737028,3578737037,9
1,1094,23186,3578737028,3578737038,10
1,1094,23187,3578737028,3578737039,11
1,1094,23188,3578737028,3578737039,11
1,1094,23189,3578737028,3578737042,14
1,1094,23190,3578737028,3578737043,15
1,1094,23191,3578737028,3578737046,18
1,1094,23192,3578737028,3578737046,18
1,1094,23193,3578737028,3578737046,18
1,1094,23194,3578737028,3578737047,19
1,1094,23195,3578737028,3578737047,19
1,1094,23196,3578737028,3578737048,20
1,1094,23197,3578737028,3578737048,20
1,1094,23198,3578737028,3578737050,22
1,1094,23199,3578737028,3578737050,22
1,1094,23200,3578737028,3578737050,22
1,1094,23201,3578737028,3578737051,23
1,1094,23202,3578737028,3578737052,24
1,1094,23203,3578737028,3578737056,28
1,1094,23204,3578737028,3578737058,30
1,1094,23205,3578737028,3578737059,31
1,1094,23206,3578737028,3578737061,33
1,1094,23207,3578737028,3578737062,34
1,1094,23208,3578737028,3578737063,35
1,1094,23209,3578737028,3578737063,35
1,1094,23210,3578737028,3578737064,36
1,1094,23211,3578737028,3578737064,36
1,1094,23212,3578737028,3578737065,37
1,1094,23213,3578737028,3578737066,38
1,1094,23214,3578737028,3578737066,38
1,1094,23215,3578737028,3578737067,39
1,1094,23216,3578737028,3578737068,40
1,1094,23217,3578737028,3578737068,40
1,1094,23218,3578737028,3578737069,41
1,1094,23219,3578737028,3578737070,42
1,1094,23220,3578737028,3578737071,43
1,1094,23221,3578737028,3578737071,43
1,1094,23222,3578737028,3578737074,46
1,1094,23223,3578737028,3578737076,48
1,1095,23224,3578737089,3578737089,0
1,1095,23225,3578737089,3578737089,0
1,1095,23226,3578737089,3578737089,0
1,1095,23227,3578737089,3578737089,0
1,1095,23228,3578737089,3578737089,0
1,1095,23229,3578737089,3578737091,2
1,1095,23230,3578737089,3578737092,3
1,1095,23231,3578737089,3578737092,3
1,1095,23232,3578737089,3578737093,4
1,1095,23233,3578737089,3578737094,5
1,1095,23234,3578737089,3578737095,6
1,1095,23235,3578737089,3578737098,9
1,1095,23236,3578737089,3578737100,11
1,1095,23237,3578737089,3578737101,12
1,1095,23238,3578737089,3578737101,12
1,1095,23239,3578737089,3578737102,13
1,1095,23240,3578737089,3578737102,13
1,1095,23241,3578737089,3578737104,15
1,1095,23242,3578737089,3578737105,16
1,1095,23243,3578737089,3578737106,17
1,1095,23244,3578737089,3578737107,18
1,1095,23245,3578737089,3578737107,18
1,1095,23246,3578737089,3578737107,18
1,1095,23247,3578737089,3578737107,18
1,1095,23248,3578737089,3578737107,18
1,1095,23249,3578737089,3578737108,19
1,1095,23250,3578737089,3578737109,20
1,1095,23251,3578737089,3578737110,21
1,1095,23252,3578737089,3578737112,23
1,1095,23253,3578737089,3578737112,23
1,1095,23254,3578737089,3578737112,23
1,1095,23255,3578737089,3578737112,23
1,1095,23256,3578737089,3578737113,24
1,1095,23257,3578737089,3578737114,25
1,1095,23258,3578737089,3578737114,25
1,1095,23259,3578737089,3578737114,25
1,1095,23260,3578737089,3578737115,26
1,1095,23261,3578737089,3578737115,26
1,1095,23262,3578737089,3578737117,28
1,1095,23263,3578737089,3578737117,28
1,1095,23264,3578737089,3578737118,29
1,1095,23265,3578737089,3578737119,30
1,1095,23266,3578737089,3578737120,31
1,1095,23267,3578737089,3578737120,31
1,1095,23268,3578737089,3578737121,32
1,1095,23269,3578737089,3578737121,32
1,1095,23270,3578737089,3578737122,33
1,1095,23271,3578737089,3578737124,35
1,1095,23272,3578737089,3578737125,36
1,1095,23273,3578737089,3578737126,37
1,1095,23274,3578737089,3578737127,38
1,1095,23275,3578737089,3578737128,39
1,1095,23276,3578737089,3578737128,39
1,1095,23277,3578737089,3578737128,39
1,1095,23278,3578737089,3578737129,40
1,1095,23279,3578737089,3578737129,40
1,1095,23280,3578737089,3578737129,40
1,1095,23281,3578737089,3578737129,40
1,1095,23282,3578737089,3578737130,41
1,1095,23283,3578737089,3578737131,42
1,1095,23284,3578737089,3578737131,42
1,1095,23285,3578737089,3578737132,43
1,1095,23286,3578737089,3578737133,44
1,1095,23287,3578737089,3578737133,44
1,1095,23288,3578737089,3578737133,44
1,1095,23289,3578737089,3578737134,45
1,1095,23290,3578737089,3578737138,49
1,1095,23291,3578737089,3578737138,49
1,1096,23292,3578737152,3578737152,0
1,1096,23293,3578737152,3578737152,0
1,1096,23294,3578737152,3578737152,0
1,1096,23295,3578737152,3578737152,0
1,1096,23296,3578737152,3578737152,0
1,1096,23297,3578737152,3578737152,0
1,1096,23298,3578737152,3578737152,0
1,1096,23299,3578737152,3578737152,0
1,1096,23300,3578737152,3578737152,0
1,1096,23301,3578737152,3578737152,0
1,1096,23302,3578737152,3578737152,0
1,1096,23303,3578737152,3578737152,0
1,1096,23304,3578737152,3578737152,0
1,1096,23305,3578737152,3578737155,3
1,1096,23306,3578737152,3578737156,4
1,1096,23307,3578737152,3578737156,4
1,1096,23308,3578737152,3578737156,4
1,1096,23309,3578737152,3578737156,4
1,1096,23310,3578737152,3578737156,4
1,1096,23311,3578737152,3578737157,5
1,1096,23312,3578737152,3578737157,5
1,1096,23313,3578737152,3578737162,10
1,1096,23314,3578737152,3578737162,10
1,1096,23315,3578737152,3578737163,11
1,1096,23316,3578737152,3578737164,12
1,1096,23317,3578737152,3578737166,14
1,1096,23318,3578737152,3578737166,14
1,1096,23319,3578737152,3578737166,14
1,1096,23320,3578737152,3578737166,14
1,1096,23321,3578737152,3578737167,15
1,1096,23322,3578737152,3578737168,16
1,1096,23323,3578737152,3578737169,17
1,1096,23324,3578737152,3578737172,20
1,1096,23325,3578737152,3578737172,20
1,1096,23326,3578737152,3578737172,20
1,1096,23327,3578737152,3578737175,23
1,1096,23328,3578737152,3578737175,23
1,1096,23329,3578737152,3578737176,24
1,1096,23330,3578737152,3578737179,27
1,1096,23331,3578737152,3578737182,30
1,1096,23332,3578737152,3578737182,30
1,1096,23333,3578737152,3578737183,31
1,1096,23334,3578737152,3578737184,32
1,1096,23335,3578737152,3578737184,32
1,1096,23336,3578737152,3578737185,33
1,1096,23337,3578737152,3578737186,34
1,1096,23338,3578737152,3578737186,34
1,1096,23339,3578737152,3578737186,34
1,1096,23340,3578737152,3578737186,34
1,1096,23341,3578737152,3578737190,38
1,1096,23342,3578737152,3578737191,39
1,1096,23343,3578737152,3578737192,40
1,1096,23344,3578737152,3578737193,41
1,1096,23345,3578737152,3578737193,41
1,1096,23346,3578737152,3578737194,42
1,1096,23347,3578737152,3578737195,43
1,1096,23348,3578737152,3578737196,44
1,1096,23349,3578737152,3578737196,44
1,1096,23350,3578737152,3578737197,45
1,1096,23351,3578737152,3578737197,45
1,1096,23352,3578737152,3578737198,46
1,1096,23353,3578737152,3578737200,48
1,1096,23354,3578737152,3578737201,49
1,1096,23355,3578737152,3578737201,49
1,1096,23356,3578737152,3578737201,49
1,1097,23357,3578737212,3578737212,0
1,1097,23358,3578737212,3578737212,0
1,1097,23359,3578737212,3578737212,0
1,1097,23360,3578737212,3578737212,0
1,1097,23361,3578737212,3578737212,0
1,1097,23362,3578737212,3578737212,0
1,1097,23363,3578737212,3578737213,1
1,1097,23364,3578737212,3578737214,2
1,1097,23365,3578737212,3578737214,2
1,1097,23366,3578737212,3578737216,4
1,1097,23367,3578737212,3578737216,4
1,1097,23368,3578737212,3578737217,5
1,1097,23369,3578737212,3578737217,5
1,1097,23370,3578737212,3578737217,5
1,1097,23371,3578737212,3578737219,7
1,1097,23372,3578737212,3578737220,8
1,1097,23373,3578737212,3578737220,8
1,1097,23374,3578737212,3578737220,8
1,1097,23375,3578737212,3578737222,10
1,1097,23376,3578737212,3578737224,12
1,1097,23377,3578737212,3578737224,12
1,1097,23378,3578737212,3578737225,13
1,1097,23379,3578737212,3578737226,14
1,1097,23380,3578737212,3578737228,16
1,1097,23381,3578737212,3578737228,16
1,1097,23382,3578737212,3578737228,16
1,1097,23383,3578737212,3578737229,17
1,1097,23384,3578737212,3578737230,18
1,1097,23385,3578737212,3578737230,18
1,1097,23386,3578737212,3578737230,18
1,1097,23387,3578737212,3578737230,18
1,1097,23388,3578737212,3578737231,19
1,1097,23389,3578737212,3578737233,21
1,1097,23390,3578737212,3578737235,23
1,1097,23391,3578737212,3578737237,25
1,1097,23392,3578737212,3578737238,26
1,1097,23393,3578737212,3578737239,27
1,1097,23394,3578737212,3578737239,27
1,1097,23395,3578737212,3578737244,32
1,1097,23396,3578737212,3578737245,33
1,1097,23397,3578737212,3578737246,34
1,1097,23398,3578737212,3578737247,35
1,1097,23399,3578737212,3578737247,35
1,1097,23400,3578737212,3578737247,35
1,1097,23401,3578737212,3578737248,36
1,1097,23402,3578737212,3578737248,36
1,1097,23403,3578737212,3578737248,36
1,1097,23404,3578737212,3578737250,38
1,1097,23405,3578737212,3578737250,38
1,1097,23406,3578737212,3578737251,39
1,1097,23407,3578737212,3578737252,40
1,1097,23408,3578737212,3578737252,40
1,1097,23409,3578737212,3578737254,42
1,1097,23410,3578737212,3578737256,44
1,1097,23411,3578737212,3578737256,44
1,1097,23412,3578737212,3578737258,46
1,1097,23413,3578737212,3578737261,49
1,1098,23414,3578737272,3578737272,0
1,1098,23415,3578737272,3578737272,0
1,1098,23416,3578737272,3578737272,0
1,1098,23417,3578737272,3578737272,0
1,1098,23418,3578737272,3578737272,0
1,1098,23419,3578737272,3578737272,0
1,1098,23420,3578737272,3578737272,0
1,1098,23421,3578737272,3578737272,0
1,1098,23422,3578737272,3578737272,0
1,1098,23423,3578737272,3578737272,0
1,1098,23424,3578737272,3578737272,0
1,1098,23425,3578737272,3578737272,0
1,1098,23426,3578737272,3578737272,0
1,1098,23427,3578737272,3578737272,0
1,1098,23428,3578737272,3578737272,0
1,1098,23429,3578737272,3578737276,4
1,1098,23430,3578737272,3578737277,5
1,1098,23431,3578737272,3578737284,12
1,1098,23432,3578737272,3578737284,12
1,1098,23433,3578737272,3578737285,13
1,1098,23434,3578737272,3578737288,16
1,1098,23435,3578737272,3578737291,19
1,1098,23436,3578737272,3578737292,20
1,1098,23437,3578737272,3578737292,20
1,1098,23438,3578737272,3578737293,21
1,1098,23439,3578737272,3578737293,21
1,1098,23440,3578737272,3578737295,23
1,1098,23441,3578737272,3578737295,23
1,1098,23442,3578737272,3578737299,27
1,1098,23443,3578737272,3578737300,28
1,1098,23444,3578737272,3578737300,28
1,1098,23445,3578737272,3578737301,29
1,1098,23446,3578737272,3578737302,30
1,1098,23447,3578737272,3578737302,30
1,1098,23448,3578737272,3578737305,33
1,1098,23449,3578737272,3578737305,33
1,1098,23450,3578737272,3578737306,34
1,1098,23451,3578737272,3578737307,35
1,1098,23452,3578737272,3578737307,35
1,1098,23453,3578737272,3578737307,35
1,1098,23454,3578737272,3578737308,36
1,1098,23455,3578737272,3578737308,36
1,1098,23456,3578737272,3578737308,36
1,1098,23457,3578737272,3578737310,38
1,1098,23458,3578737272,3578737312,40
1,1098,23459,3578737272,3578737312,40
1,1098,23460,3578737272,3578737313,41
1,1098,23461,3578737272,3578737313,41
1,1098,23462,3578737272,3578737313,41
1,1098,23463,3578737272,3578737314,42
1,1098,23464,3578737272,3578737314,42
1,1098,23465,3578737272,3578737315,43
1,1098,23466,3578737272,3578737316,44
1,1098,23467,3578737272,3578737317,45
1,1098,23468,3578737272,3578737318,46
1,1098,23469,3578737272,3578737319,47
1,1098,23470,3578737272,3578737320,48
1,1098,23471,3578737272,3578737320,48
1,1098,23472,3578737272,3578737321,49
1,1098,23473,3578737272,3578737321,49
1,1099,23474,3578737333,3578737333,0
1,1099,23475,3578737333,3578737333,0
1,1099,23476,3578737333,3578737333,0
1,1099,23477,3578737333,3578737333,0
1,1099,23478,3578737333,3578737333,0
1,1099,23479,3578737333,3578737333,0
1,1099,23480,3578737333,3578737333,0
1,1099,23481,3578737333,3578737333,0
1,1099,23482,3578737333,3578737333,0
1,1099,23483,3578737333,3578737333,0
1,1099,23484,3578737333,3578737333,0
1,1099,23485,3578737333,3578737333,0
1,1099,23486,3578737333,3578737333,0
1,1099,23487,3578737333,3578737333,0
1,1099,23488,3578737333,3578737333,0
1,1099,23489,3578737333,3578737333,0
1,1099,23490,3578737333,3578737333,0
1,1099,23491,3578737333,3578737334,1
1,1099,23492,3578737333,3578737334,1
1,1099,23493,3578737333,3578737335,2
1,1099,23494,3578737333,3578737335,2
1,1099,23495,3578737333,3578737337,4
1,1099,23496,3578737333,3578737339,6
1,1099,23497,3578737333,3578737342,9
1,1099,23498,3578737333,3578737343,10
1,1099,23499,3578737333,3578737345,12
1,1099,23500,3578737333,3578737345,12
1,1099,23501,3578737333,3578737350,17
1,1099,23502,3578737333,3578737351,18
1,1099,23503,3578737333,3578737353,20
1,1099,23504,3578737333,3578737353,20
1,1099,23505,3578737333,3578737355,22
1,1099,23506,3578737333,3578737356,23
1,1099,23507,3578737333,3578737356,23
1,1099,23508,3578737333,3578737356,23
1,1099,23509,3578737333,3578737356,23
1,1099,23510,3578737333,3578737356,23
1,1099,23511,3578737333,3578737357,24
1,1099,23512,3578737333,3578737358,25
1,1099,23513,3578737333,3578737362,29
1,1099,23514,3578737333,3578737362,29
1,1099,23515,3578737333,3578737363,30
1,1099,23516,3578737333,3578737366,33
1,1099,23517,3578737333,3578737366,33
1,1099,23518,3578737333,3578737368,35
1,1099,23519,3578737333,3578737370,37
1,1099,23520,3578737333,3578737370,37
1,1099,23521,3578737333,3578737371,38
1,1099,23522,3578737333,3578737372,39
1,1099,23523,3578737333,3578737372,39
1,1099,23524,3578737333,3578737375,42
1,1099,23525,3578737333,3578737376,43
1,1099,23526,3578737333,3578737376,43
1,1099,23527,3578737333,3578737380,47
1,1099,23528,3578737333,3578737381,48
1,1099,23529,3578737333,3578737382,49
1,1099,23530,3578737333,3578737382,49
1,1099,23531,3578737333,3578737383,50
1,1100,23532,3578737396,3578737396,0
1,1100,23533,3578737396,3578737396,0
1,1100,23534,3578737396,3578737396,0
1,1100,23535,3578737396,3578737396,0
1,1100,23536,3578737396,3578737396,0
1,1100,23537,3578737396,3578737396,0
1,1100,23538,3578737396,3578737396,0
1,1100,23539,3578737396,3578737396,0
1,1100,23540,3578737396,3578737396,0
1,1100,23541,3578737396,3578737396,0
1,1100,23542,3578737396,3578737396,0
1,1100,23543,3578737396,3578737396,0
1,1100,23544,3578737396,3578737396,0
1,1100,23545,3578737396,3578737396,0
1,1100,23546,3578737396,3578737397,1
1,1100,23547,3578737396,3578737397,1
1,1100,23548,3578737396,3578737397,1
1,1100,23549,3578737396,3578737398,2
1,1100,23550,3578737396,3578737399,3
1,1100,23551,3578737396,3578737400,4
1,1100,23552,3578737396,3578737401,5
1,1100,23553,3578737396,3578737401,5
1,1100,23554,3578737396,3578737401,5
1,1100,23555,3578737396,3578737402,6
1,1100,23556,3578737396,3578737403,7
1,1100,23557,3578737396,3578737405,9
1,1100,23558,3578737396,3578737406,10
1,1100,23559,3578737396,3578737409,13
1,1100,23560,3578737396,3578737410,14
1,1100,23561,3578737396,3578737412,16
1,1100,23562,3578737396,3578737413,17
1,1100,23563,3578737396,3578737414,18
1,1100,23564,3578737396,3578737414,18
1,1100,23565,3578737396,3578737414,18
1,1100,23566,3578737396,3578737415,19
1,1100,23567,3578737396,3578737416,20
1,1100,23568,3578737396,3578737418,22
1,1100,23569,3578737396,3578737418,22
1,1100,23570,3578737396,3578737419,23
1,1100,23571,3578737396,3578737419,23
1,1100,23572,3578737396,3578737420,24
1,1100,23573,3578737396,3578737420,24
1,1100,23574,3578737396,3578737423,27
1,1100,23575,3578737396,3578737424,28
1,1100,23576,3578737396,3578737425,29
1,1100,23577,3578737396,3578737425,29
1,1100,23578,3578737396,3578737426,30
1,1100,23579,3578737396,3578737426,30
1,1100,23580,3578737396,3578737428,32
1,1100,23581,3578737396,3578737428,32
1,1100,23582,3578737396,3578737429,33
1,1100,23583,3578737396,3578737430,34
1,1100,23584,3578737396,3578737430,34
1,1100,23585,3578737396,3578737431,35
1,1100,23586,3578737396,3578737431,35
1,1100,23587,3578737396,3578737431,35
1,1100,23588,3578737396,3578737433,37
1,1100,23589,3578737396,3578737437,41
1,1100,23590,3578737396,3578737439,43
1,1100,23591,3578737396,3578737440,44
1,1100,23592,3578737396,3578737442,46
1,1100,23593,3578737396,3578737444,48
1,1100,23594,3578737396,3578737445,49
1,1100,23595,3578737396,3578737446,50
1,1101,23596,3578737456,3578737456,0
1,1101,23597,3578737456,3578737456,0
1,1101,23598,3578737456,3578737456,0
1,1101,23599,3578737456,3578737456,0
1,1101,23600,3578737456,3578737456,0
1,1101,23601,3578737456,3578737456,0
1,1101,23602,3578737456,3578737456,0
1,1101,23603,3578737456,3578737456,0
1,1101,23604,3578737456,3578737456,0
1,1101,23605,3578737456,3578737457,1
1,1101,23606,3578737456,3578737458,2
1,1101,23607,3578737456,3578737461,5
1,1101,23608,3578737456,3578737464,8
1,1101,23609,3578737456,3578737464,8
1,1101,23610,3578737456,3578737464,8
1,1101,23611,3578737456,3578737465,9
1,1101,23612,3578737456,3578737465,9
1,1101,23613,3578737456,3578737466,10
1,1101,23614,3578737456,3578737467,11
1,1101,23615,3578737456,3578737468,12
1,1101,23616,3578737456,3578737468,12
1,1101,23617,3578737456,3578737468,12
1,1101,23618,3578737456,3578737469,13
1,1101,23619,3578737456,3578737472,16
1,1101,23620,3578737456,3578737473,17
1,1101,23621,3578737456,3578737473,17
1,1101,23622,3578737456,3578737476,20
1,1101,23623,3578737456,3578737477,21
1,1101,23624,3578737456,3578737480,24
1,1101,23625,3578737456,3578737484,28
1,1101,23626,3578737456,3578737485,29
1,1101,23627,3578737456,3578737485,29
1,1101,23628,3578737456,3578737487,31
1,1101,23629,3578737456,3578737491,35
1,1101,23630,3578737456,3578737492,36
1,1101,23631,3578737456,3578737492,36
1,1101,23632,3578737456,3578737494,38
1,1101,23633,3578737456,3578737494,38
1,1101,23634,3578737456,3578737494,38
1,1101,23635,3578737456,3578737499,43
1,1101,23636,3578737456,3578737500,44
1,1101,23637,3578737456,3578737500,44
1,1101,23638,3578737456,3578737502,46
1,1101,23639,3578737456,3578737502,46
1,1101,23640,3578737456,3578737505,49
1,1101,23641,3578737456,3578737505,49
1,1102,23642,3578737515,3578737515,0
1,1102,23643,3578737515,3578737515,0
1,1102,23644,3578737515,3578737515,0
1,1102,23645,3578737515,3578737515,0
1,1102,23646,3578737515,3578737515,0
1,1102,23647,3578737515,3578737515,0
1,1102,23648,3578737515,3578737515,0
1,1102,23649,3578737515,3578737515,0
1,1102,23650,3578737515,3578737515,0
1,1102,23651,3578737515,3578737515,0
1,1102,23652,3578737515,3578737515,0
1,1102,23653,3578737515,3578737515,0
1,1102,23654,3578737515,3578737515,0
1,1102,23655,3578737515,3578737515,0
1,1102,23656,3578737515,3578737515,0
1,1102,23657,3578737515,3578737515,0
1,1102,23658,3578737515,3578737515,0
1,1102,23659,3578737515,3578737515,0
1,1102,23660,3578737515,3578737515,0
1,1102,23661,3578737515,3578737517,2
1,1102,23662,3578737515,3578737518,3
1,1102,23663,3578737515,3578737519,4
1,1102,23664,3578737515,3578737519,4
1,1102,23665,3578737515,3578737519,4
1,1102,23666,3578737515,3578737520,5
1,1102,23667,3578737515,3578737520,5
1,1102,23668,3578737515,3578737520,5
1,1102,23669,3578737515,3578737524,9
1,1102,23670,3578737515,3578737525,10
1,1102,23671,3578737515,3578737525,10
1,1102,23672,3578737515,3578737526,11
1,1102,23673,3578737515,3578737526,11
1,1102,23674,3578737515,3578737527,12
1,1102,23675,3578737515,3578737528,13
1,1102,23676,3578737515,3578737529,14
1,1102,23677,3578737515,3578737529,14
1,1102,23678,3578737515,3578737529,14
1,1102,23679,3578737515,3578737531,16
1,1102,23680,3578737515,3578737531,16
1,1102,23681,3578737515,3578737531,16
1,1102,23682,3578737515,3578737532,17
1,1102,23683,3578737515,3578737532,17
1,1102,23684,3578737515,3578737532,17
1,1102,23685,3578737515,3578737533,18
1,1102,23686,3578737515,3578737533,18
1,1102,23687,3578737515,3578737534,19
1,1102,23688,3578737515,3578737534,19
1,1102,23689,3578737515,3578737537,22
1,1102,23690,3578737515,3578737538,23
1,1102,23691,3578737515,3578737542,27
1,1102,23692,3578737515,3578737542,27
1,1102,23693,3578737515,3578737542,27
1,1102,23694,3578737515,3578737544,29
1,1102,23695,3578737515,3578737545,30
1,1102,23696,3578737515,3578737545,30
1,1102,23697,3578737515,3578737547,32
1,1102,23698,3578737515,3578737551,36
1,1102,23699,3578737515,3578737551,36
1,1102,23700,3578737515,3578737551,36
1,1102,23701,3578737515,3578737554,39
1,1102,23702,3578737515,3578737555,40
1,1102,23703,3578737515,3578737555,40
1,1102,23704,3578737515,3578737556,41
1,1102,23705,3578737515,3578737556,41
1,1102,23706,3578737515,3578737557,42
1,1102,23707,3578737515,3578737561,46
1,1102,23708,3578737515,3578737562,47
1,1102,23709,3578737515,3578737562,47
1,1102,23710,3578737515,3578737563,48
1,1102,23711,3578737515,3578737565,50
1,1103,23712,3578737574,3578737574,0
1,1103,23713,3578737574,3578737574,0
1,1103,23714,3578737574,3578737574,0
1,1103,23715,3578737574,3578737574,0
1,1103,23716,3578737574,3578737574,0
1,1103,23717,3578737574,3578737574,0
1,1103,23718,3578737574,3578737574,0
1,1103,23719,3578737574,3578737574,0
1,1103,23720,3578737574,3578737575,1
1,1103,23721,3578737574,3578737576,2
1,1103,23722,3578737574,3578737580,6
1,1103,23723,3578737574,3578737580,6
1,1103,23724,3578737574,3578737581,7
1,1103,23725,3578737574,3578737582,8
1,1103,23726,3578737574,3578737583,9
1,1103,23727,3578737574,3578737583,9
1,1103,23728,3578737574,3578737584,10
1,1103,23729,3578737574,3578737584,10
1,1103,23730,3578737574,3578737586,12
1,1103,23731,3578737574,3578737587,13
1,1103,23732,3578737574,3578737589,15
1,1103,23733,3578737574,3578737590,16
1,1103,23734,3578737574,3578737591,17
1,1103,23735,3578737574,3578737592,18
1,1103,23736,3578737574,3578737593,19
1,1103,23737,3578737574,3578737593,19
1,1103,23738,3578737574,3578737594,20
1,1103,23739,3578737574,3578737595,21
1,1103,23740,3578737574,3578737596,22
1,1103,23741,3578737574,3578737596,22
1,1103,23742,3578737574,3578737597,23
1,1103,23743,3578737574,3578737599,25
1,1103,23744,3578737574,3578737600,26
1,1103,23745,3578737574,3578737600,26
1,1103,23746,3578737574,3578737600,26
1,1103,23747,3578737574,3578737603,29
1,1103,23748,3578737574,3578737605,31
1,1103,23749,3578737574,3578737605,31
1,1103,23750,3578737574,3578737609,35
1,1103,23751,3578737574,3578737609,35
1,1103,23752,3578737574,3578737613,39
1,1103,23753,3578737574,3578737613,39
1,1103,23754,3578737574,3578737614,40
1,1103,23755,3578737574,3578737615,41
1,1103,23756,3578737574,3578737616,42
1,1103,23757,3578737574,3578737616,42
1,1103,23758,3578737574,3578737616,42
1,1103,23759,3578737574,3578737618,44
1,1103,23760,3578737574,3578737618,44
1,1103,23761,3578737574,3578737619,45
1,1103,23762,3578737574,3578737619,45
1,1103,23763,3578737574,3578737623,49
1,1103,23764,3578737574,3578737623,49
1,1103,23765,3578737574,3578737624,50
1,1104,23766,3578737636,3578737636,0
1,1104,23767,3578737636,3578737636,0
1,1104,23768,3578737636,3578737636,0
1,1104,23769,3578737636,3578737636,0
1,1104,23770,3578737636,3578737636,0
1,1104,23771,3578737636,3578737636,0
1,1104,23772,3578737636,3578737636,0
1,1104,23773,3578737636,3578737636,0
1,1104,23774,3578737636,3578737636,0
1,1104,23775,3578737636,3578737636,0
1,1104,23776,3578737636,3578737636,0
1,1104,23777,3578737636,3578737636,0
1,1104,23778,3578737636,3578737636,0
1,1104,23779,3578737636,3578737636,0
1,1104,23780,3578737636,3578737637,1
1,1104,23781,3578737636,3578737638,2
1,1104,23782,3578737636,3578737639,3
1,1104,23783,3578737636,3578737639,3
1,1104,23784,3578737636,3578737644,8
1,1104,23785,3578737636,3578737645,9
1,1104,23786,3578737636,3578737645,9
1,1104,23787,3578737636,3578737648,12
1,1104,23788,3578737636,3578737649,13
1,1104,23789,3578737636,3578737650,14
1,1104,23790,3578737636,3578737650,14
1,1104,23791,3578737636,3578737650,14
1,1104,23792,3578737636,3578737651,15
1,1104,23793,3578737636,3578737651,15
1,1104,23794,3578737636,3578737651,15
1,1104,23795,3578737636,3578737651,15
1,1104,23796,3578737636,3578737656,20
1,1104,23797,3578737636,3578737658,22
1,1104,23798,3578737636,3578737659,23
1,1104,23799,3578737636,3578737660,24
1,1104,23800,3578737636,3578737662,26
1,1104,23801,3578737636,3578737662,26
1,1104,23802,3578737636,3578737663,27
1,1104,23803,3578737636,3578737664,28
1,1104,23804,3578737636,3578737664,28
1,1104,23805,3578737636,3578737665,29
1,1104,23806,3578737636,3578737666,30
1,1104,23807,3578737636,3578737667,31
1,1104,23808,3578737636,3578737667,31
1,1104,23809,3578737636,3578737667,31
1,1104,23810,3578737636,3578737668,32
1,1104,23811,3578737636,3578737669,33
1,1104,23812,3578737636,3578737673,37
1,1104,23813,3578737636,3578737673,37
1,1104,23814,3578737636,3578737673,37
1,1104,23815,3578737636,3578737676,40
1,1104,23816,3578737636,3578737677,41
1,1104,23817,3578737636,3578737680,44
1,1104,23818,3578737636,3578737684,48
1,1104,23819,3578737636,3578737684,48
1,1104,23820,3578737636,3578737685,49
1,1104,23821,3578737636,3578737685,49
1,1105,23822,3578737698,3578737698,0
1,1105,23823,3578737698,3578737698,0
1,1105,23824,3578737698,3578737698,0
1,1105,23825,3578737698,3578737698,0
1,1105,23826,3578737698,3578737698,0
1,1105,23827,3578737698,3578737698,0
1,1105,23828,3578737698,3578737698,0
1,1105,23829,3578737698,3578737699,1
1,1105,23830,3578737698,3578737701,3
1,1105,23831,3578737698,3578737702,4
1,1105,23832,3578737698,3578737703,5
1,1105,23833,3578737698,3578737704,6
1,1105,23834,3578737698,3578737705,7
1,1105,23835,3578737698,3578737706,8
1,1105,23836,3578737698,3578737707,9
1,1105,23837,3578737698,3578737707,9
1,1105,23838,3578737698,3578737708,10
1,1105,23839,3578737698,3578737709,11
1,1105,23840,3578737698,3578737709,11
1,1105,23841,3578737698,3578737711,13
1,1105,23842,3578737698,3578737711,13
1,1105,23843,3578737698,3578737711,13
1,1105,23844,3578737698,3578737711,13
1,1105,23845,3578737698,3578737712,14
1,1105,23846,3578737698,3578737713,15
1,1105,23847,3578737698,3578737713,15
1,1105,23848,3578737698,3578737713,15
1,1105,23849,3578737698,3578737713,15
1,1105,23850,3578737698,3578737713,15
1,1105,23851,3578737698,3578737714,16
1,1105,23852,3578737698,3578737715,17
1,1105,23853,3578737698,3578737715,17
1,1105,23854,3578737698,3578737716,18
1,1105,23855,3578737698,3578737719,21
1,1105,23856,3578737698,3578737719,21
1,1105,23857,3578737698,3578737720,22
1,1105,23858,3578737698,3578737720,22
1,1105,23859,3578737698,3578737720,22
1,1105,23860,3578737698,3578737720,22
1,1105,23861,3578737698,3578737720,22
1,1105,23862,3578737698,3578737724,26
1,1105,23863,3578737698,3578737724,26
1,1105,23864,3578737698,3578737725,27
1,1105,23865,3578737698,3578737725,27
1,1105,23866,3578737698,3578737727,29
1,1105,23867,3578737698,3578737727,29
1,1105,23868,3578737698,3578737728,30
1,1105,23869,3578737698,3578737728,30
1,1105,23870,3578737698,3578737729,31
1,1105,23871,3578737698,3578737729,31
1,1105,23872,3578737698,3578737730,32
1,1105,23873,3578737698,3578737730,32
1,1105,23874,3578737698,3578737731,33
1,1105,23875,3578737698,3578737731,33
1,1105,23876,3578737698,3578737732,34
1,1105,23877,3578737698,3578737732,34
1,1105,23878,3578737698,3578737733,35
1,1105,23879,3578737698,3578737733,35
1,1105,23880,3578737698,3578737733,35
1,1105,23881,3578737698,3578737733,35
1,1105,23882,3578737698,3578737734,36
1,1105,23883,3578737698,3578737737,39
1,1105,23884,3578737698,3578737738,40
1,1105,23885,3578737698,3578737743,45
1,1105,23886,3578737698,3578737743,45
1,1105,23887,3578737698,3578737744,46
1,1105,23888,3578737698,3578737745,47
1,1105,23889,3578737698,3578737746,48
1,1105,23890,3578737698,3578737747,49
1,1106,23891,3578737759,3578737759,0
1,1106,23892,3578737759,3578737759,0
1,1106,23893,3578737759,3578737759,0
1,1106,23894,3578737759,3578737759,0
1,1106,23895,3578737759,3578737759,0
1,1106,23896,3578737759,3578737759,0
1,1106,23897,3578737759,3578737759,0
1,1106,23898,3578737759,3578737759,0
1,1106,23899,3578737759,3578737759,0
1,1106,23900,3578737759,3578737759,0
1,1106,23901,3578737759,3578737759,0
1,1106,23902,3578737759,3578737761,2
1,1106,23903,3578737759,3578737762,3
1,1106,23904,3578737759,3578737762,3
1,1106,23905,3578737759,3578737763,4
1,1106,23906,3578737759,3578737764,5
1,1106,23907,3578737759,3578737765,6
1,1106,23908,3578737759,3578737765,6
1,1106,23909,3578737759,3578737766,7
1,1106,23910,3578737759,3578737767,8
1,1106,23911,3578737759,3578737768,9
1,1106,23912,3578737759,3578737769,10
1,1106,23913,3578737759,3578737769,10
1,1106,23914,3578737759,3578737771,12
1,1106,23915,3578737759,3578737771,12
1,1106,23916,3578737759,3578737772,13
1,1106,23917,3578737759,3578737774,15
1,1106,23918,3578737759,3578737775,16
1,1106,23919,3578737759,3578737776,17
1,1106,23920,3578737759,3578737781,22
1,1106,23921,3578737759,3578737781,22
1,1106,23922,3578737759,3578737781,22
1,1106,23923,3578737759,3578737782,23
1,1106,23924,3578737759,3578737782,23
1,1106,23925,3578737759,3578737783,24
1,1106,23926,3578737759,3578737784,25
1,1106,23927,3578737759,3578737784,25
1,1106,23928,3578737759,3578737786,27
1,1106,23929,3578737759,3578737786,27
1,1106,23930,3578737759,3578737787,28
1,1106,23931,3578737759,3578737787,28
1,1106,23932,3578737759,3578737789,30
1,1106,23933,3578737759,3578737792,33
1,1106,23934,3578737759,3578737793,34
1,1106,23935,3578737759,3578737793,34
1,1106,23936,3578737759,3578737794,35
1,1106,23937,3578737759,3578737794,35
1,1106,23938,3578737759,3578737796,37
1,1106,23939,3578737759,3578737796,37
1,1106,23940,3578737759,3578737796,37
1,1106,23941,3578737759,3578737797,38
1,1106,23942,3578737759,3578737797,38
1,1106,23943,3578737759,3578737799,40
1,1106,23944,3578737759,3578737800,41
1,1106,23945,3578737759,3578737800,41
1,1106,23946,3578737759,3578737800,41
1,1106,23947,3578737759,3578737801,42
1,1106,23948,3578737759,3578737803,44
1,1106,23949,3578737759,3578737805,46
1,1106,23950,3578737759,3578737806,47
1,1106,23951,3578737759,3578737809,50
1,1107,23952,3578737821,3578737821,0
1,1107,23953,3578737821,3578737821,0
1,1107,23954,3578737821,3578737821,0
1,1107,23955,3578737821,3578737821,0
1,1107,23956,3578737821,3578737821,0
1,1107,23957,3578737821,3578737821,0
1,1107,23958,3578737821,3578737821,0
1,1107,23959,3578737821,3578737821,0
1,1107,23960,3578737821,3578737821,0
1,1107,23961,3578737821,3578737821,0
1,1107,23962,3578737821,3578737821,0
1,1107,23963,3578737821,3578737821,0
1,1107,23964,3578737821,3578737821,0
1,1107,23965,3578737821,3578737821,0
1,1107,23966,3578737821,3578737821,0
1,1107,23967,3578737821,3578737824,3
1,1107,23968,3578737821,3578737824,3
1,1107,23969,3578737821,3578737824,3
1,1107,23970,3578737821,3578737824,3
1,1107,23971,3578737821,3578737825,4
1,1107,23972,3578737821,3578737827,6
1,1107,23973,3578737821,3578737828,7
1,1107,23974,3578737821,3578737828,7
1,1107,23975,3578737821,3578737829,8
1,1107,23976,3578737821,3578737829,8
1,1107,23977,3578737821,3578737829,8
1,1107,23978,3578737821,3578737830,9
1,1107,23979,3578737821,3578737831,10
1,1107,23980,3578737821,3578737831,10
1,1107,23981,3578737821,3578737833,12
1,1107,23982,3578737821,3578737835,14
1,1107,23983,3578737821,3578737836,15
1,1107,23984,3578737821,3578737837,16
1,1107,23985,3578737821,3578737838,17
1,1107,23986,3578737821,3578737839,18
1,1107,23987,3578737821,3578737841,20
1,1107,23988,3578737821,3578737845,24
1,1107,23989,3578737821,3578737845,24
1,1107,23990,3578737821,3578737845,24
1,1107,23991,3578737821,3578737848,27
1,1107,23992,3578737821,3578737849,28
1,1107,23993,3578737821,3578737850,29
1,1107,23994,3578737821,3578737850,29
1,1107,23995,3578737821,3578737850,29
1,1107,23996,3578737821,3578737851,30
1,1107,23997,3578737821,3578737852,31
1,1107,23998,3578737821,3578737852,31
1,1107,23999,3578737821,3578737856,35
1,1107,24000,3578737821,3578737859,38
1,1107,24001,3578737821,3578737859,38
1,1107,24002,3578737821,3578737860,39
1,1107,24003,3578737821,3578737863,42
1,1107,24004,3578737821,3578737863,42
1,1107,24005,3578737821,3578737864,43
1,1107,24006,3578737821,3578737865,44
1,1107,24007,3578737821,3578737865,44
1,1107,24008,3578737821,3578737866,45
1,1107,24009,3578737821,3578737867,46
1,1107,24010,3578737821,3578737867,46
1,1107,24011,3578737821,3578737868,47
1,1107,24012,3578737821,3578737869,48
1,1107,24013,3578737821,3578737869,48
1,1108,24014,3578737882,3578737882,0
1,1108,24015,3578737882,3578737882,0
1,1108,24016,3578737882,3578737882,0
1,1108,24017,3578737882,3578737882,0
1,1108,24018,3578737882,3578737882,0
1,1108,24019,3578737882,3578737882,0
1,1108,24020,3578737882,3578737884,2
1,1108,24021,3578737882,3578737884,2
1,1108,24022,3578737882,3578737885,3
1,1108,24023,3578737882,3578737885,3
1,1108,24024,3578737882,3578737887,5
1,1108,24025,3578737882,3578737893,11
1,1108,24026,3578737882,3578737893,11
1,1108,24027,3578737882,3578737893,11
1,1108,24028,3578737882,3578737895,13
1,1108,24029,3578737882,3578737895,13
1,1108,24030,3578737882,3578737899,17
1,1108,24031,3578737882,3578737900,18
1,1108,24032,3578737882,3578737902,20
1,1108,24033,3578737882,3578737902,20
1,1108,24034,3578737882,3578737905,23
1,1108,24035,3578737882,3578737905,23
1,1108,24036,3578737882,3578737906,24
1,1108,24037,3578737882,3578737907,25
1,1108,24038,3578737882,3578737908,26
1,1108,24039,3578737882,3578737909,27
1,1108,24040,3578737882,3578737910,28
1,1108,24041,3578737882,3578737911,29
1,1108,24042,3578737882,3578737911,29
1,1108,24043,3578737882,3578737912,30
1,1108,24044,3578737882,3578737912,30
1,1108,24045,3578737882,3578737912,30
1,1108,24046,3578737882,3578737912,30
1,1108,24047,3578737882,3578737912,30
1,1108,24048,3578737882,3578737913,31
1,1108,24049,3578737882,3578737913,31
1,1108,24050,3578737882,3578737914,32
1,1108,24051,3578737882,3578737914,32
1,1108,24052,3578737882,3578737914,32
1,1108,24053,3578737882,3578737916,34
1,1108,24054,3578737882,3578737919,37
1,1108,24055,3578737882,3578737919,37
1,1108,24056,3578737882,3578737920,38
1,1108,24057,3578737882,3578737920,38
1,1108,24058,3578737882,3578737920,38
1,1108,24059,3578737882,3578737924,42
1,1108,24060,3578737882,3578737924,42
1,1108,24061,3578737882,3578737926,44
1,1108,24062,3578737882,3578737927,45
1,1108,24063,3578737882,3578737927,45
1,1108,24064,3578737882,3578737927,45
1,1108,24065,3578737882,3578737928,46
1,1108,24066,3578737882,3578737929,47
1,1108,24067,3578737882,3578737929,47
1,1108,24068,3578737882,3578737929,47
1,1108,24069,3578737882,3578737929,47
1,1108,24070,3578737882,3578737930,48
1,1108,24071,3578737882,3578737931,49
1,1108,24072,3578737882,3578737931,49
1,1108,24073,3578737882,3578737932,50
1,1109,24074,3578737942,3578737942,0
1,1109,24075,3578737942,3578737942,0
1,1109,24076,3578737942,3578737942,0
1,1109,24077,3578737942,3578737942,0
1,1109,24078,3578737942,3578737942,0
1,1109,24079,3578737942,3578737942,0
1,1109,24080,3578737942,3578737942,0
1,1109,24081,3578737942,3578737942,0
1,1109,24082,3578737942,3578737942,0
1,1109,24083,3578737942,3578737942,0
1,1109,24084,3578737942,3578737943,1
1,1109,24085,3578737942,3578737944,2
1,1109,24086,3578737942,3578737946,4
1,1109,24087,3578737942,3578737946,4
1,1109,24088,3578737942,3578737946,4
1,1109,24089,3578737942,3578737948,6
1,1109,24090,3578737942,3578737951,9
1,1109,24091,3578737942,3578737951,9
1,1109,24092,3578737942,3578737952,10
1,1109,24093,3578737942,3578737953,11
1,1109,24094,3578737942,3578737955,13
1,1109,24095,3578737942,3578737955,13
1,1109,24096,3578737942,3578737955,13
1,1109,24097,3578737942,3578737956,14
1,1109,24098,3578737942,3578737956,14
1,1109,24099,3578737942,3578737956,14
1,1109,24100,3578737942,3578737957,15
1,1109,24101,3578737942,3578737960,18
1,1109,24102,3578737942,3578737961,19
1,1109,24103,3578737942,3578737962,20
1,1109,24104,3578737942,3578737962,20
1,1109,24105,3578737942,3578737963,21
1,1109,24106,3578737942,3578737965,23
1,1109,24107,3578737942,3578737966,24
1,1109,24108,3578737942,3578737966,24
1,1109,24109,3578737942,3578737968,26
1,1109,24110,3578737942,3578737969,27
1,1109,24111,3578737942,3578737969,27
1,1109,24112,3578737942,3578737971,29
1,1109,24113,3578737942,3578737974,32
1,1109,24114,3578737942,3578737975,33
1,1109,24115,3578737942,3578737976,34
1,1109,24116,3578737942,3578737979,37
1,1109,24117,3578737942,3578737980,38
1,1109,24118,3578737942,3578737981,39
1,1109,24119,3578737942,3578737981,39
1,1109,24120,3578737942,3578737982,40
1,1109,24121,3578737942,3578737983,41
1,1109,24122,3578737942,3578737983,41
1,1109,24123,3578737942,3578737984,42
1,1109,24124,3578737942,3578737986,44
1,1109,24125,3578737942,3578737987,45
1,1109,24126,3578737942,3578737987,45
1,1109,24127,3578737942,3578737989,47
1,1109,24128,3578737942,3578737991,49
1,1109,24129,3578737942,3578737992,50
1,1110,24130,3578738003,3578738003,0
1,1110,24131,3578738003,3578738003,0
1,1110,24132,3578738003,3578738003,0
1,1110,24133,3578738003,3578738003,0
1,1110,24134,3578738003,3578738003,0
1,1110,24135,3578738003,3578738003,0
1,1110,24136,3578738003,3578738003,0
1,1110,24137,3578738003,3578738003,0
1,1110,24138,3578738003,3578738003,0
1,1110,24139,3578738003,3578738003,0
1,1110,24140,3578738003,3578738003,0
1,1110,24141,3578738003,3578738005,2
1,1110,24142,3578738003,3578738006,3
1,1110,24143,3578738003,3578738009,6
1,1110,24144,3578738003,3578738009,6
1,1110,24145,3578738003,3578738012,9
1,1110,24146,3578738003,3578738013,10
1,1110,24147,3578738003,3578738014,11
1,1110,24148,3578738003,3578738015,12
1,1110,24149,3578738003,3578738015,12
1,1110,24150,3578738003,3578738016,13
1,1110,24151,3578738003,3578738016,13
1,1110,24152,3578738003,3578738018,15
1,1110,24153,3578738003,3578738018,15
1,1110,24154,3578738003,3578738018,15
1,1110,24155,3578738003,3578738019,16
1,1110,24156,3578738003,3578738020,17
1,1110,24157,3578738003,3578738021,18
1,1110,24158,3578738003,3578738025,22
1,1110,24159,3578738003,3578738025,22
1,1110,24160,3578738003,3578738025,22
1,1110,24161,3578738003,3578738025,22
1,1110,24162,3578738003,3578738027,24
1,1110,24163,3578738003,3578738028,25
1,1110,24164,3578738003,3578738028,25
1,1110,24165,3578738003,3578738028,25
1,1110,24166,3578738003,3578738029,26
1,1110,24167,3578738003,3578738029,26
1,1110,24168,3578738003,3578738029,26
1,1110,24169,3578738003,3578738030,27
1,1110,24170,3578738003,3578738030,27
1,1110,24171,3578738003,3578738031,28
1,1110,24172,3578738003,3578738032,29
1,1110,24173,3578738003,3578738033,30
1,1110,24174,3578738003,3578738035,32
1,1110,24175,3578738003,3578738036,33
1,1110,24176,3578738003,3578738037,34
1,1110,24177,3578738003,3578738038,35
1,1110,24178,3578738003,3578738039,36
1,1110,24179,3578738003,3578738040,37
1,1110,24180,3578738003,3578738044,41
1,1110,24181,3578738003,3578738045,42
1,1110,24182,3578738003,3578738045,42
1,1110,24183,3578738003,3578738048,45
1,1110,24184,3578738003,3578738049,46
1,1110,24185,3578738003,3578738049,46
1,1110,24186,3578738003,3578738049,46
1,1110,24187,3578738003,3578738050,47
1,1110,24188,3578738003,3578738051,48
1,1110,24189,3578738003,3578738051,48
1,1110,24190,3578738003,3578738051,48
1,1110,24191,3578738003,3578738052,49
1,1111,24192,3578738062,3578738062,0
1,1111,24193,3578738062,3578738062,0
1,1111,24194,3578738062,3578738062,0
1,1111,24195,3578738062,3578738062,0
1,1111,24196,3578738062,3578738062,0
1,1111,24197,3578738062,3578738062,0
1,1111,24198,3578738062,3578738063,1
1,1111,24199,3578738062,3578738064,2
1,1111,24200,3578738062,3578738065,3
1,1111,24201,3578738062,3578738065,3
1,1111,24202,3578738062,3578738066,4
1,1111,24203,3578738062,3578738067,5
1,1111,24204,3578738062,3578738068,6
1,1111,24205,3578738062,3578738068,6
1,1111,24206,3578738062,3578738069,7
1,1111,24207,3578738062,3578738069,7
1,1111,24208,3578738062,3578738074,12
1,1111,24209,3578738062,3578738075,13
1,1111,24210,3578738062,3578738075,13
1,1111,24211,3578738062,3578738077,15
1,1111,24212,3578738062,3578738079,17
1,1111,24213,3578738062,3578738082,20
1,1111,24214,3578738062,3578738084,22
1,1111,24215,3578738062,3578738085,23
1,1111,24216,3578738062,3578738085,23
1,1111,24217,3578738062,3578738085,23
1,1111,24218,3578738062,3578738087,25
1,1111,24219,3578738062,3578738092,30
1,1111,24220,3578738062,3578738092,30
1,1111,24221,3578738062,3578738094,32
1,1111,24222,3578738062,3578738094,32
1,1111,24223,3578738062,3578738095,33
1,1111,24224,3578738062,3578738095,33
1,1111,24225,3578738062,3578738096,34
1,1111,24226,3578738062,3578738099,37
1,1111,24227,3578738062,3578738101,39
1,1111,24228,3578738062,3578738102,40
1,1111,24229,3578738062,3578738103,41
1,1111,24230,3578738062,3578738104,42
1,1111,24231,3578738062,3578738105,43
1,1111,24232,3578738062,3578738106,44
1,1111,24233,3578738062,3578738107,45
1,1111,24234,3578738062,3578738108,46
1,1111,24235,3578738062,3578738109,47
1,1111,24236,3578738062,3578738111,49
1,1111,24237,3578738062,3578738111,49
1,1111,24238,3578738062,3578738112,50
1,1112,24239,3578738127,3578738127,0
1,1112,24240,3578738127,3578738127,0
1,1112,24241,3578738127,3578738127,0
1,1112,24242,3578738127,3578738127,0
1,1112,24243,3578738127,3578738127,0
1,1112,24244,3578738127,3578738127,0
1,1112,24245,3578738127,3578738127,0
1,1112,24246,3578738127,3578738127,0
1,1112,24247,3578738127,3578738127,0
1,1112,24248,3578738127,3578738127,0
1,1112,24249,3578738127,3578738127,0
1,1112,24250,3578738127,3578738127,0
1,1112,24251,3578738127,3578738127,0
1,1112,24252,3578738127,3578738127,0
1,1112,24253,3578738127,3578738127,0
1,1112,24254,3578738127,3578738127,0
1,1112,24255,3578738127,3578738127,0
1,1112,24256,3578738127,3578738127,0
1,1112,24257,3578738127,3578738127,0
1,1112,24258,3578738127,3578738127,0
1,1112,24259,3578738127,3578738127,0
1,1112,24260,3578738127,3578738127,0
1,1112,24261,3578738127,3578738128,1
1,1112,24262,3578738127,3578738128,1
1,1112,24263,3578738127,3578738129,2
1,1112,24264,3578738127,3578738129,2
1,1112,24265,3578738127,3578738129,2
1,1112,24266,3578738127,3578738130,3
1,1112,24267,3578738127,3578738131,4
1,1112,24268,3578738127,3578738131,4
1,1112,24269,3578738127,3578738132,5
1,1112,24270,3578738127,3578738132,5
1,1112,24271,3578738127,3578738133,6
1,1112,24272,3578738127,3578738133,6
1,1112,24273,3578738127,3578738133,6
1,1112,24274,3578738127,3578738134,7
1,1112,24275,3578738127,3578738134,7
1,1112,24276,3578738127,3578738137,10
1,1112,24277,3578738127,3578738138,11
1,1112,24278,3578738127,3578738138,11
1,1112,24279,3578738127,3578738142,15
1,1112,24280,3578738127,3578738144,17
1,1112,24281,3578738127,3578738144,17
1,1112,24282,3578738127,3578738146,19
1,1112,24283,3578738127,3578738146,19
1,1112,24284,3578738127,3578738147,20
1,1112,24285,3578738127,3578738149,22
1,1112,24286,3578738127,3578738152,25
1,1112,24287,3578738127,3578738152,25
1,1112,24288,3578738127,3578738152,25
1,1112,24289,3578738127,3578738154,27
1,1112,24290,3578738127,3578738155,28
1,1112,24291,3578738127,3578738155,28
1,1112,24292,3578738127,3578738155,28
1,1112,24293,3578738127,3578738156,29
1,1112,24294,3578738127,3578738156,29
1,1112,24295,3578738127,3578738157,30
1,1112,24296,3578738127,3578738157,30
1,1112,24297,3578738127,3578738161,34
1,1112,24298,3578738127,3578738162,35
1,1112,24299,3578738127,3578738162,35
1,1112,24300,3578738127,3578738163,36
1,1112,24301,3578738127,3578738164,37
1,1112,24302,3578738127,3578738164,37
1,1112,24303,3578738127,3578738165,38
1,1112,24304,3578738127,3578738166,39
1,1112,24305,3578738127,3578738167,40
1,1112,24306,3578738127,3578738169,42
1,1112,24307,3578738127,3578738169,42
1,1112,24308,3578738127,3578738170,43
1,1112,24309,3578738127,3578738172,45
1,1112,24310,3578738127,3578738172,45
1,1112,24311,3578738127,3578738174,47
1,1112,24312,3578738127,3578738176,49
1,1113,24313,3578738188,3578738188,0
1,1113,24314,3578738188,3578738188,0
1,1113,24315,3578738188,3578738188,0
1,1113,24316,3578738188,3578738188,0
1,1113,24317,3578738188,3578738188,0
1,1113,24318,3578738188,3578738188,0
1,1113,24319,3578738188,3578738188,0
1,1113,24320,3578738188,3578738188,0
1,1113,24321,3578738188,3578738188,0
1,1113,24322,3578738188,3578738188,0
1,1113,24323,3578738188,3578738188,0
1,1113,24324,3578738188,3578738188,0
1,1113,24325,3578738188,3578738190,2
1,1113,24326,3578738188,3578738191,3
1,1113,24327,3578738188,3578738191,3
1,1113,24328,3578738188,3578738191,3
1,1113,24329,3578738188,3578738192,4
1,1113,24330,3578738188,3578738193,5
1,1113,24331,3578738188,3578738196,8
1,1113,24332,3578738188,3578738196,8
1,1113,24333,3578738188,3578738197,9
1,1113,24334,3578738188,3578738197,9
1,1113,24335,3578738188,3578738197,9
1,1113,24336,3578738188,3578738198,10
1,1113,24337,3578738188,3578738199,11
1,1113,24338,3578738188,3578738200,12
1,1113,24339,3578738188,3578738201,13
1,1113,24340,3578738188,3578738201,13
1,1113,24341,3578738188,3578738201,13
1,1113,24342,3578738188,3578738203,15
1,1113,24343,3578738188,3578738205,17
1,1113,24344,3578738188,3578738206,18
1,1113,24345,3578738188,3578738210,22
1,1113,24346,3578738188,3578738210,22
1,1113,24347,3578738188,3578738213,25
1,1113,24348,3578738188,3578738214,26
1,1113,24349,3578738188,3578738214,26
1,1113,24350,3578738188,3578738215,27
1,1113,24351,3578738188,3578738216,28
1,1113,24352,3578738188,3578738216,28
1,1113,24353,3578738188,3578738216,28
1,1113,24354,3578738188,3578738217,29
1,1113,24355,3578738188,3578738218,30
1,1113,24356,3578738188,3578738218,30
1,1113,24357,3578738188,3578738219,31
1,1113,24358,3578738188,3578738220,32
1,1113,24359,3578738188,3578738221,33
1,1113,24360,3578738188,3578738224,36
1,1113,24361,3578738188,3578738224,36
1,1113,24362,3578738188,3578738225,37
1,1113,24363,3578738188,3578738225,37
1,1113,24364,3578738188,3578738225,37
1,1113,24365,3578738188,3578738227,39
1,1113,24366,3578738188,3578738228,40
1,1113,24367,3578738188,3578738229,41
1,1113,24368,3578738188,3578738229,41
1,1113,24369,3578738188,3578738229,41
1,1113,24370,3578738188,3578738229,41
1,1113,24371,3578738188,3578738230,42
1,1113,24372,3578738188,3578738230,42
1,1113,24373,3578738188,3578738231,43
1,1113,24374,3578738188,3578738232,44
1,1113,24375,3578738188,3578738233,45
1,1113,24376,3578738188,3578738235,47
1,1113,24377,3578738188,3578738237,49
1,1113,24378,3578738188,3578738237,49
1,1114,24379,3578738250,3578738250,0
1,1114,24380,3578738250,3578738250,0
1,1114,24381,3578738250,3578738250,0
1,1114,24382,3578738250,3578738250,0
1,1114,24383,3578738250,3578738250,0
1,1114,24384,3578738250,3578738250,0
1,1114,24385,3578738250,3578738250,0
1,1114,24386,3578738250,3578738250,0
1,1114,24387,3578738250,3578738250,0
1,1114,24388,3578738250,3578738250,0
1,1114,24389,3578738250,3578738250,0
1,1114,24390,3578738250,3578738251,1
1,1114,24391,3578738250,3578738251,1
1,1114,24392,3578738250,3578738253,3
1,1114,24393,3578738250,3578738253,3
1,1114,24394,3578738250,3578738257,7
1,1114,24395,3578738250,3578738258,8
1,1114,24396,3578738250,3578738260,10
1,1114,24397,3578738250,3578738260,10
1,1114,24398,3578738250,3578738263,13
1,1114,24399,3578738250,3578738263,13
1,1114,24400,3578738250,3578738264,14
1,1114,24401,3578738250,3578738265,15
1,1114,24402,3578738250,3578738265,15
1,1114,24403,3578738250,3578738267,17
1,1114,24404,3578738250,3578738268,18
1,1114,24405,3578738250,3578738268,18
1,1114,24406,3578738250,3578738269,19
1,1114,24407,3578738250,3578738269,19
1,1114,24408,3578738250,3578738270,20
1,1114,24409,3578738250,3578738274,24
1,1114,24410,3578738250,3578738275,25
1,1114,24411,3578738250,3578738276,26
1,1114,24412,3578738250,3578738277,27
1,1114,24413,3578738250,3578738279,29
1,1114,24414,3578738250,3578738283,33
1,1114,24415,3578738250,3578738285,35
1,1114,24416,3578738250,3578738285,35
1,1114,24417,3578738250,3578738285,35
1,1114,24418,3578738250,3578738292,42
1,1114,24419,3578738250,3578738293,43
1,1114,24420,3578738250,3578738294,44
1,1114,24421,3578738250,3578738294,44
1,1114,24422,3578738250,3578738295,45
1,1114,24423,3578738250,3578738296,46
1,1114,24424,3578738250,3578738297,47
1,1114,24425,3578738250,3578738300,50
1,1115,24426,3578738309,3578738310,1
1,1115,24427,3578738309,3578738310,1
1,1115,24428,3578738309,3578738310,1
1,1115,24429,3578738309,3578738310,1
1,1115,24430,3578738309,3578738310,1
1,1115,24431,3578738309,3578738310,1
1,1115,24432,3578738309,3578738310,1
1,1115,24433,3578738309,3578738310,1
1,1115,24434,3578738309,3578738310,1
1,1115,24435,3578738309,3578738310,1
1,1115,24436,3578738309,3578738311,2
1,1115,24437,3578738309,3578738312,3
1,1115,24438,3578738309,3578738312,3
1,1115,24439,3578738309,3578738312,3
1,1115,24440,3578738309,3578738313,4
1,1115,24441,3578738309,3578738313,4
1,1115,24442,3578738309,3578738314,5
1,1115,24443,3578738309,3578738314,5
1,1115,24444,3578738309,3578738315,6
1,1115,24445,3578738309,3578738315,6
1,1115,24446,3578738309,3578738315,6
1,1115,24447,3578738309,3578738317,8
1,1115,24448,3578738309,3578738318,9
1,1115,24449,3578738309,3578738319,10
1,1115,24450,3578738309,3578738319,10
1,1115,24451,3578738309,3578738320,11
1,1115,24452,3578738309,3578738321,12
1,1115,24453,3578738309,3578738321,12
1,1115,24454,3578738309,3578738326,17
1,1115,24455,3578738309,3578738326,17
1,1115,24456,3578738309,3578738327,18
1,1115,24457,3578738309,3578738329,20
1,1115,24458,3578738309,3578738329,20
1,1115,24459,3578738309,3578738329,20
1,1115,24460,3578738309,3578738329,20
1,1115,24461,3578738309,3578738330,21
1,1115,24462,3578738309,3578738330,21
1,1115,24463,3578738309,3578738331,22
1,1115,24464,3578738309,3578738331,22
1,1115,24465,3578738309,3578738332,23
1,1115,24466,3578738309,3578738332,23
1,1115,24467,3578738309,3578738333,24
1,1115,24468,3578738309,3578738333,24
1,1115,24469,3578738309,3578738333,24
1,1115,24470,3578738309,3578738334,25
1,1115,24471,3578738309,3578738334,25
1,1115,24472,3578738309,3578738334,25
1,1115,24473,3578738309,3578738338,29
1,1115,24474,3578738309,3578738339,30
1,1115,24475,3578738309,3578738342,33
1,1115,24476,3578738309,3578738345,36
1,1115,24477,3578738309,3578738347,38
1,1115,24478,3578738309,3578738347,38
1,1115,24479,3578738309,3578738349,40
1,1115,24480,3578738309,3578738352,43
1,1115,24481,3578738309,3578738352,43
1,1115,24482,3578738309,3578738354,45
1,1115,24483,3578738309,3578738355,46
1,1115,24484,3578738309,3578738355,46
1,1115,24485,3578738309,3578738356,47
1,1115,24486,3578738309,3578738356,47
1,1115,24487,3578738309,3578738356,47
1,1115,24488,3578738309,3578738357,48
1,1115,24489,3578738309,3578738358,49
1,1116,24490,3578738372,3578738372,0
1,1116,24491,3578738372,3578738372,0
1,1116,24492,3578738372,3578738372,0
1,1116,24493,3578738372,3578738372,0
1,1116,24494,3578738372,3578738372,0
1,1116,24495,3578738372,3578738372,0
1,1116,24496,3578738372,3578738372,0
1,1116,24497,3578738372,3578738372,0
1,1116,24498,3578738372,3578738372,0
1,1116,24499,3578738372,3578738372,0
1,1116,24500,3578738372,3578738372,0
1,1116,24501,3578738372,3578738372,0
1,1116,24502,3578738372,3578738372,0
1,1116,24503,3578738372,3578738372,0
1,1116,24504,3578738372,3578738374,2
1,1116,24505,3578738372,3578738376,4
1,1116,24506,3578738372,3578738380,8
1,1116,24507,3578738372,3578738381,9
1,1116,24508,3578738372,3578738382,10
1,1116,24509,3578738372,3578738382,10
1,1116,24510,3578738372,3578738382,10
1,1116,24511,3578738372,3578738383,11
1,1116,24512,3578738372,3578738383,11
1,1116,24513,3578738372,3578738385,13
1,1116,24514,3578738372,3578738387,15
1,1116,24515,3578738372,3578738387,15
1,1116,24516,3578738372,3578738388,16
1,1116,24517,3578738372,3578738391,19
1,1116,24518,3578738372,3578738391,19
1,1116,24519,3578738372,3578738393,21
1,1116,24520,3578738372,3578738393,21
1,1116,24521,3578738372,3578738394,22
1,1116,24522,3578738372,3578738396,24
1,1116,24523,3578738372,3578738397,25
1,1116,24524,3578738372,3578738398,26
1,1116,24525,3578738372,3578738398,26
1,1116,24526,3578738372,3578738398,26
1,1116,24527,3578738372,3578738399,27
1,1116,24528,3578738372,3578738399,27
1,1116,24529,3578738372,3578738401,29
1,1116,24530,3578738372,3578738401,29
1,1116,24531,3578738372,3578738402,30
1,1116,24532,3578738372,3578738403,31
1,1116,24533,3578738372,3578738405,33
1,1116,24534,3578738372,3578738406,34
1,1116,24535,3578738372,3578738409,37
1,1116,24536,3578738372,3578738410,38
1,1116,24537,3578738372,3578738413,41
1,1116,24538,3578738372,3578738413,41
1,1116,24539,3578738372,3578738415,43
1,1116,24540,3578738372,3578738415,43
1,1116,24541,3578738372,3578738417,45
1,1116,24542,3578738372,3578738417,45
1,1116,24543,3578738372,3578738417,45
1,1116,24544,3578738372,3578738417,45
1,1116,24545,3578738372,3578738418,46
1,1116,24546,3578738372,3578738419,47
1,1116,24547,3578738372,3578738420,48
1,1116,24548,3578738372,3578738420,48
1,1117,24549,3578738433,3578738433,0
1,1117,24550,3578738433,3578738433,0
1,1117,24551,3578738433,3578738433,0
1,1117,24552,3578738433,3578738433,0
1,1117,24553,3578738433,3578738433,0
1,1117,24554,3578738433,3578738433,0
1,1117,24555,3578738433,3578738433,0
1,1117,24556,3578738433,3578738433,0
1,1117,24557,3578738433,3578738433,0
1,1117,24558,3578738433,3578738433,0
1,1117,24559,3578738433,3578738433,0
1,1117,24560,3578738433,3578738433,0
1,1117,24561,3578738433,3578738433,0
1,1117,24562,3578738433,3578738433,0
1,1117,24563,3578738433,3578738433,0
1,1117,24564,3578738433,3578738433,0
1,1117,24565,3578738433,3578738433,0
1,1117,24566,3578738433,3578738435,2
1,1117,24567,3578738433,3578738437,4
1,1117,24568,3578738433,3578738437,4
1,1117,24569,3578738433,3578738439,6
1,1117,24570,3578738433,3578738440,7
1,1117,24571,3578738433,3578738440,7
1,1117,24572,3578738433,3578738441,8
1,1117,24573,3578738433,3578738445,12
1,1117,24574,3578738433,3578738448,15
1,1117,24575,3578738433,3578738448,15
1,1117,24576,3578738433,3578738448,15
1,1117,24577,3578738433,3578738448,15
1,1117,24578,3578738433,3578738449,16
1,1117,24579,3578738433,3578738450,17
1,1117,24580,3578738433,3578738451,18
1,1117,24581,3578738433,3578738451,18
1,1117,24582,3578738433,3578738451,18
1,1117,24583,3578738433,3578738451,18
1,1117,24584,3578738433,3578738452,19
1,1117,24585,3578738433,3578738453,20
1,1117,24586,3578738433,3578738454,21
1,1117,24587,3578738433,3578738457,24
1,1117,24588,3578738433,3578738458,25
1,1117,24589,3578738433,3578738460,27
1,1117,24590,3578738433,3578738461,28
1,1117,24591,3578738433,3578738463,30
1,1117,24592,3578738433,3578738463,30
1,1117,24593,3578738433,3578738464,31
1,1117,24594,3578738433,3578738465,32
1,1117,24595,3578738433,3578738467,34
1,1117,24596,3578738433,3578738468,35
1,1117,24597,3578738433,3578738469,36
1,1117,24598,3578738433,3578738469,36
1,1117,24599,3578738433,3578738470,37
1,1117,24600,3578738433,3578738470,37
1,1117,24601,3578738433,3578738473,40
1,1117,24602,3578738433,3578738475,42
1,1117,24603,3578738433,3578738477,44
1,1117,24604,3578738433,3578738478,45
1,1117,24605,3578738433,3578738479,46
1,1118,24606,3578738492,3578738492,0
1,1118,24607,3578738492,3578738492,0
1,1118,24608,3578738492,3578738492,0
1,1118,24609,3578738492,3578738492,0
1,1118,24610,3578738492,3578738492,0
1,1118,24611,3578738492,3578738493,1
1,1118,24612,3578738492,3578738493,1
1,1118,24613,3578738492,3578738493,1
1,1118,24614,3578738492,3578738494,2
1,1118,24615,3578738492,3578738495,3
1,1118,24616,3578738492,3578738497,5
1,1118,24617,3578738492,3578738499,7
1,1118,24618,3578738492,3578738500,8
1,1118,24619,3578738492,3578738501,9
1,1118,24620,3578738492,3578738501,9
1,1118,24621,3578738492,3578738503,11
1,1118,24622,3578738492,3578738503,11
1,1118,24623,3578738492,3578738505,13
1,1118,24624,3578738492,3578738507,15
1,1118,24625,3578738492,3578738508,16
1,1118,24626,3578738492,3578738509,17
1,1118,24627,3578738492,3578738509,17
1,1118,24628,3578738492,3578738509,17
1,1118,24629,3578738492,3578738510,18
1,1118,24630,3578738492,3578738511,19
1,1118,24631,3578738492,3578738511,19
1,1118,24632,3578738492,3578738512,20
1,1118,24633,3578738492,3578738512,20
1,1118,24634,3578738492,3578738513,21
1,1118,24635,3578738492,3578738513,21
1,1118,24636,3578738492,3578738514,22
1,1118,24637,3578738492,3578738515,23
1,1118,24638,3578738492,3578738515,23
1,1118,24639,3578738492,3578738516,24
1,1118,24640,3578738492,3578738516,24
1,1118,24641,3578738492,3578738517,25
1,1118,24642,3578738492,3578738517,25
1,1118,24643,3578738492,3578738518,26
1,1118,24644,3578738492,3578738520,28
1,1118,24645,3578738492,3578738520,28
1,1118,24646,3578738492,3578738520,28
1,1118,24647,3578738492,3578738520,28
1,1118,24648,3578738492,3578738521,29
1,1118,24649,3578738492,3578738524,32
1,1118,24650,3578738492,3578738524,32
1,1118,24651,3578738492,3578738525,33
1,1118,24652,3578738492,3578738525,33
1,1118,24653,3578738492,3578738528,36
1,1118,24654,3578738492,3578738528,36
1,1118,24655,3578738492,3578738528,36
1,1118,24656,3578738492,3578738529,37
1,1118,24657,3578738492,3578738529,37
1,1118,24658,3578738492,3578738529,37
1,1118,24659,3578738492,3578738530,38
1,1118,24660,3578738492,3578738530,38
1,1118,24661,3578738492,3578738531,39
1,1118,24662,3578738492,3578738531,39
1,1118,24663,3578738492,3578738531,39
1,1118,24664,3578738492,3578738532,40
1,1118,24665,3578738492,3578738533,41
1,1118,24666,3578738492,3578738533,41
1,1118,24667,3578738492,3578738533,41
1,1118,24668,3578738492,3578738533,41
1,1118,24669,3578738492,3578738533,41
1,1118,24670,3578738492,3578738537,45
1,1118,24671,3578738492,3578738538,46
1,1118,24672,3578738492,3578738538,46
1,1118,24673,3578738492,3578738541,49
1,1119,24674,3578738553,3578738553,0
1,1119,24675,3578738553,3578738553,0
1,1119,24676,3578738553,3578738553,0
1,1119,24677,3578738553,3578738553,0
1,1119,24678,3578738553,3578738553,0
1,1119,24679,3578738553,3578738553,0
1,1119,24680,3578738553,3578738553,0
1,1119,24681,3578738553,3578738553,0
1,1119,24682,3578738553,3578738553,0
1,1119,24683,3578738553,3578738554,1
1,1119,24684,3578738553,3578738555,2
1,1119,24685,3578738553,3578738556,3
1,1119,24686,3578738553,3578738556,3
1,1119,24687,3578738553,3578738557,4
1,1119,24688,3578738553,3578738557,4
1,1119,24689,3578738553,3578738562,9
1,1119,24690,3578738553,3578738562,9
1,1119,24691,3578738553,3578738562,9
1,1119,24692,3578738553,3578738562,9
1,1119,24693,3578738553,3578738565,12
1,1119,24694,3578738553,3578738565,12
1,1119,24695,3578738553,3578738565,12
1,1119,24696,3578738553,3578738567,14
1,1119,24697,3578738553,3578738567,14
1,1119,24698,3578738553,3578738568,15
1,1119,24699,3578738553,3578738568,15
1,1119,24700,3578738553,3578738569,16
1,1119,24701,3578738553,3578738570,17
1,1119,24702,3578738553,3578738571,18
1,1119,24703,3578738553,3578738574,21
1,1119,24704,3578738553,3578738575,22
1,1119,24705,3578738553,3578738575,22
1,1119,24706,3578738553,3578738579,26
1,1119,24707,3578738553,3578738580,27
1,1119,24708,3578738553,3578738581,28
1,1119,24709,3578738553,3578738581,28
1,1119,24710,3578738553,3578738581,28
1,1119,24711,3578738553,3578738581,28
1,1119,24712,3578738553,3578738582,29
1,1119,24713,3578738553,3578738584,31
1,1119,24714,3578738553,3578738585,32
1,1119,24715,3578738553,3578738586,33
1,1119,24716,3578738553,3578738586,33
1,1119,24717,3578738553,3578738587,34
1,1119,24718,3578738553,3578738587,34
1,1119,24719,3578738553,3578738590,37
1,1119,24720,3578738553,3578738590,37
1,1119,24721,3578738553,3578738592,39
1,1119,24722,3578738553,3578738592,39
1,1119,24723,3578738553,3578738593,40
1,1119,24724,3578738553,3578738594,41
1,1119,24725,3578738553,3578738595,42
1,1119,24726,3578738553,3578738596,43
1,1119,24727,3578738553,3578738596,43
1,1119,24728,3578738553,3578738597,44
1,1119,24729,3578738553,3578738597,44
1,1119,24730,3578738553,3578738597,44
1,1119,24731,3578738553,3578738598,45
1,1119,24732,3578738553,3578738598,45
1,1119,24733,3578738553,3578738599,46
1,1119,24734,3578738553,3578738600,47
1,1119,24735,3578738553,3578738600,47
1,1119,24736,3578738553,3578738602,49
1,1119,24737,3578738553,3578738602,49
1,1120,24738,3578738613,3578738613,0
1,1120,24739,3578738613,3578738613,0
1,1120,24740,3578738613,3578738613,0
1,1120,24741,3578738613,3578738613,0
1,1120,24742,3578738613,3578738613,0
1,1120,24743,3578738613,3578738613,0
1,1120,24744,3578738613,3578738615,2
1,1120,24745,3578738613,3578738615,2
1,1120,24746,3578738613,3578738616,3
1,1120,24747,3578738613,3578738616,3
1,1120,24748,3578738613,3578738616,3
1,1120,24749,3578738613,3578738617,4
1,1120,24750,3578738613,3578738617,4
1,1120,24751,3578738613,3578738619,6
1,1120,24752,3578738613,3578738620,7
1,1120,24753,3578738613,3578738622,9
1,1120,24754,3578738613,3578738623,10
1,1120,24755,3578738613,3578738624,11
1,1120,24756,3578738613,3578738624,11
1,1120,24757,3578738613,3578738625,12
1,1120,24758,3578738613,3578738626,13
1,1120,24759,3578738613,3578738627,14
1,1120,24760,3578738613,3578738629,16
1,1120,24761,3578738613,3578738629,16
1,1120,24762,3578738613,3578738629,16
1,1120,24763,3578738613,3578738629,16
1,1120,24764,3578738613,3578738629,16
1,1120,24765,3578738613,3578738630,17
1,1120,24766,3578738613,3578738630,17
1,1120,24767,3578738613,3578738631,18
1,1120,24768,3578738613,3578738632,19
1,1120,24769,3578738613,3578738636,23
1,1120,24770,3578738613,3578738638,25
1,1120,24771,3578738613,3578738639,26
1,1120,24772,3578738613,3578738640,27
1,1120,24773,3578738613,3578738644,31
1,1120,24774,3578738613,3578738645,32
1,1120,24775,3578738613,3578738646,33
1,1120,24776,3578738613,3578738648,35
1,1120,24777,3578738613,3578738649,36
1,1120,24778,3578738613,3578738649,36
1,1120,24779,3578738613,3578738650,37
1,1120,24780,3578738613,3578738650,37
1,1120,24781,3578738613,3578738651,38
1,1120,24782,3578738613,3578738652,39
1,1120,24783,3578738613,3578738652,39
1,1120,24784,3578738613,3578738653,40
1,1120,24785,3578738613,3578738656,43
1,1120,24786,3578738613,3578738659,46
1,1120,24787,3578738613,3578738659,46
1,1120,24788,3578738613,3578738661,48
1,1120,24789,3578738613,3578738663,50
1,1121,24790,3578738673,3578738673,0
1,1121,24791,3578738673,3578738673,0
1,1121,24792,3578738673,3578738673,0
1,1121,24793,3578738673,3578738673,0
1,1121,24794,3578738673,3578738673,0
1,1121,24795,3578738673,3578738673,0
1,1121,24796,3578738673,3578738673,0
1,1121,24797,3578738673,3578738673,0
1,1121,24798,3578738673,3578738673,0
1,1121,24799,3578738673,3578738673,0
1,1121,24800,3578738673,3578738675,2
1,1121,24801,3578738673,3578738678,5
1,1121,24802,3578738673,3578738678,5
1,1121,24803,3578738673,3578738680,7
1,1121,24804,3578738673,3578738683,10
1,1121,24805,3578738673,3578738685,12
1,1121,24806,3578738673,3578738688,15
1,1121,24807,3578738673,3578738689,16
1,1121,24808,3578738673,3578738689,16
1,1121,24809,3578738673,3578738691,18
1,1121,24810,3578738673,3578738693,20
1,1121,24811,3578738673,3578738693,20
1,1121,24812,3578738673,3578738693,20
1,1121,24813,3578738673,3578738694,21
1,1121,24814,3578738673,3578738694,21
1,1121,24815,3578738673,3578738695,22
1,1121,24816,3578738673,3578738696,23
1,1121,24817,3578738673,3578738699,26
1,1121,24818,3578738673,3578738700,27
1,1121,24819,3578738673,3578738701,28
1,1121,24820,3578738673,3578738702,29
1,1121,24821,3578738673,3578738703,30
1,1121,24822,3578738673,3578738703,30
1,1121,24823,3578738673,3578738704,31
1,1121,24824,3578738673,3578738705,32
1,1121,24825,3578738673,3578738707,34
1,1121,24826,3578738673,3578738707,34
1,1121,24827,3578738673,3578738709,36
1,1121,24828,3578738673,3578738709,36
1,1121,24829,3578738673,3578738709,36
1,1121,24830,3578738673,3578738711,38
1,1121,24831,3578738673,3578738711,38
1,1121,24832,3578738673,3578738711,38
1,1121,24833,3578738673,3578738712,39
1,1121,24834,3578738673,3578738712,39
1,1121,24835,3578738673,3578738712,39
1,1121,24836,3578738673,3578738713,40
1,1121,24837,3578738673,3578738713,40
1,1121,24838,3578738673,3578738713,40
1,1121,24839,3578738673,3578738714,41
1,1121,24840,3578738673,3578738715,42
1,1121,24841,3578738673,3578738715,42
1,1121,24842,3578738673,3578738716,43
1,1121,24843,3578738673,3578738717,44
1,1121,24844,3578738673,3578738718,45
1,1121,24845,3578738673,3578738719,46
1,1121,24846,3578738673,3578738720,47
1,1121,24847,3578738673,3578738720,47
1,1121,24848,3578738673,3578738720,47
1,1121,24849,3578738673,3578738721,48
1,1121,24850,3578738673,3578738721,48
1,1122,24851,3578738735,3578738735,0
1,1122,24852,3578738735,3578738735,0
1,1122,24853,3578738735,3578738735,0
1,1122,24854,3578738735,3578738735,0
1,1122,24855,3578738735,3578738735,0
1,1122,24856,3578738735,3578738735,0
1,1122,24857,3578738735,3578738735,0
1,1122,24858,3578738735,3578738735,0
1,1122,24859,3578738735,3578738735,0
1,1122,24860,3578738735,3578738735,0
1,1122,24861,3578738735,3578738735,0
1,1122,24862,3578738735,3578738735,0
1,1122,24863,3578738735,3578738735,0
1,1122,24864,3578738735,3578738735,0
1,1122,24865,3578738735,3578738735,0
1,1122,24866,3578738735,3578738735,0
1,1122,24867,3578738735,3578738735,0
1,1122,24868,3578738735,3578738735,0
1,1122,24869,3578738735,3578738735,0
1,1122,24870,3578738735,3578738735,0
1,1122,24871,3578738735,3578738735,0
1,1122,24872,3578738735,3578738737,2
1,1122,24873,3578738735,3578738741,6
1,1122,24874,3578738735,3578738742,7
1,1122,24875,3578738735,3578738745,10
1,1122,24876,3578738735,3578738746,11
1,1122,24877,3578738735,3578738746,11
1,1122,24878,3578738735,3578738746,11
1,1122,24879,3578738735,3578738747,12
1,1122,24880,3578738735,3578738749,14
1,1122,24881,3578738735,3578738751,16
1,1122,24882,3578738735,3578738752,17
1,1122,24883,3578738735,3578738753,18
1,1122,24884,3578738735,3578738755,20
1,1122,24885,3578738735,3578738755,20
1,1122,24886,3578738735,3578738755,20
1,1122,24887,3578738735,3578738756,21
1,1122,24888,3578738735,3578738757,22
1,1122,24889,3578738735,3578738757,22
1,1122,24890,3578738735,3578738757,22
1,1122,24891,3578738735,3578738761,26
1,1122,24892,3578738735,3578738762,27
1,1122,24893,3578738735,3578738763,28
1,1122,24894,3578738735,3578738765,30
1,1122,24895,3578738735,3578738765,30
1,1122,24896,3578738735,3578738765,30
1,1122,24897,3578738735,3578738766,31
1,1122,24898,3578738735,3578738768,33
1,1122,24899,3578738735,3578738768,33
1,1122,24900,3578738735,3578738769,34
1,1122,24901,3578738735,3578738769,34
1,1122,24902,3578738735,3578738770,35
1,1122,24903,3578738735,3578738774,39
1,1122,24904,3578738735,3578738774,39
1,1122,24905,3578738735,3578738775,40
1,1122,24906,3578738735,3578738776,41
1,1122,24907,3578738735,3578738778,43
1,1122,24908,3578738735,3578738780,45
1,1122,24909,3578738735,3578738781,46
1,1122,24910,3578738735,3578738782,47
1,1122,24911,3578738735,3578738782,47
1,1122,24912,3578738735,3578738783,48
1,1122,24913,3578738735,3578738784,49
1,1123,24914,3578738799,3578738799,0
1,1123,24915,3578738799,3578738799,0
1,1123,24916,3578738799,3578738799,0
1,1123,24917,3578738799,3578738799,0
1,1123,24918,3578738799,3578738799,0
1,1123,24919,3578738799,3578738799,0
1,1123,24920,3578738799,3578738799,0
1,1123,24921,3578738799,3578738799,0
1,1123,24922,3578738799,3578738799,0
1,1123,24923,3578738799,3578738799,0
1,1123,24924,3578738799,3578738799,0
1,1123,24925,3578738799,3578738799,0
1,1123,24926,3578738799,3578738799,0
1,1123,24927,3578738799,3578738799,0
1,1123,24928,3578738799,3578738799,0
1,1123,24929,3578738799,3578738799,0
1,1123,24930,3578738799,3578738799,0
1,1123,24931,3578738799,3578738800,1
1,1123,24932,3578738799,3578738800,1
1,1123,24933,3578738799,3578738802,3
1,1123,24934,3578738799,3578738803,4
1,1123,24935,3578738799,3578738803,4
1,1123,24936,3578738799,3578738808,9
1,1123,24937,3578738799,3578738809,10
1,1123,24938,3578738799,3578738811,12
1,1123,24939,3578738799,3578738813,14
1,1123,24940,3578738799,3578738813,14
1,1123,24941,3578738799,3578738815,16
1,1123,24942,3578738799,3578738815,16
1,1123,24943,3578738799,3578738816,17
1,1123,24944,3578738799,3578738816,17
1,1123,24945,3578738799,3578738817,18
1,1123,24946,3578738799,3578738818,19
1,1123,24947,3578738799,3578738818,19
1,1123,24948,3578738799,3578738818,19
1,1123,24949,3578738799,3578738819,20
1,1123,24950,3578738799,3578738819,20
1,1123,24951,3578738799,3578738820,21
1,1123,24952,3578738799,3578738823,24
1,1123,24953,3578738799,3578738824,25
1,1123,24954,3578738799,3578738824,25
1,1123,24955,3578738799,3578738825,26
1,1123,24956,3578738799,3578738826,27
1,1123,24957,3578738799,3578738826,27
1,1123,24958,3578738799,3578738828,29
1,1123,24959,3578738799,3578738828,29
1,1123,24960,3578738799,3578738829,30
1,1123,24961,3578738799,3578738829,30
1,1123,24962,3578738799,3578738830,31
1,1123,24963,3578738799,3578738830,31
1,1123,24964,3578738799,3578738830,31
1,1123,24965,3578738799,3578738831,32
1,1123,24966,3578738799,3578738832,33
1,1123,24967,3578738799,3578738835,36
1,1123,24968,3578738799,3578738836,37
1,1123,24969,3578738799,3578738838,39
1,1123,24970,3578738799,3578738840,41
1,1123,24971,3578738799,3578738840,41
1,1123,24972,3578738799,3578738845,46
1,1123,24973,3578738799,3578738845,46
1,1123,24974,3578738799,3578738847,48
1,1123,24975,3578738799,3578738847,48
1,1123,24976,3578738799,3578738849,50
1,1124,24977,3578738861,3578738861,0
1,1124,24978,3578738861,3578738861,0
1,1124,24979,3578738861,3578738861,0
1,1124,24980,3578738861,3578738861,0
1,1124,24981,3578738861,3578738861,0
1,1124,24982,3578738861,3578738861,0
1,1124,24983,3578738861,3578738861,0
1,1124,24984,3578738861,3578738861,0
1,1124,24985,3578738861,3578738861,0
1,1124,24986,3578738861,3578738861,0
1,1124,24987,3578738861,3578738863,2
1,1124,24988,3578738861,3578738864,3
1,1124,24989,3578738861,3578738864,3
1,1124,24990,3578738861,3578738864,3
1,1124,24991,3578738861,3578738866,5
1,1124,24992,3578738861,3578738867,6
1,1124,24993,3578738861,3578738869,8
1,1124,24994,3578738861,3578738873,12
1,1124,24995,3578738861,3578738875,14
1,1124,24996,3578738861,3578738878,17
1,1124,24997,3578738861,3578738878,17
1,1124,24998,3578738861,3578738880,19
1,1124,24999,3578738861,3578738884,23
1,1124,25000,3578738861,3578738885,24
1,1124,25001,3578738861,3578738889,28
1,1124,25002,3578738861,3578738889,28
1,1124,25003,3578738861,3578738890,29
1,1124,25004,3578738861,3578738891,30
1,1124,25005,3578738861,3578738893,32
1,1124,25006,3578738861,3578738893,32
1,1124,25007,3578738861,3578738894,33
1,1124,25008,3578738861,3578738894,33
1,1124,25009,3578738861,3578738895,34
1,1124,25010,3578738861,3578738896,35
1,1124,25011,3578738861,3578738900,39
1,1124,25012,3578738861,3578738901,40
1,1124,25013,3578738861,3578738901,40
1,1124,25014,3578738861,3578738902,41
1,1124,25015,3578738861,3578738903,42
1,1124,25016,3578738861,3578738903,42
1,1124,25017,3578738861,3578738905,44
1,1124,25018,3578738861,3578738905,44
1,1124,25019,3578738861,3578738907,46
1,1124,25020,3578738861,3578738908,47
1,1124,25021,3578738861,3578738908,47
1,1124,25022,3578738861,3578738909,48
1,1124,25023,3578738861,3578738910,49
1,1125,25024,3578738923,3578738923,0
1,1125,25025,3578738923,3578738923,0
1,1125,25026,3578738923,3578738923,0
1,1125,25027,3578738923,3578738923,0
1,1125,25028,3578738923,3578738923,0
1,1125,25029,3578738923,3578738923,0
1,1125,25030,3578738923,3578738923,0
1,1125,25031,3578738923,3578738923,0
1,1125,25032,3578738923,3578738923,0
1,1125,25033,3578738923,3578738923,0
1,1125,25034,3578738923,3578738923,0
1,1125,25035,3578738923,3578738923,0
1,1125,25036,3578738923,3578738923,0
1,1125,25037,3578738923,3578738923,0
1,1125,25038,3578738923,3578738923,0
1,1125,25039,3578738923,3578738923,0
1,1125,25040,3578738923,3578738923,0
1,1125,25041,3578738923,3578738923,0
1,1125,25042,3578738923,3578738923,0
1,1125,25043,3578738923,3578738923,0
1,1125,25044,3578738923,3578738923,0
1,1125,25045,3578738923,3578738923,0
1,1125,25046,3578738923,3578738923,0
1,1125,25047,3578738923,3578738924,1
1,1125,25048,3578738923,3578738924,1
1,1125,25049,3578738923,3578738925,2
1,1125,25050,3578738923,3578738927,4
1,1125,25051,3578738923,3578738928,5
1,1125,25052,3578738923,3578738929,6
1,1125,25053,3578738923,3578738929,6
1,1125,25054,3578738923,3578738929,6
1,1125,25055,3578738923,3578738930,7
1,1125,25056,3578738923,3578738930,7
1,1125,25057,3578738923,3578738930,7
1,1125,25058,3578738923,3578738931,8
1,1125,25059,3578738923,3578738931,8
1,1125,25060,3578738923,3578738932,9
1,1125,25061,3578738923,3578738932,9
1,1125,25062,3578738923,3578738932,9
1,1125,25063,3578738923,3578738932,9
1,1125,25064,3578738923,3578738934,11
1,1125,25065,3578738923,3578738935,12
1,1125,25066,3578738923,3578738935,12
1,1125,25067,3578738923,3578738935,12
1,1125,25068,3578738923,3578738937,14
1,1125,25069,3578738923,3578738938,15
1,1125,25070,3578738923,3578738939,16
1,1125,25071,3578738923,3578738941,18
1,1125,25072,3578738923,3578738946,23
1,1125,25073,3578738923,3578738947,24
1,1125,25074,3578738923,3578738947,24
1,1125,25075,3578738923,3578738948,25
1,1125,25076,3578738923,3578738951,28
1,1125,25077,3578738923,3578738952,29
1,1125,25078,3578738923,3578738952,29
1,1125,25079,3578738923,3578738953,30
1,1125,25080,3578738923,3578738955,32
1,1125,25081,3578738923,3578738955,32
1,1125,25082,3578738923,3578738956,33
1,1125,25083,3578738923,3578738956,33
1,1125,25084,3578738923,3578738956,33
1,1125,25085,3578738923,3578738958,35
1,1125,25086,3578738923,3578738958,35
1,1125,25087,3578738923,3578738962,39
1,1125,25088,3578738923,3578738962,39
1,1125,25089,3578738923,3578738963,40
1,1125,25090,3578738923,3578738963,40
1,1125,25091,3578738923,3578738963,40
1,1125,25092,3578738923,3578738965,42
1,1125,25093,3578738923,3578738965,42
1,1125,25094,3578738923,3578738966,43
1,1125,25095,3578738923,3578738967,44
1,1125,25096,3578738923,3578738968,45
1,1125,25097,3578738923,3578738968,45
1,1125,25098,3578738923,3578738969,46
1,1125,25099,3578738923,3578738971,48
1,1126,25100,3578738986,3578738986,0
1,1126,25101,3578738986,3578738986,0
1,1126,25102,3578738986,3578738986,0
1,1126,25103,3578738986,3578738986,0
1,1126,25104,3578738986,3578738986,0
1,1126,25105,3578738986,3578738986,0
1,1126,25106,3578738986,3578738986,0
1,1126,25107,3578738986,3578738986,0
1,1126,25108,3578738986,3578738986,0
1,1126,25109,3578738986,3578738986,0
1,1126,25110,3578738986,3578738986,0
1,1126,25111,3578738986,3578738986,0
1,1126,25112,3578738986,3578738988,2
1,1126,25113,3578738986,3578738989,3
1,1126,25114,3578738986,3578738989,3
1,1126,25115,3578738986,3578738991,5
1,1126,25116,3578738986,3578738992,6
1,1126,25117,3578738986,3578738992,6
1,1126,25118,3578738986,3578738993,7
1,1126,25119,3578738986,3578738993,7
1,1126,25120,3578738986,3578738994,8
1,1126,25121,3578738986,3578738996,10
1,1126,25122,3578738986,3578738997,11
1,1126,25123,3578738986,3578738997,11
1,1126,25124,3578738986,3578738998,12
1,1126,25125,3578738986,3578738998,12
1,1126,25126,3578738986,3578738999,13
1,1126,25127,3578738986,3578738999,13
1,1126,25128,3578738986,3578739000,14
1,1126,25129,3578738986,3578739001,15
1,1126,25130,3578738986,3578739002,16
1,1126,25131,3578738986,3578739003,17
1,1126,25132,3578738986,3578739004,18
1,1126,25133,3578738986,3578739008,22
1,1126,25134,3578738986,3578739009,23
1,1126,25135,3578738986,3578739011,25
1,1126,25136,3578738986,3578739013,27
1,1126,25137,3578738986,3578739013,27
1,1126,25138,3578738986,3578739015,29
1,1126,25139,3578738986,3578739015,29
1,1126,25140,3578738986,3578739016,30
1,1126,25141,3578738986,3578739017,31
1,1126,25142,3578738986,3578739017,31
1,1126,25143,3578738986,3578739018,32
1,1126,25144,3578738986,3578739019,33
1,1126,25145,3578738986,3578739019,33
1,1126,25146,3578738986,3578739021,35
1,1126,25147,3578738986,3578739023,37
1,1126,25148,3578738986,3578739024,38
1,1126,25149,3578738986,3578739024,38
1,1126,25150,3578738986,3578739024,38
1,1126,25151,3578738986,3578739025,39
1,1126,25152,3578738986,3578739027,41
1,1126,25153,3578738986,3578739027,41
1,1126,25154,3578738986,3578739028,42
1,1126,25155,3578738986,3578739028,42
1,1126,25156,3578738986,3578739029,43
1,1126,25157,3578738986,3578739029,43
1,1126,25158,3578738986,3578739030,44
1,1126,25159,3578738986,3578739030,44
1,1126,25160,3578738986,3578739030,44
1,1126,25161,3578738986,3578739031,45
1,1126,25162,3578738986,3578739032,46
1,1127,25163,3578739048,3578739048,0
1,1127,25164,3578739048,3578739048,0
1,1127,25165,3578739048,3578739048,0
1,1127,25166,3578739048,3578739048,0
1,1127,25167,3578739048,3578739048,0
1,1127,25168,3578739048,3578739048,0
1,1127,25169,3578739048,3578739048,0
1,1127,25170,3578739048,3578739048,0
1,1127,25171,3578739048,3578739048,0
1,1127,25172,3578739048,3578739048,0
1,1127,25173,3578739048,3578739049,1
1,1127,25174,3578739048,3578739050,2
1,1127,25175,3578739048,3578739051,3
1,1127,25176,3578739048,3578739052,4
1,1127,25177,3578739048,3578739052,4
1,1127,25178,3578739048,3578739054,6
1,1127,25179,3578739048,3578739056,8
1,1127,25180,3578739048,3578739059,11
1,1127,25181,3578739048,3578739059,11
1,1127,25182,3578739048,3578739062,14
1,1127,25183,3578739048,3578739063,15
1,1127,25184,3578739048,3578739063,15
1,1127,25185,3578739048,3578739065,17
1,1127,25186,3578739048,3578739065,17
1,1127,25187,3578739048,3578739065,17
1,1127,25188,3578739048,3578739065,17
1,1127,25189,3578739048,3578739065,17
1,1127,25190,3578739048,3578739067,19
1,1127,25191,3578739048,3578739068,20
1,1127,25192,3578739048,3578739068,20
1,1127,25193,3578739048,3578739068,20
1,1127,25194,3578739048,3578739069,21
1,1127,25195,3578739048,3578739073,25
1,1127,25196,3578739048,3578739075,27
1,1127,25197,3578739048,3578739078,30
1,1127,25198,3578739048,3578739078,30
1,1127,25199,3578739048,3578739081,33
1,1127,25200,3578739048,3578739084,36
1,1127,25201,3578739048,3578739085,37
1,1127,25202,3578739048,3578739089,41
1,1127,25203,3578739048,3578739090,42
1,1127,25204,3578739048,3578739090,42
1,1127,25205,3578739048,3578739092,44
1,1127,25206,3578739048,3578739093,45
1,1127,25207,3578739048,3578739093,45
1,1127,25208,3578739048,3578739094,46
1,1127,25209,3578739048,3578739094,46
1,1127,25210,3578739048,3578739095,47
1,1127,25211,3578739048,3578739096,48
1,1128,25212,3578739114,3578739114,0
1,1128,25213,3578739114,3578739114,0
1,1128,25214,3578739114,3578739114,0
1,1128,25215,3578739114,3578739114,0
1,1128,25216,3578739114,3578739114,0
1,1128,25217,3578739114,3578739114,0
1,1128,25218,3578739114,3578739114,0
1,1128,25219,3578739114,3578739114,0
1,1128,25220,3578739114,3578739114,0
1,1128,25221,3578739114,3578739114,0
1,1128,25222,3578739114,3578739114,0
1,1128,25223,3578739114,3578739114,0
1,1128,25224,3578739114,3578739114,0
1,1128,25225,3578739114,3578739114,0
1,1128,25226,3578739114,3578739114,0
1,1128,25227,3578739114,3578739114,0
1,1128,25228,3578739114,3578739114,0
1,1128,25229,3578739114,3578739114,0
1,1128,25230,3578739114,3578739114,0
1,1128,25231,3578739114,3578739115,1
1,1128,25232,3578739114,3578739115,1
1,1128,25233,3578739114,3578739115,1
1,1128,25234,3578739114,3578739117,3
1,1128,25235,3578739114,3578739118,4
1,1128,25236,3578739114,3578739118,4
1,1128,25237,3578739114,3578739119,5
1,1128,25238,3578739114,3578739120,6
1,1128,25239,3578739114,3578739120,6
1,1128,25240,3578739114,3578739120,6
1,1128,25241,3578739114,3578739122,8
1,1128,25242,3578739114,3578739122,8
1,1128,25243,3578739114,3578739122,8
1,1128,25244,3578739114,3578739124,10
1,1128,25245,3578739114,3578739125,11
1,1128,25246,3578739114,3578739125,11
1,1128,25247,3578739114,3578739127,13
1,1128,25248,3578739114,3578739127,13
1,1128,25249,3578739114,3578739129,15
1,1128,25250,3578739114,3578739129,15
1,1128,25251,3578739114,3578739129,15
1,1128,25252,3578739114,3578739129,15
1,1128,25253,3578739114,3578739129,15
1,1128,25254,3578739114,3578739130,16
1,1128,25255,3578739114,3578739130,16
1,1128,25256,3578739114,3578739131,17
1,1128,25257,3578739114,3578739131,17
1,1128,25258,3578739114,3578739132,18
1,1128,25259,3578739114,3578739133,19
1,1128,25260,3578739114,3578739133,19
1,1128,25261,3578739114,3578739134,20
1,1128,25262,3578739114,3578739134,20
1,1128,25263,3578739114,3578739134,20
1,1128,25264,3578739114,3578739135,21
1,1128,25265,3578739114,3578739135,21
1,1128,25266,3578739114,3578739136,22
1,1128,25267,3578739114,3578739137,23
1,1128,25268,3578739114,3578739139,25
1,1128,25269,3578739114,3578739141,27
1,1128,25270,3578739114,3578739142,28
1,1128,25271,3578739114,3578739146,32
1,1128,25272,3578739114,3578739146,32
1,1128,25273,3578739114,3578739147,33
1,1128,25274,3578739114,3578739148,34
1,1128,25275,3578739114,3578739148,34
1,1128,25276,3578739114,3578739151,37
1,1128,25277,3578739114,3578739152,38
1,1128,25278,3578739114,3578739153,39
1,1128,25279,3578739114,3578739155,41
1,1128,25280,3578739114,3578739155,41
1,1128,25281,3578739114,3578739156,42
1,1128,25282,3578739114,3578739156,42
1,1128,25283,3578739114,3578739157,43
1,1128,25284,3578739114,3578739158,44
1,1128,25285,3578739114,3578739159,45
1,1128,25286,3578739114,3578739162,48
1,1128,25287,3578739114,3578739162,48
1,1128,25288,3578739114,3578739163,49
1,1128,25289,3578739114,3578739164,50
1,1129,25290,3578739178,3578739178,0
1,1129,25291,3578739178,3578739178,0
1,1129,25292,3578739178,3578739178,0
1,1129,25293,3578739178,3578739178,0
1,1129,25294,3578739178,3578739178,0
1,1129,25295,3578739178,3578739178,0
1,1129,25296,3578739178,3578739178,0
1,1129,25297,3578739178,3578739178,0
1,1129,25298,3578739178,3578739178,0
1,1129,25299,3578739178,3578739178,0
1,1129,25300,3578739178,3578739178,0
1,1129,25301,3578739178,3578739178,0
1,1129,25302,3578739178,3578739179,1
1,1129,25303,3578739178,3578739179,1
1,1129,25304,3578739178,3578739180,2
1,1129,25305,3578739178,3578739182,4
1,1129,25306,3578739178,3578739182,4
1,1129,25307,3578739178,3578739183,5
1,1129,25308,3578739178,3578739183,5
1,1129,25309,3578739178,3578739183,5
1,1129,25310,3578739178,3578739185,7
1,1129,25311,3578739178,3578739185,7
1,1129,25312,3578739178,3578739189,11
1,1129,25313,3578739178,3578739189,11
1,1129,25314,3578739178,3578739190,12
1,1129,25315,3578739178,3578739191,13
1,1129,25316,3578739178,3578739192,14
1,1129,25317,3578739178,3578739193,15
1,1129,25318,3578739178,3578739194,16
1,1129,25319,3578739178,3578739196,18
1,1129,25320,3578739178,3578739198,20
1,1129,25321,3578739178,3578739198,20
1,1129,25322,3578739178,3578739199,21
1,1129,25323,3578739178,3578739201,23
1,1129,25324,3578739178,3578739201,23
1,1129,25325,3578739178,3578739202,24
1,1129,25326,3578739178,3578739204,26
1,1129,25327,3578739178,3578739204,26
1,1129,25328,3578739178,3578739208,30
1,1129,25329,3578739178,3578739209,31
1,1129,25330,3578739178,3578739211,33
1,1129,25331,3578739178,3578739213,35
1,1129,25332,3578739178,3578739214,36
1,1129,25333,3578739178,3578739215,37
1,1129,25334,3578739178,3578739215,37
1,1129,25335,3578739178,3578739217,39
1,1129,25336,3578739178,3578739217,39
1,1129,25337,3578739178,3578739217,39
1,1129,25338,3578739178,3578739218,40
1,1129,25339,3578739178,3578739219,41
1,1129,25340,3578739178,3578739220,42
1,1129,25341,3578739178,3578739220,42
1,1129,25342,3578739178,3578739221,43
1,1129,25343,3578739178,3578739223,45
1,1129,25344,3578739178,3578739224,46
1,1129,25345,3578739178,3578739224,46
1,1129,25346,3578739178,3578739225,47
1,1129,25347,3578739178,3578739227,49
1,1129,25348,3578739178,3578739228,50
1,1130,25349,3578739238,3578739238,0
1,1130,25350,3578739238,3578739238,0
1,1130,25351,3578739238,3578739238,0
1,1130,25352,3578739238,3578739238,0
1,1130,25353,3578739238,3578739238,0
1,1130,25354,3578739238,3578739239,1
1,1130,25355,3578739238,3578739239,1
1,1130,25356,3578739238,3578739239,1
1,1130,25357,3578739238,3578739239,1
1,1130,25358,3578739238,3578739239,1
1,1130,25359,3578739238,3578739239,1
1,1130,25360,3578739238,3578739239,1
1,1130,25361,3578739238,3578739239,1
1,1130,25362,3578739238,3578739239,1
1,1130,25363,3578739238,3578739239,1
1,1130,25364,3578739238,3578739241,3
1,1130,25365,3578739238,3578739241,3
1,1130,25366,3578739238,3578739245,7
1,1130,25367,3578739238,3578739246,8
1,1130,25368,3578739238,3578739247,9
1,1130,25369,3578739238,3578739247,9
1,1130,25370,3578739238,3578739249,11
1,1130,25371,3578739238,3578739249,11
1,1130,25372,3578739238,3578739251,13
1,1130,25373,3578739238,3578739252,14
1,1130,25374,3578739238,3578739252,14
1,1130,25375,3578739238,3578739253,15
1,1130,25376,3578739238,3578739254,16
1,1130,25377,3578739238,3578739256,18
1,1130,25378,3578739238,3578739259,21
1,1130,25379,3578739238,3578739259,21
1,1130,25380,3578739238,3578739260,22
1,1130,25381,3578739238,3578739263,25
1,1130,25382,3578739238,3578739265,27
1,1130,25383,3578739238,3578739265,27
1,1130,25384,3578739238,3578739267,29
1,1130,25385,3578739238,3578739268,30
1,1130,25386,3578739238,3578739268,30
1,1130,25387,3578739238,3578739270,32
1,1130,25388,3578739238,3578739273,35
1,1130,25389,3578739238,3578739275,37
1,1130,25390,3578739238,3578739278,40
1,1130,25391,3578739238,3578739278,40
1,1130,25392,3578739238,3578739279,41
1,1130,25393,3578739238,3578739281,43
1,1130,25394,3578739238,3578739283,45
1,1130,25395,3578739238,3578739285,47
1,1131,25396,3578739298,3578739298,0
1,1131,25397,3578739298,3578739298,0
1,1131,25398,3578739298,3578739298,0
1,1131,25399,3578739298,3578739298,0
1,1131,25400,3578739298,3578739298,0
1,1131,25401,3578739298,3578739298,0
1,1131,25402,3578739298,3578739298,0
1,1131,25403,3578739298,3578739298,0
1,1131,25404,3578739298,3578739298,0
1,1131,25405,3578739298,3578739300,2
1,1131,25406,3578739298,3578739301,3
1,1131,25407,3578739298,3578739302,4
1,1131,25408,3578739298,3578739303,5
1,1131,25409,3578739298,3578739304,6
1,1131,25410,3578739298,3578739306,8
1,1131,25411,3578739298,3578739307,9
1,1131,25412,3578739298,3578739308,10
1,1131,25413,3578739298,3578739309,11
1,1131,25414,3578739298,3578739310,12
1,1131,25415,3578739298,3578739311,13
1,1131,25416,3578739298,3578739311,13
1,1131,25417,3578739298,3578739312,14
1,1131,25418,3578739298,3578739312,14
1,1131,25419,3578739298,3578739312,14
1,1131,25420,3578739298,3578739312,14
1,1131,25421,3578739298,3578739312,14
1,1131,25422,3578739298,3578739314,16
1,1131,25423,3578739298,3578739314,16
1,1131,25424,3578739298,3578739314,16
1,1131,25425,3578739298,3578739314,16
1,1131,25426,3578739298,3578739315,17
1,1131,25427,3578739298,3578739315,17
1,1131,25428,3578739298,3578739317,19
1,1131,25429,3578739298,3578739317,19
1,1131,25430,3578739298,3578739319,21
1,1131,25431,3578739298,3578739319,21
1,1131,25432,3578739298,3578739319,21
1,1131,25433,3578739298,3578739320,22
1,1131,25434,3578739298,3578739321,23
1,1131,25435,3578739298,3578739322,24
1,1131,25436,3578739298,3578739322,24
1,1131,25437,3578739298,3578739323,25
1,1131,25438,3578739298,3578739324,26
1,1131,25439,3578739298,3578739325,27
1,1131,25440,3578739298,3578739325,27
1,1131,25441,3578739298,3578739327,29
1,1131,25442,3578739298,3578739328,30
1,1131,25443,3578739298,3578739329,31
1,1131,25444,3578739298,3578739329,31
1,1131,25445,3578739298,3578739330,32
1,1131,25446,3578739298,3578739330,32
1,1131,25447,3578739298,3578739330,32
1,1131,25448,3578739298,3578739330,32
1,1131,25449,3578739298,3578739330,32
1,1131,25450,3578739298,3578739331,33
1,1131,25451,3578739298,3578739331,33
1,1131,25452,3578739298,3578739332,34
1,1131,25453,3578739298,3578739332,34
1,1131,25454,3578739298,3578739332,34
1,1131,25455,3578739298,3578739333,35
1,1131,25456,3578739298,3578739334,36
1,1131,25457,3578739298,3578739334,36
1,1131,25458,3578739298,3578739334,36
1,1131,25459,3578739298,3578739335,37
1,1131,25460,3578739298,3578739336,38
1,1131,25461,3578739298,3578739336,38
1,1131,25462,3578739298,3578739337,39
1,1131,25463,3578739298,3578739339,41
1,1131,25464,3578739298,3578739339,41
1,1131,25465,3578739298,3578739346,48
1,1131,25466,3578739298,3578739346,48
1,1131,25467,3578739298,3578739347,49
1,1131,25468,3578739298,3578739348,50
1,1132,25469,3578739360,3578739360,0
1,1132,25470,3578739360,3578739360,0
1,1132,25471,3578739360,3578739360,0
1,1132,25472,3578739360,3578739360,0
1,1132,25473,3578739360,3578739360,0
1,1132,25474,3578739360,3578739360,0
1,1132,25475,3578739360,3578739360,0
1,1132,25476,3578739360,3578739360,0
1,1132,25477,3578739360,3578739360,0
1,1132,25478,3578739360,3578739360,0
1,1132,25479,3578739360,3578739362,2
1,1132,25480,3578739360,3578739362,2
1,1132,25481,3578739360,3578739364,4
1,1132,25482,3578739360,3578739365,5
1,1132,25483,3578739360,3578739365,5
1,1132,25484,3578739360,3578739366,6
1,1132,25485,3578739360,3578739367,7
1,1132,25486,3578739360,3578739368,8
1,1132,25487,3578739360,3578739368,8
1,1132,25488,3578739360,3578739368,8
1,1132,25489,3578739360,3578739369,9
1,1132,25490,3578739360,3578739370,10
1,1132,25491,3578739360,3578739371,11
1,1132,25492,3578739360,3578739372,12
1,1132,25493,3578739360,3578739374,14
1,1132,25494,3578739360,3578739376,16
1,1132,25495,3578739360,3578739380,20
1,1132,25496,3578739360,3578739381,21
1,1132,25497,3578739360,3578739381,21
1,1132,25498,3578739360,3578739381,21
1,1132,25499,3578739360,3578739382,22
1,1132,25500,3578739360,3578739382,22
1,1132,25501,3578739360,3578739383,23
1,1132,25502,3578739360,3578739383,23
1,1132,25503,3578739360,3578739385,25
1,1132,25504,3578739360,3578739386,26
1,1132,25505,3578739360,3578739387,27
1,1132,25506,3578739360,3578739387,27
1,1132,25507,3578739360,3578739389,29
1,1132,25508,3578739360,3578739390,30
1,1132,25509,3578739360,3578739392,32
1,1132,25510,3578739360,3578739393,33
1,1132,25511,3578739360,3578739393,33
1,1132,25512,3578739360,3578739393,33
1,1132,25513,3578739360,3578739394,34
1,1132,25514,3578739360,3578739397,37
1,1132,25515,3578739360,3578739398,38
1,1132,25516,3578739360,3578739398,38
1,1132,25517,3578739360,3578739398,38
1,1132,25518,3578739360,3578739399,39
1,1132,25519,3578739360,3578739399,39
1,1132,25520,3578739360,3578739399,39
1,1132,25521,3578739360,3578739399,39
1,1132,25522,3578739360,3578739401,41
1,1132,25523,3578739360,3578739402,42
1,1132,25524,3578739360,3578739402,42
1,1132,25525,3578739360,3578739404,44
1,1132,25526,3578739360,3578739404,44
1,1132,25527,3578739360,3578739408,48
1,1132,25528,3578739360,3578739409,49
1,1133,25529,3578739427,3578739427,0
1,1133,25530,3578739427,3578739427,0
1,1133,25531,3578739427,3578739427,0
1,1133,25532,3578739427,3578739427,0
1,1133,25533,3578739427,3578739427,0
1,1133,25534,3578739427,3578739427,0
1,1133,25535,3578739427,3578739427,0
1,1133,25536,3578739427,3578739427,0
1,1133,25537,3578739427,3578739427,0
1,1133,25538,3578739427,3578739427,0
1,1133,25539,3578739427,3578739427,0
1,1133,25540,3578739427,3578739427,0
1,1133,25541,3578739427,3578739427,0
1,1133,25542,3578739427,3578739427,0
1,1133,25543,3578739427,3578739427,0
1,1133,25544,3578739427,3578739427,0
1,1133,25545,3578739427,3578739428,1
1,1133,25546,3578739427,3578739428,1
1,1133,25547,3578739427,3578739428,1
1,1133,25548,3578739427,3578739429,2
1,1133,25549,3578739427,3578739430,3
1,1133,25550,3578739427,3578739430,3
1,1133,25551,3578739427,3578739430,3
1,1133,25552,3578739427,3578739431,4
1,1133,25553,3578739427,3578739432,5
1,1133,25554,3578739427,3578739432,5
1,1133,25555,3578739427,3578739436,9
1,1133,25556,3578739427,3578739437,10
1,1133,25557,3578739427,3578739437,10
1,1133,25558,3578739427,3578739437,10
1,1133,25559,3578739427,3578739439,12
1,1133,25560,3578739427,3578739440,13
1,1133,25561,3578739427,3578739441,14
1,1133,25562,3578739427,3578739445,18
1,1133,25563,3578739427,3578739447,20
1,1133,25564,3578739427,3578739448,21
1,1133,25565,3578739427,3578739449,22
1,1133,25566,3578739427,3578739449,22
1,1133,25567,3578739427,3578739449,22
1,1133,25568,3578739427,3578739452,25
1,1133,25569,3578739427,3578739452,25
1,1133,25570,3578739427,3578739452,25
1,1133,25571,3578739427,3578739454,27
1,1133,25572,3578739427,3578739454,27
1,1133,25573,3578739427,3578739456,29
1,1133,25574,3578739427,3578739458,31
1,1133,25575,3578739427,3578739459,32
1,1133,25576,3578739427,3578739459,32
1,1133,25577,3578739427,3578739462,35
1,1133,25578,3578739427,3578739463,36
1,1133,25579,3578739427,3578739463,36
1,1133,25580,3578739427,3578739465,38
1,1133,25581,3578739427,3578739465,38
1,1133,25582,3578739427,3578739465,38
1,1133,25583,3578739427,3578739466,39
1,1133,25584,3578739427,3578739467,40
1,1133,25585,3578739427,3578739469,42
1,1133,25586,3578739427,3578739470,43
1,1133,25587,3578739427,3578739473,46
1,1133,25588,3578739427,3578739475,48
1,1134,25589,3578739490,3578739490,0
1,1134,25590,3578739490,3578739490,0
1,1134,25591,3578739490,3578739490,0
1,1134,25592,3578739490,3578739490,0
1,1134,25593,3578739490,3578739490,0
1,1134,25594,3578739490,3578739490,0
1,1134,25595,3578739490,3578739490,0
1,1134,25596,3578739490,3578739490,0
1,1134,25597,3578739490,3578739490,0
1,1134,25598,3578739490,3578739492,2
1,1134,25599,3578739490,3578739493,3
1,1134,25600,3578739490,3578739493,3
1,1134,25601,3578739490,3578739494,4
1,1134,25602,3578739490,3578739494,4
1,1134,25603,3578739490,3578739499,9
1,1134,25604,3578739490,3578739500,10
1,1134,25605,3578739490,3578739501,11
1,1134,25606,3578739490,3578739501,11
1,1134,25607,3578739490,3578739502,12
1,1134,25608,3578739490,3578739503,13
1,1134,25609,3578739490,3578739504,14
1,1134,25610,3578739490,3578739507,17
1,1134,25611,3578739490,3578739509,19
1,1134,25612,3578739490,3578739510,20
1,1134,25613,3578739490,3578739511,21
1,1134,25614,3578739490,3578739511,21
1,1134,25615,3578739490,3578739511,21
1,1134,25616,3578739490,3578739512,22
1,1134,25617,3578739490,3578739512,22
1,1134,25618,3578739490,3578739513,23
1,1134,25619,3578739490,3578739513,23
1,1134,25620,3578739490,3578739513,23
1,1134,25621,3578739490,3578739513,23
1,1134,25622,3578739490,3578739514,24
1,1134,25623,3578739490,3578739514,24
1,1134,25624,3578739490,3578739516,26
1,1134,25625,3578739490,3578739516,26
1,1134,25626,3578739490,3578739516,26
1,1134,25627,3578739490,3578739518,28
1,1134,25628,3578739490,3578739518,28
1,1134,25629,3578739490,3578739518,28
1,1134,25630,3578739490,3578739519,29
1,1134,25631,3578739490,3578739520,30
1,1134,25632,3578739490,3578739521,31
1,1134,25633,3578739490,3578739521,31
1,1134,25634,3578739490,3578739521,31
1,1134,25635,3578739490,3578739521,31
1,1134,25636,3578739490,3578739524,34
1,1134,25637,3578739490,3578739524,34
1,1134,25638,3578739490,3578739524,34
1,1134,25639,3578739490,3578739526,36
1,1134,25640,3578739490,3578739528,38
1,1134,25641,3578739490,3578739529,39
1,1134,25642,3578739490,3578739529,39
1,1134,25643,3578739490,3578739530,40
1,1134,25644,3578739490,3578739530,40
1,1134,25645,3578739490,3578739530,40
1,1134,25646,3578739490,3578739530,40
1,1134,25647,3578739490,3578739530,40
1,1134,25648,3578739490,3578739531,41
1,1134,25649,3578739490,3578739531,41
1,1134,25650,3578739490,3578739532,42
1,1134,25651,3578739490,3578739533,43
1,1134,25652,3578739490,3578739533,43
1,1134,25653,3578739490,3578739534,44
1,1134,25654,3578739490,3578739535,45
1,1134,25655,3578739490,3578739535,45
1,1134,25656,3578739490,3578739536,46
1,1134,25657,3578739490,3578739537,47
1,1134,25658,3578739490,3578739538,48
1,1134,25659,3578739490,3578739540,50
1,1135,25660,3578739551,3578739551,0
1,1135,25661,3578739551,3578739551,0
1,1135,25662,3578739551,3578739551,0
1,1135,25663,3578739551,3578739551,0
1,1135,25664,3578739551,3578739551,0
1,1135,25665,3578739551,3578739551,0
1,1135,25666,3578739551,3578739551,0
1,1135,25667,3578739551,3578739552,1
1,1135,25668,3578739551,3578739554,3
1,1135,25669,3578739551,3578739554,3
1,1135,25670,3578739551,3578739555,4
1,1135,25671,3578739551,3578739556,5
1,1135,25672,3578739551,3578739556,5
1,1135,25673,3578739551,3578739557,6
1,1135,25674,3578739551,3578739558,7
1,1135,25675,3578739551,3578739560,9
1,1135,25676,3578739551,3578739562,11
1,1135,25677,3578739551,3578739565,14
1,1135,25678,3578739551,3578739565,14
1,1135,25679,3578739551,3578739566,15
1,1135,25680,3578739551,3578739566,15
1,1135,25681,3578739551,3578739566,15
1,1135,25682,3578739551,3578739567,16
1,1135,25683,3578739551,3578739567,16
1,1135,25684,3578739551,3578739568,17
1,1135,25685,3578739551,3578739568,17
1,1135,25686,3578739551,3578739569,18
1,1135,25687,3578739551,3578739571,20
1,1135,25688,3578739551,3578739574,23
1,1135,25689,3578739551,3578739574,23
1,1135,25690,3578739551,3578739574,23
1,1135,25691,3578739551,3578739578,27
1,1135,25692,3578739551,3578739579,28
1,1135,25693,3578739551,3578739580,29
1,1135,25694,3578739551,3578739581,30
1,1135,25695,3578739551,3578739581,30
1,1135,25696,3578739551,3578739582,31
1,1135,25697,3578739551,3578739582,31
1,1135,25698,3578739551,3578739583,32
1,1135,25699,3578739551,3578739584,33
1,1135,25700,3578739551,3578739585,34
1,1135,25701,3578739551,3578739588,37
1,1135,25702,3578739551,3578739588,37
1,1135,25703,3578739551,3578739589,38
1,1135,25704,3578739551,3578739591,40
1,1135,25705,3578739551,3578739592,41
1,1135,25706,3578739551,3578739592,41
1,1135,25707,3578739551,3578739593,42
1,1135,25708,3578739551,3578739596,45
1,1135,25709,3578739551,3578739597,46
1,1135,25710,3578739551,3578739597,46
1,1135,25711,3578739551,3578739598,47
1,1135,25712,3578739551,3578739598,47
1,1135,25713,3578739551,3578739598,47
1,1135,25714,3578739551,3578739600,49
1,1135,25715,3578739551,3578739600,49
1,1136,25716,3578739613,3578739613,0
1,1136,25717,3578739613,3578739613,0
1,1136,25718,3578739613,3578739613,0
1,1136,25719,3578739613,3578739613,0
1,1136,25720,3578739613,3578739613,0
1,1136,25721,3578739613,3578739613,0
1,1136,25722,3578739613,3578739613,0
1,1136,25723,3578739613,3578739614,1
1,1136,25724,3578739613,3578739615,2
1,1136,25725,3578739613,3578739616,3
1,1136,25726,3578739613,3578739617,4
1,1136,25727,3578739613,3578739617,4
1,1136,25728,3578739613,3578739617,4
1,1136,25729,3578739613,3578739618,5
1,1136,25730,3578739613,3578739618,5
1,1136,25731,3578739613,3578739619,6
1,1136,25732,3578739613,3578739619,6
1,1136,25733,3578739613,3578739621,8
1,1136,25734,3578739613,3578739623,10
1,1136,25735,3578739613,3578739624,11
1,1136,25736,3578739613,3578739624,11
1,1136,25737,3578739613,3578739624,11
1,1136,25738,3578739613,3578739626,13
1,1136,25739,3578739613,3578739627,14
1,1136,25740,3578739613,3578739628,15
1,1136,25741,3578739613,3578739628,15
1,1136,25742,3578739613,3578739628,15
1,1136,25743,3578739613,3578739628,15
1,1136,25744,3578739613,3578739629,16
1,1136,25745,3578739613,3578739630,17
1,1136,25746,3578739613,3578739630,17
1,1136,25747,3578739613,3578739631,18
1,1136,25748,3578739613,3578739631,18
1,1136,25749,3578739613,3578739635,22
1,1136,25750,3578739613,3578739636,23
1,1136,25751,3578739613,3578739636,23
1,1136,25752,3578739613,3578739636,23
1,1136,25753,3578739613,3578739639,26
1,1136,25754,3578739613,3578739640,27
1,1136,25755,3578739613,3578739640,27
1,1136,25756,3578739613,3578739644,31
1,1136,25757,3578739613,3578739646,33
1,1136,25758,3578739613,3578739648,35
1,1136,25759,3578739613,3578739648,35
1,1136,25760,3578739613,3578739648,35
1,1136,25761,3578739613,3578739649,36
1,1136,25762,3578739613,3578739651,38
1,1136,25763,3578739613,3578739651,38
1,1136,25764,3578739613,3578739651,38
1,1136,25765,3578739613,3578739652,39
1,1136,25766,3578739613,3578739655,42
1,1136,25767,3578739613,3578739655,42
1,1136,25768,3578739613,3578739659,46
1,1136,25769,3578739613,3578739659,46
1,1136,25770,3578739613,3578739659,46
1,1136,25771,3578739613,3578739662,49
1,1136,25772,3578739613,3578739662,49
1,1136,25773,3578739613,3578739662,49
1,1137,25774,3578739674,3578739675,1
1,1137,25775,3578739674,3578739675,1
1,1137,25776,3578739674,3578739675,1
1,1137,25777,3578739674,3578739675,1
1,1137,25778,3578739674,3578739675,1
1,1137,25779,3578739674,3578739675,1
1,1137,25780,3578739674,3578739675,1
1,1137,25781,3578739674,3578739675,1
1,1137,25782,3578739674,3578739680,6
1,1137,25783,3578739674,3578739680,6
1,1137,25784,3578739674,3578739681,7
1,1137,25785,3578739674,3578739684,10
1,1137,25786,3578739674,3578739685,11
1,1137,25787,3578739674,3578739686,12
1,1137,25788,3578739674,3578739687,13
1,1137,25789,3578739674,3578739689,15
1,1137,25790,3578739674,3578739690,16
1,1137,25791,3578739674,3578739690,16
1,1137,25792,3578739674,3578739691,17
1,1137,25793,3578739674,3578739692,18
1,1137,25794,3578739674,3578739693,19
1,1137,25795,3578739674,3578739693,19
1,1137,25796,3578739674,3578739693,19
1,1137,25797,3578739674,3578739693,19
1,1137,25798,3578739674,3578739694,20
1,1137,25799,3578739674,3578739695,21
1,1137,25800,3578739674,3578739699,25
1,1137,25801,3578739674,3578739699,25
1,1137,25802,3578739674,3578739702,28
1,1137,25803,3578739674,3578739702,28
1,1137,25804,3578739674,3578739704,30
1,1137,25805,3578739674,3578739705,31
1,1137,25806,3578739674,3578739707,33
1,1137,25807,3578739674,3578739708,34
1,1137,25808,3578739674,3578739710,36
1,1137,25809,3578739674,3578739711,37
1,1137,25810,3578739674,3578739711,37
1,1137,25811,3578739674,3578739711,37
1,1137,25812,3578739674,3578739711,37
1,1137,25813,3578739674,3578739711,37
1,1137,25814,3578739674,3578739712,38
1,1137,25815,3578739674,3578739712,38
1,1137,25816,3578739674,3578739712,38
1,1137,25817,3578739674,3578739713,39
1,1137,25818,3578739674,3578739713,39
1,1137,25819,3578739674,3578739713,39
1,1137,25820,3578739674,3578739714,40
1,1137,25821,3578739674,3578739714,40
1,1137,25822,3578739674,3578739714,40
1,1137,25823,3578739674,3578739717,43
1,1137,25824,3578739674,3578739717,43
1,1137,25825,3578739674,3578739718,44
1,1137,25826,3578739674,3578739718,44
1,1137,25827,3578739674,3578739720,46
1,1137,25828,3578739674,3578739721,47
1,1137,25829,3578739674,3578739721,47
1,1137,25830,3578739674,3578739721,47
1,1137,25831,3578739674,3578739721,47
1,1137,25832,3578739674,3578739724,50
1,1138,25833,3578739737,3578739737,0
1,1138,25834,3578739737,3578739737,0
1,1138,25835,3578739737,3578739737,0
1,1138,25836,3578739737,3578739737,0
1,1138,25837,3578739737,3578739737,0
1,1138,25838,3578739737,3578739737,0
1,1138,25839,3578739737,3578739737,0
1,1138,25840,3578739737,3578739737,0
1,1138,25841,3578739737,3578739737,0
1,1138,25842,3578739737,3578739737,0
1,1138,25843,3578739737,3578739737,0
1,1138,25844,3578739737,3578739737,0
1,1138,25845,3578739737,3578739737,0
1,1138,25846,3578739737,3578739737,0
1,1138,25847,3578739737,3578739737,0
1,1138,25848,3578739737,3578739737,0
1,1138,25849,3578739737,3578739737,0
1,1138,25850,3578739737,3578739737,0
1,1138,25851,3578739737,3578739737,0
1,1138,25852,3578739737,3578739737,0
1,1138,25853,3578739737,3578739737,0
1,1138,25854,3578739737,3578739738,1
1,1138,25855,3578739737,3578739738,1
1,1138,25856,3578739737,3578739738,1
1,1138,25857,3578739737,3578739740,3
1,1138,25858,3578739737,3578739745,8
1,1138,25859,3578739737,3578739745,8
1,1138,25860,3578739737,3578739747,10
1,1138,25861,3578739737,3578739747,10
1,1138,25862,3578739737,3578739748,11
1,1138,25863,3578739737,3578739750,13
1,1138,25864,3578739737,3578739751,14
1,1138,25865,3578739737,3578739754,17
1,1138,25866,3578739737,3578739754,17
1,1138,25867,3578739737,3578739756,19
1,1138,25868,3578739737,3578739756,19
1,1138,25869,3578739737,3578739756,19
1,1138,25870,3578739737,3578739758,21
1,1138,25871,3578739737,3578739761,24
1,1138,25872,3578739737,3578739762,25
1,1138,25873,3578739737,3578739763,26
1,1138,25874,3578739737,3578739763,26
1,1138,25875,3578739737,3578739765,28
1,1138,25876,3578739737,3578739765,28
1,1138,25877,3578739737,3578739766,29
1,1138,25878,3578739737,3578739767,30
1,1138,25879,3578739737,3578739767,30
1,1138,25880,3578739737,3578739767,30
1,1138,25881,3578739737,3578739768,31
1,1138,25882,3578739737,3578739769,32
1,1138,25883,3578739737,3578739769,32
1,1138,25884,3578739737,3578739772,35
1,1138,25885,3578739737,3578739774,37
1,1138,25886,3578739737,3578739774,37
1,1138,25887,3578739737,3578739779,42
1,1138,25888,3578739737,3578739779,42
1,1138,25889,3578739737,3578739781,44
1,1138,25890,3578739737,3578739781,44
1,1138,25891,3578739737,3578739782,45
1,1138,25892,3578739737,3578739783,46
1,1138,25893,3578739737,3578739784,47
1,1138,25894,3578739737,3578739785,48
1,1138,25895,3578739737,3578739786,49
1,1139,25896,3578739799,3578739799,0
1,1139,25897,3578739799,3578739799,0
1,1139,25898,3578739799,3578739799,0
1,1139,25899,3578739799,3578739799,0
1,1139,25900,3578739799,3578739799,0
1,1139,25901,3578739799,3578739799,0
1,1139,25902,3578739799,3578739799,0
1,1139,25903,3578739799,3578739799,0
1,1139,25904,3578739799,3578739799,0
1,1139,25905,3578739799,3578739799,0
1,1139,25906,3578739799,3578739799,0
1,1139,25907,3578739799,3578739799,0
1,1139,25908,3578739799,3578739799,0
1,1139,25909,3578739799,3578739799,0
1,1139,25910,3578739799,3578739799,0
1,1139,25911,3578739799,3578739800,1
1,1139,25912,3578739799,3578739800,1
1,1139,25913,3578739799,3578739801,2
1,1139,25914,3578739799,3578739802,3
1,1139,25915,3578739799,3578739805,6
1,1139,25916,3578739799,3578739807,8
1,1139,25917,3578739799,3578739813,14
1,1139,25918,3578739799,3578739814,15
1,1139,25919,3578739799,3578739815,16
1,1139,25920,3578739799,3578739815,16
1,1139,25921,3578739799,3578739815,16
1,1139,25922,3578739799,3578739816,17
1,1139,25923,3578739799,3578739817,18
1,1139,25924,3578739799,3578739818,19
1,1139,25925,3578739799,3578739818,19
1,1139,25926,3578739799,3578739818,19
1,1139,25927,3578739799,3578739820,21
1,1139,25928,3578739799,3578739820,21
1,1139,25929,3578739799,3578739824,25
1,1139,25930,3578739799,3578739824,25
1,1139,25931,3578739799,3578739824,25
1,1139,25932,3578739799,3578739824,25
1,1139,25933,3578739799,3578739824,25
1,1139,25934,3578739799,3578739826,27
1,1139,25935,3578739799,3578739827,28
1,1139,25936,3578739799,3578739828,29
1,1139,25937,3578739799,3578739829,30
1,1139,25938,3578739799,3578739829,30
1,1139,25939,3578739799,3578739829,30
1,1139,25940,3578739799,3578739829,30
1,1139,25941,3578739799,3578739829,30
1,1139,25942,3578739799,3578739830,31
1,1139,25943,3578739799,3578739831,32
1,1139,25944,3578739799,3578739831,32
1,1139,25945,3578739799,3578739835,36
1,1139,25946,3578739799,3578739836,37
1,1139,25947,3578739799,3578739840,41
1,1139,25948,3578739799,3578739841,42
1,1139,25949,3578739799,3578739845,46
1,1139,25950,3578739799,3578739846,47
1,1139,25951,3578739799,3578739847,48
1,1139,25952,3578739799,3578739847,48
1,1139,25953,3578739799,3578739848,49
1,1140,25954,3578739861,3578739861,0
1,1140,25955,3578739861,3578739861,0
1,1140,25956,3578739861,3578739861,0
1,1140,25957,3578739861,3578739861,0
1,1140,25958,3578739861,3578739861,0
1,1140,25959,3578739861,3578739861,0
1,1140,25960,3578739861,3578739861,0
1,1140,25961,3578739861,3578739861,0
1,1140,25962,3578739861,3578739862,1
1,1140,25963,3578739861,3578739863,2
1,1140,25964,3578739861,3578739864,3
1,1140,25965,3578739861,3578739865,4
1,1140,25966,3578739861,3578739868,7
1,1140,25967,3578739861,3578739868,7
1,1140,25968,3578739861,3578739868,7
1,1140,25969,3578739861,3578739868,7
1,1140,25970,3578739861,3578739869,8
1,1140,25971,3578739861,3578739869,8
1,1140,25972,3578739861,3578739869,8
1,1140,25973,3578739861,3578739873,12
1,1140,25974,3578739861,3578739875,14
1,1140,25975,3578739861,3578739880,19
1,1140,25976,3578739861,3578739881,20
1,1140,25977,3578739861,3578739885,24
1,1140,25978,3578739861,3578739887,26
1,1140,25979,3578739861,3578739887,26
1,1140,25980,3578739861,3578739890,29
1,1140,25981,3578739861,3578739891,30
1,1140,25982,3578739861,3578739893,32
1,1140,25983,3578739861,3578739893,32
1,1140,25984,3578739861,3578739894,33
1,1140,25985,3578739861,3578739894,33
1,1140,25986,3578739861,3578739895,34
1,1140,25987,3578739861,3578739895,34
1,1140,25988,3578739861,3578739899,38
1,1140,25989,3578739861,3578739899,38
1,1140,25990,3578739861,3578739902,41
1,1140,25991,3578739861,3578739902,41
1,1140,25992,3578739861,3578739903,42
1,1140,25993,3578739861,3578739904,43
1,1140,25994,3578739861,3578739904,43
1,1140,25995,3578739861,3578739907,46
1,1140,25996,3578739861,3578739908,47
1,1140,25997,3578739861,3578739909,48
1,1141,25998,3578739922,3578739922,0
1,1141,25999,3578739922,3578739922,0
1,1141,26000,3578739922,3578739922,0
1,1141,26001,3578739922,3578739922,0
1,1141,26002,3578739922,3578739922,0
1,1141,26003,3578739922,3578739922,0
1,1141,26004,3578739922,3578739922,0
1,1141,26005,3578739922,3578739922,0
1,1141,26006,3578739922,3578739922,0
1,1141,26007,3578739922,3578739922,0
1,1141,26008,3578739922,3578739922,0
1,1141,26009,3578739922,3578739922,0
1,1141,26010,3578739922,3578739922,0
1,1141,26011,3578739922,3578739922,0
1,1141,26012,3578739922,3578739922,0
1,1141,26013,3578739922,3578739922,0
1,1141,26014,3578739922,3578739922,0
1,1141,26015,3578739922,3578739922,0
1,1141,26016,3578739922,3578739922,0
1,1141,26017,3578739922,3578739922,0
1,1141,26018,3578739922,3578739922,0
1,1141,26019,3578739922,3578739922,0
1,1141,26020,3578739922,3578739924,2
1,1141,26021,3578739922,3578739924,2
1,1141,26022,3578739922,3578739927,5
1,1141,26023,3578739922,3578739929,7
1,1141,26024,3578739922,3578739929,7
1,1141,26025,3578739922,3578739929,7
1,1141,26026,3578739922,3578739930,8
1,1141,26027,3578739922,3578739930,8
1,1141,26028,3578739922,3578739931,9
1,1141,26029,3578739922,3578739932,10
1,1141,26030,3578739922,3578739932,10
1,1141,26031,3578739922,3578739932,10
1,1141,26032,3578739922,3578739932,10
1,1141,26033,3578739922,3578739935,13
1,1141,26034,3578739922,3578739935,13
1,1141,26035,3578739922,3578739935,13
1,1141,26036,3578739922,3578739936,14
1,1141,26037,3578739922,3578739937,15
1,1141,26038,3578739922,3578739938,16
1,1141,26039,3578739922,3578739940,18
1,1141,26040,3578739922,3578739943,21
1,1141,26041,3578739922,3578739945,23
1,1141,26042,3578739922,3578739946,24
1,1141,26043,3578739922,3578739947,25
1,1141,26044,3578739922,3578739948,26
1,1141,26045,3578739922,3578739948,26
1,1141,26046,3578739922,3578739950,28
1,1141,26047,3578739922,3578739952,30
1,1141,26048,3578739922,3578739952,30
1,1141,26049,3578739922,3578739953,31
1,1141,26050,3578739922,3578739954,32
1,1141,26051,3578739922,3578739957,35
1,1141,26052,3578739922,3578739957,35
1,1141,26053,3578739922,3578739957,35
1,1141,26054,3578739922,3578739958,36
1,1141,26055,3578739922,3578739962,40
1,1141,26056,3578739922,3578739962,40
1,1141,26057,3578739922,3578739963,41
1,1141,26058,3578739922,3578739966,44
1,1141,26059,3578739922,3578739967,45
1,1141,26060,3578739922,3578739967,45
1,1141,26061,3578739922,3578739968,46
1,1141,26062,3578739922,3578739969,47
1,1141,26063,3578739922,3578739969,47
1,1142,26064,3578739984,3578739984,0
1,1142,26065,3578739984,3578739984,0
1,1142,26066,3578739984,3578739984,0
1,1142,26067,3578739984,3578739984,0
1,1142,26068,3578739984,3578739984,0
1,1142,26069,3578739984,3578739984,0
1,1142,26070,3578739984,3578739984,0
1,1142,26071,3578739984,3578739984,0
1,1142,26072,3578739984,3578739984,0
1,1142,26073,3578739984,3578739984,0
1,1142,26074,3578739984,3578739984,0
1,1142,26075,3578739984,3578739985,1
1,1142,26076,3578739984,3578739985,1
1,1142,26077,3578739984,3578739985,1
1,1142,26078,3578739984,3578739988,4
1,1142,26079,3578739984,3578739989,5
1,1142,26080,3578739984,3578739991,7
1,1142,26081,3578739984,3578739992,8
1,1142,26082,3578739984,3578739992,8
1,1142,26083,3578739984,3578739992,8
1,1142,26084,3578739984,3578739993,9
1,1142,26085,3578739984,3578739994,10
1,1142,26086,3578739984,3578739996,12
1,1142,26087,3578739984,3578739996,12
1,1142,26088,3578739984,3578739998,14
1,1142,26089,3578739984,3578739999,15
1,1142,26090,3578739984,3578739999,15
1,1142,26091,3578739984,3578740001,17
1,1142,26092,3578739984,3578740002,18
1,1142,26093,3578739984,3578740003,19
1,1142,26094,3578739984,3578740005,21
1,1142,26095,3578739984,3578740010,26
1,1142,26096,3578739984,3578740014,30
1,1142,26097,3578739984,3578740015,31
1,1142,26098,3578739984,3578740015,31
1,1142,26099,3578739984,3578740016,32
1,1142,26100,3578739984,3578740017,33
1,1142,26101,3578739984,3578740018,34
1,1142,26102,3578739984,3578740018,34
1,1142,26103,3578739984,3578740018,34
1,1142,26104,3578739984,3578740018,34
1,1142,26105,3578739984,3578740021,37
1,1142,26106,3578739984,3578740021,37
1,1142,26107,3578739984,3578740024,40
1,1142,26108,3578739984,3578740025,41
1,1142,26109,3578739984,3578740025,41
1,1142,26110,3578739984,3578740025,41
1,1142,26111,3578739984,3578740026,42
1,1142,26112,3578739984,3578740027,43
1,1142,26113,3578739984,3578740028,44
1,1142,26114,3578739984,3578740029,45
1,1142,26115,3578739984,3578740029,45
1,1142,26116,3578739984,3578740029,45
1,1142,26117,3578739984,3578740030,46
1,1142,26118,3578739984,3578740031,47
1,1142,26119,3578739984,3578740031,47
1,1143,26120,3578740048,3578740048,0
1,1143,26121,3578740048,3578740048,0
1,1143,26122,3578740048,3578740048,0
1,1143,26123,3578740048,3578740048,0
1,1143,26124,3578740048,3578740048,0
1,1143,26125,3578740048,3578740048,0
1,1143,26126,3578740048,3578740048,0
1,1143,26127,3578740048,3578740048,0
1,1143,26128,3578740048,3578740048,0
1,1143,26129,3578740048,3578740049,1
1,1143,26130,3578740048,3578740049,1
1,1143,26131,3578740048,3578740051,3
1,1143,26132,3578740048,3578740051,3
1,1143,26133,3578740048,3578740051,3
1,1143,26134,3578740048,3578740052,4
1,1143,26135,3578740048,3578740054,6
1,1143,26136,3578740048,3578740055,7
1,1143,26137,3578740048,3578740056,8
1,1143,26138,3578740048,3578740058,10
1,1143,26139,3578740048,3578740059,11
1,1143,26140,3578740048,3578740060,12
1,1143,26141,3578740048,3578740062,14
1,1143,26142,3578740048,3578740063,15
1,1143,26143,3578740048,3578740063,15
1,1143,26144,3578740048,3578740065,17
1,1143,26145,3578740048,3578740065,17
1,1143,26146,3578740048,3578740066,18
1,1143,26147,3578740048,3578740068,20
1,1143,26148,3578740048,3578740068,20
1,1143,26149,3578740048,3578740068,20
1,1143,26150,3578740048,3578740068,20
1,1143,26151,3578740048,3578740069,21
1,1143,26152,3578740048,3578740073,25
1,1143,26153,3578740048,3578740075,27
1,1143,26154,3578740048,3578740081,33
1,1143,26155,3578740048,3578740081,33
1,1143,26156,3578740048,3578740082,34
1,1143,26157,3578740048,3578740084,36
1,1143,26158,3578740048,3578740085,37
1,1143,26159,3578740048,3578740086,38
1,1143,26160,3578740048,3578740088,40
1,1143,26161,3578740048,3578740089,41
1,1143,26162,3578740048,3578740090,42
1,1143,26163,3578740048,3578740090,42
1,1143,26164,3578740048,3578740092,44
1,1143,26165,3578740048,3578740093,45
1,1143,26166,3578740048,3578740093,45
1,1143,26167,3578740048,3578740093,45
1,1143,26168,3578740048,3578740094,46
1,1143,26169,3578740048,3578740095,47
1,1143,26170,3578740048,3578740095,47
1,1144,26171,3578740111,3578740111,0
1,1144,26172,3578740111,3578740111,0
1,1144,26173,3578740111,3578740111,0
1,1144,26174,3578740111,3578740111,0
1,1144,26175,3578740111,3578740111,0
1,1144,26176,3578740111,3578740111,0
1,1144,26177,3578740111,3578740111,0
1,1144,26178,3578740111,3578740111,0
1,1144,26179,3578740111,3578740111,0
1,1144,26180,3578740111,3578740111,0
1,1144,26181,3578740111,3578740112,1
1,1144,26182,3578740111,3578740112,1
1,1144,26183,3578740111,3578740112,1
1,1144,26184,3578740111,3578740112,1
1,1144,26185,3578740111,3578740112,1
1,1144,26186,3578740111,3578740112,1
1,1144,26187,3578740111,3578740114,3
1,1144,26188,3578740111,3578740114,3
1,1144,26189,3578740111,3578740114,3
1,1144,26190,3578740111,3578740115,4
1,1144,26191,3578740111,3578740115,4
1,1144,26192,3578740111,3578740118,7
1,1144,26193,3578740111,3578740118,7
1,1144,26194,3578740111,3578740118,7
1,1144,26195,3578740111,3578740118,7
1,1144,26196,3578740111,3578740119,8
1,1144,26197,3578740111,3578740119,8
1,1144,26198,3578740111,3578740121,10
1,1144,26199,3578740111,3578740122,11
1,1144,26200,3578740111,3578740122,11
1,1144,26201,3578740111,3578740123,12
1,1144,26202,3578740111,3578740124,13
1,1144,26203,3578740111,3578740125,14
1,1144,26204,3578740111,3578740125,14
1,1144,26205,3578740111,3578740127,16
1,1144,26206,3578740111,3578740129,18
1,1144,26207,3578740111,3578740129,18
1,1144,26208,3578740111,3578740130,19
1,1144,26209,3578740111,3578740130,19
1,1144,26210,3578740111,3578740130,19
1,1144,26211,3578740111,3578740130,19
1,1144,26212,3578740111,3578740131,20
1,1144,26213,3578740111,3578740131,20
1,1144,26214,3578740111,3578740131,20
1,1144,26215,3578740111,3578740132,21
1,1144,26216,3578740111,3578740132,21
1,1144,26217,3578740111,3578740132,21
1,1144,26218,3578740111,3578740134,23
1,1144,26219,3578740111,3578740135,24
1,1144,26220,3578740111,3578740135,24
1,1144,26221,3578740111,3578740135,24
1,1144,26222,3578740111,3578740136,25
1,1144,26223,3578740111,3578740136,25
1,1144,26224,3578740111,3578740136,25
1,1144,26225,3578740111,3578740138,27
1,1144,26226,3578740111,3578740139,28
1,1144,26227,3578740111,3578740140,29
1,1144,26228,3578740111,3578740142,31
1,1144,26229,3578740111,3578740145,34
1,1144,26230,3578740111,3578740146,35
1,1144,26231,3578740111,3578740147,36
1,1144,26232,3578740111,3578740148,37
1,1144,26233,3578740111,3578740148,37
1,1144,26234,3578740111,3578740151,40
1,1144,26235,3578740111,3578740152,41
1,1144,26236,3578740111,3578740154,43
1,1144,26237,3578740111,3578740154,43
1,1144,26238,3578740111,3578740157,46
1,1144,26239,3578740111,3578740157,46
1,1144,26240,3578740111,3578740158,47
1,1144,26241,3578740111,3578740159,48
1,1145,26242,3578740172,3578740172,0
1,1145,26243,3578740172,3578740172,0
1,1145,26244,3578740172,3578740172,0
1,1145,26245,3578740172,3578740172,0
1,1145,26246,3578740172,3578740172,0
1,1145,26247,3578740172,3578740172,0
1,1145,26248,3578740172,3578740172,0
1,1145,26249,3578740172,3578740172,0
1,1145,26250,3578740172,3578740172,0
1,1145,26251,3578740172,3578740172,0
1,1145,26252,3578740172,3578740172,0
1,1145,26253,3578740172,3578740173,1
1,1145,26254,3578740172,3578740174,2
1,1145,26255,3578740172,3578740179,7
1,1145,26256,3578740172,3578740180,8
1,1145,26257,3578740172,3578740180,8
1,1145,26258,3578740172,3578740181,9
1,1145,26259,3578740172,3578740181,9
1,1145,26260,3578740172,3578740182,10
1,1145,26261,3578740172,3578740183,11
1,1145,26262,3578740172,3578740184,12
1,1145,26263,3578740172,3578740185,13
1,1145,26264,3578740172,3578740185,13
1,1145,26265,3578740172,3578740186,14
1,1145,26266,3578740172,3578740187,15
1,1145,26267,3578740172,3578740189,17
1,1145,26268,3578740172,3578740191,19
1,1145,26269,3578740172,3578740192,20
1,1145,26270,3578740172,3578740192,20
1,1145,26271,3578740172,3578740192,20
1,1145,26272,3578740172,3578740192,20
1,1145,26273,3578740172,3578740194,22
1,1145,26274,3578740172,3578740196,24
1,1145,26275,3578740172,3578740197,25
1,1145,26276,3578740172,3578740197,25
1,1145,26277,3578740172,3578740197,25
1,1145,26278,3578740172,3578740198,26
1,1145,26279,3578740172,3578740199,27
1,1145,26280,3578740172,3578740200,28
1,1145,26281,3578740172,3578740201,29
1,1145,26282,3578740172,3578740201,29
1,1145,26283,3578740172,3578740201,29
1,1145,26284,3578740172,3578740201,29
1,1145,26285,3578740172,3578740202,30
1,1145,26286,3578740172,3578740205,33
1,1145,26287,3578740172,3578740211,39
1,1145,26288,3578740172,3578740214,42
1,1145,26289,3578740172,3578740215,43
1,1145,26290,3578740172,3578740215,43
1,1145,26291,3578740172,3578740216,44
1,1145,26292,3578740172,3578740217,45
1,1145,26293,3578740172,3578740217,45
1,1145,26294,3578740172,3578740218,46
1,1145,26295,3578740172,3578740218,46
1,1145,26296,3578740172,3578740219,47
1,1145,26297,3578740172,3578740219,47
1,1145,26298,3578740172,3578740221,49
1,1145,26299,3578740172,3578740221,49
1,1146,26300,3578740235,3578740235,0
1,1146,26301,3578740235,3578740235,0
1,1146,26302,3578740235,3578740235,0
1,1146,26303,3578740235,3578740236,1
1,1146,26304,3578740235,3578740236,1
1,1146,26305,3578740235,3578740236,1
1,1146,26306,3578740235,3578740236,1
1,1146,26307,3578740235,3578740236,1
1,1146,26308,3578740235,3578740236,1
1,1146,26309,3578740235,3578740236,1
1,1146,26310,3578740235,3578740236,1
1,1146,26311,3578740235,3578740236,1
1,1146,26312,3578740235,3578740236,1
1,1146,26313,3578740235,3578740236,1
1,1146,26314,3578740235,3578740236,1
1,1146,26315,3578740235,3578740236,1
1,1146,26316,3578740235,3578740237,2
1,1146,26317,3578740235,3578740239,4
1,1146,26318,3578740235,3578740239,4
1,1146,26319,3578740235,3578740240,5
1,1146,26320,3578740235,3578740240,5
1,1146,26321,3578740235,3578740241,6
1,1146,26322,3578740235,3578740247,12
1,1146,26323,3578740235,3578740247,12
1,1146,26324,3578740235,3578740248,13
1,1146,26325,3578740235,3578740249,14
1,1146,26326,3578740235,3578740250,15
1,1146,26327,3578740235,3578740251,16
1,1146,26328,3578740235,3578740252,17
1,1146,26329,3578740235,3578740252,17
1,1146,26330,3578740235,3578740254,19
1,1146,26331,3578740235,3578740256,21
1,1146,26332,3578740235,3578740259,24
1,1146,26333,3578740235,3578740260,25
1,1146,26334,3578740235,3578740261,26
1,1146,26335,3578740235,3578740263,28
1,1146,26336,3578740235,3578740264,29
1,1146,26337,3578740235,3578740265,30
1,1146,26338,3578740235,3578740267,32
1,1146,26339,3578740235,3578740268,33
1,1146,26340,3578740235,3578740268,33
1,1146,26341,3578740235,3578740268,33
1,1146,26342,3578740235,3578740269,34
1,1146,26343,3578740235,3578740269,34
1,1146,26344,3578740235,3578740273,38
1,1146,26345,3578740235,3578740275,40
1,1146,26346,3578740235,3578740276,41
1,1146,26347,3578740235,3578740280,45
1,1146,26348,3578740235,3578740281,46
1,1146,26349,3578740235,3578740282,47
1,1146,26350,3578740235,3578740284,49
1,1147,26351,3578740298,3578740298,0
1,1147,26352,3578740298,3578740298,0
1,1147,26353,3578740298,3578740298,0
1,1147,26354,3578740298,3578740298,0
1,1147,26355,3578740298,3578740298,0
1,1147,26356,3578740298,3578740298,0
1,1147,26357,3578740298,3578740298,0
1,1147,26358,3578740298,3578740298,0
1,1147,26359,3578740298,3578740298,0
1,1147,26360,3578740298,3578740298,0
1,1147,26361,3578740298,3578740301,3
1,1147,26362,3578740298,3578740302,4
1,1147,26363,3578740298,3578740304,6
1,1147,26364,3578740298,3578740305,7
1,1147,26365,3578740298,3578740308,10
1,1147,26366,3578740298,3578740309,11
1,1147,26367,3578740298,3578740311,13
1,1147,26368,3578740298,3578740311,13
1,1147,26369,3578740298,3578740312,14
1,1147,26370,3578740298,3578740312,14
1,1147,26371,3578740298,3578740313,15
1,1147,26372,3578740298,3578740313,15
1,1147,26373,3578740298,3578740314,16
1,1147,26374,3578740298,3578740314,16
1,1147,26375,3578740298,3578740314,16
1,1147,26376,3578740298,3578740315,17
1,1147,26377,3578740298,3578740315,17
1,1147,26378,3578740298,3578740317,19
1,1147,26379,3578740298,3578740317,19
1,1147,26380,3578740298,3578740318,20
1,1147,26381,3578740298,3578740319,21
1,1147,26382,3578740298,3578740320,22
1,1147,26383,3578740298,3578740320,22
1,1147,26384,3578740298,3578740321,23
1,1147,26385,3578740298,3578740322,24
1,1147,26386,3578740298,3578740322,24
1,1147,26387,3578740298,3578740323,25
1,1147,26388,3578740298,3578740325,27
1,1147,26389,3578740298,3578740325,27
1,1147,26390,3578740298,3578740325,27
1,1147,26391,3578740298,3578740327,29
1,1147,26392,3578740298,3578740329,31
1,1147,26393,3578740298,3578740329,31
1,1147,26394,3578740298,3578740329,31
1,1147,26395,3578740298,3578740330,32
1,1147,26396,3578740298,3578740331,33
1,1147,26397,3578740298,3578740332,34
1,1147,26398,3578740298,3578740332,34
1,1147,26399,3578740298,3578740333,35
1,1147,26400,3578740298,3578740333,35
1,1147,26401,3578740298,3578740333,35
1,1147,26402,3578740298,3578740334,36
1,1147,26403,3578740298,3578740335,37
1,1147,26404,3578740298,3578740335,37
1,1147,26405,3578740298,3578740335,37
1,1147,26406,3578740298,3578740336,38
1,1147,26407,3578740298,3578740337,39
1,1147,26408,3578740298,3578740338,40
1,1147,26409,3578740298,3578740340,42
1,1147,26410,3578740298,3578740345,47
1,1147,26411,3578740298,3578740346,48
1,1147,26412,3578740298,3578740347,49
1,1148,26413,3578740363,3578740363,0
1,1148,26414,3578740363,3578740363,0
1,1148,26415,3578740363,3578740363,0
1,1148,26416,3578740363,3578740363,0
1,1148,26417,3578740363,3578740363,0
1,1148,26418,3578740363,3578740363,0
1,1148,26419,3578740363,3578740363,0
1,1148,26420,3578740363,3578740363,0
1,1148,26421,3578740363,3578740363,0
1,1148,26422,3578740363,3578740363,0
1,1148,26423,3578740363,3578740363,0
1,1148,26424,3578740363,3578740363,0
1,1148,26425,3578740363,3578740366,3
1,1148,26426,3578740363,3578740367,4
1,1148,26427,3578740363,3578740367,4
1,1148,26428,3578740363,3578740367,4
1,1148,26429,3578740363,3578740368,5
1,1148,26430,3578740363,3578740370,7
1,1148,26431,3578740363,3578740371,8
1,1148,26432,3578740363,3578740373,10
1,1148,26433,3578740363,3578740373,10
1,1148,26434,3578740363,3578740374,11
1,1148,26435,3578740363,3578740375,12
1,1148,26436,3578740363,3578740379,16
1,1148,26437,3578740363,3578740381,18
1,1148,26438,3578740363,3578740381,18
1,1148,26439,3578740363,3578740381,18
1,1148,26440,3578740363,3578740381,18
1,1148,26441,3578740363,3578740382,19
1,1148,26442,3578740363,3578740383,20
1,1148,26443,3578740363,3578740385,22
1,1148,26444,3578740363,3578740385,22
1,1148,26445,3578740363,3578740385,22
1,1148,26446,3578740363,3578740385,22
1,1148,26447,3578740363,3578740388,25
1,1148,26448,3578740363,3578740390,27
1,1148,26449,3578740363,3578740391,28
1,1148,26450,3578740363,3578740392,29
1,1148,26451,3578740363,3578740392,29
1,1148,26452,3578740363,3578740392,29
1,1148,26453,3578740363,3578740395,32
1,1148,26454,3578740363,3578740396,33
1,1148,26455,3578740363,3578740397,34
1,1148,26456,3578740363,3578740397,34
1,1148,26457,3578740363,3578740398,35
1,1148,26458,3578740363,3578740399,36
1,1148,26459,3578740363,3578740399,36
1,1148,26460,3578740363,3578740400,37
1,1148,26461,3578740363,3578740401,38
1,1148,26462,3578740363,3578740401,38
1,1148,26463,3578740363,3578740402,39
1,1148,26464,3578740363,3578740404,41
1,1148,26465,3578740363,3578740406,43
1,1148,26466,3578740363,3578740412,49
1,1148,26467,3578740363,3578740413,50
1,1149,26468,3578740426,3578740426,0
1,1149,26469,3578740426,3578740426,0
1,1149,26470,3578740426,3578740426,0
1,1149,26471,3578740426,3578740426,0
1,1149,26472,3578740426,3578740426,0
1,1149,26473,3578740426,3578740426,0
1,1149,26474,3578740426,3578740426,0
1,1149,26475,3578740426,3578740426,0
1,1149,26476,3578740426,3578740426,0
1,1149,26477,3578740426,3578740426,0
1,1149,26478,3578740426,3578740426,0
1,1149,26479,3578740426,3578740426,0
1,1149,26480,3578740426,3578740426,0
1,1149,26481,3578740426,3578740426,0
1,1149,26482,3578740426,3578740426,0
1,1149,26483,3578740426,3578740427,1
1,1149,26484,3578740426,3578740428,2
1,1149,26485,3578740426,3578740428,2
1,1149,26486,3578740426,3578740428,2
1,1149,26487,3578740426,3578740429,3
1,1149,26488,3578740426,3578740429,3
1,1149,26489,3578740426,3578740430,4
1,1149,26490,3578740426,3578740430,4
1,1149,26491,3578740426,3578740431,5
1,1149,26492,3578740426,3578740431,5
1,1149,26493,3578740426,3578740431,5
1,1149,26494,3578740426,3578740432,6
1,1149,26495,3578740426,3578740437,11
1,1149,26496,3578740426,3578740439,13
1,1149,26497,3578740426,3578740439,13
1,1149,26498,3578740426,3578740440,14
1,1149,26499,3578740426,3578740441,15
1,1149,26500,3578740426,3578740446,20
1,1149,26501,3578740426,3578740447,21
1,1149,26502,3578740426,3578740448,22
1,1149,26503,3578740426,3578740448,22
1,1149,26504,3578740426,3578740448,22
1,1149,26505,3578740426,3578740449,23
1,1149,26506,3578740426,3578740450,24
1,1149,26507,3578740426,3578740451,25
1,1149,26508,3578740426,3578740451,25
1,1149,26509,3578740426,3578740454,28
1,1149,26510,3578740426,3578740456,30
1,1149,26511,3578740426,3578740458,32
1,1149,26512,3578740426,3578740458,32
1,1149,26513,3578740426,3578740459,33
1,1149,26514,3578740426,3578740461,35
1,1149,26515,3578740426,3578740463,37
1,1149,26516,3578740426,3578740463,37
1,1149,26517,3578740426,3578740463,37
1,1149,26518,3578740426,3578740464,38
1,1149,26519,3578740426,3578740465,39
1,1149,26520,3578740426,3578740467,41
1,1149,26521,3578740426,3578740468,42
1,1149,26522,3578740426,3578740469,43
1,1149,26523,3578740426,3578740469,43
1,1149,26524,3578740426,3578740470,44
1,1149,26525,3578740426,3578740473,47
1,1149,26526,3578740426,3578740475,49
1,1150,26527,3578740489,3578740489,0
1,1150,26528,3578740489,3578740489,0
1,1150,26529,3578740489,3578740489,0
1,1150,26530,3578740489,3578740489,0
1,1150,26531,3578740489,3578740489,0
1,1150,26532,3578740489,3578740489,0
1,1150,26533,3578740489,3578740489,0
1,1150,26534,3578740489,3578740490,1
1,1150,26535,3578740489,3578740490,1
1,1150,26536,3578740489,3578740491,2
1,1150,26537,3578740489,3578740492,3
1,1150,26538,3578740489,3578740492,3
1,1150,26539,3578740489,3578740494,5
1,1150,26540,3578740489,3578740494,5
1,1150,26541,3578740489,3578740494,5
1,1150,26542,3578740489,3578740494,5
1,1150,26543,3578740489,3578740503,14
1,1150,26544,3578740489,3578740504,15
1,1150,26545,3578740489,3578740504,15
1,1150,26546,3578740489,3578740506,17
1,1150,26547,3578740489,3578740507,18
1,1150,26548,3578740489,3578740510,21
1,1150,26549,3578740489,3578740511,22
1,1150,26550,3578740489,3578740511,22
1,1150,26551,3578740489,3578740511,22
1,1150,26552,3578740489,3578740511,22
1,1150,26553,3578740489,3578740512,23
1,1150,26554,3578740489,3578740512,23
1,1150,26555,3578740489,3578740513,24
1,1150,26556,3578740489,3578740513,24
1,1150,26557,3578740489,3578740513,24
1,1150,26558,3578740489,3578740514,25
1,1150,26559,3578740489,3578740514,25
1,1150,26560,3578740489,3578740514,25
1,1150,26561,3578740489,3578740516,27
1,1150,26562,3578740489,3578740517,28
1,1150,26563,3578740489,3578740517,28
1,1150,26564,3578740489,3578740518,29
1,1150,26565,3578740489,3578740519,30
1,1150,26566,3578740489,3578740519,30
1,1150,26567,3578740489,3578740520,31
1,1150,26568,3578740489,3578740520,31
1,1150,26569,3578740489,3578740521,32
1,1150,26570,3578740489,3578740522,33
1,1150,26571,3578740489,3578740522,33
1,1150,26572,3578740489,3578740524,35
1,1150,26573,3578740489,3578740524,35
1,1150,26574,3578740489,3578740524,35
1,1150,26575,3578740489,3578740528,39
1,1150,26576,3578740489,3578740528,39
1,1150,26577,3578740489,3578740528,39
1,1150,26578,3578740489,3578740528,39
1,1150,26579,3578740489,3578740529,40
1,1150,26580,3578740489,3578740529,40
1,1150,26581,3578740489,3578740529,40
1,1150,26582,3578740489,3578740529,40
1,1150,26583,3578740489,3578740530,41
1,1150,26584,3578740489,3578740531,42
1,1150,26585,3578740489,3578740531,42
1,1150,26586,3578740489,3578740532,43
1,1150,26587,3578740489,3578740532,43
1,1150,26588,3578740489,3578740533,44
1,1150,26589,3578740489,3578740534,45
1,1150,26590,3578740489,3578740534,45
1,1150,26591,3578740489,3578740534,45
1,1150,26592,3578740489,3578740535,46
1,1150,26593,3578740489,3578740535,46
1,1150,26594,3578740489,3578740536,47
1,1150,26595,3578740489,3578740537,48
1,1150,26596,3578740489,3578740539,50
1,1151,26597,3578740554,3578740554,0
1,1151,26598,3578740554,3578740554,0
1,1151,26599,3578740554,3578740554,0
1,1151,26600,3578740554,3578740554,0
1,1151,26601,3578740554,3578740554,0
1,1151,26602,3578740554,3578740554,0
1,1151,26603,3578740554,3578740554,0
1,1151,26604,3578740554,3578740554,0
1,1151,26605,3578740554,3578740554,0
1,1151,26606,3578740554,3578740554,0
1,1151,26607,3578740554,3578740554,0
1,1151,26608,3578740554,3578740557,3
1,1151,26609,3578740554,3578740557,3
1,1151,26610,3578740554,3578740557,3
1,1151,26611,3578740554,3578740560,6
1,1151,26612,3578740554,3578740561,7
1,1151,26613,3578740554,3578740562,8
1,1151,26614,3578740554,3578740563,9
1,1151,26615,3578740554,3578740566,12
1,1151,26616,3578740554,3578740566,12
1,1151,26617,3578740554,3578740566,12
1,1151,26618,3578740554,3578740567,13
1,1151,26619,3578740554,3578740567,13
1,1151,26620,3578740554,3578740567,13
1,1151,26621,3578740554,3578740568,14
1,1151,26622,3578740554,3578740569,15
1,1151,26623,3578740554,3578740569,15
1,1151,26624,3578740554,3578740570,16
1,1151,26625,3578740554,3578740571,17
1,1151,26626,3578740554,3578740572,18
1,1151,26627,3578740554,3578740573,19
1,1151,26628,3578740554,3578740574,20
1,1151,26629,3578740554,3578740578,24
1,1151,26630,3578740554,3578740580,26
1,1151,26631,3578740554,3578740580,26
1,1151,26632,3578740554,3578740580,26
1,1151,26633,3578740554,3578740582,28
1,1151,26634,3578740554,3578740582,28
1,1151,26635,3578740554,3578740582,28
1,1151,26636,3578740554,3578740584,30
1,1151,26637,3578740554,3578740584,30
1,1151,26638,3578740554,3578740584,30
1,1151,26639,3578740554,3578740585,31
1,1151,26640,3578740554,3578740585,31
1,1151,26641,3578740554,3578740587,33
1,1151,26642,3578740554,3578740587,33
1,1151,26643,3578740554,3578740588,34
1,1151,26644,3578740554,3578740590,36
1,1151,26645,3578740554,3578740591,37
1,1151,26646,3578740554,3578740591,37
1,1151,26647,3578740554,3578740592,38
1,1151,26648,3578740554,3578740593,39
1,1151,26649,3578740554,3578740593,39
1,1151,26650,3578740554,3578740594,40
1,1151,26651,3578740554,3578740596,42
1,1151,26652,3578740554,3578740596,42
1,1151,26653,3578740554,3578740597,43
1,1151,26654,3578740554,3578740598,44
1,1151,26655,3578740554,3578740599,45
1,1151,26656,3578740554,3578740599,45
1,1151,26657,3578740554,3578740600,46
1,1151,26658,3578740554,3578740600,46
1,1151,26659,3578740554,3578740600,46
1,1151,26660,3578740554,3578740601,47
1,1151,26661,3578740554,3578740603,49
1,1152,26662,3578740615,3578740615,0
1,1152,26663,3578740615,3578740615,0
1,1152,26664,3578740615,3578740615,0
1,1152,26665,3578740615,3578740615,0
1,1152,26666,3578740615,3578740615,0
1,1152,26667,3578740615,3578740615,0
1,1152,26668,3578740615,3578740615,0
1,1152,26669,3578740615,3578740616,1
1,1152,26670,3578740615,3578740616,1
1,1152,26671,3578740615,3578740616,1
1,1152,26672,3578740615,3578740618,3
1,1152,26673,3578740615,3578740618,3
1,1152,26674,3578740615,3578740618,3
1,1152,26675,3578740615,3578740620,5
1,1152,26676,3578740615,3578740621,6
1,1152,26677,3578740615,3578740622,7
1,1152,26678,3578740615,3578740623,8
1,1152,26679,3578740615,3578740624,9
1,1152,26680,3578740615,3578740624,9
1,1152,26681,3578740615,3578740624,9
1,1152,26682,3578740615,3578740626,11
1,1152,26683,3578740615,3578740627,12
1,1152,26684,3578740615,3578740628,13
1,1152,26685,3578740615,3578740628,13
1,1152,26686,3578740615,3578740628,13
1,1152,26687,3578740615,3578740629,14
1,1152,26688,3578740615,3578740629,14
1,1152,26689,3578740615,3578740629,14
1,1152,26690,3578740615,3578740629,14
1,1152,26691,3578740615,3578740630,15
1,1152,26692,3578740615,3578740632,17
1,1152,26693,3578740615,3578740637,22
1,1152,26694,3578740615,3578740637,22
1,1152,26695,3578740615,3578740639,24
1,1152,26696,3578740615,3578740640,25
1,1152,26697,3578740615,3578740641,26
1,1152,26698,3578740615,3578740644,29
1,1152,26699,3578740615,3578740646,31
1,1152,26700,3578740615,3578740647,32
1,1152,26701,3578740615,3578740647,32
1,1152,26702,3578740615,3578740647,32
1,1152,26703,3578740615,3578740648,33
1,1152,26704,3578740615,3578740649,34
1,1152,26705,3578740615,3578740650,35
1,1152,26706,3578740615,3578740650,35
1,1152,26707,3578740615,3578740651,36
1,1152,26708,3578740615,3578740654,39
1,1152,26709,3578740615,3578740656,41
1,1152,26710,3578740615,3578740658,43
1,1152,26711,3578740615,3578740659,44
1,1152,26712,3578740615,3578740659,44
1,1152,26713,3578740615,3578740661,46
1,1152,26714,3578740615,3578740661,46
1,1152,26715,3578740615,3578740662,47
1,1152,26716,3578740615,3578740663,48
1,1152,26717,3578740615,3578740664,49
1,1152,26718,3578740615,3578740664,49
1,1153,26719,3578740677,3578740677,0
1,1153,26720,3578740677,3578740677,0
1,1153,26721,3578740677,3578740677,0
1,1153,26722,3578740677,3578740677,0
1,1153,26723,3578740677,3578740677,0
1,1153,26724,3578740677,3578740677,0
1,1153,26725,3578740677,3578740677,0
1,1153,26726,3578740677,3578740677,0
1,1153,26727,3578740677,3578740680,3
1,1153,26728,3578740677,3578740680,3
1,1153,26729,3578740677,3578740681,4
1,1153,26730,3578740677,3578740682,5
1,1153,26731,3578740677,3578740684,7
1,1153,26732,3578740677,3578740685,8
1,1153,26733,3578740677,3578740689,12
1,1153,26734,3578740677,3578740690,13
1,1153,26735,3578740677,3578740692,15
1,1153,26736,3578740677,3578740692,15
1,1153,26737,3578740677,3578740694,17
1,1153,26738,3578740677,3578740694,17
1,1153,26739,3578740677,3578740694,17
1,1153,26740,3578740677,3578740694,17
1,1153,26741,3578740677,3578740702,25
1,1153,26742,3578740677,3578740703,26
1,1153,26743,3578740677,3578740703,26
1,1153,26744,3578740677,3578740703,26
1,1153,26745,3578740677,3578740706,29
1,1153,26746,3578740677,3578740707,30
1,1153,26747,3578740677,3578740709,32
1,1153,26748,3578740677,3578740711,34
1,1153,26749,3578740677,3578740711,34
1,1153,26750,3578740677,3578740711,34
1,1153,26751,3578740677,3578740712,35
1,1153,26752,3578740677,3578740713,36
1,1153,26753,3578740677,3578740713,36
1,1153,26754,3578740677,3578740713,36
1,1153,26755,3578740677,3578740714,37
1,1153,26756,3578740677,3578740714,37
1,1153,26757,3578740677,3578740715,38
1,1153,26758,3578740677,3578740716,39
1,1153,26759,3578740677,3578740717,40
1,1153,26760,3578740677,3578740717,40
1,1153,26761,3578740677,3578740718,41
1,1153,26762,3578740677,3578740719,42
1,1153,26763,3578740677,3578740720,43
1,1153,26764,3578740677,3578740721,44
1,1153,26765,3578740677,3578740721,44
1,1153,26766,3578740677,3578740722,45
1,1153,26767,3578740677,3578740723,46
1,1153,26768,3578740677,3578740724,47
1,1153,26769,3578740677,3578740724,47
1,1153,26770,3578740677,3578740727,50
1,1154,26771,3578740744,3578740744,0
1,1154,26772,3578740744,3578740744,0
1,1154,26773,3578740744,3578740744,0
1,1154,26774,3578740744,3578740744,0
1,1154,26775,3578740744,3578740744,0
1,1154,26776,3578740744,3578740744,0
1,1154,26777,3578740744,3578740744,0
1,1154,26778,3578740744,3578740744,0
1,1154,26779,3578740744,3578740744,0
1,1154,26780,3578740744,3578740744,0
1,1154,26781,3578740744,3578740744,0
1,1154,26782,3578740744,3578740744,0
1,1154,26783,3578740744,3578740744,0
1,1154,26784,3578740744,3578740744,0
1,1154,26785,3578740744,3578740744,0
1,1154,26786,3578740744,3578740744,0
1,1154,26787,3578740744,3578740744,0
1,1154,26788,3578740744,3578740744,0
1,1154,26789,3578740744,3578740744,0
1,1154,26790,3578740744,3578740745,1
1,1154,26791,3578740744,3578740748,4
1,1154,26792,3578740744,3578740748,4
1,1154,26793,3578740744,3578740749,5
1,1154,26794,3578740744,3578740751,7
1,1154,26795,3578740744,3578740754,10
1,1154,26796,3578740744,3578740756,12
1,1154,26797,3578740744,3578740757,13
1,1154,26798,3578740744,3578740757,13
1,1154,26799,3578740744,3578740761,17
1,1154,26800,3578740744,3578740763,19
1,1154,26801,3578740744,3578740765,21
1,1154,26802,3578740744,3578740765,21
1,1154,26803,3578740744,3578740766,22
1,1154,26804,3578740744,3578740766,22
1,1154,26805,3578740744,3578740767,23
1,1154,26806,3578740744,3578740767,23
1,1154,26807,3578740744,3578740768,24
1,1154,26808,3578740744,3578740768,24
1,1154,26809,3578740744,3578740769,25
1,1154,26810,3578740744,3578740770,26
1,1154,26811,3578740744,3578740772,28
1,1154,26812,3578740744,3578740773,29
1,1154,26813,3578740744,3578740774,30
1,1154,26814,3578740744,3578740775,31
1,1154,26815,3578740744,3578740779,35
1,1154,26816,3578740744,3578740780,36
1,1154,26817,3578740744,3578740780,36
1,1154,26818,3578740744,3578740782,38
1,1154,26819,3578740744,3578740782,38
1,1154,26820,3578740744,3578740782,38
1,1154,26821,3578740744,3578740783,39
1,1154,26822,3578740744,3578740784,40
1,1154,26823,3578740744,3578740784,40
1,1154,26824,3578740744,3578740784,40
1,1154,26825,3578740744,3578740785,41
1,1154,26826,3578740744,3578740786,42
1,1154,26827,3578740744,3578740787,43
1,1154,26828,3578740744,3578740788,44
1,1154,26829,3578740744,3578740789,45
1,1154,26830,3578740744,3578740790,46
1,1154,26831,3578740744,3578740792,48
1,1154,26832,3578740744,3578740794,50
1,1155,26833,3578740805,3578740805,0
1,1155,26834,3578740805,3578740805,0
1,1155,26835,3578740805,3578740805,0
1,1155,26836,3578740805,3578740805,0
1,1155,26837,3578740805,3578740805,0
1,1155,26838,3578740805,3578740805,0
1,1155,26839,3578740805,3578740805,0
1,1155,26840,3578740805,3578740805,0
1,1155,26841,3578740805,3578740805,0
1,1155,26842,3578740805,3578740805,0
1,1155,26843,3578740805,3578740805,0
1,1155,26844,3578740805,3578740805,0
1,1155,26845,3578740805,3578740805,0
1,1155,26846,3578740805,3578740807,2
1,1155,26847,3578740805,3578740813,8
1,1155,26848,3578740805,3578740813,8
1,1155,26849,3578740805,3578740814,9
1,1155,26850,3578740805,3578740814,9
1,1155,26851,3578740805,3578740816,11
1,1155,26852,3578740805,3578740816,11
1,1155,26853,3578740805,3578740816,11
1,1155,26854,3578740805,3578740818,13
1,1155,26855,3578740805,3578740818,13
1,1155,26856,3578740805,3578740818,13
1,1155,26857,3578740805,3578740819,14
1,1155,26858,3578740805,3578740820,15
1,1155,26859,3578740805,3578740823,18
1,1155,26860,3578740805,3578740823,18
1,1155,26861,3578740805,3578740824,19
1,1155,26862,3578740805,3578740824,19
1,1155,26863,3578740805,3578740825,20
1,1155,26864,3578740805,3578740825,20
1,1155,26865,3578740805,3578740827,22
1,1155,26866,3578740805,3578740828,23
1,1155,26867,3578740805,3578740829,24
1,1155,26868,3578740805,3578740829,24
1,1155,26869,3578740805,3578740829,24
1,1155,26870,3578740805,3578740829,24
1,1155,26871,3578740805,3578740829,24
1,1155,26872,3578740805,3578740830,25
1,1155,26873,3578740805,3578740830,25
1,1155,26874,3578740805,3578740830,25
1,1155,26875,3578740805,3578740832,27
1,1155,26876,3578740805,3578740837,32
1,1155,26877,3578740805,3578740837,32
1,1155,26878,3578740805,3578740839,34
1,1155,26879,3578740805,3578740839,34
1,1155,26880,3578740805,3578740841,36
1,1155,26881,3578740805,3578740842,37
1,1155,26882,3578740805,3578740842,37
1,1155,26883,3578740805,3578740847,42
1,1155,26884,3578740805,3578740847,42
1,1155,26885,3578740805,3578740847,42
1,1155,26886,3578740805,3578740848,43
1,1155,26887,3578740805,3578740848,43
1,1155,26888,3578740805,3578740848,43
1,1155,26889,3578740805,3578740849,44
1,1155,26890,3578740805,3578740850,45
1,1155,26891,3578740805,3578740850,45
1,1155,26892,3578740805,3578740852,47
1,1155,26893,3578740805,3578740854,49
1,1156,26894,3578740870,3578740870,0
1,1156,26895,3578740870,3578740870,0
1,1156,26896,3578740870,3578740870,0
1,1156,26897,3578740870,3578740870,0
1,1156,26898,3578740870,3578740870,0
1,1156,26899,3578740870,3578740870,0
1,1156,26900,3578740870,3578740870,0
1,1156,26901,3578740870,3578740870,0
1,1156,26902,3578740870,3578740870,0
1,1156,26903,3578740870,3578740870,0
1,1156,26904,3578740870,3578740870,0
1,1156,26905,3578740870,3578740870,0
1,1156,26906,3578740870,3578740870,0
1,1156,26907,3578740870,3578740870,0
1,1156,26908,3578740870,3578740873,3
1,1156,26909,3578740870,3578740875,5
1,1156,26910,3578740870,3578740875,5
1,1156,26911,3578740870,3578740880,10
1,1156,26912,3578740870,3578740881,11
1,1156,26913,3578740870,3578740881,11
1,1156,26914,3578740870,3578740882,12
1,1156,26915,3578740870,3578740884,14
1,1156,26916,3578740870,3578740885,15
1,1156,26917,3578740870,3578740889,19
1,1156,26918,3578740870,3578740889,19
1,1156,26919,3578740870,3578740890,20
1,1156,26920,3578740870,3578740890,20
1,1156,26921,3578740870,3578740891,21
1,1156,26922,3578740870,3578740892,22
1,1156,26923,3578740870,3578740893,23
1,1156,26924,3578740870,3578740893,23
1,1156,26925,3578740870,3578740894,24
1,1156,26926,3578740870,3578740894,24
1,1156,26927,3578740870,3578740895,25
1,1156,26928,3578740870,3578740898,28
1,1156,26929,3578740870,3578740899,29
1,1156,26930,3578740870,3578740902,32
1,1156,26931,3578740870,3578740903,33
1,1156,26932,3578740870,3578740903,33
1,1156,26933,3578740870,3578740904,34
1,1156,26934,3578740870,3578740905,35
1,1156,26935,3578740870,3578740907,37
1,1156,26936,3578740870,3578740908,38
1,1156,26937,3578740870,3578740911,41
1,1156,26938,3578740870,3578740911,41
1,1156,26939,3578740870,3578740911,41
1,1156,26940,3578740870,3578740912,42
1,1156,26941,3578740870,3578740912,42
1,1156,26942,3578740870,3578740915,45
1,1156,26943,3578740870,3578740915,45
1,1156,26944,3578740870,3578740915,45
1,1156,26945,3578740870,3578740915,45
1,1156,26946,3578740870,3578740915,45
1,1156,26947,3578740870,3578740915,45
1,1156,26948,3578740870,3578740915,45
1,1156,26949,3578740870,3578740916,46
1,1156,26950,3578740870,3578740917,47
1,1156,26951,3578740870,3578740917,47
1,1156,26952,3578740870,3578740917,47
1,1156,26953,3578740870,3578740918,48
1,1156,26954,3578740870,3578740919,49
1,1157,26955,3578740931,3578740931,0
1,1157,26956,3578740931,3578740931,0
1,1157,26957,3578740931,3578740931,0
1,1157,26958,3578740931,3578740931,0
1,1157,26959,3578740931,3578740931,0
1,1157,26960,3578740931,3578740931,0
1,1157,26961,3578740931,3578740931,0
1,1157,26962,3578740931,3578740931,0
1,1157,26963,3578740931,3578740931,0
1,1157,26964,3578740931,3578740931,0
1,1157,26965,3578740931,3578740931,0
1,1157,26966,3578740931,3578740931,0
1,1157,26967,3578740931,3578740931,0
1,1157,26968,3578740931,3578740931,0
1,1157,26969,3578740931,3578740931,0
1,1157,26970,3578740931,3578740931,0
1,1157,26971,3578740931,3578740931,0
1,1157,26972,3578740931,3578740931,0
1,1157,26973,3578740931,3578740932,1
1,1157,26974,3578740931,3578740932,1
1,1157,26975,3578740931,3578740932,1
1,1157,26976,3578740931,3578740933,2
1,1157,26977,3578740931,3578740934,3
1,1157,26978,3578740931,3578740934,3
1,1157,26979,3578740931,3578740935,4
1,1157,26980,3578740931,3578740936,5
1,1157,26981,3578740931,3578740936,5
1,1157,26982,3578740931,3578740938,7
1,1157,26983,3578740931,3578740939,8
1,1157,26984,3578740931,3578740940,9
1,1157,26985,3578740931,3578740944,13
1,1157,26986,3578740931,3578740944,13
1,1157,26987,3578740931,3578740946,15
1,1157,26988,3578740931,3578740948,17
1,1157,26989,3578740931,3578740948,17
1,1157,26990,3578740931,3578740949,18
1,1157,26991,3578740931,3578740949,18
1,1157,26992,3578740931,3578740952,21
1,1157,26993,3578740931,3578740953,22
1,1157,26994,3578740931,3578740953,22
1,1157,26995,3578740931,3578740954,23
1,1157,26996,3578740931,3578740956,25
1,1157,26997,3578740931,3578740957,26
1,1157,26998,3578740931,3578740957,26
1,1157,26999,3578740931,3578740961,30
1,1157,27000,3578740931,3578740962,31
1,1157,27001,3578740931,3578740962,31
1,1157,27002,3578740931,3578740964,33
1,1157,27003,3578740931,3578740965,34
1,1157,27004,3578740931,3578740965,34
1,1157,27005,3578740931,3578740966,35
1,1157,27006,3578740931,3578740966,35
1,1157,27007,3578740931,3578740966,35
1,1157,27008,3578740931,3578740967,36
1,1157,27009,3578740931,3578740968,37
1,1157,27010,3578740931,3578740969,38
1,1157,27011,3578740931,3578740969,38
1,1157,27012,3578740931,3578740970,39
1,1157,27013,3578740931,3578740973,42
1,1157,27014,3578740931,3578740973,42
1,1157,27015,3578740931,3578740973,42
1,1157,27016,3578740931,3578740974,43
1,1157,27017,3578740931,3578740975,44
1,1157,27018,3578740931,3578740979,48
1,1157,27019,3578740931,3578740979,48
1,1157,27020,3578740931,3578740979,48
1,1157,27021,3578740931,3578740981,50
1,1158,27022,3578740992,3578740992,0
1,1158,27023,3578740992,3578740992,0
1,1158,27024,3578740992,3578740992,0
1,1158,27025,3578740992,3578740992,0
1,1158,27026,3578740992,3578740992,0
1,1158,27027,3578740992,3578740992,0
1,1158,27028,3578740992,3578740992,0
1,1158,27029,3578740992,3578740992,0
1,1158,27030,3578740992,3578740992,0
1,1158,27031,3578740992,3578740992,0
1,1158,27032,3578740992,3578740992,0
1,1158,27033,3578740992,3578740992,0
1,1158,27034,3578740992,3578740992,0
1,1158,27035,3578740992,3578740992,0
1,1158,27036,3578740992,3578740992,0
1,1158,27037,3578740992,3578740992,0
1,1158,27038,3578740992,3578740993,1
1,1158,27039,3578740992,3578740994,2
1,1158,27040,3578740992,3578740994,2
1,1158,27041,3578740992,3578740996,4
1,1158,27042,3578740992,3578740997,5
1,1158,27043,3578740992,3578740998,6
1,1158,27044,3578740992,3578740998,6
1,1158,27045,3578740992,3578740999,7
1,1158,27046,3578740992,3578740999,7
1,1158,27047,3578740992,3578741000,8
1,1158,27048,3578740992,3578741000,8
1,1158,27049,3578740992,3578741000,8
1,1158,27050,3578740992,3578741001,9
1,1158,27051,3578740992,3578741002,10
1,1158,27052,3578740992,3578741002,10
1,1158,27053,3578740992,3578741005,13
1,1158,27054,3578740992,3578741007,15
1,1158,27055,3578740992,3578741013,21
1,1158,27056,3578740992,3578741013,21
1,1158,27057,3578740992,3578741014,22
1,1158,27058,3578740992,3578741015,23
1,1158,27059,3578740992,3578741015,23
1,1158,27060,3578740992,3578741017,25
1,1158,27061,3578740992,3578741017,25
1,1158,27062,3578740992,3578741018,26
1,1158,27063,3578740992,3578741018,26
1,1158,27064,3578740992,3578741018,26
1,1158,27065,3578740992,3578741018,26
1,1158,27066,3578740992,3578741019,27
1,1158,27067,3578740992,3578741019,27
1,1158,27068,3578740992,3578741021,29
1,1158,27069,3578740992,3578741023,31
1,1158,27070,3578740992,3578741023,31
1,1158,27071,3578740992,3578741024,32
1,1158,27072,3578740992,3578741024,32
1,1158,27073,3578740992,3578741025,33
1,1158,27074,3578740992,3578741026,34
1,1158,27075,3578740992,3578741028,36
1,1158,27076,3578740992,3578741028,36
1,1158,27077,3578740992,3578741029,37
1,1158,27078,3578740992,3578741029,37
1,1158,27079,3578740992,3578741030,38
1,1158,27080,3578740992,3578741030,38
1,1158,27081,3578740992,3578741031,39
1,1158,27082,3578740992,3578741032,40
1,1158,27083,3578740992,3578741038,46
1,1158,27084,3578740992,3578741039,47
1,1158,27085,3578740992,3578741039,47
1,1158,27086,3578740992,3578741040,48
1,1158,27087,3578740992,3578741042,50
1,1159,27088,3578741054,3578741054,0
1,1159,27089,3578741054,3578741054,0
1,1159,27090,3578741054,3578741054,0
1,1159,27091,3578741054,3578741054,0
1,1159,27092,3578741054,3578741054,0
1,1159,27093,3578741054,3578741054,0
1,1159,27094,3578741054,3578741054,0
1,1159,27095,3578741054,3578741054,0
1,1159,27096,3578741054,3578741054,0
1,1159,27097,3578741054,3578741054,0
1,1159,27098,3578741054,3578741054,0
1,1159,27099,3578741054,3578741054,0
1,1159,27100,3578741054,3578741054,0
1,1159,27101,3578741054,3578741055,1
1,1159,27102,3578741054,3578741055,1
1,1159,27103,3578741054,3578741056,2
1,1159,27104,3578741054,3578741057,3
1,1159,27105,3578741054,3578741058,4
1,1159,27106,3578741054,3578741059,5
1,1159,27107,3578741054,3578741061,7
1,1159,27108,3578741054,3578741061,7
1,1159,27109,3578741054,3578741063,9
1,1159,27110,3578741054,3578741063,9
1,1159,27111,3578741054,3578741064,10
1,1159,27112,3578741054,3578741065,11
1,1159,27113,3578741054,3578741067,13
1,1159,27114,3578741054,3578741067,13
1,1159,27115,3578741054,3578741067,13
1,1159,27116,3578741054,3578741068,14
1,1159,27117,3578741054,3578741068,14
1,1159,27118,3578741054,3578741070,16
1,1159,27119,3578741054,3578741073,19
1,1159,27120,3578741054,3578741075,21
1,1159,27121,3578741054,3578741076,22
1,1159,27122,3578741054,3578741080,26
1,1159,27123,3578741054,3578741081,27
1,1159,27124,3578741054,3578741081,27
1,1159,27125,3578741054,3578741084,30
1,1159,27126,3578741054,3578741085,31
1,1159,27127,3578741054,3578741089,35
1,1159,27128,3578741054,3578741089,35
1,1159,27129,3578741054,3578741090,36
1,1159,27130,3578741054,3578741090,36
1,1159,27131,3578741054,3578741091,37
1,1159,27132,3578741054,3578741092,38
1,1159,27133,3578741054,3578741092,38
1,1159,27134,3578741054,3578741093,39
1,1159,27135,3578741054,3578741094,40
1,1159,27136,3578741054,3578741094,40
1,1159,27137,3578741054,3578741095,41
1,1159,27138,3578741054,3578741095,41
1,1159,27139,3578741054,3578741097,43
1,1159,27140,3578741054,3578741099,45
1,1159,27141,3578741054,3578741099,45
1,1159,27142,3578741054,3578741102,48
1,1159,27143,3578741054,3578741102,48
1,1159,27144,3578741054,3578741103,49
1,1159,27145,3578741054,3578741103,49
1,1159,27146,3578741054,3578741104,50
1,1160,27147,3578741117,3578741117,0
1,1160,27148,3578741117,3578741117,0
1,1160,27149,3578741117,3578741117,0
1,1160,27150,3578741117,3578741117,0
1,1160,27151,3578741117,3578741117,0
1,1160,27152,3578741117,3578741117,0
1,1160,27153,3578741117,3578741117,0
1,1160,27154,3578741117,3578741117,0
1,1160,27155,3578741117,3578741117,0
1,1160,27156,3578741117,3578741117,0
1,1160,27157,3578741117,3578741117,0
1,1160,27158,3578741117,3578741117,0
1,1160,27159,3578741117,3578741117,0
1,1160,27160,3578741117,3578741117,0
1,1160,27161,3578741117,3578741117,0
1,1160,27162,3578741117,3578741117,0
1,1160,27163,3578741117,3578741117,0
1,1160,27164,3578741117,3578741117,0
1,1160,27165,3578741117,3578741117,0
1,1160,27166,3578741117,3578741117,0
1,1160,27167,3578741117,3578741118,1
1,1160,27168,3578741117,3578741120,3
1,1160,27169,3578741117,3578741121,4
1,1160,27170,3578741117,3578741123,6
1,1160,27171,3578741117,3578741124,7
1,1160,27172,3578741117,3578741124,7
1,1160,27173,3578741117,3578741125,8
1,1160,27174,3578741117,3578741125,8
1,1160,27175,3578741117,3578741126,9
1,1160,27176,3578741117,3578741127,10
1,1160,27177,3578741117,3578741128,11
1,1160,27178,3578741117,3578741129,12
1,1160,27179,3578741117,3578741129,12
1,1160,27180,3578741117,3578741130,13
1,1160,27181,3578741117,3578741130,13
1,1160,27182,3578741117,3578741130,13
1,1160,27183,3578741117,3578741130,13
1,1160,27184,3578741117,3578741130,13
1,1160,27185,3578741117,3578741132,15
1,1160,27186,3578741117,3578741132,15
1,1160,27187,3578741117,3578741133,16
1,1160,27188,3578741117,3578741133,16
1,1160,27189,3578741117,3578741134,17
1,1160,27190,3578741117,3578741134,17
1,1160,27191,3578741117,3578741135,18
1,1160,27192,3578741117,3578741136,19
1,1160,27193,3578741117,3578741137,20
1,1160,27194,3578741117,3578741138,21
1,1160,27195,3578741117,3578741139,22
1,1160,27196,3578741117,3578741139,22
1,1160,27197,3578741117,3578741141,24
1,1160,27198,3578741117,3578741143,26
1,1160,27199,3578741117,3578741144,27
1,1160,27200,3578741117,3578741146,29
1,1160,27201,3578741117,3578741148,31
1,1160,27202,3578741117,3578741149,32
1,1160,27203,3578741117,3578741149,32
1,1160,27204,3578741117,3578741149,32
1,1160,27205,3578741117,3578741151,34
1,1160,27206,3578741117,3578741152,35
1,1160,27207,3578741117,3578741152,35
1,1160,27208,3578741117,3578741153,36
1,1160,27209,3578741117,3578741154,37
1,1160,27210,3578741117,3578741154,37
1,1160,27211,3578741117,3578741156,39
1,1160,27212,3578741117,3578741157,40
1,1160,27213,3578741117,3578741158,41
1,1160,27214,3578741117,3578741161,44
1,1160,27215,3578741117,3578741162,45
1,1160,27216,3578741117,3578741162,45
1,1160,27217,3578741117,3578741163,46
1,1160,27218,3578741117,3578741165,48
1,1160,27219,3578741117,3578741166,49
1,1160,27220,3578741117,3578741166,49
1,1160,27221,3578741117,3578741166,49
1,1160,27222,3578741117,3578741166,49
1,1161,27223,3578741181,3578741181,0
1,1161,27224,3578741181,3578741181,0
1,1161,27225,3578741181,3578741181,0
1,1161,27226,3578741181,3578741181,0
1,1161,27227,3578741181,3578741181,0
1,1161,27228,3578741181,3578741181,0
1,1161,27229,3578741181,3578741181,0
1,1161,27230,3578741181,3578741181,0
1,1161,27231,3578741181,3578741181,0
1,1161,27232,3578741181,3578741181,0
1,1161,27233,3578741181,3578741181,0
1,1161,27234,3578741181,3578741181,0
1,1161,27235,3578741181,3578741181,0
1,1161,27236,3578741181,3578741181,0
1,1161,27237,3578741181,3578741181,0
1,1161,27238,3578741181,3578741182,1
1,1161,27239,3578741181,3578741182,1
1,1161,27240,3578741181,3578741184,3
1,1161,27241,3578741181,3578741184,3
1,1161,27242,3578741181,3578741184,3
1,1161,27243,3578741181,3578741184,3
1,1161,27244,3578741181,3578741185,4
1,1161,27245,3578741181,3578741186,5
1,1161,27246,3578741181,3578741188,7
1,1161,27247,3578741181,3578741189,8
1,1161,27248,3578741181,3578741190,9
1,1161,27249,3578741181,3578741190,9
1,1161,27250,3578741181,3578741191,10
1,1161,27251,3578741181,3578741192,11
1,1161,27252,3578741181,3578741193,12
1,1161,27253,3578741181,3578741193,12
1,1161,27254,3578741181,3578741194,13
1,1161,27255,3578741181,3578741195,14
1,1161,27256,3578741181,3578741196,15
1,1161,27257,3578741181,3578741198,17
1,1161,27258,3578741181,3578741198,17
1,1161,27259,3578741181,3578741198,17
1,1161,27260,3578741181,3578741198,17
1,1161,27261,3578741181,3578741199,18
1,1161,27262,3578741181,3578741199,18
1,1161,27263,3578741181,3578741200,19
1,1161,27264,3578741181,3578741201,20
1,1161,27265,3578741181,3578741201,20
1,1161,27266,3578741181,3578741202,21
1,1161,27267,3578741181,3578741202,21
1,1161,27268,3578741181,3578741203,22
1,1161,27269,3578741181,3578741205,24
1,1161,27270,3578741181,3578741206,25
1,1161,27271,3578741181,3578741213,32
1,1161,27272,3578741181,3578741214,33
1,1161,27273,3578741181,3578741214,33
1,1161,27274,3578741181,3578741215,34
1,1161,27275,3578741181,3578741215,34
1,1161,27276,3578741181,3578741216,35
1,1161,27277,3578741181,3578741217,36
1,1161,27278,3578741181,3578741217,36
1,1161,27279,3578741181,3578741218,37
1,1161,27280,3578741181,3578741219,38
1,1161,27281,3578741181,3578741219,38
1,1161,27282,3578741181,3578741220,39
1,1161,27283,3578741181,3578741221,40
1,1161,27284,3578741181,3578741223,42
1,1161,27285,3578741181,3578741224,43
1,1161,27286,3578741181,3578741224,43
1,1161,27287,3578741181,3578741224,43
1,1161,27288,3578741181,3578741226,45
1,1161,27289,3578741181,3578741228,47
1,1161,27290,3578741181,3578741229,48
1,1161,27291,3578741181,3578741229,48
1,1161,27292,3578741181,3578741230,49
1,1161,27293,3578741181,3578741230,49
1,1161,27294,3578741181,3578741230,49
1,1161,27295,3578741181,3578741231,50
1,1162,27296,3578741242,3578741242,0
1,1162,27297,3578741242,3578741242,0
1,1162,27298,3578741242,3578741242,0
1,1162,27299,3578741242,3578741242,0
1,1162,27300,3578741242,3578741242,0
1,1162,27301,3578741242,3578741242,0
1,1162,27302,3578741242,3578741242,0
1,1162,27303,3578741242,3578741242,0
1,1162,27304,3578741242,3578741246,4
1,1162,27305,3578741242,3578741246,4
1,1162,27306,3578741242,3578741247,5
1,1162,27307,3578741242,3578741247,5
1,1162,27308,3578741242,3578741248,6
1,1162,27309,3578741242,3578741248,6
1,1162,27310,3578741242,3578741248,6
1,1162,27311,3578741242,3578741249,7
1,1162,27312,3578741242,3578741249,7
1,1162,27313,3578741242,3578741250,8
1,1162,27314,3578741242,3578741251,9
1,1162,27315,3578741242,3578741252,10
1,1162,27316,3578741242,3578741254,12
1,1162,27317,3578741242,3578741256,14
1,1162,27318,3578741242,3578741256,14
1,1162,27319,3578741242,3578741256,14
1,1162,27320,3578741242,3578741257,15
1,1162,27321,3578741242,3578741258,16
1,1162,27322,3578741242,3578741260,18
1,1162,27323,3578741242,3578741261,19
1,1162,27324,3578741242,3578741262,20
1,1162,27325,3578741242,3578741263,21
1,1162,27326,3578741242,3578741264,22
1,1162,27327,3578741242,3578741265,23
1,1162,27328,3578741242,3578741265,23
1,1162,27329,3578741242,3578741266,24
1,1162,27330,3578741242,3578741267,25
1,1162,27331,3578741242,3578741268,26
1,1162,27332,3578741242,3578741268,26
1,1162,27333,3578741242,3578741269,27
1,1162,27334,3578741242,3578741270,28
1,1162,27335,3578741242,3578741273,31
1,1162,27336,3578741242,3578741275,33
1,1162,27337,3578741242,3578741275,33
1,1162,27338,3578741242,3578741279,37
1,1162,27339,3578741242,3578741281,39
1,1162,27340,3578741242,3578741281,39
1,1162,27341,3578741242,3578741283,41
1,1162,27342,3578741242,3578741284,42
1,1162,27343,3578741242,3578741286,44
1,1162,27344,3578741242,3578741289,47
1,1162,27345,3578741242,3578741289,47
1,1162,27346,3578741242,3578741290,48
1,1162,27347,3578741242,3578741290,48
1,1162,27348,3578741242,3578741290,48
1,1162,27349,3578741242,3578741291,49
1,1162,27350,3578741242,3578741292,50
1,1163,27351,3578741302,3578741302,0
1,1163,27352,3578741302,3578741302,0
1,1163,27353,3578741302,3578741302,0
1,1163,27354,3578741302,3578741302,0
1,1163,27355,3578741302,3578741302,0
1,1163,27356,3578741302,3578741302,0
1,1163,27357,3578741302,3578741302,0
1,1163,27358,3578741302,3578741302,0
1,1163,27359,3578741302,3578741302,0
1,1163,27360,3578741302,3578741302,0
1,1163,27361,3578741302,3578741302,0
1,1163,27362,3578741302,3578741304,2
1,1163,27363,3578741302,3578741304,2
1,1163,27364,3578741302,3578741304,2
1,1163,27365,3578741302,3578741305,3
1,1163,27366,3578741302,3578741307,5
1,1163,27367,3578741302,3578741309,7
1,1163,27368,3578741302,3578741309,7
1,1163,27369,3578741302,3578741311,9
1,1163,27370,3578741302,3578741312,10
1,1163,27371,3578741302,3578741312,10
1,1163,27372,3578741302,3578741312,10
1,1163,27373,3578741302,3578741313,11
1,1163,27374,3578741302,3578741313,11
1,1163,27375,3578741302,3578741314,12
1,1163,27376,3578741302,3578741314,12
1,1163,27377,3578741302,3578741314,12
1,1163,27378,3578741302,3578741314,12
1,1163,27379,3578741302,3578741315,13
1,1163,27380,3578741302,3578741316,14
1,1163,27381,3578741302,3578741317,15
1,1163,27382,3578741302,3578741318,16
1,1163,27383,3578741302,3578741318,16
1,1163,27384,3578741302,3578741318,16
1,1163,27385,3578741302,3578741321,19
1,1163,27386,3578741302,3578741321,19
1,1163,27387,3578741302,3578741324,22
1,1163,27388,3578741302,3578741324,22
1,1163,27389,3578741302,3578741324,22
1,1163,27390,3578741302,3578741324,22
1,1163,27391,3578741302,3578741325,23
1,1163,27392,3578741302,3578741325,23
1,1163,27393,3578741302,3578741326,24
1,1163,27394,3578741302,3578741327,25
1,1163,27395,3578741302,3578741329,27
1,1163,27396,3578741302,3578741329,27
1,1163,27397,3578741302,3578741329,27
1,1163,27398,3578741302,3578741329,27
1,1163,27399,3578741302,3578741330,28
1,1163,27400,3578741302,3578741330,28
1,1163,27401,3578741302,3578741330,28
1,1163,27402,3578741302,3578741331,29
1,1163,27403,3578741302,3578741331,29
1,1163,27404,3578741302,3578741332,30
1,1163,27405,3578741302,3578741332,30
1,1163,27406,3578741302,3578741333,31
1,1163,27407,3578741302,3578741333,31
1,1163,27408,3578741302,3578741334,32
1,1163,27409,3578741302,3578741334,32
1,1163,27410,3578741302,3578741335,33
1,1163,27411,3578741302,3578741336,34
1,1163,27412,3578741302,3578741336,34
1,1163,27413,3578741302,3578741337,35
1,1163,27414,3578741302,3578741337,35
1,1163,27415,3578741302,3578741339,37
1,1163,27416,3578741302,3578741340,38
1,1163,27417,3578741302,3578741341,39
1,1163,27418,3578741302,3578741343,41
1,1163,27419,3578741302,3578741344,42
1,1163,27420,3578741302,3578741345,43
1,1163,27421,3578741302,3578741346,44
1,1163,27422,3578741302,3578741349,47
1,1163,27423,3578741302,3578741349,47
1,1163,27424,3578741302,3578741349,47
1,1163,27425,3578741302,3578741349,47
1,1163,27426,3578741302,3578741351,49
1,1163,27427,3578741302,3578741351,49
1,1164,27428,3578741366,3578741366,0
1,1164,27429,3578741366,3578741366,0
1,1164,27430,3578741366,3578741366,0
1,1164,27431,3578741366,3578741367,1
1,1164,27432,3578741366,3578741367,1
1,1164,27433,3578741366,3578741367,1
1,1164,27434,3578741366,3578741367,1
1,1164,27435,3578741366,3578741367,1
1,1164,27436,3578741366,3578741367,1
1,1164,27437,3578741366,3578741367,1
1,1164,27438,3578741366,3578741367,1
1,1164,27439,3578741366,3578741367,1
1,1164,27440,3578741366,3578741367,1
1,1164,27441,3578741366,3578741367,1
1,1164,27442,3578741366,3578741367,1
1,1164,27443,3578741366,3578741368,2
1,1164,27444,3578741366,3578741369,3
1,1164,27445,3578741366,3578741370,4
1,1164,27446,3578741366,3578741370,4
1,1164,27447,3578741366,3578741371,5
1,1164,27448,3578741366,3578741373,7
1,1164,27449,3578741366,3578741373,7
1,1164,27450,3578741366,3578741374,8
1,1164,27451,3578741366,3578741374,8
1,1164,27452,3578741366,3578741376,10
1,1164,27453,3578741366,3578741379,13
1,1164,27454,3578741366,3578741380,14
1,1164,27455,3578741366,3578741381,15
1,1164,27456,3578741366,3578741381,15
1,1164,27457,3578741366,3578741381,15
1,1164,27458,3578741366,3578741382,16
1,1164,27459,3578741366,3578741382,16
1,1164,27460,3578741366,3578741383,17
1,1164,27461,3578741366,3578741384,18
1,1164,27462,3578741366,3578741384,18
1,1164,27463,3578741366,3578741385,19
1,1164,27464,3578741366,3578741386,20
1,1164,27465,3578741366,3578741386,20
1,1164,27466,3578741366,3578741389,23
1,1164,27467,3578741366,3578741389,23
1,1164,27468,3578741366,3578741392,26
1,1164,27469,3578741366,3578741392,26
1,1164,27470,3578741366,3578741392,26
1,1164,27471,3578741366,3578741392,26
1,1164,27472,3578741366,3578741394,28
1,1164,27473,3578741366,3578741394,28
1,1164,27474,3578741366,3578741397,31
1,1164,27475,3578741366,3578741398,32
1,1164,27476,3578741366,3578741398,32
1,1164,27477,3578741366,3578741399,33
1,1164,27478,3578741366,3578741400,34
1,1164,27479,3578741366,3578741400,34
1,1164,27480,3578741366,3578741401,35
1,1164,27481,3578741366,3578741402,36
1,1164,27482,3578741366,3578741402,36
1,1164,27483,3578741366,3578741403,37
1,1164,27484,3578741366,3578741404,38
1,1164,27485,3578741366,3578741405,39
1,1164,27486,3578741366,3578741408,42
1,1164,27487,3578741366,3578741413,47
1,1164,27488,3578741366,3578741414,48
1,1164,27489,3578741366,3578741414,48
1,1164,27490,3578741366,3578741415,49
1,1164,27491,3578741366,3578741416,50
1,1165,27492,3578741427,3578741427,0
1,1165,27493,3578741427,3578741427,0
1,1165,27494,3578741427,3578741427,0
1,1165,27495,3578741427,3578741427,0
1,1165,27496,3578741427,3578741427,0
1,1165,27497,3578741427,3578741427,0
1,1165,27498,3578741427,3578741427,0
1,1165,27499,3578741427,3578741427,0
1,1165,27500,3578741427,3578741427,0
1,1165,27501,3578741427,3578741427,0
1,1165,27502,3578741427,3578741427,0
1,1165,27503,3578741427,3578741427,0
1,1165,27504,3578741427,3578741427,0
1,1165,27505,3578741427,3578741427,0
1,1165,27506,3578741427,3578741428,1
1,1165,27507,3578741427,3578741428,1
1,1165,27508,3578741427,3578741429,2
1,1165,27509,3578741427,3578741429,2
1,1165,27510,3578741427,3578741430,3
1,1165,27511,3578741427,3578741431,4
1,1165,27512,3578741427,3578741431,4
1,1165,27513,3578741427,3578741431,4
1,1165,27514,3578741427,3578741433,6
1,1165,27515,3578741427,3578741437,10
1,1165,27516,3578741427,3578741437,10
1,1165,27517,3578741427,3578741440,13
1,1165,27518,3578741427,3578741440,13
1,1165,27519,3578741427,3578741441,14
1,1165,27520,3578741427,3578741442,15
1,1165,27521,3578741427,3578741442,15
1,1165,27522,3578741427,3578741445,18
1,1165,27523,3578741427,3578741446,19
1,1165,27524,3578741427,3578741447,20
1,1165,27525,3578741427,3578741447,20
1,1165,27526,3578741427,3578741448,21
1,1165,27527,3578741427,3578741448,21
1,1165,27528,3578741427,3578741448,21
1,1165,27529,3578741427,3578741448,21
1,1165,27530,3578741427,3578741450,23
1,1165,27531,3578741427,3578741450,23
1,1165,27532,3578741427,3578741451,24
1,1165,27533,3578741427,3578741452,25
1,1165,27534,3578741427,3578741454,27
1,1165,27535,3578741427,3578741455,28
1,1165,27536,3578741427,3578741457,30
1,1165,27537,3578741427,3578741458,31
1,1165,27538,3578741427,3578741459,32
1,1165,27539,3578741427,3578741459,32
1,1165,27540,3578741427,3578741461,34
1,1165,27541,3578741427,3578741461,34
1,1165,27542,3578741427,3578741464,37
1,1165,27543,3578741427,3578741464,37
1,1165,27544,3578741427,3578741464,37
1,1165,27545,3578741427,3578741464,37
1,1165,27546,3578741427,3578741467,40
1,1165,27547,3578741427,3578741467,40
1,1165,27548,3578741427,3578741467,40
1,1165,27549,3578741427,3578741468,41
1,1165,27550,3578741427,3578741468,41
1,1165,27551,3578741427,3578741469,42
1,1165,27552,3578741427,3578741470,43
1,1165,27553,3578741427,3578741475,48
1,1165,27554,3578741427,3578741475,48
1,1166,27555,3578741489,3578741489,0
1,1166,27556,3578741489,3578741489,0
1,1166,27557,3578741489,3578741489,0
1,1166,27558,3578741489,3578741489,0
1,1166,27559,3578741489,3578741489,0
1,1166,27560,3578741489,3578741489,0
1,1166,27561,3578741489,3578741489,0
1,1166,27562,3578741489,3578741489,0
1,1166,27563,3578741489,3578741489,0
1,1166,27564,3578741489,3578741491,2
1,1166,27565,3578741489,3578741492,3
1,1166,27566,3578741489,3578741492,3
1,1166,27567,3578741489,3578741493,4
1,1166,27568,3578741489,3578741493,4
1,1166,27569,3578741489,3578741494,5
1,1166,27570,3578741489,3578741494,5
1,1166,27571,3578741489,3578741497,8
1,1166,27572,3578741489,3578741497,8
1,1166,27573,3578741489,3578741498,9
1,1166,27574,3578741489,3578741501,12
1,1166,27575,3578741489,3578741501,12
1,1166,27576,3578741489,3578741501,12
1,1166,27577,3578741489,3578741503,14
1,1166,27578,3578741489,3578741503,14
1,1166,27579,3578741489,3578741503,14
1,1166,27580,3578741489,3578741504,15
1,1166,27581,3578741489,3578741505,16
1,1166,27582,3578741489,3578741506,17
1,1166,27583,3578741489,3578741508,19
1,1166,27584,3578741489,3578741508,19
1,1166,27585,3578741489,3578741510,21
1,1166,27586,3578741489,3578741511,22
1,1166,27587,3578741489,3578741511,22
1,1166,27588,3578741489,3578741512,23
1,1166,27589,3578741489,3578741512,23
1,1166,27590,3578741489,3578741512,23
1,1166,27591,3578741489,3578741513,24
1,1166,27592,3578741489,3578741513,24
1,1166,27593,3578741489,3578741513,24
1,1166,27594,3578741489,3578741514,25
1,1166,27595,3578741489,3578741514,25
1,1166,27596,3578741489,3578741515,26
1,1166,27597,3578741489,3578741516,27
1,1166,27598,3578741489,3578741516,27
1,1166,27599,3578741489,3578741517,28
1,1166,27600,3578741489,3578741517,28
1,1166,27601,3578741489,3578741518,29
1,1166,27602,3578741489,3578741519,30
1,1166,27603,3578741489,3578741520,31
1,1166,27604,3578741489,3578741523,34
1,1166,27605,3578741489,3578741523,34
1,1166,27606,3578741489,3578741523,34
1,1166,27607,3578741489,3578741524,35
1,1166,27608,3578741489,3578741524,35
1,1166,27609,3578741489,3578741525,36
1,1166,27610,3578741489,3578741526,37
1,1166,27611,3578741489,3578741528,39
1,1166,27612,3578741489,3578741528,39
1,1166,27613,3578741489,3578741528,39
1,1166,27614,3578741489,3578741528,39
1,1166,27615,3578741489,3578741529,40
1,1166,27616,3578741489,3578741529,40
1,1166,27617,3578741489,3578741530,41
1,1166,27618,3578741489,3578741530,41
1,1166,27619,3578741489,3578741530,41
1,1166,27620,3578741489,3578741531,42
1,1166,27621,3578741489,3578741531,42
1,1166,27622,3578741489,3578741532,43
1,1166,27623,3578741489,3578741532,43
1,1166,27624,3578741489,3578741533,44
1,1166,27625,3578741489,3578741533,44
1,1166,27626,3578741489,3578741534,45
1,1166,27627,3578741489,3578741535,46
1,1166,27628,3578741489,3578741535,46
1,1166,27629,3578741489,3578741536,47
1,1166,27630,3578741489,3578741538,49
1,1166,27631,3578741489,3578741538,49
1,1167,27632,3578741552,3578741552,0
1,1167,27633,3578741552,3578741552,0
1,1167,27634,3578741552,3578741552,0
1,1167,27635,3578741552,3578741552,0
1,1167,27636,3578741552,3578741552,0
1,1167,27637,3578741552,3578741552,0
1,1167,27638,3578741552,3578741552,0
1,1167,27639,3578741552,3578741552,0
1,1167,27640,3578741552,3578741552,0
1,1167,27641,3578741552,3578741552,0
1,1167,27642,3578741552,3578741552,0
1,1167,27643,3578741552,3578741553,1
1,1167,27644,3578741552,3578741553,1
1,1167,27645,3578741552,3578741555,3
1,1167,27646,3578741552,3578741556,4
1,1167,27647,3578741552,3578741556,4
1,1167,27648,3578741552,3578741556,4
1,1167,27649,3578741552,3578741561,9
1,1167,27650,3578741552,3578741562,10
1,1167,27651,3578741552,3578741562,10
1,1167,27652,3578741552,3578741562,10
1,1167,27653,3578741552,3578741563,11
1,1167,27654,3578741552,3578741564,12
1,1167,27655,3578741552,3578741565,13
1,1167,27656,3578741552,3578741566,14
1,1167,27657,3578741552,3578741566,14
1,1167,27658,3578741552,3578741568,16
1,1167,27659,3578741552,3578741568,16
1,1167,27660,3578741552,3578741569,17
1,1167,27661,3578741552,3578741570,18
1,1167,27662,3578741552,3578741570,18
1,1167,27663,3578741552,3578741572,20
1,1167,27664,3578741552,3578741572,20
1,1167,27665,3578741552,3578741573,21
1,1167,27666,3578741552,3578741574,22
1,1167,27667,3578741552,3578741576,24
1,1167,27668,3578741552,3578741579,27
1,1167,27669,3578741552,3578741580,28
1,1167,27670,3578741552,3578741580,28
1,1167,27671,3578741552,3578741580,28
1,1167,27672,3578741552,3578741580,28
1,1167,27673,3578741552,3578741581,29
1,1167,27674,3578741552,3578741581,29
1,1167,27675,3578741552,3578741581,29
1,1167,27676,3578741552,3578741582,30
1,1167,27677,3578741552,3578741583,31
1,1167,27678,3578741552,3578741583,31
1,1167,27679,3578741552,3578741584,32
1,1167,27680,3578741552,3578741586,34
1,1167,27681,3578741552,3578741586,34
1,1167,27682,3578741552,3578741588,36
1,1167,27683,3578741552,3578741589,37
1,1167,27684,3578741552,3578741591,39
1,1167,27685,3578741552,3578741591,39
1,1167,27686,3578741552,3578741592,40
1,1167,27687,3578741552,3578741593,41
1,1167,27688,3578741552,3578741593,41
1,1167,27689,3578741552,3578741596,44
1,1167,27690,3578741552,3578741597,45
1,1167,27691,3578741552,3578741597,45
1,1167,27692,3578741552,3578741598,46
1,1167,27693,3578741552,3578741598,46
1,1167,27694,3578741552,3578741599,47
1,1167,27695,3578741552,3578741599,47
1,1167,27696,3578741552,3578741600,48
1,1167,27697,3578741552,3578741601,49
1,1167,27698,3578741552,3578741601,49
1,1167,27699,3578741552,3578741602,50
1,1168,27700,3578741615,3578741615,0
1,1168,27701,3578741615,3578741615,0
1,1168,27702,3578741615,3578741615,0
1,1168,27703,3578741615,3578741615,0
1,1168,27704,3578741615,3578741615,0
1,1168,27705,3578741615,3578741616,1
1,1168,27706,3578741615,3578741616,1
1,1168,27707,3578741615,3578741616,1
1,1168,27708,3578741615,3578741616,1
1,1168,27709,3578741615,3578741616,1
1,1168,27710,3578741615,3578741616,1
1,1168,27711,3578741615,3578741617,2
1,1168,27712,3578741615,3578741618,3
1,1168,27713,3578741615,3578741618,3
1,1168,27714,3578741615,3578741619,4
1,1168,27715,3578741615,3578741619,4
1,1168,27716,3578741615,3578741620,5
1,1168,27717,3578741615,3578741621,6
1,1168,27718,3578741615,3578741623,8
1,1168,27719,3578741615,3578741623,8
1,1168,27720,3578741615,3578741623,8
1,1168,27721,3578741615,3578741624,9
1,1168,27722,3578741615,3578741625,10
1,1168,27723,3578741615,3578741626,11
1,1168,27724,3578741615,3578741628,13
1,1168,27725,3578741615,3578741628,13
1,1168,27726,3578741615,3578741628,13
1,1168,27727,3578741615,3578741628,13
1,1168,27728,3578741615,3578741628,13
1,1168,27729,3578741615,3578741628,13
1,1168,27730,3578741615,3578741629,14
1,1168,27731,3578741615,3578741630,15
1,1168,27732,3578741615,3578741631,16
1,1168,27733,3578741615,3578741631,16
1,1168,27734,3578741615,3578741636,21
1,1168,27735,3578741615,3578741636,21
1,1168,27736,3578741615,3578741639,24
1,1168,27737,3578741615,3578741640,25
1,1168,27738,3578741615,3578741641,26
1,1168,27739,3578741615,3578741641,26
1,1168,27740,3578741615,3578741645,30
1,1168,27741,3578741615,3578741645,30
1,1168,27742,3578741615,3578741647,32
1,1168,27743,3578741615,3578741647,32
1,1168,27744,3578741615,3578741647,32
1,1168,27745,3578741615,3578741647,32
1,1168,27746,3578741615,3578741647,32
1,1168,27747,3578741615,3578741647,32
1,1168,27748,3578741615,3578741649,34
1,1168,27749,3578741615,3578741650,35
1,1168,27750,3578741615,3578741651,36
1,1168,27751,3578741615,3578741652,37
1,1168,27752,3578741615,3578741652,37
1,1168,27753,3578741615,3578741655,40
1,1168,27754,3578741615,3578741655,40
1,1168,27755,3578741615,3578741656,41
1,1168,27756,3578741615,3578741657,42
1,1168,27757,3578741615,3578741658,43
1,1168,27758,3578741615,3578741658,43
1,1168,27759,3578741615,3578741660,45
1,1168,27760,3578741615,3578741661,46
1,1168,27761,3578741615,3578741662,47
1,1168,27762,3578741615,3578741663,48
1,1168,27763,3578741615,3578741663,48
1,1169,27764,3578741677,3578741677,0
1,1169,27765,3578741677,3578741677,0
1,1169,27766,3578741677,3578741677,0
1,1169,27767,3578741677,3578741677,0
1,1169,27768,3578741677,3578741677,0
1,1169,27769,3578741677,3578741677,0
1,1169,27770,3578741677,3578741677,0
1,1169,27771,3578741677,3578741679,2
1,1169,27772,3578741677,3578741681,4
1,1169,27773,3578741677,3578741683,6
1,1169,27774,3578741677,3578741685,8
1,1169,27775,3578741677,3578741685,8
1,1169,27776,3578741677,3578741688,11
1,1169,27777,3578741677,3578741689,12
1,1169,27778,3578741677,3578741689,12
1,1169,27779,3578741677,3578741689,12
1,1169,27780,3578741677,3578741691,14
1,1169,27781,3578741677,3578741691,14
1,1169,27782,3578741677,3578741692,15
1,1169,27783,3578741677,3578741693,16
1,1169,27784,3578741677,3578741693,16
1,1169,27785,3578741677,3578741694,17
1,1169,27786,3578741677,3578741694,17
1,1169,27787,3578741677,3578741697,20
1,1169,27788,3578741677,3578741697,20
1,1169,27789,3578741677,3578741699,22
1,1169,27790,3578741677,3578741701,24
1,1169,27791,3578741677,3578741701,24
1,1169,27792,3578741677,3578741702,25
1,1169,27793,3578741677,3578741702,25
1,1169,27794,3578741677,3578741703,26
1,1169,27795,3578741677,3578741703,26
1,1169,27796,3578741677,3578741703,26
1,1169,27797,3578741677,3578741706,29
1,1169,27798,3578741677,3578741706,29
1,1169,27799,3578741677,3578741708,31
1,1169,27800,3578741677,3578741710,33
1,1169,27801,3578741677,3578741711,34
1,1169,27802,3578741677,3578741711,34
1,1169,27803,3578741677,3578741711,34
1,1169,27804,3578741677,3578741712,35
1,1169,27805,3578741677,3578741712,35
1,1169,27806,3578741677,3578741713,36
1,1169,27807,3578741677,3578741713,36
1,1169,27808,3578741677,3578741713,36
1,1169,27809,3578741677,3578741714,37
1,1169,27810,3578741677,3578741714,37
1,1169,27811,3578741677,3578741715,38
1,1169,27812,3578741677,3578741715,38
1,1169,27813,3578741677,3578741716,39
1,1169,27814,3578741677,3578741716,39
1,1169,27815,3578741677,3578741717,40
1,1169,27816,3578741677,3578741718,41
1,1169,27817,3578741677,3578741720,43
1,1169,27818,3578741677,3578741721,44
1,1169,27819,3578741677,3578741723,46
1,1169,27820,3578741677,3578741723,46
1,1169,27821,3578741677,3578741723,46
1,1169,27822,3578741677,3578741724,47
1,1169,27823,3578741677,3578741724,47
1,1169,27824,3578741677,3578741725,48
1,1169,27825,3578741677,3578741725,48
1,1169,27826,3578741677,3578741726,49
1,1170,27827,3578741738,3578741738,0
1,1170,27828,3578741738,3578741738,0
1,1170,27829,3578741738,3578741738,0
1,1170,27830,3578741738,3578741738,0
1,1170,27831,3578741738,3578741738,0
1,1170,27832,3578741738,3578741738,0
1,1170,27833,3578741738,3578741738,0
1,1170,27834,3578741738,3578741738,0
1,1170,27835,3578741738,3578741738,0
1,1170,27836,3578741738,3578741738,0
1,1170,27837,3578741738,3578741738,0
1,1170,27838,3578741738,3578741738,0
1,1170,27839,3578741738,3578741738,0
1,1170,27840,3578741738,3578741738,0
1,1170,27841,3578741738,3578741738,0
1,1170,27842,3578741738,3578741738,0
1,1170,27843,3578741738,3578741738,0
1,1170,27844,3578741738,3578741738,0
1,1170,27845,3578741738,3578741738,0
1,1170,27846,3578741738,3578741740,2
1,1170,27847,3578741738,3578741740,2
1,1170,27848,3578741738,3578741742,4
1,1170,27849,3578741738,3578741744,6
1,1170,27850,3578741738,3578741745,7
1,1170,27851,3578741738,3578741748,10
1,1170,27852,3578741738,3578741748,10
1,1170,27853,3578741738,3578741748,10
1,1170,27854,3578741738,3578741749,11
1,1170,27855,3578741738,3578741749,11
1,1170,27856,3578741738,3578741751,13
1,1170,27857,3578741738,3578741752,14
1,1170,27858,3578741738,3578741753,15
1,1170,27859,3578741738,3578741755,17
1,1170,27860,3578741738,3578741755,17
1,1170,27861,3578741738,3578741756,18
1,1170,27862,3578741738,3578741756,18
1,1170,27863,3578741738,3578741759,21
1,1170,27864,3578741738,3578741761,23
1,1170,27865,3578741738,3578741762,24
1,1170,27866,3578741738,3578741762,24
1,1170,27867,3578741738,3578741762,24
1,1170,27868,3578741738,3578741762,24
1,1170,27869,3578741738,3578741764,26
1,1170,27870,3578741738,3578741765,27
1,1170,27871,3578741738,3578741765,27
1,1170,27872,3578741738,3578741766,28
1,1170,27873,3578741738,3578741768,30
1,1170,27874,3578741738,3578741770,32
1,1170,27875,3578741738,3578741770,32
1,1170,27876,3578741738,3578741771,33
1,1170,27877,3578741738,3578741772,34
1,1170,27878,3578741738,3578741772,34
1,1170,27879,3578741738,3578741773,35
1,1170,27880,3578741738,3578741775,37
1,1170,27881,3578741738,3578741776,38
1,1170,27882,3578741738,3578741778,40
1,1170,27883,3578741738,3578741779,41
1,1170,27884,3578741738,3578741779,41
1,1170,27885,3578741738,3578741780,42
1,1170,27886,3578741738,3578741780,42
1,1170,27887,3578741738,3578741781,43
1,1170,27888,3578741738,3578741781,43
1,1170,27889,3578741738,3578741781,43
1,1170,27890,3578741738,3578741783,45
1,1170,27891,3578741738,3578741783,45
1,1170,27892,3578741738,3578741783,45
1,1170,27893,3578741738,3578741784,46
1,1170,27894,3578741738,3578741785,47
1,1170,27895,3578741738,3578741786,48
1,1170,27896,3578741738,3578741788,50
1,1171,27897,3578741799,3578741800,1
1,1171,27898,3578741799,3578741800,1
1,1171,27899,3578741799,3578741800,1
1,1171,27900,3578741799,3578741800,1
1,1171,27901,3578741799,3578741800,1
1,1171,27902,3578741799,3578741800,1
1,1171,27903,3578741799,3578741800,1
1,1171,27904,3578741799,3578741800,1
1,1171,27905,3578741799,3578741800,1
1,1171,27906,3578741799,3578741800,1
1,1171,27907,3578741799,3578741800,1
1,1171,27908,3578741799,3578741800,1
1,1171,27909,3578741799,3578741800,1
1,1171,27910,3578741799,3578741800,1
1,1171,27911,3578741799,3578741801,2
1,1171,27912,3578741799,3578741802,3
1,1171,27913,3578741799,3578741803,4
1,1171,27914,3578741799,3578741805,6
1,1171,27915,3578741799,3578741807,8
1,1171,27916,3578741799,3578741812,13
1,1171,27917,3578741799,3578741814,15
1,1171,27918,3578741799,3578741814,15
1,1171,27919,3578741799,3578741814,15
1,1171,27920,3578741799,3578741815,16
1,1171,27921,3578741799,3578741815,16
1,1171,27922,3578741799,3578741815,16
1,1171,27923,3578741799,3578741817,18
1,1171,27924,3578741799,3578741818,19
1,1171,27925,3578741799,3578741818,19
1,1171,27926,3578741799,3578741819,20
1,1171,27927,3578741799,3578741819,20
1,1171,27928,3578741799,3578741820,21
1,1171,27929,3578741799,3578741820,21
1,1171,27930,3578741799,3578741821,22
1,1171,27931,3578741799,3578741823,24
1,1171,27932,3578741799,3578741823,24
1,1171,27933,3578741799,3578741824,25
1,1171,27934,3578741799,3578741824,25
1,1171,27935,3578741799,3578741824,25
1,1171,27936,3578741799,3578741825,26
1,1171,27937,3578741799,3578741826,27
1,1171,27938,3578741799,3578741826,27
1,1171,27939,3578741799,3578741827,28
1,1171,27940,3578741799,3578741828,29
1,1171,27941,3578741799,3578741828,29
1,1171,27942,3578741799,3578741828,29
1,1171,27943,3578741799,3578741828,29
1,1171,27944,3578741799,3578741828,29
1,1171,27945,3578741799,3578741829,30
1,1171,27946,3578741799,3578741829,30
1,1171,27947,3578741799,3578741830,31
1,1171,27948,3578741799,3578741831,32
1,1171,27949,3578741799,3578741831,32
1,1171,27950,3578741799,3578741836,37
1,1171,27951,3578741799,3578741839,40
1,1171,27952,3578741799,3578741839,40
1,1171,27953,3578741799,3578741841,42
1,1171,27954,3578741799,3578741841,42
1,1171,27955,3578741799,3578741841,42
1,1171,27956,3578741799,3578741845,46
1,1171,27957,3578741799,3578741845,46
1,1171,27958,3578741799,3578741847,48
1,1171,27959,3578741799,3578741847,48
1,1171,27960,3578741799,3578741847,48
1,1171,27961,3578741799,3578741848,49
1,1171,27962,3578741799,3578741848,49
1,1171,27963,3578741799,3578741849,50
1,1172,27964,3578741861,3578741861,0
1,1172,27965,3578741861,3578741861,0
1,1172,27966,3578741861,3578741861,0
1,1172,27967,3578741861,3578741861,0
1,1172,27968,3578741861,3578741861,0
1,1172,27969,3578741861,3578741861,0
1,1172,27970,3578741861,3578741861,0
1,1172,27971,3578741861,3578741861,0
1,1172,27972,3578741861,3578741861,0
1,1172,27973,3578741861,3578741861,0
1,1172,27974,3578741861,3578741861,0
1,1172,27975,3578741861,3578741861,0
1,1172,27976,3578741861,3578741861,0
1,1172,27977,3578741861,3578741863,2
1,1172,27978,3578741861,3578741864,3
1,1172,27979,3578741861,3578741865,4
1,1172,27980,3578741861,3578741865,4
1,1172,27981,3578741861,3578741866,5
1,1172,27982,3578741861,3578741866,5
1,1172,27983,3578741861,3578741866,5
1,1172,27984,3578741861,3578741867,6
1,1172,27985,3578741861,3578741869,8
1,1172,27986,3578741861,3578741875,14
1,1172,27987,3578741861,3578741881,20
1,1172,27988,3578741861,3578741881,20
1,1172,27989,3578741861,3578741883,22
1,1172,27990,3578741861,3578741885,24
1,1172,27991,3578741861,3578741886,25
1,1172,27992,3578741861,3578741888,27
1,1172,27993,3578741861,3578741889,28
1,1172,27994,3578741861,3578741890,29
1,1172,27995,3578741861,3578741890,29
1,1172,27996,3578741861,3578741891,30
1,1172,27997,3578741861,3578741892,31
1,1172,27998,3578741861,3578741893,32
1,1172,27999,3578741861,3578741893,32
1,1172,28000,3578741861,3578741893,32
1,1172,28001,3578741861,3578741894,33
1,1172,28002,3578741861,3578741894,33
1,1172,28003,3578741861,3578741897,36
1,1172,28004,3578741861,3578741897,36
1,1172,28005,3578741861,3578741899,38
1,1172,28006,3578741861,3578741901,40
1,1172,28007,3578741861,3578741901,40
1,1172,28008,3578741861,3578741901,40
1,1172,28009,3578741861,3578741903,42
1,1172,28010,3578741861,3578741903,42
1,1172,28011,3578741861,3578741903,42
1,1172,28012,3578741861,3578741904,43
1,1172,28013,3578741861,3578741906,45
1,1172,28014,3578741861,3578741906,45
1,1172,28015,3578741861,3578741908,47
1,1172,28016,3578741861,3578741908,47
1,1172,28017,3578741861,3578741910,49
1,1172,28018,3578741861,3578741911,50
1,1173,28019,3578741924,3578741924,0
1,1173,28020,3578741924,3578741924,0
1,1173,28021,3578741924,3578741924,0
1,1173,28022,3578741924,3578741924,0
1,1173,28023,3578741924,3578741924,0
1,1173,28024,3578741924,3578741924,0
1,1173,28025,3578741924,3578741924,0
1,1173,28026,3578741924,3578741924,0
1,1173,28027,3578741924,3578741924,0
1,1173,28028,3578741924,3578741924,0
1,1173,28029,3578741924,3578741924,0
1,1173,28030,3578741924,3578741924,0
1,1173,28031,3578741924,3578741924,0
1,1173,28032,3578741924,3578741924,0
1,1173,28033,3578741924,3578741924,0
1,1173,28034,3578741924,3578741924,0
1,1173,28035,3578741924,3578741924,0
1,1173,28036,3578741924,3578741924,0
1,1173,28037,3578741924,3578741924,0
1,1173,28038,3578741924,3578741924,0
1,1173,28039,3578741924,3578741924,0
1,1173,28040,3578741924,3578741924,0
1,1173,28041,3578741924,3578741925,1
1,1173,28042,3578741924,3578741925,1
1,1173,28043,3578741924,3578741927,3
1,1173,28044,3578741924,3578741928,4
1,1173,28045,3578741924,3578741930,6
1,1173,28046,3578741924,3578741930,6
1,1173,28047,3578741924,3578741931,7
1,1173,28048,3578741924,3578741932,8
1,1173,28049,3578741924,3578741932,8
1,1173,28050,3578741924,3578741932,8
1,1173,28051,3578741924,3578741933,9
1,1173,28052,3578741924,3578741933,9
1,1173,28053,3578741924,3578741934,10
1,1173,28054,3578741924,3578741934,10
1,1173,28055,3578741924,3578741934,10
1,1173,28056,3578741924,3578741935,11
1,1173,28057,3578741924,3578741935,11
1,1173,28058,3578741924,3578741935,11
1,1173,28059,3578741924,3578741935,11
1,1173,28060,3578741924,3578741935,11
1,1173,28061,3578741924,3578741937,13
1,1173,28062,3578741924,3578741938,14
1,1173,28063,3578741924,3578741940,16
1,1173,28064,3578741924,3578741943,19
1,1173,28065,3578741924,3578741943,19
1,1173,28066,3578741924,3578741944,20
1,1173,28067,3578741924,3578741946,22
1,1173,28068,3578741924,3578741948,24
1,1173,28069,3578741924,3578741948,24
1,1173,28070,3578741924,3578741948,24
1,1173,28071,3578741924,3578741949,25
1,1173,28072,3578741924,3578741949,25
1,1173,28073,3578741924,3578741951,27
1,1173,28074,3578741924,3578741952,28
1,1173,28075,3578741924,3578741953,29
1,1173,28076,3578741924,3578741953,29
1,1173,28077,3578741924,3578741955,31
1,1173,28078,3578741924,3578741955,31
1,1173,28079,3578741924,3578741956,32
1,1173,28080,3578741924,3578741957,33
1,1173,28081,3578741924,3578741958,34
1,1173,28082,3578741924,3578741961,37
1,1173,28083,3578741924,3578741961,37
1,1173,28084,3578741924,3578741962,38
1,1173,28085,3578741924,3578741962,38
1,1173,28086,3578741924,3578741963,39
1,1173,28087,3578741924,3578741964,40
1,1173,28088,3578741924,3578741965,41
1,1173,28089,3578741924,3578741965,41
1,1173,28090,3578741924,3578741966,42
1,1173,28091,3578741924,3578741967,43
1,1173,28092,3578741924,3578741968,44
1,1173,28093,3578741924,3578741969,45
1,1173,28094,3578741924,3578741970,46
1,1173,28095,3578741924,3578741970,46
1,1173,28096,3578741924,3578741971,47
1,1173,28097,3578741924,3578741971,47
1,1173,28098,3578741924,3578741972,48
1,1173,28099,3578741924,3578741973,49
1,1174,28100,3578741987,3578741987,0
1,1174,28101,3578741987,3578741987,0
1,1174,28102,3578741987,3578741987,0
1,1174,28103,3578741987,3578741987,0
1,1174,28104,3578741987,3578741987,0
1,1174,28105,3578741987,3578741987,0
1,1174,28106,3578741987,3578741987,0
1,1174,28107,3578741987,3578741987,0
1,1174,28108,3578741987,3578741987,0
1,1174,28109,3578741987,3578741987,0
1,1174,28110,3578741987,3578741987,0
1,1174,28111,3578741987,3578741987,0
1,1174,28112,3578741987,3578741987,0
1,1174,28113,3578741987,3578741987,0
1,1174,28114,3578741987,3578741987,0
1,1174,28115,3578741987,3578741987,0
1,1174,28116,3578741987,3578741988,1
1,1174,28117,3578741987,3578741990,3
1,1174,28118,3578741987,3578741991,4
1,1174,28119,3578741987,3578741992,5
1,1174,28120,3578741987,3578741992,5
1,1174,28121,3578741987,3578741993,6
1,1174,28122,3578741987,3578741994,7
1,1174,28123,3578741987,3578741996,9
1,1174,28124,3578741987,3578741997,10
1,1174,28125,3578741987,3578741997,10
1,1174,28126,3578741987,3578741998,11
1,1174,28127,3578741987,3578741998,11
1,1174,28128,3578741987,3578741999,12
1,1174,28129,3578741987,3578741999,12
1,1174,28130,3578741987,3578741999,12
1,1174,28131,3578741987,3578742000,13
1,1174,28132,3578741987,3578742001,14
1,1174,28133,3578741987,3578742001,14
1,1174,28134,3578741987,3578742002,15
1,1174,28135,3578741987,3578742003,16
1,1174,28136,3578741987,3578742003,16
1,1174,28137,3578741987,3578742006,19
1,1174,28138,3578741987,3578742007,20
1,1174,28139,3578741987,3578742013,26
1,1174,28140,3578741987,3578742014,27
1,1174,28141,3578741987,3578742014,27
1,1174,28142,3578741987,3578742014,27
1,1174,28143,3578741987,3578742015,28
1,1174,28144,3578741987,3578742016,29
1,1174,28145,3578741987,3578742016,29
1,1174,28146,3578741987,3578742018,31
1,1174,28147,3578741987,3578742018,31
1,1174,28148,3578741987,3578742018,31
1,1174,28149,3578741987,3578742018,31
1,1174,28150,3578741987,3578742019,32
1,1174,28151,3578741987,3578742020,33
1,1174,28152,3578741987,3578742020,33
1,1174,28153,3578741987,3578742021,34
1,1174,28154,3578741987,3578742023,36
1,1174,28155,3578741987,3578742024,37
1,1174,28156,3578741987,3578742024,37
1,1174,28157,3578741987,3578742024,37
1,1174,28158,3578741987,3578742025,38
1,1174,28159,3578741987,3578742026,39
1,1174,28160,3578741987,3578742026,39
1,1174,28161,3578741987,3578742027,40
1,1174,28162,3578741987,3578742028,41
1,1174,28163,3578741987,3578742028,41
1,1174,28164,3578741987,3578742028,41
1,1174,28165,3578741987,3578742029,42
1,1174,28166,3578741987,3578742029,42
1,1174,28167,3578741987,3578742030,43
1,1174,28168,3578741987,3578742031,44
1,1174,28169,3578741987,3578742031,44
1,1174,28170,3578741987,3578742036,49
1,1175,28171,3578742051,3578742051,0
1,1175,28172,3578742051,3578742051,0
1,1175,28173,3578742051,3578742051,0
1,1175,28174,3578742051,3578742051,0
1,1175,28175,3578742051,3578742051,0
1,1175,28176,3578742051,3578742051,0
1,1175,28177,3578742051,3578742051,0
1,1175,28178,3578742051,3578742051,0
1,1175,28179,3578742051,3578742051,0
1,1175,28180,3578742051,3578742051,0
1,1175,28181,3578742051,3578742051,0
1,1175,28182,3578742051,3578742051,0
1,1175,28183,3578742051,3578742051,0
1,1175,28184,3578742051,3578742051,0
1,1175,28185,3578742051,3578742051,0
1,1175,28186,3578742051,3578742051,0
1,1175,28187,3578742051,3578742051,0
1,1175,28188,3578742051,3578742052,1
1,1175,28189,3578742051,3578742053,2
1,1175,28190,3578742051,3578742055,4
1,1175,28191,3578742051,3578742057,6
1,1175,28192,3578742051,3578742057,6
1,1175,28193,3578742051,3578742058,7
1,1175,28194,3578742051,3578742058,7
1,1175,28195,3578742051,3578742059,8
1,1175,28196,3578742051,3578742060,9
1,1175,28197,3578742051,3578742062,11
1,1175,28198,3578742051,3578742063,12
1,1175,28199,3578742051,3578742064,13
1,1175,28200,3578742051,3578742064,13
1,1175,28201,3578742051,3578742065,14
1,1175,28202,3578742051,3578742065,14
1,1175,28203,3578742051,3578742065,14
1,1175,28204,3578742051,3578742066,15
1,1175,28205,3578742051,3578742067,16
1,1175,28206,3578742051,3578742067,16
1,1175,28207,3578742051,3578742068,17
1,1175,28208,3578742051,3578742069,18
1,1175,28209,3578742051,3578742073,22
1,1175,28210,3578742051,3578742076,25
1,1175,28211,3578742051,3578742080,29
1,1175,28212,3578742051,3578742080,29
1,1175,28213,3578742051,3578742081,30
1,1175,28214,3578742051,3578742083,32
1,1175,28215,3578742051,3578742085,34
1,1175,28216,3578742051,3578742086,35
1,1175,28217,3578742051,3578742089,38
1,1175,28218,3578742051,3578742089,38
1,1175,28219,3578742051,3578742089,38
1,1175,28220,3578742051,3578742089,38
1,1175,28221,3578742051,3578742090,39
1,1175,28222,3578742051,3578742091,40
1,1175,28223,3578742051,3578742092,41
1,1175,28224,3578742051,3578742092,41
1,1175,28225,3578742051,3578742093,42
1,1175,28226,3578742051,3578742093,42
1,1175,28227,3578742051,3578742094,43
1,1175,28228,3578742051,3578742095,44
1,1175,28229,3578742051,3578742097,46
1,1175,28230,3578742051,3578742098,47
1,1175,28231,3578742051,3578742098,47
1,1175,28232,3578742051,3578742101,50
1,1176,28233,3578742114,3578742114,0
1,1176,28234,3578742114,3578742114,0
1,1176,28235,3578742114,3578742114,0
1,1176,28236,3578742114,3578742114,0
1,1176,28237,3578742114,3578742114,0
1,1176,28238,3578742114,3578742114,0
1,1176,28239,3578742114,3578742114,0
1,1176,28240,3578742114,3578742114,0
1,1176,28241,3578742114,3578742114,0
1,1176,28242,3578742114,3578742114,0
1,1176,28243,3578742114,3578742114,0
1,1176,28244,3578742114,3578742114,0
1,1176,28245,3578742114,3578742114,0
1,1176,28246,3578742114,3578742114,0
1,1176,28247,3578742114,3578742114,0
1,1176,28248,3578742114,3578742114,0
1,1176,28249,3578742114,3578742114,0
1,1176,28250,3578742114,3578742114,0
1,1176,28251,3578742114,3578742114,0
1,1176,28252,3578742114,3578742114,0
1,1176,28253,3578742114,3578742115,1
1,1176,28254,3578742114,3578742115,1
1,1176,28255,3578742114,3578742116,2
1,1176,28256,3578742114,3578742117,3
1,1176,28257,3578742114,3578742117,3
1,1176,28258,3578742114,3578742117,3
1,1176,28259,3578742114,3578742117,3
1,1176,28260,3578742114,3578742118,4
1,1176,28261,3578742114,3578742120,6
1,1176,28262,3578742114,3578742122,8
1,1176,28263,3578742114,3578742123,9
1,1176,28264,3578742114,3578742123,9
1,1176,28265,3578742114,3578742123,9
1,1176,28266,3578742114,3578742124,10
1,1176,28267,3578742114,3578742124,10
1,1176,28268,3578742114,3578742125,11
1,1176,28269,3578742114,3578742125,11
1,1176,28270,3578742114,3578742127,13
1,1176,28271,3578742114,3578742128,14
1,1176,28272,3578742114,3578742130,16
1,1176,28273,3578742114,3578742131,17
1,1176,28274,3578742114,3578742132,18
1,1176,28275,3578742114,3578742132,18
1,1176,28276,3578742114,3578742132,18
1,1176,28277,3578742114,3578742132,18
1,1176,28278,3578742114,3578742133,19
1,1176,28279,3578742114,3578742133,19
1,1176,28280,3578742114,3578742134,20
1,1176,28281,3578742114,3578742134,20
1,1176,28282,3578742114,3578742135,21
1,1176,28283,3578742114,3578742135,21
1,1176,28284,3578742114,3578742135,21
1,1176,28285,3578742114,3578742135,21
1,1176,28286,3578742114,3578742135,21
1,1176,28287,3578742114,3578742136,22
1,1176,28288,3578742114,3578742137,23
1,1176,28289,3578742114,3578742138,24
1,1176,28290,3578742114,3578742140,26
1,1176,28291,3578742114,3578742142,28
1,1176,28292,3578742114,3578742143,29
1,1176,28293,3578742114,3578742144,30
1,1176,28294,3578742114,3578742146,32
1,1176,28295,3578742114,3578742148,34
1,1176,28296,3578742114,3578742148,34
1,1176,28297,3578742114,3578742148,34
1,1176,28298,3578742114,3578742149,35
1,1176,28299,3578742114,3578742150,36
1,1176,28300,3578742114,3578742151,37
1,1176,28301,3578742114,3578742152,38
1,1176,28302,3578742114,3578742153,39
1,1176,28303,3578742114,3578742153,39
1,1176,28304,3578742114,3578742155,41
1,1176,28305,3578742114,3578742155,41
1,1176,28306,3578742114,3578742156,42
1,1176,28307,3578742114,3578742156,42
1,1176,28308,3578742114,3578742162,48
1,1176,28309,3578742114,3578742162,48
1,1176,28310,3578742114,3578742162,48
1,1176,28311,3578742114,3578742162,48
1,1176,28312,3578742114,3578742163,49
1,1177,28313,3578742176,3578742176,0
1,1177,28314,3578742176,3578742176,0
1,1177,28315,3578742176,3578742176,0
1,1177,28316,3578742176,3578742176,0
1,1177,28317,3578742176,3578742176,0
1,1177,28318,3578742176,3578742176,0
1,1177,28319,3578742176,3578742176,0
1,1177,28320,3578742176,3578742176,0
1,1177,28321,3578742176,3578742176,0
1,1177,28322,3578742176,3578742176,0
1,1177,28323,3578742176,3578742176,0
1,1177,28324,3578742176,3578742176,0
1,1177,28325,3578742176,3578742176,0
1,1177,28326,3578742176,3578742176,0
1,1177,28327,3578742176,3578742178,2
1,1177,28328,3578742176,3578742178,2
1,1177,28329,3578742176,3578742180,4
1,1177,28330,3578742176,3578742180,4
1,1177,28331,3578742176,3578742180,4
1,1177,28332,3578742176,3578742181,5
1,1177,28333,3578742176,3578742181,5
1,1177,28334,3578742176,3578742181,5
1,1177,28335,3578742176,3578742183,7
1,1177,28336,3578742176,3578742183,7
1,1177,28337,3578742176,3578742184,8
1,1177,28338,3578742176,3578742184,8
1,1177,28339,3578742176,3578742185,9
1,1177,28340,3578742176,3578742186,10
1,1177,28341,3578742176,3578742188,12
1,1177,28342,3578742176,3578742189,13
1,1177,28343,3578742176,3578742191,15
1,1177,28344,3578742176,3578742191,15
1,1177,28345,3578742176,3578742192,16
1,1177,28346,3578742176,3578742192,16
1,1177,28347,3578742176,3578742193,17
1,1177,28348,3578742176,3578742194,18
1,1177,28349,3578742176,3578742197,21
1,1177,28350,3578742176,3578742197,21
1,1177,28351,3578742176,3578742197,21
1,1177,28352,3578742176,3578742198,22
1,1177,28353,3578742176,3578742199,23
1,1177,28354,3578742176,3578742199,23
1,1177,28355,3578742176,3578742199,23
1,1177,28356,3578742176,3578742200,24
1,1177,28357,3578742176,3578742201,25
1,1177,28358,3578742176,3578742201,25
1,1177,28359,3578742176,3578742201,25
1,1177,28360,3578742176,3578742202,26
1,1177,28361,3578742176,3578742203,27
1,1177,28362,3578742176,3578742203,27
1,1177,28363,3578742176,3578742206,30
1,1177,28364,3578742176,3578742212,36
1,1177,28365,3578742176,3578742213,37
1,1177,28366,3578742176,3578742214,38
1,1177,28367,3578742176,3578742214,38
1,1177,28368,3578742176,3578742215,39
1,1177,28369,3578742176,3578742216,40
1,1177,28370,3578742176,3578742217,41
1,1177,28371,3578742176,3578742218,42
1,1177,28372,3578742176,3578742218,42
1,1177,28373,3578742176,3578742218,42
1,1177,28374,3578742176,3578742219,43
1,1177,28375,3578742176,3578742219,43
1,1177,28376,3578742176,3578742220,44
1,1177,28377,3578742176,3578742220,44
1,1177,28378,3578742176,3578742220,44
1,1177,28379,3578742176,3578742223,47
1,1177,28380,3578742176,3578742224,48
1,1177,28381,3578742176,3578742224,48
1,1177,28382,3578742176,3578742224,48
1,1177,28383,3578742176,3578742224,48
1,1177,28384,3578742176,3578742226,50
1,1178,28385,3578742240,3578742240,0
1,1178,28386,3578742240,3578742240,0
1,1178,28387,3578742240,3578742240,0
1,1178,28388,3578742240,3578742240,0
1,1178,28389,3578742240,3578742240,0
1,1178,28390,3578742240,3578742240,0
1,1178,28391,3578742240,3578742240,0
1,1178,28392,3578742240,3578742240,0
1,1178,28393,3578742240,3578742240,0
1,1178,28394,3578742240,3578742240,0
1,1178,28395,3578742240,3578742240,0
1,1178,28396,3578742240,3578742240,0
1,1178,28397,3578742240,3578742240,0
1,1178,28398,3578742240,3578742240,0
1,1178,28399,3578742240,3578742241,1
1,1178,28400,3578742240,3578742241,1
1,1178,28401,3578742240,3578742242,2
1,1178,28402,3578742240,3578742245,5
1,1178,28403,3578742240,3578742245,5
1,1178,28404,3578742240,3578742247,7
1,1178,28405,3578742240,3578742248,8
1,1178,28406,3578742240,3578742248,8
1,1178,28407,3578742240,3578742248,8
1,1178,28408,3578742240,3578742249,9
1,1178,28409,3578742240,3578742249,9
1,1178,28410,3578742240,3578742249,9
1,1178,28411,3578742240,3578742249,9
1,1178,28412,3578742240,3578742250,10
1,1178,28413,3578742240,3578742251,11
1,1178,28414,3578742240,3578742253,13
1,1178,28415,3578742240,3578742254,14
1,1178,28416,3578742240,3578742255,15
1,1178,28417,3578742240,3578742256,16
1,1178,28418,3578742240,3578742258,18
1,1178,28419,3578742240,3578742258,18
1,1178,28420,3578742240,3578742260,20
1,1178,28421,3578742240,3578742261,21
1,1178,28422,3578742240,3578742262,22
1,1178,28423,3578742240,3578742263,23
1,1178,28424,3578742240,3578742264,24
1,1178,28425,3578742240,3578742264,24
1,1178,28426,3578742240,3578742264,24
1,1178,28427,3578742240,3578742265,25
1,1178,28428,3578742240,3578742266,26
1,1178,28429,3578742240,3578742266,26
1,1178,28430,3578742240,3578742267,27
1,1178,28431,3578742240,3578742267,27
1,1178,28432,3578742240,3578742268,28
1,1178,28433,3578742240,3578742268,28
1,1178,28434,3578742240,3578742270,30
1,1178,28435,3578742240,3578742274,34
1,1178,28436,3578742240,3578742275,35
1,1178,28437,3578742240,3578742275,35
1,1178,28438,3578742240,3578742279,39
1,1178,28439,3578742240,3578742281,41
1,1178,28440,3578742240,3578742283,43
1,1178,28441,3578742240,3578742284,44
1,1178,28442,3578742240,3578742286,46
1,1178,28443,3578742240,3578742288,48
1,1178,28444,3578742240,3578742288,48
1,1178,28445,3578742240,3578742289,49
1,1178,28446,3578742240,3578742290,50
1,1179,28447,3578742301,3578742301,0
1,1179,28448,3578742301,3578742301,0
1,1179,28449,3578742301,3578742301,0
1,1179,28450,3578742301,3578742301,0
1,1179,28451,3578742301,3578742301,0
1,1179,28452,3578742301,3578742301,0
1,1179,28453,3578742301,3578742301,0
1,1179,28454,3578742301,3578742301,0
1,1179,28455,3578742301,3578742301,0
1,1179,28456,3578742301,3578742301,0
1,1179,28457,3578742301,3578742301,0
1,1179,28458,3578742301,3578742301,0
1,1179,28459,3578742301,3578742302,1
1,1179,28460,3578742301,3578742302,1
1,1179,28461,3578742301,3578742303,2
1,1179,28462,3578742301,3578742304,3
1,1179,28463,3578742301,3578742305,4
1,1179,28464,3578742301,3578742305,4
1,1179,28465,3578742301,3578742305,4
1,1179,28466,3578742301,3578742305,4
1,1179,28467,3578742301,3578742307,6
1,1179,28468,3578742301,3578742308,7
1,1179,28469,3578742301,3578742310,9
1,1179,28470,3578742301,3578742310,9
1,1179,28471,3578742301,3578742311,10
1,1179,28472,3578742301,3578742312,11
1,1179,28473,3578742301,3578742312,11
1,1179,28474,3578742301,3578742313,12
1,1179,28475,3578742301,3578742313,12
1,1179,28476,3578742301,3578742313,12
1,1179,28477,3578742301,3578742313,12
1,1179,28478,3578742301,3578742314,13
1,1179,28479,3578742301,3578742314,13
1,1179,28480,3578742301,3578742315,14
1,1179,28481,3578742301,3578742316,15
1,1179,28482,3578742301,3578742316,15
1,1179,28483,3578742301,3578742316,15
1,1179,28484,3578742301,3578742316,15
1,1179,28485,3578742301,3578742317,16
1,1179,28486,3578742301,3578742318,17
1,1179,28487,3578742301,3578742318,17
1,1179,28488,3578742301,3578742318,17
1,1179,28489,3578742301,3578742321,20
1,1179,28490,3578742301,3578742322,21
1,1179,28491,3578742301,3578742323,22
1,1179,28492,3578742301,3578742323,22
1,1179,28493,3578742301,3578742324,23
1,1179,28494,3578742301,3578742324,23
1,1179,28495,3578742301,3578742324,23
1,1179,28496,3578742301,3578742325,24
1,1179,28497,3578742301,3578742325,24
1,1179,28498,3578742301,3578742328,27
1,1179,28499,3578742301,3578742328,27
1,1179,28500,3578742301,3578742330,29
1,1179,28501,3578742301,3578742330,29
1,1179,28502,3578742301,3578742331,30
1,1179,28503,3578742301,3578742332,31
1,1179,28504,3578742301,3578742332,31
1,1179,28505,3578742301,3578742332,31
1,1179,28506,3578742301,3578742332,31
1,1179,28507,3578742301,3578742333,32
1,1179,28508,3578742301,3578742333,32
1,1179,28509,3578742301,3578742334,33
1,1179,28510,3578742301,3578742335,34
1,1179,28511,3578742301,3578742335,34
1,1179,28512,3578742301,3578742335,34
1,1179,28513,3578742301,3578742335,34
1,1179,28514,3578742301,3578742335,34
1,1179,28515,3578742301,3578742335,34
1,1179,28516,3578742301,3578742336,35
1,1179,28517,3578742301,3578742337,36
1,1179,28518,3578742301,3578742338,37
1,1179,28519,3578742301,3578742340,39
1,1179,28520,3578742301,3578742342,41
1,1179,28521,3578742301,3578742343,42
1,1179,28522,3578742301,3578742345,44
1,1179,28523,3578742301,3578742346,45
1,1179,28524,3578742301,3578742348,47
1,1179,28525,3578742301,3578742348,47
1,1179,28526,3578742301,3578742348,47
1,1179,28527,3578742301,3578742348,47
1,1179,28528,3578742301,3578742350,49
1,1179,28529,3578742301,3578742351,50
1,1180,28530,3578742364,3578742364,0
1,1180,28531,3578742364,3578742364,0
1,1180,28532,3578742364,3578742364,0
1,1180,28533,3578742364,3578742364,0
1,1180,28534,3578742364,3578742364,0
1,1180,28535,3578742364,3578742364,0
1,1180,28536,3578742364,3578742364,0
1,1180,28537,3578742364,3578742364,0
1,1180,28538,3578742364,3578742364,0
1,1180,28539,3578742364,3578742364,0
1,1180,28540,3578742364,3578742364,0
1,1180,28541,3578742364,3578742364,0
1,1180,28542,3578742364,3578742364,0
1,1180,28543,3578742364,3578742365,1
1,1180,28544,3578742364,3578742366,2
1,1180,28545,3578742364,3578742367,3
1,1180,28546,3578742364,3578742368,4
1,1180,28547,3578742364,3578742368,4
1,1180,28548,3578742364,3578742368,4
1,1180,28549,3578742364,3578742370,6
1,1180,28550,3578742364,3578742370,6
1,1180,28551,3578742364,3578742371,7
1,1180,28552,3578742364,3578742371,7
1,1180,28553,3578742364,3578742372,8
1,1180,28554,3578742364,3578742373,9
1,1180,28555,3578742364,3578742376,12
1,1180,28556,3578742364,3578742378,14
1,1180,28557,3578742364,3578742379,15
1,1180,28558,3578742364,3578742380,16
1,1180,28559,3578742364,3578742381,17
1,1180,28560,3578742364,3578742381,17
1,1180,28561,3578742364,3578742382,18
1,1180,28562,3578742364,3578742383,19
1,1180,28563,3578742364,3578742384,20
1,1180,28564,3578742364,3578742384,20
1,1180,28565,3578742364,3578742384,20
1,1180,28566,3578742364,3578742386,22
1,1180,28567,3578742364,3578742386,22
1,1180,28568,3578742364,3578742388,24
1,1180,28569,3578742364,3578742389,25
1,1180,28570,3578742364,3578742391,27
1,1180,28571,3578742364,3578742392,28
1,1180,28572,3578742364,3578742392,28
1,1180,28573,3578742364,3578742393,29
1,1180,28574,3578742364,3578742394,30
1,1180,28575,3578742364,3578742395,31
1,1180,28576,3578742364,3578742396,32
1,1180,28577,3578742364,3578742397,33
1,1180,28578,3578742364,3578742397,33
1,1180,28579,3578742364,3578742397,33
1,1180,28580,3578742364,3578742398,34
1,1180,28581,3578742364,3578742399,35
1,1180,28582,3578742364,3578742399,35
1,1180,28583,3578742364,3578742400,36
1,1180,28584,3578742364,3578742400,36
1,1180,28585,3578742364,3578742400,36
1,1180,28586,3578742364,3578742401,37
1,1180,28587,3578742364,3578742402,38
1,1180,28588,3578742364,3578742403,39
1,1180,28589,3578742364,3578742404,40
1,1180,28590,3578742364,3578742405,41
1,1180,28591,3578742364,3578742413,49
1,1180,28592,3578742364,3578742413,49
1,1180,28593,3578742364,3578742414,50
1,1181,28594,3578742426,3578742426,0
1,1181,28595,3578742426,3578742426,0
1,1181,28596,3578742426,3578742426,0
1,1181,28597,3578742426,3578742426,0
1,1181,28598,3578742426,3578742426,0
1,1181,28599,3578742426,3578742426,0
1,1181,28600,3578742426,3578742426,0
1,1181,28601,3578742426,3578742426,0
1,1181,28602,3578742426,3578742426,0
1,1181,28603,3578742426,3578742426,0
1,1181,28604,3578742426,3578742426,0
1,1181,28605,3578742426,3578742426,0
1,1181,28606,3578742426,3578742426,0
1,1181,28607,3578742426,3578742426,0
1,1181,28608,3578742426,3578742426,0
1,1181,28609,3578742426,3578742426,0
1,1181,28610,3578742426,3578742426,0
1,1181,28611,3578742426,3578742426,0
1,1181,28612,3578742426,3578742428,2
1,1181,28613,3578742426,3578742429,3
1,1181,28614,3578742426,3578742429,3
1,1181,28615,3578742426,3578742430,4
1,1181,28616,3578742426,3578742430,4
1,1181,28617,3578742426,3578742431,5
1,1181,28618,3578742426,3578742431,5
1,1181,28619,3578742426,3578742431,5
1,1181,28620,3578742426,3578742431,5
1,1181,28621,3578742426,3578742432,6
1,1181,28622,3578742426,3578742436,10
1,1181,28623,3578742426,3578742437,11
1,1181,28624,3578742426,3578742440,14
1,1181,28625,3578742426,3578742441,15
1,1181,28626,3578742426,3578742442,16
1,1181,28627,3578742426,3578742442,16
1,1181,28628,3578742426,3578742445,19
1,1181,28629,3578742426,3578742445,19
1,1181,28630,3578742426,3578742447,21
1,1181,28631,3578742426,3578742447,21
1,1181,28632,3578742426,3578742448,22
1,1181,28633,3578742426,3578742449,23
1,1181,28634,3578742426,3578742449,23
1,1181,28635,3578742426,3578742449,23
1,1181,28636,3578742426,3578742449,23
1,1181,28637,3578742426,3578742449,23
1,1181,28638,3578742426,3578742450,24
1,1181,28639,3578742426,3578742453,27
1,1181,28640,3578742426,3578742453,27
1,1181,28641,3578742426,3578742454,28
1,1181,28642,3578742426,3578742455,29
1,1181,28643,3578742426,3578742456,30
1,1181,28644,3578742426,3578742457,31
1,1181,28645,3578742426,3578742458,32
1,1181,28646,3578742426,3578742458,32
1,1181,28647,3578742426,3578742460,34
1,1181,28648,3578742426,3578742461,35
1,1181,28649,3578742426,3578742463,37
1,1181,28650,3578742426,3578742463,37
1,1181,28651,3578742426,3578742464,38
1,1181,28652,3578742426,3578742464,38
1,1181,28653,3578742426,3578742464,38
1,1181,28654,3578742426,3578742464,38
1,1181,28655,3578742426,3578742466,40
1,1181,28656,3578742426,3578742466,40
1,1181,28657,3578742426,3578742467,41
1,1181,28658,3578742426,3578742468,42
1,1181,28659,3578742426,3578742469,43
1,1181,28660,3578742426,3578742470,44
1,1181,28661,3578742426,3578742473,47
1,1181,28662,3578742426,3578742476,50
1,1182,28663,3578742490,3578742490,0
1,1182,28664,3578742490,3578742490,0
1,1182,28665,3578742490,3578742490,0
1,1182,28666,3578742490,3578742490,0
1,1182,28667,3578742490,3578742490,0
1,1182,28668,3578742490,3578742490,0
1,1182,28669,3578742490,3578742490,0
1,1182,28670,3578742490,3578742490,0
1,1182,28671,3578742490,3578742490,0
1,1182,28672,3578742490,3578742490,0
1,1182,28673,3578742490,3578742490,0
1,1182,28674,3578742490,3578742490,0
1,1182,28675,3578742490,3578742491,1
1,1182,28676,3578742490,3578742492,2
1,1182,28677,3578742490,3578742493,3
1,1182,28678,3578742490,3578742493,3
1,1182,28679,3578742490,3578742495,5
1,1182,28680,3578742490,3578742495,5
1,1182,28681,3578742490,3578742496,6
1,1182,28682,3578742490,3578742497,7
1,1182,28683,3578742490,3578742499,9
1,1182,28684,3578742490,3578742500,10
1,1182,28685,3578742490,3578742500,10
1,1182,28686,3578742490,3578742501,11
1,1182,28687,3578742490,3578742502,12
1,1182,28688,3578742490,3578742504,14
1,1182,28689,3578742490,3578742504,14
1,1182,28690,3578742490,3578742504,14
1,1182,28691,3578742490,3578742506,16
1,1182,28692,3578742490,3578742507,17
1,1182,28693,3578742490,3578742508,18
1,1182,28694,3578742490,3578742508,18
1,1182,28695,3578742490,3578742510,20
1,1182,28696,3578742490,3578742510,20
1,1182,28697,3578742490,3578742511,21
1,1182,28698,3578742490,3578742512,22
1,1182,28699,3578742490,3578742512,22
1,1182,28700,3578742490,3578742512,22
1,1182,28701,3578742490,3578742512,22
1,1182,28702,3578742490,3578742513,23
1,1182,28703,3578742490,3578742514,24
1,1182,28704,3578742490,3578742514,24
1,1182,28705,3578742490,3578742514,24
1,1182,28706,3578742490,3578742515,25
1,1182,28707,3578742490,3578742515,25
1,1182,28708,3578742490,3578742516,26
1,1182,28709,3578742490,3578742516,26
1,1182,28710,3578742490,3578742517,27
1,1182,28711,3578742490,3578742518,28
1,1182,28712,3578742490,3578742518,28
1,1182,28713,3578742490,3578742519,29
1,1182,28714,3578742490,3578742521,31
1,1182,28715,3578742490,3578742521,31
1,1182,28716,3578742490,3578742522,32
1,1182,28717,3578742490,3578742523,33
1,1182,28718,3578742490,3578742523,33
1,1182,28719,3578742490,3578742523,33
1,1182,28720,3578742490,3578742524,34
1,1182,28721,3578742490,3578742524,34
1,1182,28722,3578742490,3578742527,37
1,1182,28723,3578742490,3578742527,37
1,1182,28724,3578742490,3578742529,39
1,1182,28725,3578742490,3578742529,39
1,1182,28726,3578742490,3578742530,40
1,1182,28727,3578742490,3578742531,41
1,1182,28728,3578742490,3578742531,41
1,1182,28729,3578742490,3578742531,41
1,1182,28730,3578742490,3578742531,41
1,1182,28731,3578742490,3578742532,42
1,1182,28732,3578742490,3578742532,42
1,1182,28733,3578742490,3578742532,42
1,1182,28734,3578742490,3578742533,43
1,1182,28735,3578742490,3578742534,44
1,1182,28736,3578742490,3578742534,44
1,1182,28737,3578742490,3578742534,44
1,1182,28738,3578742490,3578742534,44
1,1182,28739,3578742490,3578742535,45
1,1182,28740,3578742490,3578742536,46
1,1182,28741,3578742490,3578742536,46
1,1182,28742,3578742490,3578742537,47
1,1182,28743,3578742490,3578742538,48
1,1182,28744,3578742490,3578742539,49
1,1183,28745,3578742552,3578742552,0
1,1183,28746,3578742552,3578742552,0
1,1183,28747,3578742552,3578742552,0
1,1183,28748,3578742552,3578742552,0
1,1183,28749,3578742552,3578742552,0
1,1183,28750,3578742552,3578742552,0
1,1183,28751,3578742552,3578742552,0
1,1183,28752,3578742552,3578742552,0
1,1183,28753,3578742552,3578742552,0
1,1183,28754,3578742552,3578742552,0
1,1183,28755,3578742552,3578742552,0
1,1183,28756,3578742552,3578742552,0
1,1183,28757,3578742552,3578742552,0
1,1183,28758,3578742552,3578742554,2
1,1183,28759,3578742552,3578742554,2
1,1183,28760,3578742552,3578742555,3
1,1183,28761,3578742552,3578742555,3
1,1183,28762,3578742552,3578742556,4
1,1183,28763,3578742552,3578742557,5
1,1183,28764,3578742552,3578742558,6
1,1183,28765,3578742552,3578742561,9
1,1183,28766,3578742552,3578742561,9
1,1183,28767,3578742552,3578742562,10
1,1183,28768,3578742552,3578742562,10
1,1183,28769,3578742552,3578742563,11
1,1183,28770,3578742552,3578742564,12
1,1183,28771,3578742552,3578742564,12
1,1183,28772,3578742552,3578742566,14
1,1183,28773,3578742552,3578742567,15
1,1183,28774,3578742552,3578742567,15
1,1183,28775,3578742552,3578742568,16
1,1183,28776,3578742552,3578742569,17
1,1183,28777,3578742552,3578742569,17
1,1183,28778,3578742552,3578742570,18
1,1183,28779,3578742552,3578742571,19
1,1183,28780,3578742552,3578742572,20
1,1183,28781,3578742552,3578742572,20
1,1183,28782,3578742552,3578742576,24
1,1183,28783,3578742552,3578742577,25
1,1183,28784,3578742552,3578742578,26
1,1183,28785,3578742552,3578742580,28
1,1183,28786,3578742552,3578742580,28
1,1183,28787,3578742552,3578742580,28
1,1183,28788,3578742552,3578742582,30
1,1183,28789,3578742552,3578742582,30
1,1183,28790,3578742552,3578742583,31
1,1183,28791,3578742552,3578742583,31
1,1183,28792,3578742552,3578742583,31
1,1183,28793,3578742552,3578742585,33
1,1183,28794,3578742552,3578742587,35
1,1183,28795,3578742552,3578742589,37
1,1183,28796,3578742552,3578742590,38
1,1183,28797,3578742552,3578742591,39
1,1183,28798,3578742552,3578742591,39
1,1183,28799,3578742552,3578742592,40
1,1183,28800,3578742552,3578742593,41
1,1183,28801,3578742552,3578742593,41
1,1183,28802,3578742552,3578742596,44
1,1183,28803,3578742552,3578742596,44
1,1183,28804,3578742552,3578742596,44
1,1183,28805,3578742552,3578742597,45
1,1183,28806,3578742552,3578742598,46
1,1183,28807,3578742552,3578742598,46
1,1183,28808,3578742552,3578742599,47
1,1183,28809,3578742552,3578742600,48
1,1183,28810,3578742552,3578742600,48
1,1183,28811,3578742552,3578742601,49
1,1183,28812,3578742552,3578742602,50
1,1184,28813,3578742617,3578742617,0
1,1184,28814,3578742617,3578742617,0
1,1184,28815,3578742617,3578742617,0
1,1184,28816,3578742617,3578742617,0
1,1184,28817,3578742617,3578742617,0
1,1184,28818,3578742617,3578742617,0
1,1184,28819,3578742617,3578742617,0
1,1184,28820,3578742617,3578742617,0
1,1184,28821,3578742617,3578742617,0
1,1184,28822,3578742617,3578742617,0
1,1184,28823,3578742617,3578742617,0
1,1184,28824,3578742617,3578742618,1
1,1184,28825,3578742617,3578742618,1
1,1184,28826,3578742617,3578742618,1
1,1184,28827,3578742617,3578742619,2
1,1184,28828,3578742617,3578742620,3
1,1184,28829,3578742617,3578742623,6
1,1184,28830,3578742617,3578742623,6
1,1184,28831,3578742617,3578742623,6
1,1184,28832,3578742617,3578742624,7
1,1184,28833,3578742617,3578742624,7
1,1184,28834,3578742617,3578742625,8
1,1184,28835,3578742617,3578742625,8
1,1184,28836,3578742617,3578742627,10
1,1184,28837,3578742617,3578742627,10
1,1184,28838,3578742617,3578742628,11
1,1184,28839,3578742617,3578742629,12
1,1184,28840,3578742617,3578742629,12
1,1184,28841,3578742617,3578742630,13
1,1184,28842,3578742617,3578742630,13
1,1184,28843,3578742617,3578742630,13
1,1184,28844,3578742617,3578742630,13
1,1184,28845,3578742617,3578742631,14
1,1184,28846,3578742617,3578742636,19
1,1184,28847,3578742617,3578742636,19
1,1184,28848,3578742617,3578742639,22
1,1184,28849,3578742617,3578742640,23
1,1184,28850,3578742617,3578742641,24
1,1184,28851,3578742617,3578742641,24
1,1184,28852,3578742617,3578742644,27
1,1184,28853,3578742617,3578742644,27
1,1184,28854,3578742617,3578742646,29
1,1184,28855,3578742617,3578742647,30
1,1184,28856,3578742617,3578742647,30
1,1184,28857,3578742617,3578742648,31
1,1184,28858,3578742617,3578742648,31
1,1184,28859,3578742617,3578742648,31
1,1184,28860,3578742617,3578742649,32
1,1184,28861,3578742617,3578742649,32
1,1184,28862,3578742617,3578742652,35
1,1184,28863,3578742617,3578742653,36
1,1184,28864,3578742617,3578742655,38
1,1184,28865,3578742617,3578742656,39
1,1184,28866,3578742617,3578742657,40
1,1184,28867,3578742617,3578742657,40
1,1184,28868,3578742617,3578742658,41
1,1184,28869,3578742617,3578742658,41
1,1184,28870,3578742617,3578742661,44
1,1184,28871,3578742617,3578742662,45
1,1184,28872,3578742617,3578742662,45
1,1184,28873,3578742617,3578742662,45
1,1184,28874,3578742617,3578742663,46
1,1184,28875,3578742617,3578742664,47
1,1184,28876,3578742617,3578742664,47
1,1184,28877,3578742617,3578742665,48
1,1184,28878,3578742617,3578742666,49
1,1184,28879,3578742617,3578742666,49
1,1184,28880,3578742617,3578742667,50
1,1185,28881,3578742679,3578742679,0
1,1185,28882,3578742679,3578742679,0
1,1185,28883,3578742679,3578742679,0
1,1185,28884,3578742679,3578742679,0
1,1185,28885,3578742679,3578742679,0
1,1185,28886,3578742679,3578742679,0
1,1185,28887,3578742679,3578742683,4
1,1185,28888,3578742679,3578742683,4
1,1185,28889,3578742679,3578742684,5
1,1185,28890,3578742679,3578742686,7
1,1185,28891,3578742679,3578742688,9
1,1185,28892,3578742679,3578742689,10
1,1185,28893,3578742679,3578742689,10
1,1185,28894,3578742679,3578742689,10
1,1185,28895,3578742679,3578742689,10
1,1185,28896,3578742679,3578742690,11
1,1185,28897,3578742679,3578742691,12
1,1185,28898,3578742679,3578742692,13
1,1185,28899,3578742679,3578742693,14
1,1185,28900,3578742679,3578742694,15
1,1185,28901,3578742679,3578742695,16
1,1185,28902,3578742679,3578742696,17
1,1185,28903,3578742679,3578742697,18
1,1185,28904,3578742679,3578742699,20
1,1185,28905,3578742679,3578742700,21
1,1185,28906,3578742679,3578742701,22
1,1185,28907,3578742679,3578742701,22
1,1185,28908,3578742679,3578742702,23
1,1185,28909,3578742679,3578742703,24
1,1185,28910,3578742679,3578742704,25
1,1185,28911,3578742679,3578742704,25
1,1185,28912,3578742679,3578742704,25
1,1185,28913,3578742679,3578742705,26
1,1185,28914,3578742679,3578742706,27
1,1185,28915,3578742679,3578742707,28
1,1185,28916,3578742679,3578742708,29
1,1185,28917,3578742679,3578742709,30
1,1185,28918,3578742679,3578742710,31
1,1185,28919,3578742679,3578742711,32
1,1185,28920,3578742679,3578742712,33
1,1185,28921,3578742679,3578742712,33
1,1185,28922,3578742679,3578742712,33
1,1185,28923,3578742679,3578742713,34
1,1185,28924,3578742679,3578742713,34
1,1185,28925,3578742679,3578742713,34
1,1185,28926,3578742679,3578742714,35
1,1185,28927,3578742679,3578742714,35
1,1185,28928,3578742679,3578742714,35
1,1185,28929,3578742679,3578742715,36
1,1185,28930,3578742679,3578742715,36
1,1185,28931,3578742679,3578742716,37
1,1185,28932,3578742679,3578742716,37
1,1185,28933,3578742679,3578742718,39
1,1185,28934,3578742679,3578742718,39
1,1185,28935,3578742679,3578742718,39
1,1185,28936,3578742679,3578742720,41
1,1185,28937,3578742679,3578742720,41
1,1185,28938,3578742679,3578742722,43
1,1185,28939,3578742679,3578742722,43
1,1185,28940,3578742679,3578742722,43
1,1185,28941,3578742679,3578742723,44
1,1185,28942,3578742679,3578742724,45
1,1185,28943,3578742679,3578742724,45
1,1185,28944,3578742679,3578742727,48
1,1185,28945,3578742679,3578742727,48
1,1185,28946,3578742679,3578742729,50
1,1186,28947,3578742741,3578742741,0
1,1186,28948,3578742741,3578742741,0
1,1186,28949,3578742741,3578742741,0
1,1186,28950,3578742741,3578742741,0
1,1186,28951,3578742741,3578742741,0
1,1186,28952,3578742741,3578742741,0
1,1186,28953,3578742741,3578742741,0
1,1186,28954,3578742741,3578742741,0
1,1186,28955,3578742741,3578742741,0
1,1186,28956,3578742741,3578742741,0
1,1186,28957,3578742741,3578742741,0
1,1186,28958,3578742741,3578742741,0
1,1186,28959,3578742741,3578742741,0
1,1186,28960,3578742741,3578742741,0
1,1186,28961,3578742741,3578742741,0
1,1186,28962,3578742741,3578742741,0
1,1186,28963,3578742741,3578742741,0
1,1186,28964,3578742741,3578742741,0
1,1186,28965,3578742741,3578742741,0
1,1186,28966,3578742741,3578742741,0
1,1186,28967,3578742741,3578742741,0
1,1186,28968,3578742741,3578742741,0
1,1186,28969,3578742741,3578742743,2
1,1186,28970,3578742741,3578742744,3
1,1186,28971,3578742741,3578742745,4
1,1186,28972,3578742741,3578742746,5
1,1186,28973,3578742741,3578742747,6
1,1186,28974,3578742741,3578742747,6
1,1186,28975,3578742741,3578742748,7
1,1186,28976,3578742741,3578742748,7
1,1186,28977,3578742741,3578742749,8
1,1186,28978,3578742741,3578742750,9
1,1186,28979,3578742741,3578742752,11
1,1186,28980,3578742741,3578742754,13
1,1186,28981,3578742741,3578742755,14
1,1186,28982,3578742741,3578742755,14
1,1186,28983,3578742741,3578742757,16
1,1186,28984,3578742741,3578742758,17
1,1186,28985,3578742741,3578742758,17
1,1186,28986,3578742741,3578742761,20
1,1186,28987,3578742741,3578742761,20
1,1186,28988,3578742741,3578742761,20
1,1186,28989,3578742741,3578742762,21
1,1186,28990,3578742741,3578742762,21
1,1186,28991,3578742741,3578742764,23
1,1186,28992,3578742741,3578742764,23
1,1186,28993,3578742741,3578742765,24
1,1186,28994,3578742741,3578742767,26
1,1186,28995,3578742741,3578742767,26
1,1186,28996,3578742741,3578742768,27
1,1186,28997,3578742741,3578742770,29
1,1186,28998,3578742741,3578742770,29
1,1186,28999,3578742741,3578742770,29
1,1186,29000,3578742741,3578742772,31
1,1186,29001,3578742741,3578742772,31
1,1186,29002,3578742741,3578742776,35
1,1186,29003,3578742741,3578742778,37
1,1186,29004,3578742741,3578742779,38
1,1186,29005,3578742741,3578742779,38
1,1186,29006,3578742741,3578742780,39
1,1186,29007,3578742741,3578742781,40
1,1186,29008,3578742741,3578742782,41
1,1186,29009,3578742741,3578742782,41
1,1186,29010,3578742741,3578742782,41
1,1186,29011,3578742741,3578742783,42
1,1186,29012,3578742741,3578742783,42
1,1186,29013,3578742741,3578742784,43
1,1186,29014,3578742741,3578742786,45
1,1186,29015,3578742741,3578742786,45
1,1186,29016,3578742741,3578742788,47
1,1186,29017,3578742741,3578742789,48
1,1186,29018,3578742741,3578742791,50
1,1186,29019,3578742741,3578742791,50
1,1187,29020,3578742804,3578742804,0
1,1187,29021,3578742804,3578742804,0
1,1187,29022,3578742804,3578742804,0
1,1187,29023,3578742804,3578742804,0
1,1187,29024,3578742804,3578742804,0
1,1187,29025,3578742804,3578742804,0
1,1187,29026,3578742804,3578742804,0
1,1187,29027,3578742804,3578742804,0
1,1187,29028,3578742804,3578742804,0
1,1187,29029,3578742804,3578742804,0
1,1187,29030,3578742804,3578742804,0
1,1187,29031,3578742804,3578742804,0
1,1187,29032,3578742804,3578742804,0
1,1187,29033,3578742804,3578742804,0
1,1187,29034,3578742804,3578742804,0
1,1187,29035,3578742804,3578742804,0
1,1187,29036,3578742804,3578742804,0
1,1187,29037,3578742804,3578742806,2
1,1187,29038,3578742804,3578742806,2
1,1187,29039,3578742804,3578742813,9
1,1187,29040,3578742804,3578742813,9
1,1187,29041,3578742804,3578742813,9
1,1187,29042,3578742804,3578742816,12
1,1187,29043,3578742804,3578742816,12
1,1187,29044,3578742804,3578742817,13
1,1187,29045,3578742804,3578742818,14
1,1187,29046,3578742804,3578742818,14
1,1187,29047,3578742804,3578742818,14
1,1187,29048,3578742804,3578742818,14
1,1187,29049,3578742804,3578742819,15
1,1187,29050,3578742804,3578742820,16
1,1187,29051,3578742804,3578742823,19
1,1187,29052,3578742804,3578742824,20
1,1187,29053,3578742804,3578742825,21
1,1187,29054,3578742804,3578742825,21
1,1187,29055,3578742804,3578742827,23
1,1187,29056,3578742804,3578742829,25
1,1187,29057,3578742804,3578742829,25
1,1187,29058,3578742804,3578742829,25
1,1187,29059,3578742804,3578742830,26
1,1187,29060,3578742804,3578742830,26
1,1187,29061,3578742804,3578742830,26
1,1187,29062,3578742804,3578742830,26
1,1187,29063,3578742804,3578742830,26
1,1187,29064,3578742804,3578742832,28
1,1187,29065,3578742804,3578742836,32
1,1187,29066,3578742804,3578742836,32
1,1187,29067,3578742804,3578742839,35
1,1187,29068,3578742804,3578742839,35
1,1187,29069,3578742804,3578742840,36
1,1187,29070,3578742804,3578742841,37
1,1187,29071,3578742804,3578742841,37
1,1187,29072,3578742804,3578742844,40
1,1187,29073,3578742804,3578742845,41
1,1187,29074,3578742804,3578742845,41
1,1187,29075,3578742804,3578742847,43
1,1187,29076,3578742804,3578742848,44
1,1187,29077,3578742804,3578742848,44
1,1187,29078,3578742804,3578742848,44
1,1187,29079,3578742804,3578742848,44
1,1187,29080,3578742804,3578742849,45
1,1187,29081,3578742804,3578742852,48
1,1187,29082,3578742804,3578742852,48
1,1187,29083,3578742804,3578742853,49
1,1188,29084,3578742866,3578742866,0
1,1188,29085,3578742866,3578742866,0
1,1188,29086,3578742866,3578742866,0
1,1188,29087,3578742866,3578742866,0
1,1188,29088,3578742866,3578742866,0
1,1188,29089,3578742866,3578742866,0
1,1188,29090,3578742866,3578742866,0
1,1188,29091,3578742866,3578742866,0
1,1188,29092,3578742866,3578742866,0
1,1188,29093,3578742866,3578742866,0
1,1188,29094,3578742866,3578742866,0
1,1188,29095,3578742866,3578742866,0
1,1188,29096,3578742866,3578742866,0
1,1188,29097,3578742866,3578742866,0
1,1188,29098,3578742866,3578742866,0
1,1188,29099,3578742866,3578742867,1
1,1188,29100,3578742866,3578742868,2
1,1188,29101,3578742866,3578742869,3
1,1188,29102,3578742866,3578742869,3
1,1188,29103,3578742866,3578742873,7
1,1188,29104,3578742866,3578742875,9
1,1188,29105,3578742866,3578742876,10
1,1188,29106,3578742866,3578742881,15
1,1188,29107,3578742866,3578742882,16
1,1188,29108,3578742866,3578742883,17
1,1188,29109,3578742866,3578742885,19
1,1188,29110,3578742866,3578742886,20
1,1188,29111,3578742866,3578742889,23
1,1188,29112,3578742866,3578742889,23
1,1188,29113,3578742866,3578742889,23
1,1188,29114,3578742866,3578742889,23
1,1188,29115,3578742866,3578742890,24
1,1188,29116,3578742866,3578742892,26
1,1188,29117,3578742866,3578742892,26
1,1188,29118,3578742866,3578742893,27
1,1188,29119,3578742866,3578742894,28
1,1188,29120,3578742866,3578742896,30
1,1188,29121,3578742866,3578742897,31
1,1188,29122,3578742866,3578742898,32
1,1188,29123,3578742866,3578742898,32
1,1188,29124,3578742866,3578742900,34
1,1188,29125,3578742866,3578742901,35
1,1188,29126,3578742866,3578742902,36
1,1188,29127,3578742866,3578742902,36
1,1188,29128,3578742866,3578742903,37
1,1188,29129,3578742866,3578742903,37
1,1188,29130,3578742866,3578742904,38
1,1188,29131,3578742866,3578742904,38
1,1188,29132,3578742866,3578742905,39
1,1188,29133,3578742866,3578742906,40
1,1188,29134,3578742866,3578742907,41
1,1188,29135,3578742866,3578742908,42
1,1188,29136,3578742866,3578742908,42
1,1188,29137,3578742866,3578742910,44
1,1188,29138,3578742866,3578742911,45
1,1188,29139,3578742866,3578742911,45
1,1188,29140,3578742866,3578742912,46
1,1188,29141,3578742866,3578742912,46
1,1188,29142,3578742866,3578742912,46
1,1188,29143,3578742866,3578742913,47
1,1188,29144,3578742866,3578742913,47
1,1188,29145,3578742866,3578742913,47
1,1188,29146,3578742866,3578742914,48
1,1188,29147,3578742866,3578742914,48
1,1188,29148,3578742866,3578742915,49
1,1188,29149,3578742866,3578742915,49
1,1188,29150,3578742866,3578742916,50
1,1189,29151,3578742928,3578742928,0
1,1189,29152,3578742928,3578742928,0
1,1189,29153,3578742928,3578742928,0
1,1189,29154,3578742928,3578742928,0
1,1189,29155,3578742928,3578742928,0
1,1189,29156,3578742928,3578742928,0
1,1189,29157,3578742928,3578742928,0
1,1189,29158,3578742928,3578742928,0
1,1189,29159,3578742928,3578742928,0
1,1189,29160,3578742928,3578742928,0
1,1189,29161,3578742928,3578742928,0
1,1189,29162,3578742928,3578742928,0
1,1189,29163,3578742928,3578742928,0
1,1189,29164,3578742928,3578742929,1
1,1189,29165,3578742928,3578742930,2
1,1189,29166,3578742928,3578742930,2
1,1189,29167,3578742928,3578742931,3
1,1189,29168,3578742928,3578742931,3
1,1189,29169,3578742928,3578742931,3
1,1189,29170,3578742928,3578742931,3
1,1189,29171,3578742928,3578742932,4
1,1189,29172,3578742928,3578742933,5
1,1189,29173,3578742928,3578742933,5
1,1189,29174,3578742928,3578742933,5
1,1189,29175,3578742928,3578742934,6
1,1189,29176,3578742928,3578742934,6
1,1189,29177,3578742928,3578742935,7
1,1189,29178,3578742928,3578742935,7
1,1189,29179,3578742928,3578742935,7
1,1189,29180,3578742928,3578742935,7
1,1189,29181,3578742928,3578742936,8
1,1189,29182,3578742928,3578742937,9
1,1189,29183,3578742928,3578742938,10
1,1189,29184,3578742928,3578742939,11
1,1189,29185,3578742928,3578742940,12
1,1189,29186,3578742928,3578742942,14
1,1189,29187,3578742928,3578742942,14
1,1189,29188,3578742928,3578742943,15
1,1189,29189,3578742928,3578742945,17
1,1189,29190,3578742928,3578742946,18
1,1189,29191,3578742928,3578742946,18
1,1189,29192,3578742928,3578742947,19
1,1189,29193,3578742928,3578742948,20
1,1189,29194,3578742928,3578742948,20
1,1189,29195,3578742928,3578742948,20
1,1189,29196,3578742928,3578742949,21
1,1189,29197,3578742928,3578742950,22
1,1189,29198,3578742928,3578742953,25
1,1189,29199,3578742928,3578742954,26
1,1189,29200,3578742928,3578742955,27
1,1189,29201,3578742928,3578742955,27
1,1189,29202,3578742928,3578742955,27
1,1189,29203,3578742928,3578742956,28
1,1189,29204,3578742928,3578742959,31
1,1189,29205,3578742928,3578742959,31
1,1189,29206,3578742928,3578742961,33
1,1189,29207,3578742928,3578742962,34
1,1189,29208,3578742928,3578742962,34
1,1189,29209,3578742928,3578742962,34
1,1189,29210,3578742928,3578742963,35
1,1189,29211,3578742928,3578742964,36
1,1189,29212,3578742928,3578742966,38
1,1189,29213,3578742928,3578742966,38
1,1189,29214,3578742928,3578742967,39
1,1189,29215,3578742928,3578742967,39
1,1189,29216,3578742928,3578742968,40
1,1189,29217,3578742928,3578742970,42
1,1189,29218,3578742928,3578742970,42
1,1189,29219,3578742928,3578742971,43
1,1189,29220,3578742928,3578742971,43
1,1189,29221,3578742928,3578742972,44
1,1189,29222,3578742928,3578742976,48
1,1190,29223,3578742990,3578742990,0
1,1190,29224,3578742990,3578742990,0
1,1190,29225,3578742990,3578742990,0
1,1190,29226,3578742990,3578742990,0
1,1190,29227,3578742990,3578742990,0
1,1190,29228,3578742990,3578742990,0
1,1190,29229,3578742990,3578742990,0
1,1190,29230,3578742990,3578742990,0
1,1190,29231,3578742990,3578742990,0
1,1190,29232,3578742990,3578742990,0
1,1190,29233,3578742990,3578742990,0
1,1190,29234,3578742990,3578742990,0
1,1190,29235,3578742990,3578742990,0
1,1190,29236,3578742990,3578742990,0
1,1190,29237,3578742990,3578742990,0
1,1190,29238,3578742990,3578742990,0
1,1190,29239,3578742990,3578742991,1
1,1190,29240,3578742990,3578742993,3
1,1190,29241,3578742990,3578742994,4
1,1190,29242,3578742990,3578742995,5
1,1190,29243,3578742990,3578742996,6
1,1190,29244,3578742990,3578742997,7
1,1190,29245,3578742990,3578742997,7
1,1190,29246,3578742990,3578742998,8
1,1190,29247,3578742990,3578742999,9
1,1190,29248,3578742990,3578742999,9
1,1190,29249,3578742990,3578742999,9
1,1190,29250,3578742990,3578742999,9
1,1190,29251,3578742990,3578743000,10
1,1190,29252,3578742990,3578743000,10
1,1190,29253,3578742990,3578743002,12
1,1190,29254,3578742990,3578743002,12
1,1190,29255,3578742990,3578743004,14
1,1190,29256,3578742990,3578743006,16
1,1190,29257,3578742990,3578743006,16
1,1190,29258,3578742990,3578743013,23
1,1190,29259,3578742990,3578743013,23
1,1190,29260,3578742990,3578743013,23
1,1190,29261,3578742990,3578743016,26
1,1190,29262,3578742990,3578743016,26
1,1190,29263,3578742990,3578743018,28
1,1190,29264,3578742990,3578743018,28
1,1190,29265,3578742990,3578743018,28
1,1190,29266,3578742990,3578743018,28
1,1190,29267,3578742990,3578743019,29
1,1190,29268,3578742990,3578743019,29
1,1190,29269,3578742990,3578743019,29
1,1190,29270,3578742990,3578743021,31
1,1190,29271,3578742990,3578743023,33
1,1190,29272,3578742990,3578743024,34
1,1190,29273,3578742990,3578743025,35
1,1190,29274,3578742990,3578743025,35
1,1190,29275,3578742990,3578743027,37
1,1190,29276,3578742990,3578743029,39
1,1190,29277,3578742990,3578743029,39
1,1190,29278,3578742990,3578743029,39
1,1190,29279,3578742990,3578743029,39
1,1190,29280,3578742990,3578743030,40
1,1190,29281,3578742990,3578743030,40
1,1190,29282,3578742990,3578743030,40
1,1190,29283,3578742990,3578743031,41
1,1190,29284,3578742990,3578743032,42
1,1190,29285,3578742990,3578743032,42
1,1190,29286,3578742990,3578743035,45
1,1190,29287,3578742990,3578743036,46
1,1190,29288,3578742990,3578743039,49
1,1190,29289,3578742990,3578743040,50
1,1191,29290,3578743053,3578743053,0
1,1191,29291,3578743053,3578743053,0
1,1191,29292,3578743053,3578743053,0
1,1191,29293,3578743053,3578743053,0
1,1191,29294,3578743053,3578743053,0
1,1191,29295,3578743053,3578743053,0
1,1191,29296,3578743053,3578743053,0
1,1191,29297,3578743053,3578743053,0
1,1191,29298,3578743053,3578743053,0
1,1191,29299,3578743053,3578743053,0
1,1191,29300,3578743053,3578743053,0
1,1191,29301,3578743053,3578743053,0
1,1191,29302,3578743053,3578743053,0
1,1191,29303,3578743053,3578743053,0
1,1191,29304,3578743053,3578743053,0
1,1191,29305,3578743053,3578743053,0
1,1191,29306,3578743053,3578743055,2
1,1191,29307,3578743053,3578743056,3
1,1191,29308,3578743053,3578743057,4
1,1191,29309,3578743053,3578743057,4
1,1191,29310,3578743053,3578743058,5
1,1191,29311,3578743053,3578743060,7
1,1191,29312,3578743053,3578743061,8
1,1191,29313,3578743053,3578743062,9
1,1191,29314,3578743053,3578743062,9
1,1191,29315,3578743053,3578743063,10
1,1191,29316,3578743053,3578743065,12
1,1191,29317,3578743053,3578743065,12
1,1191,29318,3578743053,3578743065,12
1,1191,29319,3578743053,3578743065,12
1,1191,29320,3578743053,3578743066,13
1,1191,29321,3578743053,3578743068,15
1,1191,29322,3578743053,3578743068,15
1,1191,29323,3578743053,3578743068,15
1,1191,29324,3578743053,3578743069,16
1,1191,29325,3578743053,3578743069,16
1,1191,29326,3578743053,3578743074,21
1,1191,29327,3578743053,3578743076,23
1,1191,29328,3578743053,3578743081,28
1,1191,29329,3578743053,3578743082,29
1,1191,29330,3578743053,3578743083,30
1,1191,29331,3578743053,3578743085,32
1,1191,29332,3578743053,3578743087,34
1,1191,29333,3578743053,3578743088,35
1,1191,29334,3578743053,3578743088,35
1,1191,29335,3578743053,3578743089,36
1,1191,29336,3578743053,3578743090,37
1,1191,29337,3578743053,3578743090,37
1,1191,29338,3578743053,3578743092,39
1,1191,29339,3578743053,3578743093,40
1,1191,29340,3578743053,3578743095,42
1,1191,29341,3578743053,3578743096,43
1,1191,29342,3578743053,3578743097,44
1,1191,29343,3578743053,3578743098,45
1,1191,29344,3578743053,3578743099,46
1,1191,29345,3578743053,3578743101,48
1,1191,29346,3578743053,3578743101,48
1,1191,29347,3578743053,3578743101,48
1,1191,29348,3578743053,3578743102,49
1,1192,29349,3578743114,3578743114,0
1,1192,29350,3578743114,3578743114,0
1,1192,29351,3578743114,3578743114,0
1,1192,29352,3578743114,3578743114,0
1,1192,29353,3578743114,3578743114,0
1,1192,29354,3578743114,3578743114,0
1,1192,29355,3578743114,3578743114,0
1,1192,29356,3578743114,3578743114,0
1,1192,29357,3578743114,3578743114,0
1,1192,29358,3578743114,3578743114,0
1,1192,29359,3578743114,3578743114,0
1,1192,29360,3578743114,3578743114,0
1,1192,29361,3578743114,3578743114,0
1,1192,29362,3578743114,3578743114,0
1,1192,29363,3578743114,3578743114,0
1,1192,29364,3578743114,3578743114,0
1,1192,29365,3578743114,3578743114,0
1,1192,29366,3578743114,3578743114,0
1,1192,29367,3578743114,3578743115,1
1,1192,29368,3578743114,3578743115,1
1,1192,29369,3578743114,3578743115,1
1,1192,29370,3578743114,3578743116,2
1,1192,29371,3578743114,3578743117,3
1,1192,29372,3578743114,3578743118,4
1,1192,29373,3578743114,3578743119,5
1,1192,29374,3578743114,3578743120,6
1,1192,29375,3578743114,3578743121,7
1,1192,29376,3578743114,3578743122,8
1,1192,29377,3578743114,3578743123,9
1,1192,29378,3578743114,3578743124,10
1,1192,29379,3578743114,3578743124,10
1,1192,29380,3578743114,3578743125,11
1,1192,29381,3578743114,3578743126,12
1,1192,29382,3578743114,3578743127,13
1,1192,29383,3578743114,3578743128,14
1,1192,29384,3578743114,3578743129,15
1,1192,29385,3578743114,3578743130,16
1,1192,29386,3578743114,3578743131,17
1,1192,29387,3578743114,3578743131,17
1,1192,29388,3578743114,3578743131,17
1,1192,29389,3578743114,3578743132,18
1,1192,29390,3578743114,3578743132,18
1,1192,29391,3578743114,3578743132,18
1,1192,29392,3578743114,3578743133,19
1,1192,29393,3578743114,3578743133,19
1,1192,29394,3578743114,3578743134,20
1,1192,29395,3578743114,3578743134,20
1,1192,29396,3578743114,3578743134,20
1,1192,29397,3578743114,3578743134,20
1,1192,29398,3578743114,3578743135,21
1,1192,29399,3578743114,3578743135,21
1,1192,29400,3578743114,3578743136,22
1,1192,29401,3578743114,3578743136,22
1,1192,29402,3578743114,3578743137,23
1,1192,29403,3578743114,3578743139,25
1,1192,29404,3578743114,3578743139,25
1,1192,29405,3578743114,3578743140,26
1,1192,29406,3578743114,3578743142,28
1,1192,29407,3578743114,3578743143,29
1,1192,29408,3578743114,3578743143,29
1,1192,29409,3578743114,3578743144,30
1,1192,29410,3578743114,3578743146,32
1,1192,29411,3578743114,3578743147,33
1,1192,29412,3578743114,3578743148,34
1,1192,29413,3578743114,3578743148,34
1,1192,29414,3578743114,3578743148,34
1,1192,29415,3578743114,3578743148,34
1,1192,29416,3578743114,3578743150,36
1,1192,29417,3578743114,3578743151,37
1,1192,29418,3578743114,3578743153,39
1,1192,29419,3578743114,3578743154,40
1,1192,29420,3578743114,3578743155,41
1,1192,29421,3578743114,3578743155,41
1,1192,29422,3578743114,3578743155,41
1,1192,29423,3578743114,3578743157,43
1,1192,29424,3578743114,3578743158,44
1,1192,29425,3578743114,3578743162,48
1,1192,29426,3578743114,3578743162,48
1,1192,29427,3578743114,3578743162,48
1,1192,29428,3578743114,3578743163,49
1,1192,29429,3578743114,3578743163,49
1,1193,29430,3578743175,3578743175,0
1,1193,29431,3578743175,3578743175,0
1,1193,29432,3578743175,3578743175,0
1,1193,29433,3578743175,3578743175,0
1,1193,29434,3578743175,3578743175,0
1,1193,29435,3578743175,3578743175,0
1,1193,29436,3578743175,3578743175,0
1,1193,29437,3578743175,3578743175,0
1,1193,29438,3578743175,3578743175,0
1,1193,29439,3578743175,3578743175,0
1,1193,29440,3578743175,3578743175,0
1,1193,29441,3578743175,3578743179,4
1,1193,29442,3578743175,3578743179,4
1,1193,29443,3578743175,3578743179,4
1,1193,29444,3578743175,3578743180,5
1,1193,29445,3578743175,3578743181,6
1,1193,29446,3578743175,3578743182,7
1,1193,29447,3578743175,3578743182,7
1,1193,29448,3578743175,3578743183,8
1,1193,29449,3578743175,3578743183,8
1,1193,29450,3578743175,3578743184,9
1,1193,29451,3578743175,3578743184,9
1,1193,29452,3578743175,3578743187,12
1,1193,29453,3578743175,3578743187,12
1,1193,29454,3578743175,3578743188,13
1,1193,29455,3578743175,3578743189,14
1,1193,29456,3578743175,3578743191,16
1,1193,29457,3578743175,3578743192,17
1,1193,29458,3578743175,3578743193,18
1,1193,29459,3578743175,3578743193,18
1,1193,29460,3578743175,3578743195,20
1,1193,29461,3578743175,3578743196,21
1,1193,29462,3578743175,3578743197,22
1,1193,29463,3578743175,3578743197,22
1,1193,29464,3578743175,3578743198,23
1,1193,29465,3578743175,3578743198,23
1,1193,29466,3578743175,3578743198,23
1,1193,29467,3578743175,3578743199,24
1,1193,29468,3578743175,3578743199,24
1,1193,29469,3578743175,3578743199,24
1,1193,29470,3578743175,3578743200,25
1,1193,29471,3578743175,3578743200,25
1,1193,29472,3578743175,3578743202,27
1,1193,29473,3578743175,3578743202,27
1,1193,29474,3578743175,3578743204,29
1,1193,29475,3578743175,3578743205,30
1,1193,29476,3578743175,3578743206,31
1,1193,29477,3578743175,3578743213,38
1,1193,29478,3578743175,3578743213,38
1,1193,29479,3578743175,3578743213,38
1,1193,29480,3578743175,3578743213,38
1,1193,29481,3578743175,3578743216,41
1,1193,29482,3578743175,3578743217,42
1,1193,29483,3578743175,3578743217,42
1,1193,29484,3578743175,3578743218,43
1,1193,29485,3578743175,3578743218,43
1,1193,29486,3578743175,3578743218,43
1,1193,29487,3578743175,3578743219,44
1,1193,29488,3578743175,3578743219,44
1,1193,29489,3578743175,3578743220,45
1,1193,29490,3578743175,3578743223,48
1,1194,29491,3578743237,3578743237,0
1,1194,29492,3578743237,3578743237,0
1,1194,29493,3578743237,3578743237,0
1,1194,29494,3578743237,3578743237,0
1,1194,29495,3578743237,3578743237,0
1,1194,29496,3578743237,3578743237,0
1,1194,29497,3578743237,3578743237,0
1,1194,29498,3578743237,3578743237,0
1,1194,29499,3578743237,3578743237,0
1,1194,29500,3578743237,3578743237,0
1,1194,29501,3578743237,3578743237,0
1,1194,29502,3578743237,3578743237,0
1,1194,29503,3578743237,3578743237,0
1,1194,29504,3578743237,3578743237,0
1,1194,29505,3578743237,3578743237,0
1,1194,29506,3578743237,3578743239,2
1,1194,29507,3578743237,3578743239,2
1,1194,29508,3578743237,3578743240,3
1,1194,29509,3578743237,3578743240,3
1,1194,29510,3578743237,3578743241,4
1,1194,29511,3578743237,3578743242,5
1,1194,29512,3578743237,3578743244,7
1,1194,29513,3578743237,3578743245,8
1,1194,29514,3578743237,3578743245,8
1,1194,29515,3578743237,3578743248,11
1,1194,29516,3578743237,3578743248,11
1,1194,29517,3578743237,3578743249,12
1,1194,29518,3578743237,3578743249,12
1,1194,29519,3578743237,3578743250,13
1,1194,29520,3578743237,3578743252,15
1,1194,29521,3578743237,3578743252,15
1,1194,29522,3578743237,3578743254,17
1,1194,29523,3578743237,3578743254,17
1,1194,29524,3578743237,3578743257,20
1,1194,29525,3578743237,3578743257,20
1,1194,29526,3578743237,3578743257,20
1,1194,29527,3578743237,3578743258,21
1,1194,29528,3578743237,3578743259,22
1,1194,29529,3578743237,3578743261,24
1,1194,29530,3578743237,3578743261,24
1,1194,29531,3578743237,3578743263,26
1,1194,29532,3578743237,3578743263,26
1,1194,29533,3578743237,3578743265,28
1,1194,29534,3578743237,3578743265,28
1,1194,29535,3578743237,3578743265,28
1,1194,29536,3578743237,3578743266,29
1,1194,29537,3578743237,3578743267,30
1,1194,29538,3578743237,3578743268,31
1,1194,29539,3578743237,3578743268,31
1,1194,29540,3578743237,3578743269,32
1,1194,29541,3578743237,3578743269,32
1,1194,29542,3578743237,3578743270,33
1,1194,29543,3578743237,3578743274,37
1,1194,29544,3578743237,3578743281,44
1,1194,29545,3578743237,3578743283,46
1,1194,29546,3578743237,3578743283,46
1,1194,29547,3578743237,3578743285,48
1,1195,29548,3578743298,3578743298,0
1,1195,29549,3578743298,3578743298,0
1,1195,29550,3578743298,3578743298,0
1,1195,29551,3578743298,3578743298,0
1,1195,29552,3578743298,3578743298,0
1,1195,29553,3578743298,3578743298,0
1,1195,29554,3578743298,3578743298,0
1,1195,29555,3578743298,3578743298,0
1,1195,29556,3578743298,3578743298,0
1,1195,29557,3578743298,3578743298,0
1,1195,29558,3578743298,3578743298,0
1,1195,29559,3578743298,3578743298,0
1,1195,29560,3578743298,3578743299,1
1,1195,29561,3578743298,3578743301,3
1,1195,29562,3578743298,3578743301,3
1,1195,29563,3578743298,3578743302,4
1,1195,29564,3578743298,3578743304,6
1,1195,29565,3578743298,3578743305,7
1,1195,29566,3578743298,3578743305,7
1,1195,29567,3578743298,3578743306,8
1,1195,29568,3578743298,3578743307,9
1,1195,29569,3578743298,3578743309,11
1,1195,29570,3578743298,3578743309,11
1,1195,29571,3578743298,3578743312,14
1,1195,29572,3578743298,3578743312,14
1,1195,29573,3578743298,3578743312,14
1,1195,29574,3578743298,3578743313,15
1,1195,29575,3578743298,3578743313,15
1,1195,29576,3578743298,3578743313,15
1,1195,29577,3578743298,3578743314,16
1,1195,29578,3578743298,3578743314,16
1,1195,29579,3578743298,3578743315,17
1,1195,29580,3578743298,3578743315,17
1,1195,29581,3578743298,3578743315,17
1,1195,29582,3578743298,3578743316,18
1,1195,29583,3578743298,3578743316,18
1,1195,29584,3578743298,3578743317,19
1,1195,29585,3578743298,3578743318,20
1,1195,29586,3578743298,3578743320,22
1,1195,29587,3578743298,3578743320,22
1,1195,29588,3578743298,3578743321,23
1,1195,29589,3578743298,3578743323,25
1,1195,29590,3578743298,3578743323,25
1,1195,29591,3578743298,3578743323,25
1,1195,29592,3578743298,3578743324,26
1,1195,29593,3578743298,3578743325,27
1,1195,29594,3578743298,3578743325,27
1,1195,29595,3578743298,3578743325,27
1,1195,29596,3578743298,3578743327,29
1,1195,29597,3578743298,3578743329,31
1,1195,29598,3578743298,3578743329,31
1,1195,29599,3578743298,3578743330,32
1,1195,29600,3578743298,3578743330,32
1,1195,29601,3578743298,3578743331,33
1,1195,29602,3578743298,3578743331,33
1,1195,29603,3578743298,3578743331,33
1,1195,29604,3578743298,3578743331,33
1,1195,29605,3578743298,3578743332,34
1,1195,29606,3578743298,3578743333,35
1,1195,29607,3578743298,3578743333,35
1,1195,29608,3578743298,3578743334,36
1,1195,29609,3578743298,3578743334,36
1,1195,29610,3578743298,3578743334,36
1,1195,29611,3578743298,3578743335,37
1,1195,29612,3578743298,3578743335,37
1,1195,29613,3578743298,3578743336,38
1,1195,29614,3578743298,3578743336,38
1,1195,29615,3578743298,3578743337,39
1,1195,29616,3578743298,3578743337,39
1,1195,29617,3578743298,3578743339,41
1,1195,29618,3578743298,3578743339,41
1,1195,29619,3578743298,3578743342,44
1,1195,29620,3578743298,3578743343,45
1,1195,29621,3578743298,3578743343,45
1,1195,29622,3578743298,3578743345,47
1,1195,29623,3578743298,3578743346,48
1,1195,29624,3578743298,3578743347,49
1,1195,29625,3578743298,3578743347,49
1,1195,29626,3578743298,3578743348,50
1,1196,29627,3578743361,3578743361,0
1,1196,29628,3578743361,3578743361,0
1,1196,29629,3578743361,3578743361,0
1,1196,29630,3578743361,3578743361,0
1,1196,29631,3578743361,3578743361,0
1,1196,29632,3578743361,3578743361,0
1,1196,29633,3578743361,3578743361,0
1,1196,29634,3578743361,3578743361,0
1,1196,29635,3578743361,3578743361,0
1,1196,29636,3578743361,3578743361,0
1,1196,29637,3578743361,3578743361,0
1,1196,29638,3578743361,3578743361,0
1,1196,29639,3578743361,3578743362,1
1,1196,29640,3578743361,3578743363,2
1,1196,29641,3578743361,3578743363,2
1,1196,29642,3578743361,3578743363,2
1,1196,29643,3578743361,3578743363,2
1,1196,29644,3578743361,3578743364,3
1,1196,29645,3578743361,3578743366,5
1,1196,29646,3578743361,3578743368,7
1,1196,29647,3578743361,3578743369,8
1,1196,29648,3578743361,3578743370,9
1,1196,29649,3578743361,3578743370,9
1,1196,29650,3578743361,3578743371,10
1,1196,29651,3578743361,3578743371,10
1,1196,29652,3578743361,3578743372,11
1,1196,29653,3578743361,3578743376,15
1,1196,29654,3578743361,3578743378,17
1,1196,29655,3578743361,3578743379,18
1,1196,29656,3578743361,3578743379,18
1,1196,29657,3578743361,3578743381,20
1,1196,29658,3578743361,3578743381,20
1,1196,29659,3578743361,3578743382,21
1,1196,29660,3578743361,3578743382,21
1,1196,29661,3578743361,3578743383,22
1,1196,29662,3578743361,3578743383,22
1,1196,29663,3578743361,3578743384,23
1,1196,29664,3578743361,3578743384,23
1,1196,29665,3578743361,3578743386,25
1,1196,29666,3578743361,3578743387,26
1,1196,29667,3578743361,3578743387,26
1,1196,29668,3578743361,3578743390,29
1,1196,29669,3578743361,3578743392,31
1,1196,29670,3578743361,3578743392,31
1,1196,29671,3578743361,3578743393,32
1,1196,29672,3578743361,3578743393,32
1,1196,29673,3578743361,3578743394,33
1,1196,29674,3578743361,3578743396,35
1,1196,29675,3578743361,3578743397,36
1,1196,29676,3578743361,3578743397,36
1,1196,29677,3578743361,3578743397,36
1,1196,29678,3578743361,3578743398,37
1,1196,29679,3578743361,3578743399,38
1,1196,29680,3578743361,3578743399,38
1,1196,29681,3578743361,3578743399,38
1,1196,29682,3578743361,3578743399,38
1,1196,29683,3578743361,3578743399,38
1,1196,29684,3578743361,3578743399,38
1,1196,29685,3578743361,3578743400,39
1,1196,29686,3578743361,3578743402,41
1,1196,29687,3578743361,3578743403,42
1,1196,29688,3578743361,3578743404,43
1,1196,29689,3578743361,3578743406,45
1,1196,29690,3578743361,3578743406,45
1,1197,29691,3578743423,3578743423,0
1,1197,29692,3578743423,3578743424,1
1,1197,29693,3578743423,3578743424,1
1,1197,29694,3578743423,3578743424,1
1,1197,29695,3578743423,3578743424,1
1,1197,29696,3578743423,3578743424,1
1,1197,29697,3578743423,3578743424,1
1,1197,29698,3578743423,3578743424,1
1,1197,29699,3578743423,3578743424,1
1,1197,29700,3578743423,3578743424,1
1,1197,29701,3578743423,3578743424,1
1,1197,29702,3578743423,3578743424,1
1,1197,29703,3578743423,3578743424,1
1,1197,29704,3578743423,3578743424,1
1,1197,29705,3578743423,3578743424,1
1,1197,29706,3578743423,3578743425,2
1,1197,29707,3578743423,3578743425,2
1,1197,29708,3578743423,3578743426,3
1,1197,29709,3578743423,3578743426,3
1,1197,29710,3578743423,3578743427,4
1,1197,29711,3578743423,3578743429,6
1,1197,29712,3578743423,3578743429,6
1,1197,29713,3578743423,3578743429,6
1,1197,29714,3578743423,3578743431,8
1,1197,29715,3578743423,3578743431,8
1,1197,29716,3578743423,3578743432,9
1,1197,29717,3578743423,3578743432,9
1,1197,29718,3578743423,3578743436,13
1,1197,29719,3578743423,3578743437,14
1,1197,29720,3578743423,3578743440,17
1,1197,29721,3578743423,3578743440,17
1,1197,29722,3578743423,3578743440,17
1,1197,29723,3578743423,3578743440,17
1,1197,29724,3578743423,3578743441,18
1,1197,29725,3578743423,3578743442,19
1,1197,29726,3578743423,3578743444,21
1,1197,29727,3578743423,3578743445,22
1,1197,29728,3578743423,3578743446,23
1,1197,29729,3578743423,3578743448,25
1,1197,29730,3578743423,3578743448,25
1,1197,29731,3578743423,3578743448,25
1,1197,29732,3578743423,3578743449,26
1,1197,29733,3578743423,3578743452,29
1,1197,29734,3578743423,3578743452,29
1,1197,29735,3578743423,3578743454,31
1,1197,29736,3578743423,3578743456,33
1,1197,29737,3578743423,3578743456,33
1,1197,29738,3578743423,3578743456,33
1,1197,29739,3578743423,3578743457,34
1,1197,29740,3578743423,3578743459,36
1,1197,29741,3578743423,3578743461,38
1,1197,29742,3578743423,3578743462,39
1,1197,29743,3578743423,3578743463,40
1,1197,29744,3578743423,3578743463,40
1,1197,29745,3578743423,3578743465,42
1,1197,29746,3578743423,3578743465,42
1,1197,29747,3578743423,3578743465,42
1,1197,29748,3578743423,3578743467,44
1,1197,29749,3578743423,3578743468,45
1,1197,29750,3578743423,3578743468,45
1,1197,29751,3578743423,3578743469,46
1,1197,29752,3578743423,3578743469,46
1,1197,29753,3578743423,3578743470,47
1,1198,29754,3578743486,3578743486,0
1,1198,29755,3578743486,3578743486,0
1,1198,29756,3578743486,3578743486,0
1,1198,29757,3578743486,3578743486,0
1,1198,29758,3578743486,3578743486,0
1,1198,29759,3578743486,3578743486,0
1,1198,29760,3578743486,3578743486,0
1,1198,29761,3578743486,3578743487,1
1,1198,29762,3578743486,3578743488,2
1,1198,29763,3578743486,3578743488,2
1,1198,29764,3578743486,3578743488,2
1,1198,29765,3578743486,3578743489,3
1,1198,29766,3578743486,3578743490,4
1,1198,29767,3578743486,3578743491,5
1,1198,29768,3578743486,3578743491,5
1,1198,29769,3578743486,3578743492,6
1,1198,29770,3578743486,3578743494,8
1,1198,29771,3578743486,3578743494,8
1,1198,29772,3578743486,3578743495,9
1,1198,29773,3578743486,3578743496,10
1,1198,29774,3578743486,3578743497,11
1,1198,29775,3578743486,3578743500,14
1,1198,29776,3578743486,3578743500,14
1,1198,29777,3578743486,3578743500,14
1,1198,29778,3578743486,3578743501,15
1,1198,29779,3578743486,3578743503,17
1,1198,29780,3578743486,3578743504,18
1,1198,29781,3578743486,3578743504,18
1,1198,29782,3578743486,3578743505,19
1,1198,29783,3578743486,3578743506,20
1,1198,29784,3578743486,3578743508,22
1,1198,29785,3578743486,3578743508,22
1,1198,29786,3578743486,3578743510,24
1,1198,29787,3578743486,3578743511,25
1,1198,29788,3578743486,3578743511,25
1,1198,29789,3578743486,3578743511,25
1,1198,29790,3578743486,3578743512,26
1,1198,29791,3578743486,3578743512,26
1,1198,29792,3578743486,3578743513,27
1,1198,29793,3578743486,3578743513,27
1,1198,29794,3578743486,3578743514,28
1,1198,29795,3578743486,3578743514,28
1,1198,29796,3578743486,3578743514,28
1,1198,29797,3578743486,3578743514,28
1,1198,29798,3578743486,3578743514,28
1,1198,29799,3578743486,3578743516,30
1,1198,29800,3578743486,3578743517,31
1,1198,29801,3578743486,3578743517,31
1,1198,29802,3578743486,3578743519,33
1,1198,29803,3578743486,3578743520,34
1,1198,29804,3578743486,3578743520,34
1,1198,29805,3578743486,3578743522,36
1,1198,29806,3578743486,3578743523,37
1,1198,29807,3578743486,3578743523,37
1,1198,29808,3578743486,3578743524,38
1,1198,29809,3578743486,3578743524,38
1,1198,29810,3578743486,3578743525,39
1,1198,29811,3578743486,3578743525,39
1,1198,29812,3578743486,3578743526,40
1,1198,29813,3578743486,3578743528,42
1,1198,29814,3578743486,3578743528,42
1,1198,29815,3578743486,3578743529,43
1,1198,29816,3578743486,3578743530,44
1,1198,29817,3578743486,3578743530,44
1,1198,29818,3578743486,3578743530,44
1,1198,29819,3578743486,3578743530,44
1,1198,29820,3578743486,3578743530,44
1,1198,29821,3578743486,3578743531,45
1,1198,29822,3578743486,3578743532,46
1,1198,29823,3578743486,3578743532,46
1,1198,29824,3578743486,3578743532,46
1,1198,29825,3578743486,3578743533,47
1,1198,29826,3578743486,3578743533,47
1,1198,29827,3578743486,3578743533,47
1,1198,29828,3578743486,3578743534,48
1,1198,29829,3578743486,3578743535,49
1,1198,29830,3578743486,3578743535,49
1,1198,29831,3578743486,3578743536,50
1,1198,29832,3578743486,3578743536,50
1,1199,29833,3578743548,3578743548,0
1,1199,29834,3578743548,3578743548,0
1,1199,29835,3578743548,3578743548,0
1,1199,29836,3578743548,3578743548,0
1,1199,29837,3578743548,3578743548,0
1,1199,29838,3578743548,3578743548,0
1,1199,29839,3578743548,3578743548,0
1,1199,29840,3578743548,3578743548,0
1,1199,29841,3578743548,3578743548,0
1,1199,29842,3578743548,3578743548,0
1,1199,29843,3578743548,3578743548,0
1,1199,29844,3578743548,3578743548,0
1,1199,29845,3578743548,3578743548,0
1,1199,29846,3578743548,3578743549,1
1,1199,29847,3578743548,3578743552,4
1,1199,29848,3578743548,3578743552,4
1,1199,29849,3578743548,3578743553,5
1,1199,29850,3578743548,3578743554,6
1,1199,29851,3578743548,3578743554,6
1,1199,29852,3578743548,3578743555,7
1,1199,29853,3578743548,3578743556,8
1,1199,29854,3578743548,3578743557,9
1,1199,29855,3578743548,3578743558,10
1,1199,29856,3578743548,3578743561,13
1,1199,29857,3578743548,3578743562,14
1,1199,29858,3578743548,3578743562,14
1,1199,29859,3578743548,3578743563,15
1,1199,29860,3578743548,3578743563,15
1,1199,29861,3578743548,3578743565,17
1,1199,29862,3578743548,3578743567,19
1,1199,29863,3578743548,3578743567,19
1,1199,29864,3578743548,3578743568,20
1,1199,29865,3578743548,3578743569,21
1,1199,29866,3578743548,3578743569,21
1,1199,29867,3578743548,3578743570,22
1,1199,29868,3578743548,3578743571,23
1,1199,29869,3578743548,3578743572,24
1,1199,29870,3578743548,3578743576,28
1,1199,29871,3578743548,3578743577,29
1,1199,29872,3578743548,3578743577,29
1,1199,29873,3578743548,3578743579,31
1,1199,29874,3578743548,3578743580,32
1,1199,29875,3578743548,3578743580,32
1,1199,29876,3578743548,3578743580,32
1,1199,29877,3578743548,3578743581,33
1,1199,29878,3578743548,3578743581,33
1,1199,29879,3578743548,3578743582,34
1,1199,29880,3578743548,3578743582,34
1,1199,29881,3578743548,3578743583,35
1,1199,29882,3578743548,3578743583,35
1,1199,29883,3578743548,3578743585,37
1,1199,29884,3578743548,3578743586,38
1,1199,29885,3578743548,3578743586,38
1,1199,29886,3578743548,3578743589,41
1,1199,29887,3578743548,3578743591,43
1,1199,29888,3578743548,3578743591,43
1,1199,29889,3578743548,3578743591,43
1,1199,29890,3578743548,3578743592,44
1,1199,29891,3578743548,3578743594,46
1,1199,29892,3578743548,3578743596,48
1,1199,29893,3578743548,3578743596,48
1,1199,29894,3578743548,3578743597,49
1,1199,29895,3578743548,3578743597,49
1,1199,29896,3578743548,3578743597,49
1,1199,29897,3578743548,3578743598,50
1,1200,29898,3578743610,3578743610,0
1,1200,29899,3578743610,3578743610,0
1,1200,29900,3578743610,3578743610,0
1,1200,29901,3578743610,3578743610,0
1,1200,29902,3578743610,3578743610,0
1,1200,29903,3578743610,3578743610,0
1,1200,29904,3578743610,3578743610,0
1,1200,29905,3578743610,3578743610,0
1,1200,29906,3578743610,3578743610,0
1,1200,29907,3578743610,3578743610,0
1,1200,29908,3578743610,3578743612,2
1,1200,29909,3578743610,3578743612,2
1,1200,29910,3578743610,3578743612,2
1,1200,29911,3578743610,3578743613,3
1,1200,29912,3578743610,3578743615,5
1,1200,29913,3578743610,3578743615,5
1,1200,29914,3578743610,3578743617,7
1,1200,29915,3578743610,3578743617,7
1,1200,29916,3578743610,3578743618,8
1,1200,29917,3578743610,3578743618,8
1,1200,29918,3578743610,3578743618,8
1,1200,29919,3578743610,3578743619,9
1,1200,29920,3578743610,3578743621,11
1,1200,29921,3578743610,3578743624,14
1,1200,29922,3578743610,3578743624,14
1,1200,29923,3578743610,3578743624,14
1,1200,29924,3578743610,3578743625,15
1,1200,29925,3578743610,3578743625,15
1,1200,29926,3578743610,3578743626,16
1,1200,29927,3578743610,3578743627,17
1,1200,29928,3578743610,3578743628,18
1,1200,29929,3578743610,3578743629,19
1,1200,29930,3578743610,3578743630,20
1,1200,29931,3578743610,3578743630,20
1,1200,29932,3578743610,3578743631,21
1,1200,29933,3578743610,3578743631,21
1,1200,29934,3578743610,3578743635,25
1,1200,29935,3578743610,3578743636,26
1,1200,29936,3578743610,3578743639,29
1,1200,29937,3578743610,3578743639,29
1,1200,29938,3578743610,3578743639,29
1,1200,29939,3578743610,3578743639,29
1,1200,29940,3578743610,3578743639,29
1,1200,29941,3578743610,3578743641,31
1,1200,29942,3578743610,3578743643,33
1,1200,29943,3578743610,3578743643,33
1,1200,29944,3578743610,3578743645,35
1,1200,29945,3578743610,3578743647,37
1,1200,29946,3578743610,3578743647,37
1,1200,29947,3578743610,3578743647,37
1,1200,29948,3578743610,3578743648,38
1,1200,29949,3578743610,3578743651,41
1,1200,29950,3578743610,3578743652,42
1,1200,29951,3578743610,3578743653,43
1,1200,29952,3578743610,3578743655,45
1,1200,29953,3578743610,3578743655,45
1,1200,29954,3578743610,3578743656,46
1,1200,29955,3578743610,3578743657,47
1,1200,29956,3578743610,3578743658,48
1,1200,29957,3578743610,3578743660,50
1,1201,29958,3578743672,3578743672,0
1,1201,29959,3578743672,3578743672,0
1,1201,29960,3578743672,3578743672,0
1,1201,29961,3578743672,3578743672,0
1,1201,29962,3578743672,3578743672,0
1,1201,29963,3578743672,3578743672,0
1,1201,29964,3578743672,3578743672,0
1,1201,29965,3578743672,3578743672,0
1,1201,29966,3578743672,3578743672,0
1,1201,29967,3578743672,3578743672,0
1,1201,29968,3578743672,3578743672,0
1,1201,29969,3578743672,3578743672,0
1,1201,29970,3578743672,3578743674,2
1,1201,29971,3578743672,3578743676,4
1,1201,29972,3578743672,3578743677,5
1,1201,29973,3578743672,3578743681,9
1,1201,29974,3578743672,3578743682,10
1,1201,29975,3578743672,3578743682,10
1,1201,29976,3578743672,3578743684,12
1,1201,29977,3578743672,3578743687,15
1,1201,29978,3578743672,3578743688,16
1,1201,29979,3578743672,3578743688,16
1,1201,29980,3578743672,3578743688,16
1,1201,29981,3578743672,3578743689,17
1,1201,29982,3578743672,3578743690,18
1,1201,29983,3578743672,3578743692,20
1,1201,29984,3578743672,3578743692,20
1,1201,29985,3578743672,3578743692,20
1,1201,29986,3578743672,3578743693,21
1,1201,29987,3578743672,3578743694,22
1,1201,29988,3578743672,3578743694,22
1,1201,29989,3578743672,3578743696,24
1,1201,29990,3578743672,3578743697,25
1,1201,29991,3578743672,3578743697,25
1,1201,29992,3578743672,3578743699,27
1,1201,29993,3578743672,3578743700,28
1,1201,29994,3578743672,3578743700,28
1,1201,29995,3578743672,3578743702,30
1,1201,29996,3578743672,3578743702,30
1,1201,29997,3578743672,3578743703,31
1,1201,29998,3578743672,3578743704,32
1,1201,29999,3578743672,3578743705,33
1,1201,30000,3578743672,3578743705,33
1,1201,30001,3578743672,3578743706,34
1,1201,30002,3578743672,3578743708,36
1,1201,30003,3578743672,3578743708,36
1,1201,30004,3578743672,3578743710,38
1,1201,30005,3578743672,3578743711,39
1,1201,30006,3578743672,3578743711,39
1,1201,30007,3578743672,3578743712,40
1,1201,30008,3578743672,3578743712,40
1,1201,30009,3578743672,3578743712,40
1,1201,30010,3578743672,3578743713,41
1,1201,30011,3578743672,3578743714,42
1,1201,30012,3578743672,3578743714,42
1,1201,30013,3578743672,3578743714,42
1,1201,30014,3578743672,3578743714,42
1,1201,30015,3578743672,3578743715,43
1,1201,30016,3578743672,3578743715,43
1,1201,30017,3578743672,3578743716,44
1,1201,30018,3578743672,3578743717,45
1,1201,30019,3578743672,3578743719,47
1,1201,30020,3578743672,3578743720,48
1,1201,30021,3578743672,3578743720,48
1,1201,30022,3578743672,3578743722,50
1,1202,30023,3578743733,3578743733,0
1,1202,30024,3578743733,3578743733,0
1,1202,30025,3578743733,3578743733,0
1,1202,30026,3578743733,3578743733,0
1,1202,30027,3578743733,3578743733,0
1,1202,30028,3578743733,3578743733,0
1,1202,30029,3578743733,3578743733,0
1,1202,30030,3578743733,3578743733,0
1,1202,30031,3578743733,3578743733,0
1,1202,30032,3578743733,3578743733,0
1,1202,30033,3578743733,3578743733,0
1,1202,30034,3578743733,3578743733,0
1,1202,30035,3578743733,3578743733,0
1,1202,30036,3578743733,3578743733,0
1,1202,30037,3578743733,3578743733,0
1,1202,30038,3578743733,3578743733,0
1,1202,30039,3578743733,3578743733,0
1,1202,30040,3578743733,3578743733,0
1,1202,30041,3578743733,3578743733,0
1,1202,30042,3578743733,3578743733,0
1,1202,30043,3578743733,3578743733,0
1,1202,30044,3578743733,3578743733,0
1,1202,30045,3578743733,3578743734,1
1,1202,30046,3578743733,3578743735,2
1,1202,30047,3578743733,3578743735,2
1,1202,30048,3578743733,3578743736,3
1,1202,30049,3578743733,3578743736,3
1,1202,30050,3578743733,3578743736,3
1,1202,30051,3578743733,3578743737,4
1,1202,30052,3578743733,3578743738,5
1,1202,30053,3578743733,3578743740,7
1,1202,30054,3578743733,3578743741,8
1,1202,30055,3578743733,3578743742,9
1,1202,30056,3578743733,3578743742,9
1,1202,30057,3578743733,3578743745,12
1,1202,30058,3578743733,3578743745,12
1,1202,30059,3578743733,3578743746,13
1,1202,30060,3578743733,3578743746,13
1,1202,30061,3578743733,3578743746,13
1,1202,30062,3578743733,3578743747,14
1,1202,30063,3578743733,3578743748,15
1,1202,30064,3578743733,3578743749,16
1,1202,30065,3578743733,3578743752,19
1,1202,30066,3578743733,3578743752,19
1,1202,30067,3578743733,3578743752,19
1,1202,30068,3578743733,3578743754,21
1,1202,30069,3578743733,3578743755,22
1,1202,30070,3578743733,3578743756,23
1,1202,30071,3578743733,3578743757,24
1,1202,30072,3578743733,3578743758,25
1,1202,30073,3578743733,3578743762,29
1,1202,30074,3578743733,3578743763,30
1,1202,30075,3578743733,3578743763,30
1,1202,30076,3578743733,3578743763,30
1,1202,30077,3578743733,3578743765,32
1,1202,30078,3578743733,3578743765,32
1,1202,30079,3578743733,3578743767,34
1,1202,30080,3578743733,3578743767,34
1,1202,30081,3578743733,3578743768,35
1,1202,30082,3578743733,3578743769,36
1,1202,30083,3578743733,3578743770,37
1,1202,30084,3578743733,3578743770,37
1,1202,30085,3578743733,3578743770,37
1,1202,30086,3578743733,3578743771,38
1,1202,30087,3578743733,3578743771,38
1,1202,30088,3578743733,3578743775,42
1,1202,30089,3578743733,3578743777,44
1,1202,30090,3578743733,3578743778,45
1,1202,30091,3578743733,3578743779,46
1,1202,30092,3578743733,3578743779,46
1,1202,30093,3578743733,3578743781,48
1,1202,30094,3578743733,3578743781,48
1,1202,30095,3578743733,3578743781,48
1,1202,30096,3578743733,3578743782,49
1,1202,30097,3578743733,3578743782,49
1,1202,30098,3578743733,3578743782,49
1,1203,30099,3578743795,3578743795,0
1,1203,30100,3578743795,3578743795,0
1,1203,30101,3578743795,3578743795,0
1,1203,30102,3578743795,3578743795,0
1,1203,30103,3578743795,3578743795,0
1,1203,30104,3578743795,3578743795,0
1,1203,30105,3578743795,3578743795,0
1,1203,30106,3578743795,3578743795,0
1,1203,30107,3578743795,3578743795,0
1,1203,30108,3578743795,3578743795,0
1,1203,30109,3578743795,3578743795,0
1,1203,30110,3578743795,3578743795,0
1,1203,30111,3578743795,3578743796,1
1,1203,30112,3578743795,3578743796,1
1,1203,30113,3578743795,3578743797,2
1,1203,30114,3578743795,3578743797,2
1,1203,30115,3578743795,3578743797,2
1,1203,30116,3578743795,3578743798,3
1,1203,30117,3578743795,3578743799,4
1,1203,30118,3578743795,3578743799,4
1,1203,30119,3578743795,3578743799,4
1,1203,30120,3578743795,3578743799,4
1,1203,30121,3578743795,3578743799,4
1,1203,30122,3578743795,3578743801,6
1,1203,30123,3578743795,3578743801,6
1,1203,30124,3578743795,3578743802,7
1,1203,30125,3578743795,3578743805,10
1,1203,30126,3578743795,3578743806,11
1,1203,30127,3578743795,3578743811,16
1,1203,30128,3578743795,3578743812,17
1,1203,30129,3578743795,3578743813,18
1,1203,30130,3578743795,3578743814,19
1,1203,30131,3578743795,3578743816,21
1,1203,30132,3578743795,3578743816,21
1,1203,30133,3578743795,3578743817,22
1,1203,30134,3578743795,3578743817,22
1,1203,30135,3578743795,3578743818,23
1,1203,30136,3578743795,3578743818,23
1,1203,30137,3578743795,3578743818,23
1,1203,30138,3578743795,3578743818,23
1,1203,30139,3578743795,3578743822,27
1,1203,30140,3578743795,3578743824,29
1,1203,30141,3578743795,3578743824,29
1,1203,30142,3578743795,3578743825,30
1,1203,30143,3578743795,3578743825,30
1,1203,30144,3578743795,3578743826,31
1,1203,30145,3578743795,3578743829,34
1,1203,30146,3578743795,3578743829,34
1,1203,30147,3578743795,3578743829,34
1,1203,30148,3578743795,3578743830,35
1,1203,30149,3578743795,3578743830,35
1,1203,30150,3578743795,3578743831,36
1,1203,30151,3578743795,3578743832,37
1,1203,30152,3578743795,3578743836,41
1,1203,30153,3578743795,3578743836,41
1,1203,30154,3578743795,3578743838,43
1,1203,30155,3578743795,3578743839,44
1,1203,30156,3578743795,3578743839,44
1,1203,30157,3578743795,3578743839,44
1,1203,30158,3578743795,3578743840,45
1,1203,30159,3578743795,3578743841,46
1,1203,30160,3578743795,3578743843,48
1,1203,30161,3578743795,3578743844,49
1,1203,30162,3578743795,3578743845,50
1,1204,30163,3578743858,3578743858,0
1,1204,30164,3578743858,3578743858,0
1,1204,30165,3578743858,3578743858,0
1,1204,30166,3578743858,3578743858,0
1,1204,30167,3578743858,3578743858,0
1,1204,30168,3578743858,3578743858,0
1,1204,30169,3578743858,3578743858,0
1,1204,30170,3578743858,3578743858,0
1,1204,30171,3578743858,3578743858,0
1,1204,30172,3578743858,3578743858,0
1,1204,30173,3578743858,3578743858,0
1,1204,30174,3578743858,3578743859,1
1,1204,30175,3578743858,3578743860,2
1,1204,30176,3578743858,3578743861,3
1,1204,30177,3578743858,3578743862,4
1,1204,30178,3578743858,3578743862,4
1,1204,30179,3578743858,3578743863,5
1,1204,30180,3578743858,3578743864,6
1,1204,30181,3578743858,3578743864,6
1,1204,30182,3578743858,3578743866,8
1,1204,30183,3578743858,3578743867,9
1,1204,30184,3578743858,3578743869,11
1,1204,30185,3578743858,3578743869,11
1,1204,30186,3578743858,3578743875,17
1,1204,30187,3578743858,3578743877,19
1,1204,30188,3578743858,3578743877,19
1,1204,30189,3578743858,3578743882,24
1,1204,30190,3578743858,3578743883,25
1,1204,30191,3578743858,3578743883,25
1,1204,30192,3578743858,3578743883,25
1,1204,30193,3578743858,3578743886,28
1,1204,30194,3578743858,3578743888,30
1,1204,30195,3578743858,3578743888,30
1,1204,30196,3578743858,3578743888,30
1,1204,30197,3578743858,3578743888,30
1,1204,30198,3578743858,3578743888,30
1,1204,30199,3578743858,3578743890,32
1,1204,30200,3578743858,3578743891,33
1,1204,30201,3578743858,3578743891,33
1,1204,30202,3578743858,3578743892,34
1,1204,30203,3578743858,3578743893,35
1,1204,30204,3578743858,3578743893,35
1,1204,30205,3578743858,3578743893,35
1,1204,30206,3578743858,3578743895,37
1,1204,30207,3578743858,3578743897,39
1,1204,30208,3578743858,3578743897,39
1,1204,30209,3578743858,3578743898,40
1,1204,30210,3578743858,3578743900,42
1,1204,30211,3578743858,3578743900,42
1,1204,30212,3578743858,3578743901,43
1,1204,30213,3578743858,3578743902,44
1,1204,30214,3578743858,3578743904,46
1,1204,30215,3578743858,3578743904,46
1,1204,30216,3578743858,3578743904,46
1,1204,30217,3578743858,3578743905,47
1,1204,30218,3578743858,3578743905,47
1,1204,30219,3578743858,3578743906,48
1,1204,30220,3578743858,3578743908,50
1,1205,30221,3578743919,3578743919,0
1,1205,30222,3578743919,3578743919,0
1,1205,30223,3578743919,3578743919,0
1,1205,30224,3578743919,3578743919,0
1,1205,30225,3578743919,3578743919,0
1,1205,30226,3578743919,3578743919,0
1,1205,30227,3578743919,3578743919,0
1,1205,30228,3578743919,3578743919,0
1,1205,30229,3578743919,3578743919,0
1,1205,30230,3578743919,3578743919,0
1,1205,30231,3578743919,3578743919,0
1,1205,30232,3578743919,3578743919,0
1,1205,30233,3578743919,3578743919,0
1,1205,30234,3578743919,3578743919,0
1,1205,30235,3578743919,3578743919,0
1,1205,30236,3578743919,3578743919,0
1,1205,30237,3578743919,3578743919,0
1,1205,30238,3578743919,3578743920,1
1,1205,30239,3578743919,3578743920,1
1,1205,30240,3578743919,3578743922,3
1,1205,30241,3578743919,3578743922,3
1,1205,30242,3578743919,3578743923,4
1,1205,30243,3578743919,3578743924,5
1,1205,30244,3578743919,3578743925,6
1,1205,30245,3578743919,3578743925,6
1,1205,30246,3578743919,3578743927,8
1,1205,30247,3578743919,3578743927,8
1,1205,30248,3578743919,3578743928,9
1,1205,30249,3578743919,3578743930,11
1,1205,30250,3578743919,3578743930,11
1,1205,30251,3578743919,3578743930,11
1,1205,30252,3578743919,3578743930,11
1,1205,30253,3578743919,3578743930,11
1,1205,30254,3578743919,3578743930,11
1,1205,30255,3578743919,3578743931,12
1,1205,30256,3578743919,3578743932,13
1,1205,30257,3578743919,3578743932,13
1,1205,30258,3578743919,3578743932,13
1,1205,30259,3578743919,3578743933,14
1,1205,30260,3578743919,3578743933,14
1,1205,30261,3578743919,3578743934,15
1,1205,30262,3578743919,3578743934,15
1,1205,30263,3578743919,3578743934,15
1,1205,30264,3578743919,3578743935,16
1,1205,30265,3578743919,3578743935,16
1,1205,30266,3578743919,3578743936,17
1,1205,30267,3578743919,3578743937,18
1,1205,30268,3578743919,3578743937,18
1,1205,30269,3578743919,3578743938,19
1,1205,30270,3578743919,3578743939,20
1,1205,30271,3578743919,3578743939,20
1,1205,30272,3578743919,3578743941,22
1,1205,30273,3578743919,3578743942,23
1,1205,30274,3578743919,3578743943,24
1,1205,30275,3578743919,3578743945,26
1,1205,30276,3578743919,3578743946,27
1,1205,30277,3578743919,3578743946,27
1,1205,30278,3578743919,3578743947,28
1,1205,30279,3578743919,3578743947,28
1,1205,30280,3578743919,3578743948,29
1,1205,30281,3578743919,3578743948,29
1,1205,30282,3578743919,3578743950,31
1,1205,30283,3578743919,3578743952,33
1,1205,30284,3578743919,3578743952,33
1,1205,30285,3578743919,3578743953,34
1,1205,30286,3578743919,3578743954,35
1,1205,30287,3578743919,3578743955,36
1,1205,30288,3578743919,3578743955,36
1,1205,30289,3578743919,3578743956,37
1,1205,30290,3578743919,3578743957,38
1,1205,30291,3578743919,3578743958,39
1,1205,30292,3578743919,3578743961,42
1,1205,30293,3578743919,3578743963,44
1,1205,30294,3578743919,3578743964,45
1,1205,30295,3578743919,3578743965,46
1,1205,30296,3578743919,3578743966,47
1,1205,30297,3578743919,3578743968,49
1,1205,30298,3578743919,3578743968,49
1,1205,30299,3578743919,3578743968,49
1,1206,30300,3578743981,3578743981,0
1,1206,30301,3578743981,3578743981,0
1,1206,30302,3578743981,3578743981,0
1,1206,30303,3578743981,3578743981,0
1,1206,30304,3578743981,3578743981,0
1,1206,30305,3578743981,3578743981,0
1,1206,30306,3578743981,3578743981,0
1,1206,30307,3578743981,3578743981,0
1,1206,30308,3578743981,3578743981,0
1,1206,30309,3578743981,3578743981,0
1,1206,30310,3578743981,3578743981,0
1,1206,30311,3578743981,3578743981,0
1,1206,30312,3578743981,3578743981,0
1,1206,30313,3578743981,3578743982,1
1,1206,30314,3578743981,3578743982,1
1,1206,30315,3578743981,3578743982,1
1,1206,30316,3578743981,3578743983,2
1,1206,30317,3578743981,3578743983,2
1,1206,30318,3578743981,3578743983,2
1,1206,30319,3578743981,3578743986,5
1,1206,30320,3578743981,3578743986,5
1,1206,30321,3578743981,3578743986,5
1,1206,30322,3578743981,3578743990,9
1,1206,30323,3578743981,3578743991,10
1,1206,30324,3578743981,3578743991,10
1,1206,30325,3578743981,3578743991,10
1,1206,30326,3578743981,3578743993,12
1,1206,30327,3578743981,3578743995,14
1,1206,30328,3578743981,3578743996,15
1,1206,30329,3578743981,3578743996,15
1,1206,30330,3578743981,3578743996,15
1,1206,30331,3578743981,3578743996,15
1,1206,30332,3578743981,3578743997,16
1,1206,30333,3578743981,3578743997,16
1,1206,30334,3578743981,3578743998,17
1,1206,30335,3578743981,3578743998,17
1,1206,30336,3578743981,3578743999,18
1,1206,30337,3578743981,3578743999,18
1,1206,30338,3578743981,3578743999,18
1,1206,30339,3578743981,3578743999,18
1,1206,30340,3578743981,3578744001,20
1,1206,30341,3578743981,3578744002,21
1,1206,30342,3578743981,3578744003,22
1,1206,30343,3578743981,3578744006,25
1,1206,30344,3578743981,3578744006,25
1,1206,30345,3578743981,3578744012,31
1,1206,30346,3578743981,3578744012,31
1,1206,30347,3578743981,3578744013,32
1,1206,30348,3578743981,3578744015,34
1,1206,30349,3578743981,3578744016,35
1,1206,30350,3578743981,3578744017,36
1,1206,30351,3578743981,3578744017,36
1,1206,30352,3578743981,3578744018,37
1,1206,30353,3578743981,3578744018,37
1,1206,30354,3578743981,3578744018,37
1,1206,30355,3578743981,3578744021,40
1,1206,30356,3578743981,3578744024,43
1,1206,30357,3578743981,3578744024,43
1,1206,30358,3578743981,3578744026,45
1,1206,30359,3578743981,3578744026,45
1,1206,30360,3578743981,3578744026,45
1,1206,30361,3578743981,3578744029,48
1,1206,30362,3578743981,3578744029,48
1,1206,30363,3578743981,3578744029,48
1,1206,30364,3578743981,3578744030,49
1,1206,30365,3578743981,3578744030,49
1,1206,30366,3578743981,3578744031,50
1,1207,30367,3578744043,3578744043,0
1,1207,30368,3578744043,3578744043,0
1,1207,30369,3578744043,3578744043,0
1,1207,30370,3578744043,3578744043,0
1,1207,30371,3578744043,3578744043,0
1,1207,30372,3578744043,3578744043,0
1,1207,30373,3578744043,3578744043,0
1,1207,30374,3578744043,3578744043,0
1,1207,30375,3578744043,3578744043,0
1,1207,30376,3578744043,3578744043,0
1,1207,30377,3578744043,3578744043,0
1,1207,30378,3578744043,3578744045,2
1,1207,30379,3578744043,3578744045,2
1,1207,30380,3578744043,3578744047,4
1,1207,30381,3578744043,3578744048,5
1,1207,30382,3578744043,3578744048,5
1,1207,30383,3578744043,3578744048,5
1,1207,30384,3578744043,3578744049,6
1,1207,30385,3578744043,3578744051,8
1,1207,30386,3578744043,3578744052,9
1,1207,30387,3578744043,3578744053,10
1,1207,30388,3578744043,3578744054,11
1,1207,30389,3578744043,3578744056,13
1,1207,30390,3578744043,3578744056,13
1,1207,30391,3578744043,3578744058,15
1,1207,30392,3578744043,3578744059,16
1,1207,30393,3578744043,3578744059,16
1,1207,30394,3578744043,3578744061,18
1,1207,30395,3578744043,3578744061,18
1,1207,30396,3578744043,3578744063,20
1,1207,30397,3578744043,3578744063,20
1,1207,30398,3578744043,3578744064,21
1,1207,30399,3578744043,3578744065,22
1,1207,30400,3578744043,3578744065,22
1,1207,30401,3578744043,3578744066,23
1,1207,30402,3578744043,3578744067,24
1,1207,30403,3578744043,3578744068,25
1,1207,30404,3578744043,3578744068,25
1,1207,30405,3578744043,3578744069,26
1,1207,30406,3578744043,3578744074,31
1,1207,30407,3578744043,3578744076,33
1,1207,30408,3578744043,3578744077,34
1,1207,30409,3578744043,3578744082,39
1,1207,30410,3578744043,3578744083,40
1,1207,30411,3578744043,3578744083,40
1,1207,30412,3578744043,3578744084,41
1,1207,30413,3578744043,3578744086,43
1,1207,30414,3578744043,3578744088,45
1,1207,30415,3578744043,3578744088,45
1,1207,30416,3578744043,3578744089,46
1,1207,30417,3578744043,3578744089,46
1,1207,30418,3578744043,3578744089,46
1,1207,30419,3578744043,3578744090,47
1,1207,30420,3578744043,3578744091,48
1,1207,30421,3578744043,3578744092,49
1,1207,30422,3578744043,3578744092,49
1,1207,30423,3578744043,3578744092,49
1,1207,30424,3578744043,3578744093,50
1,1207,30425,3578744043,3578744093,50
1,1208,30426,3578744106,3578744106,0
1,1208,30427,3578744106,3578744106,0
1,1208,30428,3578744106,3578744106,0
1,1208,30429,3578744106,3578744106,0
1,1208,30430,3578744106,3578744106,0
1,1208,30431,3578744106,3578744106,0
1,1208,30432,3578744106,3578744106,0
1,1208,30433,3578744106,3578744106,0
1,1208,30434,3578744106,3578744106,0
1,1208,30435,3578744106,3578744106,0
1,1208,30436,3578744106,3578744106,0
1,1208,30437,3578744106,3578744106,0
1,1208,30438,3578744106,3578744106,0
1,1208,30439,3578744106,3578744106,0
1,1208,30440,3578744106,3578744107,1
1,1208,30441,3578744106,3578744109,3
1,1208,30442,3578744106,3578744111,5
1,1208,30443,3578744106,3578744112,6
1,1208,30444,3578744106,3578744112,6
1,1208,30445,3578744106,3578744112,6
1,1208,30446,3578744106,3578744112,6
1,1208,30447,3578744106,3578744113,7
1,1208,30448,3578744106,3578744113,7
1,1208,30449,3578744106,3578744114,8
1,1208,30450,3578744106,3578744114,8
1,1208,30451,3578744106,3578744115,9
1,1208,30452,3578744106,3578744115,9
1,1208,30453,3578744106,3578744116,10
1,1208,30454,3578744106,3578744116,10
1,1208,30455,3578744106,3578744117,11
1,1208,30456,3578744106,3578744117,11
1,1208,30457,3578744106,3578744119,13
1,1208,30458,3578744106,3578744119,13
1,1208,30459,3578744106,3578744120,14
1,1208,30460,3578744106,3578744122,16
1,1208,30461,3578744106,3578744122,16
1,1208,30462,3578744106,3578744123,17
1,1208,30463,3578744106,3578744125,19
1,1208,30464,3578744106,3578744125,19
1,1208,30465,3578744106,3578744125,19
1,1208,30466,3578744106,3578744126,20
1,1208,30467,3578744106,3578744127,21
1,1208,30468,3578744106,3578744128,22
1,1208,30469,3578744106,3578744130,24
1,1208,30470,3578744106,3578744130,24
1,1208,30471,3578744106,3578744130,24
1,1208,30472,3578744106,3578744130,24
1,1208,30473,3578744106,3578744130,24
1,1208,30474,3578744106,3578744131,25
1,1208,30475,3578744106,3578744131,25
1,1208,30476,3578744106,3578744131,25
1,1208,30477,3578744106,3578744132,26
1,1208,30478,3578744106,3578744132,26
1,1208,30479,3578744106,3578744133,27
1,1208,30480,3578744106,3578744133,27
1,1208,30481,3578744106,3578744134,28
1,1208,30482,3578744106,3578744135,29
1,1208,30483,3578744106,3578744135,29
1,1208,30484,3578744106,3578744135,29
1,1208,30485,3578744106,3578744136,30
1,1208,30486,3578744106,3578744136,30
1,1208,30487,3578744106,3578744136,30
1,1208,30488,3578744106,3578744137,31
1,1208,30489,3578744106,3578744137,31
1,1208,30490,3578744106,3578744139,33
1,1208,30491,3578744106,3578744140,34
1,1208,30492,3578744106,3578744141,35
1,1208,30493,3578744106,3578744143,37
1,1208,30494,3578744106,3578744143,37
1,1208,30495,3578744106,3578744145,39
1,1208,30496,3578744106,3578744146,40
1,1208,30497,3578744106,3578744147,41
1,1208,30498,3578744106,3578744147,41
1,1208,30499,3578744106,3578744148,42
1,1208,30500,3578744106,3578744148,42
1,1208,30501,3578744106,3578744150,44
1,1208,30502,3578744106,3578744150,44
1,1208,30503,3578744106,3578744152,46
1,1208,30504,3578744106,3578744152,46
1,1208,30505,3578744106,3578744152,46
1,1208,30506,3578744106,3578744154,48
1,1208,30507,3578744106,3578744155,49
1,1208,30508,3578744106,3578744156,50
1,1209,30509,3578744169,3578744169,0
1,1209,30510,3578744169,3578744169,0
1,1209,30511,3578744169,3578744169,0
1,1209,30512,3578744169,3578744169,0
1,1209,30513,3578744169,3578744169,0
1,1209,30514,3578744169,3578744169,0
1,1209,30515,3578744169,3578744169,0
1,1209,30516,3578744169,3578744169,0
1,1209,30517,3578744169,3578744169,0
1,1209,30518,3578744169,3578744169,0
1,1209,30519,3578744169,3578744169,0
1,1209,30520,3578744169,3578744169,0
1,1209,30521,3578744169,3578744169,0
1,1209,30522,3578744169,3578744170,1
1,1209,30523,3578744169,3578744171,2
1,1209,30524,3578744169,3578744171,2
1,1209,30525,3578744169,3578744172,3
1,1209,30526,3578744169,3578744175,6
1,1209,30527,3578744169,3578744177,8
1,1209,30528,3578744169,3578744178,9
1,1209,30529,3578744169,3578744179,10
1,1209,30530,3578744169,3578744179,10
1,1209,30531,3578744169,3578744180,11
1,1209,30532,3578744169,3578744181,12
1,1209,30533,3578744169,3578744181,12
1,1209,30534,3578744169,3578744181,12
1,1209,30535,3578744169,3578744182,13
1,1209,30536,3578744169,3578744183,14
1,1209,30537,3578744169,3578744183,14
1,1209,30538,3578744169,3578744184,15
1,1209,30539,3578744169,3578744186,17
1,1209,30540,3578744169,3578744187,18
1,1209,30541,3578744169,3578744187,18
1,1209,30542,3578744169,3578744190,21
1,1209,30543,3578744169,3578744190,21
1,1209,30544,3578744169,3578744192,23
1,1209,30545,3578744169,3578744192,23
1,1209,30546,3578744169,3578744192,23
1,1209,30547,3578744169,3578744194,25
1,1209,30548,3578744169,3578744195,26
1,1209,30549,3578744169,3578744196,27
1,1209,30550,3578744169,3578744196,27
1,1209,30551,3578744169,3578744197,28
1,1209,30552,3578744169,3578744197,28
1,1209,30553,3578744169,3578744198,29
1,1209,30554,3578744169,3578744198,29
1,1209,30555,3578744169,3578744199,30
1,1209,30556,3578744169,3578744199,30
1,1209,30557,3578744169,3578744199,30
1,1209,30558,3578744169,3578744199,30
1,1209,30559,3578744169,3578744200,31
1,1209,30560,3578744169,3578744201,32
1,1209,30561,3578744169,3578744202,33
1,1209,30562,3578744169,3578744203,34
1,1209,30563,3578744169,3578744206,37
1,1209,30564,3578744169,3578744206,37
1,1209,30565,3578744169,3578744212,43
1,1209,30566,3578744169,3578744212,43
1,1209,30567,3578744169,3578744212,43
1,1209,30568,3578744169,3578744213,44
1,1209,30569,3578744169,3578744216,47
1,1209,30570,3578744169,3578744217,48
1,1209,30571,3578744169,3578744217,48
1,1209,30572,3578744169,3578744218,49
1,1209,30573,3578744169,3578744218,49
1,1209,30574,3578744169,3578744219,50
1,1210,30575,3578744231,3578744231,0
1,1210,30576,3578744231,3578744231,0
1,1210,30577,3578744231,3578744231,0
1,1210,30578,3578744231,3578744231,0
1,1210,30579,3578744231,3578744231,0
1,1210,30580,3578744231,3578744231,0
1,1210,30581,3578744231,3578744231,0
1,1210,30582,3578744231,3578744231,0
1,1210,30583,3578744231,3578744231,0
1,1210,30584,3578744231,3578744231,0
1,1210,30585,3578744231,3578744231,0
1,1210,30586,3578744231,3578744231,0
1,1210,30587,3578744231,3578744231,0
1,1210,30588,3578744231,3578744231,0
1,1210,30589,3578744231,3578744232,1
1,1210,30590,3578744231,3578744233,2
1,1210,30591,3578744231,3578744235,4
1,1210,30592,3578744231,3578744237,6
1,1210,30593,3578744231,3578744239,8
1,1210,30594,3578744231,3578744239,8
1,1210,30595,3578744231,3578744239,8
1,1210,30596,3578744231,3578744240,9
1,1210,30597,3578744231,3578744240,9
1,1210,30598,3578744231,3578744241,10
1,1210,30599,3578744231,3578744244,13
1,1210,30600,3578744231,3578744245,14
1,1210,30601,3578744231,3578744246,15
1,1210,30602,3578744231,3578744248,17
1,1210,30603,3578744231,3578744248,17
1,1210,30604,3578744231,3578744248,17
1,1210,30605,3578744231,3578744248,17
1,1210,30606,3578744231,3578744251,20
1,1210,30607,3578744231,3578744252,21
1,1210,30608,3578744231,3578744254,23
1,1210,30609,3578744231,3578744255,24
1,1210,30610,3578744231,3578744255,24
1,1210,30611,3578744231,3578744256,25
1,1210,30612,3578744231,3578744258,27
1,1210,30613,3578744231,3578744258,27
1,1210,30614,3578744231,3578744261,30
1,1210,30615,3578744231,3578744261,30
1,1210,30616,3578744231,3578744262,31
1,1210,30617,3578744231,3578744263,32
1,1210,30618,3578744231,3578744264,33
1,1210,30619,3578744231,3578744265,34
1,1210,30620,3578744231,3578744265,34
1,1210,30621,3578744231,3578744267,36
1,1210,30622,3578744231,3578744267,36
1,1210,30623,3578744231,3578744269,38
1,1210,30624,3578744231,3578744270,39
1,1210,30625,3578744231,3578744274,43
1,1210,30626,3578744231,3578744281,50
1,1211,30627,3578744292,3578744292,0
1,1211,30628,3578744292,3578744292,0
1,1211,30629,3578744292,3578744292,0
1,1211,30630,3578744292,3578744292,0
1,1211,30631,3578744292,3578744292,0
1,1211,30632,3578744292,3578744292,0
1,1211,30633,3578744292,3578744292,0
1,1211,30634,3578744292,3578744292,0
1,1211,30635,3578744292,3578744292,0
1,1211,30636,3578744292,3578744292,0
1,1211,30637,3578744292,3578744292,0
1,1211,30638,3578744292,3578744292,0
1,1211,30639,3578744292,3578744293,1
1,1211,30640,3578744292,3578744293,1
1,1211,30641,3578744292,3578744293,1
1,1211,30642,3578744292,3578744296,4
1,1211,30643,3578744292,3578744297,5
1,1211,30644,3578744292,3578744298,6
1,1211,30645,3578744292,3578744299,7
1,1211,30646,3578744292,3578744301,9
1,1211,30647,3578744292,3578744301,9
1,1211,30648,3578744292,3578744302,10
1,1211,30649,3578744292,3578744302,10
1,1211,30650,3578744292,3578744303,11
1,1211,30651,3578744292,3578744304,12
1,1211,30652,3578744292,3578744305,13
1,1211,30653,3578744292,3578744305,13
1,1211,30654,3578744292,3578744305,13
1,1211,30655,3578744292,3578744305,13
1,1211,30656,3578744292,3578744306,14
1,1211,30657,3578744292,3578744308,16
1,1211,30658,3578744292,3578744310,18
1,1211,30659,3578744292,3578744311,19
1,1211,30660,3578744292,3578744311,19
1,1211,30661,3578744292,3578744311,19
1,1211,30662,3578744292,3578744312,20
1,1211,30663,3578744292,3578744313,21
1,1211,30664,3578744292,3578744313,21
1,1211,30665,3578744292,3578744314,22
1,1211,30666,3578744292,3578744314,22
1,1211,30667,3578744292,3578744314,22
1,1211,30668,3578744292,3578744315,23
1,1211,30669,3578744292,3578744316,24
1,1211,30670,3578744292,3578744316,24
1,1211,30671,3578744292,3578744317,25
1,1211,30672,3578744292,3578744318,26
1,1211,30673,3578744292,3578744320,28
1,1211,30674,3578744292,3578744320,28
1,1211,30675,3578744292,3578744321,29
1,1211,30676,3578744292,3578744323,31
1,1211,30677,3578744292,3578744323,31
1,1211,30678,3578744292,3578744323,31
1,1211,30679,3578744292,3578744325,33
1,1211,30680,3578744292,3578744325,33
1,1211,30681,3578744292,3578744326,34
1,1211,30682,3578744292,3578744326,34
1,1211,30683,3578744292,3578744328,36
1,1211,30684,3578744292,3578744329,37
1,1211,30685,3578744292,3578744329,37
1,1211,30686,3578744292,3578744330,38
1,1211,30687,3578744292,3578744330,38
1,1211,30688,3578744292,3578744330,38
1,1211,30689,3578744292,3578744331,39
1,1211,30690,3578744292,3578744331,39
1,1211,30691,3578744292,3578744333,41
1,1211,30692,3578744292,3578744333,41
1,1211,30693,3578744292,3578744333,41
1,1211,30694,3578744292,3578744333,41
1,1211,30695,3578744292,3578744334,42
1,1211,30696,3578744292,3578744335,43
1,1211,30697,3578744292,3578744335,43
1,1211,30698,3578744292,3578744335,43
1,1211,30699,3578744292,3578744335,43
1,1211,30700,3578744292,3578744336,44
1,1211,30701,3578744292,3578744337,45
1,1211,30702,3578744292,3578744337,45
1,1211,30703,3578744292,3578744338,46
1,1211,30704,3578744292,3578744339,47
1,1211,30705,3578744292,3578744340,48
1,1211,30706,3578744292,3578744341,49
1,1212,30707,3578744354,3578744354,0
1,1212,30708,3578744354,3578744354,0
1,1212,30709,3578744354,3578744354,0
1,1212,30710,3578744354,3578744354,0
1,1212,30711,3578744354,3578744354,0
1,1212,30712,3578744354,3578744354,0
1,1212,30713,3578744354,3578744354,0
1,1212,30714,3578744354,3578744354,0
1,1212,30715,3578744354,3578744354,0
1,1212,30716,3578744354,3578744354,0
1,1212,30717,3578744354,3578744354,0
1,1212,30718,3578744354,3578744354,0
1,1212,30719,3578744354,3578744354,0
1,1212,30720,3578744354,3578744355,1
1,1212,30721,3578744354,3578744355,1
1,1212,30722,3578744354,3578744356,2
1,1212,30723,3578744354,3578744356,2
1,1212,30724,3578744354,3578744357,3
1,1212,30725,3578744354,3578744358,4
1,1212,30726,3578744354,3578744360,6
1,1212,30727,3578744354,3578744363,9
1,1212,30728,3578744354,3578744363,9
1,1212,30729,3578744354,3578744363,9
1,1212,30730,3578744354,3578744363,9
1,1212,30731,3578744354,3578744364,10
1,1212,30732,3578744354,3578744366,12
1,1212,30733,3578744354,3578744367,13
1,1212,30734,3578744354,3578744368,14
1,1212,30735,3578744354,3578744369,15
1,1212,30736,3578744354,3578744370,16
1,1212,30737,3578744354,3578744370,16
1,1212,30738,3578744354,3578744370,16
1,1212,30739,3578744354,3578744370,16
1,1212,30740,3578744354,3578744371,17
1,1212,30741,3578744354,3578744373,19
1,1212,30742,3578744354,3578744376,22
1,1212,30743,3578744354,3578744377,23
1,1212,30744,3578744354,3578744378,24
1,1212,30745,3578744354,3578744379,25
1,1212,30746,3578744354,3578744381,27
1,1212,30747,3578744354,3578744381,27
1,1212,30748,3578744354,3578744381,27
1,1212,30749,3578744354,3578744382,28
1,1212,30750,3578744354,3578744382,28
1,1212,30751,3578744354,3578744383,29
1,1212,30752,3578744354,3578744383,29
1,1212,30753,3578744354,3578744384,30
1,1212,30754,3578744354,3578744386,32
1,1212,30755,3578744354,3578744386,32
1,1212,30756,3578744354,3578744390,36
1,1212,30757,3578744354,3578744391,37
1,1212,30758,3578744354,3578744392,38
1,1212,30759,3578744354,3578744392,38
1,1212,30760,3578744354,3578744394,40
1,1212,30761,3578744354,3578744396,42
1,1212,30762,3578744354,3578744396,42
1,1212,30763,3578744354,3578744397,43
1,1212,30764,3578744354,3578744397,43
1,1212,30765,3578744354,3578744397,43
1,1212,30766,3578744354,3578744398,44
1,1212,30767,3578744354,3578744398,44
1,1212,30768,3578744354,3578744399,45
1,1212,30769,3578744354,3578744399,45
1,1212,30770,3578744354,3578744399,45
1,1212,30771,3578744354,3578744399,45
1,1212,30772,3578744354,3578744401,47
1,1212,30773,3578744354,3578744402,48
1,1212,30774,3578744354,3578744404,50
1,1213,30775,3578744415,3578744415,0
1,1213,30776,3578744415,3578744415,0
1,1213,30777,3578744415,3578744415,0
1,1213,30778,3578744415,3578744415,0
1,1213,30779,3578744415,3578744415,0
1,1213,30780,3578744415,3578744415,0
1,1213,30781,3578744415,3578744416,1
1,1213,30782,3578744415,3578744417,2
1,1213,30783,3578744415,3578744418,3
1,1213,30784,3578744415,3578744418,3
1,1213,30785,3578744415,3578744418,3
1,1213,30786,3578744415,3578744419,4
1,1213,30787,3578744415,3578744420,5
1,1213,30788,3578744415,3578744421,6
1,1213,30789,3578744415,3578744422,7
1,1213,30790,3578744415,3578744423,8
1,1213,30791,3578744415,3578744424,9
1,1213,30792,3578744415,3578744426,11
1,1213,30793,3578744415,3578744427,12
1,1213,30794,3578744415,3578744427,12
1,1213,30795,3578744415,3578744429,14
1,1213,30796,3578744415,3578744430,15
1,1213,30797,3578744415,3578744430,15
1,1213,30798,3578744415,3578744430,15
1,1213,30799,3578744415,3578744430,15
1,1213,30800,3578744415,3578744430,15
1,1213,30801,3578744415,3578744431,16
1,1213,30802,3578744415,3578744432,17
1,1213,30803,3578744415,3578744433,18
1,1213,30804,3578744415,3578744437,22
1,1213,30805,3578744415,3578744439,24
1,1213,30806,3578744415,3578744439,24
1,1213,30807,3578744415,3578744440,25
1,1213,30808,3578744415,3578744440,25
1,1213,30809,3578744415,3578744440,25
1,1213,30810,3578744415,3578744441,26
1,1213,30811,3578744415,3578744443,28
1,1213,30812,3578744415,3578744445,30
1,1213,30813,3578744415,3578744445,30
1,1213,30814,3578744415,3578744447,32
1,1213,30815,3578744415,3578744448,33
1,1213,30816,3578744415,3578744448,33
1,1213,30817,3578744415,3578744448,33
1,1213,30818,3578744415,3578744449,34
1,1213,30819,3578744415,3578744451,36
1,1213,30820,3578744415,3578744452,37
1,1213,30821,3578744415,3578744454,39
1,1213,30822,3578744415,3578744455,40
1,1213,30823,3578744415,3578744456,41
1,1213,30824,3578744415,3578744457,42
1,1213,30825,3578744415,3578744457,42
1,1213,30826,3578744415,3578744459,44
1,1213,30827,3578744415,3578744461,46
1,1213,30828,3578744415,3578744462,47
1,1213,30829,3578744415,3578744463,48
1,1213,30830,3578744415,3578744463,48
1,1213,30831,3578744415,3578744464,49
1,1213,30832,3578744415,3578744465,50
1,1214,30833,3578744476,3578744476,0
1,1214,30834,3578744476,3578744476,0
1,1214,30835,3578744476,3578744476,0
1,1214,30836,3578744476,3578744476,0
1,1214,30837,3578744476,3578744476,0
1,1214,30838,3578744476,3578744476,0
1,1214,30839,3578744476,3578744476,0
1,1214,30840,3578744476,3578744477,1
1,1214,30841,3578744476,3578744481,5
1,1214,30842,3578744476,3578744483,7
1,1214,30843,3578744476,3578744484,8
1,1214,30844,3578744476,3578744485,9
1,1214,30845,3578744476,3578744486,10
1,1214,30846,3578744476,3578744488,12
1,1214,30847,3578744476,3578744488,12
1,1214,30848,3578744476,3578744489,13
1,1214,30849,3578744476,3578744489,13
1,1214,30850,3578744476,3578744489,13
1,1214,30851,3578744476,3578744491,15
1,1214,30852,3578744476,3578744491,15
1,1214,30853,3578744476,3578744492,16
1,1214,30854,3578744476,3578744492,16
1,1214,30855,3578744476,3578744492,16
1,1214,30856,3578744476,3578744493,17
1,1214,30857,3578744476,3578744493,17
1,1214,30858,3578744476,3578744496,20
1,1214,30859,3578744476,3578744497,21
1,1214,30860,3578744476,3578744498,22
1,1214,30861,3578744476,3578744500,24
1,1214,30862,3578744476,3578744501,25
1,1214,30863,3578744476,3578744501,25
1,1214,30864,3578744476,3578744501,25
1,1214,30865,3578744476,3578744502,26
1,1214,30866,3578744476,3578744504,28
1,1214,30867,3578744476,3578744504,28
1,1214,30868,3578744476,3578744505,29
1,1214,30869,3578744476,3578744505,29
1,1214,30870,3578744476,3578744505,29
1,1214,30871,3578744476,3578744506,30
1,1214,30872,3578744476,3578744508,32
1,1214,30873,3578744476,3578744508,32
1,1214,30874,3578744476,3578744510,34
1,1214,30875,3578744476,3578744511,35
1,1214,30876,3578744476,3578744511,35
1,1214,30877,3578744476,3578744512,36
1,1214,30878,3578744476,3578744513,37
1,1214,30879,3578744476,3578744513,37
1,1214,30880,3578744476,3578744513,37
1,1214,30881,3578744476,3578744514,38
1,1214,30882,3578744476,3578744514,38
1,1214,30883,3578744476,3578744514,38
1,1214,30884,3578744476,3578744515,39
1,1214,30885,3578744476,3578744516,40
1,1214,30886,3578744476,3578744516,40
1,1214,30887,3578744476,3578744517,41
1,1214,30888,3578744476,3578744518,42
1,1214,30889,3578744476,3578744520,44
1,1214,30890,3578744476,3578744521,45
1,1214,30891,3578744476,3578744521,45
1,1214,30892,3578744476,3578744522,46
1,1214,30893,3578744476,3578744522,46
1,1214,30894,3578744476,3578744523,47
1,1214,30895,3578744476,3578744525,49
1,1214,30896,3578744476,3578744525,49
1,1214,30897,3578744476,3578744525,49
1,1215,30898,3578744539,3578744539,0
1,1215,30899,3578744539,3578744539,0
1,1215,30900,3578744539,3578744539,0
1,1215,30901,3578744539,3578744539,0
1,1215,30902,3578744539,3578744539,0
1,1215,30903,3578744539,3578744539,0
1,1215,30904,3578744539,3578744539,0
1,1215,30905,3578744539,3578744539,0
1,1215,30906,3578744539,3578744539,0
1,1215,30907,3578744539,3578744539,0
1,1215,30908,3578744539,3578744539,0
1,1215,30909,3578744539,3578744539,0
1,1215,30910,3578744539,3578744539,0
1,1215,30911,3578744539,3578744539,0
1,1215,30912,3578744539,3578744539,0
1,1215,30913,3578744539,3578744539,0
1,1215,30914,3578744539,3578744539,0
1,1215,30915,3578744539,3578744539,0
1,1215,30916,3578744539,3578744539,0
1,1215,30917,3578744539,3578744539,0
1,1215,30918,3578744539,3578744539,0
1,1215,30919,3578744539,3578744539,0
1,1215,30920,3578744539,3578744539,0
1,1215,30921,3578744539,3578744540,1
1,1215,30922,3578744539,3578744541,2
1,1215,30923,3578744539,3578744542,3
1,1215,30924,3578744539,3578744543,4
1,1215,30925,3578744539,3578744544,5
1,1215,30926,3578744539,3578744545,6
1,1215,30927,3578744539,3578744546,7
1,1215,30928,3578744539,3578744548,9
1,1215,30929,3578744539,3578744549,10
1,1215,30930,3578744539,3578744549,10
1,1215,30931,3578744539,3578744550,11
1,1215,30932,3578744539,3578744551,12
1,1215,30933,3578744539,3578744551,12
1,1215,30934,3578744539,3578744552,13
1,1215,30935,3578744539,3578744554,15
1,1215,30936,3578744539,3578744555,16
1,1215,30937,3578744539,3578744555,16
1,1215,30938,3578744539,3578744556,17
1,1215,30939,3578744539,3578744556,17
1,1215,30940,3578744539,3578744557,18
1,1215,30941,3578744539,3578744559,20
1,1215,30942,3578744539,3578744561,22
1,1215,30943,3578744539,3578744562,23
1,1215,30944,3578744539,3578744562,23
1,1215,30945,3578744539,3578744562,23
1,1215,30946,3578744539,3578744563,24
1,1215,30947,3578744539,3578744565,26
1,1215,30948,3578744539,3578744566,27
1,1215,30949,3578744539,3578744566,27
1,1215,30950,3578744539,3578744567,28
1,1215,30951,3578744539,3578744569,30
1,1215,30952,3578744539,3578744569,30
1,1215,30953,3578744539,3578744569,30
1,1215,30954,3578744539,3578744570,31
1,1215,30955,3578744539,3578744571,32
1,1215,30956,3578744539,3578744572,33
1,1215,30957,3578744539,3578744575,36
1,1215,30958,3578744539,3578744576,37
1,1215,30959,3578744539,3578744577,38
1,1215,30960,3578744539,3578744578,39
1,1215,30961,3578744539,3578744579,40
1,1215,30962,3578744539,3578744580,41
1,1215,30963,3578744539,3578744580,41
1,1215,30964,3578744539,3578744581,42
1,1215,30965,3578744539,3578744581,42
1,1215,30966,3578744539,3578744582,43
1,1215,30967,3578744539,3578744583,44
1,1215,30968,3578744539,3578744583,44
1,1215,30969,3578744539,3578744585,46
1,1215,30970,3578744539,3578744585,46
1,1216,30971,3578744600,3578744600,0
1,1216,30972,3578744600,3578744600,0
1,1216,30973,3578744600,3578744600,0
1,1216,30974,3578744600,3578744600,0
1,1216,30975,3578744600,3578744600,0
1,1216,30976,3578744600,3578744600,0
1,1216,30977,3578744600,3578744600,0
1,1216,30978,3578744600,3578744600,0
1,1216,30979,3578744600,3578744600,0
1,1216,30980,3578744600,3578744600,0
1,1216,30981,3578744600,3578744600,0
1,1216,30982,3578744600,3578744600,0
1,1216,30983,3578744600,3578744600,0
1,1216,30984,3578744600,3578744600,0
1,1216,30985,3578744600,3578744600,0
1,1216,30986,3578744600,3578744600,0
1,1216,30987,3578744600,3578744600,0
1,1216,30988,3578744600,3578744600,0
1,1216,30989,3578744600,3578744600,0
1,1216,30990,3578744600,3578744601,1
1,1216,30991,3578744600,3578744603,3
1,1216,30992,3578744600,3578744605,5
1,1216,30993,3578744600,3578744605,5
1,1216,30994,3578744600,3578744611,11
1,1216,30995,3578744600,3578744611,11
1,1216,30996,3578744600,3578744612,12
1,1216,30997,3578744600,3578744615,15
1,1216,30998,3578744600,3578744616,16
1,1216,30999,3578744600,3578744616,16
1,1216,31000,3578744600,3578744617,17
1,1216,31001,3578744600,3578744617,17
1,1216,31002,3578744600,3578744618,18
1,1216,31003,3578744600,3578744618,18
1,1216,31004,3578744600,3578744618,18
1,1216,31005,3578744600,3578744621,21
1,1216,31006,3578744600,3578744621,21
1,1216,31007,3578744600,3578744623,23
1,1216,31008,3578744600,3578744624,24
1,1216,31009,3578744600,3578744624,24
1,1216,31010,3578744600,3578744626,26
1,1216,31011,3578744600,3578744627,27
1,1216,31012,3578744600,3578744628,28
1,1216,31013,3578744600,3578744629,29
1,1216,31014,3578744600,3578744629,29
1,1216,31015,3578744600,3578744629,29
1,1216,31016,3578744600,3578744629,29
1,1216,31017,3578744600,3578744629,29
1,1216,31018,3578744600,3578744630,30
1,1216,31019,3578744600,3578744630,30
1,1216,31020,3578744600,3578744631,31
1,1216,31021,3578744600,3578744632,32
1,1216,31022,3578744600,3578744636,36
1,1216,31023,3578744600,3578744638,38
1,1216,31024,3578744600,3578744638,38
1,1216,31025,3578744600,3578744639,39
1,1216,31026,3578744600,3578744639,39
1,1216,31027,3578744600,3578744640,40
1,1216,31028,3578744600,3578744640,40
1,1216,31029,3578744600,3578744642,42
1,1216,31030,3578744600,3578744643,43
1,1216,31031,3578744600,3578744644,44
1,1216,31032,3578744600,3578744646,46
1,1216,31033,3578744600,3578744647,47
1,1216,31034,3578744600,3578744648,48
1,1216,31035,3578744600,3578744648,48
1,1216,31036,3578744600,3578744648,48
1,1216,31037,3578744600,3578744650,50
1,1217,31038,3578744663,3578744663,0
1,1217,31039,3578744663,3578744663,0
1,1217,31040,3578744663,3578744663,0
1,1217,31041,3578744663,3578744663,0
1,1217,31042,3578744663,3578744663,0
1,1217,31043,3578744663,3578744663,0
1,1217,31044,3578744663,3578744663,0
1,1217,31045,3578744663,3578744663,0
1,1217,31046,3578744663,3578744663,0
1,1217,31047,3578744663,3578744663,0
1,1217,31048,3578744663,3578744663,0
1,1217,31049,3578744663,3578744664,1
1,1217,31050,3578744663,3578744665,2
1,1217,31051,3578744663,3578744665,2
1,1217,31052,3578744663,3578744666,3
1,1217,31053,3578744663,3578744667,4
1,1217,31054,3578744663,3578744668,5
1,1217,31055,3578744663,3578744668,5
1,1217,31056,3578744663,3578744669,6
1,1217,31057,3578744663,3578744675,12
1,1217,31058,3578744663,3578744677,14
1,1217,31059,3578744663,3578744681,18
1,1217,31060,3578744663,3578744684,21
1,1217,31061,3578744663,3578744684,21
1,1217,31062,3578744663,3578744685,22
1,1217,31063,3578744663,3578744685,22
1,1217,31064,3578744663,3578744688,25
1,1217,31065,3578744663,3578744688,25
1,1217,31066,3578744663,3578744688,25
1,1217,31067,3578744663,3578744689,26
1,1217,31068,3578744663,3578744690,27
1,1217,31069,3578744663,3578744691,28
1,1217,31070,3578744663,3578744691,28
1,1217,31071,3578744663,3578744692,29
1,1217,31072,3578744663,3578744693,30
1,1217,31073,3578744663,3578744693,30
1,1217,31074,3578744663,3578744694,31
1,1217,31075,3578744663,3578744694,31
1,1217,31076,3578744663,3578744697,34
1,1217,31077,3578744663,3578744698,35
1,1217,31078,3578744663,3578744699,36
1,1217,31079,3578744663,3578744701,38
1,1217,31080,3578744663,3578744701,38
1,1217,31081,3578744663,3578744702,39
1,1217,31082,3578744663,3578744703,40
1,1217,31083,3578744663,3578744705,42
1,1217,31084,3578744663,3578744705,42
1,1217,31085,3578744663,3578744705,42
1,1217,31086,3578744663,3578744706,43
1,1217,31087,3578744663,3578744706,43
1,1217,31088,3578744663,3578744707,44
1,1217,31089,3578744663,3578744711,48
1,1217,31090,3578744663,3578744711,48
1,1217,31091,3578744663,3578744711,48
1,1217,31092,3578744663,3578744712,49
1,1217,31093,3578744663,3578744712,49
1,1217,31094,3578744663,3578744713,50
1,1218,31095,3578744726,3578744726,0
1,1218,31096,3578744726,3578744726,0
1,1218,31097,3578744726,3578744726,0
1,1218,31098,3578744726,3578744726,0
1,1218,31099,3578744726,3578744726,0
1,1218,31100,3578744726,3578744726,0
1,1218,31101,3578744726,3578744726,0
1,1218,31102,3578744726,3578744726,0
1,1218,31103,3578744726,3578744726,0
1,1218,31104,3578744726,3578744726,0
1,1218,31105,3578744726,3578744726,0
1,1218,31106,3578744726,3578744726,0
1,1218,31107,3578744726,3578744726,0
1,1218,31108,3578744726,3578744726,0
1,1218,31109,3578744726,3578744726,0
1,1218,31110,3578744726,3578744726,0
1,1218,31111,3578744726,3578744726,0
1,1218,31112,3578744726,3578744726,0
1,1218,31113,3578744726,3578744727,1
1,1218,31114,3578744726,3578744727,1
1,1218,31115,3578744726,3578744728,2
1,1218,31116,3578744726,3578744729,3
1,1218,31117,3578744726,3578744729,3
1,1218,31118,3578744726,3578744729,3
1,1218,31119,3578744726,3578744730,4
1,1218,31120,3578744726,3578744731,5
1,1218,31121,3578744726,3578744731,5
1,1218,31122,3578744726,3578744731,5
1,1218,31123,3578744726,3578744732,6
1,1218,31124,3578744726,3578744732,6
1,1218,31125,3578744726,3578744733,7
1,1218,31126,3578744726,3578744733,7
1,1218,31127,3578744726,3578744734,8
1,1218,31128,3578744726,3578744734,8
1,1218,31129,3578744726,3578744735,9
1,1218,31130,3578744726,3578744735,9
1,1218,31131,3578744726,3578744736,10
1,1218,31132,3578744726,3578744736,10
1,1218,31133,3578744726,3578744737,11
1,1218,31134,3578744726,3578744738,12
1,1218,31135,3578744726,3578744739,13
1,1218,31136,3578744726,3578744741,15
1,1218,31137,3578744726,3578744742,16
1,1218,31138,3578744726,3578744742,16
1,1218,31139,3578744726,3578744744,18
1,1218,31140,3578744726,3578744745,19
1,1218,31141,3578744726,3578744746,20
1,1218,31142,3578744726,3578744746,20
1,1218,31143,3578744726,3578744747,21
1,1218,31144,3578744726,3578744747,21
1,1218,31145,3578744726,3578744748,22
1,1218,31146,3578744726,3578744749,23
1,1218,31147,3578744726,3578744750,24
1,1218,31148,3578744726,3578744751,25
1,1218,31149,3578744726,3578744752,26
1,1218,31150,3578744726,3578744753,27
1,1218,31151,3578744726,3578744755,29
1,1218,31152,3578744726,3578744755,29
1,1218,31153,3578744726,3578744756,30
1,1218,31154,3578744726,3578744756,30
1,1218,31155,3578744726,3578744757,31
1,1218,31156,3578744726,3578744757,31
1,1218,31157,3578744726,3578744759,33
1,1218,31158,3578744726,3578744761,35
1,1218,31159,3578744726,3578744762,36
1,1218,31160,3578744726,3578744762,36
1,1218,31161,3578744726,3578744762,36
1,1218,31162,3578744726,3578744762,36
1,1218,31163,3578744726,3578744765,39
1,1218,31164,3578744726,3578744766,40
1,1218,31165,3578744726,3578744767,41
1,1218,31166,3578744726,3578744768,42
1,1218,31167,3578744726,3578744769,43
1,1218,31168,3578744726,3578744770,44
1,1218,31169,3578744726,3578744771,45
1,1218,31170,3578744726,3578744771,45
1,1218,31171,3578744726,3578744772,46
1,1219,31172,3578744788,3578744788,0
1,1219,31173,3578744788,3578744788,0
1,1219,31174,3578744788,3578744788,0
1,1219,31175,3578744788,3578744788,0
1,1219,31176,3578744788,3578744788,0
1,1219,31177,3578744788,3578744788,0
1,1219,31178,3578744788,3578744788,0
1,1219,31179,3578744788,3578744788,0
1,1219,31180,3578744788,3578744788,0
1,1219,31181,3578744788,3578744788,0
1,1219,31182,3578744788,3578744788,0
1,1219,31183,3578744788,3578744788,0
1,1219,31184,3578744788,3578744789,1
1,1219,31185,3578744788,3578744790,2
1,1219,31186,3578744788,3578744790,2
1,1219,31187,3578744788,3578744792,4
1,1219,31188,3578744788,3578744793,5
1,1219,31189,3578744788,3578744793,5
1,1219,31190,3578744788,3578744794,6
1,1219,31191,3578744788,3578744795,7
1,1219,31192,3578744788,3578744796,8
1,1219,31193,3578744788,3578744796,8
1,1219,31194,3578744788,3578744797,9
1,1219,31195,3578744788,3578744797,9
1,1219,31196,3578744788,3578744797,9
1,1219,31197,3578744788,3578744798,10
1,1219,31198,3578744788,3578744798,10
1,1219,31199,3578744788,3578744798,10
1,1219,31200,3578744788,3578744800,12
1,1219,31201,3578744788,3578744800,12
1,1219,31202,3578744788,3578744800,12
1,1219,31203,3578744788,3578744801,13
1,1219,31204,3578744788,3578744802,14
1,1219,31205,3578744788,3578744805,17
1,1219,31206,3578744788,3578744806,18
1,1219,31207,3578744788,3578744811,23
1,1219,31208,3578744788,3578744812,24
1,1219,31209,3578744788,3578744813,25
1,1219,31210,3578744788,3578744815,27
1,1219,31211,3578744788,3578744816,28
1,1219,31212,3578744788,3578744817,29
1,1219,31213,3578744788,3578744817,29
1,1219,31214,3578744788,3578744817,29
1,1219,31215,3578744788,3578744818,30
1,1219,31216,3578744788,3578744818,30
1,1219,31217,3578744788,3578744819,31
1,1219,31218,3578744788,3578744821,33
1,1219,31219,3578744788,3578744821,33
1,1219,31220,3578744788,3578744823,35
1,1219,31221,3578744788,3578744824,36
1,1219,31222,3578744788,3578744825,37
1,1219,31223,3578744788,3578744826,38
1,1219,31224,3578744788,3578744826,38
1,1219,31225,3578744788,3578744828,40
1,1219,31226,3578744788,3578744828,40
1,1219,31227,3578744788,3578744829,41
1,1219,31228,3578744788,3578744829,41
1,1219,31229,3578744788,3578744829,41
1,1219,31230,3578744788,3578744829,41
1,1219,31231,3578744788,3578744830,42
1,1219,31232,3578744788,3578744830,42
1,1219,31233,3578744788,3578744832,44
1,1219,31234,3578744788,3578744832,44
1,1219,31235,3578744788,3578744834,46
1,1219,31236,3578744788,3578744836,48
1,1219,31237,3578744788,3578744838,50
1,1220,31238,3578744852,3578744852,0
1,1220,31239,3578744852,3578744852,0
1,1220,31240,3578744852,3578744852,0
1,1220,31241,3578744852,3578744852,0
1,1220,31242,3578744852,3578744852,0
1,1220,31243,3578744852,3578744852,0
1,1220,31244,3578744852,3578744852,0
1,1220,31245,3578744852,3578744852,0
1,1220,31246,3578744852,3578744852,0
1,1220,31247,3578744852,3578744852,0
1,1220,31248,3578744852,3578744852,0
1,1220,31249,3578744852,3578744852,0
1,1220,31250,3578744852,3578744852,0
1,1220,31251,3578744852,3578744852,0
1,1220,31252,3578744852,3578744852,0
1,1220,31253,3578744852,3578744853,1
1,1220,31254,3578744852,3578744854,2
1,1220,31255,3578744852,3578744855,3
1,1220,31256,3578744852,3578744856,4
1,1220,31257,3578744852,3578744858,6
1,1220,31258,3578744852,3578744858,6
1,1220,31259,3578744852,3578744860,8
1,1220,31260,3578744852,3578744861,9
1,1220,31261,3578744852,3578744862,10
1,1220,31262,3578744852,3578744863,11
1,1220,31263,3578744852,3578744864,12
1,1220,31264,3578744852,3578744864,12
1,1220,31265,3578744852,3578744865,13
1,1220,31266,3578744852,3578744866,14
1,1220,31267,3578744852,3578744867,15
1,1220,31268,3578744852,3578744868,16
1,1220,31269,3578744852,3578744868,16
1,1220,31270,3578744852,3578744869,17
1,1220,31271,3578744852,3578744869,17
1,1220,31272,3578744852,3578744875,23
1,1220,31273,3578744852,3578744877,25
1,1220,31274,3578744852,3578744878,26
1,1220,31275,3578744852,3578744881,29
1,1220,31276,3578744852,3578744884,32
1,1220,31277,3578744852,3578744884,32
1,1220,31278,3578744852,3578744885,33
1,1220,31279,3578744852,3578744886,34
1,1220,31280,3578744852,3578744888,36
1,1220,31281,3578744852,3578744888,36
1,1220,31282,3578744852,3578744889,37
1,1220,31283,3578744852,3578744889,37
1,1220,31284,3578744852,3578744890,38
1,1220,31285,3578744852,3578744891,39
1,1220,31286,3578744852,3578744891,39
1,1220,31287,3578744852,3578744892,40
1,1220,31288,3578744852,3578744892,40
1,1220,31289,3578744852,3578744893,41
1,1220,31290,3578744852,3578744895,43
1,1220,31291,3578744852,3578744897,45
1,1220,31292,3578744852,3578744899,47
1,1220,31293,3578744852,3578744900,48
1,1220,31294,3578744852,3578744900,48
1,1220,31295,3578744852,3578744901,49
1,1220,31296,3578744852,3578744902,50
1,1221,31297,3578744914,3578744914,0
1,1221,31298,3578744914,3578744914,0
1,1221,31299,3578744914,3578744914,0
1,1221,31300,3578744914,3578744914,0
1,1221,31301,3578744914,3578744914,0
1,1221,31302,3578744914,3578744914,0
1,1221,31303,3578744914,3578744914,0
1,1221,31304,3578744914,3578744914,0
1,1221,31305,3578744914,3578744914,0
1,1221,31306,3578744914,3578744914,0
1,1221,31307,3578744914,3578744914,0
1,1221,31308,3578744914,3578744915,1
1,1221,31309,3578744914,3578744915,1
1,1221,31310,3578744914,3578744915,1
1,1221,31311,3578744914,3578744915,1
1,1221,31312,3578744914,3578744915,1
1,1221,31313,3578744914,3578744915,1
1,1221,31314,3578744914,3578744915,1
1,1221,31315,3578744914,3578744915,1
1,1221,31316,3578744914,3578744915,1
1,1221,31317,3578744914,3578744916,2
1,1221,31318,3578744914,3578744917,3
1,1221,31319,3578744914,3578744918,4
1,1221,31320,3578744914,3578744919,5
1,1221,31321,3578744914,3578744920,6
1,1221,31322,3578744914,3578744921,7
1,1221,31323,3578744914,3578744922,8
1,1221,31324,3578744914,3578744923,9
1,1221,31325,3578744914,3578744923,9
1,1221,31326,3578744914,3578744924,10
1,1221,31327,3578744914,3578744925,11
1,1221,31328,3578744914,3578744925,11
1,1221,31329,3578744914,3578744925,11
1,1221,31330,3578744914,3578744926,12
1,1221,31331,3578744914,3578744928,14
1,1221,31332,3578744914,3578744928,14
1,1221,31333,3578744914,3578744928,14
1,1221,31334,3578744914,3578744929,15
1,1221,31335,3578744914,3578744929,15
1,1221,31336,3578744914,3578744930,16
1,1221,31337,3578744914,3578744931,17
1,1221,31338,3578744914,3578744931,17
1,1221,31339,3578744914,3578744931,17
1,1221,31340,3578744914,3578744931,17
1,1221,31341,3578744914,3578744933,19
1,1221,31342,3578744914,3578744933,19
1,1221,31343,3578744914,3578744933,19
1,1221,31344,3578744914,3578744934,20
1,1221,31345,3578744914,3578744935,21
1,1221,31346,3578744914,3578744935,21
1,1221,31347,3578744914,3578744935,21
1,1221,31348,3578744914,3578744935,21
1,1221,31349,3578744914,3578744935,21
1,1221,31350,3578744914,3578744937,23
1,1221,31351,3578744914,3578744937,23
1,1221,31352,3578744914,3578744938,24
1,1221,31353,3578744914,3578744939,25
1,1221,31354,3578744914,3578744941,27
1,1221,31355,3578744914,3578744942,28
1,1221,31356,3578744914,3578744943,29
1,1221,31357,3578744914,3578744944,30
1,1221,31358,3578744914,3578744945,31
1,1221,31359,3578744914,3578744945,31
1,1221,31360,3578744914,3578744946,32
1,1221,31361,3578744914,3578744947,33
1,1221,31362,3578744914,3578744948,34
1,1221,31363,3578744914,3578744949,35
1,1221,31364,3578744914,3578744950,36
1,1221,31365,3578744914,3578744950,36
1,1221,31366,3578744914,3578744951,37
1,1221,31367,3578744914,3578744952,38
1,1221,31368,3578744914,3578744952,38
1,1221,31369,3578744914,3578744955,41
1,1221,31370,3578744914,3578744955,41
1,1221,31371,3578744914,3578744956,42
1,1221,31372,3578744914,3578744956,42
1,1221,31373,3578744914,3578744957,43
1,1221,31374,3578744914,3578744957,43
1,1221,31375,3578744914,3578744959,45
1,1221,31376,3578744914,3578744961,47
1,1221,31377,3578744914,3578744962,48
1,1221,31378,3578744914,3578744962,48
1,1221,31379,3578744914,3578744962,48
1,1221,31380,3578744914,3578744964,50
1,1222,31381,3578744977,3578744977,0
1,1222,31382,3578744977,3578744977,0
1,1222,31383,3578744977,3578744977,0
1,1222,31384,3578744977,3578744977,0
1,1222,31385,3578744977,3578744977,0
1,1222,31386,3578744977,3578744977,0
1,1222,31387,3578744977,3578744977,0
1,1222,31388,3578744977,3578744977,0
1,1222,31389,3578744977,3578744977,0
1,1222,31390,3578744977,3578744977,0
1,1222,31391,3578744977,3578744977,0
1,1222,31392,3578744977,3578744978,1
1,1222,31393,3578744977,3578744979,2
1,1222,31394,3578744977,3578744979,2
1,1222,31395,3578744977,3578744980,3
1,1222,31396,3578744977,3578744980,3
1,1222,31397,3578744977,3578744981,4
1,1222,31398,3578744977,3578744981,4
1,1222,31399,3578744977,3578744982,5
1,1222,31400,3578744977,3578744984,7
1,1222,31401,3578744977,3578744984,7
1,1222,31402,3578744977,3578744985,8
1,1222,31403,3578744977,3578744985,8
1,1222,31404,3578744977,3578744987,10
1,1222,31405,3578744977,3578744990,13
1,1222,31406,3578744977,3578744991,14
1,1222,31407,3578744977,3578744991,14
1,1222,31408,3578744977,3578744992,15
1,1222,31409,3578744977,3578744993,16
1,1222,31410,3578744977,3578744993,16
1,1222,31411,3578744977,3578744994,17
1,1222,31412,3578744977,3578744996,19
1,1222,31413,3578744977,3578744996,19
1,1222,31414,3578744977,3578744996,19
1,1222,31415,3578744977,3578744997,20
1,1222,31416,3578744977,3578744998,21
1,1222,31417,3578744977,3578744998,21
1,1222,31418,3578744977,3578744998,21
1,1222,31419,3578744977,3578744998,21
1,1222,31420,3578744977,3578744999,22
1,1222,31421,3578744977,3578745000,23
1,1222,31422,3578744977,3578745000,23
1,1222,31423,3578744977,3578745001,24
1,1222,31424,3578744977,3578745001,24
1,1222,31425,3578744977,3578745005,28
1,1222,31426,3578744977,3578745006,29
1,1222,31427,3578744977,3578745011,34
1,1222,31428,3578744977,3578745011,34
1,1222,31429,3578744977,3578745014,37
1,1222,31430,3578744977,3578745016,39
1,1222,31431,3578744977,3578745017,40
1,1222,31432,3578744977,3578745017,40
1,1222,31433,3578744977,3578745018,41
1,1222,31434,3578744977,3578745018,41
1,1222,31435,3578744977,3578745018,41
1,1222,31436,3578744977,3578745019,42
1,1222,31437,3578744977,3578745020,43
1,1222,31438,3578744977,3578745021,44
1,1222,31439,3578744977,3578745023,46
1,1222,31440,3578744977,3578745024,47
1,1222,31441,3578744977,3578745024,47
1,1222,31442,3578744977,3578745026,49
1,1222,31443,3578744977,3578745027,50
1,1223,31444,3578745039,3578745039,0
1,1223,31445,3578745039,3578745039,0
1,1223,31446,3578745039,3578745039,0
1,1223,31447,3578745039,3578745039,0
1,1223,31448,3578745039,3578745039,0
1,1223,31449,3578745039,3578745039,0
1,1223,31450,3578745039,3578745039,0
1,1223,31451,3578745039,3578745039,0
1,1223,31452,3578745039,3578745039,0
1,1223,31453,3578745039,3578745039,0
1,1223,31454,3578745039,3578745039,0
1,1223,31455,3578745039,3578745039,0
1,1223,31456,3578745039,3578745039,0
1,1223,31457,3578745039,3578745039,0
1,1223,31458,3578745039,3578745040,1
1,1223,31459,3578745039,3578745040,1
1,1223,31460,3578745039,3578745040,1
1,1223,31461,3578745039,3578745041,2
1,1223,31462,3578745039,3578745043,4
1,1223,31463,3578745039,3578745044,5
1,1223,31464,3578745039,3578745045,6
1,1223,31465,3578745039,3578745045,6
1,1223,31466,3578745039,3578745047,8
1,1223,31467,3578745039,3578745047,8
1,1223,31468,3578745039,3578745049,10
1,1223,31469,3578745039,3578745049,10
1,1223,31470,3578745039,3578745050,11
1,1223,31471,3578745039,3578745050,11
1,1223,31472,3578745039,3578745052,13
1,1223,31473,3578745039,3578745053,14
1,1223,31474,3578745039,3578745054,15
1,1223,31475,3578745039,3578745056,17
1,1223,31476,3578745039,3578745056,17
1,1223,31477,3578745039,3578745058,19
1,1223,31478,3578745039,3578745058,19
1,1223,31479,3578745039,3578745059,20
1,1223,31480,3578745039,3578745060,21
1,1223,31481,3578745039,3578745061,22
1,1223,31482,3578745039,3578745063,24
1,1223,31483,3578745039,3578745063,24
1,1223,31484,3578745039,3578745064,25
1,1223,31485,3578745039,3578745064,25
1,1223,31486,3578745039,3578745065,26
1,1223,31487,3578745039,3578745066,27
1,1223,31488,3578745039,3578745067,28
1,1223,31489,3578745039,3578745068,29
1,1223,31490,3578745039,3578745069,30
1,1223,31491,3578745039,3578745069,30
1,1223,31492,3578745039,3578745069,30
1,1223,31493,3578745039,3578745074,35
1,1223,31494,3578745039,3578745077,38
1,1223,31495,3578745039,3578745077,38
1,1223,31496,3578745039,3578745080,41
1,1223,31497,3578745039,3578745084,45
1,1223,31498,3578745039,3578745084,45
1,1223,31499,3578745039,3578745085,46
1,1223,31500,3578745039,3578745086,47
1,1223,31501,3578745039,3578745088,49
1,1224,31502,3578745100,3578745100,0
1,1224,31503,3578745100,3578745100,0
1,1224,31504,3578745100,3578745100,0
1,1224,31505,3578745100,3578745100,0
1,1224,31506,3578745100,3578745100,0
1,1224,31507,3578745100,3578745100,0
1,1224,31508,3578745100,3578745100,0
1,1224,31509,3578745100,3578745100,0
1,1224,31510,3578745100,3578745100,0
1,1224,31511,3578745100,3578745100,0
1,1224,31512,3578745100,3578745100,0
1,1224,31513,3578745100,3578745100,0
1,1224,31514,3578745100,3578745101,1
1,1224,31515,3578745100,3578745101,1
1,1224,31516,3578745100,3578745102,2
1,1224,31517,3578745100,3578745102,2
1,1224,31518,3578745100,3578745103,3
1,1224,31519,3578745100,3578745104,4
1,1224,31520,3578745100,3578745105,5
1,1224,31521,3578745100,3578745106,6
1,1224,31522,3578745100,3578745106,6
1,1224,31523,3578745100,3578745107,7
1,1224,31524,3578745100,3578745107,7
1,1224,31525,3578745100,3578745108,8
1,1224,31526,3578745100,3578745109,9
1,1224,31527,3578745100,3578745110,10
1,1224,31528,3578745100,3578745111,11
1,1224,31529,3578745100,3578745111,11
1,1224,31530,3578745100,3578745111,11
1,1224,31531,3578745100,3578745112,12
1,1224,31532,3578745100,3578745113,13
1,1224,31533,3578745100,3578745113,13
1,1224,31534,3578745100,3578745113,13
1,1224,31535,3578745100,3578745114,14
1,1224,31536,3578745100,3578745115,15
1,1224,31537,3578745100,3578745115,15
1,1224,31538,3578745100,3578745115,15
1,1224,31539,3578745100,3578745116,16
1,1224,31540,3578745100,3578745117,17
1,1224,31541,3578745100,3578745118,18
1,1224,31542,3578745100,3578745119,19
1,1224,31543,3578745100,3578745119,19
1,1224,31544,3578745100,3578745121,21
1,1224,31545,3578745100,3578745122,22
1,1224,31546,3578745100,3578745123,23
1,1224,31547,3578745100,3578745124,24
1,1224,31548,3578745100,3578745124,24
1,1224,31549,3578745100,3578745125,25
1,1224,31550,3578745100,3578745125,25
1,1224,31551,3578745100,3578745125,25
1,1224,31552,3578745100,3578745125,25
1,1224,31553,3578745100,3578745128,28
1,1224,31554,3578745100,3578745128,28
1,1224,31555,3578745100,3578745128,28
1,1224,31556,3578745100,3578745128,28
1,1224,31557,3578745100,3578745129,29
1,1224,31558,3578745100,3578745130,30
1,1224,31559,3578745100,3578745131,31
1,1224,31560,3578745100,3578745131,31
1,1224,31561,3578745100,3578745131,31
1,1224,31562,3578745100,3578745132,32
1,1224,31563,3578745100,3578745132,32
1,1224,31564,3578745100,3578745133,33
1,1224,31565,3578745100,3578745133,33
1,1224,31566,3578745100,3578745134,34
1,1224,31567,3578745100,3578745134,34
1,1224,31568,3578745100,3578745134,34
1,1224,31569,3578745100,3578745134,34
1,1224,31570,3578745100,3578745134,34
1,1224,31571,3578745100,3578745136,36
1,1224,31572,3578745100,3578745136,36
1,1224,31573,3578745100,3578745136,36
1,1224,31574,3578745100,3578745137,37
1,1224,31575,3578745100,3578745139,39
1,1224,31576,3578745100,3578745139,39
1,1224,31577,3578745100,3578745140,40
1,1224,31578,3578745100,3578745142,42
1,1224,31579,3578745100,3578745143,43
1,1224,31580,3578745100,3578745144,44
1,1224,31581,3578745100,3578745145,45
1,1224,31582,3578745100,3578745146,46
1,1224,31583,3578745100,3578745148,48
1,1224,31584,3578745100,3578745148,48
1,1224,31585,3578745100,3578745149,49
1,1224,31586,3578745100,3578745149,49
1,1224,31587,3578745100,3578745150,50
1,1225,31588,3578745161,3578745161,0
1,1225,31589,3578745161,3578745161,0
1,1225,31590,3578745161,3578745161,0
1,1225,31591,3578745161,3578745161,0
1,1225,31592,3578745161,3578745161,0
1,1225,31593,3578745161,3578745161,0
1,1225,31594,3578745161,3578745161,0
1,1225,31595,3578745161,3578745161,0
1,1225,31596,3578745161,3578745161,0
1,1225,31597,3578745161,3578745162,1
1,1225,31598,3578745161,3578745162,1
1,1225,31599,3578745161,3578745162,1
1,1225,31600,3578745161,3578745163,2
1,1225,31601,3578745161,3578745164,3
1,1225,31602,3578745161,3578745165,4
1,1225,31603,3578745161,3578745166,5
1,1225,31604,3578745161,3578745167,6
1,1225,31605,3578745161,3578745167,6
1,1225,31606,3578745161,3578745169,8
1,1225,31607,3578745161,3578745170,9
1,1225,31608,3578745161,3578745171,10
1,1225,31609,3578745161,3578745171,10
1,1225,31610,3578745161,3578745171,10
1,1225,31611,3578745161,3578745172,11
1,1225,31612,3578745161,3578745176,15
1,1225,31613,3578745161,3578745178,17
1,1225,31614,3578745161,3578745179,18
1,1225,31615,3578745161,3578745179,18
1,1225,31616,3578745161,3578745180,19
1,1225,31617,3578745161,3578745180,19
1,1225,31618,3578745161,3578745180,19
1,1225,31619,3578745161,3578745181,20
1,1225,31620,3578745161,3578745181,20
1,1225,31621,3578745161,3578745183,22
1,1225,31622,3578745161,3578745183,22
1,1225,31623,3578745161,3578745183,22
1,1225,31624,3578745161,3578745185,24
1,1225,31625,3578745161,3578745186,25
1,1225,31626,3578745161,3578745187,26
1,1225,31627,3578745161,3578745189,28
1,1225,31628,3578745161,3578745191,30
1,1225,31629,3578745161,3578745191,30
1,1225,31630,3578745161,3578745191,30
1,1225,31631,3578745161,3578745192,31
1,1225,31632,3578745161,3578745193,32
1,1225,31633,3578745161,3578745193,32
1,1225,31634,3578745161,3578745195,34
1,1225,31635,3578745161,3578745196,35
1,1225,31636,3578745161,3578745196,35
1,1225,31637,3578745161,3578745196,35
1,1225,31638,3578745161,3578745197,36
1,1225,31639,3578745161,3578745197,36
1,1225,31640,3578745161,3578745198,37
1,1225,31641,3578745161,3578745198,37
1,1225,31642,3578745161,3578745198,37
1,1225,31643,3578745161,3578745199,38
1,1225,31644,3578745161,3578745199,38
1,1225,31645,3578745161,3578745200,39
1,1225,31646,3578745161,3578745201,40
1,1225,31647,3578745161,3578745202,41
1,1225,31648,3578745161,3578745202,41
1,1225,31649,3578745161,3578745205,44
1,1225,31650,3578745161,3578745206,45
1,1226,31651,3578745222,3578745222,0
1,1226,31652,3578745222,3578745222,0
1,1226,31653,3578745222,3578745222,0
1,1226,31654,3578745222,3578745222,0
1,1226,31655,3578745222,3578745222,0
1,1226,31656,3578745222,3578745222,0
1,1226,31657,3578745222,3578745222,0
1,1226,31658,3578745222,3578745222,0
1,1226,31659,3578745222,3578745222,0
1,1226,31660,3578745222,3578745222,0
1,1226,31661,3578745222,3578745222,0
1,1226,31662,3578745222,3578745222,0
1,1226,31663,3578745222,3578745222,0
1,1226,31664,3578745222,3578745222,0
1,1226,31665,3578745222,3578745224,2
1,1226,31666,3578745222,3578745224,2
1,1226,31667,3578745222,3578745224,2
1,1226,31668,3578745222,3578745226,4
1,1226,31669,3578745222,3578745226,4
1,1226,31670,3578745222,3578745228,6
1,1226,31671,3578745222,3578745228,6
1,1226,31672,3578745222,3578745229,7
1,1226,31673,3578745222,3578745229,7
1,1226,31674,3578745222,3578745229,7
1,1226,31675,3578745222,3578745229,7
1,1226,31676,3578745222,3578745230,8
1,1226,31677,3578745222,3578745230,8
1,1226,31678,3578745222,3578745231,9
1,1226,31679,3578745222,3578745232,10
1,1226,31680,3578745222,3578745236,14
1,1226,31681,3578745222,3578745237,15
1,1226,31682,3578745222,3578745239,17
1,1226,31683,3578745222,3578745239,17
1,1226,31684,3578745222,3578745239,17
1,1226,31685,3578745222,3578745240,18
1,1226,31686,3578745222,3578745240,18
1,1226,31687,3578745222,3578745241,19
1,1226,31688,3578745222,3578745244,22
1,1226,31689,3578745222,3578745244,22
1,1226,31690,3578745222,3578745245,23
1,1226,31691,3578745222,3578745246,24
1,1226,31692,3578745222,3578745247,25
1,1226,31693,3578745222,3578745248,26
1,1226,31694,3578745222,3578745248,26
1,1226,31695,3578745222,3578745248,26
1,1226,31696,3578745222,3578745250,28
1,1226,31697,3578745222,3578745250,28
1,1226,31698,3578745222,3578745251,29
1,1226,31699,3578745222,3578745254,32
1,1226,31700,3578745222,3578745254,32
1,1226,31701,3578745222,3578745256,34
1,1226,31702,3578745222,3578745256,34
1,1226,31703,3578745222,3578745257,35
1,1226,31704,3578745222,3578745258,36
1,1226,31705,3578745222,3578745259,37
1,1226,31706,3578745222,3578745259,37
1,1226,31707,3578745222,3578745261,39
1,1226,31708,3578745222,3578745262,40
1,1226,31709,3578745222,3578745263,41
1,1226,31710,3578745222,3578745264,42
1,1226,31711,3578745222,3578745265,43
1,1226,31712,3578745222,3578745265,43
1,1226,31713,3578745222,3578745267,45
1,1226,31714,3578745222,3578745267,45
1,1226,31715,3578745222,3578745268,46
1,1226,31716,3578745222,3578745269,47
1,1226,31717,3578745222,3578745269,47
1,1226,31718,3578745222,3578745270,48
1,1227,31719,3578745285,3578745285,0
1,1227,31720,3578745285,3578745285,0
1,1227,31721,3578745285,3578745285,0
1,1227,31722,3578745285,3578745285,0
1,1227,31723,3578745285,3578745285,0
1,1227,31724,3578745285,3578745285,0
1,1227,31725,3578745285,3578745285,0
1,1227,31726,3578745285,3578745286,1
1,1227,31727,3578745285,3578745288,3
1,1227,31728,3578745285,3578745289,4
1,1227,31729,3578745285,3578745289,4
1,1227,31730,3578745285,3578745289,4
1,1227,31731,3578745285,3578745289,4
1,1227,31732,3578745285,3578745292,7
1,1227,31733,3578745285,3578745294,9
1,1227,31734,3578745285,3578745294,9
1,1227,31735,3578745285,3578745298,13
1,1227,31736,3578745285,3578745298,13
1,1227,31737,3578745285,3578745300,15
1,1227,31738,3578745285,3578745301,16
1,1227,31739,3578745285,3578745301,16
1,1227,31740,3578745285,3578745301,16
1,1227,31741,3578745285,3578745302,17
1,1227,31742,3578745285,3578745304,19
1,1227,31743,3578745285,3578745305,20
1,1227,31744,3578745285,3578745305,20
1,1227,31745,3578745285,3578745306,21
1,1227,31746,3578745285,3578745307,22
1,1227,31747,3578745285,3578745308,23
1,1227,31748,3578745285,3578745310,25
1,1227,31749,3578745285,3578745310,25
1,1227,31750,3578745285,3578745311,26
1,1227,31751,3578745285,3578745311,26
1,1227,31752,3578745285,3578745312,27
1,1227,31753,3578745285,3578745312,27
1,1227,31754,3578745285,3578745312,27
1,1227,31755,3578745285,3578745313,28
1,1227,31756,3578745285,3578745314,29
1,1227,31757,3578745285,3578745314,29
1,1227,31758,3578745285,3578745315,30
1,1227,31759,3578745285,3578745315,30
1,1227,31760,3578745285,3578745316,31
1,1227,31761,3578745285,3578745316,31
1,1227,31762,3578745285,3578745317,32
1,1227,31763,3578745285,3578745319,34
1,1227,31764,3578745285,3578745320,35
1,1227,31765,3578745285,3578745321,36
1,1227,31766,3578745285,3578745321,36
1,1227,31767,3578745285,3578745322,37
1,1227,31768,3578745285,3578745324,39
1,1227,31769,3578745285,3578745324,39
1,1227,31770,3578745285,3578745325,40
1,1227,31771,3578745285,3578745325,40
1,1227,31772,3578745285,3578745325,40
1,1227,31773,3578745285,3578745328,43
1,1227,31774,3578745285,3578745328,43
1,1227,31775,3578745285,3578745328,43
1,1227,31776,3578745285,3578745329,44
1,1227,31777,3578745285,3578745330,45
1,1227,31778,3578745285,3578745330,45
1,1227,31779,3578745285,3578745331,46
1,1227,31780,3578745285,3578745331,46
1,1227,31781,3578745285,3578745332,47
1,1227,31782,3578745285,3578745332,47
1,1227,31783,3578745285,3578745332,47
1,1227,31784,3578745285,3578745333,48
1,1227,31785,3578745285,3578745334,49
1,1227,31786,3578745285,3578745334,49
1,1227,31787,3578745285,3578745334,49
1,1227,31788,3578745285,3578745335,50
1,1228,31789,3578745346,3578745346,0
1,1228,31790,3578745346,3578745346,0
1,1228,31791,3578745346,3578745346,0
1,1228,31792,3578745346,3578745346,0
1,1228,31793,3578745346,3578745346,0
1,1228,31794,3578745346,3578745346,0
1,1228,31795,3578745346,3578745346,0
1,1228,31796,3578745346,3578745346,0
1,1228,31797,3578745346,3578745346,0
1,1228,31798,3578745346,3578745346,0
1,1228,31799,3578745346,3578745346,0
1,1228,31800,3578745346,3578745346,0
1,1228,31801,3578745346,3578745346,0
1,1228,31802,3578745346,3578745346,0
1,1228,31803,3578745346,3578745348,2
1,1228,31804,3578745346,3578745348,2
1,1228,31805,3578745346,3578745349,3
1,1228,31806,3578745346,3578745350,4
1,1228,31807,3578745346,3578745352,6
1,1228,31808,3578745346,3578745353,7
1,1228,31809,3578745346,3578745355,9
1,1228,31810,3578745346,3578745355,9
1,1228,31811,3578745346,3578745356,10
1,1228,31812,3578745346,3578745356,10
1,1228,31813,3578745346,3578745357,11
1,1228,31814,3578745346,3578745358,12
1,1228,31815,3578745346,3578745360,14
1,1228,31816,3578745346,3578745362,16
1,1228,31817,3578745346,3578745362,16
1,1228,31818,3578745346,3578745362,16
1,1228,31819,3578745346,3578745363,17
1,1228,31820,3578745346,3578745363,17
1,1228,31821,3578745346,3578745363,17
1,1228,31822,3578745346,3578745366,20
1,1228,31823,3578745346,3578745366,20
1,1228,31824,3578745346,3578745366,20
1,1228,31825,3578745346,3578745367,21
1,1228,31826,3578745346,3578745368,22
1,1228,31827,3578745346,3578745370,24
1,1228,31828,3578745346,3578745371,25
1,1228,31829,3578745346,3578745371,25
1,1228,31830,3578745346,3578745371,25
1,1228,31831,3578745346,3578745373,27
1,1228,31832,3578745346,3578745376,30
1,1228,31833,3578745346,3578745379,33
1,1228,31834,3578745346,3578745379,33
1,1228,31835,3578745346,3578745379,33
1,1228,31836,3578745346,3578745380,34
1,1228,31837,3578745346,3578745381,35
1,1228,31838,3578745346,3578745381,35
1,1228,31839,3578745346,3578745381,35
1,1228,31840,3578745346,3578745382,36
1,1228,31841,3578745346,3578745382,36
1,1228,31842,3578745346,3578745383,37
1,1228,31843,3578745346,3578745383,37
1,1228,31844,3578745346,3578745383,37
1,1228,31845,3578745346,3578745385,39
1,1228,31846,3578745346,3578745386,40
1,1228,31847,3578745346,3578745388,42
1,1228,31848,3578745346,3578745389,43
1,1228,31849,3578745346,3578745391,45
1,1228,31850,3578745346,3578745391,45
1,1228,31851,3578745346,3578745392,46
1,1228,31852,3578745346,3578745392,46
1,1228,31853,3578745346,3578745393,47
1,1228,31854,3578745346,3578745394,48
1,1228,31855,3578745346,3578745395,49
1,1228,31856,3578745346,3578745396,50
1,1229,31857,3578745407,3578745407,0
1,1229,31858,3578745407,3578745407,0
1,1229,31859,3578745407,3578745407,0
1,1229,31860,3578745407,3578745407,0
1,1229,31861,3578745407,3578745407,0
1,1229,31862,3578745407,3578745407,0
1,1229,31863,3578745407,3578745407,0
1,1229,31864,3578745407,3578745407,0
1,1229,31865,3578745407,3578745407,0
1,1229,31866,3578745407,3578745407,0
1,1229,31867,3578745407,3578745407,0
1,1229,31868,3578745407,3578745407,0
1,1229,31869,3578745407,3578745407,0
1,1229,31870,3578745407,3578745411,4
1,1229,31871,3578745407,3578745412,5
1,1229,31872,3578745407,3578745412,5
1,1229,31873,3578745407,3578745414,7
1,1229,31874,3578745407,3578745415,8
1,1229,31875,3578745407,3578745417,10
1,1229,31876,3578745407,3578745417,10
1,1229,31877,3578745407,3578745417,10
1,1229,31878,3578745407,3578745418,11
1,1229,31879,3578745407,3578745419,12
1,1229,31880,3578745407,3578745419,12
1,1229,31881,3578745407,3578745419,12
1,1229,31882,3578745407,3578745421,14
1,1229,31883,3578745407,3578745421,14
1,1229,31884,3578745407,3578745424,17
1,1229,31885,3578745407,3578745424,17
1,1229,31886,3578745407,3578745425,18
1,1229,31887,3578745407,3578745426,19
1,1229,31888,3578745407,3578745427,20
1,1229,31889,3578745407,3578745428,21
1,1229,31890,3578745407,3578745429,22
1,1229,31891,3578745407,3578745429,22
1,1229,31892,3578745407,3578745429,22
1,1229,31893,3578745407,3578745430,23
1,1229,31894,3578745407,3578745430,23
1,1229,31895,3578745407,3578745430,23
1,1229,31896,3578745407,3578745431,24
1,1229,31897,3578745407,3578745432,25
1,1229,31898,3578745407,3578745432,25
1,1229,31899,3578745407,3578745435,28
1,1229,31900,3578745407,3578745437,30
1,1229,31901,3578745407,3578745439,32
1,1229,31902,3578745407,3578745439,32
1,1229,31903,3578745407,3578745440,33
1,1229,31904,3578745407,3578745440,33
1,1229,31905,3578745407,3578745441,34
1,1229,31906,3578745407,3578745443,36
1,1229,31907,3578745407,3578745444,37
1,1229,31908,3578745407,3578745445,38
1,1229,31909,3578745407,3578745446,39
1,1229,31910,3578745407,3578745447,40
1,1229,31911,3578745407,3578745447,40
1,1229,31912,3578745407,3578745448,41
1,1229,31913,3578745407,3578745449,42
1,1229,31914,3578745407,3578745450,43
1,1229,31915,3578745407,3578745450,43
1,1229,31916,3578745407,3578745452,45
1,1229,31917,3578745407,3578745454,47
1,1229,31918,3578745407,3578745455,48
1,1229,31919,3578745407,3578745456,49
1,1230,31920,3578745470,3578745470,0
1,1230,31921,3578745470,3578745470,0
1,1230,31922,3578745470,3578745470,0
1,1230,31923,3578745470,3578745470,0
1,1230,31924,3578745470,3578745470,0
1,1230,31925,3578745470,3578745470,0
1,1230,31926,3578745470,3578745470,0
1,1230,31927,3578745470,3578745470,0
1,1230,31928,3578745470,3578745470,0
1,1230,31929,3578745470,3578745470,0
1,1230,31930,3578745470,3578745470,0
1,1230,31931,3578745470,3578745470,0
1,1230,31932,3578745470,3578745470,0
1,1230,31933,3578745470,3578745470,0
1,1230,31934,3578745470,3578745470,0
1,1230,31935,3578745470,3578745474,4
1,1230,31936,3578745470,3578745476,6
1,1230,31937,3578745470,3578745477,7
1,1230,31938,3578745470,3578745480,10
1,1230,31939,3578745470,3578745480,10
1,1230,31940,3578745470,3578745484,14
1,1230,31941,3578745470,3578745484,14
1,1230,31942,3578745470,3578745485,15
1,1230,31943,3578745470,3578745486,16
1,1230,31944,3578745470,3578745489,19
1,1230,31945,3578745470,3578745489,19
1,1230,31946,3578745470,3578745490,20
1,1230,31947,3578745470,3578745490,20
1,1230,31948,3578745470,3578745490,20
1,1230,31949,3578745470,3578745492,22
1,1230,31950,3578745470,3578745492,22
1,1230,31951,3578745470,3578745492,22
1,1230,31952,3578745470,3578745494,24
1,1230,31953,3578745470,3578745498,28
1,1230,31954,3578745470,3578745498,28
1,1230,31955,3578745470,3578745500,30
1,1230,31956,3578745470,3578745501,31
1,1230,31957,3578745470,3578745501,31
1,1230,31958,3578745470,3578745502,32
1,1230,31959,3578745470,3578745502,32
1,1230,31960,3578745470,3578745503,33
1,1230,31961,3578745470,3578745505,35
1,1230,31962,3578745470,3578745505,35
1,1230,31963,3578745470,3578745506,36
1,1230,31964,3578745470,3578745506,36
1,1230,31965,3578745470,3578745507,37
1,1230,31966,3578745470,3578745510,40
1,1230,31967,3578745470,3578745511,41
1,1230,31968,3578745470,3578745511,41
1,1230,31969,3578745470,3578745511,41
1,1230,31970,3578745470,3578745512,42
1,1230,31971,3578745470,3578745512,42
1,1230,31972,3578745470,3578745513,43
1,1230,31973,3578745470,3578745514,44
1,1230,31974,3578745470,3578745514,44
1,1230,31975,3578745470,3578745515,45
1,1230,31976,3578745470,3578745515,45
1,1230,31977,3578745470,3578745516,46
1,1230,31978,3578745470,3578745516,46
1,1230,31979,3578745470,3578745517,47
1,1230,31980,3578745470,3578745518,48
1,1230,31981,3578745470,3578745519,49
1,1231,31982,3578745534,3578745534,0
1,1231,31983,3578745534,3578745534,0
1,1231,31984,3578745534,3578745534,0
1,1231,31985,3578745534,3578745534,0
1,1231,31986,3578745534,3578745534,0
1,1231,31987,3578745534,3578745534,0
1,1231,31988,3578745534,3578745534,0
1,1231,31989,3578745534,3578745534,0
1,1231,31990,3578745534,3578745534,0
1,1231,31991,3578745534,3578745534,0
1,1231,31992,3578745534,3578745534,0
1,1231,31993,3578745534,3578745534,0
1,1231,31994,3578745534,3578745534,0
1,1231,31995,3578745534,3578745534,0
1,1231,31996,3578745534,3578745534,0
1,1231,31997,3578745534,3578745534,0
1,1231,31998,3578745534,3578745534,0
1,1231,31999,3578745534,3578745534,0
1,1231,32000,3578745534,3578745534,0
1,1231,32001,3578745534,3578745534,0
1,1231,32002,3578745534,3578745534,0
1,1231,32003,3578745534,3578745534,0
1,1231,32004,3578745534,3578745534,0
1,1231,32005,3578745534,3578745535,1
1,1231,32006,3578745534,3578745535,1
1,1231,32007,3578745534,3578745535,1
1,1231,32008,3578745534,3578745536,2
1,1231,32009,3578745534,3578745536,2
1,1231,32010,3578745534,3578745537,3
1,1231,32011,3578745534,3578745537,3
1,1231,32012,3578745534,3578745540,6
1,1231,32013,3578745534,3578745541,7
1,1231,32014,3578745534,3578745543,9
1,1231,32015,3578745534,3578745544,10
1,1231,32016,3578745534,3578745544,10
1,1231,32017,3578745534,3578745545,11
1,1231,32018,3578745534,3578745546,12
1,1231,32019,3578745534,3578745547,13
1,1231,32020,3578745534,3578745548,14
1,1231,32021,3578745534,3578745549,15
1,1231,32022,3578745534,3578745549,15
1,1231,32023,3578745534,3578745551,17
1,1231,32024,3578745534,3578745551,17
1,1231,32025,3578745534,3578745554,20
1,1231,32026,3578745534,3578745554,20
1,1231,32027,3578745534,3578745555,21
1,1231,32028,3578745534,3578745556,22
1,1231,32029,3578745534,3578745556,22
1,1231,32030,3578745534,3578745558,24
1,1231,32031,3578745534,3578745559,25
1,1231,32032,3578745534,3578745561,27
1,1231,32033,3578745534,3578745561,27
1,1231,32034,3578745534,3578745561,27
1,1231,32035,3578745534,3578745562,28
1,1231,32036,3578745534,3578745562,28
1,1231,32037,3578745534,3578745562,28
1,1231,32038,3578745534,3578745565,31
1,1231,32039,3578745534,3578745565,31
1,1231,32040,3578745534,3578745566,32
1,1231,32041,3578745534,3578745566,32
1,1231,32042,3578745534,3578745568,34
1,1231,32043,3578745534,3578745568,34
1,1231,32044,3578745534,3578745569,35
1,1231,32045,3578745534,3578745570,36
1,1231,32046,3578745534,3578745572,38
1,1231,32047,3578745534,3578745572,38
1,1231,32048,3578745534,3578745574,40
1,1231,32049,3578745534,3578745577,43
1,1231,32050,3578745534,3578745577,43
1,1231,32051,3578745534,3578745578,44
1,1231,32052,3578745534,3578745578,44
1,1231,32053,3578745534,3578745579,45
1,1231,32054,3578745534,3578745580,46
1,1231,32055,3578745534,3578745580,46
1,1231,32056,3578745534,3578745580,46
1,1231,32057,3578745534,3578745581,47
1,1231,32058,3578745534,3578745581,47
1,1231,32059,3578745534,3578745582,48
1,1231,32060,3578745534,3578745582,48
1,1231,32061,3578745534,3578745583,49
1,1232,32062,3578745597,3578745597,0
1,1232,32063,3578745597,3578745597,0
1,1232,32064,3578745597,3578745597,0
1,1232,32065,3578745597,3578745597,0
1,1232,32066,3578745597,3578745597,0
1,1232,32067,3578745597,3578745597,0
1,1232,32068,3578745597,3578745597,0
1,1232,32069,3578745597,3578745597,0
1,1232,32070,3578745597,3578745597,0
1,1232,32071,3578745597,3578745597,0
1,1232,32072,3578745597,3578745597,0
1,1232,32073,3578745597,3578745597,0
1,1232,32074,3578745597,3578745597,0
1,1232,32075,3578745597,3578745597,0
1,1232,32076,3578745597,3578745597,0
1,1232,32077,3578745597,3578745597,0
1,1232,32078,3578745597,3578745597,0
1,1232,32079,3578745597,3578745598,1
1,1232,32080,3578745597,3578745598,1
1,1232,32081,3578745597,3578745598,1
1,1232,32082,3578745597,3578745599,2
1,1232,32083,3578745597,3578745599,2
1,1232,32084,3578745597,3578745599,2
1,1232,32085,3578745597,3578745601,4
1,1232,32086,3578745597,3578745605,8
1,1232,32087,3578745597,3578745605,8
1,1232,32088,3578745597,3578745610,13
1,1232,32089,3578745597,3578745611,14
1,1232,32090,3578745597,3578745612,15
1,1232,32091,3578745597,3578745612,15
1,1232,32092,3578745597,3578745614,17
1,1232,32093,3578745597,3578745616,19
1,1232,32094,3578745597,3578745616,19
1,1232,32095,3578745597,3578745616,19
1,1232,32096,3578745597,3578745618,21
1,1232,32097,3578745597,3578745618,21
1,1232,32098,3578745597,3578745618,21
1,1232,32099,3578745597,3578745619,22
1,1232,32100,3578745597,3578745620,23
1,1232,32101,3578745597,3578745620,23
1,1232,32102,3578745597,3578745624,27
1,1232,32103,3578745597,3578745624,27
1,1232,32104,3578745597,3578745624,27
1,1232,32105,3578745597,3578745625,28
1,1232,32106,3578745597,3578745628,31
1,1232,32107,3578745597,3578745628,31
1,1232,32108,3578745597,3578745628,31
1,1232,32109,3578745597,3578745628,31
1,1232,32110,3578745597,3578745629,32
1,1232,32111,3578745597,3578745629,32
1,1232,32112,3578745597,3578745629,32
1,1232,32113,3578745597,3578745630,33
1,1232,32114,3578745597,3578745630,33
1,1232,32115,3578745597,3578745631,34
1,1232,32116,3578745597,3578745635,38
1,1232,32117,3578745597,3578745636,39
1,1232,32118,3578745597,3578745638,41
1,1232,32119,3578745597,3578745639,42
1,1232,32120,3578745597,3578745639,42
1,1232,32121,3578745597,3578745639,42
1,1232,32122,3578745597,3578745640,43
1,1232,32123,3578745597,3578745643,46
1,1232,32124,3578745597,3578745643,46
1,1232,32125,3578745597,3578745644,47
1,1232,32126,3578745597,3578745645,48
1,1232,32127,3578745597,3578745645,48
1,1232,32128,3578745597,3578745646,49
1,1233,32129,3578745658,3578745658,0
1,1233,32130,3578745658,3578745658,0
1,1233,32131,3578745658,3578745658,0
1,1233,32132,3578745658,3578745658,0
1,1233,32133,3578745658,3578745658,0
1,1233,32134,3578745658,3578745658,0
1,1233,32135,3578745658,3578745658,0
1,1233,32136,3578745658,3578745659,1
1,1233,32137,3578745658,3578745659,1
1,1233,32138,3578745658,3578745659,1
1,1233,32139,3578745658,3578745659,1
1,1233,32140,3578745658,3578745659,1
1,1233,32141,3578745658,3578745662,4
1,1233,32142,3578745658,3578745662,4
1,1233,32143,3578745658,3578745663,5
1,1233,32144,3578745658,3578745664,6
1,1233,32145,3578745658,3578745664,6
1,1233,32146,3578745658,3578745666,8
1,1233,32147,3578745658,3578745667,9
1,1233,32148,3578745658,3578745667,9
1,1233,32149,3578745658,3578745667,9
1,1233,32150,3578745658,3578745668,10
1,1233,32151,3578745658,3578745669,11
1,1233,32152,3578745658,3578745674,16
1,1233,32153,3578745658,3578745676,18
1,1233,32154,3578745658,3578745677,19
1,1233,32155,3578745658,3578745680,22
1,1233,32156,3578745658,3578745681,23
1,1233,32157,3578745658,3578745684,26
1,1233,32158,3578745658,3578745684,26
1,1233,32159,3578745658,3578745685,27
1,1233,32160,3578745658,3578745686,28
1,1233,32161,3578745658,3578745688,30
1,1233,32162,3578745658,3578745689,31
1,1233,32163,3578745658,3578745690,32
1,1233,32164,3578745658,3578745690,32
1,1233,32165,3578745658,3578745690,32
1,1233,32166,3578745658,3578745692,34
1,1233,32167,3578745658,3578745692,34
1,1233,32168,3578745658,3578745692,34
1,1233,32169,3578745658,3578745693,35
1,1233,32170,3578745658,3578745694,36
1,1233,32171,3578745658,3578745694,36
1,1233,32172,3578745658,3578745698,40
1,1233,32173,3578745658,3578745698,40
1,1233,32174,3578745658,3578745698,40
1,1233,32175,3578745658,3578745699,41
1,1233,32176,3578745658,3578745701,43
1,1233,32177,3578745658,3578745701,43
1,1233,32178,3578745658,3578745702,44
1,1233,32179,3578745658,3578745702,44
1,1233,32180,3578745658,3578745704,46
1,1233,32181,3578745658,3578745705,47
1,1233,32182,3578745658,3578745705,47
1,1233,32183,3578745658,3578745706,48
1,1233,32184,3578745658,3578745706,48
1,1233,32185,3578745658,3578745707,49
1,1234,32186,3578745720,3578745720,0
1,1234,32187,3578745720,3578745720,0
1,1234,32188,3578745720,3578745720,0
1,1234,32189,3578745720,3578745720,0
1,1234,32190,3578745720,3578745720,0
1,1234,32191,3578745720,3578745720,0
1,1234,32192,3578745720,3578745720,0
1,1234,32193,3578745720,3578745720,0
1,1234,32194,3578745720,3578745720,0
1,1234,32195,3578745720,3578745720,0
1,1234,32196,3578745720,3578745720,0
1,1234,32197,3578745720,3578745720,0
1,1234,32198,3578745720,3578745720,0
1,1234,32199,3578745720,3578745720,0
1,1234,32200,3578745720,3578745720,0
1,1234,32201,3578745720,3578745720,0
1,1234,32202,3578745720,3578745721,1
1,1234,32203,3578745720,3578745721,1
1,1234,32204,3578745720,3578745722,2
1,1234,32205,3578745720,3578745724,4
1,1234,32206,3578745720,3578745725,5
1,1234,32207,3578745720,3578745725,5
1,1234,32208,3578745720,3578745725,5
1,1234,32209,3578745720,3578745726,6
1,1234,32210,3578745720,3578745726,6
1,1234,32211,3578745720,3578745727,7
1,1234,32212,3578745720,3578745728,8
1,1234,32213,3578745720,3578745728,8
1,1234,32214,3578745720,3578745730,10
1,1234,32215,3578745720,3578745730,10
1,1234,32216,3578745720,3578745730,10
1,1234,32217,3578745720,3578745730,10
1,1234,32218,3578745720,3578745731,11
1,1234,32219,3578745720,3578745731,11
1,1234,32220,3578745720,3578745731,11
1,1234,32221,3578745720,3578745731,11
1,1234,32222,3578745720,3578745732,12
1,1234,32223,3578745720,3578745733,13
1,1234,32224,3578745720,3578745733,13
1,1234,32225,3578745720,3578745733,13
1,1234,32226,3578745720,3578745734,14
1,1234,32227,3578745720,3578745734,14
1,1234,32228,3578745720,3578745735,15
1,1234,32229,3578745720,3578745735,15
1,1234,32230,3578745720,3578745735,15
1,1234,32231,3578745720,3578745736,16
1,1234,32232,3578745720,3578745737,17
1,1234,32233,3578745720,3578745739,19
1,1234,32234,3578745720,3578745742,22
1,1234,32235,3578745720,3578745743,23
1,1234,32236,3578745720,3578745743,23
1,1234,32237,3578745720,3578745744,24
1,1234,32238,3578745720,3578745746,26
1,1234,32239,3578745720,3578745747,27
1,1234,32240,3578745720,3578745748,28
1,1234,32241,3578745720,3578745749,29
1,1234,32242,3578745720,3578745750,30
1,1234,32243,3578745720,3578745752,32
1,1234,32244,3578745720,3578745753,33
1,1234,32245,3578745720,3578745754,34
1,1234,32246,3578745720,3578745754,34
1,1234,32247,3578745720,3578745755,35
1,1234,32248,3578745720,3578745756,36
1,1234,32249,3578745720,3578745758,38
1,1234,32250,3578745720,3578745759,39
1,1234,32251,3578745720,3578745761,41
1,1234,32252,3578745720,3578745762,42
1,1234,32253,3578745720,3578745762,42
1,1234,32254,3578745720,3578745763,43
1,1234,32255,3578745720,3578745764,44
1,1234,32256,3578745720,3578745765,45
1,1234,32257,3578745720,3578745766,46
1,1234,32258,3578745720,3578745767,47
1,1234,32259,3578745720,3578745768,48
1,1234,32260,3578745720,3578745770,50
1,1235,32261,3578745782,3578745782,0
1,1235,32262,3578745782,3578745782,0
1,1235,32263,3578745782,3578745782,0
1,1235,32264,3578745782,3578745782,0
1,1235,32265,3578745782,3578745782,0
1,1235,32266,3578745782,3578745782,0
1,1235,32267,3578745782,3578745782,0
1,1235,32268,3578745782,3578745782,0
1,1235,32269,3578745782,3578745782,0
1,1235,32270,3578745782,3578745782,0
1,1235,32271,3578745782,3578745782,0
1,1235,32272,3578745782,3578745782,0
1,1235,32273,3578745782,3578745782,0
1,1235,32274,3578745782,3578745782,0
1,1235,32275,3578745782,3578745782,0
1,1235,32276,3578745782,3578745782,0
1,1235,32277,3578745782,3578745784,2
1,1235,32278,3578745782,3578745785,3
1,1235,32279,3578745782,3578745786,4
1,1235,32280,3578745782,3578745787,5
1,1235,32281,3578745782,3578745791,9
1,1235,32282,3578745782,3578745791,9
1,1235,32283,3578745782,3578745792,10
1,1235,32284,3578745782,3578745792,10
1,1235,32285,3578745782,3578745792,10
1,1235,32286,3578745782,3578745793,11
1,1235,32287,3578745782,3578745795,13
1,1235,32288,3578745782,3578745796,14
1,1235,32289,3578745782,3578745796,14
1,1235,32290,3578745782,3578745796,14
1,1235,32291,3578745782,3578745797,15
1,1235,32292,3578745782,3578745797,15
1,1235,32293,3578745782,3578745797,15
1,1235,32294,3578745782,3578745798,16
1,1235,32295,3578745782,3578745798,16
1,1235,32296,3578745782,3578745798,16
1,1235,32297,3578745782,3578745798,16
1,1235,32298,3578745782,3578745800,18
1,1235,32299,3578745782,3578745800,18
1,1235,32300,3578745782,3578745800,18
1,1235,32301,3578745782,3578745801,19
1,1235,32302,3578745782,3578745803,21
1,1235,32303,3578745782,3578745804,22
1,1235,32304,3578745782,3578745805,23
1,1235,32305,3578745782,3578745811,29
1,1235,32306,3578745782,3578745812,30
1,1235,32307,3578745782,3578745813,31
1,1235,32308,3578745782,3578745814,32
1,1235,32309,3578745782,3578745816,34
1,1235,32310,3578745782,3578745816,34
1,1235,32311,3578745782,3578745818,36
1,1235,32312,3578745782,3578745818,36
1,1235,32313,3578745782,3578745818,36
1,1235,32314,3578745782,3578745819,37
1,1235,32315,3578745782,3578745819,37
1,1235,32316,3578745782,3578745820,38
1,1235,32317,3578745782,3578745824,42
1,1235,32318,3578745782,3578745824,42
1,1235,32319,3578745782,3578745825,43
1,1235,32320,3578745782,3578745825,43
1,1235,32321,3578745782,3578745826,44
1,1235,32322,3578745782,3578745828,46
1,1235,32323,3578745782,3578745828,46
1,1235,32324,3578745782,3578745829,47
1,1235,32325,3578745782,3578745829,47
1,1235,32326,3578745782,3578745829,47
1,1235,32327,3578745782,3578745829,47
1,1235,32328,3578745782,3578745830,48
1,1235,32329,3578745782,3578745831,49
1,1236,32330,3578745843,3578745843,0
1,1236,32331,3578745843,3578745843,0
1,1236,32332,3578745843,3578745843,0
1,1236,32333,3578745843,3578745843,0
1,1236,32334,3578745843,3578745843,0
1,1236,32335,3578745843,3578745843,0
1,1236,32336,3578745843,3578745843,0
1,1236,32337,3578745843,3578745844,1
1,1236,32338,3578745843,3578745844,1
1,1236,32339,3578745843,3578745846,3
1,1236,32340,3578745843,3578745846,3
1,1236,32341,3578745843,3578745847,4
1,1236,32342,3578745843,3578745848,5
1,1236,32343,3578745843,3578745848,5
1,1236,32344,3578745843,3578745849,6
1,1236,32345,3578745843,3578745850,7
1,1236,32346,3578745843,3578745850,7
1,1236,32347,3578745843,3578745853,10
1,1236,32348,3578745843,3578745853,10
1,1236,32349,3578745843,3578745854,11
1,1236,32350,3578745843,3578745855,12
1,1236,32351,3578745843,3578745856,13
1,1236,32352,3578745843,3578745857,14
1,1236,32353,3578745843,3578745858,15
1,1236,32354,3578745843,3578745858,15
1,1236,32355,3578745843,3578745861,18
1,1236,32356,3578745843,3578745862,19
1,1236,32357,3578745843,3578745862,19
1,1236,32358,3578745843,3578745863,20
1,1236,32359,3578745843,3578745864,21
1,1236,32360,3578745843,3578745865,22
1,1236,32361,3578745843,3578745866,23
1,1236,32362,3578745843,3578745867,24
1,1236,32363,3578745843,3578745868,25
1,1236,32364,3578745843,3578745868,25
1,1236,32365,3578745843,3578745869,26
1,1236,32366,3578745843,3578745875,32
1,1236,32367,3578745843,3578745876,33
1,1236,32368,3578745843,3578745878,35
1,1236,32369,3578745843,3578745880,37
1,1236,32370,3578745843,3578745881,38
1,1236,32371,3578745843,3578745884,41
1,1236,32372,3578745843,3578745885,42
1,1236,32373,3578745843,3578745886,43
1,1236,32374,3578745843,3578745886,43
1,1236,32375,3578745843,3578745888,45
1,1236,32376,3578745843,3578745889,46
1,1236,32377,3578745843,3578745890,47
1,1236,32378,3578745843,3578745890,47
1,1236,32379,3578745843,3578745890,47
1,1236,32380,3578745843,3578745892,49
1,1236,32381,3578745843,3578745893,50
1,1237,32382,3578745905,3578745905,0
1,1237,32383,3578745905,3578745905,0
1,1237,32384,3578745905,3578745905,0
1,1237,32385,3578745905,3578745905,0
1,1237,32386,3578745905,3578745905,0
1,1237,32387,3578745905,3578745905,0
1,1237,32388,3578745905,3578745905,0
1,1237,32389,3578745905,3578745905,0
1,1237,32390,3578745905,3578745905,0
1,1237,32391,3578745905,3578745905,0
1,1237,32392,3578745905,3578745905,0
1,1237,32393,3578745905,3578745905,0
1,1237,32394,3578745905,3578745905,0
1,1237,32395,3578745905,3578745906,1
1,1237,32396,3578745905,3578745906,1
1,1237,32397,3578745905,3578745907,2
1,1237,32398,3578745905,3578745907,2
1,1237,32399,3578745905,3578745910,5
1,1237,32400,3578745905,3578745911,6
1,1237,32401,3578745905,3578745911,6
1,1237,32402,3578745905,3578745911,6
1,1237,32403,3578745905,3578745911,6
1,1237,32404,3578745905,3578745912,7
1,1237,32405,3578745905,3578745912,7
1,1237,32406,3578745905,3578745913,8
1,1237,32407,3578745905,3578745913,8
1,1237,32408,3578745905,3578745914,9
1,1237,32409,3578745905,3578745915,10
1,1237,32410,3578745905,3578745915,10
1,1237,32411,3578745905,3578745915,10
1,1237,32412,3578745905,3578745916,11
1,1237,32413,3578745905,3578745917,12
1,1237,32414,3578745905,3578745920,15
1,1237,32415,3578745905,3578745921,16
1,1237,32416,3578745905,3578745921,16
1,1237,32417,3578745905,3578745922,17
1,1237,32418,3578745905,3578745924,19
1,1237,32419,3578745905,3578745925,20
1,1237,32420,3578745905,3578745926,21
1,1237,32421,3578745905,3578745926,21
1,1237,32422,3578745905,3578745926,21
1,1237,32423,3578745905,3578745927,22
1,1237,32424,3578745905,3578745927,22
1,1237,32425,3578745905,3578745927,22
1,1237,32426,3578745905,3578745929,24
1,1237,32427,3578745905,3578745930,25
1,1237,32428,3578745905,3578745930,25
1,1237,32429,3578745905,3578745931,26
1,1237,32430,3578745905,3578745931,26
1,1237,32431,3578745905,3578745931,26
1,1237,32432,3578745905,3578745932,27
1,1237,32433,3578745905,3578745932,27
1,1237,32434,3578745905,3578745932,27
1,1237,32435,3578745905,3578745933,28
1,1237,32436,3578745905,3578745933,28
1,1237,32437,3578745905,3578745934,29
1,1237,32438,3578745905,3578745934,29
1,1237,32439,3578745905,3578745935,30
1,1237,32440,3578745905,3578745935,30
1,1237,32441,3578745905,3578745935,30
1,1237,32442,3578745905,3578745936,31
1,1237,32443,3578745905,3578745936,31
1,1237,32444,3578745905,3578745937,32
1,1237,32445,3578745905,3578745938,33
1,1237,32446,3578745905,3578745939,34
1,1237,32447,3578745905,3578745941,36
1,1237,32448,3578745905,3578745941,36
1,1237,32449,3578745905,3578745943,38
1,1237,32450,3578745905,3578745943,38
1,1237,32451,3578745905,3578745944,39
1,1237,32452,3578745905,3578745947,42
1,1237,32453,3578745905,3578745948,43
1,1237,32454,3578745905,3578745948,43
1,1237,32455,3578745905,3578745949,44
1,1237,32456,3578745905,3578745950,45
1,1237,32457,3578745905,3578745952,47
1,1237,32458,3578745905,3578745952,47
1,1237,32459,3578745905,3578745954,49
1,1237,32460,3578745905,3578745954,49
1,1238,32461,3578745968,3578745968,0
1,1238,32462,3578745968,3578745968,0
1,1238,32463,3578745968,3578745968,0
1,1238,32464,3578745968,3578745968,0
1,1238,32465,3578745968,3578745968,0
1,1238,32466,3578745968,3578745968,0
1,1238,32467,3578745968,3578745968,0
1,1238,32468,3578745968,3578745968,0
1,1238,32469,3578745968,3578745968,0
1,1238,32470,3578745968,3578745968,0
1,1238,32471,3578745968,3578745968,0
1,1238,32472,3578745968,3578745968,0
1,1238,32473,3578745968,3578745969,1
1,1238,32474,3578745968,3578745969,1
1,1238,32475,3578745968,3578745970,2
1,1238,32476,3578745968,3578745972,4
1,1238,32477,3578745968,3578745972,4
1,1238,32478,3578745968,3578745976,8
1,1238,32479,3578745968,3578745977,9
1,1238,32480,3578745968,3578745978,10
1,1238,32481,3578745968,3578745979,11
1,1238,32482,3578745968,3578745979,11
1,1238,32483,3578745968,3578745980,12
1,1238,32484,3578745968,3578745980,12
1,1238,32485,3578745968,3578745982,14
1,1238,32486,3578745968,3578745982,14
1,1238,32487,3578745968,3578745982,14
1,1238,32488,3578745968,3578745982,14
1,1238,32489,3578745968,3578745984,16
1,1238,32490,3578745968,3578745985,17
1,1238,32491,3578745968,3578745985,17
1,1238,32492,3578745968,3578745986,18
1,1238,32493,3578745968,3578745989,21
1,1238,32494,3578745968,3578745991,23
1,1238,32495,3578745968,3578745991,23
1,1238,32496,3578745968,3578745992,24
1,1238,32497,3578745968,3578745992,24
1,1238,32498,3578745968,3578745992,24
1,1238,32499,3578745968,3578745993,25
1,1238,32500,3578745968,3578745994,26
1,1238,32501,3578745968,3578745996,28
1,1238,32502,3578745968,3578745997,29
1,1238,32503,3578745968,3578745997,29
1,1238,32504,3578745968,3578745997,29
1,1238,32505,3578745968,3578745997,29
1,1238,32506,3578745968,3578745998,30
1,1238,32507,3578745968,3578745998,30
1,1238,32508,3578745968,3578745998,30
1,1238,32509,3578745968,3578745998,30
1,1238,32510,3578745968,3578745999,31
1,1238,32511,3578745968,3578746000,32
1,1238,32512,3578745968,3578746000,32
1,1238,32513,3578745968,3578746001,33
1,1238,32514,3578745968,3578746003,35
1,1238,32515,3578745968,3578746004,36
1,1238,32516,3578745968,3578746006,38
1,1238,32517,3578745968,3578746010,42
1,1238,32518,3578745968,3578746012,44
1,1238,32519,3578745968,3578746013,45
1,1238,32520,3578745968,3578746014,46
1,1238,32521,3578745968,3578746014,46
1,1238,32522,3578745968,3578746015,47
1,1238,32523,3578745968,3578746016,48
1,1238,32524,3578745968,3578746016,48
1,1238,32525,3578745968,3578746018,50
1,1239,32526,3578746030,3578746030,0
1,1239,32527,3578746030,3578746030,0
1,1239,32528,3578746030,3578746030,0
1,1239,32529,3578746030,3578746030,0
1,1239,32530,3578746030,3578746030,0
1,1239,32531,3578746030,3578746030,0
1,1239,32532,3578746030,3578746030,0
1,1239,32533,3578746030,3578746030,0
1,1239,32534,3578746030,3578746030,0
1,1239,32535,3578746030,3578746030,0
1,1239,32536,3578746030,3578746030,0
1,1239,32537,3578746030,3578746030,0
1,1239,32538,3578746030,3578746030,0
1,1239,32539,3578746030,3578746030,0
1,1239,32540,3578746030,3578746030,0
1,1239,32541,3578746030,3578746030,0
1,1239,32542,3578746030,3578746031,1
1,1239,32543,3578746030,3578746031,1
1,1239,32544,3578746030,3578746033,3
1,1239,32545,3578746030,3578746035,5
1,1239,32546,3578746030,3578746037,7
1,1239,32547,3578746030,3578746037,7
1,1239,32548,3578746030,3578746038,8
1,1239,32549,3578746030,3578746039,9
1,1239,32550,3578746030,3578746039,9
1,1239,32551,3578746030,3578746040,10
1,1239,32552,3578746030,3578746041,11
1,1239,32553,3578746030,3578746043,13
1,1239,32554,3578746030,3578746044,14
1,1239,32555,3578746030,3578746044,14
1,1239,32556,3578746030,3578746046,16
1,1239,32557,3578746030,3578746047,17
1,1239,32558,3578746030,3578746047,17
1,1239,32559,3578746030,3578746048,18
1,1239,32560,3578746030,3578746049,19
1,1239,32561,3578746030,3578746050,20
1,1239,32562,3578746030,3578746051,21
1,1239,32563,3578746030,3578746051,21
1,1239,32564,3578746030,3578746053,23
1,1239,32565,3578746030,3578746053,23
1,1239,32566,3578746030,3578746054,24
1,1239,32567,3578746030,3578746055,25
1,1239,32568,3578746030,3578746057,27
1,1239,32569,3578746030,3578746057,27
1,1239,32570,3578746030,3578746058,28
1,1239,32571,3578746030,3578746058,28
1,1239,32572,3578746030,3578746059,29
1,1239,32573,3578746030,3578746062,32
1,1239,32574,3578746030,3578746062,32
1,1239,32575,3578746030,3578746063,33
1,1239,32576,3578746030,3578746063,33
1,1239,32577,3578746030,3578746065,35
1,1239,32578,3578746030,3578746066,36
1,1239,32579,3578746030,3578746068,38
1,1239,32580,3578746030,3578746068,38
1,1239,32581,3578746030,3578746069,39
1,1239,32582,3578746030,3578746074,44
1,1239,32583,3578746030,3578746077,47
1,1239,32584,3578746030,3578746077,47
1,1240,32585,3578746092,3578746092,0
1,1240,32586,3578746092,3578746092,0
1,1240,32587,3578746092,3578746092,0
1,1240,32588,3578746092,3578746092,0
1,1240,32589,3578746092,3578746092,0
1,1240,32590,3578746092,3578746092,0
1,1240,32591,3578746092,3578746092,0
1,1240,32592,3578746092,3578746092,0
1,1240,32593,3578746092,3578746092,0
1,1240,32594,3578746092,3578746092,0
1,1240,32595,3578746092,3578746092,0
1,1240,32596,3578746092,3578746092,0
1,1240,32597,3578746092,3578746092,0
1,1240,32598,3578746092,3578746093,1
1,1240,32599,3578746092,3578746094,2
1,1240,32600,3578746092,3578746094,2
1,1240,32601,3578746092,3578746095,3
1,1240,32602,3578746092,3578746099,7
1,1240,32603,3578746092,3578746099,7
1,1240,32604,3578746092,3578746100,8
1,1240,32605,3578746092,3578746100,8
1,1240,32606,3578746092,3578746101,9
1,1240,32607,3578746092,3578746102,10
1,1240,32608,3578746092,3578746102,10
1,1240,32609,3578746092,3578746104,12
1,1240,32610,3578746092,3578746105,13
1,1240,32611,3578746092,3578746106,14
1,1240,32612,3578746092,3578746107,15
1,1240,32613,3578746092,3578746108,16
1,1240,32614,3578746092,3578746110,18
1,1240,32615,3578746092,3578746111,19
1,1240,32616,3578746092,3578746111,19
1,1240,32617,3578746092,3578746111,19
1,1240,32618,3578746092,3578746112,20
1,1240,32619,3578746092,3578746112,20
1,1240,32620,3578746092,3578746112,20
1,1240,32621,3578746092,3578746113,21
1,1240,32622,3578746092,3578746114,22
1,1240,32623,3578746092,3578746114,22
1,1240,32624,3578746092,3578746114,22
1,1240,32625,3578746092,3578746115,23
1,1240,32626,3578746092,3578746116,24
1,1240,32627,3578746092,3578746117,25
1,1240,32628,3578746092,3578746117,25
1,1240,32629,3578746092,3578746120,28
1,1240,32630,3578746092,3578746121,29
1,1240,32631,3578746092,3578746121,29
1,1240,32632,3578746092,3578746121,29
1,1240,32633,3578746092,3578746124,32
1,1240,32634,3578746092,3578746125,33
1,1240,32635,3578746092,3578746126,34
1,1240,32636,3578746092,3578746126,34
1,1240,32637,3578746092,3578746126,34
1,1240,32638,3578746092,3578746127,35
1,1240,32639,3578746092,3578746127,35
1,1240,32640,3578746092,3578746127,35
1,1240,32641,3578746092,3578746130,38
1,1240,32642,3578746092,3578746130,38
1,1240,32643,3578746092,3578746131,39
1,1240,32644,3578746092,3578746131,39
1,1240,32645,3578746092,3578746132,40
1,1240,32646,3578746092,3578746132,40
1,1240,32647,3578746092,3578746132,40
1,1240,32648,3578746092,3578746133,41
1,1240,32649,3578746092,3578746133,41
1,1240,32650,3578746092,3578746134,42
1,1240,32651,3578746092,3578746134,42
1,1240,32652,3578746092,3578746134,42
1,1240,32653,3578746092,3578746135,43
1,1240,32654,3578746092,3578746135,43
1,1240,32655,3578746092,3578746136,44
1,1240,32656,3578746092,3578746136,44
1,1240,32657,3578746092,3578746136,44
1,1240,32658,3578746092,3578746137,45
1,1240,32659,3578746092,3578746138,46
1,1240,32660,3578746092,3578746139,47
1,1240,32661,3578746092,3578746141,49
1,1240,32662,3578746092,3578746141,49
1,1241,32663,3578746154,3578746154,0
1,1241,32664,3578746154,3578746154,0
1,1241,32665,3578746154,3578746154,0
1,1241,32666,3578746154,3578746154,0
1,1241,32667,3578746154,3578746154,0
1,1241,32668,3578746154,3578746154,0
1,1241,32669,3578746154,3578746154,0
1,1241,32670,3578746154,3578746154,0
1,1241,32671,3578746154,3578746154,0
1,1241,32672,3578746154,3578746154,0
1,1241,32673,3578746154,3578746154,0
1,1241,32674,3578746154,3578746155,1
1,1241,32675,3578746154,3578746155,1
1,1241,32676,3578746154,3578746158,4
1,1241,32677,3578746154,3578746159,5
1,1241,32678,3578746154,3578746162,8
1,1241,32679,3578746154,3578746162,8
1,1241,32680,3578746154,3578746162,8
1,1241,32681,3578746154,3578746163,9
1,1241,32682,3578746154,3578746165,11
1,1241,32683,3578746154,3578746166,12
1,1241,32684,3578746154,3578746166,12
1,1241,32685,3578746154,3578746167,13
1,1241,32686,3578746154,3578746168,14
1,1241,32687,3578746154,3578746169,15
1,1241,32688,3578746154,3578746169,15
1,1241,32689,3578746154,3578746171,17
1,1241,32690,3578746154,3578746172,18
1,1241,32691,3578746154,3578746172,18
1,1241,32692,3578746154,3578746172,18
1,1241,32693,3578746154,3578746176,22
1,1241,32694,3578746154,3578746178,24
1,1241,32695,3578746154,3578746178,24
1,1241,32696,3578746154,3578746179,25
1,1241,32697,3578746154,3578746179,25
1,1241,32698,3578746154,3578746180,26
1,1241,32699,3578746154,3578746180,26
1,1241,32700,3578746154,3578746180,26
1,1241,32701,3578746154,3578746182,28
1,1241,32702,3578746154,3578746182,28
1,1241,32703,3578746154,3578746182,28
1,1241,32704,3578746154,3578746182,28
1,1241,32705,3578746154,3578746184,30
1,1241,32706,3578746154,3578746185,31
1,1241,32707,3578746154,3578746186,32
1,1241,32708,3578746154,3578746187,33
1,1241,32709,3578746154,3578746189,35
1,1241,32710,3578746154,3578746190,36
1,1241,32711,3578746154,3578746192,38
1,1241,32712,3578746154,3578746192,38
1,1241,32713,3578746154,3578746192,38
1,1241,32714,3578746154,3578746193,39
1,1241,32715,3578746154,3578746194,40
1,1241,32716,3578746154,3578746196,42
1,1241,32717,3578746154,3578746196,42
1,1241,32718,3578746154,3578746197,43
1,1241,32719,3578746154,3578746197,43
1,1241,32720,3578746154,3578746197,43
1,1241,32721,3578746154,3578746197,43
1,1241,32722,3578746154,3578746198,44
1,1241,32723,3578746154,3578746198,44
1,1241,32724,3578746154,3578746198,44
1,1241,32725,3578746154,3578746199,45
1,1241,32726,3578746154,3578746200,46
1,1241,32727,3578746154,3578746200,46
1,1241,32728,3578746154,3578746201,47
1,1241,32729,3578746154,3578746203,49
1,1241,32730,3578746154,3578746203,49
1,1242,32731,3578746215,3578746215,0
1,1242,32732,3578746215,3578746215,0
1,1242,32733,3578746215,3578746215,0
1,1242,32734,3578746215,3578746215,0
1,1242,32735,3578746215,3578746215,0
1,1242,32736,3578746215,3578746215,0
1,1242,32737,3578746215,3578746216,1
1,1242,32738,3578746215,3578746217,2
1,1242,32739,3578746215,3578746217,2
1,1242,32740,3578746215,3578746217,2
1,1242,32741,3578746215,3578746218,3
1,1242,32742,3578746215,3578746218,3
1,1242,32743,3578746215,3578746220,5
1,1242,32744,3578746215,3578746220,5
1,1242,32745,3578746215,3578746220,5
1,1242,32746,3578746215,3578746224,9
1,1242,32747,3578746215,3578746225,10
1,1242,32748,3578746215,3578746225,10
1,1242,32749,3578746215,3578746226,11
1,1242,32750,3578746215,3578746226,11
1,1242,32751,3578746215,3578746228,13
1,1242,32752,3578746215,3578746229,14
1,1242,32753,3578746215,3578746229,14
1,1242,32754,3578746215,3578746229,14
1,1242,32755,3578746215,3578746230,15
1,1242,32756,3578746215,3578746230,15
1,1242,32757,3578746215,3578746231,16
1,1242,32758,3578746215,3578746232,17
1,1242,32759,3578746215,3578746233,18
1,1242,32760,3578746215,3578746236,21
1,1242,32761,3578746215,3578746237,22
1,1242,32762,3578746215,3578746238,23
1,1242,32763,3578746215,3578746239,24
1,1242,32764,3578746215,3578746239,24
1,1242,32765,3578746215,3578746239,24
1,1242,32766,3578746215,3578746241,26
1,1242,32767,3578746215,3578746241,26
1,1242,32768,3578746215,3578746242,27
1,1242,32769,3578746215,3578746245,30
1,1242,32770,3578746215,3578746246,31
1,1242,32771,3578746215,3578746247,32
1,1242,32772,3578746215,3578746247,32
1,1242,32773,3578746215,3578746248,33
1,1242,32774,3578746215,3578746248,33
1,1242,32775,3578746215,3578746249,34
1,1242,32776,3578746215,3578746251,36
1,1242,32777,3578746215,3578746251,36
1,1242,32778,3578746215,3578746253,38
1,1242,32779,3578746215,3578746254,39
1,1242,32780,3578746215,3578746254,39
1,1242,32781,3578746215,3578746255,40
1,1242,32782,3578746215,3578746256,41
1,1242,32783,3578746215,3578746257,42
1,1242,32784,3578746215,3578746257,42
1,1242,32785,3578746215,3578746258,43
1,1242,32786,3578746215,3578746259,44
1,1242,32787,3578746215,3578746263,48
1,1242,32788,3578746215,3578746263,48
1,1242,32789,3578746215,3578746263,48
1,1242,32790,3578746215,3578746263,48
1,1242,32791,3578746215,3578746265,50
1,1243,32792,3578746276,3578746276,0
1,1243,32793,3578746276,3578746276,0
1,1243,32794,3578746276,3578746276,0
1,1243,32795,3578746276,3578746276,0
1,1243,32796,3578746276,3578746276,0
1,1243,32797,3578746276,3578746277,1
1,1243,32798,3578746276,3578746281,5
1,1243,32799,3578746276,3578746281,5
1,1243,32800,3578746276,3578746284,8
1,1243,32801,3578746276,3578746285,9
1,1243,32802,3578746276,3578746286,10
1,1243,32803,3578746276,3578746286,10
1,1243,32804,3578746276,3578746288,12
1,1243,32805,3578746276,3578746290,14
1,1243,32806,3578746276,3578746290,14
1,1243,32807,3578746276,3578746290,14
1,1243,32808,3578746276,3578746292,16
1,1243,32809,3578746276,3578746292,16
1,1243,32810,3578746276,3578746293,17
1,1243,32811,3578746276,3578746294,18
1,1243,32812,3578746276,3578746296,20
1,1243,32813,3578746276,3578746298,22
1,1243,32814,3578746276,3578746299,23
1,1243,32815,3578746276,3578746300,24
1,1243,32816,3578746276,3578746300,24
1,1243,32817,3578746276,3578746302,26
1,1243,32818,3578746276,3578746302,26
1,1243,32819,3578746276,3578746302,26
1,1243,32820,3578746276,3578746302,26
1,1243,32821,3578746276,3578746304,28
1,1243,32822,3578746276,3578746306,30
1,1243,32823,3578746276,3578746307,31
1,1243,32824,3578746276,3578746307,31
1,1243,32825,3578746276,3578746308,32
1,1243,32826,3578746276,3578746310,34
1,1243,32827,3578746276,3578746310,34
1,1243,32828,3578746276,3578746312,36
1,1243,32829,3578746276,3578746312,36
1,1243,32830,3578746276,3578746312,36
1,1243,32831,3578746276,3578746313,37
1,1243,32832,3578746276,3578746313,37
1,1243,32833,3578746276,3578746314,38
1,1243,32834,3578746276,3578746315,39
1,1243,32835,3578746276,3578746315,39
1,1243,32836,3578746276,3578746316,40
1,1243,32837,3578746276,3578746316,40
1,1243,32838,3578746276,3578746317,41
1,1243,32839,3578746276,3578746319,43
1,1243,32840,3578746276,3578746320,44
1,1243,32841,3578746276,3578746321,45
1,1243,32842,3578746276,3578746321,45
1,1243,32843,3578746276,3578746322,46
1,1243,32844,3578746276,3578746324,48
1,1243,32845,3578746276,3578746325,49
1,1243,32846,3578746276,3578746326,50
1,1244,32847,3578746339,3578746339,0
1,1244,32848,3578746339,3578746339,0
1,1244,32849,3578746339,3578746339,0
1,1244,32850,3578746339,3578746339,0
1,1244,32851,3578746339,3578746339,0
1,1244,32852,3578746339,3578746339,0
1,1244,32853,3578746339,3578746339,0
1,1244,32854,3578746339,3578746339,0
1,1244,32855,3578746339,3578746339,0
1,1244,32856,3578746339,3578746339,0
1,1244,32857,3578746339,3578746339,0
1,1244,32858,3578746339,3578746339,0
1,1244,32859,3578746339,3578746339,0
1,1244,32860,3578746339,3578746339,0
1,1244,32861,3578746339,3578746339,0
1,1244,32862,3578746339,3578746339,0
1,1244,32863,3578746339,3578746339,0
1,1244,32864,3578746339,3578746339,0
1,1244,32865,3578746339,3578746339,0
1,1244,32866,3578746339,3578746339,0
1,1244,32867,3578746339,3578746339,0
1,1244,32868,3578746339,3578746339,0
1,1244,32869,3578746339,3578746339,0
1,1244,32870,3578746339,3578746339,0
1,1244,32871,3578746339,3578746339,0
1,1244,32872,3578746339,3578746341,2
1,1244,32873,3578746339,3578746342,3
1,1244,32874,3578746339,3578746344,5
1,1244,32875,3578746339,3578746344,5
1,1244,32876,3578746339,3578746346,7
1,1244,32877,3578746339,3578746347,8
1,1244,32878,3578746339,3578746348,9
1,1244,32879,3578746339,3578746349,10
1,1244,32880,3578746339,3578746350,11
1,1244,32881,3578746339,3578746350,11
1,1244,32882,3578746339,3578746350,11
1,1244,32883,3578746339,3578746353,14
1,1244,32884,3578746339,3578746353,14
1,1244,32885,3578746339,3578746355,16
1,1244,32886,3578746339,3578746355,16
1,1244,32887,3578746339,3578746355,16
1,1244,32888,3578746339,3578746356,17
1,1244,32889,3578746339,3578746358,19
1,1244,32890,3578746339,3578746360,21
1,1244,32891,3578746339,3578746362,23
1,1244,32892,3578746339,3578746362,23
1,1244,32893,3578746339,3578746363,24
1,1244,32894,3578746339,3578746363,24
1,1244,32895,3578746339,3578746363,24
1,1244,32896,3578746339,3578746366,27
1,1244,32897,3578746339,3578746366,27
1,1244,32898,3578746339,3578746367,28
1,1244,32899,3578746339,3578746367,28
1,1244,32900,3578746339,3578746368,29
1,1244,32901,3578746339,3578746369,30
1,1244,32902,3578746339,3578746370,31
1,1244,32903,3578746339,3578746370,31
1,1244,32904,3578746339,3578746372,33
1,1244,32905,3578746339,3578746372,33
1,1244,32906,3578746339,3578746372,33
1,1244,32907,3578746339,3578746375,36
1,1244,32908,3578746339,3578746377,38
1,1244,32909,3578746339,3578746378,39
1,1244,32910,3578746339,3578746378,39
1,1244,32911,3578746339,3578746378,39
1,1244,32912,3578746339,3578746380,41
1,1244,32913,3578746339,3578746381,42
1,1244,32914,3578746339,3578746382,43
1,1244,32915,3578746339,3578746382,43
1,1244,32916,3578746339,3578746382,43
1,1244,32917,3578746339,3578746383,44
1,1244,32918,3578746339,3578746384,45
1,1244,32919,3578746339,3578746386,47
1,1244,32920,3578746339,3578746386,47
1,1244,32921,3578746339,3578746388,49
1,1245,32922,3578746402,3578746402,0
1,1245,32923,3578746402,3578746402,0
1,1245,32924,3578746402,3578746402,0
1,1245,32925,3578746402,3578746402,0
1,1245,32926,3578746402,3578746402,0
1,1245,32927,3578746402,3578746402,0
1,1245,32928,3578746402,3578746402,0
1,1245,32929,3578746402,3578746402,0
1,1245,32930,3578746402,3578746402,0
1,1245,32931,3578746402,3578746402,0
1,1245,32932,3578746402,3578746402,0
1,1245,32933,3578746402,3578746402,0
1,1245,32934,3578746402,3578746402,0
1,1245,32935,3578746402,3578746402,0
1,1245,32936,3578746402,3578746402,0
1,1245,32937,3578746402,3578746402,0
1,1245,32938,3578746402,3578746402,0
1,1245,32939,3578746402,3578746402,0
1,1245,32940,3578746402,3578746402,0
1,1245,32941,3578746402,3578746402,0
1,1245,32942,3578746402,3578746404,2
1,1245,32943,3578746402,3578746404,2
1,1245,32944,3578746402,3578746405,3
1,1245,32945,3578746402,3578746411,9
1,1245,32946,3578746402,3578746413,11
1,1245,32947,3578746402,3578746413,11
1,1245,32948,3578746402,3578746413,11
1,1245,32949,3578746402,3578746414,12
1,1245,32950,3578746402,3578746416,14
1,1245,32951,3578746402,3578746417,15
1,1245,32952,3578746402,3578746417,15
1,1245,32953,3578746402,3578746418,16
1,1245,32954,3578746402,3578746418,16
1,1245,32955,3578746402,3578746419,17
1,1245,32956,3578746402,3578746420,18
1,1245,32957,3578746402,3578746420,18
1,1245,32958,3578746402,3578746421,19
1,1245,32959,3578746402,3578746424,22
1,1245,32960,3578746402,3578746425,23
1,1245,32961,3578746402,3578746425,23
1,1245,32962,3578746402,3578746425,23
1,1245,32963,3578746402,3578746426,24
1,1245,32964,3578746402,3578746429,27
1,1245,32965,3578746402,3578746429,27
1,1245,32966,3578746402,3578746429,27
1,1245,32967,3578746402,3578746429,27
1,1245,32968,3578746402,3578746430,28
1,1245,32969,3578746402,3578746431,29
1,1245,32970,3578746402,3578746432,30
1,1245,32971,3578746402,3578746433,31
1,1245,32972,3578746402,3578746436,34
1,1245,32973,3578746402,3578746437,35
1,1245,32974,3578746402,3578746438,36
1,1245,32975,3578746402,3578746439,37
1,1245,32976,3578746402,3578746440,38
1,1245,32977,3578746402,3578746441,39
1,1245,32978,3578746402,3578746443,41
1,1245,32979,3578746402,3578746444,42
1,1245,32980,3578746402,3578746445,43
1,1245,32981,3578746402,3578746446,44
1,1245,32982,3578746402,3578746447,45
1,1245,32983,3578746402,3578746447,45
1,1245,32984,3578746402,3578746447,45
1,1245,32985,3578746402,3578746448,46
1,1245,32986,3578746402,3578746450,48
1,1245,32987,3578746402,3578746451,49
1,1245,32988,3578746402,3578746451,49
1,1246,32989,3578746464,3578746464,0
1,1246,32990,3578746464,3578746464,0
1,1246,32991,3578746464,3578746464,0
1,1246,32992,3578746464,3578746464,0
1,1246,32993,3578746464,3578746464,0
1,1246,32994,3578746464,3578746464,0
1,1246,32995,3578746464,3578746464,0
1,1246,32996,3578746464,3578746464,0
1,1246,32997,3578746464,3578746464,0
1,1246,32998,3578746464,3578746464,0
1,1246,32999,3578746464,3578746464,0
1,1246,33000,3578746464,3578746464,0
1,1246,33001,3578746464,3578746465,1
1,1246,33002,3578746464,3578746466,2
1,1246,33003,3578746464,3578746468,4
1,1246,33004,3578746464,3578746468,4
1,1246,33005,3578746464,3578746468,4
1,1246,33006,3578746464,3578746470,6
1,1246,33007,3578746464,3578746476,12
1,1246,33008,3578746464,3578746476,12
1,1246,33009,3578746464,3578746477,13
1,1246,33010,3578746464,3578746481,17
1,1246,33011,3578746464,3578746484,20
1,1246,33012,3578746464,3578746485,21
1,1246,33013,3578746464,3578746486,22
1,1246,33014,3578746464,3578746486,22
1,1246,33015,3578746464,3578746489,25
1,1246,33016,3578746464,3578746490,26
1,1246,33017,3578746464,3578746490,26
1,1246,33018,3578746464,3578746490,26
1,1246,33019,3578746464,3578746492,28
1,1246,33020,3578746464,3578746492,28
1,1246,33021,3578746464,3578746493,29
1,1246,33022,3578746464,3578746494,30
1,1246,33023,3578746464,3578746495,31
1,1246,33024,3578746464,3578746495,31
1,1246,33025,3578746464,3578746495,31
1,1246,33026,3578746464,3578746498,34
1,1246,33027,3578746464,3578746499,35
1,1246,33028,3578746464,3578746500,36
1,1246,33029,3578746464,3578746500,36
1,1246,33030,3578746464,3578746501,37
1,1246,33031,3578746464,3578746502,38
1,1246,33032,3578746464,3578746502,38
1,1246,33033,3578746464,3578746504,40
1,1246,33034,3578746464,3578746506,42
1,1246,33035,3578746464,3578746506,42
1,1246,33036,3578746464,3578746506,42
1,1246,33037,3578746464,3578746506,42
1,1246,33038,3578746464,3578746507,43
1,1246,33039,3578746464,3578746510,46
1,1246,33040,3578746464,3578746511,47
1,1246,33041,3578746464,3578746512,48
1,1246,33042,3578746464,3578746512,48
1,1246,33043,3578746464,3578746512,48
1,1246,33044,3578746464,3578746512,48
1,1246,33045,3578746464,3578746513,49
1,1247,33046,3578746527,3578746527,0
1,1247,33047,3578746527,3578746527,0
1,1247,33048,3578746527,3578746527,0
1,1247,33049,3578746527,3578746527,0
1,1247,33050,3578746527,3578746527,0
1,1247,33051,3578746527,3578746527,0
1,1247,33052,3578746527,3578746527,0
1,1247,33053,3578746527,3578746527,0
1,1247,33054,3578746527,3578746527,0
1,1247,33055,3578746527,3578746527,0
1,1247,33056,3578746527,3578746527,0
1,1247,33057,3578746527,3578746527,0
1,1247,33058,3578746527,3578746527,0
1,1247,33059,3578746527,3578746527,0
1,1247,33060,3578746527,3578746527,0
1,1247,33061,3578746527,3578746527,0
1,1247,33062,3578746527,3578746527,0
1,1247,33063,3578746527,3578746527,0
1,1247,33064,3578746527,3578746527,0
1,1247,33065,3578746527,3578746529,2
1,1247,33066,3578746527,3578746529,2
1,1247,33067,3578746527,3578746530,3
1,1247,33068,3578746527,3578746530,3
1,1247,33069,3578746527,3578746530,3
1,1247,33070,3578746527,3578746531,4
1,1247,33071,3578746527,3578746532,5
1,1247,33072,3578746527,3578746532,5
1,1247,33073,3578746527,3578746533,6
1,1247,33074,3578746527,3578746533,6
1,1247,33075,3578746527,3578746534,7
1,1247,33076,3578746527,3578746534,7
1,1247,33077,3578746527,3578746534,7
1,1247,33078,3578746527,3578746535,8
1,1247,33079,3578746527,3578746535,8
1,1247,33080,3578746527,3578746536,9
1,1247,33081,3578746527,3578746536,9
1,1247,33082,3578746527,3578746538,11
1,1247,33083,3578746527,3578746538,11
1,1247,33084,3578746527,3578746541,14
1,1247,33085,3578746527,3578746543,16
1,1247,33086,3578746527,3578746543,16
1,1247,33087,3578746527,3578746543,16
1,1247,33088,3578746527,3578746545,18
1,1247,33089,3578746527,3578746546,19
1,1247,33090,3578746527,3578746546,19
1,1247,33091,3578746527,3578746547,20
1,1247,33092,3578746527,3578746549,22
1,1247,33093,3578746527,3578746549,22
1,1247,33094,3578746527,3578746550,23
1,1247,33095,3578746527,3578746552,25
1,1247,33096,3578746527,3578746552,25
1,1247,33097,3578746527,3578746554,27
1,1247,33098,3578746527,3578746555,28
1,1247,33099,3578746527,3578746555,28
1,1247,33100,3578746527,3578746556,29
1,1247,33101,3578746527,3578746556,29
1,1247,33102,3578746527,3578746557,30
1,1247,33103,3578746527,3578746559,32
1,1247,33104,3578746527,3578746561,34
1,1247,33105,3578746527,3578746561,34
1,1247,33106,3578746527,3578746561,34
1,1247,33107,3578746527,3578746562,35
1,1247,33108,3578746527,3578746563,36
1,1247,33109,3578746527,3578746565,38
1,1247,33110,3578746527,3578746565,38
1,1247,33111,3578746527,3578746566,39
1,1247,33112,3578746527,3578746566,39
1,1247,33113,3578746527,3578746566,39
1,1247,33114,3578746527,3578746568,41
1,1247,33115,3578746527,3578746569,42
1,1247,33116,3578746527,3578746571,44
1,1247,33117,3578746527,3578746571,44
1,1247,33118,3578746527,3578746572,45
1,1247,33119,3578746527,3578746572,45
1,1247,33120,3578746527,3578746574,47
1,1247,33121,3578746527,3578746576,49
1,1247,33122,3578746527,3578746577,50
1,1248,33123,3578746589,3578746589,0
1,1248,33124,3578746589,3578746589,0
1,1248,33125,3578746589,3578746589,0
1,1248,33126,3578746589,3578746589,0
1,1248,33127,3578746589,3578746589,0
1,1248,33128,3578746589,3578746589,0
1,1248,33129,3578746589,3578746589,0
1,1248,33130,3578746589,3578746589,0
1,1248,33131,3578746589,3578746589,0
1,1248,33132,3578746589,3578746589,0
1,1248,33133,3578746589,3578746589,0
1,1248,33134,3578746589,3578746589,0
1,1248,33135,3578746589,3578746589,0
1,1248,33136,3578746589,3578746590,1
1,1248,33137,3578746589,3578746590,1
1,1248,33138,3578746589,3578746591,2
1,1248,33139,3578746589,3578746593,4
1,1248,33140,3578746589,3578746593,4
1,1248,33141,3578746589,3578746594,5
1,1248,33142,3578746589,3578746595,6
1,1248,33143,3578746589,3578746596,7
1,1248,33144,3578746589,3578746596,7
1,1248,33145,3578746589,3578746597,8
1,1248,33146,3578746589,3578746597,8
1,1248,33147,3578746589,3578746597,8
1,1248,33148,3578746589,3578746598,9
1,1248,33149,3578746589,3578746598,9
1,1248,33150,3578746589,3578746598,9
1,1248,33151,3578746589,3578746599,10
1,1248,33152,3578746589,3578746600,11
1,1248,33153,3578746589,3578746600,11
1,1248,33154,3578746589,3578746603,14
1,1248,33155,3578746589,3578746604,15
1,1248,33156,3578746589,3578746605,16
1,1248,33157,3578746589,3578746610,21
1,1248,33158,3578746589,3578746612,23
1,1248,33159,3578746589,3578746612,23
1,1248,33160,3578746589,3578746613,24
1,1248,33161,3578746589,3578746613,24
1,1248,33162,3578746589,3578746615,26
1,1248,33163,3578746589,3578746616,27
1,1248,33164,3578746589,3578746616,27
1,1248,33165,3578746589,3578746616,27
1,1248,33166,3578746589,3578746618,29
1,1248,33167,3578746589,3578746618,29
1,1248,33168,3578746589,3578746619,30
1,1248,33169,3578746589,3578746619,30
1,1248,33170,3578746589,3578746621,32
1,1248,33171,3578746589,3578746624,35
1,1248,33172,3578746589,3578746624,35
1,1248,33173,3578746589,3578746625,36
1,1248,33174,3578746589,3578746625,36
1,1248,33175,3578746589,3578746627,38
1,1248,33176,3578746589,3578746628,39
1,1248,33177,3578746589,3578746628,39
1,1248,33178,3578746589,3578746629,40
1,1248,33179,3578746589,3578746629,40
1,1248,33180,3578746589,3578746629,40
1,1248,33181,3578746589,3578746632,43
1,1248,33182,3578746589,3578746632,43
1,1248,33183,3578746589,3578746636,47
1,1248,33184,3578746589,3578746636,47
1,1248,33185,3578746589,3578746637,48
1,1249,33186,3578746651,3578746651,0
1,1249,33187,3578746651,3578746651,0
1,1249,33188,3578746651,3578746651,0
1,1249,33189,3578746651,3578746651,0
1,1249,33190,3578746651,3578746651,0
1,1249,33191,3578746651,3578746651,0
1,1249,33192,3578746651,3578746651,0
1,1249,33193,3578746651,3578746651,0
1,1249,33194,3578746651,3578746651,0
1,1249,33195,3578746651,3578746651,0
1,1249,33196,3578746651,3578746651,0
1,1249,33197,3578746651,3578746651,0
1,1249,33198,3578746651,3578746651,0
1,1249,33199,3578746651,3578746651,0
1,1249,33200,3578746651,3578746652,1
1,1249,33201,3578746651,3578746653,2
1,1249,33202,3578746651,3578746653,2
1,1249,33203,3578746651,3578746655,4
1,1249,33204,3578746651,3578746657,6
1,1249,33205,3578746651,3578746657,6
1,1249,33206,3578746651,3578746658,7
1,1249,33207,3578746651,3578746658,7
1,1249,33208,3578746651,3578746662,11
1,1249,33209,3578746651,3578746662,11
1,1249,33210,3578746651,3578746662,11
1,1249,33211,3578746651,3578746662,11
1,1249,33212,3578746651,3578746664,13
1,1249,33213,3578746651,3578746665,14
1,1249,33214,3578746651,3578746666,15
1,1249,33215,3578746651,3578746667,16
1,1249,33216,3578746651,3578746667,16
1,1249,33217,3578746651,3578746668,17
1,1249,33218,3578746651,3578746669,18
1,1249,33219,3578746651,3578746676,25
1,1249,33220,3578746651,3578746676,25
1,1249,33221,3578746651,3578746677,26
1,1249,33222,3578746651,3578746680,29
1,1249,33223,3578746651,3578746681,30
1,1249,33224,3578746651,3578746684,33
1,1249,33225,3578746651,3578746685,34
1,1249,33226,3578746651,3578746686,35
1,1249,33227,3578746651,3578746687,36
1,1249,33228,3578746651,3578746689,38
1,1249,33229,3578746651,3578746690,39
1,1249,33230,3578746651,3578746690,39
1,1249,33231,3578746651,3578746691,40
1,1249,33232,3578746651,3578746692,41
1,1249,33233,3578746651,3578746693,42
1,1249,33234,3578746651,3578746694,43
1,1249,33235,3578746651,3578746694,43
1,1249,33236,3578746651,3578746695,44
1,1249,33237,3578746651,3578746695,44
1,1249,33238,3578746651,3578746699,48
1,1249,33239,3578746651,3578746699,48
1,1249,33240,3578746651,3578746700,49
1,1249,33241,3578746651,3578746700,49
1,1250,33242,3578746714,3578746714,0
1,1250,33243,3578746714,3578746714,0
1,1250,33244,3578746714,3578746714,0
1,1250,33245,3578746714,3578746714,0
1,1250,33246,3578746714,3578746714,0
1,1250,33247,3578746714,3578746714,0
1,1250,33248,3578746714,3578746714,0
1,1250,33249,3578746714,3578746714,0
1,1250,33250,3578746714,3578746714,0
1,1250,33251,3578746714,3578746714,0
1,1250,33252,3578746714,3578746714,0
1,1250,33253,3578746714,3578746714,0
1,1250,33254,3578746714,3578746714,0
1,1250,33255,3578746714,3578746714,0
1,1250,33256,3578746714,3578746714,0
1,1250,33257,3578746714,3578746715,1
1,1250,33258,3578746714,3578746715,1
1,1250,33259,3578746714,3578746715,1
1,1250,33260,3578746714,3578746716,2
1,1250,33261,3578746714,3578746716,2
1,1250,33262,3578746714,3578746717,3
1,1250,33263,3578746714,3578746719,5
1,1250,33264,3578746714,3578746720,6
1,1250,33265,3578746714,3578746720,6
1,1250,33266,3578746714,3578746722,8
1,1250,33267,3578746714,3578746723,9
1,1250,33268,3578746714,3578746725,11
1,1250,33269,3578746714,3578746725,11
1,1250,33270,3578746714,3578746725,11
1,1250,33271,3578746714,3578746725,11
1,1250,33272,3578746714,3578746726,12
1,1250,33273,3578746714,3578746727,13
1,1250,33274,3578746714,3578746728,14
1,1250,33275,3578746714,3578746729,15
1,1250,33276,3578746714,3578746730,16
1,1250,33277,3578746714,3578746730,16
1,1250,33278,3578746714,3578746730,16
1,1250,33279,3578746714,3578746730,16
1,1250,33280,3578746714,3578746731,17
1,1250,33281,3578746714,3578746731,17
1,1250,33282,3578746714,3578746732,18
1,1250,33283,3578746714,3578746732,18
1,1250,33284,3578746714,3578746733,19
1,1250,33285,3578746714,3578746733,19
1,1250,33286,3578746714,3578746733,19
1,1250,33287,3578746714,3578746733,19
1,1250,33288,3578746714,3578746734,20
1,1250,33289,3578746714,3578746734,20
1,1250,33290,3578746714,3578746735,21
1,1250,33291,3578746714,3578746736,22
1,1250,33292,3578746714,3578746736,22
1,1250,33293,3578746714,3578746736,22
1,1250,33294,3578746714,3578746737,23
1,1250,33295,3578746714,3578746738,24
1,1250,33296,3578746714,3578746738,24
1,1250,33297,3578746714,3578746741,27
1,1250,33298,3578746714,3578746742,28
1,1250,33299,3578746714,3578746743,29
1,1250,33300,3578746714,3578746743,29
1,1250,33301,3578746714,3578746746,32
1,1250,33302,3578746714,3578746746,32
1,1250,33303,3578746714,3578746747,33
1,1250,33304,3578746714,3578746747,33
1,1250,33305,3578746714,3578746749,35
1,1250,33306,3578746714,3578746750,36
1,1250,33307,3578746714,3578746750,36
1,1250,33308,3578746714,3578746752,38
1,1250,33309,3578746714,3578746752,38
1,1250,33310,3578746714,3578746754,40
1,1250,33311,3578746714,3578746754,40
1,1250,33312,3578746714,3578746755,41
1,1250,33313,3578746714,3578746756,42
1,1250,33314,3578746714,3578746757,43
1,1250,33315,3578746714,3578746758,44
1,1250,33316,3578746714,3578746759,45
1,1250,33317,3578746714,3578746761,47
1,1250,33318,3578746714,3578746761,47
1,1250,33319,3578746714,3578746762,48
1,1250,33320,3578746714,3578746762,48
1,1250,33321,3578746714,3578746763,49
1,1251,33322,3578746776,3578746776,0
1,1251,33323,3578746776,3578746776,0
1,1251,33324,3578746776,3578746776,0
1,1251,33325,3578746776,3578746776,0
1,1251,33326,3578746776,3578746776,0
1,1251,33327,3578746776,3578746776,0
1,1251,33328,3578746776,3578746776,0
1,1251,33329,3578746776,3578746776,0
1,1251,33330,3578746776,3578746776,0
1,1251,33331,3578746776,3578746776,0
1,1251,33332,3578746776,3578746776,0
1,1251,33333,3578746776,3578746776,0
1,1251,33334,3578746776,3578746776,0
1,1251,33335,3578746776,3578746777,1
1,1251,33336,3578746776,3578746778,2
1,1251,33337,3578746776,3578746780,4
1,1251,33338,3578746776,3578746780,4
1,1251,33339,3578746776,3578746780,4
1,1251,33340,3578746776,3578746781,5
1,1251,33341,3578746776,3578746781,5
1,1251,33342,3578746776,3578746781,5
1,1251,33343,3578746776,3578746781,5
1,1251,33344,3578746776,3578746783,7
1,1251,33345,3578746776,3578746785,9
1,1251,33346,3578746776,3578746786,10
1,1251,33347,3578746776,3578746788,12
1,1251,33348,3578746776,3578746790,14
1,1251,33349,3578746776,3578746791,15
1,1251,33350,3578746776,3578746792,16
1,1251,33351,3578746776,3578746792,16
1,1251,33352,3578746776,3578746793,17
1,1251,33353,3578746776,3578746793,17
1,1251,33354,3578746776,3578746795,19
1,1251,33355,3578746776,3578746796,20
1,1251,33356,3578746776,3578746796,20
1,1251,33357,3578746776,3578746796,20
1,1251,33358,3578746776,3578746797,21
1,1251,33359,3578746776,3578746797,21
1,1251,33360,3578746776,3578746798,22
1,1251,33361,3578746776,3578746798,22
1,1251,33362,3578746776,3578746798,22
1,1251,33363,3578746776,3578746799,23
1,1251,33364,3578746776,3578746799,23
1,1251,33365,3578746776,3578746800,24
1,1251,33366,3578746776,3578746800,24
1,1251,33367,3578746776,3578746804,28
1,1251,33368,3578746776,3578746806,30
1,1251,33369,3578746776,3578746810,34
1,1251,33370,3578746776,3578746812,36
1,1251,33371,3578746776,3578746812,36
1,1251,33372,3578746776,3578746813,37
1,1251,33373,3578746776,3578746813,37
1,1251,33374,3578746776,3578746815,39
1,1251,33375,3578746776,3578746816,40
1,1251,33376,3578746776,3578746816,40
1,1251,33377,3578746776,3578746817,41
1,1251,33378,3578746776,3578746818,42
1,1251,33379,3578746776,3578746818,42
1,1251,33380,3578746776,3578746819,43
1,1251,33381,3578746776,3578746820,44
1,1251,33382,3578746776,3578746821,45
1,1251,33383,3578746776,3578746824,48
1,1251,33384,3578746776,3578746825,49
1,1251,33385,3578746776,3578746825,49
1,1251,33386,3578746776,3578746825,49
1,1251,33387,3578746776,3578746826,50
1,1252,33388,3578746838,3578746838,0
1,1252,33389,3578746838,3578746838,0
1,1252,33390,3578746838,3578746838,0
1,1252,33391,3578746838,3578746838,0
1,1252,33392,3578746838,3578746838,0
1,1252,33393,3578746838,3578746838,0
1,1252,33394,3578746838,3578746838,0
1,1252,33395,3578746838,3578746838,0
1,1252,33396,3578746838,3578746838,0
1,1252,33397,3578746838,3578746838,0
1,1252,33398,3578746838,3578746838,0
1,1252,33399,3578746838,3578746838,0
1,1252,33400,3578746838,3578746839,1
1,1252,33401,3578746838,3578746839,1
1,1252,33402,3578746838,3578746840,2
1,1252,33403,3578746838,3578746840,2
1,1252,33404,3578746838,3578746841,3
1,1252,33405,3578746838,3578746843,5
1,1252,33406,3578746838,3578746845,7
1,1252,33407,3578746838,3578746845,7
1,1252,33408,3578746838,3578746845,7
1,1252,33409,3578746838,3578746847,9
1,1252,33410,3578746838,3578746848,10
1,1252,33411,3578746838,3578746848,10
1,1252,33412,3578746838,3578746848,10
1,1252,33413,3578746838,3578746851,13
1,1252,33414,3578746838,3578746853,15
1,1252,33415,3578746838,3578746854,16
1,1252,33416,3578746838,3578746855,17
1,1252,33417,3578746838,3578746856,18
1,1252,33418,3578746838,3578746857,19
1,1252,33419,3578746838,3578746857,19
1,1252,33420,3578746838,3578746861,23
1,1252,33421,3578746838,3578746862,24
1,1252,33422,3578746838,3578746864,26
1,1252,33423,3578746838,3578746864,26
1,1252,33424,3578746838,3578746865,27
1,1252,33425,3578746838,3578746866,28
1,1252,33426,3578746838,3578746867,29
1,1252,33427,3578746838,3578746867,29
1,1252,33428,3578746838,3578746868,30
1,1252,33429,3578746838,3578746869,31
1,1252,33430,3578746838,3578746876,38
1,1252,33431,3578746838,3578746876,38
1,1252,33432,3578746838,3578746877,39
1,1252,33433,3578746838,3578746881,43
1,1252,33434,3578746838,3578746882,44
1,1252,33435,3578746838,3578746884,46
1,1252,33436,3578746838,3578746885,47
1,1252,33437,3578746838,3578746886,48
1,1252,33438,3578746838,3578746887,49
1,1253,33439,3578746899,3578746899,0
1,1253,33440,3578746899,3578746899,0
1,1253,33441,3578746899,3578746899,0
1,1253,33442,3578746899,3578746899,0
1,1253,33443,3578746899,3578746899,0
1,1253,33444,3578746899,3578746899,0
1,1253,33445,3578746899,3578746899,0
1,1253,33446,3578746899,3578746899,0
1,1253,33447,3578746899,3578746899,0
1,1253,33448,3578746899,3578746899,0
1,1253,33449,3578746899,3578746899,0
1,1253,33450,3578746899,3578746899,0
1,1253,33451,3578746899,3578746899,0
1,1253,33452,3578746899,3578746900,1
1,1253,33453,3578746899,3578746901,2
1,1253,33454,3578746899,3578746902,3
1,1253,33455,3578746899,3578746902,3
1,1253,33456,3578746899,3578746902,3
1,1253,33457,3578746899,3578746903,4
1,1253,33458,3578746899,3578746906,7
1,1253,33459,3578746899,3578746906,7
1,1253,33460,3578746899,3578746906,7
1,1253,33461,3578746899,3578746907,8
1,1253,33462,3578746899,3578746907,8
1,1253,33463,3578746899,3578746908,9
1,1253,33464,3578746899,3578746911,12
1,1253,33465,3578746899,3578746912,13
1,1253,33466,3578746899,3578746912,13
1,1253,33467,3578746899,3578746913,14
1,1253,33468,3578746899,3578746913,14
1,1253,33469,3578746899,3578746914,15
1,1253,33470,3578746899,3578746916,17
1,1253,33471,3578746899,3578746916,17
1,1253,33472,3578746899,3578746917,18
1,1253,33473,3578746899,3578746917,18
1,1253,33474,3578746899,3578746919,20
1,1253,33475,3578746899,3578746920,21
1,1253,33476,3578746899,3578746921,22
1,1253,33477,3578746899,3578746921,22
1,1253,33478,3578746899,3578746922,23
1,1253,33479,3578746899,3578746923,24
1,1253,33480,3578746899,3578746924,25
1,1253,33481,3578746899,3578746924,25
1,1253,33482,3578746899,3578746924,25
1,1253,33483,3578746899,3578746925,26
1,1253,33484,3578746899,3578746927,28
1,1253,33485,3578746899,3578746927,28
1,1253,33486,3578746899,3578746927,28
1,1253,33487,3578746899,3578746930,31
1,1253,33488,3578746899,3578746930,31
1,1253,33489,3578746899,3578746930,31
1,1253,33490,3578746899,3578746930,31
1,1253,33491,3578746899,3578746930,31
1,1253,33492,3578746899,3578746931,32
1,1253,33493,3578746899,3578746932,33
1,1253,33494,3578746899,3578746932,33
1,1253,33495,3578746899,3578746932,33
1,1253,33496,3578746899,3578746933,34
1,1253,33497,3578746899,3578746933,34
1,1253,33498,3578746899,3578746934,35
1,1253,33499,3578746899,3578746934,35
1,1253,33500,3578746899,3578746935,36
1,1253,33501,3578746899,3578746935,36
1,1253,33502,3578746899,3578746935,36
1,1253,33503,3578746899,3578746935,36
1,1253,33504,3578746899,3578746935,36
1,1253,33505,3578746899,3578746936,37
1,1253,33506,3578746899,3578746937,38
1,1253,33507,3578746899,3578746939,40
1,1253,33508,3578746899,3578746939,40
1,1253,33509,3578746899,3578746941,42
1,1253,33510,3578746899,3578746943,44
1,1253,33511,3578746899,3578746943,44
1,1253,33512,3578746899,3578746944,45
1,1253,33513,3578746899,3578746945,46
1,1253,33514,3578746899,3578746946,47
1,1253,33515,3578746899,3578746948,49
1,1253,33516,3578746899,3578746948,49
1,1254,33517,3578746961,3578746961,0
1,1254,33518,3578746961,3578746961,0
1,1254,33519,3578746961,3578746961,0
1,1254,33520,3578746961,3578746961,0
1,1254,33521,3578746961,3578746961,0
1,1254,33522,3578746961,3578746961,0
1,1254,33523,3578746961,3578746961,0
1,1254,33524,3578746961,3578746961,0
1,1254,33525,3578746961,3578746961,0
1,1254,33526,3578746961,3578746961,0
1,1254,33527,3578746961,3578746961,0
1,1254,33528,3578746961,3578746961,0
1,1254,33529,3578746961,3578746962,1
1,1254,33530,3578746961,3578746962,1
1,1254,33531,3578746961,3578746962,1
1,1254,33532,3578746961,3578746962,1
1,1254,33533,3578746961,3578746964,3
1,1254,33534,3578746961,3578746965,4
1,1254,33535,3578746961,3578746966,5
1,1254,33536,3578746961,3578746966,5
1,1254,33537,3578746961,3578746966,5
1,1254,33538,3578746961,3578746967,6
1,1254,33539,3578746961,3578746968,7
1,1254,33540,3578746961,3578746969,8
1,1254,33541,3578746961,3578746971,10
1,1254,33542,3578746961,3578746971,10
1,1254,33543,3578746961,3578746972,11
1,1254,33544,3578746961,3578746973,12
1,1254,33545,3578746961,3578746974,13
1,1254,33546,3578746961,3578746977,16
1,1254,33547,3578746961,3578746978,17
1,1254,33548,3578746961,3578746979,18
1,1254,33549,3578746961,3578746979,18
1,1254,33550,3578746961,3578746980,19
1,1254,33551,3578746961,3578746981,20
1,1254,33552,3578746961,3578746981,20
1,1254,33553,3578746961,3578746981,20
1,1254,33554,3578746961,3578746982,21
1,1254,33555,3578746961,3578746982,21
1,1254,33556,3578746961,3578746984,23
1,1254,33557,3578746961,3578746986,25
1,1254,33558,3578746961,3578746987,26
1,1254,33559,3578746961,3578746989,28
1,1254,33560,3578746961,3578746990,29
1,1254,33561,3578746961,3578746991,30
1,1254,33562,3578746961,3578746992,31
1,1254,33563,3578746961,3578746992,31
1,1254,33564,3578746961,3578746993,32
1,1254,33565,3578746961,3578746993,32
1,1254,33566,3578746961,3578746993,32
1,1254,33567,3578746961,3578746996,35
1,1254,33568,3578746961,3578746996,35
1,1254,33569,3578746961,3578746996,35
1,1254,33570,3578746961,3578746997,36
1,1254,33571,3578746961,3578746997,36
1,1254,33572,3578746961,3578746998,37
1,1254,33573,3578746961,3578746998,37
1,1254,33574,3578746961,3578746998,37
1,1254,33575,3578746961,3578746998,37
1,1254,33576,3578746961,3578746999,38
1,1254,33577,3578746961,3578746999,38
1,1254,33578,3578746961,3578746999,38
1,1254,33579,3578746961,3578746999,38
1,1254,33580,3578746961,3578747001,40
1,1254,33581,3578746961,3578747001,40
1,1254,33582,3578746961,3578747004,43
1,1254,33583,3578746961,3578747004,43
1,1254,33584,3578746961,3578747006,45
1,1254,33585,3578746961,3578747011,50
1,1255,33586,3578747024,3578747024,0
1,1255,33587,3578747024,3578747024,0
1,1255,33588,3578747024,3578747024,0
1,1255,33589,3578747024,3578747024,0
1,1255,33590,3578747024,3578747024,0
1,1255,33591,3578747024,3578747024,0
1,1255,33592,3578747024,3578747024,0
1,1255,33593,3578747024,3578747024,0
1,1255,33594,3578747024,3578747024,0
1,1255,33595,3578747024,3578747024,0
1,1255,33596,3578747024,3578747024,0
1,1255,33597,3578747024,3578747024,0
1,1255,33598,3578747024,3578747024,0
1,1255,33599,3578747024,3578747025,1
1,1255,33600,3578747024,3578747025,1
1,1255,33601,3578747024,3578747027,3
1,1255,33602,3578747024,3578747028,4
1,1255,33603,3578747024,3578747028,4
1,1255,33604,3578747024,3578747029,5
1,1255,33605,3578747024,3578747029,5
1,1255,33606,3578747024,3578747029,5
1,1255,33607,3578747024,3578747029,5
1,1255,33608,3578747024,3578747030,6
1,1255,33609,3578747024,3578747030,6
1,1255,33610,3578747024,3578747032,8
1,1255,33611,3578747024,3578747035,11
1,1255,33612,3578747024,3578747036,12
1,1255,33613,3578747024,3578747037,13
1,1255,33614,3578747024,3578747039,15
1,1255,33615,3578747024,3578747039,15
1,1255,33616,3578747024,3578747040,16
1,1255,33617,3578747024,3578747041,17
1,1255,33618,3578747024,3578747042,18
1,1255,33619,3578747024,3578747043,19
1,1255,33620,3578747024,3578747044,20
1,1255,33621,3578747024,3578747045,21
1,1255,33622,3578747024,3578747046,22
1,1255,33623,3578747024,3578747047,23
1,1255,33624,3578747024,3578747048,24
1,1255,33625,3578747024,3578747048,24
1,1255,33626,3578747024,3578747049,25
1,1255,33627,3578747024,3578747051,27
1,1255,33628,3578747024,3578747051,27
1,1255,33629,3578747024,3578747053,29
1,1255,33630,3578747024,3578747053,29
1,1255,33631,3578747024,3578747054,30
1,1255,33632,3578747024,3578747055,31
1,1255,33633,3578747024,3578747056,32
1,1255,33634,3578747024,3578747057,33
1,1255,33635,3578747024,3578747058,34
1,1255,33636,3578747024,3578747058,34
1,1255,33637,3578747024,3578747060,36
1,1255,33638,3578747024,3578747061,37
1,1255,33639,3578747024,3578747063,39
1,1255,33640,3578747024,3578747064,40
1,1255,33641,3578747024,3578747065,41
1,1255,33642,3578747024,3578747065,41
1,1255,33643,3578747024,3578747066,42
1,1255,33644,3578747024,3578747067,43
1,1255,33645,3578747024,3578747068,44
1,1255,33646,3578747024,3578747068,44
1,1255,33647,3578747024,3578747069,45
1,1256,33648,3578747086,3578747086,0
1,1256,33649,3578747086,3578747086,0
1,1256,33650,3578747086,3578747086,0
1,1256,33651,3578747086,3578747086,0
1,1256,33652,3578747086,3578747086,0
1,1256,33653,3578747086,3578747086,0
1,1256,33654,3578747086,3578747087,1
1,1256,33655,3578747086,3578747089,3
1,1256,33656,3578747086,3578747090,4
1,1256,33657,3578747086,3578747090,4
1,1256,33658,3578747086,3578747091,5
1,1256,33659,3578747086,3578747092,6
1,1256,33660,3578747086,3578747093,7
1,1256,33661,3578747086,3578747094,8
1,1256,33662,3578747086,3578747095,9
1,1256,33663,3578747086,3578747095,9
1,1256,33664,3578747086,3578747096,10
1,1256,33665,3578747086,3578747097,11
1,1256,33666,3578747086,3578747099,13
1,1256,33667,3578747086,3578747099,13
1,1256,33668,3578747086,3578747100,14
1,1256,33669,3578747086,3578747100,14
1,1256,33670,3578747086,3578747102,16
1,1256,33671,3578747086,3578747102,16
1,1256,33672,3578747086,3578747102,16
1,1256,33673,3578747086,3578747103,17
1,1256,33674,3578747086,3578747106,20
1,1256,33675,3578747086,3578747106,20
1,1256,33676,3578747086,3578747107,21
1,1256,33677,3578747086,3578747107,21
1,1256,33678,3578747086,3578747108,22
1,1256,33679,3578747086,3578747111,25
1,1256,33680,3578747086,3578747111,25
1,1256,33681,3578747086,3578747112,26
1,1256,33682,3578747086,3578747112,26
1,1256,33683,3578747086,3578747114,28
1,1256,33684,3578747086,3578747114,28
1,1256,33685,3578747086,3578747115,29
1,1256,33686,3578747086,3578747115,29
1,1256,33687,3578747086,3578747116,30
1,1256,33688,3578747086,3578747117,31
1,1256,33689,3578747086,3578747117,31
1,1256,33690,3578747086,3578747119,33
1,1256,33691,3578747086,3578747120,34
1,1256,33692,3578747086,3578747120,34
1,1256,33693,3578747086,3578747121,35
1,1256,33694,3578747086,3578747123,37
1,1256,33695,3578747086,3578747124,38
1,1256,33696,3578747086,3578747125,39
1,1256,33697,3578747086,3578747125,39
1,1256,33698,3578747086,3578747126,40
1,1256,33699,3578747086,3578747127,41
1,1256,33700,3578747086,3578747127,41
1,1256,33701,3578747086,3578747127,41
1,1256,33702,3578747086,3578747127,41
1,1256,33703,3578747086,3578747129,43
1,1256,33704,3578747086,3578747130,44
1,1256,33705,3578747086,3578747130,44
1,1256,33706,3578747086,3578747131,45
1,1256,33707,3578747086,3578747131,45
1,1256,33708,3578747086,3578747131,45
1,1256,33709,3578747086,3578747132,46
1,1256,33710,3578747086,3578747133,47
1,1256,33711,3578747086,3578747133,47
1,1256,33712,3578747086,3578747134,48
1,1256,33713,3578747086,3578747134,48
1,1256,33714,3578747086,3578747134,48
1,1256,33715,3578747086,3578747135,49
1,1256,33716,3578747086,3578747135,49
1,1256,33717,3578747086,3578747135,49
1,1256,33718,3578747086,3578747135,49
1,1257,33719,3578747148,3578747148,0
1,1257,33720,3578747148,3578747148,0
1,1257,33721,3578747148,3578747148,0
1,1257,33722,3578747148,3578747148,0
1,1257,33723,3578747148,3578747148,0
1,1257,33724,3578747148,3578747148,0
1,1257,33725,3578747148,3578747148,0
1,1257,33726,3578747148,3578747148,0
1,1257,33727,3578747148,3578747148,0
1,1257,33728,3578747148,3578747148,0
1,1257,33729,3578747148,3578747148,0
1,1257,33730,3578747148,3578747148,0
1,1257,33731,3578747148,3578747148,0
1,1257,33732,3578747148,3578747149,1
1,1257,33733,3578747148,3578747150,2
1,1257,33734,3578747148,3578747150,2
1,1257,33735,3578747148,3578747152,4
1,1257,33736,3578747148,3578747152,4
1,1257,33737,3578747148,3578747154,6
1,1257,33738,3578747148,3578747154,6
1,1257,33739,3578747148,3578747156,8
1,1257,33740,3578747148,3578747158,10
1,1257,33741,3578747148,3578747160,12
1,1257,33742,3578747148,3578747161,13
1,1257,33743,3578747148,3578747162,14
1,1257,33744,3578747148,3578747162,14
1,1257,33745,3578747148,3578747162,14
1,1257,33746,3578747148,3578747162,14
1,1257,33747,3578747148,3578747164,16
1,1257,33748,3578747148,3578747166,18
1,1257,33749,3578747148,3578747166,18
1,1257,33750,3578747148,3578747166,18
1,1257,33751,3578747148,3578747166,18
1,1257,33752,3578747148,3578747167,19
1,1257,33753,3578747148,3578747168,20
1,1257,33754,3578747148,3578747169,21
1,1257,33755,3578747148,3578747171,23
1,1257,33756,3578747148,3578747171,23
1,1257,33757,3578747148,3578747172,24
1,1257,33758,3578747148,3578747173,25
1,1257,33759,3578747148,3578747175,27
1,1257,33760,3578747148,3578747177,29
1,1257,33761,3578747148,3578747178,30
1,1257,33762,3578747148,3578747178,30
1,1257,33763,3578747148,3578747180,32
1,1257,33764,3578747148,3578747180,32
1,1257,33765,3578747148,3578747180,32
1,1257,33766,3578747148,3578747180,32
1,1257,33767,3578747148,3578747181,33
1,1257,33768,3578747148,3578747181,33
1,1257,33769,3578747148,3578747182,34
1,1257,33770,3578747148,3578747183,35
1,1257,33771,3578747148,3578747183,35
1,1257,33772,3578747148,3578747185,37
1,1257,33773,3578747148,3578747187,39
1,1257,33774,3578747148,3578747189,41
1,1257,33775,3578747148,3578747190,42
1,1257,33776,3578747148,3578747191,43
1,1257,33777,3578747148,3578747192,44
1,1257,33778,3578747148,3578747192,44
1,1257,33779,3578747148,3578747193,45
1,1257,33780,3578747148,3578747193,45
1,1257,33781,3578747148,3578747193,45
1,1257,33782,3578747148,3578747196,48
1,1257,33783,3578747148,3578747196,48
1,1257,33784,3578747148,3578747196,48
1,1257,33785,3578747148,3578747197,49
1,1257,33786,3578747148,3578747197,49
1,1257,33787,3578747148,3578747197,49
1,1258,33788,3578747210,3578747210,0
1,1258,33789,3578747210,3578747210,0
1,1258,33790,3578747210,3578747210,0
1,1258,33791,3578747210,3578747210,0
1,1258,33792,3578747210,3578747210,0
1,1258,33793,3578747210,3578747210,0
1,1258,33794,3578747210,3578747210,0
1,1258,33795,3578747210,3578747210,0
1,1258,33796,3578747210,3578747210,0
1,1258,33797,3578747210,3578747210,0
1,1258,33798,3578747210,3578747211,1
1,1258,33799,3578747210,3578747213,3
1,1258,33800,3578747210,3578747215,5
1,1258,33801,3578747210,3578747215,5
1,1258,33802,3578747210,3578747218,8
1,1258,33803,3578747210,3578747218,8
1,1258,33804,3578747210,3578747219,9
1,1258,33805,3578747210,3578747219,9
1,1258,33806,3578747210,3578747219,9
1,1258,33807,3578747210,3578747221,11
1,1258,33808,3578747210,3578747224,14
1,1258,33809,3578747210,3578747225,15
1,1258,33810,3578747210,3578747226,16
1,1258,33811,3578747210,3578747228,18
1,1258,33812,3578747210,3578747228,18
1,1258,33813,3578747210,3578747228,18
1,1258,33814,3578747210,3578747229,19
1,1258,33815,3578747210,3578747229,19
1,1258,33816,3578747210,3578747229,19
1,1258,33817,3578747210,3578747230,20
1,1258,33818,3578747210,3578747230,20
1,1258,33819,3578747210,3578747232,22
1,1258,33820,3578747210,3578747233,23
1,1258,33821,3578747210,3578747236,26
1,1258,33822,3578747210,3578747236,26
1,1258,33823,3578747210,3578747237,27
1,1258,33824,3578747210,3578747239,29
1,1258,33825,3578747210,3578747240,30
1,1258,33826,3578747210,3578747240,30
1,1258,33827,3578747210,3578747241,31
1,1258,33828,3578747210,3578747242,32
1,1258,33829,3578747210,3578747243,33
1,1258,33830,3578747210,3578747245,35
1,1258,33831,3578747210,3578747245,35
1,1258,33832,3578747210,3578747245,35
1,1258,33833,3578747210,3578747247,37
1,1258,33834,3578747210,3578747248,38
1,1258,33835,3578747210,3578747249,39
1,1258,33836,3578747210,3578747249,39
1,1258,33837,3578747210,3578747251,41
1,1258,33838,3578747210,3578747252,42
1,1258,33839,3578747210,3578747253,43
1,1258,33840,3578747210,3578747253,43
1,1258,33841,3578747210,3578747254,44
1,1258,33842,3578747210,3578747255,45
1,1258,33843,3578747210,3578747256,46
1,1258,33844,3578747210,3578747257,47
1,1258,33845,3578747210,3578747258,48
1,1258,33846,3578747210,3578747260,50
1,1259,33847,3578747272,3578747272,0
1,1259,33848,3578747272,3578747272,0
1,1259,33849,3578747272,3578747272,0
1,1259,33850,3578747272,3578747272,0
1,1259,33851,3578747272,3578747272,0
1,1259,33852,3578747272,3578747272,0
1,1259,33853,3578747272,3578747272,0
1,1259,33854,3578747272,3578747272,0
1,1259,33855,3578747272,3578747272,0
1,1259,33856,3578747272,3578747272,0
1,1259,33857,3578747272,3578747272,0
1,1259,33858,3578747272,3578747276,4
1,1259,33859,3578747272,3578747277,5
1,1259,33860,3578747272,3578747277,5
1,1259,33861,3578747272,3578747281,9
1,1259,33862,3578747272,3578747282,10
1,1259,33863,3578747272,3578747283,11
1,1259,33864,3578747272,3578747285,13
1,1259,33865,3578747272,3578747285,13
1,1259,33866,3578747272,3578747286,14
1,1259,33867,3578747272,3578747287,15
1,1259,33868,3578747272,3578747289,17
1,1259,33869,3578747272,3578747290,18
1,1259,33870,3578747272,3578747290,18
1,1259,33871,3578747272,3578747291,19
1,1259,33872,3578747272,3578747292,20
1,1259,33873,3578747272,3578747293,21
1,1259,33874,3578747272,3578747293,21
1,1259,33875,3578747272,3578747295,23
1,1259,33876,3578747272,3578747295,23
1,1259,33877,3578747272,3578747297,25
1,1259,33878,3578747272,3578747297,25
1,1259,33879,3578747272,3578747297,25
1,1259,33880,3578747272,3578747300,28
1,1259,33881,3578747272,3578747300,28
1,1259,33882,3578747272,3578747300,28
1,1259,33883,3578747272,3578747302,30
1,1259,33884,3578747272,3578747302,30
1,1259,33885,3578747272,3578747302,30
1,1259,33886,3578747272,3578747304,32
1,1259,33887,3578747272,3578747306,34
1,1259,33888,3578747272,3578747306,34
1,1259,33889,3578747272,3578747306,34
1,1259,33890,3578747272,3578747307,35
1,1259,33891,3578747272,3578747308,36
1,1259,33892,3578747272,3578747309,37
1,1259,33893,3578747272,3578747312,40
1,1259,33894,3578747272,3578747312,40
1,1259,33895,3578747272,3578747312,40
1,1259,33896,3578747272,3578747312,40
1,1259,33897,3578747272,3578747313,41
1,1259,33898,3578747272,3578747314,42
1,1259,33899,3578747272,3578747314,42
1,1259,33900,3578747272,3578747315,43
1,1259,33901,3578747272,3578747315,43
1,1259,33902,3578747272,3578747316,44
1,1259,33903,3578747272,3578747316,44
1,1259,33904,3578747272,3578747317,45
1,1259,33905,3578747272,3578747319,47
1,1259,33906,3578747272,3578747320,48
1,1259,33907,3578747272,3578747321,49
1,1259,33908,3578747272,3578747321,49
1,1259,33909,3578747272,3578747322,50
1,1260,33910,3578747334,3578747334,0
1,1260,33911,3578747334,3578747334,0
1,1260,33912,3578747334,3578747334,0
1,1260,33913,3578747334,3578747334,0
1,1260,33914,3578747334,3578747334,0
1,1260,33915,3578747334,3578747334,0
1,1260,33916,3578747334,3578747334,0
1,1260,33917,3578747334,3578747334,0
1,1260,33918,3578747334,3578747334,0
1,1260,33919,3578747334,3578747334,0
1,1260,33920,3578747334,3578747334,0
1,1260,33921,3578747334,3578747334,0
1,1260,33922,3578747334,3578747334,0
1,1260,33923,3578747334,3578747334,0
1,1260,33924,3578747334,3578747334,0
1,1260,33925,3578747334,3578747334,0
1,1260,33926,3578747334,3578747334,0
1,1260,33927,3578747334,3578747334,0
1,1260,33928,3578747334,3578747334,0
1,1260,33929,3578747334,3578747334,0
1,1260,33930,3578747334,3578747334,0
1,1260,33931,3578747334,3578747334,0
1,1260,33932,3578747334,3578747335,1
1,1260,33933,3578747334,3578747335,1
1,1260,33934,3578747334,3578747337,3
1,1260,33935,3578747334,3578747337,3
1,1260,33936,3578747334,3578747337,3
1,1260,33937,3578747334,3578747338,4
1,1260,33938,3578747334,3578747339,5
1,1260,33939,3578747334,3578747342,8
1,1260,33940,3578747334,3578747342,8
1,1260,33941,3578747334,3578747343,9
1,1260,33942,3578747334,3578747345,11
1,1260,33943,3578747334,3578747346,12
1,1260,33944,3578747334,3578747347,13
1,1260,33945,3578747334,3578747347,13
1,1260,33946,3578747334,3578747348,14
1,1260,33947,3578747334,3578747349,15
1,1260,33948,3578747334,3578747349,15
1,1260,33949,3578747334,3578747350,16
1,1260,33950,3578747334,3578747353,19
1,1260,33951,3578747334,3578747353,19
1,1260,33952,3578747334,3578747355,21
1,1260,33953,3578747334,3578747355,21
1,1260,33954,3578747334,3578747356,22
1,1260,33955,3578747334,3578747357,23
1,1260,33956,3578747334,3578747358,24
1,1260,33957,3578747334,3578747361,27
1,1260,33958,3578747334,3578747361,27
1,1260,33959,3578747334,3578747362,28
1,1260,33960,3578747334,3578747362,28
1,1260,33961,3578747334,3578747362,28
1,1260,33962,3578747334,3578747362,28
1,1260,33963,3578747334,3578747363,29
1,1260,33964,3578747334,3578747366,32
1,1260,33965,3578747334,3578747366,32
1,1260,33966,3578747334,3578747366,32
1,1260,33967,3578747334,3578747366,32
1,1260,33968,3578747334,3578747368,34
1,1260,33969,3578747334,3578747368,34
1,1260,33970,3578747334,3578747370,36
1,1260,33971,3578747334,3578747370,36
1,1260,33972,3578747334,3578747371,37
1,1260,33973,3578747334,3578747372,38
1,1260,33974,3578747334,3578747373,39
1,1260,33975,3578747334,3578747376,42
1,1260,33976,3578747334,3578747378,44
1,1260,33977,3578747334,3578747378,44
1,1260,33978,3578747334,3578747379,45
1,1260,33979,3578747334,3578747380,46
1,1260,33980,3578747334,3578747380,46
1,1260,33981,3578747334,3578747380,46
1,1260,33982,3578747334,3578747381,47
1,1260,33983,3578747334,3578747381,47
1,1260,33984,3578747334,3578747382,48
1,1260,33985,3578747334,3578747382,48
1,1260,33986,3578747334,3578747383,49
1,1260,33987,3578747334,3578747383,49
1,1261,33988,3578747396,3578747396,0
1,1261,33989,3578747396,3578747396,0
1,1261,33990,3578747396,3578747396,0
1,1261,33991,3578747396,3578747396,0
1,1261,33992,3578747396,3578747396,0
1,1261,33993,3578747396,3578747396,0
1,1261,33994,3578747396,3578747396,0
1,1261,33995,3578747396,3578747396,0
1,1261,33996,3578747396,3578747396,0
1,1261,33997,3578747396,3578747396,0
1,1261,33998,3578747396,3578747396,0
1,1261,33999,3578747396,3578747396,0
1,1261,34000,3578747396,3578747396,0
1,1261,34001,3578747396,3578747397,1
1,1261,34002,3578747396,3578747397,1
1,1261,34003,3578747396,3578747398,2
1,1261,34004,3578747396,3578747398,2
1,1261,34005,3578747396,3578747399,3
1,1261,34006,3578747396,3578747399,3
1,1261,34007,3578747396,3578747399,3
1,1261,34008,3578747396,3578747400,4
1,1261,34009,3578747396,3578747400,4
1,1261,34010,3578747396,3578747400,4
1,1261,34011,3578747396,3578747403,7
1,1261,34012,3578747396,3578747404,8
1,1261,34013,3578747396,3578747405,9
1,1261,34014,3578747396,3578747411,15
1,1261,34015,3578747396,3578747412,16
1,1261,34016,3578747396,3578747413,17
1,1261,34017,3578747396,3578747413,17
1,1261,34018,3578747396,3578747415,19
1,1261,34019,3578747396,3578747415,19
1,1261,34020,3578747396,3578747416,20
1,1261,34021,3578747396,3578747417,21
1,1261,34022,3578747396,3578747418,22
1,1261,34023,3578747396,3578747419,23
1,1261,34024,3578747396,3578747419,23
1,1261,34025,3578747396,3578747419,23
1,1261,34026,3578747396,3578747420,24
1,1261,34027,3578747396,3578747420,24
1,1261,34028,3578747396,3578747425,29
1,1261,34029,3578747396,3578747425,29
1,1261,34030,3578747396,3578747425,29
1,1261,34031,3578747396,3578747427,31
1,1261,34032,3578747396,3578747427,31
1,1261,34033,3578747396,3578747428,32
1,1261,34034,3578747396,3578747428,32
1,1261,34035,3578747396,3578747429,33
1,1261,34036,3578747396,3578747429,33
1,1261,34037,3578747396,3578747429,33
1,1261,34038,3578747396,3578747429,33
1,1261,34039,3578747396,3578747431,35
1,1261,34040,3578747396,3578747432,36
1,1261,34041,3578747396,3578747433,37
1,1261,34042,3578747396,3578747435,39
1,1261,34043,3578747396,3578747437,41
1,1261,34044,3578747396,3578747437,41
1,1261,34045,3578747396,3578747439,43
1,1261,34046,3578747396,3578747440,44
1,1261,34047,3578747396,3578747443,47
1,1261,34048,3578747396,3578747445,49
1,1261,34049,3578747396,3578747445,49
1,1261,34050,3578747396,3578747445,49
1,1262,34051,3578747459,3578747459,0
1,1262,34052,3578747459,3578747459,0
1,1262,34053,3578747459,3578747459,0
1,1262,34054,3578747459,3578747459,0
1,1262,34055,3578747459,3578747459,0
1,1262,34056,3578747459,3578747459,0
1,1262,34057,3578747459,3578747459,0
1,1262,34058,3578747459,3578747459,0
1,1262,34059,3578747459,3578747459,0
1,1262,34060,3578747459,3578747459,0
1,1262,34061,3578747459,3578747459,0
1,1262,34062,3578747459,3578747459,0
1,1262,34063,3578747459,3578747459,0
1,1262,34064,3578747459,3578747460,1
1,1262,34065,3578747459,3578747463,4
1,1262,34066,3578747459,3578747463,4
1,1262,34067,3578747459,3578747463,4
1,1262,34068,3578747459,3578747464,5
1,1262,34069,3578747459,3578747465,6
1,1262,34070,3578747459,3578747465,6
1,1262,34071,3578747459,3578747467,8
1,1262,34072,3578747459,3578747468,9
1,1262,34073,3578747459,3578747469,10
1,1262,34074,3578747459,3578747469,10
1,1262,34075,3578747459,3578747469,10
1,1262,34076,3578747459,3578747470,11
1,1262,34077,3578747459,3578747476,17
1,1262,34078,3578747459,3578747477,18
1,1262,34079,3578747459,3578747477,18
1,1262,34080,3578747459,3578747480,21
1,1262,34081,3578747459,3578747482,23
1,1262,34082,3578747459,3578747483,24
1,1262,34083,3578747459,3578747484,25
1,1262,34084,3578747459,3578747485,26
1,1262,34085,3578747459,3578747486,27
1,1262,34086,3578747459,3578747486,27
1,1262,34087,3578747459,3578747489,30
1,1262,34088,3578747459,3578747490,31
1,1262,34089,3578747459,3578747490,31
1,1262,34090,3578747459,3578747492,33
1,1262,34091,3578747459,3578747493,34
1,1262,34092,3578747459,3578747494,35
1,1262,34093,3578747459,3578747495,36
1,1262,34094,3578747459,3578747495,36
1,1262,34095,3578747459,3578747496,37
1,1262,34096,3578747459,3578747498,39
1,1262,34097,3578747459,3578747498,39
1,1262,34098,3578747459,3578747499,40
1,1262,34099,3578747459,3578747500,41
1,1262,34100,3578747459,3578747502,43
1,1262,34101,3578747459,3578747502,43
1,1262,34102,3578747459,3578747503,44
1,1262,34103,3578747459,3578747506,47
1,1262,34104,3578747459,3578747506,47
1,1262,34105,3578747459,3578747506,47
1,1262,34106,3578747459,3578747506,47
1,1262,34107,3578747459,3578747508,49
1,1262,34108,3578747459,3578747509,50
1,1263,34109,3578747523,3578747523,0
1,1263,34110,3578747523,3578747523,0
1,1263,34111,3578747523,3578747523,0
1,1263,34112,3578747523,3578747523,0
1,1263,34113,3578747523,3578747523,0
1,1263,34114,3578747523,3578747523,0
1,1263,34115,3578747523,3578747523,0
1,1263,34116,3578747523,3578747523,0
1,1263,34117,3578747523,3578747523,0
1,1263,34118,3578747523,3578747523,0
1,1263,34119,3578747523,3578747523,0
1,1263,34120,3578747523,3578747523,0
1,1263,34121,3578747523,3578747523,0
1,1263,34122,3578747523,3578747523,0
1,1263,34123,3578747523,3578747523,0
1,1263,34124,3578747523,3578747524,1
1,1263,34125,3578747523,3578747524,1
1,1263,34126,3578747523,3578747524,1
1,1263,34127,3578747523,3578747526,3
1,1263,34128,3578747523,3578747526,3
1,1263,34129,3578747523,3578747526,3
1,1263,34130,3578747523,3578747527,4
1,1263,34131,3578747523,3578747528,5
1,1263,34132,3578747523,3578747529,6
1,1263,34133,3578747523,3578747529,6
1,1263,34134,3578747523,3578747530,7
1,1263,34135,3578747523,3578747530,7
1,1263,34136,3578747523,3578747531,8
1,1263,34137,3578747523,3578747531,8
1,1263,34138,3578747523,3578747532,9
1,1263,34139,3578747523,3578747533,10
1,1263,34140,3578747523,3578747533,10
1,1263,34141,3578747523,3578747533,10
1,1263,34142,3578747523,3578747534,11
1,1263,34143,3578747523,3578747534,11
1,1263,34144,3578747523,3578747535,12
1,1263,34145,3578747523,3578747536,13
1,1263,34146,3578747523,3578747536,13
1,1263,34147,3578747523,3578747536,13
1,1263,34148,3578747523,3578747537,14
1,1263,34149,3578747523,3578747537,14
1,1263,34150,3578747523,3578747538,15
1,1263,34151,3578747523,3578747540,17
1,1263,34152,3578747523,3578747541,18
1,1263,34153,3578747523,3578747542,19
1,1263,34154,3578747523,3578747542,19
1,1263,34155,3578747523,3578747544,21
1,1263,34156,3578747523,3578747545,22
1,1263,34157,3578747523,3578747546,23
1,1263,34158,3578747523,3578747547,24
1,1263,34159,3578747523,3578747547,24
1,1263,34160,3578747523,3578747548,25
1,1263,34161,3578747523,3578747549,26
1,1263,34162,3578747523,3578747550,27
1,1263,34163,3578747523,3578747552,29
1,1263,34164,3578747523,3578747553,30
1,1263,34165,3578747523,3578747553,30
1,1263,34166,3578747523,3578747554,31
1,1263,34167,3578747523,3578747555,32
1,1263,34168,3578747523,3578747557,34
1,1263,34169,3578747523,3578747557,34
1,1263,34170,3578747523,3578747560,37
1,1263,34171,3578747523,3578747561,38
1,1263,34172,3578747523,3578747561,38
1,1263,34173,3578747523,3578747561,38
1,1263,34174,3578747523,3578747561,38
1,1263,34175,3578747523,3578747562,39
1,1263,34176,3578747523,3578747565,42
1,1263,34177,3578747523,3578747565,42
1,1263,34178,3578747523,3578747565,42
1,1263,34179,3578747523,3578747566,43
1,1263,34180,3578747523,3578747567,44
1,1263,34181,3578747523,3578747568,45
1,1263,34182,3578747523,3578747569,46
1,1263,34183,3578747523,3578747570,47
1,1263,34184,3578747523,3578747570,47
1,1263,34185,3578747523,3578747571,48
1,1263,34186,3578747523,3578747572,49
1,1264,34187,3578747585,3578747585,0
1,1264,34188,3578747585,3578747585,0
1,1264,34189,3578747585,3578747585,0
1,1264,34190,3578747585,3578747585,0
1,1264,34191,3578747585,3578747585,0
1,1264,34192,3578747585,3578747585,0
1,1264,34193,3578747585,3578747585,0
1,1264,34194,3578747585,3578747585,0
1,1264,34195,3578747585,3578747585,0
1,1264,34196,3578747585,3578747585,0
1,1264,34197,3578747585,3578747585,0
1,1264,34198,3578747585,3578747585,0
1,1264,34199,3578747585,3578747585,0
1,1264,34200,3578747585,3578747585,0
1,1264,34201,3578747585,3578747585,0
1,1264,34202,3578747585,3578747589,4
1,1264,34203,3578747585,3578747589,4
1,1264,34204,3578747585,3578747591,6
1,1264,34205,3578747585,3578747592,7
1,1264,34206,3578747585,3578747592,7
1,1264,34207,3578747585,3578747592,7
1,1264,34208,3578747585,3578747594,9
1,1264,34209,3578747585,3578747595,10
1,1264,34210,3578747585,3578747596,11
1,1264,34211,3578747585,3578747596,11
1,1264,34212,3578747585,3578747596,11
1,1264,34213,3578747585,3578747597,12
1,1264,34214,3578747585,3578747597,12
1,1264,34215,3578747585,3578747597,12
1,1264,34216,3578747585,3578747597,12
1,1264,34217,3578747585,3578747599,14
1,1264,34218,3578747585,3578747599,14
1,1264,34219,3578747585,3578747599,14
1,1264,34220,3578747585,3578747599,14
1,1264,34221,3578747585,3578747600,15
1,1264,34222,3578747585,3578747602,17
1,1264,34223,3578747585,3578747602,17
1,1264,34224,3578747585,3578747605,20
1,1264,34225,3578747585,3578747609,24
1,1264,34226,3578747585,3578747611,26
1,1264,34227,3578747585,3578747612,27
1,1264,34228,3578747585,3578747613,28
1,1264,34229,3578747585,3578747614,29
1,1264,34230,3578747585,3578747614,29
1,1264,34231,3578747585,3578747616,31
1,1264,34232,3578747585,3578747616,31
1,1264,34233,3578747585,3578747616,31
1,1264,34234,3578747585,3578747617,32
1,1264,34235,3578747585,3578747618,33
1,1264,34236,3578747585,3578747618,33
1,1264,34237,3578747585,3578747618,33
1,1264,34238,3578747585,3578747619,34
1,1264,34239,3578747585,3578747620,35
1,1264,34240,3578747585,3578747624,39
1,1264,34241,3578747585,3578747624,39
1,1264,34242,3578747585,3578747624,39
1,1264,34243,3578747585,3578747625,40
1,1264,34244,3578747585,3578747627,42
1,1264,34245,3578747585,3578747628,43
1,1264,34246,3578747585,3578747628,43
1,1264,34247,3578747585,3578747628,43
1,1264,34248,3578747585,3578747628,43
1,1264,34249,3578747585,3578747629,44
1,1264,34250,3578747585,3578747629,44
1,1264,34251,3578747585,3578747631,46
1,1265,34252,3578747646,3578747646,0
1,1265,34253,3578747646,3578747646,0
1,1265,34254,3578747646,3578747646,0
1,1265,34255,3578747646,3578747646,0
1,1265,34256,3578747646,3578747646,0
1,1265,34257,3578747646,3578747646,0
1,1265,34258,3578747646,3578747646,0
1,1265,34259,3578747646,3578747646,0
1,1265,34260,3578747646,3578747646,0
1,1265,34261,3578747646,3578747646,0
1,1265,34262,3578747646,3578747647,1
1,1265,34263,3578747646,3578747648,2
1,1265,34264,3578747646,3578747649,3
1,1265,34265,3578747646,3578747651,5
1,1265,34266,3578747646,3578747652,6
1,1265,34267,3578747646,3578747653,7
1,1265,34268,3578747646,3578747653,7
1,1265,34269,3578747646,3578747655,9
1,1265,34270,3578747646,3578747656,10
1,1265,34271,3578747646,3578747657,11
1,1265,34272,3578747646,3578747657,11
1,1265,34273,3578747646,3578747659,13
1,1265,34274,3578747646,3578747660,14
1,1265,34275,3578747646,3578747662,16
1,1265,34276,3578747646,3578747662,16
1,1265,34277,3578747646,3578747663,17
1,1265,34278,3578747646,3578747664,18
1,1265,34279,3578747646,3578747664,18
1,1265,34280,3578747646,3578747667,21
1,1265,34281,3578747646,3578747668,22
1,1265,34282,3578747646,3578747668,22
1,1265,34283,3578747646,3578747668,22
1,1265,34284,3578747646,3578747669,23
1,1265,34285,3578747646,3578747677,31
1,1265,34286,3578747646,3578747677,31
1,1265,34287,3578747646,3578747680,34
1,1265,34288,3578747646,3578747683,37
1,1265,34289,3578747646,3578747683,37
1,1265,34290,3578747646,3578747684,38
1,1265,34291,3578747646,3578747684,38
1,1265,34292,3578747646,3578747685,39
1,1265,34293,3578747646,3578747685,39
1,1265,34294,3578747646,3578747686,40
1,1265,34295,3578747646,3578747689,43
1,1265,34296,3578747646,3578747690,44
1,1265,34297,3578747646,3578747691,45
1,1265,34298,3578747646,3578747692,46
1,1265,34299,3578747646,3578747693,47
1,1265,34300,3578747646,3578747693,47
1,1265,34301,3578747646,3578747695,49
1,1265,34302,3578747646,3578747696,50
1,1266,34303,3578747710,3578747710,0
1,1266,34304,3578747710,3578747710,0
1,1266,34305,3578747710,3578747710,0
1,1266,34306,3578747710,3578747710,0
1,1266,34307,3578747710,3578747710,0
1,1266,34308,3578747710,3578747710,0
1,1266,34309,3578747710,3578747710,0
1,1266,34310,3578747710,3578747710,0
1,1266,34311,3578747710,3578747710,0
1,1266,34312,3578747710,3578747710,0
1,1266,34313,3578747710,3578747710,0
1,1266,34314,3578747710,3578747710,0
1,1266,34315,3578747710,3578747710,0
1,1266,34316,3578747710,3578747710,0
1,1266,34317,3578747710,3578747710,0
1,1266,34318,3578747710,3578747710,0
1,1266,34319,3578747710,3578747711,1
1,1266,34320,3578747710,3578747711,1
1,1266,34321,3578747710,3578747711,1
1,1266,34322,3578747710,3578747713,3
1,1266,34323,3578747710,3578747713,3
1,1266,34324,3578747710,3578747713,3
1,1266,34325,3578747710,3578747714,4
1,1266,34326,3578747710,3578747715,5
1,1266,34327,3578747710,3578747715,5
1,1266,34328,3578747710,3578747716,6
1,1266,34329,3578747710,3578747717,7
1,1266,34330,3578747710,3578747718,8
1,1266,34331,3578747710,3578747719,9
1,1266,34332,3578747710,3578747720,10
1,1266,34333,3578747710,3578747721,11
1,1266,34334,3578747710,3578747721,11
1,1266,34335,3578747710,3578747722,12
1,1266,34336,3578747710,3578747723,13
1,1266,34337,3578747710,3578747724,14
1,1266,34338,3578747710,3578747724,14
1,1266,34339,3578747710,3578747724,14
1,1266,34340,3578747710,3578747726,16
1,1266,34341,3578747710,3578747726,16
1,1266,34342,3578747710,3578747727,17
1,1266,34343,3578747710,3578747727,17
1,1266,34344,3578747710,3578747728,18
1,1266,34345,3578747710,3578747729,19
1,1266,34346,3578747710,3578747729,19
1,1266,34347,3578747710,3578747730,20
1,1266,34348,3578747710,3578747730,20
1,1266,34349,3578747710,3578747731,21
1,1266,34350,3578747710,3578747732,22
1,1266,34351,3578747710,3578747732,22
1,1266,34352,3578747710,3578747733,23
1,1266,34353,3578747710,3578747733,23
1,1266,34354,3578747710,3578747734,24
1,1266,34355,3578747710,3578747734,24
1,1266,34356,3578747710,3578747734,24
1,1266,34357,3578747710,3578747735,25
1,1266,34358,3578747710,3578747736,26
1,1266,34359,3578747710,3578747736,26
1,1266,34360,3578747710,3578747736,26
1,1266,34361,3578747710,3578747737,27
1,1266,34362,3578747710,3578747738,28
1,1266,34363,3578747710,3578747738,28
1,1266,34364,3578747710,3578747741,31
1,1266,34365,3578747710,3578747741,31
1,1266,34366,3578747710,3578747742,32
1,1266,34367,3578747710,3578747742,32
1,1266,34368,3578747710,3578747744,34
1,1266,34369,3578747710,3578747745,35
1,1266,34370,3578747710,3578747746,36
1,1266,34371,3578747710,3578747747,37
1,1266,34372,3578747710,3578747749,39
1,1266,34373,3578747710,3578747749,39
1,1266,34374,3578747710,3578747750,40
1,1266,34375,3578747710,3578747752,42
1,1266,34376,3578747710,3578747753,43
1,1266,34377,3578747710,3578747753,43
1,1266,34378,3578747710,3578747754,44
1,1266,34379,3578747710,3578747755,45
1,1266,34380,3578747710,3578747757,47
1,1266,34381,3578747710,3578747758,48
1,1266,34382,3578747710,3578747760,50
1,1267,34383,3578747772,3578747772,0
1,1267,34384,3578747772,3578747772,0
1,1267,34385,3578747772,3578747772,0
1,1267,34386,3578747772,3578747772,0
1,1267,34387,3578747772,3578747772,0
1,1267,34388,3578747772,3578747772,0
1,1267,34389,3578747772,3578747772,0
1,1267,34390,3578747772,3578747772,0
1,1267,34391,3578747772,3578747772,0
1,1267,34392,3578747772,3578747772,0
1,1267,34393,3578747772,3578747772,0
1,1267,34394,3578747772,3578747772,0
1,1267,34395,3578747772,3578747772,0
1,1267,34396,3578747772,3578747772,0
1,1267,34397,3578747772,3578747772,0
1,1267,34398,3578747772,3578747775,3
1,1267,34399,3578747772,3578747776,4
1,1267,34400,3578747772,3578747778,6
1,1267,34401,3578747772,3578747778,6
1,1267,34402,3578747772,3578747779,7
1,1267,34403,3578747772,3578747779,7
1,1267,34404,3578747772,3578747779,7
1,1267,34405,3578747772,3578747780,8
1,1267,34406,3578747772,3578747781,9
1,1267,34407,3578747772,3578747781,9
1,1267,34408,3578747772,3578747782,10
1,1267,34409,3578747772,3578747783,11
1,1267,34410,3578747772,3578747784,12
1,1267,34411,3578747772,3578747784,12
1,1267,34412,3578747772,3578747786,14
1,1267,34413,3578747772,3578747788,16
1,1267,34414,3578747772,3578747790,18
1,1267,34415,3578747772,3578747791,19
1,1267,34416,3578747772,3578747792,20
1,1267,34417,3578747772,3578747792,20
1,1267,34418,3578747772,3578747792,20
1,1267,34419,3578747772,3578747794,22
1,1267,34420,3578747772,3578747794,22
1,1267,34421,3578747772,3578747796,24
1,1267,34422,3578747772,3578747796,24
1,1267,34423,3578747772,3578747797,25
1,1267,34424,3578747772,3578747797,25
1,1267,34425,3578747772,3578747797,25
1,1267,34426,3578747772,3578747798,26
1,1267,34427,3578747772,3578747798,26
1,1267,34428,3578747772,3578747799,27
1,1267,34429,3578747772,3578747799,27
1,1267,34430,3578747772,3578747800,28
1,1267,34431,3578747772,3578747800,28
1,1267,34432,3578747772,3578747802,30
1,1267,34433,3578747772,3578747802,30
1,1267,34434,3578747772,3578747806,34
1,1267,34435,3578747772,3578747810,38
1,1267,34436,3578747772,3578747811,39
1,1267,34437,3578747772,3578747811,39
1,1267,34438,3578747772,3578747814,42
1,1267,34439,3578747772,3578747814,42
1,1267,34440,3578747772,3578747815,43
1,1267,34441,3578747772,3578747815,43
1,1267,34442,3578747772,3578747816,44
1,1267,34443,3578747772,3578747816,44
1,1267,34444,3578747772,3578747817,45
1,1267,34445,3578747772,3578747818,46
1,1267,34446,3578747772,3578747818,46
1,1267,34447,3578747772,3578747818,46
1,1267,34448,3578747772,3578747821,49
1,1268,34449,3578747834,3578747834,0
1,1268,34450,3578747834,3578747834,0
1,1268,34451,3578747834,3578747834,0
1,1268,34452,3578747834,3578747834,0
1,1268,34453,3578747834,3578747834,0
1,1268,34454,3578747834,3578747834,0
1,1268,34455,3578747834,3578747834,0
1,1268,34456,3578747834,3578747834,0
1,1268,34457,3578747834,3578747834,0
1,1268,34458,3578747834,3578747834,0
1,1268,34459,3578747834,3578747834,0
1,1268,34460,3578747834,3578747836,2
1,1268,34461,3578747834,3578747839,5
1,1268,34462,3578747834,3578747839,5
1,1268,34463,3578747834,3578747839,5
1,1268,34464,3578747834,3578747842,8
1,1268,34465,3578747834,3578747843,9
1,1268,34466,3578747834,3578747844,10
1,1268,34467,3578747834,3578747844,10
1,1268,34468,3578747834,3578747844,10
1,1268,34469,3578747834,3578747845,11
1,1268,34470,3578747834,3578747847,13
1,1268,34471,3578747834,3578747848,14
1,1268,34472,3578747834,3578747848,14
1,1268,34473,3578747834,3578747849,15
1,1268,34474,3578747834,3578747850,16
1,1268,34475,3578747834,3578747852,18
1,1268,34476,3578747834,3578747853,19
1,1268,34477,3578747834,3578747853,19
1,1268,34478,3578747834,3578747855,21
1,1268,34479,3578747834,3578747856,22
1,1268,34480,3578747834,3578747856,22
1,1268,34481,3578747834,3578747857,23
1,1268,34482,3578747834,3578747860,26
1,1268,34483,3578747834,3578747860,26
1,1268,34484,3578747834,3578747861,27
1,1268,34485,3578747834,3578747862,28
1,1268,34486,3578747834,3578747863,29
1,1268,34487,3578747834,3578747863,29
1,1268,34488,3578747834,3578747864,30
1,1268,34489,3578747834,3578747864,30
1,1268,34490,3578747834,3578747867,33
1,1268,34491,3578747834,3578747868,34
1,1268,34492,3578747834,3578747868,34
1,1268,34493,3578747834,3578747868,34
1,1268,34494,3578747834,3578747869,35
1,1268,34495,3578747834,3578747878,44
1,1268,34496,3578747834,3578747878,44
1,1268,34497,3578747834,3578747881,47
1,1268,34498,3578747834,3578747883,49
1,1269,34499,3578747897,3578747897,0
1,1269,34500,3578747897,3578747897,0
1,1269,34501,3578747897,3578747897,0
1,1269,34502,3578747897,3578747897,0
1,1269,34503,3578747897,3578747897,0
1,1269,34504,3578747897,3578747897,0
1,1269,34505,3578747897,3578747897,0
1,1269,34506,3578747897,3578747897,0
1,1269,34507,3578747897,3578747897,0
1,1269,34508,3578747897,3578747897,0
1,1269,34509,3578747897,3578747897,0
1,1269,34510,3578747897,3578747897,0
1,1269,34511,3578747897,3578747897,0
1,1269,34512,3578747897,3578747897,0
1,1269,34513,3578747897,3578747898,1
1,1269,34514,3578747897,3578747899,2
1,1269,34515,3578747897,3578747899,2
1,1269,34516,3578747897,3578747899,2
1,1269,34517,3578747897,3578747900,3
1,1269,34518,3578747897,3578747900,3
1,1269,34519,3578747897,3578747901,4
1,1269,34520,3578747897,3578747902,5
1,1269,34521,3578747897,3578747902,5
1,1269,34522,3578747897,3578747902,5
1,1269,34523,3578747897,3578747903,6
1,1269,34524,3578747897,3578747906,9
1,1269,34525,3578747897,3578747906,9
1,1269,34526,3578747897,3578747907,10
1,1269,34527,3578747897,3578747907,10
1,1269,34528,3578747897,3578747908,11
1,1269,34529,3578747897,3578747909,12
1,1269,34530,3578747897,3578747911,14
1,1269,34531,3578747897,3578747911,14
1,1269,34532,3578747897,3578747911,14
1,1269,34533,3578747897,3578747913,16
1,1269,34534,3578747897,3578747914,17
1,1269,34535,3578747897,3578747914,17
1,1269,34536,3578747897,3578747914,17
1,1269,34537,3578747897,3578747915,18
1,1269,34538,3578747897,3578747915,18
1,1269,34539,3578747897,3578747917,20
1,1269,34540,3578747897,3578747917,20
1,1269,34541,3578747897,3578747918,21
1,1269,34542,3578747897,3578747920,23
1,1269,34543,3578747897,3578747921,24
1,1269,34544,3578747897,3578747921,24
1,1269,34545,3578747897,3578747921,24
1,1269,34546,3578747897,3578747922,25
1,1269,34547,3578747897,3578747924,27
1,1269,34548,3578747897,3578747924,27
1,1269,34549,3578747897,3578747924,27
1,1269,34550,3578747897,3578747926,29
1,1269,34551,3578747897,3578747926,29
1,1269,34552,3578747897,3578747927,30
1,1269,34553,3578747897,3578747928,31
1,1269,34554,3578747897,3578747929,32
1,1269,34555,3578747897,3578747929,32
1,1269,34556,3578747897,3578747929,32
1,1269,34557,3578747897,3578747931,34
1,1269,34558,3578747897,3578747931,34
1,1269,34559,3578747897,3578747931,34
1,1269,34560,3578747897,3578747932,35
1,1269,34561,3578747897,3578747932,35
1,1269,34562,3578747897,3578747933,36
1,1269,34563,3578747897,3578747933,36
1,1269,34564,3578747897,3578747934,37
1,1269,34565,3578747897,3578747935,38
1,1269,34566,3578747897,3578747935,38
1,1269,34567,3578747897,3578747935,38
1,1269,34568,3578747897,3578747936,39
1,1269,34569,3578747897,3578747936,39
1,1269,34570,3578747897,3578747936,39
1,1269,34571,3578747897,3578747937,40
1,1269,34572,3578747897,3578747938,41
1,1269,34573,3578747897,3578747941,44
1,1269,34574,3578747897,3578747942,45
1,1269,34575,3578747897,3578747942,45
1,1269,34576,3578747897,3578747944,47
1,1269,34577,3578747897,3578747946,49
1,1269,34578,3578747897,3578747946,49
1,1270,34579,3578747959,3578747959,0
1,1270,34580,3578747959,3578747959,0
1,1270,34581,3578747959,3578747959,0
1,1270,34582,3578747959,3578747959,0
1,1270,34583,3578747959,3578747959,0
1,1270,34584,3578747959,3578747959,0
1,1270,34585,3578747959,3578747959,0
1,1270,34586,3578747959,3578747959,0
1,1270,34587,3578747959,3578747959,0
1,1270,34588,3578747959,3578747959,0
1,1270,34589,3578747959,3578747960,1
1,1270,34590,3578747959,3578747962,3
1,1270,34591,3578747959,3578747962,3
1,1270,34592,3578747959,3578747962,3
1,1270,34593,3578747959,3578747962,3
1,1270,34594,3578747959,3578747963,4
1,1270,34595,3578747959,3578747965,6
1,1270,34596,3578747959,3578747966,7
1,1270,34597,3578747959,3578747966,7
1,1270,34598,3578747959,3578747967,8
1,1270,34599,3578747959,3578747968,9
1,1270,34600,3578747959,3578747970,11
1,1270,34601,3578747959,3578747970,11
1,1270,34602,3578747959,3578747971,12
1,1270,34603,3578747959,3578747972,13
1,1270,34604,3578747959,3578747974,15
1,1270,34605,3578747959,3578747976,17
1,1270,34606,3578747959,3578747978,19
1,1270,34607,3578747959,3578747979,20
1,1270,34608,3578747959,3578747979,20
1,1270,34609,3578747959,3578747979,20
1,1270,34610,3578747959,3578747980,21
1,1270,34611,3578747959,3578747980,21
1,1270,34612,3578747959,3578747981,22
1,1270,34613,3578747959,3578747982,23
1,1270,34614,3578747959,3578747983,24
1,1270,34615,3578747959,3578747984,25
1,1270,34616,3578747959,3578747985,26
1,1270,34617,3578747959,3578747986,27
1,1270,34618,3578747959,3578747988,29
1,1270,34619,3578747959,3578747990,31
1,1270,34620,3578747959,3578747991,32
1,1270,34621,3578747959,3578747992,33
1,1270,34622,3578747959,3578747992,33
1,1270,34623,3578747959,3578747992,33
1,1270,34624,3578747959,3578747993,34
1,1270,34625,3578747959,3578747994,35
1,1270,34626,3578747959,3578747996,37
1,1270,34627,3578747959,3578747996,37
1,1270,34628,3578747959,3578747997,38
1,1270,34629,3578747959,3578747997,38
1,1270,34630,3578747959,3578747997,38
1,1270,34631,3578747959,3578747997,38
1,1270,34632,3578747959,3578747997,38
1,1270,34633,3578747959,3578747998,39
1,1270,34634,3578747959,3578747999,40
1,1270,34635,3578747959,3578747999,40
1,1270,34636,3578747959,3578747999,40
1,1270,34637,3578747959,3578747999,40
1,1270,34638,3578747959,3578748001,42
1,1270,34639,3578747959,3578748002,43
1,1270,34640,3578747959,3578748002,43
1,1270,34641,3578747959,3578748003,44
1,1270,34642,3578747959,3578748006,47
1,1271,34643,3578748022,3578748022,0
1,1271,34644,3578748022,3578748022,0
1,1271,34645,3578748022,3578748022,0
1,1271,34646,3578748022,3578748022,0
1,1271,34647,3578748022,3578748022,0
1,1271,34648,3578748022,3578748022,0
1,1271,34649,3578748022,3578748022,0
1,1271,34650,3578748022,3578748022,0
1,1271,34651,3578748022,3578748022,0
1,1271,34652,3578748022,3578748022,0
1,1271,34653,3578748022,3578748022,0
1,1271,34654,3578748022,3578748022,0
1,1271,34655,3578748022,3578748022,0
1,1271,34656,3578748022,3578748022,0
1,1271,34657,3578748022,3578748024,2
1,1271,34658,3578748022,3578748024,2
1,1271,34659,3578748022,3578748024,2
1,1271,34660,3578748022,3578748027,5
1,1271,34661,3578748022,3578748027,5
1,1271,34662,3578748022,3578748029,7
1,1271,34663,3578748022,3578748030,8
1,1271,34664,3578748022,3578748030,8
1,1271,34665,3578748022,3578748031,9
1,1271,34666,3578748022,3578748032,10
1,1271,34667,3578748022,3578748036,14
1,1271,34668,3578748022,3578748036,14
1,1271,34669,3578748022,3578748039,17
1,1271,34670,3578748022,3578748039,17
1,1271,34671,3578748022,3578748039,17
1,1271,34672,3578748022,3578748043,21
1,1271,34673,3578748022,3578748043,21
1,1271,34674,3578748022,3578748044,22
1,1271,34675,3578748022,3578748044,22
1,1271,34676,3578748022,3578748045,23
1,1271,34677,3578748022,3578748045,23
1,1271,34678,3578748022,3578748047,25
1,1271,34679,3578748022,3578748048,26
1,1271,34680,3578748022,3578748049,27
1,1271,34681,3578748022,3578748050,28
1,1271,34682,3578748022,3578748050,28
1,1271,34683,3578748022,3578748052,30
1,1271,34684,3578748022,3578748053,31
1,1271,34685,3578748022,3578748054,32
1,1271,34686,3578748022,3578748056,34
1,1271,34687,3578748022,3578748056,34
1,1271,34688,3578748022,3578748057,35
1,1271,34689,3578748022,3578748057,35
1,1271,34690,3578748022,3578748059,37
1,1271,34691,3578748022,3578748060,38
1,1271,34692,3578748022,3578748062,40
1,1271,34693,3578748022,3578748063,41
1,1271,34694,3578748022,3578748063,41
1,1271,34695,3578748022,3578748064,42
1,1271,34696,3578748022,3578748064,42
1,1271,34697,3578748022,3578748065,43
1,1271,34698,3578748022,3578748068,46
1,1271,34699,3578748022,3578748068,46
1,1271,34700,3578748022,3578748068,46
1,1271,34701,3578748022,3578748069,47
1,1272,34702,3578748083,3578748083,0
1,1272,34703,3578748083,3578748083,0
1,1272,34704,3578748083,3578748083,0
1,1272,34705,3578748083,3578748083,0
1,1272,34706,3578748083,3578748083,0
1,1272,34707,3578748083,3578748084,1
1,1272,34708,3578748083,3578748085,2
1,1272,34709,3578748083,3578748086,3
1,1272,34710,3578748083,3578748087,4
1,1272,34711,3578748083,3578748089,6
1,1272,34712,3578748083,3578748090,7
1,1272,34713,3578748083,3578748090,7
1,1272,34714,3578748083,3578748091,8
1,1272,34715,3578748083,3578748092,9
1,1272,34716,3578748083,3578748093,10
1,1272,34717,3578748083,3578748094,11
1,1272,34718,3578748083,3578748096,13
1,1272,34719,3578748083,3578748097,14
1,1272,34720,3578748083,3578748097,14
1,1272,34721,3578748083,3578748098,15
1,1272,34722,3578748083,3578748099,16
1,1272,34723,3578748083,3578748100,17
1,1272,34724,3578748083,3578748100,17
1,1272,34725,3578748083,3578748100,17
1,1272,34726,3578748083,3578748102,19
1,1272,34727,3578748083,3578748102,19
1,1272,34728,3578748083,3578748102,19
1,1272,34729,3578748083,3578748102,19
1,1272,34730,3578748083,3578748104,21
1,1272,34731,3578748083,3578748106,23
1,1272,34732,3578748083,3578748106,23
1,1272,34733,3578748083,3578748107,24
1,1272,34734,3578748083,3578748107,24
1,1272,34735,3578748083,3578748108,25
1,1272,34736,3578748083,3578748108,25
1,1272,34737,3578748083,3578748111,28
1,1272,34738,3578748083,3578748112,29
1,1272,34739,3578748083,3578748112,29
1,1272,34740,3578748083,3578748112,29
1,1272,34741,3578748083,3578748113,30
1,1272,34742,3578748083,3578748114,31
1,1272,34743,3578748083,3578748114,31
1,1272,34744,3578748083,3578748115,32
1,1272,34745,3578748083,3578748115,32
1,1272,34746,3578748083,3578748117,34
1,1272,34747,3578748083,3578748117,34
1,1272,34748,3578748083,3578748119,36
1,1272,34749,3578748083,3578748120,37
1,1272,34750,3578748083,3578748121,38
1,1272,34751,3578748083,3578748121,38
1,1272,34752,3578748083,3578748121,38
1,1272,34753,3578748083,3578748122,39
1,1272,34754,3578748083,3578748124,41
1,1272,34755,3578748083,3578748125,42
1,1272,34756,3578748083,3578748125,42
1,1272,34757,3578748083,3578748125,42
1,1272,34758,3578748083,3578748126,43
1,1272,34759,3578748083,3578748127,44
1,1272,34760,3578748083,3578748127,44
1,1272,34761,3578748083,3578748128,45
1,1272,34762,3578748083,3578748129,46
1,1272,34763,3578748083,3578748129,46
1,1272,34764,3578748083,3578748129,46
1,1272,34765,3578748083,3578748131,48
1,1272,34766,3578748083,3578748131,48
1,1272,34767,3578748083,3578748131,48
1,1272,34768,3578748083,3578748132,49
1,1272,34769,3578748083,3578748132,49
1,1272,34770,3578748083,3578748133,50
1,1273,34771,3578748146,3578748146,0
1,1273,34772,3578748146,3578748146,0
1,1273,34773,3578748146,3578748146,0
1,1273,34774,3578748146,3578748146,0
1,1273,34775,3578748146,3578748146,0
1,1273,34776,3578748146,3578748146,0
1,1273,34777,3578748146,3578748146,0
1,1273,34778,3578748146,3578748146,0
1,1273,34779,3578748146,3578748146,0
1,1273,34780,3578748146,3578748146,0
1,1273,34781,3578748146,3578748146,0
1,1273,34782,3578748146,3578748146,0
1,1273,34783,3578748146,3578748146,0
1,1273,34784,3578748146,3578748146,0
1,1273,34785,3578748146,3578748146,0
1,1273,34786,3578748146,3578748147,1
1,1273,34787,3578748146,3578748148,2
1,1273,34788,3578748146,3578748148,2
1,1273,34789,3578748146,3578748150,4
1,1273,34790,3578748146,3578748151,5
1,1273,34791,3578748146,3578748152,6
1,1273,34792,3578748146,3578748153,7
1,1273,34793,3578748146,3578748153,7
1,1273,34794,3578748146,3578748154,8
1,1273,34795,3578748146,3578748155,9
1,1273,34796,3578748146,3578748156,10
1,1273,34797,3578748146,3578748157,11
1,1273,34798,3578748146,3578748158,12
1,1273,34799,3578748146,3578748160,14
1,1273,34800,3578748146,3578748161,15
1,1273,34801,3578748146,3578748162,16
1,1273,34802,3578748146,3578748162,16
1,1273,34803,3578748146,3578748163,17
1,1273,34804,3578748146,3578748163,17
1,1273,34805,3578748146,3578748165,19
1,1273,34806,3578748146,3578748166,20
1,1273,34807,3578748146,3578748166,20
1,1273,34808,3578748146,3578748167,21
1,1273,34809,3578748146,3578748167,21
1,1273,34810,3578748146,3578748167,21
1,1273,34811,3578748146,3578748170,24
1,1273,34812,3578748146,3578748170,24
1,1273,34813,3578748146,3578748171,25
1,1273,34814,3578748146,3578748172,26
1,1273,34815,3578748146,3578748175,29
1,1273,34816,3578748146,3578748177,31
1,1273,34817,3578748146,3578748178,32
1,1273,34818,3578748146,3578748178,32
1,1273,34819,3578748146,3578748179,33
1,1273,34820,3578748146,3578748179,33
1,1273,34821,3578748146,3578748180,34
1,1273,34822,3578748146,3578748180,34
1,1273,34823,3578748146,3578748182,36
1,1273,34824,3578748146,3578748182,36
1,1273,34825,3578748146,3578748183,37
1,1273,34826,3578748146,3578748184,38
1,1273,34827,3578748146,3578748186,40
1,1273,34828,3578748146,3578748186,40
1,1273,34829,3578748146,3578748188,42
1,1273,34830,3578748146,3578748189,43
1,1273,34831,3578748146,3578748191,45
1,1273,34832,3578748146,3578748192,46
1,1273,34833,3578748146,3578748193,47
1,1273,34834,3578748146,3578748193,47
1,1273,34835,3578748146,3578748193,47
1,1273,34836,3578748146,3578748194,48
1,1274,34837,3578748208,3578748208,0
1,1274,34838,3578748208,3578748208,0
1,1274,34839,3578748208,3578748208,0
1,1274,34840,3578748208,3578748208,0
1,1274,34841,3578748208,3578748208,0
1,1274,34842,3578748208,3578748208,0
1,1274,34843,3578748208,3578748208,0
1,1274,34844,3578748208,3578748208,0
1,1274,34845,3578748208,3578748208,0
1,1274,34846,3578748208,3578748208,0
1,1274,34847,3578748208,3578748208,0
1,1274,34848,3578748208,3578748208,0
1,1274,34849,3578748208,3578748208,0
1,1274,34850,3578748208,3578748208,0
1,1274,34851,3578748208,3578748208,0
1,1274,34852,3578748208,3578748208,0
1,1274,34853,3578748208,3578748208,0
1,1274,34854,3578748208,3578748208,0
1,1274,34855,3578748208,3578748211,3
1,1274,34856,3578748208,3578748211,3
1,1274,34857,3578748208,3578748211,3
1,1274,34858,3578748208,3578748213,5
1,1274,34859,3578748208,3578748214,6
1,1274,34860,3578748208,3578748215,7
1,1274,34861,3578748208,3578748216,8
1,1274,34862,3578748208,3578748217,9
1,1274,34863,3578748208,3578748217,9
1,1274,34864,3578748208,3578748217,9
1,1274,34865,3578748208,3578748218,10
1,1274,34866,3578748208,3578748219,11
1,1274,34867,3578748208,3578748219,11
1,1274,34868,3578748208,3578748219,11
1,1274,34869,3578748208,3578748221,13
1,1274,34870,3578748208,3578748224,16
1,1274,34871,3578748208,3578748224,16
1,1274,34872,3578748208,3578748224,16
1,1274,34873,3578748208,3578748224,16
1,1274,34874,3578748208,3578748225,17
1,1274,34875,3578748208,3578748227,19
1,1274,34876,3578748208,3578748227,19
1,1274,34877,3578748208,3578748229,21
1,1274,34878,3578748208,3578748230,22
1,1274,34879,3578748208,3578748230,22
1,1274,34880,3578748208,3578748231,23
1,1274,34881,3578748208,3578748232,24
1,1274,34882,3578748208,3578748235,27
1,1274,34883,3578748208,3578748236,28
1,1274,34884,3578748208,3578748237,29
1,1274,34885,3578748208,3578748239,31
1,1274,34886,3578748208,3578748239,31
1,1274,34887,3578748208,3578748239,31
1,1274,34888,3578748208,3578748243,35
1,1274,34889,3578748208,3578748243,35
1,1274,34890,3578748208,3578748244,36
1,1274,34891,3578748208,3578748244,36
1,1274,34892,3578748208,3578748248,40
1,1274,34893,3578748208,3578748248,40
1,1274,34894,3578748208,3578748248,40
1,1274,34895,3578748208,3578748250,42
1,1274,34896,3578748208,3578748253,45
1,1274,34897,3578748208,3578748254,46
1,1274,34898,3578748208,3578748254,46
1,1274,34899,3578748208,3578748256,48
1,1274,34900,3578748208,3578748256,48
1,1274,34901,3578748208,3578748256,48
1,1274,34902,3578748208,3578748258,50
1,1275,34903,3578748271,3578748271,0
1,1275,34904,3578748271,3578748271,0
1,1275,34905,3578748271,3578748271,0
1,1275,34906,3578748271,3578748271,0
1,1275,34907,3578748271,3578748271,0
1,1275,34908,3578748271,3578748271,0
1,1275,34909,3578748271,3578748271,0
1,1275,34910,3578748271,3578748271,0
1,1275,34911,3578748271,3578748271,0
1,1275,34912,3578748271,3578748271,0
1,1275,34913,3578748271,3578748271,0
1,1275,34914,3578748271,3578748271,0
1,1275,34915,3578748271,3578748277,6
1,1275,34916,3578748271,3578748277,6
1,1275,34917,3578748271,3578748278,7
1,1275,34918,3578748271,3578748281,10
1,1275,34919,3578748271,3578748283,12
1,1275,34920,3578748271,3578748283,12
1,1275,34921,3578748271,3578748284,13
1,1275,34922,3578748271,3578748285,14
1,1275,34923,3578748271,3578748285,14
1,1275,34924,3578748271,3578748287,16
1,1275,34925,3578748271,3578748287,16
1,1275,34926,3578748271,3578748289,18
1,1275,34927,3578748271,3578748290,19
1,1275,34928,3578748271,3578748291,20
1,1275,34929,3578748271,3578748291,20
1,1275,34930,3578748271,3578748293,22
1,1275,34931,3578748271,3578748295,24
1,1275,34932,3578748271,3578748297,26
1,1275,34933,3578748271,3578748297,26
1,1275,34934,3578748271,3578748298,27
1,1275,34935,3578748271,3578748298,27
1,1275,34936,3578748271,3578748300,29
1,1275,34937,3578748271,3578748300,29
1,1275,34938,3578748271,3578748301,30
1,1275,34939,3578748271,3578748302,31
1,1275,34940,3578748271,3578748302,31
1,1275,34941,3578748271,3578748302,31
1,1275,34942,3578748271,3578748305,34
1,1275,34943,3578748271,3578748306,35
1,1275,34944,3578748271,3578748306,35
1,1275,34945,3578748271,3578748307,36
1,1275,34946,3578748271,3578748307,36
1,1275,34947,3578748271,3578748308,37
1,1275,34948,3578748271,3578748309,38
1,1275,34949,3578748271,3578748311,40
1,1275,34950,3578748271,3578748311,40
1,1275,34951,3578748271,3578748311,40
1,1275,34952,3578748271,3578748312,41
1,1275,34953,3578748271,3578748313,42
1,1275,34954,3578748271,3578748313,42
1,1275,34955,3578748271,3578748314,43
1,1275,34956,3578748271,3578748314,43
1,1275,34957,3578748271,3578748315,44
1,1275,34958,3578748271,3578748316,45
1,1275,34959,3578748271,3578748319,48
1,1275,34960,3578748271,3578748320,49
1,1275,34961,3578748271,3578748320,49
1,1275,34962,3578748271,3578748321,50
1,1275,34963,3578748271,3578748321,50
1,1276,34964,3578748334,3578748334,0
1,1276,34965,3578748334,3578748334,0
1,1276,34966,3578748334,3578748334,0
1,1276,34967,3578748334,3578748334,0
1,1276,34968,3578748334,3578748334,0
1,1276,34969,3578748334,3578748334,0
1,1276,34970,3578748334,3578748334,0
1,1276,34971,3578748334,3578748334,0
1,1276,34972,3578748334,3578748334,0
1,1276,34973,3578748334,3578748334,0
1,1276,34974,3578748334,3578748334,0
1,1276,34975,3578748334,3578748334,0
1,1276,34976,3578748334,3578748334,0
1,1276,34977,3578748334,3578748334,0
1,1276,34978,3578748334,3578748334,0
1,1276,34979,3578748334,3578748334,0
1,1276,34980,3578748334,3578748334,0
1,1276,34981,3578748334,3578748334,0
1,1276,34982,3578748334,3578748334,0
1,1276,34983,3578748334,3578748334,0
1,1276,34984,3578748334,3578748334,0
1,1276,34985,3578748334,3578748335,1
1,1276,34986,3578748334,3578748335,1
1,1276,34987,3578748334,3578748336,2
1,1276,34988,3578748334,3578748337,3
1,1276,34989,3578748334,3578748337,3
1,1276,34990,3578748334,3578748337,3
1,1276,34991,3578748334,3578748338,4
1,1276,34992,3578748334,3578748341,7
1,1276,34993,3578748334,3578748341,7
1,1276,34994,3578748334,3578748343,9
1,1276,34995,3578748334,3578748345,11
1,1276,34996,3578748334,3578748347,13
1,1276,34997,3578748334,3578748347,13
1,1276,34998,3578748334,3578748348,14
1,1276,34999,3578748334,3578748348,14
1,1276,35000,3578748334,3578748350,16
1,1276,35001,3578748334,3578748350,16
1,1276,35002,3578748334,3578748352,18
1,1276,35003,3578748334,3578748353,19
1,1276,35004,3578748334,3578748353,19
1,1276,35005,3578748334,3578748355,21
1,1276,35006,3578748334,3578748355,21
1,1276,35007,3578748334,3578748356,22
1,1276,35008,3578748334,3578748357,23
1,1276,35009,3578748334,3578748358,24
1,1276,35010,3578748334,3578748360,26
1,1276,35011,3578748334,3578748362,28
1,1276,35012,3578748334,3578748362,28
1,1276,35013,3578748334,3578748362,28
1,1276,35014,3578748334,3578748362,28
1,1276,35015,3578748334,3578748362,28
1,1276,35016,3578748334,3578748363,29
1,1276,35017,3578748334,3578748365,31
1,1276,35018,3578748334,3578748366,32
1,1276,35019,3578748334,3578748366,32
1,1276,35020,3578748334,3578748366,32
1,1276,35021,3578748334,3578748367,33
1,1276,35022,3578748334,3578748369,35
1,1276,35023,3578748334,3578748370,36
1,1276,35024,3578748334,3578748370,36
1,1276,35025,3578748334,3578748371,37
1,1276,35026,3578748334,3578748372,38
1,1276,35027,3578748334,3578748376,42
1,1276,35028,3578748334,3578748376,42
1,1276,35029,3578748334,3578748378,44
1,1276,35030,3578748334,3578748378,44
1,1276,35031,3578748334,3578748379,45
1,1276,35032,3578748334,3578748379,45
1,1276,35033,3578748334,3578748379,45
1,1276,35034,3578748334,3578748380,46
1,1276,35035,3578748334,3578748381,47
1,1276,35036,3578748334,3578748381,47
1,1276,35037,3578748334,3578748382,48
1,1276,35038,3578748334,3578748383,49
1,1276,35039,3578748334,3578748383,49
1,1277,35040,3578748396,3578748396,0
1,1277,35041,3578748396,3578748396,0
1,1277,35042,3578748396,3578748396,0
1,1277,35043,3578748396,3578748396,0
1,1277,35044,3578748396,3578748396,0
1,1277,35045,3578748396,3578748396,0
1,1277,35046,3578748396,3578748396,0
1,1277,35047,3578748396,3578748396,0
1,1277,35048,3578748396,3578748396,0
1,1277,35049,3578748396,3578748396,0
1,1277,35050,3578748396,3578748396,0
1,1277,35051,3578748396,3578748396,0
1,1277,35052,3578748396,3578748397,1
1,1277,35053,3578748396,3578748397,1
1,1277,35054,3578748396,3578748397,1
1,1277,35055,3578748396,3578748397,1
1,1277,35056,3578748396,3578748398,2
1,1277,35057,3578748396,3578748399,3
1,1277,35058,3578748396,3578748399,3
1,1277,35059,3578748396,3578748399,3
1,1277,35060,3578748396,3578748399,3
1,1277,35061,3578748396,3578748399,3
1,1277,35062,3578748396,3578748401,5
1,1277,35063,3578748396,3578748402,6
1,1277,35064,3578748396,3578748403,7
1,1277,35065,3578748396,3578748404,8
1,1277,35066,3578748396,3578748406,10
1,1277,35067,3578748396,3578748410,14
1,1277,35068,3578748396,3578748411,15
1,1277,35069,3578748396,3578748412,16
1,1277,35070,3578748396,3578748414,18
1,1277,35071,3578748396,3578748414,18
1,1277,35072,3578748396,3578748416,20
1,1277,35073,3578748396,3578748416,20
1,1277,35074,3578748396,3578748417,21
1,1277,35075,3578748396,3578748417,21
1,1277,35076,3578748396,3578748417,21
1,1277,35077,3578748396,3578748418,22
1,1277,35078,3578748396,3578748419,23
1,1277,35079,3578748396,3578748419,23
1,1277,35080,3578748396,3578748420,24
1,1277,35081,3578748396,3578748421,25
1,1277,35082,3578748396,3578748424,28
1,1277,35083,3578748396,3578748424,28
1,1277,35084,3578748396,3578748424,28
1,1277,35085,3578748396,3578748424,28
1,1277,35086,3578748396,3578748427,31
1,1277,35087,3578748396,3578748427,31
1,1277,35088,3578748396,3578748429,33
1,1277,35089,3578748396,3578748429,33
1,1277,35090,3578748396,3578748430,34
1,1277,35091,3578748396,3578748431,35
1,1277,35092,3578748396,3578748432,36
1,1277,35093,3578748396,3578748436,40
1,1277,35094,3578748396,3578748436,40
1,1277,35095,3578748396,3578748437,41
1,1277,35096,3578748396,3578748439,43
1,1277,35097,3578748396,3578748439,43
1,1277,35098,3578748396,3578748440,44
1,1277,35099,3578748396,3578748443,47
1,1277,35100,3578748396,3578748444,48
1,1277,35101,3578748396,3578748444,48
1,1277,35102,3578748396,3578748445,49
1,1277,35103,3578748396,3578748445,49
1,1278,35104,3578748461,3578748461,0
1,1278,35105,3578748461,3578748461,0
1,1278,35106,3578748461,3578748461,0
1,1278,35107,3578748461,3578748461,0
1,1278,35108,3578748461,3578748461,0
1,1278,35109,3578748461,3578748461,0
1,1278,35110,3578748461,3578748461,0
1,1278,35111,3578748461,3578748461,0
1,1278,35112,3578748461,3578748461,0
1,1278,35113,3578748461,3578748461,0
1,1278,35114,3578748461,3578748461,0
1,1278,35115,3578748461,3578748461,0
1,1278,35116,3578748461,3578748461,0
1,1278,35117,3578748461,3578748461,0
1,1278,35118,3578748461,3578748462,1
1,1278,35119,3578748461,3578748463,2
1,1278,35120,3578748461,3578748464,3
1,1278,35121,3578748461,3578748465,4
1,1278,35122,3578748461,3578748466,5
1,1278,35123,3578748461,3578748468,7
1,1278,35124,3578748461,3578748468,7
1,1278,35125,3578748461,3578748469,8
1,1278,35126,3578748461,3578748469,8
1,1278,35127,3578748461,3578748476,15
1,1278,35128,3578748461,3578748477,16
1,1278,35129,3578748461,3578748478,17
1,1278,35130,3578748461,3578748481,20
1,1278,35131,3578748461,3578748483,22
1,1278,35132,3578748461,3578748483,22
1,1278,35133,3578748461,3578748484,23
1,1278,35134,3578748461,3578748485,24
1,1278,35135,3578748461,3578748485,24
1,1278,35136,3578748461,3578748486,25
1,1278,35137,3578748461,3578748487,26
1,1278,35138,3578748461,3578748489,28
1,1278,35139,3578748461,3578748490,29
1,1278,35140,3578748461,3578748491,30
1,1278,35141,3578748461,3578748491,30
1,1278,35142,3578748461,3578748492,31
1,1278,35143,3578748461,3578748494,33
1,1278,35144,3578748461,3578748495,34
1,1278,35145,3578748461,3578748497,36
1,1278,35146,3578748461,3578748498,37
1,1278,35147,3578748461,3578748498,37
1,1278,35148,3578748461,3578748500,39
1,1278,35149,3578748461,3578748500,39
1,1278,35150,3578748461,3578748501,40
1,1278,35151,3578748461,3578748502,41
1,1278,35152,3578748461,3578748502,41
1,1278,35153,3578748461,3578748502,41
1,1278,35154,3578748461,3578748502,41
1,1278,35155,3578748461,3578748504,43
1,1278,35156,3578748461,3578748506,45
1,1278,35157,3578748461,3578748506,45
1,1278,35158,3578748461,3578748507,46
1,1278,35159,3578748461,3578748508,47
1,1278,35160,3578748461,3578748509,48
1,1278,35161,3578748461,3578748509,48
1,1279,35162,3578748524,3578748524,0
1,1279,35163,3578748524,3578748524,0
1,1279,35164,3578748524,3578748524,0
1,1279,35165,3578748524,3578748524,0
1,1279,35166,3578748524,3578748524,0
1,1279,35167,3578748524,3578748524,0
1,1279,35168,3578748524,3578748524,0
1,1279,35169,3578748524,3578748524,0
1,1279,35170,3578748524,3578748524,0
1,1279,35171,3578748524,3578748524,0
1,1279,35172,3578748524,3578748524,0
1,1279,35173,3578748524,3578748524,0
1,1279,35174,3578748524,3578748524,0
1,1279,35175,3578748524,3578748524,0
1,1279,35176,3578748524,3578748524,0
1,1279,35177,3578748524,3578748524,0
1,1279,35178,3578748524,3578748524,0
1,1279,35179,3578748524,3578748524,0
1,1279,35180,3578748524,3578748525,1
1,1279,35181,3578748524,3578748525,1
1,1279,35182,3578748524,3578748525,1
1,1279,35183,3578748524,3578748526,2
1,1279,35184,3578748524,3578748526,2
1,1279,35185,3578748524,3578748527,3
1,1279,35186,3578748524,3578748528,4
1,1279,35187,3578748524,3578748528,4
1,1279,35188,3578748524,3578748529,5
1,1279,35189,3578748524,3578748529,5
1,1279,35190,3578748524,3578748529,5
1,1279,35191,3578748524,3578748530,6
1,1279,35192,3578748524,3578748531,7
1,1279,35193,3578748524,3578748531,7
1,1279,35194,3578748524,3578748531,7
1,1279,35195,3578748524,3578748531,7
1,1279,35196,3578748524,3578748532,8
1,1279,35197,3578748524,3578748532,8
1,1279,35198,3578748524,3578748533,9
1,1279,35199,3578748524,3578748533,9
1,1279,35200,3578748524,3578748534,10
1,1279,35201,3578748524,3578748535,11
1,1279,35202,3578748524,3578748535,11
1,1279,35203,3578748524,3578748537,13
1,1279,35204,3578748524,3578748537,13
1,1279,35205,3578748524,3578748537,13
1,1279,35206,3578748524,3578748537,13
1,1279,35207,3578748524,3578748541,17
1,1279,35208,3578748524,3578748541,17
1,1279,35209,3578748524,3578748542,18
1,1279,35210,3578748524,3578748544,20
1,1279,35211,3578748524,3578748545,21
1,1279,35212,3578748524,3578748547,23
1,1279,35213,3578748524,3578748547,23
1,1279,35214,3578748524,3578748548,24
1,1279,35215,3578748524,3578748549,25
1,1279,35216,3578748524,3578748549,25
1,1279,35217,3578748524,3578748549,25
1,1279,35218,3578748524,3578748551,27
1,1279,35219,3578748524,3578748552,28
1,1279,35220,3578748524,3578748553,29
1,1279,35221,3578748524,3578748554,30
1,1279,35222,3578748524,3578748555,31
1,1279,35223,3578748524,3578748556,32
1,1279,35224,3578748524,3578748557,33
1,1279,35225,3578748524,3578748557,33
1,1279,35226,3578748524,3578748559,35
1,1279,35227,3578748524,3578748561,37
1,1279,35228,3578748524,3578748561,37
1,1279,35229,3578748524,3578748561,37
1,1279,35230,3578748524,3578748561,37
1,1279,35231,3578748524,3578748562,38
1,1279,35232,3578748524,3578748563,39
1,1279,35233,3578748524,3578748565,41
1,1279,35234,3578748524,3578748565,41
1,1279,35235,3578748524,3578748566,42
1,1279,35236,3578748524,3578748566,42
1,1279,35237,3578748524,3578748566,42
1,1279,35238,3578748524,3578748568,44
1,1279,35239,3578748524,3578748569,45
1,1279,35240,3578748524,3578748570,46
1,1279,35241,3578748524,3578748571,47
1,1279,35242,3578748524,3578748572,48
1,1280,35243,3578748587,3578748587,0
1,1280,35244,3578748587,3578748587,0
1,1280,35245,3578748587,3578748587,0
1,1280,35246,3578748587,3578748587,0
1,1280,35247,3578748587,3578748587,0
1,1280,35248,3578748587,3578748587,0
1,1280,35249,3578748587,3578748587,0
1,1280,35250,3578748587,3578748587,0
1,1280,35251,3578748587,3578748587,0
1,1280,35252,3578748587,3578748587,0
1,1280,35253,3578748587,3578748587,0
1,1280,35254,3578748587,3578748587,0
1,1280,35255,3578748587,3578748587,0
1,1280,35256,3578748587,3578748587,0
1,1280,35257,3578748587,3578748587,0
1,1280,35258,3578748587,3578748587,0
1,1280,35259,3578748587,3578748587,0
1,1280,35260,3578748587,3578748588,1
1,1280,35261,3578748587,3578748589,2
1,1280,35262,3578748587,3578748591,4
1,1280,35263,3578748587,3578748591,4
1,1280,35264,3578748587,3578748592,5
1,1280,35265,3578748587,3578748592,5
1,1280,35266,3578748587,3578748593,6
1,1280,35267,3578748587,3578748595,8
1,1280,35268,3578748587,3578748596,9
1,1280,35269,3578748587,3578748596,9
1,1280,35270,3578748587,3578748596,9
1,1280,35271,3578748587,3578748597,10
1,1280,35272,3578748587,3578748597,10
1,1280,35273,3578748587,3578748598,11
1,1280,35274,3578748587,3578748598,11
1,1280,35275,3578748587,3578748598,11
1,1280,35276,3578748587,3578748599,12
1,1280,35277,3578748587,3578748600,13
1,1280,35278,3578748587,3578748601,14
1,1280,35279,3578748587,3578748601,14
1,1280,35280,3578748587,3578748603,16
1,1280,35281,3578748587,3578748605,18
1,1280,35282,3578748587,3578748610,23
1,1280,35283,3578748587,3578748611,24
1,1280,35284,3578748587,3578748611,24
1,1280,35285,3578748587,3578748613,26
1,1280,35286,3578748587,3578748613,26
1,1280,35287,3578748587,3578748615,28
1,1280,35288,3578748587,3578748615,28
1,1280,35289,3578748587,3578748616,29
1,1280,35290,3578748587,3578748616,29
1,1280,35291,3578748587,3578748617,30
1,1280,35292,3578748587,3578748618,31
1,1280,35293,3578748587,3578748619,32
1,1280,35294,3578748587,3578748619,32
1,1280,35295,3578748587,3578748620,33
1,1280,35296,3578748587,3578748623,36
1,1280,35297,3578748587,3578748623,36
1,1280,35298,3578748587,3578748624,37
1,1280,35299,3578748587,3578748624,37
1,1280,35300,3578748587,3578748626,39
1,1280,35301,3578748587,3578748627,40
1,1280,35302,3578748587,3578748627,40
1,1280,35303,3578748587,3578748628,41
1,1280,35304,3578748587,3578748629,42
1,1280,35305,3578748587,3578748630,43
1,1280,35306,3578748587,3578748630,43
1,1280,35307,3578748587,3578748631,44
1,1280,35308,3578748587,3578748631,44
1,1280,35309,3578748587,3578748634,47
1,1280,35310,3578748587,3578748636,49
1,1280,35311,3578748587,3578748636,49
1,1281,35312,3578748650,3578748650,0
1,1281,35313,3578748650,3578748650,0
1,1281,35314,3578748650,3578748650,0
1,1281,35315,3578748650,3578748650,0
1,1281,35316,3578748650,3578748650,0
1,1281,35317,3578748650,3578748650,0
1,1281,35318,3578748650,3578748650,0
1,1281,35319,3578748650,3578748650,0
1,1281,35320,3578748650,3578748650,0
1,1281,35321,3578748650,3578748650,0
1,1281,35322,3578748650,3578748650,0
1,1281,35323,3578748650,3578748650,0
1,1281,35324,3578748650,3578748650,0
1,1281,35325,3578748650,3578748650,0
1,1281,35326,3578748650,3578748652,2
1,1281,35327,3578748650,3578748652,2
1,1281,35328,3578748650,3578748653,3
1,1281,35329,3578748650,3578748655,5
1,1281,35330,3578748650,3578748655,5
1,1281,35331,3578748650,3578748655,5
1,1281,35332,3578748650,3578748657,7
1,1281,35333,3578748650,3578748658,8
1,1281,35334,3578748650,3578748659,9
1,1281,35335,3578748650,3578748660,10
1,1281,35336,3578748650,3578748662,12
1,1281,35337,3578748650,3578748662,12
1,1281,35338,3578748650,3578748663,13
1,1281,35339,3578748650,3578748664,14
1,1281,35340,3578748650,3578748665,15
1,1281,35341,3578748650,3578748667,17
1,1281,35342,3578748650,3578748667,17
1,1281,35343,3578748650,3578748668,18
1,1281,35344,3578748650,3578748669,19
1,1281,35345,3578748650,3578748677,27
1,1281,35346,3578748650,3578748677,27
1,1281,35347,3578748650,3578748678,28
1,1281,35348,3578748650,3578748681,31
1,1281,35349,3578748650,3578748683,33
1,1281,35350,3578748650,3578748683,33
1,1281,35351,3578748650,3578748684,34
1,1281,35352,3578748650,3578748685,35
1,1281,35353,3578748650,3578748685,35
1,1281,35354,3578748650,3578748686,36
1,1281,35355,3578748650,3578748687,37
1,1281,35356,3578748650,3578748690,40
1,1281,35357,3578748650,3578748690,40
1,1281,35358,3578748650,3578748691,41
1,1281,35359,3578748650,3578748692,42
1,1281,35360,3578748650,3578748694,44
1,1281,35361,3578748650,3578748696,46
1,1281,35362,3578748650,3578748697,47
1,1281,35363,3578748650,3578748697,47
1,1281,35364,3578748650,3578748698,48
1,1281,35365,3578748650,3578748698,48
1,1281,35366,3578748650,3578748700,50
1,1282,35367,3578748712,3578748712,0
1,1282,35368,3578748712,3578748712,0
1,1282,35369,3578748712,3578748712,0
1,1282,35370,3578748712,3578748712,0
1,1282,35371,3578748712,3578748712,0
1,1282,35372,3578748712,3578748712,0
1,1282,35373,3578748712,3578748712,0
1,1282,35374,3578748712,3578748712,0
1,1282,35375,3578748712,3578748712,0
1,1282,35376,3578748712,3578748712,0
1,1282,35377,3578748712,3578748712,0
1,1282,35378,3578748712,3578748712,0
1,1282,35379,3578748712,3578748712,0
1,1282,35380,3578748712,3578748712,0
1,1282,35381,3578748712,3578748712,0
1,1282,35382,3578748712,3578748712,0
1,1282,35383,3578748712,3578748712,0
1,1282,35384,3578748712,3578748713,1
1,1282,35385,3578748712,3578748713,1
1,1282,35386,3578748712,3578748713,1
1,1282,35387,3578748712,3578748714,2
1,1282,35388,3578748712,3578748715,3
1,1282,35389,3578748712,3578748717,5
1,1282,35390,3578748712,3578748719,7
1,1282,35391,3578748712,3578748720,8
1,1282,35392,3578748712,3578748720,8
1,1282,35393,3578748712,3578748720,8
1,1282,35394,3578748712,3578748721,9
1,1282,35395,3578748712,3578748721,9
1,1282,35396,3578748712,3578748723,11
1,1282,35397,3578748712,3578748724,12
1,1282,35398,3578748712,3578748725,13
1,1282,35399,3578748712,3578748725,13
1,1282,35400,3578748712,3578748726,14
1,1282,35401,3578748712,3578748726,14
1,1282,35402,3578748712,3578748726,14
1,1282,35403,3578748712,3578748727,15
1,1282,35404,3578748712,3578748728,16
1,1282,35405,3578748712,3578748729,17
1,1282,35406,3578748712,3578748729,17
1,1282,35407,3578748712,3578748729,17
1,1282,35408,3578748712,3578748731,19
1,1282,35409,3578748712,3578748731,19
1,1282,35410,3578748712,3578748731,19
1,1282,35411,3578748712,3578748731,19
1,1282,35412,3578748712,3578748731,19
1,1282,35413,3578748712,3578748732,20
1,1282,35414,3578748712,3578748732,20
1,1282,35415,3578748712,3578748734,22
1,1282,35416,3578748712,3578748734,22
1,1282,35417,3578748712,3578748735,23
1,1282,35418,3578748712,3578748735,23
1,1282,35419,3578748712,3578748736,24
1,1282,35420,3578748712,3578748736,24
1,1282,35421,3578748712,3578748736,24
1,1282,35422,3578748712,3578748737,25
1,1282,35423,3578748712,3578748741,29
1,1282,35424,3578748712,3578748741,29
1,1282,35425,3578748712,3578748742,30
1,1282,35426,3578748712,3578748742,30
1,1282,35427,3578748712,3578748743,31
1,1282,35428,3578748712,3578748745,33
1,1282,35429,3578748712,3578748747,35
1,1282,35430,3578748712,3578748747,35
1,1282,35431,3578748712,3578748748,36
1,1282,35432,3578748712,3578748749,37
1,1282,35433,3578748712,3578748749,37
1,1282,35434,3578748712,3578748750,38
1,1282,35435,3578748712,3578748752,40
1,1282,35436,3578748712,3578748752,40
1,1282,35437,3578748712,3578748752,40
1,1282,35438,3578748712,3578748755,43
1,1282,35439,3578748712,3578748756,44
1,1282,35440,3578748712,3578748757,45
1,1282,35441,3578748712,3578748757,45
1,1282,35442,3578748712,3578748758,46
1,1282,35443,3578748712,3578748759,47
1,1282,35444,3578748712,3578748761,49
1,1282,35445,3578748712,3578748762,50
1,1283,35446,3578748775,3578748775,0
1,1283,35447,3578748775,3578748775,0
1,1283,35448,3578748775,3578748775,0
1,1283,35449,3578748775,3578748775,0
1,1283,35450,3578748775,3578748775,0
1,1283,35451,3578748775,3578748775,0
1,1283,35452,3578748775,3578748775,0
1,1283,35453,3578748775,3578748775,0
1,1283,35454,3578748775,3578748775,0
1,1283,35455,3578748775,3578748775,0
1,1283,35456,3578748775,3578748775,0
1,1283,35457,3578748775,3578748775,0
1,1283,35458,3578748775,3578748775,0
1,1283,35459,3578748775,3578748776,1
1,1283,35460,3578748775,3578748777,2
1,1283,35461,3578748775,3578748778,3
1,1283,35462,3578748775,3578748778,3
1,1283,35463,3578748775,3578748778,3
1,1283,35464,3578748775,3578748779,4
1,1283,35465,3578748775,3578748779,4
1,1283,35466,3578748775,3578748781,6
1,1283,35467,3578748775,3578748781,6
1,1283,35468,3578748775,3578748781,6
1,1283,35469,3578748775,3578748781,6
1,1283,35470,3578748775,3578748782,7
1,1283,35471,3578748775,3578748783,8
1,1283,35472,3578748775,3578748783,8
1,1283,35473,3578748775,3578748786,11
1,1283,35474,3578748775,3578748786,11
1,1283,35475,3578748775,3578748788,13
1,1283,35476,3578748775,3578748790,15
1,1283,35477,3578748775,3578748791,16
1,1283,35478,3578748775,3578748791,16
1,1283,35479,3578748775,3578748792,17
1,1283,35480,3578748775,3578748792,17
1,1283,35481,3578748775,3578748794,19
1,1283,35482,3578748775,3578748795,20
1,1283,35483,3578748775,3578748796,21
1,1283,35484,3578748775,3578748796,21
1,1283,35485,3578748775,3578748796,21
1,1283,35486,3578748775,3578748796,21
1,1283,35487,3578748775,3578748797,22
1,1283,35488,3578748775,3578748797,22
1,1283,35489,3578748775,3578748798,23
1,1283,35490,3578748775,3578748798,23
1,1283,35491,3578748775,3578748799,24
1,1283,35492,3578748775,3578748799,24
1,1283,35493,3578748775,3578748800,25
1,1283,35494,3578748775,3578748801,26
1,1283,35495,3578748775,3578748802,27
1,1283,35496,3578748775,3578748803,28
1,1283,35497,3578748775,3578748806,31
1,1283,35498,3578748775,3578748810,35
1,1283,35499,3578748775,3578748811,36
1,1283,35500,3578748775,3578748811,36
1,1283,35501,3578748775,3578748813,38
1,1283,35502,3578748775,3578748813,38
1,1283,35503,3578748775,3578748815,40
1,1283,35504,3578748775,3578748815,40
1,1283,35505,3578748775,3578748816,41
1,1283,35506,3578748775,3578748816,41
1,1283,35507,3578748775,3578748816,41
1,1283,35508,3578748775,3578748817,42
1,1283,35509,3578748775,3578748819,44
1,1283,35510,3578748775,3578748820,45
1,1283,35511,3578748775,3578748820,45
1,1283,35512,3578748775,3578748823,48
1,1283,35513,3578748775,3578748823,48
1,1283,35514,3578748775,3578748824,49
1,1283,35515,3578748775,3578748825,50
1,1284,35516,3578748837,3578748837,0
1,1284,35517,3578748837,3578748837,0
1,1284,35518,3578748837,3578748837,0
1,1284,35519,3578748837,3578748837,0
1,1284,35520,3578748837,3578748837,0
1,1284,35521,3578748837,3578748837,0
1,1284,35522,3578748837,3578748837,0
1,1284,35523,3578748837,3578748838,1
1,1284,35524,3578748837,3578748838,1
1,1284,35525,3578748837,3578748838,1
1,1284,35526,3578748837,3578748838,1
1,1284,35527,3578748837,3578748839,2
1,1284,35528,3578748837,3578748839,2
1,1284,35529,3578748837,3578748840,3
1,1284,35530,3578748837,3578748842,5
1,1284,35531,3578748837,3578748843,6
1,1284,35532,3578748837,3578748843,6
1,1284,35533,3578748837,3578748843,6
1,1284,35534,3578748837,3578748845,8
1,1284,35535,3578748837,3578748845,8
1,1284,35536,3578748837,3578748848,11
1,1284,35537,3578748837,3578748848,11
1,1284,35538,3578748837,3578748848,11
1,1284,35539,3578748837,3578748849,12
1,1284,35540,3578748837,3578748850,13
1,1284,35541,3578748837,3578748851,14
1,1284,35542,3578748837,3578748852,15
1,1284,35543,3578748837,3578748853,16
1,1284,35544,3578748837,3578748855,18
1,1284,35545,3578748837,3578748855,18
1,1284,35546,3578748837,3578748856,19
1,1284,35547,3578748837,3578748857,20
1,1284,35548,3578748837,3578748858,21
1,1284,35549,3578748837,3578748859,22
1,1284,35550,3578748837,3578748860,23
1,1284,35551,3578748837,3578748863,26
1,1284,35552,3578748837,3578748864,27
1,1284,35553,3578748837,3578748864,27
1,1284,35554,3578748837,3578748865,28
1,1284,35555,3578748837,3578748867,30
1,1284,35556,3578748837,3578748867,30
1,1284,35557,3578748837,3578748868,31
1,1284,35558,3578748837,3578748868,31
1,1284,35559,3578748837,3578748876,39
1,1284,35560,3578748837,3578748877,40
1,1284,35561,3578748837,3578748878,41
1,1284,35562,3578748837,3578748882,45
1,1284,35563,3578748837,3578748882,45
1,1284,35564,3578748837,3578748882,45
1,1284,35565,3578748837,3578748884,47
1,1284,35566,3578748837,3578748885,48
1,1284,35567,3578748837,3578748886,49
1,1285,35568,3578748899,3578748899,0
1,1285,35569,3578748899,3578748899,0
1,1285,35570,3578748899,3578748899,0
1,1285,35571,3578748899,3578748899,0
1,1285,35572,3578748899,3578748899,0
1,1285,35573,3578748899,3578748899,0
1,1285,35574,3578748899,3578748899,0
1,1285,35575,3578748899,3578748899,0
1,1285,35576,3578748899,3578748899,0
1,1285,35577,3578748899,3578748899,0
1,1285,35578,3578748899,3578748899,0
1,1285,35579,3578748899,3578748899,0
1,1285,35580,3578748899,3578748899,0
1,1285,35581,3578748899,3578748899,0
1,1285,35582,3578748899,3578748900,1
1,1285,35583,3578748899,3578748900,1
1,1285,35584,3578748899,3578748900,1
1,1285,35585,3578748899,3578748901,2
1,1285,35586,3578748899,3578748901,2
1,1285,35587,3578748899,3578748902,3
1,1285,35588,3578748899,3578748902,3
1,1285,35589,3578748899,3578748902,3
1,1285,35590,3578748899,3578748904,5
1,1285,35591,3578748899,3578748906,7
1,1285,35592,3578748899,3578748906,7
1,1285,35593,3578748899,3578748907,8
1,1285,35594,3578748899,3578748907,8
1,1285,35595,3578748899,3578748910,11
1,1285,35596,3578748899,3578748911,12
1,1285,35597,3578748899,3578748911,12
1,1285,35598,3578748899,3578748912,13
1,1285,35599,3578748899,3578748912,13
1,1285,35600,3578748899,3578748913,14
1,1285,35601,3578748899,3578748913,14
1,1285,35602,3578748899,3578748914,15
1,1285,35603,3578748899,3578748914,15
1,1285,35604,3578748899,3578748915,16
1,1285,35605,3578748899,3578748915,16
1,1285,35606,3578748899,3578748916,17
1,1285,35607,3578748899,3578748916,17
1,1285,35608,3578748899,3578748919,20
1,1285,35609,3578748899,3578748920,21
1,1285,35610,3578748899,3578748920,21
1,1285,35611,3578748899,3578748921,22
1,1285,35612,3578748899,3578748921,22
1,1285,35613,3578748899,3578748921,22
1,1285,35614,3578748899,3578748924,25
1,1285,35615,3578748899,3578748924,25
1,1285,35616,3578748899,3578748924,25
1,1285,35617,3578748899,3578748925,26
1,1285,35618,3578748899,3578748926,27
1,1285,35619,3578748899,3578748926,27
1,1285,35620,3578748899,3578748926,27
1,1285,35621,3578748899,3578748926,27
1,1285,35622,3578748899,3578748928,29
1,1285,35623,3578748899,3578748928,29
1,1285,35624,3578748899,3578748929,30
1,1285,35625,3578748899,3578748929,30
1,1285,35626,3578748899,3578748931,32
1,1285,35627,3578748899,3578748931,32
1,1285,35628,3578748899,3578748932,33
1,1285,35629,3578748899,3578748932,33
1,1285,35630,3578748899,3578748932,33
1,1285,35631,3578748899,3578748932,33
1,1285,35632,3578748899,3578748932,33
1,1285,35633,3578748899,3578748933,34
1,1285,35634,3578748899,3578748935,36
1,1285,35635,3578748899,3578748935,36
1,1285,35636,3578748899,3578748935,36
1,1285,35637,3578748899,3578748935,36
1,1285,35638,3578748899,3578748935,36
1,1285,35639,3578748899,3578748936,37
1,1285,35640,3578748899,3578748937,38
1,1285,35641,3578748899,3578748937,38
1,1285,35642,3578748899,3578748937,38
1,1285,35643,3578748899,3578748941,42
1,1285,35644,3578748899,3578748941,42
1,1285,35645,3578748899,3578748941,42
1,1285,35646,3578748899,3578748943,44
1,1285,35647,3578748899,3578748944,45
1,1285,35648,3578748899,3578748945,46
1,1285,35649,3578748899,3578748947,48
1,1285,35650,3578748899,3578748948,49
1,1285,35651,3578748899,3578748948,49
1,1286,35652,3578748961,3578748961,0
1,1286,35653,3578748961,3578748961,0
1,1286,35654,3578748961,3578748961,0
1,1286,35655,3578748961,3578748961,0
1,1286,35656,3578748961,3578748961,0
1,1286,35657,3578748961,3578748961,0
1,1286,35658,3578748961,3578748961,0
1,1286,35659,3578748961,3578748961,0
1,1286,35660,3578748961,3578748962,1
1,1286,35661,3578748961,3578748962,1
1,1286,35662,3578748961,3578748962,1
1,1286,35663,3578748961,3578748962,1
1,1286,35664,3578748961,3578748964,3
1,1286,35665,3578748961,3578748965,4
1,1286,35666,3578748961,3578748965,4
1,1286,35667,3578748961,3578748966,5
1,1286,35668,3578748961,3578748966,5
1,1286,35669,3578748961,3578748967,6
1,1286,35670,3578748961,3578748967,6
1,1286,35671,3578748961,3578748969,8
1,1286,35672,3578748961,3578748970,9
1,1286,35673,3578748961,3578748971,10
1,1286,35674,3578748961,3578748975,14
1,1286,35675,3578748961,3578748975,14
1,1286,35676,3578748961,3578748977,16
1,1286,35677,3578748961,3578748978,17
1,1286,35678,3578748961,3578748978,17
1,1286,35679,3578748961,3578748978,17
1,1286,35680,3578748961,3578748979,18
1,1286,35681,3578748961,3578748979,18
1,1286,35682,3578748961,3578748980,19
1,1286,35683,3578748961,3578748981,20
1,1286,35684,3578748961,3578748981,20
1,1286,35685,3578748961,3578748982,21
1,1286,35686,3578748961,3578748983,22
1,1286,35687,3578748961,3578748983,22
1,1286,35688,3578748961,3578748984,23
1,1286,35689,3578748961,3578748985,24
1,1286,35690,3578748961,3578748986,25
1,1286,35691,3578748961,3578748988,27
1,1286,35692,3578748961,3578748989,28
1,1286,35693,3578748961,3578748991,30
1,1286,35694,3578748961,3578748991,30
1,1286,35695,3578748961,3578748992,31
1,1286,35696,3578748961,3578748992,31
1,1286,35697,3578748961,3578748993,32
1,1286,35698,3578748961,3578748994,33
1,1286,35699,3578748961,3578748996,35
1,1286,35700,3578748961,3578748996,35
1,1286,35701,3578748961,3578748997,36
1,1286,35702,3578748961,3578748998,37
1,1286,35703,3578748961,3578748998,37
1,1286,35704,3578748961,3578748998,37
1,1286,35705,3578748961,3578748999,38
1,1286,35706,3578748961,3578748999,38
1,1286,35707,3578748961,3578748999,38
1,1286,35708,3578748961,3578749001,40
1,1286,35709,3578748961,3578749001,40
1,1286,35710,3578748961,3578749002,41
1,1286,35711,3578748961,3578749002,41
1,1286,35712,3578748961,3578749006,45
1,1286,35713,3578748961,3578749011,50
1,1287,35714,3578749024,3578749024,0
1,1287,35715,3578749024,3578749024,0
1,1287,35716,3578749024,3578749024,0
1,1287,35717,3578749024,3578749024,0
1,1287,35718,3578749024,3578749024,0
1,1287,35719,3578749024,3578749024,0
1,1287,35720,3578749024,3578749024,0
1,1287,35721,3578749024,3578749024,0
1,1287,35722,3578749024,3578749024,0
1,1287,35723,3578749024,3578749024,0
1,1287,35724,3578749024,3578749024,0
1,1287,35725,3578749024,3578749024,0
1,1287,35726,3578749024,3578749024,0
1,1287,35727,3578749024,3578749024,0
1,1287,35728,3578749024,3578749024,0
1,1287,35729,3578749024,3578749024,0
1,1287,35730,3578749024,3578749025,1
1,1287,35731,3578749024,3578749027,3
1,1287,35732,3578749024,3578749028,4
1,1287,35733,3578749024,3578749028,4
1,1287,35734,3578749024,3578749028,4
1,1287,35735,3578749024,3578749029,5
1,1287,35736,3578749024,3578749029,5
1,1287,35737,3578749024,3578749030,6
1,1287,35738,3578749024,3578749032,8
1,1287,35739,3578749024,3578749036,12
1,1287,35740,3578749024,3578749036,12
1,1287,35741,3578749024,3578749038,14
1,1287,35742,3578749024,3578749039,15
1,1287,35743,3578749024,3578749039,15
1,1287,35744,3578749024,3578749041,17
1,1287,35745,3578749024,3578749043,19
1,1287,35746,3578749024,3578749043,19
1,1287,35747,3578749024,3578749043,19
1,1287,35748,3578749024,3578749044,20
1,1287,35749,3578749024,3578749045,21
1,1287,35750,3578749024,3578749048,24
1,1287,35751,3578749024,3578749048,24
1,1287,35752,3578749024,3578749048,24
1,1287,35753,3578749024,3578749050,26
1,1287,35754,3578749024,3578749050,26
1,1287,35755,3578749024,3578749052,28
1,1287,35756,3578749024,3578749053,29
1,1287,35757,3578749024,3578749053,29
1,1287,35758,3578749024,3578749055,31
1,1287,35759,3578749024,3578749056,32
1,1287,35760,3578749024,3578749056,32
1,1287,35761,3578749024,3578749059,35
1,1287,35762,3578749024,3578749060,36
1,1287,35763,3578749024,3578749061,37
1,1287,35764,3578749024,3578749062,38
1,1287,35765,3578749024,3578749064,40
1,1287,35766,3578749024,3578749064,40
1,1287,35767,3578749024,3578749065,41
1,1287,35768,3578749024,3578749066,42
1,1287,35769,3578749024,3578749067,43
1,1287,35770,3578749024,3578749068,44
1,1287,35771,3578749024,3578749068,44
1,1287,35772,3578749024,3578749068,44
1,1288,35773,3578749087,3578749087,0
1,1288,35774,3578749087,3578749087,0
1,1288,35775,3578749087,3578749087,0
1,1288,35776,3578749087,3578749087,0
1,1288,35777,3578749087,3578749087,0
1,1288,35778,3578749087,3578749087,0
1,1288,35779,3578749087,3578749087,0
1,1288,35780,3578749087,3578749087,0
1,1288,35781,3578749087,3578749087,0
1,1288,35782,3578749087,3578749087,0
1,1288,35783,3578749087,3578749087,0
1,1288,35784,3578749087,3578749089,2
1,1288,35785,3578749087,3578749090,3
1,1288,35786,3578749087,3578749091,4
1,1288,35787,3578749087,3578749091,4
1,1288,35788,3578749087,3578749092,5
1,1288,35789,3578749087,3578749093,6
1,1288,35790,3578749087,3578749093,6
1,1288,35791,3578749087,3578749096,9
1,1288,35792,3578749087,3578749098,11
1,1288,35793,3578749087,3578749099,12
1,1288,35794,3578749087,3578749099,12
1,1288,35795,3578749087,3578749100,13
1,1288,35796,3578749087,3578749100,13
1,1288,35797,3578749087,3578749100,13
1,1288,35798,3578749087,3578749101,14
1,1288,35799,3578749087,3578749101,14
1,1288,35800,3578749087,3578749102,15
1,1288,35801,3578749087,3578749102,15
1,1288,35802,3578749087,3578749102,15
1,1288,35803,3578749087,3578749102,15
1,1288,35804,3578749087,3578749106,19
1,1288,35805,3578749087,3578749106,19
1,1288,35806,3578749087,3578749107,20
1,1288,35807,3578749087,3578749107,20
1,1288,35808,3578749087,3578749110,23
1,1288,35809,3578749087,3578749111,24
1,1288,35810,3578749087,3578749112,25
1,1288,35811,3578749087,3578749112,25
1,1288,35812,3578749087,3578749112,25
1,1288,35813,3578749087,3578749114,27
1,1288,35814,3578749087,3578749114,27
1,1288,35815,3578749087,3578749114,27
1,1288,35816,3578749087,3578749115,28
1,1288,35817,3578749087,3578749117,30
1,1288,35818,3578749087,3578749117,30
1,1288,35819,3578749087,3578749119,32
1,1288,35820,3578749087,3578749120,33
1,1288,35821,3578749087,3578749121,34
1,1288,35822,3578749087,3578749121,34
1,1288,35823,3578749087,3578749123,36
1,1288,35824,3578749087,3578749124,37
1,1288,35825,3578749087,3578749125,38
1,1288,35826,3578749087,3578749125,38
1,1288,35827,3578749087,3578749126,39
1,1288,35828,3578749087,3578749126,39
1,1288,35829,3578749087,3578749127,40
1,1288,35830,3578749087,3578749128,41
1,1288,35831,3578749087,3578749128,41
1,1288,35832,3578749087,3578749128,41
1,1288,35833,3578749087,3578749129,42
1,1288,35834,3578749087,3578749129,42
1,1288,35835,3578749087,3578749131,44
1,1288,35836,3578749087,3578749131,44
1,1288,35837,3578749087,3578749131,44
1,1288,35838,3578749087,3578749132,45
1,1288,35839,3578749087,3578749132,45
1,1288,35840,3578749087,3578749133,46
1,1288,35841,3578749087,3578749133,46
1,1288,35842,3578749087,3578749134,47
1,1288,35843,3578749087,3578749134,47
1,1288,35844,3578749087,3578749134,47
1,1288,35845,3578749087,3578749135,48
1,1288,35846,3578749087,3578749135,48
1,1288,35847,3578749087,3578749135,48
1,1288,35848,3578749087,3578749136,49
1,1288,35849,3578749087,3578749137,50
1,1289,35850,3578749150,3578749150,0
1,1289,35851,3578749150,3578749150,0
1,1289,35852,3578749150,3578749150,0
1,1289,35853,3578749150,3578749150,0
1,1289,35854,3578749150,3578749150,0
1,1289,35855,3578749150,3578749150,0
1,1289,35856,3578749150,3578749150,0
1,1289,35857,3578749150,3578749150,0
1,1289,35858,3578749150,3578749150,0
1,1289,35859,3578749150,3578749150,0
1,1289,35860,3578749150,3578749150,0
1,1289,35861,3578749150,3578749150,0
1,1289,35862,3578749150,3578749150,0
1,1289,35863,3578749150,3578749150,0
1,1289,35864,3578749150,3578749152,2
1,1289,35865,3578749150,3578749152,2
1,1289,35866,3578749150,3578749153,3
1,1289,35867,3578749150,3578749154,4
1,1289,35868,3578749150,3578749156,6
1,1289,35869,3578749150,3578749157,7
1,1289,35870,3578749150,3578749157,7
1,1289,35871,3578749150,3578749157,7
1,1289,35872,3578749150,3578749160,10
1,1289,35873,3578749150,3578749162,12
1,1289,35874,3578749150,3578749162,12
1,1289,35875,3578749150,3578749162,12
1,1289,35876,3578749150,3578749162,12
1,1289,35877,3578749150,3578749163,13
1,1289,35878,3578749150,3578749165,15
1,1289,35879,3578749150,3578749165,15
1,1289,35880,3578749150,3578749166,16
1,1289,35881,3578749150,3578749166,16
1,1289,35882,3578749150,3578749166,16
1,1289,35883,3578749150,3578749167,17
1,1289,35884,3578749150,3578749168,18
1,1289,35885,3578749150,3578749169,19
1,1289,35886,3578749150,3578749170,20
1,1289,35887,3578749150,3578749171,21
1,1289,35888,3578749150,3578749171,21
1,1289,35889,3578749150,3578749174,24
1,1289,35890,3578749150,3578749174,24
1,1289,35891,3578749150,3578749175,25
1,1289,35892,3578749150,3578749177,27
1,1289,35893,3578749150,3578749178,28
1,1289,35894,3578749150,3578749178,28
1,1289,35895,3578749150,3578749178,28
1,1289,35896,3578749150,3578749179,29
1,1289,35897,3578749150,3578749179,29
1,1289,35898,3578749150,3578749180,30
1,1289,35899,3578749150,3578749181,31
1,1289,35900,3578749150,3578749182,32
1,1289,35901,3578749150,3578749182,32
1,1289,35902,3578749150,3578749183,33
1,1289,35903,3578749150,3578749183,33
1,1289,35904,3578749150,3578749186,36
1,1289,35905,3578749150,3578749187,37
1,1289,35906,3578749150,3578749188,38
1,1289,35907,3578749150,3578749189,39
1,1289,35908,3578749150,3578749191,41
1,1289,35909,3578749150,3578749191,41
1,1289,35910,3578749150,3578749192,42
1,1289,35911,3578749150,3578749192,42
1,1289,35912,3578749150,3578749193,43
1,1289,35913,3578749150,3578749196,46
1,1289,35914,3578749150,3578749196,46
1,1289,35915,3578749150,3578749196,46
1,1289,35916,3578749150,3578749196,46
1,1289,35917,3578749150,3578749197,47
1,1289,35918,3578749150,3578749197,47
1,1289,35919,3578749150,3578749197,47
1,1289,35920,3578749150,3578749197,47
1,1289,35921,3578749150,3578749199,49
1,1289,35922,3578749150,3578749199,49
1,1289,35923,3578749150,3578749199,49
1,1290,35924,3578749212,3578749212,0
1,1290,35925,3578749212,3578749212,0
1,1290,35926,3578749212,3578749212,0
1,1290,35927,3578749212,3578749212,0
1,1290,35928,3578749212,3578749212,0
1,1290,35929,3578749212,3578749212,0
1,1290,35930,3578749212,3578749212,0
1,1290,35931,3578749212,3578749212,0
1,1290,35932,3578749212,3578749214,2
1,1290,35933,3578749212,3578749216,4
1,1290,35934,3578749212,3578749216,4
1,1290,35935,3578749212,3578749217,5
1,1290,35936,3578749212,3578749217,5
1,1290,35937,3578749212,3578749217,5
1,1290,35938,3578749212,3578749218,6
1,1290,35939,3578749212,3578749218,6
1,1290,35940,3578749212,3578749220,8
1,1290,35941,3578749212,3578749220,8
1,1290,35942,3578749212,3578749221,9
1,1290,35943,3578749212,3578749223,11
1,1290,35944,3578749212,3578749224,12
1,1290,35945,3578749212,3578749224,12
1,1290,35946,3578749212,3578749224,12
1,1290,35947,3578749212,3578749225,13
1,1290,35948,3578749212,3578749228,16
1,1290,35949,3578749212,3578749228,16
1,1290,35950,3578749212,3578749229,17
1,1290,35951,3578749212,3578749229,17
1,1290,35952,3578749212,3578749229,17
1,1290,35953,3578749212,3578749232,20
1,1290,35954,3578749212,3578749236,24
1,1290,35955,3578749212,3578749237,25
1,1290,35956,3578749212,3578749238,26
1,1290,35957,3578749212,3578749239,27
1,1290,35958,3578749212,3578749239,27
1,1290,35959,3578749212,3578749241,29
1,1290,35960,3578749212,3578749243,31
1,1290,35961,3578749212,3578749243,31
1,1290,35962,3578749212,3578749243,31
1,1290,35963,3578749212,3578749243,31
1,1290,35964,3578749212,3578749245,33
1,1290,35965,3578749212,3578749248,36
1,1290,35966,3578749212,3578749248,36
1,1290,35967,3578749212,3578749249,37
1,1290,35968,3578749212,3578749250,38
1,1290,35969,3578749212,3578749250,38
1,1290,35970,3578749212,3578749251,39
1,1290,35971,3578749212,3578749253,41
1,1290,35972,3578749212,3578749254,42
1,1290,35973,3578749212,3578749254,42
1,1290,35974,3578749212,3578749256,44
1,1290,35975,3578749212,3578749257,45
1,1290,35976,3578749212,3578749259,47
1,1290,35977,3578749212,3578749259,47
1,1290,35978,3578749212,3578749261,49
1,1291,35979,3578749275,3578749275,0
1,1291,35980,3578749275,3578749275,0
1,1291,35981,3578749275,3578749275,0
1,1291,35982,3578749275,3578749275,0
1,1291,35983,3578749275,3578749275,0
1,1291,35984,3578749275,3578749275,0
1,1291,35985,3578749275,3578749275,0
1,1291,35986,3578749275,3578749275,0
1,1291,35987,3578749275,3578749276,1
1,1291,35988,3578749275,3578749277,2
1,1291,35989,3578749275,3578749281,6
1,1291,35990,3578749275,3578749282,7
1,1291,35991,3578749275,3578749283,8
1,1291,35992,3578749275,3578749285,10
1,1291,35993,3578749275,3578749285,10
1,1291,35994,3578749275,3578749286,11
1,1291,35995,3578749275,3578749287,12
1,1291,35996,3578749275,3578749287,12
1,1291,35997,3578749275,3578749290,15
1,1291,35998,3578749275,3578749290,15
1,1291,35999,3578749275,3578749291,16
1,1291,36000,3578749275,3578749291,16
1,1291,36001,3578749275,3578749292,17
1,1291,36002,3578749275,3578749294,19
1,1291,36003,3578749275,3578749294,19
1,1291,36004,3578749275,3578749297,22
1,1291,36005,3578749275,3578749298,23
1,1291,36006,3578749275,3578749299,24
1,1291,36007,3578749275,3578749300,25
1,1291,36008,3578749275,3578749300,25
1,1291,36009,3578749275,3578749300,25
1,1291,36010,3578749275,3578749301,26
1,1291,36011,3578749275,3578749301,26
1,1291,36012,3578749275,3578749301,26
1,1291,36013,3578749275,3578749302,27
1,1291,36014,3578749275,3578749302,27
1,1291,36015,3578749275,3578749302,27
1,1291,36016,3578749275,3578749304,29
1,1291,36017,3578749275,3578749306,31
1,1291,36018,3578749275,3578749307,32
1,1291,36019,3578749275,3578749307,32
1,1291,36020,3578749275,3578749308,33
1,1291,36021,3578749275,3578749310,35
1,1291,36022,3578749275,3578749311,36
1,1291,36023,3578749275,3578749311,36
1,1291,36024,3578749275,3578749312,37
1,1291,36025,3578749275,3578749312,37
1,1291,36026,3578749275,3578749313,38
1,1291,36027,3578749275,3578749314,39
1,1291,36028,3578749275,3578749314,39
1,1291,36029,3578749275,3578749315,40
1,1291,36030,3578749275,3578749315,40
1,1291,36031,3578749275,3578749317,42
1,1291,36032,3578749275,3578749317,42
1,1291,36033,3578749275,3578749319,44
1,1291,36034,3578749275,3578749320,45
1,1291,36035,3578749275,3578749321,46
1,1291,36036,3578749275,3578749321,46
1,1291,36037,3578749275,3578749321,46
1,1291,36038,3578749275,3578749323,48
1,1291,36039,3578749275,3578749324,49
1,1291,36040,3578749275,3578749325,50
1,1292,36041,3578749337,3578749337,0
1,1292,36042,3578749337,3578749337,0
1,1292,36043,3578749337,3578749337,0
1,1292,36044,3578749337,3578749337,0
1,1292,36045,3578749337,3578749337,0
1,1292,36046,3578749337,3578749337,0
1,1292,36047,3578749337,3578749337,0
1,1292,36048,3578749337,3578749337,0
1,1292,36049,3578749337,3578749337,0
1,1292,36050,3578749337,3578749337,0
1,1292,36051,3578749337,3578749337,0
1,1292,36052,3578749337,3578749337,0
1,1292,36053,3578749337,3578749337,0
1,1292,36054,3578749337,3578749337,0
1,1292,36055,3578749337,3578749337,0
1,1292,36056,3578749337,3578749337,0
1,1292,36057,3578749337,3578749337,0
1,1292,36058,3578749337,3578749337,0
1,1292,36059,3578749337,3578749337,0
1,1292,36060,3578749337,3578749337,0
1,1292,36061,3578749337,3578749337,0
1,1292,36062,3578749337,3578749337,0
1,1292,36063,3578749337,3578749337,0
1,1292,36064,3578749337,3578749337,0
1,1292,36065,3578749337,3578749337,0
1,1292,36066,3578749337,3578749341,4
1,1292,36067,3578749337,3578749341,4
1,1292,36068,3578749337,3578749341,4
1,1292,36069,3578749337,3578749343,6
1,1292,36070,3578749337,3578749344,7
1,1292,36071,3578749337,3578749347,10
1,1292,36072,3578749337,3578749348,11
1,1292,36073,3578749337,3578749349,12
1,1292,36074,3578749337,3578749350,13
1,1292,36075,3578749337,3578749350,13
1,1292,36076,3578749337,3578749353,16
1,1292,36077,3578749337,3578749353,16
1,1292,36078,3578749337,3578749355,18
1,1292,36079,3578749337,3578749356,19
1,1292,36080,3578749337,3578749357,20
1,1292,36081,3578749337,3578749357,20
1,1292,36082,3578749337,3578749358,21
1,1292,36083,3578749337,3578749360,23
1,1292,36084,3578749337,3578749361,24
1,1292,36085,3578749337,3578749362,25
1,1292,36086,3578749337,3578749362,25
1,1292,36087,3578749337,3578749362,25
1,1292,36088,3578749337,3578749364,27
1,1292,36089,3578749337,3578749366,29
1,1292,36090,3578749337,3578749366,29
1,1292,36091,3578749337,3578749366,29
1,1292,36092,3578749337,3578749366,29
1,1292,36093,3578749337,3578749366,29
1,1292,36094,3578749337,3578749369,32
1,1292,36095,3578749337,3578749370,33
1,1292,36096,3578749337,3578749370,33
1,1292,36097,3578749337,3578749372,35
1,1292,36098,3578749337,3578749374,37
1,1292,36099,3578749337,3578749375,38
1,1292,36100,3578749337,3578749376,39
1,1292,36101,3578749337,3578749378,41
1,1292,36102,3578749337,3578749378,41
1,1292,36103,3578749337,3578749378,41
1,1292,36104,3578749337,3578749379,42
1,1292,36105,3578749337,3578749379,42
1,1292,36106,3578749337,3578749380,43
1,1292,36107,3578749337,3578749380,43
1,1292,36108,3578749337,3578749381,44
1,1292,36109,3578749337,3578749382,45
1,1292,36110,3578749337,3578749382,45
1,1292,36111,3578749337,3578749383,46
1,1292,36112,3578749337,3578749383,46
1,1292,36113,3578749337,3578749384,47
1,1292,36114,3578749337,3578749385,48
1,1292,36115,3578749337,3578749386,49
1,1293,36116,3578749400,3578749400,0
1,1293,36117,3578749400,3578749400,0
1,1293,36118,3578749400,3578749400,0
1,1293,36119,3578749400,3578749400,0
1,1293,36120,3578749400,3578749400,0
1,1293,36121,3578749400,3578749400,0
1,1293,36122,3578749400,3578749400,0
1,1293,36123,3578749400,3578749400,0
1,1293,36124,3578749400,3578749400,0
1,1293,36125,3578749400,3578749400,0
1,1293,36126,3578749400,3578749400,0
1,1293,36127,3578749400,3578749400,0
1,1293,36128,3578749400,3578749400,0
1,1293,36129,3578749400,3578749400,0
1,1293,36130,3578749400,3578749400,0
1,1293,36131,3578749400,3578749400,0
1,1293,36132,3578749400,3578749400,0
1,1293,36133,3578749400,3578749400,0
1,1293,36134,3578749400,3578749400,0
1,1293,36135,3578749400,3578749401,1
1,1293,36136,3578749400,3578749401,1
1,1293,36137,3578749400,3578749402,2
1,1293,36138,3578749400,3578749404,4
1,1293,36139,3578749400,3578749406,6
1,1293,36140,3578749400,3578749410,10
1,1293,36141,3578749400,3578749411,11
1,1293,36142,3578749400,3578749412,12
1,1293,36143,3578749400,3578749414,14
1,1293,36144,3578749400,3578749416,16
1,1293,36145,3578749400,3578749416,16
1,1293,36146,3578749400,3578749416,16
1,1293,36147,3578749400,3578749416,16
1,1293,36148,3578749400,3578749418,18
1,1293,36149,3578749400,3578749419,19
1,1293,36150,3578749400,3578749419,19
1,1293,36151,3578749400,3578749419,19
1,1293,36152,3578749400,3578749422,22
1,1293,36153,3578749400,3578749424,24
1,1293,36154,3578749400,3578749424,24
1,1293,36155,3578749400,3578749424,24
1,1293,36156,3578749400,3578749424,24
1,1293,36157,3578749400,3578749424,24
1,1293,36158,3578749400,3578749427,27
1,1293,36159,3578749400,3578749428,28
1,1293,36160,3578749400,3578749430,30
1,1293,36161,3578749400,3578749430,30
1,1293,36162,3578749400,3578749430,30
1,1293,36163,3578749400,3578749431,31
1,1293,36164,3578749400,3578749431,31
1,1293,36165,3578749400,3578749432,32
1,1293,36166,3578749400,3578749435,35
1,1293,36167,3578749400,3578749437,37
1,1293,36168,3578749400,3578749437,37
1,1293,36169,3578749400,3578749438,38
1,1293,36170,3578749400,3578749439,39
1,1293,36171,3578749400,3578749440,40
1,1293,36172,3578749400,3578749441,41
1,1293,36173,3578749400,3578749442,42
1,1293,36174,3578749400,3578749443,43
1,1293,36175,3578749400,3578749444,44
1,1293,36176,3578749400,3578749444,44
1,1293,36177,3578749400,3578749444,44
1,1293,36178,3578749400,3578749448,48
1,1293,36179,3578749400,3578749448,48
1,1293,36180,3578749400,3578749449,49
1,1293,36181,3578749400,3578749450,50
1,1293,36182,3578749400,3578749450,50
1,1294,36183,3578749463,3578749463,0
1,1294,36184,3578749463,3578749463,0
1,1294,36185,3578749463,3578749463,0
1,1294,36186,3578749463,3578749463,0
1,1294,36187,3578749463,3578749463,0
1,1294,36188,3578749463,3578749463,0
1,1294,36189,3578749463,3578749463,0
1,1294,36190,3578749463,3578749463,0
1,1294,36191,3578749463,3578749464,1
1,1294,36192,3578749463,3578749464,1
1,1294,36193,3578749463,3578749465,2
1,1294,36194,3578749463,3578749465,2
1,1294,36195,3578749463,3578749465,2
1,1294,36196,3578749463,3578749468,5
1,1294,36197,3578749463,3578749468,5
1,1294,36198,3578749463,3578749469,6
1,1294,36199,3578749463,3578749477,14
1,1294,36200,3578749463,3578749477,14
1,1294,36201,3578749463,3578749480,17
1,1294,36202,3578749463,3578749483,20
1,1294,36203,3578749463,3578749483,20
1,1294,36204,3578749463,3578749485,22
1,1294,36205,3578749463,3578749485,22
1,1294,36206,3578749463,3578749486,23
1,1294,36207,3578749463,3578749487,24
1,1294,36208,3578749463,3578749490,27
1,1294,36209,3578749463,3578749490,27
1,1294,36210,3578749463,3578749490,27
1,1294,36211,3578749463,3578749491,28
1,1294,36212,3578749463,3578749492,29
1,1294,36213,3578749463,3578749493,30
1,1294,36214,3578749463,3578749494,31
1,1294,36215,3578749463,3578749496,33
1,1294,36216,3578749463,3578749498,35
1,1294,36217,3578749463,3578749499,36
1,1294,36218,3578749463,3578749499,36
1,1294,36219,3578749463,3578749500,37
1,1294,36220,3578749463,3578749500,37
1,1294,36221,3578749463,3578749500,37
1,1294,36222,3578749463,3578749500,37
1,1294,36223,3578749463,3578749501,38
1,1294,36224,3578749463,3578749501,38
1,1294,36225,3578749463,3578749502,39
1,1294,36226,3578749463,3578749502,39
1,1294,36227,3578749463,3578749502,39
1,1294,36228,3578749463,3578749505,42
1,1294,36229,3578749463,3578749506,43
1,1294,36230,3578749463,3578749507,44
1,1294,36231,3578749463,3578749508,45
1,1294,36232,3578749463,3578749510,47
1,1294,36233,3578749463,3578749510,47
1,1294,36234,3578749463,3578749511,48
1,1294,36235,3578749463,3578749512,49
1,1294,36236,3578749463,3578749512,49
1,1295,36237,3578749525,3578749525,0
1,1295,36238,3578749525,3578749525,0
1,1295,36239,3578749525,3578749525,0
1,1295,36240,3578749525,3578749525,0
1,1295,36241,3578749525,3578749525,0
1,1295,36242,3578749525,3578749525,0
1,1295,36243,3578749525,3578749525,0
1,1295,36244,3578749525,3578749525,0
1,1295,36245,3578749525,3578749525,0
1,1295,36246,3578749525,3578749525,0
1,1295,36247,3578749525,3578749525,0
1,1295,36248,3578749525,3578749525,0
1,1295,36249,3578749525,3578749525,0
1,1295,36250,3578749525,3578749525,0
1,1295,36251,3578749525,3578749525,0
1,1295,36252,3578749525,3578749525,0
1,1295,36253,3578749525,3578749525,0
1,1295,36254,3578749525,3578749525,0
1,1295,36255,3578749525,3578749525,0
1,1295,36256,3578749525,3578749525,0
1,1295,36257,3578749525,3578749526,1
1,1295,36258,3578749525,3578749527,2
1,1295,36259,3578749525,3578749528,3
1,1295,36260,3578749525,3578749528,3
1,1295,36261,3578749525,3578749529,4
1,1295,36262,3578749525,3578749529,4
1,1295,36263,3578749525,3578749531,6
1,1295,36264,3578749525,3578749531,6
1,1295,36265,3578749525,3578749531,6
1,1295,36266,3578749525,3578749532,7
1,1295,36267,3578749525,3578749532,7
1,1295,36268,3578749525,3578749533,8
1,1295,36269,3578749525,3578749533,8
1,1295,36270,3578749525,3578749533,8
1,1295,36271,3578749525,3578749534,9
1,1295,36272,3578749525,3578749534,9
1,1295,36273,3578749525,3578749534,9
1,1295,36274,3578749525,3578749536,11
1,1295,36275,3578749525,3578749536,11
1,1295,36276,3578749525,3578749537,12
1,1295,36277,3578749525,3578749538,13
1,1295,36278,3578749525,3578749539,14
1,1295,36279,3578749525,3578749540,15
1,1295,36280,3578749525,3578749542,17
1,1295,36281,3578749525,3578749542,17
1,1295,36282,3578749525,3578749543,18
1,1295,36283,3578749525,3578749545,20
1,1295,36284,3578749525,3578749546,21
1,1295,36285,3578749525,3578749547,22
1,1295,36286,3578749525,3578749548,23
1,1295,36287,3578749525,3578749549,24
1,1295,36288,3578749525,3578749549,24
1,1295,36289,3578749525,3578749552,27
1,1295,36290,3578749525,3578749552,27
1,1295,36291,3578749525,3578749552,27
1,1295,36292,3578749525,3578749554,29
1,1295,36293,3578749525,3578749555,30
1,1295,36294,3578749525,3578749556,31
1,1295,36295,3578749525,3578749556,31
1,1295,36296,3578749525,3578749557,32
1,1295,36297,3578749525,3578749558,33
1,1295,36298,3578749525,3578749561,36
1,1295,36299,3578749525,3578749561,36
1,1295,36300,3578749525,3578749561,36
1,1295,36301,3578749525,3578749562,37
1,1295,36302,3578749525,3578749563,38
1,1295,36303,3578749525,3578749565,40
1,1295,36304,3578749525,3578749565,40
1,1295,36305,3578749525,3578749565,40
1,1295,36306,3578749525,3578749565,40
1,1295,36307,3578749525,3578749565,40
1,1295,36308,3578749525,3578749568,43
1,1295,36309,3578749525,3578749569,44
1,1295,36310,3578749525,3578749569,44
1,1295,36311,3578749525,3578749570,45
1,1295,36312,3578749525,3578749570,45
1,1295,36313,3578749525,3578749573,48
1,1295,36314,3578749525,3578749573,48
1,1295,36315,3578749525,3578749574,49
1,1296,36316,3578749588,3578749588,0
1,1296,36317,3578749588,3578749588,0
1,1296,36318,3578749588,3578749588,0
1,1296,36319,3578749588,3578749588,0
1,1296,36320,3578749588,3578749588,0
1,1296,36321,3578749588,3578749588,0
1,1296,36322,3578749588,3578749588,0
1,1296,36323,3578749588,3578749588,0
1,1296,36324,3578749588,3578749588,0
1,1296,36325,3578749588,3578749588,0
1,1296,36326,3578749588,3578749588,0
1,1296,36327,3578749588,3578749588,0
1,1296,36328,3578749588,3578749588,0
1,1296,36329,3578749588,3578749588,0
1,1296,36330,3578749588,3578749588,0
1,1296,36331,3578749588,3578749588,0
1,1296,36332,3578749588,3578749589,1
1,1296,36333,3578749588,3578749590,2
1,1296,36334,3578749588,3578749591,3
1,1296,36335,3578749588,3578749591,3
1,1296,36336,3578749588,3578749591,3
1,1296,36337,3578749588,3578749592,4
1,1296,36338,3578749588,3578749593,5
1,1296,36339,3578749588,3578749595,7
1,1296,36340,3578749588,3578749596,8
1,1296,36341,3578749588,3578749596,8
1,1296,36342,3578749588,3578749596,8
1,1296,36343,3578749588,3578749596,8
1,1296,36344,3578749588,3578749596,8
1,1296,36345,3578749588,3578749597,9
1,1296,36346,3578749588,3578749598,10
1,1296,36347,3578749588,3578749598,10
1,1296,36348,3578749588,3578749599,11
1,1296,36349,3578749588,3578749599,11
1,1296,36350,3578749588,3578749600,12
1,1296,36351,3578749588,3578749600,12
1,1296,36352,3578749588,3578749603,15
1,1296,36353,3578749588,3578749604,16
1,1296,36354,3578749588,3578749610,22
1,1296,36355,3578749588,3578749611,23
1,1296,36356,3578749588,3578749612,24
1,1296,36357,3578749588,3578749615,27
1,1296,36358,3578749588,3578749615,27
1,1296,36359,3578749588,3578749615,27
1,1296,36360,3578749588,3578749616,28
1,1296,36361,3578749588,3578749618,30
1,1296,36362,3578749588,3578749618,30
1,1296,36363,3578749588,3578749618,30
1,1296,36364,3578749588,3578749618,30
1,1296,36365,3578749588,3578749620,32
1,1296,36366,3578749588,3578749623,35
1,1296,36367,3578749588,3578749624,36
1,1296,36368,3578749588,3578749624,36
1,1296,36369,3578749588,3578749624,36
1,1296,36370,3578749588,3578749624,36
1,1296,36371,3578749588,3578749626,38
1,1296,36372,3578749588,3578749628,40
1,1296,36373,3578749588,3578749629,41
1,1296,36374,3578749588,3578749629,41
1,1296,36375,3578749588,3578749631,43
1,1296,36376,3578749588,3578749631,43
1,1296,36377,3578749588,3578749631,43
1,1296,36378,3578749588,3578749634,46
1,1296,36379,3578749588,3578749635,47
1,1296,36380,3578749588,3578749636,48
1,1296,36381,3578749588,3578749637,49
1,1297,36382,3578749651,3578749651,0
1,1297,36383,3578749651,3578749651,0
1,1297,36384,3578749651,3578749651,0
1,1297,36385,3578749651,3578749651,0
1,1297,36386,3578749651,3578749651,0
1,1297,36387,3578749651,3578749651,0
1,1297,36388,3578749651,3578749651,0
1,1297,36389,3578749651,3578749651,0
1,1297,36390,3578749651,3578749651,0
1,1297,36391,3578749651,3578749651,0
1,1297,36392,3578749651,3578749651,0
1,1297,36393,3578749651,3578749651,0
1,1297,36394,3578749651,3578749651,0
1,1297,36395,3578749651,3578749652,1
1,1297,36396,3578749651,3578749654,3
1,1297,36397,3578749651,3578749655,4
1,1297,36398,3578749651,3578749655,4
1,1297,36399,3578749651,3578749657,6
1,1297,36400,3578749651,3578749658,7
1,1297,36401,3578749651,3578749661,10
1,1297,36402,3578749651,3578749662,11
1,1297,36403,3578749651,3578749662,11
1,1297,36404,3578749651,3578749663,12
1,1297,36405,3578749651,3578749663,12
1,1297,36406,3578749651,3578749664,13
1,1297,36407,3578749651,3578749664,13
1,1297,36408,3578749651,3578749667,16
1,1297,36409,3578749651,3578749667,16
1,1297,36410,3578749651,3578749668,17
1,1297,36411,3578749651,3578749669,18
1,1297,36412,3578749651,3578749677,26
1,1297,36413,3578749651,3578749677,26
1,1297,36414,3578749651,3578749680,29
1,1297,36415,3578749651,3578749682,31
1,1297,36416,3578749651,3578749683,32
1,1297,36417,3578749651,3578749683,32
1,1297,36418,3578749651,3578749684,33
1,1297,36419,3578749651,3578749686,35
1,1297,36420,3578749651,3578749686,35
1,1297,36421,3578749651,3578749686,35
1,1297,36422,3578749651,3578749687,36
1,1297,36423,3578749651,3578749690,39
1,1297,36424,3578749651,3578749690,39
1,1297,36425,3578749651,3578749691,40
1,1297,36426,3578749651,3578749691,40
1,1297,36427,3578749651,3578749692,41
1,1297,36428,3578749651,3578749693,42
1,1297,36429,3578749651,3578749694,43
1,1297,36430,3578749651,3578749696,45
1,1297,36431,3578749651,3578749698,47
1,1297,36432,3578749651,3578749698,47
1,1297,36433,3578749651,3578749699,48
1,1297,36434,3578749651,3578749700,49
1,1298,36435,3578749713,3578749713,0
1,1298,36436,3578749713,3578749713,0
1,1298,36437,3578749713,3578749713,0
1,1298,36438,3578749713,3578749713,0
1,1298,36439,3578749713,3578749713,0
1,1298,36440,3578749713,3578749713,0
1,1298,36441,3578749713,3578749713,0
1,1298,36442,3578749713,3578749713,0
1,1298,36443,3578749713,3578749713,0
1,1298,36444,3578749713,3578749713,0
1,1298,36445,3578749713,3578749713,0
1,1298,36446,3578749713,3578749713,0
1,1298,36447,3578749713,3578749713,0
1,1298,36448,3578749713,3578749713,0
1,1298,36449,3578749713,3578749713,0
1,1298,36450,3578749713,3578749713,0
1,1298,36451,3578749713,3578749713,0
1,1298,36452,3578749713,3578749713,0
1,1298,36453,3578749713,3578749714,1
1,1298,36454,3578749713,3578749714,1
1,1298,36455,3578749713,3578749715,2
1,1298,36456,3578749713,3578749716,3
1,1298,36457,3578749713,3578749716,3
1,1298,36458,3578749713,3578749717,4
1,1298,36459,3578749713,3578749718,5
1,1298,36460,3578749713,3578749719,6
1,1298,36461,3578749713,3578749720,7
1,1298,36462,3578749713,3578749721,8
1,1298,36463,3578749713,3578749721,8
1,1298,36464,3578749713,3578749721,8
1,1298,36465,3578749713,3578749722,9
1,1298,36466,3578749713,3578749724,11
1,1298,36467,3578749713,3578749724,11
1,1298,36468,3578749713,3578749724,11
1,1298,36469,3578749713,3578749725,12
1,1298,36470,3578749713,3578749726,13
1,1298,36471,3578749713,3578749726,13
1,1298,36472,3578749713,3578749728,15
1,1298,36473,3578749713,3578749728,15
1,1298,36474,3578749713,3578749729,16
1,1298,36475,3578749713,3578749729,16
1,1298,36476,3578749713,3578749729,16
1,1298,36477,3578749713,3578749731,18
1,1298,36478,3578749713,3578749731,18
1,1298,36479,3578749713,3578749731,18
1,1298,36480,3578749713,3578749732,19
1,1298,36481,3578749713,3578749733,20
1,1298,36482,3578749713,3578749734,21
1,1298,36483,3578749713,3578749734,21
1,1298,36484,3578749713,3578749734,21
1,1298,36485,3578749713,3578749734,21
1,1298,36486,3578749713,3578749735,22
1,1298,36487,3578749713,3578749736,23
1,1298,36488,3578749713,3578749736,23
1,1298,36489,3578749713,3578749737,24
1,1298,36490,3578749713,3578749738,25
1,1298,36491,3578749713,3578749739,26
1,1298,36492,3578749713,3578749742,29
1,1298,36493,3578749713,3578749742,29
1,1298,36494,3578749713,3578749743,30
1,1298,36495,3578749713,3578749746,33
1,1298,36496,3578749713,3578749747,34
1,1298,36497,3578749713,3578749748,35
1,1298,36498,3578749713,3578749748,35
1,1298,36499,3578749713,3578749749,36
1,1298,36500,3578749713,3578749749,36
1,1298,36501,3578749713,3578749751,38
1,1298,36502,3578749713,3578749752,39
1,1298,36503,3578749713,3578749752,39
1,1298,36504,3578749713,3578749754,41
1,1298,36505,3578749713,3578749755,42
1,1298,36506,3578749713,3578749756,43
1,1298,36507,3578749713,3578749757,44
1,1298,36508,3578749713,3578749757,44
1,1298,36509,3578749713,3578749759,46
1,1298,36510,3578749713,3578749760,47
1,1298,36511,3578749713,3578749761,48
1,1298,36512,3578749713,3578749762,49
1,1298,36513,3578749713,3578749762,49
1,1299,36514,3578749776,3578749776,0
1,1299,36515,3578749776,3578749776,0
1,1299,36516,3578749776,3578749776,0
1,1299,36517,3578749776,3578749776,0
1,1299,36518,3578749776,3578749776,0
1,1299,36519,3578749776,3578749776,0
1,1299,36520,3578749776,3578749776,0
1,1299,36521,3578749776,3578749776,0
1,1299,36522,3578749776,3578749776,0
1,1299,36523,3578749776,3578749776,0
1,1299,36524,3578749776,3578749776,0
1,1299,36525,3578749776,3578749776,0
1,1299,36526,3578749776,3578749776,0
1,1299,36527,3578749776,3578749776,0
1,1299,36528,3578749776,3578749776,0
1,1299,36529,3578749776,3578749776,0
1,1299,36530,3578749776,3578749778,2
1,1299,36531,3578749776,3578749778,2
1,1299,36532,3578749776,3578749778,2
1,1299,36533,3578749776,3578749778,2
1,1299,36534,3578749776,3578749778,2
1,1299,36535,3578749776,3578749779,3
1,1299,36536,3578749776,3578749781,5
1,1299,36537,3578749776,3578749781,5
1,1299,36538,3578749776,3578749781,5
1,1299,36539,3578749776,3578749782,6
1,1299,36540,3578749776,3578749783,7
1,1299,36541,3578749776,3578749784,8
1,1299,36542,3578749776,3578749785,9
1,1299,36543,3578749776,3578749786,10
1,1299,36544,3578749776,3578749789,13
1,1299,36545,3578749776,3578749790,14
1,1299,36546,3578749776,3578749790,14
1,1299,36547,3578749776,3578749791,15
1,1299,36548,3578749776,3578749791,15
1,1299,36549,3578749776,3578749792,16
1,1299,36550,3578749776,3578749792,16
1,1299,36551,3578749776,3578749793,17
1,1299,36552,3578749776,3578749795,19
1,1299,36553,3578749776,3578749796,20
1,1299,36554,3578749776,3578749796,20
1,1299,36555,3578749776,3578749796,20
1,1299,36556,3578749776,3578749797,21
1,1299,36557,3578749776,3578749797,21
1,1299,36558,3578749776,3578749797,21
1,1299,36559,3578749776,3578749798,22
1,1299,36560,3578749776,3578749799,23
1,1299,36561,3578749776,3578749799,23
1,1299,36562,3578749776,3578749799,23
1,1299,36563,3578749776,3578749800,24
1,1299,36564,3578749776,3578749800,24
1,1299,36565,3578749776,3578749801,25
1,1299,36566,3578749776,3578749803,27
1,1299,36567,3578749776,3578749806,30
1,1299,36568,3578749776,3578749809,33
1,1299,36569,3578749776,3578749810,34
1,1299,36570,3578749776,3578749810,34
1,1299,36571,3578749776,3578749812,36
1,1299,36572,3578749776,3578749813,37
1,1299,36573,3578749776,3578749815,39
1,1299,36574,3578749776,3578749815,39
1,1299,36575,3578749776,3578749816,40
1,1299,36576,3578749776,3578749818,42
1,1299,36577,3578749776,3578749818,42
1,1299,36578,3578749776,3578749818,42
1,1299,36579,3578749776,3578749820,44
1,1299,36580,3578749776,3578749823,47
1,1299,36581,3578749776,3578749823,47
1,1299,36582,3578749776,3578749824,48
1,1299,36583,3578749776,3578749824,48
1,1299,36584,3578749776,3578749825,49
1,1300,36585,3578749837,3578749838,1
1,1300,36586,3578749837,3578749838,1
1,1300,36587,3578749837,3578749838,1
1,1300,36588,3578749837,3578749838,1
1,1300,36589,3578749837,3578749838,1
1,1300,36590,3578749837,3578749838,1
1,1300,36591,3578749837,3578749838,1
1,1300,36592,3578749837,3578749838,1
1,1300,36593,3578749837,3578749838,1
1,1300,36594,3578749837,3578749838,1
1,1300,36595,3578749837,3578749838,1
1,1300,36596,3578749837,3578749839,2
1,1300,36597,3578749837,3578749839,2
1,1300,36598,3578749837,3578749841,4
1,1300,36599,3578749837,3578749842,5
1,1300,36600,3578749837,3578749842,5
1,1300,36601,3578749837,3578749842,5
1,1300,36602,3578749837,3578749843,6
1,1300,36603,3578749837,3578749845,8
1,1300,36604,3578749837,3578749847,10
1,1300,36605,3578749837,3578749848,11
1,1300,36606,3578749837,3578749848,11
1,1300,36607,3578749837,3578749848,11
1,1300,36608,3578749837,3578749849,12
1,1300,36609,3578749837,3578749850,13
1,1300,36610,3578749837,3578749851,14
1,1300,36611,3578749837,3578749852,15
1,1300,36612,3578749837,3578749854,17
1,1300,36613,3578749837,3578749854,17
1,1300,36614,3578749837,3578749855,18
1,1300,36615,3578749837,3578749856,19
1,1300,36616,3578749837,3578749857,20
1,1300,36617,3578749837,3578749858,21
1,1300,36618,3578749837,3578749860,23
1,1300,36619,3578749837,3578749861,24
1,1300,36620,3578749837,3578749863,26
1,1300,36621,3578749837,3578749863,26
1,1300,36622,3578749837,3578749864,27
1,1300,36623,3578749837,3578749864,27
1,1300,36624,3578749837,3578749865,28
1,1300,36625,3578749837,3578749867,30
1,1300,36626,3578749837,3578749867,30
1,1300,36627,3578749837,3578749868,31
1,1300,36628,3578749837,3578749869,32
1,1300,36629,3578749837,3578749877,40
1,1300,36630,3578749837,3578749877,40
1,1300,36631,3578749837,3578749880,43
1,1300,36632,3578749837,3578749882,45
1,1300,36633,3578749837,3578749883,46
1,1300,36634,3578749837,3578749884,47
1,1300,36635,3578749837,3578749884,47
1,1300,36636,3578749837,3578749885,48
1,1300,36637,3578749837,3578749886,49
1,1300,36638,3578749837,3578749886,49
1,1300,36639,3578749837,3578749887,50
1,1301,36640,3578749898,3578749898,0
1,1301,36641,3578749898,3578749898,0
1,1301,36642,3578749898,3578749898,0
1,1301,36643,3578749898,3578749898,0
1,1301,36644,3578749898,3578749898,0
1,1301,36645,3578749898,3578749898,0
1,1301,36646,3578749898,3578749898,0
1,1301,36647,3578749898,3578749898,0
1,1301,36648,3578749898,3578749898,0
1,1301,36649,3578749898,3578749899,1
1,1301,36650,3578749898,3578749900,2
1,1301,36651,3578749898,3578749901,3
1,1301,36652,3578749898,3578749901,3
1,1301,36653,3578749898,3578749901,3
1,1301,36654,3578749898,3578749901,3
1,1301,36655,3578749898,3578749901,3
1,1301,36656,3578749898,3578749902,4
1,1301,36657,3578749898,3578749902,4
1,1301,36658,3578749898,3578749902,4
1,1301,36659,3578749898,3578749904,6
1,1301,36660,3578749898,3578749904,6
1,1301,36661,3578749898,3578749906,8
1,1301,36662,3578749898,3578749907,9
1,1301,36663,3578749898,3578749907,9
1,1301,36664,3578749898,3578749908,10
1,1301,36665,3578749898,3578749910,12
1,1301,36666,3578749898,3578749911,13
1,1301,36667,3578749898,3578749912,14
1,1301,36668,3578749898,3578749912,14
1,1301,36669,3578749898,3578749912,14
1,1301,36670,3578749898,3578749912,14
1,1301,36671,3578749898,3578749912,14
1,1301,36672,3578749898,3578749913,15
1,1301,36673,3578749898,3578749914,16
1,1301,36674,3578749898,3578749914,16
1,1301,36675,3578749898,3578749916,18
1,1301,36676,3578749898,3578749916,18
1,1301,36677,3578749898,3578749918,20
1,1301,36678,3578749898,3578749918,20
1,1301,36679,3578749898,3578749919,21
1,1301,36680,3578749898,3578749920,22
1,1301,36681,3578749898,3578749921,23
1,1301,36682,3578749898,3578749921,23
1,1301,36683,3578749898,3578749922,24
1,1301,36684,3578749898,3578749922,24
1,1301,36685,3578749898,3578749924,26
1,1301,36686,3578749898,3578749925,27
1,1301,36687,3578749898,3578749925,27
1,1301,36688,3578749898,3578749926,28
1,1301,36689,3578749898,3578749926,28
1,1301,36690,3578749898,3578749927,29
1,1301,36691,3578749898,3578749928,30
1,1301,36692,3578749898,3578749928,30
1,1301,36693,3578749898,3578749929,31
1,1301,36694,3578749898,3578749930,32
1,1301,36695,3578749898,3578749931,33
1,1301,36696,3578749898,3578749931,33
1,1301,36697,3578749898,3578749932,34
1,1301,36698,3578749898,3578749932,34
1,1301,36699,3578749898,3578749933,35
1,1301,36700,3578749898,3578749934,36
1,1301,36701,3578749898,3578749934,36
1,1301,36702,3578749898,3578749934,36
1,1301,36703,3578749898,3578749934,36
1,1301,36704,3578749898,3578749935,37
1,1301,36705,3578749898,3578749935,37
1,1301,36706,3578749898,3578749936,38
1,1301,36707,3578749898,3578749936,38
1,1301,36708,3578749898,3578749938,40
1,1301,36709,3578749898,3578749939,41
1,1301,36710,3578749898,3578749941,43
1,1301,36711,3578749898,3578749942,44
1,1301,36712,3578749898,3578749942,44
1,1301,36713,3578749898,3578749946,48
1,1302,36714,3578749961,3578749961,0
1,1302,36715,3578749961,3578749961,0
1,1302,36716,3578749961,3578749961,0
1,1302,36717,3578749961,3578749961,0
1,1302,36718,3578749961,3578749961,0
1,1302,36719,3578749961,3578749961,0
1,1302,36720,3578749961,3578749961,0
1,1302,36721,3578749961,3578749961,0
1,1302,36722,3578749961,3578749961,0
1,1302,36723,3578749961,3578749961,0
1,1302,36724,3578749961,3578749961,0
1,1302,36725,3578749961,3578749961,0
1,1302,36726,3578749961,3578749961,0
1,1302,36727,3578749961,3578749961,0
1,1302,36728,3578749961,3578749961,0
1,1302,36729,3578749961,3578749962,1
1,1302,36730,3578749961,3578749962,1
1,1302,36731,3578749961,3578749962,1
1,1302,36732,3578749961,3578749962,1
1,1302,36733,3578749961,3578749963,2
1,1302,36734,3578749961,3578749964,3
1,1302,36735,3578749961,3578749965,4
1,1302,36736,3578749961,3578749966,5
1,1302,36737,3578749961,3578749967,6
1,1302,36738,3578749961,3578749968,7
1,1302,36739,3578749961,3578749969,8
1,1302,36740,3578749961,3578749970,9
1,1302,36741,3578749961,3578749970,9
1,1302,36742,3578749961,3578749971,10
1,1302,36743,3578749961,3578749973,12
1,1302,36744,3578749961,3578749974,13
1,1302,36745,3578749961,3578749974,13
1,1302,36746,3578749961,3578749976,15
1,1302,36747,3578749961,3578749977,16
1,1302,36748,3578749961,3578749978,17
1,1302,36749,3578749961,3578749978,17
1,1302,36750,3578749961,3578749978,17
1,1302,36751,3578749961,3578749978,17
1,1302,36752,3578749961,3578749979,18
1,1302,36753,3578749961,3578749979,18
1,1302,36754,3578749961,3578749980,19
1,1302,36755,3578749961,3578749982,21
1,1302,36756,3578749961,3578749982,21
1,1302,36757,3578749961,3578749982,21
1,1302,36758,3578749961,3578749983,22
1,1302,36759,3578749961,3578749983,22
1,1302,36760,3578749961,3578749986,25
1,1302,36761,3578749961,3578749986,25
1,1302,36762,3578749961,3578749988,27
1,1302,36763,3578749961,3578749990,29
1,1302,36764,3578749961,3578749990,29
1,1302,36765,3578749961,3578749991,30
1,1302,36766,3578749961,3578749992,31
1,1302,36767,3578749961,3578749992,31
1,1302,36768,3578749961,3578749992,31
1,1302,36769,3578749961,3578749995,34
1,1302,36770,3578749961,3578749996,35
1,1302,36771,3578749961,3578749996,35
1,1302,36772,3578749961,3578749997,36
1,1302,36773,3578749961,3578749997,36
1,1302,36774,3578749961,3578749997,36
1,1302,36775,3578749961,3578749997,36
1,1302,36776,3578749961,3578749997,36
1,1302,36777,3578749961,3578749999,38
1,1302,36778,3578749961,3578749999,38
1,1302,36779,3578749961,3578749999,38
1,1302,36780,3578749961,3578750000,39
1,1302,36781,3578749961,3578750001,40
1,1302,36782,3578749961,3578750001,40
1,1302,36783,3578749961,3578750003,42
1,1302,36784,3578749961,3578750006,45
1,1302,36785,3578749961,3578750009,48
1,1302,36786,3578749961,3578750010,49
1,1303,36787,3578750024,3578750024,0
1,1303,36788,3578750024,3578750024,0
1,1303,36789,3578750024,3578750024,0
1,1303,36790,3578750024,3578750024,0
1,1303,36791,3578750024,3578750024,0
1,1303,36792,3578750024,3578750024,0
1,1303,36793,3578750024,3578750024,0
1,1303,36794,3578750024,3578750024,0
1,1303,36795,3578750024,3578750024,0
1,1303,36796,3578750024,3578750024,0
1,1303,36797,3578750024,3578750024,0
1,1303,36798,3578750024,3578750024,0
1,1303,36799,3578750024,3578750024,0
1,1303,36800,3578750024,3578750024,0
1,1303,36801,3578750024,3578750024,0
1,1303,36802,3578750024,3578750024,0
1,1303,36803,3578750024,3578750024,0
1,1303,36804,3578750024,3578750026,2
1,1303,36805,3578750024,3578750028,4
1,1303,36806,3578750024,3578750028,4
1,1303,36807,3578750024,3578750029,5
1,1303,36808,3578750024,3578750029,5
1,1303,36809,3578750024,3578750030,6
1,1303,36810,3578750024,3578750031,7
1,1303,36811,3578750024,3578750032,8
1,1303,36812,3578750024,3578750033,9
1,1303,36813,3578750024,3578750034,10
1,1303,36814,3578750024,3578750036,12
1,1303,36815,3578750024,3578750036,12
1,1303,36816,3578750024,3578750037,13
1,1303,36817,3578750024,3578750039,15
1,1303,36818,3578750024,3578750039,15
1,1303,36819,3578750024,3578750041,17
1,1303,36820,3578750024,3578750042,18
1,1303,36821,3578750024,3578750042,18
1,1303,36822,3578750024,3578750043,19
1,1303,36823,3578750024,3578750044,20
1,1303,36824,3578750024,3578750045,21
1,1303,36825,3578750024,3578750047,23
1,1303,36826,3578750024,3578750048,24
1,1303,36827,3578750024,3578750048,24
1,1303,36828,3578750024,3578750050,26
1,1303,36829,3578750024,3578750050,26
1,1303,36830,3578750024,3578750052,28
1,1303,36831,3578750024,3578750052,28
1,1303,36832,3578750024,3578750052,28
1,1303,36833,3578750024,3578750054,30
1,1303,36834,3578750024,3578750055,31
1,1303,36835,3578750024,3578750056,32
1,1303,36836,3578750024,3578750058,34
1,1303,36837,3578750024,3578750060,36
1,1303,36838,3578750024,3578750061,37
1,1303,36839,3578750024,3578750063,39
1,1303,36840,3578750024,3578750064,40
1,1303,36841,3578750024,3578750064,40
1,1303,36842,3578750024,3578750064,40
1,1303,36843,3578750024,3578750065,41
1,1303,36844,3578750024,3578750067,43
1,1303,36845,3578750024,3578750068,44
1,1303,36846,3578750024,3578750068,44
1,1303,36847,3578750024,3578750069,45
1,1304,36848,3578750087,3578750087,0
1,1304,36849,3578750087,3578750087,0
1,1304,36850,3578750087,3578750087,0
1,1304,36851,3578750087,3578750087,0
1,1304,36852,3578750087,3578750087,0
1,1304,36853,3578750087,3578750087,0
1,1304,36854,3578750087,3578750087,0
1,1304,36855,3578750087,3578750087,0
1,1304,36856,3578750087,3578750087,0
1,1304,36857,3578750087,3578750087,0
1,1304,36858,3578750087,3578750087,0
1,1304,36859,3578750087,3578750090,3
1,1304,36860,3578750087,3578750091,4
1,1304,36861,3578750087,3578750092,5
1,1304,36862,3578750087,3578750093,6
1,1304,36863,3578750087,3578750094,7
1,1304,36864,3578750087,3578750095,8
1,1304,36865,3578750087,3578750096,9
1,1304,36866,3578750087,3578750099,12
1,1304,36867,3578750087,3578750099,12
1,1304,36868,3578750087,3578750100,13
1,1304,36869,3578750087,3578750100,13
1,1304,36870,3578750087,3578750100,13
1,1304,36871,3578750087,3578750100,13
1,1304,36872,3578750087,3578750102,15
1,1304,36873,3578750087,3578750102,15
1,1304,36874,3578750087,3578750102,15
1,1304,36875,3578750087,3578750102,15
1,1304,36876,3578750087,3578750103,16
1,1304,36877,3578750087,3578750104,17
1,1304,36878,3578750087,3578750105,18
1,1304,36879,3578750087,3578750106,19
1,1304,36880,3578750087,3578750106,19
1,1304,36881,3578750087,3578750107,20
1,1304,36882,3578750087,3578750108,21
1,1304,36883,3578750087,3578750110,23
1,1304,36884,3578750087,3578750111,24
1,1304,36885,3578750087,3578750112,25
1,1304,36886,3578750087,3578750112,25
1,1304,36887,3578750087,3578750112,25
1,1304,36888,3578750087,3578750112,25
1,1304,36889,3578750087,3578750112,25
1,1304,36890,3578750087,3578750113,26
1,1304,36891,3578750087,3578750114,27
1,1304,36892,3578750087,3578750114,27
1,1304,36893,3578750087,3578750115,28
1,1304,36894,3578750087,3578750116,29
1,1304,36895,3578750087,3578750117,30
1,1304,36896,3578750087,3578750118,31
1,1304,36897,3578750087,3578750118,31
1,1304,36898,3578750087,3578750119,32
1,1304,36899,3578750087,3578750120,33
1,1304,36900,3578750087,3578750121,34
1,1304,36901,3578750087,3578750121,34
1,1304,36902,3578750087,3578750122,35
1,1304,36903,3578750087,3578750123,36
1,1304,36904,3578750087,3578750125,38
1,1304,36905,3578750087,3578750125,38
1,1304,36906,3578750087,3578750125,38
1,1304,36907,3578750087,3578750125,38
1,1304,36908,3578750087,3578750126,39
1,1304,36909,3578750087,3578750126,39
1,1304,36910,3578750087,3578750127,40
1,1304,36911,3578750087,3578750127,40
1,1304,36912,3578750087,3578750129,42
1,1304,36913,3578750087,3578750129,42
1,1304,36914,3578750087,3578750129,42
1,1304,36915,3578750087,3578750130,43
1,1304,36916,3578750087,3578750131,44
1,1304,36917,3578750087,3578750131,44
1,1304,36918,3578750087,3578750132,45
1,1304,36919,3578750087,3578750133,46
1,1304,36920,3578750087,3578750133,46
1,1304,36921,3578750087,3578750134,47
1,1304,36922,3578750087,3578750134,47
1,1304,36923,3578750087,3578750134,47
1,1304,36924,3578750087,3578750135,48
1,1304,36925,3578750087,3578750135,48
1,1304,36926,3578750087,3578750136,49
1,1305,36927,3578750150,3578750150,0
1,1305,36928,3578750150,3578750150,0
1,1305,36929,3578750150,3578750150,0
1,1305,36930,3578750150,3578750150,0
1,1305,36931,3578750150,3578750150,0
1,1305,36932,3578750150,3578750150,0
1,1305,36933,3578750150,3578750150,0
1,1305,36934,3578750150,3578750150,0
1,1305,36935,3578750150,3578750150,0
1,1305,36936,3578750150,3578750150,0
1,1305,36937,3578750150,3578750150,0
1,1305,36938,3578750150,3578750150,0
1,1305,36939,3578750150,3578750151,1
1,1305,36940,3578750150,3578750152,2
1,1305,36941,3578750150,3578750153,3
1,1305,36942,3578750150,3578750154,4
1,1305,36943,3578750150,3578750155,5
1,1305,36944,3578750150,3578750156,6
1,1305,36945,3578750150,3578750157,7
1,1305,36946,3578750150,3578750158,8
1,1305,36947,3578750150,3578750160,10
1,1305,36948,3578750150,3578750160,10
1,1305,36949,3578750150,3578750162,12
1,1305,36950,3578750150,3578750162,12
1,1305,36951,3578750150,3578750163,13
1,1305,36952,3578750150,3578750163,13
1,1305,36953,3578750150,3578750165,15
1,1305,36954,3578750150,3578750165,15
1,1305,36955,3578750150,3578750166,16
1,1305,36956,3578750150,3578750167,17
1,1305,36957,3578750150,3578750168,18
1,1305,36958,3578750150,3578750168,18
1,1305,36959,3578750150,3578750169,19
1,1305,36960,3578750150,3578750170,20
1,1305,36961,3578750150,3578750170,20
1,1305,36962,3578750150,3578750171,21
1,1305,36963,3578750150,3578750173,23
1,1305,36964,3578750150,3578750174,24
1,1305,36965,3578750150,3578750174,24
1,1305,36966,3578750150,3578750175,25
1,1305,36967,3578750150,3578750178,28
1,1305,36968,3578750150,3578750178,28
1,1305,36969,3578750150,3578750178,28
1,1305,36970,3578750150,3578750179,29
1,1305,36971,3578750150,3578750179,29
1,1305,36972,3578750150,3578750179,29
1,1305,36973,3578750150,3578750180,30
1,1305,36974,3578750150,3578750181,31
1,1305,36975,3578750150,3578750182,32
1,1305,36976,3578750150,3578750182,32
1,1305,36977,3578750150,3578750183,33
1,1305,36978,3578750150,3578750183,33
1,1305,36979,3578750150,3578750186,36
1,1305,36980,3578750150,3578750187,37
1,1305,36981,3578750150,3578750188,38
1,1305,36982,3578750150,3578750190,40
1,1305,36983,3578750150,3578750191,41
1,1305,36984,3578750150,3578750191,41
1,1305,36985,3578750150,3578750191,41
1,1305,36986,3578750150,3578750192,42
1,1305,36987,3578750150,3578750192,42
1,1305,36988,3578750150,3578750193,43
1,1305,36989,3578750150,3578750195,45
1,1305,36990,3578750150,3578750196,46
1,1305,36991,3578750150,3578750196,46
1,1305,36992,3578750150,3578750197,47
1,1305,36993,3578750150,3578750197,47
1,1305,36994,3578750150,3578750197,47
1,1305,36995,3578750150,3578750199,49
1,1305,36996,3578750150,3578750199,49
1,1305,36997,3578750150,3578750199,49
1,1305,36998,3578750150,3578750200,50
1,1306,36999,3578750212,3578750212,0
1,1306,37000,3578750212,3578750212,0
1,1306,37001,3578750212,3578750212,0
1,1306,37002,3578750212,3578750212,0
1,1306,37003,3578750212,3578750213,1
1,1306,37004,3578750212,3578750213,1
1,1306,37005,3578750212,3578750213,1
1,1306,37006,3578750212,3578750213,1
1,1306,37007,3578750212,3578750215,3
1,1306,37008,3578750212,3578750217,5
1,1306,37009,3578750212,3578750217,5
1,1306,37010,3578750212,3578750217,5
1,1306,37011,3578750212,3578750218,6
1,1306,37012,3578750212,3578750219,7
1,1306,37013,3578750212,3578750220,8
1,1306,37014,3578750212,3578750220,8
1,1306,37015,3578750212,3578750223,11
1,1306,37016,3578750212,3578750223,11
1,1306,37017,3578750212,3578750224,12
1,1306,37018,3578750212,3578750224,12
1,1306,37019,3578750212,3578750224,12
1,1306,37020,3578750212,3578750227,15
1,1306,37021,3578750212,3578750228,16
1,1306,37022,3578750212,3578750229,17
1,1306,37023,3578750212,3578750229,17
1,1306,37024,3578750212,3578750230,18
1,1306,37025,3578750212,3578750231,19
1,1306,37026,3578750212,3578750231,19
1,1306,37027,3578750212,3578750232,20
1,1306,37028,3578750212,3578750233,21
1,1306,37029,3578750212,3578750234,22
1,1306,37030,3578750212,3578750236,24
1,1306,37031,3578750212,3578750237,25
1,1306,37032,3578750212,3578750237,25
1,1306,37033,3578750212,3578750240,28
1,1306,37034,3578750212,3578750240,28
1,1306,37035,3578750212,3578750241,29
1,1306,37036,3578750212,3578750242,30
1,1306,37037,3578750212,3578750242,30
1,1306,37038,3578750212,3578750243,31
1,1306,37039,3578750212,3578750244,32
1,1306,37040,3578750212,3578750248,36
1,1306,37041,3578750212,3578750249,37
1,1306,37042,3578750212,3578750249,37
1,1306,37043,3578750212,3578750250,38
1,1306,37044,3578750212,3578750252,40
1,1306,37045,3578750212,3578750252,40
1,1306,37046,3578750212,3578750253,41
1,1306,37047,3578750212,3578750254,42
1,1306,37048,3578750212,3578750257,45
1,1306,37049,3578750212,3578750258,46
1,1306,37050,3578750212,3578750259,47
1,1306,37051,3578750212,3578750261,49
1,1307,37052,3578750274,3578750274,0
1,1307,37053,3578750274,3578750274,0
1,1307,37054,3578750274,3578750274,0
1,1307,37055,3578750274,3578750274,0
1,1307,37056,3578750274,3578750274,0
1,1307,37057,3578750274,3578750274,0
1,1307,37058,3578750274,3578750274,0
1,1307,37059,3578750274,3578750274,0
1,1307,37060,3578750274,3578750278,4
1,1307,37061,3578750274,3578750282,8
1,1307,37062,3578750274,3578750282,8
1,1307,37063,3578750274,3578750282,8
1,1307,37064,3578750274,3578750285,11
1,1307,37065,3578750274,3578750285,11
1,1307,37066,3578750274,3578750285,11
1,1307,37067,3578750274,3578750286,12
1,1307,37068,3578750274,3578750286,12
1,1307,37069,3578750274,3578750290,16
1,1307,37070,3578750274,3578750290,16
1,1307,37071,3578750274,3578750290,16
1,1307,37072,3578750274,3578750292,18
1,1307,37073,3578750274,3578750294,20
1,1307,37074,3578750274,3578750294,20
1,1307,37075,3578750274,3578750295,21
1,1307,37076,3578750274,3578750296,22
1,1307,37077,3578750274,3578750299,25
1,1307,37078,3578750274,3578750299,25
1,1307,37079,3578750274,3578750300,26
1,1307,37080,3578750274,3578750300,26
1,1307,37081,3578750274,3578750300,26
1,1307,37082,3578750274,3578750300,26
1,1307,37083,3578750274,3578750301,27
1,1307,37084,3578750274,3578750302,28
1,1307,37085,3578750274,3578750302,28
1,1307,37086,3578750274,3578750302,28
1,1307,37087,3578750274,3578750304,30
1,1307,37088,3578750274,3578750304,30
1,1307,37089,3578750274,3578750306,32
1,1307,37090,3578750274,3578750306,32
1,1307,37091,3578750274,3578750307,33
1,1307,37092,3578750274,3578750308,34
1,1307,37093,3578750274,3578750310,36
1,1307,37094,3578750274,3578750311,37
1,1307,37095,3578750274,3578750312,38
1,1307,37096,3578750274,3578750312,38
1,1307,37097,3578750274,3578750312,38
1,1307,37098,3578750274,3578750313,39
1,1307,37099,3578750274,3578750313,39
1,1307,37100,3578750274,3578750314,40
1,1307,37101,3578750274,3578750314,40
1,1307,37102,3578750274,3578750315,41
1,1307,37103,3578750274,3578750316,42
1,1307,37104,3578750274,3578750317,43
1,1307,37105,3578750274,3578750318,44
1,1307,37106,3578750274,3578750319,45
1,1307,37107,3578750274,3578750320,46
1,1307,37108,3578750274,3578750320,46
1,1307,37109,3578750274,3578750321,47
1,1307,37110,3578750274,3578750321,47
1,1307,37111,3578750274,3578750322,48
1,1307,37112,3578750274,3578750323,49
1,1308,37113,3578750336,3578750336,0
1,1308,37114,3578750336,3578750336,0
1,1308,37115,3578750336,3578750336,0
1,1308,37116,3578750336,3578750336,0
1,1308,37117,3578750336,3578750336,0
1,1308,37118,3578750336,3578750336,0
1,1308,37119,3578750336,3578750336,0
1,1308,37120,3578750336,3578750336,0
1,1308,37121,3578750336,3578750336,0
1,1308,37122,3578750336,3578750336,0
1,1308,37123,3578750336,3578750336,0
1,1308,37124,3578750336,3578750336,0
1,1308,37125,3578750336,3578750336,0
1,1308,37126,3578750336,3578750336,0
1,1308,37127,3578750336,3578750336,0
1,1308,37128,3578750336,3578750336,0
1,1308,37129,3578750336,3578750336,0
1,1308,37130,3578750336,3578750336,0
1,1308,37131,3578750336,3578750336,0
1,1308,37132,3578750336,3578750336,0
1,1308,37133,3578750336,3578750336,0
1,1308,37134,3578750336,3578750336,0
1,1308,37135,3578750336,3578750336,0
1,1308,37136,3578750336,3578750337,1
1,1308,37137,3578750336,3578750337,1
1,1308,37138,3578750336,3578750338,2
1,1308,37139,3578750336,3578750340,4
1,1308,37140,3578750336,3578750341,5
1,1308,37141,3578750336,3578750342,6
1,1308,37142,3578750336,3578750342,6
1,1308,37143,3578750336,3578750343,7
1,1308,37144,3578750336,3578750346,10
1,1308,37145,3578750336,3578750346,10
1,1308,37146,3578750336,3578750348,12
1,1308,37147,3578750336,3578750349,13
1,1308,37148,3578750336,3578750350,14
1,1308,37149,3578750336,3578750350,14
1,1308,37150,3578750336,3578750351,15
1,1308,37151,3578750336,3578750353,17
1,1308,37152,3578750336,3578750353,17
1,1308,37153,3578750336,3578750355,19
1,1308,37154,3578750336,3578750355,19
1,1308,37155,3578750336,3578750356,20
1,1308,37156,3578750336,3578750358,22
1,1308,37157,3578750336,3578750358,22
1,1308,37158,3578750336,3578750360,24
1,1308,37159,3578750336,3578750361,25
1,1308,37160,3578750336,3578750361,25
1,1308,37161,3578750336,3578750363,27
1,1308,37162,3578750336,3578750363,27
1,1308,37163,3578750336,3578750363,27
1,1308,37164,3578750336,3578750366,30
1,1308,37165,3578750336,3578750366,30
1,1308,37166,3578750336,3578750366,30
1,1308,37167,3578750336,3578750367,31
1,1308,37168,3578750336,3578750367,31
1,1308,37169,3578750336,3578750369,33
1,1308,37170,3578750336,3578750370,34
1,1308,37171,3578750336,3578750370,34
1,1308,37172,3578750336,3578750370,34
1,1308,37173,3578750336,3578750371,35
1,1308,37174,3578750336,3578750373,37
1,1308,37175,3578750336,3578750374,38
1,1308,37176,3578750336,3578750374,38
1,1308,37177,3578750336,3578750376,40
1,1308,37178,3578750336,3578750377,41
1,1308,37179,3578750336,3578750378,42
1,1308,37180,3578750336,3578750378,42
1,1308,37181,3578750336,3578750378,42
1,1308,37182,3578750336,3578750379,43
1,1308,37183,3578750336,3578750379,43
1,1308,37184,3578750336,3578750381,45
1,1308,37185,3578750336,3578750381,45
1,1308,37186,3578750336,3578750381,45
1,1308,37187,3578750336,3578750382,46
1,1308,37188,3578750336,3578750382,46
1,1308,37189,3578750336,3578750383,47
1,1308,37190,3578750336,3578750384,48
1,1309,37191,3578750398,3578750398,0
1,1309,37192,3578750398,3578750398,0
1,1309,37193,3578750398,3578750398,0
1,1309,37194,3578750398,3578750398,0
1,1309,37195,3578750398,3578750399,1
1,1309,37196,3578750398,3578750399,1
1,1309,37197,3578750398,3578750399,1
1,1309,37198,3578750398,3578750399,1
1,1309,37199,3578750398,3578750399,1
1,1309,37200,3578750398,3578750399,1
1,1309,37201,3578750398,3578750399,1
1,1309,37202,3578750398,3578750399,1
1,1309,37203,3578750398,3578750399,1
1,1309,37204,3578750398,3578750399,1
1,1309,37205,3578750398,3578750399,1
1,1309,37206,3578750398,3578750399,1
1,1309,37207,3578750398,3578750399,1
1,1309,37208,3578750398,3578750399,1
1,1309,37209,3578750398,3578750399,1
1,1309,37210,3578750398,3578750399,1
1,1309,37211,3578750398,3578750400,2
1,1309,37212,3578750398,3578750401,3
1,1309,37213,3578750398,3578750401,3
1,1309,37214,3578750398,3578750402,4
1,1309,37215,3578750398,3578750404,6
1,1309,37216,3578750398,3578750405,7
1,1309,37217,3578750398,3578750409,11
1,1309,37218,3578750398,3578750411,13
1,1309,37219,3578750398,3578750412,14
1,1309,37220,3578750398,3578750413,15
1,1309,37221,3578750398,3578750415,17
1,1309,37222,3578750398,3578750417,19
1,1309,37223,3578750398,3578750417,19
1,1309,37224,3578750398,3578750417,19
1,1309,37225,3578750398,3578750418,20
1,1309,37226,3578750398,3578750418,20
1,1309,37227,3578750398,3578750419,21
1,1309,37228,3578750398,3578750419,21
1,1309,37229,3578750398,3578750421,23
1,1309,37230,3578750398,3578750424,26
1,1309,37231,3578750398,3578750424,26
1,1309,37232,3578750398,3578750424,26
1,1309,37233,3578750398,3578750424,26
1,1309,37234,3578750398,3578750424,26
1,1309,37235,3578750398,3578750425,27
1,1309,37236,3578750398,3578750427,29
1,1309,37237,3578750398,3578750428,30
1,1309,37238,3578750398,3578750429,31
1,1309,37239,3578750398,3578750429,31
1,1309,37240,3578750398,3578750430,32
1,1309,37241,3578750398,3578750430,32
1,1309,37242,3578750398,3578750431,33
1,1309,37243,3578750398,3578750432,34
1,1309,37244,3578750398,3578750433,35
1,1309,37245,3578750398,3578750433,35
1,1309,37246,3578750398,3578750435,37
1,1309,37247,3578750398,3578750437,39
1,1309,37248,3578750398,3578750437,39
1,1309,37249,3578750398,3578750440,42
1,1309,37250,3578750398,3578750440,42
1,1309,37251,3578750398,3578750441,43
1,1309,37252,3578750398,3578750442,44
1,1309,37253,3578750398,3578750443,45
1,1309,37254,3578750398,3578750445,47
1,1309,37255,3578750398,3578750447,49
1,1310,37256,3578750461,3578750461,0
1,1310,37257,3578750461,3578750461,0
1,1310,37258,3578750461,3578750461,0
1,1310,37259,3578750461,3578750461,0
1,1310,37260,3578750461,3578750461,0
1,1310,37261,3578750461,3578750461,0
1,1310,37262,3578750461,3578750461,0
1,1310,37263,3578750461,3578750461,0
1,1310,37264,3578750461,3578750461,0
1,1310,37265,3578750461,3578750461,0
1,1310,37266,3578750461,3578750461,0
1,1310,37267,3578750461,3578750461,0
1,1310,37268,3578750461,3578750461,0
1,1310,37269,3578750461,3578750463,2
1,1310,37270,3578750461,3578750464,3
1,1310,37271,3578750461,3578750464,3
1,1310,37272,3578750461,3578750465,4
1,1310,37273,3578750461,3578750465,4
1,1310,37274,3578750461,3578750466,5
1,1310,37275,3578750461,3578750468,7
1,1310,37276,3578750461,3578750468,7
1,1310,37277,3578750461,3578750469,8
1,1310,37278,3578750461,3578750469,8
1,1310,37279,3578750461,3578750477,16
1,1310,37280,3578750461,3578750478,17
1,1310,37281,3578750461,3578750481,20
1,1310,37282,3578750461,3578750482,21
1,1310,37283,3578750461,3578750483,22
1,1310,37284,3578750461,3578750485,24
1,1310,37285,3578750461,3578750485,24
1,1310,37286,3578750461,3578750486,25
1,1310,37287,3578750461,3578750487,26
1,1310,37288,3578750461,3578750487,26
1,1310,37289,3578750461,3578750488,27
1,1310,37290,3578750461,3578750489,28
1,1310,37291,3578750461,3578750491,30
1,1310,37292,3578750461,3578750491,30
1,1310,37293,3578750461,3578750492,31
1,1310,37294,3578750461,3578750494,33
1,1310,37295,3578750461,3578750494,33
1,1310,37296,3578750461,3578750494,33
1,1310,37297,3578750461,3578750497,36
1,1310,37298,3578750461,3578750499,38
1,1310,37299,3578750461,3578750500,39
1,1310,37300,3578750461,3578750501,40
1,1310,37301,3578750461,3578750501,40
1,1310,37302,3578750461,3578750501,40
1,1310,37303,3578750461,3578750502,41
1,1310,37304,3578750461,3578750502,41
1,1310,37305,3578750461,3578750502,41
1,1310,37306,3578750461,3578750502,41
1,1310,37307,3578750461,3578750504,43
1,1310,37308,3578750461,3578750505,44
1,1310,37309,3578750461,3578750506,45
1,1310,37310,3578750461,3578750506,45
1,1310,37311,3578750461,3578750507,46
1,1310,37312,3578750461,3578750508,47
1,1310,37313,3578750461,3578750509,48
1,1311,37314,3578750523,3578750523,0
1,1311,37315,3578750523,3578750523,0
1,1311,37316,3578750523,3578750523,0
1,1311,37317,3578750523,3578750523,0
1,1311,37318,3578750523,3578750523,0
1,1311,37319,3578750523,3578750523,0
1,1311,37320,3578750523,3578750523,0
1,1311,37321,3578750523,3578750523,0
1,1311,37322,3578750523,3578750523,0
1,1311,37323,3578750523,3578750523,0
1,1311,37324,3578750523,3578750523,0
1,1311,37325,3578750523,3578750523,0
1,1311,37326,3578750523,3578750523,0
1,1311,37327,3578750523,3578750523,0
1,1311,37328,3578750523,3578750523,0
1,1311,37329,3578750523,3578750523,0
1,1311,37330,3578750523,3578750523,0
1,1311,37331,3578750523,3578750523,0
1,1311,37332,3578750523,3578750523,0
1,1311,37333,3578750523,3578750523,0
1,1311,37334,3578750523,3578750523,0
1,1311,37335,3578750523,3578750524,1
1,1311,37336,3578750523,3578750524,1
1,1311,37337,3578750523,3578750525,2
1,1311,37338,3578750523,3578750525,2
1,1311,37339,3578750523,3578750526,3
1,1311,37340,3578750523,3578750527,4
1,1311,37341,3578750523,3578750527,4
1,1311,37342,3578750523,3578750528,5
1,1311,37343,3578750523,3578750529,6
1,1311,37344,3578750523,3578750529,6
1,1311,37345,3578750523,3578750530,7
1,1311,37346,3578750523,3578750531,8
1,1311,37347,3578750523,3578750531,8
1,1311,37348,3578750523,3578750531,8
1,1311,37349,3578750523,3578750532,9
1,1311,37350,3578750523,3578750532,9
1,1311,37351,3578750523,3578750532,9
1,1311,37352,3578750523,3578750533,10
1,1311,37353,3578750523,3578750534,11
1,1311,37354,3578750523,3578750534,11
1,1311,37355,3578750523,3578750535,12
1,1311,37356,3578750523,3578750535,12
1,1311,37357,3578750523,3578750536,13
1,1311,37358,3578750523,3578750537,14
1,1311,37359,3578750523,3578750538,15
1,1311,37360,3578750523,3578750539,16
1,1311,37361,3578750523,3578750541,18
1,1311,37362,3578750523,3578750542,19
1,1311,37363,3578750523,3578750544,21
1,1311,37364,3578750523,3578750545,22
1,1311,37365,3578750523,3578750547,24
1,1311,37366,3578750523,3578750547,24
1,1311,37367,3578750523,3578750548,25
1,1311,37368,3578750523,3578750549,26
1,1311,37369,3578750523,3578750549,26
1,1311,37370,3578750523,3578750552,29
1,1311,37371,3578750523,3578750552,29
1,1311,37372,3578750523,3578750553,30
1,1311,37373,3578750523,3578750554,31
1,1311,37374,3578750523,3578750555,32
1,1311,37375,3578750523,3578750556,33
1,1311,37376,3578750523,3578750557,34
1,1311,37377,3578750523,3578750559,36
1,1311,37378,3578750523,3578750560,37
1,1311,37379,3578750523,3578750561,38
1,1311,37380,3578750523,3578750561,38
1,1311,37381,3578750523,3578750561,38
1,1311,37382,3578750523,3578750562,39
1,1311,37383,3578750523,3578750562,39
1,1311,37384,3578750523,3578750565,42
1,1311,37385,3578750523,3578750565,42
1,1311,37386,3578750523,3578750566,43
1,1311,37387,3578750523,3578750566,43
1,1311,37388,3578750523,3578750567,44
1,1311,37389,3578750523,3578750568,45
1,1311,37390,3578750523,3578750568,45
1,1311,37391,3578750523,3578750569,46
1,1311,37392,3578750523,3578750571,48
1,1311,37393,3578750523,3578750571,48
1,1311,37394,3578750523,3578750572,49
1,1312,37395,3578750584,3578750584,0
1,1312,37396,3578750584,3578750584,0
1,1312,37397,3578750584,3578750584,0
1,1312,37398,3578750584,3578750584,0
1,1312,37399,3578750584,3578750584,0
1,1312,37400,3578750584,3578750584,0
1,1312,37401,3578750584,3578750584,0
1,1312,37402,3578750584,3578750584,0
1,1312,37403,3578750584,3578750584,0
1,1312,37404,3578750584,3578750584,0
1,1312,37405,3578750584,3578750584,0
1,1312,37406,3578750584,3578750584,0
1,1312,37407,3578750584,3578750584,0
1,1312,37408,3578750584,3578750584,0
1,1312,37409,3578750584,3578750585,1
1,1312,37410,3578750584,3578750585,1
1,1312,37411,3578750584,3578750589,5
1,1312,37412,3578750584,3578750589,5
1,1312,37413,3578750584,3578750589,5
1,1312,37414,3578750584,3578750590,6
1,1312,37415,3578750584,3578750592,8
1,1312,37416,3578750584,3578750592,8
1,1312,37417,3578750584,3578750592,8
1,1312,37418,3578750584,3578750594,10
1,1312,37419,3578750584,3578750595,11
1,1312,37420,3578750584,3578750596,12
1,1312,37421,3578750584,3578750596,12
1,1312,37422,3578750584,3578750596,12
1,1312,37423,3578750584,3578750596,12
1,1312,37424,3578750584,3578750597,13
1,1312,37425,3578750584,3578750597,13
1,1312,37426,3578750584,3578750598,14
1,1312,37427,3578750584,3578750599,15
1,1312,37428,3578750584,3578750599,15
1,1312,37429,3578750584,3578750599,15
1,1312,37430,3578750584,3578750600,16
1,1312,37431,3578750584,3578750601,17
1,1312,37432,3578750584,3578750601,17
1,1312,37433,3578750584,3578750604,20
1,1312,37434,3578750584,3578750605,21
1,1312,37435,3578750584,3578750608,24
1,1312,37436,3578750584,3578750610,26
1,1312,37437,3578750584,3578750611,27
1,1312,37438,3578750584,3578750612,28
1,1312,37439,3578750584,3578750613,29
1,1312,37440,3578750584,3578750615,31
1,1312,37441,3578750584,3578750615,31
1,1312,37442,3578750584,3578750616,32
1,1312,37443,3578750584,3578750616,32
1,1312,37444,3578750584,3578750616,32
1,1312,37445,3578750584,3578750618,34
1,1312,37446,3578750584,3578750618,34
1,1312,37447,3578750584,3578750619,35
1,1312,37448,3578750584,3578750621,37
1,1312,37449,3578750584,3578750622,38
1,1312,37450,3578750584,3578750623,39
1,1312,37451,3578750584,3578750623,39
1,1312,37452,3578750584,3578750624,40
1,1312,37453,3578750584,3578750624,40
1,1312,37454,3578750584,3578750625,41
1,1312,37455,3578750584,3578750626,42
1,1312,37456,3578750584,3578750628,44
1,1312,37457,3578750584,3578750628,44
1,1312,37458,3578750584,3578750628,44
1,1312,37459,3578750584,3578750629,45
1,1312,37460,3578750584,3578750630,46
1,1312,37461,3578750584,3578750630,46
1,1312,37462,3578750584,3578750631,47
1,1312,37463,3578750584,3578750632,48
1,1312,37464,3578750584,3578750633,49
1,1313,37465,3578750646,3578750646,0
1,1313,37466,3578750646,3578750646,0
1,1313,37467,3578750646,3578750646,0
1,1313,37468,3578750646,3578750646,0
1,1313,37469,3578750646,3578750646,0
1,1313,37470,3578750646,3578750646,0
1,1313,37471,3578750646,3578750646,0
1,1313,37472,3578750646,3578750646,0
1,1313,37473,3578750646,3578750646,0
1,1313,37474,3578750646,3578750646,0
1,1313,37475,3578750646,3578750646,0
1,1313,37476,3578750646,3578750647,1
1,1313,37477,3578750646,3578750648,2
1,1313,37478,3578750646,3578750649,3
1,1313,37479,3578750646,3578750650,4
1,1313,37480,3578750646,3578750650,4
1,1313,37481,3578750646,3578750652,6
1,1313,37482,3578750646,3578750652,6
1,1313,37483,3578750646,3578750653,7
1,1313,37484,3578750646,3578750655,9
1,1313,37485,3578750646,3578750655,9
1,1313,37486,3578750646,3578750657,11
1,1313,37487,3578750646,3578750657,11
1,1313,37488,3578750646,3578750658,12
1,1313,37489,3578750646,3578750660,14
1,1313,37490,3578750646,3578750662,16
1,1313,37491,3578750646,3578750662,16
1,1313,37492,3578750646,3578750663,17
1,1313,37493,3578750646,3578750663,17
1,1313,37494,3578750646,3578750665,19
1,1313,37495,3578750646,3578750665,19
1,1313,37496,3578750646,3578750667,21
1,1313,37497,3578750646,3578750667,21
1,1313,37498,3578750646,3578750668,22
1,1313,37499,3578750646,3578750668,22
1,1313,37500,3578750646,3578750678,32
1,1313,37501,3578750646,3578750679,33
1,1313,37502,3578750646,3578750682,36
1,1313,37503,3578750646,3578750682,36
1,1313,37504,3578750646,3578750683,37
1,1313,37505,3578750646,3578750685,39
1,1313,37506,3578750646,3578750685,39
1,1313,37507,3578750646,3578750685,39
1,1313,37508,3578750646,3578750685,39
1,1313,37509,3578750646,3578750687,41
1,1313,37510,3578750646,3578750687,41
1,1313,37511,3578750646,3578750688,42
1,1313,37512,3578750646,3578750690,44
1,1313,37513,3578750646,3578750690,44
1,1313,37514,3578750646,3578750690,44
1,1313,37515,3578750646,3578750692,46
1,1313,37516,3578750646,3578750693,47
1,1313,37517,3578750646,3578750694,48
1,1313,37518,3578750646,3578750694,48
1,1314,37519,3578750708,3578750708,0
1,1314,37520,3578750708,3578750708,0
1,1314,37521,3578750708,3578750708,0
1,1314,37522,3578750708,3578750708,0
1,1314,37523,3578750708,3578750708,0
1,1314,37524,3578750708,3578750708,0
1,1314,37525,3578750708,3578750708,0
1,1314,37526,3578750708,3578750708,0
1,1314,37527,3578750708,3578750708,0
1,1314,37528,3578750708,3578750708,0
1,1314,37529,3578750708,3578750708,0
1,1314,37530,3578750708,3578750708,0
1,1314,37531,3578750708,3578750708,0
1,1314,37532,3578750708,3578750708,0
1,1314,37533,3578750708,3578750708,0
1,1314,37534,3578750708,3578750708,0
1,1314,37535,3578750708,3578750708,0
1,1314,37536,3578750708,3578750709,1
1,1314,37537,3578750708,3578750712,4
1,1314,37538,3578750708,3578750712,4
1,1314,37539,3578750708,3578750712,4
1,1314,37540,3578750708,3578750712,4
1,1314,37541,3578750708,3578750712,4
1,1314,37542,3578750708,3578750712,4
1,1314,37543,3578750708,3578750713,5
1,1314,37544,3578750708,3578750714,6
1,1314,37545,3578750708,3578750715,7
1,1314,37546,3578750708,3578750715,7
1,1314,37547,3578750708,3578750715,7
1,1314,37548,3578750708,3578750715,7
1,1314,37549,3578750708,3578750716,8
1,1314,37550,3578750708,3578750716,8
1,1314,37551,3578750708,3578750718,10
1,1314,37552,3578750708,3578750719,11
1,1314,37553,3578750708,3578750720,12
1,1314,37554,3578750708,3578750720,12
1,1314,37555,3578750708,3578750720,12
1,1314,37556,3578750708,3578750721,13
1,1314,37557,3578750708,3578750722,14
1,1314,37558,3578750708,3578750724,16
1,1314,37559,3578750708,3578750724,16
1,1314,37560,3578750708,3578750724,16
1,1314,37561,3578750708,3578750725,17
1,1314,37562,3578750708,3578750725,17
1,1314,37563,3578750708,3578750726,18
1,1314,37564,3578750708,3578750726,18
1,1314,37565,3578750708,3578750726,18
1,1314,37566,3578750708,3578750728,20
1,1314,37567,3578750708,3578750729,21
1,1314,37568,3578750708,3578750729,21
1,1314,37569,3578750708,3578750730,22
1,1314,37570,3578750708,3578750730,22
1,1314,37571,3578750708,3578750731,23
1,1314,37572,3578750708,3578750732,24
1,1314,37573,3578750708,3578750732,24
1,1314,37574,3578750708,3578750732,24
1,1314,37575,3578750708,3578750733,25
1,1314,37576,3578750708,3578750734,26
1,1314,37577,3578750708,3578750734,26
1,1314,37578,3578750708,3578750734,26
1,1314,37579,3578750708,3578750735,27
1,1314,37580,3578750708,3578750735,27
1,1314,37581,3578750708,3578750736,28
1,1314,37582,3578750708,3578750738,30
1,1314,37583,3578750708,3578750738,30
1,1314,37584,3578750708,3578750741,33
1,1314,37585,3578750708,3578750741,33
1,1314,37586,3578750708,3578750741,33
1,1314,37587,3578750708,3578750745,37
1,1314,37588,3578750708,3578750745,37
1,1314,37589,3578750708,3578750747,39
1,1314,37590,3578750708,3578750747,39
1,1314,37591,3578750708,3578750747,39
1,1314,37592,3578750708,3578750750,42
1,1314,37593,3578750708,3578750752,44
1,1314,37594,3578750708,3578750752,44
1,1314,37595,3578750708,3578750752,44
1,1314,37596,3578750708,3578750756,48
1,1314,37597,3578750708,3578750757,49
1,1314,37598,3578750708,3578750758,50
1,1315,37599,3578750770,3578750770,0
1,1315,37600,3578750770,3578750770,0
1,1315,37601,3578750770,3578750770,0
1,1315,37602,3578750770,3578750770,0
1,1315,37603,3578750770,3578750770,0
1,1315,37604,3578750770,3578750770,0
1,1315,37605,3578750770,3578750770,0
1,1315,37606,3578750770,3578750770,0
1,1315,37607,3578750770,3578750770,0
1,1315,37608,3578750770,3578750770,0
1,1315,37609,3578750770,3578750770,0
1,1315,37610,3578750770,3578750770,0
1,1315,37611,3578750770,3578750770,0
1,1315,37612,3578750770,3578750770,0
1,1315,37613,3578750770,3578750770,0
1,1315,37614,3578750770,3578750771,1
1,1315,37615,3578750770,3578750772,2
1,1315,37616,3578750770,3578750772,2
1,1315,37617,3578750770,3578750773,3
1,1315,37618,3578750770,3578750776,6
1,1315,37619,3578750770,3578750777,7
1,1315,37620,3578750770,3578750777,7
1,1315,37621,3578750770,3578750777,7
1,1315,37622,3578750770,3578750778,8
1,1315,37623,3578750770,3578750778,8
1,1315,37624,3578750770,3578750779,9
1,1315,37625,3578750770,3578750780,10
1,1315,37626,3578750770,3578750781,11
1,1315,37627,3578750770,3578750781,11
1,1315,37628,3578750770,3578750781,11
1,1315,37629,3578750770,3578750782,12
1,1315,37630,3578750770,3578750783,13
1,1315,37631,3578750770,3578750785,15
1,1315,37632,3578750770,3578750785,15
1,1315,37633,3578750770,3578750788,18
1,1315,37634,3578750770,3578750789,19
1,1315,37635,3578750770,3578750789,19
1,1315,37636,3578750770,3578750790,20
1,1315,37637,3578750770,3578750792,22
1,1315,37638,3578750770,3578750792,22
1,1315,37639,3578750770,3578750793,23
1,1315,37640,3578750770,3578750794,24
1,1315,37641,3578750770,3578750796,26
1,1315,37642,3578750770,3578750796,26
1,1315,37643,3578750770,3578750796,26
1,1315,37644,3578750770,3578750796,26
1,1315,37645,3578750770,3578750797,27
1,1315,37646,3578750770,3578750797,27
1,1315,37647,3578750770,3578750798,28
1,1315,37648,3578750770,3578750799,29
1,1315,37649,3578750770,3578750799,29
1,1315,37650,3578750770,3578750799,29
1,1315,37651,3578750770,3578750800,30
1,1315,37652,3578750770,3578750801,31
1,1315,37653,3578750770,3578750802,32
1,1315,37654,3578750770,3578750803,33
1,1315,37655,3578750770,3578750806,36
1,1315,37656,3578750770,3578750808,38
1,1315,37657,3578750770,3578750810,40
1,1315,37658,3578750770,3578750811,41
1,1315,37659,3578750770,3578750813,43
1,1315,37660,3578750770,3578750813,43
1,1315,37661,3578750770,3578750814,44
1,1315,37662,3578750770,3578750816,46
1,1315,37663,3578750770,3578750816,46
1,1315,37664,3578750770,3578750816,46
1,1315,37665,3578750770,3578750817,47
1,1315,37666,3578750770,3578750818,48
1,1315,37667,3578750770,3578750819,49
1,1315,37668,3578750770,3578750819,49
1,1316,37669,3578750832,3578750832,0
1,1316,37670,3578750832,3578750832,0
1,1316,37671,3578750832,3578750832,0
1,1316,37672,3578750832,3578750832,0
1,1316,37673,3578750832,3578750832,0
1,1316,37674,3578750832,3578750833,1
1,1316,37675,3578750832,3578750833,1
1,1316,37676,3578750832,3578750833,1
1,1316,37677,3578750832,3578750833,1
1,1316,37678,3578750832,3578750833,1
1,1316,37679,3578750832,3578750833,1
1,1316,37680,3578750832,3578750833,1
1,1316,37681,3578750832,3578750833,1
1,1316,37682,3578750832,3578750833,1
1,1316,37683,3578750832,3578750833,1
1,1316,37684,3578750832,3578750833,1
1,1316,37685,3578750832,3578750833,1
1,1316,37686,3578750832,3578750835,3
1,1316,37687,3578750832,3578750836,4
1,1316,37688,3578750832,3578750836,4
1,1316,37689,3578750832,3578750839,7
1,1316,37690,3578750832,3578750839,7
1,1316,37691,3578750832,3578750840,8
1,1316,37692,3578750832,3578750842,10
1,1316,37693,3578750832,3578750842,10
1,1316,37694,3578750832,3578750843,11
1,1316,37695,3578750832,3578750844,12
1,1316,37696,3578750832,3578750847,15
1,1316,37697,3578750832,3578750847,15
1,1316,37698,3578750832,3578750848,16
1,1316,37699,3578750832,3578750849,17
1,1316,37700,3578750832,3578750850,18
1,1316,37701,3578750832,3578750851,19
1,1316,37702,3578750832,3578750852,20
1,1316,37703,3578750832,3578750853,21
1,1316,37704,3578750832,3578750854,22
1,1316,37705,3578750832,3578750855,23
1,1316,37706,3578750832,3578750858,26
1,1316,37707,3578750832,3578750860,28
1,1316,37708,3578750832,3578750861,29
1,1316,37709,3578750832,3578750863,31
1,1316,37710,3578750832,3578750863,31
1,1316,37711,3578750832,3578750864,32
1,1316,37712,3578750832,3578750865,33
1,1316,37713,3578750832,3578750867,35
1,1316,37714,3578750832,3578750868,36
1,1316,37715,3578750832,3578750868,36
1,1316,37716,3578750832,3578750868,36
1,1316,37717,3578750832,3578750878,46
1,1316,37718,3578750832,3578750878,46
1,1316,37719,3578750832,3578750881,49
1,1316,37720,3578750832,3578750881,49
1,1317,37721,3578750896,3578750896,0
1,1317,37722,3578750896,3578750896,0
1,1317,37723,3578750896,3578750896,0
1,1317,37724,3578750896,3578750896,0
1,1317,37725,3578750896,3578750896,0
1,1317,37726,3578750896,3578750896,0
1,1317,37727,3578750896,3578750896,0
1,1317,37728,3578750896,3578750896,0
1,1317,37729,3578750896,3578750896,0
1,1317,37730,3578750896,3578750896,0
1,1317,37731,3578750896,3578750896,0
1,1317,37732,3578750896,3578750896,0
1,1317,37733,3578750896,3578750896,0
1,1317,37734,3578750896,3578750896,0
1,1317,37735,3578750896,3578750896,0
1,1317,37736,3578750896,3578750896,0
1,1317,37737,3578750896,3578750899,3
1,1317,37738,3578750896,3578750900,4
1,1317,37739,3578750896,3578750900,4
1,1317,37740,3578750896,3578750900,4
1,1317,37741,3578750896,3578750901,5
1,1317,37742,3578750896,3578750902,6
1,1317,37743,3578750896,3578750902,6
1,1317,37744,3578750896,3578750902,6
1,1317,37745,3578750896,3578750902,6
1,1317,37746,3578750896,3578750902,6
1,1317,37747,3578750896,3578750902,6
1,1317,37748,3578750896,3578750904,8
1,1317,37749,3578750896,3578750905,9
1,1317,37750,3578750896,3578750906,10
1,1317,37751,3578750896,3578750906,10
1,1317,37752,3578750896,3578750907,11
1,1317,37753,3578750896,3578750908,12
1,1317,37754,3578750896,3578750909,13
1,1317,37755,3578750896,3578750912,16
1,1317,37756,3578750896,3578750912,16
1,1317,37757,3578750896,3578750912,16
1,1317,37758,3578750896,3578750912,16
1,1317,37759,3578750896,3578750912,16
1,1317,37760,3578750896,3578750913,17
1,1317,37761,3578750896,3578750913,17
1,1317,37762,3578750896,3578750914,18
1,1317,37763,3578750896,3578750915,19
1,1317,37764,3578750896,3578750915,19
1,1317,37765,3578750896,3578750915,19
1,1317,37766,3578750896,3578750916,20
1,1317,37767,3578750896,3578750916,20
1,1317,37768,3578750896,3578750917,21
1,1317,37769,3578750896,3578750919,23
1,1317,37770,3578750896,3578750919,23
1,1317,37771,3578750896,3578750920,24
1,1317,37772,3578750896,3578750920,24
1,1317,37773,3578750896,3578750922,26
1,1317,37774,3578750896,3578750922,26
1,1317,37775,3578750896,3578750924,28
1,1317,37776,3578750896,3578750924,28
1,1317,37777,3578750896,3578750924,28
1,1317,37778,3578750896,3578750925,29
1,1317,37779,3578750896,3578750926,30
1,1317,37780,3578750896,3578750926,30
1,1317,37781,3578750896,3578750927,31
1,1317,37782,3578750896,3578750927,31
1,1317,37783,3578750896,3578750929,33
1,1317,37784,3578750896,3578750929,33
1,1317,37785,3578750896,3578750930,34
1,1317,37786,3578750896,3578750930,34
1,1317,37787,3578750896,3578750932,36
1,1317,37788,3578750896,3578750932,36
1,1317,37789,3578750896,3578750932,36
1,1317,37790,3578750896,3578750933,37
1,1317,37791,3578750896,3578750935,39
1,1317,37792,3578750896,3578750935,39
1,1317,37793,3578750896,3578750935,39
1,1317,37794,3578750896,3578750935,39
1,1317,37795,3578750896,3578750935,39
1,1317,37796,3578750896,3578750936,40
1,1317,37797,3578750896,3578750937,41
1,1317,37798,3578750896,3578750937,41
1,1317,37799,3578750896,3578750939,43
1,1317,37800,3578750896,3578750941,45
1,1317,37801,3578750896,3578750941,45
1,1317,37802,3578750896,3578750942,46
1,1317,37803,3578750896,3578750944,48
1,1317,37804,3578750896,3578750946,50
1,1318,37805,3578750959,3578750959,0
1,1318,37806,3578750959,3578750959,0
1,1318,37807,3578750959,3578750959,0
1,1318,37808,3578750959,3578750959,0
1,1318,37809,3578750959,3578750959,0
1,1318,37810,3578750959,3578750959,0
1,1318,37811,3578750959,3578750960,1
1,1318,37812,3578750959,3578750960,1
1,1318,37813,3578750959,3578750960,1
1,1318,37814,3578750959,3578750960,1
1,1318,37815,3578750959,3578750960,1
1,1318,37816,3578750959,3578750961,2
1,1318,37817,3578750959,3578750962,3
1,1318,37818,3578750959,3578750962,3
1,1318,37819,3578750959,3578750963,4
1,1318,37820,3578750959,3578750964,5
1,1318,37821,3578750959,3578750965,6
1,1318,37822,3578750959,3578750965,6
1,1318,37823,3578750959,3578750966,7
1,1318,37824,3578750959,3578750966,7
1,1318,37825,3578750959,3578750967,8
1,1318,37826,3578750959,3578750967,8
1,1318,37827,3578750959,3578750969,10
1,1318,37828,3578750959,3578750969,10
1,1318,37829,3578750959,3578750971,12
1,1318,37830,3578750959,3578750972,13
1,1318,37831,3578750959,3578750973,14
1,1318,37832,3578750959,3578750974,15
1,1318,37833,3578750959,3578750975,16
1,1318,37834,3578750959,3578750977,18
1,1318,37835,3578750959,3578750977,18
1,1318,37836,3578750959,3578750978,19
1,1318,37837,3578750959,3578750978,19
1,1318,37838,3578750959,3578750978,19
1,1318,37839,3578750959,3578750979,20
1,1318,37840,3578750959,3578750979,20
1,1318,37841,3578750959,3578750980,21
1,1318,37842,3578750959,3578750981,22
1,1318,37843,3578750959,3578750982,23
1,1318,37844,3578750959,3578750982,23
1,1318,37845,3578750959,3578750983,24
1,1318,37846,3578750959,3578750985,26
1,1318,37847,3578750959,3578750986,27
1,1318,37848,3578750959,3578750989,30
1,1318,37849,3578750959,3578750989,30
1,1318,37850,3578750959,3578750990,31
1,1318,37851,3578750959,3578750991,32
1,1318,37852,3578750959,3578750992,33
1,1318,37853,3578750959,3578750993,34
1,1318,37854,3578750959,3578750993,34
1,1318,37855,3578750959,3578750994,35
1,1318,37856,3578750959,3578750996,37
1,1318,37857,3578750959,3578750996,37
1,1318,37858,3578750959,3578750996,37
1,1318,37859,3578750959,3578750997,38
1,1318,37860,3578750959,3578750997,38
1,1318,37861,3578750959,3578750997,38
1,1318,37862,3578750959,3578750997,38
1,1318,37863,3578750959,3578750998,39
1,1318,37864,3578750959,3578750999,40
1,1318,37865,3578750959,3578750999,40
1,1318,37866,3578750959,3578750999,40
1,1318,37867,3578750959,3578751001,42
1,1318,37868,3578750959,3578751003,44
1,1318,37869,3578750959,3578751005,46
1,1318,37870,3578750959,3578751008,49
1,1319,37871,3578751021,3578751021,0
1,1319,37872,3578751021,3578751021,0
1,1319,37873,3578751021,3578751021,0
1,1319,37874,3578751021,3578751021,0
1,1319,37875,3578751021,3578751021,0
1,1319,37876,3578751021,3578751021,0
1,1319,37877,3578751021,3578751021,0
1,1319,37878,3578751021,3578751021,0
1,1319,37879,3578751021,3578751021,0
1,1319,37880,3578751021,3578751021,0
1,1319,37881,3578751021,3578751021,0
1,1319,37882,3578751021,3578751021,0
1,1319,37883,3578751021,3578751023,2
1,1319,37884,3578751021,3578751023,2
1,1319,37885,3578751021,3578751023,2
1,1319,37886,3578751021,3578751024,3
1,1319,37887,3578751021,3578751024,3
1,1319,37888,3578751021,3578751024,3
1,1319,37889,3578751021,3578751027,6
1,1319,37890,3578751021,3578751028,7
1,1319,37891,3578751021,3578751029,8
1,1319,37892,3578751021,3578751029,8
1,1319,37893,3578751021,3578751030,9
1,1319,37894,3578751021,3578751031,10
1,1319,37895,3578751021,3578751031,10
1,1319,37896,3578751021,3578751031,10
1,1319,37897,3578751021,3578751032,11
1,1319,37898,3578751021,3578751033,12
1,1319,37899,3578751021,3578751035,14
1,1319,37900,3578751021,3578751036,15
1,1319,37901,3578751021,3578751036,15
1,1319,37902,3578751021,3578751038,17
1,1319,37903,3578751021,3578751039,18
1,1319,37904,3578751021,3578751041,20
1,1319,37905,3578751021,3578751042,21
1,1319,37906,3578751021,3578751043,22
1,1319,37907,3578751021,3578751044,23
1,1319,37908,3578751021,3578751045,24
1,1319,37909,3578751021,3578751047,26
1,1319,37910,3578751021,3578751048,27
1,1319,37911,3578751021,3578751049,28
1,1319,37912,3578751021,3578751049,28
1,1319,37913,3578751021,3578751050,29
1,1319,37914,3578751021,3578751051,30
1,1319,37915,3578751021,3578751051,30
1,1319,37916,3578751021,3578751052,31
1,1319,37917,3578751021,3578751053,32
1,1319,37918,3578751021,3578751055,34
1,1319,37919,3578751021,3578751056,35
1,1319,37920,3578751021,3578751057,36
1,1319,37921,3578751021,3578751059,38
1,1319,37922,3578751021,3578751061,40
1,1319,37923,3578751021,3578751063,42
1,1319,37924,3578751021,3578751063,42
1,1319,37925,3578751021,3578751063,42
1,1319,37926,3578751021,3578751065,44
1,1319,37927,3578751021,3578751065,44
1,1319,37928,3578751021,3578751065,44
1,1319,37929,3578751021,3578751067,46
1,1319,37930,3578751021,3578751068,47
1,1319,37931,3578751021,3578751069,48
1,1320,37932,3578751083,3578751083,0
1,1320,37933,3578751083,3578751083,0
1,1320,37934,3578751083,3578751083,0
1,1320,37935,3578751083,3578751083,0
1,1320,37936,3578751083,3578751083,0
1,1320,37937,3578751083,3578751085,2
1,1320,37938,3578751083,3578751085,2
1,1320,37939,3578751083,3578751085,2
1,1320,37940,3578751083,3578751085,2
1,1320,37941,3578751083,3578751087,4
1,1320,37942,3578751083,3578751088,5
1,1320,37943,3578751083,3578751089,6
1,1320,37944,3578751083,3578751090,7
1,1320,37945,3578751083,3578751090,7
1,1320,37946,3578751083,3578751091,8
1,1320,37947,3578751083,3578751092,9
1,1320,37948,3578751083,3578751093,10
1,1320,37949,3578751083,3578751093,10
1,1320,37950,3578751083,3578751094,11
1,1320,37951,3578751083,3578751096,13
1,1320,37952,3578751083,3578751099,16
1,1320,37953,3578751083,3578751100,17
1,1320,37954,3578751083,3578751100,17
1,1320,37955,3578751083,3578751101,18
1,1320,37956,3578751083,3578751101,18
1,1320,37957,3578751083,3578751102,19
1,1320,37958,3578751083,3578751102,19
1,1320,37959,3578751083,3578751102,19
1,1320,37960,3578751083,3578751102,19
1,1320,37961,3578751083,3578751103,20
1,1320,37962,3578751083,3578751103,20
1,1320,37963,3578751083,3578751104,21
1,1320,37964,3578751083,3578751104,21
1,1320,37965,3578751083,3578751105,22
1,1320,37966,3578751083,3578751106,23
1,1320,37967,3578751083,3578751107,24
1,1320,37968,3578751083,3578751108,25
1,1320,37969,3578751083,3578751110,27
1,1320,37970,3578751083,3578751111,28
1,1320,37971,3578751083,3578751112,29
1,1320,37972,3578751083,3578751112,29
1,1320,37973,3578751083,3578751112,29
1,1320,37974,3578751083,3578751113,30
1,1320,37975,3578751083,3578751113,30
1,1320,37976,3578751083,3578751114,31
1,1320,37977,3578751083,3578751114,31
1,1320,37978,3578751083,3578751115,32
1,1320,37979,3578751083,3578751116,33
1,1320,37980,3578751083,3578751116,33
1,1320,37981,3578751083,3578751117,34
1,1320,37982,3578751083,3578751117,34
1,1320,37983,3578751083,3578751119,36
1,1320,37984,3578751083,3578751120,37
1,1320,37985,3578751083,3578751120,37
1,1320,37986,3578751083,3578751120,37
1,1320,37987,3578751083,3578751122,39
1,1320,37988,3578751083,3578751123,40
1,1320,37989,3578751083,3578751123,40
1,1320,37990,3578751083,3578751124,41
1,1320,37991,3578751083,3578751125,42
1,1320,37992,3578751083,3578751125,42
1,1320,37993,3578751083,3578751126,43
1,1320,37994,3578751083,3578751126,43
1,1320,37995,3578751083,3578751126,43
1,1320,37996,3578751083,3578751127,44
1,1320,37997,3578751083,3578751129,46
1,1320,37998,3578751083,3578751130,47
1,1320,37999,3578751083,3578751130,47
1,1320,38000,3578751083,3578751131,48
1,1320,38001,3578751083,3578751132,49
1,1320,38002,3578751083,3578751132,49
1,1320,38003,3578751083,3578751132,49
1,1320,38004,3578751083,3578751132,49
1,1320,38005,3578751083,3578751133,50
1,1321,38006,3578751144,3578751144,0
1,1321,38007,3578751144,3578751144,0
1,1321,38008,3578751144,3578751144,0
1,1321,38009,3578751144,3578751144,0
1,1321,38010,3578751144,3578751144,0
1,1321,38011,3578751144,3578751144,0
1,1321,38012,3578751144,3578751144,0
1,1321,38013,3578751144,3578751144,0
1,1321,38014,3578751144,3578751144,0
1,1321,38015,3578751144,3578751144,0
1,1321,38016,3578751144,3578751144,0
1,1321,38017,3578751144,3578751144,0
1,1321,38018,3578751144,3578751145,1
1,1321,38019,3578751144,3578751146,2
1,1321,38020,3578751144,3578751147,3
1,1321,38021,3578751144,3578751148,4
1,1321,38022,3578751144,3578751149,5
1,1321,38023,3578751144,3578751150,6
1,1321,38024,3578751144,3578751151,7
1,1321,38025,3578751144,3578751153,9
1,1321,38026,3578751144,3578751153,9
1,1321,38027,3578751144,3578751154,10
1,1321,38028,3578751144,3578751155,11
1,1321,38029,3578751144,3578751158,14
1,1321,38030,3578751144,3578751158,14
1,1321,38031,3578751144,3578751159,15
1,1321,38032,3578751144,3578751160,16
1,1321,38033,3578751144,3578751161,17
1,1321,38034,3578751144,3578751162,18
1,1321,38035,3578751144,3578751162,18
1,1321,38036,3578751144,3578751163,19
1,1321,38037,3578751144,3578751163,19
1,1321,38038,3578751144,3578751166,22
1,1321,38039,3578751144,3578751166,22
1,1321,38040,3578751144,3578751166,22
1,1321,38041,3578751144,3578751167,23
1,1321,38042,3578751144,3578751167,23
1,1321,38043,3578751144,3578751167,23
1,1321,38044,3578751144,3578751169,25
1,1321,38045,3578751144,3578751170,26
1,1321,38046,3578751144,3578751171,27
1,1321,38047,3578751144,3578751172,28
1,1321,38048,3578751144,3578751173,29
1,1321,38049,3578751144,3578751174,30
1,1321,38050,3578751144,3578751174,30
1,1321,38051,3578751144,3578751176,32
1,1321,38052,3578751144,3578751176,32
1,1321,38053,3578751144,3578751178,34
1,1321,38054,3578751144,3578751178,34
1,1321,38055,3578751144,3578751179,35
1,1321,38056,3578751144,3578751179,35
1,1321,38057,3578751144,3578751179,35
1,1321,38058,3578751144,3578751179,35
1,1321,38059,3578751144,3578751181,37
1,1321,38060,3578751144,3578751182,38
1,1321,38061,3578751144,3578751182,38
1,1321,38062,3578751144,3578751183,39
1,1321,38063,3578751144,3578751184,40
1,1321,38064,3578751144,3578751185,41
1,1321,38065,3578751144,3578751186,42
1,1321,38066,3578751144,3578751189,45
1,1321,38067,3578751144,3578751190,46
1,1321,38068,3578751144,3578751191,47
1,1321,38069,3578751144,3578751192,48
1,1321,38070,3578751144,3578751192,48
1,1321,38071,3578751144,3578751193,49
1,1322,38072,3578751208,3578751208,0
1,1322,38073,3578751208,3578751208,0
1,1322,38074,3578751208,3578751208,0
1,1322,38075,3578751208,3578751208,0
1,1322,38076,3578751208,3578751208,0
1,1322,38077,3578751208,3578751208,0
1,1322,38078,3578751208,3578751208,0
1,1322,38079,3578751208,3578751208,0
1,1322,38080,3578751208,3578751208,0
1,1322,38081,3578751208,3578751208,0
1,1322,38082,3578751208,3578751208,0
1,1322,38083,3578751208,3578751208,0
1,1322,38084,3578751208,3578751208,0
1,1322,38085,3578751208,3578751208,0
1,1322,38086,3578751208,3578751208,0
1,1322,38087,3578751208,3578751208,0
1,1322,38088,3578751208,3578751209,1
1,1322,38089,3578751208,3578751210,2
1,1322,38090,3578751208,3578751212,4
1,1322,38091,3578751208,3578751213,5
1,1322,38092,3578751208,3578751215,7
1,1322,38093,3578751208,3578751216,8
1,1322,38094,3578751208,3578751217,9
1,1322,38095,3578751208,3578751217,9
1,1322,38096,3578751208,3578751218,10
1,1322,38097,3578751208,3578751219,11
1,1322,38098,3578751208,3578751219,11
1,1322,38099,3578751208,3578751221,13
1,1322,38100,3578751208,3578751223,15
1,1322,38101,3578751208,3578751224,16
1,1322,38102,3578751208,3578751224,16
1,1322,38103,3578751208,3578751224,16
1,1322,38104,3578751208,3578751225,17
1,1322,38105,3578751208,3578751227,19
1,1322,38106,3578751208,3578751228,20
1,1322,38107,3578751208,3578751228,20
1,1322,38108,3578751208,3578751229,21
1,1322,38109,3578751208,3578751230,22
1,1322,38110,3578751208,3578751231,23
1,1322,38111,3578751208,3578751231,23
1,1322,38112,3578751208,3578751232,24
1,1322,38113,3578751208,3578751232,24
1,1322,38114,3578751208,3578751233,25
1,1322,38115,3578751208,3578751235,27
1,1322,38116,3578751208,3578751236,28
1,1322,38117,3578751208,3578751237,29
1,1322,38118,3578751208,3578751239,31
1,1322,38119,3578751208,3578751240,32
1,1322,38120,3578751208,3578751241,33
1,1322,38121,3578751208,3578751242,34
1,1322,38122,3578751208,3578751243,35
1,1322,38123,3578751208,3578751243,35
1,1322,38124,3578751208,3578751245,37
1,1322,38125,3578751208,3578751247,39
1,1322,38126,3578751208,3578751247,39
1,1322,38127,3578751208,3578751249,41
1,1322,38128,3578751208,3578751249,41
1,1322,38129,3578751208,3578751250,42
1,1322,38130,3578751208,3578751252,44
1,1322,38131,3578751208,3578751254,46
1,1322,38132,3578751208,3578751254,46
1,1322,38133,3578751208,3578751255,47
1,1322,38134,3578751208,3578751256,48
1,1322,38135,3578751208,3578751256,48
1,1323,38136,3578751271,3578751272,1
1,1323,38137,3578751271,3578751272,1
1,1323,38138,3578751271,3578751272,1
1,1323,38139,3578751271,3578751272,1
1,1323,38140,3578751271,3578751272,1
1,1323,38141,3578751271,3578751272,1
1,1323,38142,3578751271,3578751272,1
1,1323,38143,3578751271,3578751272,1
1,1323,38144,3578751271,3578751272,1
1,1323,38145,3578751271,3578751272,1
1,1323,38146,3578751271,3578751272,1
1,1323,38147,3578751271,3578751278,7
1,1323,38148,3578751271,3578751279,8
1,1323,38149,3578751271,3578751281,10
1,1323,38150,3578751271,3578751282,11
1,1323,38151,3578751271,3578751282,11
1,1323,38152,3578751271,3578751284,13
1,1323,38153,3578751271,3578751285,14
1,1323,38154,3578751271,3578751285,14
1,1323,38155,3578751271,3578751286,15
1,1323,38156,3578751271,3578751286,15
1,1323,38157,3578751271,3578751287,16
1,1323,38158,3578751271,3578751289,18
1,1323,38159,3578751271,3578751290,19
1,1323,38160,3578751271,3578751291,20
1,1323,38161,3578751271,3578751291,20
1,1323,38162,3578751271,3578751291,20
1,1323,38163,3578751271,3578751293,22
1,1323,38164,3578751271,3578751294,23
1,1323,38165,3578751271,3578751294,23
1,1323,38166,3578751271,3578751297,26
1,1323,38167,3578751271,3578751299,28
1,1323,38168,3578751271,3578751299,28
1,1323,38169,3578751271,3578751300,29
1,1323,38170,3578751271,3578751301,30
1,1323,38171,3578751271,3578751302,31
1,1323,38172,3578751271,3578751302,31
1,1323,38173,3578751271,3578751302,31
1,1323,38174,3578751271,3578751302,31
1,1323,38175,3578751271,3578751302,31
1,1323,38176,3578751271,3578751302,31
1,1323,38177,3578751271,3578751303,32
1,1323,38178,3578751271,3578751303,32
1,1323,38179,3578751271,3578751304,33
1,1323,38180,3578751271,3578751306,35
1,1323,38181,3578751271,3578751306,35
1,1323,38182,3578751271,3578751307,36
1,1323,38183,3578751271,3578751308,37
1,1323,38184,3578751271,3578751310,39
1,1323,38185,3578751271,3578751311,40
1,1323,38186,3578751271,3578751312,41
1,1323,38187,3578751271,3578751312,41
1,1323,38188,3578751271,3578751312,41
1,1323,38189,3578751271,3578751312,41
1,1323,38190,3578751271,3578751313,42
1,1323,38191,3578751271,3578751314,43
1,1323,38192,3578751271,3578751314,43
1,1323,38193,3578751271,3578751315,44
1,1323,38194,3578751271,3578751316,45
1,1323,38195,3578751271,3578751316,45
1,1323,38196,3578751271,3578751317,46
1,1323,38197,3578751271,3578751317,46
1,1323,38198,3578751271,3578751320,49
1,1323,38199,3578751271,3578751320,49
1,1323,38200,3578751271,3578751320,49
1,1323,38201,3578751271,3578751320,49
1,1324,38202,3578751333,3578751333,0
1,1324,38203,3578751333,3578751333,0
1,1324,38204,3578751333,3578751333,0
1,1324,38205,3578751333,3578751333,0
1,1324,38206,3578751333,3578751333,0
1,1324,38207,3578751333,3578751333,0
1,1324,38208,3578751333,3578751333,0
1,1324,38209,3578751333,3578751333,0
1,1324,38210,3578751333,3578751333,0
1,1324,38211,3578751333,3578751333,0
1,1324,38212,3578751333,3578751333,0
1,1324,38213,3578751333,3578751333,0
1,1324,38214,3578751333,3578751333,0
1,1324,38215,3578751333,3578751333,0
1,1324,38216,3578751333,3578751333,0
1,1324,38217,3578751333,3578751333,0
1,1324,38218,3578751333,3578751333,0
1,1324,38219,3578751333,3578751334,1
1,1324,38220,3578751333,3578751334,1
1,1324,38221,3578751333,3578751335,2
1,1324,38222,3578751333,3578751335,2
1,1324,38223,3578751333,3578751335,2
1,1324,38224,3578751333,3578751336,3
1,1324,38225,3578751333,3578751336,3
1,1324,38226,3578751333,3578751338,5
1,1324,38227,3578751333,3578751338,5
1,1324,38228,3578751333,3578751339,6
1,1324,38229,3578751333,3578751340,7
1,1324,38230,3578751333,3578751341,8
1,1324,38231,3578751333,3578751344,11
1,1324,38232,3578751333,3578751346,13
1,1324,38233,3578751333,3578751347,14
1,1324,38234,3578751333,3578751348,15
1,1324,38235,3578751333,3578751348,15
1,1324,38236,3578751333,3578751351,18
1,1324,38237,3578751333,3578751351,18
1,1324,38238,3578751333,3578751353,20
1,1324,38239,3578751333,3578751353,20
1,1324,38240,3578751333,3578751354,21
1,1324,38241,3578751333,3578751355,22
1,1324,38242,3578751333,3578751355,22
1,1324,38243,3578751333,3578751358,25
1,1324,38244,3578751333,3578751359,26
1,1324,38245,3578751333,3578751359,26
1,1324,38246,3578751333,3578751360,27
1,1324,38247,3578751333,3578751362,29
1,1324,38248,3578751333,3578751362,29
1,1324,38249,3578751333,3578751363,30
1,1324,38250,3578751333,3578751363,30
1,1324,38251,3578751333,3578751363,30
1,1324,38252,3578751333,3578751363,30
1,1324,38253,3578751333,3578751365,32
1,1324,38254,3578751333,3578751366,33
1,1324,38255,3578751333,3578751366,33
1,1324,38256,3578751333,3578751367,34
1,1324,38257,3578751333,3578751367,34
1,1324,38258,3578751333,3578751369,36
1,1324,38259,3578751333,3578751370,37
1,1324,38260,3578751333,3578751372,39
1,1324,38261,3578751333,3578751372,39
1,1324,38262,3578751333,3578751373,40
1,1324,38263,3578751333,3578751374,41
1,1324,38264,3578751333,3578751375,42
1,1324,38265,3578751333,3578751375,42
1,1324,38266,3578751333,3578751377,44
1,1324,38267,3578751333,3578751378,45
1,1324,38268,3578751333,3578751378,45
1,1324,38269,3578751333,3578751378,45
1,1324,38270,3578751333,3578751379,46
1,1324,38271,3578751333,3578751379,46
1,1324,38272,3578751333,3578751380,47
1,1324,38273,3578751333,3578751381,48
1,1324,38274,3578751333,3578751382,49
1,1324,38275,3578751333,3578751382,49
1,1325,38276,3578751396,3578751396,0
1,1325,38277,3578751396,3578751396,0
1,1325,38278,3578751396,3578751396,0
1,1325,38279,3578751396,3578751396,0
1,1325,38280,3578751396,3578751396,0
1,1325,38281,3578751396,3578751396,0
1,1325,38282,3578751396,3578751396,0
1,1325,38283,3578751396,3578751396,0
1,1325,38284,3578751396,3578751396,0
1,1325,38285,3578751396,3578751397,1
1,1325,38286,3578751396,3578751397,1
1,1325,38287,3578751396,3578751397,1
1,1325,38288,3578751396,3578751397,1
1,1325,38289,3578751396,3578751397,1
1,1325,38290,3578751396,3578751397,1
1,1325,38291,3578751396,3578751398,2
1,1325,38292,3578751396,3578751399,3
1,1325,38293,3578751396,3578751399,3
1,1325,38294,3578751396,3578751399,3
1,1325,38295,3578751396,3578751400,4
1,1325,38296,3578751396,3578751401,5
1,1325,38297,3578751396,3578751404,8
1,1325,38298,3578751396,3578751409,13
1,1325,38299,3578751396,3578751410,14
1,1325,38300,3578751396,3578751413,17
1,1325,38301,3578751396,3578751413,17
1,1325,38302,3578751396,3578751413,17
1,1325,38303,3578751396,3578751414,18
1,1325,38304,3578751396,3578751416,20
1,1325,38305,3578751396,3578751417,21
1,1325,38306,3578751396,3578751417,21
1,1325,38307,3578751396,3578751418,22
1,1325,38308,3578751396,3578751420,24
1,1325,38309,3578751396,3578751420,24
1,1325,38310,3578751396,3578751420,24
1,1325,38311,3578751396,3578751424,28
1,1325,38312,3578751396,3578751424,28
1,1325,38313,3578751396,3578751424,28
1,1325,38314,3578751396,3578751424,28
1,1325,38315,3578751396,3578751424,28
1,1325,38316,3578751396,3578751427,31
1,1325,38317,3578751396,3578751428,32
1,1325,38318,3578751396,3578751428,32
1,1325,38319,3578751396,3578751429,33
1,1325,38320,3578751396,3578751431,35
1,1325,38321,3578751396,3578751431,35
1,1325,38322,3578751396,3578751431,35
1,1325,38323,3578751396,3578751432,36
1,1325,38324,3578751396,3578751432,36
1,1325,38325,3578751396,3578751432,36
1,1325,38326,3578751396,3578751435,39
1,1325,38327,3578751396,3578751436,40
1,1325,38328,3578751396,3578751437,41
1,1325,38329,3578751396,3578751440,44
1,1325,38330,3578751396,3578751440,44
1,1325,38331,3578751396,3578751441,45
1,1325,38332,3578751396,3578751442,46
1,1325,38333,3578751396,3578751442,46
1,1325,38334,3578751396,3578751444,48
1,1325,38335,3578751396,3578751444,48
1,1326,38336,3578751458,3578751458,0
1,1326,38337,3578751458,3578751458,0
1,1326,38338,3578751458,3578751458,0
1,1326,38339,3578751458,3578751458,0
1,1326,38340,3578751458,3578751458,0
1,1326,38341,3578751458,3578751458,0
1,1326,38342,3578751458,3578751458,0
1,1326,38343,3578751458,3578751458,0
1,1326,38344,3578751458,3578751458,0
1,1326,38345,3578751458,3578751458,0
1,1326,38346,3578751458,3578751458,0
1,1326,38347,3578751458,3578751459,1
1,1326,38348,3578751458,3578751462,4
1,1326,38349,3578751458,3578751463,5
1,1326,38350,3578751458,3578751463,5
1,1326,38351,3578751458,3578751463,5
1,1326,38352,3578751458,3578751465,7
1,1326,38353,3578751458,3578751466,8
1,1326,38354,3578751458,3578751468,10
1,1326,38355,3578751458,3578751468,10
1,1326,38356,3578751458,3578751468,10
1,1326,38357,3578751458,3578751470,12
1,1326,38358,3578751458,3578751476,18
1,1326,38359,3578751458,3578751478,20
1,1326,38360,3578751458,3578751479,21
1,1326,38361,3578751458,3578751481,23
1,1326,38362,3578751458,3578751482,24
1,1326,38363,3578751458,3578751483,25
1,1326,38364,3578751458,3578751485,27
1,1326,38365,3578751458,3578751485,27
1,1326,38366,3578751458,3578751485,27
1,1326,38367,3578751458,3578751485,27
1,1326,38368,3578751458,3578751487,29
1,1326,38369,3578751458,3578751487,29
1,1326,38370,3578751458,3578751489,31
1,1326,38371,3578751458,3578751490,32
1,1326,38372,3578751458,3578751491,33
1,1326,38373,3578751458,3578751492,34
1,1326,38374,3578751458,3578751492,34
1,1326,38375,3578751458,3578751493,35
1,1326,38376,3578751458,3578751494,36
1,1326,38377,3578751458,3578751495,37
1,1326,38378,3578751458,3578751497,39
1,1326,38379,3578751458,3578751500,42
1,1326,38380,3578751458,3578751501,43
1,1326,38381,3578751458,3578751501,43
1,1326,38382,3578751458,3578751502,44
1,1326,38383,3578751458,3578751502,44
1,1326,38384,3578751458,3578751502,44
1,1326,38385,3578751458,3578751502,44
1,1326,38386,3578751458,3578751503,45
1,1326,38387,3578751458,3578751503,45
1,1326,38388,3578751458,3578751504,46
1,1326,38389,3578751458,3578751504,46
1,1326,38390,3578751458,3578751507,49
1,1327,38391,3578751521,3578751521,0
1,1327,38392,3578751521,3578751521,0
1,1327,38393,3578751521,3578751521,0
1,1327,38394,3578751521,3578751521,0
1,1327,38395,3578751521,3578751521,0
1,1327,38396,3578751521,3578751521,0
1,1327,38397,3578751521,3578751521,0
1,1327,38398,3578751521,3578751521,0
1,1327,38399,3578751521,3578751521,0
1,1327,38400,3578751521,3578751521,0
1,1327,38401,3578751521,3578751521,0
1,1327,38402,3578751521,3578751521,0
1,1327,38403,3578751521,3578751521,0
1,1327,38404,3578751521,3578751521,0
1,1327,38405,3578751521,3578751521,0
1,1327,38406,3578751521,3578751521,0
1,1327,38407,3578751521,3578751521,0
1,1327,38408,3578751521,3578751521,0
1,1327,38409,3578751521,3578751521,0
1,1327,38410,3578751521,3578751521,0
1,1327,38411,3578751521,3578751521,0
1,1327,38412,3578751521,3578751523,2
1,1327,38413,3578751521,3578751524,3
1,1327,38414,3578751521,3578751524,3
1,1327,38415,3578751521,3578751525,4
1,1327,38416,3578751521,3578751526,5
1,1327,38417,3578751521,3578751526,5
1,1327,38418,3578751521,3578751527,6
1,1327,38419,3578751521,3578751527,6
1,1327,38420,3578751521,3578751529,8
1,1327,38421,3578751521,3578751529,8
1,1327,38422,3578751521,3578751529,8
1,1327,38423,3578751521,3578751531,10
1,1327,38424,3578751521,3578751531,10
1,1327,38425,3578751521,3578751531,10
1,1327,38426,3578751521,3578751531,10
1,1327,38427,3578751521,3578751531,10
1,1327,38428,3578751521,3578751533,12
1,1327,38429,3578751521,3578751533,12
1,1327,38430,3578751521,3578751533,12
1,1327,38431,3578751521,3578751534,13
1,1327,38432,3578751521,3578751534,13
1,1327,38433,3578751521,3578751535,14
1,1327,38434,3578751521,3578751536,15
1,1327,38435,3578751521,3578751536,15
1,1327,38436,3578751521,3578751537,16
1,1327,38437,3578751521,3578751538,17
1,1327,38438,3578751521,3578751540,19
1,1327,38439,3578751521,3578751540,19
1,1327,38440,3578751521,3578751544,23
1,1327,38441,3578751521,3578751545,24
1,1327,38442,3578751521,3578751547,26
1,1327,38443,3578751521,3578751548,27
1,1327,38444,3578751521,3578751550,29
1,1327,38445,3578751521,3578751550,29
1,1327,38446,3578751521,3578751552,31
1,1327,38447,3578751521,3578751553,32
1,1327,38448,3578751521,3578751553,32
1,1327,38449,3578751521,3578751554,33
1,1327,38450,3578751521,3578751555,34
1,1327,38451,3578751521,3578751558,37
1,1327,38452,3578751521,3578751558,37
1,1327,38453,3578751521,3578751559,38
1,1327,38454,3578751521,3578751561,40
1,1327,38455,3578751521,3578751561,40
1,1327,38456,3578751521,3578751562,41
1,1327,38457,3578751521,3578751562,41
1,1327,38458,3578751521,3578751563,42
1,1327,38459,3578751521,3578751565,44
1,1327,38460,3578751521,3578751565,44
1,1327,38461,3578751521,3578751567,46
1,1327,38462,3578751521,3578751567,46
1,1327,38463,3578751521,3578751568,47
1,1327,38464,3578751521,3578751569,48
1,1327,38465,3578751521,3578751571,50
1,1328,38466,3578751583,3578751583,0
1,1328,38467,3578751583,3578751583,0
1,1328,38468,3578751583,3578751583,0
1,1328,38469,3578751583,3578751583,0
1,1328,38470,3578751583,3578751583,0
1,1328,38471,3578751583,3578751583,0
1,1328,38472,3578751583,3578751583,0
1,1328,38473,3578751583,3578751583,0
1,1328,38474,3578751583,3578751583,0
1,1328,38475,3578751583,3578751583,0
1,1328,38476,3578751583,3578751583,0
1,1328,38477,3578751583,3578751583,0
1,1328,38478,3578751583,3578751583,0
1,1328,38479,3578751583,3578751583,0
1,1328,38480,3578751583,3578751583,0
1,1328,38481,3578751583,3578751583,0
1,1328,38482,3578751583,3578751583,0
1,1328,38483,3578751583,3578751584,1
1,1328,38484,3578751583,3578751586,3
1,1328,38485,3578751583,3578751589,6
1,1328,38486,3578751583,3578751589,6
1,1328,38487,3578751583,3578751590,7
1,1328,38488,3578751583,3578751590,7
1,1328,38489,3578751583,3578751591,8
1,1328,38490,3578751583,3578751594,11
1,1328,38491,3578751583,3578751595,12
1,1328,38492,3578751583,3578751595,12
1,1328,38493,3578751583,3578751596,13
1,1328,38494,3578751583,3578751596,13
1,1328,38495,3578751583,3578751596,13
1,1328,38496,3578751583,3578751597,14
1,1328,38497,3578751583,3578751597,14
1,1328,38498,3578751583,3578751598,15
1,1328,38499,3578751583,3578751598,15
1,1328,38500,3578751583,3578751599,16
1,1328,38501,3578751583,3578751599,16
1,1328,38502,3578751583,3578751600,17
1,1328,38503,3578751583,3578751602,19
1,1328,38504,3578751583,3578751604,21
1,1328,38505,3578751583,3578751605,22
1,1328,38506,3578751583,3578751609,26
1,1328,38507,3578751583,3578751609,26
1,1328,38508,3578751583,3578751611,28
1,1328,38509,3578751583,3578751612,29
1,1328,38510,3578751583,3578751612,29
1,1328,38511,3578751583,3578751613,30
1,1328,38512,3578751583,3578751615,32
1,1328,38513,3578751583,3578751616,33
1,1328,38514,3578751583,3578751616,33
1,1328,38515,3578751583,3578751617,34
1,1328,38516,3578751583,3578751618,35
1,1328,38517,3578751583,3578751618,35
1,1328,38518,3578751583,3578751620,37
1,1328,38519,3578751583,3578751620,37
1,1328,38520,3578751583,3578751623,40
1,1328,38521,3578751583,3578751623,40
1,1328,38522,3578751583,3578751623,40
1,1328,38523,3578751583,3578751624,41
1,1328,38524,3578751583,3578751624,41
1,1328,38525,3578751583,3578751624,41
1,1328,38526,3578751583,3578751626,43
1,1328,38527,3578751583,3578751628,45
1,1328,38528,3578751583,3578751629,46
1,1328,38529,3578751583,3578751629,46
1,1328,38530,3578751583,3578751630,47
1,1328,38531,3578751583,3578751630,47
1,1328,38532,3578751583,3578751632,49
1,1328,38533,3578751583,3578751632,49
1,1329,38534,3578751645,3578751645,0
1,1329,38535,3578751645,3578751645,0
1,1329,38536,3578751645,3578751645,0
1,1329,38537,3578751645,3578751645,0
1,1329,38538,3578751645,3578751645,0
1,1329,38539,3578751645,3578751645,0
1,1329,38540,3578751645,3578751645,0
1,1329,38541,3578751645,3578751645,0
1,1329,38542,3578751645,3578751645,0
1,1329,38543,3578751645,3578751645,0
1,1329,38544,3578751645,3578751646,1
1,1329,38545,3578751645,3578751648,3
1,1329,38546,3578751645,3578751648,3
1,1329,38547,3578751645,3578751649,4
1,1329,38548,3578751645,3578751650,5
1,1329,38549,3578751645,3578751650,5
1,1329,38550,3578751645,3578751652,7
1,1329,38551,3578751645,3578751652,7
1,1329,38552,3578751645,3578751655,10
1,1329,38553,3578751645,3578751655,10
1,1329,38554,3578751645,3578751656,11
1,1329,38555,3578751645,3578751658,13
1,1329,38556,3578751645,3578751661,16
1,1329,38557,3578751645,3578751662,17
1,1329,38558,3578751645,3578751662,17
1,1329,38559,3578751645,3578751663,18
1,1329,38560,3578751645,3578751664,19
1,1329,38561,3578751645,3578751665,20
1,1329,38562,3578751645,3578751667,22
1,1329,38563,3578751645,3578751667,22
1,1329,38564,3578751645,3578751668,23
1,1329,38565,3578751645,3578751669,24
1,1329,38566,3578751645,3578751676,31
1,1329,38567,3578751645,3578751678,33
1,1329,38568,3578751645,3578751679,34
1,1329,38569,3578751645,3578751681,36
1,1329,38570,3578751645,3578751682,37
1,1329,38571,3578751645,3578751682,37
1,1329,38572,3578751645,3578751684,39
1,1329,38573,3578751645,3578751685,40
1,1329,38574,3578751645,3578751685,40
1,1329,38575,3578751645,3578751685,40
1,1329,38576,3578751645,3578751687,42
1,1329,38577,3578751645,3578751688,43
1,1329,38578,3578751645,3578751690,45
1,1329,38579,3578751645,3578751691,46
1,1329,38580,3578751645,3578751691,46
1,1329,38581,3578751645,3578751692,47
1,1329,38582,3578751645,3578751693,48
1,1329,38583,3578751645,3578751693,48
1,1329,38584,3578751645,3578751693,48
1,1329,38585,3578751645,3578751695,50
1,1330,38586,3578751707,3578751707,0
1,1330,38587,3578751707,3578751707,0
1,1330,38588,3578751707,3578751707,0
1,1330,38589,3578751707,3578751707,0
1,1330,38590,3578751707,3578751707,0
1,1330,38591,3578751707,3578751707,0
1,1330,38592,3578751707,3578751707,0
1,1330,38593,3578751707,3578751707,0
1,1330,38594,3578751707,3578751707,0
1,1330,38595,3578751707,3578751707,0
1,1330,38596,3578751707,3578751707,0
1,1330,38597,3578751707,3578751707,0
1,1330,38598,3578751707,3578751707,0
1,1330,38599,3578751707,3578751707,0
1,1330,38600,3578751707,3578751707,0
1,1330,38601,3578751707,3578751709,2
1,1330,38602,3578751707,3578751710,3
1,1330,38603,3578751707,3578751711,4
1,1330,38604,3578751707,3578751712,5
1,1330,38605,3578751707,3578751712,5
1,1330,38606,3578751707,3578751712,5
1,1330,38607,3578751707,3578751713,6
1,1330,38608,3578751707,3578751714,7
1,1330,38609,3578751707,3578751714,7
1,1330,38610,3578751707,3578751714,7
1,1330,38611,3578751707,3578751715,8
1,1330,38612,3578751707,3578751716,9
1,1330,38613,3578751707,3578751716,9
1,1330,38614,3578751707,3578751718,11
1,1330,38615,3578751707,3578751718,11
1,1330,38616,3578751707,3578751719,12
1,1330,38617,3578751707,3578751720,13
1,1330,38618,3578751707,3578751720,13
1,1330,38619,3578751707,3578751721,14
1,1330,38620,3578751707,3578751721,14
1,1330,38621,3578751707,3578751723,16
1,1330,38622,3578751707,3578751724,17
1,1330,38623,3578751707,3578751724,17
1,1330,38624,3578751707,3578751725,18
1,1330,38625,3578751707,3578751726,19
1,1330,38626,3578751707,3578751726,19
1,1330,38627,3578751707,3578751726,19
1,1330,38628,3578751707,3578751727,20
1,1330,38629,3578751707,3578751728,21
1,1330,38630,3578751707,3578751728,21
1,1330,38631,3578751707,3578751729,22
1,1330,38632,3578751707,3578751730,23
1,1330,38633,3578751707,3578751731,24
1,1330,38634,3578751707,3578751731,24
1,1330,38635,3578751707,3578751732,25
1,1330,38636,3578751707,3578751732,25
1,1330,38637,3578751707,3578751733,26
1,1330,38638,3578751707,3578751733,26
1,1330,38639,3578751707,3578751734,27
1,1330,38640,3578751707,3578751734,27
1,1330,38641,3578751707,3578751734,27
1,1330,38642,3578751707,3578751735,28
1,1330,38643,3578751707,3578751736,29
1,1330,38644,3578751707,3578751736,29
1,1330,38645,3578751707,3578751737,30
1,1330,38646,3578751707,3578751739,32
1,1330,38647,3578751707,3578751740,33
1,1330,38648,3578751707,3578751742,35
1,1330,38649,3578751707,3578751744,37
1,1330,38650,3578751707,3578751745,38
1,1330,38651,3578751707,3578751747,40
1,1330,38652,3578751707,3578751749,42
1,1330,38653,3578751707,3578751750,43
1,1330,38654,3578751707,3578751752,45
1,1330,38655,3578751707,3578751752,45
1,1330,38656,3578751707,3578751753,46
1,1330,38657,3578751707,3578751754,47
1,1330,38658,3578751707,3578751755,48
1,1331,38659,3578751770,3578751770,0
1,1331,38660,3578751770,3578751770,0
1,1331,38661,3578751770,3578751770,0
1,1331,38662,3578751770,3578751770,0
1,1331,38663,3578751770,3578751770,0
1,1331,38664,3578751770,3578751770,0
1,1331,38665,3578751770,3578751770,0
1,1331,38666,3578751770,3578751770,0
1,1331,38667,3578751770,3578751770,0
1,1331,38668,3578751770,3578751770,0
1,1331,38669,3578751770,3578751770,0
1,1331,38670,3578751770,3578751770,0
1,1331,38671,3578751770,3578751770,0
1,1331,38672,3578751770,3578751770,0
1,1331,38673,3578751770,3578751771,1
1,1331,38674,3578751770,3578751772,2
1,1331,38675,3578751770,3578751773,3
1,1331,38676,3578751770,3578751774,4
1,1331,38677,3578751770,3578751775,5
1,1331,38678,3578751770,3578751776,6
1,1331,38679,3578751770,3578751777,7
1,1331,38680,3578751770,3578751778,8
1,1331,38681,3578751770,3578751778,8
1,1331,38682,3578751770,3578751779,9
1,1331,38683,3578751770,3578751779,9
1,1331,38684,3578751770,3578751779,9
1,1331,38685,3578751770,3578751780,10
1,1331,38686,3578751770,3578751780,10
1,1331,38687,3578751770,3578751781,11
1,1331,38688,3578751770,3578751782,12
1,1331,38689,3578751770,3578751782,12
1,1331,38690,3578751770,3578751783,13
1,1331,38691,3578751770,3578751784,14
1,1331,38692,3578751770,3578751785,15
1,1331,38693,3578751770,3578751786,16
1,1331,38694,3578751770,3578751788,18
1,1331,38695,3578751770,3578751790,20
1,1331,38696,3578751770,3578751790,20
1,1331,38697,3578751770,3578751791,21
1,1331,38698,3578751770,3578751791,21
1,1331,38699,3578751770,3578751795,25
1,1331,38700,3578751770,3578751795,25
1,1331,38701,3578751770,3578751795,25
1,1331,38702,3578751770,3578751796,26
1,1331,38703,3578751770,3578751796,26
1,1331,38704,3578751770,3578751797,27
1,1331,38705,3578751770,3578751797,27
1,1331,38706,3578751770,3578751797,27
1,1331,38707,3578751770,3578751798,28
1,1331,38708,3578751770,3578751798,28
1,1331,38709,3578751770,3578751798,28
1,1331,38710,3578751770,3578751799,29
1,1331,38711,3578751770,3578751799,29
1,1331,38712,3578751770,3578751800,30
1,1331,38713,3578751770,3578751803,33
1,1331,38714,3578751770,3578751804,34
1,1331,38715,3578751770,3578751806,36
1,1331,38716,3578751770,3578751809,39
1,1331,38717,3578751770,3578751809,39
1,1331,38718,3578751770,3578751812,42
1,1331,38719,3578751770,3578751812,42
1,1331,38720,3578751770,3578751813,43
1,1331,38721,3578751770,3578751814,44
1,1331,38722,3578751770,3578751815,45
1,1331,38723,3578751770,3578751815,45
1,1331,38724,3578751770,3578751815,45
1,1331,38725,3578751770,3578751816,46
1,1331,38726,3578751770,3578751819,49
1,1331,38727,3578751770,3578751819,49
1,1331,38728,3578751770,3578751819,49
1,1332,38729,3578751833,3578751833,0
1,1332,38730,3578751833,3578751833,0
1,1332,38731,3578751833,3578751833,0
1,1332,38732,3578751833,3578751833,0
1,1332,38733,3578751833,3578751833,0
1,1332,38734,3578751833,3578751833,0
1,1332,38735,3578751833,3578751833,0
1,1332,38736,3578751833,3578751833,0
1,1332,38737,3578751833,3578751833,0
1,1332,38738,3578751833,3578751834,1
1,1332,38739,3578751833,3578751834,1
1,1332,38740,3578751833,3578751834,1
1,1332,38741,3578751833,3578751834,1
1,1332,38742,3578751833,3578751834,1
1,1332,38743,3578751833,3578751834,1
1,1332,38744,3578751833,3578751834,1
1,1332,38745,3578751833,3578751834,1
1,1332,38746,3578751833,3578751836,3
1,1332,38747,3578751833,3578751836,3
1,1332,38748,3578751833,3578751838,5
1,1332,38749,3578751833,3578751839,6
1,1332,38750,3578751833,3578751840,7
1,1332,38751,3578751833,3578751841,8
1,1332,38752,3578751833,3578751842,9
1,1332,38753,3578751833,3578751843,10
1,1332,38754,3578751833,3578751844,11
1,1332,38755,3578751833,3578751847,14
1,1332,38756,3578751833,3578751848,15
1,1332,38757,3578751833,3578751848,15
1,1332,38758,3578751833,3578751849,16
1,1332,38759,3578751833,3578751850,17
1,1332,38760,3578751833,3578751851,18
1,1332,38761,3578751833,3578751851,18
1,1332,38762,3578751833,3578751853,20
1,1332,38763,3578751833,3578751854,21
1,1332,38764,3578751833,3578751855,22
1,1332,38765,3578751833,3578751855,22
1,1332,38766,3578751833,3578751856,23
1,1332,38767,3578751833,3578751858,25
1,1332,38768,3578751833,3578751861,28
1,1332,38769,3578751833,3578751861,28
1,1332,38770,3578751833,3578751862,29
1,1332,38771,3578751833,3578751863,30
1,1332,38772,3578751833,3578751864,31
1,1332,38773,3578751833,3578751865,32
1,1332,38774,3578751833,3578751867,34
1,1332,38775,3578751833,3578751867,34
1,1332,38776,3578751833,3578751868,35
1,1332,38777,3578751833,3578751869,36
1,1332,38778,3578751833,3578751877,44
1,1332,38779,3578751833,3578751879,46
1,1332,38780,3578751833,3578751880,47
1,1332,38781,3578751833,3578751882,49
1,1332,38782,3578751833,3578751883,50
1,1333,38783,3578751895,3578751895,0
1,1333,38784,3578751895,3578751895,0
1,1333,38785,3578751895,3578751895,0
1,1333,38786,3578751895,3578751895,0
1,1333,38787,3578751895,3578751895,0
1,1333,38788,3578751895,3578751895,0
1,1333,38789,3578751895,3578751895,0
1,1333,38790,3578751895,3578751895,0
1,1333,38791,3578751895,3578751895,0
1,1333,38792,3578751895,3578751895,0
1,1333,38793,3578751895,3578751895,0
1,1333,38794,3578751895,3578751895,0
1,1333,38795,3578751895,3578751895,0
1,1333,38796,3578751895,3578751895,0
1,1333,38797,3578751895,3578751895,0
1,1333,38798,3578751895,3578751896,1
1,1333,38799,3578751895,3578751899,4
1,1333,38800,3578751895,3578751901,6
1,1333,38801,3578751895,3578751901,6
1,1333,38802,3578751895,3578751902,7
1,1333,38803,3578751895,3578751902,7
1,1333,38804,3578751895,3578751902,7
1,1333,38805,3578751895,3578751903,8
1,1333,38806,3578751895,3578751903,8
1,1333,38807,3578751895,3578751903,8
1,1333,38808,3578751895,3578751904,9
1,1333,38809,3578751895,3578751904,9
1,1333,38810,3578751895,3578751906,11
1,1333,38811,3578751895,3578751907,12
1,1333,38812,3578751895,3578751907,12
1,1333,38813,3578751895,3578751910,15
1,1333,38814,3578751895,3578751910,15
1,1333,38815,3578751895,3578751911,16
1,1333,38816,3578751895,3578751911,16
1,1333,38817,3578751895,3578751912,17
1,1333,38818,3578751895,3578751913,18
1,1333,38819,3578751895,3578751913,18
1,1333,38820,3578751895,3578751914,19
1,1333,38821,3578751895,3578751915,20
1,1333,38822,3578751895,3578751916,21
1,1333,38823,3578751895,3578751916,21
1,1333,38824,3578751895,3578751916,21
1,1333,38825,3578751895,3578751917,22
1,1333,38826,3578751895,3578751919,24
1,1333,38827,3578751895,3578751919,24
1,1333,38828,3578751895,3578751919,24
1,1333,38829,3578751895,3578751920,25
1,1333,38830,3578751895,3578751922,27
1,1333,38831,3578751895,3578751922,27
1,1333,38832,3578751895,3578751922,27
1,1333,38833,3578751895,3578751923,28
1,1333,38834,3578751895,3578751924,29
1,1333,38835,3578751895,3578751925,30
1,1333,38836,3578751895,3578751926,31
1,1333,38837,3578751895,3578751927,32
1,1333,38838,3578751895,3578751927,32
1,1333,38839,3578751895,3578751927,32
1,1333,38840,3578751895,3578751929,34
1,1333,38841,3578751895,3578751929,34
1,1333,38842,3578751895,3578751930,35
1,1333,38843,3578751895,3578751931,36
1,1333,38844,3578751895,3578751931,36
1,1333,38845,3578751895,3578751932,37
1,1333,38846,3578751895,3578751932,37
1,1333,38847,3578751895,3578751932,37
1,1333,38848,3578751895,3578751933,38
1,1333,38849,3578751895,3578751933,38
1,1333,38850,3578751895,3578751933,38
1,1333,38851,3578751895,3578751934,39
1,1333,38852,3578751895,3578751935,40
1,1333,38853,3578751895,3578751935,40
1,1333,38854,3578751895,3578751935,40
1,1333,38855,3578751895,3578751936,41
1,1333,38856,3578751895,3578751937,42
1,1333,38857,3578751895,3578751938,43
1,1333,38858,3578751895,3578751939,44
1,1333,38859,3578751895,3578751940,45
1,1333,38860,3578751895,3578751941,46
1,1333,38861,3578751895,3578751942,47
1,1333,38862,3578751895,3578751944,49
1,1334,38863,3578751957,3578751957,0
1,1334,38864,3578751957,3578751957,0
1,1334,38865,3578751957,3578751957,0
1,1334,38866,3578751957,3578751957,0
1,1334,38867,3578751957,3578751957,0
1,1334,38868,3578751957,3578751957,0
1,1334,38869,3578751957,3578751957,0
1,1334,38870,3578751957,3578751957,0
1,1334,38871,3578751957,3578751957,0
1,1334,38872,3578751957,3578751957,0
1,1334,38873,3578751957,3578751958,1
1,1334,38874,3578751957,3578751958,1
1,1334,38875,3578751957,3578751960,3
1,1334,38876,3578751957,3578751961,4
1,1334,38877,3578751957,3578751962,5
1,1334,38878,3578751957,3578751962,5
1,1334,38879,3578751957,3578751962,5
1,1334,38880,3578751957,3578751964,7
1,1334,38881,3578751957,3578751964,7
1,1334,38882,3578751957,3578751965,8
1,1334,38883,3578751957,3578751965,8
1,1334,38884,3578751957,3578751967,10
1,1334,38885,3578751957,3578751968,11
1,1334,38886,3578751957,3578751969,12
1,1334,38887,3578751957,3578751970,13
1,1334,38888,3578751957,3578751971,14
1,1334,38889,3578751957,3578751972,15
1,1334,38890,3578751957,3578751974,17
1,1334,38891,3578751957,3578751974,17
1,1334,38892,3578751957,3578751975,18
1,1334,38893,3578751957,3578751976,19
1,1334,38894,3578751957,3578751978,21
1,1334,38895,3578751957,3578751978,21
1,1334,38896,3578751957,3578751978,21
1,1334,38897,3578751957,3578751979,22
1,1334,38898,3578751957,3578751979,22
1,1334,38899,3578751957,3578751979,22
1,1334,38900,3578751957,3578751979,22
1,1334,38901,3578751957,3578751981,24
1,1334,38902,3578751957,3578751982,25
1,1334,38903,3578751957,3578751982,25
1,1334,38904,3578751957,3578751983,26
1,1334,38905,3578751957,3578751984,27
1,1334,38906,3578751957,3578751985,28
1,1334,38907,3578751957,3578751985,28
1,1334,38908,3578751957,3578751987,30
1,1334,38909,3578751957,3578751988,31
1,1334,38910,3578751957,3578751989,32
1,1334,38911,3578751957,3578751989,32
1,1334,38912,3578751957,3578751990,33
1,1334,38913,3578751957,3578751991,34
1,1334,38914,3578751957,3578751992,35
1,1334,38915,3578751957,3578751994,37
1,1334,38916,3578751957,3578751995,38
1,1334,38917,3578751957,3578751996,39
1,1334,38918,3578751957,3578751996,39
1,1334,38919,3578751957,3578751996,39
1,1334,38920,3578751957,3578751997,40
1,1334,38921,3578751957,3578751997,40
1,1334,38922,3578751957,3578751998,41
1,1334,38923,3578751957,3578751998,41
1,1334,38924,3578751957,3578751999,42
1,1334,38925,3578751957,3578751999,42
1,1334,38926,3578751957,3578751999,42
1,1334,38927,3578751957,3578752000,43
1,1334,38928,3578751957,3578752001,44
1,1334,38929,3578751957,3578752002,45
1,1334,38930,3578751957,3578752004,47
1,1334,38931,3578751957,3578752006,49
1,1335,38932,3578752018,3578752018,0
1,1335,38933,3578752018,3578752018,0
1,1335,38934,3578752018,3578752018,0
1,1335,38935,3578752018,3578752018,0
1,1335,38936,3578752018,3578752018,0
1,1335,38937,3578752018,3578752018,0
1,1335,38938,3578752018,3578752018,0
1,1335,38939,3578752018,3578752018,0
1,1335,38940,3578752018,3578752018,0
1,1335,38941,3578752018,3578752019,1
1,1335,38942,3578752018,3578752019,1
1,1335,38943,3578752018,3578752020,2
1,1335,38944,3578752018,3578752020,2
1,1335,38945,3578752018,3578752023,5
1,1335,38946,3578752018,3578752023,5
1,1335,38947,3578752018,3578752023,5
1,1335,38948,3578752018,3578752024,6
1,1335,38949,3578752018,3578752024,6
1,1335,38950,3578752018,3578752025,7
1,1335,38951,3578752018,3578752025,7
1,1335,38952,3578752018,3578752028,10
1,1335,38953,3578752018,3578752029,11
1,1335,38954,3578752018,3578752030,12
1,1335,38955,3578752018,3578752030,12
1,1335,38956,3578752018,3578752031,13
1,1335,38957,3578752018,3578752032,14
1,1335,38958,3578752018,3578752033,15
1,1335,38959,3578752018,3578752035,17
1,1335,38960,3578752018,3578752036,18
1,1335,38961,3578752018,3578752037,19
1,1335,38962,3578752018,3578752039,21
1,1335,38963,3578752018,3578752039,21
1,1335,38964,3578752018,3578752041,23
1,1335,38965,3578752018,3578752041,23
1,1335,38966,3578752018,3578752043,25
1,1335,38967,3578752018,3578752043,25
1,1335,38968,3578752018,3578752044,26
1,1335,38969,3578752018,3578752047,29
1,1335,38970,3578752018,3578752048,30
1,1335,38971,3578752018,3578752049,31
1,1335,38972,3578752018,3578752049,31
1,1335,38973,3578752018,3578752050,32
1,1335,38974,3578752018,3578752051,33
1,1335,38975,3578752018,3578752052,34
1,1335,38976,3578752018,3578752053,35
1,1335,38977,3578752018,3578752054,36
1,1335,38978,3578752018,3578752054,36
1,1335,38979,3578752018,3578752056,38
1,1335,38980,3578752018,3578752057,39
1,1335,38981,3578752018,3578752059,41
1,1335,38982,3578752018,3578752061,43
1,1335,38983,3578752018,3578752063,45
1,1335,38984,3578752018,3578752063,45
1,1335,38985,3578752018,3578752063,45
1,1335,38986,3578752018,3578752065,47
1,1335,38987,3578752018,3578752065,47
1,1335,38988,3578752018,3578752067,49
1,1335,38989,3578752018,3578752068,50
1,1336,38990,3578752080,3578752080,0
1,1336,38991,3578752080,3578752080,0
1,1336,38992,3578752080,3578752080,0
1,1336,38993,3578752080,3578752080,0
1,1336,38994,3578752080,3578752080,0
1,1336,38995,3578752080,3578752081,1
1,1336,38996,3578752080,3578752083,3
1,1336,38997,3578752080,3578752083,3
1,1336,38998,3578752080,3578752085,5
1,1336,38999,3578752080,3578752086,6
1,1336,39000,3578752080,3578752086,6
1,1336,39001,3578752080,3578752088,8
1,1336,39002,3578752080,3578752090,10
1,1336,39003,3578752080,3578752091,11
1,1336,39004,3578752080,3578752091,11
1,1336,39005,3578752080,3578752091,11
1,1336,39006,3578752080,3578752093,13
1,1336,39007,3578752080,3578752094,14
1,1336,39008,3578752080,3578752095,15
1,1336,39009,3578752080,3578752096,16
1,1336,39010,3578752080,3578752099,19
1,1336,39011,3578752080,3578752101,21
1,1336,39012,3578752080,3578752102,22
1,1336,39013,3578752080,3578752102,22
1,1336,39014,3578752080,3578752102,22
1,1336,39015,3578752080,3578752102,22
1,1336,39016,3578752080,3578752103,23
1,1336,39017,3578752080,3578752103,23
1,1336,39018,3578752080,3578752103,23
1,1336,39019,3578752080,3578752104,24
1,1336,39020,3578752080,3578752105,25
1,1336,39021,3578752080,3578752106,26
1,1336,39022,3578752080,3578752107,27
1,1336,39023,3578752080,3578752107,27
1,1336,39024,3578752080,3578752109,29
1,1336,39025,3578752080,3578752110,30
1,1336,39026,3578752080,3578752110,30
1,1336,39027,3578752080,3578752111,31
1,1336,39028,3578752080,3578752112,32
1,1336,39029,3578752080,3578752112,32
1,1336,39030,3578752080,3578752112,32
1,1336,39031,3578752080,3578752113,33
1,1336,39032,3578752080,3578752113,33
1,1336,39033,3578752080,3578752114,34
1,1336,39034,3578752080,3578752115,35
1,1336,39035,3578752080,3578752115,35
1,1336,39036,3578752080,3578752116,36
1,1336,39037,3578752080,3578752116,36
1,1336,39038,3578752080,3578752117,37
1,1336,39039,3578752080,3578752118,38
1,1336,39040,3578752080,3578752119,39
1,1336,39041,3578752080,3578752119,39
1,1336,39042,3578752080,3578752120,40
1,1336,39043,3578752080,3578752122,42
1,1336,39044,3578752080,3578752123,43
1,1336,39045,3578752080,3578752125,45
1,1336,39046,3578752080,3578752125,45
1,1336,39047,3578752080,3578752125,45
1,1336,39048,3578752080,3578752125,45
1,1336,39049,3578752080,3578752127,47
1,1336,39050,3578752080,3578752127,47
1,1336,39051,3578752080,3578752128,48
1,1336,39052,3578752080,3578752128,48
1,1336,39053,3578752080,3578752129,49
1,1337,39054,3578752142,3578752142,0
1,1337,39055,3578752142,3578752143,1
1,1337,39056,3578752142,3578752143,1
1,1337,39057,3578752142,3578752143,1
1,1337,39058,3578752142,3578752143,1
1,1337,39059,3578752142,3578752143,1
1,1337,39060,3578752142,3578752143,1
1,1337,39061,3578752142,3578752143,1
1,1337,39062,3578752142,3578752143,1
1,1337,39063,3578752142,3578752143,1
1,1337,39064,3578752142,3578752143,1
1,1337,39065,3578752142,3578752143,1
1,1337,39066,3578752142,3578752143,1
1,1337,39067,3578752142,3578752143,1
1,1337,39068,3578752142,3578752143,1
1,1337,39069,3578752142,3578752143,1
1,1337,39070,3578752142,3578752143,1
1,1337,39071,3578752142,3578752143,1
1,1337,39072,3578752142,3578752143,1
1,1337,39073,3578752142,3578752143,1
1,1337,39074,3578752142,3578752146,4
1,1337,39075,3578752142,3578752148,6
1,1337,39076,3578752142,3578752150,8
1,1337,39077,3578752142,3578752152,10
1,1337,39078,3578752142,3578752153,11
1,1337,39079,3578752142,3578752154,12
1,1337,39080,3578752142,3578752155,13
1,1337,39081,3578752142,3578752157,15
1,1337,39082,3578752142,3578752158,16
1,1337,39083,3578752142,3578752160,18
1,1337,39084,3578752142,3578752162,20
1,1337,39085,3578752142,3578752162,20
1,1337,39086,3578752142,3578752162,20
1,1337,39087,3578752142,3578752163,21
1,1337,39088,3578752142,3578752164,22
1,1337,39089,3578752142,3578752165,23
1,1337,39090,3578752142,3578752165,23
1,1337,39091,3578752142,3578752166,24
1,1337,39092,3578752142,3578752168,26
1,1337,39093,3578752142,3578752168,26
1,1337,39094,3578752142,3578752169,27
1,1337,39095,3578752142,3578752170,28
1,1337,39096,3578752142,3578752171,29
1,1337,39097,3578752142,3578752172,30
1,1337,39098,3578752142,3578752174,32
1,1337,39099,3578752142,3578752174,32
1,1337,39100,3578752142,3578752175,33
1,1337,39101,3578752142,3578752176,34
1,1337,39102,3578752142,3578752177,35
1,1337,39103,3578752142,3578752179,37
1,1337,39104,3578752142,3578752179,37
1,1337,39105,3578752142,3578752179,37
1,1337,39106,3578752142,3578752179,37
1,1337,39107,3578752142,3578752180,38
1,1337,39108,3578752142,3578752180,38
1,1337,39109,3578752142,3578752182,40
1,1337,39110,3578752142,3578752182,40
1,1337,39111,3578752142,3578752183,41
1,1337,39112,3578752142,3578752184,42
1,1337,39113,3578752142,3578752185,43
1,1337,39114,3578752142,3578752186,44
1,1337,39115,3578752142,3578752188,46
1,1337,39116,3578752142,3578752188,46
1,1337,39117,3578752142,3578752189,47
1,1337,39118,3578752142,3578752191,49
1,1337,39119,3578752142,3578752191,49
1,1337,39120,3578752142,3578752192,50
1,1338,39121,3578752205,3578752205,0
1,1338,39122,3578752205,3578752205,0
1,1338,39123,3578752205,3578752205,0
1,1338,39124,3578752205,3578752205,0
1,1338,39125,3578752205,3578752205,0
1,1338,39126,3578752205,3578752205,0
1,1338,39127,3578752205,3578752205,0
1,1338,39128,3578752205,3578752205,0
1,1338,39129,3578752205,3578752205,0
1,1338,39130,3578752205,3578752205,0
1,1338,39131,3578752205,3578752205,0
1,1338,39132,3578752205,3578752205,0
1,1338,39133,3578752205,3578752205,0
1,1338,39134,3578752205,3578752205,0
1,1338,39135,3578752205,3578752205,0
1,1338,39136,3578752205,3578752206,1
1,1338,39137,3578752205,3578752208,3
1,1338,39138,3578752205,3578752209,4
1,1338,39139,3578752205,3578752213,8
1,1338,39140,3578752205,3578752213,8
1,1338,39141,3578752205,3578752213,8
1,1338,39142,3578752205,3578752214,9
1,1338,39143,3578752205,3578752214,9
1,1338,39144,3578752205,3578752217,12
1,1338,39145,3578752205,3578752217,12
1,1338,39146,3578752205,3578752218,13
1,1338,39147,3578752205,3578752218,13
1,1338,39148,3578752205,3578752219,14
1,1338,39149,3578752205,3578752219,14
1,1338,39150,3578752205,3578752223,18
1,1338,39151,3578752205,3578752223,18
1,1338,39152,3578752205,3578752224,19
1,1338,39153,3578752205,3578752224,19
1,1338,39154,3578752205,3578752225,20
1,1338,39155,3578752205,3578752226,21
1,1338,39156,3578752205,3578752228,23
1,1338,39157,3578752205,3578752230,25
1,1338,39158,3578752205,3578752230,25
1,1338,39159,3578752205,3578752230,25
1,1338,39160,3578752205,3578752231,26
1,1338,39161,3578752205,3578752231,26
1,1338,39162,3578752205,3578752234,29
1,1338,39163,3578752205,3578752235,30
1,1338,39164,3578752205,3578752236,31
1,1338,39165,3578752205,3578752237,32
1,1338,39166,3578752205,3578752239,34
1,1338,39167,3578752205,3578752239,34
1,1338,39168,3578752205,3578752242,37
1,1338,39169,3578752205,3578752243,38
1,1338,39170,3578752205,3578752243,38
1,1338,39171,3578752205,3578752245,40
1,1338,39172,3578752205,3578752246,41
1,1338,39173,3578752205,3578752248,43
1,1338,39174,3578752205,3578752249,44
1,1338,39175,3578752205,3578752250,45
1,1338,39176,3578752205,3578752250,45
1,1338,39177,3578752205,3578752252,47
1,1338,39178,3578752205,3578752252,47
1,1338,39179,3578752205,3578752254,49
1,1338,39180,3578752205,3578752254,49
1,1338,39181,3578752205,3578752255,50
1,1339,39182,3578752268,3578752268,0
1,1339,39183,3578752268,3578752268,0
1,1339,39184,3578752268,3578752268,0
1,1339,39185,3578752268,3578752268,0
1,1339,39186,3578752268,3578752268,0
1,1339,39187,3578752268,3578752268,0
1,1339,39188,3578752268,3578752268,0
1,1339,39189,3578752268,3578752268,0
1,1339,39190,3578752268,3578752268,0
1,1339,39191,3578752268,3578752268,0
1,1339,39192,3578752268,3578752269,1
1,1339,39193,3578752268,3578752270,2
1,1339,39194,3578752268,3578752277,9
1,1339,39195,3578752268,3578752278,10
1,1339,39196,3578752268,3578752281,13
1,1339,39197,3578752268,3578752282,14
1,1339,39198,3578752268,3578752283,15
1,1339,39199,3578752268,3578752284,16
1,1339,39200,3578752268,3578752285,17
1,1339,39201,3578752268,3578752286,18
1,1339,39202,3578752268,3578752286,18
1,1339,39203,3578752268,3578752288,20
1,1339,39204,3578752268,3578752289,21
1,1339,39205,3578752268,3578752289,21
1,1339,39206,3578752268,3578752291,23
1,1339,39207,3578752268,3578752291,23
1,1339,39208,3578752268,3578752292,24
1,1339,39209,3578752268,3578752293,25
1,1339,39210,3578752268,3578752294,26
1,1339,39211,3578752268,3578752295,27
1,1339,39212,3578752268,3578752297,29
1,1339,39213,3578752268,3578752301,33
1,1339,39214,3578752268,3578752302,34
1,1339,39215,3578752268,3578752302,34
1,1339,39216,3578752268,3578752302,34
1,1339,39217,3578752268,3578752303,35
1,1339,39218,3578752268,3578752303,35
1,1339,39219,3578752268,3578752303,35
1,1339,39220,3578752268,3578752304,36
1,1339,39221,3578752268,3578752304,36
1,1339,39222,3578752268,3578752304,36
1,1339,39223,3578752268,3578752307,39
1,1339,39224,3578752268,3578752307,39
1,1339,39225,3578752268,3578752307,39
1,1339,39226,3578752268,3578752309,41
1,1339,39227,3578752268,3578752309,41
1,1339,39228,3578752268,3578752311,43
1,1339,39229,3578752268,3578752311,43
1,1339,39230,3578752268,3578752312,44
1,1339,39231,3578752268,3578752312,44
1,1339,39232,3578752268,3578752312,44
1,1339,39233,3578752268,3578752313,45
1,1339,39234,3578752268,3578752313,45
1,1339,39235,3578752268,3578752314,46
1,1339,39236,3578752268,3578752315,47
1,1339,39237,3578752268,3578752316,48
1,1339,39238,3578752268,3578752316,48
1,1339,39239,3578752268,3578752316,48
1,1339,39240,3578752268,3578752317,49
1,1339,39241,3578752268,3578752317,49
1,1340,39242,3578752330,3578752330,0
1,1340,39243,3578752330,3578752330,0
1,1340,39244,3578752330,3578752330,0
1,1340,39245,3578752330,3578752330,0
1,1340,39246,3578752330,3578752330,0
1,1340,39247,3578752330,3578752330,0
1,1340,39248,3578752330,3578752330,0
1,1340,39249,3578752330,3578752330,0
1,1340,39250,3578752330,3578752330,0
1,1340,39251,3578752330,3578752330,0
1,1340,39252,3578752330,3578752330,0
1,1340,39253,3578752330,3578752330,0
1,1340,39254,3578752330,3578752330,0
1,1340,39255,3578752330,3578752330,0
1,1340,39256,3578752330,3578752330,0
1,1340,39257,3578752330,3578752331,1
1,1340,39258,3578752330,3578752331,1
1,1340,39259,3578752330,3578752333,3
1,1340,39260,3578752330,3578752333,3
1,1340,39261,3578752330,3578752333,3
1,1340,39262,3578752330,3578752333,3
1,1340,39263,3578752330,3578752333,3
1,1340,39264,3578752330,3578752334,4
1,1340,39265,3578752330,3578752334,4
1,1340,39266,3578752330,3578752335,5
1,1340,39267,3578752330,3578752335,5
1,1340,39268,3578752330,3578752336,6
1,1340,39269,3578752330,3578752336,6
1,1340,39270,3578752330,3578752338,8
1,1340,39271,3578752330,3578752339,9
1,1340,39272,3578752330,3578752340,10
1,1340,39273,3578752330,3578752340,10
1,1340,39274,3578752330,3578752341,11
1,1340,39275,3578752330,3578752341,11
1,1340,39276,3578752330,3578752344,14
1,1340,39277,3578752330,3578752344,14
1,1340,39278,3578752330,3578752346,16
1,1340,39279,3578752330,3578752347,17
1,1340,39280,3578752330,3578752348,18
1,1340,39281,3578752330,3578752349,19
1,1340,39282,3578752330,3578752350,20
1,1340,39283,3578752330,3578752353,23
1,1340,39284,3578752330,3578752353,23
1,1340,39285,3578752330,3578752353,23
1,1340,39286,3578752330,3578752355,25
1,1340,39287,3578752330,3578752357,27
1,1340,39288,3578752330,3578752358,28
1,1340,39289,3578752330,3578752360,30
1,1340,39290,3578752330,3578752361,31
1,1340,39291,3578752330,3578752362,32
1,1340,39292,3578752330,3578752362,32
1,1340,39293,3578752330,3578752362,32
1,1340,39294,3578752330,3578752363,33
1,1340,39295,3578752330,3578752364,34
1,1340,39296,3578752330,3578752365,35
1,1340,39297,3578752330,3578752366,36
1,1340,39298,3578752330,3578752367,37
1,1340,39299,3578752330,3578752368,38
1,1340,39300,3578752330,3578752369,39
1,1340,39301,3578752330,3578752370,40
1,1340,39302,3578752330,3578752371,41
1,1340,39303,3578752330,3578752371,41
1,1340,39304,3578752330,3578752372,42
1,1340,39305,3578752330,3578752374,44
1,1340,39306,3578752330,3578752375,45
1,1340,39307,3578752330,3578752375,45
1,1340,39308,3578752330,3578752376,46
1,1340,39309,3578752330,3578752377,47
1,1340,39310,3578752330,3578752379,49
1,1340,39311,3578752330,3578752379,49
1,1340,39312,3578752330,3578752380,50
1,1341,39313,3578752393,3578752393,0
1,1341,39314,3578752393,3578752393,0
1,1341,39315,3578752393,3578752393,0
1,1341,39316,3578752393,3578752393,0
1,1341,39317,3578752393,3578752393,0
1,1341,39318,3578752393,3578752393,0
1,1341,39319,3578752393,3578752393,0
1,1341,39320,3578752393,3578752393,0
1,1341,39321,3578752393,3578752393,0
1,1341,39322,3578752393,3578752393,0
1,1341,39323,3578752393,3578752393,0
1,1341,39324,3578752393,3578752393,0
1,1341,39325,3578752393,3578752393,0
1,1341,39326,3578752393,3578752393,0
1,1341,39327,3578752393,3578752393,0
1,1341,39328,3578752393,3578752393,0
1,1341,39329,3578752393,3578752395,2
1,1341,39330,3578752393,3578752396,3
1,1341,39331,3578752393,3578752397,4
1,1341,39332,3578752393,3578752397,4
1,1341,39333,3578752393,3578752397,4
1,1341,39334,3578752393,3578752398,5
1,1341,39335,3578752393,3578752398,5
1,1341,39336,3578752393,3578752398,5
1,1341,39337,3578752393,3578752399,6
1,1341,39338,3578752393,3578752400,7
1,1341,39339,3578752393,3578752403,10
1,1341,39340,3578752393,3578752405,12
1,1341,39341,3578752393,3578752409,16
1,1341,39342,3578752393,3578752413,20
1,1341,39343,3578752393,3578752413,20
1,1341,39344,3578752393,3578752413,20
1,1341,39345,3578752393,3578752414,21
1,1341,39346,3578752393,3578752415,22
1,1341,39347,3578752393,3578752416,23
1,1341,39348,3578752393,3578752417,24
1,1341,39349,3578752393,3578752418,25
1,1341,39350,3578752393,3578752418,25
1,1341,39351,3578752393,3578752420,27
1,1341,39352,3578752393,3578752420,27
1,1341,39353,3578752393,3578752421,28
1,1341,39354,3578752393,3578752424,31
1,1341,39355,3578752393,3578752424,31
1,1341,39356,3578752393,3578752424,31
1,1341,39357,3578752393,3578752424,31
1,1341,39358,3578752393,3578752425,32
1,1341,39359,3578752393,3578752425,32
1,1341,39360,3578752393,3578752426,33
1,1341,39361,3578752393,3578752429,36
1,1341,39362,3578752393,3578752429,36
1,1341,39363,3578752393,3578752430,37
1,1341,39364,3578752393,3578752430,37
1,1341,39365,3578752393,3578752430,37
1,1341,39366,3578752393,3578752431,38
1,1341,39367,3578752393,3578752432,39
1,1341,39368,3578752393,3578752433,40
1,1341,39369,3578752393,3578752434,41
1,1341,39370,3578752393,3578752435,42
1,1341,39371,3578752393,3578752436,43
1,1341,39372,3578752393,3578752437,44
1,1341,39373,3578752393,3578752439,46
1,1341,39374,3578752393,3578752440,47
1,1341,39375,3578752393,3578752442,49
1,1341,39376,3578752393,3578752442,49
1,1342,39377,3578752456,3578752456,0
1,1342,39378,3578752456,3578752456,0
1,1342,39379,3578752456,3578752456,0
1,1342,39380,3578752456,3578752456,0
1,1342,39381,3578752456,3578752456,0
1,1342,39382,3578752456,3578752456,0
1,1342,39383,3578752456,3578752456,0
1,1342,39384,3578752456,3578752456,0
1,1342,39385,3578752456,3578752456,0
1,1342,39386,3578752456,3578752456,0
1,1342,39387,3578752456,3578752456,0
1,1342,39388,3578752456,3578752456,0
1,1342,39389,3578752456,3578752457,1
1,1342,39390,3578752456,3578752457,1
1,1342,39391,3578752456,3578752459,3
1,1342,39392,3578752456,3578752462,6
1,1342,39393,3578752456,3578752462,6
1,1342,39394,3578752456,3578752463,7
1,1342,39395,3578752456,3578752464,8
1,1342,39396,3578752456,3578752465,9
1,1342,39397,3578752456,3578752465,9
1,1342,39398,3578752456,3578752468,12
1,1342,39399,3578752456,3578752468,12
1,1342,39400,3578752456,3578752469,13
1,1342,39401,3578752456,3578752469,13
1,1342,39402,3578752456,3578752476,20
1,1342,39403,3578752456,3578752478,22
1,1342,39404,3578752456,3578752482,26
1,1342,39405,3578752456,3578752483,27
1,1342,39406,3578752456,3578752484,28
1,1342,39407,3578752456,3578752485,29
1,1342,39408,3578752456,3578752486,30
1,1342,39409,3578752456,3578752486,30
1,1342,39410,3578752456,3578752488,32
1,1342,39411,3578752456,3578752488,32
1,1342,39412,3578752456,3578752490,34
1,1342,39413,3578752456,3578752490,34
1,1342,39414,3578752456,3578752491,35
1,1342,39415,3578752456,3578752492,36
1,1342,39416,3578752456,3578752493,37
1,1342,39417,3578752456,3578752494,38
1,1342,39418,3578752456,3578752495,39
1,1342,39419,3578752456,3578752496,40
1,1342,39420,3578752456,3578752500,44
1,1342,39421,3578752456,3578752501,45
1,1342,39422,3578752456,3578752502,46
1,1342,39423,3578752456,3578752502,46
1,1342,39424,3578752456,3578752502,46
1,1342,39425,3578752456,3578752502,46
1,1342,39426,3578752456,3578752502,46
1,1342,39427,3578752456,3578752503,47
1,1342,39428,3578752456,3578752503,47
1,1342,39429,3578752456,3578752504,48
1,1342,39430,3578752456,3578752505,49
1,1343,39431,3578752518,3578752518,0
1,1343,39432,3578752518,3578752518,0
1,1343,39433,3578752518,3578752518,0
1,1343,39434,3578752518,3578752518,0
1,1343,39435,3578752518,3578752518,0
1,1343,39436,3578752518,3578752518,0
1,1343,39437,3578752518,3578752518,0
1,1343,39438,3578752518,3578752518,0
1,1343,39439,3578752518,3578752518,0
1,1343,39440,3578752518,3578752518,0
1,1343,39441,3578752518,3578752518,0
1,1343,39442,3578752518,3578752518,0
1,1343,39443,3578752518,3578752518,0
1,1343,39444,3578752518,3578752518,0
1,1343,39445,3578752518,3578752518,0
1,1343,39446,3578752518,3578752518,0
1,1343,39447,3578752518,3578752518,0
1,1343,39448,3578752518,3578752518,0
1,1343,39449,3578752518,3578752519,1
1,1343,39450,3578752518,3578752520,2
1,1343,39451,3578752518,3578752521,3
1,1343,39452,3578752518,3578752523,5
1,1343,39453,3578752518,3578752523,5
1,1343,39454,3578752518,3578752524,6
1,1343,39455,3578752518,3578752524,6
1,1343,39456,3578752518,3578752524,6
1,1343,39457,3578752518,3578752524,6
1,1343,39458,3578752518,3578752525,7
1,1343,39459,3578752518,3578752527,9
1,1343,39460,3578752518,3578752528,10
1,1343,39461,3578752518,3578752528,10
1,1343,39462,3578752518,3578752529,11
1,1343,39463,3578752518,3578752530,12
1,1343,39464,3578752518,3578752531,13
1,1343,39465,3578752518,3578752531,13
1,1343,39466,3578752518,3578752531,13
1,1343,39467,3578752518,3578752532,14
1,1343,39468,3578752518,3578752532,14
1,1343,39469,3578752518,3578752532,14
1,1343,39470,3578752518,3578752533,15
1,1343,39471,3578752518,3578752533,15
1,1343,39472,3578752518,3578752533,15
1,1343,39473,3578752518,3578752533,15
1,1343,39474,3578752518,3578752533,15
1,1343,39475,3578752518,3578752535,17
1,1343,39476,3578752518,3578752536,18
1,1343,39477,3578752518,3578752537,19
1,1343,39478,3578752518,3578752538,20
1,1343,39479,3578752518,3578752538,20
1,1343,39480,3578752518,3578752540,22
1,1343,39481,3578752518,3578752540,22
1,1343,39482,3578752518,3578752540,22
1,1343,39483,3578752518,3578752542,24
1,1343,39484,3578752518,3578752543,25
1,1343,39485,3578752518,3578752545,27
1,1343,39486,3578752518,3578752545,27
1,1343,39487,3578752518,3578752548,30
1,1343,39488,3578752518,3578752549,31
1,1343,39489,3578752518,3578752551,33
1,1343,39490,3578752518,3578752552,34
1,1343,39491,3578752518,3578752555,37
1,1343,39492,3578752518,3578752556,38
1,1343,39493,3578752518,3578752557,39
1,1343,39494,3578752518,3578752559,41
1,1343,39495,3578752518,3578752560,42
1,1343,39496,3578752518,3578752560,42
1,1343,39497,3578752518,3578752562,44
1,1343,39498,3578752518,3578752562,44
1,1343,39499,3578752518,3578752564,46
1,1343,39500,3578752518,3578752564,46
1,1343,39501,3578752518,3578752564,46
1,1343,39502,3578752518,3578752565,47
1,1343,39503,3578752518,3578752566,48
1,1343,39504,3578752518,3578752568,50
1,1344,39505,3578752581,3578752581,0
1,1344,39506,3578752581,3578752581,0
1,1344,39507,3578752581,3578752581,0
1,1344,39508,3578752581,3578752581,0
1,1344,39509,3578752581,3578752581,0
1,1344,39510,3578752581,3578752581,0
1,1344,39511,3578752581,3578752581,0
1,1344,39512,3578752581,3578752581,0
1,1344,39513,3578752581,3578752581,0
1,1344,39514,3578752581,3578752581,0
1,1344,39515,3578752581,3578752581,0
1,1344,39516,3578752581,3578752581,0
1,1344,39517,3578752581,3578752581,0
1,1344,39518,3578752581,3578752581,0
1,1344,39519,3578752581,3578752582,1
1,1344,39520,3578752581,3578752583,2
1,1344,39521,3578752581,3578752584,3
1,1344,39522,3578752581,3578752584,3
1,1344,39523,3578752581,3578752585,4
1,1344,39524,3578752581,3578752587,6
1,1344,39525,3578752581,3578752588,7
1,1344,39526,3578752581,3578752589,8
1,1344,39527,3578752581,3578752591,10
1,1344,39528,3578752581,3578752592,11
1,1344,39529,3578752581,3578752592,11
1,1344,39530,3578752581,3578752593,12
1,1344,39531,3578752581,3578752595,14
1,1344,39532,3578752581,3578752595,14
1,1344,39533,3578752581,3578752596,15
1,1344,39534,3578752581,3578752596,15
1,1344,39535,3578752581,3578752597,16
1,1344,39536,3578752581,3578752597,16
1,1344,39537,3578752581,3578752597,16
1,1344,39538,3578752581,3578752598,17
1,1344,39539,3578752581,3578752598,17
1,1344,39540,3578752581,3578752599,18
1,1344,39541,3578752581,3578752600,19
1,1344,39542,3578752581,3578752600,19
1,1344,39543,3578752581,3578752604,23
1,1344,39544,3578752581,3578752608,27
1,1344,39545,3578752581,3578752609,28
1,1344,39546,3578752581,3578752612,31
1,1344,39547,3578752581,3578752612,31
1,1344,39548,3578752581,3578752612,31
1,1344,39549,3578752581,3578752612,31
1,1344,39550,3578752581,3578752614,33
1,1344,39551,3578752581,3578752616,35
1,1344,39552,3578752581,3578752616,35
1,1344,39553,3578752581,3578752617,36
1,1344,39554,3578752581,3578752618,37
1,1344,39555,3578752581,3578752618,37
1,1344,39556,3578752581,3578752619,38
1,1344,39557,3578752581,3578752622,41
1,1344,39558,3578752581,3578752623,42
1,1344,39559,3578752581,3578752623,42
1,1344,39560,3578752581,3578752623,42
1,1344,39561,3578752581,3578752623,42
1,1344,39562,3578752581,3578752624,43
1,1344,39563,3578752581,3578752625,44
1,1344,39564,3578752581,3578752628,47
1,1344,39565,3578752581,3578752628,47
1,1344,39566,3578752581,3578752629,48
1,1344,39567,3578752581,3578752629,48
1,1344,39568,3578752581,3578752629,48
1,1344,39569,3578752581,3578752630,49
1,1344,39570,3578752581,3578752631,50
1,1345,39571,3578752643,3578752643,0
1,1345,39572,3578752643,3578752643,0
1,1345,39573,3578752643,3578752643,0
1,1345,39574,3578752643,3578752643,0
1,1345,39575,3578752643,3578752643,0
1,1345,39576,3578752643,3578752643,0
1,1345,39577,3578752643,3578752643,0
1,1345,39578,3578752643,3578752643,0
1,1345,39579,3578752643,3578752643,0
1,1345,39580,3578752643,3578752644,1
1,1345,39581,3578752643,3578752644,1
1,1345,39582,3578752643,3578752646,3
1,1345,39583,3578752643,3578752648,5
1,1345,39584,3578752643,3578752648,5
1,1345,39585,3578752643,3578752648,5
1,1345,39586,3578752643,3578752650,7
1,1345,39587,3578752643,3578752651,8
1,1345,39588,3578752643,3578752653,10
1,1345,39589,3578752643,3578752654,11
1,1345,39590,3578752643,3578752655,12
1,1345,39591,3578752643,3578752656,13
1,1345,39592,3578752643,3578752656,13
1,1345,39593,3578752643,3578752659,16
1,1345,39594,3578752643,3578752660,17
1,1345,39595,3578752643,3578752662,19
1,1345,39596,3578752643,3578752662,19
1,1345,39597,3578752643,3578752663,20
1,1345,39598,3578752643,3578752664,21
1,1345,39599,3578752643,3578752664,21
1,1345,39600,3578752643,3578752667,24
1,1345,39601,3578752643,3578752667,24
1,1345,39602,3578752643,3578752668,25
1,1345,39603,3578752643,3578752676,33
1,1345,39604,3578752643,3578752679,36
1,1345,39605,3578752643,3578752682,39
1,1345,39606,3578752643,3578752682,39
1,1345,39607,3578752643,3578752683,40
1,1345,39608,3578752643,3578752685,42
1,1345,39609,3578752643,3578752685,42
1,1345,39610,3578752643,3578752686,43
1,1345,39611,3578752643,3578752686,43
1,1345,39612,3578752643,3578752688,45
1,1345,39613,3578752643,3578752688,45
1,1345,39614,3578752643,3578752690,47
1,1345,39615,3578752643,3578752690,47
1,1345,39616,3578752643,3578752691,48
1,1345,39617,3578752643,3578752692,49
1,1346,39618,3578752706,3578752706,0
1,1346,39619,3578752706,3578752706,0
1,1346,39620,3578752706,3578752706,0
1,1346,39621,3578752706,3578752706,0
1,1346,39622,3578752706,3578752706,0
1,1346,39623,3578752706,3578752706,0
1,1346,39624,3578752706,3578752706,0
1,1346,39625,3578752706,3578752706,0
1,1346,39626,3578752706,3578752706,0
1,1346,39627,3578752706,3578752706,0
1,1346,39628,3578752706,3578752706,0
1,1346,39629,3578752706,3578752706,0
1,1346,39630,3578752706,3578752706,0
1,1346,39631,3578752706,3578752706,0
1,1346,39632,3578752706,3578752706,0
1,1346,39633,3578752706,3578752707,1
1,1346,39634,3578752706,3578752708,2
1,1346,39635,3578752706,3578752708,2
1,1346,39636,3578752706,3578752709,3
1,1346,39637,3578752706,3578752710,4
1,1346,39638,3578752706,3578752711,5
1,1346,39639,3578752706,3578752711,5
1,1346,39640,3578752706,3578752711,5
1,1346,39641,3578752706,3578752712,6
1,1346,39642,3578752706,3578752712,6
1,1346,39643,3578752706,3578752713,7
1,1346,39644,3578752706,3578752714,8
1,1346,39645,3578752706,3578752714,8
1,1346,39646,3578752706,3578752715,9
1,1346,39647,3578752706,3578752716,10
1,1346,39648,3578752706,3578752716,10
1,1346,39649,3578752706,3578752717,11
1,1346,39650,3578752706,3578752718,12
1,1346,39651,3578752706,3578752719,13
1,1346,39652,3578752706,3578752720,14
1,1346,39653,3578752706,3578752720,14
1,1346,39654,3578752706,3578752721,15
1,1346,39655,3578752706,3578752723,17
1,1346,39656,3578752706,3578752723,17
1,1346,39657,3578752706,3578752723,17
1,1346,39658,3578752706,3578752723,17
1,1346,39659,3578752706,3578752724,18
1,1346,39660,3578752706,3578752724,18
1,1346,39661,3578752706,3578752724,18
1,1346,39662,3578752706,3578752726,20
1,1346,39663,3578752706,3578752726,20
1,1346,39664,3578752706,3578752728,22
1,1346,39665,3578752706,3578752728,22
1,1346,39666,3578752706,3578752729,23
1,1346,39667,3578752706,3578752730,24
1,1346,39668,3578752706,3578752730,24
1,1346,39669,3578752706,3578752731,25
1,1346,39670,3578752706,3578752731,25
1,1346,39671,3578752706,3578752731,25
1,1346,39672,3578752706,3578752732,26
1,1346,39673,3578752706,3578752732,26
1,1346,39674,3578752706,3578752733,27
1,1346,39675,3578752706,3578752733,27
1,1346,39676,3578752706,3578752733,27
1,1346,39677,3578752706,3578752733,27
1,1346,39678,3578752706,3578752733,27
1,1346,39679,3578752706,3578752735,29
1,1346,39680,3578752706,3578752735,29
1,1346,39681,3578752706,3578752736,30
1,1346,39682,3578752706,3578752737,31
1,1346,39683,3578752706,3578752737,31
1,1346,39684,3578752706,3578752738,32
1,1346,39685,3578752706,3578752740,34
1,1346,39686,3578752706,3578752740,34
1,1346,39687,3578752706,3578752741,35
1,1346,39688,3578752706,3578752742,36
1,1346,39689,3578752706,3578752743,37
1,1346,39690,3578752706,3578752745,39
1,1346,39691,3578752706,3578752746,40
1,1346,39692,3578752706,3578752746,40
1,1346,39693,3578752706,3578752748,42
1,1346,39694,3578752706,3578752749,43
1,1346,39695,3578752706,3578752751,45
1,1346,39696,3578752706,3578752752,46
1,1346,39697,3578752706,3578752754,48
1,1346,39698,3578752706,3578752755,49
1,1347,39699,3578752768,3578752768,0
1,1347,39700,3578752768,3578752768,0
1,1347,39701,3578752768,3578752768,0
1,1347,39702,3578752768,3578752768,0
1,1347,39703,3578752768,3578752768,0
1,1347,39704,3578752768,3578752768,0
1,1347,39705,3578752768,3578752768,0
1,1347,39706,3578752768,3578752768,0
1,1347,39707,3578752768,3578752768,0
1,1347,39708,3578752768,3578752768,0
1,1347,39709,3578752768,3578752768,0
1,1347,39710,3578752768,3578752768,0
1,1347,39711,3578752768,3578752768,0
1,1347,39712,3578752768,3578752768,0
1,1347,39713,3578752768,3578752770,2
1,1347,39714,3578752768,3578752771,3
1,1347,39715,3578752768,3578752772,4
1,1347,39716,3578752768,3578752772,4
1,1347,39717,3578752768,3578752774,6
1,1347,39718,3578752768,3578752774,6
1,1347,39719,3578752768,3578752778,10
1,1347,39720,3578752768,3578752778,10
1,1347,39721,3578752768,3578752778,10
1,1347,39722,3578752768,3578752778,10
1,1347,39723,3578752768,3578752779,11
1,1347,39724,3578752768,3578752780,12
1,1347,39725,3578752768,3578752780,12
1,1347,39726,3578752768,3578752780,12
1,1347,39727,3578752768,3578752781,13
1,1347,39728,3578752768,3578752782,14
1,1347,39729,3578752768,3578752782,14
1,1347,39730,3578752768,3578752783,15
1,1347,39731,3578752768,3578752784,16
1,1347,39732,3578752768,3578752785,17
1,1347,39733,3578752768,3578752788,20
1,1347,39734,3578752768,3578752788,20
1,1347,39735,3578752768,3578752788,20
1,1347,39736,3578752768,3578752791,23
1,1347,39737,3578752768,3578752791,23
1,1347,39738,3578752768,3578752792,24
1,1347,39739,3578752768,3578752794,26
1,1347,39740,3578752768,3578752795,27
1,1347,39741,3578752768,3578752796,28
1,1347,39742,3578752768,3578752796,28
1,1347,39743,3578752768,3578752796,28
1,1347,39744,3578752768,3578752796,28
1,1347,39745,3578752768,3578752797,29
1,1347,39746,3578752768,3578752798,30
1,1347,39747,3578752768,3578752798,30
1,1347,39748,3578752768,3578752798,30
1,1347,39749,3578752768,3578752799,31
1,1347,39750,3578752768,3578752799,31
1,1347,39751,3578752768,3578752800,32
1,1347,39752,3578752768,3578752802,34
1,1347,39753,3578752768,3578752803,35
1,1347,39754,3578752768,3578752805,37
1,1347,39755,3578752768,3578752808,40
1,1347,39756,3578752768,3578752809,41
1,1347,39757,3578752768,3578752812,44
1,1347,39758,3578752768,3578752812,44
1,1347,39759,3578752768,3578752813,45
1,1347,39760,3578752768,3578752814,46
1,1347,39761,3578752768,3578752816,48
1,1347,39762,3578752768,3578752816,48
1,1347,39763,3578752768,3578752817,49
1,1348,39764,3578752831,3578752831,0
1,1348,39765,3578752831,3578752831,0
1,1348,39766,3578752831,3578752831,0
1,1348,39767,3578752831,3578752831,0
1,1348,39768,3578752831,3578752831,0
1,1348,39769,3578752831,3578752831,0
1,1348,39770,3578752831,3578752831,0
1,1348,39771,3578752831,3578752831,0
1,1348,39772,3578752831,3578752831,0
1,1348,39773,3578752831,3578752831,0
1,1348,39774,3578752831,3578752831,0
1,1348,39775,3578752831,3578752831,0
1,1348,39776,3578752831,3578752831,0
1,1348,39777,3578752831,3578752831,0
1,1348,39778,3578752831,3578752831,0
1,1348,39779,3578752831,3578752833,2
1,1348,39780,3578752831,3578752834,3
1,1348,39781,3578752831,3578752835,4
1,1348,39782,3578752831,3578752835,4
1,1348,39783,3578752831,3578752836,5
1,1348,39784,3578752831,3578752839,8
1,1348,39785,3578752831,3578752839,8
1,1348,39786,3578752831,3578752840,9
1,1348,39787,3578752831,3578752841,10
1,1348,39788,3578752831,3578752842,11
1,1348,39789,3578752831,3578752844,13
1,1348,39790,3578752831,3578752845,14
1,1348,39791,3578752831,3578752847,16
1,1348,39792,3578752831,3578752848,17
1,1348,39793,3578752831,3578752849,18
1,1348,39794,3578752831,3578752850,19
1,1348,39795,3578752831,3578752851,20
1,1348,39796,3578752831,3578752852,21
1,1348,39797,3578752831,3578752853,22
1,1348,39798,3578752831,3578752853,22
1,1348,39799,3578752831,3578752854,23
1,1348,39800,3578752831,3578752856,25
1,1348,39801,3578752831,3578752857,26
1,1348,39802,3578752831,3578752859,28
1,1348,39803,3578752831,3578752860,29
1,1348,39804,3578752831,3578752862,31
1,1348,39805,3578752831,3578752862,31
1,1348,39806,3578752831,3578752863,32
1,1348,39807,3578752831,3578752863,32
1,1348,39808,3578752831,3578752864,33
1,1348,39809,3578752831,3578752865,34
1,1348,39810,3578752831,3578752867,36
1,1348,39811,3578752831,3578752868,37
1,1348,39812,3578752831,3578752868,37
1,1348,39813,3578752831,3578752876,45
1,1348,39814,3578752831,3578752879,48
1,1349,39815,3578752894,3578752894,0
1,1349,39816,3578752894,3578752894,0
1,1349,39817,3578752894,3578752894,0
1,1349,39818,3578752894,3578752894,0
1,1349,39819,3578752894,3578752894,0
1,1349,39820,3578752894,3578752894,0
1,1349,39821,3578752894,3578752894,0
1,1349,39822,3578752894,3578752894,0
1,1349,39823,3578752894,3578752894,0
1,1349,39824,3578752894,3578752894,0
1,1349,39825,3578752894,3578752894,0
1,1349,39826,3578752894,3578752894,0
1,1349,39827,3578752894,3578752894,0
1,1349,39828,3578752894,3578752894,0
1,1349,39829,3578752894,3578752895,1
1,1349,39830,3578752894,3578752895,1
1,1349,39831,3578752894,3578752896,2
1,1349,39832,3578752894,3578752900,6
1,1349,39833,3578752894,3578752901,7
1,1349,39834,3578752894,3578752902,8
1,1349,39835,3578752894,3578752902,8
1,1349,39836,3578752894,3578752903,9
1,1349,39837,3578752894,3578752903,9
1,1349,39838,3578752894,3578752903,9
1,1349,39839,3578752894,3578752904,10
1,1349,39840,3578752894,3578752904,10
1,1349,39841,3578752894,3578752905,11
1,1349,39842,3578752894,3578752906,12
1,1349,39843,3578752894,3578752907,13
1,1349,39844,3578752894,3578752908,14
1,1349,39845,3578752894,3578752908,14
1,1349,39846,3578752894,3578752909,15
1,1349,39847,3578752894,3578752910,16
1,1349,39848,3578752894,3578752910,16
1,1349,39849,3578752894,3578752911,17
1,1349,39850,3578752894,3578752911,17
1,1349,39851,3578752894,3578752911,17
1,1349,39852,3578752894,3578752912,18
1,1349,39853,3578752894,3578752912,18
1,1349,39854,3578752894,3578752912,18
1,1349,39855,3578752894,3578752913,19
1,1349,39856,3578752894,3578752913,19
1,1349,39857,3578752894,3578752913,19
1,1349,39858,3578752894,3578752915,21
1,1349,39859,3578752894,3578752915,21
1,1349,39860,3578752894,3578752916,22
1,1349,39861,3578752894,3578752916,22
1,1349,39862,3578752894,3578752917,23
1,1349,39863,3578752894,3578752918,24
1,1349,39864,3578752894,3578752919,25
1,1349,39865,3578752894,3578752920,26
1,1349,39866,3578752894,3578752920,26
1,1349,39867,3578752894,3578752921,27
1,1349,39868,3578752894,3578752923,29
1,1349,39869,3578752894,3578752923,29
1,1349,39870,3578752894,3578752924,30
1,1349,39871,3578752894,3578752924,30
1,1349,39872,3578752894,3578752924,30
1,1349,39873,3578752894,3578752924,30
1,1349,39874,3578752894,3578752924,30
1,1349,39875,3578752894,3578752927,33
1,1349,39876,3578752894,3578752927,33
1,1349,39877,3578752894,3578752928,34
1,1349,39878,3578752894,3578752928,34
1,1349,39879,3578752894,3578752929,35
1,1349,39880,3578752894,3578752930,36
1,1349,39881,3578752894,3578752930,36
1,1349,39882,3578752894,3578752931,37
1,1349,39883,3578752894,3578752931,37
1,1349,39884,3578752894,3578752933,39
1,1349,39885,3578752894,3578752933,39
1,1349,39886,3578752894,3578752933,39
1,1349,39887,3578752894,3578752933,39
1,1349,39888,3578752894,3578752933,39
1,1349,39889,3578752894,3578752935,41
1,1349,39890,3578752894,3578752935,41
1,1349,39891,3578752894,3578752936,42
1,1349,39892,3578752894,3578752936,42
1,1349,39893,3578752894,3578752938,44
1,1349,39894,3578752894,3578752938,44
1,1349,39895,3578752894,3578752938,44
1,1349,39896,3578752894,3578752939,45
1,1349,39897,3578752894,3578752940,46
1,1349,39898,3578752894,3578752942,48
1,1349,39899,3578752894,3578752943,49
1,1349,39900,3578752894,3578752943,49
1,1350,39901,3578752956,3578752956,0
1,1350,39902,3578752956,3578752956,0
1,1350,39903,3578752956,3578752956,0
1,1350,39904,3578752956,3578752956,0
1,1350,39905,3578752956,3578752956,0
1,1350,39906,3578752956,3578752957,1
1,1350,39907,3578752956,3578752957,1
1,1350,39908,3578752956,3578752957,1
1,1350,39909,3578752956,3578752957,1
1,1350,39910,3578752956,3578752957,1
1,1350,39911,3578752956,3578752959,3
1,1350,39912,3578752956,3578752961,5
1,1350,39913,3578752956,3578752962,6
1,1350,39914,3578752956,3578752962,6
1,1350,39915,3578752956,3578752962,6
1,1350,39916,3578752956,3578752964,8
1,1350,39917,3578752956,3578752965,9
1,1350,39918,3578752956,3578752965,9
1,1350,39919,3578752956,3578752965,9
1,1350,39920,3578752956,3578752966,10
1,1350,39921,3578752956,3578752967,11
1,1350,39922,3578752956,3578752969,13
1,1350,39923,3578752956,3578752969,13
1,1350,39924,3578752956,3578752970,14
1,1350,39925,3578752956,3578752970,14
1,1350,39926,3578752956,3578752972,16
1,1350,39927,3578752956,3578752972,16
1,1350,39928,3578752956,3578752974,18
1,1350,39929,3578752956,3578752975,19
1,1350,39930,3578752956,3578752977,21
1,1350,39931,3578752956,3578752978,22
1,1350,39932,3578752956,3578752978,22
1,1350,39933,3578752956,3578752978,22
1,1350,39934,3578752956,3578752980,24
1,1350,39935,3578752956,3578752980,24
1,1350,39936,3578752956,3578752980,24
1,1350,39937,3578752956,3578752980,24
1,1350,39938,3578752956,3578752981,25
1,1350,39939,3578752956,3578752982,26
1,1350,39940,3578752956,3578752982,26
1,1350,39941,3578752956,3578752982,26
1,1350,39942,3578752956,3578752983,27
1,1350,39943,3578752956,3578752985,29
1,1350,39944,3578752956,3578752986,30
1,1350,39945,3578752956,3578752988,32
1,1350,39946,3578752956,3578752988,32
1,1350,39947,3578752956,3578752989,33
1,1350,39948,3578752956,3578752991,35
1,1350,39949,3578752956,3578752991,35
1,1350,39950,3578752956,3578752992,36
1,1350,39951,3578752956,3578752995,39
1,1350,39952,3578752956,3578752995,39
1,1350,39953,3578752956,3578752996,40
1,1350,39954,3578752956,3578752996,40
1,1350,39955,3578752956,3578752997,41
1,1350,39956,3578752956,3578752997,41
1,1350,39957,3578752956,3578752997,41
1,1350,39958,3578752956,3578752997,41
1,1350,39959,3578752956,3578752997,41
1,1350,39960,3578752956,3578752999,43
1,1350,39961,3578752956,3578752999,43
1,1350,39962,3578752956,3578752999,43
1,1350,39963,3578752956,3578752999,43
1,1350,39964,3578752956,3578753001,45
1,1350,39965,3578752956,3578753001,45
1,1350,39966,3578752956,3578753003,47
1,1350,39967,3578752956,3578753005,49
1,1351,39968,3578753018,3578753018,0
1,1351,39969,3578753018,3578753018,0
1,1351,39970,3578753018,3578753018,0
1,1351,39971,3578753018,3578753018,0
1,1351,39972,3578753018,3578753018,0
1,1351,39973,3578753018,3578753018,0
1,1351,39974,3578753018,3578753018,0
1,1351,39975,3578753018,3578753018,0
1,1351,39976,3578753018,3578753018,0
1,1351,39977,3578753018,3578753018,0
1,1351,39978,3578753018,3578753019,1
1,1351,39979,3578753018,3578753019,1
1,1351,39980,3578753018,3578753021,3
1,1351,39981,3578753018,3578753022,4
1,1351,39982,3578753018,3578753023,5
1,1351,39983,3578753018,3578753023,5
1,1351,39984,3578753018,3578753024,6
1,1351,39985,3578753018,3578753024,6
1,1351,39986,3578753018,3578753025,7
1,1351,39987,3578753018,3578753028,10
1,1351,39988,3578753018,3578753029,11
1,1351,39989,3578753018,3578753029,11
1,1351,39990,3578753018,3578753030,12
1,1351,39991,3578753018,3578753031,13
1,1351,39992,3578753018,3578753031,13
1,1351,39993,3578753018,3578753031,13
1,1351,39994,3578753018,3578753032,14
1,1351,39995,3578753018,3578753034,16
1,1351,39996,3578753018,3578753035,17
1,1351,39997,3578753018,3578753035,17
1,1351,39998,3578753018,3578753037,19
1,1351,39999,3578753018,3578753039,21
1,1351,40000,3578753018,3578753039,21
1,1351,40001,3578753018,3578753041,23
1,1351,40002,3578753018,3578753042,24
1,1351,40003,3578753018,3578753045,27
1,1351,40004,3578753018,3578753045,27
1,1351,40005,3578753018,3578753048,30
1,1351,40006,3578753018,3578753048,30
1,1351,40007,3578753018,3578753050,32
1,1351,40008,3578753018,3578753050,32
1,1351,40009,3578753018,3578753051,33
1,1351,40010,3578753018,3578753051,33
1,1351,40011,3578753018,3578753053,35
1,1351,40012,3578753018,3578753055,37
1,1351,40013,3578753018,3578753056,38
1,1351,40014,3578753018,3578753057,39
1,1351,40015,3578753018,3578753060,42
1,1351,40016,3578753018,3578753060,42
1,1351,40017,3578753018,3578753063,45
1,1351,40018,3578753018,3578753063,45
1,1351,40019,3578753018,3578753063,45
1,1351,40020,3578753018,3578753063,45
1,1351,40021,3578753018,3578753064,46
1,1351,40022,3578753018,3578753068,50
1,1352,40023,3578753080,3578753080,0
1,1352,40024,3578753080,3578753080,0
1,1352,40025,3578753080,3578753080,0
1,1352,40026,3578753080,3578753080,0
1,1352,40027,3578753080,3578753081,1
1,1352,40028,3578753080,3578753085,5
1,1352,40029,3578753080,3578753085,5
1,1352,40030,3578753080,3578753085,5
1,1352,40031,3578753080,3578753086,6
1,1352,40032,3578753080,3578753088,8
1,1352,40033,3578753080,3578753088,8
1,1352,40034,3578753080,3578753091,11
1,1352,40035,3578753080,3578753091,11
1,1352,40036,3578753080,3578753091,11
1,1352,40037,3578753080,3578753092,12
1,1352,40038,3578753080,3578753093,13
1,1352,40039,3578753080,3578753095,15
1,1352,40040,3578753080,3578753095,15
1,1352,40041,3578753080,3578753095,15
1,1352,40042,3578753080,3578753101,21
1,1352,40043,3578753080,3578753102,22
1,1352,40044,3578753080,3578753102,22
1,1352,40045,3578753080,3578753102,22
1,1352,40046,3578753080,3578753103,23
1,1352,40047,3578753080,3578753103,23
1,1352,40048,3578753080,3578753103,23
1,1352,40049,3578753080,3578753104,24
1,1352,40050,3578753080,3578753104,24
1,1352,40051,3578753080,3578753105,25
1,1352,40052,3578753080,3578753106,26
1,1352,40053,3578753080,3578753107,27
1,1352,40054,3578753080,3578753107,27
1,1352,40055,3578753080,3578753108,28
1,1352,40056,3578753080,3578753110,30
1,1352,40057,3578753080,3578753110,30
1,1352,40058,3578753080,3578753110,30
1,1352,40059,3578753080,3578753111,31
1,1352,40060,3578753080,3578753111,31
1,1352,40061,3578753080,3578753112,32
1,1352,40062,3578753080,3578753112,32
1,1352,40063,3578753080,3578753112,32
1,1352,40064,3578753080,3578753113,33
1,1352,40065,3578753080,3578753113,33
1,1352,40066,3578753080,3578753113,33
1,1352,40067,3578753080,3578753114,34
1,1352,40068,3578753080,3578753115,35
1,1352,40069,3578753080,3578753116,36
1,1352,40070,3578753080,3578753117,37
1,1352,40071,3578753080,3578753117,37
1,1352,40072,3578753080,3578753117,37
1,1352,40073,3578753080,3578753118,38
1,1352,40074,3578753080,3578753119,39
1,1352,40075,3578753080,3578753119,39
1,1352,40076,3578753080,3578753120,40
1,1352,40077,3578753080,3578753122,42
1,1352,40078,3578753080,3578753123,43
1,1352,40079,3578753080,3578753124,44
1,1352,40080,3578753080,3578753124,44
1,1352,40081,3578753080,3578753124,44
1,1352,40082,3578753080,3578753124,44
1,1352,40083,3578753080,3578753125,45
1,1352,40084,3578753080,3578753125,45
1,1352,40085,3578753080,3578753126,46
1,1352,40086,3578753080,3578753127,47
1,1352,40087,3578753080,3578753128,48
1,1352,40088,3578753080,3578753128,48
1,1352,40089,3578753080,3578753129,49
1,1353,40090,3578753142,3578753142,0
1,1353,40091,3578753142,3578753142,0
1,1353,40092,3578753142,3578753142,0
1,1353,40093,3578753142,3578753142,0
1,1353,40094,3578753142,3578753142,0
1,1353,40095,3578753142,3578753142,0
1,1353,40096,3578753142,3578753142,0
1,1353,40097,3578753142,3578753142,0
1,1353,40098,3578753142,3578753142,0
1,1353,40099,3578753142,3578753142,0
1,1353,40100,3578753142,3578753142,0
1,1353,40101,3578753142,3578753142,0
1,1353,40102,3578753142,3578753142,0
1,1353,40103,3578753142,3578753142,0
1,1353,40104,3578753142,3578753142,0
1,1353,40105,3578753142,3578753142,0
1,1353,40106,3578753142,3578753142,0
1,1353,40107,3578753142,3578753142,0
1,1353,40108,3578753142,3578753142,0
1,1353,40109,3578753142,3578753144,2
1,1353,40110,3578753142,3578753146,4
1,1353,40111,3578753142,3578753147,5
1,1353,40112,3578753142,3578753148,6
1,1353,40113,3578753142,3578753150,8
1,1353,40114,3578753142,3578753152,10
1,1353,40115,3578753142,3578753153,11
1,1353,40116,3578753142,3578753153,11
1,1353,40117,3578753142,3578753154,12
1,1353,40118,3578753142,3578753155,13
1,1353,40119,3578753142,3578753156,14
1,1353,40120,3578753142,3578753157,15
1,1353,40121,3578753142,3578753159,17
1,1353,40122,3578753142,3578753160,18
1,1353,40123,3578753142,3578753161,19
1,1353,40124,3578753142,3578753163,21
1,1353,40125,3578753142,3578753163,21
1,1353,40126,3578753142,3578753163,21
1,1353,40127,3578753142,3578753164,22
1,1353,40128,3578753142,3578753165,23
1,1353,40129,3578753142,3578753165,23
1,1353,40130,3578753142,3578753166,24
1,1353,40131,3578753142,3578753167,25
1,1353,40132,3578753142,3578753168,26
1,1353,40133,3578753142,3578753168,26
1,1353,40134,3578753142,3578753170,28
1,1353,40135,3578753142,3578753170,28
1,1353,40136,3578753142,3578753172,30
1,1353,40137,3578753142,3578753172,30
1,1353,40138,3578753142,3578753174,32
1,1353,40139,3578753142,3578753174,32
1,1353,40140,3578753142,3578753176,34
1,1353,40141,3578753142,3578753177,35
1,1353,40142,3578753142,3578753178,36
1,1353,40143,3578753142,3578753179,37
1,1353,40144,3578753142,3578753179,37
1,1353,40145,3578753142,3578753180,38
1,1353,40146,3578753142,3578753180,38
1,1353,40147,3578753142,3578753181,39
1,1353,40148,3578753142,3578753181,39
1,1353,40149,3578753142,3578753182,40
1,1353,40150,3578753142,3578753182,40
1,1353,40151,3578753142,3578753182,40
1,1353,40152,3578753142,3578753183,41
1,1353,40153,3578753142,3578753185,43
1,1353,40154,3578753142,3578753187,45
1,1353,40155,3578753142,3578753188,46
1,1353,40156,3578753142,3578753188,46
1,1353,40157,3578753142,3578753189,47
1,1353,40158,3578753142,3578753191,49
1,1353,40159,3578753142,3578753191,49
1,1353,40160,3578753142,3578753192,50
1,1354,40161,3578753204,3578753204,0
1,1354,40162,3578753204,3578753204,0
1,1354,40163,3578753204,3578753204,0
1,1354,40164,3578753204,3578753204,0
1,1354,40165,3578753204,3578753204,0
1,1354,40166,3578753204,3578753204,0
1,1354,40167,3578753204,3578753204,0
1,1354,40168,3578753204,3578753204,0
1,1354,40169,3578753204,3578753204,0
1,1354,40170,3578753204,3578753204,0
1,1354,40171,3578753204,3578753204,0
1,1354,40172,3578753204,3578753204,0
1,1354,40173,3578753204,3578753204,0
1,1354,40174,3578753204,3578753204,0
1,1354,40175,3578753204,3578753204,0
1,1354,40176,3578753204,3578753206,2
1,1354,40177,3578753204,3578753208,4
1,1354,40178,3578753204,3578753210,6
1,1354,40179,3578753204,3578753212,8
1,1354,40180,3578753204,3578753213,9
1,1354,40181,3578753204,3578753214,10
1,1354,40182,3578753204,3578753214,10
1,1354,40183,3578753204,3578753216,12
1,1354,40184,3578753204,3578753217,13
1,1354,40185,3578753204,3578753218,14
1,1354,40186,3578753204,3578753218,14
1,1354,40187,3578753204,3578753218,14
1,1354,40188,3578753204,3578753219,15
1,1354,40189,3578753204,3578753221,17
1,1354,40190,3578753204,3578753223,19
1,1354,40191,3578753204,3578753223,19
1,1354,40192,3578753204,3578753223,19
1,1354,40193,3578753204,3578753224,20
1,1354,40194,3578753204,3578753224,20
1,1354,40195,3578753204,3578753225,21
1,1354,40196,3578753204,3578753228,24
1,1354,40197,3578753204,3578753228,24
1,1354,40198,3578753204,3578753229,25
1,1354,40199,3578753204,3578753230,26
1,1354,40200,3578753204,3578753230,26
1,1354,40201,3578753204,3578753231,27
1,1354,40202,3578753204,3578753231,27
1,1354,40203,3578753204,3578753235,31
1,1354,40204,3578753204,3578753235,31
1,1354,40205,3578753204,3578753235,31
1,1354,40206,3578753204,3578753237,33
1,1354,40207,3578753204,3578753239,35
1,1354,40208,3578753204,3578753239,35
1,1354,40209,3578753204,3578753241,37
1,1354,40210,3578753204,3578753242,38
1,1354,40211,3578753204,3578753243,39
1,1354,40212,3578753204,3578753244,40
1,1354,40213,3578753204,3578753247,43
1,1354,40214,3578753204,3578753248,44
1,1354,40215,3578753204,3578753249,45
1,1354,40216,3578753204,3578753250,46
1,1354,40217,3578753204,3578753251,47
1,1354,40218,3578753204,3578753251,47
1,1354,40219,3578753204,3578753252,48
1,1354,40220,3578753204,3578753254,50
1,1355,40221,3578753266,3578753266,0
1,1355,40222,3578753266,3578753266,0
1,1355,40223,3578753266,3578753266,0
1,1355,40224,3578753266,3578753266,0
1,1355,40225,3578753266,3578753266,0
1,1355,40226,3578753266,3578753266,0
1,1355,40227,3578753266,3578753266,0
1,1355,40228,3578753266,3578753267,1
1,1355,40229,3578753266,3578753267,1
1,1355,40230,3578753266,3578753267,1
1,1355,40231,3578753266,3578753267,1
1,1355,40232,3578753266,3578753268,2
1,1355,40233,3578753266,3578753268,2
1,1355,40234,3578753266,3578753269,3
1,1355,40235,3578753266,3578753277,11
1,1355,40236,3578753266,3578753280,14
1,1355,40237,3578753266,3578753282,16
1,1355,40238,3578753266,3578753283,17
1,1355,40239,3578753266,3578753285,19
1,1355,40240,3578753266,3578753285,19
1,1355,40241,3578753266,3578753286,20
1,1355,40242,3578753266,3578753287,21
1,1355,40243,3578753266,3578753288,22
1,1355,40244,3578753266,3578753289,23
1,1355,40245,3578753266,3578753290,24
1,1355,40246,3578753266,3578753291,25
1,1355,40247,3578753266,3578753292,26
1,1355,40248,3578753266,3578753292,26
1,1355,40249,3578753266,3578753293,27
1,1355,40250,3578753266,3578753295,29
1,1355,40251,3578753266,3578753295,29
1,1355,40252,3578753266,3578753300,34
1,1355,40253,3578753266,3578753302,36
1,1355,40254,3578753266,3578753302,36
1,1355,40255,3578753266,3578753302,36
1,1355,40256,3578753266,3578753302,36
1,1355,40257,3578753266,3578753303,37
1,1355,40258,3578753266,3578753305,39
1,1355,40259,3578753266,3578753305,39
1,1355,40260,3578753266,3578753305,39
1,1355,40261,3578753266,3578753307,41
1,1355,40262,3578753266,3578753307,41
1,1355,40263,3578753266,3578753307,41
1,1355,40264,3578753266,3578753308,42
1,1355,40265,3578753266,3578753310,44
1,1355,40266,3578753266,3578753310,44
1,1355,40267,3578753266,3578753310,44
1,1355,40268,3578753266,3578753311,45
1,1355,40269,3578753266,3578753311,45
1,1355,40270,3578753266,3578753312,46
1,1355,40271,3578753266,3578753312,46
1,1355,40272,3578753266,3578753312,46
1,1355,40273,3578753266,3578753313,47
1,1355,40274,3578753266,3578753313,47
1,1355,40275,3578753266,3578753314,48
1,1355,40276,3578753266,3578753314,48
1,1355,40277,3578753266,3578753315,49
1,1356,40278,3578753330,3578753330,0
1,1356,40279,3578753330,3578753330,0
1,1356,40280,3578753330,3578753330,0
1,1356,40281,3578753330,3578753330,0
1,1356,40282,3578753330,3578753330,0
1,1356,40283,3578753330,3578753330,0
1,1356,40284,3578753330,3578753330,0
1,1356,40285,3578753330,3578753330,0
1,1356,40286,3578753330,3578753330,0
1,1356,40287,3578753330,3578753330,0
1,1356,40288,3578753330,3578753330,0
1,1356,40289,3578753330,3578753330,0
1,1356,40290,3578753330,3578753330,0
1,1356,40291,3578753330,3578753330,0
1,1356,40292,3578753330,3578753330,0
1,1356,40293,3578753330,3578753330,0
1,1356,40294,3578753330,3578753330,0
1,1356,40295,3578753330,3578753330,0
1,1356,40296,3578753330,3578753330,0
1,1356,40297,3578753330,3578753331,1
1,1356,40298,3578753330,3578753331,1
1,1356,40299,3578753330,3578753331,1
1,1356,40300,3578753330,3578753332,2
1,1356,40301,3578753330,3578753332,2
1,1356,40302,3578753330,3578753333,3
1,1356,40303,3578753330,3578753334,4
1,1356,40304,3578753330,3578753334,4
1,1356,40305,3578753330,3578753334,4
1,1356,40306,3578753330,3578753336,6
1,1356,40307,3578753330,3578753336,6
1,1356,40308,3578753330,3578753336,6
1,1356,40309,3578753330,3578753337,7
1,1356,40310,3578753330,3578753338,8
1,1356,40311,3578753330,3578753339,9
1,1356,40312,3578753330,3578753339,9
1,1356,40313,3578753330,3578753341,11
1,1356,40314,3578753330,3578753342,12
1,1356,40315,3578753330,3578753343,13
1,1356,40316,3578753330,3578753343,13
1,1356,40317,3578753330,3578753343,13
1,1356,40318,3578753330,3578753346,16
1,1356,40319,3578753330,3578753347,17
1,1356,40320,3578753330,3578753348,18
1,1356,40321,3578753330,3578753349,19
1,1356,40322,3578753330,3578753351,21
1,1356,40323,3578753330,3578753351,21
1,1356,40324,3578753330,3578753353,23
1,1356,40325,3578753330,3578753354,24
1,1356,40326,3578753330,3578753355,25
1,1356,40327,3578753330,3578753357,27
1,1356,40328,3578753330,3578753358,28
1,1356,40329,3578753330,3578753360,30
1,1356,40330,3578753330,3578753360,30
1,1356,40331,3578753330,3578753362,32
1,1356,40332,3578753330,3578753363,33
1,1356,40333,3578753330,3578753363,33
1,1356,40334,3578753330,3578753363,33
1,1356,40335,3578753330,3578753364,34
1,1356,40336,3578753330,3578753365,35
1,1356,40337,3578753330,3578753365,35
1,1356,40338,3578753330,3578753366,36
1,1356,40339,3578753330,3578753366,36
1,1356,40340,3578753330,3578753368,38
1,1356,40341,3578753330,3578753368,38
1,1356,40342,3578753330,3578753370,40
1,1356,40343,3578753330,3578753371,41
1,1356,40344,3578753330,3578753371,41
1,1356,40345,3578753330,3578753372,42
1,1356,40346,3578753330,3578753374,44
1,1356,40347,3578753330,3578753376,46
1,1356,40348,3578753330,3578753376,46
1,1356,40349,3578753330,3578753378,48
1,1356,40350,3578753330,3578753379,49
1,1356,40351,3578753330,3578753379,49
1,1356,40352,3578753330,3578753379,49
1,1356,40353,3578753330,3578753380,50
1,1357,40354,3578753393,3578753393,0
1,1357,40355,3578753393,3578753393,0
1,1357,40356,3578753393,3578753393,0
1,1357,40357,3578753393,3578753393,0
1,1357,40358,3578753393,3578753393,0
1,1357,40359,3578753393,3578753393,0
1,1357,40360,3578753393,3578753393,0
1,1357,40361,3578753393,3578753393,0
1,1357,40362,3578753393,3578753393,0
1,1357,40363,3578753393,3578753393,0
1,1357,40364,3578753393,3578753393,0
1,1357,40365,3578753393,3578753393,0
1,1357,40366,3578753393,3578753393,0
1,1357,40367,3578753393,3578753393,0
1,1357,40368,3578753393,3578753393,0
1,1357,40369,3578753393,3578753394,1
1,1357,40370,3578753393,3578753395,2
1,1357,40371,3578753393,3578753397,4
1,1357,40372,3578753393,3578753397,4
1,1357,40373,3578753393,3578753397,4
1,1357,40374,3578753393,3578753397,4
1,1357,40375,3578753393,3578753397,4
1,1357,40376,3578753393,3578753399,6
1,1357,40377,3578753393,3578753399,6
1,1357,40378,3578753393,3578753399,6
1,1357,40379,3578753393,3578753399,6
1,1357,40380,3578753393,3578753400,7
1,1357,40381,3578753393,3578753404,11
1,1357,40382,3578753393,3578753406,13
1,1357,40383,3578753393,3578753408,15
1,1357,40384,3578753393,3578753410,17
1,1357,40385,3578753393,3578753412,19
1,1357,40386,3578753393,3578753412,19
1,1357,40387,3578753393,3578753413,20
1,1357,40388,3578753393,3578753413,20
1,1357,40389,3578753393,3578753414,21
1,1357,40390,3578753393,3578753417,24
1,1357,40391,3578753393,3578753417,24
1,1357,40392,3578753393,3578753418,25
1,1357,40393,3578753393,3578753418,25
1,1357,40394,3578753393,3578753419,26
1,1357,40395,3578753393,3578753420,27
1,1357,40396,3578753393,3578753420,27
1,1357,40397,3578753393,3578753421,28
1,1357,40398,3578753393,3578753422,29
1,1357,40399,3578753393,3578753423,30
1,1357,40400,3578753393,3578753423,30
1,1357,40401,3578753393,3578753424,31
1,1357,40402,3578753393,3578753424,31
1,1357,40403,3578753393,3578753424,31
1,1357,40404,3578753393,3578753425,32
1,1357,40405,3578753393,3578753427,34
1,1357,40406,3578753393,3578753428,35
1,1357,40407,3578753393,3578753429,36
1,1357,40408,3578753393,3578753429,36
1,1357,40409,3578753393,3578753431,38
1,1357,40410,3578753393,3578753431,38
1,1357,40411,3578753393,3578753431,38
1,1357,40412,3578753393,3578753432,39
1,1357,40413,3578753393,3578753435,42
1,1357,40414,3578753393,3578753435,42
1,1357,40415,3578753393,3578753436,43
1,1357,40416,3578753393,3578753437,44
1,1357,40417,3578753393,3578753439,46
1,1357,40418,3578753393,3578753439,46
1,1357,40419,3578753393,3578753441,48
1,1357,40420,3578753393,3578753442,49
1,1357,40421,3578753393,3578753443,50
1,1358,40422,3578753455,3578753455,0
1,1358,40423,3578753455,3578753455,0
1,1358,40424,3578753455,3578753455,0
1,1358,40425,3578753455,3578753455,0
1,1358,40426,3578753455,3578753455,0
1,1358,40427,3578753455,3578753455,0
1,1358,40428,3578753455,3578753455,0
1,1358,40429,3578753455,3578753455,0
1,1358,40430,3578753455,3578753455,0
1,1358,40431,3578753455,3578753455,0
1,1358,40432,3578753455,3578753456,1
1,1358,40433,3578753455,3578753456,1
1,1358,40434,3578753455,3578753457,2
1,1358,40435,3578753455,3578753460,5
1,1358,40436,3578753455,3578753461,6
1,1358,40437,3578753455,3578753462,7
1,1358,40438,3578753455,3578753462,7
1,1358,40439,3578753455,3578753463,8
1,1358,40440,3578753455,3578753463,8
1,1358,40441,3578753455,3578753465,10
1,1358,40442,3578753455,3578753468,13
1,1358,40443,3578753455,3578753469,14
1,1358,40444,3578753455,3578753469,14
1,1358,40445,3578753455,3578753476,21
1,1358,40446,3578753455,3578753480,25
1,1358,40447,3578753455,3578753482,27
1,1358,40448,3578753455,3578753483,28
1,1358,40449,3578753455,3578753485,30
1,1358,40450,3578753455,3578753485,30
1,1358,40451,3578753455,3578753486,31
1,1358,40452,3578753455,3578753487,32
1,1358,40453,3578753455,3578753488,33
1,1358,40454,3578753455,3578753489,34
1,1358,40455,3578753455,3578753492,37
1,1358,40456,3578753455,3578753492,37
1,1358,40457,3578753455,3578753493,38
1,1358,40458,3578753455,3578753495,40
1,1358,40459,3578753455,3578753495,40
1,1358,40460,3578753455,3578753495,40
1,1358,40461,3578753455,3578753501,46
1,1358,40462,3578753455,3578753502,47
1,1358,40463,3578753455,3578753502,47
1,1358,40464,3578753455,3578753502,47
1,1358,40465,3578753455,3578753503,48
1,1358,40466,3578753455,3578753503,48
1,1358,40467,3578753455,3578753504,49
1,1358,40468,3578753455,3578753505,50
1,1359,40469,3578753517,3578753517,0
1,1359,40470,3578753517,3578753517,0
1,1359,40471,3578753517,3578753517,0
1,1359,40472,3578753517,3578753517,0
1,1359,40473,3578753517,3578753517,0
1,1359,40474,3578753517,3578753517,0
1,1359,40475,3578753517,3578753517,0
1,1359,40476,3578753517,3578753517,0
1,1359,40477,3578753517,3578753517,0
1,1359,40478,3578753517,3578753517,0
1,1359,40479,3578753517,3578753517,0
1,1359,40480,3578753517,3578753517,0
1,1359,40481,3578753517,3578753517,0
1,1359,40482,3578753517,3578753517,0
1,1359,40483,3578753517,3578753517,0
1,1359,40484,3578753517,3578753517,0
1,1359,40485,3578753517,3578753517,0
1,1359,40486,3578753517,3578753517,0
1,1359,40487,3578753517,3578753517,0
1,1359,40488,3578753517,3578753517,0
1,1359,40489,3578753517,3578753517,0
1,1359,40490,3578753517,3578753517,0
1,1359,40491,3578753517,3578753517,0
1,1359,40492,3578753517,3578753518,1
1,1359,40493,3578753517,3578753520,3
1,1359,40494,3578753517,3578753520,3
1,1359,40495,3578753517,3578753521,4
1,1359,40496,3578753517,3578753523,6
1,1359,40497,3578753517,3578753523,6
1,1359,40498,3578753517,3578753523,6
1,1359,40499,3578753517,3578753523,6
1,1359,40500,3578753517,3578753523,6
1,1359,40501,3578753517,3578753524,7
1,1359,40502,3578753517,3578753524,7
1,1359,40503,3578753517,3578753525,8
1,1359,40504,3578753517,3578753527,10
1,1359,40505,3578753517,3578753528,11
1,1359,40506,3578753517,3578753528,11
1,1359,40507,3578753517,3578753530,13
1,1359,40508,3578753517,3578753530,13
1,1359,40509,3578753517,3578753531,14
1,1359,40510,3578753517,3578753531,14
1,1359,40511,3578753517,3578753531,14
1,1359,40512,3578753517,3578753532,15
1,1359,40513,3578753517,3578753532,15
1,1359,40514,3578753517,3578753533,16
1,1359,40515,3578753517,3578753533,16
1,1359,40516,3578753517,3578753534,17
1,1359,40517,3578753517,3578753535,18
1,1359,40518,3578753517,3578753536,19
1,1359,40519,3578753517,3578753538,21
1,1359,40520,3578753517,3578753538,21
1,1359,40521,3578753517,3578753538,21
1,1359,40522,3578753517,3578753538,21
1,1359,40523,3578753517,3578753540,23
1,1359,40524,3578753517,3578753542,25
1,1359,40525,3578753517,3578753542,25
1,1359,40526,3578753517,3578753542,25
1,1359,40527,3578753517,3578753545,28
1,1359,40528,3578753517,3578753546,29
1,1359,40529,3578753517,3578753547,30
1,1359,40530,3578753517,3578753547,30
1,1359,40531,3578753517,3578753551,34
1,1359,40532,3578753517,3578753555,38
1,1359,40533,3578753517,3578753557,40
1,1359,40534,3578753517,3578753557,40
1,1359,40535,3578753517,3578753559,42
1,1359,40536,3578753517,3578753559,42
1,1359,40537,3578753517,3578753561,44
1,1359,40538,3578753517,3578753562,45
1,1359,40539,3578753517,3578753562,45
1,1359,40540,3578753517,3578753563,46
1,1359,40541,3578753517,3578753563,46
1,1359,40542,3578753517,3578753564,47
1,1359,40543,3578753517,3578753564,47
1,1359,40544,3578753517,3578753565,48
1,1359,40545,3578753517,3578753565,48
1,1359,40546,3578753517,3578753567,50
1,1360,40547,3578753580,3578753580,0
1,1360,40548,3578753580,3578753580,0
1,1360,40549,3578753580,3578753580,0
1,1360,40550,3578753580,3578753580,0
1,1360,40551,3578753580,3578753580,0
1,1360,40552,3578753580,3578753580,0
1,1360,40553,3578753580,3578753580,0
1,1360,40554,3578753580,3578753580,0
1,1360,40555,3578753580,3578753580,0
1,1360,40556,3578753580,3578753580,0
1,1360,40557,3578753580,3578753580,0
1,1360,40558,3578753580,3578753580,0
1,1360,40559,3578753580,3578753580,0
1,1360,40560,3578753580,3578753580,0
1,1360,40561,3578753580,3578753580,0
1,1360,40562,3578753580,3578753580,0
1,1360,40563,3578753580,3578753580,0
1,1360,40564,3578753580,3578753580,0
1,1360,40565,3578753580,3578753581,1
1,1360,40566,3578753580,3578753582,2
1,1360,40567,3578753580,3578753582,2
1,1360,40568,3578753580,3578753584,4
1,1360,40569,3578753580,3578753586,6
1,1360,40570,3578753580,3578753586,6
1,1360,40571,3578753580,3578753587,7
1,1360,40572,3578753580,3578753590,10
1,1360,40573,3578753580,3578753592,12
1,1360,40574,3578753580,3578753593,13
1,1360,40575,3578753580,3578753595,15
1,1360,40576,3578753580,3578753595,15
1,1360,40577,3578753580,3578753596,16
1,1360,40578,3578753580,3578753596,16
1,1360,40579,3578753580,3578753596,16
1,1360,40580,3578753580,3578753596,16
1,1360,40581,3578753580,3578753597,17
1,1360,40582,3578753580,3578753598,18
1,1360,40583,3578753580,3578753598,18
1,1360,40584,3578753580,3578753599,19
1,1360,40585,3578753580,3578753600,20
1,1360,40586,3578753580,3578753600,20
1,1360,40587,3578753580,3578753602,22
1,1360,40588,3578753580,3578753606,26
1,1360,40589,3578753580,3578753607,27
1,1360,40590,3578753580,3578753609,29
1,1360,40591,3578753580,3578753610,30
1,1360,40592,3578753580,3578753612,32
1,1360,40593,3578753580,3578753612,32
1,1360,40594,3578753580,3578753613,33
1,1360,40595,3578753580,3578753613,33
1,1360,40596,3578753580,3578753615,35
1,1360,40597,3578753580,3578753616,36
1,1360,40598,3578753580,3578753616,36
1,1360,40599,3578753580,3578753618,38
1,1360,40600,3578753580,3578753618,38
1,1360,40601,3578753580,3578753619,39
1,1360,40602,3578753580,3578753619,39
1,1360,40603,3578753580,3578753621,41
1,1360,40604,3578753580,3578753621,41
1,1360,40605,3578753580,3578753622,42
1,1360,40606,3578753580,3578753622,42
1,1360,40607,3578753580,3578753623,43
1,1360,40608,3578753580,3578753623,43
1,1360,40609,3578753580,3578753624,44
1,1360,40610,3578753580,3578753626,46
1,1360,40611,3578753580,3578753628,48
1,1360,40612,3578753580,3578753628,48
1,1360,40613,3578753580,3578753629,49
1,1361,40614,3578753643,3578753643,0
1,1361,40615,3578753643,3578753643,0
1,1361,40616,3578753643,3578753643,0
1,1361,40617,3578753643,3578753643,0
1,1361,40618,3578753643,3578753643,0
1,1361,40619,3578753643,3578753643,0
1,1361,40620,3578753643,3578753643,0
1,1361,40621,3578753643,3578753643,0
1,1361,40622,3578753643,3578753643,0
1,1361,40623,3578753643,3578753643,0
1,1361,40624,3578753643,3578753643,0
1,1361,40625,3578753643,3578753643,0
1,1361,40626,3578753643,3578753643,0
1,1361,40627,3578753643,3578753644,1
1,1361,40628,3578753643,3578753647,4
1,1361,40629,3578753643,3578753648,5
1,1361,40630,3578753643,3578753649,6
1,1361,40631,3578753643,3578753650,7
1,1361,40632,3578753643,3578753651,8
1,1361,40633,3578753643,3578753651,8
1,1361,40634,3578753643,3578753652,9
1,1361,40635,3578753643,3578753653,10
1,1361,40636,3578753643,3578753655,12
1,1361,40637,3578753643,3578753655,12
1,1361,40638,3578753643,3578753657,14
1,1361,40639,3578753643,3578753661,18
1,1361,40640,3578753643,3578753662,19
1,1361,40641,3578753643,3578753662,19
1,1361,40642,3578753643,3578753663,20
1,1361,40643,3578753643,3578753663,20
1,1361,40644,3578753643,3578753664,21
1,1361,40645,3578753643,3578753665,22
1,1361,40646,3578753643,3578753667,24
1,1361,40647,3578753643,3578753668,25
1,1361,40648,3578753643,3578753668,25
1,1361,40649,3578753643,3578753676,33
1,1361,40650,3578753643,3578753680,37
1,1361,40651,3578753643,3578753682,39
1,1361,40652,3578753643,3578753682,39
1,1361,40653,3578753643,3578753685,42
1,1361,40654,3578753643,3578753685,42
1,1361,40655,3578753643,3578753686,43
1,1361,40656,3578753643,3578753686,43
1,1361,40657,3578753643,3578753686,43
1,1361,40658,3578753643,3578753688,45
1,1361,40659,3578753643,3578753689,46
1,1361,40660,3578753643,3578753691,48
1,1361,40661,3578753643,3578753692,49
1,1361,40662,3578753643,3578753692,49
1,1362,40663,3578753706,3578753706,0
1,1362,40664,3578753706,3578753706,0
1,1362,40665,3578753706,3578753706,0
1,1362,40666,3578753706,3578753706,0
1,1362,40667,3578753706,3578753706,0
1,1362,40668,3578753706,3578753706,0
1,1362,40669,3578753706,3578753706,0
1,1362,40670,3578753706,3578753706,0
1,1362,40671,3578753706,3578753706,0
1,1362,40672,3578753706,3578753706,0
1,1362,40673,3578753706,3578753706,0
1,1362,40674,3578753706,3578753706,0
1,1362,40675,3578753706,3578753706,0
1,1362,40676,3578753706,3578753707,1
1,1362,40677,3578753706,3578753707,1
1,1362,40678,3578753706,3578753707,1
1,1362,40679,3578753706,3578753708,2
1,1362,40680,3578753706,3578753709,3
1,1362,40681,3578753706,3578753710,4
1,1362,40682,3578753706,3578753710,4
1,1362,40683,3578753706,3578753711,5
1,1362,40684,3578753706,3578753711,5
1,1362,40685,3578753706,3578753711,5
1,1362,40686,3578753706,3578753711,5
1,1362,40687,3578753706,3578753712,6
1,1362,40688,3578753706,3578753713,7
1,1362,40689,3578753706,3578753713,7
1,1362,40690,3578753706,3578753713,7
1,1362,40691,3578753706,3578753714,8
1,1362,40692,3578753706,3578753715,9
1,1362,40693,3578753706,3578753716,10
1,1362,40694,3578753706,3578753716,10
1,1362,40695,3578753706,3578753717,11
1,1362,40696,3578753706,3578753717,11
1,1362,40697,3578753706,3578753719,13
1,1362,40698,3578753706,3578753719,13
1,1362,40699,3578753706,3578753720,14
1,1362,40700,3578753706,3578753722,16
1,1362,40701,3578753706,3578753722,16
1,1362,40702,3578753706,3578753723,17
1,1362,40703,3578753706,3578753723,17
1,1362,40704,3578753706,3578753723,17
1,1362,40705,3578753706,3578753723,17
1,1362,40706,3578753706,3578753724,18
1,1362,40707,3578753706,3578753724,18
1,1362,40708,3578753706,3578753726,20
1,1362,40709,3578753706,3578753727,21
1,1362,40710,3578753706,3578753728,22
1,1362,40711,3578753706,3578753729,23
1,1362,40712,3578753706,3578753731,25
1,1362,40713,3578753706,3578753731,25
1,1362,40714,3578753706,3578753731,25
1,1362,40715,3578753706,3578753731,25
1,1362,40716,3578753706,3578753731,25
1,1362,40717,3578753706,3578753731,25
1,1362,40718,3578753706,3578753733,27
1,1362,40719,3578753706,3578753733,27
1,1362,40720,3578753706,3578753733,27
1,1362,40721,3578753706,3578753733,27
1,1362,40722,3578753706,3578753735,29
1,1362,40723,3578753706,3578753735,29
1,1362,40724,3578753706,3578753738,32
1,1362,40725,3578753706,3578753738,32
1,1362,40726,3578753706,3578753739,33
1,1362,40727,3578753706,3578753740,34
1,1362,40728,3578753706,3578753742,36
1,1362,40729,3578753706,3578753742,36
1,1362,40730,3578753706,3578753742,36
1,1362,40731,3578753706,3578753742,36
1,1362,40732,3578753706,3578753745,39
1,1362,40733,3578753706,3578753747,41
1,1362,40734,3578753706,3578753747,41
1,1362,40735,3578753706,3578753748,42
1,1362,40736,3578753706,3578753751,45
1,1362,40737,3578753706,3578753751,45
1,1362,40738,3578753706,3578753753,47
1,1362,40739,3578753706,3578753755,49
1,1363,40740,3578753769,3578753769,0
1,1363,40741,3578753769,3578753769,0
1,1363,40742,3578753769,3578753769,0
1,1363,40743,3578753769,3578753769,0
1,1363,40744,3578753769,3578753769,0
1,1363,40745,3578753769,3578753769,0
1,1363,40746,3578753769,3578753769,0
1,1363,40747,3578753769,3578753769,0
1,1363,40748,3578753769,3578753769,0
1,1363,40749,3578753769,3578753769,0
1,1363,40750,3578753769,3578753769,0
1,1363,40751,3578753769,3578753769,0
1,1363,40752,3578753769,3578753769,0
1,1363,40753,3578753769,3578753769,0
1,1363,40754,3578753769,3578753769,0
1,1363,40755,3578753769,3578753769,0
1,1363,40756,3578753769,3578753769,0
1,1363,40757,3578753769,3578753771,2
1,1363,40758,3578753769,3578753771,2
1,1363,40759,3578753769,3578753773,4
1,1363,40760,3578753769,3578753774,5
1,1363,40761,3578753769,3578753775,6
1,1363,40762,3578753769,3578753776,7
1,1363,40763,3578753769,3578753777,8
1,1363,40764,3578753769,3578753777,8
1,1363,40765,3578753769,3578753778,9
1,1363,40766,3578753769,3578753778,9
1,1363,40767,3578753769,3578753779,10
1,1363,40768,3578753769,3578753780,11
1,1363,40769,3578753769,3578753781,12
1,1363,40770,3578753769,3578753781,12
1,1363,40771,3578753769,3578753781,12
1,1363,40772,3578753769,3578753781,12
1,1363,40773,3578753769,3578753782,13
1,1363,40774,3578753769,3578753784,15
1,1363,40775,3578753769,3578753784,15
1,1363,40776,3578753769,3578753786,17
1,1363,40777,3578753769,3578753787,18
1,1363,40778,3578753769,3578753788,19
1,1363,40779,3578753769,3578753788,19
1,1363,40780,3578753769,3578753790,21
1,1363,40781,3578753769,3578753791,22
1,1363,40782,3578753769,3578753792,23
1,1363,40783,3578753769,3578753793,24
1,1363,40784,3578753769,3578753795,26
1,1363,40785,3578753769,3578753796,27
1,1363,40786,3578753769,3578753796,27
1,1363,40787,3578753769,3578753796,27
1,1363,40788,3578753769,3578753797,28
1,1363,40789,3578753769,3578753797,28
1,1363,40790,3578753769,3578753797,28
1,1363,40791,3578753769,3578753797,28
1,1363,40792,3578753769,3578753798,29
1,1363,40793,3578753769,3578753798,29
1,1363,40794,3578753769,3578753799,30
1,1363,40795,3578753769,3578753800,31
1,1363,40796,3578753769,3578753803,34
1,1363,40797,3578753769,3578753806,37
1,1363,40798,3578753769,3578753807,38
1,1363,40799,3578753769,3578753810,41
1,1363,40800,3578753769,3578753811,42
1,1363,40801,3578753769,3578753812,43
1,1363,40802,3578753769,3578753812,43
1,1363,40803,3578753769,3578753813,44
1,1363,40804,3578753769,3578753816,47
1,1363,40805,3578753769,3578753816,47
1,1363,40806,3578753769,3578753816,47
1,1363,40807,3578753769,3578753818,49
1,1363,40808,3578753769,3578753819,50
1,1364,40809,3578753832,3578753832,0
1,1364,40810,3578753832,3578753832,0
1,1364,40811,3578753832,3578753832,0
1,1364,40812,3578753832,3578753832,0
1,1364,40813,3578753832,3578753832,0
1,1364,40814,3578753832,3578753832,0
1,1364,40815,3578753832,3578753832,0
1,1364,40816,3578753832,3578753832,0
1,1364,40817,3578753832,3578753832,0
1,1364,40818,3578753832,3578753832,0
1,1364,40819,3578753832,3578753832,0
1,1364,40820,3578753832,3578753832,0
1,1364,40821,3578753832,3578753832,0
1,1364,40822,3578753832,3578753832,0
1,1364,40823,3578753832,3578753832,0
1,1364,40824,3578753832,3578753832,0
1,1364,40825,3578753832,3578753833,1
1,1364,40826,3578753832,3578753834,2
1,1364,40827,3578753832,3578753834,2
1,1364,40828,3578753832,3578753834,2
1,1364,40829,3578753832,3578753836,4
1,1364,40830,3578753832,3578753839,7
1,1364,40831,3578753832,3578753839,7
1,1364,40832,3578753832,3578753840,8
1,1364,40833,3578753832,3578753841,9
1,1364,40834,3578753832,3578753845,13
1,1364,40835,3578753832,3578753847,15
1,1364,40836,3578753832,3578753848,16
1,1364,40837,3578753832,3578753849,17
1,1364,40838,3578753832,3578753849,17
1,1364,40839,3578753832,3578753850,18
1,1364,40840,3578753832,3578753850,18
1,1364,40841,3578753832,3578753851,19
1,1364,40842,3578753832,3578753852,20
1,1364,40843,3578753832,3578753853,21
1,1364,40844,3578753832,3578753855,23
1,1364,40845,3578753832,3578753855,23
1,1364,40846,3578753832,3578753857,25
1,1364,40847,3578753832,3578753859,27
1,1364,40848,3578753832,3578753861,29
1,1364,40849,3578753832,3578753862,30
1,1364,40850,3578753832,3578753862,30
1,1364,40851,3578753832,3578753863,31
1,1364,40852,3578753832,3578753864,32
1,1364,40853,3578753832,3578753865,33
1,1364,40854,3578753832,3578753867,35
1,1364,40855,3578753832,3578753868,36
1,1364,40856,3578753832,3578753869,37
1,1364,40857,3578753832,3578753876,44
1,1364,40858,3578753832,3578753880,48
1,1364,40859,3578753832,3578753882,50
1,1365,40860,3578753893,3578753893,0
1,1365,40861,3578753893,3578753893,0
1,1365,40862,3578753893,3578753893,0
1,1365,40863,3578753893,3578753893,0
1,1365,40864,3578753893,3578753893,0
1,1365,40865,3578753893,3578753893,0
1,1365,40866,3578753893,3578753893,0
1,1365,40867,3578753893,3578753893,0
1,1365,40868,3578753893,3578753894,1
1,1365,40869,3578753893,3578753894,1
1,1365,40870,3578753893,3578753894,1
1,1365,40871,3578753893,3578753894,1
1,1365,40872,3578753893,3578753894,1
1,1365,40873,3578753893,3578753894,1
1,1365,40874,3578753893,3578753895,2
1,1365,40875,3578753893,3578753896,3
1,1365,40876,3578753893,3578753901,8
1,1365,40877,3578753893,3578753902,9
1,1365,40878,3578753893,3578753903,10
1,1365,40879,3578753893,3578753903,10
1,1365,40880,3578753893,3578753903,10
1,1365,40881,3578753893,3578753903,10
1,1365,40882,3578753893,3578753904,11
1,1365,40883,3578753893,3578753906,13
1,1365,40884,3578753893,3578753907,14
1,1365,40885,3578753893,3578753907,14
1,1365,40886,3578753893,3578753908,15
1,1365,40887,3578753893,3578753908,15
1,1365,40888,3578753893,3578753909,16
1,1365,40889,3578753893,3578753909,16
1,1365,40890,3578753893,3578753910,17
1,1365,40891,3578753893,3578753910,17
1,1365,40892,3578753893,3578753911,18
1,1365,40893,3578753893,3578753911,18
1,1365,40894,3578753893,3578753912,19
1,1365,40895,3578753893,3578753912,19
1,1365,40896,3578753893,3578753913,20
1,1365,40897,3578753893,3578753914,21
1,1365,40898,3578753893,3578753914,21
1,1365,40899,3578753893,3578753914,21
1,1365,40900,3578753893,3578753916,23
1,1365,40901,3578753893,3578753916,23
1,1365,40902,3578753893,3578753917,24
1,1365,40903,3578753893,3578753918,25
1,1365,40904,3578753893,3578753919,26
1,1365,40905,3578753893,3578753920,27
1,1365,40906,3578753893,3578753922,29
1,1365,40907,3578753893,3578753923,30
1,1365,40908,3578753893,3578753923,30
1,1365,40909,3578753893,3578753923,30
1,1365,40910,3578753893,3578753923,30
1,1365,40911,3578753893,3578753924,31
1,1365,40912,3578753893,3578753924,31
1,1365,40913,3578753893,3578753925,32
1,1365,40914,3578753893,3578753926,33
1,1365,40915,3578753893,3578753928,35
1,1365,40916,3578753893,3578753929,36
1,1365,40917,3578753893,3578753930,37
1,1365,40918,3578753893,3578753931,38
1,1365,40919,3578753893,3578753932,39
1,1365,40920,3578753893,3578753932,39
1,1365,40921,3578753893,3578753932,39
1,1365,40922,3578753893,3578753932,39
1,1365,40923,3578753893,3578753933,40
1,1365,40924,3578753893,3578753933,40
1,1365,40925,3578753893,3578753934,41
1,1365,40926,3578753893,3578753934,41
1,1365,40927,3578753893,3578753935,42
1,1365,40928,3578753893,3578753935,42
1,1365,40929,3578753893,3578753938,45
1,1365,40930,3578753893,3578753939,46
1,1365,40931,3578753893,3578753939,46
1,1365,40932,3578753893,3578753940,47
1,1365,40933,3578753893,3578753942,49
1,1365,40934,3578753893,3578753942,49
1,1365,40935,3578753893,3578753942,49
1,1366,40936,3578754072,3578754072,0
1,1366,40937,3578754072,3578754072,0
1,1366,40938,3578754072,3578754072,0
1,1366,40939,3578754072,3578754072,0
1,1366,40940,3578754072,3578754072,0
1,1366,40941,3578754072,3578754072,0
1,1366,40942,3578754072,3578754072,0
1,1366,40943,3578754072,3578754072,0
1,1366,40944,3578754072,3578754072,0
1,1366,40945,3578754072,3578754072,0
1,1366,40946,3578754072,3578754072,0
1,1366,40947,3578754072,3578754072,0
1,1366,40948,3578754072,3578754072,0
1,1366,40949,3578754072,3578754072,0
1,1366,40950,3578754072,3578754072,0
1,1366,40951,3578754072,3578754072,0
1,1366,40952,3578754072,3578754072,0
1,1366,40953,3578754072,3578754072,0
1,1366,40954,3578754072,3578754072,0
1,1366,40955,3578754072,3578754072,0
1,1366,40956,3578754072,3578754072,0
1,1366,40957,3578754072,3578754072,0
1,1366,40958,3578754072,3578754072,0
1,1366,40959,3578754072,3578754072,0
1,1366,40960,3578754072,3578754072,0
1,1366,40961,3578754072,3578754072,0
1,1366,40962,3578754072,3578754072,0
1,1366,40963,3578754072,3578754072,0
1,1366,40964,3578754072,3578754072,0
1,1366,40965,3578754072,3578754072,0
1,1366,40966,3578754072,3578754072,0
1,1366,40967,3578754072,3578754072,0
1,1366,40968,3578754072,3578754072,0
1,1366,40969,3578754072,3578754072,0
1,1366,40970,3578754072,3578754072,0
1,1366,40971,3578754072,3578754072,0
1,1366,40972,3578754072,3578754072,0
1,1366,40973,3578754072,3578754072,0
1,1366,40974,3578754072,3578754072,0
1,1366,40975,3578754072,3578754072,0
1,1366,40976,3578754072,3578754072,0
1,1366,40977,3578754072,3578754072,0
1,1366,40978,3578754072,3578754072,0
1,1366,40979,3578754072,3578754072,0
1,1366,40980,3578754072,3578754072,0
1,1366,40981,3578754072,3578754072,0
1,1366,40982,3578754072,3578754073,1
1,1366,40983,3578754072,3578754073,1
1,1366,40984,3578754072,3578754073,1
1,1366,40985,3578754072,3578754073,1
1,1366,40986,3578754072,3578754073,1
1,1366,40987,3578754072,3578754073,1
1,1366,40988,3578754072,3578754073,1
1,1366,40989,3578754072,3578754073,1
1,1366,40990,3578754072,3578754073,1
1,1366,40991,3578754072,3578754073,1
1,1366,40992,3578754072,3578754073,1
1,1366,40993,3578754072,3578754073,1
1,1366,40994,3578754072,3578754073,1
1,1366,40995,3578754072,3578754073,1
1,1366,40996,3578754072,3578754114,42
1,1366,40997,3578754072,3578754114,42
1,1366,40998,3578754072,3578754114,42
1,1366,40999,3578754072,3578754114,42
1,1366,41000,3578754072,3578754114,42
1,1366,41001,3578754072,3578754114,42
1,1366,41002,3578754072,3578754114,42
1,1366,41003,3578754072,3578754114,42
1,1366,41004,3578754072,3578754114,42
1,1366,41005,3578754072,3578754114,42
1,1366,41006,3578754072,3578754114,42
1,1366,41007,3578754072,3578754114,42
1,1366,41008,3578754072,3578754114,42
1,1366,41009,3578754072,3578754114,42
1,1366,41010,3578754072,3578754114,42
1,1366,41011,3578754072,3578754114,42
1,1366,41012,3578754072,3578754114,42
1,1366,41013,3578754072,3578754114,42
1,1366,41014,3578754072,3578754114,42
1,1366,41015,3578754072,3578754114,42
1,1366,41016,3578754072,3578754114,42
1,1366,41017,3578754072,3578754114,42
1,1366,41018,3578754072,3578754114,42
1,1366,41019,3578754072,3578754114,42
1,1366,41020,3578754072,3578754114,42
1,1366,41021,3578754072,3578754114,42
1,1366,41022,3578754072,3578754114,42
1,1366,41023,3578754072,3578754114,42
1,1366,41024,3578754072,3578754114,42
1,1366,41025,3578754072,3578754114,42
1,1366,41026,3578754072,3578754114,42
1,1366,41027,3578754072,3578754114,42
1,1366,41028,3578754072,3578754114,42
1,1366,41029,3578754072,3578754114,42
1,1366,41030,3578754072,3578754114,42
1,1366,41031,3578754072,3578754114,42
1,1366,41032,3578754072,3578754114,42
1,1366,41033,3578754072,3578754114,42
1,1366,41034,3578754072,3578754114,42
1,1366,41035,3578754072,3578754114,42
1,1366,41036,3578754072,3578754114,42
1,1366,41037,3578754072,3578754114,42
1,1366,41038,3578754072,3578754114,42
1,1366,41039,3578754072,3578754114,42
1,1366,41040,3578754072,3578754114,42
1,1366,41041,3578754072,3578754114,42
1,1366,41042,3578754072,3578754114,42
1,1366,41043,3578754072,3578754114,42
1,1366,41044,3578754072,3578754114,42
1,1366,41045,3578754072,3578754114,42
1,1366,41046,3578754072,3578754114,42
1,1366,41047,3578754072,3578754114,42
1,1366,41048,3578754072,3578754114,42
1,1366,41049,3578754072,3578754114,42
1,1366,41050,3578754072,3578754114,42
1,1366,41051,3578754072,3578754114,42
1,1366,41052,3578754072,3578754114,42
1,1366,41053,3578754072,3578754114,42
1,1366,41054,3578754072,3578754114,42
1,1366,41055,3578754072,3578754114,42
1,1366,41056,3578754072,3578754114,42
1,1366,41057,3578754072,3578754114,42
1,1366,41058,3578754072,3578754114,42
1,1366,41059,3578754072,3578754114,42
1,1366,41060,3578754072,3578754114,42
1,1366,41061,3578754072,3578754114,42
1,1366,41062,3578754072,3578754114,42
1,1366,41063,3578754072,3578754114,42
1,1366,41064,3578754072,3578754114,42
1,1366,41065,3578754072,3578754114,42
1,1366,41066,3578754072,3578754114,42
1,1366,41067,3578754072,3578754114,42
1,1366,41068,3578754072,3578754114,42
1,1366,41069,3578754072,3578754114,42
1,1366,41070,3578754072,3578754114,42
1,1366,41071,3578754072,3578754114,42
1,1366,41072,3578754072,3578754114,42
1,1366,41073,3578754072,3578754114,42
1,1366,41074,3578754072,3578754114,42
1,1366,41075,3578754072,3578754114,42
1,1366,41076,3578754072,3578754114,42
1,1366,41077,3578754072,3578754114,42
1,1366,41078,3578754072,3578754114,42
1,1366,41079,3578754072,3578754114,42
1,1366,41080,3578754072,3578754114,42
1,1366,41081,3578754072,3578754114,42
1,1366,41082,3578754072,3578754114,42
1,1366,41083,3578754072,3578754114,42
1,1366,41084,3578754072,3578754114,42
1,1366,41085,3578754072,3578754114,42
1,1366,41086,3578754072,3578754114,42
1,1366,41087,3578754072,3578754114,42
1,1366,41088,3578754072,3578754114,42
1,1366,41089,3578754072,3578754114,42
1,1366,41090,3578754072,3578754114,42
1,1366,41091,3578754072,3578754114,42
1,1366,41092,3578754072,3578754114,42
1,1366,41093,3578754072,3578754114,42
1,1366,41094,3578754072,3578754114,42
1,1366,41095,3578754072,3578754114,42
1,1366,41096,3578754072,3578754114,42
1,1366,41097,3578754072,3578754114,42
1,1366,41098,3578754072,3578754114,42
1,1366,41099,3578754072,3578754114,42
1,1366,41100,3578754072,3578754115,43
1,1366,41101,3578754072,3578754117,45
1,1366,41102,3578754072,3578754117,45
1,1366,41103,3578754072,3578754118,46
1,1366,41104,3578754072,3578754119,47
1,1366,41105,3578754072,3578754120,48
1,1366,41106,3578754072,3578754120,48
1,1366,41107,3578754072,3578754122,50
1,1367,41108,3578754147,3578754147,0
1,1367,41109,3578754147,3578754147,0
1,1367,41110,3578754147,3578754147,0
1,1367,41111,3578754147,3578754147,0
1,1367,41112,3578754147,3578754147,0
1,1367,41113,3578754147,3578754147,0
1,1367,41114,3578754147,3578754147,0
1,1367,41115,3578754147,3578754147,0
1,1367,41116,3578754147,3578754147,0
1,1367,41117,3578754147,3578754147,0
1,1367,41118,3578754147,3578754147,0
1,1367,41119,3578754147,3578754147,0
1,1367,41120,3578754147,3578754147,0
1,1367,41121,3578754147,3578754147,0
1,1367,41122,3578754147,3578754147,0
1,1367,41123,3578754147,3578754147,0
1,1367,41124,3578754147,3578754147,0
1,1367,41125,3578754147,3578754147,0
1,1367,41126,3578754147,3578754147,0
1,1367,41127,3578754147,3578754147,0
1,1367,41128,3578754147,3578754147,0
1,1367,41129,3578754147,3578754147,0
1,1367,41130,3578754147,3578754147,0
1,1367,41131,3578754147,3578754147,0
1,1367,41132,3578754147,3578754147,0
1,1367,41133,3578754147,3578754147,0
1,1367,41134,3578754147,3578754147,0
1,1367,41135,3578754147,3578754147,0
1,1367,41136,3578754147,3578754147,0
1,1367,41137,3578754147,3578754147,0
1,1367,41138,3578754147,3578754147,0
1,1367,41139,3578754147,3578754149,2
1,1367,41140,3578754147,3578754149,2
1,1367,41141,3578754147,3578754150,3
1,1367,41142,3578754147,3578754151,4
1,1367,41143,3578754147,3578754154,7
1,1367,41144,3578754147,3578754155,8
1,1367,41145,3578754147,3578754158,11
1,1367,41146,3578754147,3578754159,12
1,1367,41147,3578754147,3578754160,13
1,1367,41148,3578754147,3578754162,15
1,1367,41149,3578754147,3578754162,15
1,1367,41150,3578754147,3578754162,15
1,1367,41151,3578754147,3578754163,16
1,1367,41152,3578754147,3578754163,16
1,1367,41153,3578754147,3578754164,17
1,1367,41154,3578754147,3578754165,18
1,1367,41155,3578754147,3578754166,19
1,1367,41156,3578754147,3578754166,19
1,1367,41157,3578754147,3578754168,21
1,1367,41158,3578754147,3578754168,21
1,1367,41159,3578754147,3578754168,21
1,1367,41160,3578754147,3578754169,22
1,1367,41161,3578754147,3578754170,23
1,1367,41162,3578754147,3578754171,24
1,1367,41163,3578754147,3578754173,26
1,1367,41164,3578754147,3578754175,28
1,1367,41165,3578754147,3578754177,30
1,1367,41166,3578754147,3578754177,30
1,1367,41167,3578754147,3578754178,31
1,1367,41168,3578754147,3578754178,31
1,1367,41169,3578754147,3578754179,32
1,1367,41170,3578754147,3578754179,32
1,1367,41171,3578754147,3578754180,33
1,1367,41172,3578754147,3578754181,34
1,1367,41173,3578754147,3578754181,34
1,1367,41174,3578754147,3578754182,35
1,1367,41175,3578754147,3578754183,36
1,1367,41176,3578754147,3578754184,37
1,1367,41177,3578754147,3578754185,38
1,1367,41178,3578754147,3578754186,39
1,1367,41179,3578754147,3578754186,39
1,1367,41180,3578754147,3578754187,40
1,1367,41181,3578754147,3578754188,41
1,1367,41182,3578754147,3578754191,44
1,1367,41183,3578754147,3578754191,44
1,1367,41184,3578754147,3578754192,45
1,1367,41185,3578754147,3578754194,47
1,1367,41186,3578754147,3578754195,48
1,1367,41187,3578754147,3578754196,49
1,1367,41188,3578754147,3578754197,50
1,1368,41189,3578754210,3578754210,0
1,1368,41190,3578754210,3578754210,0
1,1368,41191,3578754210,3578754210,0
1,1368,41192,3578754210,3578754210,0
1,1368,41193,3578754210,3578754210,0
1,1368,41194,3578754210,3578754210,0
1,1368,41195,3578754210,3578754210,0
1,1368,41196,3578754210,3578754210,0
1,1368,41197,3578754210,3578754210,0
1,1368,41198,3578754210,3578754210,0
1,1368,41199,3578754210,3578754210,0
1,1368,41200,3578754210,3578754212,2
1,1368,41201,3578754210,3578754213,3
1,1368,41202,3578754210,3578754213,3
1,1368,41203,3578754210,3578754213,3
1,1368,41204,3578754210,3578754214,4
1,1368,41205,3578754210,3578754215,5
1,1368,41206,3578754210,3578754216,6
1,1368,41207,3578754210,3578754216,6
1,1368,41208,3578754210,3578754217,7
1,1368,41209,3578754210,3578754218,8
1,1368,41210,3578754210,3578754219,9
1,1368,41211,3578754210,3578754219,9
1,1368,41212,3578754210,3578754220,10
1,1368,41213,3578754210,3578754221,11
1,1368,41214,3578754210,3578754222,12
1,1368,41215,3578754210,3578754222,12
1,1368,41216,3578754210,3578754222,12
1,1368,41217,3578754210,3578754223,13
1,1368,41218,3578754210,3578754224,14
1,1368,41219,3578754210,3578754226,16
1,1368,41220,3578754210,3578754228,18
1,1368,41221,3578754210,3578754228,18
1,1368,41222,3578754210,3578754230,20
1,1368,41223,3578754210,3578754230,20
1,1368,41224,3578754210,3578754230,20
1,1368,41225,3578754210,3578754231,21
1,1368,41226,3578754210,3578754233,23
1,1368,41227,3578754210,3578754234,24
1,1368,41228,3578754210,3578754235,25
1,1368,41229,3578754210,3578754235,25
1,1368,41230,3578754210,3578754237,27
1,1368,41231,3578754210,3578754238,28
1,1368,41232,3578754210,3578754239,29
1,1368,41233,3578754210,3578754241,31
1,1368,41234,3578754210,3578754242,32
1,1368,41235,3578754210,3578754243,33
1,1368,41236,3578754210,3578754245,35
1,1368,41237,3578754210,3578754248,38
1,1368,41238,3578754210,3578754248,38
1,1368,41239,3578754210,3578754249,39
1,1368,41240,3578754210,3578754250,40
1,1368,41241,3578754210,3578754250,40
1,1368,41242,3578754210,3578754251,41
1,1368,41243,3578754210,3578754252,42
1,1368,41244,3578754210,3578754253,43
1,1368,41245,3578754210,3578754254,44
1,1368,41246,3578754210,3578754255,45
1,1368,41247,3578754210,3578754256,46
1,1368,41248,3578754210,3578754257,47
1,1368,41249,3578754210,3578754259,49
1,1369,41250,3578754274,3578754274,0
1,1369,41251,3578754274,3578754274,0
1,1369,41252,3578754274,3578754274,0
1,1369,41253,3578754274,3578754274,0
1,1369,41254,3578754274,3578754274,0
1,1369,41255,3578754274,3578754274,0
1,1369,41256,3578754274,3578754274,0
1,1369,41257,3578754274,3578754274,0
1,1369,41258,3578754274,3578754274,0
1,1369,41259,3578754274,3578754277,3
1,1369,41260,3578754274,3578754281,7
1,1369,41261,3578754274,3578754281,7
1,1369,41262,3578754274,3578754283,9
1,1369,41263,3578754274,3578754284,10
1,1369,41264,3578754274,3578754285,11
1,1369,41265,3578754274,3578754285,11
1,1369,41266,3578754274,3578754287,13
1,1369,41267,3578754274,3578754288,14
1,1369,41268,3578754274,3578754288,14
1,1369,41269,3578754274,3578754289,15
1,1369,41270,3578754274,3578754291,17
1,1369,41271,3578754274,3578754291,17
1,1369,41272,3578754274,3578754292,18
1,1369,41273,3578754274,3578754293,19
1,1369,41274,3578754274,3578754293,19
1,1369,41275,3578754274,3578754294,20
1,1369,41276,3578754274,3578754294,20
1,1369,41277,3578754274,3578754295,21
1,1369,41278,3578754274,3578754295,21
1,1369,41279,3578754274,3578754295,21
1,1369,41280,3578754274,3578754296,22
1,1369,41281,3578754274,3578754297,23
1,1369,41282,3578754274,3578754300,26
1,1369,41283,3578754274,3578754302,28
1,1369,41284,3578754274,3578754303,29
1,1369,41285,3578754274,3578754303,29
1,1369,41286,3578754274,3578754303,29
1,1369,41287,3578754274,3578754303,29
1,1369,41288,3578754274,3578754305,31
1,1369,41289,3578754274,3578754305,31
1,1369,41290,3578754274,3578754306,32
1,1369,41291,3578754274,3578754306,32
1,1369,41292,3578754274,3578754307,33
1,1369,41293,3578754274,3578754308,34
1,1369,41294,3578754274,3578754308,34
1,1369,41295,3578754274,3578754309,35
1,1369,41296,3578754274,3578754309,35
1,1369,41297,3578754274,3578754310,36
1,1369,41298,3578754274,3578754310,36
1,1369,41299,3578754274,3578754311,37
1,1369,41300,3578754274,3578754311,37
1,1369,41301,3578754274,3578754311,37
1,1369,41302,3578754274,3578754312,38
1,1369,41303,3578754274,3578754312,38
1,1369,41304,3578754274,3578754313,39
1,1369,41305,3578754274,3578754313,39
1,1369,41306,3578754274,3578754314,40
1,1369,41307,3578754274,3578754314,40
1,1369,41308,3578754274,3578754314,40
1,1369,41309,3578754274,3578754316,42
1,1369,41310,3578754274,3578754317,43
1,1369,41311,3578754274,3578754318,44
1,1369,41312,3578754274,3578754320,46
1,1369,41313,3578754274,3578754320,46
1,1369,41314,3578754274,3578754321,47
1,1369,41315,3578754274,3578754322,48
1,1369,41316,3578754274,3578754323,49
1,1369,41317,3578754274,3578754323,49
1,1369,41318,3578754274,3578754323,49
1,1369,41319,3578754274,3578754324,50
1,1370,41320,3578754338,3578754338,0
1,1370,41321,3578754338,3578754338,0
1,1370,41322,3578754338,3578754338,0
1,1370,41323,3578754338,3578754338,0
1,1370,41324,3578754338,3578754338,0
1,1370,41325,3578754338,3578754338,0
1,1370,41326,3578754338,3578754338,0
1,1370,41327,3578754338,3578754338,0
1,1370,41328,3578754338,3578754338,0
1,1370,41329,3578754338,3578754338,0
1,1370,41330,3578754338,3578754338,0
1,1370,41331,3578754338,3578754338,0
1,1370,41332,3578754338,3578754338,0
1,1370,41333,3578754338,3578754338,0
1,1370,41334,3578754338,3578754338,0
1,1370,41335,3578754338,3578754338,0
1,1370,41336,3578754338,3578754338,0
1,1370,41337,3578754338,3578754338,0
1,1370,41338,3578754338,3578754338,0
1,1370,41339,3578754338,3578754338,0
1,1370,41340,3578754338,3578754338,0
1,1370,41341,3578754338,3578754338,0
1,1370,41342,3578754338,3578754338,0
1,1370,41343,3578754338,3578754338,0
1,1370,41344,3578754338,3578754341,3
1,1370,41345,3578754338,3578754341,3
1,1370,41346,3578754338,3578754342,4
1,1370,41347,3578754338,3578754343,5
1,1370,41348,3578754338,3578754343,5
1,1370,41349,3578754338,3578754347,9
1,1370,41350,3578754338,3578754347,9
1,1370,41351,3578754338,3578754349,11
1,1370,41352,3578754338,3578754350,12
1,1370,41353,3578754338,3578754351,13
1,1370,41354,3578754338,3578754354,16
1,1370,41355,3578754338,3578754356,18
1,1370,41356,3578754338,3578754358,20
1,1370,41357,3578754338,3578754360,22
1,1370,41358,3578754338,3578754360,22
1,1370,41359,3578754338,3578754362,24
1,1370,41360,3578754338,3578754363,25
1,1370,41361,3578754338,3578754363,25
1,1370,41362,3578754338,3578754363,25
1,1370,41363,3578754338,3578754364,26
1,1370,41364,3578754338,3578754364,26
1,1370,41365,3578754338,3578754365,27
1,1370,41366,3578754338,3578754366,28
1,1370,41367,3578754338,3578754366,28
1,1370,41368,3578754338,3578754368,30
1,1370,41369,3578754338,3578754368,30
1,1370,41370,3578754338,3578754369,31
1,1370,41371,3578754338,3578754370,32
1,1370,41372,3578754338,3578754371,33
1,1370,41373,3578754338,3578754371,33
1,1370,41374,3578754338,3578754373,35
1,1370,41375,3578754338,3578754375,37
1,1370,41376,3578754338,3578754378,40
1,1370,41377,3578754338,3578754378,40
1,1370,41378,3578754338,3578754378,40
1,1370,41379,3578754338,3578754378,40
1,1370,41380,3578754338,3578754379,41
1,1370,41381,3578754338,3578754380,42
1,1370,41382,3578754338,3578754380,42
1,1370,41383,3578754338,3578754380,42
1,1370,41384,3578754338,3578754380,42
1,1370,41385,3578754338,3578754381,43
1,1370,41386,3578754338,3578754382,44
1,1370,41387,3578754338,3578754382,44
1,1370,41388,3578754338,3578754384,46
1,1370,41389,3578754338,3578754384,46
1,1370,41390,3578754338,3578754385,47
1,1370,41391,3578754338,3578754386,48
1,1370,41392,3578754338,3578754387,49
1,1370,41393,3578754338,3578754387,49
1,1371,41394,3578754401,3578754401,0
1,1371,41395,3578754401,3578754401,0
1,1371,41396,3578754401,3578754401,0
1,1371,41397,3578754401,3578754401,0
1,1371,41398,3578754401,3578754401,0
1,1371,41399,3578754401,3578754401,0
1,1371,41400,3578754401,3578754401,0
1,1371,41401,3578754401,3578754401,0
1,1371,41402,3578754401,3578754401,0
1,1371,41403,3578754401,3578754401,0
1,1371,41404,3578754401,3578754401,0
1,1371,41405,3578754401,3578754401,0
1,1371,41406,3578754401,3578754401,0
1,1371,41407,3578754401,3578754401,0
1,1371,41408,3578754401,3578754402,1
1,1371,41409,3578754401,3578754403,2
1,1371,41410,3578754401,3578754406,5
1,1371,41411,3578754401,3578754407,6
1,1371,41412,3578754401,3578754409,8
1,1371,41413,3578754401,3578754412,11
1,1371,41414,3578754401,3578754413,12
1,1371,41415,3578754401,3578754413,12
1,1371,41416,3578754401,3578754413,12
1,1371,41417,3578754401,3578754415,14
1,1371,41418,3578754401,3578754416,15
1,1371,41419,3578754401,3578754417,16
1,1371,41420,3578754401,3578754419,18
1,1371,41421,3578754401,3578754420,19
1,1371,41422,3578754401,3578754420,19
1,1371,41423,3578754401,3578754421,20
1,1371,41424,3578754401,3578754421,20
1,1371,41425,3578754401,3578754422,21
1,1371,41426,3578754401,3578754422,21
1,1371,41427,3578754401,3578754423,22
1,1371,41428,3578754401,3578754423,22
1,1371,41429,3578754401,3578754424,23
1,1371,41430,3578754401,3578754425,24
1,1371,41431,3578754401,3578754427,26
1,1371,41432,3578754401,3578754428,27
1,1371,41433,3578754401,3578754430,29
1,1371,41434,3578754401,3578754430,29
1,1371,41435,3578754401,3578754431,30
1,1371,41436,3578754401,3578754431,30
1,1371,41437,3578754401,3578754433,32
1,1371,41438,3578754401,3578754434,33
1,1371,41439,3578754401,3578754435,34
1,1371,41440,3578754401,3578754435,34
1,1371,41441,3578754401,3578754437,36
1,1371,41442,3578754401,3578754439,38
1,1371,41443,3578754401,3578754440,39
1,1371,41444,3578754401,3578754442,41
1,1371,41445,3578754401,3578754442,41
1,1371,41446,3578754401,3578754443,42
1,1371,41447,3578754401,3578754445,44
1,1371,41448,3578754401,3578754448,47
1,1371,41449,3578754401,3578754449,48
1,1371,41450,3578754401,3578754449,48
1,1371,41451,3578754401,3578754451,50
1,1372,41452,3578754464,3578754464,0
1,1372,41453,3578754464,3578754464,0
1,1372,41454,3578754464,3578754464,0
1,1372,41455,3578754464,3578754464,0
1,1372,41456,3578754464,3578754464,0
1,1372,41457,3578754464,3578754464,0
1,1372,41458,3578754464,3578754464,0
1,1372,41459,3578754464,3578754464,0
1,1372,41460,3578754464,3578754464,0
1,1372,41461,3578754464,3578754464,0
1,1372,41462,3578754464,3578754464,0
1,1372,41463,3578754464,3578754464,0
1,1372,41464,3578754464,3578754464,0
1,1372,41465,3578754464,3578754465,1
1,1372,41466,3578754464,3578754465,1
1,1372,41467,3578754464,3578754468,4
1,1372,41468,3578754464,3578754468,4
1,1372,41469,3578754464,3578754469,5
1,1372,41470,3578754464,3578754470,6
1,1372,41471,3578754464,3578754476,12
1,1372,41472,3578754464,3578754480,16
1,1372,41473,3578754464,3578754481,17
1,1372,41474,3578754464,3578754483,19
1,1372,41475,3578754464,3578754484,20
1,1372,41476,3578754464,3578754484,20
1,1372,41477,3578754464,3578754486,22
1,1372,41478,3578754464,3578754487,23
1,1372,41479,3578754464,3578754488,24
1,1372,41480,3578754464,3578754489,25
1,1372,41481,3578754464,3578754489,25
1,1372,41482,3578754464,3578754491,27
1,1372,41483,3578754464,3578754491,27
1,1372,41484,3578754464,3578754493,29
1,1372,41485,3578754464,3578754493,29
1,1372,41486,3578754464,3578754493,29
1,1372,41487,3578754464,3578754493,29
1,1372,41488,3578754464,3578754494,30
1,1372,41489,3578754464,3578754494,30
1,1372,41490,3578754464,3578754494,30
1,1372,41491,3578754464,3578754495,31
1,1372,41492,3578754464,3578754495,31
1,1372,41493,3578754464,3578754496,32
1,1372,41494,3578754464,3578754497,33
1,1372,41495,3578754464,3578754501,37
1,1372,41496,3578754464,3578754502,38
1,1372,41497,3578754464,3578754502,38
1,1372,41498,3578754464,3578754503,39
1,1372,41499,3578754464,3578754503,39
1,1372,41500,3578754464,3578754503,39
1,1372,41501,3578754464,3578754504,40
1,1372,41502,3578754464,3578754505,41
1,1372,41503,3578754464,3578754505,41
1,1372,41504,3578754464,3578754506,42
1,1372,41505,3578754464,3578754507,43
1,1372,41506,3578754464,3578754509,45
1,1372,41507,3578754464,3578754509,45
1,1372,41508,3578754464,3578754509,45
1,1372,41509,3578754464,3578754510,46
1,1372,41510,3578754464,3578754511,47
1,1372,41511,3578754464,3578754511,47
1,1372,41512,3578754464,3578754511,47
1,1372,41513,3578754464,3578754512,48
1,1372,41514,3578754464,3578754512,48
1,1372,41515,3578754464,3578754512,48
1,1372,41516,3578754464,3578754512,48
1,1372,41517,3578754464,3578754513,49
1,1372,41518,3578754464,3578754513,49
1,1372,41519,3578754464,3578754514,50
1,1373,41520,3578754528,3578754528,0
1,1373,41521,3578754528,3578754528,0
1,1373,41522,3578754528,3578754528,0
1,1373,41523,3578754528,3578754528,0
1,1373,41524,3578754528,3578754528,0
1,1373,41525,3578754528,3578754528,0
1,1373,41526,3578754528,3578754528,0
1,1373,41527,3578754528,3578754528,0
1,1373,41528,3578754528,3578754528,0
1,1373,41529,3578754528,3578754528,0
1,1373,41530,3578754528,3578754528,0
1,1373,41531,3578754528,3578754528,0
1,1373,41532,3578754528,3578754528,0
1,1373,41533,3578754528,3578754528,0
1,1373,41534,3578754528,3578754528,0
1,1373,41535,3578754528,3578754528,0
1,1373,41536,3578754528,3578754528,0
1,1373,41537,3578754528,3578754528,0
1,1373,41538,3578754528,3578754528,0
1,1373,41539,3578754528,3578754528,0
1,1373,41540,3578754528,3578754528,0
1,1373,41541,3578754528,3578754529,1
1,1373,41542,3578754528,3578754530,2
1,1373,41543,3578754528,3578754531,3
1,1373,41544,3578754528,3578754531,3
1,1373,41545,3578754528,3578754531,3
1,1373,41546,3578754528,3578754531,3
1,1373,41547,3578754528,3578754532,4
1,1373,41548,3578754528,3578754533,5
1,1373,41549,3578754528,3578754533,5
1,1373,41550,3578754528,3578754533,5
1,1373,41551,3578754528,3578754534,6
1,1373,41552,3578754528,3578754536,8
1,1373,41553,3578754528,3578754537,9
1,1373,41554,3578754528,3578754538,10
1,1373,41555,3578754528,3578754538,10
1,1373,41556,3578754528,3578754541,13
1,1373,41557,3578754528,3578754541,13
1,1373,41558,3578754528,3578754542,14
1,1373,41559,3578754528,3578754542,14
1,1373,41560,3578754528,3578754546,18
1,1373,41561,3578754528,3578754546,18
1,1373,41562,3578754528,3578754550,22
1,1373,41563,3578754528,3578754551,23
1,1373,41564,3578754528,3578754554,26
1,1373,41565,3578754528,3578754557,29
1,1373,41566,3578754528,3578754558,30
1,1373,41567,3578754528,3578754559,31
1,1373,41568,3578754528,3578754561,33
1,1373,41569,3578754528,3578754562,34
1,1373,41570,3578754528,3578754562,34
1,1373,41571,3578754528,3578754562,34
1,1373,41572,3578754528,3578754563,35
1,1373,41573,3578754528,3578754563,35
1,1373,41574,3578754528,3578754564,36
1,1373,41575,3578754528,3578754565,37
1,1373,41576,3578754528,3578754566,38
1,1373,41577,3578754528,3578754567,39
1,1373,41578,3578754528,3578754567,39
1,1373,41579,3578754528,3578754569,41
1,1373,41580,3578754528,3578754571,43
1,1373,41581,3578754528,3578754571,43
1,1373,41582,3578754528,3578754572,44
1,1373,41583,3578754528,3578754575,47
1,1373,41584,3578754528,3578754576,48
1,1373,41585,3578754528,3578754577,49
1,1373,41586,3578754528,3578754578,50
1,1374,41587,3578754592,3578754592,0
1,1374,41588,3578754592,3578754592,0
1,1374,41589,3578754592,3578754592,0
1,1374,41590,3578754592,3578754592,0
1,1374,41591,3578754592,3578754592,0
1,1374,41592,3578754592,3578754592,0
1,1374,41593,3578754592,3578754592,0
1,1374,41594,3578754592,3578754592,0
1,1374,41595,3578754592,3578754592,0
1,1374,41596,3578754592,3578754592,0
1,1374,41597,3578754592,3578754592,0
1,1374,41598,3578754592,3578754592,0
1,1374,41599,3578754592,3578754592,0
1,1374,41600,3578754592,3578754592,0
1,1374,41601,3578754592,3578754592,0
1,1374,41602,3578754592,3578754592,0
1,1374,41603,3578754592,3578754593,1
1,1374,41604,3578754592,3578754595,3
1,1374,41605,3578754592,3578754595,3
1,1374,41606,3578754592,3578754596,4
1,1374,41607,3578754592,3578754596,4
1,1374,41608,3578754592,3578754597,5
1,1374,41609,3578754592,3578754598,6
1,1374,41610,3578754592,3578754598,6
1,1374,41611,3578754592,3578754598,6
1,1374,41612,3578754592,3578754599,7
1,1374,41613,3578754592,3578754599,7
1,1374,41614,3578754592,3578754600,8
1,1374,41615,3578754592,3578754602,10
1,1374,41616,3578754592,3578754603,11
1,1374,41617,3578754592,3578754605,13
1,1374,41618,3578754592,3578754607,15
1,1374,41619,3578754592,3578754608,16
1,1374,41620,3578754592,3578754611,19
1,1374,41621,3578754592,3578754612,20
1,1374,41622,3578754592,3578754612,20
1,1374,41623,3578754592,3578754613,21
1,1374,41624,3578754592,3578754614,22
1,1374,41625,3578754592,3578754615,23
1,1374,41626,3578754592,3578754616,24
1,1374,41627,3578754592,3578754616,24
1,1374,41628,3578754592,3578754616,24
1,1374,41629,3578754592,3578754619,27
1,1374,41630,3578754592,3578754619,27
1,1374,41631,3578754592,3578754619,27
1,1374,41632,3578754592,3578754620,28
1,1374,41633,3578754592,3578754621,29
1,1374,41634,3578754592,3578754621,29
1,1374,41635,3578754592,3578754621,29
1,1374,41636,3578754592,3578754621,29
1,1374,41637,3578754592,3578754622,30
1,1374,41638,3578754592,3578754622,30
1,1374,41639,3578754592,3578754624,32
1,1374,41640,3578754592,3578754625,33
1,1374,41641,3578754592,3578754628,36
1,1374,41642,3578754592,3578754629,37
1,1374,41643,3578754592,3578754629,37
1,1374,41644,3578754592,3578754630,38
1,1374,41645,3578754592,3578754630,38
1,1374,41646,3578754592,3578754631,39
1,1374,41647,3578754592,3578754632,40
1,1374,41648,3578754592,3578754633,41
1,1374,41649,3578754592,3578754634,42
1,1374,41650,3578754592,3578754635,43
1,1374,41651,3578754592,3578754636,44
1,1374,41652,3578754592,3578754637,45
1,1374,41653,3578754592,3578754638,46
1,1374,41654,3578754592,3578754639,47
1,1374,41655,3578754592,3578754640,48
1,1374,41656,3578754592,3578754641,49
1,1374,41657,3578754592,3578754642,50
1,1375,41658,3578754655,3578754655,0
1,1375,41659,3578754655,3578754655,0
1,1375,41660,3578754655,3578754655,0
1,1375,41661,3578754655,3578754655,0
1,1375,41662,3578754655,3578754655,0
1,1375,41663,3578754655,3578754655,0
1,1375,41664,3578754655,3578754655,0
1,1375,41665,3578754655,3578754655,0
1,1375,41666,3578754655,3578754655,0
1,1375,41667,3578754655,3578754655,0
1,1375,41668,3578754655,3578754655,0
1,1375,41669,3578754655,3578754657,2
1,1375,41670,3578754655,3578754659,4
1,1375,41671,3578754655,3578754661,6
1,1375,41672,3578754655,3578754661,6
1,1375,41673,3578754655,3578754662,7
1,1375,41674,3578754655,3578754662,7
1,1375,41675,3578754655,3578754663,8
1,1375,41676,3578754655,3578754663,8
1,1375,41677,3578754655,3578754664,9
1,1375,41678,3578754655,3578754667,12
1,1375,41679,3578754655,3578754667,12
1,1375,41680,3578754655,3578754668,13
1,1375,41681,3578754655,3578754677,22
1,1375,41682,3578754655,3578754680,25
1,1375,41683,3578754655,3578754681,26
1,1375,41684,3578754655,3578754683,28
1,1375,41685,3578754655,3578754684,29
1,1375,41686,3578754655,3578754684,29
1,1375,41687,3578754655,3578754686,31
1,1375,41688,3578754655,3578754688,33
1,1375,41689,3578754655,3578754688,33
1,1375,41690,3578754655,3578754689,34
1,1375,41691,3578754655,3578754691,36
1,1375,41692,3578754655,3578754691,36
1,1375,41693,3578754655,3578754692,37
1,1375,41694,3578754655,3578754692,37
1,1375,41695,3578754655,3578754693,38
1,1375,41696,3578754655,3578754693,38
1,1375,41697,3578754655,3578754694,39
1,1375,41698,3578754655,3578754695,40
1,1375,41699,3578754655,3578754695,40
1,1375,41700,3578754655,3578754695,40
1,1375,41701,3578754655,3578754696,41
1,1375,41702,3578754655,3578754696,41
1,1375,41703,3578754655,3578754698,43
1,1375,41704,3578754655,3578754700,45
1,1375,41705,3578754655,3578754702,47
1,1375,41706,3578754655,3578754702,47
1,1375,41707,3578754655,3578754703,48
1,1375,41708,3578754655,3578754703,48
1,1375,41709,3578754655,3578754703,48
1,1375,41710,3578754655,3578754704,49
1,1376,41711,3578754717,3578754717,0
1,1376,41712,3578754717,3578754717,0
1,1376,41713,3578754717,3578754717,0
1,1376,41714,3578754717,3578754717,0
1,1376,41715,3578754717,3578754717,0
1,1376,41716,3578754717,3578754717,0
1,1376,41717,3578754717,3578754717,0
1,1376,41718,3578754717,3578754717,0
1,1376,41719,3578754717,3578754717,0
1,1376,41720,3578754717,3578754717,0
1,1376,41721,3578754717,3578754717,0
1,1376,41722,3578754717,3578754717,0
1,1376,41723,3578754717,3578754717,0
1,1376,41724,3578754717,3578754717,0
1,1376,41725,3578754717,3578754717,0
1,1376,41726,3578754717,3578754717,0
1,1376,41727,3578754717,3578754717,0
1,1376,41728,3578754717,3578754717,0
1,1376,41729,3578754717,3578754717,0
1,1376,41730,3578754717,3578754717,0
1,1376,41731,3578754717,3578754717,0
1,1376,41732,3578754717,3578754718,1
1,1376,41733,3578754717,3578754719,2
1,1376,41734,3578754717,3578754720,3
1,1376,41735,3578754717,3578754720,3
1,1376,41736,3578754717,3578754722,5
1,1376,41737,3578754717,3578754722,5
1,1376,41738,3578754717,3578754723,6
1,1376,41739,3578754717,3578754723,6
1,1376,41740,3578754717,3578754724,7
1,1376,41741,3578754717,3578754724,7
1,1376,41742,3578754717,3578754724,7
1,1376,41743,3578754717,3578754726,9
1,1376,41744,3578754717,3578754726,9
1,1376,41745,3578754717,3578754727,10
1,1376,41746,3578754717,3578754727,10
1,1376,41747,3578754717,3578754728,11
1,1376,41748,3578754717,3578754729,12
1,1376,41749,3578754717,3578754730,13
1,1376,41750,3578754717,3578754730,13
1,1376,41751,3578754717,3578754731,14
1,1376,41752,3578754717,3578754731,14
1,1376,41753,3578754717,3578754731,14
1,1376,41754,3578754717,3578754732,15
1,1376,41755,3578754717,3578754733,16
1,1376,41756,3578754717,3578754734,17
1,1376,41757,3578754717,3578754734,17
1,1376,41758,3578754717,3578754734,17
1,1376,41759,3578754717,3578754735,18
1,1376,41760,3578754717,3578754735,18
1,1376,41761,3578754717,3578754736,19
1,1376,41762,3578754717,3578754738,21
1,1376,41763,3578754717,3578754738,21
1,1376,41764,3578754717,3578754738,21
1,1376,41765,3578754717,3578754738,21
1,1376,41766,3578754717,3578754740,23
1,1376,41767,3578754717,3578754741,24
1,1376,41768,3578754717,3578754741,24
1,1376,41769,3578754717,3578754742,25
1,1376,41770,3578754717,3578754742,25
1,1376,41771,3578754717,3578754746,29
1,1376,41772,3578754717,3578754746,29
1,1376,41773,3578754717,3578754748,31
1,1376,41774,3578754717,3578754750,33
1,1376,41775,3578754717,3578754751,34
1,1376,41776,3578754717,3578754754,37
1,1376,41777,3578754717,3578754755,38
1,1376,41778,3578754717,3578754757,40
1,1376,41779,3578754717,3578754758,41
1,1376,41780,3578754717,3578754759,42
1,1376,41781,3578754717,3578754759,42
1,1376,41782,3578754717,3578754762,45
1,1376,41783,3578754717,3578754762,45
1,1376,41784,3578754717,3578754762,45
1,1376,41785,3578754717,3578754762,45
1,1376,41786,3578754717,3578754763,46
1,1376,41787,3578754717,3578754764,47
1,1376,41788,3578754717,3578754764,47
1,1376,41789,3578754717,3578754764,47
1,1376,41790,3578754717,3578754765,48
1,1376,41791,3578754717,3578754765,48
1,1376,41792,3578754717,3578754767,50
1,1377,41793,3578754780,3578754780,0
1,1377,41794,3578754780,3578754780,0
1,1377,41795,3578754780,3578754780,0
1,1377,41796,3578754780,3578754780,0
1,1377,41797,3578754780,3578754780,0
1,1377,41798,3578754780,3578754780,0
1,1377,41799,3578754780,3578754780,0
1,1377,41800,3578754780,3578754780,0
1,1377,41801,3578754780,3578754780,0
1,1377,41802,3578754780,3578754780,0
1,1377,41803,3578754780,3578754780,0
1,1377,41804,3578754780,3578754780,0
1,1377,41805,3578754780,3578754780,0
1,1377,41806,3578754780,3578754780,0
1,1377,41807,3578754780,3578754781,1
1,1377,41808,3578754780,3578754782,2
1,1377,41809,3578754780,3578754783,3
1,1377,41810,3578754780,3578754784,4
1,1377,41811,3578754780,3578754784,4
1,1377,41812,3578754780,3578754785,5
1,1377,41813,3578754780,3578754786,6
1,1377,41814,3578754780,3578754787,7
1,1377,41815,3578754780,3578754789,9
1,1377,41816,3578754780,3578754792,12
1,1377,41817,3578754780,3578754792,12
1,1377,41818,3578754780,3578754793,13
1,1377,41819,3578754780,3578754795,15
1,1377,41820,3578754780,3578754796,16
1,1377,41821,3578754780,3578754796,16
1,1377,41822,3578754780,3578754796,16
1,1377,41823,3578754780,3578754797,17
1,1377,41824,3578754780,3578754797,17
1,1377,41825,3578754780,3578754798,18
1,1377,41826,3578754780,3578754798,18
1,1377,41827,3578754780,3578754798,18
1,1377,41828,3578754780,3578754799,19
1,1377,41829,3578754780,3578754800,20
1,1377,41830,3578754780,3578754800,20
1,1377,41831,3578754780,3578754801,21
1,1377,41832,3578754780,3578754803,23
1,1377,41833,3578754780,3578754806,26
1,1377,41834,3578754780,3578754806,26
1,1377,41835,3578754780,3578754809,29
1,1377,41836,3578754780,3578754811,31
1,1377,41837,3578754780,3578754812,32
1,1377,41838,3578754780,3578754812,32
1,1377,41839,3578754780,3578754812,32
1,1377,41840,3578754780,3578754815,35
1,1377,41841,3578754780,3578754815,35
1,1377,41842,3578754780,3578754816,36
1,1377,41843,3578754780,3578754816,36
1,1377,41844,3578754780,3578754817,37
1,1377,41845,3578754780,3578754818,38
1,1377,41846,3578754780,3578754819,39
1,1377,41847,3578754780,3578754819,39
1,1377,41848,3578754780,3578754819,39
1,1377,41849,3578754780,3578754820,40
1,1377,41850,3578754780,3578754821,41
1,1377,41851,3578754780,3578754822,42
1,1377,41852,3578754780,3578754822,42
1,1377,41853,3578754780,3578754822,42
1,1377,41854,3578754780,3578754823,43
1,1377,41855,3578754780,3578754824,44
1,1377,41856,3578754780,3578754827,47
1,1377,41857,3578754780,3578754828,48
1,1377,41858,3578754780,3578754829,49
1,1378,41859,3578754842,3578754842,0
1,1378,41860,3578754842,3578754843,1
1,1378,41861,3578754842,3578754843,1
1,1378,41862,3578754842,3578754843,1
1,1378,41863,3578754842,3578754843,1
1,1378,41864,3578754842,3578754843,1
1,1378,41865,3578754842,3578754843,1
1,1378,41866,3578754842,3578754843,1
1,1378,41867,3578754842,3578754843,1
1,1378,41868,3578754842,3578754843,1
1,1378,41869,3578754842,3578754843,1
1,1378,41870,3578754842,3578754843,1
1,1378,41871,3578754842,3578754843,1
1,1378,41872,3578754842,3578754843,1
1,1378,41873,3578754842,3578754845,3
1,1378,41874,3578754842,3578754847,5
1,1378,41875,3578754842,3578754848,6
1,1378,41876,3578754842,3578754849,7
1,1378,41877,3578754842,3578754849,7
1,1378,41878,3578754842,3578754850,8
1,1378,41879,3578754842,3578754851,9
1,1378,41880,3578754842,3578754852,10
1,1378,41881,3578754842,3578754853,11
1,1378,41882,3578754842,3578754855,13
1,1378,41883,3578754842,3578754857,15
1,1378,41884,3578754842,3578754860,18
1,1378,41885,3578754842,3578754862,20
1,1378,41886,3578754842,3578754862,20
1,1378,41887,3578754842,3578754862,20
1,1378,41888,3578754842,3578754863,21
1,1378,41889,3578754842,3578754863,21
1,1378,41890,3578754842,3578754864,22
1,1378,41891,3578754842,3578754865,23
1,1378,41892,3578754842,3578754867,25
1,1378,41893,3578754842,3578754867,25
1,1378,41894,3578754842,3578754868,26
1,1378,41895,3578754842,3578754868,26
1,1378,41896,3578754842,3578754877,35
1,1378,41897,3578754842,3578754880,38
1,1378,41898,3578754842,3578754881,39
1,1378,41899,3578754842,3578754883,41
1,1378,41900,3578754842,3578754884,42
1,1378,41901,3578754842,3578754885,43
1,1378,41902,3578754842,3578754886,44
1,1378,41903,3578754842,3578754887,45
1,1378,41904,3578754842,3578754888,46
1,1378,41905,3578754842,3578754888,46
1,1378,41906,3578754842,3578754889,47
1,1378,41907,3578754842,3578754890,48
1,1378,41908,3578754842,3578754891,49
1,1379,41909,3578754903,3578754903,0
1,1379,41910,3578754903,3578754904,1
1,1379,41911,3578754903,3578754904,1
1,1379,41912,3578754903,3578754904,1
1,1379,41913,3578754903,3578754904,1
1,1379,41914,3578754903,3578754904,1
1,1379,41915,3578754903,3578754904,1
1,1379,41916,3578754903,3578754904,1
1,1379,41917,3578754903,3578754904,1
1,1379,41918,3578754903,3578754904,1
1,1379,41919,3578754903,3578754904,1
1,1379,41920,3578754903,3578754904,1
1,1379,41921,3578754903,3578754904,1
1,1379,41922,3578754903,3578754904,1
1,1379,41923,3578754903,3578754904,1
1,1379,41924,3578754903,3578754904,1
1,1379,41925,3578754903,3578754904,1
1,1379,41926,3578754903,3578754905,2
1,1379,41927,3578754903,3578754906,3
1,1379,41928,3578754903,3578754908,5
1,1379,41929,3578754903,3578754908,5
1,1379,41930,3578754903,3578754908,5
1,1379,41931,3578754903,3578754909,6
1,1379,41932,3578754903,3578754909,6
1,1379,41933,3578754903,3578754910,7
1,1379,41934,3578754903,3578754910,7
1,1379,41935,3578754903,3578754910,7
1,1379,41936,3578754903,3578754911,8
1,1379,41937,3578754903,3578754911,8
1,1379,41938,3578754903,3578754911,8
1,1379,41939,3578754903,3578754912,9
1,1379,41940,3578754903,3578754913,10
1,1379,41941,3578754903,3578754913,10
1,1379,41942,3578754903,3578754913,10
1,1379,41943,3578754903,3578754914,11
1,1379,41944,3578754903,3578754914,11
1,1379,41945,3578754903,3578754914,11
1,1379,41946,3578754903,3578754914,11
1,1379,41947,3578754903,3578754917,14
1,1379,41948,3578754903,3578754917,14
1,1379,41949,3578754903,3578754918,15
1,1379,41950,3578754903,3578754919,16
1,1379,41951,3578754903,3578754920,17
1,1379,41952,3578754903,3578754920,17
1,1379,41953,3578754903,3578754921,18
1,1379,41954,3578754903,3578754921,18
1,1379,41955,3578754903,3578754923,20
1,1379,41956,3578754903,3578754924,21
1,1379,41957,3578754903,3578754924,21
1,1379,41958,3578754903,3578754925,22
1,1379,41959,3578754903,3578754926,23
1,1379,41960,3578754903,3578754926,23
1,1379,41961,3578754903,3578754928,25
1,1379,41962,3578754903,3578754929,26
1,1379,41963,3578754903,3578754929,26
1,1379,41964,3578754903,3578754930,27
1,1379,41965,3578754903,3578754931,28
1,1379,41966,3578754903,3578754931,28
1,1379,41967,3578754903,3578754931,28
1,1379,41968,3578754903,3578754933,30
1,1379,41969,3578754903,3578754933,30
1,1379,41970,3578754903,3578754933,30
1,1379,41971,3578754903,3578754934,31
1,1379,41972,3578754903,3578754934,31
1,1379,41973,3578754903,3578754935,32
1,1379,41974,3578754903,3578754935,32
1,1379,41975,3578754903,3578754936,33
1,1379,41976,3578754903,3578754937,34
1,1379,41977,3578754903,3578754938,35
1,1379,41978,3578754903,3578754938,35
1,1379,41979,3578754903,3578754939,36
1,1379,41980,3578754903,3578754940,37
1,1379,41981,3578754903,3578754940,37
1,1379,41982,3578754903,3578754941,38
1,1379,41983,3578754903,3578754942,39
1,1379,41984,3578754903,3578754943,40
1,1379,41985,3578754903,3578754946,43
1,1379,41986,3578754903,3578754946,43
1,1379,41987,3578754903,3578754948,45
1,1379,41988,3578754903,3578754948,45
1,1379,41989,3578754903,3578754949,46
1,1379,41990,3578754903,3578754951,48
1,1380,41991,3578754965,3578754965,0
1,1380,41992,3578754965,3578754965,0
1,1380,41993,3578754965,3578754965,0
1,1380,41994,3578754965,3578754965,0
1,1380,41995,3578754965,3578754965,0
1,1380,41996,3578754965,3578754965,0
1,1380,41997,3578754965,3578754965,0
1,1380,41998,3578754965,3578754965,0
1,1380,41999,3578754965,3578754965,0
1,1380,42000,3578754965,3578754965,0
1,1380,42001,3578754965,3578754965,0
1,1380,42002,3578754965,3578754965,0
1,1380,42003,3578754965,3578754965,0
1,1380,42004,3578754965,3578754965,0
1,1380,42005,3578754965,3578754965,0
1,1380,42006,3578754965,3578754966,1
1,1380,42007,3578754965,3578754967,2
1,1380,42008,3578754965,3578754968,3
1,1380,42009,3578754965,3578754969,4
1,1380,42010,3578754965,3578754970,5
1,1380,42011,3578754965,3578754971,6
1,1380,42012,3578754965,3578754972,7
1,1380,42013,3578754965,3578754975,10
1,1380,42014,3578754965,3578754977,12
1,1380,42015,3578754965,3578754978,13
1,1380,42016,3578754965,3578754979,14
1,1380,42017,3578754965,3578754979,14
1,1380,42018,3578754965,3578754979,14
1,1380,42019,3578754965,3578754979,14
1,1380,42020,3578754965,3578754980,15
1,1380,42021,3578754965,3578754981,16
1,1380,42022,3578754965,3578754981,16
1,1380,42023,3578754965,3578754982,17
1,1380,42024,3578754965,3578754983,18
1,1380,42025,3578754965,3578754984,19
1,1380,42026,3578754965,3578754985,20
1,1380,42027,3578754965,3578754986,21
1,1380,42028,3578754965,3578754986,21
1,1380,42029,3578754965,3578754987,22
1,1380,42030,3578754965,3578754989,24
1,1380,42031,3578754965,3578754992,27
1,1380,42032,3578754965,3578754992,27
1,1380,42033,3578754965,3578754992,27
1,1380,42034,3578754965,3578754993,28
1,1380,42035,3578754965,3578754996,31
1,1380,42036,3578754965,3578754996,31
1,1380,42037,3578754965,3578754996,31
1,1380,42038,3578754965,3578754997,32
1,1380,42039,3578754965,3578754997,32
1,1380,42040,3578754965,3578754998,33
1,1380,42041,3578754965,3578754998,33
1,1380,42042,3578754965,3578754998,33
1,1380,42043,3578754965,3578754999,34
1,1380,42044,3578754965,3578754999,34
1,1380,42045,3578754965,3578755000,35
1,1380,42046,3578754965,3578755001,36
1,1380,42047,3578754965,3578755001,36
1,1380,42048,3578754965,3578755004,39
1,1380,42049,3578754965,3578755006,41
1,1380,42050,3578754965,3578755006,41
1,1380,42051,3578754965,3578755009,44
1,1380,42052,3578754965,3578755012,47
1,1380,42053,3578754965,3578755013,48
1,1380,42054,3578754965,3578755013,48
1,1380,42055,3578754965,3578755014,49
1,1380,42056,3578754965,3578755015,50
1,1381,42057,3578755028,3578755028,0
1,1381,42058,3578755028,3578755028,0
1,1381,42059,3578755028,3578755028,0
1,1381,42060,3578755028,3578755028,0
1,1381,42061,3578755028,3578755028,0
1,1381,42062,3578755028,3578755028,0
1,1381,42063,3578755028,3578755028,0
1,1381,42064,3578755028,3578755028,0
1,1381,42065,3578755028,3578755028,0
1,1381,42066,3578755028,3578755028,0
1,1381,42067,3578755028,3578755028,0
1,1381,42068,3578755028,3578755028,0
1,1381,42069,3578755028,3578755028,0
1,1381,42070,3578755028,3578755028,0
1,1381,42071,3578755028,3578755028,0
1,1381,42072,3578755028,3578755028,0
1,1381,42073,3578755028,3578755028,0
1,1381,42074,3578755028,3578755029,1
1,1381,42075,3578755028,3578755030,2
1,1381,42076,3578755028,3578755030,2
1,1381,42077,3578755028,3578755031,3
1,1381,42078,3578755028,3578755031,3
1,1381,42079,3578755028,3578755031,3
1,1381,42080,3578755028,3578755034,6
1,1381,42081,3578755028,3578755034,6
1,1381,42082,3578755028,3578755035,7
1,1381,42083,3578755028,3578755037,9
1,1381,42084,3578755028,3578755037,9
1,1381,42085,3578755028,3578755039,11
1,1381,42086,3578755028,3578755039,11
1,1381,42087,3578755028,3578755041,13
1,1381,42088,3578755028,3578755041,13
1,1381,42089,3578755028,3578755043,15
1,1381,42090,3578755028,3578755045,17
1,1381,42091,3578755028,3578755047,19
1,1381,42092,3578755028,3578755049,21
1,1381,42093,3578755028,3578755049,21
1,1381,42094,3578755028,3578755049,21
1,1381,42095,3578755028,3578755050,22
1,1381,42096,3578755028,3578755051,23
1,1381,42097,3578755028,3578755052,24
1,1381,42098,3578755028,3578755052,24
1,1381,42099,3578755028,3578755053,25
1,1381,42100,3578755028,3578755056,28
1,1381,42101,3578755028,3578755060,32
1,1381,42102,3578755028,3578755062,34
1,1381,42103,3578755028,3578755063,35
1,1381,42104,3578755028,3578755063,35
1,1381,42105,3578755028,3578755064,36
1,1381,42106,3578755028,3578755064,36
1,1381,42107,3578755028,3578755064,36
1,1381,42108,3578755028,3578755065,37
1,1381,42109,3578755028,3578755067,39
1,1381,42110,3578755028,3578755068,40
1,1381,42111,3578755028,3578755068,40
1,1381,42112,3578755028,3578755077,49
1,1382,42113,3578755091,3578755091,0
1,1382,42114,3578755091,3578755091,0
1,1382,42115,3578755091,3578755091,0
1,1382,42116,3578755091,3578755091,0
1,1382,42117,3578755091,3578755091,0
1,1382,42118,3578755091,3578755091,0
1,1382,42119,3578755091,3578755091,0
1,1382,42120,3578755091,3578755091,0
1,1382,42121,3578755091,3578755091,0
1,1382,42122,3578755091,3578755091,0
1,1382,42123,3578755091,3578755091,0
1,1382,42124,3578755091,3578755093,2
1,1382,42125,3578755091,3578755093,2
1,1382,42126,3578755091,3578755093,2
1,1382,42127,3578755091,3578755093,2
1,1382,42128,3578755091,3578755095,4
1,1382,42129,3578755091,3578755095,4
1,1382,42130,3578755091,3578755095,4
1,1382,42131,3578755091,3578755095,4
1,1382,42132,3578755091,3578755096,5
1,1382,42133,3578755091,3578755097,6
1,1382,42134,3578755091,3578755099,8
1,1382,42135,3578755091,3578755102,11
1,1382,42136,3578755091,3578755102,11
1,1382,42137,3578755091,3578755103,12
1,1382,42138,3578755091,3578755103,12
1,1382,42139,3578755091,3578755103,12
1,1382,42140,3578755091,3578755104,13
1,1382,42141,3578755091,3578755105,14
1,1382,42142,3578755091,3578755105,14
1,1382,42143,3578755091,3578755107,16
1,1382,42144,3578755091,3578755107,16
1,1382,42145,3578755091,3578755108,17
1,1382,42146,3578755091,3578755109,18
1,1382,42147,3578755091,3578755109,18
1,1382,42148,3578755091,3578755109,18
1,1382,42149,3578755091,3578755109,18
1,1382,42150,3578755091,3578755110,19
1,1382,42151,3578755091,3578755110,19
1,1382,42152,3578755091,3578755111,20
1,1382,42153,3578755091,3578755111,20
1,1382,42154,3578755091,3578755111,20
1,1382,42155,3578755091,3578755111,20
1,1382,42156,3578755091,3578755112,21
1,1382,42157,3578755091,3578755112,21
1,1382,42158,3578755091,3578755113,22
1,1382,42159,3578755091,3578755114,23
1,1382,42160,3578755091,3578755114,23
1,1382,42161,3578755091,3578755114,23
1,1382,42162,3578755091,3578755114,23
1,1382,42163,3578755091,3578755114,23
1,1382,42164,3578755091,3578755117,26
1,1382,42165,3578755091,3578755117,26
1,1382,42166,3578755091,3578755118,27
1,1382,42167,3578755091,3578755119,28
1,1382,42168,3578755091,3578755120,29
1,1382,42169,3578755091,3578755122,31
1,1382,42170,3578755091,3578755122,31
1,1382,42171,3578755091,3578755123,32
1,1382,42172,3578755091,3578755124,33
1,1382,42173,3578755091,3578755124,33
1,1382,42174,3578755091,3578755124,33
1,1382,42175,3578755091,3578755125,34
1,1382,42176,3578755091,3578755126,35
1,1382,42177,3578755091,3578755126,35
1,1382,42178,3578755091,3578755128,37
1,1382,42179,3578755091,3578755129,38
1,1382,42180,3578755091,3578755129,38
1,1382,42181,3578755091,3578755130,39
1,1382,42182,3578755091,3578755131,40
1,1382,42183,3578755091,3578755131,40
1,1382,42184,3578755091,3578755131,40
1,1382,42185,3578755091,3578755132,41
1,1382,42186,3578755091,3578755132,41
1,1382,42187,3578755091,3578755134,43
1,1382,42188,3578755091,3578755134,43
1,1382,42189,3578755091,3578755134,43
1,1382,42190,3578755091,3578755135,44
1,1382,42191,3578755091,3578755137,46
1,1382,42192,3578755091,3578755138,47
1,1382,42193,3578755091,3578755138,47
1,1382,42194,3578755091,3578755140,49
1,1382,42195,3578755091,3578755141,50
1,1382,42196,3578755091,3578755141,50
1,1383,42197,3578755154,3578755154,0
1,1383,42198,3578755154,3578755154,0
1,1383,42199,3578755154,3578755154,0
1,1383,42200,3578755154,3578755154,0
1,1383,42201,3578755154,3578755154,0
1,1383,42202,3578755154,3578755154,0
1,1383,42203,3578755154,3578755154,0
1,1383,42204,3578755154,3578755154,0
1,1383,42205,3578755154,3578755155,1
1,1383,42206,3578755154,3578755157,3
1,1383,42207,3578755154,3578755158,4
1,1383,42208,3578755154,3578755160,6
1,1383,42209,3578755154,3578755162,8
1,1383,42210,3578755154,3578755162,8
1,1383,42211,3578755154,3578755162,8
1,1383,42212,3578755154,3578755163,9
1,1383,42213,3578755154,3578755163,9
1,1383,42214,3578755154,3578755164,10
1,1383,42215,3578755154,3578755164,10
1,1383,42216,3578755154,3578755166,12
1,1383,42217,3578755154,3578755166,12
1,1383,42218,3578755154,3578755167,13
1,1383,42219,3578755154,3578755169,15
1,1383,42220,3578755154,3578755169,15
1,1383,42221,3578755154,3578755171,17
1,1383,42222,3578755154,3578755171,17
1,1383,42223,3578755154,3578755172,18
1,1383,42224,3578755154,3578755174,20
1,1383,42225,3578755154,3578755178,24
1,1383,42226,3578755154,3578755178,24
1,1383,42227,3578755154,3578755178,24
1,1383,42228,3578755154,3578755178,24
1,1383,42229,3578755154,3578755179,25
1,1383,42230,3578755154,3578755179,25
1,1383,42231,3578755154,3578755180,26
1,1383,42232,3578755154,3578755181,27
1,1383,42233,3578755154,3578755181,27
1,1383,42234,3578755154,3578755182,28
1,1383,42235,3578755154,3578755183,29
1,1383,42236,3578755154,3578755185,31
1,1383,42237,3578755154,3578755185,31
1,1383,42238,3578755154,3578755186,32
1,1383,42239,3578755154,3578755188,34
1,1383,42240,3578755154,3578755191,37
1,1383,42241,3578755154,3578755192,38
1,1383,42242,3578755154,3578755192,38
1,1383,42243,3578755154,3578755193,39
1,1383,42244,3578755154,3578755196,42
1,1383,42245,3578755154,3578755196,42
1,1383,42246,3578755154,3578755196,42
1,1383,42247,3578755154,3578755197,43
1,1383,42248,3578755154,3578755197,43
1,1383,42249,3578755154,3578755198,44
1,1383,42250,3578755154,3578755198,44
1,1383,42251,3578755154,3578755199,45
1,1383,42252,3578755154,3578755199,45
1,1383,42253,3578755154,3578755200,46
1,1383,42254,3578755154,3578755201,47
1,1383,42255,3578755154,3578755203,49
1,1384,42256,3578755216,3578755216,0
1,1384,42257,3578755216,3578755216,0
1,1384,42258,3578755216,3578755216,0
1,1384,42259,3578755216,3578755216,0
1,1384,42260,3578755216,3578755216,0
1,1384,42261,3578755216,3578755216,0
1,1384,42262,3578755216,3578755216,0
1,1384,42263,3578755216,3578755216,0
1,1384,42264,3578755216,3578755216,0
1,1384,42265,3578755216,3578755217,1
1,1384,42266,3578755216,3578755217,1
1,1384,42267,3578755216,3578755217,1
1,1384,42268,3578755216,3578755217,1
1,1384,42269,3578755216,3578755219,3
1,1384,42270,3578755216,3578755219,3
1,1384,42271,3578755216,3578755220,4
1,1384,42272,3578755216,3578755220,4
1,1384,42273,3578755216,3578755221,5
1,1384,42274,3578755216,3578755221,5
1,1384,42275,3578755216,3578755222,6
1,1384,42276,3578755216,3578755222,6
1,1384,42277,3578755216,3578755223,7
1,1384,42278,3578755216,3578755224,8
1,1384,42279,3578755216,3578755225,9
1,1384,42280,3578755216,3578755226,10
1,1384,42281,3578755216,3578755228,12
1,1384,42282,3578755216,3578755230,14
1,1384,42283,3578755216,3578755230,14
1,1384,42284,3578755216,3578755230,14
1,1384,42285,3578755216,3578755230,14
1,1384,42286,3578755216,3578755231,15
1,1384,42287,3578755216,3578755231,15
1,1384,42288,3578755216,3578755232,16
1,1384,42289,3578755216,3578755235,19
1,1384,42290,3578755216,3578755235,19
1,1384,42291,3578755216,3578755236,20
1,1384,42292,3578755216,3578755237,21
1,1384,42293,3578755216,3578755237,21
1,1384,42294,3578755216,3578755239,23
1,1384,42295,3578755216,3578755239,23
1,1384,42296,3578755216,3578755241,25
1,1384,42297,3578755216,3578755242,26
1,1384,42298,3578755216,3578755244,28
1,1384,42299,3578755216,3578755244,28
1,1384,42300,3578755216,3578755247,31
1,1384,42301,3578755216,3578755248,32
1,1384,42302,3578755216,3578755249,33
1,1384,42303,3578755216,3578755252,36
1,1384,42304,3578755216,3578755252,36
1,1384,42305,3578755216,3578755253,37
1,1384,42306,3578755216,3578755254,38
1,1384,42307,3578755216,3578755256,40
1,1384,42308,3578755216,3578755257,41
1,1384,42309,3578755216,3578755259,43
1,1384,42310,3578755216,3578755261,45
1,1384,42311,3578755216,3578755262,46
1,1384,42312,3578755216,3578755264,48
1,1384,42313,3578755216,3578755265,49
1,1384,42314,3578755216,3578755265,49
1,1384,42315,3578755216,3578755265,49
1,1385,42316,3578755279,3578755279,0
1,1385,42317,3578755279,3578755279,0
1,1385,42318,3578755279,3578755279,0
1,1385,42319,3578755279,3578755280,1
1,1385,42320,3578755279,3578755283,4
1,1385,42321,3578755279,3578755284,5
1,1385,42322,3578755279,3578755284,5
1,1385,42323,3578755279,3578755286,7
1,1385,42324,3578755279,3578755287,8
1,1385,42325,3578755279,3578755288,9
1,1385,42326,3578755279,3578755289,10
1,1385,42327,3578755279,3578755289,10
1,1385,42328,3578755279,3578755291,12
1,1385,42329,3578755279,3578755291,12
1,1385,42330,3578755279,3578755292,13
1,1385,42331,3578755279,3578755292,13
1,1385,42332,3578755279,3578755293,14
1,1385,42333,3578755279,3578755295,16
1,1385,42334,3578755279,3578755295,16
1,1385,42335,3578755279,3578755296,17
1,1385,42336,3578755279,3578755296,17
1,1385,42337,3578755279,3578755296,17
1,1385,42338,3578755279,3578755298,19
1,1385,42339,3578755279,3578755298,19
1,1385,42340,3578755279,3578755302,23
1,1385,42341,3578755279,3578755303,24
1,1385,42342,3578755279,3578755303,24
1,1385,42343,3578755279,3578755303,24
1,1385,42344,3578755279,3578755303,24
1,1385,42345,3578755279,3578755304,25
1,1385,42346,3578755279,3578755305,26
1,1385,42347,3578755279,3578755305,26
1,1385,42348,3578755279,3578755306,27
1,1385,42349,3578755279,3578755307,28
1,1385,42350,3578755279,3578755308,29
1,1385,42351,3578755279,3578755308,29
1,1385,42352,3578755279,3578755308,29
1,1385,42353,3578755279,3578755309,30
1,1385,42354,3578755279,3578755310,31
1,1385,42355,3578755279,3578755310,31
1,1385,42356,3578755279,3578755310,31
1,1385,42357,3578755279,3578755311,32
1,1385,42358,3578755279,3578755312,33
1,1385,42359,3578755279,3578755312,33
1,1385,42360,3578755279,3578755313,34
1,1385,42361,3578755279,3578755313,34
1,1385,42362,3578755279,3578755313,34
1,1385,42363,3578755279,3578755314,35
1,1385,42364,3578755279,3578755314,35
1,1385,42365,3578755279,3578755314,35
1,1385,42366,3578755279,3578755316,37
1,1385,42367,3578755279,3578755317,38
1,1385,42368,3578755279,3578755318,39
1,1385,42369,3578755279,3578755320,41
1,1385,42370,3578755279,3578755320,41
1,1385,42371,3578755279,3578755322,43
1,1385,42372,3578755279,3578755322,43
1,1385,42373,3578755279,3578755323,44
1,1385,42374,3578755279,3578755323,44
1,1385,42375,3578755279,3578755324,45
1,1385,42376,3578755279,3578755325,46
1,1385,42377,3578755279,3578755325,46
1,1385,42378,3578755279,3578755327,48
1,1385,42379,3578755279,3578755328,49
1,1386,42380,3578755342,3578755342,0
1,1386,42381,3578755342,3578755342,0
1,1386,42382,3578755342,3578755342,0
1,1386,42383,3578755342,3578755342,0
1,1386,42384,3578755342,3578755342,0
1,1386,42385,3578755342,3578755342,0
1,1386,42386,3578755342,3578755342,0
1,1386,42387,3578755342,3578755342,0
1,1386,42388,3578755342,3578755342,0
1,1386,42389,3578755342,3578755342,0
1,1386,42390,3578755342,3578755342,0
1,1386,42391,3578755342,3578755342,0
1,1386,42392,3578755342,3578755342,0
1,1386,42393,3578755342,3578755342,0
1,1386,42394,3578755342,3578755342,0
1,1386,42395,3578755342,3578755342,0
1,1386,42396,3578755342,3578755342,0
1,1386,42397,3578755342,3578755343,1
1,1386,42398,3578755342,3578755343,1
1,1386,42399,3578755342,3578755347,5
1,1386,42400,3578755342,3578755347,5
1,1386,42401,3578755342,3578755348,6
1,1386,42402,3578755342,3578755348,6
1,1386,42403,3578755342,3578755350,8
1,1386,42404,3578755342,3578755354,12
1,1386,42405,3578755342,3578755355,13
1,1386,42406,3578755342,3578755358,16
1,1386,42407,3578755342,3578755360,18
1,1386,42408,3578755342,3578755360,18
1,1386,42409,3578755342,3578755362,20
1,1386,42410,3578755342,3578755362,20
1,1386,42411,3578755342,3578755363,21
1,1386,42412,3578755342,3578755363,21
1,1386,42413,3578755342,3578755364,22
1,1386,42414,3578755342,3578755365,23
1,1386,42415,3578755342,3578755365,23
1,1386,42416,3578755342,3578755367,25
1,1386,42417,3578755342,3578755368,26
1,1386,42418,3578755342,3578755369,27
1,1386,42419,3578755342,3578755370,28
1,1386,42420,3578755342,3578755371,29
1,1386,42421,3578755342,3578755371,29
1,1386,42422,3578755342,3578755372,30
1,1386,42423,3578755342,3578755375,33
1,1386,42424,3578755342,3578755377,35
1,1386,42425,3578755342,3578755378,36
1,1386,42426,3578755342,3578755378,36
1,1386,42427,3578755342,3578755379,37
1,1386,42428,3578755342,3578755379,37
1,1386,42429,3578755342,3578755380,38
1,1386,42430,3578755342,3578755380,38
1,1386,42431,3578755342,3578755381,39
1,1386,42432,3578755342,3578755381,39
1,1386,42433,3578755342,3578755382,40
1,1386,42434,3578755342,3578755382,40
1,1386,42435,3578755342,3578755382,40
1,1386,42436,3578755342,3578755384,42
1,1386,42437,3578755342,3578755384,42
1,1386,42438,3578755342,3578755385,43
1,1386,42439,3578755342,3578755387,45
1,1386,42440,3578755342,3578755388,46
1,1386,42441,3578755342,3578755389,47
1,1386,42442,3578755342,3578755392,50
1,1387,42443,3578755404,3578755404,0
1,1387,42444,3578755404,3578755404,0
1,1387,42445,3578755404,3578755404,0
1,1387,42446,3578755404,3578755404,0
1,1387,42447,3578755404,3578755404,0
1,1387,42448,3578755404,3578755404,0
1,1387,42449,3578755404,3578755404,0
1,1387,42450,3578755404,3578755404,0
1,1387,42451,3578755404,3578755404,0
1,1387,42452,3578755404,3578755404,0
1,1387,42453,3578755404,3578755404,0
1,1387,42454,3578755404,3578755404,0
1,1387,42455,3578755404,3578755404,0
1,1387,42456,3578755404,3578755404,0
1,1387,42457,3578755404,3578755406,2
1,1387,42458,3578755404,3578755407,3
1,1387,42459,3578755404,3578755408,4
1,1387,42460,3578755404,3578755412,8
1,1387,42461,3578755404,3578755412,8
1,1387,42462,3578755404,3578755414,10
1,1387,42463,3578755404,3578755414,10
1,1387,42464,3578755404,3578755416,12
1,1387,42465,3578755404,3578755417,13
1,1387,42466,3578755404,3578755417,13
1,1387,42467,3578755404,3578755418,14
1,1387,42468,3578755404,3578755419,15
1,1387,42469,3578755404,3578755419,15
1,1387,42470,3578755404,3578755420,16
1,1387,42471,3578755404,3578755420,16
1,1387,42472,3578755404,3578755421,17
1,1387,42473,3578755404,3578755421,17
1,1387,42474,3578755404,3578755421,17
1,1387,42475,3578755404,3578755423,19
1,1387,42476,3578755404,3578755424,20
1,1387,42477,3578755404,3578755424,20
1,1387,42478,3578755404,3578755426,22
1,1387,42479,3578755404,3578755428,24
1,1387,42480,3578755404,3578755429,25
1,1387,42481,3578755404,3578755429,25
1,1387,42482,3578755404,3578755430,26
1,1387,42483,3578755404,3578755430,26
1,1387,42484,3578755404,3578755431,27
1,1387,42485,3578755404,3578755432,28
1,1387,42486,3578755404,3578755432,28
1,1387,42487,3578755404,3578755435,31
1,1387,42488,3578755404,3578755436,32
1,1387,42489,3578755404,3578755436,32
1,1387,42490,3578755404,3578755437,33
1,1387,42491,3578755404,3578755439,35
1,1387,42492,3578755404,3578755439,35
1,1387,42493,3578755404,3578755439,35
1,1387,42494,3578755404,3578755441,37
1,1387,42495,3578755404,3578755441,37
1,1387,42496,3578755404,3578755444,40
1,1387,42497,3578755404,3578755445,41
1,1387,42498,3578755404,3578755447,43
1,1387,42499,3578755404,3578755449,45
1,1387,42500,3578755404,3578755449,45
1,1387,42501,3578755404,3578755450,46
1,1387,42502,3578755404,3578755450,46
1,1387,42503,3578755404,3578755451,47
1,1387,42504,3578755404,3578755453,49
1,1387,42505,3578755404,3578755454,50
1,1388,42506,3578755468,3578755468,0
1,1388,42507,3578755468,3578755468,0
1,1388,42508,3578755468,3578755468,0
1,1388,42509,3578755468,3578755468,0
1,1388,42510,3578755468,3578755468,0
1,1388,42511,3578755468,3578755468,0
1,1388,42512,3578755468,3578755468,0
1,1388,42513,3578755468,3578755468,0
1,1388,42514,3578755468,3578755468,0
1,1388,42515,3578755468,3578755468,0
1,1388,42516,3578755468,3578755468,0
1,1388,42517,3578755468,3578755468,0
1,1388,42518,3578755468,3578755477,9
1,1388,42519,3578755468,3578755480,12
1,1388,42520,3578755468,3578755482,14
1,1388,42521,3578755468,3578755483,15
1,1388,42522,3578755468,3578755484,16
1,1388,42523,3578755468,3578755484,16
1,1388,42524,3578755468,3578755486,18
1,1388,42525,3578755468,3578755487,19
1,1388,42526,3578755468,3578755488,20
1,1388,42527,3578755468,3578755489,21
1,1388,42528,3578755468,3578755490,22
1,1388,42529,3578755468,3578755491,23
1,1388,42530,3578755468,3578755491,23
1,1388,42531,3578755468,3578755492,24
1,1388,42532,3578755468,3578755492,24
1,1388,42533,3578755468,3578755493,25
1,1388,42534,3578755468,3578755493,25
1,1388,42535,3578755468,3578755495,27
1,1388,42536,3578755468,3578755495,27
1,1388,42537,3578755468,3578755495,27
1,1388,42538,3578755468,3578755495,27
1,1388,42539,3578755468,3578755496,28
1,1388,42540,3578755468,3578755497,29
1,1388,42541,3578755468,3578755498,30
1,1388,42542,3578755468,3578755502,34
1,1388,42543,3578755468,3578755503,35
1,1388,42544,3578755468,3578755503,35
1,1388,42545,3578755468,3578755503,35
1,1388,42546,3578755468,3578755504,36
1,1388,42547,3578755468,3578755504,36
1,1388,42548,3578755468,3578755505,37
1,1388,42549,3578755468,3578755506,38
1,1388,42550,3578755468,3578755507,39
1,1388,42551,3578755468,3578755508,40
1,1388,42552,3578755468,3578755508,40
1,1388,42553,3578755468,3578755508,40
1,1388,42554,3578755468,3578755510,42
1,1388,42555,3578755468,3578755510,42
1,1388,42556,3578755468,3578755510,42
1,1388,42557,3578755468,3578755510,42
1,1388,42558,3578755468,3578755510,42
1,1388,42559,3578755468,3578755511,43
1,1388,42560,3578755468,3578755513,45
1,1388,42561,3578755468,3578755513,45
1,1388,42562,3578755468,3578755513,45
1,1388,42563,3578755468,3578755513,45
1,1388,42564,3578755468,3578755514,46
1,1388,42565,3578755468,3578755514,46
1,1388,42566,3578755468,3578755515,47
1,1388,42567,3578755468,3578755516,48
1,1388,42568,3578755468,3578755517,49
1,1388,42569,3578755468,3578755518,50
1,1389,42570,3578755532,3578755532,0
1,1389,42571,3578755532,3578755532,0
1,1389,42572,3578755532,3578755532,0
1,1389,42573,3578755532,3578755532,0
1,1389,42574,3578755532,3578755532,0
1,1389,42575,3578755532,3578755532,0
1,1389,42576,3578755532,3578755532,0
1,1389,42577,3578755532,3578755532,0
1,1389,42578,3578755532,3578755532,0
1,1389,42579,3578755532,3578755532,0
1,1389,42580,3578755532,3578755532,0
1,1389,42581,3578755532,3578755532,0
1,1389,42582,3578755532,3578755532,0
1,1389,42583,3578755532,3578755532,0
1,1389,42584,3578755532,3578755532,0
1,1389,42585,3578755532,3578755532,0
1,1389,42586,3578755532,3578755532,0
1,1389,42587,3578755532,3578755532,0
1,1389,42588,3578755532,3578755532,0
1,1389,42589,3578755532,3578755532,0
1,1389,42590,3578755532,3578755533,1
1,1389,42591,3578755532,3578755533,1
1,1389,42592,3578755532,3578755535,3
1,1389,42593,3578755532,3578755535,3
1,1389,42594,3578755532,3578755537,5
1,1389,42595,3578755532,3578755537,5
1,1389,42596,3578755532,3578755540,8
1,1389,42597,3578755532,3578755540,8
1,1389,42598,3578755532,3578755540,8
1,1389,42599,3578755532,3578755542,10
1,1389,42600,3578755532,3578755546,14
1,1389,42601,3578755532,3578755546,14
1,1389,42602,3578755532,3578755546,14
1,1389,42603,3578755532,3578755551,19
1,1389,42604,3578755532,3578755552,20
1,1389,42605,3578755532,3578755555,23
1,1389,42606,3578755532,3578755556,24
1,1389,42607,3578755532,3578755558,26
1,1389,42608,3578755532,3578755558,26
1,1389,42609,3578755532,3578755561,29
1,1389,42610,3578755532,3578755561,29
1,1389,42611,3578755532,3578755562,30
1,1389,42612,3578755532,3578755562,30
1,1389,42613,3578755532,3578755564,32
1,1389,42614,3578755532,3578755565,33
1,1389,42615,3578755532,3578755566,34
1,1389,42616,3578755532,3578755566,34
1,1389,42617,3578755532,3578755567,35
1,1389,42618,3578755532,3578755567,35
1,1389,42619,3578755532,3578755569,37
1,1389,42620,3578755532,3578755571,39
1,1389,42621,3578755532,3578755571,39
1,1389,42622,3578755532,3578755572,40
1,1389,42623,3578755532,3578755575,43
1,1389,42624,3578755532,3578755577,45
1,1389,42625,3578755532,3578755577,45
1,1389,42626,3578755532,3578755578,46
1,1389,42627,3578755532,3578755578,46
1,1389,42628,3578755532,3578755579,47
1,1389,42629,3578755532,3578755579,47
1,1389,42630,3578755532,3578755580,48
1,1389,42631,3578755532,3578755581,49
1,1389,42632,3578755532,3578755581,49
1,1389,42633,3578755532,3578755581,49
1,1389,42634,3578755532,3578755582,50
1,1390,42635,3578755596,3578755596,0
1,1390,42636,3578755596,3578755596,0
1,1390,42637,3578755596,3578755596,0
1,1390,42638,3578755596,3578755596,0
1,1390,42639,3578755596,3578755596,0
1,1390,42640,3578755596,3578755596,0
1,1390,42641,3578755596,3578755596,0
1,1390,42642,3578755596,3578755596,0
1,1390,42643,3578755596,3578755596,0
1,1390,42644,3578755596,3578755596,0
1,1390,42645,3578755596,3578755596,0
1,1390,42646,3578755596,3578755596,0
1,1390,42647,3578755596,3578755597,1
1,1390,42648,3578755596,3578755597,1
1,1390,42649,3578755596,3578755597,1
1,1390,42650,3578755596,3578755598,2
1,1390,42651,3578755596,3578755598,2
1,1390,42652,3578755596,3578755598,2
1,1390,42653,3578755596,3578755599,3
1,1390,42654,3578755596,3578755600,4
1,1390,42655,3578755596,3578755601,5
1,1390,42656,3578755596,3578755603,7
1,1390,42657,3578755596,3578755605,9
1,1390,42658,3578755596,3578755606,10
1,1390,42659,3578755596,3578755608,12
1,1390,42660,3578755596,3578755611,15
1,1390,42661,3578755596,3578755611,15
1,1390,42662,3578755596,3578755613,17
1,1390,42663,3578755596,3578755614,18
1,1390,42664,3578755596,3578755614,18
1,1390,42665,3578755596,3578755615,19
1,1390,42666,3578755596,3578755616,20
1,1390,42667,3578755596,3578755616,20
1,1390,42668,3578755596,3578755617,21
1,1390,42669,3578755596,3578755617,21
1,1390,42670,3578755596,3578755618,22
1,1390,42671,3578755596,3578755619,23
1,1390,42672,3578755596,3578755619,23
1,1390,42673,3578755596,3578755620,24
1,1390,42674,3578755596,3578755620,24
1,1390,42675,3578755596,3578755620,24
1,1390,42676,3578755596,3578755621,25
1,1390,42677,3578755596,3578755622,26
1,1390,42678,3578755596,3578755622,26
1,1390,42679,3578755596,3578755623,27
1,1390,42680,3578755596,3578755625,29
1,1390,42681,3578755596,3578755625,29
1,1390,42682,3578755596,3578755628,32
1,1390,42683,3578755596,3578755629,33
1,1390,42684,3578755596,3578755629,33
1,1390,42685,3578755596,3578755629,33
1,1390,42686,3578755596,3578755630,34
1,1390,42687,3578755596,3578755630,34
1,1390,42688,3578755596,3578755630,34
1,1390,42689,3578755596,3578755631,35
1,1390,42690,3578755596,3578755631,35
1,1390,42691,3578755596,3578755634,38
1,1390,42692,3578755596,3578755635,39
1,1390,42693,3578755596,3578755636,40
1,1390,42694,3578755596,3578755637,41
1,1390,42695,3578755596,3578755639,43
1,1390,42696,3578755596,3578755639,43
1,1390,42697,3578755596,3578755640,44
1,1390,42698,3578755596,3578755641,45
1,1390,42699,3578755596,3578755642,46
1,1390,42700,3578755596,3578755644,48
1,1390,42701,3578755596,3578755646,50
1,1391,42702,3578755659,3578755659,0
1,1391,42703,3578755659,3578755659,0
1,1391,42704,3578755659,3578755659,0
1,1391,42705,3578755659,3578755659,0
1,1391,42706,3578755659,3578755659,0
1,1391,42707,3578755659,3578755659,0
1,1391,42708,3578755659,3578755659,0
1,1391,42709,3578755659,3578755659,0
1,1391,42710,3578755659,3578755659,0
1,1391,42711,3578755659,3578755660,1
1,1391,42712,3578755659,3578755662,3
1,1391,42713,3578755659,3578755662,3
1,1391,42714,3578755659,3578755663,4
1,1391,42715,3578755659,3578755663,4
1,1391,42716,3578755659,3578755664,5
1,1391,42717,3578755659,3578755665,6
1,1391,42718,3578755659,3578755667,8
1,1391,42719,3578755659,3578755667,8
1,1391,42720,3578755659,3578755668,9
1,1391,42721,3578755659,3578755677,18
1,1391,42722,3578755659,3578755681,22
1,1391,42723,3578755659,3578755682,23
1,1391,42724,3578755659,3578755683,24
1,1391,42725,3578755659,3578755684,25
1,1391,42726,3578755659,3578755685,26
1,1391,42727,3578755659,3578755687,28
1,1391,42728,3578755659,3578755688,29
1,1391,42729,3578755659,3578755688,29
1,1391,42730,3578755659,3578755689,30
1,1391,42731,3578755659,3578755689,30
1,1391,42732,3578755659,3578755691,32
1,1391,42733,3578755659,3578755692,33
1,1391,42734,3578755659,3578755692,33
1,1391,42735,3578755659,3578755692,33
1,1391,42736,3578755659,3578755693,34
1,1391,42737,3578755659,3578755694,35
1,1391,42738,3578755659,3578755694,35
1,1391,42739,3578755659,3578755695,36
1,1391,42740,3578755659,3578755696,37
1,1391,42741,3578755659,3578755696,37
1,1391,42742,3578755659,3578755697,38
1,1391,42743,3578755659,3578755698,39
1,1391,42744,3578755659,3578755698,39
1,1391,42745,3578755659,3578755702,43
1,1391,42746,3578755659,3578755702,43
1,1391,42747,3578755659,3578755702,43
1,1391,42748,3578755659,3578755702,43
1,1391,42749,3578755659,3578755704,45
1,1391,42750,3578755659,3578755704,45
1,1391,42751,3578755659,3578755704,45
1,1391,42752,3578755659,3578755704,45
1,1391,42753,3578755659,3578755706,47
1,1391,42754,3578755659,3578755706,47
1,1391,42755,3578755659,3578755708,49
1,1391,42756,3578755659,3578755708,49
1,1391,42757,3578755659,3578755708,49
1,1391,42758,3578755659,3578755708,49
1,1392,42759,3578755723,3578755723,0
1,1392,42760,3578755723,3578755724,1
1,1392,42761,3578755723,3578755724,1
1,1392,42762,3578755723,3578755724,1
1,1392,42763,3578755723,3578755724,1
1,1392,42764,3578755723,3578755724,1
1,1392,42765,3578755723,3578755724,1
1,1392,42766,3578755723,3578755724,1
1,1392,42767,3578755723,3578755724,1
1,1392,42768,3578755723,3578755724,1
1,1392,42769,3578755723,3578755724,1
1,1392,42770,3578755723,3578755724,1
1,1392,42771,3578755723,3578755724,1
1,1392,42772,3578755723,3578755724,1
1,1392,42773,3578755723,3578755724,1
1,1392,42774,3578755723,3578755724,1
1,1392,42775,3578755723,3578755724,1
1,1392,42776,3578755723,3578755724,1
1,1392,42777,3578755723,3578755724,1
1,1392,42778,3578755723,3578755724,1
1,1392,42779,3578755723,3578755724,1
1,1392,42780,3578755723,3578755724,1
1,1392,42781,3578755723,3578755724,1
1,1392,42782,3578755723,3578755724,1
1,1392,42783,3578755723,3578755726,3
1,1392,42784,3578755723,3578755726,3
1,1392,42785,3578755723,3578755726,3
1,1392,42786,3578755723,3578755727,4
1,1392,42787,3578755723,3578755728,5
1,1392,42788,3578755723,3578755729,6
1,1392,42789,3578755723,3578755729,6
1,1392,42790,3578755723,3578755730,7
1,1392,42791,3578755723,3578755732,9
1,1392,42792,3578755723,3578755733,10
1,1392,42793,3578755723,3578755733,10
1,1392,42794,3578755723,3578755734,11
1,1392,42795,3578755723,3578755735,12
1,1392,42796,3578755723,3578755735,12
1,1392,42797,3578755723,3578755736,13
1,1392,42798,3578755723,3578755736,13
1,1392,42799,3578755723,3578755736,13
1,1392,42800,3578755723,3578755738,15
1,1392,42801,3578755723,3578755738,15
1,1392,42802,3578755723,3578755738,15
1,1392,42803,3578755723,3578755739,16
1,1392,42804,3578755723,3578755740,17
1,1392,42805,3578755723,3578755741,18
1,1392,42806,3578755723,3578755742,19
1,1392,42807,3578755723,3578755746,23
1,1392,42808,3578755723,3578755746,23
1,1392,42809,3578755723,3578755747,24
1,1392,42810,3578755723,3578755749,26
1,1392,42811,3578755723,3578755751,28
1,1392,42812,3578755723,3578755753,30
1,1392,42813,3578755723,3578755755,32
1,1392,42814,3578755723,3578755757,34
1,1392,42815,3578755723,3578755759,36
1,1392,42816,3578755723,3578755761,38
1,1392,42817,3578755723,3578755762,39
1,1392,42818,3578755723,3578755762,39
1,1392,42819,3578755723,3578755763,40
1,1392,42820,3578755723,3578755764,41
1,1392,42821,3578755723,3578755765,42
1,1392,42822,3578755723,3578755765,42
1,1392,42823,3578755723,3578755766,43
1,1392,42824,3578755723,3578755766,43
1,1392,42825,3578755723,3578755768,45
1,1392,42826,3578755723,3578755769,46
1,1392,42827,3578755723,3578755771,48
1,1392,42828,3578755723,3578755771,48
1,1392,42829,3578755723,3578755772,49
1,1393,42830,3578755785,3578755785,0
1,1393,42831,3578755785,3578755785,0
1,1393,42832,3578755785,3578755785,0
1,1393,42833,3578755785,3578755785,0
1,1393,42834,3578755785,3578755785,0
1,1393,42835,3578755785,3578755785,0
1,1393,42836,3578755785,3578755785,0
1,1393,42837,3578755785,3578755785,0
1,1393,42838,3578755785,3578755785,0
1,1393,42839,3578755785,3578755785,0
1,1393,42840,3578755785,3578755785,0
1,1393,42841,3578755785,3578755786,1
1,1393,42842,3578755785,3578755786,1
1,1393,42843,3578755785,3578755786,1
1,1393,42844,3578755785,3578755786,1
1,1393,42845,3578755785,3578755786,1
1,1393,42846,3578755785,3578755786,1
1,1393,42847,3578755785,3578755789,4
1,1393,42848,3578755785,3578755790,5
1,1393,42849,3578755785,3578755791,6
1,1393,42850,3578755785,3578755792,7
1,1393,42851,3578755785,3578755793,8
1,1393,42852,3578755785,3578755794,9
1,1393,42853,3578755785,3578755796,11
1,1393,42854,3578755785,3578755796,11
1,1393,42855,3578755785,3578755796,11
1,1393,42856,3578755785,3578755796,11
1,1393,42857,3578755785,3578755797,12
1,1393,42858,3578755785,3578755798,13
1,1393,42859,3578755785,3578755798,13
1,1393,42860,3578755785,3578755798,13
1,1393,42861,3578755785,3578755799,14
1,1393,42862,3578755785,3578755800,15
1,1393,42863,3578755785,3578755801,16
1,1393,42864,3578755785,3578755804,19
1,1393,42865,3578755785,3578755806,21
1,1393,42866,3578755785,3578755807,22
1,1393,42867,3578755785,3578755808,23
1,1393,42868,3578755785,3578755812,27
1,1393,42869,3578755785,3578755812,27
1,1393,42870,3578755785,3578755812,27
1,1393,42871,3578755785,3578755812,27
1,1393,42872,3578755785,3578755813,28
1,1393,42873,3578755785,3578755814,29
1,1393,42874,3578755785,3578755815,30
1,1393,42875,3578755785,3578755816,31
1,1393,42876,3578755785,3578755816,31
1,1393,42877,3578755785,3578755817,32
1,1393,42878,3578755785,3578755818,33
1,1393,42879,3578755785,3578755819,34
1,1393,42880,3578755785,3578755820,35
1,1393,42881,3578755785,3578755820,35
1,1393,42882,3578755785,3578755820,35
1,1393,42883,3578755785,3578755820,35
1,1393,42884,3578755785,3578755820,35
1,1393,42885,3578755785,3578755822,37
1,1393,42886,3578755785,3578755823,38
1,1393,42887,3578755785,3578755825,40
1,1393,42888,3578755785,3578755826,41
1,1393,42889,3578755785,3578755828,43
1,1393,42890,3578755785,3578755828,43
1,1393,42891,3578755785,3578755829,44
1,1393,42892,3578755785,3578755829,44
1,1393,42893,3578755785,3578755830,45
1,1393,42894,3578755785,3578755830,45
1,1393,42895,3578755785,3578755830,45
1,1393,42896,3578755785,3578755831,46
1,1393,42897,3578755785,3578755832,47
1,1394,42898,3578755847,3578755847,0
1,1394,42899,3578755847,3578755847,0
1,1394,42900,3578755847,3578755847,0
1,1394,42901,3578755847,3578755847,0
1,1394,42902,3578755847,3578755847,0
1,1394,42903,3578755847,3578755847,0
1,1394,42904,3578755847,3578755847,0
1,1394,42905,3578755847,3578755847,0
1,1394,42906,3578755847,3578755847,0
1,1394,42907,3578755847,3578755847,0
1,1394,42908,3578755847,3578755847,0
1,1394,42909,3578755847,3578755848,1
1,1394,42910,3578755847,3578755848,1
1,1394,42911,3578755847,3578755848,1
1,1394,42912,3578755847,3578755849,2
1,1394,42913,3578755847,3578755852,5
1,1394,42914,3578755847,3578755854,7
1,1394,42915,3578755847,3578755855,8
1,1394,42916,3578755847,3578755858,11
1,1394,42917,3578755847,3578755858,11
1,1394,42918,3578755847,3578755860,13
1,1394,42919,3578755847,3578755861,14
1,1394,42920,3578755847,3578755863,16
1,1394,42921,3578755847,3578755863,16
1,1394,42922,3578755847,3578755864,17
1,1394,42923,3578755847,3578755864,17
1,1394,42924,3578755847,3578755864,17
1,1394,42925,3578755847,3578755867,20
1,1394,42926,3578755847,3578755867,20
1,1394,42927,3578755847,3578755868,21
1,1394,42928,3578755847,3578755877,30
1,1394,42929,3578755847,3578755880,33
1,1394,42930,3578755847,3578755880,33
1,1394,42931,3578755847,3578755882,35
1,1394,42932,3578755847,3578755883,36
1,1394,42933,3578755847,3578755883,36
1,1394,42934,3578755847,3578755884,37
1,1394,42935,3578755847,3578755885,38
1,1394,42936,3578755847,3578755887,40
1,1394,42937,3578755847,3578755888,41
1,1394,42938,3578755847,3578755888,41
1,1394,42939,3578755847,3578755889,42
1,1394,42940,3578755847,3578755889,42
1,1394,42941,3578755847,3578755891,44
1,1394,42942,3578755847,3578755893,46
1,1394,42943,3578755847,3578755893,46
1,1394,42944,3578755847,3578755893,46
1,1394,42945,3578755847,3578755893,46
1,1394,42946,3578755847,3578755895,48
1,1394,42947,3578755847,3578755895,48
1,1394,42948,3578755847,3578755896,49
1,1394,42949,3578755847,3578755896,49
1,1395,42950,3578755908,3578755908,0
1,1395,42951,3578755908,3578755908,0
1,1395,42952,3578755908,3578755908,0
1,1395,42953,3578755908,3578755908,0
1,1395,42954,3578755908,3578755908,0
1,1395,42955,3578755908,3578755908,0
1,1395,42956,3578755908,3578755908,0
1,1395,42957,3578755908,3578755908,0
1,1395,42958,3578755908,3578755908,0
1,1395,42959,3578755908,3578755908,0
1,1395,42960,3578755908,3578755908,0
1,1395,42961,3578755908,3578755908,0
1,1395,42962,3578755908,3578755908,0
1,1395,42963,3578755908,3578755908,0
1,1395,42964,3578755908,3578755909,1
1,1395,42965,3578755908,3578755910,2
1,1395,42966,3578755908,3578755910,2
1,1395,42967,3578755908,3578755910,2
1,1395,42968,3578755908,3578755911,3
1,1395,42969,3578755908,3578755911,3
1,1395,42970,3578755908,3578755911,3
1,1395,42971,3578755908,3578755912,4
1,1395,42972,3578755908,3578755913,5
1,1395,42973,3578755908,3578755914,6
1,1395,42974,3578755908,3578755914,6
1,1395,42975,3578755908,3578755914,6
1,1395,42976,3578755908,3578755914,6
1,1395,42977,3578755908,3578755914,6
1,1395,42978,3578755908,3578755917,9
1,1395,42979,3578755908,3578755917,9
1,1395,42980,3578755908,3578755920,12
1,1395,42981,3578755908,3578755920,12
1,1395,42982,3578755908,3578755922,14
1,1395,42983,3578755908,3578755922,14
1,1395,42984,3578755908,3578755923,15
1,1395,42985,3578755908,3578755924,16
1,1395,42986,3578755908,3578755924,16
1,1395,42987,3578755908,3578755925,17
1,1395,42988,3578755908,3578755925,17
1,1395,42989,3578755908,3578755926,18
1,1395,42990,3578755908,3578755926,18
1,1395,42991,3578755908,3578755926,18
1,1395,42992,3578755908,3578755926,18
1,1395,42993,3578755908,3578755929,21
1,1395,42994,3578755908,3578755929,21
1,1395,42995,3578755908,3578755930,22
1,1395,42996,3578755908,3578755930,22
1,1395,42997,3578755908,3578755931,23
1,1395,42998,3578755908,3578755933,25
1,1395,42999,3578755908,3578755933,25
1,1395,43000,3578755908,3578755933,25
1,1395,43001,3578755908,3578755934,26
1,1395,43002,3578755908,3578755934,26
1,1395,43003,3578755908,3578755935,27
1,1395,43004,3578755908,3578755935,27
1,1395,43005,3578755908,3578755936,28
1,1395,43006,3578755908,3578755937,29
1,1395,43007,3578755908,3578755938,30
1,1395,43008,3578755908,3578755939,31
1,1395,43009,3578755908,3578755939,31
1,1395,43010,3578755908,3578755940,32
1,1395,43011,3578755908,3578755941,33
1,1395,43012,3578755908,3578755946,38
1,1395,43013,3578755908,3578755948,40
1,1395,43014,3578755908,3578755948,40
1,1395,43015,3578755908,3578755949,41
1,1395,43016,3578755908,3578755952,44
1,1395,43017,3578755908,3578755955,47
1,1395,43018,3578755908,3578755958,50
1,1396,43019,3578755971,3578755971,0
1,1396,43020,3578755971,3578755971,0
1,1396,43021,3578755971,3578755971,0
1,1396,43022,3578755971,3578755971,0
1,1396,43023,3578755971,3578755971,0
1,1396,43024,3578755971,3578755971,0
1,1396,43025,3578755971,3578755971,0
1,1396,43026,3578755971,3578755971,0
1,1396,43027,3578755971,3578755971,0
1,1396,43028,3578755971,3578755971,0
1,1396,43029,3578755971,3578755971,0
1,1396,43030,3578755971,3578755971,0
1,1396,43031,3578755971,3578755971,0
1,1396,43032,3578755971,3578755971,0
1,1396,43033,3578755971,3578755971,0
1,1396,43034,3578755971,3578755972,1
1,1396,43035,3578755971,3578755975,4
1,1396,43036,3578755971,3578755976,5
1,1396,43037,3578755971,3578755977,6
1,1396,43038,3578755971,3578755977,6
1,1396,43039,3578755971,3578755978,7
1,1396,43040,3578755971,3578755979,8
1,1396,43041,3578755971,3578755979,8
1,1396,43042,3578755971,3578755980,9
1,1396,43043,3578755971,3578755981,10
1,1396,43044,3578755971,3578755981,10
1,1396,43045,3578755971,3578755981,10
1,1396,43046,3578755971,3578755982,11
1,1396,43047,3578755971,3578755982,11
1,1396,43048,3578755971,3578755982,11
1,1396,43049,3578755971,3578755983,12
1,1396,43050,3578755971,3578755985,14
1,1396,43051,3578755971,3578755985,14
1,1396,43052,3578755971,3578755986,15
1,1396,43053,3578755971,3578755987,16
1,1396,43054,3578755971,3578755988,17
1,1396,43055,3578755971,3578755991,20
1,1396,43056,3578755971,3578755991,20
1,1396,43057,3578755971,3578755993,22
1,1396,43058,3578755971,3578755994,23
1,1396,43059,3578755971,3578755995,24
1,1396,43060,3578755971,3578755996,25
1,1396,43061,3578755971,3578755997,26
1,1396,43062,3578755971,3578755997,26
1,1396,43063,3578755971,3578755997,26
1,1396,43064,3578755971,3578755998,27
1,1396,43065,3578755971,3578755998,27
1,1396,43066,3578755971,3578755999,28
1,1396,43067,3578755971,3578755999,28
1,1396,43068,3578755971,3578755999,28
1,1396,43069,3578755971,3578756001,30
1,1396,43070,3578755971,3578756001,30
1,1396,43071,3578755971,3578756007,36
1,1396,43072,3578755971,3578756009,38
1,1396,43073,3578755971,3578756012,41
1,1396,43074,3578755971,3578756012,41
1,1396,43075,3578755971,3578756013,42
1,1396,43076,3578755971,3578756013,42
1,1396,43077,3578755971,3578756013,42
1,1396,43078,3578755971,3578756015,44
1,1396,43079,3578755971,3578756016,45
1,1396,43080,3578755971,3578756017,46
1,1396,43081,3578755971,3578756017,46
1,1396,43082,3578755971,3578756017,46
1,1396,43083,3578755971,3578756019,48
1,1396,43084,3578755971,3578756019,48
1,1396,43085,3578755971,3578756020,49
1,1396,43086,3578755971,3578756020,49
1,1396,43087,3578755971,3578756020,49
1,1396,43088,3578755971,3578756021,50
1,1397,43089,3578756035,3578756035,0
1,1397,43090,3578756035,3578756035,0
1,1397,43091,3578756035,3578756035,0
1,1397,43092,3578756035,3578756035,0
1,1397,43093,3578756035,3578756035,0
1,1397,43094,3578756035,3578756035,0
1,1397,43095,3578756035,3578756035,0
1,1397,43096,3578756035,3578756035,0
1,1397,43097,3578756035,3578756035,0
1,1397,43098,3578756035,3578756035,0
1,1397,43099,3578756035,3578756035,0
1,1397,43100,3578756035,3578756035,0
1,1397,43101,3578756035,3578756035,0
1,1397,43102,3578756035,3578756035,0
1,1397,43103,3578756035,3578756035,0
1,1397,43104,3578756035,3578756035,0
1,1397,43105,3578756035,3578756037,2
1,1397,43106,3578756035,3578756038,3
1,1397,43107,3578756035,3578756039,4
1,1397,43108,3578756035,3578756039,4
1,1397,43109,3578756035,3578756041,6
1,1397,43110,3578756035,3578756043,8
1,1397,43111,3578756035,3578756045,10
1,1397,43112,3578756035,3578756047,12
1,1397,43113,3578756035,3578756048,13
1,1397,43114,3578756035,3578756049,14
1,1397,43115,3578756035,3578756050,15
1,1397,43116,3578756035,3578756052,17
1,1397,43117,3578756035,3578756054,19
1,1397,43118,3578756035,3578756055,20
1,1397,43119,3578756035,3578756058,23
1,1397,43120,3578756035,3578756059,24
1,1397,43121,3578756035,3578756059,24
1,1397,43122,3578756035,3578756061,26
1,1397,43123,3578756035,3578756062,27
1,1397,43124,3578756035,3578756063,28
1,1397,43125,3578756035,3578756065,30
1,1397,43126,3578756035,3578756065,30
1,1397,43127,3578756035,3578756065,30
1,1397,43128,3578756035,3578756067,32
1,1397,43129,3578756035,3578756067,32
1,1397,43130,3578756035,3578756068,33
1,1397,43131,3578756035,3578756068,33
1,1397,43132,3578756035,3578756080,45
1,1397,43133,3578756035,3578756081,46
1,1397,43134,3578756035,3578756083,48
1,1397,43135,3578756035,3578756083,48
1,1397,43136,3578756035,3578756083,48
1,1397,43137,3578756035,3578756085,50
1,1398,43138,3578756100,3578756100,0
1,1398,43139,3578756100,3578756100,0
1,1398,43140,3578756100,3578756100,0
1,1398,43141,3578756100,3578756100,0
1,1398,43142,3578756100,3578756100,0
1,1398,43143,3578756100,3578756100,0
1,1398,43144,3578756100,3578756100,0
1,1398,43145,3578756100,3578756100,0
1,1398,43146,3578756100,3578756100,0
1,1398,43147,3578756100,3578756100,0
1,1398,43148,3578756100,3578756100,0
1,1398,43149,3578756100,3578756100,0
1,1398,43150,3578756100,3578756100,0
1,1398,43151,3578756100,3578756100,0
1,1398,43152,3578756100,3578756100,0
1,1398,43153,3578756100,3578756102,2
1,1398,43154,3578756100,3578756103,3
1,1398,43155,3578756100,3578756104,4
1,1398,43156,3578756100,3578756105,5
1,1398,43157,3578756100,3578756105,5
1,1398,43158,3578756100,3578756105,5
1,1398,43159,3578756100,3578756105,5
1,1398,43160,3578756100,3578756107,7
1,1398,43161,3578756100,3578756108,8
1,1398,43162,3578756100,3578756108,8
1,1398,43163,3578756100,3578756108,8
1,1398,43164,3578756100,3578756110,10
1,1398,43165,3578756100,3578756110,10
1,1398,43166,3578756100,3578756110,10
1,1398,43167,3578756100,3578756110,10
1,1398,43168,3578756100,3578756110,10
1,1398,43169,3578756100,3578756111,11
1,1398,43170,3578756100,3578756112,12
1,1398,43171,3578756100,3578756112,12
1,1398,43172,3578756100,3578756112,12
1,1398,43173,3578756100,3578756113,13
1,1398,43174,3578756100,3578756113,13
1,1398,43175,3578756100,3578756114,14
1,1398,43176,3578756100,3578756114,14
1,1398,43177,3578756100,3578756114,14
1,1398,43178,3578756100,3578756114,14
1,1398,43179,3578756100,3578756115,15
1,1398,43180,3578756100,3578756117,17
1,1398,43181,3578756100,3578756118,18
1,1398,43182,3578756100,3578756121,21
1,1398,43183,3578756100,3578756121,21
1,1398,43184,3578756100,3578756121,21
1,1398,43185,3578756100,3578756123,23
1,1398,43186,3578756100,3578756123,23
1,1398,43187,3578756100,3578756124,24
1,1398,43188,3578756100,3578756124,24
1,1398,43189,3578756100,3578756125,25
1,1398,43190,3578756100,3578756125,25
1,1398,43191,3578756100,3578756126,26
1,1398,43192,3578756100,3578756126,26
1,1398,43193,3578756100,3578756127,27
1,1398,43194,3578756100,3578756127,27
1,1398,43195,3578756100,3578756128,28
1,1398,43196,3578756100,3578756129,29
1,1398,43197,3578756100,3578756130,30
1,1398,43198,3578756100,3578756130,30
1,1398,43199,3578756100,3578756131,31
1,1398,43200,3578756100,3578756131,31
1,1398,43201,3578756100,3578756132,32
1,1398,43202,3578756100,3578756133,33
1,1398,43203,3578756100,3578756133,33
1,1398,43204,3578756100,3578756134,34
1,1398,43205,3578756100,3578756134,34
1,1398,43206,3578756100,3578756135,35
1,1398,43207,3578756100,3578756135,35
1,1398,43208,3578756100,3578756137,37
1,1398,43209,3578756100,3578756138,38
1,1398,43210,3578756100,3578756138,38
1,1398,43211,3578756100,3578756139,39
1,1398,43212,3578756100,3578756139,39
1,1398,43213,3578756100,3578756140,40
1,1398,43214,3578756100,3578756141,41
1,1398,43215,3578756100,3578756142,42
1,1398,43216,3578756100,3578756143,43
1,1398,43217,3578756100,3578756146,46
1,1398,43218,3578756100,3578756148,48
1,1398,43219,3578756100,3578756148,48
1,1398,43220,3578756100,3578756150,50
1,1399,43221,3578756163,3578756163,0
1,1399,43222,3578756163,3578756163,0
1,1399,43223,3578756163,3578756163,0
1,1399,43224,3578756163,3578756163,0
1,1399,43225,3578756163,3578756163,0
1,1399,43226,3578756163,3578756163,0
1,1399,43227,3578756163,3578756163,0
1,1399,43228,3578756163,3578756163,0
1,1399,43229,3578756163,3578756163,0
1,1399,43230,3578756163,3578756164,1
1,1399,43231,3578756163,3578756164,1
1,1399,43232,3578756163,3578756165,2
1,1399,43233,3578756163,3578756166,3
1,1399,43234,3578756163,3578756166,3
1,1399,43235,3578756163,3578756166,3
1,1399,43236,3578756163,3578756167,4
1,1399,43237,3578756163,3578756168,5
1,1399,43238,3578756163,3578756169,6
1,1399,43239,3578756163,3578756171,8
1,1399,43240,3578756163,3578756171,8
1,1399,43241,3578756163,3578756172,9
1,1399,43242,3578756163,3578756175,12
1,1399,43243,3578756163,3578756176,13
1,1399,43244,3578756163,3578756178,15
1,1399,43245,3578756163,3578756178,15
1,1399,43246,3578756163,3578756179,16
1,1399,43247,3578756163,3578756179,16
1,1399,43248,3578756163,3578756179,16
1,1399,43249,3578756163,3578756180,17
1,1399,43250,3578756163,3578756181,18
1,1399,43251,3578756163,3578756181,18
1,1399,43252,3578756163,3578756181,18
1,1399,43253,3578756163,3578756182,19
1,1399,43254,3578756163,3578756182,19
1,1399,43255,3578756163,3578756183,20
1,1399,43256,3578756163,3578756184,21
1,1399,43257,3578756163,3578756186,23
1,1399,43258,3578756163,3578756186,23
1,1399,43259,3578756163,3578756186,23
1,1399,43260,3578756163,3578756189,26
1,1399,43261,3578756163,3578756191,28
1,1399,43262,3578756163,3578756191,28
1,1399,43263,3578756163,3578756193,30
1,1399,43264,3578756163,3578756195,32
1,1399,43265,3578756163,3578756196,33
1,1399,43266,3578756163,3578756197,34
1,1399,43267,3578756163,3578756197,34
1,1399,43268,3578756163,3578756197,34
1,1399,43269,3578756163,3578756198,35
1,1399,43270,3578756163,3578756199,36
1,1399,43271,3578756163,3578756199,36
1,1399,43272,3578756163,3578756200,37
1,1399,43273,3578756163,3578756201,38
1,1399,43274,3578756163,3578756202,39
1,1399,43275,3578756163,3578756204,41
1,1399,43276,3578756163,3578756206,43
1,1399,43277,3578756163,3578756207,44
1,1399,43278,3578756163,3578756208,45
1,1399,43279,3578756163,3578756211,48
1,1399,43280,3578756163,3578756212,49
1,1399,43281,3578756163,3578756212,49
1,1399,43282,3578756163,3578756213,50
1,1400,43283,3578756226,3578756226,0
1,1400,43284,3578756226,3578756226,0
1,1400,43285,3578756226,3578756226,0
1,1400,43286,3578756226,3578756226,0
1,1400,43287,3578756226,3578756226,0
1,1400,43288,3578756226,3578756226,0
1,1400,43289,3578756226,3578756226,0
1,1400,43290,3578756226,3578756226,0
1,1400,43291,3578756226,3578756226,0
1,1400,43292,3578756226,3578756226,0
1,1400,43293,3578756226,3578756226,0
1,1400,43294,3578756226,3578756226,0
1,1400,43295,3578756226,3578756226,0
1,1400,43296,3578756226,3578756226,0
1,1400,43297,3578756226,3578756226,0
1,1400,43298,3578756226,3578756226,0
1,1400,43299,3578756226,3578756226,0
1,1400,43300,3578756226,3578756228,2
1,1400,43301,3578756226,3578756228,2
1,1400,43302,3578756226,3578756230,4
1,1400,43303,3578756226,3578756230,4
1,1400,43304,3578756226,3578756230,4
1,1400,43305,3578756226,3578756231,5
1,1400,43306,3578756226,3578756231,5
1,1400,43307,3578756226,3578756231,5
1,1400,43308,3578756226,3578756235,9
1,1400,43309,3578756226,3578756236,10
1,1400,43310,3578756226,3578756236,10
1,1400,43311,3578756226,3578756237,11
1,1400,43312,3578756226,3578756237,11
1,1400,43313,3578756226,3578756239,13
1,1400,43314,3578756226,3578756239,13
1,1400,43315,3578756226,3578756242,16
1,1400,43316,3578756226,3578756243,17
1,1400,43317,3578756226,3578756245,19
1,1400,43318,3578756226,3578756247,21
1,1400,43319,3578756226,3578756248,22
1,1400,43320,3578756226,3578756249,23
1,1400,43321,3578756226,3578756250,24
1,1400,43322,3578756226,3578756252,26
1,1400,43323,3578756226,3578756253,27
1,1400,43324,3578756226,3578756255,29
1,1400,43325,3578756226,3578756255,29
1,1400,43326,3578756226,3578756258,32
1,1400,43327,3578756226,3578756259,33
1,1400,43328,3578756226,3578756259,33
1,1400,43329,3578756226,3578756260,34
1,1400,43330,3578756226,3578756263,37
1,1400,43331,3578756226,3578756263,37
1,1400,43332,3578756226,3578756264,38
1,1400,43333,3578756226,3578756265,39
1,1400,43334,3578756226,3578756265,39
1,1400,43335,3578756226,3578756267,41
1,1400,43336,3578756226,3578756268,42
1,1400,43337,3578756226,3578756268,42
1,1400,43338,3578756226,3578756269,43
1,1401,43339,3578756289,3578756289,0
1,1401,43340,3578756289,3578756289,0
1,1401,43341,3578756289,3578756289,0
1,1401,43342,3578756289,3578756289,0
1,1401,43343,3578756289,3578756289,0
1,1401,43344,3578756289,3578756289,0
1,1401,43345,3578756289,3578756289,0
1,1401,43346,3578756289,3578756289,0
1,1401,43347,3578756289,3578756289,0
1,1401,43348,3578756289,3578756291,2
1,1401,43349,3578756289,3578756291,2
1,1401,43350,3578756289,3578756292,3
1,1401,43351,3578756289,3578756293,4
1,1401,43352,3578756289,3578756293,4
1,1401,43353,3578756289,3578756293,4
1,1401,43354,3578756289,3578756294,5
1,1401,43355,3578756289,3578756295,6
1,1401,43356,3578756289,3578756295,6
1,1401,43357,3578756289,3578756296,7
1,1401,43358,3578756289,3578756297,8
1,1401,43359,3578756289,3578756298,9
1,1401,43360,3578756289,3578756299,10
1,1401,43361,3578756289,3578756302,13
1,1401,43362,3578756289,3578756303,14
1,1401,43363,3578756289,3578756304,15
1,1401,43364,3578756289,3578756304,15
1,1401,43365,3578756289,3578756305,16
1,1401,43366,3578756289,3578756305,16
1,1401,43367,3578756289,3578756308,19
1,1401,43368,3578756289,3578756308,19
1,1401,43369,3578756289,3578756309,20
1,1401,43370,3578756289,3578756309,20
1,1401,43371,3578756289,3578756310,21
1,1401,43372,3578756289,3578756310,21
1,1401,43373,3578756289,3578756310,21
1,1401,43374,3578756289,3578756311,22
1,1401,43375,3578756289,3578756311,22
1,1401,43376,3578756289,3578756311,22
1,1401,43377,3578756289,3578756312,23
1,1401,43378,3578756289,3578756312,23
1,1401,43379,3578756289,3578756313,24
1,1401,43380,3578756289,3578756313,24
1,1401,43381,3578756289,3578756314,25
1,1401,43382,3578756289,3578756314,25
1,1401,43383,3578756289,3578756315,26
1,1401,43384,3578756289,3578756315,26
1,1401,43385,3578756289,3578756317,28
1,1401,43386,3578756289,3578756319,30
1,1401,43387,3578756289,3578756320,31
1,1401,43388,3578756289,3578756321,32
1,1401,43389,3578756289,3578756322,33
1,1401,43390,3578756289,3578756323,34
1,1401,43391,3578756289,3578756323,34
1,1401,43392,3578756289,3578756324,35
1,1401,43393,3578756289,3578756324,35
1,1401,43394,3578756289,3578756325,36
1,1401,43395,3578756289,3578756326,37
1,1401,43396,3578756289,3578756326,37
1,1401,43397,3578756289,3578756327,38
1,1401,43398,3578756289,3578756327,38
1,1401,43399,3578756289,3578756330,41
1,1401,43400,3578756289,3578756331,42
1,1401,43401,3578756289,3578756331,42
1,1401,43402,3578756289,3578756331,42
1,1401,43403,3578756289,3578756333,44
1,1401,43404,3578756289,3578756333,44
1,1401,43405,3578756289,3578756333,44
1,1401,43406,3578756289,3578756334,45
1,1401,43407,3578756289,3578756334,45
1,1401,43408,3578756289,3578756335,46
1,1401,43409,3578756289,3578756335,46
1,1401,43410,3578756289,3578756336,47
1,1401,43411,3578756289,3578756338,49
1,1401,43412,3578756289,3578756338,49
1,1401,43413,3578756289,3578756338,49
1,1401,43414,3578756289,3578756338,49
1,1401,43415,3578756289,3578756339,50
1,1402,43416,3578756350,3578756350,0
1,1402,43417,3578756350,3578756350,0
1,1402,43418,3578756350,3578756350,0
1,1402,43419,3578756350,3578756350,0
1,1402,43420,3578756350,3578756350,0
1,1402,43421,3578756350,3578756350,0
1,1402,43422,3578756350,3578756350,0
1,1402,43423,3578756350,3578756350,0
1,1402,43424,3578756350,3578756352,2
1,1402,43425,3578756350,3578756355,5
1,1402,43426,3578756350,3578756356,6
1,1402,43427,3578756350,3578756358,8
1,1402,43428,3578756350,3578756359,9
1,1402,43429,3578756350,3578756360,10
1,1402,43430,3578756350,3578756362,12
1,1402,43431,3578756350,3578756363,13
1,1402,43432,3578756350,3578756364,14
1,1402,43433,3578756350,3578756364,14
1,1402,43434,3578756350,3578756364,14
1,1402,43435,3578756350,3578756365,15
1,1402,43436,3578756350,3578756366,16
1,1402,43437,3578756350,3578756366,16
1,1402,43438,3578756350,3578756367,17
1,1402,43439,3578756350,3578756368,18
1,1402,43440,3578756350,3578756369,19
1,1402,43441,3578756350,3578756370,20
1,1402,43442,3578756350,3578756371,21
1,1402,43443,3578756350,3578756371,21
1,1402,43444,3578756350,3578756371,21
1,1402,43445,3578756350,3578756376,26
1,1402,43446,3578756350,3578756377,27
1,1402,43447,3578756350,3578756378,28
1,1402,43448,3578756350,3578756379,29
1,1402,43449,3578756350,3578756379,29
1,1402,43450,3578756350,3578756379,29
1,1402,43451,3578756350,3578756380,30
1,1402,43452,3578756350,3578756381,31
1,1402,43453,3578756350,3578756381,31
1,1402,43454,3578756350,3578756381,31
1,1402,43455,3578756350,3578756382,32
1,1402,43456,3578756350,3578756382,32
1,1402,43457,3578756350,3578756383,33
1,1402,43458,3578756350,3578756383,33
1,1402,43459,3578756350,3578756384,34
1,1402,43460,3578756350,3578756384,34
1,1402,43461,3578756350,3578756386,36
1,1402,43462,3578756350,3578756387,37
1,1402,43463,3578756350,3578756387,37
1,1402,43464,3578756350,3578756389,39
1,1402,43465,3578756350,3578756391,41
1,1402,43466,3578756350,3578756392,42
1,1402,43467,3578756350,3578756394,44
1,1402,43468,3578756350,3578756394,44
1,1402,43469,3578756350,3578756396,46
1,1402,43470,3578756350,3578756397,47
1,1402,43471,3578756350,3578756397,47
1,1402,43472,3578756350,3578756397,47
1,1402,43473,3578756350,3578756398,48
1,1402,43474,3578756350,3578756399,49
1,1402,43475,3578756350,3578756399,49
1,1402,43476,3578756350,3578756399,49
1,1402,43477,3578756350,3578756400,50
1,1403,43478,3578756413,3578756413,0
1,1403,43479,3578756413,3578756413,0
1,1403,43480,3578756413,3578756413,0
1,1403,43481,3578756413,3578756413,0
1,1403,43482,3578756413,3578756413,0
1,1403,43483,3578756413,3578756413,0
1,1403,43484,3578756413,3578756413,0
1,1403,43485,3578756413,3578756413,0
1,1403,43486,3578756413,3578756413,0
1,1403,43487,3578756413,3578756414,1
1,1403,43488,3578756413,3578756414,1
1,1403,43489,3578756413,3578756415,2
1,1403,43490,3578756413,3578756417,4
1,1403,43491,3578756413,3578756417,4
1,1403,43492,3578756413,3578756417,4
1,1403,43493,3578756413,3578756418,5
1,1403,43494,3578756413,3578756419,6
1,1403,43495,3578756413,3578756420,7
1,1403,43496,3578756413,3578756420,7
1,1403,43497,3578756413,3578756420,7
1,1403,43498,3578756413,3578756420,7
1,1403,43499,3578756413,3578756420,7
1,1403,43500,3578756413,3578756422,9
1,1403,43501,3578756413,3578756422,9
1,1403,43502,3578756413,3578756422,9
1,1403,43503,3578756413,3578756423,10
1,1403,43504,3578756413,3578756424,11
1,1403,43505,3578756413,3578756428,15
1,1403,43506,3578756413,3578756429,16
1,1403,43507,3578756413,3578756430,17
1,1403,43508,3578756413,3578756430,17
1,1403,43509,3578756413,3578756430,17
1,1403,43510,3578756413,3578756431,18
1,1403,43511,3578756413,3578756431,18
1,1403,43512,3578756413,3578756432,19
1,1403,43513,3578756413,3578756432,19
1,1403,43514,3578756413,3578756435,22
1,1403,43515,3578756413,3578756435,22
1,1403,43516,3578756413,3578756435,22
1,1403,43517,3578756413,3578756437,24
1,1403,43518,3578756413,3578756437,24
1,1403,43519,3578756413,3578756439,26
1,1403,43520,3578756413,3578756440,27
1,1403,43521,3578756413,3578756442,29
1,1403,43522,3578756413,3578756442,29
1,1403,43523,3578756413,3578756447,34
1,1403,43524,3578756413,3578756448,35
1,1403,43525,3578756413,3578756448,35
1,1403,43526,3578756413,3578756450,37
1,1403,43527,3578756413,3578756452,39
1,1403,43528,3578756413,3578756454,41
1,1403,43529,3578756413,3578756455,42
1,1403,43530,3578756413,3578756457,44
1,1403,43531,3578756413,3578756460,47
1,1403,43532,3578756413,3578756462,49
1,1404,43533,3578756475,3578756475,0
1,1404,43534,3578756475,3578756475,0
1,1404,43535,3578756475,3578756475,0
1,1404,43536,3578756475,3578756475,0
1,1404,43537,3578756475,3578756475,0
1,1404,43538,3578756475,3578756476,1
1,1404,43539,3578756475,3578756476,1
1,1404,43540,3578756475,3578756476,1
1,1404,43541,3578756475,3578756477,2
1,1404,43542,3578756475,3578756480,5
1,1404,43543,3578756475,3578756480,5
1,1404,43544,3578756475,3578756482,7
1,1404,43545,3578756475,3578756483,8
1,1404,43546,3578756475,3578756483,8
1,1404,43547,3578756475,3578756484,9
1,1404,43548,3578756475,3578756485,10
1,1404,43549,3578756475,3578756487,12
1,1404,43550,3578756475,3578756488,13
1,1404,43551,3578756475,3578756491,16
1,1404,43552,3578756475,3578756491,16
1,1404,43553,3578756475,3578756492,17
1,1404,43554,3578756475,3578756492,17
1,1404,43555,3578756475,3578756493,18
1,1404,43556,3578756475,3578756493,18
1,1404,43557,3578756475,3578756494,19
1,1404,43558,3578756475,3578756495,20
1,1404,43559,3578756475,3578756495,20
1,1404,43560,3578756475,3578756496,21
1,1404,43561,3578756475,3578756498,23
1,1404,43562,3578756475,3578756498,23
1,1404,43563,3578756475,3578756502,27
1,1404,43564,3578756475,3578756503,28
1,1404,43565,3578756475,3578756504,29
1,1404,43566,3578756475,3578756504,29
1,1404,43567,3578756475,3578756505,30
1,1404,43568,3578756475,3578756505,30
1,1404,43569,3578756475,3578756505,30
1,1404,43570,3578756475,3578756506,31
1,1404,43571,3578756475,3578756506,31
1,1404,43572,3578756475,3578756508,33
1,1404,43573,3578756475,3578756509,34
1,1404,43574,3578756475,3578756509,34
1,1404,43575,3578756475,3578756510,35
1,1404,43576,3578756475,3578756510,35
1,1404,43577,3578756475,3578756511,36
1,1404,43578,3578756475,3578756511,36
1,1404,43579,3578756475,3578756511,36
1,1404,43580,3578756475,3578756512,37
1,1404,43581,3578756475,3578756512,37
1,1404,43582,3578756475,3578756512,37
1,1404,43583,3578756475,3578756513,38
1,1404,43584,3578756475,3578756514,39
1,1404,43585,3578756475,3578756514,39
1,1404,43586,3578756475,3578756514,39
1,1404,43587,3578756475,3578756516,41
1,1404,43588,3578756475,3578756516,41
1,1404,43589,3578756475,3578756517,42
1,1404,43590,3578756475,3578756519,44
1,1404,43591,3578756475,3578756521,46
1,1404,43592,3578756475,3578756521,46
1,1404,43593,3578756475,3578756521,46
1,1404,43594,3578756475,3578756523,48
1,1404,43595,3578756475,3578756524,49
1,1404,43596,3578756475,3578756524,49
1,1404,43597,3578756475,3578756525,50
1,1405,43598,3578756539,3578756539,0
1,1405,43599,3578756539,3578756539,0
1,1405,43600,3578756539,3578756539,0
1,1405,43601,3578756539,3578756539,0
1,1405,43602,3578756539,3578756539,0
1,1405,43603,3578756539,3578756539,0
1,1405,43604,3578756539,3578756539,0
1,1405,43605,3578756539,3578756539,0
1,1405,43606,3578756539,3578756539,0
1,1405,43607,3578756539,3578756539,0
1,1405,43608,3578756539,3578756539,0
1,1405,43609,3578756539,3578756539,0
1,1405,43610,3578756539,3578756539,0
1,1405,43611,3578756539,3578756539,0
1,1405,43612,3578756539,3578756539,0
1,1405,43613,3578756539,3578756539,0
1,1405,43614,3578756539,3578756539,0
1,1405,43615,3578756539,3578756539,0
1,1405,43616,3578756539,3578756539,0
1,1405,43617,3578756539,3578756539,0
1,1405,43618,3578756539,3578756539,0
1,1405,43619,3578756539,3578756539,0
1,1405,43620,3578756539,3578756539,0
1,1405,43621,3578756539,3578756539,0
1,1405,43622,3578756539,3578756540,1
1,1405,43623,3578756539,3578756540,1
1,1405,43624,3578756539,3578756541,2
1,1405,43625,3578756539,3578756542,3
1,1405,43626,3578756539,3578756546,7
1,1405,43627,3578756539,3578756546,7
1,1405,43628,3578756539,3578756547,8
1,1405,43629,3578756539,3578756548,9
1,1405,43630,3578756539,3578756549,10
1,1405,43631,3578756539,3578756552,13
1,1405,43632,3578756539,3578756555,16
1,1405,43633,3578756539,3578756555,16
1,1405,43634,3578756539,3578756556,17
1,1405,43635,3578756539,3578756557,18
1,1405,43636,3578756539,3578756558,19
1,1405,43637,3578756539,3578756559,20
1,1405,43638,3578756539,3578756561,22
1,1405,43639,3578756539,3578756562,23
1,1405,43640,3578756539,3578756563,24
1,1405,43641,3578756539,3578756563,24
1,1405,43642,3578756539,3578756563,24
1,1405,43643,3578756539,3578756564,25
1,1405,43644,3578756539,3578756565,26
1,1405,43645,3578756539,3578756566,27
1,1405,43646,3578756539,3578756566,27
1,1405,43647,3578756539,3578756567,28
1,1405,43648,3578756539,3578756567,28
1,1405,43649,3578756539,3578756568,29
1,1405,43650,3578756539,3578756571,32
1,1405,43651,3578756539,3578756571,32
1,1405,43652,3578756539,3578756572,33
1,1405,43653,3578756539,3578756574,35
1,1405,43654,3578756539,3578756575,36
1,1405,43655,3578756539,3578756577,38
1,1405,43656,3578756539,3578756578,39
1,1405,43657,3578756539,3578756578,39
1,1405,43658,3578756539,3578756578,39
1,1405,43659,3578756539,3578756579,40
1,1405,43660,3578756539,3578756580,41
1,1405,43661,3578756539,3578756580,41
1,1405,43662,3578756539,3578756580,41
1,1405,43663,3578756539,3578756581,42
1,1405,43664,3578756539,3578756581,42
1,1405,43665,3578756539,3578756581,42
1,1405,43666,3578756539,3578756582,43
1,1405,43667,3578756539,3578756583,44
1,1405,43668,3578756539,3578756583,44
1,1405,43669,3578756539,3578756585,46
1,1405,43670,3578756539,3578756585,46
1,1405,43671,3578756539,3578756586,47
1,1405,43672,3578756539,3578756588,49
1,1406,43673,3578756601,3578756601,0
1,1406,43674,3578756601,3578756601,0
1,1406,43675,3578756601,3578756601,0
1,1406,43676,3578756601,3578756601,0
1,1406,43677,3578756601,3578756601,0
1,1406,43678,3578756601,3578756601,0
1,1406,43679,3578756601,3578756601,0
1,1406,43680,3578756601,3578756601,0
1,1406,43681,3578756601,3578756601,0
1,1406,43682,3578756601,3578756601,0
1,1406,43683,3578756601,3578756601,0
1,1406,43684,3578756601,3578756601,0
1,1406,43685,3578756601,3578756601,0
1,1406,43686,3578756601,3578756601,0
1,1406,43687,3578756601,3578756601,0
1,1406,43688,3578756601,3578756602,1
1,1406,43689,3578756601,3578756603,2
1,1406,43690,3578756601,3578756604,3
1,1406,43691,3578756601,3578756606,5
1,1406,43692,3578756601,3578756609,8
1,1406,43693,3578756601,3578756610,9
1,1406,43694,3578756601,3578756611,10
1,1406,43695,3578756601,3578756612,11
1,1406,43696,3578756601,3578756612,11
1,1406,43697,3578756601,3578756614,13
1,1406,43698,3578756601,3578756616,15
1,1406,43699,3578756601,3578756617,16
1,1406,43700,3578756601,3578756617,16
1,1406,43701,3578756601,3578756619,18
1,1406,43702,3578756601,3578756619,18
1,1406,43703,3578756601,3578756619,18
1,1406,43704,3578756601,3578756620,19
1,1406,43705,3578756601,3578756620,19
1,1406,43706,3578756601,3578756621,20
1,1406,43707,3578756601,3578756622,21
1,1406,43708,3578756601,3578756622,21
1,1406,43709,3578756601,3578756623,22
1,1406,43710,3578756601,3578756625,24
1,1406,43711,3578756601,3578756626,25
1,1406,43712,3578756601,3578756628,27
1,1406,43713,3578756601,3578756628,27
1,1406,43714,3578756601,3578756629,28
1,1406,43715,3578756601,3578756629,28
1,1406,43716,3578756601,3578756629,28
1,1406,43717,3578756601,3578756630,29
1,1406,43718,3578756601,3578756630,29
1,1406,43719,3578756601,3578756631,30
1,1406,43720,3578756601,3578756631,30
1,1406,43721,3578756601,3578756634,33
1,1406,43722,3578756601,3578756635,34
1,1406,43723,3578756601,3578756636,35
1,1406,43724,3578756601,3578756637,36
1,1406,43725,3578756601,3578756639,38
1,1406,43726,3578756601,3578756640,39
1,1406,43727,3578756601,3578756641,40
1,1406,43728,3578756601,3578756646,45
1,1406,43729,3578756601,3578756647,46
1,1406,43730,3578756601,3578756648,47
1,1406,43731,3578756601,3578756649,48
1,1406,43732,3578756601,3578756651,50
1,1407,43733,3578756663,3578756663,0
1,1407,43734,3578756663,3578756663,0
1,1407,43735,3578756663,3578756663,0
1,1407,43736,3578756663,3578756663,0
1,1407,43737,3578756663,3578756663,0
1,1407,43738,3578756663,3578756663,0
1,1407,43739,3578756663,3578756663,0
1,1407,43740,3578756663,3578756663,0
1,1407,43741,3578756663,3578756663,0
1,1407,43742,3578756663,3578756663,0
1,1407,43743,3578756663,3578756664,1
1,1407,43744,3578756663,3578756664,1
1,1407,43745,3578756663,3578756667,4
1,1407,43746,3578756663,3578756668,5
1,1407,43747,3578756663,3578756678,15
1,1407,43748,3578756663,3578756680,17
1,1407,43749,3578756663,3578756680,17
1,1407,43750,3578756663,3578756683,20
1,1407,43751,3578756663,3578756684,21
1,1407,43752,3578756663,3578756684,21
1,1407,43753,3578756663,3578756684,21
1,1407,43754,3578756663,3578756685,22
1,1407,43755,3578756663,3578756687,24
1,1407,43756,3578756663,3578756687,24
1,1407,43757,3578756663,3578756689,26
1,1407,43758,3578756663,3578756689,26
1,1407,43759,3578756663,3578756691,28
1,1407,43760,3578756663,3578756692,29
1,1407,43761,3578756663,3578756693,30
1,1407,43762,3578756663,3578756693,30
1,1407,43763,3578756663,3578756693,30
1,1407,43764,3578756663,3578756694,31
1,1407,43765,3578756663,3578756695,32
1,1407,43766,3578756663,3578756695,32
1,1407,43767,3578756663,3578756695,32
1,1407,43768,3578756663,3578756697,34
1,1407,43769,3578756663,3578756698,35
1,1407,43770,3578756663,3578756698,35
1,1407,43771,3578756663,3578756702,39
1,1407,43772,3578756663,3578756702,39
1,1407,43773,3578756663,3578756703,40
1,1407,43774,3578756663,3578756704,41
1,1407,43775,3578756663,3578756704,41
1,1407,43776,3578756663,3578756705,42
1,1407,43777,3578756663,3578756705,42
1,1407,43778,3578756663,3578756705,42
1,1407,43779,3578756663,3578756706,43
1,1407,43780,3578756663,3578756706,43
1,1407,43781,3578756663,3578756709,46
1,1407,43782,3578756663,3578756709,46
1,1407,43783,3578756663,3578756710,47
1,1407,43784,3578756663,3578756710,47
1,1407,43785,3578756663,3578756711,48
1,1407,43786,3578756663,3578756711,48
1,1407,43787,3578756663,3578756712,49
1,1407,43788,3578756663,3578756712,49
1,1407,43789,3578756663,3578756712,49
1,1407,43790,3578756663,3578756712,49
1,1407,43791,3578756663,3578756713,50
1,1408,43792,3578756726,3578756726,0
1,1408,43793,3578756726,3578756726,0
1,1408,43794,3578756726,3578756726,0
1,1408,43795,3578756726,3578756726,0
1,1408,43796,3578756726,3578756726,0
1,1408,43797,3578756726,3578756726,0
1,1408,43798,3578756726,3578756726,0
1,1408,43799,3578756726,3578756726,0
1,1408,43800,3578756726,3578756726,0
1,1408,43801,3578756726,3578756726,0
1,1408,43802,3578756726,3578756726,0
1,1408,43803,3578756726,3578756726,0
1,1408,43804,3578756726,3578756726,0
1,1408,43805,3578756726,3578756726,0
1,1408,43806,3578756726,3578756727,1
1,1408,43807,3578756726,3578756727,1
1,1408,43808,3578756726,3578756727,1
1,1408,43809,3578756726,3578756728,2
1,1408,43810,3578756726,3578756728,2
1,1408,43811,3578756726,3578756729,3
1,1408,43812,3578756726,3578756730,4
1,1408,43813,3578756726,3578756731,5
1,1408,43814,3578756726,3578756731,5
1,1408,43815,3578756726,3578756732,6
1,1408,43816,3578756726,3578756733,7
1,1408,43817,3578756726,3578756733,7
1,1408,43818,3578756726,3578756733,7
1,1408,43819,3578756726,3578756733,7
1,1408,43820,3578756726,3578756733,7
1,1408,43821,3578756726,3578756734,8
1,1408,43822,3578756726,3578756735,9
1,1408,43823,3578756726,3578756736,10
1,1408,43824,3578756726,3578756738,12
1,1408,43825,3578756726,3578756738,12
1,1408,43826,3578756726,3578756738,12
1,1408,43827,3578756726,3578756739,13
1,1408,43828,3578756726,3578756740,14
1,1408,43829,3578756726,3578756741,15
1,1408,43830,3578756726,3578756742,16
1,1408,43831,3578756726,3578756742,16
1,1408,43832,3578756726,3578756746,20
1,1408,43833,3578756726,3578756746,20
1,1408,43834,3578756726,3578756747,21
1,1408,43835,3578756726,3578756749,23
1,1408,43836,3578756726,3578756752,26
1,1408,43837,3578756726,3578756755,29
1,1408,43838,3578756726,3578756756,30
1,1408,43839,3578756726,3578756757,31
1,1408,43840,3578756726,3578756758,32
1,1408,43841,3578756726,3578756758,32
1,1408,43842,3578756726,3578756759,33
1,1408,43843,3578756726,3578756763,37
1,1408,43844,3578756726,3578756763,37
1,1408,43845,3578756726,3578756763,37
1,1408,43846,3578756726,3578756764,38
1,1408,43847,3578756726,3578756765,39
1,1408,43848,3578756726,3578756765,39
1,1408,43849,3578756726,3578756766,40
1,1408,43850,3578756726,3578756767,41
1,1408,43851,3578756726,3578756768,42
1,1408,43852,3578756726,3578756768,42
1,1408,43853,3578756726,3578756770,44
1,1408,43854,3578756726,3578756771,45
1,1408,43855,3578756726,3578756771,45
1,1408,43856,3578756726,3578756771,45
1,1408,43857,3578756726,3578756775,49
1,1409,43858,3578756790,3578756790,0
1,1409,43859,3578756790,3578756790,0
1,1409,43860,3578756790,3578756790,0
1,1409,43861,3578756790,3578756790,0
1,1409,43862,3578756790,3578756790,0
1,1409,43863,3578756790,3578756790,0
1,1409,43864,3578756790,3578756790,0
1,1409,43865,3578756790,3578756790,0
1,1409,43866,3578756790,3578756790,0
1,1409,43867,3578756790,3578756790,0
1,1409,43868,3578756790,3578756790,0
1,1409,43869,3578756790,3578756790,0
1,1409,43870,3578756790,3578756790,0
1,1409,43871,3578756790,3578756790,0
1,1409,43872,3578756790,3578756790,0
1,1409,43873,3578756790,3578756790,0
1,1409,43874,3578756790,3578756792,2
1,1409,43875,3578756790,3578756793,3
1,1409,43876,3578756790,3578756793,3
1,1409,43877,3578756790,3578756794,4
1,1409,43878,3578756790,3578756796,6
1,1409,43879,3578756790,3578756796,6
1,1409,43880,3578756790,3578756796,6
1,1409,43881,3578756790,3578756797,7
1,1409,43882,3578756790,3578756797,7
1,1409,43883,3578756790,3578756798,8
1,1409,43884,3578756790,3578756798,8
1,1409,43885,3578756790,3578756799,9
1,1409,43886,3578756790,3578756799,9
1,1409,43887,3578756790,3578756799,9
1,1409,43888,3578756790,3578756799,9
1,1409,43889,3578756790,3578756801,11
1,1409,43890,3578756790,3578756802,12
1,1409,43891,3578756790,3578756802,12
1,1409,43892,3578756790,3578756806,16
1,1409,43893,3578756790,3578756806,16
1,1409,43894,3578756790,3578756809,19
1,1409,43895,3578756790,3578756811,21
1,1409,43896,3578756790,3578756812,22
1,1409,43897,3578756790,3578756813,23
1,1409,43898,3578756790,3578756813,23
1,1409,43899,3578756790,3578756814,24
1,1409,43900,3578756790,3578756816,26
1,1409,43901,3578756790,3578756816,26
1,1409,43902,3578756790,3578756816,26
1,1409,43903,3578756790,3578756817,27
1,1409,43904,3578756790,3578756818,28
1,1409,43905,3578756790,3578756819,29
1,1409,43906,3578756790,3578756819,29
1,1409,43907,3578756790,3578756819,29
1,1409,43908,3578756790,3578756821,31
1,1409,43909,3578756790,3578756821,31
1,1409,43910,3578756790,3578756822,32
1,1409,43911,3578756790,3578756822,32
1,1409,43912,3578756790,3578756824,34
1,1409,43913,3578756790,3578756827,37
1,1409,43914,3578756790,3578756828,38
1,1409,43915,3578756790,3578756828,38
1,1409,43916,3578756790,3578756829,39
1,1409,43917,3578756790,3578756830,40
1,1409,43918,3578756790,3578756830,40
1,1409,43919,3578756790,3578756831,41
1,1409,43920,3578756790,3578756832,42
1,1409,43921,3578756790,3578756834,44
1,1409,43922,3578756790,3578756834,44
1,1409,43923,3578756790,3578756839,49
1,1409,43924,3578756790,3578756839,49
1,1409,43925,3578756790,3578756840,50
1,1410,43926,3578756853,3578756853,0
1,1410,43927,3578756853,3578756853,0
1,1410,43928,3578756853,3578756853,0
1,1410,43929,3578756853,3578756853,0
1,1410,43930,3578756853,3578756853,0
1,1410,43931,3578756853,3578756853,0
1,1410,43932,3578756853,3578756853,0
1,1410,43933,3578756853,3578756854,1
1,1410,43934,3578756853,3578756855,2
1,1410,43935,3578756853,3578756857,4
1,1410,43936,3578756853,3578756860,7
1,1410,43937,3578756853,3578756860,7
1,1410,43938,3578756853,3578756861,8
1,1410,43939,3578756853,3578756862,9
1,1410,43940,3578756853,3578756862,9
1,1410,43941,3578756853,3578756863,10
1,1410,43942,3578756853,3578756863,10
1,1410,43943,3578756853,3578756865,12
1,1410,43944,3578756853,3578756867,14
1,1410,43945,3578756853,3578756867,14
1,1410,43946,3578756853,3578756868,15
1,1410,43947,3578756853,3578756879,26
1,1410,43948,3578756853,3578756880,27
1,1410,43949,3578756853,3578756880,27
1,1410,43950,3578756853,3578756882,29
1,1410,43951,3578756853,3578756883,30
1,1410,43952,3578756853,3578756883,30
1,1410,43953,3578756853,3578756884,31
1,1410,43954,3578756853,3578756884,31
1,1410,43955,3578756853,3578756887,34
1,1410,43956,3578756853,3578756887,34
1,1410,43957,3578756853,3578756889,36
1,1410,43958,3578756853,3578756889,36
1,1410,43959,3578756853,3578756890,37
1,1410,43960,3578756853,3578756892,39
1,1410,43961,3578756853,3578756893,40
1,1410,43962,3578756853,3578756893,40
1,1410,43963,3578756853,3578756893,40
1,1410,43964,3578756853,3578756894,41
1,1410,43965,3578756853,3578756895,42
1,1410,43966,3578756853,3578756895,42
1,1410,43967,3578756853,3578756896,43
1,1410,43968,3578756853,3578756897,44
1,1410,43969,3578756853,3578756898,45
1,1410,43970,3578756853,3578756898,45
1,1410,43971,3578756853,3578756899,46
1,1411,43972,3578756916,3578756916,0
1,1411,43973,3578756916,3578756916,0
1,1411,43974,3578756916,3578756916,0
1,1411,43975,3578756916,3578756916,0
1,1411,43976,3578756916,3578756916,0
1,1411,43977,3578756916,3578756916,0
1,1411,43978,3578756916,3578756916,0
1,1411,43979,3578756916,3578756916,0
1,1411,43980,3578756916,3578756916,0
1,1411,43981,3578756916,3578756916,0
1,1411,43982,3578756916,3578756916,0
1,1411,43983,3578756916,3578756916,0
1,1411,43984,3578756916,3578756916,0
1,1411,43985,3578756916,3578756916,0
1,1411,43986,3578756916,3578756916,0
1,1411,43987,3578756916,3578756916,0
1,1411,43988,3578756916,3578756916,0
1,1411,43989,3578756916,3578756916,0
1,1411,43990,3578756916,3578756916,0
1,1411,43991,3578756916,3578756916,0
1,1411,43992,3578756916,3578756916,0
1,1411,43993,3578756916,3578756916,0
1,1411,43994,3578756916,3578756916,0
1,1411,43995,3578756916,3578756916,0
1,1411,43996,3578756916,3578756916,0
1,1411,43997,3578756916,3578756918,2
1,1411,43998,3578756916,3578756921,5
1,1411,43999,3578756916,3578756921,5
1,1411,44000,3578756916,3578756921,5
1,1411,44001,3578756916,3578756923,7
1,1411,44002,3578756916,3578756924,8
1,1411,44003,3578756916,3578756924,8
1,1411,44004,3578756916,3578756924,8
1,1411,44005,3578756916,3578756925,9
1,1411,44006,3578756916,3578756927,11
1,1411,44007,3578756916,3578756927,11
1,1411,44008,3578756916,3578756927,11
1,1411,44009,3578756916,3578756928,12
1,1411,44010,3578756916,3578756929,13
1,1411,44011,3578756916,3578756929,13
1,1411,44012,3578756916,3578756929,13
1,1411,44013,3578756916,3578756930,14
1,1411,44014,3578756916,3578756930,14
1,1411,44015,3578756916,3578756932,16
1,1411,44016,3578756916,3578756933,17
1,1411,44017,3578756916,3578756933,17
1,1411,44018,3578756916,3578756934,18
1,1411,44019,3578756916,3578756934,18
1,1411,44020,3578756916,3578756935,19
1,1411,44021,3578756916,3578756935,19
1,1411,44022,3578756916,3578756936,20
1,1411,44023,3578756916,3578756937,21
1,1411,44024,3578756916,3578756937,21
1,1411,44025,3578756916,3578756938,22
1,1411,44026,3578756916,3578756938,22
1,1411,44027,3578756916,3578756940,24
1,1411,44028,3578756916,3578756940,24
1,1411,44029,3578756916,3578756941,25
1,1411,44030,3578756916,3578756942,26
1,1411,44031,3578756916,3578756942,26
1,1411,44032,3578756916,3578756946,30
1,1411,44033,3578756916,3578756946,30
1,1411,44034,3578756916,3578756948,32
1,1411,44035,3578756916,3578756950,34
1,1411,44036,3578756916,3578756953,37
1,1411,44037,3578756916,3578756955,39
1,1411,44038,3578756916,3578756956,40
1,1411,44039,3578756916,3578756957,41
1,1411,44040,3578756916,3578756958,42
1,1411,44041,3578756916,3578756959,43
1,1411,44042,3578756916,3578756959,43
1,1411,44043,3578756916,3578756962,46
1,1411,44044,3578756916,3578756963,47
1,1411,44045,3578756916,3578756963,47
1,1411,44046,3578756916,3578756963,47
1,1411,44047,3578756916,3578756963,47
1,1411,44048,3578756916,3578756964,48
1,1411,44049,3578756916,3578756965,49
1,1411,44050,3578756916,3578756965,49
1,1411,44051,3578756916,3578756966,50
1,1412,44052,3578756979,3578756979,0
1,1412,44053,3578756979,3578756979,0
1,1412,44054,3578756979,3578756979,0
1,1412,44055,3578756979,3578756979,0
1,1412,44056,3578756979,3578756979,0
1,1412,44057,3578756979,3578756979,0
1,1412,44058,3578756979,3578756979,0
1,1412,44059,3578756979,3578756979,0
1,1412,44060,3578756979,3578756979,0
1,1412,44061,3578756979,3578756979,0
1,1412,44062,3578756979,3578756979,0
1,1412,44063,3578756979,3578756979,0
1,1412,44064,3578756979,3578756979,0
1,1412,44065,3578756979,3578756980,1
1,1412,44066,3578756979,3578756981,2
1,1412,44067,3578756979,3578756981,2
1,1412,44068,3578756979,3578756981,2
1,1412,44069,3578756979,3578756981,2
1,1412,44070,3578756979,3578756982,3
1,1412,44071,3578756979,3578756982,3
1,1412,44072,3578756979,3578756984,5
1,1412,44073,3578756979,3578756984,5
1,1412,44074,3578756979,3578756986,7
1,1412,44075,3578756979,3578756986,7
1,1412,44076,3578756979,3578756986,7
1,1412,44077,3578756979,3578756988,9
1,1412,44078,3578756979,3578756991,12
1,1412,44079,3578756979,3578756992,13
1,1412,44080,3578756979,3578756993,14
1,1412,44081,3578756979,3578756994,15
1,1412,44082,3578756979,3578756996,17
1,1412,44083,3578756979,3578756996,17
1,1412,44084,3578756979,3578756996,17
1,1412,44085,3578756979,3578756997,18
1,1412,44086,3578756979,3578756998,19
1,1412,44087,3578756979,3578756999,20
1,1412,44088,3578756979,3578756999,20
1,1412,44089,3578756979,3578756999,20
1,1412,44090,3578756979,3578757000,21
1,1412,44091,3578756979,3578757001,22
1,1412,44092,3578756979,3578757003,24
1,1412,44093,3578756979,3578757003,24
1,1412,44094,3578756979,3578757006,27
1,1412,44095,3578756979,3578757007,28
1,1412,44096,3578756979,3578757009,30
1,1412,44097,3578756979,3578757012,33
1,1412,44098,3578756979,3578757012,33
1,1412,44099,3578756979,3578757012,33
1,1412,44100,3578756979,3578757013,34
1,1412,44101,3578756979,3578757015,36
1,1412,44102,3578756979,3578757015,36
1,1412,44103,3578756979,3578757016,37
1,1412,44104,3578756979,3578757017,38
1,1412,44105,3578756979,3578757017,38
1,1412,44106,3578756979,3578757017,38
1,1412,44107,3578756979,3578757019,40
1,1412,44108,3578756979,3578757019,40
1,1412,44109,3578756979,3578757019,40
1,1412,44110,3578756979,3578757019,40
1,1412,44111,3578756979,3578757021,42
1,1412,44112,3578756979,3578757021,42
1,1412,44113,3578756979,3578757022,43
1,1412,44114,3578756979,3578757022,43
1,1412,44115,3578756979,3578757025,46
1,1412,44116,3578756979,3578757027,48
1,1412,44117,3578756979,3578757029,50
1,1413,44118,3578757043,3578757043,0
1,1413,44119,3578757043,3578757043,0
1,1413,44120,3578757043,3578757043,0
1,1413,44121,3578757043,3578757043,0
1,1413,44122,3578757043,3578757043,0
1,1413,44123,3578757043,3578757043,0
1,1413,44124,3578757043,3578757043,0
1,1413,44125,3578757043,3578757043,0
1,1413,44126,3578757043,3578757043,0
1,1413,44127,3578757043,3578757043,0
1,1413,44128,3578757043,3578757043,0
1,1413,44129,3578757043,3578757043,0
1,1413,44130,3578757043,3578757043,0
1,1413,44131,3578757043,3578757043,0
1,1413,44132,3578757043,3578757047,4
1,1413,44133,3578757043,3578757048,5
1,1413,44134,3578757043,3578757049,6
1,1413,44135,3578757043,3578757050,7
1,1413,44136,3578757043,3578757050,7
1,1413,44137,3578757043,3578757051,8
1,1413,44138,3578757043,3578757053,10
1,1413,44139,3578757043,3578757054,11
1,1413,44140,3578757043,3578757054,11
1,1413,44141,3578757043,3578757057,14
1,1413,44142,3578757043,3578757059,16
1,1413,44143,3578757043,3578757060,17
1,1413,44144,3578757043,3578757061,18
1,1413,44145,3578757043,3578757063,20
1,1413,44146,3578757043,3578757063,20
1,1413,44147,3578757043,3578757063,20
1,1413,44148,3578757043,3578757063,20
1,1413,44149,3578757043,3578757064,21
1,1413,44150,3578757043,3578757065,22
1,1413,44151,3578757043,3578757068,25
1,1413,44152,3578757043,3578757068,25
1,1413,44153,3578757043,3578757068,25
1,1413,44154,3578757043,3578757068,25
1,1413,44155,3578757043,3578757079,36
1,1413,44156,3578757043,3578757081,38
1,1413,44157,3578757043,3578757081,38
1,1413,44158,3578757043,3578757083,40
1,1413,44159,3578757043,3578757083,40
1,1413,44160,3578757043,3578757084,41
1,1413,44161,3578757043,3578757084,41
1,1413,44162,3578757043,3578757085,42
1,1413,44163,3578757043,3578757087,44
1,1413,44164,3578757043,3578757089,46
1,1413,44165,3578757043,3578757089,46
1,1413,44166,3578757043,3578757090,47
1,1413,44167,3578757043,3578757092,49
1,1413,44168,3578757043,3578757092,49
1,1413,44169,3578757043,3578757093,50
1,1414,44170,3578757104,3578757104,0
1,1414,44171,3578757104,3578757104,0
1,1414,44172,3578757104,3578757104,0
1,1414,44173,3578757104,3578757104,0
1,1414,44174,3578757104,3578757104,0
1,1414,44175,3578757104,3578757104,0
1,1414,44176,3578757104,3578757104,0
1,1414,44177,3578757104,3578757104,0
1,1414,44178,3578757104,3578757104,0
1,1414,44179,3578757104,3578757105,1
1,1414,44180,3578757104,3578757105,1
1,1414,44181,3578757104,3578757105,1
1,1414,44182,3578757104,3578757105,1
1,1414,44183,3578757104,3578757105,1
1,1414,44184,3578757104,3578757105,1
1,1414,44185,3578757104,3578757105,1
1,1414,44186,3578757104,3578757106,2
1,1414,44187,3578757104,3578757106,2
1,1414,44188,3578757104,3578757107,3
1,1414,44189,3578757104,3578757109,5
1,1414,44190,3578757104,3578757109,5
1,1414,44191,3578757104,3578757110,6
1,1414,44192,3578757104,3578757111,7
1,1414,44193,3578757104,3578757111,7
1,1414,44194,3578757104,3578757111,7
1,1414,44195,3578757104,3578757111,7
1,1414,44196,3578757104,3578757112,8
1,1414,44197,3578757104,3578757113,9
1,1414,44198,3578757104,3578757114,10
1,1414,44199,3578757104,3578757114,10
1,1414,44200,3578757104,3578757115,11
1,1414,44201,3578757104,3578757116,12
1,1414,44202,3578757104,3578757117,13
1,1414,44203,3578757104,3578757119,15
1,1414,44204,3578757104,3578757121,17
1,1414,44205,3578757104,3578757121,17
1,1414,44206,3578757104,3578757122,18
1,1414,44207,3578757104,3578757123,19
1,1414,44208,3578757104,3578757124,20
1,1414,44209,3578757104,3578757124,20
1,1414,44210,3578757104,3578757124,20
1,1414,44211,3578757104,3578757125,21
1,1414,44212,3578757104,3578757127,23
1,1414,44213,3578757104,3578757127,23
1,1414,44214,3578757104,3578757127,23
1,1414,44215,3578757104,3578757128,24
1,1414,44216,3578757104,3578757128,24
1,1414,44217,3578757104,3578757129,25
1,1414,44218,3578757104,3578757129,25
1,1414,44219,3578757104,3578757130,26
1,1414,44220,3578757104,3578757131,27
1,1414,44221,3578757104,3578757133,29
1,1414,44222,3578757104,3578757133,29
1,1414,44223,3578757104,3578757133,29
1,1414,44224,3578757104,3578757133,29
1,1414,44225,3578757104,3578757134,30
1,1414,44226,3578757104,3578757134,30
1,1414,44227,3578757104,3578757135,31
1,1414,44228,3578757104,3578757136,32
1,1414,44229,3578757104,3578757137,33
1,1414,44230,3578757104,3578757137,33
1,1414,44231,3578757104,3578757138,34
1,1414,44232,3578757104,3578757138,34
1,1414,44233,3578757104,3578757139,35
1,1414,44234,3578757104,3578757140,36
1,1414,44235,3578757104,3578757141,37
1,1414,44236,3578757104,3578757141,37
1,1414,44237,3578757104,3578757143,39
1,1414,44238,3578757104,3578757146,42
1,1414,44239,3578757104,3578757146,42
1,1414,44240,3578757104,3578757148,44
1,1414,44241,3578757104,3578757150,46
1,1414,44242,3578757104,3578757154,50
1,1415,44243,3578757168,3578757168,0
1,1415,44244,3578757168,3578757168,0
1,1415,44245,3578757168,3578757168,0
1,1415,44246,3578757168,3578757168,0
1,1415,44247,3578757168,3578757168,0
1,1415,44248,3578757168,3578757168,0
1,1415,44249,3578757168,3578757168,0
1,1415,44250,3578757168,3578757168,0
1,1415,44251,3578757168,3578757168,0
1,1415,44252,3578757168,3578757168,0
1,1415,44253,3578757168,3578757168,0
1,1415,44254,3578757168,3578757168,0
1,1415,44255,3578757168,3578757168,0
1,1415,44256,3578757168,3578757168,0
1,1415,44257,3578757168,3578757168,0
1,1415,44258,3578757168,3578757171,3
1,1415,44259,3578757168,3578757171,3
1,1415,44260,3578757168,3578757172,4
1,1415,44261,3578757168,3578757177,9
1,1415,44262,3578757168,3578757178,10
1,1415,44263,3578757168,3578757178,10
1,1415,44264,3578757168,3578757179,11
1,1415,44265,3578757168,3578757179,11
1,1415,44266,3578757168,3578757179,11
1,1415,44267,3578757168,3578757180,12
1,1415,44268,3578757168,3578757181,13
1,1415,44269,3578757168,3578757182,14
1,1415,44270,3578757168,3578757182,14
1,1415,44271,3578757168,3578757182,14
1,1415,44272,3578757168,3578757182,14
1,1415,44273,3578757168,3578757185,17
1,1415,44274,3578757168,3578757186,18
1,1415,44275,3578757168,3578757187,19
1,1415,44276,3578757168,3578757188,20
1,1415,44277,3578757168,3578757192,24
1,1415,44278,3578757168,3578757192,24
1,1415,44279,3578757168,3578757193,25
1,1415,44280,3578757168,3578757194,26
1,1415,44281,3578757168,3578757194,26
1,1415,44282,3578757168,3578757196,28
1,1415,44283,3578757168,3578757196,28
1,1415,44284,3578757168,3578757196,28
1,1415,44285,3578757168,3578757197,29
1,1415,44286,3578757168,3578757197,29
1,1415,44287,3578757168,3578757197,29
1,1415,44288,3578757168,3578757199,31
1,1415,44289,3578757168,3578757199,31
1,1415,44290,3578757168,3578757199,31
1,1415,44291,3578757168,3578757199,31
1,1415,44292,3578757168,3578757201,33
1,1415,44293,3578757168,3578757202,34
1,1415,44294,3578757168,3578757203,35
1,1415,44295,3578757168,3578757206,38
1,1415,44296,3578757168,3578757207,39
1,1415,44297,3578757168,3578757209,41
1,1415,44298,3578757168,3578757212,44
1,1415,44299,3578757168,3578757213,45
1,1415,44300,3578757168,3578757214,46
1,1415,44301,3578757168,3578757215,47
1,1415,44302,3578757168,3578757216,48
1,1415,44303,3578757168,3578757217,49
1,1415,44304,3578757168,3578757217,49
1,1415,44305,3578757168,3578757217,49
1,1415,44306,3578757168,3578757218,50
1,1416,44307,3578757231,3578757231,0
1,1416,44308,3578757231,3578757231,0
1,1416,44309,3578757231,3578757231,0
1,1416,44310,3578757231,3578757231,0
1,1416,44311,3578757231,3578757231,0
1,1416,44312,3578757231,3578757231,0
1,1416,44313,3578757231,3578757231,0
1,1416,44314,3578757231,3578757231,0
1,1416,44315,3578757231,3578757231,0
1,1416,44316,3578757231,3578757231,0
1,1416,44317,3578757231,3578757231,0
1,1416,44318,3578757231,3578757231,0
1,1416,44319,3578757231,3578757231,0
1,1416,44320,3578757231,3578757231,0
1,1416,44321,3578757231,3578757231,0
1,1416,44322,3578757231,3578757232,1
1,1416,44323,3578757231,3578757234,3
1,1416,44324,3578757231,3578757235,4
1,1416,44325,3578757231,3578757235,4
1,1416,44326,3578757231,3578757237,6
1,1416,44327,3578757231,3578757238,7
1,1416,44328,3578757231,3578757239,8
1,1416,44329,3578757231,3578757239,8
1,1416,44330,3578757231,3578757242,11
1,1416,44331,3578757231,3578757243,12
1,1416,44332,3578757231,3578757247,16
1,1416,44333,3578757231,3578757247,16
1,1416,44334,3578757231,3578757249,18
1,1416,44335,3578757231,3578757250,19
1,1416,44336,3578757231,3578757250,19
1,1416,44337,3578757231,3578757252,21
1,1416,44338,3578757231,3578757253,22
1,1416,44339,3578757231,3578757254,23
1,1416,44340,3578757231,3578757254,23
1,1416,44341,3578757231,3578757257,26
1,1416,44342,3578757231,3578757260,29
1,1416,44343,3578757231,3578757260,29
1,1416,44344,3578757231,3578757262,31
1,1416,44345,3578757231,3578757263,32
1,1416,44346,3578757231,3578757263,32
1,1416,44347,3578757231,3578757263,32
1,1416,44348,3578757231,3578757263,32
1,1416,44349,3578757231,3578757265,34
1,1416,44350,3578757231,3578757268,37
1,1416,44351,3578757231,3578757268,37
1,1416,44352,3578757231,3578757268,37
1,1416,44353,3578757231,3578757268,37
1,1416,44354,3578757231,3578757278,47
1,1416,44355,3578757231,3578757280,49
1,1416,44356,3578757231,3578757281,50
1,1417,44357,3578757294,3578757294,0
1,1417,44358,3578757294,3578757294,0
1,1417,44359,3578757294,3578757294,0
1,1417,44360,3578757294,3578757294,0
1,1417,44361,3578757294,3578757294,0
1,1417,44362,3578757294,3578757294,0
1,1417,44363,3578757294,3578757294,0
1,1417,44364,3578757294,3578757294,0
1,1417,44365,3578757294,3578757294,0
1,1417,44366,3578757294,3578757294,0
1,1417,44367,3578757294,3578757294,0
1,1417,44368,3578757294,3578757294,0
1,1417,44369,3578757294,3578757294,0
1,1417,44370,3578757294,3578757294,0
1,1417,44371,3578757294,3578757295,1
1,1417,44372,3578757294,3578757295,1
1,1417,44373,3578757294,3578757295,1
1,1417,44374,3578757294,3578757295,1
1,1417,44375,3578757294,3578757298,4
1,1417,44376,3578757294,3578757298,4
1,1417,44377,3578757294,3578757298,4
1,1417,44378,3578757294,3578757299,5
1,1417,44379,3578757294,3578757302,8
1,1417,44380,3578757294,3578757304,10
1,1417,44381,3578757294,3578757305,11
1,1417,44382,3578757294,3578757305,11
1,1417,44383,3578757294,3578757305,11
1,1417,44384,3578757294,3578757306,12
1,1417,44385,3578757294,3578757306,12
1,1417,44386,3578757294,3578757307,13
1,1417,44387,3578757294,3578757309,15
1,1417,44388,3578757294,3578757310,16
1,1417,44389,3578757294,3578757310,16
1,1417,44390,3578757294,3578757311,17
1,1417,44391,3578757294,3578757311,17
1,1417,44392,3578757294,3578757312,18
1,1417,44393,3578757294,3578757312,18
1,1417,44394,3578757294,3578757312,18
1,1417,44395,3578757294,3578757312,18
1,1417,44396,3578757294,3578757313,19
1,1417,44397,3578757294,3578757313,19
1,1417,44398,3578757294,3578757315,21
1,1417,44399,3578757294,3578757315,21
1,1417,44400,3578757294,3578757316,22
1,1417,44401,3578757294,3578757316,22
1,1417,44402,3578757294,3578757316,22
1,1417,44403,3578757294,3578757320,26
1,1417,44404,3578757294,3578757320,26
1,1417,44405,3578757294,3578757322,28
1,1417,44406,3578757294,3578757323,29
1,1417,44407,3578757294,3578757324,30
1,1417,44408,3578757294,3578757324,30
1,1417,44409,3578757294,3578757325,31
1,1417,44410,3578757294,3578757325,31
1,1417,44411,3578757294,3578757326,32
1,1417,44412,3578757294,3578757327,33
1,1417,44413,3578757294,3578757327,33
1,1417,44414,3578757294,3578757328,34
1,1417,44415,3578757294,3578757328,34
1,1417,44416,3578757294,3578757329,35
1,1417,44417,3578757294,3578757330,36
1,1417,44418,3578757294,3578757330,36
1,1417,44419,3578757294,3578757333,39
1,1417,44420,3578757294,3578757333,39
1,1417,44421,3578757294,3578757333,39
1,1417,44422,3578757294,3578757333,39
1,1417,44423,3578757294,3578757334,40
1,1417,44424,3578757294,3578757335,41
1,1417,44425,3578757294,3578757336,42
1,1417,44426,3578757294,3578757337,43
1,1417,44427,3578757294,3578757337,43
1,1417,44428,3578757294,3578757337,43
1,1417,44429,3578757294,3578757338,44
1,1417,44430,3578757294,3578757338,44
1,1417,44431,3578757294,3578757339,45
1,1417,44432,3578757294,3578757341,47
1,1417,44433,3578757294,3578757341,47
1,1417,44434,3578757294,3578757342,48
1,1417,44435,3578757294,3578757344,50
1,1418,44436,3578757357,3578757357,0
1,1418,44437,3578757357,3578757357,0
1,1418,44438,3578757357,3578757357,0
1,1418,44439,3578757357,3578757357,0
1,1418,44440,3578757357,3578757357,0
1,1418,44441,3578757357,3578757357,0
1,1418,44442,3578757357,3578757357,0
1,1418,44443,3578757357,3578757358,1
1,1418,44444,3578757357,3578757360,3
1,1418,44445,3578757357,3578757363,6
1,1418,44446,3578757357,3578757363,6
1,1418,44447,3578757357,3578757363,6
1,1418,44448,3578757357,3578757364,7
1,1418,44449,3578757357,3578757365,8
1,1418,44450,3578757357,3578757365,8
1,1418,44451,3578757357,3578757365,8
1,1418,44452,3578757357,3578757367,10
1,1418,44453,3578757357,3578757367,10
1,1418,44454,3578757357,3578757368,11
1,1418,44455,3578757357,3578757369,12
1,1418,44456,3578757357,3578757371,14
1,1418,44457,3578757357,3578757371,14
1,1418,44458,3578757357,3578757371,14
1,1418,44459,3578757357,3578757372,15
1,1418,44460,3578757357,3578757376,19
1,1418,44461,3578757357,3578757377,20
1,1418,44462,3578757357,3578757378,21
1,1418,44463,3578757357,3578757378,21
1,1418,44464,3578757357,3578757379,22
1,1418,44465,3578757357,3578757380,23
1,1418,44466,3578757357,3578757381,24
1,1418,44467,3578757357,3578757381,24
1,1418,44468,3578757357,3578757382,25
1,1418,44469,3578757357,3578757382,25
1,1418,44470,3578757357,3578757382,25
1,1418,44471,3578757357,3578757382,25
1,1418,44472,3578757357,3578757383,26
1,1418,44473,3578757357,3578757386,29
1,1418,44474,3578757357,3578757387,30
1,1418,44475,3578757357,3578757387,30
1,1418,44476,3578757357,3578757388,31
1,1418,44477,3578757357,3578757392,35
1,1418,44478,3578757357,3578757392,35
1,1418,44479,3578757357,3578757393,36
1,1418,44480,3578757357,3578757393,36
1,1418,44481,3578757357,3578757394,37
1,1418,44482,3578757357,3578757396,39
1,1418,44483,3578757357,3578757396,39
1,1418,44484,3578757357,3578757396,39
1,1418,44485,3578757357,3578757397,40
1,1418,44486,3578757357,3578757397,40
1,1418,44487,3578757357,3578757398,41
1,1418,44488,3578757357,3578757399,42
1,1418,44489,3578757357,3578757399,42
1,1418,44490,3578757357,3578757399,42
1,1418,44491,3578757357,3578757400,43
1,1418,44492,3578757357,3578757401,44
1,1418,44493,3578757357,3578757402,45
1,1418,44494,3578757357,3578757404,47
1,1419,44495,3578757422,3578757422,0
1,1419,44496,3578757422,3578757422,0
1,1419,44497,3578757422,3578757422,0
1,1419,44498,3578757422,3578757422,0
1,1419,44499,3578757422,3578757422,0
1,1419,44500,3578757422,3578757422,0
1,1419,44501,3578757422,3578757422,0
1,1419,44502,3578757422,3578757422,0
1,1419,44503,3578757422,3578757422,0
1,1419,44504,3578757422,3578757422,0
1,1419,44505,3578757422,3578757422,0
1,1419,44506,3578757422,3578757422,0
1,1419,44507,3578757422,3578757422,0
1,1419,44508,3578757422,3578757422,0
1,1419,44509,3578757422,3578757422,0
1,1419,44510,3578757422,3578757422,0
1,1419,44511,3578757422,3578757422,0
1,1419,44512,3578757422,3578757422,0
1,1419,44513,3578757422,3578757422,0
1,1419,44514,3578757422,3578757422,0
1,1419,44515,3578757422,3578757423,1
1,1419,44516,3578757422,3578757425,3
1,1419,44517,3578757422,3578757428,6
1,1419,44518,3578757422,3578757429,7
1,1419,44519,3578757422,3578757430,8
1,1419,44520,3578757422,3578757430,8
1,1419,44521,3578757422,3578757431,9
1,1419,44522,3578757422,3578757432,10
1,1419,44523,3578757422,3578757433,11
1,1419,44524,3578757422,3578757434,12
1,1419,44525,3578757422,3578757435,13
1,1419,44526,3578757422,3578757435,13
1,1419,44527,3578757422,3578757437,15
1,1419,44528,3578757422,3578757439,17
1,1419,44529,3578757422,3578757439,17
1,1419,44530,3578757422,3578757440,18
1,1419,44531,3578757422,3578757442,20
1,1419,44532,3578757422,3578757447,25
1,1419,44533,3578757422,3578757448,26
1,1419,44534,3578757422,3578757449,27
1,1419,44535,3578757422,3578757450,28
1,1419,44536,3578757422,3578757451,29
1,1419,44537,3578757422,3578757452,30
1,1419,44538,3578757422,3578757453,31
1,1419,44539,3578757422,3578757454,32
1,1419,44540,3578757422,3578757456,34
1,1419,44541,3578757422,3578757456,34
1,1419,44542,3578757422,3578757459,37
1,1419,44543,3578757422,3578757461,39
1,1419,44544,3578757422,3578757461,39
1,1419,44545,3578757422,3578757462,40
1,1419,44546,3578757422,3578757463,41
1,1419,44547,3578757422,3578757463,41
1,1419,44548,3578757422,3578757464,42
1,1419,44549,3578757422,3578757468,46
1,1419,44550,3578757422,3578757469,47
1,1419,44551,3578757422,3578757469,47
1,1420,44552,3578757487,3578757487,0
1,1420,44553,3578757487,3578757487,0
1,1420,44554,3578757487,3578757487,0
1,1420,44555,3578757487,3578757487,0
1,1420,44556,3578757487,3578757487,0
1,1420,44557,3578757487,3578757487,0
1,1420,44558,3578757487,3578757487,0
1,1420,44559,3578757487,3578757487,0
1,1420,44560,3578757487,3578757487,0
1,1420,44561,3578757487,3578757488,1
1,1420,44562,3578757487,3578757488,1
1,1420,44563,3578757487,3578757490,3
1,1420,44564,3578757487,3578757491,4
1,1420,44565,3578757487,3578757492,5
1,1420,44566,3578757487,3578757492,5
1,1420,44567,3578757487,3578757493,6
1,1420,44568,3578757487,3578757493,6
1,1420,44569,3578757487,3578757494,7
1,1420,44570,3578757487,3578757495,8
1,1420,44571,3578757487,3578757495,8
1,1420,44572,3578757487,3578757497,10
1,1420,44573,3578757487,3578757497,10
1,1420,44574,3578757487,3578757497,10
1,1420,44575,3578757487,3578757497,10
1,1420,44576,3578757487,3578757501,14
1,1420,44577,3578757487,3578757502,15
1,1420,44578,3578757487,3578757502,15
1,1420,44579,3578757487,3578757503,16
1,1420,44580,3578757487,3578757504,17
1,1420,44581,3578757487,3578757504,17
1,1420,44582,3578757487,3578757505,18
1,1420,44583,3578757487,3578757505,18
1,1420,44584,3578757487,3578757505,18
1,1420,44585,3578757487,3578757507,20
1,1420,44586,3578757487,3578757508,21
1,1420,44587,3578757487,3578757509,22
1,1420,44588,3578757487,3578757509,22
1,1420,44589,3578757487,3578757509,22
1,1420,44590,3578757487,3578757510,23
1,1420,44591,3578757487,3578757511,24
1,1420,44592,3578757487,3578757511,24
1,1420,44593,3578757487,3578757512,25
1,1420,44594,3578757487,3578757512,25
1,1420,44595,3578757487,3578757513,26
1,1420,44596,3578757487,3578757514,27
1,1420,44597,3578757487,3578757514,27
1,1420,44598,3578757487,3578757515,28
1,1420,44599,3578757487,3578757515,28
1,1420,44600,3578757487,3578757515,28
1,1420,44601,3578757487,3578757518,31
1,1420,44602,3578757487,3578757519,32
1,1420,44603,3578757487,3578757520,33
1,1420,44604,3578757487,3578757520,33
1,1420,44605,3578757487,3578757521,34
1,1420,44606,3578757487,3578757522,35
1,1420,44607,3578757487,3578757523,36
1,1420,44608,3578757487,3578757523,36
1,1420,44609,3578757487,3578757523,36
1,1420,44610,3578757487,3578757525,38
1,1420,44611,3578757487,3578757526,39
1,1420,44612,3578757487,3578757526,39
1,1420,44613,3578757487,3578757526,39
1,1420,44614,3578757487,3578757527,40
1,1420,44615,3578757487,3578757527,40
1,1420,44616,3578757487,3578757528,41
1,1420,44617,3578757487,3578757529,42
1,1420,44618,3578757487,3578757529,42
1,1420,44619,3578757487,3578757530,43
1,1420,44620,3578757487,3578757532,45
1,1420,44621,3578757487,3578757532,45
1,1420,44622,3578757487,3578757532,45
1,1420,44623,3578757487,3578757534,47
1,1420,44624,3578757487,3578757535,48
1,1420,44625,3578757487,3578757536,49
1,1420,44626,3578757487,3578757536,49
1,1420,44627,3578757487,3578757536,49
1,1420,44628,3578757487,3578757537,50
1,1421,44629,3578757551,3578757551,0
1,1421,44630,3578757551,3578757551,0
1,1421,44631,3578757551,3578757551,0
1,1421,44632,3578757551,3578757551,0
1,1421,44633,3578757551,3578757551,0
1,1421,44634,3578757551,3578757551,0
1,1421,44635,3578757551,3578757551,0
1,1421,44636,3578757551,3578757551,0
1,1421,44637,3578757551,3578757551,0
1,1421,44638,3578757551,3578757552,1
1,1421,44639,3578757551,3578757554,3
1,1421,44640,3578757551,3578757555,4
1,1421,44641,3578757551,3578757555,4
1,1421,44642,3578757551,3578757556,5
1,1421,44643,3578757551,3578757557,6
1,1421,44644,3578757551,3578757559,8
1,1421,44645,3578757551,3578757562,11
1,1421,44646,3578757551,3578757562,11
1,1421,44647,3578757551,3578757562,11
1,1421,44648,3578757551,3578757563,12
1,1421,44649,3578757551,3578757563,12
1,1421,44650,3578757551,3578757564,13
1,1421,44651,3578757551,3578757565,14
1,1421,44652,3578757551,3578757565,14
1,1421,44653,3578757551,3578757566,15
1,1421,44654,3578757551,3578757566,15
1,1421,44655,3578757551,3578757567,16
1,1421,44656,3578757551,3578757567,16
1,1421,44657,3578757551,3578757570,19
1,1421,44658,3578757551,3578757571,20
1,1421,44659,3578757551,3578757571,20
1,1421,44660,3578757551,3578757572,21
1,1421,44661,3578757551,3578757575,24
1,1421,44662,3578757551,3578757576,25
1,1421,44663,3578757551,3578757578,27
1,1421,44664,3578757551,3578757578,27
1,1421,44665,3578757551,3578757578,27
1,1421,44666,3578757551,3578757578,27
1,1421,44667,3578757551,3578757579,28
1,1421,44668,3578757551,3578757580,29
1,1421,44669,3578757551,3578757581,30
1,1421,44670,3578757551,3578757581,30
1,1421,44671,3578757551,3578757581,30
1,1421,44672,3578757551,3578757582,31
1,1421,44673,3578757551,3578757585,34
1,1421,44674,3578757551,3578757585,34
1,1421,44675,3578757551,3578757586,35
1,1421,44676,3578757551,3578757588,37
1,1421,44677,3578757551,3578757591,40
1,1421,44678,3578757551,3578757592,41
1,1421,44679,3578757551,3578757592,41
1,1421,44680,3578757551,3578757594,43
1,1421,44681,3578757551,3578757594,43
1,1421,44682,3578757551,3578757595,44
1,1421,44683,3578757551,3578757595,44
1,1421,44684,3578757551,3578757595,44
1,1421,44685,3578757551,3578757595,44
1,1421,44686,3578757551,3578757597,46
1,1421,44687,3578757551,3578757598,47
1,1421,44688,3578757551,3578757598,47
1,1421,44689,3578757551,3578757598,47
1,1421,44690,3578757551,3578757599,48
1,1421,44691,3578757551,3578757599,48
1,1421,44692,3578757551,3578757600,49
1,1422,44693,3578757615,3578757616,1
1,1422,44694,3578757615,3578757616,1
1,1422,44695,3578757615,3578757616,1
1,1422,44696,3578757615,3578757616,1
1,1422,44697,3578757615,3578757616,1
1,1422,44698,3578757615,3578757616,1
1,1422,44699,3578757615,3578757616,1
1,1422,44700,3578757615,3578757616,1
1,1422,44701,3578757615,3578757616,1
1,1422,44702,3578757615,3578757617,2
1,1422,44703,3578757615,3578757617,2
1,1422,44704,3578757615,3578757618,3
1,1422,44705,3578757615,3578757618,3
1,1422,44706,3578757615,3578757619,4
1,1422,44707,3578757615,3578757619,4
1,1422,44708,3578757615,3578757620,5
1,1422,44709,3578757615,3578757620,5
1,1422,44710,3578757615,3578757621,6
1,1422,44711,3578757615,3578757621,6
1,1422,44712,3578757615,3578757622,7
1,1422,44713,3578757615,3578757624,9
1,1422,44714,3578757615,3578757626,11
1,1422,44715,3578757615,3578757628,13
1,1422,44716,3578757615,3578757629,14
1,1422,44717,3578757615,3578757629,14
1,1422,44718,3578757615,3578757630,15
1,1422,44719,3578757615,3578757631,16
1,1422,44720,3578757615,3578757632,17
1,1422,44721,3578757615,3578757633,18
1,1422,44722,3578757615,3578757634,19
1,1422,44723,3578757615,3578757634,19
1,1422,44724,3578757615,3578757636,21
1,1422,44725,3578757615,3578757638,23
1,1422,44726,3578757615,3578757639,24
1,1422,44727,3578757615,3578757639,24
1,1422,44728,3578757615,3578757641,26
1,1422,44729,3578757615,3578757646,31
1,1422,44730,3578757615,3578757647,32
1,1422,44731,3578757615,3578757649,34
1,1422,44732,3578757615,3578757649,34
1,1422,44733,3578757615,3578757650,35
1,1422,44734,3578757615,3578757652,37
1,1422,44735,3578757615,3578757652,37
1,1422,44736,3578757615,3578757653,38
1,1422,44737,3578757615,3578757655,40
1,1422,44738,3578757615,3578757656,41
1,1422,44739,3578757615,3578757658,43
1,1422,44740,3578757615,3578757661,46
1,1422,44741,3578757615,3578757662,47
1,1422,44742,3578757615,3578757662,47
1,1422,44743,3578757615,3578757662,47
1,1422,44744,3578757615,3578757663,48
1,1422,44745,3578757615,3578757664,49
1,1423,44746,3578757679,3578757679,0
1,1423,44747,3578757679,3578757679,0
1,1423,44748,3578757679,3578757679,0
1,1423,44749,3578757679,3578757679,0
1,1423,44750,3578757679,3578757679,0
1,1423,44751,3578757679,3578757680,1
1,1423,44752,3578757679,3578757681,2
1,1423,44753,3578757679,3578757683,4
1,1423,44754,3578757679,3578757683,4
1,1423,44755,3578757679,3578757683,4
1,1423,44756,3578757679,3578757683,4
1,1423,44757,3578757679,3578757685,6
1,1423,44758,3578757679,3578757687,8
1,1423,44759,3578757679,3578757687,8
1,1423,44760,3578757679,3578757689,10
1,1423,44761,3578757679,3578757689,10
1,1423,44762,3578757679,3578757690,11
1,1423,44763,3578757679,3578757691,12
1,1423,44764,3578757679,3578757691,12
1,1423,44765,3578757679,3578757692,13
1,1423,44766,3578757679,3578757693,14
1,1423,44767,3578757679,3578757693,14
1,1423,44768,3578757679,3578757694,15
1,1423,44769,3578757679,3578757695,16
1,1423,44770,3578757679,3578757695,16
1,1423,44771,3578757679,3578757695,16
1,1423,44772,3578757679,3578757697,18
1,1423,44773,3578757679,3578757697,18
1,1423,44774,3578757679,3578757697,18
1,1423,44775,3578757679,3578757698,19
1,1423,44776,3578757679,3578757702,23
1,1423,44777,3578757679,3578757702,23
1,1423,44778,3578757679,3578757702,23
1,1423,44779,3578757679,3578757703,24
1,1423,44780,3578757679,3578757704,25
1,1423,44781,3578757679,3578757704,25
1,1423,44782,3578757679,3578757705,26
1,1423,44783,3578757679,3578757706,27
1,1423,44784,3578757679,3578757706,27
1,1423,44785,3578757679,3578757707,28
1,1423,44786,3578757679,3578757709,30
1,1423,44787,3578757679,3578757709,30
1,1423,44788,3578757679,3578757709,30
1,1423,44789,3578757679,3578757710,31
1,1423,44790,3578757679,3578757710,31
1,1423,44791,3578757679,3578757711,32
1,1423,44792,3578757679,3578757711,32
1,1423,44793,3578757679,3578757711,32
1,1423,44794,3578757679,3578757712,33
1,1423,44795,3578757679,3578757712,33
1,1423,44796,3578757679,3578757713,34
1,1423,44797,3578757679,3578757714,35
1,1423,44798,3578757679,3578757714,35
1,1423,44799,3578757679,3578757714,35
1,1423,44800,3578757679,3578757715,36
1,1423,44801,3578757679,3578757715,36
1,1423,44802,3578757679,3578757715,36
1,1423,44803,3578757679,3578757718,39
1,1423,44804,3578757679,3578757719,40
1,1423,44805,3578757679,3578757720,41
1,1423,44806,3578757679,3578757720,41
1,1423,44807,3578757679,3578757721,42
1,1423,44808,3578757679,3578757721,42
1,1423,44809,3578757679,3578757722,43
1,1423,44810,3578757679,3578757723,44
1,1423,44811,3578757679,3578757723,44
1,1423,44812,3578757679,3578757723,44
1,1423,44813,3578757679,3578757724,45
1,1423,44814,3578757679,3578757726,47
1,1423,44815,3578757679,3578757726,47
1,1423,44816,3578757679,3578757727,48
1,1423,44817,3578757679,3578757727,48
1,1423,44818,3578757679,3578757729,50
1,1424,44819,3578757743,3578757743,0
1,1424,44820,3578757743,3578757743,0
1,1424,44821,3578757743,3578757743,0
1,1424,44822,3578757743,3578757743,0
1,1424,44823,3578757743,3578757743,0
1,1424,44824,3578757743,3578757743,0
1,1424,44825,3578757743,3578757743,0
1,1424,44826,3578757743,3578757743,0
1,1424,44827,3578757743,3578757743,0
1,1424,44828,3578757743,3578757743,0
1,1424,44829,3578757743,3578757743,0
1,1424,44830,3578757743,3578757743,0
1,1424,44831,3578757743,3578757743,0
1,1424,44832,3578757743,3578757743,0
1,1424,44833,3578757743,3578757743,0
1,1424,44834,3578757743,3578757743,0
1,1424,44835,3578757743,3578757745,2
1,1424,44836,3578757743,3578757747,4
1,1424,44837,3578757743,3578757747,4
1,1424,44838,3578757743,3578757748,5
1,1424,44839,3578757743,3578757753,10
1,1424,44840,3578757743,3578757755,12
1,1424,44841,3578757743,3578757756,13
1,1424,44842,3578757743,3578757757,14
1,1424,44843,3578757743,3578757758,15
1,1424,44844,3578757743,3578757759,16
1,1424,44845,3578757743,3578757762,19
1,1424,44846,3578757743,3578757762,19
1,1424,44847,3578757743,3578757763,20
1,1424,44848,3578757743,3578757763,20
1,1424,44849,3578757743,3578757764,21
1,1424,44850,3578757743,3578757764,21
1,1424,44851,3578757743,3578757765,22
1,1424,44852,3578757743,3578757765,22
1,1424,44853,3578757743,3578757765,22
1,1424,44854,3578757743,3578757766,23
1,1424,44855,3578757743,3578757767,24
1,1424,44856,3578757743,3578757768,25
1,1424,44857,3578757743,3578757770,27
1,1424,44858,3578757743,3578757770,27
1,1424,44859,3578757743,3578757771,28
1,1424,44860,3578757743,3578757772,29
1,1424,44861,3578757743,3578757774,31
1,1424,44862,3578757743,3578757776,33
1,1424,44863,3578757743,3578757777,34
1,1424,44864,3578757743,3578757778,35
1,1424,44865,3578757743,3578757778,35
1,1424,44866,3578757743,3578757779,36
1,1424,44867,3578757743,3578757779,36
1,1424,44868,3578757743,3578757780,37
1,1424,44869,3578757743,3578757780,37
1,1424,44870,3578757743,3578757781,38
1,1424,44871,3578757743,3578757781,38
1,1424,44872,3578757743,3578757781,38
1,1424,44873,3578757743,3578757782,39
1,1424,44874,3578757743,3578757783,40
1,1424,44875,3578757743,3578757784,41
1,1424,44876,3578757743,3578757784,41
1,1424,44877,3578757743,3578757786,43
1,1424,44878,3578757743,3578757786,43
1,1424,44879,3578757743,3578757788,45
1,1424,44880,3578757743,3578757791,48
1,1424,44881,3578757743,3578757792,49
1,1424,44882,3578757743,3578757792,49
1,1424,44883,3578757743,3578757793,50
1,1425,44884,3578757805,3578757805,0
1,1425,44885,3578757805,3578757805,0
1,1425,44886,3578757805,3578757805,0
1,1425,44887,3578757805,3578757805,0
1,1425,44888,3578757805,3578757805,0
1,1425,44889,3578757805,3578757805,0
1,1425,44890,3578757805,3578757805,0
1,1425,44891,3578757805,3578757805,0
1,1425,44892,3578757805,3578757805,0
1,1425,44893,3578757805,3578757805,0
1,1425,44894,3578757805,3578757805,0
1,1425,44895,3578757805,3578757805,0
1,1425,44896,3578757805,3578757805,0
1,1425,44897,3578757805,3578757805,0
1,1425,44898,3578757805,3578757806,1
1,1425,44899,3578757805,3578757808,3
1,1425,44900,3578757805,3578757809,4
1,1425,44901,3578757805,3578757810,5
1,1425,44902,3578757805,3578757812,7
1,1425,44903,3578757805,3578757812,7
1,1425,44904,3578757805,3578757813,8
1,1425,44905,3578757805,3578757814,9
1,1425,44906,3578757805,3578757816,11
1,1425,44907,3578757805,3578757816,11
1,1425,44908,3578757805,3578757816,11
1,1425,44909,3578757805,3578757817,12
1,1425,44910,3578757805,3578757817,12
1,1425,44911,3578757805,3578757819,14
1,1425,44912,3578757805,3578757819,14
1,1425,44913,3578757805,3578757819,14
1,1425,44914,3578757805,3578757820,15
1,1425,44915,3578757805,3578757820,15
1,1425,44916,3578757805,3578757821,16
1,1425,44917,3578757805,3578757821,16
1,1425,44918,3578757805,3578757821,16
1,1425,44919,3578757805,3578757823,18
1,1425,44920,3578757805,3578757824,19
1,1425,44921,3578757805,3578757826,21
1,1425,44922,3578757805,3578757828,23
1,1425,44923,3578757805,3578757829,24
1,1425,44924,3578757805,3578757829,24
1,1425,44925,3578757805,3578757829,24
1,1425,44926,3578757805,3578757830,25
1,1425,44927,3578757805,3578757831,26
1,1425,44928,3578757805,3578757832,27
1,1425,44929,3578757805,3578757834,29
1,1425,44930,3578757805,3578757834,29
1,1425,44931,3578757805,3578757835,30
1,1425,44932,3578757805,3578757837,32
1,1425,44933,3578757805,3578757838,33
1,1425,44934,3578757805,3578757838,33
1,1425,44935,3578757805,3578757839,34
1,1425,44936,3578757805,3578757839,34
1,1425,44937,3578757805,3578757841,36
1,1425,44938,3578757805,3578757841,36
1,1425,44939,3578757805,3578757847,42
1,1425,44940,3578757805,3578757848,43
1,1425,44941,3578757805,3578757849,44
1,1425,44942,3578757805,3578757849,44
1,1425,44943,3578757805,3578757849,44
1,1425,44944,3578757805,3578757853,48
1,1425,44945,3578757805,3578757853,48
1,1425,44946,3578757805,3578757855,50
1,1426,44947,3578757868,3578757868,0
1,1426,44948,3578757868,3578757868,0
1,1426,44949,3578757868,3578757868,0
1,1426,44950,3578757868,3578757868,0
1,1426,44951,3578757868,3578757868,0
1,1426,44952,3578757868,3578757868,0
1,1426,44953,3578757868,3578757868,0
1,1426,44954,3578757868,3578757868,0
1,1426,44955,3578757868,3578757868,0
1,1426,44956,3578757868,3578757868,0
1,1426,44957,3578757868,3578757870,2
1,1426,44958,3578757868,3578757878,10
1,1426,44959,3578757868,3578757879,11
1,1426,44960,3578757868,3578757879,11
1,1426,44961,3578757868,3578757881,13
1,1426,44962,3578757868,3578757881,13
1,1426,44963,3578757868,3578757883,15
1,1426,44964,3578757868,3578757884,16
1,1426,44965,3578757868,3578757884,16
1,1426,44966,3578757868,3578757886,18
1,1426,44967,3578757868,3578757887,19
1,1426,44968,3578757868,3578757887,19
1,1426,44969,3578757868,3578757889,21
1,1426,44970,3578757868,3578757889,21
1,1426,44971,3578757868,3578757890,22
1,1426,44972,3578757868,3578757891,23
1,1426,44973,3578757868,3578757891,23
1,1426,44974,3578757868,3578757892,24
1,1426,44975,3578757868,3578757892,24
1,1426,44976,3578757868,3578757893,25
1,1426,44977,3578757868,3578757894,26
1,1426,44978,3578757868,3578757895,27
1,1426,44979,3578757868,3578757895,27
1,1426,44980,3578757868,3578757896,28
1,1426,44981,3578757868,3578757896,28
1,1426,44982,3578757868,3578757897,29
1,1426,44983,3578757868,3578757898,30
1,1426,44984,3578757868,3578757898,30
1,1426,44985,3578757868,3578757902,34
1,1426,44986,3578757868,3578757902,34
1,1426,44987,3578757868,3578757903,35
1,1426,44988,3578757868,3578757903,35
1,1426,44989,3578757868,3578757904,36
1,1426,44990,3578757868,3578757904,36
1,1426,44991,3578757868,3578757905,37
1,1426,44992,3578757868,3578757906,38
1,1426,44993,3578757868,3578757906,38
1,1426,44994,3578757868,3578757909,41
1,1426,44995,3578757868,3578757909,41
1,1426,44996,3578757868,3578757910,42
1,1426,44997,3578757868,3578757910,42
1,1426,44998,3578757868,3578757910,42
1,1426,44999,3578757868,3578757910,42
1,1426,45000,3578757868,3578757911,43
1,1426,45001,3578757868,3578757911,43
1,1426,45002,3578757868,3578757911,43
1,1426,45003,3578757868,3578757912,44
1,1426,45004,3578757868,3578757912,44
1,1426,45005,3578757868,3578757913,45
1,1426,45006,3578757868,3578757914,46
1,1426,45007,3578757868,3578757914,46
1,1426,45008,3578757868,3578757915,47
1,1426,45009,3578757868,3578757916,48
1,1426,45010,3578757868,3578757916,48
1,1427,45011,3578757931,3578757931,0
1,1427,45012,3578757931,3578757931,0
1,1427,45013,3578757931,3578757931,0
1,1427,45014,3578757931,3578757931,0
1,1427,45015,3578757931,3578757931,0
1,1427,45016,3578757931,3578757931,0
1,1427,45017,3578757931,3578757931,0
1,1427,45018,3578757931,3578757931,0
1,1427,45019,3578757931,3578757931,0
1,1427,45020,3578757931,3578757931,0
1,1427,45021,3578757931,3578757931,0
1,1427,45022,3578757931,3578757931,0
1,1427,45023,3578757931,3578757931,0
1,1427,45024,3578757931,3578757931,0
1,1427,45025,3578757931,3578757931,0
1,1427,45026,3578757931,3578757931,0
1,1427,45027,3578757931,3578757931,0
1,1427,45028,3578757931,3578757931,0
1,1427,45029,3578757931,3578757931,0
1,1427,45030,3578757931,3578757931,0
1,1427,45031,3578757931,3578757931,0
1,1427,45032,3578757931,3578757932,1
1,1427,45033,3578757931,3578757932,1
1,1427,45034,3578757931,3578757933,2
1,1427,45035,3578757931,3578757933,2
1,1427,45036,3578757931,3578757935,4
1,1427,45037,3578757931,3578757935,4
1,1427,45038,3578757931,3578757936,5
1,1427,45039,3578757931,3578757936,5
1,1427,45040,3578757931,3578757937,6
1,1427,45041,3578757931,3578757937,6
1,1427,45042,3578757931,3578757937,6
1,1427,45043,3578757931,3578757937,6
1,1427,45044,3578757931,3578757940,9
1,1427,45045,3578757931,3578757941,10
1,1427,45046,3578757931,3578757941,10
1,1427,45047,3578757931,3578757946,15
1,1427,45048,3578757931,3578757946,15
1,1427,45049,3578757931,3578757948,17
1,1427,45050,3578757931,3578757950,19
1,1427,45051,3578757931,3578757953,22
1,1427,45052,3578757931,3578757955,24
1,1427,45053,3578757931,3578757955,24
1,1427,45054,3578757931,3578757955,24
1,1427,45055,3578757931,3578757956,25
1,1427,45056,3578757931,3578757957,26
1,1427,45057,3578757931,3578757959,28
1,1427,45058,3578757931,3578757961,30
1,1427,45059,3578757931,3578757963,32
1,1427,45060,3578757931,3578757963,32
1,1427,45061,3578757931,3578757963,32
1,1427,45062,3578757931,3578757965,34
1,1427,45063,3578757931,3578757965,34
1,1427,45064,3578757931,3578757965,34
1,1427,45065,3578757931,3578757965,34
1,1427,45066,3578757931,3578757965,34
1,1427,45067,3578757931,3578757965,34
1,1427,45068,3578757931,3578757966,35
1,1427,45069,3578757931,3578757968,37
1,1427,45070,3578757931,3578757970,39
1,1427,45071,3578757931,3578757970,39
1,1427,45072,3578757931,3578757972,41
1,1427,45073,3578757931,3578757974,43
1,1427,45074,3578757931,3578757976,45
1,1427,45075,3578757931,3578757977,46
1,1427,45076,3578757931,3578757978,47
1,1427,45077,3578757931,3578757978,47
1,1427,45078,3578757931,3578757979,48
1,1427,45079,3578757931,3578757980,49
1,1427,45080,3578757931,3578757980,49
1,1427,45081,3578757931,3578757980,49
1,1427,45082,3578757931,3578757981,50
1,1428,45083,3578757995,3578757995,0
1,1428,45084,3578757995,3578757995,0
1,1428,45085,3578757995,3578757995,0
1,1428,45086,3578757995,3578757995,0
1,1428,45087,3578757995,3578757995,0
1,1428,45088,3578757995,3578757995,0
1,1428,45089,3578757995,3578757995,0
1,1428,45090,3578757995,3578757995,0
1,1428,45091,3578757995,3578757995,0
1,1428,45092,3578757995,3578757995,0
1,1428,45093,3578757995,3578757995,0
1,1428,45094,3578757995,3578757995,0
1,1428,45095,3578757995,3578757995,0
1,1428,45096,3578757995,3578757995,0
1,1428,45097,3578757995,3578757995,0
1,1428,45098,3578757995,3578757996,1
1,1428,45099,3578757995,3578757996,1
1,1428,45100,3578757995,3578757997,2
1,1428,45101,3578757995,3578757997,2
1,1428,45102,3578757995,3578757997,2
1,1428,45103,3578757995,3578757997,2
1,1428,45104,3578757995,3578757998,3
1,1428,45105,3578757995,3578757999,4
1,1428,45106,3578757995,3578758001,6
1,1428,45107,3578757995,3578758001,6
1,1428,45108,3578757995,3578758001,6
1,1428,45109,3578757995,3578758001,6
1,1428,45110,3578757995,3578758006,11
1,1428,45111,3578757995,3578758008,13
1,1428,45112,3578757995,3578758009,14
1,1428,45113,3578757995,3578758012,17
1,1428,45114,3578757995,3578758012,17
1,1428,45115,3578757995,3578758012,17
1,1428,45116,3578757995,3578758013,18
1,1428,45117,3578757995,3578758013,18
1,1428,45118,3578757995,3578758016,21
1,1428,45119,3578757995,3578758016,21
1,1428,45120,3578757995,3578758017,22
1,1428,45121,3578757995,3578758018,23
1,1428,45122,3578757995,3578758018,23
1,1428,45123,3578757995,3578758019,24
1,1428,45124,3578757995,3578758020,25
1,1428,45125,3578757995,3578758020,25
1,1428,45126,3578757995,3578758020,25
1,1428,45127,3578757995,3578758020,25
1,1428,45128,3578757995,3578758021,26
1,1428,45129,3578757995,3578758021,26
1,1428,45130,3578757995,3578758022,27
1,1428,45131,3578757995,3578758025,30
1,1428,45132,3578757995,3578758027,32
1,1428,45133,3578757995,3578758028,33
1,1428,45134,3578757995,3578758029,34
1,1428,45135,3578757995,3578758030,35
1,1428,45136,3578757995,3578758030,35
1,1428,45137,3578757995,3578758031,36
1,1428,45138,3578757995,3578758031,36
1,1428,45139,3578757995,3578758032,37
1,1428,45140,3578757995,3578758034,39
1,1428,45141,3578757995,3578758034,39
1,1428,45142,3578757995,3578758035,40
1,1428,45143,3578757995,3578758037,42
1,1428,45144,3578757995,3578758037,42
1,1428,45145,3578757995,3578758038,43
1,1428,45146,3578757995,3578758039,44
1,1428,45147,3578757995,3578758039,44
1,1428,45148,3578757995,3578758040,45
1,1428,45149,3578757995,3578758041,46
1,1429,45150,3578758059,3578758059,0
1,1429,45151,3578758059,3578758059,0
1,1429,45152,3578758059,3578758059,0
1,1429,45153,3578758059,3578758059,0
1,1429,45154,3578758059,3578758059,0
1,1429,45155,3578758059,3578758059,0
1,1429,45156,3578758059,3578758059,0
1,1429,45157,3578758059,3578758059,0
1,1429,45158,3578758059,3578758059,0
1,1429,45159,3578758059,3578758060,1
1,1429,45160,3578758059,3578758063,4
1,1429,45161,3578758059,3578758063,4
1,1429,45162,3578758059,3578758064,5
1,1429,45163,3578758059,3578758065,6
1,1429,45164,3578758059,3578758065,6
1,1429,45165,3578758059,3578758067,8
1,1429,45166,3578758059,3578758068,9
1,1429,45167,3578758059,3578758069,10
1,1429,45168,3578758059,3578758078,19
1,1429,45169,3578758059,3578758079,20
1,1429,45170,3578758059,3578758081,22
1,1429,45171,3578758059,3578758081,22
1,1429,45172,3578758059,3578758084,25
1,1429,45173,3578758059,3578758084,25
1,1429,45174,3578758059,3578758084,25
1,1429,45175,3578758059,3578758086,27
1,1429,45176,3578758059,3578758087,28
1,1429,45177,3578758059,3578758087,28
1,1429,45178,3578758059,3578758089,30
1,1429,45179,3578758059,3578758089,30
1,1429,45180,3578758059,3578758090,31
1,1429,45181,3578758059,3578758091,32
1,1429,45182,3578758059,3578758091,32
1,1429,45183,3578758059,3578758091,32
1,1429,45184,3578758059,3578758092,33
1,1429,45185,3578758059,3578758093,34
1,1429,45186,3578758059,3578758094,35
1,1429,45187,3578758059,3578758094,35
1,1429,45188,3578758059,3578758096,37
1,1429,45189,3578758059,3578758096,37
1,1429,45190,3578758059,3578758096,37
1,1429,45191,3578758059,3578758098,39
1,1429,45192,3578758059,3578758098,39
1,1429,45193,3578758059,3578758102,43
1,1429,45194,3578758059,3578758102,43
1,1429,45195,3578758059,3578758103,44
1,1429,45196,3578758059,3578758103,44
1,1429,45197,3578758059,3578758104,45
1,1429,45198,3578758059,3578758104,45
1,1429,45199,3578758059,3578758105,46
1,1429,45200,3578758059,3578758106,47
1,1429,45201,3578758059,3578758106,47
1,1429,45202,3578758059,3578758107,48
1,1429,45203,3578758059,3578758109,50
1,1430,45204,3578758123,3578758123,0
1,1430,45205,3578758123,3578758123,0
1,1430,45206,3578758123,3578758123,0
1,1430,45207,3578758123,3578758123,0
1,1430,45208,3578758123,3578758123,0
1,1430,45209,3578758123,3578758123,0
1,1430,45210,3578758123,3578758123,0
1,1430,45211,3578758123,3578758123,0
1,1430,45212,3578758123,3578758123,0
1,1430,45213,3578758123,3578758123,0
1,1430,45214,3578758123,3578758123,0
1,1430,45215,3578758123,3578758123,0
1,1430,45216,3578758123,3578758123,0
1,1430,45217,3578758123,3578758123,0
1,1430,45218,3578758123,3578758123,0
1,1430,45219,3578758123,3578758123,0
1,1430,45220,3578758123,3578758123,0
1,1430,45221,3578758123,3578758123,0
1,1430,45222,3578758123,3578758123,0
1,1430,45223,3578758123,3578758123,0
1,1430,45224,3578758123,3578758123,0
1,1430,45225,3578758123,3578758123,0
1,1430,45226,3578758123,3578758123,0
1,1430,45227,3578758123,3578758123,0
1,1430,45228,3578758123,3578758124,1
1,1430,45229,3578758123,3578758125,2
1,1430,45230,3578758123,3578758126,3
1,1430,45231,3578758123,3578758126,3
1,1430,45232,3578758123,3578758127,4
1,1430,45233,3578758123,3578758127,4
1,1430,45234,3578758123,3578758129,6
1,1430,45235,3578758123,3578758129,6
1,1430,45236,3578758123,3578758129,6
1,1430,45237,3578758123,3578758130,7
1,1430,45238,3578758123,3578758130,7
1,1430,45239,3578758123,3578758131,8
1,1430,45240,3578758123,3578758132,9
1,1430,45241,3578758123,3578758133,10
1,1430,45242,3578758123,3578758133,10
1,1430,45243,3578758123,3578758133,10
1,1430,45244,3578758123,3578758135,12
1,1430,45245,3578758123,3578758135,12
1,1430,45246,3578758123,3578758137,14
1,1430,45247,3578758123,3578758138,15
1,1430,45248,3578758123,3578758138,15
1,1430,45249,3578758123,3578758140,17
1,1430,45250,3578758123,3578758141,18
1,1430,45251,3578758123,3578758141,18
1,1430,45252,3578758123,3578758146,23
1,1430,45253,3578758123,3578758148,25
1,1430,45254,3578758123,3578758148,25
1,1430,45255,3578758123,3578758150,27
1,1430,45256,3578758123,3578758153,30
1,1430,45257,3578758123,3578758155,32
1,1430,45258,3578758123,3578758155,32
1,1430,45259,3578758123,3578758155,32
1,1430,45260,3578758123,3578758156,33
1,1430,45261,3578758123,3578758158,35
1,1430,45262,3578758123,3578758159,36
1,1430,45263,3578758123,3578758162,39
1,1430,45264,3578758123,3578758163,40
1,1430,45265,3578758123,3578758163,40
1,1430,45266,3578758123,3578758163,40
1,1430,45267,3578758123,3578758164,41
1,1430,45268,3578758123,3578758165,42
1,1430,45269,3578758123,3578758166,43
1,1430,45270,3578758123,3578758166,43
1,1430,45271,3578758123,3578758166,43
1,1430,45272,3578758123,3578758166,43
1,1430,45273,3578758123,3578758166,43
1,1430,45274,3578758123,3578758168,45
1,1430,45275,3578758123,3578758170,47
1,1430,45276,3578758123,3578758170,47
1,1430,45277,3578758123,3578758171,48
1,1430,45278,3578758123,3578758172,49
1,1431,45279,3578758185,3578758185,0
1,1431,45280,3578758185,3578758185,0
1,1431,45281,3578758185,3578758185,0
1,1431,45282,3578758185,3578758185,0
1,1431,45283,3578758185,3578758185,0
1,1431,45284,3578758185,3578758185,0
1,1431,45285,3578758185,3578758185,0
1,1431,45286,3578758185,3578758185,0
1,1431,45287,3578758185,3578758185,0
1,1431,45288,3578758185,3578758185,0
1,1431,45289,3578758185,3578758185,0
1,1431,45290,3578758185,3578758185,0
1,1431,45291,3578758185,3578758185,0
1,1431,45292,3578758185,3578758185,0
1,1431,45293,3578758185,3578758185,0
1,1431,45294,3578758185,3578758185,0
1,1431,45295,3578758185,3578758185,0
1,1431,45296,3578758185,3578758188,3
1,1431,45297,3578758185,3578758191,6
1,1431,45298,3578758185,3578758192,7
1,1431,45299,3578758185,3578758192,7
1,1431,45300,3578758185,3578758192,7
1,1431,45301,3578758185,3578758194,9
1,1431,45302,3578758185,3578758194,9
1,1431,45303,3578758185,3578758194,9
1,1431,45304,3578758185,3578758195,10
1,1431,45305,3578758185,3578758196,11
1,1431,45306,3578758185,3578758197,12
1,1431,45307,3578758185,3578758197,12
1,1431,45308,3578758185,3578758197,12
1,1431,45309,3578758185,3578758198,13
1,1431,45310,3578758185,3578758199,14
1,1431,45311,3578758185,3578758199,14
1,1431,45312,3578758185,3578758201,16
1,1431,45313,3578758185,3578758201,16
1,1431,45314,3578758185,3578758201,16
1,1431,45315,3578758185,3578758203,18
1,1431,45316,3578758185,3578758203,18
1,1431,45317,3578758185,3578758205,20
1,1431,45318,3578758185,3578758208,23
1,1431,45319,3578758185,3578758209,24
1,1431,45320,3578758185,3578758211,26
1,1431,45321,3578758185,3578758213,28
1,1431,45322,3578758185,3578758213,28
1,1431,45323,3578758185,3578758214,29
1,1431,45324,3578758185,3578758214,29
1,1431,45325,3578758185,3578758216,31
1,1431,45326,3578758185,3578758217,32
1,1431,45327,3578758185,3578758217,32
1,1431,45328,3578758185,3578758217,32
1,1431,45329,3578758185,3578758218,33
1,1431,45330,3578758185,3578758219,34
1,1431,45331,3578758185,3578758220,35
1,1431,45332,3578758185,3578758220,35
1,1431,45333,3578758185,3578758220,35
1,1431,45334,3578758185,3578758220,35
1,1431,45335,3578758185,3578758220,35
1,1431,45336,3578758185,3578758221,36
1,1431,45337,3578758185,3578758222,37
1,1431,45338,3578758185,3578758222,37
1,1431,45339,3578758185,3578758224,39
1,1431,45340,3578758185,3578758225,40
1,1431,45341,3578758185,3578758227,42
1,1431,45342,3578758185,3578758229,44
1,1431,45343,3578758185,3578758230,45
1,1431,45344,3578758185,3578758230,45
1,1431,45345,3578758185,3578758230,45
1,1431,45346,3578758185,3578758232,47
1,1431,45347,3578758185,3578758232,47
1,1431,45348,3578758185,3578758234,49
1,1431,45349,3578758185,3578758235,50
1,1432,45350,3578758248,3578758248,0
1,1432,45351,3578758248,3578758248,0
1,1432,45352,3578758248,3578758248,0
1,1432,45353,3578758248,3578758248,0
1,1432,45354,3578758248,3578758248,0
1,1432,45355,3578758248,3578758248,0
1,1432,45356,3578758248,3578758248,0
1,1432,45357,3578758248,3578758249,1
1,1432,45358,3578758248,3578758249,1
1,1432,45359,3578758248,3578758249,1
1,1432,45360,3578758248,3578758249,1
1,1432,45361,3578758248,3578758249,1
1,1432,45362,3578758248,3578758252,4
1,1432,45363,3578758248,3578758253,5
1,1432,45364,3578758248,3578758254,6
1,1432,45365,3578758248,3578758255,7
1,1432,45366,3578758248,3578758257,9
1,1432,45367,3578758248,3578758259,11
1,1432,45368,3578758248,3578758260,12
1,1432,45369,3578758248,3578758261,13
1,1432,45370,3578758248,3578758263,15
1,1432,45371,3578758248,3578758263,15
1,1432,45372,3578758248,3578758263,15
1,1432,45373,3578758248,3578758264,16
1,1432,45374,3578758248,3578758264,16
1,1432,45375,3578758248,3578758265,17
1,1432,45376,3578758248,3578758267,19
1,1432,45377,3578758248,3578758268,20
1,1432,45378,3578758248,3578758269,21
1,1432,45379,3578758248,3578758278,30
1,1432,45380,3578758248,3578758279,31
1,1432,45381,3578758248,3578758280,32
1,1432,45382,3578758248,3578758282,34
1,1432,45383,3578758248,3578758283,35
1,1432,45384,3578758248,3578758283,35
1,1432,45385,3578758248,3578758283,35
1,1432,45386,3578758248,3578758287,39
1,1432,45387,3578758248,3578758287,39
1,1432,45388,3578758248,3578758289,41
1,1432,45389,3578758248,3578758289,41
1,1432,45390,3578758248,3578758290,42
1,1432,45391,3578758248,3578758291,43
1,1432,45392,3578758248,3578758291,43
1,1432,45393,3578758248,3578758291,43
1,1432,45394,3578758248,3578758293,45
1,1432,45395,3578758248,3578758293,45
1,1432,45396,3578758248,3578758294,46
1,1432,45397,3578758248,3578758295,47
1,1432,45398,3578758248,3578758295,47
1,1432,45399,3578758248,3578758296,48
1,1432,45400,3578758248,3578758298,50
1,1432,45401,3578758248,3578758298,50
1,1433,45402,3578758311,3578758311,0
1,1433,45403,3578758311,3578758311,0
1,1433,45404,3578758311,3578758311,0
1,1433,45405,3578758311,3578758311,0
1,1433,45406,3578758311,3578758311,0
1,1433,45407,3578758311,3578758311,0
1,1433,45408,3578758311,3578758311,0
1,1433,45409,3578758311,3578758311,0
1,1433,45410,3578758311,3578758311,0
1,1433,45411,3578758311,3578758311,0
1,1433,45412,3578758311,3578758311,0
1,1433,45413,3578758311,3578758311,0
1,1433,45414,3578758311,3578758311,0
1,1433,45415,3578758311,3578758311,0
1,1433,45416,3578758311,3578758311,0
1,1433,45417,3578758311,3578758311,0
1,1433,45418,3578758311,3578758311,0
1,1433,45419,3578758311,3578758311,0
1,1433,45420,3578758311,3578758312,1
1,1433,45421,3578758311,3578758313,2
1,1433,45422,3578758311,3578758314,3
1,1433,45423,3578758311,3578758315,4
1,1433,45424,3578758311,3578758315,4
1,1433,45425,3578758311,3578758315,4
1,1433,45426,3578758311,3578758316,5
1,1433,45427,3578758311,3578758318,7
1,1433,45428,3578758311,3578758319,8
1,1433,45429,3578758311,3578758319,8
1,1433,45430,3578758311,3578758320,9
1,1433,45431,3578758311,3578758320,9
1,1433,45432,3578758311,3578758321,10
1,1433,45433,3578758311,3578758323,12
1,1433,45434,3578758311,3578758323,12
1,1433,45435,3578758311,3578758324,13
1,1433,45436,3578758311,3578758325,14
1,1433,45437,3578758311,3578758326,15
1,1433,45438,3578758311,3578758327,16
1,1433,45439,3578758311,3578758327,16
1,1433,45440,3578758311,3578758329,18
1,1433,45441,3578758311,3578758329,18
1,1433,45442,3578758311,3578758330,19
1,1433,45443,3578758311,3578758331,20
1,1433,45444,3578758311,3578758331,20
1,1433,45445,3578758311,3578758332,21
1,1433,45446,3578758311,3578758333,22
1,1433,45447,3578758311,3578758333,22
1,1433,45448,3578758311,3578758335,24
1,1433,45449,3578758311,3578758335,24
1,1433,45450,3578758311,3578758336,25
1,1433,45451,3578758311,3578758337,26
1,1433,45452,3578758311,3578758337,26
1,1433,45453,3578758311,3578758338,27
1,1433,45454,3578758311,3578758341,30
1,1433,45455,3578758311,3578758341,30
1,1433,45456,3578758311,3578758341,30
1,1433,45457,3578758311,3578758342,31
1,1433,45458,3578758311,3578758344,33
1,1433,45459,3578758311,3578758347,36
1,1433,45460,3578758311,3578758348,37
1,1433,45461,3578758311,3578758348,37
1,1433,45462,3578758311,3578758350,39
1,1433,45463,3578758311,3578758353,42
1,1433,45464,3578758311,3578758354,43
1,1433,45465,3578758311,3578758355,44
1,1433,45466,3578758311,3578758355,44
1,1433,45467,3578758311,3578758356,45
1,1433,45468,3578758311,3578758360,49
1,1434,45469,3578758375,3578758375,0
1,1434,45470,3578758375,3578758375,0
1,1434,45471,3578758375,3578758375,0
1,1434,45472,3578758375,3578758375,0
1,1434,45473,3578758375,3578758375,0
1,1434,45474,3578758375,3578758375,0
1,1434,45475,3578758375,3578758375,0
1,1434,45476,3578758375,3578758375,0
1,1434,45477,3578758375,3578758375,0
1,1434,45478,3578758375,3578758375,0
1,1434,45479,3578758375,3578758375,0
1,1434,45480,3578758375,3578758375,0
1,1434,45481,3578758375,3578758375,0
1,1434,45482,3578758375,3578758375,0
1,1434,45483,3578758375,3578758375,0
1,1434,45484,3578758375,3578758375,0
1,1434,45485,3578758375,3578758375,0
1,1434,45486,3578758375,3578758376,1
1,1434,45487,3578758375,3578758376,1
1,1434,45488,3578758375,3578758377,2
1,1434,45489,3578758375,3578758378,3
1,1434,45490,3578758375,3578758379,4
1,1434,45491,3578758375,3578758379,4
1,1434,45492,3578758375,3578758380,5
1,1434,45493,3578758375,3578758381,6
1,1434,45494,3578758375,3578758381,6
1,1434,45495,3578758375,3578758381,6
1,1434,45496,3578758375,3578758382,7
1,1434,45497,3578758375,3578758382,7
1,1434,45498,3578758375,3578758382,7
1,1434,45499,3578758375,3578758384,9
1,1434,45500,3578758375,3578758385,10
1,1434,45501,3578758375,3578758386,11
1,1434,45502,3578758375,3578758386,11
1,1434,45503,3578758375,3578758388,13
1,1434,45504,3578758375,3578758391,16
1,1434,45505,3578758375,3578758391,16
1,1434,45506,3578758375,3578758393,18
1,1434,45507,3578758375,3578758393,18
1,1434,45508,3578758375,3578758393,18
1,1434,45509,3578758375,3578758394,19
1,1434,45510,3578758375,3578758394,19
1,1434,45511,3578758375,3578758395,20
1,1434,45512,3578758375,3578758396,21
1,1434,45513,3578758375,3578758396,21
1,1434,45514,3578758375,3578758397,22
1,1434,45515,3578758375,3578758398,23
1,1434,45516,3578758375,3578758399,24
1,1434,45517,3578758375,3578758399,24
1,1434,45518,3578758375,3578758399,24
1,1434,45519,3578758375,3578758401,26
1,1434,45520,3578758375,3578758401,26
1,1434,45521,3578758375,3578758402,27
1,1434,45522,3578758375,3578758404,29
1,1434,45523,3578758375,3578758406,31
1,1434,45524,3578758375,3578758408,33
1,1434,45525,3578758375,3578758409,34
1,1434,45526,3578758375,3578758411,36
1,1434,45527,3578758375,3578758412,37
1,1434,45528,3578758375,3578758413,38
1,1434,45529,3578758375,3578758413,38
1,1434,45530,3578758375,3578758413,38
1,1434,45531,3578758375,3578758417,42
1,1434,45532,3578758375,3578758417,42
1,1434,45533,3578758375,3578758417,42
1,1434,45534,3578758375,3578758418,43
1,1434,45535,3578758375,3578758418,43
1,1434,45536,3578758375,3578758419,44
1,1434,45537,3578758375,3578758419,44
1,1434,45538,3578758375,3578758420,45
1,1434,45539,3578758375,3578758420,45
1,1434,45540,3578758375,3578758420,45
1,1434,45541,3578758375,3578758421,46
1,1434,45542,3578758375,3578758421,46
1,1434,45543,3578758375,3578758422,47
1,1434,45544,3578758375,3578758422,47
1,1434,45545,3578758375,3578758424,49
1,1434,45546,3578758375,3578758425,50
1,1435,45547,3578758437,3578758437,0
1,1435,45548,3578758437,3578758437,0
1,1435,45549,3578758437,3578758437,0
1,1435,45550,3578758437,3578758437,0
1,1435,45551,3578758437,3578758437,0
1,1435,45552,3578758437,3578758437,0
1,1435,45553,3578758437,3578758437,0
1,1435,45554,3578758437,3578758437,0
1,1435,45555,3578758437,3578758437,0
1,1435,45556,3578758437,3578758437,0
1,1435,45557,3578758437,3578758437,0
1,1435,45558,3578758437,3578758438,1
1,1435,45559,3578758437,3578758439,2
1,1435,45560,3578758437,3578758440,3
1,1435,45561,3578758437,3578758440,3
1,1435,45562,3578758437,3578758441,4
1,1435,45563,3578758437,3578758442,5
1,1435,45564,3578758437,3578758447,10
1,1435,45565,3578758437,3578758448,11
1,1435,45566,3578758437,3578758449,12
1,1435,45567,3578758437,3578758450,13
1,1435,45568,3578758437,3578758450,13
1,1435,45569,3578758437,3578758452,15
1,1435,45570,3578758437,3578758454,17
1,1435,45571,3578758437,3578758456,19
1,1435,45572,3578758437,3578758458,21
1,1435,45573,3578758437,3578758459,22
1,1435,45574,3578758437,3578758460,23
1,1435,45575,3578758437,3578758462,25
1,1435,45576,3578758437,3578758463,26
1,1435,45577,3578758437,3578758463,26
1,1435,45578,3578758437,3578758465,28
1,1435,45579,3578758437,3578758469,32
1,1435,45580,3578758437,3578758479,42
1,1435,45581,3578758437,3578758480,43
1,1435,45582,3578758437,3578758482,45
1,1435,45583,3578758437,3578758483,46
1,1435,45584,3578758437,3578758483,46
1,1435,45585,3578758437,3578758483,46
1,1435,45586,3578758437,3578758484,47
1,1435,45587,3578758437,3578758485,48
1,1435,45588,3578758437,3578758487,50
1,1436,45589,3578758500,3578758500,0
1,1436,45590,3578758500,3578758500,0
1,1436,45591,3578758500,3578758500,0
1,1436,45592,3578758500,3578758500,0
1,1436,45593,3578758500,3578758500,0
1,1436,45594,3578758500,3578758500,0
1,1436,45595,3578758500,3578758500,0
1,1436,45596,3578758500,3578758500,0
1,1436,45597,3578758500,3578758500,0
1,1436,45598,3578758500,3578758500,0
1,1436,45599,3578758500,3578758500,0
1,1436,45600,3578758500,3578758500,0
1,1436,45601,3578758500,3578758500,0
1,1436,45602,3578758500,3578758500,0
1,1436,45603,3578758500,3578758501,1
1,1436,45604,3578758500,3578758502,2
1,1436,45605,3578758500,3578758502,2
1,1436,45606,3578758500,3578758503,3
1,1436,45607,3578758500,3578758503,3
1,1436,45608,3578758500,3578758504,4
1,1436,45609,3578758500,3578758505,5
1,1436,45610,3578758500,3578758505,5
1,1436,45611,3578758500,3578758506,6
1,1436,45612,3578758500,3578758508,8
1,1436,45613,3578758500,3578758508,8
1,1436,45614,3578758500,3578758509,9
1,1436,45615,3578758500,3578758510,10
1,1436,45616,3578758500,3578758510,10
1,1436,45617,3578758500,3578758510,10
1,1436,45618,3578758500,3578758510,10
1,1436,45619,3578758500,3578758511,11
1,1436,45620,3578758500,3578758511,11
1,1436,45621,3578758500,3578758511,11
1,1436,45622,3578758500,3578758512,12
1,1436,45623,3578758500,3578758513,13
1,1436,45624,3578758500,3578758514,14
1,1436,45625,3578758500,3578758514,14
1,1436,45626,3578758500,3578758516,16
1,1436,45627,3578758500,3578758517,17
1,1436,45628,3578758500,3578758517,17
1,1436,45629,3578758500,3578758519,19
1,1436,45630,3578758500,3578758519,19
1,1436,45631,3578758500,3578758520,20
1,1436,45632,3578758500,3578758520,20
1,1436,45633,3578758500,3578758522,22
1,1436,45634,3578758500,3578758522,22
1,1436,45635,3578758500,3578758522,22
1,1436,45636,3578758500,3578758524,24
1,1436,45637,3578758500,3578758524,24
1,1436,45638,3578758500,3578758526,26
1,1436,45639,3578758500,3578758526,26
1,1436,45640,3578758500,3578758526,26
1,1436,45641,3578758500,3578758528,28
1,1436,45642,3578758500,3578758528,28
1,1436,45643,3578758500,3578758529,29
1,1436,45644,3578758500,3578758529,29
1,1436,45645,3578758500,3578758530,30
1,1436,45646,3578758500,3578758531,31
1,1436,45647,3578758500,3578758532,32
1,1436,45648,3578758500,3578758532,32
1,1436,45649,3578758500,3578758533,33
1,1436,45650,3578758500,3578758536,36
1,1436,45651,3578758500,3578758536,36
1,1436,45652,3578758500,3578758536,36
1,1436,45653,3578758500,3578758536,36
1,1436,45654,3578758500,3578758537,37
1,1436,45655,3578758500,3578758540,40
1,1436,45656,3578758500,3578758540,40
1,1436,45657,3578758500,3578758541,41
1,1436,45658,3578758500,3578758542,42
1,1436,45659,3578758500,3578758543,43
1,1436,45660,3578758500,3578758545,45
1,1436,45661,3578758500,3578758545,45
1,1436,45662,3578758500,3578758548,48
1,1436,45663,3578758500,3578758548,48
1,1436,45664,3578758500,3578758550,50
1,1437,45665,3578758565,3578758565,0
1,1437,45666,3578758565,3578758565,0
1,1437,45667,3578758565,3578758565,0
1,1437,45668,3578758565,3578758565,0
1,1437,45669,3578758565,3578758565,0
1,1437,45670,3578758565,3578758565,0
1,1437,45671,3578758565,3578758565,0
1,1437,45672,3578758565,3578758565,0
1,1437,45673,3578758565,3578758565,0
1,1437,45674,3578758565,3578758565,0
1,1437,45675,3578758565,3578758565,0
1,1437,45676,3578758565,3578758565,0
1,1437,45677,3578758565,3578758566,1
1,1437,45678,3578758565,3578758566,1
1,1437,45679,3578758565,3578758566,1
1,1437,45680,3578758565,3578758567,2
1,1437,45681,3578758565,3578758567,2
1,1437,45682,3578758565,3578758568,3
1,1437,45683,3578758565,3578758571,6
1,1437,45684,3578758565,3578758572,7
1,1437,45685,3578758565,3578758574,9
1,1437,45686,3578758565,3578758575,10
1,1437,45687,3578758565,3578758577,12
1,1437,45688,3578758565,3578758577,12
1,1437,45689,3578758565,3578758578,13
1,1437,45690,3578758565,3578758579,14
1,1437,45691,3578758565,3578758580,15
1,1437,45692,3578758565,3578758580,15
1,1437,45693,3578758565,3578758580,15
1,1437,45694,3578758565,3578758581,16
1,1437,45695,3578758565,3578758581,16
1,1437,45696,3578758565,3578758581,16
1,1437,45697,3578758565,3578758582,17
1,1437,45698,3578758565,3578758583,18
1,1437,45699,3578758565,3578758584,19
1,1437,45700,3578758565,3578758584,19
1,1437,45701,3578758565,3578758585,20
1,1437,45702,3578758565,3578758585,20
1,1437,45703,3578758565,3578758588,23
1,1437,45704,3578758565,3578758590,25
1,1437,45705,3578758565,3578758591,26
1,1437,45706,3578758565,3578758591,26
1,1437,45707,3578758565,3578758593,28
1,1437,45708,3578758565,3578758593,28
1,1437,45709,3578758565,3578758594,29
1,1437,45710,3578758565,3578758595,30
1,1437,45711,3578758565,3578758596,31
1,1437,45712,3578758565,3578758596,31
1,1437,45713,3578758565,3578758596,31
1,1437,45714,3578758565,3578758597,32
1,1437,45715,3578758565,3578758598,33
1,1437,45716,3578758565,3578758600,35
1,1437,45717,3578758565,3578758600,35
1,1437,45718,3578758565,3578758601,36
1,1437,45719,3578758565,3578758601,36
1,1437,45720,3578758565,3578758603,38
1,1437,45721,3578758565,3578758605,40
1,1437,45722,3578758565,3578758607,42
1,1437,45723,3578758565,3578758609,44
1,1437,45724,3578758565,3578758611,46
1,1437,45725,3578758565,3578758612,47
1,1437,45726,3578758565,3578758612,47
1,1437,45727,3578758565,3578758612,47
1,1437,45728,3578758565,3578758612,47
1,1438,45729,3578758629,3578758629,0
1,1438,45730,3578758629,3578758629,0
1,1438,45731,3578758629,3578758629,0
1,1438,45732,3578758629,3578758629,0
1,1438,45733,3578758629,3578758629,0
1,1438,45734,3578758629,3578758629,0
1,1438,45735,3578758629,3578758629,0
1,1438,45736,3578758629,3578758629,0
1,1438,45737,3578758629,3578758629,0
1,1438,45738,3578758629,3578758629,0
1,1438,45739,3578758629,3578758629,0
1,1438,45740,3578758629,3578758629,0
1,1438,45741,3578758629,3578758629,0
1,1438,45742,3578758629,3578758629,0
1,1438,45743,3578758629,3578758629,0
1,1438,45744,3578758629,3578758629,0
1,1438,45745,3578758629,3578758629,0
1,1438,45746,3578758629,3578758629,0
1,1438,45747,3578758629,3578758629,0
1,1438,45748,3578758629,3578758629,0
1,1438,45749,3578758629,3578758630,1
1,1438,45750,3578758629,3578758631,2
1,1438,45751,3578758629,3578758631,2
1,1438,45752,3578758629,3578758633,4
1,1438,45753,3578758629,3578758633,4
1,1438,45754,3578758629,3578758635,6
1,1438,45755,3578758629,3578758636,7
1,1438,45756,3578758629,3578758637,8
1,1438,45757,3578758629,3578758639,10
1,1438,45758,3578758629,3578758639,10
1,1438,45759,3578758629,3578758646,17
1,1438,45760,3578758629,3578758646,17
1,1438,45761,3578758629,3578758647,18
1,1438,45762,3578758629,3578758648,19
1,1438,45763,3578758629,3578758649,20
1,1438,45764,3578758629,3578758651,22
1,1438,45765,3578758629,3578758652,23
1,1438,45766,3578758629,3578758653,24
1,1438,45767,3578758629,3578758655,26
1,1438,45768,3578758629,3578758657,28
1,1438,45769,3578758629,3578758658,29
1,1438,45770,3578758629,3578758660,31
1,1438,45771,3578758629,3578758660,31
1,1438,45772,3578758629,3578758662,33
1,1438,45773,3578758629,3578758663,34
1,1438,45774,3578758629,3578758664,35
1,1438,45775,3578758629,3578758666,37
1,1438,45776,3578758629,3578758667,38
1,1438,45777,3578758629,3578758667,38
1,1438,45778,3578758629,3578758668,39
1,1438,45779,3578758629,3578758679,50
1,1439,45780,3578758693,3578758693,0
1,1439,45781,3578758693,3578758693,0
1,1439,45782,3578758693,3578758693,0
1,1439,45783,3578758693,3578758693,0
1,1439,45784,3578758693,3578758693,0
1,1439,45785,3578758693,3578758693,0
1,1439,45786,3578758693,3578758693,0
1,1439,45787,3578758693,3578758693,0
1,1439,45788,3578758693,3578758693,0
1,1439,45789,3578758693,3578758693,0
1,1439,45790,3578758693,3578758693,0
1,1439,45791,3578758693,3578758693,0
1,1439,45792,3578758693,3578758693,0
1,1439,45793,3578758693,3578758693,0
1,1439,45794,3578758693,3578758694,1
1,1439,45795,3578758693,3578758694,1
1,1439,45796,3578758693,3578758694,1
1,1439,45797,3578758693,3578758694,1
1,1439,45798,3578758693,3578758696,3
1,1439,45799,3578758693,3578758697,4
1,1439,45800,3578758693,3578758697,4
1,1439,45801,3578758693,3578758701,8
1,1439,45802,3578758693,3578758702,9
1,1439,45803,3578758693,3578758703,10
1,1439,45804,3578758693,3578758703,10
1,1439,45805,3578758693,3578758706,13
1,1439,45806,3578758693,3578758706,13
1,1439,45807,3578758693,3578758706,13
1,1439,45808,3578758693,3578758708,15
1,1439,45809,3578758693,3578758708,15
1,1439,45810,3578758693,3578758709,16
1,1439,45811,3578758693,3578758709,16
1,1439,45812,3578758693,3578758710,17
1,1439,45813,3578758693,3578758710,17
1,1439,45814,3578758693,3578758711,18
1,1439,45815,3578758693,3578758711,18
1,1439,45816,3578758693,3578758711,18
1,1439,45817,3578758693,3578758712,19
1,1439,45818,3578758693,3578758713,20
1,1439,45819,3578758693,3578758713,20
1,1439,45820,3578758693,3578758714,21
1,1439,45821,3578758693,3578758714,21
1,1439,45822,3578758693,3578758714,21
1,1439,45823,3578758693,3578758715,22
1,1439,45824,3578758693,3578758717,24
1,1439,45825,3578758693,3578758717,24
1,1439,45826,3578758693,3578758719,26
1,1439,45827,3578758693,3578758720,27
1,1439,45828,3578758693,3578758720,27
1,1439,45829,3578758693,3578758720,27
1,1439,45830,3578758693,3578758720,27
1,1439,45831,3578758693,3578758722,29
1,1439,45832,3578758693,3578758722,29
1,1439,45833,3578758693,3578758722,29
1,1439,45834,3578758693,3578758724,31
1,1439,45835,3578758693,3578758724,31
1,1439,45836,3578758693,3578758725,32
1,1439,45837,3578758693,3578758726,33
1,1439,45838,3578758693,3578758726,33
1,1439,45839,3578758693,3578758727,34
1,1439,45840,3578758693,3578758728,35
1,1439,45841,3578758693,3578758728,35
1,1439,45842,3578758693,3578758730,37
1,1439,45843,3578758693,3578758730,37
1,1439,45844,3578758693,3578758731,38
1,1439,45845,3578758693,3578758732,39
1,1439,45846,3578758693,3578758732,39
1,1439,45847,3578758693,3578758733,40
1,1439,45848,3578758693,3578758733,40
1,1439,45849,3578758693,3578758733,40
1,1439,45850,3578758693,3578758735,42
1,1439,45851,3578758693,3578758735,42
1,1439,45852,3578758693,3578758736,43
1,1439,45853,3578758693,3578758737,44
1,1439,45854,3578758693,3578758737,44
1,1439,45855,3578758693,3578758740,47
1,1439,45856,3578758693,3578758741,48
1,1439,45857,3578758693,3578758742,49
1,1440,45858,3578758758,3578758758,0
1,1440,45859,3578758758,3578758758,0
1,1440,45860,3578758758,3578758758,0
1,1440,45861,3578758758,3578758758,0
1,1440,45862,3578758758,3578758758,0
1,1440,45863,3578758758,3578758758,0
1,1440,45864,3578758758,3578758758,0
1,1440,45865,3578758758,3578758758,0
1,1440,45866,3578758758,3578758758,0
1,1440,45867,3578758758,3578758758,0
1,1440,45868,3578758758,3578758758,0
1,1440,45869,3578758758,3578758759,1
1,1440,45870,3578758758,3578758762,4
1,1440,45871,3578758758,3578758762,4
1,1440,45872,3578758758,3578758762,4
1,1440,45873,3578758758,3578758763,5
1,1440,45874,3578758758,3578758764,6
1,1440,45875,3578758758,3578758766,8
1,1440,45876,3578758758,3578758767,9
1,1440,45877,3578758758,3578758767,9
1,1440,45878,3578758758,3578758767,9
1,1440,45879,3578758758,3578758767,9
1,1440,45880,3578758758,3578758767,9
1,1440,45881,3578758758,3578758768,10
1,1440,45882,3578758758,3578758771,13
1,1440,45883,3578758758,3578758772,14
1,1440,45884,3578758758,3578758775,17
1,1440,45885,3578758758,3578758776,18
1,1440,45886,3578758758,3578758778,20
1,1440,45887,3578758758,3578758778,20
1,1440,45888,3578758758,3578758779,21
1,1440,45889,3578758758,3578758779,21
1,1440,45890,3578758758,3578758781,23
1,1440,45891,3578758758,3578758781,23
1,1440,45892,3578758758,3578758781,23
1,1440,45893,3578758758,3578758781,23
1,1440,45894,3578758758,3578758781,23
1,1440,45895,3578758758,3578758782,24
1,1440,45896,3578758758,3578758783,25
1,1440,45897,3578758758,3578758784,26
1,1440,45898,3578758758,3578758785,27
1,1440,45899,3578758758,3578758785,27
1,1440,45900,3578758758,3578758785,27
1,1440,45901,3578758758,3578758788,30
1,1440,45902,3578758758,3578758790,32
1,1440,45903,3578758758,3578758790,32
1,1440,45904,3578758758,3578758791,33
1,1440,45905,3578758758,3578758792,34
1,1440,45906,3578758758,3578758792,34
1,1440,45907,3578758758,3578758793,35
1,1440,45908,3578758758,3578758793,35
1,1440,45909,3578758758,3578758794,36
1,1440,45910,3578758758,3578758795,37
1,1440,45911,3578758758,3578758796,38
1,1440,45912,3578758758,3578758796,38
1,1440,45913,3578758758,3578758796,38
1,1440,45914,3578758758,3578758797,39
1,1440,45915,3578758758,3578758798,40
1,1440,45916,3578758758,3578758798,40
1,1440,45917,3578758758,3578758800,42
1,1440,45918,3578758758,3578758801,43
1,1440,45919,3578758758,3578758801,43
1,1440,45920,3578758758,3578758802,44
1,1440,45921,3578758758,3578758806,48
1,1440,45922,3578758758,3578758806,48
1,1441,45923,3578758821,3578758821,0
1,1441,45924,3578758821,3578758821,0
1,1441,45925,3578758821,3578758821,0
1,1441,45926,3578758821,3578758821,0
1,1441,45927,3578758821,3578758821,0
1,1441,45928,3578758821,3578758821,0
1,1441,45929,3578758821,3578758821,0
1,1441,45930,3578758821,3578758821,0
1,1441,45931,3578758821,3578758821,0
1,1441,45932,3578758821,3578758821,0
1,1441,45933,3578758821,3578758821,0
1,1441,45934,3578758821,3578758821,0
1,1441,45935,3578758821,3578758821,0
1,1441,45936,3578758821,3578758821,0
1,1441,45937,3578758821,3578758821,0
1,1441,45938,3578758821,3578758821,0
1,1441,45939,3578758821,3578758821,0
1,1441,45940,3578758821,3578758821,0
1,1441,45941,3578758821,3578758824,3
1,1441,45942,3578758821,3578758824,3
1,1441,45943,3578758821,3578758826,5
1,1441,45944,3578758821,3578758828,7
1,1441,45945,3578758821,3578758829,8
1,1441,45946,3578758821,3578758829,8
1,1441,45947,3578758821,3578758830,9
1,1441,45948,3578758821,3578758830,9
1,1441,45949,3578758821,3578758831,10
1,1441,45950,3578758821,3578758832,11
1,1441,45951,3578758821,3578758834,13
1,1441,45952,3578758821,3578758835,14
1,1441,45953,3578758821,3578758836,15
1,1441,45954,3578758821,3578758837,16
1,1441,45955,3578758821,3578758838,17
1,1441,45956,3578758821,3578758839,18
1,1441,45957,3578758821,3578758839,18
1,1441,45958,3578758821,3578758841,20
1,1441,45959,3578758821,3578758848,27
1,1441,45960,3578758821,3578758848,27
1,1441,45961,3578758821,3578758849,28
1,1441,45962,3578758821,3578758849,28
1,1441,45963,3578758821,3578758852,31
1,1441,45964,3578758821,3578758853,32
1,1441,45965,3578758821,3578758853,32
1,1441,45966,3578758821,3578758856,35
1,1441,45967,3578758821,3578758859,38
1,1441,45968,3578758821,3578758859,38
1,1441,45969,3578758821,3578758861,40
1,1441,45970,3578758821,3578758862,41
1,1441,45971,3578758821,3578758863,42
1,1441,45972,3578758821,3578758864,43
1,1441,45973,3578758821,3578758866,45
1,1441,45974,3578758821,3578758867,46
1,1441,45975,3578758821,3578758867,46
1,1441,45976,3578758821,3578758868,47
1,1442,45977,3578758885,3578758885,0
1,1442,45978,3578758885,3578758885,0
1,1442,45979,3578758885,3578758885,0
1,1442,45980,3578758885,3578758885,0
1,1442,45981,3578758885,3578758885,0
1,1442,45982,3578758885,3578758885,0
1,1442,45983,3578758885,3578758885,0
1,1442,45984,3578758885,3578758885,0
1,1442,45985,3578758885,3578758886,1
1,1442,45986,3578758885,3578758888,3
1,1442,45987,3578758885,3578758889,4
1,1442,45988,3578758885,3578758890,5
1,1442,45989,3578758885,3578758892,7
1,1442,45990,3578758885,3578758893,8
1,1442,45991,3578758885,3578758893,8
1,1442,45992,3578758885,3578758894,9
1,1442,45993,3578758885,3578758894,9
1,1442,45994,3578758885,3578758894,9
1,1442,45995,3578758885,3578758894,9
1,1442,45996,3578758885,3578758895,10
1,1442,45997,3578758885,3578758897,12
1,1442,45998,3578758885,3578758897,12
1,1442,45999,3578758885,3578758897,12
1,1442,46000,3578758885,3578758897,12
1,1442,46001,3578758885,3578758902,17
1,1442,46002,3578758885,3578758903,18
1,1442,46003,3578758885,3578758904,19
1,1442,46004,3578758885,3578758906,21
1,1442,46005,3578758885,3578758906,21
1,1442,46006,3578758885,3578758908,23
1,1442,46007,3578758885,3578758909,24
1,1442,46008,3578758885,3578758910,25
1,1442,46009,3578758885,3578758910,25
1,1442,46010,3578758885,3578758910,25
1,1442,46011,3578758885,3578758911,26
1,1442,46012,3578758885,3578758911,26
1,1442,46013,3578758885,3578758911,26
1,1442,46014,3578758885,3578758912,27
1,1442,46015,3578758885,3578758912,27
1,1442,46016,3578758885,3578758914,29
1,1442,46017,3578758885,3578758914,29
1,1442,46018,3578758885,3578758915,30
1,1442,46019,3578758885,3578758917,32
1,1442,46020,3578758885,3578758917,32
1,1442,46021,3578758885,3578758917,32
1,1442,46022,3578758885,3578758918,33
1,1442,46023,3578758885,3578758920,35
1,1442,46024,3578758885,3578758920,35
1,1442,46025,3578758885,3578758920,35
1,1442,46026,3578758885,3578758922,37
1,1442,46027,3578758885,3578758923,38
1,1442,46028,3578758885,3578758923,38
1,1442,46029,3578758885,3578758924,39
1,1442,46030,3578758885,3578758924,39
1,1442,46031,3578758885,3578758926,41
1,1442,46032,3578758885,3578758926,41
1,1442,46033,3578758885,3578758927,42
1,1442,46034,3578758885,3578758927,42
1,1442,46035,3578758885,3578758928,43
1,1442,46036,3578758885,3578758928,43
1,1442,46037,3578758885,3578758929,44
1,1442,46038,3578758885,3578758930,45
1,1442,46039,3578758885,3578758932,47
1,1442,46040,3578758885,3578758932,47
1,1442,46041,3578758885,3578758933,48
1,1442,46042,3578758885,3578758933,48
1,1442,46043,3578758885,3578758935,50
1,1443,46044,3578758948,3578758948,0
1,1443,46045,3578758948,3578758948,0
1,1443,46046,3578758948,3578758948,0
1,1443,46047,3578758948,3578758948,0
1,1443,46048,3578758948,3578758948,0
1,1443,46049,3578758948,3578758948,0
1,1443,46050,3578758948,3578758948,0
1,1443,46051,3578758948,3578758948,0
1,1443,46052,3578758948,3578758948,0
1,1443,46053,3578758948,3578758948,0
1,1443,46054,3578758948,3578758949,1
1,1443,46055,3578758948,3578758952,4
1,1443,46056,3578758948,3578758952,4
1,1443,46057,3578758948,3578758954,6
1,1443,46058,3578758948,3578758955,7
1,1443,46059,3578758948,3578758956,8
1,1443,46060,3578758948,3578758957,9
1,1443,46061,3578758948,3578758959,11
1,1443,46062,3578758948,3578758961,13
1,1443,46063,3578758948,3578758963,15
1,1443,46064,3578758948,3578758963,15
1,1443,46065,3578758948,3578758964,16
1,1443,46066,3578758948,3578758964,16
1,1443,46067,3578758948,3578758965,17
1,1443,46068,3578758948,3578758966,18
1,1443,46069,3578758948,3578758966,18
1,1443,46070,3578758948,3578758967,19
1,1443,46071,3578758948,3578758967,19
1,1443,46072,3578758948,3578758967,19
1,1443,46073,3578758948,3578758967,19
1,1443,46074,3578758948,3578758969,21
1,1443,46075,3578758948,3578758971,23
1,1443,46076,3578758948,3578758972,24
1,1443,46077,3578758948,3578758975,27
1,1443,46078,3578758948,3578758976,28
1,1443,46079,3578758948,3578758977,29
1,1443,46080,3578758948,3578758978,30
1,1443,46081,3578758948,3578758978,30
1,1443,46082,3578758948,3578758979,31
1,1443,46083,3578758948,3578758979,31
1,1443,46084,3578758948,3578758981,33
1,1443,46085,3578758948,3578758981,33
1,1443,46086,3578758948,3578758981,33
1,1443,46087,3578758948,3578758982,34
1,1443,46088,3578758948,3578758982,34
1,1443,46089,3578758948,3578758984,36
1,1443,46090,3578758948,3578758984,36
1,1443,46091,3578758948,3578758985,37
1,1443,46092,3578758948,3578758986,38
1,1443,46093,3578758948,3578758986,38
1,1443,46094,3578758948,3578758989,41
1,1443,46095,3578758948,3578758991,43
1,1443,46096,3578758948,3578758991,43
1,1443,46097,3578758948,3578758992,44
1,1443,46098,3578758948,3578758993,45
1,1443,46099,3578758948,3578758993,45
1,1443,46100,3578758948,3578758994,46
1,1443,46101,3578758948,3578758995,47
1,1443,46102,3578758948,3578758995,47
1,1443,46103,3578758948,3578758996,48
1,1443,46104,3578758948,3578758996,48
1,1443,46105,3578758948,3578758996,48
1,1444,46106,3578759012,3578759012,0
1,1444,46107,3578759012,3578759012,0
1,1444,46108,3578759012,3578759012,0
1,1444,46109,3578759012,3578759012,0
1,1444,46110,3578759012,3578759012,0
1,1444,46111,3578759012,3578759012,0
1,1444,46112,3578759012,3578759012,0
1,1444,46113,3578759012,3578759012,0
1,1444,46114,3578759012,3578759012,0
1,1444,46115,3578759012,3578759012,0
1,1444,46116,3578759012,3578759012,0
1,1444,46117,3578759012,3578759014,2
1,1444,46118,3578759012,3578759015,3
1,1444,46119,3578759012,3578759016,4
1,1444,46120,3578759012,3578759017,5
1,1444,46121,3578759012,3578759018,6
1,1444,46122,3578759012,3578759018,6
1,1444,46123,3578759012,3578759019,7
1,1444,46124,3578759012,3578759019,7
1,1444,46125,3578759012,3578759019,7
1,1444,46126,3578759012,3578759020,8
1,1444,46127,3578759012,3578759020,8
1,1444,46128,3578759012,3578759020,8
1,1444,46129,3578759012,3578759021,9
1,1444,46130,3578759012,3578759024,12
1,1444,46131,3578759012,3578759024,12
1,1444,46132,3578759012,3578759027,15
1,1444,46133,3578759012,3578759028,16
1,1444,46134,3578759012,3578759028,16
1,1444,46135,3578759012,3578759029,17
1,1444,46136,3578759012,3578759031,19
1,1444,46137,3578759012,3578759032,20
1,1444,46138,3578759012,3578759032,20
1,1444,46139,3578759012,3578759035,23
1,1444,46140,3578759012,3578759035,23
1,1444,46141,3578759012,3578759037,25
1,1444,46142,3578759012,3578759037,25
1,1444,46143,3578759012,3578759039,27
1,1444,46144,3578759012,3578759039,27
1,1444,46145,3578759012,3578759041,29
1,1444,46146,3578759012,3578759042,30
1,1444,46147,3578759012,3578759048,36
1,1444,46148,3578759012,3578759048,36
1,1444,46149,3578759012,3578759049,37
1,1444,46150,3578759012,3578759050,38
1,1444,46151,3578759012,3578759050,38
1,1444,46152,3578759012,3578759052,40
1,1444,46153,3578759012,3578759052,40
1,1444,46154,3578759012,3578759052,40
1,1444,46155,3578759012,3578759056,44
1,1444,46156,3578759012,3578759057,45
1,1444,46157,3578759012,3578759057,45
1,1444,46158,3578759012,3578759059,47
1,1444,46159,3578759012,3578759060,48
1,1444,46160,3578759012,3578759062,50
1,1445,46161,3578759074,3578759074,0
1,1445,46162,3578759074,3578759074,0
1,1445,46163,3578759074,3578759074,0
1,1445,46164,3578759074,3578759074,0
1,1445,46165,3578759074,3578759074,0
1,1445,46166,3578759074,3578759074,0
1,1445,46167,3578759074,3578759079,5
1,1445,46168,3578759074,3578759079,5
1,1445,46169,3578759074,3578759080,6
1,1445,46170,3578759074,3578759081,7
1,1445,46171,3578759074,3578759082,8
1,1445,46172,3578759074,3578759084,10
1,1445,46173,3578759074,3578759084,10
1,1445,46174,3578759074,3578759084,10
1,1445,46175,3578759074,3578759085,11
1,1445,46176,3578759074,3578759085,11
1,1445,46177,3578759074,3578759088,14
1,1445,46178,3578759074,3578759089,15
1,1445,46179,3578759074,3578759090,16
1,1445,46180,3578759074,3578759092,18
1,1445,46181,3578759074,3578759094,20
1,1445,46182,3578759074,3578759094,20
1,1445,46183,3578759074,3578759094,20
1,1445,46184,3578759074,3578759094,20
1,1445,46185,3578759074,3578759094,20
1,1445,46186,3578759074,3578759095,21
1,1445,46187,3578759074,3578759095,21
1,1445,46188,3578759074,3578759097,23
1,1445,46189,3578759074,3578759097,23
1,1445,46190,3578759074,3578759097,23
1,1445,46191,3578759074,3578759097,23
1,1445,46192,3578759074,3578759101,27
1,1445,46193,3578759074,3578759103,29
1,1445,46194,3578759074,3578759103,29
1,1445,46195,3578759074,3578759103,29
1,1445,46196,3578759074,3578759104,30
1,1445,46197,3578759074,3578759105,31
1,1445,46198,3578759074,3578759105,31
1,1445,46199,3578759074,3578759106,32
1,1445,46200,3578759074,3578759107,33
1,1445,46201,3578759074,3578759108,34
1,1445,46202,3578759074,3578759108,34
1,1445,46203,3578759074,3578759109,35
1,1445,46204,3578759074,3578759110,36
1,1445,46205,3578759074,3578759110,36
1,1445,46206,3578759074,3578759111,37
1,1445,46207,3578759074,3578759111,37
1,1445,46208,3578759074,3578759112,38
1,1445,46209,3578759074,3578759112,38
1,1445,46210,3578759074,3578759113,39
1,1445,46211,3578759074,3578759114,40
1,1445,46212,3578759074,3578759114,40
1,1445,46213,3578759074,3578759114,40
1,1445,46214,3578759074,3578759115,41
1,1445,46215,3578759074,3578759117,43
1,1445,46216,3578759074,3578759117,43
1,1445,46217,3578759074,3578759117,43
1,1445,46218,3578759074,3578759119,45
1,1445,46219,3578759074,3578759120,46
1,1445,46220,3578759074,3578759120,46
1,1445,46221,3578759074,3578759121,47
1,1445,46222,3578759074,3578759122,48
1,1445,46223,3578759074,3578759122,48
1,1445,46224,3578759074,3578759124,50
1,1446,46225,3578759137,3578759137,0
1,1446,46226,3578759137,3578759137,0
1,1446,46227,3578759137,3578759137,0
1,1446,46228,3578759137,3578759137,0
1,1446,46229,3578759137,3578759137,0
1,1446,46230,3578759137,3578759137,0
1,1446,46231,3578759137,3578759137,0
1,1446,46232,3578759137,3578759137,0
1,1446,46233,3578759137,3578759137,0
1,1446,46234,3578759137,3578759137,0
1,1446,46235,3578759137,3578759137,0
1,1446,46236,3578759137,3578759137,0
1,1446,46237,3578759137,3578759137,0
1,1446,46238,3578759137,3578759137,0
1,1446,46239,3578759137,3578759137,0
1,1446,46240,3578759137,3578759137,0
1,1446,46241,3578759137,3578759137,0
1,1446,46242,3578759137,3578759137,0
1,1446,46243,3578759137,3578759137,0
1,1446,46244,3578759137,3578759141,4
1,1446,46245,3578759137,3578759141,4
1,1446,46246,3578759137,3578759142,5
1,1446,46247,3578759137,3578759143,6
1,1446,46248,3578759137,3578759146,9
1,1446,46249,3578759137,3578759146,9
1,1446,46250,3578759137,3578759147,10
1,1446,46251,3578759137,3578759150,13
1,1446,46252,3578759137,3578759153,16
1,1446,46253,3578759137,3578759155,18
1,1446,46254,3578759137,3578759156,19
1,1446,46255,3578759137,3578759157,20
1,1446,46256,3578759137,3578759160,23
1,1446,46257,3578759137,3578759162,25
1,1446,46258,3578759137,3578759163,26
1,1446,46259,3578759137,3578759163,26
1,1446,46260,3578759137,3578759164,27
1,1446,46261,3578759137,3578759166,29
1,1446,46262,3578759137,3578759166,29
1,1446,46263,3578759137,3578759167,30
1,1446,46264,3578759137,3578759167,30
1,1446,46265,3578759137,3578759168,31
1,1446,46266,3578759137,3578759168,31
1,1446,46267,3578759137,3578759169,32
1,1446,46268,3578759137,3578759171,34
1,1446,46269,3578759137,3578759172,35
1,1446,46270,3578759137,3578759174,37
1,1446,46271,3578759137,3578759176,39
1,1446,46272,3578759137,3578759178,41
1,1446,46273,3578759137,3578759178,41
1,1446,46274,3578759137,3578759178,41
1,1446,46275,3578759137,3578759179,42
1,1446,46276,3578759137,3578759181,44
1,1446,46277,3578759137,3578759181,44
1,1446,46278,3578759137,3578759181,44
1,1446,46279,3578759137,3578759182,45
1,1446,46280,3578759137,3578759182,45
1,1446,46281,3578759137,3578759182,45
1,1446,46282,3578759137,3578759183,46
1,1446,46283,3578759137,3578759184,47
1,1446,46284,3578759137,3578759185,48
1,1446,46285,3578759137,3578759186,49
1,1447,46286,3578759199,3578759199,0
1,1447,46287,3578759199,3578759199,0
1,1447,46288,3578759199,3578759199,0
1,1447,46289,3578759199,3578759199,0
1,1447,46290,3578759199,3578759199,0
1,1447,46291,3578759199,3578759199,0
1,1447,46292,3578759199,3578759199,0
1,1447,46293,3578759199,3578759199,0
1,1447,46294,3578759199,3578759199,0
1,1447,46295,3578759199,3578759199,0
1,1447,46296,3578759199,3578759199,0
1,1447,46297,3578759199,3578759199,0
1,1447,46298,3578759199,3578759199,0
1,1447,46299,3578759199,3578759199,0
1,1447,46300,3578759199,3578759199,0
1,1447,46301,3578759199,3578759201,2
1,1447,46302,3578759199,3578759202,3
1,1447,46303,3578759199,3578759202,3
1,1447,46304,3578759199,3578759203,4
1,1447,46305,3578759199,3578759206,7
1,1447,46306,3578759199,3578759207,8
1,1447,46307,3578759199,3578759209,10
1,1447,46308,3578759199,3578759211,12
1,1447,46309,3578759199,3578759212,13
1,1447,46310,3578759199,3578759212,13
1,1447,46311,3578759199,3578759213,14
1,1447,46312,3578759199,3578759214,15
1,1447,46313,3578759199,3578759216,17
1,1447,46314,3578759199,3578759217,18
1,1447,46315,3578759199,3578759217,18
1,1447,46316,3578759199,3578759218,19
1,1447,46317,3578759199,3578759219,20
1,1447,46318,3578759199,3578759219,20
1,1447,46319,3578759199,3578759219,20
1,1447,46320,3578759199,3578759219,20
1,1447,46321,3578759199,3578759220,21
1,1447,46322,3578759199,3578759220,21
1,1447,46323,3578759199,3578759220,21
1,1447,46324,3578759199,3578759221,22
1,1447,46325,3578759199,3578759221,22
1,1447,46326,3578759199,3578759224,25
1,1447,46327,3578759199,3578759224,25
1,1447,46328,3578759199,3578759227,28
1,1447,46329,3578759199,3578759228,29
1,1447,46330,3578759199,3578759229,30
1,1447,46331,3578759199,3578759231,32
1,1447,46332,3578759199,3578759232,33
1,1447,46333,3578759199,3578759232,33
1,1447,46334,3578759199,3578759235,36
1,1447,46335,3578759199,3578759235,36
1,1447,46336,3578759199,3578759237,38
1,1447,46337,3578759199,3578759238,39
1,1447,46338,3578759199,3578759238,39
1,1447,46339,3578759199,3578759239,40
1,1447,46340,3578759199,3578759242,43
1,1447,46341,3578759199,3578759248,49
1,1447,46342,3578759199,3578759248,49
1,1447,46343,3578759199,3578759249,50
1,1448,46344,3578759262,3578759262,0
1,1448,46345,3578759262,3578759262,0
1,1448,46346,3578759262,3578759262,0
1,1448,46347,3578759262,3578759262,0
1,1448,46348,3578759262,3578759262,0
1,1448,46349,3578759262,3578759263,1
1,1448,46350,3578759262,3578759263,1
1,1448,46351,3578759262,3578759263,1
1,1448,46352,3578759262,3578759263,1
1,1448,46353,3578759262,3578759263,1
1,1448,46354,3578759262,3578759265,3
1,1448,46355,3578759262,3578759266,4
1,1448,46356,3578759262,3578759267,5
1,1448,46357,3578759262,3578759268,6
1,1448,46358,3578759262,3578759279,17
1,1448,46359,3578759262,3578759279,17
1,1448,46360,3578759262,3578759281,19
1,1448,46361,3578759262,3578759282,20
1,1448,46362,3578759262,3578759284,22
1,1448,46363,3578759262,3578759284,22
1,1448,46364,3578759262,3578759284,22
1,1448,46365,3578759262,3578759285,23
1,1448,46366,3578759262,3578759285,23
1,1448,46367,3578759262,3578759288,26
1,1448,46368,3578759262,3578759289,27
1,1448,46369,3578759262,3578759289,27
1,1448,46370,3578759262,3578759290,28
1,1448,46371,3578759262,3578759291,29
1,1448,46372,3578759262,3578759293,31
1,1448,46373,3578759262,3578759293,31
1,1448,46374,3578759262,3578759294,32
1,1448,46375,3578759262,3578759294,32
1,1448,46376,3578759262,3578759295,33
1,1448,46377,3578759262,3578759296,34
1,1448,46378,3578759262,3578759296,34
1,1448,46379,3578759262,3578759297,35
1,1448,46380,3578759262,3578759298,36
1,1448,46381,3578759262,3578759298,36
1,1448,46382,3578759262,3578759302,40
1,1448,46383,3578759262,3578759303,41
1,1448,46384,3578759262,3578759303,41
1,1448,46385,3578759262,3578759303,41
1,1448,46386,3578759262,3578759304,42
1,1448,46387,3578759262,3578759304,42
1,1448,46388,3578759262,3578759304,42
1,1448,46389,3578759262,3578759304,42
1,1448,46390,3578759262,3578759305,43
1,1448,46391,3578759262,3578759306,44
1,1448,46392,3578759262,3578759307,45
1,1448,46393,3578759262,3578759308,46
1,1448,46394,3578759262,3578759308,46
1,1448,46395,3578759262,3578759309,47
1,1448,46396,3578759262,3578759310,48
1,1448,46397,3578759262,3578759310,48
1,1448,46398,3578759262,3578759310,48
1,1448,46399,3578759262,3578759310,48
1,1448,46400,3578759262,3578759311,49
1,1448,46401,3578759262,3578759311,49
1,1448,46402,3578759262,3578759312,50
1,1449,46403,3578759326,3578759326,0
1,1449,46404,3578759326,3578759326,0
1,1449,46405,3578759326,3578759326,0
1,1449,46406,3578759326,3578759326,0
1,1449,46407,3578759326,3578759326,0
1,1449,46408,3578759326,3578759326,0
1,1449,46409,3578759326,3578759326,0
1,1449,46410,3578759326,3578759326,0
1,1449,46411,3578759326,3578759326,0
1,1449,46412,3578759326,3578759326,0
1,1449,46413,3578759326,3578759326,0
1,1449,46414,3578759326,3578759326,0
1,1449,46415,3578759326,3578759326,0
1,1449,46416,3578759326,3578759326,0
1,1449,46417,3578759326,3578759326,0
1,1449,46418,3578759326,3578759326,0
1,1449,46419,3578759326,3578759326,0
1,1449,46420,3578759326,3578759327,1
1,1449,46421,3578759326,3578759327,1
1,1449,46422,3578759326,3578759327,1
1,1449,46423,3578759326,3578759328,2
1,1449,46424,3578759326,3578759330,4
1,1449,46425,3578759326,3578759331,5
1,1449,46426,3578759326,3578759331,5
1,1449,46427,3578759326,3578759332,6
1,1449,46428,3578759326,3578759332,6
1,1449,46429,3578759326,3578759333,7
1,1449,46430,3578759326,3578759334,8
1,1449,46431,3578759326,3578759334,8
1,1449,46432,3578759326,3578759335,9
1,1449,46433,3578759326,3578759336,10
1,1449,46434,3578759326,3578759336,10
1,1449,46435,3578759326,3578759338,12
1,1449,46436,3578759326,3578759338,12
1,1449,46437,3578759326,3578759341,15
1,1449,46438,3578759326,3578759341,15
1,1449,46439,3578759326,3578759341,15
1,1449,46440,3578759326,3578759341,15
1,1449,46441,3578759326,3578759344,18
1,1449,46442,3578759326,3578759346,20
1,1449,46443,3578759326,3578759347,21
1,1449,46444,3578759326,3578759348,22
1,1449,46445,3578759326,3578759353,27
1,1449,46446,3578759326,3578759354,28
1,1449,46447,3578759326,3578759355,29
1,1449,46448,3578759326,3578759355,29
1,1449,46449,3578759326,3578759357,31
1,1449,46450,3578759326,3578759358,32
1,1449,46451,3578759326,3578759360,34
1,1449,46452,3578759326,3578759362,36
1,1449,46453,3578759326,3578759363,37
1,1449,46454,3578759326,3578759364,38
1,1449,46455,3578759326,3578759366,40
1,1449,46456,3578759326,3578759367,41
1,1449,46457,3578759326,3578759367,41
1,1449,46458,3578759326,3578759367,41
1,1449,46459,3578759326,3578759367,41
1,1449,46460,3578759326,3578759368,42
1,1449,46461,3578759326,3578759368,42
1,1449,46462,3578759326,3578759370,44
1,1449,46463,3578759326,3578759371,45
1,1449,46464,3578759326,3578759372,46
1,1449,46465,3578759326,3578759376,50
1,1450,46466,3578759389,3578759389,0
1,1450,46467,3578759389,3578759389,0
1,1450,46468,3578759389,3578759389,0
1,1450,46469,3578759389,3578759389,0
1,1450,46470,3578759389,3578759389,0
1,1450,46471,3578759389,3578759389,0
1,1450,46472,3578759389,3578759389,0
1,1450,46473,3578759389,3578759389,0
1,1450,46474,3578759389,3578759389,0
1,1450,46475,3578759389,3578759389,0
1,1450,46476,3578759389,3578759389,0
1,1450,46477,3578759389,3578759389,0
1,1450,46478,3578759389,3578759389,0
1,1450,46479,3578759389,3578759389,0
1,1450,46480,3578759389,3578759389,0
1,1450,46481,3578759389,3578759389,0
1,1450,46482,3578759389,3578759391,2
1,1450,46483,3578759389,3578759392,3
1,1450,46484,3578759389,3578759392,3
1,1450,46485,3578759389,3578759393,4
1,1450,46486,3578759389,3578759394,5
1,1450,46487,3578759389,3578759394,5
1,1450,46488,3578759389,3578759394,5
1,1450,46489,3578759389,3578759395,6
1,1450,46490,3578759389,3578759396,7
1,1450,46491,3578759389,3578759396,7
1,1450,46492,3578759389,3578759396,7
1,1450,46493,3578759389,3578759397,8
1,1450,46494,3578759389,3578759398,9
1,1450,46495,3578759389,3578759399,10
1,1450,46496,3578759389,3578759399,10
1,1450,46497,3578759389,3578759401,12
1,1450,46498,3578759389,3578759402,13
1,1450,46499,3578759389,3578759402,13
1,1450,46500,3578759389,3578759403,14
1,1450,46501,3578759389,3578759403,14
1,1450,46502,3578759389,3578759406,17
1,1450,46503,3578759389,3578759407,18
1,1450,46504,3578759389,3578759410,21
1,1450,46505,3578759389,3578759412,23
1,1450,46506,3578759389,3578759412,23
1,1450,46507,3578759389,3578759413,24
1,1450,46508,3578759389,3578759414,25
1,1450,46509,3578759389,3578759414,25
1,1450,46510,3578759389,3578759417,28
1,1450,46511,3578759389,3578759417,28
1,1450,46512,3578759389,3578759417,28
1,1450,46513,3578759389,3578759417,28
1,1450,46514,3578759389,3578759418,29
1,1450,46515,3578759389,3578759419,30
1,1450,46516,3578759389,3578759419,30
1,1450,46517,3578759389,3578759420,31
1,1450,46518,3578759389,3578759420,31
1,1450,46519,3578759389,3578759420,31
1,1450,46520,3578759389,3578759421,32
1,1450,46521,3578759389,3578759421,32
1,1450,46522,3578759389,3578759421,32
1,1450,46523,3578759389,3578759424,35
1,1450,46524,3578759389,3578759425,36
1,1450,46525,3578759389,3578759428,39
1,1450,46526,3578759389,3578759429,40
1,1450,46527,3578759389,3578759430,41
1,1450,46528,3578759389,3578759430,41
1,1450,46529,3578759389,3578759430,41
1,1450,46530,3578759389,3578759432,43
1,1450,46531,3578759389,3578759432,43
1,1450,46532,3578759389,3578759436,47
1,1450,46533,3578759389,3578759436,47
1,1450,46534,3578759389,3578759437,48
1,1450,46535,3578759389,3578759437,48
1,1450,46536,3578759389,3578759438,49
1,1451,46537,3578759452,3578759452,0
1,1451,46538,3578759452,3578759452,0
1,1451,46539,3578759452,3578759452,0
1,1451,46540,3578759452,3578759452,0
1,1451,46541,3578759452,3578759452,0
1,1451,46542,3578759452,3578759452,0
1,1451,46543,3578759452,3578759453,1
1,1451,46544,3578759452,3578759454,2
1,1451,46545,3578759452,3578759456,4
1,1451,46546,3578759452,3578759456,4
1,1451,46547,3578759452,3578759457,5
1,1451,46548,3578759452,3578759460,8
1,1451,46549,3578759452,3578759462,10
1,1451,46550,3578759452,3578759463,11
1,1451,46551,3578759452,3578759463,11
1,1451,46552,3578759452,3578759466,14
1,1451,46553,3578759452,3578759468,16
1,1451,46554,3578759452,3578759468,16
1,1451,46555,3578759452,3578759468,16
1,1451,46556,3578759452,3578759478,26
1,1451,46557,3578759452,3578759479,27
1,1451,46558,3578759452,3578759479,27
1,1451,46559,3578759452,3578759481,29
1,1451,46560,3578759452,3578759481,29
1,1451,46561,3578759452,3578759484,32
1,1451,46562,3578759452,3578759484,32
1,1451,46563,3578759452,3578759484,32
1,1451,46564,3578759452,3578759485,33
1,1451,46565,3578759452,3578759485,33
1,1451,46566,3578759452,3578759488,36
1,1451,46567,3578759452,3578759488,36
1,1451,46568,3578759452,3578759489,37
1,1451,46569,3578759452,3578759490,38
1,1451,46570,3578759452,3578759491,39
1,1451,46571,3578759452,3578759491,39
1,1451,46572,3578759452,3578759493,41
1,1451,46573,3578759452,3578759494,42
1,1451,46574,3578759452,3578759494,42
1,1451,46575,3578759452,3578759495,43
1,1451,46576,3578759452,3578759495,43
1,1451,46577,3578759452,3578759496,44
1,1451,46578,3578759452,3578759497,45
1,1451,46579,3578759452,3578759498,46
1,1452,46580,3578759515,3578759515,0
1,1452,46581,3578759515,3578759515,0
1,1452,46582,3578759515,3578759515,0
1,1452,46583,3578759515,3578759515,0
1,1452,46584,3578759515,3578759515,0
1,1452,46585,3578759515,3578759515,0
1,1452,46586,3578759515,3578759515,0
1,1452,46587,3578759515,3578759515,0
1,1452,46588,3578759515,3578759515,0
1,1452,46589,3578759515,3578759515,0
1,1452,46590,3578759515,3578759515,0
1,1452,46591,3578759515,3578759515,0
1,1452,46592,3578759515,3578759515,0
1,1452,46593,3578759515,3578759515,0
1,1452,46594,3578759515,3578759515,0
1,1452,46595,3578759515,3578759515,0
1,1452,46596,3578759515,3578759515,0
1,1452,46597,3578759515,3578759515,0
1,1452,46598,3578759515,3578759515,0
1,1452,46599,3578759515,3578759515,0
1,1452,46600,3578759515,3578759515,0
1,1452,46601,3578759515,3578759515,0
1,1452,46602,3578759515,3578759515,0
1,1452,46603,3578759515,3578759515,0
1,1452,46604,3578759515,3578759515,0
1,1452,46605,3578759515,3578759515,0
1,1452,46606,3578759515,3578759515,0
1,1452,46607,3578759515,3578759515,0
1,1452,46608,3578759515,3578759517,2
1,1452,46609,3578759515,3578759517,2
1,1452,46610,3578759515,3578759517,2
1,1452,46611,3578759515,3578759517,2
1,1452,46612,3578759515,3578759519,4
1,1452,46613,3578759515,3578759519,4
1,1452,46614,3578759515,3578759519,4
1,1452,46615,3578759515,3578759520,5
1,1452,46616,3578759515,3578759521,6
1,1452,46617,3578759515,3578759521,6
1,1452,46618,3578759515,3578759523,8
1,1452,46619,3578759515,3578759523,8
1,1452,46620,3578759515,3578759524,9
1,1452,46621,3578759515,3578759526,11
1,1452,46622,3578759515,3578759526,11
1,1452,46623,3578759515,3578759526,11
1,1452,46624,3578759515,3578759527,12
1,1452,46625,3578759515,3578759527,12
1,1452,46626,3578759515,3578759529,14
1,1452,46627,3578759515,3578759529,14
1,1452,46628,3578759515,3578759530,15
1,1452,46629,3578759515,3578759531,16
1,1452,46630,3578759515,3578759531,16
1,1452,46631,3578759515,3578759532,17
1,1452,46632,3578759515,3578759532,17
1,1452,46633,3578759515,3578759533,18
1,1452,46634,3578759515,3578759534,19
1,1452,46635,3578759515,3578759535,20
1,1452,46636,3578759515,3578759535,20
1,1452,46637,3578759515,3578759535,20
1,1452,46638,3578759515,3578759536,21
1,1452,46639,3578759515,3578759537,22
1,1452,46640,3578759515,3578759537,22
1,1452,46641,3578759515,3578759540,25
1,1452,46642,3578759515,3578759540,25
1,1452,46643,3578759515,3578759541,26
1,1452,46644,3578759515,3578759542,27
1,1452,46645,3578759515,3578759542,27
1,1452,46646,3578759515,3578759545,30
1,1452,46647,3578759515,3578759546,31
1,1452,46648,3578759515,3578759548,33
1,1452,46649,3578759515,3578759548,33
1,1452,46650,3578759515,3578759553,38
1,1452,46651,3578759515,3578759553,38
1,1452,46652,3578759515,3578759554,39
1,1452,46653,3578759515,3578759555,40
1,1452,46654,3578759515,3578759555,40
1,1452,46655,3578759515,3578759557,42
1,1452,46656,3578759515,3578759558,43
1,1452,46657,3578759515,3578759561,46
1,1452,46658,3578759515,3578759562,47
1,1452,46659,3578759515,3578759562,47
1,1452,46660,3578759515,3578759563,48
1,1453,46661,3578759577,3578759577,0
1,1453,46662,3578759577,3578759577,0
1,1453,46663,3578759577,3578759577,0
1,1453,46664,3578759577,3578759577,0
1,1453,46665,3578759577,3578759577,0
1,1453,46666,3578759577,3578759577,0
1,1453,46667,3578759577,3578759577,0
1,1453,46668,3578759577,3578759577,0
1,1453,46669,3578759577,3578759577,0
1,1453,46670,3578759577,3578759577,0
1,1453,46671,3578759577,3578759577,0
1,1453,46672,3578759577,3578759577,0
1,1453,46673,3578759577,3578759577,0
1,1453,46674,3578759577,3578759577,0
1,1453,46675,3578759577,3578759578,1
1,1453,46676,3578759577,3578759579,2
1,1453,46677,3578759577,3578759580,3
1,1453,46678,3578759577,3578759580,3
1,1453,46679,3578759577,3578759580,3
1,1453,46680,3578759577,3578759581,4
1,1453,46681,3578759577,3578759581,4
1,1453,46682,3578759577,3578759581,4
1,1453,46683,3578759577,3578759581,4
1,1453,46684,3578759577,3578759583,6
1,1453,46685,3578759577,3578759583,6
1,1453,46686,3578759577,3578759584,7
1,1453,46687,3578759577,3578759585,8
1,1453,46688,3578759577,3578759586,9
1,1453,46689,3578759577,3578759589,12
1,1453,46690,3578759577,3578759591,14
1,1453,46691,3578759577,3578759591,14
1,1453,46692,3578759577,3578759591,14
1,1453,46693,3578759577,3578759591,14
1,1453,46694,3578759577,3578759593,16
1,1453,46695,3578759577,3578759593,16
1,1453,46696,3578759577,3578759595,18
1,1453,46697,3578759577,3578759595,18
1,1453,46698,3578759577,3578759595,18
1,1453,46699,3578759577,3578759595,18
1,1453,46700,3578759577,3578759596,19
1,1453,46701,3578759577,3578759596,19
1,1453,46702,3578759577,3578759597,20
1,1453,46703,3578759577,3578759598,21
1,1453,46704,3578759577,3578759598,21
1,1453,46705,3578759577,3578759598,21
1,1453,46706,3578759577,3578759600,23
1,1453,46707,3578759577,3578759601,24
1,1453,46708,3578759577,3578759601,24
1,1453,46709,3578759577,3578759601,24
1,1453,46710,3578759577,3578759603,26
1,1453,46711,3578759577,3578759605,28
1,1453,46712,3578759577,3578759606,29
1,1453,46713,3578759577,3578759608,31
1,1453,46714,3578759577,3578759611,34
1,1453,46715,3578759577,3578759612,35
1,1453,46716,3578759577,3578759612,35
1,1453,46717,3578759577,3578759612,35
1,1453,46718,3578759577,3578759615,38
1,1453,46719,3578759577,3578759616,39
1,1453,46720,3578759577,3578759616,39
1,1453,46721,3578759577,3578759617,40
1,1453,46722,3578759577,3578759617,40
1,1453,46723,3578759577,3578759617,40
1,1453,46724,3578759577,3578759618,41
1,1453,46725,3578759577,3578759618,41
1,1453,46726,3578759577,3578759618,41
1,1453,46727,3578759577,3578759619,42
1,1453,46728,3578759577,3578759619,42
1,1453,46729,3578759577,3578759620,43
1,1453,46730,3578759577,3578759620,43
1,1453,46731,3578759577,3578759620,43
1,1453,46732,3578759577,3578759624,47
1,1453,46733,3578759577,3578759625,48
1,1454,46734,3578759642,3578759642,0
1,1454,46735,3578759642,3578759642,0
1,1454,46736,3578759642,3578759642,0
1,1454,46737,3578759642,3578759642,0
1,1454,46738,3578759642,3578759642,0
1,1454,46739,3578759642,3578759642,0
1,1454,46740,3578759642,3578759642,0
1,1454,46741,3578759642,3578759642,0
1,1454,46742,3578759642,3578759642,0
1,1454,46743,3578759642,3578759642,0
1,1454,46744,3578759642,3578759642,0
1,1454,46745,3578759642,3578759642,0
1,1454,46746,3578759642,3578759642,0
1,1454,46747,3578759642,3578759647,5
1,1454,46748,3578759642,3578759648,6
1,1454,46749,3578759642,3578759649,7
1,1454,46750,3578759642,3578759649,7
1,1454,46751,3578759642,3578759652,10
1,1454,46752,3578759642,3578759652,10
1,1454,46753,3578759642,3578759654,12
1,1454,46754,3578759642,3578759654,12
1,1454,46755,3578759642,3578759656,14
1,1454,46756,3578759642,3578759657,15
1,1454,46757,3578759642,3578759657,15
1,1454,46758,3578759642,3578759658,16
1,1454,46759,3578759642,3578759662,20
1,1454,46760,3578759642,3578759662,20
1,1454,46761,3578759642,3578759665,23
1,1454,46762,3578759642,3578759666,24
1,1454,46763,3578759642,3578759667,25
1,1454,46764,3578759642,3578759669,27
1,1454,46765,3578759642,3578759679,37
1,1454,46766,3578759642,3578759679,37
1,1454,46767,3578759642,3578759682,40
1,1454,46768,3578759642,3578759682,40
1,1454,46769,3578759642,3578759684,42
1,1454,46770,3578759642,3578759685,43
1,1454,46771,3578759642,3578759685,43
1,1454,46772,3578759642,3578759685,43
1,1454,46773,3578759642,3578759686,44
1,1454,46774,3578759642,3578759688,46
1,1454,46775,3578759642,3578759689,47
1,1454,46776,3578759642,3578759689,47
1,1454,46777,3578759642,3578759690,48
1,1454,46778,3578759642,3578759691,49
1,1454,46779,3578759642,3578759692,50
1,1455,46780,3578759706,3578759706,0
1,1455,46781,3578759706,3578759706,0
1,1455,46782,3578759706,3578759706,0
1,1455,46783,3578759706,3578759706,0
1,1455,46784,3578759706,3578759706,0
1,1455,46785,3578759706,3578759706,0
1,1455,46786,3578759706,3578759706,0
1,1455,46787,3578759706,3578759706,0
1,1455,46788,3578759706,3578759706,0
1,1455,46789,3578759706,3578759706,0
1,1455,46790,3578759706,3578759706,0
1,1455,46791,3578759706,3578759706,0
1,1455,46792,3578759706,3578759706,0
1,1455,46793,3578759706,3578759706,0
1,1455,46794,3578759706,3578759706,0
1,1455,46795,3578759706,3578759706,0
1,1455,46796,3578759706,3578759706,0
1,1455,46797,3578759706,3578759707,1
1,1455,46798,3578759706,3578759707,1
1,1455,46799,3578759706,3578759707,1
1,1455,46800,3578759706,3578759708,2
1,1455,46801,3578759706,3578759708,2
1,1455,46802,3578759706,3578759709,3
1,1455,46803,3578759706,3578759709,3
1,1455,46804,3578759706,3578759709,3
1,1455,46805,3578759706,3578759710,4
1,1455,46806,3578759706,3578759710,4
1,1455,46807,3578759706,3578759710,4
1,1455,46808,3578759706,3578759711,5
1,1455,46809,3578759706,3578759712,6
1,1455,46810,3578759706,3578759712,6
1,1455,46811,3578759706,3578759713,7
1,1455,46812,3578759706,3578759713,7
1,1455,46813,3578759706,3578759713,7
1,1455,46814,3578759706,3578759714,8
1,1455,46815,3578759706,3578759717,11
1,1455,46816,3578759706,3578759717,11
1,1455,46817,3578759706,3578759718,12
1,1455,46818,3578759706,3578759719,13
1,1455,46819,3578759706,3578759720,14
1,1455,46820,3578759706,3578759720,14
1,1455,46821,3578759706,3578759720,14
1,1455,46822,3578759706,3578759720,14
1,1455,46823,3578759706,3578759721,15
1,1455,46824,3578759706,3578759721,15
1,1455,46825,3578759706,3578759723,17
1,1455,46826,3578759706,3578759724,18
1,1455,46827,3578759706,3578759724,18
1,1455,46828,3578759706,3578759726,20
1,1455,46829,3578759706,3578759726,20
1,1455,46830,3578759706,3578759726,20
1,1455,46831,3578759706,3578759727,21
1,1455,46832,3578759706,3578759730,24
1,1455,46833,3578759706,3578759730,24
1,1455,46834,3578759706,3578759730,24
1,1455,46835,3578759706,3578759732,26
1,1455,46836,3578759706,3578759732,26
1,1455,46837,3578759706,3578759733,27
1,1455,46838,3578759706,3578759734,28
1,1455,46839,3578759706,3578759734,28
1,1455,46840,3578759706,3578759735,29
1,1455,46841,3578759706,3578759736,30
1,1455,46842,3578759706,3578759736,30
1,1455,46843,3578759706,3578759736,30
1,1455,46844,3578759706,3578759736,30
1,1455,46845,3578759706,3578759738,32
1,1455,46846,3578759706,3578759739,33
1,1455,46847,3578759706,3578759741,35
1,1455,46848,3578759706,3578759742,36
1,1455,46849,3578759706,3578759745,39
1,1455,46850,3578759706,3578759747,41
1,1455,46851,3578759706,3578759747,41
1,1455,46852,3578759706,3578759749,43
1,1455,46853,3578759706,3578759749,43
1,1455,46854,3578759706,3578759753,47
1,1455,46855,3578759706,3578759754,48
1,1455,46856,3578759706,3578759755,49
1,1455,46857,3578759706,3578759756,50
1,1456,46858,3578759770,3578759770,0
1,1456,46859,3578759770,3578759770,0
1,1456,46860,3578759770,3578759770,0
1,1456,46861,3578759770,3578759770,0
1,1456,46862,3578759770,3578759770,0
1,1456,46863,3578759770,3578759770,0
1,1456,46864,3578759770,3578759770,0
1,1456,46865,3578759770,3578759770,0
1,1456,46866,3578759770,3578759770,0
1,1456,46867,3578759770,3578759770,0
1,1456,46868,3578759770,3578759771,1
1,1456,46869,3578759770,3578759772,2
1,1456,46870,3578759770,3578759775,5
1,1456,46871,3578759770,3578759776,6
1,1456,46872,3578759770,3578759778,8
1,1456,46873,3578759770,3578759778,8
1,1456,46874,3578759770,3578759779,9
1,1456,46875,3578759770,3578759780,10
1,1456,46876,3578759770,3578759780,10
1,1456,46877,3578759770,3578759781,11
1,1456,46878,3578759770,3578759781,11
1,1456,46879,3578759770,3578759781,11
1,1456,46880,3578759770,3578759781,11
1,1456,46881,3578759770,3578759782,12
1,1456,46882,3578759770,3578759784,14
1,1456,46883,3578759770,3578759784,14
1,1456,46884,3578759770,3578759785,15
1,1456,46885,3578759770,3578759786,16
1,1456,46886,3578759770,3578759788,18
1,1456,46887,3578759770,3578759790,20
1,1456,46888,3578759770,3578759791,21
1,1456,46889,3578759770,3578759791,21
1,1456,46890,3578759770,3578759792,22
1,1456,46891,3578759770,3578759792,22
1,1456,46892,3578759770,3578759793,23
1,1456,46893,3578759770,3578759795,25
1,1456,46894,3578759770,3578759795,25
1,1456,46895,3578759770,3578759795,25
1,1456,46896,3578759770,3578759796,26
1,1456,46897,3578759770,3578759796,26
1,1456,46898,3578759770,3578759796,26
1,1456,46899,3578759770,3578759797,27
1,1456,46900,3578759770,3578759798,28
1,1456,46901,3578759770,3578759798,28
1,1456,46902,3578759770,3578759798,28
1,1456,46903,3578759770,3578759800,30
1,1456,46904,3578759770,3578759801,31
1,1456,46905,3578759770,3578759801,31
1,1456,46906,3578759770,3578759803,33
1,1456,46907,3578759770,3578759805,35
1,1456,46908,3578759770,3578759806,36
1,1456,46909,3578759770,3578759809,39
1,1456,46910,3578759770,3578759811,41
1,1456,46911,3578759770,3578759812,42
1,1456,46912,3578759770,3578759813,43
1,1456,46913,3578759770,3578759816,46
1,1456,46914,3578759770,3578759816,46
1,1456,46915,3578759770,3578759816,46
1,1456,46916,3578759770,3578759817,47
1,1456,46917,3578759770,3578759817,47
1,1456,46918,3578759770,3578759818,48
1,1456,46919,3578759770,3578759818,48
1,1456,46920,3578759770,3578759818,48
1,1456,46921,3578759770,3578759819,49
1,1456,46922,3578759770,3578759819,49
1,1456,46923,3578759770,3578759819,49
1,1456,46924,3578759770,3578759819,49
1,1456,46925,3578759770,3578759820,50
1,1457,46926,3578759833,3578759833,0
1,1457,46927,3578759833,3578759833,0
1,1457,46928,3578759833,3578759833,0
1,1457,46929,3578759833,3578759833,0
1,1457,46930,3578759833,3578759833,0
1,1457,46931,3578759833,3578759833,0
1,1457,46932,3578759833,3578759833,0
1,1457,46933,3578759833,3578759833,0
1,1457,46934,3578759833,3578759833,0
1,1457,46935,3578759833,3578759833,0
1,1457,46936,3578759833,3578759833,0
1,1457,46937,3578759833,3578759834,1
1,1457,46938,3578759833,3578759835,2
1,1457,46939,3578759833,3578759836,3
1,1457,46940,3578759833,3578759838,5
1,1457,46941,3578759833,3578759838,5
1,1457,46942,3578759833,3578759839,6
1,1457,46943,3578759833,3578759841,8
1,1457,46944,3578759833,3578759842,9
1,1457,46945,3578759833,3578759848,15
1,1457,46946,3578759833,3578759848,15
1,1457,46947,3578759833,3578759848,15
1,1457,46948,3578759833,3578759849,16
1,1457,46949,3578759833,3578759850,17
1,1457,46950,3578759833,3578759852,19
1,1457,46951,3578759833,3578759852,19
1,1457,46952,3578759833,3578759854,21
1,1457,46953,3578759833,3578759855,22
1,1457,46954,3578759833,3578759857,24
1,1457,46955,3578759833,3578759857,24
1,1457,46956,3578759833,3578759857,24
1,1457,46957,3578759833,3578759859,26
1,1457,46958,3578759833,3578759859,26
1,1457,46959,3578759833,3578759861,28
1,1457,46960,3578759833,3578759862,29
1,1457,46961,3578759833,3578759863,30
1,1457,46962,3578759833,3578759864,31
1,1457,46963,3578759833,3578759866,33
1,1457,46964,3578759833,3578759868,35
1,1457,46965,3578759833,3578759869,36
1,1457,46966,3578759833,3578759879,46
1,1457,46967,3578759833,3578759879,46
1,1457,46968,3578759833,3578759880,47
1,1457,46969,3578759833,3578759882,49
1,1457,46970,3578759833,3578759882,49
1,1458,46971,3578759897,3578759897,0
1,1458,46972,3578759897,3578759897,0
1,1458,46973,3578759897,3578759897,0
1,1458,46974,3578759897,3578759897,0
1,1458,46975,3578759897,3578759897,0
1,1458,46976,3578759897,3578759897,0
1,1458,46977,3578759897,3578759897,0
1,1458,46978,3578759897,3578759897,0
1,1458,46979,3578759897,3578759897,0
1,1458,46980,3578759897,3578759897,0
1,1458,46981,3578759897,3578759897,0
1,1458,46982,3578759897,3578759897,0
1,1458,46983,3578759897,3578759897,0
1,1458,46984,3578759897,3578759897,0
1,1458,46985,3578759897,3578759897,0
1,1458,46986,3578759897,3578759897,0
1,1458,46987,3578759897,3578759897,0
1,1458,46988,3578759897,3578759897,0
1,1458,46989,3578759897,3578759897,0
1,1458,46990,3578759897,3578759900,3
1,1458,46991,3578759897,3578759902,5
1,1458,46992,3578759897,3578759903,6
1,1458,46993,3578759897,3578759903,6
1,1458,46994,3578759897,3578759903,6
1,1458,46995,3578759897,3578759904,7
1,1458,46996,3578759897,3578759904,7
1,1458,46997,3578759897,3578759904,7
1,1458,46998,3578759897,3578759907,10
1,1458,46999,3578759897,3578759907,10
1,1458,47000,3578759897,3578759908,11
1,1458,47001,3578759897,3578759908,11
1,1458,47002,3578759897,3578759908,11
1,1458,47003,3578759897,3578759909,12
1,1458,47004,3578759897,3578759909,12
1,1458,47005,3578759897,3578759910,13
1,1458,47006,3578759897,3578759910,13
1,1458,47007,3578759897,3578759911,14
1,1458,47008,3578759897,3578759911,14
1,1458,47009,3578759897,3578759912,15
1,1458,47010,3578759897,3578759912,15
1,1458,47011,3578759897,3578759912,15
1,1458,47012,3578759897,3578759913,16
1,1458,47013,3578759897,3578759914,17
1,1458,47014,3578759897,3578759915,18
1,1458,47015,3578759897,3578759915,18
1,1458,47016,3578759897,3578759917,20
1,1458,47017,3578759897,3578759917,20
1,1458,47018,3578759897,3578759918,21
1,1458,47019,3578759897,3578759918,21
1,1458,47020,3578759897,3578759919,22
1,1458,47021,3578759897,3578759919,22
1,1458,47022,3578759897,3578759920,23
1,1458,47023,3578759897,3578759921,24
1,1458,47024,3578759897,3578759922,25
1,1458,47025,3578759897,3578759923,26
1,1458,47026,3578759897,3578759924,27
1,1458,47027,3578759897,3578759925,28
1,1458,47028,3578759897,3578759926,29
1,1458,47029,3578759897,3578759926,29
1,1458,47030,3578759897,3578759926,29
1,1458,47031,3578759897,3578759926,29
1,1458,47032,3578759897,3578759927,30
1,1458,47033,3578759897,3578759929,32
1,1458,47034,3578759897,3578759931,34
1,1458,47035,3578759897,3578759931,34
1,1458,47036,3578759897,3578759931,34
1,1458,47037,3578759897,3578759931,34
1,1458,47038,3578759897,3578759932,35
1,1458,47039,3578759897,3578759933,36
1,1458,47040,3578759897,3578759933,36
1,1458,47041,3578759897,3578759934,37
1,1458,47042,3578759897,3578759935,38
1,1458,47043,3578759897,3578759936,39
1,1458,47044,3578759897,3578759936,39
1,1458,47045,3578759897,3578759936,39
1,1458,47046,3578759897,3578759937,40
1,1458,47047,3578759897,3578759938,41
1,1458,47048,3578759897,3578759940,43
1,1458,47049,3578759897,3578759941,44
1,1458,47050,3578759897,3578759942,45
1,1458,47051,3578759897,3578759946,49
1,1459,47052,3578759960,3578759960,0
1,1459,47053,3578759960,3578759960,0
1,1459,47054,3578759960,3578759960,0
1,1459,47055,3578759960,3578759960,0
1,1459,47056,3578759960,3578759960,0
1,1459,47057,3578759960,3578759960,0
1,1459,47058,3578759960,3578759960,0
1,1459,47059,3578759960,3578759960,0
1,1459,47060,3578759960,3578759960,0
1,1459,47061,3578759960,3578759962,2
1,1459,47062,3578759960,3578759963,3
1,1459,47063,3578759960,3578759963,3
1,1459,47064,3578759960,3578759964,4
1,1459,47065,3578759960,3578759964,4
1,1459,47066,3578759960,3578759965,5
1,1459,47067,3578759960,3578759965,5
1,1459,47068,3578759960,3578759966,6
1,1459,47069,3578759960,3578759967,7
1,1459,47070,3578759960,3578759967,7
1,1459,47071,3578759960,3578759968,8
1,1459,47072,3578759960,3578759969,9
1,1459,47073,3578759960,3578759971,11
1,1459,47074,3578759960,3578759975,15
1,1459,47075,3578759960,3578759976,16
1,1459,47076,3578759960,3578759976,16
1,1459,47077,3578759960,3578759977,17
1,1459,47078,3578759960,3578759979,19
1,1459,47079,3578759960,3578759980,20
1,1459,47080,3578759960,3578759980,20
1,1459,47081,3578759960,3578759981,21
1,1459,47082,3578759960,3578759981,21
1,1459,47083,3578759960,3578759981,21
1,1459,47084,3578759960,3578759981,21
1,1459,47085,3578759960,3578759982,22
1,1459,47086,3578759960,3578759982,22
1,1459,47087,3578759960,3578759983,23
1,1459,47088,3578759960,3578759985,25
1,1459,47089,3578759960,3578759985,25
1,1459,47090,3578759960,3578759986,26
1,1459,47091,3578759960,3578759988,28
1,1459,47092,3578759960,3578759991,31
1,1459,47093,3578759960,3578759991,31
1,1459,47094,3578759960,3578759991,31
1,1459,47095,3578759960,3578759993,33
1,1459,47096,3578759960,3578759994,34
1,1459,47097,3578759960,3578759994,34
1,1459,47098,3578759960,3578759995,35
1,1459,47099,3578759960,3578759995,35
1,1459,47100,3578759960,3578759996,36
1,1459,47101,3578759960,3578759997,37
1,1459,47102,3578759960,3578759997,37
1,1459,47103,3578759960,3578759997,37
1,1459,47104,3578759960,3578759998,38
1,1459,47105,3578759960,3578759999,39
1,1459,47106,3578759960,3578759999,39
1,1459,47107,3578759960,3578760000,40
1,1459,47108,3578759960,3578760001,41
1,1459,47109,3578759960,3578760001,41
1,1459,47110,3578759960,3578760003,43
1,1459,47111,3578759960,3578760006,46
1,1459,47112,3578759960,3578760006,46
1,1459,47113,3578759960,3578760008,48
1,1460,47114,3578760026,3578760026,0
1,1460,47115,3578760026,3578760026,0
1,1460,47116,3578760026,3578760026,0
1,1460,47117,3578760026,3578760026,0
1,1460,47118,3578760026,3578760026,0
1,1460,47119,3578760026,3578760026,0
1,1460,47120,3578760026,3578760026,0
1,1460,47121,3578760026,3578760026,0
1,1460,47122,3578760026,3578760026,0
1,1460,47123,3578760026,3578760026,0
1,1460,47124,3578760026,3578760026,0
1,1460,47125,3578760026,3578760026,0
1,1460,47126,3578760026,3578760026,0
1,1460,47127,3578760026,3578760026,0
1,1460,47128,3578760026,3578760026,0
1,1460,47129,3578760026,3578760026,0
1,1460,47130,3578760026,3578760026,0
1,1460,47131,3578760026,3578760026,0
1,1460,47132,3578760026,3578760027,1
1,1460,47133,3578760026,3578760028,2
1,1460,47134,3578760026,3578760028,2
1,1460,47135,3578760026,3578760029,3
1,1460,47136,3578760026,3578760029,3
1,1460,47137,3578760026,3578760030,4
1,1460,47138,3578760026,3578760030,4
1,1460,47139,3578760026,3578760032,6
1,1460,47140,3578760026,3578760033,7
1,1460,47141,3578760026,3578760034,8
1,1460,47142,3578760026,3578760035,9
1,1460,47143,3578760026,3578760038,12
1,1460,47144,3578760026,3578760038,12
1,1460,47145,3578760026,3578760038,12
1,1460,47146,3578760026,3578760038,12
1,1460,47147,3578760026,3578760041,15
1,1460,47148,3578760026,3578760048,22
1,1460,47149,3578760026,3578760049,23
1,1460,47150,3578760026,3578760049,23
1,1460,47151,3578760026,3578760050,24
1,1460,47152,3578760026,3578760050,24
1,1460,47153,3578760026,3578760053,27
1,1460,47154,3578760026,3578760053,27
1,1460,47155,3578760026,3578760054,28
1,1460,47156,3578760026,3578760055,29
1,1460,47157,3578760026,3578760056,30
1,1460,47158,3578760026,3578760056,30
1,1460,47159,3578760026,3578760057,31
1,1460,47160,3578760026,3578760060,34
1,1460,47161,3578760026,3578760060,34
1,1460,47162,3578760026,3578760061,35
1,1460,47163,3578760026,3578760063,37
1,1460,47164,3578760026,3578760063,37
1,1460,47165,3578760026,3578760067,41
1,1460,47166,3578760026,3578760067,41
1,1460,47167,3578760026,3578760070,44
1,1461,47168,3578760089,3578760089,0
1,1461,47169,3578760089,3578760089,0
1,1461,47170,3578760089,3578760089,0
1,1461,47171,3578760089,3578760089,0
1,1461,47172,3578760089,3578760089,0
1,1461,47173,3578760089,3578760089,0
1,1461,47174,3578760089,3578760089,0
1,1461,47175,3578760089,3578760089,0
1,1461,47176,3578760089,3578760089,0
1,1461,47177,3578760089,3578760089,0
1,1461,47178,3578760089,3578760091,2
1,1461,47179,3578760089,3578760092,3
1,1461,47180,3578760089,3578760092,3
1,1461,47181,3578760089,3578760093,4
1,1461,47182,3578760089,3578760094,5
1,1461,47183,3578760089,3578760094,5
1,1461,47184,3578760089,3578760095,6
1,1461,47185,3578760089,3578760095,6
1,1461,47186,3578760089,3578760096,7
1,1461,47187,3578760089,3578760096,7
1,1461,47188,3578760089,3578760097,8
1,1461,47189,3578760089,3578760097,8
1,1461,47190,3578760089,3578760098,9
1,1461,47191,3578760089,3578760100,11
1,1461,47192,3578760089,3578760102,13
1,1461,47193,3578760089,3578760103,14
1,1461,47194,3578760089,3578760103,14
1,1461,47195,3578760089,3578760103,14
1,1461,47196,3578760089,3578760105,16
1,1461,47197,3578760089,3578760105,16
1,1461,47198,3578760089,3578760106,17
1,1461,47199,3578760089,3578760107,18
1,1461,47200,3578760089,3578760107,18
1,1461,47201,3578760089,3578760107,18
1,1461,47202,3578760089,3578760108,19
1,1461,47203,3578760089,3578760109,20
1,1461,47204,3578760089,3578760109,20
1,1461,47205,3578760089,3578760109,20
1,1461,47206,3578760089,3578760109,20
1,1461,47207,3578760089,3578760110,21
1,1461,47208,3578760089,3578760110,21
1,1461,47209,3578760089,3578760110,21
1,1461,47210,3578760089,3578760112,23
1,1461,47211,3578760089,3578760112,23
1,1461,47212,3578760089,3578760113,24
1,1461,47213,3578760089,3578760113,24
1,1461,47214,3578760089,3578760114,25
1,1461,47215,3578760089,3578760114,25
1,1461,47216,3578760089,3578760114,25
1,1461,47217,3578760089,3578760115,26
1,1461,47218,3578760089,3578760117,28
1,1461,47219,3578760089,3578760118,29
1,1461,47220,3578760089,3578760119,30
1,1461,47221,3578760089,3578760120,31
1,1461,47222,3578760089,3578760120,31
1,1461,47223,3578760089,3578760121,32
1,1461,47224,3578760089,3578760122,33
1,1461,47225,3578760089,3578760124,35
1,1461,47226,3578760089,3578760124,35
1,1461,47227,3578760089,3578760125,36
1,1461,47228,3578760089,3578760126,37
1,1461,47229,3578760089,3578760126,37
1,1461,47230,3578760089,3578760127,38
1,1461,47231,3578760089,3578760127,38
1,1461,47232,3578760089,3578760128,39
1,1461,47233,3578760089,3578760128,39
1,1461,47234,3578760089,3578760131,42
1,1461,47235,3578760089,3578760131,42
1,1461,47236,3578760089,3578760131,42
1,1461,47237,3578760089,3578760131,42
1,1461,47238,3578760089,3578760133,44
1,1461,47239,3578760089,3578760133,44
1,1461,47240,3578760089,3578760134,45
1,1461,47241,3578760089,3578760135,46
1,1461,47242,3578760089,3578760135,46
1,1461,47243,3578760089,3578760135,46
1,1461,47244,3578760089,3578760136,47
1,1461,47245,3578760089,3578760136,47
1,1462,47246,3578760153,3578760153,0
1,1462,47247,3578760153,3578760153,0
1,1462,47248,3578760153,3578760153,0
1,1462,47249,3578760153,3578760153,0
1,1462,47250,3578760153,3578760153,0
1,1462,47251,3578760153,3578760153,0
1,1462,47252,3578760153,3578760153,0
1,1462,47253,3578760153,3578760153,0
1,1462,47254,3578760153,3578760153,0
1,1462,47255,3578760153,3578760154,1
1,1462,47256,3578760153,3578760155,2
1,1462,47257,3578760153,3578760156,3
1,1462,47258,3578760153,3578760156,3
1,1462,47259,3578760153,3578760159,6
1,1462,47260,3578760153,3578760162,9
1,1462,47261,3578760153,3578760163,10
1,1462,47262,3578760153,3578760163,10
1,1462,47263,3578760153,3578760164,11
1,1462,47264,3578760153,3578760165,12
1,1462,47265,3578760153,3578760166,13
1,1462,47266,3578760153,3578760167,14
1,1462,47267,3578760153,3578760167,14
1,1462,47268,3578760153,3578760168,15
1,1462,47269,3578760153,3578760169,16
1,1462,47270,3578760153,3578760172,19
1,1462,47271,3578760153,3578760172,19
1,1462,47272,3578760153,3578760175,22
1,1462,47273,3578760153,3578760176,23
1,1462,47274,3578760153,3578760177,24
1,1462,47275,3578760153,3578760178,25
1,1462,47276,3578760153,3578760178,25
1,1462,47277,3578760153,3578760180,27
1,1462,47278,3578760153,3578760180,27
1,1462,47279,3578760153,3578760180,27
1,1462,47280,3578760153,3578760180,27
1,1462,47281,3578760153,3578760181,28
1,1462,47282,3578760153,3578760181,28
1,1462,47283,3578760153,3578760181,28
1,1462,47284,3578760153,3578760183,30
1,1462,47285,3578760153,3578760183,30
1,1462,47286,3578760153,3578760183,30
1,1462,47287,3578760153,3578760184,31
1,1462,47288,3578760153,3578760185,32
1,1462,47289,3578760153,3578760186,33
1,1462,47290,3578760153,3578760189,36
1,1462,47291,3578760153,3578760190,37
1,1462,47292,3578760153,3578760191,38
1,1462,47293,3578760153,3578760192,39
1,1462,47294,3578760153,3578760193,40
1,1462,47295,3578760153,3578760193,40
1,1462,47296,3578760153,3578760194,41
1,1462,47297,3578760153,3578760195,42
1,1462,47298,3578760153,3578760195,42
1,1462,47299,3578760153,3578760196,43
1,1462,47300,3578760153,3578760196,43
1,1462,47301,3578760153,3578760196,43
1,1462,47302,3578760153,3578760197,44
1,1462,47303,3578760153,3578760197,44
1,1462,47304,3578760153,3578760198,45
1,1462,47305,3578760153,3578760199,46
1,1462,47306,3578760153,3578760199,46
1,1462,47307,3578760153,3578760201,48
1,1462,47308,3578760153,3578760201,48
1,1462,47309,3578760153,3578760202,49
1,1463,47310,3578760216,3578760216,0
1,1463,47311,3578760216,3578760216,0
1,1463,47312,3578760216,3578760216,0
1,1463,47313,3578760216,3578760216,0
1,1463,47314,3578760216,3578760216,0
1,1463,47315,3578760216,3578760216,0
1,1463,47316,3578760216,3578760216,0
1,1463,47317,3578760216,3578760216,0
1,1463,47318,3578760216,3578760216,0
1,1463,47319,3578760216,3578760217,1
1,1463,47320,3578760216,3578760217,1
1,1463,47321,3578760216,3578760217,1
1,1463,47322,3578760216,3578760217,1
1,1463,47323,3578760216,3578760218,2
1,1463,47324,3578760216,3578760219,3
1,1463,47325,3578760216,3578760219,3
1,1463,47326,3578760216,3578760219,3
1,1463,47327,3578760216,3578760219,3
1,1463,47328,3578760216,3578760219,3
1,1463,47329,3578760216,3578760220,4
1,1463,47330,3578760216,3578760220,4
1,1463,47331,3578760216,3578760223,7
1,1463,47332,3578760216,3578760224,8
1,1463,47333,3578760216,3578760228,12
1,1463,47334,3578760216,3578760228,12
1,1463,47335,3578760216,3578760229,13
1,1463,47336,3578760216,3578760229,13
1,1463,47337,3578760216,3578760229,13
1,1463,47338,3578760216,3578760229,13
1,1463,47339,3578760216,3578760230,14
1,1463,47340,3578760216,3578760230,14
1,1463,47341,3578760216,3578760231,15
1,1463,47342,3578760216,3578760233,17
1,1463,47343,3578760216,3578760235,19
1,1463,47344,3578760216,3578760236,20
1,1463,47345,3578760216,3578760237,21
1,1463,47346,3578760216,3578760237,21
1,1463,47347,3578760216,3578760238,22
1,1463,47348,3578760216,3578760243,27
1,1463,47349,3578760216,3578760248,32
1,1463,47350,3578760216,3578760248,32
1,1463,47351,3578760216,3578760249,33
1,1463,47352,3578760216,3578760250,34
1,1463,47353,3578760216,3578760250,34
1,1463,47354,3578760216,3578760253,37
1,1463,47355,3578760216,3578760254,38
1,1463,47356,3578760216,3578760255,39
1,1463,47357,3578760216,3578760256,40
1,1463,47358,3578760216,3578760256,40
1,1463,47359,3578760216,3578760256,40
1,1463,47360,3578760216,3578760259,43
1,1463,47361,3578760216,3578760261,45
1,1463,47362,3578760216,3578760261,45
1,1463,47363,3578760216,3578760263,47
1,1463,47364,3578760216,3578760263,47
1,1464,47365,3578760281,3578760281,0
1,1464,47366,3578760281,3578760281,0
1,1464,47367,3578760281,3578760281,0
1,1464,47368,3578760281,3578760281,0
1,1464,47369,3578760281,3578760281,0
1,1464,47370,3578760281,3578760281,0
1,1464,47371,3578760281,3578760282,1
1,1464,47372,3578760281,3578760282,1
1,1464,47373,3578760281,3578760284,3
1,1464,47374,3578760281,3578760285,4
1,1464,47375,3578760281,3578760285,4
1,1464,47376,3578760281,3578760286,5
1,1464,47377,3578760281,3578760289,8
1,1464,47378,3578760281,3578760289,8
1,1464,47379,3578760281,3578760289,8
1,1464,47380,3578760281,3578760290,9
1,1464,47381,3578760281,3578760293,12
1,1464,47382,3578760281,3578760293,12
1,1464,47383,3578760281,3578760293,12
1,1464,47384,3578760281,3578760295,14
1,1464,47385,3578760281,3578760296,15
1,1464,47386,3578760281,3578760296,15
1,1464,47387,3578760281,3578760296,15
1,1464,47388,3578760281,3578760296,15
1,1464,47389,3578760281,3578760297,16
1,1464,47390,3578760281,3578760298,17
1,1464,47391,3578760281,3578760298,17
1,1464,47392,3578760281,3578760298,17
1,1464,47393,3578760281,3578760300,19
1,1464,47394,3578760281,3578760302,21
1,1464,47395,3578760281,3578760302,21
1,1464,47396,3578760281,3578760303,22
1,1464,47397,3578760281,3578760303,22
1,1464,47398,3578760281,3578760304,23
1,1464,47399,3578760281,3578760305,24
1,1464,47400,3578760281,3578760305,24
1,1464,47401,3578760281,3578760306,25
1,1464,47402,3578760281,3578760307,26
1,1464,47403,3578760281,3578760308,27
1,1464,47404,3578760281,3578760309,28
1,1464,47405,3578760281,3578760309,28
1,1464,47406,3578760281,3578760310,29
1,1464,47407,3578760281,3578760310,29
1,1464,47408,3578760281,3578760310,29
1,1464,47409,3578760281,3578760310,29
1,1464,47410,3578760281,3578760311,30
1,1464,47411,3578760281,3578760311,30
1,1464,47412,3578760281,3578760312,31
1,1464,47413,3578760281,3578760313,32
1,1464,47414,3578760281,3578760313,32
1,1464,47415,3578760281,3578760313,32
1,1464,47416,3578760281,3578760314,33
1,1464,47417,3578760281,3578760314,33
1,1464,47418,3578760281,3578760315,34
1,1464,47419,3578760281,3578760317,36
1,1464,47420,3578760281,3578760318,37
1,1464,47421,3578760281,3578760318,37
1,1464,47422,3578760281,3578760319,38
1,1464,47423,3578760281,3578760320,39
1,1464,47424,3578760281,3578760321,40
1,1464,47425,3578760281,3578760322,41
1,1464,47426,3578760281,3578760322,41
1,1464,47427,3578760281,3578760324,43
1,1464,47428,3578760281,3578760324,43
1,1464,47429,3578760281,3578760324,43
1,1464,47430,3578760281,3578760327,46
1,1464,47431,3578760281,3578760327,46
1,1464,47432,3578760281,3578760327,46
1,1464,47433,3578760281,3578760327,46
1,1464,47434,3578760281,3578760328,47
1,1464,47435,3578760281,3578760329,48
1,1464,47436,3578760281,3578760331,50
1,1465,47437,3578760345,3578760345,0
1,1465,47438,3578760345,3578760345,0
1,1465,47439,3578760345,3578760345,0
1,1465,47440,3578760345,3578760345,0
1,1465,47441,3578760345,3578760345,0
1,1465,47442,3578760345,3578760345,0
1,1465,47443,3578760345,3578760345,0
1,1465,47444,3578760345,3578760345,0
1,1465,47445,3578760345,3578760345,0
1,1465,47446,3578760345,3578760345,0
1,1465,47447,3578760345,3578760345,0
1,1465,47448,3578760345,3578760345,0
1,1465,47449,3578760345,3578760345,0
1,1465,47450,3578760345,3578760348,3
1,1465,47451,3578760345,3578760348,3
1,1465,47452,3578760345,3578760348,3
1,1465,47453,3578760345,3578760351,6
1,1465,47454,3578760345,3578760353,8
1,1465,47455,3578760345,3578760354,9
1,1465,47456,3578760345,3578760356,11
1,1465,47457,3578760345,3578760356,11
1,1465,47458,3578760345,3578760356,11
1,1465,47459,3578760345,3578760360,15
1,1465,47460,3578760345,3578760362,17
1,1465,47461,3578760345,3578760363,18
1,1465,47462,3578760345,3578760363,18
1,1465,47463,3578760345,3578760364,19
1,1465,47464,3578760345,3578760365,20
1,1465,47465,3578760345,3578760366,21
1,1465,47466,3578760345,3578760367,22
1,1465,47467,3578760345,3578760367,22
1,1465,47468,3578760345,3578760367,22
1,1465,47469,3578760345,3578760369,24
1,1465,47470,3578760345,3578760370,25
1,1465,47471,3578760345,3578760371,26
1,1465,47472,3578760345,3578760372,27
1,1465,47473,3578760345,3578760375,30
1,1465,47474,3578760345,3578760376,31
1,1465,47475,3578760345,3578760377,32
1,1465,47476,3578760345,3578760377,32
1,1465,47477,3578760345,3578760378,33
1,1465,47478,3578760345,3578760379,34
1,1465,47479,3578760345,3578760379,34
1,1465,47480,3578760345,3578760380,35
1,1465,47481,3578760345,3578760380,35
1,1465,47482,3578760345,3578760380,35
1,1465,47483,3578760345,3578760381,36
1,1465,47484,3578760345,3578760381,36
1,1465,47485,3578760345,3578760382,37
1,1465,47486,3578760345,3578760382,37
1,1465,47487,3578760345,3578760382,37
1,1465,47488,3578760345,3578760383,38
1,1465,47489,3578760345,3578760384,39
1,1465,47490,3578760345,3578760385,40
1,1465,47491,3578760345,3578760386,41
1,1465,47492,3578760345,3578760389,44
1,1465,47493,3578760345,3578760391,46
1,1465,47494,3578760345,3578760391,46
1,1465,47495,3578760345,3578760392,47
1,1465,47496,3578760345,3578760393,48
1,1465,47497,3578760345,3578760394,49
1,1465,47498,3578760345,3578760394,49
1,1466,47499,3578760409,3578760409,0
1,1466,47500,3578760409,3578760409,0
1,1466,47501,3578760409,3578760409,0
1,1466,47502,3578760409,3578760409,0
1,1466,47503,3578760409,3578760409,0
1,1466,47504,3578760409,3578760409,0
1,1466,47505,3578760409,3578760409,0
1,1466,47506,3578760409,3578760409,0
1,1466,47507,3578760409,3578760409,0
1,1466,47508,3578760409,3578760409,0
1,1466,47509,3578760409,3578760409,0
1,1466,47510,3578760409,3578760409,0
1,1466,47511,3578760409,3578760409,0
1,1466,47512,3578760409,3578760409,0
1,1466,47513,3578760409,3578760409,0
1,1466,47514,3578760409,3578760409,0
1,1466,47515,3578760409,3578760412,3
1,1466,47516,3578760409,3578760413,4
1,1466,47517,3578760409,3578760413,4
1,1466,47518,3578760409,3578760415,6
1,1466,47519,3578760409,3578760417,8
1,1466,47520,3578760409,3578760417,8
1,1466,47521,3578760409,3578760417,8
1,1466,47522,3578760409,3578760417,8
1,1466,47523,3578760409,3578760418,9
1,1466,47524,3578760409,3578760419,10
1,1466,47525,3578760409,3578760419,10
1,1466,47526,3578760409,3578760419,10
1,1466,47527,3578760409,3578760419,10
1,1466,47528,3578760409,3578760419,10
1,1466,47529,3578760409,3578760420,11
1,1466,47530,3578760409,3578760421,12
1,1466,47531,3578760409,3578760423,14
1,1466,47532,3578760409,3578760424,15
1,1466,47533,3578760409,3578760428,19
1,1466,47534,3578760409,3578760428,19
1,1466,47535,3578760409,3578760429,20
1,1466,47536,3578760409,3578760429,20
1,1466,47537,3578760409,3578760429,20
1,1466,47538,3578760409,3578760430,21
1,1466,47539,3578760409,3578760431,22
1,1466,47540,3578760409,3578760432,23
1,1466,47541,3578760409,3578760433,24
1,1466,47542,3578760409,3578760435,26
1,1466,47543,3578760409,3578760435,26
1,1466,47544,3578760409,3578760438,29
1,1466,47545,3578760409,3578760438,29
1,1466,47546,3578760409,3578760441,32
1,1466,47547,3578760409,3578760443,34
1,1466,47548,3578760409,3578760448,39
1,1466,47549,3578760409,3578760448,39
1,1466,47550,3578760409,3578760449,40
1,1466,47551,3578760409,3578760449,40
1,1466,47552,3578760409,3578760450,41
1,1466,47553,3578760409,3578760452,43
1,1466,47554,3578760409,3578760453,44
1,1466,47555,3578760409,3578760456,47
1,1466,47556,3578760409,3578760456,47
1,1466,47557,3578760409,3578760457,48
1,1467,47558,3578760473,3578760473,0
1,1467,47559,3578760473,3578760473,0
1,1467,47560,3578760473,3578760473,0
1,1467,47561,3578760473,3578760473,0
1,1467,47562,3578760473,3578760473,0
1,1467,47563,3578760473,3578760473,0
1,1467,47564,3578760473,3578760473,0
1,1467,47565,3578760473,3578760479,6
1,1467,47566,3578760473,3578760480,7
1,1467,47567,3578760473,3578760482,9
1,1467,47568,3578760473,3578760482,9
1,1467,47569,3578760473,3578760484,11
1,1467,47570,3578760473,3578760485,12
1,1467,47571,3578760473,3578760485,12
1,1467,47572,3578760473,3578760485,12
1,1467,47573,3578760473,3578760486,13
1,1467,47574,3578760473,3578760489,16
1,1467,47575,3578760473,3578760489,16
1,1467,47576,3578760473,3578760490,17
1,1467,47577,3578760473,3578760490,17
1,1467,47578,3578760473,3578760493,20
1,1467,47579,3578760473,3578760493,20
1,1467,47580,3578760473,3578760493,20
1,1467,47581,3578760473,3578760494,21
1,1467,47582,3578760473,3578760494,21
1,1467,47583,3578760473,3578760496,23
1,1467,47584,3578760473,3578760496,23
1,1467,47585,3578760473,3578760496,23
1,1467,47586,3578760473,3578760496,23
1,1467,47587,3578760473,3578760497,24
1,1467,47588,3578760473,3578760497,24
1,1467,47589,3578760473,3578760497,24
1,1467,47590,3578760473,3578760498,25
1,1467,47591,3578760473,3578760501,28
1,1467,47592,3578760473,3578760502,29
1,1467,47593,3578760473,3578760502,29
1,1467,47594,3578760473,3578760503,30
1,1467,47595,3578760473,3578760503,30
1,1467,47596,3578760473,3578760504,31
1,1467,47597,3578760473,3578760505,32
1,1467,47598,3578760473,3578760506,33
1,1467,47599,3578760473,3578760507,34
1,1467,47600,3578760473,3578760508,35
1,1467,47601,3578760473,3578760508,35
1,1467,47602,3578760473,3578760509,36
1,1467,47603,3578760473,3578760510,37
1,1467,47604,3578760473,3578760510,37
1,1467,47605,3578760473,3578760510,37
1,1467,47606,3578760473,3578760510,37
1,1467,47607,3578760473,3578760510,37
1,1467,47608,3578760473,3578760511,38
1,1467,47609,3578760473,3578760512,39
1,1467,47610,3578760473,3578760512,39
1,1467,47611,3578760473,3578760513,40
1,1467,47612,3578760473,3578760513,40
1,1467,47613,3578760473,3578760514,41
1,1467,47614,3578760473,3578760514,41
1,1467,47615,3578760473,3578760515,42
1,1467,47616,3578760473,3578760517,44
1,1467,47617,3578760473,3578760517,44
1,1467,47618,3578760473,3578760518,45
1,1467,47619,3578760473,3578760518,45
1,1467,47620,3578760473,3578760519,46
1,1467,47621,3578760473,3578760521,48
1,1467,47622,3578760473,3578760521,48
1,1467,47623,3578760473,3578760522,49
1,1467,47624,3578760473,3578760522,49
1,1467,47625,3578760473,3578760522,49
1,1468,47626,3578760536,3578760536,0
1,1468,47627,3578760536,3578760536,0
1,1468,47628,3578760536,3578760536,0
1,1468,47629,3578760536,3578760536,0
1,1468,47630,3578760536,3578760536,0
1,1468,47631,3578760536,3578760536,0
1,1468,47632,3578760536,3578760536,0
1,1468,47633,3578760536,3578760536,0
1,1468,47634,3578760536,3578760536,0
1,1468,47635,3578760536,3578760536,0
1,1468,47636,3578760536,3578760536,0
1,1468,47637,3578760536,3578760536,0
1,1468,47638,3578760536,3578760536,0
1,1468,47639,3578760536,3578760536,0
1,1468,47640,3578760536,3578760536,0
1,1468,47641,3578760536,3578760536,0
1,1468,47642,3578760536,3578760536,0
1,1468,47643,3578760536,3578760536,0
1,1468,47644,3578760536,3578760536,0
1,1468,47645,3578760536,3578760536,0
1,1468,47646,3578760536,3578760537,1
1,1468,47647,3578760536,3578760537,1
1,1468,47648,3578760536,3578760540,4
1,1468,47649,3578760536,3578760540,4
1,1468,47650,3578760536,3578760544,8
1,1468,47651,3578760536,3578760546,10
1,1468,47652,3578760536,3578760547,11
1,1468,47653,3578760536,3578760547,11
1,1468,47654,3578760536,3578760548,12
1,1468,47655,3578760536,3578760550,14
1,1468,47656,3578760536,3578760552,16
1,1468,47657,3578760536,3578760553,17
1,1468,47658,3578760536,3578760555,19
1,1468,47659,3578760536,3578760555,19
1,1468,47660,3578760536,3578760556,20
1,1468,47661,3578760536,3578760559,23
1,1468,47662,3578760536,3578760561,25
1,1468,47663,3578760536,3578760562,26
1,1468,47664,3578760536,3578760562,26
1,1468,47665,3578760536,3578760563,27
1,1468,47666,3578760536,3578760564,28
1,1468,47667,3578760536,3578760565,29
1,1468,47668,3578760536,3578760566,30
1,1468,47669,3578760536,3578760566,30
1,1468,47670,3578760536,3578760567,31
1,1468,47671,3578760536,3578760569,33
1,1468,47672,3578760536,3578760571,35
1,1468,47673,3578760536,3578760572,36
1,1468,47674,3578760536,3578760575,39
1,1468,47675,3578760536,3578760575,39
1,1468,47676,3578760536,3578760576,40
1,1468,47677,3578760536,3578760576,40
1,1468,47678,3578760536,3578760576,40
1,1468,47679,3578760536,3578760578,42
1,1468,47680,3578760536,3578760579,43
1,1468,47681,3578760536,3578760580,44
1,1468,47682,3578760536,3578760580,44
1,1468,47683,3578760536,3578760580,44
1,1468,47684,3578760536,3578760580,44
1,1468,47685,3578760536,3578760581,45
1,1468,47686,3578760536,3578760581,45
1,1468,47687,3578760536,3578760581,45
1,1468,47688,3578760536,3578760582,46
1,1468,47689,3578760536,3578760584,48
1,1468,47690,3578760536,3578760585,49
1,1469,47691,3578760598,3578760598,0
1,1469,47692,3578760598,3578760598,0
1,1469,47693,3578760598,3578760598,0
1,1469,47694,3578760598,3578760598,0
1,1469,47695,3578760598,3578760598,0
1,1469,47696,3578760598,3578760598,0
1,1469,47697,3578760598,3578760598,0
1,1469,47698,3578760598,3578760598,0
1,1469,47699,3578760598,3578760598,0
1,1469,47700,3578760598,3578760598,0
1,1469,47701,3578760598,3578760598,0
1,1469,47702,3578760598,3578760598,0
1,1469,47703,3578760598,3578760599,1
1,1469,47704,3578760598,3578760599,1
1,1469,47705,3578760598,3578760599,1
1,1469,47706,3578760598,3578760599,1
1,1469,47707,3578760598,3578760599,1
1,1469,47708,3578760598,3578760600,2
1,1469,47709,3578760598,3578760600,2
1,1469,47710,3578760598,3578760603,5
1,1469,47711,3578760598,3578760605,7
1,1469,47712,3578760598,3578760608,10
1,1469,47713,3578760598,3578760610,12
1,1469,47714,3578760598,3578760610,12
1,1469,47715,3578760598,3578760612,14
1,1469,47716,3578760598,3578760612,14
1,1469,47717,3578760598,3578760613,15
1,1469,47718,3578760598,3578760613,15
1,1469,47719,3578760598,3578760614,16
1,1469,47720,3578760598,3578760615,17
1,1469,47721,3578760598,3578760616,18
1,1469,47722,3578760598,3578760616,18
1,1469,47723,3578760598,3578760617,19
1,1469,47724,3578760598,3578760617,19
1,1469,47725,3578760598,3578760617,19
1,1469,47726,3578760598,3578760618,20
1,1469,47727,3578760598,3578760618,20
1,1469,47728,3578760598,3578760618,20
1,1469,47729,3578760598,3578760618,20
1,1469,47730,3578760598,3578760619,21
1,1469,47731,3578760598,3578760619,21
1,1469,47732,3578760598,3578760622,24
1,1469,47733,3578760598,3578760624,26
1,1469,47734,3578760598,3578760628,30
1,1469,47735,3578760598,3578760628,30
1,1469,47736,3578760598,3578760628,30
1,1469,47737,3578760598,3578760629,31
1,1469,47738,3578760598,3578760629,31
1,1469,47739,3578760598,3578760629,31
1,1469,47740,3578760598,3578760631,33
1,1469,47741,3578760598,3578760632,34
1,1469,47742,3578760598,3578760634,36
1,1469,47743,3578760598,3578760634,36
1,1469,47744,3578760598,3578760637,39
1,1469,47745,3578760598,3578760637,39
1,1469,47746,3578760598,3578760640,42
1,1469,47747,3578760598,3578760642,44
1,1469,47748,3578760598,3578760642,44
1,1469,47749,3578760598,3578760647,49
1,1469,47750,3578760598,3578760647,49
1,1469,47751,3578760598,3578760648,50
1,1470,47752,3578760663,3578760663,0
1,1470,47753,3578760663,3578760663,0
1,1470,47754,3578760663,3578760663,0
1,1470,47755,3578760663,3578760663,0
1,1470,47756,3578760663,3578760663,0
1,1470,47757,3578760663,3578760663,0
1,1470,47758,3578760663,3578760663,0
1,1470,47759,3578760663,3578760663,0
1,1470,47760,3578760663,3578760663,0
1,1470,47761,3578760663,3578760663,0
1,1470,47762,3578760663,3578760664,1
1,1470,47763,3578760663,3578760667,4
1,1470,47764,3578760663,3578760668,5
1,1470,47765,3578760663,3578760679,16
1,1470,47766,3578760663,3578760682,19
1,1470,47767,3578760663,3578760682,19
1,1470,47768,3578760663,3578760684,21
1,1470,47769,3578760663,3578760685,22
1,1470,47770,3578760663,3578760686,23
1,1470,47771,3578760663,3578760686,23
1,1470,47772,3578760663,3578760687,24
1,1470,47773,3578760663,3578760689,26
1,1470,47774,3578760663,3578760689,26
1,1470,47775,3578760663,3578760690,27
1,1470,47776,3578760663,3578760690,27
1,1470,47777,3578760663,3578760693,30
1,1470,47778,3578760663,3578760693,30
1,1470,47779,3578760663,3578760694,31
1,1470,47780,3578760663,3578760694,31
1,1470,47781,3578760663,3578760695,32
1,1470,47782,3578760663,3578760695,32
1,1470,47783,3578760663,3578760696,33
1,1470,47784,3578760663,3578760697,34
1,1470,47785,3578760663,3578760697,34
1,1470,47786,3578760663,3578760697,34
1,1470,47787,3578760663,3578760697,34
1,1470,47788,3578760663,3578760698,35
1,1470,47789,3578760663,3578760702,39
1,1470,47790,3578760663,3578760702,39
1,1470,47791,3578760663,3578760702,39
1,1470,47792,3578760663,3578760703,40
1,1470,47793,3578760663,3578760704,41
1,1470,47794,3578760663,3578760705,42
1,1470,47795,3578760663,3578760705,42
1,1470,47796,3578760663,3578760705,42
1,1470,47797,3578760663,3578760706,43
1,1470,47798,3578760663,3578760707,44
1,1470,47799,3578760663,3578760707,44
1,1470,47800,3578760663,3578760708,45
1,1470,47801,3578760663,3578760708,45
1,1470,47802,3578760663,3578760709,46
1,1470,47803,3578760663,3578760709,46
1,1470,47804,3578760663,3578760709,46
1,1470,47805,3578760663,3578760710,47
1,1470,47806,3578760663,3578760710,47
1,1470,47807,3578760663,3578760710,47
1,1470,47808,3578760663,3578760710,47
1,1470,47809,3578760663,3578760711,48
1,1470,47810,3578760663,3578760712,49
1,1470,47811,3578760663,3578760713,50
1,1471,47812,3578760729,3578760729,0
1,1471,47813,3578760729,3578760729,0
1,1471,47814,3578760729,3578760729,0
1,1471,47815,3578760729,3578760729,0
1,1471,47816,3578760729,3578760729,0
1,1471,47817,3578760729,3578760729,0
1,1471,47818,3578760729,3578760729,0
1,1471,47819,3578760729,3578760729,0
1,1471,47820,3578760729,3578760729,0
1,1471,47821,3578760729,3578760729,0
1,1471,47822,3578760729,3578760729,0
1,1471,47823,3578760729,3578760729,0
1,1471,47824,3578760729,3578760729,0
1,1471,47825,3578760729,3578760729,0
1,1471,47826,3578760729,3578760729,0
1,1471,47827,3578760729,3578760729,0
1,1471,47828,3578760729,3578760729,0
1,1471,47829,3578760729,3578760729,0
1,1471,47830,3578760729,3578760729,0
1,1471,47831,3578760729,3578760729,0
1,1471,47832,3578760729,3578760729,0
1,1471,47833,3578760729,3578760729,0
1,1471,47834,3578760729,3578760729,0
1,1471,47835,3578760729,3578760730,1
1,1471,47836,3578760729,3578760730,1
1,1471,47837,3578760729,3578760731,2
1,1471,47838,3578760729,3578760731,2
1,1471,47839,3578760729,3578760734,5
1,1471,47840,3578760729,3578760734,5
1,1471,47841,3578760729,3578760735,6
1,1471,47842,3578760729,3578760735,6
1,1471,47843,3578760729,3578760736,7
1,1471,47844,3578760729,3578760736,7
1,1471,47845,3578760729,3578760737,8
1,1471,47846,3578760729,3578760737,8
1,1471,47847,3578760729,3578760740,11
1,1471,47848,3578760729,3578760740,11
1,1471,47849,3578760729,3578760741,12
1,1471,47850,3578760729,3578760744,15
1,1471,47851,3578760729,3578760746,17
1,1471,47852,3578760729,3578760747,18
1,1471,47853,3578760729,3578760748,19
1,1471,47854,3578760729,3578760748,19
1,1471,47855,3578760729,3578760750,21
1,1471,47856,3578760729,3578760752,23
1,1471,47857,3578760729,3578760753,24
1,1471,47858,3578760729,3578760755,26
1,1471,47859,3578760729,3578760756,27
1,1471,47860,3578760729,3578760756,27
1,1471,47861,3578760729,3578760757,28
1,1471,47862,3578760729,3578760759,30
1,1471,47863,3578760729,3578760761,32
1,1471,47864,3578760729,3578760762,33
1,1471,47865,3578760729,3578760762,33
1,1471,47866,3578760729,3578760763,34
1,1471,47867,3578760729,3578760764,35
1,1471,47868,3578760729,3578760764,35
1,1471,47869,3578760729,3578760765,36
1,1471,47870,3578760729,3578760766,37
1,1471,47871,3578760729,3578760767,38
1,1471,47872,3578760729,3578760768,39
1,1471,47873,3578760729,3578760768,39
1,1471,47874,3578760729,3578760769,40
1,1471,47875,3578760729,3578760771,42
1,1471,47876,3578760729,3578760772,43
1,1471,47877,3578760729,3578760776,47
1,1471,47878,3578760729,3578760776,47
1,1471,47879,3578760729,3578760777,48
1,1471,47880,3578760729,3578760777,48
1,1471,47881,3578760729,3578760777,48
1,1471,47882,3578760729,3578760778,49
1,1471,47883,3578760729,3578760779,50
1,1472,47884,3578760792,3578760792,0
1,1472,47885,3578760792,3578760792,0
1,1472,47886,3578760792,3578760792,0
1,1472,47887,3578760792,3578760792,0
1,1472,47888,3578760792,3578760792,0
1,1472,47889,3578760792,3578760792,0
1,1472,47890,3578760792,3578760792,0
1,1472,47891,3578760792,3578760792,0
1,1472,47892,3578760792,3578760792,0
1,1472,47893,3578760792,3578760792,0
1,1472,47894,3578760792,3578760792,0
1,1472,47895,3578760792,3578760792,0
1,1472,47896,3578760792,3578760792,0
1,1472,47897,3578760792,3578760793,1
1,1472,47898,3578760792,3578760793,1
1,1472,47899,3578760792,3578760795,3
1,1472,47900,3578760792,3578760795,3
1,1472,47901,3578760792,3578760796,4
1,1472,47902,3578760792,3578760796,4
1,1472,47903,3578760792,3578760796,4
1,1472,47904,3578760792,3578760797,5
1,1472,47905,3578760792,3578760797,5
1,1472,47906,3578760792,3578760798,6
1,1472,47907,3578760792,3578760799,7
1,1472,47908,3578760792,3578760800,8
1,1472,47909,3578760792,3578760800,8
1,1472,47910,3578760792,3578760802,10
1,1472,47911,3578760792,3578760803,11
1,1472,47912,3578760792,3578760806,14
1,1472,47913,3578760792,3578760807,15
1,1472,47914,3578760792,3578760808,16
1,1472,47915,3578760792,3578760810,18
1,1472,47916,3578760792,3578760810,18
1,1472,47917,3578760792,3578760812,20
1,1472,47918,3578760792,3578760813,21
1,1472,47919,3578760792,3578760813,21
1,1472,47920,3578760792,3578760813,21
1,1472,47921,3578760792,3578760814,22
1,1472,47922,3578760792,3578760815,23
1,1472,47923,3578760792,3578760816,24
1,1472,47924,3578760792,3578760816,24
1,1472,47925,3578760792,3578760817,25
1,1472,47926,3578760792,3578760817,25
1,1472,47927,3578760792,3578760817,25
1,1472,47928,3578760792,3578760818,26
1,1472,47929,3578760792,3578760818,26
1,1472,47930,3578760792,3578760818,26
1,1472,47931,3578760792,3578760818,26
1,1472,47932,3578760792,3578760818,26
1,1472,47933,3578760792,3578760819,27
1,1472,47934,3578760792,3578760819,27
1,1472,47935,3578760792,3578760822,30
1,1472,47936,3578760792,3578760824,32
1,1472,47937,3578760792,3578760828,36
1,1472,47938,3578760792,3578760828,36
1,1472,47939,3578760792,3578760829,37
1,1472,47940,3578760792,3578760829,37
1,1472,47941,3578760792,3578760829,37
1,1472,47942,3578760792,3578760830,38
1,1472,47943,3578760792,3578760830,38
1,1472,47944,3578760792,3578760832,40
1,1472,47945,3578760792,3578760834,42
1,1472,47946,3578760792,3578760835,43
1,1472,47947,3578760792,3578760836,44
1,1472,47948,3578760792,3578760837,45
1,1472,47949,3578760792,3578760840,48
1,1473,47950,3578760855,3578760855,0
1,1473,47951,3578760855,3578760855,0
1,1473,47952,3578760855,3578760855,0
1,1473,47953,3578760855,3578760855,0
1,1473,47954,3578760855,3578760855,0
1,1473,47955,3578760855,3578760855,0
1,1473,47956,3578760855,3578760855,0
1,1473,47957,3578760855,3578760855,0
1,1473,47958,3578760855,3578760855,0
1,1473,47959,3578760855,3578760855,0
1,1473,47960,3578760855,3578760856,1
1,1473,47961,3578760855,3578760856,1
1,1473,47962,3578760855,3578760859,4
1,1473,47963,3578760855,3578760860,5
1,1473,47964,3578760855,3578760862,7
1,1473,47965,3578760855,3578760863,8
1,1473,47966,3578760855,3578760864,9
1,1473,47967,3578760855,3578760867,12
1,1473,47968,3578760855,3578760869,14
1,1473,47969,3578760855,3578760880,25
1,1473,47970,3578760855,3578760881,26
1,1473,47971,3578760855,3578760882,27
1,1473,47972,3578760855,3578760882,27
1,1473,47973,3578760855,3578760884,29
1,1473,47974,3578760855,3578760885,30
1,1473,47975,3578760855,3578760885,30
1,1473,47976,3578760855,3578760886,31
1,1473,47977,3578760855,3578760887,32
1,1473,47978,3578760855,3578760889,34
1,1473,47979,3578760855,3578760889,34
1,1473,47980,3578760855,3578760891,36
1,1473,47981,3578760855,3578760891,36
1,1473,47982,3578760855,3578760893,38
1,1473,47983,3578760855,3578760893,38
1,1473,47984,3578760855,3578760894,39
1,1473,47985,3578760855,3578760894,39
1,1473,47986,3578760855,3578760895,40
1,1473,47987,3578760855,3578760896,41
1,1473,47988,3578760855,3578760896,41
1,1473,47989,3578760855,3578760896,41
1,1473,47990,3578760855,3578760897,42
1,1473,47991,3578760855,3578760897,42
1,1473,47992,3578760855,3578760897,42
1,1473,47993,3578760855,3578760897,42
1,1473,47994,3578760855,3578760898,43
1,1473,47995,3578760855,3578760902,47
1,1473,47996,3578760855,3578760902,47
1,1473,47997,3578760855,3578760903,48
1,1473,47998,3578760855,3578760903,48
1,1473,47999,3578760855,3578760904,49
1,1473,48000,3578760855,3578760904,49
1,1473,48001,3578760855,3578760904,49
1,1473,48002,3578760855,3578760905,50
1,1474,48003,3578760919,3578760919,0
1,1474,48004,3578760919,3578760919,0
1,1474,48005,3578760919,3578760919,0
1,1474,48006,3578760919,3578760919,0
1,1474,48007,3578760919,3578760919,0
1,1474,48008,3578760919,3578760919,0
1,1474,48009,3578760919,3578760919,0
1,1474,48010,3578760919,3578760919,0
1,1474,48011,3578760919,3578760919,0
1,1474,48012,3578760919,3578760919,0
1,1474,48013,3578760919,3578760919,0
1,1474,48014,3578760919,3578760919,0
1,1474,48015,3578760919,3578760919,0
1,1474,48016,3578760919,3578760919,0
1,1474,48017,3578760919,3578760919,0
1,1474,48018,3578760919,3578760919,0
1,1474,48019,3578760919,3578760919,0
1,1474,48020,3578760919,3578760919,0
1,1474,48021,3578760919,3578760919,0
1,1474,48022,3578760919,3578760919,0
1,1474,48023,3578760919,3578760919,0
1,1474,48024,3578760919,3578760919,0
1,1474,48025,3578760919,3578760919,0
1,1474,48026,3578760919,3578760919,0
1,1474,48027,3578760919,3578760920,1
1,1474,48028,3578760919,3578760921,2
1,1474,48029,3578760919,3578760922,3
1,1474,48030,3578760919,3578760922,3
1,1474,48031,3578760919,3578760922,3
1,1474,48032,3578760919,3578760924,5
1,1474,48033,3578760919,3578760924,5
1,1474,48034,3578760919,3578760924,5
1,1474,48035,3578760919,3578760926,7
1,1474,48036,3578760919,3578760927,8
1,1474,48037,3578760919,3578760927,8
1,1474,48038,3578760919,3578760927,8
1,1474,48039,3578760919,3578760930,11
1,1474,48040,3578760919,3578760930,11
1,1474,48041,3578760919,3578760931,12
1,1474,48042,3578760919,3578760931,12
1,1474,48043,3578760919,3578760932,13
1,1474,48044,3578760919,3578760933,14
1,1474,48045,3578760919,3578760934,15
1,1474,48046,3578760919,3578760935,16
1,1474,48047,3578760919,3578760935,16
1,1474,48048,3578760919,3578760935,16
1,1474,48049,3578760919,3578760936,17
1,1474,48050,3578760919,3578760936,17
1,1474,48051,3578760919,3578760937,18
1,1474,48052,3578760919,3578760937,18
1,1474,48053,3578760919,3578760940,21
1,1474,48054,3578760919,3578760940,21
1,1474,48055,3578760919,3578760941,22
1,1474,48056,3578760919,3578760945,26
1,1474,48057,3578760919,3578760946,27
1,1474,48058,3578760919,3578760947,28
1,1474,48059,3578760919,3578760948,29
1,1474,48060,3578760919,3578760948,29
1,1474,48061,3578760919,3578760950,31
1,1474,48062,3578760919,3578760952,33
1,1474,48063,3578760919,3578760953,34
1,1474,48064,3578760919,3578760955,36
1,1474,48065,3578760919,3578760956,37
1,1474,48066,3578760919,3578760956,37
1,1474,48067,3578760919,3578760958,39
1,1474,48068,3578760919,3578760959,40
1,1474,48069,3578760919,3578760962,43
1,1474,48070,3578760919,3578760963,44
1,1474,48071,3578760919,3578760963,44
1,1474,48072,3578760919,3578760963,44
1,1474,48073,3578760919,3578760964,45
1,1474,48074,3578760919,3578760965,46
1,1474,48075,3578760919,3578760965,46
1,1474,48076,3578760919,3578760966,47
1,1474,48077,3578760919,3578760967,48
1,1474,48078,3578760919,3578760969,50
1,1475,48079,3578760982,3578760982,0
1,1475,48080,3578760982,3578760982,0
1,1475,48081,3578760982,3578760982,0
1,1475,48082,3578760982,3578760982,0
1,1475,48083,3578760982,3578760982,0
1,1475,48084,3578760982,3578760982,0
1,1475,48085,3578760982,3578760982,0
1,1475,48086,3578760982,3578760982,0
1,1475,48087,3578760982,3578760982,0
1,1475,48088,3578760982,3578760982,0
1,1475,48089,3578760982,3578760982,0
1,1475,48090,3578760982,3578760982,0
1,1475,48091,3578760982,3578760982,0
1,1475,48092,3578760982,3578760982,0
1,1475,48093,3578760982,3578760982,0
1,1475,48094,3578760982,3578760982,0
1,1475,48095,3578760982,3578760982,0
1,1475,48096,3578760982,3578760982,0
1,1475,48097,3578760982,3578760982,0
1,1475,48098,3578760982,3578760983,1
1,1475,48099,3578760982,3578760986,4
1,1475,48100,3578760982,3578760988,6
1,1475,48101,3578760982,3578760991,9
1,1475,48102,3578760982,3578760991,9
1,1475,48103,3578760982,3578760992,10
1,1475,48104,3578760982,3578760993,11
1,1475,48105,3578760982,3578760993,11
1,1475,48106,3578760982,3578760994,12
1,1475,48107,3578760982,3578760994,12
1,1475,48108,3578760982,3578760995,13
1,1475,48109,3578760982,3578760995,13
1,1475,48110,3578760982,3578760996,14
1,1475,48111,3578760982,3578760996,14
1,1475,48112,3578760982,3578760996,14
1,1475,48113,3578760982,3578760997,15
1,1475,48114,3578760982,3578760997,15
1,1475,48115,3578760982,3578760999,17
1,1475,48116,3578760982,3578760999,17
1,1475,48117,3578760982,3578760999,17
1,1475,48118,3578760982,3578761001,19
1,1475,48119,3578760982,3578761002,20
1,1475,48120,3578760982,3578761006,24
1,1475,48121,3578760982,3578761007,25
1,1475,48122,3578760982,3578761008,26
1,1475,48123,3578760982,3578761011,29
1,1475,48124,3578760982,3578761012,30
1,1475,48125,3578760982,3578761013,31
1,1475,48126,3578760982,3578761013,31
1,1475,48127,3578760982,3578761013,31
1,1475,48128,3578760982,3578761013,31
1,1475,48129,3578760982,3578761016,34
1,1475,48130,3578760982,3578761016,34
1,1475,48131,3578760982,3578761017,35
1,1475,48132,3578760982,3578761017,35
1,1475,48133,3578760982,3578761017,35
1,1475,48134,3578760982,3578761017,35
1,1475,48135,3578760982,3578761018,36
1,1475,48136,3578760982,3578761018,36
1,1475,48137,3578760982,3578761018,36
1,1475,48138,3578760982,3578761018,36
1,1475,48139,3578760982,3578761019,37
1,1475,48140,3578760982,3578761019,37
1,1475,48141,3578760982,3578761020,38
1,1475,48142,3578760982,3578761022,40
1,1475,48143,3578760982,3578761024,42
1,1475,48144,3578760982,3578761026,44
1,1475,48145,3578760982,3578761027,45
1,1475,48146,3578760982,3578761027,45
1,1475,48147,3578760982,3578761028,46
1,1475,48148,3578760982,3578761028,46
1,1475,48149,3578760982,3578761028,46
1,1475,48150,3578760982,3578761029,47
1,1475,48151,3578760982,3578761030,48
1,1475,48152,3578760982,3578761031,49
1,1475,48153,3578760982,3578761032,50
1,1476,48154,3578761046,3578761046,0
1,1476,48155,3578761046,3578761046,0
1,1476,48156,3578761046,3578761046,0
1,1476,48157,3578761046,3578761046,0
1,1476,48158,3578761046,3578761046,0
1,1476,48159,3578761046,3578761046,0
1,1476,48160,3578761046,3578761046,0
1,1476,48161,3578761046,3578761046,0
1,1476,48162,3578761046,3578761047,1
1,1476,48163,3578761046,3578761048,2
1,1476,48164,3578761046,3578761049,3
1,1476,48165,3578761046,3578761049,3
1,1476,48166,3578761046,3578761050,4
1,1476,48167,3578761046,3578761052,6
1,1476,48168,3578761046,3578761053,7
1,1476,48169,3578761046,3578761055,9
1,1476,48170,3578761046,3578761056,10
1,1476,48171,3578761046,3578761057,11
1,1476,48172,3578761046,3578761057,11
1,1476,48173,3578761046,3578761059,13
1,1476,48174,3578761046,3578761061,15
1,1476,48175,3578761046,3578761062,16
1,1476,48176,3578761046,3578761063,17
1,1476,48177,3578761046,3578761065,19
1,1476,48178,3578761046,3578761066,20
1,1476,48179,3578761046,3578761068,22
1,1476,48180,3578761046,3578761069,23
1,1476,48181,3578761046,3578761080,34
1,1476,48182,3578761046,3578761081,35
1,1476,48183,3578761046,3578761081,35
1,1476,48184,3578761046,3578761082,36
1,1476,48185,3578761046,3578761085,39
1,1476,48186,3578761046,3578761085,39
1,1476,48187,3578761046,3578761086,40
1,1476,48188,3578761046,3578761086,40
1,1476,48189,3578761046,3578761089,43
1,1476,48190,3578761046,3578761089,43
1,1476,48191,3578761046,3578761090,44
1,1476,48192,3578761046,3578761091,45
1,1476,48193,3578761046,3578761093,47
1,1476,48194,3578761046,3578761094,48
1,1476,48195,3578761046,3578761094,48
1,1476,48196,3578761046,3578761094,48
1,1476,48197,3578761046,3578761096,50
1,1477,48198,3578761111,3578761111,0
1,1477,48199,3578761111,3578761111,0
1,1477,48200,3578761111,3578761111,0
1,1477,48201,3578761111,3578761111,0
1,1477,48202,3578761111,3578761111,0
1,1477,48203,3578761111,3578761111,0
1,1477,48204,3578761111,3578761111,0
1,1477,48205,3578761111,3578761111,0
1,1477,48206,3578761111,3578761111,0
1,1477,48207,3578761111,3578761111,0
1,1477,48208,3578761111,3578761111,0
1,1477,48209,3578761111,3578761111,0
1,1477,48210,3578761111,3578761111,0
1,1477,48211,3578761111,3578761111,0
1,1477,48212,3578761111,3578761111,0
1,1477,48213,3578761111,3578761111,0
1,1477,48214,3578761111,3578761111,0
1,1477,48215,3578761111,3578761111,0
1,1477,48216,3578761111,3578761111,0
1,1477,48217,3578761111,3578761111,0
1,1477,48218,3578761111,3578761111,0
1,1477,48219,3578761111,3578761111,0
1,1477,48220,3578761111,3578761111,0
1,1477,48221,3578761111,3578761111,0
1,1477,48222,3578761111,3578761111,0
1,1477,48223,3578761111,3578761111,0
1,1477,48224,3578761111,3578761112,1
1,1477,48225,3578761111,3578761112,1
1,1477,48226,3578761111,3578761113,2
1,1477,48227,3578761111,3578761113,2
1,1477,48228,3578761111,3578761114,3
1,1477,48229,3578761111,3578761114,3
1,1477,48230,3578761111,3578761115,4
1,1477,48231,3578761111,3578761116,5
1,1477,48232,3578761111,3578761117,6
1,1477,48233,3578761111,3578761118,7
1,1477,48234,3578761111,3578761118,7
1,1477,48235,3578761111,3578761119,8
1,1477,48236,3578761111,3578761121,10
1,1477,48237,3578761111,3578761121,10
1,1477,48238,3578761111,3578761122,11
1,1477,48239,3578761111,3578761122,11
1,1477,48240,3578761111,3578761122,11
1,1477,48241,3578761111,3578761122,11
1,1477,48242,3578761111,3578761124,13
1,1477,48243,3578761111,3578761125,14
1,1477,48244,3578761111,3578761126,15
1,1477,48245,3578761111,3578761126,15
1,1477,48246,3578761111,3578761127,16
1,1477,48247,3578761111,3578761127,16
1,1477,48248,3578761111,3578761128,17
1,1477,48249,3578761111,3578761130,19
1,1477,48250,3578761111,3578761130,19
1,1477,48251,3578761111,3578761131,20
1,1477,48252,3578761111,3578761131,20
1,1477,48253,3578761111,3578761132,21
1,1477,48254,3578761111,3578761133,22
1,1477,48255,3578761111,3578761135,24
1,1477,48256,3578761111,3578761135,24
1,1477,48257,3578761111,3578761136,25
1,1477,48258,3578761111,3578761136,25
1,1477,48259,3578761111,3578761136,25
1,1477,48260,3578761111,3578761137,26
1,1477,48261,3578761111,3578761137,26
1,1477,48262,3578761111,3578761137,26
1,1477,48263,3578761111,3578761140,29
1,1477,48264,3578761111,3578761141,30
1,1477,48265,3578761111,3578761145,34
1,1477,48266,3578761111,3578761146,35
1,1477,48267,3578761111,3578761146,35
1,1477,48268,3578761111,3578761148,37
1,1477,48269,3578761111,3578761148,37
1,1477,48270,3578761111,3578761151,40
1,1477,48271,3578761111,3578761153,42
1,1477,48272,3578761111,3578761153,42
1,1477,48273,3578761111,3578761155,44
1,1477,48274,3578761111,3578761155,44
1,1477,48275,3578761111,3578761156,45
1,1477,48276,3578761111,3578761157,46
1,1477,48277,3578761111,3578761159,48
1,1478,48278,3578761176,3578761176,0
1,1478,48279,3578761176,3578761176,0
1,1478,48280,3578761176,3578761176,0
1,1478,48281,3578761176,3578761176,0
1,1478,48282,3578761176,3578761176,0
1,1478,48283,3578761176,3578761176,0
1,1478,48284,3578761176,3578761176,0
1,1478,48285,3578761176,3578761176,0
1,1478,48286,3578761176,3578761176,0
1,1478,48287,3578761176,3578761176,0
1,1478,48288,3578761176,3578761176,0
1,1478,48289,3578761176,3578761176,0
1,1478,48290,3578761176,3578761176,0
1,1478,48291,3578761176,3578761176,0
1,1478,48292,3578761176,3578761176,0
1,1478,48293,3578761176,3578761176,0
1,1478,48294,3578761176,3578761176,0
1,1478,48295,3578761176,3578761177,1
1,1478,48296,3578761176,3578761178,2
1,1478,48297,3578761176,3578761178,2
1,1478,48298,3578761176,3578761180,4
1,1478,48299,3578761176,3578761180,4
1,1478,48300,3578761176,3578761180,4
1,1478,48301,3578761176,3578761181,5
1,1478,48302,3578761176,3578761181,5
1,1478,48303,3578761176,3578761181,5
1,1478,48304,3578761176,3578761182,6
1,1478,48305,3578761176,3578761183,7
1,1478,48306,3578761176,3578761186,10
1,1478,48307,3578761176,3578761188,12
1,1478,48308,3578761176,3578761190,14
1,1478,48309,3578761176,3578761190,14
1,1478,48310,3578761176,3578761191,15
1,1478,48311,3578761176,3578761193,17
1,1478,48312,3578761176,3578761193,17
1,1478,48313,3578761176,3578761194,18
1,1478,48314,3578761176,3578761194,18
1,1478,48315,3578761176,3578761195,19
1,1478,48316,3578761176,3578761196,20
1,1478,48317,3578761176,3578761196,20
1,1478,48318,3578761176,3578761196,20
1,1478,48319,3578761176,3578761196,20
1,1478,48320,3578761176,3578761196,20
1,1478,48321,3578761176,3578761197,21
1,1478,48322,3578761176,3578761199,23
1,1478,48323,3578761176,3578761199,23
1,1478,48324,3578761176,3578761200,24
1,1478,48325,3578761176,3578761200,24
1,1478,48326,3578761176,3578761202,26
1,1478,48327,3578761176,3578761205,29
1,1478,48328,3578761176,3578761207,31
1,1478,48329,3578761176,3578761209,33
1,1478,48330,3578761176,3578761210,34
1,1478,48331,3578761176,3578761212,36
1,1478,48332,3578761176,3578761213,37
1,1478,48333,3578761176,3578761213,37
1,1478,48334,3578761176,3578761213,37
1,1478,48335,3578761176,3578761215,39
1,1478,48336,3578761176,3578761215,39
1,1478,48337,3578761176,3578761216,40
1,1478,48338,3578761176,3578761217,41
1,1478,48339,3578761176,3578761217,41
1,1478,48340,3578761176,3578761217,41
1,1478,48341,3578761176,3578761217,41
1,1478,48342,3578761176,3578761218,42
1,1478,48343,3578761176,3578761218,42
1,1478,48344,3578761176,3578761218,42
1,1478,48345,3578761176,3578761219,43
1,1478,48346,3578761176,3578761219,43
1,1478,48347,3578761176,3578761219,43
1,1478,48348,3578761176,3578761219,43
1,1478,48349,3578761176,3578761220,44
1,1478,48350,3578761176,3578761223,47
1,1478,48351,3578761176,3578761224,48
1,1479,48352,3578761240,3578761240,0
1,1479,48353,3578761240,3578761240,0
1,1479,48354,3578761240,3578761240,0
1,1479,48355,3578761240,3578761240,0
1,1479,48356,3578761240,3578761240,0
1,1479,48357,3578761240,3578761240,0
1,1479,48358,3578761240,3578761240,0
1,1479,48359,3578761240,3578761240,0
1,1479,48360,3578761240,3578761240,0
1,1479,48361,3578761240,3578761240,0
1,1479,48362,3578761240,3578761240,0
1,1479,48363,3578761240,3578761240,0
1,1479,48364,3578761240,3578761240,0
1,1479,48365,3578761240,3578761240,0
1,1479,48366,3578761240,3578761240,0
1,1479,48367,3578761240,3578761240,0
1,1479,48368,3578761240,3578761240,0
1,1479,48369,3578761240,3578761243,3
1,1479,48370,3578761240,3578761243,3
1,1479,48371,3578761240,3578761247,7
1,1479,48372,3578761240,3578761248,8
1,1479,48373,3578761240,3578761248,8
1,1479,48374,3578761240,3578761249,9
1,1479,48375,3578761240,3578761250,10
1,1479,48376,3578761240,3578761252,12
1,1479,48377,3578761240,3578761253,13
1,1479,48378,3578761240,3578761254,14
1,1479,48379,3578761240,3578761254,14
1,1479,48380,3578761240,3578761254,14
1,1479,48381,3578761240,3578761257,17
1,1479,48382,3578761240,3578761257,17
1,1479,48383,3578761240,3578761258,18
1,1479,48384,3578761240,3578761260,20
1,1479,48385,3578761240,3578761262,22
1,1479,48386,3578761240,3578761263,23
1,1479,48387,3578761240,3578761263,23
1,1479,48388,3578761240,3578761265,25
1,1479,48389,3578761240,3578761267,27
1,1479,48390,3578761240,3578761268,28
1,1479,48391,3578761240,3578761269,29
1,1479,48392,3578761240,3578761269,29
1,1479,48393,3578761240,3578761280,40
1,1479,48394,3578761240,3578761280,40
1,1479,48395,3578761240,3578761281,41
1,1479,48396,3578761240,3578761281,41
1,1479,48397,3578761240,3578761284,44
1,1479,48398,3578761240,3578761284,44
1,1479,48399,3578761240,3578761285,45
1,1479,48400,3578761240,3578761286,46
1,1479,48401,3578761240,3578761289,49
1,1479,48402,3578761240,3578761289,49
1,1480,48403,3578761303,3578761303,0
1,1480,48404,3578761303,3578761303,0
1,1480,48405,3578761303,3578761303,0
1,1480,48406,3578761303,3578761303,0
1,1480,48407,3578761303,3578761303,0
1,1480,48408,3578761303,3578761303,0
1,1480,48409,3578761303,3578761303,0
1,1480,48410,3578761303,3578761303,0
1,1480,48411,3578761303,3578761303,0
1,1480,48412,3578761303,3578761303,0
1,1480,48413,3578761303,3578761303,0
1,1480,48414,3578761303,3578761303,0
1,1480,48415,3578761303,3578761303,0
1,1480,48416,3578761303,3578761303,0
1,1480,48417,3578761303,3578761303,0
1,1480,48418,3578761303,3578761303,0
1,1480,48419,3578761303,3578761303,0
1,1480,48420,3578761303,3578761303,0
1,1480,48421,3578761303,3578761305,2
1,1480,48422,3578761303,3578761305,2
1,1480,48423,3578761303,3578761305,2
1,1480,48424,3578761303,3578761305,2
1,1480,48425,3578761303,3578761307,4
1,1480,48426,3578761303,3578761307,4
1,1480,48427,3578761303,3578761308,5
1,1480,48428,3578761303,3578761308,5
1,1480,48429,3578761303,3578761309,6
1,1480,48430,3578761303,3578761309,6
1,1480,48431,3578761303,3578761310,7
1,1480,48432,3578761303,3578761310,7
1,1480,48433,3578761303,3578761310,7
1,1480,48434,3578761303,3578761310,7
1,1480,48435,3578761303,3578761311,8
1,1480,48436,3578761303,3578761312,9
1,1480,48437,3578761303,3578761313,10
1,1480,48438,3578761303,3578761313,10
1,1480,48439,3578761303,3578761313,10
1,1480,48440,3578761303,3578761314,11
1,1480,48441,3578761303,3578761315,12
1,1480,48442,3578761303,3578761315,12
1,1480,48443,3578761303,3578761315,12
1,1480,48444,3578761303,3578761318,15
1,1480,48445,3578761303,3578761319,16
1,1480,48446,3578761303,3578761319,16
1,1480,48447,3578761303,3578761321,18
1,1480,48448,3578761303,3578761322,19
1,1480,48449,3578761303,3578761322,19
1,1480,48450,3578761303,3578761323,20
1,1480,48451,3578761303,3578761324,21
1,1480,48452,3578761303,3578761325,22
1,1480,48453,3578761303,3578761327,24
1,1480,48454,3578761303,3578761327,24
1,1480,48455,3578761303,3578761327,24
1,1480,48456,3578761303,3578761327,24
1,1480,48457,3578761303,3578761328,25
1,1480,48458,3578761303,3578761329,26
1,1480,48459,3578761303,3578761330,27
1,1480,48460,3578761303,3578761331,28
1,1480,48461,3578761303,3578761331,28
1,1480,48462,3578761303,3578761331,28
1,1480,48463,3578761303,3578761333,30
1,1480,48464,3578761303,3578761334,31
1,1480,48465,3578761303,3578761334,31
1,1480,48466,3578761303,3578761335,32
1,1480,48467,3578761303,3578761336,33
1,1480,48468,3578761303,3578761336,33
1,1480,48469,3578761303,3578761337,34
1,1480,48470,3578761303,3578761338,35
1,1480,48471,3578761303,3578761338,35
1,1480,48472,3578761303,3578761341,38
1,1480,48473,3578761303,3578761341,38
1,1480,48474,3578761303,3578761341,38
1,1480,48475,3578761303,3578761345,42
1,1480,48476,3578761303,3578761346,43
1,1480,48477,3578761303,3578761347,44
1,1480,48478,3578761303,3578761348,45
1,1480,48479,3578761303,3578761352,49
1,1481,48480,3578761368,3578761368,0
1,1481,48481,3578761368,3578761368,0
1,1481,48482,3578761368,3578761368,0
1,1481,48483,3578761368,3578761368,0
1,1481,48484,3578761368,3578761368,0
1,1481,48485,3578761368,3578761368,0
1,1481,48486,3578761368,3578761368,0
1,1481,48487,3578761368,3578761368,0
1,1481,48488,3578761368,3578761368,0
1,1481,48489,3578761368,3578761368,0
1,1481,48490,3578761368,3578761368,0
1,1481,48491,3578761368,3578761368,0
1,1481,48492,3578761368,3578761368,0
1,1481,48493,3578761368,3578761368,0
1,1481,48494,3578761368,3578761368,0
1,1481,48495,3578761368,3578761368,0
1,1481,48496,3578761368,3578761368,0
1,1481,48497,3578761368,3578761369,1
1,1481,48498,3578761368,3578761369,1
1,1481,48499,3578761368,3578761370,2
1,1481,48500,3578761368,3578761371,3
1,1481,48501,3578761368,3578761372,4
1,1481,48502,3578761368,3578761375,7
1,1481,48503,3578761368,3578761375,7
1,1481,48504,3578761368,3578761376,8
1,1481,48505,3578761368,3578761378,10
1,1481,48506,3578761368,3578761379,11
1,1481,48507,3578761368,3578761379,11
1,1481,48508,3578761368,3578761380,12
1,1481,48509,3578761368,3578761381,13
1,1481,48510,3578761368,3578761381,13
1,1481,48511,3578761368,3578761381,13
1,1481,48512,3578761368,3578761382,14
1,1481,48513,3578761368,3578761382,14
1,1481,48514,3578761368,3578761382,14
1,1481,48515,3578761368,3578761383,15
1,1481,48516,3578761368,3578761386,18
1,1481,48517,3578761368,3578761387,19
1,1481,48518,3578761368,3578761388,20
1,1481,48519,3578761368,3578761391,23
1,1481,48520,3578761368,3578761392,24
1,1481,48521,3578761368,3578761392,24
1,1481,48522,3578761368,3578761392,24
1,1481,48523,3578761368,3578761393,25
1,1481,48524,3578761368,3578761394,26
1,1481,48525,3578761368,3578761395,27
1,1481,48526,3578761368,3578761395,27
1,1481,48527,3578761368,3578761396,28
1,1481,48528,3578761368,3578761396,28
1,1481,48529,3578761368,3578761396,28
1,1481,48530,3578761368,3578761397,29
1,1481,48531,3578761368,3578761397,29
1,1481,48532,3578761368,3578761399,31
1,1481,48533,3578761368,3578761399,31
1,1481,48534,3578761368,3578761400,32
1,1481,48535,3578761368,3578761401,33
1,1481,48536,3578761368,3578761402,34
1,1481,48537,3578761368,3578761406,38
1,1481,48538,3578761368,3578761407,39
1,1481,48539,3578761368,3578761408,40
1,1481,48540,3578761368,3578761410,42
1,1481,48541,3578761368,3578761411,43
1,1481,48542,3578761368,3578761412,44
1,1481,48543,3578761368,3578761413,45
1,1481,48544,3578761368,3578761414,46
1,1481,48545,3578761368,3578761414,46
1,1481,48546,3578761368,3578761415,47
1,1481,48547,3578761368,3578761417,49
1,1481,48548,3578761368,3578761417,49
1,1481,48549,3578761368,3578761417,49
1,1481,48550,3578761368,3578761417,49
1,1481,48551,3578761368,3578761418,50
1,1482,48552,3578761432,3578761432,0
1,1482,48553,3578761432,3578761432,0
1,1482,48554,3578761432,3578761433,1
1,1482,48555,3578761432,3578761433,1
1,1482,48556,3578761432,3578761433,1
1,1482,48557,3578761432,3578761433,1
1,1482,48558,3578761432,3578761433,1
1,1482,48559,3578761432,3578761433,1
1,1482,48560,3578761432,3578761433,1
1,1482,48561,3578761432,3578761433,1
1,1482,48562,3578761432,3578761433,1
1,1482,48563,3578761432,3578761433,1
1,1482,48564,3578761432,3578761433,1
1,1482,48565,3578761432,3578761433,1
1,1482,48566,3578761432,3578761433,1
1,1482,48567,3578761432,3578761433,1
1,1482,48568,3578761432,3578761433,1
1,1482,48569,3578761432,3578761433,1
1,1482,48570,3578761432,3578761433,1
1,1482,48571,3578761432,3578761433,1
1,1482,48572,3578761432,3578761433,1
1,1482,48573,3578761432,3578761435,3
1,1482,48574,3578761432,3578761437,5
1,1482,48575,3578761432,3578761437,5
1,1482,48576,3578761432,3578761437,5
1,1482,48577,3578761432,3578761438,6
1,1482,48578,3578761432,3578761440,8
1,1482,48579,3578761432,3578761442,10
1,1482,48580,3578761432,3578761443,11
1,1482,48581,3578761432,3578761447,15
1,1482,48582,3578761432,3578761448,16
1,1482,48583,3578761432,3578761449,17
1,1482,48584,3578761432,3578761449,17
1,1482,48585,3578761432,3578761452,20
1,1482,48586,3578761432,3578761453,21
1,1482,48587,3578761432,3578761454,22
1,1482,48588,3578761432,3578761455,23
1,1482,48589,3578761432,3578761457,25
1,1482,48590,3578761432,3578761457,25
1,1482,48591,3578761432,3578761457,25
1,1482,48592,3578761432,3578761459,27
1,1482,48593,3578761432,3578761460,28
1,1482,48594,3578761432,3578761462,30
1,1482,48595,3578761432,3578761462,30
1,1482,48596,3578761432,3578761463,31
1,1482,48597,3578761432,3578761465,33
1,1482,48598,3578761432,3578761468,36
1,1482,48599,3578761432,3578761469,37
1,1482,48600,3578761432,3578761469,37
1,1482,48601,3578761432,3578761469,37
1,1482,48602,3578761432,3578761480,48
1,1482,48603,3578761432,3578761480,48
1,1482,48604,3578761432,3578761481,49
1,1482,48605,3578761432,3578761481,49
1,1483,48606,3578761496,3578761496,0
1,1483,48607,3578761496,3578761496,0
1,1483,48608,3578761496,3578761496,0
1,1483,48609,3578761496,3578761496,0
1,1483,48610,3578761496,3578761496,0
1,1483,48611,3578761496,3578761496,0
1,1483,48612,3578761496,3578761496,0
1,1483,48613,3578761496,3578761496,0
1,1483,48614,3578761496,3578761496,0
1,1483,48615,3578761496,3578761496,0
1,1483,48616,3578761496,3578761496,0
1,1483,48617,3578761496,3578761496,0
1,1483,48618,3578761496,3578761496,0
1,1483,48619,3578761496,3578761496,0
1,1483,48620,3578761496,3578761496,0
1,1483,48621,3578761496,3578761496,0
1,1483,48622,3578761496,3578761496,0
1,1483,48623,3578761496,3578761496,0
1,1483,48624,3578761496,3578761496,0
1,1483,48625,3578761496,3578761496,0
1,1483,48626,3578761496,3578761497,1
1,1483,48627,3578761496,3578761497,1
1,1483,48628,3578761496,3578761501,5
1,1483,48629,3578761496,3578761502,6
1,1483,48630,3578761496,3578761502,6
1,1483,48631,3578761496,3578761502,6
1,1483,48632,3578761496,3578761503,7
1,1483,48633,3578761496,3578761504,8
1,1483,48634,3578761496,3578761504,8
1,1483,48635,3578761496,3578761504,8
1,1483,48636,3578761496,3578761505,9
1,1483,48637,3578761496,3578761505,9
1,1483,48638,3578761496,3578761506,10
1,1483,48639,3578761496,3578761507,11
1,1483,48640,3578761496,3578761507,11
1,1483,48641,3578761496,3578761508,12
1,1483,48642,3578761496,3578761508,12
1,1483,48643,3578761496,3578761508,12
1,1483,48644,3578761496,3578761508,12
1,1483,48645,3578761496,3578761509,13
1,1483,48646,3578761496,3578761509,13
1,1483,48647,3578761496,3578761510,14
1,1483,48648,3578761496,3578761511,15
1,1483,48649,3578761496,3578761512,16
1,1483,48650,3578761496,3578761513,17
1,1483,48651,3578761496,3578761513,17
1,1483,48652,3578761496,3578761513,17
1,1483,48653,3578761496,3578761514,18
1,1483,48654,3578761496,3578761515,19
1,1483,48655,3578761496,3578761516,20
1,1483,48656,3578761496,3578761518,22
1,1483,48657,3578761496,3578761519,23
1,1483,48658,3578761496,3578761519,23
1,1483,48659,3578761496,3578761521,25
1,1483,48660,3578761496,3578761521,25
1,1483,48661,3578761496,3578761521,25
1,1483,48662,3578761496,3578761521,25
1,1483,48663,3578761496,3578761522,26
1,1483,48664,3578761496,3578761523,27
1,1483,48665,3578761496,3578761524,28
1,1483,48666,3578761496,3578761524,28
1,1483,48667,3578761496,3578761525,29
1,1483,48668,3578761496,3578761526,30
1,1483,48669,3578761496,3578761526,30
1,1483,48670,3578761496,3578761527,31
1,1483,48671,3578761496,3578761527,31
1,1483,48672,3578761496,3578761527,31
1,1483,48673,3578761496,3578761529,33
1,1483,48674,3578761496,3578761529,33
1,1483,48675,3578761496,3578761530,34
1,1483,48676,3578761496,3578761531,35
1,1483,48677,3578761496,3578761531,35
1,1483,48678,3578761496,3578761534,38
1,1483,48679,3578761496,3578761534,38
1,1483,48680,3578761496,3578761534,38
1,1483,48681,3578761496,3578761535,39
1,1483,48682,3578761496,3578761536,40
1,1483,48683,3578761496,3578761536,40
1,1483,48684,3578761496,3578761537,41
1,1483,48685,3578761496,3578761539,43
1,1483,48686,3578761496,3578761540,44
1,1483,48687,3578761496,3578761540,44
1,1483,48688,3578761496,3578761540,44
1,1483,48689,3578761496,3578761544,48
1,1483,48690,3578761496,3578761545,49
1,1483,48691,3578761496,3578761545,49
1,1484,48692,3578761560,3578761560,0
1,1484,48693,3578761560,3578761560,0
1,1484,48694,3578761560,3578761560,0
1,1484,48695,3578761560,3578761560,0
1,1484,48696,3578761560,3578761560,0
1,1484,48697,3578761560,3578761560,0
1,1484,48698,3578761560,3578761560,0
1,1484,48699,3578761560,3578761560,0
1,1484,48700,3578761560,3578761560,0
1,1484,48701,3578761560,3578761561,1
1,1484,48702,3578761560,3578761562,2
1,1484,48703,3578761560,3578761563,3
1,1484,48704,3578761560,3578761563,3
1,1484,48705,3578761560,3578761564,4
1,1484,48706,3578761560,3578761565,5
1,1484,48707,3578761560,3578761565,5
1,1484,48708,3578761560,3578761565,5
1,1484,48709,3578761560,3578761565,5
1,1484,48710,3578761560,3578761566,6
1,1484,48711,3578761560,3578761568,8
1,1484,48712,3578761560,3578761568,8
1,1484,48713,3578761560,3578761568,8
1,1484,48714,3578761560,3578761569,9
1,1484,48715,3578761560,3578761571,11
1,1484,48716,3578761560,3578761574,14
1,1484,48717,3578761560,3578761575,15
1,1484,48718,3578761560,3578761575,15
1,1484,48719,3578761560,3578761576,16
1,1484,48720,3578761560,3578761576,16
1,1484,48721,3578761560,3578761577,17
1,1484,48722,3578761560,3578761578,18
1,1484,48723,3578761560,3578761579,19
1,1484,48724,3578761560,3578761580,20
1,1484,48725,3578761560,3578761580,20
1,1484,48726,3578761560,3578761581,21
1,1484,48727,3578761560,3578761581,21
1,1484,48728,3578761560,3578761581,21
1,1484,48729,3578761560,3578761582,22
1,1484,48730,3578761560,3578761585,25
1,1484,48731,3578761560,3578761586,26
1,1484,48732,3578761560,3578761588,28
1,1484,48733,3578761560,3578761590,30
1,1484,48734,3578761560,3578761590,30
1,1484,48735,3578761560,3578761591,31
1,1484,48736,3578761560,3578761591,31
1,1484,48737,3578761560,3578761593,33
1,1484,48738,3578761560,3578761593,33
1,1484,48739,3578761560,3578761594,34
1,1484,48740,3578761560,3578761594,34
1,1484,48741,3578761560,3578761595,35
1,1484,48742,3578761560,3578761596,36
1,1484,48743,3578761560,3578761597,37
1,1484,48744,3578761560,3578761597,37
1,1484,48745,3578761560,3578761598,38
1,1484,48746,3578761560,3578761599,39
1,1484,48747,3578761560,3578761599,39
1,1484,48748,3578761560,3578761600,40
1,1484,48749,3578761560,3578761601,41
1,1484,48750,3578761560,3578761604,44
1,1484,48751,3578761560,3578761605,45
1,1484,48752,3578761560,3578761606,46
1,1484,48753,3578761560,3578761609,49
1,1484,48754,3578761560,3578761610,50
1,1485,48755,3578761625,3578761625,0
1,1485,48756,3578761625,3578761625,0
1,1485,48757,3578761625,3578761625,0
1,1485,48758,3578761625,3578761625,0
1,1485,48759,3578761625,3578761625,0
1,1485,48760,3578761625,3578761625,0
1,1485,48761,3578761625,3578761625,0
1,1485,48762,3578761625,3578761625,0
1,1485,48763,3578761625,3578761625,0
1,1485,48764,3578761625,3578761625,0
1,1485,48765,3578761625,3578761625,0
1,1485,48766,3578761625,3578761625,0
1,1485,48767,3578761625,3578761625,0
1,1485,48768,3578761625,3578761625,0
1,1485,48769,3578761625,3578761625,0
1,1485,48770,3578761625,3578761625,0
1,1485,48771,3578761625,3578761625,0
1,1485,48772,3578761625,3578761625,0
1,1485,48773,3578761625,3578761625,0
1,1485,48774,3578761625,3578761625,0
1,1485,48775,3578761625,3578761626,1
1,1485,48776,3578761625,3578761626,1
1,1485,48777,3578761625,3578761628,3
1,1485,48778,3578761625,3578761628,3
1,1485,48779,3578761625,3578761628,3
1,1485,48780,3578761625,3578761629,4
1,1485,48781,3578761625,3578761630,5
1,1485,48782,3578761625,3578761630,5
1,1485,48783,3578761625,3578761631,6
1,1485,48784,3578761625,3578761632,7
1,1485,48785,3578761625,3578761634,9
1,1485,48786,3578761625,3578761636,11
1,1485,48787,3578761625,3578761636,11
1,1485,48788,3578761625,3578761637,12
1,1485,48789,3578761625,3578761637,12
1,1485,48790,3578761625,3578761639,14
1,1485,48791,3578761625,3578761642,17
1,1485,48792,3578761625,3578761642,17
1,1485,48793,3578761625,3578761646,21
1,1485,48794,3578761625,3578761647,22
1,1485,48795,3578761625,3578761649,24
1,1485,48796,3578761625,3578761649,24
1,1485,48797,3578761625,3578761651,26
1,1485,48798,3578761625,3578761652,27
1,1485,48799,3578761625,3578761654,29
1,1485,48800,3578761625,3578761654,29
1,1485,48801,3578761625,3578761654,29
1,1485,48802,3578761625,3578761656,31
1,1485,48803,3578761625,3578761657,32
1,1485,48804,3578761625,3578761657,32
1,1485,48805,3578761625,3578761658,33
1,1485,48806,3578761625,3578761658,33
1,1485,48807,3578761625,3578761661,36
1,1485,48808,3578761625,3578761662,37
1,1485,48809,3578761625,3578761662,37
1,1485,48810,3578761625,3578761664,39
1,1485,48811,3578761625,3578761668,43
1,1485,48812,3578761625,3578761668,43
1,1485,48813,3578761625,3578761668,43
1,1485,48814,3578761625,3578761668,43
1,1486,48815,3578761688,3578761688,0
1,1486,48816,3578761688,3578761688,0
1,1486,48817,3578761688,3578761688,0
1,1486,48818,3578761688,3578761688,0
1,1486,48819,3578761688,3578761688,0
1,1486,48820,3578761688,3578761688,0
1,1486,48821,3578761688,3578761688,0
1,1486,48822,3578761688,3578761688,0
1,1486,48823,3578761688,3578761688,0
1,1486,48824,3578761688,3578761689,1
1,1486,48825,3578761688,3578761689,1
1,1486,48826,3578761688,3578761690,2
1,1486,48827,3578761688,3578761690,2
1,1486,48828,3578761688,3578761692,4
1,1486,48829,3578761688,3578761693,5
1,1486,48830,3578761688,3578761693,5
1,1486,48831,3578761688,3578761694,6
1,1486,48832,3578761688,3578761695,7
1,1486,48833,3578761688,3578761695,7
1,1486,48834,3578761688,3578761696,8
1,1486,48835,3578761688,3578761696,8
1,1486,48836,3578761688,3578761696,8
1,1486,48837,3578761688,3578761696,8
1,1486,48838,3578761688,3578761696,8
1,1486,48839,3578761688,3578761697,9
1,1486,48840,3578761688,3578761698,10
1,1486,48841,3578761688,3578761702,14
1,1486,48842,3578761688,3578761702,14
1,1486,48843,3578761688,3578761702,14
1,1486,48844,3578761688,3578761702,14
1,1486,48845,3578761688,3578761704,16
1,1486,48846,3578761688,3578761704,16
1,1486,48847,3578761688,3578761704,16
1,1486,48848,3578761688,3578761704,16
1,1486,48849,3578761688,3578761705,17
1,1486,48850,3578761688,3578761705,17
1,1486,48851,3578761688,3578761706,18
1,1486,48852,3578761688,3578761707,19
1,1486,48853,3578761688,3578761707,19
1,1486,48854,3578761688,3578761708,20
1,1486,48855,3578761688,3578761708,20
1,1486,48856,3578761688,3578761708,20
1,1486,48857,3578761688,3578761709,21
1,1486,48858,3578761688,3578761709,21
1,1486,48859,3578761688,3578761709,21
1,1486,48860,3578761688,3578761710,22
1,1486,48861,3578761688,3578761711,23
1,1486,48862,3578761688,3578761711,23
1,1486,48863,3578761688,3578761712,24
1,1486,48864,3578761688,3578761712,24
1,1486,48865,3578761688,3578761713,25
1,1486,48866,3578761688,3578761713,25
1,1486,48867,3578761688,3578761714,26
1,1486,48868,3578761688,3578761714,26
1,1486,48869,3578761688,3578761716,28
1,1486,48870,3578761688,3578761718,30
1,1486,48871,3578761688,3578761719,31
1,1486,48872,3578761688,3578761719,31
1,1486,48873,3578761688,3578761721,33
1,1486,48874,3578761688,3578761721,33
1,1486,48875,3578761688,3578761721,33
1,1486,48876,3578761688,3578761722,34
1,1486,48877,3578761688,3578761722,34
1,1486,48878,3578761688,3578761723,35
1,1486,48879,3578761688,3578761724,36
1,1486,48880,3578761688,3578761724,36
1,1486,48881,3578761688,3578761726,38
1,1486,48882,3578761688,3578761726,38
1,1486,48883,3578761688,3578761726,38
1,1486,48884,3578761688,3578761727,39
1,1486,48885,3578761688,3578761727,39
1,1486,48886,3578761688,3578761729,41
1,1486,48887,3578761688,3578761730,42
1,1486,48888,3578761688,3578761731,43
1,1486,48889,3578761688,3578761732,44
1,1486,48890,3578761688,3578761733,45
1,1486,48891,3578761688,3578761733,45
1,1486,48892,3578761688,3578761734,46
1,1486,48893,3578761688,3578761734,46
1,1486,48894,3578761688,3578761735,47
1,1486,48895,3578761688,3578761735,47
1,1486,48896,3578761688,3578761737,49
1,1486,48897,3578761688,3578761737,49
1,1487,48898,3578761753,3578761753,0
1,1487,48899,3578761753,3578761753,0
1,1487,48900,3578761753,3578761753,0
1,1487,48901,3578761753,3578761753,0
1,1487,48902,3578761753,3578761753,0
1,1487,48903,3578761753,3578761753,0
1,1487,48904,3578761753,3578761753,0
1,1487,48905,3578761753,3578761753,0
1,1487,48906,3578761753,3578761753,0
1,1487,48907,3578761753,3578761753,0
1,1487,48908,3578761753,3578761753,0
1,1487,48909,3578761753,3578761753,0
1,1487,48910,3578761753,3578761755,2
1,1487,48911,3578761753,3578761756,3
1,1487,48912,3578761753,3578761757,4
1,1487,48913,3578761753,3578761758,5
1,1487,48914,3578761753,3578761759,6
1,1487,48915,3578761753,3578761761,8
1,1487,48916,3578761753,3578761762,9
1,1487,48917,3578761753,3578761762,9
1,1487,48918,3578761753,3578761763,10
1,1487,48919,3578761753,3578761764,11
1,1487,48920,3578761753,3578761765,12
1,1487,48921,3578761753,3578761765,12
1,1487,48922,3578761753,3578761765,12
1,1487,48923,3578761753,3578761767,14
1,1487,48924,3578761753,3578761768,15
1,1487,48925,3578761753,3578761769,16
1,1487,48926,3578761753,3578761769,16
1,1487,48927,3578761753,3578761769,16
1,1487,48928,3578761753,3578761772,19
1,1487,48929,3578761753,3578761774,21
1,1487,48930,3578761753,3578761774,21
1,1487,48931,3578761753,3578761776,23
1,1487,48932,3578761753,3578761777,24
1,1487,48933,3578761753,3578761777,24
1,1487,48934,3578761753,3578761778,25
1,1487,48935,3578761753,3578761778,25
1,1487,48936,3578761753,3578761779,26
1,1487,48937,3578761753,3578761780,27
1,1487,48938,3578761753,3578761780,27
1,1487,48939,3578761753,3578761781,28
1,1487,48940,3578761753,3578761781,28
1,1487,48941,3578761753,3578761781,28
1,1487,48942,3578761753,3578761781,28
1,1487,48943,3578761753,3578761783,30
1,1487,48944,3578761753,3578761785,32
1,1487,48945,3578761753,3578761785,32
1,1487,48946,3578761753,3578761788,35
1,1487,48947,3578761753,3578761790,37
1,1487,48948,3578761753,3578761791,38
1,1487,48949,3578761753,3578761791,38
1,1487,48950,3578761753,3578761791,38
1,1487,48951,3578761753,3578761793,40
1,1487,48952,3578761753,3578761793,40
1,1487,48953,3578761753,3578761794,41
1,1487,48954,3578761753,3578761794,41
1,1487,48955,3578761753,3578761796,43
1,1487,48956,3578761753,3578761796,43
1,1487,48957,3578761753,3578761797,44
1,1487,48958,3578761753,3578761797,44
1,1487,48959,3578761753,3578761798,45
1,1487,48960,3578761753,3578761799,46
1,1487,48961,3578761753,3578761799,46
1,1487,48962,3578761753,3578761801,48
1,1487,48963,3578761753,3578761802,49
1,1488,48964,3578761817,3578761817,0
1,1488,48965,3578761817,3578761817,0
1,1488,48966,3578761817,3578761817,0
1,1488,48967,3578761817,3578761817,0
1,1488,48968,3578761817,3578761817,0
1,1488,48969,3578761817,3578761817,0
1,1488,48970,3578761817,3578761817,0
1,1488,48971,3578761817,3578761817,0
1,1488,48972,3578761817,3578761817,0
1,1488,48973,3578761817,3578761817,0
1,1488,48974,3578761817,3578761817,0
1,1488,48975,3578761817,3578761817,0
1,1488,48976,3578761817,3578761817,0
1,1488,48977,3578761817,3578761817,0
1,1488,48978,3578761817,3578761817,0
1,1488,48979,3578761817,3578761818,1
1,1488,48980,3578761817,3578761818,1
1,1488,48981,3578761817,3578761818,1
1,1488,48982,3578761817,3578761818,1
1,1488,48983,3578761817,3578761818,1
1,1488,48984,3578761817,3578761818,1
1,1488,48985,3578761817,3578761820,3
1,1488,48986,3578761817,3578761822,5
1,1488,48987,3578761817,3578761824,7
1,1488,48988,3578761817,3578761826,9
1,1488,48989,3578761817,3578761826,9
1,1488,48990,3578761817,3578761828,11
1,1488,48991,3578761817,3578761828,11
1,1488,48992,3578761817,3578761828,11
1,1488,48993,3578761817,3578761829,12
1,1488,48994,3578761817,3578761829,12
1,1488,48995,3578761817,3578761831,14
1,1488,48996,3578761817,3578761832,15
1,1488,48997,3578761817,3578761833,16
1,1488,48998,3578761817,3578761834,17
1,1488,48999,3578761817,3578761836,19
1,1488,49000,3578761817,3578761837,20
1,1488,49001,3578761817,3578761837,20
1,1488,49002,3578761817,3578761838,21
1,1488,49003,3578761817,3578761839,22
1,1488,49004,3578761817,3578761841,24
1,1488,49005,3578761817,3578761842,25
1,1488,49006,3578761817,3578761847,30
1,1488,49007,3578761817,3578761847,30
1,1488,49008,3578761817,3578761849,32
1,1488,49009,3578761817,3578761849,32
1,1488,49010,3578761817,3578761851,34
1,1488,49011,3578761817,3578761853,36
1,1488,49012,3578761817,3578761854,37
1,1488,49013,3578761817,3578761854,37
1,1488,49014,3578761817,3578761855,38
1,1488,49015,3578761817,3578761856,39
1,1488,49016,3578761817,3578761857,40
1,1488,49017,3578761817,3578761858,41
1,1488,49018,3578761817,3578761859,42
1,1488,49019,3578761817,3578761862,45
1,1488,49020,3578761817,3578761862,45
1,1488,49021,3578761817,3578761863,46
1,1488,49022,3578761817,3578761863,46
1,1489,49023,3578761881,3578761881,0
1,1489,49024,3578761881,3578761881,0
1,1489,49025,3578761881,3578761881,0
1,1489,49026,3578761881,3578761881,0
1,1489,49027,3578761881,3578761881,0
1,1489,49028,3578761881,3578761881,0
1,1489,49029,3578761881,3578761882,1
1,1489,49030,3578761881,3578761882,1
1,1489,49031,3578761881,3578761885,4
1,1489,49032,3578761881,3578761885,4
1,1489,49033,3578761881,3578761886,5
1,1489,49034,3578761881,3578761886,5
1,1489,49035,3578761881,3578761886,5
1,1489,49036,3578761881,3578761889,8
1,1489,49037,3578761881,3578761890,9
1,1489,49038,3578761881,3578761890,9
1,1489,49039,3578761881,3578761890,9
1,1489,49040,3578761881,3578761892,11
1,1489,49041,3578761881,3578761893,12
1,1489,49042,3578761881,3578761893,12
1,1489,49043,3578761881,3578761894,13
1,1489,49044,3578761881,3578761894,13
1,1489,49045,3578761881,3578761896,15
1,1489,49046,3578761881,3578761896,15
1,1489,49047,3578761881,3578761896,15
1,1489,49048,3578761881,3578761896,15
1,1489,49049,3578761881,3578761896,15
1,1489,49050,3578761881,3578761896,15
1,1489,49051,3578761881,3578761898,17
1,1489,49052,3578761881,3578761898,17
1,1489,49053,3578761881,3578761902,21
1,1489,49054,3578761881,3578761902,21
1,1489,49055,3578761881,3578761903,22
1,1489,49056,3578761881,3578761903,22
1,1489,49057,3578761881,3578761903,22
1,1489,49058,3578761881,3578761904,23
1,1489,49059,3578761881,3578761905,24
1,1489,49060,3578761881,3578761905,24
1,1489,49061,3578761881,3578761905,24
1,1489,49062,3578761881,3578761905,24
1,1489,49063,3578761881,3578761906,25
1,1489,49064,3578761881,3578761907,26
1,1489,49065,3578761881,3578761907,26
1,1489,49066,3578761881,3578761908,27
1,1489,49067,3578761881,3578761908,27
1,1489,49068,3578761881,3578761908,27
1,1489,49069,3578761881,3578761908,27
1,1489,49070,3578761881,3578761909,28
1,1489,49071,3578761881,3578761909,28
1,1489,49072,3578761881,3578761910,29
1,1489,49073,3578761881,3578761911,30
1,1489,49074,3578761881,3578761912,31
1,1489,49075,3578761881,3578761912,31
1,1489,49076,3578761881,3578761913,32
1,1489,49077,3578761881,3578761914,33
1,1489,49078,3578761881,3578761914,33
1,1489,49079,3578761881,3578761914,33
1,1489,49080,3578761881,3578761914,33
1,1489,49081,3578761881,3578761914,33
1,1489,49082,3578761881,3578761917,36
1,1489,49083,3578761881,3578761918,37
1,1489,49084,3578761881,3578761919,38
1,1489,49085,3578761881,3578761919,38
1,1489,49086,3578761881,3578761920,39
1,1489,49087,3578761881,3578761921,40
1,1489,49088,3578761881,3578761921,40
1,1489,49089,3578761881,3578761921,40
1,1489,49090,3578761881,3578761922,41
1,1489,49091,3578761881,3578761922,41
1,1489,49092,3578761881,3578761922,41
1,1489,49093,3578761881,3578761923,42
1,1489,49094,3578761881,3578761925,44
1,1489,49095,3578761881,3578761926,45
1,1489,49096,3578761881,3578761926,45
1,1489,49097,3578761881,3578761926,45
1,1489,49098,3578761881,3578761926,45
1,1489,49099,3578761881,3578761927,46
1,1489,49100,3578761881,3578761929,48
1,1489,49101,3578761881,3578761930,49
1,1489,49102,3578761881,3578761930,49
1,1490,49103,3578761946,3578761946,0
1,1490,49104,3578761946,3578761946,0
1,1490,49105,3578761946,3578761946,0
1,1490,49106,3578761946,3578761946,0
1,1490,49107,3578761946,3578761946,0
1,1490,49108,3578761946,3578761946,0
1,1490,49109,3578761946,3578761946,0
1,1490,49110,3578761946,3578761946,0
1,1490,49111,3578761946,3578761946,0
1,1490,49112,3578761946,3578761946,0
1,1490,49113,3578761946,3578761946,0
1,1490,49114,3578761946,3578761946,0
1,1490,49115,3578761946,3578761946,0
1,1490,49116,3578761946,3578761946,0
1,1490,49117,3578761946,3578761946,0
1,1490,49118,3578761946,3578761946,0
1,1490,49119,3578761946,3578761948,2
1,1490,49120,3578761946,3578761949,3
1,1490,49121,3578761946,3578761951,5
1,1490,49122,3578761946,3578761953,7
1,1490,49123,3578761946,3578761953,7
1,1490,49124,3578761946,3578761955,9
1,1490,49125,3578761946,3578761956,10
1,1490,49126,3578761946,3578761956,10
1,1490,49127,3578761946,3578761957,11
1,1490,49128,3578761946,3578761959,13
1,1490,49129,3578761946,3578761962,16
1,1490,49130,3578761946,3578761963,17
1,1490,49131,3578761946,3578761963,17
1,1490,49132,3578761946,3578761964,18
1,1490,49133,3578761946,3578761964,18
1,1490,49134,3578761946,3578761965,19
1,1490,49135,3578761946,3578761965,19
1,1490,49136,3578761946,3578761965,19
1,1490,49137,3578761946,3578761966,20
1,1490,49138,3578761946,3578761967,21
1,1490,49139,3578761946,3578761968,22
1,1490,49140,3578761946,3578761968,22
1,1490,49141,3578761946,3578761969,23
1,1490,49142,3578761946,3578761969,23
1,1490,49143,3578761946,3578761972,26
1,1490,49144,3578761946,3578761975,29
1,1490,49145,3578761946,3578761975,29
1,1490,49146,3578761946,3578761977,31
1,1490,49147,3578761946,3578761977,31
1,1490,49148,3578761946,3578761977,31
1,1490,49149,3578761946,3578761978,32
1,1490,49150,3578761946,3578761978,32
1,1490,49151,3578761946,3578761979,33
1,1490,49152,3578761946,3578761980,34
1,1490,49153,3578761946,3578761980,34
1,1490,49154,3578761946,3578761981,35
1,1490,49155,3578761946,3578761981,35
1,1490,49156,3578761946,3578761982,36
1,1490,49157,3578761946,3578761982,36
1,1490,49158,3578761946,3578761982,36
1,1490,49159,3578761946,3578761985,39
1,1490,49160,3578761946,3578761986,40
1,1490,49161,3578761946,3578761988,42
1,1490,49162,3578761946,3578761991,45
1,1490,49163,3578761946,3578761991,45
1,1490,49164,3578761946,3578761991,45
1,1490,49165,3578761946,3578761992,46
1,1490,49166,3578761946,3578761994,48
1,1490,49167,3578761946,3578761994,48
1,1490,49168,3578761946,3578761995,49
1,1490,49169,3578761946,3578761996,50
1,1491,49170,3578762011,3578762011,0
1,1491,49171,3578762011,3578762011,0
1,1491,49172,3578762011,3578762011,0
1,1491,49173,3578762011,3578762011,0
1,1491,49174,3578762011,3578762011,0
1,1491,49175,3578762011,3578762011,0
1,1491,49176,3578762011,3578762011,0
1,1491,49177,3578762011,3578762011,0
1,1491,49178,3578762011,3578762011,0
1,1491,49179,3578762011,3578762011,0
1,1491,49180,3578762011,3578762011,0
1,1491,49181,3578762011,3578762011,0
1,1491,49182,3578762011,3578762011,0
1,1491,49183,3578762011,3578762011,0
1,1491,49184,3578762011,3578762011,0
1,1491,49185,3578762011,3578762011,0
1,1491,49186,3578762011,3578762012,1
1,1491,49187,3578762011,3578762012,1
1,1491,49188,3578762011,3578762013,2
1,1491,49189,3578762011,3578762013,2
1,1491,49190,3578762011,3578762015,4
1,1491,49191,3578762011,3578762016,5
1,1491,49192,3578762011,3578762017,6
1,1491,49193,3578762011,3578762017,6
1,1491,49194,3578762011,3578762017,6
1,1491,49195,3578762011,3578762018,7
1,1491,49196,3578762011,3578762018,7
1,1491,49197,3578762011,3578762019,8
1,1491,49198,3578762011,3578762019,8
1,1491,49199,3578762011,3578762019,8
1,1491,49200,3578762011,3578762020,9
1,1491,49201,3578762011,3578762022,11
1,1491,49202,3578762011,3578762024,13
1,1491,49203,3578762011,3578762026,15
1,1491,49204,3578762011,3578762028,17
1,1491,49205,3578762011,3578762028,17
1,1491,49206,3578762011,3578762028,17
1,1491,49207,3578762011,3578762030,19
1,1491,49208,3578762011,3578762031,20
1,1491,49209,3578762011,3578762031,20
1,1491,49210,3578762011,3578762032,21
1,1491,49211,3578762011,3578762033,22
1,1491,49212,3578762011,3578762034,23
1,1491,49213,3578762011,3578762037,26
1,1491,49214,3578762011,3578762037,26
1,1491,49215,3578762011,3578762037,26
1,1491,49216,3578762011,3578762038,27
1,1491,49217,3578762011,3578762041,30
1,1491,49218,3578762011,3578762042,31
1,1491,49219,3578762011,3578762047,36
1,1491,49220,3578762011,3578762048,37
1,1491,49221,3578762011,3578762050,39
1,1491,49222,3578762011,3578762050,39
1,1491,49223,3578762011,3578762051,40
1,1491,49224,3578762011,3578762053,42
1,1491,49225,3578762011,3578762054,43
1,1491,49226,3578762011,3578762054,43
1,1491,49227,3578762011,3578762055,44
1,1491,49228,3578762011,3578762056,45
1,1491,49229,3578762011,3578762057,46
1,1491,49230,3578762011,3578762057,46
1,1491,49231,3578762011,3578762059,48
1,1491,49232,3578762011,3578762060,49
1,1492,49233,3578762073,3578762073,0
1,1492,49234,3578762073,3578762074,1
1,1492,49235,3578762073,3578762074,1
1,1492,49236,3578762073,3578762074,1
1,1492,49237,3578762073,3578762074,1
1,1492,49238,3578762073,3578762074,1
1,1492,49239,3578762073,3578762074,1
1,1492,49240,3578762073,3578762074,1
1,1492,49241,3578762073,3578762080,7
1,1492,49242,3578762073,3578762081,8
1,1492,49243,3578762073,3578762082,9
1,1492,49244,3578762073,3578762083,10
1,1492,49245,3578762073,3578762085,12
1,1492,49246,3578762073,3578762086,13
1,1492,49247,3578762073,3578762086,13
1,1492,49248,3578762073,3578762089,16
1,1492,49249,3578762073,3578762090,17
1,1492,49250,3578762073,3578762090,17
1,1492,49251,3578762073,3578762092,19
1,1492,49252,3578762073,3578762093,20
1,1492,49253,3578762073,3578762093,20
1,1492,49254,3578762073,3578762094,21
1,1492,49255,3578762073,3578762095,22
1,1492,49256,3578762073,3578762096,23
1,1492,49257,3578762073,3578762096,23
1,1492,49258,3578762073,3578762096,23
1,1492,49259,3578762073,3578762097,24
1,1492,49260,3578762073,3578762097,24
1,1492,49261,3578762073,3578762097,24
1,1492,49262,3578762073,3578762101,28
1,1492,49263,3578762073,3578762102,29
1,1492,49264,3578762073,3578762102,29
1,1492,49265,3578762073,3578762102,29
1,1492,49266,3578762073,3578762103,30
1,1492,49267,3578762073,3578762103,30
1,1492,49268,3578762073,3578762104,31
1,1492,49269,3578762073,3578762104,31
1,1492,49270,3578762073,3578762105,32
1,1492,49271,3578762073,3578762105,32
1,1492,49272,3578762073,3578762105,32
1,1492,49273,3578762073,3578762107,34
1,1492,49274,3578762073,3578762107,34
1,1492,49275,3578762073,3578762108,35
1,1492,49276,3578762073,3578762108,35
1,1492,49277,3578762073,3578762109,36
1,1492,49278,3578762073,3578762109,36
1,1492,49279,3578762073,3578762109,36
1,1492,49280,3578762073,3578762110,37
1,1492,49281,3578762073,3578762110,37
1,1492,49282,3578762073,3578762111,38
1,1492,49283,3578762073,3578762112,39
1,1492,49284,3578762073,3578762112,39
1,1492,49285,3578762073,3578762113,40
1,1492,49286,3578762073,3578762114,41
1,1492,49287,3578762073,3578762114,41
1,1492,49288,3578762073,3578762114,41
1,1492,49289,3578762073,3578762114,41
1,1492,49290,3578762073,3578762115,42
1,1492,49291,3578762073,3578762117,44
1,1492,49292,3578762073,3578762118,45
1,1492,49293,3578762073,3578762118,45
1,1492,49294,3578762073,3578762121,48
1,1492,49295,3578762073,3578762121,48
1,1492,49296,3578762073,3578762121,48
1,1492,49297,3578762073,3578762122,49
1,1492,49298,3578762073,3578762122,49
1,1492,49299,3578762073,3578762122,49
1,1492,49300,3578762073,3578762122,49
1,1492,49301,3578762073,3578762123,50
1,1493,49302,3578762137,3578762137,0
1,1493,49303,3578762137,3578762137,0
1,1493,49304,3578762137,3578762137,0
1,1493,49305,3578762137,3578762137,0
1,1493,49306,3578762137,3578762137,0
1,1493,49307,3578762137,3578762137,0
1,1493,49308,3578762137,3578762137,0
1,1493,49309,3578762137,3578762137,0
1,1493,49310,3578762137,3578762137,0
1,1493,49311,3578762137,3578762137,0
1,1493,49312,3578762137,3578762137,0
1,1493,49313,3578762137,3578762137,0
1,1493,49314,3578762137,3578762137,0
1,1493,49315,3578762137,3578762137,0
1,1493,49316,3578762137,3578762137,0
1,1493,49317,3578762137,3578762137,0
1,1493,49318,3578762137,3578762137,0
1,1493,49319,3578762137,3578762138,1
1,1493,49320,3578762137,3578762138,1
1,1493,49321,3578762137,3578762138,1
1,1493,49322,3578762137,3578762138,1
1,1493,49323,3578762137,3578762138,1
1,1493,49324,3578762137,3578762139,2
1,1493,49325,3578762137,3578762141,4
1,1493,49326,3578762137,3578762142,5
1,1493,49327,3578762137,3578762144,7
1,1493,49328,3578762137,3578762146,9
1,1493,49329,3578762137,3578762148,11
1,1493,49330,3578762137,3578762148,11
1,1493,49331,3578762137,3578762150,13
1,1493,49332,3578762137,3578762152,15
1,1493,49333,3578762137,3578762152,15
1,1493,49334,3578762137,3578762155,18
1,1493,49335,3578762137,3578762155,18
1,1493,49336,3578762137,3578762156,19
1,1493,49337,3578762137,3578762158,21
1,1493,49338,3578762137,3578762158,21
1,1493,49339,3578762137,3578762161,24
1,1493,49340,3578762137,3578762163,26
1,1493,49341,3578762137,3578762163,26
1,1493,49342,3578762137,3578762164,27
1,1493,49343,3578762137,3578762165,28
1,1493,49344,3578762137,3578762165,28
1,1493,49345,3578762137,3578762165,28
1,1493,49346,3578762137,3578762166,29
1,1493,49347,3578762137,3578762167,30
1,1493,49348,3578762137,3578762168,31
1,1493,49349,3578762137,3578762168,31
1,1493,49350,3578762137,3578762169,32
1,1493,49351,3578762137,3578762169,32
1,1493,49352,3578762137,3578762172,35
1,1493,49353,3578762137,3578762172,35
1,1493,49354,3578762137,3578762175,38
1,1493,49355,3578762137,3578762176,39
1,1493,49356,3578762137,3578762177,40
1,1493,49357,3578762137,3578762177,40
1,1493,49358,3578762137,3578762177,40
1,1493,49359,3578762137,3578762178,41
1,1493,49360,3578762137,3578762179,42
1,1493,49361,3578762137,3578762180,43
1,1493,49362,3578762137,3578762180,43
1,1493,49363,3578762137,3578762181,44
1,1493,49364,3578762137,3578762181,44
1,1493,49365,3578762137,3578762181,44
1,1493,49366,3578762137,3578762182,45
1,1493,49367,3578762137,3578762182,45
1,1493,49368,3578762137,3578762185,48
1,1493,49369,3578762137,3578762187,50
1,1494,49370,3578762200,3578762200,0
1,1494,49371,3578762200,3578762200,0
1,1494,49372,3578762200,3578762200,0
1,1494,49373,3578762200,3578762200,0
1,1494,49374,3578762200,3578762200,0
1,1494,49375,3578762200,3578762200,0
1,1494,49376,3578762200,3578762200,0
1,1494,49377,3578762200,3578762200,0
1,1494,49378,3578762200,3578762200,0
1,1494,49379,3578762200,3578762200,0
1,1494,49380,3578762200,3578762200,0
1,1494,49381,3578762200,3578762200,0
1,1494,49382,3578762200,3578762200,0
1,1494,49383,3578762200,3578762200,0
1,1494,49384,3578762200,3578762200,0
1,1494,49385,3578762200,3578762200,0
1,1494,49386,3578762200,3578762200,0
1,1494,49387,3578762200,3578762201,1
1,1494,49388,3578762200,3578762202,2
1,1494,49389,3578762200,3578762203,3
1,1494,49390,3578762200,3578762206,6
1,1494,49391,3578762200,3578762206,6
1,1494,49392,3578762200,3578762210,10
1,1494,49393,3578762200,3578762211,11
1,1494,49394,3578762200,3578762212,12
1,1494,49395,3578762200,3578762214,14
1,1494,49396,3578762200,3578762214,14
1,1494,49397,3578762200,3578762214,14
1,1494,49398,3578762200,3578762215,15
1,1494,49399,3578762200,3578762216,16
1,1494,49400,3578762200,3578762217,17
1,1494,49401,3578762200,3578762217,17
1,1494,49402,3578762200,3578762217,17
1,1494,49403,3578762200,3578762218,18
1,1494,49404,3578762200,3578762218,18
1,1494,49405,3578762200,3578762218,18
1,1494,49406,3578762200,3578762218,18
1,1494,49407,3578762200,3578762219,19
1,1494,49408,3578762200,3578762219,19
1,1494,49409,3578762200,3578762219,19
1,1494,49410,3578762200,3578762221,21
1,1494,49411,3578762200,3578762222,22
1,1494,49412,3578762200,3578762224,24
1,1494,49413,3578762200,3578762227,27
1,1494,49414,3578762200,3578762227,27
1,1494,49415,3578762200,3578762228,28
1,1494,49416,3578762200,3578762228,28
1,1494,49417,3578762200,3578762229,29
1,1494,49418,3578762200,3578762230,30
1,1494,49419,3578762200,3578762230,30
1,1494,49420,3578762200,3578762231,31
1,1494,49421,3578762200,3578762232,32
1,1494,49422,3578762200,3578762233,33
1,1494,49423,3578762200,3578762235,35
1,1494,49424,3578762200,3578762237,37
1,1494,49425,3578762200,3578762237,37
1,1494,49426,3578762200,3578762237,37
1,1494,49427,3578762200,3578762239,39
1,1494,49428,3578762200,3578762241,41
1,1494,49429,3578762200,3578762242,42
1,1494,49430,3578762200,3578762248,48
1,1494,49431,3578762200,3578762250,50
1,1495,49432,3578762263,3578762263,0
1,1495,49433,3578762263,3578762263,0
1,1495,49434,3578762263,3578762263,0
1,1495,49435,3578762263,3578762263,0
1,1495,49436,3578762263,3578762263,0
1,1495,49437,3578762263,3578762263,0
1,1495,49438,3578762263,3578762263,0
1,1495,49439,3578762263,3578762263,0
1,1495,49440,3578762263,3578762263,0
1,1495,49441,3578762263,3578762263,0
1,1495,49442,3578762263,3578762263,0
1,1495,49443,3578762263,3578762263,0
1,1495,49444,3578762263,3578762263,0
1,1495,49445,3578762263,3578762263,0
1,1495,49446,3578762263,3578762264,1
1,1495,49447,3578762263,3578762268,5
1,1495,49448,3578762263,3578762268,5
1,1495,49449,3578762263,3578762268,5
1,1495,49450,3578762263,3578762269,6
1,1495,49451,3578762263,3578762281,18
1,1495,49452,3578762263,3578762282,19
1,1495,49453,3578762263,3578762282,19
1,1495,49454,3578762263,3578762283,20
1,1495,49455,3578762263,3578762285,22
1,1495,49456,3578762263,3578762286,23
1,1495,49457,3578762263,3578762286,23
1,1495,49458,3578762263,3578762286,23
1,1495,49459,3578762263,3578762288,25
1,1495,49460,3578762263,3578762289,26
1,1495,49461,3578762263,3578762290,27
1,1495,49462,3578762263,3578762290,27
1,1495,49463,3578762263,3578762292,29
1,1495,49464,3578762263,3578762293,30
1,1495,49465,3578762263,3578762293,30
1,1495,49466,3578762263,3578762294,31
1,1495,49467,3578762263,3578762295,32
1,1495,49468,3578762263,3578762295,32
1,1495,49469,3578762263,3578762296,33
1,1495,49470,3578762263,3578762297,34
1,1495,49471,3578762263,3578762297,34
1,1495,49472,3578762263,3578762297,34
1,1495,49473,3578762263,3578762297,34
1,1495,49474,3578762263,3578762302,39
1,1495,49475,3578762263,3578762302,39
1,1495,49476,3578762263,3578762302,39
1,1495,49477,3578762263,3578762302,39
1,1495,49478,3578762263,3578762303,40
1,1495,49479,3578762263,3578762304,41
1,1495,49480,3578762263,3578762304,41
1,1495,49481,3578762263,3578762304,41
1,1495,49482,3578762263,3578762305,42
1,1495,49483,3578762263,3578762305,42
1,1495,49484,3578762263,3578762305,42
1,1495,49485,3578762263,3578762307,44
1,1495,49486,3578762263,3578762307,44
1,1495,49487,3578762263,3578762308,45
1,1495,49488,3578762263,3578762308,45
1,1495,49489,3578762263,3578762308,45
1,1495,49490,3578762263,3578762309,46
1,1495,49491,3578762263,3578762309,46
1,1495,49492,3578762263,3578762309,46
1,1495,49493,3578762263,3578762309,46
1,1495,49494,3578762263,3578762310,47
1,1495,49495,3578762263,3578762311,48
1,1495,49496,3578762263,3578762312,49
1,1495,49497,3578762263,3578762312,49
1,1495,49498,3578762263,3578762313,50
1,1496,49499,3578762326,3578762326,0
1,1496,49500,3578762326,3578762326,0
1,1496,49501,3578762326,3578762326,0
1,1496,49502,3578762326,3578762326,0
1,1496,49503,3578762326,3578762326,0
1,1496,49504,3578762326,3578762326,0
1,1496,49505,3578762326,3578762326,0
1,1496,49506,3578762326,3578762326,0
1,1496,49507,3578762326,3578762326,0
1,1496,49508,3578762326,3578762326,0
1,1496,49509,3578762326,3578762326,0
1,1496,49510,3578762326,3578762326,0
1,1496,49511,3578762326,3578762326,0
1,1496,49512,3578762326,3578762326,0
1,1496,49513,3578762326,3578762326,0
1,1496,49514,3578762326,3578762326,0
1,1496,49515,3578762326,3578762326,0
1,1496,49516,3578762326,3578762326,0
1,1496,49517,3578762326,3578762326,0
1,1496,49518,3578762326,3578762326,0
1,1496,49519,3578762326,3578762326,0
1,1496,49520,3578762326,3578762326,0
1,1496,49521,3578762326,3578762327,1
1,1496,49522,3578762326,3578762327,1
1,1496,49523,3578762326,3578762328,2
1,1496,49524,3578762326,3578762329,3
1,1496,49525,3578762326,3578762330,4
1,1496,49526,3578762326,3578762331,5
1,1496,49527,3578762326,3578762331,5
1,1496,49528,3578762326,3578762332,6
1,1496,49529,3578762326,3578762333,7
1,1496,49530,3578762326,3578762334,8
1,1496,49531,3578762326,3578762335,9
1,1496,49532,3578762326,3578762335,9
1,1496,49533,3578762326,3578762335,9
1,1496,49534,3578762326,3578762335,9
1,1496,49535,3578762326,3578762337,11
1,1496,49536,3578762326,3578762337,11
1,1496,49537,3578762326,3578762338,12
1,1496,49538,3578762326,3578762338,12
1,1496,49539,3578762326,3578762341,15
1,1496,49540,3578762326,3578762341,15
1,1496,49541,3578762326,3578762342,16
1,1496,49542,3578762326,3578762346,20
1,1496,49543,3578762326,3578762346,20
1,1496,49544,3578762326,3578762347,21
1,1496,49545,3578762326,3578762350,24
1,1496,49546,3578762326,3578762353,27
1,1496,49547,3578762326,3578762354,28
1,1496,49548,3578762326,3578762355,29
1,1496,49549,3578762326,3578762356,30
1,1496,49550,3578762326,3578762356,30
1,1496,49551,3578762326,3578762357,31
1,1496,49552,3578762326,3578762360,34
1,1496,49553,3578762326,3578762362,36
1,1496,49554,3578762326,3578762364,38
1,1496,49555,3578762326,3578762365,39
1,1496,49556,3578762326,3578762366,40
1,1496,49557,3578762326,3578762366,40
1,1496,49558,3578762326,3578762367,41
1,1496,49559,3578762326,3578762367,41
1,1496,49560,3578762326,3578762369,43
1,1496,49561,3578762326,3578762369,43
1,1496,49562,3578762326,3578762369,43
1,1496,49563,3578762326,3578762370,44
1,1496,49564,3578762326,3578762372,46
1,1496,49565,3578762326,3578762372,46
1,1496,49566,3578762326,3578762375,49
1,1496,49567,3578762326,3578762376,50
1,1497,49568,3578762390,3578762390,0
1,1497,49569,3578762390,3578762390,0
1,1497,49570,3578762390,3578762390,0
1,1497,49571,3578762390,3578762390,0
1,1497,49572,3578762390,3578762390,0
1,1497,49573,3578762390,3578762390,0
1,1497,49574,3578762390,3578762390,0
1,1497,49575,3578762390,3578762390,0
1,1497,49576,3578762390,3578762390,0
1,1497,49577,3578762390,3578762390,0
1,1497,49578,3578762390,3578762390,0
1,1497,49579,3578762390,3578762390,0
1,1497,49580,3578762390,3578762390,0
1,1497,49581,3578762390,3578762390,0
1,1497,49582,3578762390,3578762390,0
1,1497,49583,3578762390,3578762392,2
1,1497,49584,3578762390,3578762392,2
1,1497,49585,3578762390,3578762392,2
1,1497,49586,3578762390,3578762393,3
1,1497,49587,3578762390,3578762394,4
1,1497,49588,3578762390,3578762395,5
1,1497,49589,3578762390,3578762395,5
1,1497,49590,3578762390,3578762396,6
1,1497,49591,3578762390,3578762396,6
1,1497,49592,3578762390,3578762397,7
1,1497,49593,3578762390,3578762397,7
1,1497,49594,3578762390,3578762397,7
1,1497,49595,3578762390,3578762398,8
1,1497,49596,3578762390,3578762399,9
1,1497,49597,3578762390,3578762399,9
1,1497,49598,3578762390,3578762399,9
1,1497,49599,3578762390,3578762401,11
1,1497,49600,3578762390,3578762404,14
1,1497,49601,3578762390,3578762406,16
1,1497,49602,3578762390,3578762406,16
1,1497,49603,3578762390,3578762411,21
1,1497,49604,3578762390,3578762411,21
1,1497,49605,3578762390,3578762411,21
1,1497,49606,3578762390,3578762412,22
1,1497,49607,3578762390,3578762414,24
1,1497,49608,3578762390,3578762414,24
1,1497,49609,3578762390,3578762414,24
1,1497,49610,3578762390,3578762415,25
1,1497,49611,3578762390,3578762416,26
1,1497,49612,3578762390,3578762417,27
1,1497,49613,3578762390,3578762417,27
1,1497,49614,3578762390,3578762417,27
1,1497,49615,3578762390,3578762418,28
1,1497,49616,3578762390,3578762418,28
1,1497,49617,3578762390,3578762419,29
1,1497,49618,3578762390,3578762419,29
1,1497,49619,3578762390,3578762419,29
1,1497,49620,3578762390,3578762420,30
1,1497,49621,3578762390,3578762421,31
1,1497,49622,3578762390,3578762423,33
1,1497,49623,3578762390,3578762424,34
1,1497,49624,3578762390,3578762424,34
1,1497,49625,3578762390,3578762426,36
1,1497,49626,3578762390,3578762427,37
1,1497,49627,3578762390,3578762428,38
1,1497,49628,3578762390,3578762429,39
1,1497,49629,3578762390,3578762430,40
1,1497,49630,3578762390,3578762430,40
1,1497,49631,3578762390,3578762431,41
1,1497,49632,3578762390,3578762432,42
1,1497,49633,3578762390,3578762433,43
1,1497,49634,3578762390,3578762435,45
1,1497,49635,3578762390,3578762437,47
1,1497,49636,3578762390,3578762438,48
1,1497,49637,3578762390,3578762438,48
1,1498,49638,3578762455,3578762455,0
1,1498,49639,3578762455,3578762455,0
1,1498,49640,3578762455,3578762455,0
1,1498,49641,3578762455,3578762455,0
1,1498,49642,3578762455,3578762455,0
1,1498,49643,3578762455,3578762455,0
1,1498,49644,3578762455,3578762455,0
1,1498,49645,3578762455,3578762455,0
1,1498,49646,3578762455,3578762455,0
1,1498,49647,3578762455,3578762456,1
1,1498,49648,3578762455,3578762456,1
1,1498,49649,3578762455,3578762456,1
1,1498,49650,3578762455,3578762457,2
1,1498,49651,3578762455,3578762459,4
1,1498,49652,3578762455,3578762460,5
1,1498,49653,3578762455,3578762461,6
1,1498,49654,3578762455,3578762462,7
1,1498,49655,3578762455,3578762463,8
1,1498,49656,3578762455,3578762465,10
1,1498,49657,3578762455,3578762468,13
1,1498,49658,3578762455,3578762468,13
1,1498,49659,3578762455,3578762469,14
1,1498,49660,3578762455,3578762480,25
1,1498,49661,3578762455,3578762481,26
1,1498,49662,3578762455,3578762481,26
1,1498,49663,3578762455,3578762482,27
1,1498,49664,3578762455,3578762485,30
1,1498,49665,3578762455,3578762486,31
1,1498,49666,3578762455,3578762486,31
1,1498,49667,3578762455,3578762487,32
1,1498,49668,3578762455,3578762489,34
1,1498,49669,3578762455,3578762490,35
1,1498,49670,3578762455,3578762490,35
1,1498,49671,3578762455,3578762490,35
1,1498,49672,3578762455,3578762492,37
1,1498,49673,3578762455,3578762492,37
1,1498,49674,3578762455,3578762494,39
1,1498,49675,3578762455,3578762495,40
1,1498,49676,3578762455,3578762495,40
1,1498,49677,3578762455,3578762496,41
1,1498,49678,3578762455,3578762496,41
1,1498,49679,3578762455,3578762497,42
1,1498,49680,3578762455,3578762497,42
1,1498,49681,3578762455,3578762502,47
1,1498,49682,3578762455,3578762503,48
1,1498,49683,3578762455,3578762503,48
1,1498,49684,3578762455,3578762503,48
1,1498,49685,3578762455,3578762503,48
1,1498,49686,3578762455,3578762504,49
1,1498,49687,3578762455,3578762504,49
1,1498,49688,3578762455,3578762504,49
1,1498,49689,3578762455,3578762505,50
1,1499,49690,3578762519,3578762519,0
1,1499,49691,3578762519,3578762519,0
1,1499,49692,3578762519,3578762519,0
1,1499,49693,3578762519,3578762519,0
1,1499,49694,3578762519,3578762519,0
1,1499,49695,3578762519,3578762519,0
1,1499,49696,3578762519,3578762519,0
1,1499,49697,3578762519,3578762519,0
1,1499,49698,3578762519,3578762519,0
1,1499,49699,3578762519,3578762519,0
1,1499,49700,3578762519,3578762519,0
1,1499,49701,3578762519,3578762519,0
1,1499,49702,3578762519,3578762519,0
1,1499,49703,3578762519,3578762519,0
1,1499,49704,3578762519,3578762519,0
1,1499,49705,3578762519,3578762519,0
1,1499,49706,3578762519,3578762519,0
1,1499,49707,3578762519,3578762519,0
1,1499,49708,3578762519,3578762519,0
1,1499,49709,3578762519,3578762519,0
1,1499,49710,3578762519,3578762519,0
1,1499,49711,3578762519,3578762519,0
1,1499,49712,3578762519,3578762519,0
1,1499,49713,3578762519,3578762520,1
1,1499,49714,3578762519,3578762520,1
1,1499,49715,3578762519,3578762521,2
1,1499,49716,3578762519,3578762521,2
1,1499,49717,3578762519,3578762521,2
1,1499,49718,3578762519,3578762521,2
1,1499,49719,3578762519,3578762522,3
1,1499,49720,3578762519,3578762524,5
1,1499,49721,3578762519,3578762524,5
1,1499,49722,3578762519,3578762524,5
1,1499,49723,3578762519,3578762524,5
1,1499,49724,3578762519,3578762526,7
1,1499,49725,3578762519,3578762526,7
1,1499,49726,3578762519,3578762526,7
1,1499,49727,3578762519,3578762527,8
1,1499,49728,3578762519,3578762528,9
1,1499,49729,3578762519,3578762530,11
1,1499,49730,3578762519,3578762530,11
1,1499,49731,3578762519,3578762531,12
1,1499,49732,3578762519,3578762531,12
1,1499,49733,3578762519,3578762531,12
1,1499,49734,3578762519,3578762532,13
1,1499,49735,3578762519,3578762533,14
1,1499,49736,3578762519,3578762533,14
1,1499,49737,3578762519,3578762534,15
1,1499,49738,3578762519,3578762535,16
1,1499,49739,3578762519,3578762536,17
1,1499,49740,3578762519,3578762536,17
1,1499,49741,3578762519,3578762537,18
1,1499,49742,3578762519,3578762537,18
1,1499,49743,3578762519,3578762538,19
1,1499,49744,3578762519,3578762540,21
1,1499,49745,3578762519,3578762541,22
1,1499,49746,3578762519,3578762541,22
1,1499,49747,3578762519,3578762544,25
1,1499,49748,3578762519,3578762545,26
1,1499,49749,3578762519,3578762545,26
1,1499,49750,3578762519,3578762546,27
1,1499,49751,3578762519,3578762548,29
1,1499,49752,3578762519,3578762548,29
1,1499,49753,3578762519,3578762549,30
1,1499,49754,3578762519,3578762551,32
1,1499,49755,3578762519,3578762553,34
1,1499,49756,3578762519,3578762554,35
1,1499,49757,3578762519,3578762555,36
1,1499,49758,3578762519,3578762555,36
1,1499,49759,3578762519,3578762557,38
1,1499,49760,3578762519,3578762559,40
1,1499,49761,3578762519,3578762561,42
1,1499,49762,3578762519,3578762562,43
1,1499,49763,3578762519,3578762563,44
1,1499,49764,3578762519,3578762564,45
1,1499,49765,3578762519,3578762565,46
1,1499,49766,3578762519,3578762565,46
1,1499,49767,3578762519,3578762565,46
1,1499,49768,3578762519,3578762566,47
1,1499,49769,3578762519,3578762567,48
1,1499,49770,3578762519,3578762567,48
1,1499,49771,3578762519,3578762568,49
1,1499,49772,3578762519,3578762569,50
1,1500,49773,3578762583,3578762583,0
1,1500,49774,3578762583,3578762583,0
1,1500,49775,3578762583,3578762583,0
1,1500,49776,3578762583,3578762583,0
1,1500,49777,3578762583,3578762583,0
1,1500,49778,3578762583,3578762583,0
1,1500,49779,3578762583,3578762583,0
1,1500,49780,3578762583,3578762583,0
1,1500,49781,3578762583,3578762583,0
1,1500,49782,3578762583,3578762583,0
1,1500,49783,3578762583,3578762583,0
1,1500,49784,3578762583,3578762583,0
1,1500,49785,3578762583,3578762583,0
1,1500,49786,3578762583,3578762583,0
1,1500,49787,3578762583,3578762585,2
1,1500,49788,3578762583,3578762586,3
1,1500,49789,3578762583,3578762588,5
1,1500,49790,3578762583,3578762591,8
1,1500,49791,3578762583,3578762591,8
1,1500,49792,3578762583,3578762592,9
1,1500,49793,3578762583,3578762592,9
1,1500,49794,3578762583,3578762593,10
1,1500,49795,3578762583,3578762594,11
1,1500,49796,3578762583,3578762594,11
1,1500,49797,3578762583,3578762595,12
1,1500,49798,3578762583,3578762595,12
1,1500,49799,3578762583,3578762596,13
1,1500,49800,3578762583,3578762596,13
1,1500,49801,3578762583,3578762596,13
1,1500,49802,3578762583,3578762597,14
1,1500,49803,3578762583,3578762598,15
1,1500,49804,3578762583,3578762599,16
1,1500,49805,3578762583,3578762599,16
1,1500,49806,3578762583,3578762599,16
1,1500,49807,3578762583,3578762600,17
1,1500,49808,3578762583,3578762601,18
1,1500,49809,3578762583,3578762604,21
1,1500,49810,3578762583,3578762604,21
1,1500,49811,3578762583,3578762605,22
1,1500,49812,3578762583,3578762610,27
1,1500,49813,3578762583,3578762610,27
1,1500,49814,3578762583,3578762610,27
1,1500,49815,3578762583,3578762612,29
1,1500,49816,3578762583,3578762612,29
1,1500,49817,3578762583,3578762612,29
1,1500,49818,3578762583,3578762613,30
1,1500,49819,3578762583,3578762614,31
1,1500,49820,3578762583,3578762616,33
1,1500,49821,3578762583,3578762616,33
1,1500,49822,3578762583,3578762616,33
1,1500,49823,3578762583,3578762617,34
1,1500,49824,3578762583,3578762617,34
1,1500,49825,3578762583,3578762617,34
1,1500,49826,3578762583,3578762617,34
1,1500,49827,3578762583,3578762617,34
1,1500,49828,3578762583,3578762618,35
1,1500,49829,3578762583,3578762618,35
1,1500,49830,3578762583,3578762618,35
1,1500,49831,3578762583,3578762619,36
1,1500,49832,3578762583,3578762620,37
1,1500,49833,3578762583,3578762621,38
1,1500,49834,3578762583,3578762623,40
1,1500,49835,3578762583,3578762625,42
1,1500,49836,3578762583,3578762626,43
1,1500,49837,3578762583,3578762626,43
1,1500,49838,3578762583,3578762627,44
1,1500,49839,3578762583,3578762629,46
1,1500,49840,3578762583,3578762629,46
1,1500,49841,3578762583,3578762629,46
1,1500,49842,3578762583,3578762630,47
1,1500,49843,3578762583,3578762630,47
1,1500,49844,3578762583,3578762631,48
1,1500,49845,3578762583,3578762632,49
1,1501,49846,3578762649,3578762649,0
1,1501,49847,3578762649,3578762649,0
1,1501,49848,3578762649,3578762649,0
1,1501,49849,3578762649,3578762649,0
1,1501,49850,3578762649,3578762649,0
1,1501,49851,3578762649,3578762649,0
1,1501,49852,3578762649,3578762649,0
1,1501,49853,3578762649,3578762649,0
1,1501,49854,3578762649,3578762649,0
1,1501,49855,3578762649,3578762649,0
1,1501,49856,3578762649,3578762651,2
1,1501,49857,3578762649,3578762653,4
1,1501,49858,3578762649,3578762653,4
1,1501,49859,3578762649,3578762653,4
1,1501,49860,3578762649,3578762655,6
1,1501,49861,3578762649,3578762657,8
1,1501,49862,3578762649,3578762657,8
1,1501,49863,3578762649,3578762657,8
1,1501,49864,3578762649,3578762658,9
1,1501,49865,3578762649,3578762659,10
1,1501,49866,3578762649,3578762660,11
1,1501,49867,3578762649,3578762662,13
1,1501,49868,3578762649,3578762664,15
1,1501,49869,3578762649,3578762667,18
1,1501,49870,3578762649,3578762667,18
1,1501,49871,3578762649,3578762668,19
1,1501,49872,3578762649,3578762680,31
1,1501,49873,3578762649,3578762682,33
1,1501,49874,3578762649,3578762682,33
1,1501,49875,3578762649,3578762682,33
1,1501,49876,3578762649,3578762685,36
1,1501,49877,3578762649,3578762685,36
1,1501,49878,3578762649,3578762685,36
1,1501,49879,3578762649,3578762686,37
1,1501,49880,3578762649,3578762686,37
1,1501,49881,3578762649,3578762687,38
1,1501,49882,3578762649,3578762689,40
1,1501,49883,3578762649,3578762690,41
1,1501,49884,3578762649,3578762690,41
1,1501,49885,3578762649,3578762692,43
1,1501,49886,3578762649,3578762693,44
1,1501,49887,3578762649,3578762693,44
1,1501,49888,3578762649,3578762694,45
1,1501,49889,3578762649,3578762695,46
1,1501,49890,3578762649,3578762696,47
1,1501,49891,3578762649,3578762696,47
1,1501,49892,3578762649,3578762697,48
1,1501,49893,3578762649,3578762697,48
1,1501,49894,3578762649,3578762698,49
1,1502,49895,3578762714,3578762714,0
1,1502,49896,3578762714,3578762714,0
1,1502,49897,3578762714,3578762714,0
1,1502,49898,3578762714,3578762714,0
1,1502,49899,3578762714,3578762714,0
1,1502,49900,3578762714,3578762714,0
1,1502,49901,3578762714,3578762714,0
1,1502,49902,3578762714,3578762714,0
1,1502,49903,3578762714,3578762714,0
1,1502,49904,3578762714,3578762714,0
1,1502,49905,3578762714,3578762714,0
1,1502,49906,3578762714,3578762714,0
1,1502,49907,3578762714,3578762714,0
1,1502,49908,3578762714,3578762714,0
1,1502,49909,3578762714,3578762714,0
1,1502,49910,3578762714,3578762714,0
1,1502,49911,3578762714,3578762714,0
1,1502,49912,3578762714,3578762714,0
1,1502,49913,3578762714,3578762714,0
1,1502,49914,3578762714,3578762714,0
1,1502,49915,3578762714,3578762714,0
1,1502,49916,3578762714,3578762714,0
1,1502,49917,3578762714,3578762714,0
1,1502,49918,3578762714,3578762714,0
1,1502,49919,3578762714,3578762714,0
1,1502,49920,3578762714,3578762714,0
1,1502,49921,3578762714,3578762715,1
1,1502,49922,3578762714,3578762716,2
1,1502,49923,3578762714,3578762717,3
1,1502,49924,3578762714,3578762718,4
1,1502,49925,3578762714,3578762718,4
1,1502,49926,3578762714,3578762720,6
1,1502,49927,3578762714,3578762721,7
1,1502,49928,3578762714,3578762721,7
1,1502,49929,3578762714,3578762721,7
1,1502,49930,3578762714,3578762721,7
1,1502,49931,3578762714,3578762722,8
1,1502,49932,3578762714,3578762723,9
1,1502,49933,3578762714,3578762723,9
1,1502,49934,3578762714,3578762725,11
1,1502,49935,3578762714,3578762725,11
1,1502,49936,3578762714,3578762726,12
1,1502,49937,3578762714,3578762726,12
1,1502,49938,3578762714,3578762727,13
1,1502,49939,3578762714,3578762727,13
1,1502,49940,3578762714,3578762729,15
1,1502,49941,3578762714,3578762730,16
1,1502,49942,3578762714,3578762731,17
1,1502,49943,3578762714,3578762731,17
1,1502,49944,3578762714,3578762733,19
1,1502,49945,3578762714,3578762733,19
1,1502,49946,3578762714,3578762734,20
1,1502,49947,3578762714,3578762735,21
1,1502,49948,3578762714,3578762735,21
1,1502,49949,3578762714,3578762736,22
1,1502,49950,3578762714,3578762736,22
1,1502,49951,3578762714,3578762737,23
1,1502,49952,3578762714,3578762737,23
1,1502,49953,3578762714,3578762740,26
1,1502,49954,3578762714,3578762740,26
1,1502,49955,3578762714,3578762741,27
1,1502,49956,3578762714,3578762744,30
1,1502,49957,3578762714,3578762745,31
1,1502,49958,3578762714,3578762746,32
1,1502,49959,3578762714,3578762747,33
1,1502,49960,3578762714,3578762747,33
1,1502,49961,3578762714,3578762748,34
1,1502,49962,3578762714,3578762749,35
1,1502,49963,3578762714,3578762753,39
1,1502,49964,3578762714,3578762754,40
1,1502,49965,3578762714,3578762755,41
1,1502,49966,3578762714,3578762755,41
1,1502,49967,3578762714,3578762755,41
1,1502,49968,3578762714,3578762758,44
1,1502,49969,3578762714,3578762759,45
1,1502,49970,3578762714,3578762761,47
1,1502,49971,3578762714,3578762762,48
1,1502,49972,3578762714,3578762763,49
1,1502,49973,3578762714,3578762764,50
1,1503,49974,3578762778,3578762778,0
1,1503,49975,3578762778,3578762778,0
1,1503,49976,3578762778,3578762778,0
1,1503,49977,3578762778,3578762778,0
1,1503,49978,3578762778,3578762778,0
1,1503,49979,3578762778,3578762778,0
1,1503,49980,3578762778,3578762778,0
1,1503,49981,3578762778,3578762778,0
1,1503,49982,3578762778,3578762778,0
1,1503,49983,3578762778,3578762778,0
1,1503,49984,3578762778,3578762778,0
1,1503,49985,3578762778,3578762778,0
1,1503,49986,3578762778,3578762778,0
1,1503,49987,3578762778,3578762778,0
1,1503,49988,3578762778,3578762778,0
1,1503,49989,3578762778,3578762779,1
1,1503,49990,3578762778,3578762779,1
1,1503,49991,3578762778,3578762780,2
1,1503,49992,3578762778,3578762780,2
1,1503,49993,3578762778,3578762780,2
1,1503,49994,3578762778,3578762781,3
1,1503,49995,3578762778,3578762781,3
1,1503,49996,3578762778,3578762781,3
1,1503,49997,3578762778,3578762781,3
1,1503,49998,3578762778,3578762785,7
1,1503,49999,3578762778,3578762785,7
1,1503,50000,3578762778,3578762789,11
1,1503,50001,3578762778,3578762791,13
1,1503,50002,3578762778,3578762791,13
1,1503,50003,3578762778,3578762791,13
1,1503,50004,3578762778,3578762792,14
1,1503,50005,3578762778,3578762793,15
1,1503,50006,3578762778,3578762794,16
1,1503,50007,3578762778,3578762794,16
1,1503,50008,3578762778,3578762795,17
1,1503,50009,3578762778,3578762796,18
1,1503,50010,3578762778,3578762796,18
1,1503,50011,3578762778,3578762796,18
1,1503,50012,3578762778,3578762796,18
1,1503,50013,3578762778,3578762797,19
1,1503,50014,3578762778,3578762798,20
1,1503,50015,3578762778,3578762799,21
1,1503,50016,3578762778,3578762799,21
1,1503,50017,3578762778,3578762800,22
1,1503,50018,3578762778,3578762802,24
1,1503,50019,3578762778,3578762804,26
1,1503,50020,3578762778,3578762805,27
1,1503,50021,3578762778,3578762806,28
1,1503,50022,3578762778,3578762809,31
1,1503,50023,3578762778,3578762810,32
1,1503,50024,3578762778,3578762811,33
1,1503,50025,3578762778,3578762812,34
1,1503,50026,3578762778,3578762813,35
1,1503,50027,3578762778,3578762814,36
1,1503,50028,3578762778,3578762814,36
1,1503,50029,3578762778,3578762816,38
1,1503,50030,3578762778,3578762816,38
1,1503,50031,3578762778,3578762816,38
1,1503,50032,3578762778,3578762816,38
1,1503,50033,3578762778,3578762817,39
1,1503,50034,3578762778,3578762817,39
1,1503,50035,3578762778,3578762817,39
1,1503,50036,3578762778,3578762817,39
1,1503,50037,3578762778,3578762817,39
1,1503,50038,3578762778,3578762818,40
1,1503,50039,3578762778,3578762818,40
1,1503,50040,3578762778,3578762819,41
1,1503,50041,3578762778,3578762822,44
1,1503,50042,3578762778,3578762824,46
1,1503,50043,3578762778,3578762824,46
1,1503,50044,3578762778,3578762826,48
1,1503,50045,3578762778,3578762826,48
1,1503,50046,3578762778,3578762827,49
1,1503,50047,3578762778,3578762828,50
1,1504,50048,3578762844,3578762844,0
1,1504,50049,3578762844,3578762845,1
1,1504,50050,3578762844,3578762845,1
1,1504,50051,3578762844,3578762845,1
1,1504,50052,3578762844,3578762845,1
1,1504,50053,3578762844,3578762845,1
1,1504,50054,3578762844,3578762845,1
1,1504,50055,3578762844,3578762845,1
1,1504,50056,3578762844,3578762845,1
1,1504,50057,3578762844,3578762845,1
1,1504,50058,3578762844,3578762845,1
1,1504,50059,3578762844,3578762845,1
1,1504,50060,3578762844,3578762845,1
1,1504,50061,3578762844,3578762847,3
1,1504,50062,3578762844,3578762848,4
1,1504,50063,3578762844,3578762849,5
1,1504,50064,3578762844,3578762851,7
1,1504,50065,3578762844,3578762852,8
1,1504,50066,3578762844,3578762853,9
1,1504,50067,3578762844,3578762854,10
1,1504,50068,3578762844,3578762854,10
1,1504,50069,3578762844,3578762857,13
1,1504,50070,3578762844,3578762857,13
1,1504,50071,3578762844,3578762858,14
1,1504,50072,3578762844,3578762860,16
1,1504,50073,3578762844,3578762860,16
1,1504,50074,3578762844,3578762862,18
1,1504,50075,3578762844,3578762864,20
1,1504,50076,3578762844,3578762864,20
1,1504,50077,3578762844,3578762867,23
1,1504,50078,3578762844,3578762867,23
1,1504,50079,3578762844,3578762868,24
1,1504,50080,3578762844,3578762880,36
1,1504,50081,3578762844,3578762881,37
1,1504,50082,3578762844,3578762883,39
1,1504,50083,3578762844,3578762885,41
1,1504,50084,3578762844,3578762885,41
1,1504,50085,3578762844,3578762885,41
1,1504,50086,3578762844,3578762886,42
1,1504,50087,3578762844,3578762887,43
1,1504,50088,3578762844,3578762887,43
1,1504,50089,3578762844,3578762889,45
1,1504,50090,3578762844,3578762890,46
1,1504,50091,3578762844,3578762890,46
1,1504,50092,3578762844,3578762892,48
1,1504,50093,3578762844,3578762893,49
1,1504,50094,3578762844,3578762893,49
1,1505,50095,3578762909,3578762909,0
1,1505,50096,3578762909,3578762909,0
1,1505,50097,3578762909,3578762909,0
1,1505,50098,3578762909,3578762909,0
1,1505,50099,3578762909,3578762909,0
1,1505,50100,3578762909,3578762909,0
1,1505,50101,3578762909,3578762909,0
1,1505,50102,3578762909,3578762909,0
1,1505,50103,3578762909,3578762909,0
1,1505,50104,3578762909,3578762909,0
1,1505,50105,3578762909,3578762909,0
1,1505,50106,3578762909,3578762909,0
1,1505,50107,3578762909,3578762909,0
1,1505,50108,3578762909,3578762909,0
1,1505,50109,3578762909,3578762909,0
1,1505,50110,3578762909,3578762909,0
1,1505,50111,3578762909,3578762909,0
1,1505,50112,3578762909,3578762909,0
1,1505,50113,3578762909,3578762909,0
1,1505,50114,3578762909,3578762909,0
1,1505,50115,3578762909,3578762909,0
1,1505,50116,3578762909,3578762909,0
1,1505,50117,3578762909,3578762909,0
1,1505,50118,3578762909,3578762909,0
1,1505,50119,3578762909,3578762909,0
1,1505,50120,3578762909,3578762910,1
1,1505,50121,3578762909,3578762910,1
1,1505,50122,3578762909,3578762910,1
1,1505,50123,3578762909,3578762910,1
1,1505,50124,3578762909,3578762911,2
1,1505,50125,3578762909,3578762912,3
1,1505,50126,3578762909,3578762912,3
1,1505,50127,3578762909,3578762912,3
1,1505,50128,3578762909,3578762912,3
1,1505,50129,3578762909,3578762913,4
1,1505,50130,3578762909,3578762914,5
1,1505,50131,3578762909,3578762914,5
1,1505,50132,3578762909,3578762914,5
1,1505,50133,3578762909,3578762916,7
1,1505,50134,3578762909,3578762918,9
1,1505,50135,3578762909,3578762918,9
1,1505,50136,3578762909,3578762919,10
1,1505,50137,3578762909,3578762920,11
1,1505,50138,3578762909,3578762921,12
1,1505,50139,3578762909,3578762921,12
1,1505,50140,3578762909,3578762921,12
1,1505,50141,3578762909,3578762921,12
1,1505,50142,3578762909,3578762922,13
1,1505,50143,3578762909,3578762923,14
1,1505,50144,3578762909,3578762925,16
1,1505,50145,3578762909,3578762925,16
1,1505,50146,3578762909,3578762925,16
1,1505,50147,3578762909,3578762925,16
1,1505,50148,3578762909,3578762926,17
1,1505,50149,3578762909,3578762926,17
1,1505,50150,3578762909,3578762927,18
1,1505,50151,3578762909,3578762928,19
1,1505,50152,3578762909,3578762928,19
1,1505,50153,3578762909,3578762930,21
1,1505,50154,3578762909,3578762931,22
1,1505,50155,3578762909,3578762933,24
1,1505,50156,3578762909,3578762933,24
1,1505,50157,3578762909,3578762934,25
1,1505,50158,3578762909,3578762935,26
1,1505,50159,3578762909,3578762935,26
1,1505,50160,3578762909,3578762937,28
1,1505,50161,3578762909,3578762937,28
1,1505,50162,3578762909,3578762937,28
1,1505,50163,3578762909,3578762938,29
1,1505,50164,3578762909,3578762940,31
1,1505,50165,3578762909,3578762941,32
1,1505,50166,3578762909,3578762944,35
1,1505,50167,3578762909,3578762946,37
1,1505,50168,3578762909,3578762947,38
1,1505,50169,3578762909,3578762948,39
1,1505,50170,3578762909,3578762948,39
1,1505,50171,3578762909,3578762948,39
1,1505,50172,3578762909,3578762950,41
1,1505,50173,3578762909,3578762953,44
1,1505,50174,3578762909,3578762955,46
1,1505,50175,3578762909,3578762955,46
1,1505,50176,3578762909,3578762955,46
1,1505,50177,3578762909,3578762956,47
1,1505,50178,3578762909,3578762957,48
1,1505,50179,3578762909,3578762958,49
1,1506,50180,3578762974,3578762974,0
1,1506,50181,3578762974,3578762974,0
1,1506,50182,3578762974,3578762974,0
1,1506,50183,3578762974,3578762974,0
1,1506,50184,3578762974,3578762974,0
1,1506,50185,3578762974,3578762974,0
1,1506,50186,3578762974,3578762974,0
1,1506,50187,3578762974,3578762974,0
1,1506,50188,3578762974,3578762974,0
1,1506,50189,3578762974,3578762974,0
1,1506,50190,3578762974,3578762974,0
1,1506,50191,3578762974,3578762974,0
1,1506,50192,3578762974,3578762974,0
1,1506,50193,3578762974,3578762974,0
1,1506,50194,3578762974,3578762974,0
1,1506,50195,3578762974,3578762974,0
1,1506,50196,3578762974,3578762975,1
1,1506,50197,3578762974,3578762977,3
1,1506,50198,3578762974,3578762978,4
1,1506,50199,3578762974,3578762978,4
1,1506,50200,3578762974,3578762978,4
1,1506,50201,3578762974,3578762979,5
1,1506,50202,3578762974,3578762980,6
1,1506,50203,3578762974,3578762980,6
1,1506,50204,3578762974,3578762981,7
1,1506,50205,3578762974,3578762981,7
1,1506,50206,3578762974,3578762981,7
1,1506,50207,3578762974,3578762982,8
1,1506,50208,3578762974,3578762985,11
1,1506,50209,3578762974,3578762985,11
1,1506,50210,3578762974,3578762989,15
1,1506,50211,3578762974,3578762991,17
1,1506,50212,3578762974,3578762992,18
1,1506,50213,3578762974,3578762992,18
1,1506,50214,3578762974,3578762992,18
1,1506,50215,3578762974,3578762994,20
1,1506,50216,3578762974,3578762995,21
1,1506,50217,3578762974,3578762996,22
1,1506,50218,3578762974,3578762996,22
1,1506,50219,3578762974,3578762996,22
1,1506,50220,3578762974,3578762997,23
1,1506,50221,3578762974,3578762998,24
1,1506,50222,3578762974,3578762999,25
1,1506,50223,3578762974,3578762999,25
1,1506,50224,3578762974,3578762999,25
1,1506,50225,3578762974,3578763000,26
1,1506,50226,3578762974,3578763001,27
1,1506,50227,3578762974,3578763002,28
1,1506,50228,3578762974,3578763005,31
1,1506,50229,3578762974,3578763005,31
1,1506,50230,3578762974,3578763009,35
1,1506,50231,3578762974,3578763010,36
1,1506,50232,3578762974,3578763012,38
1,1506,50233,3578762974,3578763012,38
1,1506,50234,3578762974,3578763013,39
1,1506,50235,3578762974,3578763014,40
1,1506,50236,3578762974,3578763015,41
1,1506,50237,3578762974,3578763016,42
1,1506,50238,3578762974,3578763016,42
1,1506,50239,3578762974,3578763016,42
1,1506,50240,3578762974,3578763016,42
1,1506,50241,3578762974,3578763016,42
1,1506,50242,3578762974,3578763017,43
1,1506,50243,3578762974,3578763017,43
1,1506,50244,3578762974,3578763017,43
1,1506,50245,3578762974,3578763018,44
1,1506,50246,3578762974,3578763018,44
1,1506,50247,3578762974,3578763018,44
1,1506,50248,3578762974,3578763019,45
1,1506,50249,3578762974,3578763022,48
1,1507,50250,3578763038,3578763038,0
1,1507,50251,3578763038,3578763038,0
1,1507,50252,3578763038,3578763038,0
1,1507,50253,3578763038,3578763038,0
1,1507,50254,3578763038,3578763038,0
1,1507,50255,3578763038,3578763038,0
1,1507,50256,3578763038,3578763038,0
1,1507,50257,3578763038,3578763038,0
1,1507,50258,3578763038,3578763038,0
1,1507,50259,3578763038,3578763038,0
1,1507,50260,3578763038,3578763038,0
1,1507,50261,3578763038,3578763038,0
1,1507,50262,3578763038,3578763038,0
1,1507,50263,3578763038,3578763038,0
1,1507,50264,3578763038,3578763040,2
1,1507,50265,3578763038,3578763041,3
1,1507,50266,3578763038,3578763041,3
1,1507,50267,3578763038,3578763047,9
1,1507,50268,3578763038,3578763048,10
1,1507,50269,3578763038,3578763049,11
1,1507,50270,3578763038,3578763051,13
1,1507,50271,3578763038,3578763052,14
1,1507,50272,3578763038,3578763053,15
1,1507,50273,3578763038,3578763054,16
1,1507,50274,3578763038,3578763055,17
1,1507,50275,3578763038,3578763057,19
1,1507,50276,3578763038,3578763057,19
1,1507,50277,3578763038,3578763057,19
1,1507,50278,3578763038,3578763059,21
1,1507,50279,3578763038,3578763060,22
1,1507,50280,3578763038,3578763061,23
1,1507,50281,3578763038,3578763063,25
1,1507,50282,3578763038,3578763064,26
1,1507,50283,3578763038,3578763065,27
1,1507,50284,3578763038,3578763067,29
1,1507,50285,3578763038,3578763067,29
1,1507,50286,3578763038,3578763080,42
1,1507,50287,3578763038,3578763082,44
1,1507,50288,3578763038,3578763082,44
1,1507,50289,3578763038,3578763082,44
1,1507,50290,3578763038,3578763083,45
1,1507,50291,3578763038,3578763085,47
1,1507,50292,3578763038,3578763085,47
1,1507,50293,3578763038,3578763085,47
1,1507,50294,3578763038,3578763086,48
1,1507,50295,3578763038,3578763086,48
1,1507,50296,3578763038,3578763086,48
1,1508,50297,3578763103,3578763103,0
1,1508,50298,3578763103,3578763103,0
1,1508,50299,3578763103,3578763103,0
1,1508,50300,3578763103,3578763103,0
1,1508,50301,3578763103,3578763103,0
1,1508,50302,3578763103,3578763103,0
1,1508,50303,3578763103,3578763103,0
1,1508,50304,3578763103,3578763103,0
1,1508,50305,3578763103,3578763103,0
1,1508,50306,3578763103,3578763103,0
1,1508,50307,3578763103,3578763103,0
1,1508,50308,3578763103,3578763103,0
1,1508,50309,3578763103,3578763103,0
1,1508,50310,3578763103,3578763103,0
1,1508,50311,3578763103,3578763103,0
1,1508,50312,3578763103,3578763103,0
1,1508,50313,3578763103,3578763103,0
1,1508,50314,3578763103,3578763103,0
1,1508,50315,3578763103,3578763104,1
1,1508,50316,3578763103,3578763105,2
1,1508,50317,3578763103,3578763105,2
1,1508,50318,3578763103,3578763107,4
1,1508,50319,3578763103,3578763107,4
1,1508,50320,3578763103,3578763108,5
1,1508,50321,3578763103,3578763108,5
1,1508,50322,3578763103,3578763108,5
1,1508,50323,3578763103,3578763109,6
1,1508,50324,3578763103,3578763109,6
1,1508,50325,3578763103,3578763109,6
1,1508,50326,3578763103,3578763110,7
1,1508,50327,3578763103,3578763110,7
1,1508,50328,3578763103,3578763110,7
1,1508,50329,3578763103,3578763111,8
1,1508,50330,3578763103,3578763112,9
1,1508,50331,3578763103,3578763112,9
1,1508,50332,3578763103,3578763113,10
1,1508,50333,3578763103,3578763113,10
1,1508,50334,3578763103,3578763114,11
1,1508,50335,3578763103,3578763114,11
1,1508,50336,3578763103,3578763115,12
1,1508,50337,3578763103,3578763118,15
1,1508,50338,3578763103,3578763118,15
1,1508,50339,3578763103,3578763119,16
1,1508,50340,3578763103,3578763121,18
1,1508,50341,3578763103,3578763121,18
1,1508,50342,3578763103,3578763121,18
1,1508,50343,3578763103,3578763121,18
1,1508,50344,3578763103,3578763121,18
1,1508,50345,3578763103,3578763122,19
1,1508,50346,3578763103,3578763123,20
1,1508,50347,3578763103,3578763124,21
1,1508,50348,3578763103,3578763124,21
1,1508,50349,3578763103,3578763126,23
1,1508,50350,3578763103,3578763126,23
1,1508,50351,3578763103,3578763126,23
1,1508,50352,3578763103,3578763127,24
1,1508,50353,3578763103,3578763127,24
1,1508,50354,3578763103,3578763128,25
1,1508,50355,3578763103,3578763131,28
1,1508,50356,3578763103,3578763132,29
1,1508,50357,3578763103,3578763133,30
1,1508,50358,3578763103,3578763134,31
1,1508,50359,3578763103,3578763135,32
1,1508,50360,3578763103,3578763135,32
1,1508,50361,3578763103,3578763137,34
1,1508,50362,3578763103,3578763137,34
1,1508,50363,3578763103,3578763138,35
1,1508,50364,3578763103,3578763138,35
1,1508,50365,3578763103,3578763140,37
1,1508,50366,3578763103,3578763141,38
1,1508,50367,3578763103,3578763141,38
1,1508,50368,3578763103,3578763144,41
1,1508,50369,3578763103,3578763147,44
1,1508,50370,3578763103,3578763148,45
1,1508,50371,3578763103,3578763148,45
1,1508,50372,3578763103,3578763149,46
1,1508,50373,3578763103,3578763150,47
1,1509,50374,3578763168,3578763168,0
1,1509,50375,3578763168,3578763168,0
1,1509,50376,3578763168,3578763168,0
1,1509,50377,3578763168,3578763168,0
1,1509,50378,3578763168,3578763168,0
1,1509,50379,3578763168,3578763168,0
1,1509,50380,3578763168,3578763168,0
1,1509,50381,3578763168,3578763168,0
1,1509,50382,3578763168,3578763168,0
1,1509,50383,3578763168,3578763168,0
1,1509,50384,3578763168,3578763168,0
1,1509,50385,3578763168,3578763168,0
1,1509,50386,3578763168,3578763168,0
1,1509,50387,3578763168,3578763168,0
1,1509,50388,3578763168,3578763169,1
1,1509,50389,3578763168,3578763169,1
1,1509,50390,3578763168,3578763171,3
1,1509,50391,3578763168,3578763173,5
1,1509,50392,3578763168,3578763174,6
1,1509,50393,3578763168,3578763176,8
1,1509,50394,3578763168,3578763177,9
1,1509,50395,3578763168,3578763178,10
1,1509,50396,3578763168,3578763178,10
1,1509,50397,3578763168,3578763179,11
1,1509,50398,3578763168,3578763180,12
1,1509,50399,3578763168,3578763180,12
1,1509,50400,3578763168,3578763180,12
1,1509,50401,3578763168,3578763181,13
1,1509,50402,3578763168,3578763181,13
1,1509,50403,3578763168,3578763181,13
1,1509,50404,3578763168,3578763181,13
1,1509,50405,3578763168,3578763182,14
1,1509,50406,3578763168,3578763185,17
1,1509,50407,3578763168,3578763186,18
1,1509,50408,3578763168,3578763188,20
1,1509,50409,3578763168,3578763191,23
1,1509,50410,3578763168,3578763192,24
1,1509,50411,3578763168,3578763192,24
1,1509,50412,3578763168,3578763194,26
1,1509,50413,3578763168,3578763194,26
1,1509,50414,3578763168,3578763195,27
1,1509,50415,3578763168,3578763195,27
1,1509,50416,3578763168,3578763196,28
1,1509,50417,3578763168,3578763196,28
1,1509,50418,3578763168,3578763196,28
1,1509,50419,3578763168,3578763197,29
1,1509,50420,3578763168,3578763198,30
1,1509,50421,3578763168,3578763199,31
1,1509,50422,3578763168,3578763199,31
1,1509,50423,3578763168,3578763200,32
1,1509,50424,3578763168,3578763201,33
1,1509,50425,3578763168,3578763201,33
1,1509,50426,3578763168,3578763203,35
1,1509,50427,3578763168,3578763206,38
1,1509,50428,3578763168,3578763206,38
1,1509,50429,3578763168,3578763209,41
1,1509,50430,3578763168,3578763210,42
1,1509,50431,3578763168,3578763212,44
1,1509,50432,3578763168,3578763213,45
1,1509,50433,3578763168,3578763213,45
1,1509,50434,3578763168,3578763215,47
1,1509,50435,3578763168,3578763215,47
1,1509,50436,3578763168,3578763216,48
1,1509,50437,3578763168,3578763216,48
1,1509,50438,3578763168,3578763216,48
1,1509,50439,3578763168,3578763216,48
1,1509,50440,3578763168,3578763217,49
1,1509,50441,3578763168,3578763217,49
1,1509,50442,3578763168,3578763217,49
1,1509,50443,3578763168,3578763218,50
1,1509,50444,3578763168,3578763218,50
1,1510,50445,3578763234,3578763234,0
1,1510,50446,3578763234,3578763234,0
1,1510,50447,3578763234,3578763234,0
1,1510,50448,3578763234,3578763234,0
1,1510,50449,3578763234,3578763234,0
1,1510,50450,3578763234,3578763234,0
1,1510,50451,3578763234,3578763234,0
1,1510,50452,3578763234,3578763234,0
1,1510,50453,3578763234,3578763234,0
1,1510,50454,3578763234,3578763234,0
1,1510,50455,3578763234,3578763234,0
1,1510,50456,3578763234,3578763234,0
1,1510,50457,3578763234,3578763234,0
1,1510,50458,3578763234,3578763234,0
1,1510,50459,3578763234,3578763234,0
1,1510,50460,3578763234,3578763235,1
1,1510,50461,3578763234,3578763237,3
1,1510,50462,3578763234,3578763237,3
1,1510,50463,3578763234,3578763238,4
1,1510,50464,3578763234,3578763240,6
1,1510,50465,3578763234,3578763241,7
1,1510,50466,3578763234,3578763242,8
1,1510,50467,3578763234,3578763248,14
1,1510,50468,3578763234,3578763249,15
1,1510,50469,3578763234,3578763252,18
1,1510,50470,3578763234,3578763253,19
1,1510,50471,3578763234,3578763254,20
1,1510,50472,3578763234,3578763254,20
1,1510,50473,3578763234,3578763254,20
1,1510,50474,3578763234,3578763257,23
1,1510,50475,3578763234,3578763257,23
1,1510,50476,3578763234,3578763257,23
1,1510,50477,3578763234,3578763259,25
1,1510,50478,3578763234,3578763259,25
1,1510,50479,3578763234,3578763261,27
1,1510,50480,3578763234,3578763263,29
1,1510,50481,3578763234,3578763265,31
1,1510,50482,3578763234,3578763269,35
1,1510,50483,3578763234,3578763281,47
1,1510,50484,3578763234,3578763282,48
1,1510,50485,3578763234,3578763283,49
1,1511,50486,3578763298,3578763298,0
1,1511,50487,3578763298,3578763298,0
1,1511,50488,3578763298,3578763298,0
1,1511,50489,3578763298,3578763298,0
1,1511,50490,3578763298,3578763298,0
1,1511,50491,3578763298,3578763298,0
1,1511,50492,3578763298,3578763298,0
1,1511,50493,3578763298,3578763298,0
1,1511,50494,3578763298,3578763298,0
1,1511,50495,3578763298,3578763298,0
1,1511,50496,3578763298,3578763298,0
1,1511,50497,3578763298,3578763298,0
1,1511,50498,3578763298,3578763298,0
1,1511,50499,3578763298,3578763298,0
1,1511,50500,3578763298,3578763298,0
1,1511,50501,3578763298,3578763298,0
1,1511,50502,3578763298,3578763298,0
1,1511,50503,3578763298,3578763298,0
1,1511,50504,3578763298,3578763298,0
1,1511,50505,3578763298,3578763298,0
1,1511,50506,3578763298,3578763299,1
1,1511,50507,3578763298,3578763299,1
1,1511,50508,3578763298,3578763299,1
1,1511,50509,3578763298,3578763302,4
1,1511,50510,3578763298,3578763303,5
1,1511,50511,3578763298,3578763303,5
1,1511,50512,3578763298,3578763303,5
1,1511,50513,3578763298,3578763303,5
1,1511,50514,3578763298,3578763304,6
1,1511,50515,3578763298,3578763305,7
1,1511,50516,3578763298,3578763305,7
1,1511,50517,3578763298,3578763305,7
1,1511,50518,3578763298,3578763305,7
1,1511,50519,3578763298,3578763307,9
1,1511,50520,3578763298,3578763307,9
1,1511,50521,3578763298,3578763309,11
1,1511,50522,3578763298,3578763309,11
1,1511,50523,3578763298,3578763309,11
1,1511,50524,3578763298,3578763309,11
1,1511,50525,3578763298,3578763310,12
1,1511,50526,3578763298,3578763310,12
1,1511,50527,3578763298,3578763310,12
1,1511,50528,3578763298,3578763310,12
1,1511,50529,3578763298,3578763311,13
1,1511,50530,3578763298,3578763312,14
1,1511,50531,3578763298,3578763313,15
1,1511,50532,3578763298,3578763313,15
1,1511,50533,3578763298,3578763313,15
1,1511,50534,3578763298,3578763314,16
1,1511,50535,3578763298,3578763315,17
1,1511,50536,3578763298,3578763318,20
1,1511,50537,3578763298,3578763319,21
1,1511,50538,3578763298,3578763319,21
1,1511,50539,3578763298,3578763320,22
1,1511,50540,3578763298,3578763320,22
1,1511,50541,3578763298,3578763321,23
1,1511,50542,3578763298,3578763321,23
1,1511,50543,3578763298,3578763321,23
1,1511,50544,3578763298,3578763322,24
1,1511,50545,3578763298,3578763322,24
1,1511,50546,3578763298,3578763324,26
1,1511,50547,3578763298,3578763325,27
1,1511,50548,3578763298,3578763325,27
1,1511,50549,3578763298,3578763326,28
1,1511,50550,3578763298,3578763326,28
1,1511,50551,3578763298,3578763327,29
1,1511,50552,3578763298,3578763327,29
1,1511,50553,3578763298,3578763328,30
1,1511,50554,3578763298,3578763331,33
1,1511,50555,3578763298,3578763332,34
1,1511,50556,3578763298,3578763334,36
1,1511,50557,3578763298,3578763335,37
1,1511,50558,3578763298,3578763337,39
1,1511,50559,3578763298,3578763337,39
1,1511,50560,3578763298,3578763337,39
1,1511,50561,3578763298,3578763337,39
1,1511,50562,3578763298,3578763338,40
1,1511,50563,3578763298,3578763340,42
1,1511,50564,3578763298,3578763341,43
1,1511,50565,3578763298,3578763341,43
1,1511,50566,3578763298,3578763344,46
1,1511,50567,3578763298,3578763346,48
1,1511,50568,3578763298,3578763347,49
1,1511,50569,3578763298,3578763348,50
1,1512,50570,3578763362,3578763362,0
1,1512,50571,3578763362,3578763362,0
1,1512,50572,3578763362,3578763362,0
1,1512,50573,3578763362,3578763362,0
1,1512,50574,3578763362,3578763362,0
1,1512,50575,3578763362,3578763362,0
1,1512,50576,3578763362,3578763362,0
1,1512,50577,3578763362,3578763362,0
1,1512,50578,3578763362,3578763362,0
1,1512,50579,3578763362,3578763363,1
1,1512,50580,3578763362,3578763364,2
1,1512,50581,3578763362,3578763364,2
1,1512,50582,3578763362,3578763365,3
1,1512,50583,3578763362,3578763365,3
1,1512,50584,3578763362,3578763366,4
1,1512,50585,3578763362,3578763366,4
1,1512,50586,3578763362,3578763366,4
1,1512,50587,3578763362,3578763367,5
1,1512,50588,3578763362,3578763368,6
1,1512,50589,3578763362,3578763368,6
1,1512,50590,3578763362,3578763369,7
1,1512,50591,3578763362,3578763369,7
1,1512,50592,3578763362,3578763370,8
1,1512,50593,3578763362,3578763371,9
1,1512,50594,3578763362,3578763373,11
1,1512,50595,3578763362,3578763376,14
1,1512,50596,3578763362,3578763376,14
1,1512,50597,3578763362,3578763376,14
1,1512,50598,3578763362,3578763378,16
1,1512,50599,3578763362,3578763380,18
1,1512,50600,3578763362,3578763380,18
1,1512,50601,3578763362,3578763381,19
1,1512,50602,3578763362,3578763381,19
1,1512,50603,3578763362,3578763382,20
1,1512,50604,3578763362,3578763382,20
1,1512,50605,3578763362,3578763382,20
1,1512,50606,3578763362,3578763385,23
1,1512,50607,3578763362,3578763386,24
1,1512,50608,3578763362,3578763388,26
1,1512,50609,3578763362,3578763392,30
1,1512,50610,3578763362,3578763392,30
1,1512,50611,3578763362,3578763393,31
1,1512,50612,3578763362,3578763393,31
1,1512,50613,3578763362,3578763394,32
1,1512,50614,3578763362,3578763394,32
1,1512,50615,3578763362,3578763395,33
1,1512,50616,3578763362,3578763396,34
1,1512,50617,3578763362,3578763396,34
1,1512,50618,3578763362,3578763396,34
1,1512,50619,3578763362,3578763397,35
1,1512,50620,3578763362,3578763397,35
1,1512,50621,3578763362,3578763398,36
1,1512,50622,3578763362,3578763399,37
1,1512,50623,3578763362,3578763399,37
1,1512,50624,3578763362,3578763400,38
1,1512,50625,3578763362,3578763401,39
1,1512,50626,3578763362,3578763401,39
1,1512,50627,3578763362,3578763402,40
1,1512,50628,3578763362,3578763406,44
1,1512,50629,3578763362,3578763406,44
1,1512,50630,3578763362,3578763410,48
1,1512,50631,3578763362,3578763410,48
1,1512,50632,3578763362,3578763412,50
1,1513,50633,3578763425,3578763425,0
1,1513,50634,3578763425,3578763425,0
1,1513,50635,3578763425,3578763425,0
1,1513,50636,3578763425,3578763425,0
1,1513,50637,3578763425,3578763425,0
1,1513,50638,3578763425,3578763425,0
1,1513,50639,3578763425,3578763425,0
1,1513,50640,3578763425,3578763425,0
1,1513,50641,3578763425,3578763426,1
1,1513,50642,3578763425,3578763426,1
1,1513,50643,3578763425,3578763426,1
1,1513,50644,3578763425,3578763426,1
1,1513,50645,3578763425,3578763426,1
1,1513,50646,3578763425,3578763426,1
1,1513,50647,3578763425,3578763426,1
1,1513,50648,3578763425,3578763426,1
1,1513,50649,3578763425,3578763426,1
1,1513,50650,3578763425,3578763426,1
1,1513,50651,3578763425,3578763426,1
1,1513,50652,3578763425,3578763427,2
1,1513,50653,3578763425,3578763427,2
1,1513,50654,3578763425,3578763429,4
1,1513,50655,3578763425,3578763429,4
1,1513,50656,3578763425,3578763430,5
1,1513,50657,3578763425,3578763430,5
1,1513,50658,3578763425,3578763432,7
1,1513,50659,3578763425,3578763435,10
1,1513,50660,3578763425,3578763436,11
1,1513,50661,3578763425,3578763437,12
1,1513,50662,3578763425,3578763438,13
1,1513,50663,3578763425,3578763440,15
1,1513,50664,3578763425,3578763441,16
1,1513,50665,3578763425,3578763442,17
1,1513,50666,3578763425,3578763447,22
1,1513,50667,3578763425,3578763450,25
1,1513,50668,3578763425,3578763453,28
1,1513,50669,3578763425,3578763453,28
1,1513,50670,3578763425,3578763454,29
1,1513,50671,3578763425,3578763455,30
1,1513,50672,3578763425,3578763456,31
1,1513,50673,3578763425,3578763457,32
1,1513,50674,3578763425,3578763457,32
1,1513,50675,3578763425,3578763457,32
1,1513,50676,3578763425,3578763459,34
1,1513,50677,3578763425,3578763460,35
1,1513,50678,3578763425,3578763462,37
1,1513,50679,3578763425,3578763463,38
1,1513,50680,3578763425,3578763465,40
1,1513,50681,3578763425,3578763467,42
1,1513,50682,3578763425,3578763468,43
1,1514,50683,3578763490,3578763490,0
1,1514,50684,3578763490,3578763490,0
1,1514,50685,3578763490,3578763490,0
1,1514,50686,3578763490,3578763490,0
1,1514,50687,3578763490,3578763490,0
1,1514,50688,3578763490,3578763490,0
1,1514,50689,3578763490,3578763490,0
1,1514,50690,3578763490,3578763490,0
1,1514,50691,3578763490,3578763490,0
1,1514,50692,3578763490,3578763490,0
1,1514,50693,3578763490,3578763490,0
1,1514,50694,3578763490,3578763490,0
1,1514,50695,3578763490,3578763491,1
1,1514,50696,3578763490,3578763492,2
1,1514,50697,3578763490,3578763493,3
1,1514,50698,3578763490,3578763494,4
1,1514,50699,3578763490,3578763495,5
1,1514,50700,3578763490,3578763495,5
1,1514,50701,3578763490,3578763495,5
1,1514,50702,3578763490,3578763496,6
1,1514,50703,3578763490,3578763496,6
1,1514,50704,3578763490,3578763497,7
1,1514,50705,3578763490,3578763498,8
1,1514,50706,3578763490,3578763498,8
1,1514,50707,3578763490,3578763499,9
1,1514,50708,3578763490,3578763502,12
1,1514,50709,3578763490,3578763502,12
1,1514,50710,3578763490,3578763502,12
1,1514,50711,3578763490,3578763502,12
1,1514,50712,3578763490,3578763502,12
1,1514,50713,3578763490,3578763503,13
1,1514,50714,3578763490,3578763504,14
1,1514,50715,3578763490,3578763504,14
1,1514,50716,3578763490,3578763504,14
1,1514,50717,3578763490,3578763506,16
1,1514,50718,3578763490,3578763506,16
1,1514,50719,3578763490,3578763508,18
1,1514,50720,3578763490,3578763508,18
1,1514,50721,3578763490,3578763508,18
1,1514,50722,3578763490,3578763508,18
1,1514,50723,3578763490,3578763509,19
1,1514,50724,3578763490,3578763509,19
1,1514,50725,3578763490,3578763509,19
1,1514,50726,3578763490,3578763510,20
1,1514,50727,3578763490,3578763512,22
1,1514,50728,3578763490,3578763512,22
1,1514,50729,3578763490,3578763512,22
1,1514,50730,3578763490,3578763513,23
1,1514,50731,3578763490,3578763513,23
1,1514,50732,3578763490,3578763514,24
1,1514,50733,3578763490,3578763518,28
1,1514,50734,3578763490,3578763519,29
1,1514,50735,3578763490,3578763519,29
1,1514,50736,3578763490,3578763520,30
1,1514,50737,3578763490,3578763520,30
1,1514,50738,3578763490,3578763520,30
1,1514,50739,3578763490,3578763520,30
1,1514,50740,3578763490,3578763521,31
1,1514,50741,3578763490,3578763521,31
1,1514,50742,3578763490,3578763522,32
1,1514,50743,3578763490,3578763522,32
1,1514,50744,3578763490,3578763524,34
1,1514,50745,3578763490,3578763524,34
1,1514,50746,3578763490,3578763524,34
1,1514,50747,3578763490,3578763525,35
1,1514,50748,3578763490,3578763525,35
1,1514,50749,3578763490,3578763526,36
1,1514,50750,3578763490,3578763527,37
1,1514,50751,3578763490,3578763527,37
1,1514,50752,3578763490,3578763530,40
1,1514,50753,3578763490,3578763531,41
1,1514,50754,3578763490,3578763532,42
1,1514,50755,3578763490,3578763532,42
1,1514,50756,3578763490,3578763533,43
1,1514,50757,3578763490,3578763534,44
1,1514,50758,3578763490,3578763534,44
1,1514,50759,3578763490,3578763535,45
1,1514,50760,3578763490,3578763536,46
1,1514,50761,3578763490,3578763536,46
1,1514,50762,3578763490,3578763537,47
1,1514,50763,3578763490,3578763537,47
1,1514,50764,3578763490,3578763540,50
1,1515,50765,3578763555,3578763555,0
1,1515,50766,3578763555,3578763555,0
1,1515,50767,3578763555,3578763555,0
1,1515,50768,3578763555,3578763555,0
1,1515,50769,3578763555,3578763555,0
1,1515,50770,3578763555,3578763555,0
1,1515,50771,3578763555,3578763555,0
1,1515,50772,3578763555,3578763555,0
1,1515,50773,3578763555,3578763555,0
1,1515,50774,3578763555,3578763555,0
1,1515,50775,3578763555,3578763555,0
1,1515,50776,3578763555,3578763555,0
1,1515,50777,3578763555,3578763555,0
1,1515,50778,3578763555,3578763556,1
1,1515,50779,3578763555,3578763557,2
1,1515,50780,3578763555,3578763558,3
1,1515,50781,3578763555,3578763562,7
1,1515,50782,3578763555,3578763563,8
1,1515,50783,3578763555,3578763563,8
1,1515,50784,3578763555,3578763564,9
1,1515,50785,3578763555,3578763564,9
1,1515,50786,3578763555,3578763565,10
1,1515,50787,3578763555,3578763565,10
1,1515,50788,3578763555,3578763566,11
1,1515,50789,3578763555,3578763566,11
1,1515,50790,3578763555,3578763567,12
1,1515,50791,3578763555,3578763567,12
1,1515,50792,3578763555,3578763567,12
1,1515,50793,3578763555,3578763568,13
1,1515,50794,3578763555,3578763569,14
1,1515,50795,3578763555,3578763571,16
1,1515,50796,3578763555,3578763572,17
1,1515,50797,3578763555,3578763574,19
1,1515,50798,3578763555,3578763575,20
1,1515,50799,3578763555,3578763575,20
1,1515,50800,3578763555,3578763577,22
1,1515,50801,3578763555,3578763578,23
1,1515,50802,3578763555,3578763579,24
1,1515,50803,3578763555,3578763580,25
1,1515,50804,3578763555,3578763580,25
1,1515,50805,3578763555,3578763581,26
1,1515,50806,3578763555,3578763581,26
1,1515,50807,3578763555,3578763582,27
1,1515,50808,3578763555,3578763584,29
1,1515,50809,3578763555,3578763585,30
1,1515,50810,3578763555,3578763588,33
1,1515,50811,3578763555,3578763591,36
1,1515,50812,3578763555,3578763591,36
1,1515,50813,3578763555,3578763592,37
1,1515,50814,3578763555,3578763592,37
1,1515,50815,3578763555,3578763593,38
1,1515,50816,3578763555,3578763593,38
1,1515,50817,3578763555,3578763594,39
1,1515,50818,3578763555,3578763595,40
1,1515,50819,3578763555,3578763595,40
1,1515,50820,3578763555,3578763596,41
1,1515,50821,3578763555,3578763596,41
1,1515,50822,3578763555,3578763596,41
1,1515,50823,3578763555,3578763597,42
1,1515,50824,3578763555,3578763598,43
1,1515,50825,3578763555,3578763599,44
1,1515,50826,3578763555,3578763599,44
1,1515,50827,3578763555,3578763600,45
1,1515,50828,3578763555,3578763601,46
1,1515,50829,3578763555,3578763605,50
1,1516,50830,3578763619,3578763619,0
1,1516,50831,3578763619,3578763619,0
1,1516,50832,3578763619,3578763619,0
1,1516,50833,3578763619,3578763619,0
1,1516,50834,3578763619,3578763619,0
1,1516,50835,3578763619,3578763619,0
1,1516,50836,3578763619,3578763619,0
1,1516,50837,3578763619,3578763619,0
1,1516,50838,3578763619,3578763619,0
1,1516,50839,3578763619,3578763619,0
1,1516,50840,3578763619,3578763619,0
1,1516,50841,3578763619,3578763619,0
1,1516,50842,3578763619,3578763619,0
1,1516,50843,3578763619,3578763619,0
1,1516,50844,3578763619,3578763619,0
1,1516,50845,3578763619,3578763619,0
1,1516,50846,3578763619,3578763619,0
1,1516,50847,3578763619,3578763619,0
1,1516,50848,3578763619,3578763620,1
1,1516,50849,3578763619,3578763623,4
1,1516,50850,3578763619,3578763624,5
1,1516,50851,3578763619,3578763625,6
1,1516,50852,3578763619,3578763626,7
1,1516,50853,3578763619,3578763627,8
1,1516,50854,3578763619,3578763628,9
1,1516,50855,3578763619,3578763628,9
1,1516,50856,3578763619,3578763630,11
1,1516,50857,3578763619,3578763630,11
1,1516,50858,3578763619,3578763631,12
1,1516,50859,3578763619,3578763635,16
1,1516,50860,3578763619,3578763636,17
1,1516,50861,3578763619,3578763636,17
1,1516,50862,3578763619,3578763636,17
1,1516,50863,3578763619,3578763637,18
1,1516,50864,3578763619,3578763639,20
1,1516,50865,3578763619,3578763641,22
1,1516,50866,3578763619,3578763641,22
1,1516,50867,3578763619,3578763646,27
1,1516,50868,3578763619,3578763647,28
1,1516,50869,3578763619,3578763648,29
1,1516,50870,3578763619,3578763651,32
1,1516,50871,3578763619,3578763652,33
1,1516,50872,3578763619,3578763653,34
1,1516,50873,3578763619,3578763653,34
1,1516,50874,3578763619,3578763654,35
1,1516,50875,3578763619,3578763655,36
1,1516,50876,3578763619,3578763656,37
1,1516,50877,3578763619,3578763657,38
1,1516,50878,3578763619,3578763657,38
1,1516,50879,3578763619,3578763657,38
1,1516,50880,3578763619,3578763658,39
1,1516,50881,3578763619,3578763658,39
1,1516,50882,3578763619,3578763661,42
1,1516,50883,3578763619,3578763664,45
1,1516,50884,3578763619,3578763667,48
1,1516,50885,3578763619,3578763668,49
1,1517,50886,3578763683,3578763683,0
1,1517,50887,3578763683,3578763683,0
1,1517,50888,3578763683,3578763683,0
1,1517,50889,3578763683,3578763683,0
1,1517,50890,3578763683,3578763683,0
1,1517,50891,3578763683,3578763683,0
1,1517,50892,3578763683,3578763684,1
1,1517,50893,3578763683,3578763684,1
1,1517,50894,3578763683,3578763685,2
1,1517,50895,3578763683,3578763685,2
1,1517,50896,3578763683,3578763686,3
1,1517,50897,3578763683,3578763688,5
1,1517,50898,3578763683,3578763690,7
1,1517,50899,3578763683,3578763691,8
1,1517,50900,3578763683,3578763692,9
1,1517,50901,3578763683,3578763692,9
1,1517,50902,3578763683,3578763693,10
1,1517,50903,3578763683,3578763695,12
1,1517,50904,3578763683,3578763696,13
1,1517,50905,3578763683,3578763696,13
1,1517,50906,3578763683,3578763696,13
1,1517,50907,3578763683,3578763697,14
1,1517,50908,3578763683,3578763697,14
1,1517,50909,3578763683,3578763698,15
1,1517,50910,3578763683,3578763698,15
1,1517,50911,3578763683,3578763699,16
1,1517,50912,3578763683,3578763701,18
1,1517,50913,3578763683,3578763701,18
1,1517,50914,3578763683,3578763702,19
1,1517,50915,3578763683,3578763702,19
1,1517,50916,3578763683,3578763702,19
1,1517,50917,3578763683,3578763702,19
1,1517,50918,3578763683,3578763704,21
1,1517,50919,3578763683,3578763704,21
1,1517,50920,3578763683,3578763704,21
1,1517,50921,3578763683,3578763704,21
1,1517,50922,3578763683,3578763706,23
1,1517,50923,3578763683,3578763706,23
1,1517,50924,3578763683,3578763708,25
1,1517,50925,3578763683,3578763708,25
1,1517,50926,3578763683,3578763708,25
1,1517,50927,3578763683,3578763709,26
1,1517,50928,3578763683,3578763709,26
1,1517,50929,3578763683,3578763709,26
1,1517,50930,3578763683,3578763709,26
1,1517,50931,3578763683,3578763709,26
1,1517,50932,3578763683,3578763710,27
1,1517,50933,3578763683,3578763712,29
1,1517,50934,3578763683,3578763712,29
1,1517,50935,3578763683,3578763713,30
1,1517,50936,3578763683,3578763713,30
1,1517,50937,3578763683,3578763714,31
1,1517,50938,3578763683,3578763714,31
1,1517,50939,3578763683,3578763716,33
1,1517,50940,3578763683,3578763717,34
1,1517,50941,3578763683,3578763719,36
1,1517,50942,3578763683,3578763720,37
1,1517,50943,3578763683,3578763720,37
1,1517,50944,3578763683,3578763720,37
1,1517,50945,3578763683,3578763720,37
1,1517,50946,3578763683,3578763721,38
1,1517,50947,3578763683,3578763721,38
1,1517,50948,3578763683,3578763721,38
1,1517,50949,3578763683,3578763722,39
1,1517,50950,3578763683,3578763723,40
1,1517,50951,3578763683,3578763723,40
1,1517,50952,3578763683,3578763725,42
1,1517,50953,3578763683,3578763725,42
1,1517,50954,3578763683,3578763725,42
1,1517,50955,3578763683,3578763725,42
1,1517,50956,3578763683,3578763726,43
1,1517,50957,3578763683,3578763727,44
1,1517,50958,3578763683,3578763729,46
1,1517,50959,3578763683,3578763729,46
1,1517,50960,3578763683,3578763730,47
1,1517,50961,3578763683,3578763731,48
1,1517,50962,3578763683,3578763732,49
1,1518,50963,3578763747,3578763747,0
1,1518,50964,3578763747,3578763747,0
1,1518,50965,3578763747,3578763747,0
1,1518,50966,3578763747,3578763747,0
1,1518,50967,3578763747,3578763747,0
1,1518,50968,3578763747,3578763747,0
1,1518,50969,3578763747,3578763747,0
1,1518,50970,3578763747,3578763747,0
1,1518,50971,3578763747,3578763747,0
1,1518,50972,3578763747,3578763747,0
1,1518,50973,3578763747,3578763747,0
1,1518,50974,3578763747,3578763747,0
1,1518,50975,3578763747,3578763747,0
1,1518,50976,3578763747,3578763748,1
1,1518,50977,3578763747,3578763748,1
1,1518,50978,3578763747,3578763748,1
1,1518,50979,3578763747,3578763749,2
1,1518,50980,3578763747,3578763753,6
1,1518,50981,3578763747,3578763753,6
1,1518,50982,3578763747,3578763754,7
1,1518,50983,3578763747,3578763755,8
1,1518,50984,3578763747,3578763755,8
1,1518,50985,3578763747,3578763755,8
1,1518,50986,3578763747,3578763755,8
1,1518,50987,3578763747,3578763758,11
1,1518,50988,3578763747,3578763758,11
1,1518,50989,3578763747,3578763762,15
1,1518,50990,3578763747,3578763762,15
1,1518,50991,3578763747,3578763763,16
1,1518,50992,3578763747,3578763764,17
1,1518,50993,3578763747,3578763764,17
1,1518,50994,3578763747,3578763765,18
1,1518,50995,3578763747,3578763765,18
1,1518,50996,3578763747,3578763766,19
1,1518,50997,3578763747,3578763766,19
1,1518,50998,3578763747,3578763767,20
1,1518,50999,3578763747,3578763767,20
1,1518,51000,3578763747,3578763768,21
1,1518,51001,3578763747,3578763768,21
1,1518,51002,3578763747,3578763769,22
1,1518,51003,3578763747,3578763771,24
1,1518,51004,3578763747,3578763771,24
1,1518,51005,3578763747,3578763774,27
1,1518,51006,3578763747,3578763775,28
1,1518,51007,3578763747,3578763776,29
1,1518,51008,3578763747,3578763778,31
1,1518,51009,3578763747,3578763778,31
1,1518,51010,3578763747,3578763779,32
1,1518,51011,3578763747,3578763780,33
1,1518,51012,3578763747,3578763781,34
1,1518,51013,3578763747,3578763781,34
1,1518,51014,3578763747,3578763781,34
1,1518,51015,3578763747,3578763781,34
1,1518,51016,3578763747,3578763781,34
1,1518,51017,3578763747,3578763784,37
1,1518,51018,3578763747,3578763789,42
1,1518,51019,3578763747,3578763791,44
1,1518,51020,3578763747,3578763792,45
1,1518,51021,3578763747,3578763792,45
1,1518,51022,3578763747,3578763793,46
1,1518,51023,3578763747,3578763793,46
1,1518,51024,3578763747,3578763794,47
1,1518,51025,3578763747,3578763794,47
1,1518,51026,3578763747,3578763796,49
1,1518,51027,3578763747,3578763796,49
1,1518,51028,3578763747,3578763796,49
1,1518,51029,3578763747,3578763796,49
1,1518,51030,3578763747,3578763797,50
1,1519,51031,3578763812,3578763812,0
1,1519,51032,3578763812,3578763812,0
1,1519,51033,3578763812,3578763812,0
1,1519,51034,3578763812,3578763812,0
1,1519,51035,3578763812,3578763812,0
1,1519,51036,3578763812,3578763812,0
1,1519,51037,3578763812,3578763812,0
1,1519,51038,3578763812,3578763812,0
1,1519,51039,3578763812,3578763812,0
1,1519,51040,3578763812,3578763812,0
1,1519,51041,3578763812,3578763812,0
1,1519,51042,3578763812,3578763812,0
1,1519,51043,3578763812,3578763813,1
1,1519,51044,3578763812,3578763813,1
1,1519,51045,3578763812,3578763813,1
1,1519,51046,3578763812,3578763813,1
1,1519,51047,3578763812,3578763815,3
1,1519,51048,3578763812,3578763815,3
1,1519,51049,3578763812,3578763816,4
1,1519,51050,3578763812,3578763816,4
1,1519,51051,3578763812,3578763816,4
1,1519,51052,3578763812,3578763817,5
1,1519,51053,3578763812,3578763817,5
1,1519,51054,3578763812,3578763818,6
1,1519,51055,3578763812,3578763819,7
1,1519,51056,3578763812,3578763819,7
1,1519,51057,3578763812,3578763819,7
1,1519,51058,3578763812,3578763822,10
1,1519,51059,3578763812,3578763823,11
1,1519,51060,3578763812,3578763824,12
1,1519,51061,3578763812,3578763824,12
1,1519,51062,3578763812,3578763826,14
1,1519,51063,3578763812,3578763826,14
1,1519,51064,3578763812,3578763827,15
1,1519,51065,3578763812,3578763828,16
1,1519,51066,3578763812,3578763829,17
1,1519,51067,3578763812,3578763829,17
1,1519,51068,3578763812,3578763830,18
1,1519,51069,3578763812,3578763831,19
1,1519,51070,3578763812,3578763834,22
1,1519,51071,3578763812,3578763835,23
1,1519,51072,3578763812,3578763836,24
1,1519,51073,3578763812,3578763836,24
1,1519,51074,3578763812,3578763836,24
1,1519,51075,3578763812,3578763837,25
1,1519,51076,3578763812,3578763839,27
1,1519,51077,3578763812,3578763840,28
1,1519,51078,3578763812,3578763841,29
1,1519,51079,3578763812,3578763847,35
1,1519,51080,3578763812,3578763848,36
1,1519,51081,3578763812,3578763849,37
1,1519,51082,3578763812,3578763851,39
1,1519,51083,3578763812,3578763852,40
1,1519,51084,3578763812,3578763853,41
1,1519,51085,3578763812,3578763853,41
1,1519,51086,3578763812,3578763854,42
1,1519,51087,3578763812,3578763854,42
1,1519,51088,3578763812,3578763857,45
1,1519,51089,3578763812,3578763857,45
1,1519,51090,3578763812,3578763857,45
1,1519,51091,3578763812,3578763858,46
1,1519,51092,3578763812,3578763859,47
1,1519,51093,3578763812,3578763859,47
1,1519,51094,3578763812,3578763860,48
1,1520,51095,3578763876,3578763876,0
1,1520,51096,3578763876,3578763876,0
1,1520,51097,3578763876,3578763876,0
1,1520,51098,3578763876,3578763876,0
1,1520,51099,3578763876,3578763876,0
1,1520,51100,3578763876,3578763876,0
1,1520,51101,3578763876,3578763879,3
1,1520,51102,3578763876,3578763882,6
1,1520,51103,3578763876,3578763882,6
1,1520,51104,3578763876,3578763883,7
1,1520,51105,3578763876,3578763884,8
1,1520,51106,3578763876,3578763884,8
1,1520,51107,3578763876,3578763885,9
1,1520,51108,3578763876,3578763885,9
1,1520,51109,3578763876,3578763886,10
1,1520,51110,3578763876,3578763887,11
1,1520,51111,3578763876,3578763888,12
1,1520,51112,3578763876,3578763891,15
1,1520,51113,3578763876,3578763891,15
1,1520,51114,3578763876,3578763892,16
1,1520,51115,3578763876,3578763892,16
1,1520,51116,3578763876,3578763893,17
1,1520,51117,3578763876,3578763894,18
1,1520,51118,3578763876,3578763895,19
1,1520,51119,3578763876,3578763895,19
1,1520,51120,3578763876,3578763896,20
1,1520,51121,3578763876,3578763897,21
1,1520,51122,3578763876,3578763897,21
1,1520,51123,3578763876,3578763897,21
1,1520,51124,3578763876,3578763898,22
1,1520,51125,3578763876,3578763899,23
1,1520,51126,3578763876,3578763899,23
1,1520,51127,3578763876,3578763901,25
1,1520,51128,3578763876,3578763901,25
1,1520,51129,3578763876,3578763902,26
1,1520,51130,3578763876,3578763902,26
1,1520,51131,3578763876,3578763902,26
1,1520,51132,3578763876,3578763903,27
1,1520,51133,3578763876,3578763904,28
1,1520,51134,3578763876,3578763904,28
1,1520,51135,3578763876,3578763904,28
1,1520,51136,3578763876,3578763906,30
1,1520,51137,3578763876,3578763906,30
1,1520,51138,3578763876,3578763907,31
1,1520,51139,3578763876,3578763908,32
1,1520,51140,3578763876,3578763909,33
1,1520,51141,3578763876,3578763909,33
1,1520,51142,3578763876,3578763909,33
1,1520,51143,3578763876,3578763909,33
1,1520,51144,3578763876,3578763910,34
1,1520,51145,3578763876,3578763912,36
1,1520,51146,3578763876,3578763913,37
1,1520,51147,3578763876,3578763913,37
1,1520,51148,3578763876,3578763913,37
1,1520,51149,3578763876,3578763914,38
1,1520,51150,3578763876,3578763914,38
1,1520,51151,3578763876,3578763914,38
1,1520,51152,3578763876,3578763915,39
1,1520,51153,3578763876,3578763917,41
1,1520,51154,3578763876,3578763918,42
1,1520,51155,3578763876,3578763920,44
1,1520,51156,3578763876,3578763920,44
1,1520,51157,3578763876,3578763920,44
1,1520,51158,3578763876,3578763921,45
1,1520,51159,3578763876,3578763921,45
1,1520,51160,3578763876,3578763922,46
1,1520,51161,3578763876,3578763922,46
1,1520,51162,3578763876,3578763923,47
1,1520,51163,3578763876,3578763924,48
1,1520,51164,3578763876,3578763924,48
1,1520,51165,3578763876,3578763924,48
1,1520,51166,3578763876,3578763925,49
1,1520,51167,3578763876,3578763925,49
1,1520,51168,3578763876,3578763926,50
1,1521,51169,3578763940,3578763940,0
1,1521,51170,3578763940,3578763940,0
1,1521,51171,3578763940,3578763940,0
1,1521,51172,3578763940,3578763940,0
1,1521,51173,3578763940,3578763940,0
1,1521,51174,3578763940,3578763940,0
1,1521,51175,3578763940,3578763940,0
1,1521,51176,3578763940,3578763940,0
1,1521,51177,3578763940,3578763940,0
1,1521,51178,3578763940,3578763940,0
1,1521,51179,3578763940,3578763940,0
1,1521,51180,3578763940,3578763940,0
1,1521,51181,3578763940,3578763940,0
1,1521,51182,3578763940,3578763940,0
1,1521,51183,3578763940,3578763940,0
1,1521,51184,3578763940,3578763940,0
1,1521,51185,3578763940,3578763940,0
1,1521,51186,3578763940,3578763941,1
1,1521,51187,3578763940,3578763942,2
1,1521,51188,3578763940,3578763944,4
1,1521,51189,3578763940,3578763946,6
1,1521,51190,3578763940,3578763947,7
1,1521,51191,3578763940,3578763947,7
1,1521,51192,3578763940,3578763948,8
1,1521,51193,3578763940,3578763948,8
1,1521,51194,3578763940,3578763949,9
1,1521,51195,3578763940,3578763953,13
1,1521,51196,3578763940,3578763953,13
1,1521,51197,3578763940,3578763955,15
1,1521,51198,3578763940,3578763955,15
1,1521,51199,3578763940,3578763955,15
1,1521,51200,3578763940,3578763955,15
1,1521,51201,3578763940,3578763955,15
1,1521,51202,3578763940,3578763958,18
1,1521,51203,3578763940,3578763958,18
1,1521,51204,3578763940,3578763963,23
1,1521,51205,3578763940,3578763963,23
1,1521,51206,3578763940,3578763964,24
1,1521,51207,3578763940,3578763964,24
1,1521,51208,3578763940,3578763965,25
1,1521,51209,3578763940,3578763966,26
1,1521,51210,3578763940,3578763966,26
1,1521,51211,3578763940,3578763968,28
1,1521,51212,3578763940,3578763968,28
1,1521,51213,3578763940,3578763968,28
1,1521,51214,3578763940,3578763968,28
1,1521,51215,3578763940,3578763969,29
1,1521,51216,3578763940,3578763971,31
1,1521,51217,3578763940,3578763972,32
1,1521,51218,3578763940,3578763974,34
1,1521,51219,3578763940,3578763975,35
1,1521,51220,3578763940,3578763977,37
1,1521,51221,3578763940,3578763978,38
1,1521,51222,3578763940,3578763978,38
1,1521,51223,3578763940,3578763979,39
1,1521,51224,3578763940,3578763980,40
1,1521,51225,3578763940,3578763980,40
1,1521,51226,3578763940,3578763980,40
1,1521,51227,3578763940,3578763981,41
1,1521,51228,3578763940,3578763981,41
1,1521,51229,3578763940,3578763982,42
1,1521,51230,3578763940,3578763982,42
1,1521,51231,3578763940,3578763985,45
1,1521,51232,3578763940,3578763989,49
1,1522,51233,3578764019,3578764019,0
1,1522,51234,3578764019,3578764019,0
1,1522,51235,3578764019,3578764019,0
1,1522,51236,3578764019,3578764019,0
1,1522,51237,3578764019,3578764019,0
1,1522,51238,3578764019,3578764019,0
1,1522,51239,3578764019,3578764019,0
1,1522,51240,3578764019,3578764019,0
1,1522,51241,3578764019,3578764019,0
1,1522,51242,3578764019,3578764019,0
1,1522,51243,3578764019,3578764019,0
1,1522,51244,3578764019,3578764019,0
1,1522,51245,3578764019,3578764019,0
1,1522,51246,3578764019,3578764019,0
1,1522,51247,3578764019,3578764019,0
1,1522,51248,3578764019,3578764019,0
1,1522,51249,3578764019,3578764019,0
1,1522,51250,3578764019,3578764019,0
1,1522,51251,3578764019,3578764019,0
1,1522,51252,3578764019,3578764019,0
1,1522,51253,3578764019,3578764019,0
1,1522,51254,3578764019,3578764019,0
1,1522,51255,3578764019,3578764019,0
1,1522,51256,3578764019,3578764019,0
1,1522,51257,3578764019,3578764019,0
1,1522,51258,3578764019,3578764019,0
1,1522,51259,3578764019,3578764019,0
1,1522,51260,3578764019,3578764019,0
1,1522,51261,3578764019,3578764019,0
1,1522,51262,3578764019,3578764019,0
1,1522,51263,3578764019,3578764019,0
1,1522,51264,3578764019,3578764019,0
1,1522,51265,3578764019,3578764019,0
1,1522,51266,3578764019,3578764019,0
1,1522,51267,3578764019,3578764019,0
1,1522,51268,3578764019,3578764019,0
1,1522,51269,3578764019,3578764019,0
1,1522,51270,3578764019,3578764022,3
1,1522,51271,3578764019,3578764024,5
1,1522,51272,3578764019,3578764024,5
1,1522,51273,3578764019,3578764025,6
1,1522,51274,3578764019,3578764026,7
1,1522,51275,3578764019,3578764026,7
1,1522,51276,3578764019,3578764027,8
1,1522,51277,3578764019,3578764028,9
1,1522,51278,3578764019,3578764029,10
1,1522,51279,3578764019,3578764030,11
1,1522,51280,3578764019,3578764030,11
1,1522,51281,3578764019,3578764031,12
1,1522,51282,3578764019,3578764032,13
1,1522,51283,3578764019,3578764036,17
1,1522,51284,3578764019,3578764037,18
1,1522,51285,3578764019,3578764037,18
1,1522,51286,3578764019,3578764037,18
1,1522,51287,3578764019,3578764037,18
1,1522,51288,3578764019,3578764039,20
1,1522,51289,3578764019,3578764041,22
1,1522,51290,3578764019,3578764041,22
1,1522,51291,3578764019,3578764047,28
1,1522,51292,3578764019,3578764050,31
1,1522,51293,3578764019,3578764051,32
1,1522,51294,3578764019,3578764052,33
1,1522,51295,3578764019,3578764053,34
1,1522,51296,3578764019,3578764053,34
1,1522,51297,3578764019,3578764054,35
1,1522,51298,3578764019,3578764055,36
1,1522,51299,3578764019,3578764056,37
1,1522,51300,3578764019,3578764057,38
1,1522,51301,3578764019,3578764059,40
1,1522,51302,3578764019,3578764059,40
1,1522,51303,3578764019,3578764060,41
1,1522,51304,3578764019,3578764060,41
1,1522,51305,3578764019,3578764063,44
1,1522,51306,3578764019,3578764063,44
1,1522,51307,3578764019,3578764065,46
1,1522,51308,3578764019,3578764068,49
1,1523,51309,3578764083,3578764083,0
1,1523,51310,3578764083,3578764083,0
1,1523,51311,3578764083,3578764083,0
1,1523,51312,3578764083,3578764083,0
1,1523,51313,3578764083,3578764083,0
1,1523,51314,3578764083,3578764084,1
1,1523,51315,3578764083,3578764084,1
1,1523,51316,3578764083,3578764084,1
1,1523,51317,3578764083,3578764085,2
1,1523,51318,3578764083,3578764086,3
1,1523,51319,3578764083,3578764088,5
1,1523,51320,3578764083,3578764088,5
1,1523,51321,3578764083,3578764091,8
1,1523,51322,3578764083,3578764091,8
1,1523,51323,3578764083,3578764092,9
1,1523,51324,3578764083,3578764092,9
1,1523,51325,3578764083,3578764093,10
1,1523,51326,3578764083,3578764094,11
1,1523,51327,3578764083,3578764095,12
1,1523,51328,3578764083,3578764095,12
1,1523,51329,3578764083,3578764096,13
1,1523,51330,3578764083,3578764097,14
1,1523,51331,3578764083,3578764097,14
1,1523,51332,3578764083,3578764097,14
1,1523,51333,3578764083,3578764098,15
1,1523,51334,3578764083,3578764099,16
1,1523,51335,3578764083,3578764099,16
1,1523,51336,3578764083,3578764101,18
1,1523,51337,3578764083,3578764102,19
1,1523,51338,3578764083,3578764102,19
1,1523,51339,3578764083,3578764102,19
1,1523,51340,3578764083,3578764103,20
1,1523,51341,3578764083,3578764103,20
1,1523,51342,3578764083,3578764104,21
1,1523,51343,3578764083,3578764104,21
1,1523,51344,3578764083,3578764104,21
1,1523,51345,3578764083,3578764104,21
1,1523,51346,3578764083,3578764106,23
1,1523,51347,3578764083,3578764107,24
1,1523,51348,3578764083,3578764107,24
1,1523,51349,3578764083,3578764108,25
1,1523,51350,3578764083,3578764108,25
1,1523,51351,3578764083,3578764109,26
1,1523,51352,3578764083,3578764109,26
1,1523,51353,3578764083,3578764109,26
1,1523,51354,3578764083,3578764109,26
1,1523,51355,3578764083,3578764110,27
1,1523,51356,3578764083,3578764112,29
1,1523,51357,3578764083,3578764113,30
1,1523,51358,3578764083,3578764113,30
1,1523,51359,3578764083,3578764113,30
1,1523,51360,3578764083,3578764114,31
1,1523,51361,3578764083,3578764114,31
1,1523,51362,3578764083,3578764114,31
1,1523,51363,3578764083,3578764116,33
1,1523,51364,3578764083,3578764117,34
1,1523,51365,3578764083,3578764119,36
1,1523,51366,3578764083,3578764120,37
1,1523,51367,3578764083,3578764120,37
1,1523,51368,3578764083,3578764120,37
1,1523,51369,3578764083,3578764121,38
1,1523,51370,3578764083,3578764122,39
1,1523,51371,3578764083,3578764122,39
1,1523,51372,3578764083,3578764123,40
1,1523,51373,3578764083,3578764124,41
1,1523,51374,3578764083,3578764124,41
1,1523,51375,3578764083,3578764124,41
1,1523,51376,3578764083,3578764125,42
1,1523,51377,3578764083,3578764127,44
1,1523,51378,3578764083,3578764127,44
1,1523,51379,3578764083,3578764128,45
1,1523,51380,3578764083,3578764129,46
1,1523,51381,3578764083,3578764130,47
1,1523,51382,3578764083,3578764130,47
1,1523,51383,3578764083,3578764131,48
1,1523,51384,3578764083,3578764133,50
1,1524,51385,3578764147,3578764147,0
1,1524,51386,3578764147,3578764147,0
1,1524,51387,3578764147,3578764147,0
1,1524,51388,3578764147,3578764147,0
1,1524,51389,3578764147,3578764147,0
1,1524,51390,3578764147,3578764147,0
1,1524,51391,3578764147,3578764147,0
1,1524,51392,3578764147,3578764147,0
1,1524,51393,3578764147,3578764147,0
1,1524,51394,3578764147,3578764147,0
1,1524,51395,3578764147,3578764147,0
1,1524,51396,3578764147,3578764147,0
1,1524,51397,3578764147,3578764147,0
1,1524,51398,3578764147,3578764147,0
1,1524,51399,3578764147,3578764147,0
1,1524,51400,3578764147,3578764147,0
1,1524,51401,3578764147,3578764147,0
1,1524,51402,3578764147,3578764148,1
1,1524,51403,3578764147,3578764150,3
1,1524,51404,3578764147,3578764151,4
1,1524,51405,3578764147,3578764153,6
1,1524,51406,3578764147,3578764153,6
1,1524,51407,3578764147,3578764155,8
1,1524,51408,3578764147,3578764155,8
1,1524,51409,3578764147,3578764155,8
1,1524,51410,3578764147,3578764155,8
1,1524,51411,3578764147,3578764158,11
1,1524,51412,3578764147,3578764159,12
1,1524,51413,3578764147,3578764163,16
1,1524,51414,3578764147,3578764163,16
1,1524,51415,3578764147,3578764164,17
1,1524,51416,3578764147,3578764164,17
1,1524,51417,3578764147,3578764166,19
1,1524,51418,3578764147,3578764166,19
1,1524,51419,3578764147,3578764166,19
1,1524,51420,3578764147,3578764167,20
1,1524,51421,3578764147,3578764167,20
1,1524,51422,3578764147,3578764168,21
1,1524,51423,3578764147,3578764168,21
1,1524,51424,3578764147,3578764169,22
1,1524,51425,3578764147,3578764171,24
1,1524,51426,3578764147,3578764172,25
1,1524,51427,3578764147,3578764175,28
1,1524,51428,3578764147,3578764175,28
1,1524,51429,3578764147,3578764177,30
1,1524,51430,3578764147,3578764177,30
1,1524,51431,3578764147,3578764178,31
1,1524,51432,3578764147,3578764179,32
1,1524,51433,3578764147,3578764180,33
1,1524,51434,3578764147,3578764180,33
1,1524,51435,3578764147,3578764180,33
1,1524,51436,3578764147,3578764181,34
1,1524,51437,3578764147,3578764181,34
1,1524,51438,3578764147,3578764181,34
1,1524,51439,3578764147,3578764181,34
1,1524,51440,3578764147,3578764185,38
1,1524,51441,3578764147,3578764190,43
1,1524,51442,3578764147,3578764192,45
1,1524,51443,3578764147,3578764192,45
1,1524,51444,3578764147,3578764193,46
1,1524,51445,3578764147,3578764194,47
1,1524,51446,3578764147,3578764194,47
1,1524,51447,3578764147,3578764194,47
1,1524,51448,3578764147,3578764196,49
1,1524,51449,3578764147,3578764196,49
1,1524,51450,3578764147,3578764196,49
1,1524,51451,3578764147,3578764196,49
1,1524,51452,3578764147,3578764197,50
1,1525,51453,3578764211,3578764211,0
1,1525,51454,3578764211,3578764211,0
1,1525,51455,3578764211,3578764211,0
1,1525,51456,3578764211,3578764211,0
1,1525,51457,3578764211,3578764211,0
1,1525,51458,3578764211,3578764211,0
1,1525,51459,3578764211,3578764211,0
1,1525,51460,3578764211,3578764211,0
1,1525,51461,3578764211,3578764211,0
1,1525,51462,3578764211,3578764211,0
1,1525,51463,3578764211,3578764211,0
1,1525,51464,3578764211,3578764211,0
1,1525,51465,3578764211,3578764212,1
1,1525,51466,3578764211,3578764213,2
1,1525,51467,3578764211,3578764213,2
1,1525,51468,3578764211,3578764214,3
1,1525,51469,3578764211,3578764215,4
1,1525,51470,3578764211,3578764215,4
1,1525,51471,3578764211,3578764215,4
1,1525,51472,3578764211,3578764216,5
1,1525,51473,3578764211,3578764217,6
1,1525,51474,3578764211,3578764217,6
1,1525,51475,3578764211,3578764219,8
1,1525,51476,3578764211,3578764219,8
1,1525,51477,3578764211,3578764220,9
1,1525,51478,3578764211,3578764220,9
1,1525,51479,3578764211,3578764222,11
1,1525,51480,3578764211,3578764223,12
1,1525,51481,3578764211,3578764224,13
1,1525,51482,3578764211,3578764224,13
1,1525,51483,3578764211,3578764225,14
1,1525,51484,3578764211,3578764226,15
1,1525,51485,3578764211,3578764227,16
1,1525,51486,3578764211,3578764227,16
1,1525,51487,3578764211,3578764228,17
1,1525,51488,3578764211,3578764229,18
1,1525,51489,3578764211,3578764229,18
1,1525,51490,3578764211,3578764230,19
1,1525,51491,3578764211,3578764231,20
1,1525,51492,3578764211,3578764232,21
1,1525,51493,3578764211,3578764235,24
1,1525,51494,3578764211,3578764236,25
1,1525,51495,3578764211,3578764237,26
1,1525,51496,3578764211,3578764237,26
1,1525,51497,3578764211,3578764238,27
1,1525,51498,3578764211,3578764238,27
1,1525,51499,3578764211,3578764239,28
1,1525,51500,3578764211,3578764241,30
1,1525,51501,3578764211,3578764242,31
1,1525,51502,3578764211,3578764247,36
1,1525,51503,3578764211,3578764248,37
1,1525,51504,3578764211,3578764250,39
1,1525,51505,3578764211,3578764252,41
1,1525,51506,3578764211,3578764253,42
1,1525,51507,3578764211,3578764253,42
1,1525,51508,3578764211,3578764254,43
1,1525,51509,3578764211,3578764255,44
1,1525,51510,3578764211,3578764257,46
1,1525,51511,3578764211,3578764257,46
1,1525,51512,3578764211,3578764257,46
1,1525,51513,3578764211,3578764258,47
1,1525,51514,3578764211,3578764259,48
1,1525,51515,3578764211,3578764260,49
1,1526,51516,3578764274,3578764274,0
1,1526,51517,3578764274,3578764274,0
1,1526,51518,3578764274,3578764274,0
1,1526,51519,3578764274,3578764274,0
1,1526,51520,3578764274,3578764274,0
1,1526,51521,3578764274,3578764279,5
1,1526,51522,3578764274,3578764281,7
1,1526,51523,3578764274,3578764282,8
1,1526,51524,3578764274,3578764282,8
1,1526,51525,3578764274,3578764284,10
1,1526,51526,3578764274,3578764284,10
1,1526,51527,3578764274,3578764284,10
1,1526,51528,3578764274,3578764286,12
1,1526,51529,3578764274,3578764286,12
1,1526,51530,3578764274,3578764288,14
1,1526,51531,3578764274,3578764289,15
1,1526,51532,3578764274,3578764291,17
1,1526,51533,3578764274,3578764292,18
1,1526,51534,3578764274,3578764292,18
1,1526,51535,3578764274,3578764294,20
1,1526,51536,3578764274,3578764295,21
1,1526,51537,3578764274,3578764295,21
1,1526,51538,3578764274,3578764295,21
1,1526,51539,3578764274,3578764297,23
1,1526,51540,3578764274,3578764298,24
1,1526,51541,3578764274,3578764299,25
1,1526,51542,3578764274,3578764299,25
1,1526,51543,3578764274,3578764300,26
1,1526,51544,3578764274,3578764301,27
1,1526,51545,3578764274,3578764302,28
1,1526,51546,3578764274,3578764302,28
1,1526,51547,3578764274,3578764303,29
1,1526,51548,3578764274,3578764303,29
1,1526,51549,3578764274,3578764303,29
1,1526,51550,3578764274,3578764303,29
1,1526,51551,3578764274,3578764304,30
1,1526,51552,3578764274,3578764304,30
1,1526,51553,3578764274,3578764305,31
1,1526,51554,3578764274,3578764306,32
1,1526,51555,3578764274,3578764306,32
1,1526,51556,3578764274,3578764307,33
1,1526,51557,3578764274,3578764308,34
1,1526,51558,3578764274,3578764309,35
1,1526,51559,3578764274,3578764309,35
1,1526,51560,3578764274,3578764309,35
1,1526,51561,3578764274,3578764309,35
1,1526,51562,3578764274,3578764309,35
1,1526,51563,3578764274,3578764312,38
1,1526,51564,3578764274,3578764312,38
1,1526,51565,3578764274,3578764313,39
1,1526,51566,3578764274,3578764314,40
1,1526,51567,3578764274,3578764315,41
1,1526,51568,3578764274,3578764316,42
1,1526,51569,3578764274,3578764318,44
1,1526,51570,3578764274,3578764320,46
1,1526,51571,3578764274,3578764320,46
1,1526,51572,3578764274,3578764320,46
1,1526,51573,3578764274,3578764321,47
1,1526,51574,3578764274,3578764322,48
1,1526,51575,3578764274,3578764322,48
1,1526,51576,3578764274,3578764323,49
1,1526,51577,3578764274,3578764323,49
1,1526,51578,3578764274,3578764324,50
1,1527,51579,3578764340,3578764340,0
1,1527,51580,3578764340,3578764340,0
1,1527,51581,3578764340,3578764340,0
1,1527,51582,3578764340,3578764340,0
1,1527,51583,3578764340,3578764340,0
1,1527,51584,3578764340,3578764340,0
1,1527,51585,3578764340,3578764340,0
1,1527,51586,3578764340,3578764340,0
1,1527,51587,3578764340,3578764340,0
1,1527,51588,3578764340,3578764340,0
1,1527,51589,3578764340,3578764340,0
1,1527,51590,3578764340,3578764340,0
1,1527,51591,3578764340,3578764340,0
1,1527,51592,3578764340,3578764340,0
1,1527,51593,3578764340,3578764340,0
1,1527,51594,3578764340,3578764340,0
1,1527,51595,3578764340,3578764340,0
1,1527,51596,3578764340,3578764340,0
1,1527,51597,3578764340,3578764340,0
1,1527,51598,3578764340,3578764340,0
1,1527,51599,3578764340,3578764341,1
1,1527,51600,3578764340,3578764341,1
1,1527,51601,3578764340,3578764342,2
1,1527,51602,3578764340,3578764344,4
1,1527,51603,3578764340,3578764346,6
1,1527,51604,3578764340,3578764346,6
1,1527,51605,3578764340,3578764348,8
1,1527,51606,3578764340,3578764348,8
1,1527,51607,3578764340,3578764354,14
1,1527,51608,3578764340,3578764354,14
1,1527,51609,3578764340,3578764355,15
1,1527,51610,3578764340,3578764355,15
1,1527,51611,3578764340,3578764355,15
1,1527,51612,3578764340,3578764356,16
1,1527,51613,3578764340,3578764357,17
1,1527,51614,3578764340,3578764360,20
1,1527,51615,3578764340,3578764363,23
1,1527,51616,3578764340,3578764363,23
1,1527,51617,3578764340,3578764364,24
1,1527,51618,3578764340,3578764364,24
1,1527,51619,3578764340,3578764364,24
1,1527,51620,3578764340,3578764366,26
1,1527,51621,3578764340,3578764366,26
1,1527,51622,3578764340,3578764367,27
1,1527,51623,3578764340,3578764368,28
1,1527,51624,3578764340,3578764368,28
1,1527,51625,3578764340,3578764369,29
1,1527,51626,3578764340,3578764369,29
1,1527,51627,3578764340,3578764370,30
1,1527,51628,3578764340,3578764371,31
1,1527,51629,3578764340,3578764372,32
1,1527,51630,3578764340,3578764375,35
1,1527,51631,3578764340,3578764375,35
1,1527,51632,3578764340,3578764377,37
1,1527,51633,3578764340,3578764377,37
1,1527,51634,3578764340,3578764378,38
1,1527,51635,3578764340,3578764378,38
1,1527,51636,3578764340,3578764380,40
1,1527,51637,3578764340,3578764381,41
1,1527,51638,3578764340,3578764381,41
1,1527,51639,3578764340,3578764381,41
1,1527,51640,3578764340,3578764382,42
1,1527,51641,3578764340,3578764382,42
1,1527,51642,3578764340,3578764382,42
1,1527,51643,3578764340,3578764382,42
1,1527,51644,3578764340,3578764385,45
1,1527,51645,3578764340,3578764389,49
1,1528,51646,3578764404,3578764404,0
1,1528,51647,3578764404,3578764404,0
1,1528,51648,3578764404,3578764404,0
1,1528,51649,3578764404,3578764404,0
1,1528,51650,3578764404,3578764404,0
1,1528,51651,3578764404,3578764404,0
1,1528,51652,3578764404,3578764404,0
1,1528,51653,3578764404,3578764404,0
1,1528,51654,3578764404,3578764404,0
1,1528,51655,3578764404,3578764404,0
1,1528,51656,3578764404,3578764404,0
1,1528,51657,3578764404,3578764404,0
1,1528,51658,3578764404,3578764405,1
1,1528,51659,3578764404,3578764405,1
1,1528,51660,3578764404,3578764405,1
1,1528,51661,3578764404,3578764405,1
1,1528,51662,3578764404,3578764405,1
1,1528,51663,3578764404,3578764405,1
1,1528,51664,3578764404,3578764406,2
1,1528,51665,3578764404,3578764408,4
1,1528,51666,3578764404,3578764411,7
1,1528,51667,3578764404,3578764413,9
1,1528,51668,3578764404,3578764413,9
1,1528,51669,3578764404,3578764414,10
1,1528,51670,3578764404,3578764415,11
1,1528,51671,3578764404,3578764415,11
1,1528,51672,3578764404,3578764415,11
1,1528,51673,3578764404,3578764417,13
1,1528,51674,3578764404,3578764417,13
1,1528,51675,3578764404,3578764418,14
1,1528,51676,3578764404,3578764418,14
1,1528,51677,3578764404,3578764419,15
1,1528,51678,3578764404,3578764419,15
1,1528,51679,3578764404,3578764420,16
1,1528,51680,3578764404,3578764422,18
1,1528,51681,3578764404,3578764422,18
1,1528,51682,3578764404,3578764424,20
1,1528,51683,3578764404,3578764425,21
1,1528,51684,3578764404,3578764427,23
1,1528,51685,3578764404,3578764427,23
1,1528,51686,3578764404,3578764428,24
1,1528,51687,3578764404,3578764429,25
1,1528,51688,3578764404,3578764429,25
1,1528,51689,3578764404,3578764430,26
1,1528,51690,3578764404,3578764430,26
1,1528,51691,3578764404,3578764431,27
1,1528,51692,3578764404,3578764432,28
1,1528,51693,3578764404,3578764435,31
1,1528,51694,3578764404,3578764437,33
1,1528,51695,3578764404,3578764437,33
1,1528,51696,3578764404,3578764438,34
1,1528,51697,3578764404,3578764438,34
1,1528,51698,3578764404,3578764438,34
1,1528,51699,3578764404,3578764440,36
1,1528,51700,3578764404,3578764441,37
1,1528,51701,3578764404,3578764442,38
1,1528,51702,3578764404,3578764447,43
1,1528,51703,3578764404,3578764448,44
1,1528,51704,3578764404,3578764450,46
1,1528,51705,3578764404,3578764450,46
1,1528,51706,3578764404,3578764454,50
1,1529,51707,3578764468,3578764468,0
1,1529,51708,3578764468,3578764468,0
1,1529,51709,3578764468,3578764468,0
1,1529,51710,3578764468,3578764468,0
1,1529,51711,3578764468,3578764468,0
1,1529,51712,3578764468,3578764468,0
1,1529,51713,3578764468,3578764468,0
1,1529,51714,3578764468,3578764468,0
1,1529,51715,3578764468,3578764468,0
1,1529,51716,3578764468,3578764468,0
1,1529,51717,3578764468,3578764468,0
1,1529,51718,3578764468,3578764468,0
1,1529,51719,3578764468,3578764471,3
1,1529,51720,3578764468,3578764479,11
1,1529,51721,3578764468,3578764482,14
1,1529,51722,3578764468,3578764482,14
1,1529,51723,3578764468,3578764483,15
1,1529,51724,3578764468,3578764483,15
1,1529,51725,3578764468,3578764484,16
1,1529,51726,3578764468,3578764484,16
1,1529,51727,3578764468,3578764486,18
1,1529,51728,3578764468,3578764487,19
1,1529,51729,3578764468,3578764489,21
1,1529,51730,3578764468,3578764491,23
1,1529,51731,3578764468,3578764491,23
1,1529,51732,3578764468,3578764492,24
1,1529,51733,3578764468,3578764495,27
1,1529,51734,3578764468,3578764495,27
1,1529,51735,3578764468,3578764495,27
1,1529,51736,3578764468,3578764496,28
1,1529,51737,3578764468,3578764497,29
1,1529,51738,3578764468,3578764498,30
1,1529,51739,3578764468,3578764499,31
1,1529,51740,3578764468,3578764499,31
1,1529,51741,3578764468,3578764499,31
1,1529,51742,3578764468,3578764501,33
1,1529,51743,3578764468,3578764502,34
1,1529,51744,3578764468,3578764502,34
1,1529,51745,3578764468,3578764503,35
1,1529,51746,3578764468,3578764503,35
1,1529,51747,3578764468,3578764503,35
1,1529,51748,3578764468,3578764504,36
1,1529,51749,3578764468,3578764504,36
1,1529,51750,3578764468,3578764504,36
1,1529,51751,3578764468,3578764504,36
1,1529,51752,3578764468,3578764506,38
1,1529,51753,3578764468,3578764507,39
1,1529,51754,3578764468,3578764508,40
1,1529,51755,3578764468,3578764508,40
1,1529,51756,3578764468,3578764509,41
1,1529,51757,3578764468,3578764509,41
1,1529,51758,3578764468,3578764509,41
1,1529,51759,3578764468,3578764509,41
1,1529,51760,3578764468,3578764509,41
1,1529,51761,3578764468,3578764512,44
1,1529,51762,3578764468,3578764513,45
1,1529,51763,3578764468,3578764513,45
1,1529,51764,3578764468,3578764513,45
1,1529,51765,3578764468,3578764514,46
1,1529,51766,3578764468,3578764514,46
1,1529,51767,3578764468,3578764514,46
1,1529,51768,3578764468,3578764515,47
1,1529,51769,3578764468,3578764516,48
1,1530,51770,3578764532,3578764532,0
1,1530,51771,3578764532,3578764532,0
1,1530,51772,3578764532,3578764532,0
1,1530,51773,3578764532,3578764532,0
1,1530,51774,3578764532,3578764532,0
1,1530,51775,3578764532,3578764532,0
1,1530,51776,3578764532,3578764532,0
1,1530,51777,3578764532,3578764532,0
1,1530,51778,3578764532,3578764532,0
1,1530,51779,3578764532,3578764532,0
1,1530,51780,3578764532,3578764532,0
1,1530,51781,3578764532,3578764532,0
1,1530,51782,3578764532,3578764532,0
1,1530,51783,3578764532,3578764532,0
1,1530,51784,3578764532,3578764532,0
1,1530,51785,3578764532,3578764532,0
1,1530,51786,3578764532,3578764532,0
1,1530,51787,3578764532,3578764532,0
1,1530,51788,3578764532,3578764532,0
1,1530,51789,3578764532,3578764532,0
1,1530,51790,3578764532,3578764532,0
1,1530,51791,3578764532,3578764532,0
1,1530,51792,3578764532,3578764533,1
1,1530,51793,3578764532,3578764533,1
1,1530,51794,3578764532,3578764534,2
1,1530,51795,3578764532,3578764534,2
1,1530,51796,3578764532,3578764534,2
1,1530,51797,3578764532,3578764536,4
1,1530,51798,3578764532,3578764536,4
1,1530,51799,3578764532,3578764537,5
1,1530,51800,3578764532,3578764537,5
1,1530,51801,3578764532,3578764540,8
1,1530,51802,3578764532,3578764540,8
1,1530,51803,3578764532,3578764540,8
1,1530,51804,3578764532,3578764545,13
1,1530,51805,3578764532,3578764545,13
1,1530,51806,3578764532,3578764547,15
1,1530,51807,3578764532,3578764547,15
1,1530,51808,3578764532,3578764550,18
1,1530,51809,3578764532,3578764553,21
1,1530,51810,3578764532,3578764553,21
1,1530,51811,3578764532,3578764554,22
1,1530,51812,3578764532,3578764555,23
1,1530,51813,3578764532,3578764555,23
1,1530,51814,3578764532,3578764555,23
1,1530,51815,3578764532,3578764559,27
1,1530,51816,3578764532,3578764562,30
1,1530,51817,3578764532,3578764562,30
1,1530,51818,3578764532,3578764563,31
1,1530,51819,3578764532,3578764563,31
1,1530,51820,3578764532,3578764564,32
1,1530,51821,3578764532,3578764564,32
1,1530,51822,3578764532,3578764565,33
1,1530,51823,3578764532,3578764566,34
1,1530,51824,3578764532,3578764567,35
1,1530,51825,3578764532,3578764568,36
1,1530,51826,3578764532,3578764568,36
1,1530,51827,3578764532,3578764568,36
1,1530,51828,3578764532,3578764569,37
1,1530,51829,3578764532,3578764571,39
1,1530,51830,3578764532,3578764572,40
1,1530,51831,3578764532,3578764574,42
1,1530,51832,3578764532,3578764575,43
1,1530,51833,3578764532,3578764576,44
1,1530,51834,3578764532,3578764577,45
1,1530,51835,3578764532,3578764577,45
1,1530,51836,3578764532,3578764579,47
1,1530,51837,3578764532,3578764580,48
1,1530,51838,3578764532,3578764580,48
1,1530,51839,3578764532,3578764581,49
1,1530,51840,3578764532,3578764581,49
1,1530,51841,3578764532,3578764581,49
1,1530,51842,3578764532,3578764582,50
1,1531,51843,3578764598,3578764598,0
1,1531,51844,3578764598,3578764598,0
1,1531,51845,3578764598,3578764598,0
1,1531,51846,3578764598,3578764598,0
1,1531,51847,3578764598,3578764598,0
1,1531,51848,3578764598,3578764598,0
1,1531,51849,3578764598,3578764598,0
1,1531,51850,3578764598,3578764598,0
1,1531,51851,3578764598,3578764598,0
1,1531,51852,3578764598,3578764598,0
1,1531,51853,3578764598,3578764598,0
1,1531,51854,3578764598,3578764598,0
1,1531,51855,3578764598,3578764598,0
1,1531,51856,3578764598,3578764598,0
1,1531,51857,3578764598,3578764598,0
1,1531,51858,3578764598,3578764599,1
1,1531,51859,3578764598,3578764599,1
1,1531,51860,3578764598,3578764599,1
1,1531,51861,3578764598,3578764600,2
1,1531,51862,3578764598,3578764602,4
1,1531,51863,3578764598,3578764604,6
1,1531,51864,3578764598,3578764604,6
1,1531,51865,3578764598,3578764605,7
1,1531,51866,3578764598,3578764608,10
1,1531,51867,3578764598,3578764609,11
1,1531,51868,3578764598,3578764612,14
1,1531,51869,3578764598,3578764612,14
1,1531,51870,3578764598,3578764614,16
1,1531,51871,3578764598,3578764614,16
1,1531,51872,3578764598,3578764614,16
1,1531,51873,3578764598,3578764614,16
1,1531,51874,3578764598,3578764616,18
1,1531,51875,3578764598,3578764616,18
1,1531,51876,3578764598,3578764616,18
1,1531,51877,3578764598,3578764617,19
1,1531,51878,3578764598,3578764618,20
1,1531,51879,3578764598,3578764618,20
1,1531,51880,3578764598,3578764618,20
1,1531,51881,3578764598,3578764619,21
1,1531,51882,3578764598,3578764621,23
1,1531,51883,3578764598,3578764621,23
1,1531,51884,3578764598,3578764624,26
1,1531,51885,3578764598,3578764624,26
1,1531,51886,3578764598,3578764624,26
1,1531,51887,3578764598,3578764625,27
1,1531,51888,3578764598,3578764626,28
1,1531,51889,3578764598,3578764629,31
1,1531,51890,3578764598,3578764629,31
1,1531,51891,3578764598,3578764629,31
1,1531,51892,3578764598,3578764630,32
1,1531,51893,3578764598,3578764630,32
1,1531,51894,3578764598,3578764631,33
1,1531,51895,3578764598,3578764634,36
1,1531,51896,3578764598,3578764635,37
1,1531,51897,3578764598,3578764636,38
1,1531,51898,3578764598,3578764636,38
1,1531,51899,3578764598,3578764637,39
1,1531,51900,3578764598,3578764638,40
1,1531,51901,3578764598,3578764639,41
1,1531,51902,3578764598,3578764640,42
1,1531,51903,3578764598,3578764641,43
1,1531,51904,3578764598,3578764646,48
1,1531,51905,3578764598,3578764647,49
1,1532,51906,3578764663,3578764663,0
1,1532,51907,3578764663,3578764663,0
1,1532,51908,3578764663,3578764663,0
1,1532,51909,3578764663,3578764663,0
1,1532,51910,3578764663,3578764663,0
1,1532,51911,3578764663,3578764663,0
1,1532,51912,3578764663,3578764663,0
1,1532,51913,3578764663,3578764663,0
1,1532,51914,3578764663,3578764663,0
1,1532,51915,3578764663,3578764663,0
1,1532,51916,3578764663,3578764663,0
1,1532,51917,3578764663,3578764663,0
1,1532,51918,3578764663,3578764663,0
1,1532,51919,3578764663,3578764665,2
1,1532,51920,3578764663,3578764667,4
1,1532,51921,3578764663,3578764669,6
1,1532,51922,3578764663,3578764669,6
1,1532,51923,3578764663,3578764669,6
1,1532,51924,3578764663,3578764679,16
1,1532,51925,3578764663,3578764681,18
1,1532,51926,3578764663,3578764682,19
1,1532,51927,3578764663,3578764683,20
1,1532,51928,3578764663,3578764684,21
1,1532,51929,3578764663,3578764684,21
1,1532,51930,3578764663,3578764684,21
1,1532,51931,3578764663,3578764686,23
1,1532,51932,3578764663,3578764687,24
1,1532,51933,3578764663,3578764688,25
1,1532,51934,3578764663,3578764688,25
1,1532,51935,3578764663,3578764691,28
1,1532,51936,3578764663,3578764691,28
1,1532,51937,3578764663,3578764692,29
1,1532,51938,3578764663,3578764693,30
1,1532,51939,3578764663,3578764695,32
1,1532,51940,3578764663,3578764695,32
1,1532,51941,3578764663,3578764695,32
1,1532,51942,3578764663,3578764697,34
1,1532,51943,3578764663,3578764697,34
1,1532,51944,3578764663,3578764699,36
1,1532,51945,3578764663,3578764699,36
1,1532,51946,3578764663,3578764700,37
1,1532,51947,3578764663,3578764701,38
1,1532,51948,3578764663,3578764702,39
1,1532,51949,3578764663,3578764703,40
1,1532,51950,3578764663,3578764703,40
1,1532,51951,3578764663,3578764703,40
1,1532,51952,3578764663,3578764704,41
1,1532,51953,3578764663,3578764704,41
1,1532,51954,3578764663,3578764704,41
1,1532,51955,3578764663,3578764704,41
1,1532,51956,3578764663,3578764706,43
1,1532,51957,3578764663,3578764707,44
1,1532,51958,3578764663,3578764708,45
1,1532,51959,3578764663,3578764708,45
1,1532,51960,3578764663,3578764708,45
1,1532,51961,3578764663,3578764708,45
1,1532,51962,3578764663,3578764709,46
1,1532,51963,3578764663,3578764709,46
1,1532,51964,3578764663,3578764709,46
1,1532,51965,3578764663,3578764709,46
1,1532,51966,3578764663,3578764709,46
1,1532,51967,3578764663,3578764713,50
1,1533,51968,3578764727,3578764727,0
1,1533,51969,3578764727,3578764727,0
1,1533,51970,3578764727,3578764727,0
1,1533,51971,3578764727,3578764727,0
1,1533,51972,3578764727,3578764727,0
1,1533,51973,3578764727,3578764727,0
1,1533,51974,3578764727,3578764727,0
1,1533,51975,3578764727,3578764727,0
1,1533,51976,3578764727,3578764727,0
1,1533,51977,3578764727,3578764727,0
1,1533,51978,3578764727,3578764727,0
1,1533,51979,3578764727,3578764727,0
1,1533,51980,3578764727,3578764727,0
1,1533,51981,3578764727,3578764727,0
1,1533,51982,3578764727,3578764727,0
1,1533,51983,3578764727,3578764727,0
1,1533,51984,3578764727,3578764727,0
1,1533,51985,3578764727,3578764727,0
1,1533,51986,3578764727,3578764727,0
1,1533,51987,3578764727,3578764727,0
1,1533,51988,3578764727,3578764727,0
1,1533,51989,3578764727,3578764727,0
1,1533,51990,3578764727,3578764728,1
1,1533,51991,3578764727,3578764728,1
1,1533,51992,3578764727,3578764729,2
1,1533,51993,3578764727,3578764729,2
1,1533,51994,3578764727,3578764731,4
1,1533,51995,3578764727,3578764732,5
1,1533,51996,3578764727,3578764733,6
1,1533,51997,3578764727,3578764733,6
1,1533,51998,3578764727,3578764734,7
1,1533,51999,3578764727,3578764734,7
1,1533,52000,3578764727,3578764734,7
1,1533,52001,3578764727,3578764736,9
1,1533,52002,3578764727,3578764736,9
1,1533,52003,3578764727,3578764737,10
1,1533,52004,3578764727,3578764737,10
1,1533,52005,3578764727,3578764737,10
1,1533,52006,3578764727,3578764740,13
1,1533,52007,3578764727,3578764741,14
1,1533,52008,3578764727,3578764741,14
1,1533,52009,3578764727,3578764745,18
1,1533,52010,3578764727,3578764746,19
1,1533,52011,3578764727,3578764748,21
1,1533,52012,3578764727,3578764750,23
1,1533,52013,3578764727,3578764752,25
1,1533,52014,3578764727,3578764752,25
1,1533,52015,3578764727,3578764754,27
1,1533,52016,3578764727,3578764755,28
1,1533,52017,3578764727,3578764755,28
1,1533,52018,3578764727,3578764756,29
1,1533,52019,3578764727,3578764759,32
1,1533,52020,3578764727,3578764762,35
1,1533,52021,3578764727,3578764763,36
1,1533,52022,3578764727,3578764763,36
1,1533,52023,3578764727,3578764764,37
1,1533,52024,3578764727,3578764764,37
1,1533,52025,3578764727,3578764765,38
1,1533,52026,3578764727,3578764766,39
1,1533,52027,3578764727,3578764766,39
1,1533,52028,3578764727,3578764767,40
1,1533,52029,3578764727,3578764768,41
1,1533,52030,3578764727,3578764768,41
1,1533,52031,3578764727,3578764769,42
1,1533,52032,3578764727,3578764770,43
1,1533,52033,3578764727,3578764771,44
1,1533,52034,3578764727,3578764772,45
1,1533,52035,3578764727,3578764773,46
1,1533,52036,3578764727,3578764774,47
1,1533,52037,3578764727,3578764777,50
1,1534,52038,3578764791,3578764791,0
1,1534,52039,3578764791,3578764791,0
1,1534,52040,3578764791,3578764791,0
1,1534,52041,3578764791,3578764791,0
1,1534,52042,3578764791,3578764791,0
1,1534,52043,3578764791,3578764791,0
1,1534,52044,3578764791,3578764791,0
1,1534,52045,3578764791,3578764791,0
1,1534,52046,3578764791,3578764791,0
1,1534,52047,3578764791,3578764791,0
1,1534,52048,3578764791,3578764791,0
1,1534,52049,3578764791,3578764791,0
1,1534,52050,3578764791,3578764791,0
1,1534,52051,3578764791,3578764792,1
1,1534,52052,3578764791,3578764792,1
1,1534,52053,3578764791,3578764793,2
1,1534,52054,3578764791,3578764793,2
1,1534,52055,3578764791,3578764795,4
1,1534,52056,3578764791,3578764796,5
1,1534,52057,3578764791,3578764796,5
1,1534,52058,3578764791,3578764796,5
1,1534,52059,3578764791,3578764797,6
1,1534,52060,3578764791,3578764797,6
1,1534,52061,3578764791,3578764798,7
1,1534,52062,3578764791,3578764799,8
1,1534,52063,3578764791,3578764799,8
1,1534,52064,3578764791,3578764799,8
1,1534,52065,3578764791,3578764800,9
1,1534,52066,3578764791,3578764801,10
1,1534,52067,3578764791,3578764804,13
1,1534,52068,3578764791,3578764805,14
1,1534,52069,3578764791,3578764805,14
1,1534,52070,3578764791,3578764808,17
1,1534,52071,3578764791,3578764811,20
1,1534,52072,3578764791,3578764811,20
1,1534,52073,3578764791,3578764813,22
1,1534,52074,3578764791,3578764813,22
1,1534,52075,3578764791,3578764813,22
1,1534,52076,3578764791,3578764814,23
1,1534,52077,3578764791,3578764814,23
1,1534,52078,3578764791,3578764815,24
1,1534,52079,3578764791,3578764816,25
1,1534,52080,3578764791,3578764816,25
1,1534,52081,3578764791,3578764817,26
1,1534,52082,3578764791,3578764818,27
1,1534,52083,3578764791,3578764818,27
1,1534,52084,3578764791,3578764818,27
1,1534,52085,3578764791,3578764819,28
1,1534,52086,3578764791,3578764819,28
1,1534,52087,3578764791,3578764822,31
1,1534,52088,3578764791,3578764822,31
1,1534,52089,3578764791,3578764824,33
1,1534,52090,3578764791,3578764825,34
1,1534,52091,3578764791,3578764826,35
1,1534,52092,3578764791,3578764827,36
1,1534,52093,3578764791,3578764827,36
1,1534,52094,3578764791,3578764828,37
1,1534,52095,3578764791,3578764829,38
1,1534,52096,3578764791,3578764830,39
1,1534,52097,3578764791,3578764830,39
1,1534,52098,3578764791,3578764836,45
1,1534,52099,3578764791,3578764836,45
1,1534,52100,3578764791,3578764838,47
1,1534,52101,3578764791,3578764838,47
1,1534,52102,3578764791,3578764839,48
1,1534,52103,3578764791,3578764840,49
1,1534,52104,3578764791,3578764841,50
1,1535,52105,3578764855,3578764855,0
1,1535,52106,3578764855,3578764855,0
1,1535,52107,3578764855,3578764855,0
1,1535,52108,3578764855,3578764855,0
1,1535,52109,3578764855,3578764855,0
1,1535,52110,3578764855,3578764855,0
1,1535,52111,3578764855,3578764855,0
1,1535,52112,3578764855,3578764855,0
1,1535,52113,3578764855,3578764855,0
1,1535,52114,3578764855,3578764856,1
1,1535,52115,3578764855,3578764857,2
1,1535,52116,3578764855,3578764857,2
1,1535,52117,3578764855,3578764858,3
1,1535,52118,3578764855,3578764861,6
1,1535,52119,3578764855,3578764863,8
1,1535,52120,3578764855,3578764863,8
1,1535,52121,3578764855,3578764864,9
1,1535,52122,3578764855,3578764868,13
1,1535,52123,3578764855,3578764868,13
1,1535,52124,3578764855,3578764869,14
1,1535,52125,3578764855,3578764869,14
1,1535,52126,3578764855,3578764880,25
1,1535,52127,3578764855,3578764881,26
1,1535,52128,3578764855,3578764882,27
1,1535,52129,3578764855,3578764883,28
1,1535,52130,3578764855,3578764883,28
1,1535,52131,3578764855,3578764883,28
1,1535,52132,3578764855,3578764884,29
1,1535,52133,3578764855,3578764884,29
1,1535,52134,3578764855,3578764885,30
1,1535,52135,3578764855,3578764885,30
1,1535,52136,3578764855,3578764886,31
1,1535,52137,3578764855,3578764887,32
1,1535,52138,3578764855,3578764889,34
1,1535,52139,3578764855,3578764891,36
1,1535,52140,3578764855,3578764892,37
1,1535,52141,3578764855,3578764892,37
1,1535,52142,3578764855,3578764893,38
1,1535,52143,3578764855,3578764894,39
1,1535,52144,3578764855,3578764894,39
1,1535,52145,3578764855,3578764895,40
1,1535,52146,3578764855,3578764896,41
1,1535,52147,3578764855,3578764897,42
1,1535,52148,3578764855,3578764897,42
1,1535,52149,3578764855,3578764898,43
1,1535,52150,3578764855,3578764898,43
1,1535,52151,3578764855,3578764899,44
1,1535,52152,3578764855,3578764899,44
1,1535,52153,3578764855,3578764899,44
1,1535,52154,3578764855,3578764901,46
1,1535,52155,3578764855,3578764902,47
1,1535,52156,3578764855,3578764903,48
1,1535,52157,3578764855,3578764903,48
1,1535,52158,3578764855,3578764904,49
1,1535,52159,3578764855,3578764904,49
1,1535,52160,3578764855,3578764904,49
1,1536,52161,3578764919,3578764919,0
1,1536,52162,3578764919,3578764919,0
1,1536,52163,3578764919,3578764919,0
1,1536,52164,3578764919,3578764919,0
1,1536,52165,3578764919,3578764919,0
1,1536,52166,3578764919,3578764919,0
1,1536,52167,3578764919,3578764919,0
1,1536,52168,3578764919,3578764919,0
1,1536,52169,3578764919,3578764919,0
1,1536,52170,3578764919,3578764919,0
1,1536,52171,3578764919,3578764919,0
1,1536,52172,3578764919,3578764919,0
1,1536,52173,3578764919,3578764919,0
1,1536,52174,3578764919,3578764919,0
1,1536,52175,3578764919,3578764919,0
1,1536,52176,3578764919,3578764919,0
1,1536,52177,3578764919,3578764919,0
1,1536,52178,3578764919,3578764919,0
1,1536,52179,3578764919,3578764919,0
1,1536,52180,3578764919,3578764919,0
1,1536,52181,3578764919,3578764919,0
1,1536,52182,3578764919,3578764919,0
1,1536,52183,3578764919,3578764919,0
1,1536,52184,3578764919,3578764920,1
1,1536,52185,3578764919,3578764921,2
1,1536,52186,3578764919,3578764921,2
1,1536,52187,3578764919,3578764921,2
1,1536,52188,3578764919,3578764921,2
1,1536,52189,3578764919,3578764922,3
1,1536,52190,3578764919,3578764923,4
1,1536,52191,3578764919,3578764923,4
1,1536,52192,3578764919,3578764924,5
1,1536,52193,3578764919,3578764924,5
1,1536,52194,3578764919,3578764925,6
1,1536,52195,3578764919,3578764925,6
1,1536,52196,3578764919,3578764926,7
1,1536,52197,3578764919,3578764926,7
1,1536,52198,3578764919,3578764928,9
1,1536,52199,3578764919,3578764929,10
1,1536,52200,3578764919,3578764929,10
1,1536,52201,3578764919,3578764930,11
1,1536,52202,3578764919,3578764931,12
1,1536,52203,3578764919,3578764933,14
1,1536,52204,3578764919,3578764933,14
1,1536,52205,3578764919,3578764933,14
1,1536,52206,3578764919,3578764934,15
1,1536,52207,3578764919,3578764934,15
1,1536,52208,3578764919,3578764934,15
1,1536,52209,3578764919,3578764935,16
1,1536,52210,3578764919,3578764936,17
1,1536,52211,3578764919,3578764936,17
1,1536,52212,3578764919,3578764937,18
1,1536,52213,3578764919,3578764940,21
1,1536,52214,3578764919,3578764942,23
1,1536,52215,3578764919,3578764946,27
1,1536,52216,3578764919,3578764948,29
1,1536,52217,3578764919,3578764948,29
1,1536,52218,3578764919,3578764950,31
1,1536,52219,3578764919,3578764953,34
1,1536,52220,3578764919,3578764955,36
1,1536,52221,3578764919,3578764955,36
1,1536,52222,3578764919,3578764955,36
1,1536,52223,3578764919,3578764955,36
1,1536,52224,3578764919,3578764959,40
1,1536,52225,3578764919,3578764963,44
1,1536,52226,3578764919,3578764963,44
1,1536,52227,3578764919,3578764964,45
1,1536,52228,3578764919,3578764964,45
1,1536,52229,3578764919,3578764964,45
1,1536,52230,3578764919,3578764965,46
1,1536,52231,3578764919,3578764965,46
1,1536,52232,3578764919,3578764966,47
1,1536,52233,3578764919,3578764967,48
1,1536,52234,3578764919,3578764968,49
1,1536,52235,3578764919,3578764968,49
1,1536,52236,3578764919,3578764969,50
1,1536,52237,3578764919,3578764969,50
1,1537,52238,3578764983,3578764983,0
1,1537,52239,3578764983,3578764983,0
1,1537,52240,3578764983,3578764983,0
1,1537,52241,3578764983,3578764983,0
1,1537,52242,3578764983,3578764983,0
1,1537,52243,3578764983,3578764983,0
1,1537,52244,3578764983,3578764983,0
1,1537,52245,3578764983,3578764983,0
1,1537,52246,3578764983,3578764983,0
1,1537,52247,3578764983,3578764983,0
1,1537,52248,3578764983,3578764983,0
1,1537,52249,3578764983,3578764983,0
1,1537,52250,3578764983,3578764983,0
1,1537,52251,3578764983,3578764985,2
1,1537,52252,3578764983,3578764989,6
1,1537,52253,3578764983,3578764990,7
1,1537,52254,3578764983,3578764991,8
1,1537,52255,3578764983,3578764992,9
1,1537,52256,3578764983,3578764992,9
1,1537,52257,3578764983,3578764994,11
1,1537,52258,3578764983,3578764994,11
1,1537,52259,3578764983,3578764996,13
1,1537,52260,3578764983,3578764996,13
1,1537,52261,3578764983,3578764996,13
1,1537,52262,3578764983,3578764996,13
1,1537,52263,3578764983,3578764997,14
1,1537,52264,3578764983,3578764998,15
1,1537,52265,3578764983,3578764999,16
1,1537,52266,3578764983,3578764999,16
1,1537,52267,3578764983,3578765001,18
1,1537,52268,3578764983,3578765002,19
1,1537,52269,3578764983,3578765004,21
1,1537,52270,3578764983,3578765005,22
1,1537,52271,3578764983,3578765005,22
1,1537,52272,3578764983,3578765011,28
1,1537,52273,3578764983,3578765012,29
1,1537,52274,3578764983,3578765012,29
1,1537,52275,3578764983,3578765013,30
1,1537,52276,3578764983,3578765013,30
1,1537,52277,3578764983,3578765013,30
1,1537,52278,3578764983,3578765014,31
1,1537,52279,3578764983,3578765015,32
1,1537,52280,3578764983,3578765016,33
1,1537,52281,3578764983,3578765016,33
1,1537,52282,3578764983,3578765017,34
1,1537,52283,3578764983,3578765018,35
1,1537,52284,3578764983,3578765018,35
1,1537,52285,3578764983,3578765019,36
1,1537,52286,3578764983,3578765019,36
1,1537,52287,3578764983,3578765021,38
1,1537,52288,3578764983,3578765022,39
1,1537,52289,3578764983,3578765025,42
1,1537,52290,3578764983,3578765025,42
1,1537,52291,3578764983,3578765027,44
1,1537,52292,3578764983,3578765027,44
1,1537,52293,3578764983,3578765028,45
1,1537,52294,3578764983,3578765029,46
1,1537,52295,3578764983,3578765030,47
1,1537,52296,3578764983,3578765030,47
1,1538,52297,3578765046,3578765046,0
1,1538,52298,3578765046,3578765046,0
1,1538,52299,3578765046,3578765046,0
1,1538,52300,3578765046,3578765046,0
1,1538,52301,3578765046,3578765046,0
1,1538,52302,3578765046,3578765046,0
1,1538,52303,3578765046,3578765047,1
1,1538,52304,3578765046,3578765047,1
1,1538,52305,3578765046,3578765047,1
1,1538,52306,3578765046,3578765047,1
1,1538,52307,3578765046,3578765048,2
1,1538,52308,3578765046,3578765050,4
1,1538,52309,3578765046,3578765051,5
1,1538,52310,3578765046,3578765051,5
1,1538,52311,3578765046,3578765052,6
1,1538,52312,3578765046,3578765054,8
1,1538,52313,3578765046,3578765055,9
1,1538,52314,3578765046,3578765057,11
1,1538,52315,3578765046,3578765057,11
1,1538,52316,3578765046,3578765057,11
1,1538,52317,3578765046,3578765058,12
1,1538,52318,3578765046,3578765060,14
1,1538,52319,3578765046,3578765060,14
1,1538,52320,3578765046,3578765061,15
1,1538,52321,3578765046,3578765063,17
1,1538,52322,3578765046,3578765064,18
1,1538,52323,3578765046,3578765067,21
1,1538,52324,3578765046,3578765068,22
1,1538,52325,3578765046,3578765069,23
1,1538,52326,3578765046,3578765070,24
1,1538,52327,3578765046,3578765079,33
1,1538,52328,3578765046,3578765081,35
1,1538,52329,3578765046,3578765082,36
1,1538,52330,3578765046,3578765082,36
1,1538,52331,3578765046,3578765083,37
1,1538,52332,3578765046,3578765084,38
1,1538,52333,3578765046,3578765084,38
1,1538,52334,3578765046,3578765084,38
1,1538,52335,3578765046,3578765085,39
1,1538,52336,3578765046,3578765085,39
1,1538,52337,3578765046,3578765087,41
1,1538,52338,3578765046,3578765088,42
1,1538,52339,3578765046,3578765089,43
1,1538,52340,3578765046,3578765091,45
1,1538,52341,3578765046,3578765091,45
1,1538,52342,3578765046,3578765092,46
1,1538,52343,3578765046,3578765093,47
1,1538,52344,3578765046,3578765094,48
1,1538,52345,3578765046,3578765094,48
1,1538,52346,3578765046,3578765095,49
1,1538,52347,3578765046,3578765095,49
1,1538,52348,3578765046,3578765096,50
1,1539,52349,3578765111,3578765111,0
1,1539,52350,3578765111,3578765111,0
1,1539,52351,3578765111,3578765111,0
1,1539,52352,3578765111,3578765111,0
1,1539,52353,3578765111,3578765111,0
1,1539,52354,3578765111,3578765111,0
1,1539,52355,3578765111,3578765111,0
1,1539,52356,3578765111,3578765111,0
1,1539,52357,3578765111,3578765111,0
1,1539,52358,3578765111,3578765111,0
1,1539,52359,3578765111,3578765111,0
1,1539,52360,3578765111,3578765111,0
1,1539,52361,3578765111,3578765111,0
1,1539,52362,3578765111,3578765111,0
1,1539,52363,3578765111,3578765111,0
1,1539,52364,3578765111,3578765111,0
1,1539,52365,3578765111,3578765111,0
1,1539,52366,3578765111,3578765111,0
1,1539,52367,3578765111,3578765111,0
1,1539,52368,3578765111,3578765111,0
1,1539,52369,3578765111,3578765111,0
1,1539,52370,3578765111,3578765111,0
1,1539,52371,3578765111,3578765111,0
1,1539,52372,3578765111,3578765112,1
1,1539,52373,3578765111,3578765113,2
1,1539,52374,3578765111,3578765114,3
1,1539,52375,3578765111,3578765114,3
1,1539,52376,3578765111,3578765114,3
1,1539,52377,3578765111,3578765114,3
1,1539,52378,3578765111,3578765115,4
1,1539,52379,3578765111,3578765116,5
1,1539,52380,3578765111,3578765119,8
1,1539,52381,3578765111,3578765119,8
1,1539,52382,3578765111,3578765120,9
1,1539,52383,3578765111,3578765120,9
1,1539,52384,3578765111,3578765121,10
1,1539,52385,3578765111,3578765121,10
1,1539,52386,3578765111,3578765122,11
1,1539,52387,3578765111,3578765122,11
1,1539,52388,3578765111,3578765122,11
1,1539,52389,3578765111,3578765123,12
1,1539,52390,3578765111,3578765124,13
1,1539,52391,3578765111,3578765124,13
1,1539,52392,3578765111,3578765124,13
1,1539,52393,3578765111,3578765126,15
1,1539,52394,3578765111,3578765126,15
1,1539,52395,3578765111,3578765127,16
1,1539,52396,3578765111,3578765127,16
1,1539,52397,3578765111,3578765128,17
1,1539,52398,3578765111,3578765128,17
1,1539,52399,3578765111,3578765129,18
1,1539,52400,3578765111,3578765129,18
1,1539,52401,3578765111,3578765129,18
1,1539,52402,3578765111,3578765130,19
1,1539,52403,3578765111,3578765130,19
1,1539,52404,3578765111,3578765133,22
1,1539,52405,3578765111,3578765133,22
1,1539,52406,3578765111,3578765133,22
1,1539,52407,3578765111,3578765133,22
1,1539,52408,3578765111,3578765133,22
1,1539,52409,3578765111,3578765134,23
1,1539,52410,3578765111,3578765135,24
1,1539,52411,3578765111,3578765137,26
1,1539,52412,3578765111,3578765137,26
1,1539,52413,3578765111,3578765138,27
1,1539,52414,3578765111,3578765138,27
1,1539,52415,3578765111,3578765138,27
1,1539,52416,3578765111,3578765140,29
1,1539,52417,3578765111,3578765141,30
1,1539,52418,3578765111,3578765141,30
1,1539,52419,3578765111,3578765143,32
1,1539,52420,3578765111,3578765146,35
1,1539,52421,3578765111,3578765147,36
1,1539,52422,3578765111,3578765148,37
1,1539,52423,3578765111,3578765149,38
1,1539,52424,3578765111,3578765151,40
1,1539,52425,3578765111,3578765153,42
1,1539,52426,3578765111,3578765154,43
1,1539,52427,3578765111,3578765155,44
1,1539,52428,3578765111,3578765155,44
1,1539,52429,3578765111,3578765155,44
1,1539,52430,3578765111,3578765156,45
1,1539,52431,3578765111,3578765159,48
1,1540,52432,3578765176,3578765176,0
1,1540,52433,3578765176,3578765176,0
1,1540,52434,3578765176,3578765176,0
1,1540,52435,3578765176,3578765176,0
1,1540,52436,3578765176,3578765176,0
1,1540,52437,3578765176,3578765176,0
1,1540,52438,3578765176,3578765176,0
1,1540,52439,3578765176,3578765176,0
1,1540,52440,3578765176,3578765176,0
1,1540,52441,3578765176,3578765176,0
1,1540,52442,3578765176,3578765176,0
1,1540,52443,3578765176,3578765176,0
1,1540,52444,3578765176,3578765176,0
1,1540,52445,3578765176,3578765176,0
1,1540,52446,3578765176,3578765176,0
1,1540,52447,3578765176,3578765176,0
1,1540,52448,3578765176,3578765176,0
1,1540,52449,3578765176,3578765177,1
1,1540,52450,3578765176,3578765177,1
1,1540,52451,3578765176,3578765178,2
1,1540,52452,3578765176,3578765178,2
1,1540,52453,3578765176,3578765179,3
1,1540,52454,3578765176,3578765181,5
1,1540,52455,3578765176,3578765181,5
1,1540,52456,3578765176,3578765182,6
1,1540,52457,3578765176,3578765182,6
1,1540,52458,3578765176,3578765183,7
1,1540,52459,3578765176,3578765188,12
1,1540,52460,3578765176,3578765191,15
1,1540,52461,3578765176,3578765191,15
1,1540,52462,3578765176,3578765191,15
1,1540,52463,3578765176,3578765192,16
1,1540,52464,3578765176,3578765194,18
1,1540,52465,3578765176,3578765194,18
1,1540,52466,3578765176,3578765196,20
1,1540,52467,3578765176,3578765196,20
1,1540,52468,3578765176,3578765196,20
1,1540,52469,3578765176,3578765197,21
1,1540,52470,3578765176,3578765197,21
1,1540,52471,3578765176,3578765199,23
1,1540,52472,3578765176,3578765200,24
1,1540,52473,3578765176,3578765201,25
1,1540,52474,3578765176,3578765202,26
1,1540,52475,3578765176,3578765204,28
1,1540,52476,3578765176,3578765204,28
1,1540,52477,3578765176,3578765206,30
1,1540,52478,3578765176,3578765209,33
1,1540,52479,3578765176,3578765210,34
1,1540,52480,3578765176,3578765212,36
1,1540,52481,3578765176,3578765213,37
1,1540,52482,3578765176,3578765214,38
1,1540,52483,3578765176,3578765214,38
1,1540,52484,3578765176,3578765215,39
1,1540,52485,3578765176,3578765215,39
1,1540,52486,3578765176,3578765215,39
1,1540,52487,3578765176,3578765216,40
1,1540,52488,3578765176,3578765217,41
1,1540,52489,3578765176,3578765218,42
1,1540,52490,3578765176,3578765218,42
1,1540,52491,3578765176,3578765219,43
1,1540,52492,3578765176,3578765219,43
1,1540,52493,3578765176,3578765220,44
1,1540,52494,3578765176,3578765222,46
1,1540,52495,3578765176,3578765222,46
1,1540,52496,3578765176,3578765225,49
1,1540,52497,3578765176,3578765225,49
1,1540,52498,3578765176,3578765225,49
1,1541,52499,3578765241,3578765241,0
1,1541,52500,3578765241,3578765241,0
1,1541,52501,3578765241,3578765241,0
1,1541,52502,3578765241,3578765241,0
1,1541,52503,3578765241,3578765241,0
1,1541,52504,3578765241,3578765241,0
1,1541,52505,3578765241,3578765241,0
1,1541,52506,3578765241,3578765241,0
1,1541,52507,3578765241,3578765242,1
1,1541,52508,3578765241,3578765242,1
1,1541,52509,3578765241,3578765242,1
1,1541,52510,3578765241,3578765242,1
1,1541,52511,3578765241,3578765242,1
1,1541,52512,3578765241,3578765242,1
1,1541,52513,3578765241,3578765242,1
1,1541,52514,3578765241,3578765242,1
1,1541,52515,3578765241,3578765247,6
1,1541,52516,3578765241,3578765247,6
1,1541,52517,3578765241,3578765249,8
1,1541,52518,3578765241,3578765250,9
1,1541,52519,3578765241,3578765252,11
1,1541,52520,3578765241,3578765253,12
1,1541,52521,3578765241,3578765253,12
1,1541,52522,3578765241,3578765257,16
1,1541,52523,3578765241,3578765257,16
1,1541,52524,3578765241,3578765257,16
1,1541,52525,3578765241,3578765258,17
1,1541,52526,3578765241,3578765259,18
1,1541,52527,3578765241,3578765259,18
1,1541,52528,3578765241,3578765261,20
1,1541,52529,3578765241,3578765263,22
1,1541,52530,3578765241,3578765268,27
1,1541,52531,3578765241,3578765268,27
1,1541,52532,3578765241,3578765269,28
1,1541,52533,3578765241,3578765269,28
1,1541,52534,3578765241,3578765280,39
1,1541,52535,3578765241,3578765281,40
1,1541,52536,3578765241,3578765283,42
1,1541,52537,3578765241,3578765283,42
1,1541,52538,3578765241,3578765283,42
1,1541,52539,3578765241,3578765284,43
1,1541,52540,3578765241,3578765285,44
1,1541,52541,3578765241,3578765285,44
1,1541,52542,3578765241,3578765287,46
1,1541,52543,3578765241,3578765287,46
1,1541,52544,3578765241,3578765289,48
1,1542,52545,3578765305,3578765305,0
1,1542,52546,3578765305,3578765305,0
1,1542,52547,3578765305,3578765305,0
1,1542,52548,3578765305,3578765305,0
1,1542,52549,3578765305,3578765305,0
1,1542,52550,3578765305,3578765305,0
1,1542,52551,3578765305,3578765305,0
1,1542,52552,3578765305,3578765305,0
1,1542,52553,3578765305,3578765305,0
1,1542,52554,3578765305,3578765305,0
1,1542,52555,3578765305,3578765305,0
1,1542,52556,3578765305,3578765305,0
1,1542,52557,3578765305,3578765305,0
1,1542,52558,3578765305,3578765305,0
1,1542,52559,3578765305,3578765305,0
1,1542,52560,3578765305,3578765305,0
1,1542,52561,3578765305,3578765305,0
1,1542,52562,3578765305,3578765306,1
1,1542,52563,3578765305,3578765306,1
1,1542,52564,3578765305,3578765306,1
1,1542,52565,3578765305,3578765306,1
1,1542,52566,3578765305,3578765306,1
1,1542,52567,3578765305,3578765306,1
1,1542,52568,3578765305,3578765306,1
1,1542,52569,3578765305,3578765307,2
1,1542,52570,3578765305,3578765307,2
1,1542,52571,3578765305,3578765308,3
1,1542,52572,3578765305,3578765308,3
1,1542,52573,3578765305,3578765308,3
1,1542,52574,3578765305,3578765309,4
1,1542,52575,3578765305,3578765309,4
1,1542,52576,3578765305,3578765310,5
1,1542,52577,3578765305,3578765310,5
1,1542,52578,3578765305,3578765312,7
1,1542,52579,3578765305,3578765313,8
1,1542,52580,3578765305,3578765313,8
1,1542,52581,3578765305,3578765314,9
1,1542,52582,3578765305,3578765314,9
1,1542,52583,3578765305,3578765314,9
1,1542,52584,3578765305,3578765314,9
1,1542,52585,3578765305,3578765315,10
1,1542,52586,3578765305,3578765315,10
1,1542,52587,3578765305,3578765316,11
1,1542,52588,3578765305,3578765319,14
1,1542,52589,3578765305,3578765319,14
1,1542,52590,3578765305,3578765321,16
1,1542,52591,3578765305,3578765321,16
1,1542,52592,3578765305,3578765321,16
1,1542,52593,3578765305,3578765321,16
1,1542,52594,3578765305,3578765322,17
1,1542,52595,3578765305,3578765322,17
1,1542,52596,3578765305,3578765323,18
1,1542,52597,3578765305,3578765324,19
1,1542,52598,3578765305,3578765324,19
1,1542,52599,3578765305,3578765325,20
1,1542,52600,3578765305,3578765326,21
1,1542,52601,3578765305,3578765326,21
1,1542,52602,3578765305,3578765327,22
1,1542,52603,3578765305,3578765327,22
1,1542,52604,3578765305,3578765329,24
1,1542,52605,3578765305,3578765329,24
1,1542,52606,3578765305,3578765329,24
1,1542,52607,3578765305,3578765329,24
1,1542,52608,3578765305,3578765331,26
1,1542,52609,3578765305,3578765331,26
1,1542,52610,3578765305,3578765332,27
1,1542,52611,3578765305,3578765333,28
1,1542,52612,3578765305,3578765333,28
1,1542,52613,3578765305,3578765334,29
1,1542,52614,3578765305,3578765334,29
1,1542,52615,3578765305,3578765334,29
1,1542,52616,3578765305,3578765336,31
1,1542,52617,3578765305,3578765337,32
1,1542,52618,3578765305,3578765337,32
1,1542,52619,3578765305,3578765337,32
1,1542,52620,3578765305,3578765338,33
1,1542,52621,3578765305,3578765338,33
1,1542,52622,3578765305,3578765341,36
1,1542,52623,3578765305,3578765342,37
1,1542,52624,3578765305,3578765343,38
1,1542,52625,3578765305,3578765346,41
1,1542,52626,3578765305,3578765346,41
1,1542,52627,3578765305,3578765348,43
1,1542,52628,3578765305,3578765349,44
1,1542,52629,3578765305,3578765350,45
1,1542,52630,3578765305,3578765351,46
1,1542,52631,3578765305,3578765354,49
1,1542,52632,3578765305,3578765354,49
1,1542,52633,3578765305,3578765355,50
1,1542,52634,3578765305,3578765355,50
1,1543,52635,3578765369,3578765369,0
1,1543,52636,3578765369,3578765369,0
1,1543,52637,3578765369,3578765369,0
1,1543,52638,3578765369,3578765369,0
1,1543,52639,3578765369,3578765369,0
1,1543,52640,3578765369,3578765369,0
1,1543,52641,3578765369,3578765369,0
1,1543,52642,3578765369,3578765369,0
1,1543,52643,3578765369,3578765369,0
1,1543,52644,3578765369,3578765369,0
1,1543,52645,3578765369,3578765369,0
1,1543,52646,3578765369,3578765369,0
1,1543,52647,3578765369,3578765369,0
1,1543,52648,3578765369,3578765369,0
1,1543,52649,3578765369,3578765369,0
1,1543,52650,3578765369,3578765370,1
1,1543,52651,3578765369,3578765371,2
1,1543,52652,3578765369,3578765372,3
1,1543,52653,3578765369,3578765374,5
1,1543,52654,3578765369,3578765375,6
1,1543,52655,3578765369,3578765377,8
1,1543,52656,3578765369,3578765377,8
1,1543,52657,3578765369,3578765378,9
1,1543,52658,3578765369,3578765378,9
1,1543,52659,3578765369,3578765380,11
1,1543,52660,3578765369,3578765381,12
1,1543,52661,3578765369,3578765381,12
1,1543,52662,3578765369,3578765382,13
1,1543,52663,3578765369,3578765382,13
1,1543,52664,3578765369,3578765383,14
1,1543,52665,3578765369,3578765383,14
1,1543,52666,3578765369,3578765388,19
1,1543,52667,3578765369,3578765391,22
1,1543,52668,3578765369,3578765392,23
1,1543,52669,3578765369,3578765392,23
1,1543,52670,3578765369,3578765392,23
1,1543,52671,3578765369,3578765394,25
1,1543,52672,3578765369,3578765395,26
1,1543,52673,3578765369,3578765396,27
1,1543,52674,3578765369,3578765397,28
1,1543,52675,3578765369,3578765397,28
1,1543,52676,3578765369,3578765397,28
1,1543,52677,3578765369,3578765397,28
1,1543,52678,3578765369,3578765399,30
1,1543,52679,3578765369,3578765400,31
1,1543,52680,3578765369,3578765400,31
1,1543,52681,3578765369,3578765401,32
1,1543,52682,3578765369,3578765403,34
1,1543,52683,3578765369,3578765404,35
1,1543,52684,3578765369,3578765404,35
1,1543,52685,3578765369,3578765406,37
1,1543,52686,3578765369,3578765409,40
1,1543,52687,3578765369,3578765410,41
1,1543,52688,3578765369,3578765412,43
1,1543,52689,3578765369,3578765413,44
1,1543,52690,3578765369,3578765414,45
1,1543,52691,3578765369,3578765414,45
1,1543,52692,3578765369,3578765415,46
1,1543,52693,3578765369,3578765415,46
1,1543,52694,3578765369,3578765416,47
1,1543,52695,3578765369,3578765417,48
1,1543,52696,3578765369,3578765418,49
1,1543,52697,3578765369,3578765418,49
1,1543,52698,3578765369,3578765418,49
1,1543,52699,3578765369,3578765419,50
1,1544,52700,3578765434,3578765434,0
1,1544,52701,3578765434,3578765434,0
1,1544,52702,3578765434,3578765434,0
1,1544,52703,3578765434,3578765434,0
1,1544,52704,3578765434,3578765434,0
1,1544,52705,3578765434,3578765434,0
1,1544,52706,3578765434,3578765434,0
1,1544,52707,3578765434,3578765434,0
1,1544,52708,3578765434,3578765434,0
1,1544,52709,3578765434,3578765434,0
1,1544,52710,3578765434,3578765434,0
1,1544,52711,3578765434,3578765434,0
1,1544,52712,3578765434,3578765434,0
1,1544,52713,3578765434,3578765434,0
1,1544,52714,3578765434,3578765434,0
1,1544,52715,3578765434,3578765435,1
1,1544,52716,3578765434,3578765436,2
1,1544,52717,3578765434,3578765436,2
1,1544,52718,3578765434,3578765437,3
1,1544,52719,3578765434,3578765437,3
1,1544,52720,3578765434,3578765439,5
1,1544,52721,3578765434,3578765440,6
1,1544,52722,3578765434,3578765440,6
1,1544,52723,3578765434,3578765442,8
1,1544,52724,3578765434,3578765442,8
1,1544,52725,3578765434,3578765447,13
1,1544,52726,3578765434,3578765447,13
1,1544,52727,3578765434,3578765449,15
1,1544,52728,3578765434,3578765450,16
1,1544,52729,3578765434,3578765451,17
1,1544,52730,3578765434,3578765452,18
1,1544,52731,3578765434,3578765453,19
1,1544,52732,3578765434,3578765455,21
1,1544,52733,3578765434,3578765456,22
1,1544,52734,3578765434,3578765457,23
1,1544,52735,3578765434,3578765457,23
1,1544,52736,3578765434,3578765457,23
1,1544,52737,3578765434,3578765458,24
1,1544,52738,3578765434,3578765459,25
1,1544,52739,3578765434,3578765459,25
1,1544,52740,3578765434,3578765462,28
1,1544,52741,3578765434,3578765463,29
1,1544,52742,3578765434,3578765463,29
1,1544,52743,3578765434,3578765468,34
1,1544,52744,3578765434,3578765468,34
1,1544,52745,3578765434,3578765470,36
1,1544,52746,3578765434,3578765470,36
1,1544,52747,3578765434,3578765470,36
1,1544,52748,3578765434,3578765479,45
1,1544,52749,3578765434,3578765481,47
1,1544,52750,3578765434,3578765482,48
1,1544,52751,3578765434,3578765482,48
1,1544,52752,3578765434,3578765483,49
1,1544,52753,3578765434,3578765483,49
1,1544,52754,3578765434,3578765484,50
1,1545,52755,3578765499,3578765499,0
1,1545,52756,3578765499,3578765499,0
1,1545,52757,3578765499,3578765499,0
1,1545,52758,3578765499,3578765499,0
1,1545,52759,3578765499,3578765499,0
1,1545,52760,3578765499,3578765499,0
1,1545,52761,3578765499,3578765499,0
1,1545,52762,3578765499,3578765499,0
1,1545,52763,3578765499,3578765499,0
1,1545,52764,3578765499,3578765499,0
1,1545,52765,3578765499,3578765499,0
1,1545,52766,3578765499,3578765499,0
1,1545,52767,3578765499,3578765499,0
1,1545,52768,3578765499,3578765499,0
1,1545,52769,3578765499,3578765499,0
1,1545,52770,3578765499,3578765499,0
1,1545,52771,3578765499,3578765499,0
1,1545,52772,3578765499,3578765499,0
1,1545,52773,3578765499,3578765501,2
1,1545,52774,3578765499,3578765501,2
1,1545,52775,3578765499,3578765502,3
1,1545,52776,3578765499,3578765502,3
1,1545,52777,3578765499,3578765503,4
1,1545,52778,3578765499,3578765503,4
1,1545,52779,3578765499,3578765503,4
1,1545,52780,3578765499,3578765503,4
1,1545,52781,3578765499,3578765504,5
1,1545,52782,3578765499,3578765504,5
1,1545,52783,3578765499,3578765505,6
1,1545,52784,3578765499,3578765506,7
1,1545,52785,3578765499,3578765507,8
1,1545,52786,3578765499,3578765508,9
1,1545,52787,3578765499,3578765508,9
1,1545,52788,3578765499,3578765508,9
1,1545,52789,3578765499,3578765508,9
1,1545,52790,3578765499,3578765508,9
1,1545,52791,3578765499,3578765509,10
1,1545,52792,3578765499,3578765510,11
1,1545,52793,3578765499,3578765512,13
1,1545,52794,3578765499,3578765512,13
1,1545,52795,3578765499,3578765512,13
1,1545,52796,3578765499,3578765513,14
1,1545,52797,3578765499,3578765513,14
1,1545,52798,3578765499,3578765514,15
1,1545,52799,3578765499,3578765514,15
1,1545,52800,3578765499,3578765515,16
1,1545,52801,3578765499,3578765517,18
1,1545,52802,3578765499,3578765519,20
1,1545,52803,3578765499,3578765520,21
1,1545,52804,3578765499,3578765520,21
1,1545,52805,3578765499,3578765521,22
1,1545,52806,3578765499,3578765521,22
1,1545,52807,3578765499,3578765521,22
1,1545,52808,3578765499,3578765521,22
1,1545,52809,3578765499,3578765522,23
1,1545,52810,3578765499,3578765523,24
1,1545,52811,3578765499,3578765523,24
1,1545,52812,3578765499,3578765525,26
1,1545,52813,3578765499,3578765526,27
1,1545,52814,3578765499,3578765527,28
1,1545,52815,3578765499,3578765528,29
1,1545,52816,3578765499,3578765529,30
1,1545,52817,3578765499,3578765529,30
1,1545,52818,3578765499,3578765529,30
1,1545,52819,3578765499,3578765531,32
1,1545,52820,3578765499,3578765531,32
1,1545,52821,3578765499,3578765531,32
1,1545,52822,3578765499,3578765532,33
1,1545,52823,3578765499,3578765532,33
1,1545,52824,3578765499,3578765533,34
1,1545,52825,3578765499,3578765533,34
1,1545,52826,3578765499,3578765533,34
1,1545,52827,3578765499,3578765534,35
1,1545,52828,3578765499,3578765535,36
1,1545,52829,3578765499,3578765536,37
1,1545,52830,3578765499,3578765536,37
1,1545,52831,3578765499,3578765536,37
1,1545,52832,3578765499,3578765537,38
1,1545,52833,3578765499,3578765540,41
1,1545,52834,3578765499,3578765540,41
1,1545,52835,3578765499,3578765541,42
1,1545,52836,3578765499,3578765543,44
1,1545,52837,3578765499,3578765545,46
1,1545,52838,3578765499,3578765546,47
1,1545,52839,3578765499,3578765547,48
1,1545,52840,3578765499,3578765547,48
1,1545,52841,3578765499,3578765549,50
1,1546,52842,3578765564,3578765564,0
1,1546,52843,3578765564,3578765564,0
1,1546,52844,3578765564,3578765564,0
1,1546,52845,3578765564,3578765564,0
1,1546,52846,3578765564,3578765564,0
1,1546,52847,3578765564,3578765564,0
1,1546,52848,3578765564,3578765564,0
1,1546,52849,3578765564,3578765564,0
1,1546,52850,3578765564,3578765564,0
1,1546,52851,3578765564,3578765564,0
1,1546,52852,3578765564,3578765564,0
1,1546,52853,3578765564,3578765564,0
1,1546,52854,3578765564,3578765564,0
1,1546,52855,3578765564,3578765564,0
1,1546,52856,3578765564,3578765565,1
1,1546,52857,3578765564,3578765566,2
1,1546,52858,3578765564,3578765566,2
1,1546,52859,3578765564,3578765567,3
1,1546,52860,3578765564,3578765568,4
1,1546,52861,3578765564,3578765568,4
1,1546,52862,3578765564,3578765568,4
1,1546,52863,3578765564,3578765572,8
1,1546,52864,3578765564,3578765574,10
1,1546,52865,3578765564,3578765575,11
1,1546,52866,3578765564,3578765576,12
1,1546,52867,3578765564,3578765576,12
1,1546,52868,3578765564,3578765580,16
1,1546,52869,3578765564,3578765580,16
1,1546,52870,3578765564,3578765580,16
1,1546,52871,3578765564,3578765581,17
1,1546,52872,3578765564,3578765581,17
1,1546,52873,3578765564,3578765581,17
1,1546,52874,3578765564,3578765582,18
1,1546,52875,3578765564,3578765582,18
1,1546,52876,3578765564,3578765588,24
1,1546,52877,3578765564,3578765590,26
1,1546,52878,3578765564,3578765591,27
1,1546,52879,3578765564,3578765591,27
1,1546,52880,3578765564,3578765592,28
1,1546,52881,3578765564,3578765593,29
1,1546,52882,3578765564,3578765593,29
1,1546,52883,3578765564,3578765594,30
1,1546,52884,3578765564,3578765595,31
1,1546,52885,3578765564,3578765596,32
1,1546,52886,3578765564,3578765596,32
1,1546,52887,3578765564,3578765597,33
1,1546,52888,3578765564,3578765598,34
1,1546,52889,3578765564,3578765599,35
1,1546,52890,3578765564,3578765599,35
1,1546,52891,3578765564,3578765600,36
1,1546,52892,3578765564,3578765601,37
1,1546,52893,3578765564,3578765603,39
1,1546,52894,3578765564,3578765604,40
1,1546,52895,3578765564,3578765604,40
1,1546,52896,3578765564,3578765609,45
1,1546,52897,3578765564,3578765609,45
1,1546,52898,3578765564,3578765612,48
1,1546,52899,3578765564,3578765613,49
1,1546,52900,3578765564,3578765613,49
1,1546,52901,3578765564,3578765613,49
1,1546,52902,3578765564,3578765613,49
1,1546,52903,3578765564,3578765614,50
1,1547,52904,3578765627,3578765627,0
1,1547,52905,3578765627,3578765627,0
1,1547,52906,3578765627,3578765627,0
1,1547,52907,3578765627,3578765627,0
1,1547,52908,3578765627,3578765627,0
1,1547,52909,3578765627,3578765627,0
1,1547,52910,3578765627,3578765627,0
1,1547,52911,3578765627,3578765627,0
1,1547,52912,3578765627,3578765627,0
1,1547,52913,3578765627,3578765627,0
1,1547,52914,3578765627,3578765627,0
1,1547,52915,3578765627,3578765627,0
1,1547,52916,3578765627,3578765627,0
1,1547,52917,3578765627,3578765627,0
1,1547,52918,3578765627,3578765627,0
1,1547,52919,3578765627,3578765627,0
1,1547,52920,3578765627,3578765627,0
1,1547,52921,3578765627,3578765627,0
1,1547,52922,3578765627,3578765628,1
1,1547,52923,3578765627,3578765629,2
1,1547,52924,3578765627,3578765629,2
1,1547,52925,3578765627,3578765629,2
1,1547,52926,3578765627,3578765630,3
1,1547,52927,3578765627,3578765631,4
1,1547,52928,3578765627,3578765634,7
1,1547,52929,3578765627,3578765635,8
1,1547,52930,3578765627,3578765636,9
1,1547,52931,3578765627,3578765637,10
1,1547,52932,3578765627,3578765638,11
1,1547,52933,3578765627,3578765638,11
1,1547,52934,3578765627,3578765639,12
1,1547,52935,3578765627,3578765641,14
1,1547,52936,3578765627,3578765646,19
1,1547,52937,3578765627,3578765646,19
1,1547,52938,3578765627,3578765647,20
1,1547,52939,3578765627,3578765650,23
1,1547,52940,3578765627,3578765651,24
1,1547,52941,3578765627,3578765652,25
1,1547,52942,3578765627,3578765653,26
1,1547,52943,3578765627,3578765654,27
1,1547,52944,3578765627,3578765657,30
1,1547,52945,3578765627,3578765657,30
1,1547,52946,3578765627,3578765657,30
1,1547,52947,3578765627,3578765658,31
1,1547,52948,3578765627,3578765659,32
1,1547,52949,3578765627,3578765661,34
1,1547,52950,3578765627,3578765662,35
1,1547,52951,3578765627,3578765663,36
1,1547,52952,3578765627,3578765663,36
1,1547,52953,3578765627,3578765667,40
1,1547,52954,3578765627,3578765667,40
1,1547,52955,3578765627,3578765669,42
1,1547,52956,3578765627,3578765669,42
1,1547,52957,3578765627,3578765670,43
1,1548,52958,3578765691,3578765691,0
1,1548,52959,3578765691,3578765691,0
1,1548,52960,3578765691,3578765691,0
1,1548,52961,3578765691,3578765691,0
1,1548,52962,3578765691,3578765691,0
1,1548,52963,3578765691,3578765691,0
1,1548,52964,3578765691,3578765691,0
1,1548,52965,3578765691,3578765691,0
1,1548,52966,3578765691,3578765691,0
1,1548,52967,3578765691,3578765691,0
1,1548,52968,3578765691,3578765691,0
1,1548,52969,3578765691,3578765691,0
1,1548,52970,3578765691,3578765692,1
1,1548,52971,3578765691,3578765692,1
1,1548,52972,3578765691,3578765692,1
1,1548,52973,3578765691,3578765694,3
1,1548,52974,3578765691,3578765694,3
1,1548,52975,3578765691,3578765695,4
1,1548,52976,3578765691,3578765696,5
1,1548,52977,3578765691,3578765696,5
1,1548,52978,3578765691,3578765697,6
1,1548,52979,3578765691,3578765698,7
1,1548,52980,3578765691,3578765698,7
1,1548,52981,3578765691,3578765701,10
1,1548,52982,3578765691,3578765702,11
1,1548,52983,3578765691,3578765702,11
1,1548,52984,3578765691,3578765703,12
1,1548,52985,3578765691,3578765703,12
1,1548,52986,3578765691,3578765703,12
1,1548,52987,3578765691,3578765703,12
1,1548,52988,3578765691,3578765703,12
1,1548,52989,3578765691,3578765704,13
1,1548,52990,3578765691,3578765705,14
1,1548,52991,3578765691,3578765706,15
1,1548,52992,3578765691,3578765707,16
1,1548,52993,3578765691,3578765707,16
1,1548,52994,3578765691,3578765707,16
1,1548,52995,3578765691,3578765708,17
1,1548,52996,3578765691,3578765708,17
1,1548,52997,3578765691,3578765708,17
1,1548,52998,3578765691,3578765709,18
1,1548,52999,3578765691,3578765709,18
1,1548,53000,3578765691,3578765710,19
1,1548,53001,3578765691,3578765711,20
1,1548,53002,3578765691,3578765712,21
1,1548,53003,3578765691,3578765713,22
1,1548,53004,3578765691,3578765713,22
1,1548,53005,3578765691,3578765713,22
1,1548,53006,3578765691,3578765713,22
1,1548,53007,3578765691,3578765714,23
1,1548,53008,3578765691,3578765714,23
1,1548,53009,3578765691,3578765714,23
1,1548,53010,3578765691,3578765715,24
1,1548,53011,3578765691,3578765718,27
1,1548,53012,3578765691,3578765719,28
1,1548,53013,3578765691,3578765720,29
1,1548,53014,3578765691,3578765720,29
1,1548,53015,3578765691,3578765720,29
1,1548,53016,3578765691,3578765721,30
1,1548,53017,3578765691,3578765721,30
1,1548,53018,3578765691,3578765721,30
1,1548,53019,3578765691,3578765721,30
1,1548,53020,3578765691,3578765723,32
1,1548,53021,3578765691,3578765723,32
1,1548,53022,3578765691,3578765724,33
1,1548,53023,3578765691,3578765724,33
1,1548,53024,3578765691,3578765724,33
1,1548,53025,3578765691,3578765725,34
1,1548,53026,3578765691,3578765726,35
1,1548,53027,3578765691,3578765726,35
1,1548,53028,3578765691,3578765726,35
1,1548,53029,3578765691,3578765728,37
1,1548,53030,3578765691,3578765728,37
1,1548,53031,3578765691,3578765729,38
1,1548,53032,3578765691,3578765730,39
1,1548,53033,3578765691,3578765731,40
1,1548,53034,3578765691,3578765731,40
1,1548,53035,3578765691,3578765731,40
1,1548,53036,3578765691,3578765733,42
1,1548,53037,3578765691,3578765733,42
1,1548,53038,3578765691,3578765733,42
1,1548,53039,3578765691,3578765733,42
1,1548,53040,3578765691,3578765734,43
1,1548,53041,3578765691,3578765735,44
1,1548,53042,3578765691,3578765736,45
1,1548,53043,3578765691,3578765736,45
1,1548,53044,3578765691,3578765736,45
1,1548,53045,3578765691,3578765737,46
1,1548,53046,3578765691,3578765740,49
1,1549,53047,3578765754,3578765754,0
1,1549,53048,3578765754,3578765754,0
1,1549,53049,3578765754,3578765754,0
1,1549,53050,3578765754,3578765754,0
1,1549,53051,3578765754,3578765754,0
1,1549,53052,3578765754,3578765754,0
1,1549,53053,3578765754,3578765755,1
1,1549,53054,3578765754,3578765755,1
1,1549,53055,3578765754,3578765755,1
1,1549,53056,3578765754,3578765755,1
1,1549,53057,3578765754,3578765755,1
1,1549,53058,3578765754,3578765755,1
1,1549,53059,3578765754,3578765756,2
1,1549,53060,3578765754,3578765762,8
1,1549,53061,3578765754,3578765762,8
1,1549,53062,3578765754,3578765763,9
1,1549,53063,3578765754,3578765763,9
1,1549,53064,3578765754,3578765765,11
1,1549,53065,3578765754,3578765765,11
1,1549,53066,3578765754,3578765765,11
1,1549,53067,3578765754,3578765766,12
1,1549,53068,3578765754,3578765766,12
1,1549,53069,3578765754,3578765767,13
1,1549,53070,3578765754,3578765767,13
1,1549,53071,3578765754,3578765767,13
1,1549,53072,3578765754,3578765768,14
1,1549,53073,3578765754,3578765769,15
1,1549,53074,3578765754,3578765772,18
1,1549,53075,3578765754,3578765774,20
1,1549,53076,3578765754,3578765775,21
1,1549,53077,3578765754,3578765775,21
1,1549,53078,3578765754,3578765777,23
1,1549,53079,3578765754,3578765778,24
1,1549,53080,3578765754,3578765780,26
1,1549,53081,3578765754,3578765780,26
1,1549,53082,3578765754,3578765780,26
1,1549,53083,3578765754,3578765781,27
1,1549,53084,3578765754,3578765781,27
1,1549,53085,3578765754,3578765781,27
1,1549,53086,3578765754,3578765782,28
1,1549,53087,3578765754,3578765783,29
1,1549,53088,3578765754,3578765784,30
1,1549,53089,3578765754,3578765788,34
1,1549,53090,3578765754,3578765790,36
1,1549,53091,3578765754,3578765790,36
1,1549,53092,3578765754,3578765791,37
1,1549,53093,3578765754,3578765792,38
1,1549,53094,3578765754,3578765795,41
1,1549,53095,3578765754,3578765795,41
1,1549,53096,3578765754,3578765796,42
1,1549,53097,3578765754,3578765796,42
1,1549,53098,3578765754,3578765796,42
1,1549,53099,3578765754,3578765797,43
1,1549,53100,3578765754,3578765797,43
1,1549,53101,3578765754,3578765799,45
1,1549,53102,3578765754,3578765799,45
1,1549,53103,3578765754,3578765799,45
1,1549,53104,3578765754,3578765800,46
1,1549,53105,3578765754,3578765801,47
1,1549,53106,3578765754,3578765803,49
1,1550,53107,3578765819,3578765819,0
1,1550,53108,3578765819,3578765819,0
1,1550,53109,3578765819,3578765819,0
1,1550,53110,3578765819,3578765819,0
1,1550,53111,3578765819,3578765819,0
1,1550,53112,3578765819,3578765819,0
1,1550,53113,3578765819,3578765819,0
1,1550,53114,3578765819,3578765819,0
1,1550,53115,3578765819,3578765819,0
1,1550,53116,3578765819,3578765819,0
1,1550,53117,3578765819,3578765819,0
1,1550,53118,3578765819,3578765819,0
1,1550,53119,3578765819,3578765819,0
1,1550,53120,3578765819,3578765819,0
1,1550,53121,3578765819,3578765819,0
1,1550,53122,3578765819,3578765819,0
1,1550,53123,3578765819,3578765819,0
1,1550,53124,3578765819,3578765819,0
1,1550,53125,3578765819,3578765820,1
1,1550,53126,3578765819,3578765821,2
1,1550,53127,3578765819,3578765822,3
1,1550,53128,3578765819,3578765823,4
1,1550,53129,3578765819,3578765824,5
1,1550,53130,3578765819,3578765826,7
1,1550,53131,3578765819,3578765826,7
1,1550,53132,3578765819,3578765826,7
1,1550,53133,3578765819,3578765826,7
1,1550,53134,3578765819,3578765827,8
1,1550,53135,3578765819,3578765829,10
1,1550,53136,3578765819,3578765830,11
1,1550,53137,3578765819,3578765830,11
1,1550,53138,3578765819,3578765831,12
1,1550,53139,3578765819,3578765834,15
1,1550,53140,3578765819,3578765836,17
1,1550,53141,3578765819,3578765836,17
1,1550,53142,3578765819,3578765836,17
1,1550,53143,3578765819,3578765838,19
1,1550,53144,3578765819,3578765838,19
1,1550,53145,3578765819,3578765840,21
1,1550,53146,3578765819,3578765841,22
1,1550,53147,3578765819,3578765846,27
1,1550,53148,3578765819,3578765847,28
1,1550,53149,3578765819,3578765848,29
1,1550,53150,3578765819,3578765849,30
1,1550,53151,3578765819,3578765850,31
1,1550,53152,3578765819,3578765851,32
1,1550,53153,3578765819,3578765853,34
1,1550,53154,3578765819,3578765853,34
1,1550,53155,3578765819,3578765854,35
1,1550,53156,3578765819,3578765855,36
1,1550,53157,3578765819,3578765856,37
1,1550,53158,3578765819,3578765857,38
1,1550,53159,3578765819,3578765857,38
1,1550,53160,3578765819,3578765857,38
1,1550,53161,3578765819,3578765859,40
1,1550,53162,3578765819,3578765859,40
1,1550,53163,3578765819,3578765860,41
1,1550,53164,3578765819,3578765862,43
1,1550,53165,3578765819,3578765862,43
1,1550,53166,3578765819,3578765863,44
1,1550,53167,3578765819,3578765863,44
1,1550,53168,3578765819,3578765867,48
1,1550,53169,3578765819,3578765867,48
1,1550,53170,3578765819,3578765869,50
1,1551,53171,3578765883,3578765883,0
1,1551,53172,3578765883,3578765883,0
1,1551,53173,3578765883,3578765883,0
1,1551,53174,3578765883,3578765883,0
1,1551,53175,3578765883,3578765883,0
1,1551,53176,3578765883,3578765883,0
1,1551,53177,3578765883,3578765884,1
1,1551,53178,3578765883,3578765884,1
1,1551,53179,3578765883,3578765884,1
1,1551,53180,3578765883,3578765885,2
1,1551,53181,3578765883,3578765886,3
1,1551,53182,3578765883,3578765887,4
1,1551,53183,3578765883,3578765887,4
1,1551,53184,3578765883,3578765889,6
1,1551,53185,3578765883,3578765892,9
1,1551,53186,3578765883,3578765892,9
1,1551,53187,3578765883,3578765893,10
1,1551,53188,3578765883,3578765893,10
1,1551,53189,3578765883,3578765893,10
1,1551,53190,3578765883,3578765893,10
1,1551,53191,3578765883,3578765894,11
1,1551,53192,3578765883,3578765894,11
1,1551,53193,3578765883,3578765896,13
1,1551,53194,3578765883,3578765896,13
1,1551,53195,3578765883,3578765897,14
1,1551,53196,3578765883,3578765898,15
1,1551,53197,3578765883,3578765899,16
1,1551,53198,3578765883,3578765901,18
1,1551,53199,3578765883,3578765902,19
1,1551,53200,3578765883,3578765902,19
1,1551,53201,3578765883,3578765902,19
1,1551,53202,3578765883,3578765903,20
1,1551,53203,3578765883,3578765903,20
1,1551,53204,3578765883,3578765903,20
1,1551,53205,3578765883,3578765904,21
1,1551,53206,3578765883,3578765904,21
1,1551,53207,3578765883,3578765905,22
1,1551,53208,3578765883,3578765906,23
1,1551,53209,3578765883,3578765907,24
1,1551,53210,3578765883,3578765908,25
1,1551,53211,3578765883,3578765908,25
1,1551,53212,3578765883,3578765908,25
1,1551,53213,3578765883,3578765908,25
1,1551,53214,3578765883,3578765909,26
1,1551,53215,3578765883,3578765909,26
1,1551,53216,3578765883,3578765910,27
1,1551,53217,3578765883,3578765911,28
1,1551,53218,3578765883,3578765912,29
1,1551,53219,3578765883,3578765913,30
1,1551,53220,3578765883,3578765913,30
1,1551,53221,3578765883,3578765914,31
1,1551,53222,3578765883,3578765914,31
1,1551,53223,3578765883,3578765914,31
1,1551,53224,3578765883,3578765914,31
1,1551,53225,3578765883,3578765914,31
1,1551,53226,3578765883,3578765918,35
1,1551,53227,3578765883,3578765919,36
1,1551,53228,3578765883,3578765919,36
1,1551,53229,3578765883,3578765920,37
1,1551,53230,3578765883,3578765920,37
1,1551,53231,3578765883,3578765921,38
1,1551,53232,3578765883,3578765921,38
1,1551,53233,3578765883,3578765922,39
1,1551,53234,3578765883,3578765923,40
1,1551,53235,3578765883,3578765923,40
1,1551,53236,3578765883,3578765923,40
1,1551,53237,3578765883,3578765925,42
1,1551,53238,3578765883,3578765925,42
1,1551,53239,3578765883,3578765925,42
1,1551,53240,3578765883,3578765926,43
1,1551,53241,3578765883,3578765926,43
1,1551,53242,3578765883,3578765927,44
1,1551,53243,3578765883,3578765928,45
1,1551,53244,3578765883,3578765928,45
1,1551,53245,3578765883,3578765929,46
1,1551,53246,3578765883,3578765930,47
1,1551,53247,3578765883,3578765930,47
1,1551,53248,3578765883,3578765933,50
1,1552,53249,3578765947,3578765947,0
1,1552,53250,3578765947,3578765947,0
1,1552,53251,3578765947,3578765947,0
1,1552,53252,3578765947,3578765947,0
1,1552,53253,3578765947,3578765947,0
1,1552,53254,3578765947,3578765947,0
1,1552,53255,3578765947,3578765947,0
1,1552,53256,3578765947,3578765947,0
1,1552,53257,3578765947,3578765947,0
1,1552,53258,3578765947,3578765947,0
1,1552,53259,3578765947,3578765947,0
1,1552,53260,3578765947,3578765947,0
1,1552,53261,3578765947,3578765947,0
1,1552,53262,3578765947,3578765948,1
1,1552,53263,3578765947,3578765948,1
1,1552,53264,3578765947,3578765949,2
1,1552,53265,3578765947,3578765951,4
1,1552,53266,3578765947,3578765952,5
1,1552,53267,3578765947,3578765953,6
1,1552,53268,3578765947,3578765955,8
1,1552,53269,3578765947,3578765955,8
1,1552,53270,3578765947,3578765955,8
1,1552,53271,3578765947,3578765956,9
1,1552,53272,3578765947,3578765963,16
1,1552,53273,3578765947,3578765964,17
1,1552,53274,3578765947,3578765964,17
1,1552,53275,3578765947,3578765965,18
1,1552,53276,3578765947,3578765965,18
1,1552,53277,3578765947,3578765965,18
1,1552,53278,3578765947,3578765965,18
1,1552,53279,3578765947,3578765967,20
1,1552,53280,3578765947,3578765967,20
1,1552,53281,3578765947,3578765968,21
1,1552,53282,3578765947,3578765968,21
1,1552,53283,3578765947,3578765972,25
1,1552,53284,3578765947,3578765973,26
1,1552,53285,3578765947,3578765973,26
1,1552,53286,3578765947,3578765975,28
1,1552,53287,3578765947,3578765977,30
1,1552,53288,3578765947,3578765977,30
1,1552,53289,3578765947,3578765978,31
1,1552,53290,3578765947,3578765978,31
1,1552,53291,3578765947,3578765979,32
1,1552,53292,3578765947,3578765980,33
1,1552,53293,3578765947,3578765981,34
1,1552,53294,3578765947,3578765981,34
1,1552,53295,3578765947,3578765981,34
1,1552,53296,3578765947,3578765982,35
1,1552,53297,3578765947,3578765982,35
1,1552,53298,3578765947,3578765984,37
1,1552,53299,3578765947,3578765985,38
1,1552,53300,3578765947,3578765990,43
1,1552,53301,3578765947,3578765991,44
1,1552,53302,3578765947,3578765992,45
1,1552,53303,3578765947,3578765992,45
1,1552,53304,3578765947,3578765994,47
1,1552,53305,3578765947,3578765995,48
1,1552,53306,3578765947,3578765996,49
1,1552,53307,3578765947,3578765996,49
1,1552,53308,3578765947,3578765996,49
1,1552,53309,3578765947,3578765997,50
1,1553,53310,3578766010,3578766010,0
1,1553,53311,3578766010,3578766010,0
1,1553,53312,3578766010,3578766011,1
1,1553,53313,3578766010,3578766011,1
1,1553,53314,3578766010,3578766011,1
1,1553,53315,3578766010,3578766011,1
1,1553,53316,3578766010,3578766011,1
1,1553,53317,3578766010,3578766011,1
1,1553,53318,3578766010,3578766011,1
1,1553,53319,3578766010,3578766011,1
1,1553,53320,3578766010,3578766011,1
1,1553,53321,3578766010,3578766012,2
1,1553,53322,3578766010,3578766012,2
1,1553,53323,3578766010,3578766013,3
1,1553,53324,3578766010,3578766013,3
1,1553,53325,3578766010,3578766013,3
1,1553,53326,3578766010,3578766014,4
1,1553,53327,3578766010,3578766014,4
1,1553,53328,3578766010,3578766014,4
1,1553,53329,3578766010,3578766016,6
1,1553,53330,3578766010,3578766016,6
1,1553,53331,3578766010,3578766017,7
1,1553,53332,3578766010,3578766017,7
1,1553,53333,3578766010,3578766018,8
1,1553,53334,3578766010,3578766018,8
1,1553,53335,3578766010,3578766019,9
1,1553,53336,3578766010,3578766022,12
1,1553,53337,3578766010,3578766024,14
1,1553,53338,3578766010,3578766025,15
1,1553,53339,3578766010,3578766026,16
1,1553,53340,3578766010,3578766026,16
1,1553,53341,3578766010,3578766027,17
1,1553,53342,3578766010,3578766027,17
1,1553,53343,3578766010,3578766028,18
1,1553,53344,3578766010,3578766029,19
1,1553,53345,3578766010,3578766029,19
1,1553,53346,3578766010,3578766031,21
1,1553,53347,3578766010,3578766032,22
1,1553,53348,3578766010,3578766035,25
1,1553,53349,3578766010,3578766036,26
1,1553,53350,3578766010,3578766036,26
1,1553,53351,3578766010,3578766037,27
1,1553,53352,3578766010,3578766038,28
1,1553,53353,3578766010,3578766039,29
1,1553,53354,3578766010,3578766039,29
1,1553,53355,3578766010,3578766041,31
1,1553,53356,3578766010,3578766042,32
1,1553,53357,3578766010,3578766046,36
1,1553,53358,3578766010,3578766047,37
1,1553,53359,3578766010,3578766049,39
1,1553,53360,3578766010,3578766050,40
1,1553,53361,3578766010,3578766050,40
1,1553,53362,3578766010,3578766051,41
1,1553,53363,3578766010,3578766052,42
1,1553,53364,3578766010,3578766054,44
1,1553,53365,3578766010,3578766057,47
1,1553,53366,3578766010,3578766057,47
1,1553,53367,3578766010,3578766057,47
1,1553,53368,3578766010,3578766057,47
1,1553,53369,3578766010,3578766059,49
1,1553,53370,3578766010,3578766060,50
1,1554,53371,3578766074,3578766074,0
1,1554,53372,3578766074,3578766074,0
1,1554,53373,3578766074,3578766074,0
1,1554,53374,3578766074,3578766074,0
1,1554,53375,3578766074,3578766074,0
1,1554,53376,3578766074,3578766074,0
1,1554,53377,3578766074,3578766074,0
1,1554,53378,3578766074,3578766074,0
1,1554,53379,3578766074,3578766074,0
1,1554,53380,3578766074,3578766074,0
1,1554,53381,3578766074,3578766080,6
1,1554,53382,3578766074,3578766082,8
1,1554,53383,3578766074,3578766082,8
1,1554,53384,3578766074,3578766082,8
1,1554,53385,3578766074,3578766084,10
1,1554,53386,3578766074,3578766084,10
1,1554,53387,3578766074,3578766085,11
1,1554,53388,3578766074,3578766085,11
1,1554,53389,3578766074,3578766086,12
1,1554,53390,3578766074,3578766087,13
1,1554,53391,3578766074,3578766088,14
1,1554,53392,3578766074,3578766090,16
1,1554,53393,3578766074,3578766092,18
1,1554,53394,3578766074,3578766092,18
1,1554,53395,3578766074,3578766093,19
1,1554,53396,3578766074,3578766093,19
1,1554,53397,3578766074,3578766093,19
1,1554,53398,3578766074,3578766094,20
1,1554,53399,3578766074,3578766094,20
1,1554,53400,3578766074,3578766095,21
1,1554,53401,3578766074,3578766096,22
1,1554,53402,3578766074,3578766096,22
1,1554,53403,3578766074,3578766096,22
1,1554,53404,3578766074,3578766097,23
1,1554,53405,3578766074,3578766097,23
1,1554,53406,3578766074,3578766099,25
1,1554,53407,3578766074,3578766101,27
1,1554,53408,3578766074,3578766102,28
1,1554,53409,3578766074,3578766102,28
1,1554,53410,3578766074,3578766102,28
1,1554,53411,3578766074,3578766103,29
1,1554,53412,3578766074,3578766103,29
1,1554,53413,3578766074,3578766103,29
1,1554,53414,3578766074,3578766103,29
1,1554,53415,3578766074,3578766104,30
1,1554,53416,3578766074,3578766106,32
1,1554,53417,3578766074,3578766107,33
1,1554,53418,3578766074,3578766108,34
1,1554,53419,3578766074,3578766108,34
1,1554,53420,3578766074,3578766108,34
1,1554,53421,3578766074,3578766108,34
1,1554,53422,3578766074,3578766108,34
1,1554,53423,3578766074,3578766109,35
1,1554,53424,3578766074,3578766110,36
1,1554,53425,3578766074,3578766112,38
1,1554,53426,3578766074,3578766113,39
1,1554,53427,3578766074,3578766113,39
1,1554,53428,3578766074,3578766113,39
1,1554,53429,3578766074,3578766113,39
1,1554,53430,3578766074,3578766114,40
1,1554,53431,3578766074,3578766114,40
1,1554,53432,3578766074,3578766114,40
1,1554,53433,3578766074,3578766114,40
1,1554,53434,3578766074,3578766115,41
1,1554,53435,3578766074,3578766119,45
1,1554,53436,3578766074,3578766119,45
1,1554,53437,3578766074,3578766120,46
1,1554,53438,3578766074,3578766120,46
1,1554,53439,3578766074,3578766120,46
1,1554,53440,3578766074,3578766121,47
1,1554,53441,3578766074,3578766121,47
1,1554,53442,3578766074,3578766121,47
1,1554,53443,3578766074,3578766122,48
1,1554,53444,3578766074,3578766123,49
1,1554,53445,3578766074,3578766123,49
1,1554,53446,3578766074,3578766123,49
1,1555,53447,3578766140,3578766140,0
1,1555,53448,3578766140,3578766140,0
1,1555,53449,3578766140,3578766140,0
1,1555,53450,3578766140,3578766140,0
1,1555,53451,3578766140,3578766140,0
1,1555,53452,3578766140,3578766140,0
1,1555,53453,3578766140,3578766140,0
1,1555,53454,3578766140,3578766140,0
1,1555,53455,3578766140,3578766140,0
1,1555,53456,3578766140,3578766140,0
1,1555,53457,3578766140,3578766140,0
1,1555,53458,3578766140,3578766140,0
1,1555,53459,3578766140,3578766140,0
1,1555,53460,3578766140,3578766140,0
1,1555,53461,3578766140,3578766140,0
1,1555,53462,3578766140,3578766140,0
1,1555,53463,3578766140,3578766140,0
1,1555,53464,3578766140,3578766140,0
1,1555,53465,3578766140,3578766140,0
1,1555,53466,3578766140,3578766140,0
1,1555,53467,3578766140,3578766140,0
1,1555,53468,3578766140,3578766140,0
1,1555,53469,3578766140,3578766140,0
1,1555,53470,3578766140,3578766140,0
1,1555,53471,3578766140,3578766140,0
1,1555,53472,3578766140,3578766142,2
1,1555,53473,3578766140,3578766143,3
1,1555,53474,3578766140,3578766146,6
1,1555,53475,3578766140,3578766148,8
1,1555,53476,3578766140,3578766148,8
1,1555,53477,3578766140,3578766151,11
1,1555,53478,3578766140,3578766153,13
1,1555,53479,3578766140,3578766153,13
1,1555,53480,3578766140,3578766155,15
1,1555,53481,3578766140,3578766155,15
1,1555,53482,3578766140,3578766155,15
1,1555,53483,3578766140,3578766156,16
1,1555,53484,3578766140,3578766163,23
1,1555,53485,3578766140,3578766163,23
1,1555,53486,3578766140,3578766163,23
1,1555,53487,3578766140,3578766165,25
1,1555,53488,3578766140,3578766165,25
1,1555,53489,3578766140,3578766165,25
1,1555,53490,3578766140,3578766166,26
1,1555,53491,3578766140,3578766166,26
1,1555,53492,3578766140,3578766167,27
1,1555,53493,3578766140,3578766168,28
1,1555,53494,3578766140,3578766168,28
1,1555,53495,3578766140,3578766168,28
1,1555,53496,3578766140,3578766172,32
1,1555,53497,3578766140,3578766173,33
1,1555,53498,3578766140,3578766174,34
1,1555,53499,3578766140,3578766175,35
1,1555,53500,3578766140,3578766177,37
1,1555,53501,3578766140,3578766177,37
1,1555,53502,3578766140,3578766178,38
1,1555,53503,3578766140,3578766179,39
1,1555,53504,3578766140,3578766179,39
1,1555,53505,3578766140,3578766180,40
1,1555,53506,3578766140,3578766180,40
1,1555,53507,3578766140,3578766181,41
1,1555,53508,3578766140,3578766181,41
1,1555,53509,3578766140,3578766182,42
1,1555,53510,3578766140,3578766182,42
1,1555,53511,3578766140,3578766184,44
1,1555,53512,3578766140,3578766189,49
1,1556,53513,3578766204,3578766204,0
1,1556,53514,3578766204,3578766204,0
1,1556,53515,3578766204,3578766204,0
1,1556,53516,3578766204,3578766204,0
1,1556,53517,3578766204,3578766204,0
1,1556,53518,3578766204,3578766204,0
1,1556,53519,3578766204,3578766204,0
1,1556,53520,3578766204,3578766204,0
1,1556,53521,3578766204,3578766204,0
1,1556,53522,3578766204,3578766204,0
1,1556,53523,3578766204,3578766204,0
1,1556,53524,3578766204,3578766204,0
1,1556,53525,3578766204,3578766204,0
1,1556,53526,3578766204,3578766204,0
1,1556,53527,3578766204,3578766204,0
1,1556,53528,3578766204,3578766204,0
1,1556,53529,3578766204,3578766204,0
1,1556,53530,3578766204,3578766204,0
1,1556,53531,3578766204,3578766205,1
1,1556,53532,3578766204,3578766208,4
1,1556,53533,3578766204,3578766210,6
1,1556,53534,3578766204,3578766212,8
1,1556,53535,3578766204,3578766212,8
1,1556,53536,3578766204,3578766213,9
1,1556,53537,3578766204,3578766213,9
1,1556,53538,3578766204,3578766213,9
1,1556,53539,3578766204,3578766214,10
1,1556,53540,3578766204,3578766214,10
1,1556,53541,3578766204,3578766215,11
1,1556,53542,3578766204,3578766216,12
1,1556,53543,3578766204,3578766216,12
1,1556,53544,3578766204,3578766217,13
1,1556,53545,3578766204,3578766217,13
1,1556,53546,3578766204,3578766218,14
1,1556,53547,3578766204,3578766219,15
1,1556,53548,3578766204,3578766219,15
1,1556,53549,3578766204,3578766219,15
1,1556,53550,3578766204,3578766222,18
1,1556,53551,3578766204,3578766223,19
1,1556,53552,3578766204,3578766225,21
1,1556,53553,3578766204,3578766225,21
1,1556,53554,3578766204,3578766226,22
1,1556,53555,3578766204,3578766226,22
1,1556,53556,3578766204,3578766227,23
1,1556,53557,3578766204,3578766227,23
1,1556,53558,3578766204,3578766227,23
1,1556,53559,3578766204,3578766229,25
1,1556,53560,3578766204,3578766230,26
1,1556,53561,3578766204,3578766231,27
1,1556,53562,3578766204,3578766232,28
1,1556,53563,3578766204,3578766235,31
1,1556,53564,3578766204,3578766235,31
1,1556,53565,3578766204,3578766236,32
1,1556,53566,3578766204,3578766236,32
1,1556,53567,3578766204,3578766237,33
1,1556,53568,3578766204,3578766238,34
1,1556,53569,3578766204,3578766238,34
1,1556,53570,3578766204,3578766239,35
1,1556,53571,3578766204,3578766246,42
1,1556,53572,3578766204,3578766248,44
1,1556,53573,3578766204,3578766249,45
1,1556,53574,3578766204,3578766249,45
1,1556,53575,3578766204,3578766250,46
1,1556,53576,3578766204,3578766252,48
1,1556,53577,3578766204,3578766253,49
1,1556,53578,3578766204,3578766254,50
1,1557,53579,3578766269,3578766269,0
1,1557,53580,3578766269,3578766269,0
1,1557,53581,3578766269,3578766269,0
1,1557,53582,3578766269,3578766269,0
1,1557,53583,3578766269,3578766269,0
1,1557,53584,3578766269,3578766269,0
1,1557,53585,3578766269,3578766269,0
1,1557,53586,3578766269,3578766269,0
1,1557,53587,3578766269,3578766269,0
1,1557,53588,3578766269,3578766269,0
1,1557,53589,3578766269,3578766269,0
1,1557,53590,3578766269,3578766269,0
1,1557,53591,3578766269,3578766269,0
1,1557,53592,3578766269,3578766269,0
1,1557,53593,3578766269,3578766271,2
1,1557,53594,3578766269,3578766280,11
1,1557,53595,3578766269,3578766282,13
1,1557,53596,3578766269,3578766282,13
1,1557,53597,3578766269,3578766283,14
1,1557,53598,3578766269,3578766284,15
1,1557,53599,3578766269,3578766284,15
1,1557,53600,3578766269,3578766285,16
1,1557,53601,3578766269,3578766286,17
1,1557,53602,3578766269,3578766286,17
1,1557,53603,3578766269,3578766288,19
1,1557,53604,3578766269,3578766288,19
1,1557,53605,3578766269,3578766290,21
1,1557,53606,3578766269,3578766291,22
1,1557,53607,3578766269,3578766293,24
1,1557,53608,3578766269,3578766293,24
1,1557,53609,3578766269,3578766294,25
1,1557,53610,3578766269,3578766294,25
1,1557,53611,3578766269,3578766294,25
1,1557,53612,3578766269,3578766295,26
1,1557,53613,3578766269,3578766296,27
1,1557,53614,3578766269,3578766297,28
1,1557,53615,3578766269,3578766297,28
1,1557,53616,3578766269,3578766297,28
1,1557,53617,3578766269,3578766298,29
1,1557,53618,3578766269,3578766299,30
1,1557,53619,3578766269,3578766299,30
1,1557,53620,3578766269,3578766301,32
1,1557,53621,3578766269,3578766302,33
1,1557,53622,3578766269,3578766303,34
1,1557,53623,3578766269,3578766303,34
1,1557,53624,3578766269,3578766303,34
1,1557,53625,3578766269,3578766303,34
1,1557,53626,3578766269,3578766304,35
1,1557,53627,3578766269,3578766304,35
1,1557,53628,3578766269,3578766305,36
1,1557,53629,3578766269,3578766307,38
1,1557,53630,3578766269,3578766307,38
1,1557,53631,3578766269,3578766308,39
1,1557,53632,3578766269,3578766308,39
1,1557,53633,3578766269,3578766308,39
1,1557,53634,3578766269,3578766309,40
1,1557,53635,3578766269,3578766309,40
1,1557,53636,3578766269,3578766310,41
1,1557,53637,3578766269,3578766312,43
1,1557,53638,3578766269,3578766313,44
1,1557,53639,3578766269,3578766313,44
1,1557,53640,3578766269,3578766313,44
1,1557,53641,3578766269,3578766314,45
1,1557,53642,3578766269,3578766314,45
1,1557,53643,3578766269,3578766314,45
1,1557,53644,3578766269,3578766314,45
1,1557,53645,3578766269,3578766315,46
1,1558,53646,3578766333,3578766333,0
1,1558,53647,3578766333,3578766333,0
1,1558,53648,3578766333,3578766333,0
1,1558,53649,3578766333,3578766333,0
1,1558,53650,3578766333,3578766333,0
1,1558,53651,3578766333,3578766333,0
1,1558,53652,3578766333,3578766333,0
1,1558,53653,3578766333,3578766333,0
1,1558,53654,3578766333,3578766333,0
1,1558,53655,3578766333,3578766333,0
1,1558,53656,3578766333,3578766333,0
1,1558,53657,3578766333,3578766333,0
1,1558,53658,3578766333,3578766333,0
1,1558,53659,3578766333,3578766333,0
1,1558,53660,3578766333,3578766333,0
1,1558,53661,3578766333,3578766333,0
1,1558,53662,3578766333,3578766333,0
1,1558,53663,3578766333,3578766333,0
1,1558,53664,3578766333,3578766333,0
1,1558,53665,3578766333,3578766333,0
1,1558,53666,3578766333,3578766333,0
1,1558,53667,3578766333,3578766333,0
1,1558,53668,3578766333,3578766333,0
1,1558,53669,3578766333,3578766333,0
1,1558,53670,3578766333,3578766333,0
1,1558,53671,3578766333,3578766333,0
1,1558,53672,3578766333,3578766333,0
1,1558,53673,3578766333,3578766333,0
1,1558,53674,3578766333,3578766334,1
1,1558,53675,3578766333,3578766335,2
1,1558,53676,3578766333,3578766336,3
1,1558,53677,3578766333,3578766336,3
1,1558,53678,3578766333,3578766336,3
1,1558,53679,3578766333,3578766337,4
1,1558,53680,3578766333,3578766338,5
1,1558,53681,3578766333,3578766338,5
1,1558,53682,3578766333,3578766341,8
1,1558,53683,3578766333,3578766341,8
1,1558,53684,3578766333,3578766342,9
1,1558,53685,3578766333,3578766343,10
1,1558,53686,3578766333,3578766346,13
1,1558,53687,3578766333,3578766347,14
1,1558,53688,3578766333,3578766348,15
1,1558,53689,3578766333,3578766348,15
1,1558,53690,3578766333,3578766350,17
1,1558,53691,3578766333,3578766350,17
1,1558,53692,3578766333,3578766353,20
1,1558,53693,3578766333,3578766354,21
1,1558,53694,3578766333,3578766355,22
1,1558,53695,3578766333,3578766355,22
1,1558,53696,3578766333,3578766356,23
1,1558,53697,3578766333,3578766356,23
1,1558,53698,3578766333,3578766360,27
1,1558,53699,3578766333,3578766363,30
1,1558,53700,3578766333,3578766363,30
1,1558,53701,3578766333,3578766364,31
1,1558,53702,3578766333,3578766365,32
1,1558,53703,3578766333,3578766366,33
1,1558,53704,3578766333,3578766366,33
1,1558,53705,3578766333,3578766366,33
1,1558,53706,3578766333,3578766367,34
1,1558,53707,3578766333,3578766369,36
1,1558,53708,3578766333,3578766369,36
1,1558,53709,3578766333,3578766369,36
1,1558,53710,3578766333,3578766369,36
1,1558,53711,3578766333,3578766372,39
1,1558,53712,3578766333,3578766375,42
1,1558,53713,3578766333,3578766375,42
1,1558,53714,3578766333,3578766377,44
1,1558,53715,3578766333,3578766377,44
1,1558,53716,3578766333,3578766379,46
1,1558,53717,3578766333,3578766380,47
1,1558,53718,3578766333,3578766380,47
1,1558,53719,3578766333,3578766380,47
1,1558,53720,3578766333,3578766381,48
1,1558,53721,3578766333,3578766382,49
1,1558,53722,3578766333,3578766382,49
1,1558,53723,3578766333,3578766382,49
1,1559,53724,3578766397,3578766397,0
1,1559,53725,3578766397,3578766398,1
1,1559,53726,3578766397,3578766398,1
1,1559,53727,3578766397,3578766398,1
1,1559,53728,3578766397,3578766398,1
1,1559,53729,3578766397,3578766398,1
1,1559,53730,3578766397,3578766398,1
1,1559,53731,3578766397,3578766398,1
1,1559,53732,3578766397,3578766398,1
1,1559,53733,3578766397,3578766398,1
1,1559,53734,3578766397,3578766398,1
1,1559,53735,3578766397,3578766398,1
1,1559,53736,3578766397,3578766398,1
1,1559,53737,3578766397,3578766398,1
1,1559,53738,3578766397,3578766399,2
1,1559,53739,3578766397,3578766400,3
1,1559,53740,3578766397,3578766401,4
1,1559,53741,3578766397,3578766402,5
1,1559,53742,3578766397,3578766404,7
1,1559,53743,3578766397,3578766404,7
1,1559,53744,3578766397,3578766405,8
1,1559,53745,3578766397,3578766409,12
1,1559,53746,3578766397,3578766410,13
1,1559,53747,3578766397,3578766412,15
1,1559,53748,3578766397,3578766412,15
1,1559,53749,3578766397,3578766413,16
1,1559,53750,3578766397,3578766414,17
1,1559,53751,3578766397,3578766414,17
1,1559,53752,3578766397,3578766414,17
1,1559,53753,3578766397,3578766416,19
1,1559,53754,3578766397,3578766416,19
1,1559,53755,3578766397,3578766417,20
1,1559,53756,3578766397,3578766417,20
1,1559,53757,3578766397,3578766418,21
1,1559,53758,3578766397,3578766418,21
1,1559,53759,3578766397,3578766419,22
1,1559,53760,3578766397,3578766419,22
1,1559,53761,3578766397,3578766419,22
1,1559,53762,3578766397,3578766420,23
1,1559,53763,3578766397,3578766422,25
1,1559,53764,3578766397,3578766423,26
1,1559,53765,3578766397,3578766425,28
1,1559,53766,3578766397,3578766426,29
1,1559,53767,3578766397,3578766426,29
1,1559,53768,3578766397,3578766426,29
1,1559,53769,3578766397,3578766427,30
1,1559,53770,3578766397,3578766428,31
1,1559,53771,3578766397,3578766429,32
1,1559,53772,3578766397,3578766430,33
1,1559,53773,3578766397,3578766430,33
1,1559,53774,3578766397,3578766431,34
1,1559,53775,3578766397,3578766432,35
1,1559,53776,3578766397,3578766435,38
1,1559,53777,3578766397,3578766436,39
1,1559,53778,3578766397,3578766436,39
1,1559,53779,3578766397,3578766438,41
1,1559,53780,3578766397,3578766439,42
1,1559,53781,3578766397,3578766439,42
1,1559,53782,3578766397,3578766442,45
1,1560,53783,3578766461,3578766461,0
1,1560,53784,3578766461,3578766461,0
1,1560,53785,3578766461,3578766461,0
1,1560,53786,3578766461,3578766461,0
1,1560,53787,3578766461,3578766461,0
1,1560,53788,3578766461,3578766461,0
1,1560,53789,3578766461,3578766461,0
1,1560,53790,3578766461,3578766461,0
1,1560,53791,3578766461,3578766461,0
1,1560,53792,3578766461,3578766461,0
1,1560,53793,3578766461,3578766461,0
1,1560,53794,3578766461,3578766461,0
1,1560,53795,3578766461,3578766461,0
1,1560,53796,3578766461,3578766461,0
1,1560,53797,3578766461,3578766462,1
1,1560,53798,3578766461,3578766463,2
1,1560,53799,3578766461,3578766463,2
1,1560,53800,3578766461,3578766465,4
1,1560,53801,3578766461,3578766465,4
1,1560,53802,3578766461,3578766468,7
1,1560,53803,3578766461,3578766468,7
1,1560,53804,3578766461,3578766470,9
1,1560,53805,3578766461,3578766471,10
1,1560,53806,3578766461,3578766481,20
1,1560,53807,3578766461,3578766482,21
1,1560,53808,3578766461,3578766482,21
1,1560,53809,3578766461,3578766484,23
1,1560,53810,3578766461,3578766485,24
1,1560,53811,3578766461,3578766485,24
1,1560,53812,3578766461,3578766485,24
1,1560,53813,3578766461,3578766485,24
1,1560,53814,3578766461,3578766487,26
1,1560,53815,3578766461,3578766488,27
1,1560,53816,3578766461,3578766488,27
1,1560,53817,3578766461,3578766490,29
1,1560,53818,3578766461,3578766492,31
1,1560,53819,3578766461,3578766493,32
1,1560,53820,3578766461,3578766493,32
1,1560,53821,3578766461,3578766493,32
1,1560,53822,3578766461,3578766494,33
1,1560,53823,3578766461,3578766495,34
1,1560,53824,3578766461,3578766495,34
1,1560,53825,3578766461,3578766496,35
1,1560,53826,3578766461,3578766496,35
1,1560,53827,3578766461,3578766498,37
1,1560,53828,3578766461,3578766498,37
1,1560,53829,3578766461,3578766498,37
1,1560,53830,3578766461,3578766499,38
1,1560,53831,3578766461,3578766499,38
1,1560,53832,3578766461,3578766501,40
1,1560,53833,3578766461,3578766502,41
1,1560,53834,3578766461,3578766503,42
1,1560,53835,3578766461,3578766503,42
1,1560,53836,3578766461,3578766503,42
1,1560,53837,3578766461,3578766503,42
1,1560,53838,3578766461,3578766504,43
1,1560,53839,3578766461,3578766504,43
1,1560,53840,3578766461,3578766505,44
1,1560,53841,3578766461,3578766505,44
1,1560,53842,3578766461,3578766507,46
1,1560,53843,3578766461,3578766508,47
1,1560,53844,3578766461,3578766508,47
1,1560,53845,3578766461,3578766508,47
1,1560,53846,3578766461,3578766508,47
1,1560,53847,3578766461,3578766509,48
1,1560,53848,3578766461,3578766509,48
1,1560,53849,3578766461,3578766510,49
1,1561,53850,3578766526,3578766526,0
1,1561,53851,3578766526,3578766526,0
1,1561,53852,3578766526,3578766526,0
1,1561,53853,3578766526,3578766526,0
1,1561,53854,3578766526,3578766526,0
1,1561,53855,3578766526,3578766526,0
1,1561,53856,3578766526,3578766526,0
1,1561,53857,3578766526,3578766526,0
1,1561,53858,3578766526,3578766526,0
1,1561,53859,3578766526,3578766526,0
1,1561,53860,3578766526,3578766526,0
1,1561,53861,3578766526,3578766526,0
1,1561,53862,3578766526,3578766526,0
1,1561,53863,3578766526,3578766526,0
1,1561,53864,3578766526,3578766526,0
1,1561,53865,3578766526,3578766526,0
1,1561,53866,3578766526,3578766526,0
1,1561,53867,3578766526,3578766526,0
1,1561,53868,3578766526,3578766526,0
1,1561,53869,3578766526,3578766526,0
1,1561,53870,3578766526,3578766526,0
1,1561,53871,3578766526,3578766526,0
1,1561,53872,3578766526,3578766526,0
1,1561,53873,3578766526,3578766526,0
1,1561,53874,3578766526,3578766526,0
1,1561,53875,3578766526,3578766526,0
1,1561,53876,3578766526,3578766527,1
1,1561,53877,3578766526,3578766527,1
1,1561,53878,3578766526,3578766527,1
1,1561,53879,3578766526,3578766527,1
1,1561,53880,3578766526,3578766528,2
1,1561,53881,3578766526,3578766529,3
1,1561,53882,3578766526,3578766529,3
1,1561,53883,3578766526,3578766531,5
1,1561,53884,3578766526,3578766531,5
1,1561,53885,3578766526,3578766531,5
1,1561,53886,3578766526,3578766532,6
1,1561,53887,3578766526,3578766532,6
1,1561,53888,3578766526,3578766532,6
1,1561,53889,3578766526,3578766533,7
1,1561,53890,3578766526,3578766534,8
1,1561,53891,3578766526,3578766535,9
1,1561,53892,3578766526,3578766535,9
1,1561,53893,3578766526,3578766536,10
1,1561,53894,3578766526,3578766536,10
1,1561,53895,3578766526,3578766536,10
1,1561,53896,3578766526,3578766537,11
1,1561,53897,3578766526,3578766540,14
1,1561,53898,3578766526,3578766540,14
1,1561,53899,3578766526,3578766542,16
1,1561,53900,3578766526,3578766542,16
1,1561,53901,3578766526,3578766546,20
1,1561,53902,3578766526,3578766547,21
1,1561,53903,3578766526,3578766548,22
1,1561,53904,3578766526,3578766549,23
1,1561,53905,3578766526,3578766549,23
1,1561,53906,3578766526,3578766552,26
1,1561,53907,3578766526,3578766553,27
1,1561,53908,3578766526,3578766554,28
1,1561,53909,3578766526,3578766555,29
1,1561,53910,3578766526,3578766555,29
1,1561,53911,3578766526,3578766556,30
1,1561,53912,3578766526,3578766559,33
1,1561,53913,3578766526,3578766562,36
1,1561,53914,3578766526,3578766563,37
1,1561,53915,3578766526,3578766563,37
1,1561,53916,3578766526,3578766564,38
1,1561,53917,3578766526,3578766564,38
1,1561,53918,3578766526,3578766565,39
1,1561,53919,3578766526,3578766565,39
1,1561,53920,3578766526,3578766566,40
1,1561,53921,3578766526,3578766567,41
1,1561,53922,3578766526,3578766568,42
1,1561,53923,3578766526,3578766568,42
1,1561,53924,3578766526,3578766568,42
1,1561,53925,3578766526,3578766569,43
1,1561,53926,3578766526,3578766572,46
1,1561,53927,3578766526,3578766572,46
1,1561,53928,3578766526,3578766574,48
1,1561,53929,3578766526,3578766574,48
1,1561,53930,3578766526,3578766575,49
1,1561,53931,3578766526,3578766576,50
1,1562,53932,3578766591,3578766591,0
1,1562,53933,3578766591,3578766591,0
1,1562,53934,3578766591,3578766591,0
1,1562,53935,3578766591,3578766591,0
1,1562,53936,3578766591,3578766591,0
1,1562,53937,3578766591,3578766591,0
1,1562,53938,3578766591,3578766591,0
1,1562,53939,3578766591,3578766591,0
1,1562,53940,3578766591,3578766591,0
1,1562,53941,3578766591,3578766591,0
1,1562,53942,3578766591,3578766591,0
1,1562,53943,3578766591,3578766591,0
1,1562,53944,3578766591,3578766591,0
1,1562,53945,3578766591,3578766591,0
1,1562,53946,3578766591,3578766592,1
1,1562,53947,3578766591,3578766593,2
1,1562,53948,3578766591,3578766594,3
1,1562,53949,3578766591,3578766594,3
1,1562,53950,3578766591,3578766596,5
1,1562,53951,3578766591,3578766596,5
1,1562,53952,3578766591,3578766596,5
1,1562,53953,3578766591,3578766597,6
1,1562,53954,3578766591,3578766598,7
1,1562,53955,3578766591,3578766598,7
1,1562,53956,3578766591,3578766598,7
1,1562,53957,3578766591,3578766599,8
1,1562,53958,3578766591,3578766600,9
1,1562,53959,3578766591,3578766602,11
1,1562,53960,3578766591,3578766603,12
1,1562,53961,3578766591,3578766605,14
1,1562,53962,3578766591,3578766608,17
1,1562,53963,3578766591,3578766609,18
1,1562,53964,3578766591,3578766612,21
1,1562,53965,3578766591,3578766612,21
1,1562,53966,3578766591,3578766612,21
1,1562,53967,3578766591,3578766612,21
1,1562,53968,3578766591,3578766613,22
1,1562,53969,3578766591,3578766613,22
1,1562,53970,3578766591,3578766614,23
1,1562,53971,3578766591,3578766615,24
1,1562,53972,3578766591,3578766615,24
1,1562,53973,3578766591,3578766616,25
1,1562,53974,3578766591,3578766616,25
1,1562,53975,3578766591,3578766617,26
1,1562,53976,3578766591,3578766617,26
1,1562,53977,3578766591,3578766618,27
1,1562,53978,3578766591,3578766618,27
1,1562,53979,3578766591,3578766618,27
1,1562,53980,3578766591,3578766619,28
1,1562,53981,3578766591,3578766621,30
1,1562,53982,3578766591,3578766622,31
1,1562,53983,3578766591,3578766623,32
1,1562,53984,3578766591,3578766625,34
1,1562,53985,3578766591,3578766625,34
1,1562,53986,3578766591,3578766626,35
1,1562,53987,3578766591,3578766626,35
1,1562,53988,3578766591,3578766626,35
1,1562,53989,3578766591,3578766628,37
1,1562,53990,3578766591,3578766628,37
1,1562,53991,3578766591,3578766629,38
1,1562,53992,3578766591,3578766630,39
1,1562,53993,3578766591,3578766630,39
1,1562,53994,3578766591,3578766631,40
1,1562,53995,3578766591,3578766631,40
1,1562,53996,3578766591,3578766634,43
1,1562,53997,3578766591,3578766635,44
1,1562,53998,3578766591,3578766637,46
1,1562,53999,3578766591,3578766638,47
1,1562,54000,3578766591,3578766638,47
1,1562,54001,3578766591,3578766639,48
1,1562,54002,3578766591,3578766641,50
1,1563,54003,3578766656,3578766656,0
1,1563,54004,3578766656,3578766656,0
1,1563,54005,3578766656,3578766656,0
1,1563,54006,3578766656,3578766656,0
1,1563,54007,3578766656,3578766656,0
1,1563,54008,3578766656,3578766656,0
1,1563,54009,3578766656,3578766656,0
1,1563,54010,3578766656,3578766656,0
1,1563,54011,3578766656,3578766656,0
1,1563,54012,3578766656,3578766656,0
1,1563,54013,3578766656,3578766657,1
1,1563,54014,3578766656,3578766657,1
1,1563,54015,3578766656,3578766657,1
1,1563,54016,3578766656,3578766658,2
1,1563,54017,3578766656,3578766659,3
1,1563,54018,3578766656,3578766660,4
1,1563,54019,3578766656,3578766661,5
1,1563,54020,3578766656,3578766662,6
1,1563,54021,3578766656,3578766663,7
1,1563,54022,3578766656,3578766664,8
1,1563,54023,3578766656,3578766665,9
1,1563,54024,3578766656,3578766666,10
1,1563,54025,3578766656,3578766667,11
1,1563,54026,3578766656,3578766668,12
1,1563,54027,3578766656,3578766669,13
1,1563,54028,3578766656,3578766670,14
1,1563,54029,3578766656,3578766680,24
1,1563,54030,3578766656,3578766682,26
1,1563,54031,3578766656,3578766682,26
1,1563,54032,3578766656,3578766683,27
1,1563,54033,3578766656,3578766684,28
1,1563,54034,3578766656,3578766684,28
1,1563,54035,3578766656,3578766685,29
1,1563,54036,3578766656,3578766685,29
1,1563,54037,3578766656,3578766687,31
1,1563,54038,3578766656,3578766688,32
1,1563,54039,3578766656,3578766688,32
1,1563,54040,3578766656,3578766690,34
1,1563,54041,3578766656,3578766692,36
1,1563,54042,3578766656,3578766693,37
1,1563,54043,3578766656,3578766693,37
1,1563,54044,3578766656,3578766694,38
1,1563,54045,3578766656,3578766694,38
1,1563,54046,3578766656,3578766694,38
1,1563,54047,3578766656,3578766695,39
1,1563,54048,3578766656,3578766696,40
1,1563,54049,3578766656,3578766696,40
1,1563,54050,3578766656,3578766697,41
1,1563,54051,3578766656,3578766698,42
1,1563,54052,3578766656,3578766698,42
1,1563,54053,3578766656,3578766699,43
1,1563,54054,3578766656,3578766699,43
1,1563,54055,3578766656,3578766699,43
1,1563,54056,3578766656,3578766701,45
1,1563,54057,3578766656,3578766702,46
1,1563,54058,3578766656,3578766702,46
1,1563,54059,3578766656,3578766702,46
1,1563,54060,3578766656,3578766703,47
1,1563,54061,3578766656,3578766703,47
1,1563,54062,3578766656,3578766703,47
1,1563,54063,3578766656,3578766703,47
1,1563,54064,3578766656,3578766704,48
1,1563,54065,3578766656,3578766705,49
1,1564,54066,3578766721,3578766721,0
1,1564,54067,3578766721,3578766721,0
1,1564,54068,3578766721,3578766721,0
1,1564,54069,3578766721,3578766721,0
1,1564,54070,3578766721,3578766721,0
1,1564,54071,3578766721,3578766721,0
1,1564,54072,3578766721,3578766721,0
1,1564,54073,3578766721,3578766722,1
1,1564,54074,3578766721,3578766722,1
1,1564,54075,3578766721,3578766722,1
1,1564,54076,3578766721,3578766722,1
1,1564,54077,3578766721,3578766722,1
1,1564,54078,3578766721,3578766722,1
1,1564,54079,3578766721,3578766722,1
1,1564,54080,3578766721,3578766722,1
1,1564,54081,3578766721,3578766722,1
1,1564,54082,3578766721,3578766722,1
1,1564,54083,3578766721,3578766722,1
1,1564,54084,3578766721,3578766722,1
1,1564,54085,3578766721,3578766722,1
1,1564,54086,3578766721,3578766722,1
1,1564,54087,3578766721,3578766722,1
1,1564,54088,3578766721,3578766722,1
1,1564,54089,3578766721,3578766722,1
1,1564,54090,3578766721,3578766722,1
1,1564,54091,3578766721,3578766722,1
1,1564,54092,3578766721,3578766722,1
1,1564,54093,3578766721,3578766723,2
1,1564,54094,3578766721,3578766724,3
1,1564,54095,3578766721,3578766725,4
1,1564,54096,3578766721,3578766727,6
1,1564,54097,3578766721,3578766727,6
1,1564,54098,3578766721,3578766727,6
1,1564,54099,3578766721,3578766728,7
1,1564,54100,3578766721,3578766728,7
1,1564,54101,3578766721,3578766729,8
1,1564,54102,3578766721,3578766729,8
1,1564,54103,3578766721,3578766730,9
1,1564,54104,3578766721,3578766731,10
1,1564,54105,3578766721,3578766732,11
1,1564,54106,3578766721,3578766732,11
1,1564,54107,3578766721,3578766733,12
1,1564,54108,3578766721,3578766733,12
1,1564,54109,3578766721,3578766733,12
1,1564,54110,3578766721,3578766734,13
1,1564,54111,3578766721,3578766735,14
1,1564,54112,3578766721,3578766736,15
1,1564,54113,3578766721,3578766736,15
1,1564,54114,3578766721,3578766736,15
1,1564,54115,3578766721,3578766736,15
1,1564,54116,3578766721,3578766737,16
1,1564,54117,3578766721,3578766740,19
1,1564,54118,3578766721,3578766740,19
1,1564,54119,3578766721,3578766742,21
1,1564,54120,3578766721,3578766742,21
1,1564,54121,3578766721,3578766746,25
1,1564,54122,3578766721,3578766746,25
1,1564,54123,3578766721,3578766747,26
1,1564,54124,3578766721,3578766748,27
1,1564,54125,3578766721,3578766749,28
1,1564,54126,3578766721,3578766753,32
1,1564,54127,3578766721,3578766754,33
1,1564,54128,3578766721,3578766755,34
1,1564,54129,3578766721,3578766755,34
1,1564,54130,3578766721,3578766755,34
1,1564,54131,3578766721,3578766759,38
1,1564,54132,3578766721,3578766762,41
1,1564,54133,3578766721,3578766762,41
1,1564,54134,3578766721,3578766763,42
1,1564,54135,3578766721,3578766763,42
1,1564,54136,3578766721,3578766764,43
1,1564,54137,3578766721,3578766765,44
1,1564,54138,3578766721,3578766765,44
1,1564,54139,3578766721,3578766765,44
1,1564,54140,3578766721,3578766766,45
1,1564,54141,3578766721,3578766768,47
1,1564,54142,3578766721,3578766768,47
1,1564,54143,3578766721,3578766768,47
1,1564,54144,3578766721,3578766768,47
1,1565,54145,3578766787,3578766787,0
1,1565,54146,3578766787,3578766787,0
1,1565,54147,3578766787,3578766787,0
1,1565,54148,3578766787,3578766787,0
1,1565,54149,3578766787,3578766787,0
1,1565,54150,3578766787,3578766787,0
1,1565,54151,3578766787,3578766787,0
1,1565,54152,3578766787,3578766787,0
1,1565,54153,3578766787,3578766787,0
1,1565,54154,3578766787,3578766787,0
1,1565,54155,3578766787,3578766787,0
1,1565,54156,3578766787,3578766787,0
1,1565,54157,3578766787,3578766787,0
1,1565,54158,3578766787,3578766787,0
1,1565,54159,3578766787,3578766787,0
1,1565,54160,3578766787,3578766787,0
1,1565,54161,3578766787,3578766790,3
1,1565,54162,3578766787,3578766791,4
1,1565,54163,3578766787,3578766791,4
1,1565,54164,3578766787,3578766792,5
1,1565,54165,3578766787,3578766794,7
1,1565,54166,3578766787,3578766795,8
1,1565,54167,3578766787,3578766795,8
1,1565,54168,3578766787,3578766796,9
1,1565,54169,3578766787,3578766796,9
1,1565,54170,3578766787,3578766798,11
1,1565,54171,3578766787,3578766798,11
1,1565,54172,3578766787,3578766799,12
1,1565,54173,3578766787,3578766800,13
1,1565,54174,3578766787,3578766802,15
1,1565,54175,3578766787,3578766803,16
1,1565,54176,3578766787,3578766804,17
1,1565,54177,3578766787,3578766806,19
1,1565,54178,3578766787,3578766809,22
1,1565,54179,3578766787,3578766810,23
1,1565,54180,3578766787,3578766812,25
1,1565,54181,3578766787,3578766812,25
1,1565,54182,3578766787,3578766813,26
1,1565,54183,3578766787,3578766813,26
1,1565,54184,3578766787,3578766813,26
1,1565,54185,3578766787,3578766813,26
1,1565,54186,3578766787,3578766813,26
1,1565,54187,3578766787,3578766815,28
1,1565,54188,3578766787,3578766815,28
1,1565,54189,3578766787,3578766817,30
1,1565,54190,3578766787,3578766817,30
1,1565,54191,3578766787,3578766818,31
1,1565,54192,3578766787,3578766818,31
1,1565,54193,3578766787,3578766818,31
1,1565,54194,3578766787,3578766818,31
1,1565,54195,3578766787,3578766820,33
1,1565,54196,3578766787,3578766822,35
1,1565,54197,3578766787,3578766822,35
1,1565,54198,3578766787,3578766823,36
1,1565,54199,3578766787,3578766825,38
1,1565,54200,3578766787,3578766826,39
1,1565,54201,3578766787,3578766826,39
1,1565,54202,3578766787,3578766826,39
1,1565,54203,3578766787,3578766827,40
1,1565,54204,3578766787,3578766829,42
1,1565,54205,3578766787,3578766829,42
1,1565,54206,3578766787,3578766829,42
1,1565,54207,3578766787,3578766829,42
1,1565,54208,3578766787,3578766831,44
1,1565,54209,3578766787,3578766832,45
1,1565,54210,3578766787,3578766832,45
1,1565,54211,3578766787,3578766834,47
1,1565,54212,3578766787,3578766835,48
1,1565,54213,3578766787,3578766836,49
1,1565,54214,3578766787,3578766836,49
1,1566,54215,3578766852,3578766852,0
1,1566,54216,3578766852,3578766852,0
1,1566,54217,3578766852,3578766852,0
1,1566,54218,3578766852,3578766852,0
1,1566,54219,3578766852,3578766852,0
1,1566,54220,3578766852,3578766852,0
1,1566,54221,3578766852,3578766852,0
1,1566,54222,3578766852,3578766852,0
1,1566,54223,3578766852,3578766852,0
1,1566,54224,3578766852,3578766853,1
1,1566,54225,3578766852,3578766853,1
1,1566,54226,3578766852,3578766853,1
1,1566,54227,3578766852,3578766853,1
1,1566,54228,3578766852,3578766855,3
1,1566,54229,3578766852,3578766856,4
1,1566,54230,3578766852,3578766856,4
1,1566,54231,3578766852,3578766857,5
1,1566,54232,3578766852,3578766857,5
1,1566,54233,3578766852,3578766859,7
1,1566,54234,3578766852,3578766860,8
1,1566,54235,3578766852,3578766861,9
1,1566,54236,3578766852,3578766863,11
1,1566,54237,3578766852,3578766863,11
1,1566,54238,3578766852,3578766864,12
1,1566,54239,3578766852,3578766865,13
1,1566,54240,3578766852,3578766867,15
1,1566,54241,3578766852,3578766867,15
1,1566,54242,3578766852,3578766869,17
1,1566,54243,3578766852,3578766869,17
1,1566,54244,3578766852,3578766870,18
1,1566,54245,3578766852,3578766881,29
1,1566,54246,3578766852,3578766882,30
1,1566,54247,3578766852,3578766882,30
1,1566,54248,3578766852,3578766884,32
1,1566,54249,3578766852,3578766884,32
1,1566,54250,3578766852,3578766885,33
1,1566,54251,3578766852,3578766885,33
1,1566,54252,3578766852,3578766885,33
1,1566,54253,3578766852,3578766887,35
1,1566,54254,3578766852,3578766888,36
1,1566,54255,3578766852,3578766890,38
1,1566,54256,3578766852,3578766892,40
1,1566,54257,3578766852,3578766893,41
1,1566,54258,3578766852,3578766893,41
1,1566,54259,3578766852,3578766893,41
1,1566,54260,3578766852,3578766894,42
1,1566,54261,3578766852,3578766894,42
1,1566,54262,3578766852,3578766895,43
1,1566,54263,3578766852,3578766895,43
1,1566,54264,3578766852,3578766896,44
1,1566,54265,3578766852,3578766897,45
1,1566,54266,3578766852,3578766897,45
1,1566,54267,3578766852,3578766898,46
1,1566,54268,3578766852,3578766898,46
1,1566,54269,3578766852,3578766899,47
1,1566,54270,3578766852,3578766899,47
1,1566,54271,3578766852,3578766901,49
1,1566,54272,3578766852,3578766902,50
1,1567,54273,3578766916,3578766916,0
1,1567,54274,3578766916,3578766916,0
1,1567,54275,3578766916,3578766916,0
1,1567,54276,3578766916,3578766916,0
1,1567,54277,3578766916,3578766916,0
1,1567,54278,3578766916,3578766916,0
1,1567,54279,3578766916,3578766916,0
1,1567,54280,3578766916,3578766916,0
1,1567,54281,3578766916,3578766916,0
1,1567,54282,3578766916,3578766916,0
1,1567,54283,3578766916,3578766916,0
1,1567,54284,3578766916,3578766916,0
1,1567,54285,3578766916,3578766916,0
1,1567,54286,3578766916,3578766916,0
1,1567,54287,3578766916,3578766916,0
1,1567,54288,3578766916,3578766916,0
1,1567,54289,3578766916,3578766916,0
1,1567,54290,3578766916,3578766916,0
1,1567,54291,3578766916,3578766916,0
1,1567,54292,3578766916,3578766916,0
1,1567,54293,3578766916,3578766916,0
1,1567,54294,3578766916,3578766918,2
1,1567,54295,3578766916,3578766920,4
1,1567,54296,3578766916,3578766920,4
1,1567,54297,3578766916,3578766920,4
1,1567,54298,3578766916,3578766921,5
1,1567,54299,3578766916,3578766921,5
1,1567,54300,3578766916,3578766921,5
1,1567,54301,3578766916,3578766921,5
1,1567,54302,3578766916,3578766922,6
1,1567,54303,3578766916,3578766922,6
1,1567,54304,3578766916,3578766922,6
1,1567,54305,3578766916,3578766924,8
1,1567,54306,3578766916,3578766924,8
1,1567,54307,3578766916,3578766925,9
1,1567,54308,3578766916,3578766926,10
1,1567,54309,3578766916,3578766926,10
1,1567,54310,3578766916,3578766927,11
1,1567,54311,3578766916,3578766928,12
1,1567,54312,3578766916,3578766929,13
1,1567,54313,3578766916,3578766930,14
1,1567,54314,3578766916,3578766931,15
1,1567,54315,3578766916,3578766932,16
1,1567,54316,3578766916,3578766932,16
1,1567,54317,3578766916,3578766932,16
1,1567,54318,3578766916,3578766933,17
1,1567,54319,3578766916,3578766933,17
1,1567,54320,3578766916,3578766934,18
1,1567,54321,3578766916,3578766935,19
1,1567,54322,3578766916,3578766936,20
1,1567,54323,3578766916,3578766936,20
1,1567,54324,3578766916,3578766937,21
1,1567,54325,3578766916,3578766937,21
1,1567,54326,3578766916,3578766940,24
1,1567,54327,3578766916,3578766940,24
1,1567,54328,3578766916,3578766942,26
1,1567,54329,3578766916,3578766942,26
1,1567,54330,3578766916,3578766946,30
1,1567,54331,3578766916,3578766946,30
1,1567,54332,3578766916,3578766946,30
1,1567,54333,3578766916,3578766947,31
1,1567,54334,3578766916,3578766948,32
1,1567,54335,3578766916,3578766949,33
1,1567,54336,3578766916,3578766950,34
1,1567,54337,3578766916,3578766954,38
1,1567,54338,3578766916,3578766954,38
1,1567,54339,3578766916,3578766955,39
1,1567,54340,3578766916,3578766955,39
1,1567,54341,3578766916,3578766956,40
1,1567,54342,3578766916,3578766963,47
1,1567,54343,3578766916,3578766963,47
1,1567,54344,3578766916,3578766963,47
1,1567,54345,3578766916,3578766963,47
1,1567,54346,3578766916,3578766964,48
1,1567,54347,3578766916,3578766964,48
1,1567,54348,3578766916,3578766964,48
1,1567,54349,3578766916,3578766964,48
1,1567,54350,3578766916,3578766965,49
1,1567,54351,3578766916,3578766965,49
1,1567,54352,3578766916,3578766966,50
1,1568,54353,3578766981,3578766981,0
1,1568,54354,3578766981,3578766981,0
1,1568,54355,3578766981,3578766981,0
1,1568,54356,3578766981,3578766981,0
1,1568,54357,3578766981,3578766981,0
1,1568,54358,3578766981,3578766981,0
1,1568,54359,3578766981,3578766981,0
1,1568,54360,3578766981,3578766981,0
1,1568,54361,3578766981,3578766981,0
1,1568,54362,3578766981,3578766981,0
1,1568,54363,3578766981,3578766981,0
1,1568,54364,3578766981,3578766981,0
1,1568,54365,3578766981,3578766981,0
1,1568,54366,3578766981,3578766981,0
1,1568,54367,3578766981,3578766981,0
1,1568,54368,3578766981,3578766981,0
1,1568,54369,3578766981,3578766982,1
1,1568,54370,3578766981,3578766984,3
1,1568,54371,3578766981,3578766986,5
1,1568,54372,3578766981,3578766990,9
1,1568,54373,3578766981,3578766991,10
1,1568,54374,3578766981,3578766991,10
1,1568,54375,3578766981,3578766992,11
1,1568,54376,3578766981,3578766994,13
1,1568,54377,3578766981,3578766994,13
1,1568,54378,3578766981,3578766995,14
1,1568,54379,3578766981,3578766996,15
1,1568,54380,3578766981,3578766996,15
1,1568,54381,3578766981,3578766997,16
1,1568,54382,3578766981,3578766997,16
1,1568,54383,3578766981,3578766999,18
1,1568,54384,3578766981,3578767000,19
1,1568,54385,3578766981,3578767000,19
1,1568,54386,3578766981,3578767001,20
1,1568,54387,3578766981,3578767001,20
1,1568,54388,3578766981,3578767004,23
1,1568,54389,3578766981,3578767006,25
1,1568,54390,3578766981,3578767009,28
1,1568,54391,3578766981,3578767011,30
1,1568,54392,3578766981,3578767012,31
1,1568,54393,3578766981,3578767012,31
1,1568,54394,3578766981,3578767012,31
1,1568,54395,3578766981,3578767012,31
1,1568,54396,3578766981,3578767013,32
1,1568,54397,3578766981,3578767014,33
1,1568,54398,3578766981,3578767014,33
1,1568,54399,3578766981,3578767014,33
1,1568,54400,3578766981,3578767015,34
1,1568,54401,3578766981,3578767017,36
1,1568,54402,3578766981,3578767017,36
1,1568,54403,3578766981,3578767017,36
1,1568,54404,3578766981,3578767018,37
1,1568,54405,3578766981,3578767018,37
1,1568,54406,3578766981,3578767019,38
1,1568,54407,3578766981,3578767019,38
1,1568,54408,3578766981,3578767019,38
1,1568,54409,3578766981,3578767022,41
1,1568,54410,3578766981,3578767022,41
1,1568,54411,3578766981,3578767025,44
1,1568,54412,3578766981,3578767026,45
1,1568,54413,3578766981,3578767026,45
1,1568,54414,3578766981,3578767026,45
1,1568,54415,3578766981,3578767026,45
1,1568,54416,3578766981,3578767026,45
1,1568,54417,3578766981,3578767029,48
1,1568,54418,3578766981,3578767029,48
1,1568,54419,3578766981,3578767029,48
1,1568,54420,3578766981,3578767031,50
1,1569,54421,3578767045,3578767045,0
1,1569,54422,3578767045,3578767045,0
1,1569,54423,3578767045,3578767045,0
1,1569,54424,3578767045,3578767045,0
1,1569,54425,3578767045,3578767045,0
1,1569,54426,3578767045,3578767045,0
1,1569,54427,3578767045,3578767045,0
1,1569,54428,3578767045,3578767045,0
1,1569,54429,3578767045,3578767045,0
1,1569,54430,3578767045,3578767045,0
1,1569,54431,3578767045,3578767045,0
1,1569,54432,3578767045,3578767047,2
1,1569,54433,3578767045,3578767049,4
1,1569,54434,3578767045,3578767049,4
1,1569,54435,3578767045,3578767050,5
1,1569,54436,3578767045,3578767052,7
1,1569,54437,3578767045,3578767053,8
1,1569,54438,3578767045,3578767053,8
1,1569,54439,3578767045,3578767053,8
1,1569,54440,3578767045,3578767055,10
1,1569,54441,3578767045,3578767056,11
1,1569,54442,3578767045,3578767057,12
1,1569,54443,3578767045,3578767057,12
1,1569,54444,3578767045,3578767057,12
1,1569,54445,3578767045,3578767059,14
1,1569,54446,3578767045,3578767059,14
1,1569,54447,3578767045,3578767060,15
1,1569,54448,3578767045,3578767062,17
1,1569,54449,3578767045,3578767063,18
1,1569,54450,3578767045,3578767063,18
1,1569,54451,3578767045,3578767066,21
1,1569,54452,3578767045,3578767067,22
1,1569,54453,3578767045,3578767068,23
1,1569,54454,3578767045,3578767069,24
1,1569,54455,3578767045,3578767070,25
1,1569,54456,3578767045,3578767081,36
1,1569,54457,3578767045,3578767082,37
1,1569,54458,3578767045,3578767082,37
1,1569,54459,3578767045,3578767084,39
1,1569,54460,3578767045,3578767085,40
1,1569,54461,3578767045,3578767085,40
1,1569,54462,3578767045,3578767085,40
1,1569,54463,3578767045,3578767086,41
1,1569,54464,3578767045,3578767087,42
1,1569,54465,3578767045,3578767088,43
1,1569,54466,3578767045,3578767090,45
1,1569,54467,3578767045,3578767092,47
1,1569,54468,3578767045,3578767093,48
1,1569,54469,3578767045,3578767094,49
1,1569,54470,3578767045,3578767094,49
1,1569,54471,3578767045,3578767094,49
1,1569,54472,3578767045,3578767094,49
1,1569,54473,3578767045,3578767095,50
1,1570,54474,3578767109,3578767109,0
1,1570,54475,3578767109,3578767109,0
1,1570,54476,3578767109,3578767109,0
1,1570,54477,3578767109,3578767109,0
1,1570,54478,3578767109,3578767109,0
1,1570,54479,3578767109,3578767109,0
1,1570,54480,3578767109,3578767109,0
1,1570,54481,3578767109,3578767109,0
1,1570,54482,3578767109,3578767109,0
1,1570,54483,3578767109,3578767109,0
1,1570,54484,3578767109,3578767109,0
1,1570,54485,3578767109,3578767109,0
1,1570,54486,3578767109,3578767109,0
1,1570,54487,3578767109,3578767109,0
1,1570,54488,3578767109,3578767109,0
1,1570,54489,3578767109,3578767109,0
1,1570,54490,3578767109,3578767109,0
1,1570,54491,3578767109,3578767109,0
1,1570,54492,3578767109,3578767109,0
1,1570,54493,3578767109,3578767109,0
1,1570,54494,3578767109,3578767111,2
1,1570,54495,3578767109,3578767112,3
1,1570,54496,3578767109,3578767113,4
1,1570,54497,3578767109,3578767113,4
1,1570,54498,3578767109,3578767113,4
1,1570,54499,3578767109,3578767114,5
1,1570,54500,3578767109,3578767114,5
1,1570,54501,3578767109,3578767114,5
1,1570,54502,3578767109,3578767115,6
1,1570,54503,3578767109,3578767116,7
1,1570,54504,3578767109,3578767119,10
1,1570,54505,3578767109,3578767120,11
1,1570,54506,3578767109,3578767120,11
1,1570,54507,3578767109,3578767120,11
1,1570,54508,3578767109,3578767121,12
1,1570,54509,3578767109,3578767121,12
1,1570,54510,3578767109,3578767122,13
1,1570,54511,3578767109,3578767122,13
1,1570,54512,3578767109,3578767122,13
1,1570,54513,3578767109,3578767123,14
1,1570,54514,3578767109,3578767125,16
1,1570,54515,3578767109,3578767125,16
1,1570,54516,3578767109,3578767126,17
1,1570,54517,3578767109,3578767128,19
1,1570,54518,3578767109,3578767128,19
1,1570,54519,3578767109,3578767129,20
1,1570,54520,3578767109,3578767129,20
1,1570,54521,3578767109,3578767129,20
1,1570,54522,3578767109,3578767130,21
1,1570,54523,3578767109,3578767132,23
1,1570,54524,3578767109,3578767133,24
1,1570,54525,3578767109,3578767133,24
1,1570,54526,3578767109,3578767133,24
1,1570,54527,3578767109,3578767135,26
1,1570,54528,3578767109,3578767136,27
1,1570,54529,3578767109,3578767138,29
1,1570,54530,3578767109,3578767138,29
1,1570,54531,3578767109,3578767138,29
1,1570,54532,3578767109,3578767141,32
1,1570,54533,3578767109,3578767142,33
1,1570,54534,3578767109,3578767143,34
1,1570,54535,3578767109,3578767146,37
1,1570,54536,3578767109,3578767146,37
1,1570,54537,3578767109,3578767146,37
1,1570,54538,3578767109,3578767148,39
1,1570,54539,3578767109,3578767148,39
1,1570,54540,3578767109,3578767150,41
1,1570,54541,3578767109,3578767150,41
1,1570,54542,3578767109,3578767152,43
1,1570,54543,3578767109,3578767154,45
1,1570,54544,3578767109,3578767154,45
1,1570,54545,3578767109,3578767155,46
1,1570,54546,3578767109,3578767155,46
1,1570,54547,3578767109,3578767155,46
1,1571,54548,3578767173,3578767173,0
1,1571,54549,3578767173,3578767173,0
1,1571,54550,3578767173,3578767173,0
1,1571,54551,3578767173,3578767173,0
1,1571,54552,3578767173,3578767173,0
1,1571,54553,3578767173,3578767173,0
1,1571,54554,3578767173,3578767173,0
1,1571,54555,3578767173,3578767173,0
1,1571,54556,3578767173,3578767173,0
1,1571,54557,3578767173,3578767173,0
1,1571,54558,3578767173,3578767173,0
1,1571,54559,3578767173,3578767173,0
1,1571,54560,3578767173,3578767173,0
1,1571,54561,3578767173,3578767173,0
1,1571,54562,3578767173,3578767173,0
1,1571,54563,3578767173,3578767173,0
1,1571,54564,3578767173,3578767174,1
1,1571,54565,3578767173,3578767174,1
1,1571,54566,3578767173,3578767177,4
1,1571,54567,3578767173,3578767177,4
1,1571,54568,3578767173,3578767178,5
1,1571,54569,3578767173,3578767178,5
1,1571,54570,3578767173,3578767179,6
1,1571,54571,3578767173,3578767180,7
1,1571,54572,3578767173,3578767181,8
1,1571,54573,3578767173,3578767181,8
1,1571,54574,3578767173,3578767181,8
1,1571,54575,3578767173,3578767181,8
1,1571,54576,3578767173,3578767182,9
1,1571,54577,3578767173,3578767183,10
1,1571,54578,3578767173,3578767186,13
1,1571,54579,3578767173,3578767190,17
1,1571,54580,3578767173,3578767191,18
1,1571,54581,3578767173,3578767192,19
1,1571,54582,3578767173,3578767192,19
1,1571,54583,3578767173,3578767195,22
1,1571,54584,3578767173,3578767195,22
1,1571,54585,3578767173,3578767196,23
1,1571,54586,3578767173,3578767196,23
1,1571,54587,3578767173,3578767197,24
1,1571,54588,3578767173,3578767197,24
1,1571,54589,3578767173,3578767199,26
1,1571,54590,3578767173,3578767199,26
1,1571,54591,3578767173,3578767200,27
1,1571,54592,3578767173,3578767201,28
1,1571,54593,3578767173,3578767203,30
1,1571,54594,3578767173,3578767204,31
1,1571,54595,3578767173,3578767206,33
1,1571,54596,3578767173,3578767209,36
1,1571,54597,3578767173,3578767210,37
1,1571,54598,3578767173,3578767211,38
1,1571,54599,3578767173,3578767212,39
1,1571,54600,3578767173,3578767212,39
1,1571,54601,3578767173,3578767213,40
1,1571,54602,3578767173,3578767213,40
1,1571,54603,3578767173,3578767213,40
1,1571,54604,3578767173,3578767214,41
1,1571,54605,3578767173,3578767215,42
1,1571,54606,3578767173,3578767216,43
1,1571,54607,3578767173,3578767216,43
1,1571,54608,3578767173,3578767216,43
1,1571,54609,3578767173,3578767217,44
1,1571,54610,3578767173,3578767217,44
1,1571,54611,3578767173,3578767217,44
1,1571,54612,3578767173,3578767219,46
1,1571,54613,3578767173,3578767219,46
1,1571,54614,3578767173,3578767220,47
1,1571,54615,3578767173,3578767222,49
1,1572,54616,3578767239,3578767239,0
1,1572,54617,3578767239,3578767239,0
1,1572,54618,3578767239,3578767239,0
1,1572,54619,3578767239,3578767239,0
1,1572,54620,3578767239,3578767239,0
1,1572,54621,3578767239,3578767239,0
1,1572,54622,3578767239,3578767239,0
1,1572,54623,3578767239,3578767239,0
1,1572,54624,3578767239,3578767239,0
1,1572,54625,3578767239,3578767239,0
1,1572,54626,3578767239,3578767239,0
1,1572,54627,3578767239,3578767239,0
1,1572,54628,3578767239,3578767239,0
1,1572,54629,3578767239,3578767239,0
1,1572,54630,3578767239,3578767239,0
1,1572,54631,3578767239,3578767239,0
1,1572,54632,3578767239,3578767239,0
1,1572,54633,3578767239,3578767239,0
1,1572,54634,3578767239,3578767239,0
1,1572,54635,3578767239,3578767239,0
1,1572,54636,3578767239,3578767240,1
1,1572,54637,3578767239,3578767241,2
1,1572,54638,3578767239,3578767247,8
1,1572,54639,3578767239,3578767247,8
1,1572,54640,3578767239,3578767249,10
1,1572,54641,3578767239,3578767249,10
1,1572,54642,3578767239,3578767250,11
1,1572,54643,3578767239,3578767252,13
1,1572,54644,3578767239,3578767253,14
1,1572,54645,3578767239,3578767253,14
1,1572,54646,3578767239,3578767254,15
1,1572,54647,3578767239,3578767255,16
1,1572,54648,3578767239,3578767257,18
1,1572,54649,3578767239,3578767257,18
1,1572,54650,3578767239,3578767257,18
1,1572,54651,3578767239,3578767258,19
1,1572,54652,3578767239,3578767259,20
1,1572,54653,3578767239,3578767259,20
1,1572,54654,3578767239,3578767261,22
1,1572,54655,3578767239,3578767263,24
1,1572,54656,3578767239,3578767263,24
1,1572,54657,3578767239,3578767263,24
1,1572,54658,3578767239,3578767266,27
1,1572,54659,3578767239,3578767267,28
1,1572,54660,3578767239,3578767268,29
1,1572,54661,3578767239,3578767269,30
1,1572,54662,3578767239,3578767270,31
1,1572,54663,3578767239,3578767281,42
1,1572,54664,3578767239,3578767282,43
1,1572,54665,3578767239,3578767285,46
1,1572,54666,3578767239,3578767285,46
1,1572,54667,3578767239,3578767285,46
1,1572,54668,3578767239,3578767285,46
1,1572,54669,3578767239,3578767286,47
1,1572,54670,3578767239,3578767289,50
1,1573,54671,3578767304,3578767304,0
1,1573,54672,3578767304,3578767304,0
1,1573,54673,3578767304,3578767304,0
1,1573,54674,3578767304,3578767304,0
1,1573,54675,3578767304,3578767304,0
1,1573,54676,3578767304,3578767304,0
1,1573,54677,3578767304,3578767304,0
1,1573,54678,3578767304,3578767304,0
1,1573,54679,3578767304,3578767304,0
1,1573,54680,3578767304,3578767304,0
1,1573,54681,3578767304,3578767304,0
1,1573,54682,3578767304,3578767304,0
1,1573,54683,3578767304,3578767304,0
1,1573,54684,3578767304,3578767304,0
1,1573,54685,3578767304,3578767304,0
1,1573,54686,3578767304,3578767304,0
1,1573,54687,3578767304,3578767304,0
1,1573,54688,3578767304,3578767304,0
1,1573,54689,3578767304,3578767304,0
1,1573,54690,3578767304,3578767304,0
1,1573,54691,3578767304,3578767304,0
1,1573,54692,3578767304,3578767304,0
1,1573,54693,3578767304,3578767304,0
1,1573,54694,3578767304,3578767304,0
1,1573,54695,3578767304,3578767306,2
1,1573,54696,3578767304,3578767307,3
1,1573,54697,3578767304,3578767308,4
1,1573,54698,3578767304,3578767308,4
1,1573,54699,3578767304,3578767309,5
1,1573,54700,3578767304,3578767309,5
1,1573,54701,3578767304,3578767309,5
1,1573,54702,3578767304,3578767310,6
1,1573,54703,3578767304,3578767311,7
1,1573,54704,3578767304,3578767312,8
1,1573,54705,3578767304,3578767312,8
1,1573,54706,3578767304,3578767313,9
1,1573,54707,3578767304,3578767313,9
1,1573,54708,3578767304,3578767314,10
1,1573,54709,3578767304,3578767314,10
1,1573,54710,3578767304,3578767315,11
1,1573,54711,3578767304,3578767316,12
1,1573,54712,3578767304,3578767316,12
1,1573,54713,3578767304,3578767319,15
1,1573,54714,3578767304,3578767320,16
1,1573,54715,3578767304,3578767321,17
1,1573,54716,3578767304,3578767321,17
1,1573,54717,3578767304,3578767321,17
1,1573,54718,3578767304,3578767321,17
1,1573,54719,3578767304,3578767321,17
1,1573,54720,3578767304,3578767323,19
1,1573,54721,3578767304,3578767323,19
1,1573,54722,3578767304,3578767325,21
1,1573,54723,3578767304,3578767325,21
1,1573,54724,3578767304,3578767327,23
1,1573,54725,3578767304,3578767328,24
1,1573,54726,3578767304,3578767328,24
1,1573,54727,3578767304,3578767329,25
1,1573,54728,3578767304,3578767329,25
1,1573,54729,3578767304,3578767330,26
1,1573,54730,3578767304,3578767331,27
1,1573,54731,3578767304,3578767332,28
1,1573,54732,3578767304,3578767333,29
1,1573,54733,3578767304,3578767333,29
1,1573,54734,3578767304,3578767334,30
1,1573,54735,3578767304,3578767335,31
1,1573,54736,3578767304,3578767335,31
1,1573,54737,3578767304,3578767335,31
1,1573,54738,3578767304,3578767336,32
1,1573,54739,3578767304,3578767337,33
1,1573,54740,3578767304,3578767338,34
1,1573,54741,3578767304,3578767338,34
1,1573,54742,3578767304,3578767340,36
1,1573,54743,3578767304,3578767341,37
1,1573,54744,3578767304,3578767342,38
1,1573,54745,3578767304,3578767343,39
1,1573,54746,3578767304,3578767346,42
1,1573,54747,3578767304,3578767346,42
1,1573,54748,3578767304,3578767346,42
1,1573,54749,3578767304,3578767348,44
1,1573,54750,3578767304,3578767348,44
1,1573,54751,3578767304,3578767350,46
1,1573,54752,3578767304,3578767350,46
1,1573,54753,3578767304,3578767352,48
1,1573,54754,3578767304,3578767354,50
1,1574,54755,3578767369,3578767369,0
1,1574,54756,3578767369,3578767369,0
1,1574,54757,3578767369,3578767369,0
1,1574,54758,3578767369,3578767369,0
1,1574,54759,3578767369,3578767369,0
1,1574,54760,3578767369,3578767369,0
1,1574,54761,3578767369,3578767369,0
1,1574,54762,3578767369,3578767369,0
1,1574,54763,3578767369,3578767369,0
1,1574,54764,3578767369,3578767369,0
1,1574,54765,3578767369,3578767369,0
1,1574,54766,3578767369,3578767369,0
1,1574,54767,3578767369,3578767369,0
1,1574,54768,3578767369,3578767369,0
1,1574,54769,3578767369,3578767369,0
1,1574,54770,3578767369,3578767370,1
1,1574,54771,3578767369,3578767372,3
1,1574,54772,3578767369,3578767373,4
1,1574,54773,3578767369,3578767376,7
1,1574,54774,3578767369,3578767376,7
1,1574,54775,3578767369,3578767377,8
1,1574,54776,3578767369,3578767378,9
1,1574,54777,3578767369,3578767379,10
1,1574,54778,3578767369,3578767380,11
1,1574,54779,3578767369,3578767380,11
1,1574,54780,3578767369,3578767380,11
1,1574,54781,3578767369,3578767382,13
1,1574,54782,3578767369,3578767382,13
1,1574,54783,3578767369,3578767382,13
1,1574,54784,3578767369,3578767384,15
1,1574,54785,3578767369,3578767385,16
1,1574,54786,3578767369,3578767390,21
1,1574,54787,3578767369,3578767391,22
1,1574,54788,3578767369,3578767392,23
1,1574,54789,3578767369,3578767392,23
1,1574,54790,3578767369,3578767394,25
1,1574,54791,3578767369,3578767394,25
1,1574,54792,3578767369,3578767395,26
1,1574,54793,3578767369,3578767395,26
1,1574,54794,3578767369,3578767396,27
1,1574,54795,3578767369,3578767397,28
1,1574,54796,3578767369,3578767397,28
1,1574,54797,3578767369,3578767397,28
1,1574,54798,3578767369,3578767399,30
1,1574,54799,3578767369,3578767399,30
1,1574,54800,3578767369,3578767400,31
1,1574,54801,3578767369,3578767401,32
1,1574,54802,3578767369,3578767402,33
1,1574,54803,3578767369,3578767404,35
1,1574,54804,3578767369,3578767404,35
1,1574,54805,3578767369,3578767406,37
1,1574,54806,3578767369,3578767408,39
1,1574,54807,3578767369,3578767411,42
1,1574,54808,3578767369,3578767412,43
1,1574,54809,3578767369,3578767412,43
1,1574,54810,3578767369,3578767413,44
1,1574,54811,3578767369,3578767413,44
1,1574,54812,3578767369,3578767413,44
1,1574,54813,3578767369,3578767414,45
1,1574,54814,3578767369,3578767416,47
1,1574,54815,3578767369,3578767416,47
1,1574,54816,3578767369,3578767417,48
1,1574,54817,3578767369,3578767417,48
1,1574,54818,3578767369,3578767417,48
1,1574,54819,3578767369,3578767417,48
1,1574,54820,3578767369,3578767419,50
1,1575,54821,3578767435,3578767435,0
1,1575,54822,3578767435,3578767435,0
1,1575,54823,3578767435,3578767435,0
1,1575,54824,3578767435,3578767435,0
1,1575,54825,3578767435,3578767435,0
1,1575,54826,3578767435,3578767435,0
1,1575,54827,3578767435,3578767435,0
1,1575,54828,3578767435,3578767435,0
1,1575,54829,3578767435,3578767435,0
1,1575,54830,3578767435,3578767435,0
1,1575,54831,3578767435,3578767435,0
1,1575,54832,3578767435,3578767435,0
1,1575,54833,3578767435,3578767435,0
1,1575,54834,3578767435,3578767435,0
1,1575,54835,3578767435,3578767435,0
1,1575,54836,3578767435,3578767436,1
1,1575,54837,3578767435,3578767436,1
1,1575,54838,3578767435,3578767437,2
1,1575,54839,3578767435,3578767437,2
1,1575,54840,3578767435,3578767438,3
1,1575,54841,3578767435,3578767438,3
1,1575,54842,3578767435,3578767440,5
1,1575,54843,3578767435,3578767441,6
1,1575,54844,3578767435,3578767447,12
1,1575,54845,3578767435,3578767447,12
1,1575,54846,3578767435,3578767449,14
1,1575,54847,3578767435,3578767450,15
1,1575,54848,3578767435,3578767452,17
1,1575,54849,3578767435,3578767453,18
1,1575,54850,3578767435,3578767454,19
1,1575,54851,3578767435,3578767455,20
1,1575,54852,3578767435,3578767455,20
1,1575,54853,3578767435,3578767456,21
1,1575,54854,3578767435,3578767456,21
1,1575,54855,3578767435,3578767457,22
1,1575,54856,3578767435,3578767458,23
1,1575,54857,3578767435,3578767458,23
1,1575,54858,3578767435,3578767459,24
1,1575,54859,3578767435,3578767460,25
1,1575,54860,3578767435,3578767461,26
1,1575,54861,3578767435,3578767463,28
1,1575,54862,3578767435,3578767463,28
1,1575,54863,3578767435,3578767463,28
1,1575,54864,3578767435,3578767467,32
1,1575,54865,3578767435,3578767469,34
1,1575,54866,3578767435,3578767469,34
1,1575,54867,3578767435,3578767470,35
1,1575,54868,3578767435,3578767481,46
1,1575,54869,3578767435,3578767483,48
1,1575,54870,3578767435,3578767485,50
1,1576,54871,3578767499,3578767499,0
1,1576,54872,3578767499,3578767499,0
1,1576,54873,3578767499,3578767499,0
1,1576,54874,3578767499,3578767499,0
1,1576,54875,3578767499,3578767499,0
1,1576,54876,3578767499,3578767499,0
1,1576,54877,3578767499,3578767499,0
1,1576,54878,3578767499,3578767499,0
1,1576,54879,3578767499,3578767499,0
1,1576,54880,3578767499,3578767499,0
1,1576,54881,3578767499,3578767499,0
1,1576,54882,3578767499,3578767499,0
1,1576,54883,3578767499,3578767499,0
1,1576,54884,3578767499,3578767499,0
1,1576,54885,3578767499,3578767499,0
1,1576,54886,3578767499,3578767499,0
1,1576,54887,3578767499,3578767499,0
1,1576,54888,3578767499,3578767499,0
1,1576,54889,3578767499,3578767499,0
1,1576,54890,3578767499,3578767499,0
1,1576,54891,3578767499,3578767499,0
1,1576,54892,3578767499,3578767499,0
1,1576,54893,3578767499,3578767500,1
1,1576,54894,3578767499,3578767502,3
1,1576,54895,3578767499,3578767502,3
1,1576,54896,3578767499,3578767502,3
1,1576,54897,3578767499,3578767502,3
1,1576,54898,3578767499,3578767503,4
1,1576,54899,3578767499,3578767503,4
1,1576,54900,3578767499,3578767504,5
1,1576,54901,3578767499,3578767505,6
1,1576,54902,3578767499,3578767506,7
1,1576,54903,3578767499,3578767507,8
1,1576,54904,3578767499,3578767507,8
1,1576,54905,3578767499,3578767508,9
1,1576,54906,3578767499,3578767508,9
1,1576,54907,3578767499,3578767508,9
1,1576,54908,3578767499,3578767509,10
1,1576,54909,3578767499,3578767511,12
1,1576,54910,3578767499,3578767512,13
1,1576,54911,3578767499,3578767512,13
1,1576,54912,3578767499,3578767512,13
1,1576,54913,3578767499,3578767512,13
1,1576,54914,3578767499,3578767513,14
1,1576,54915,3578767499,3578767513,14
1,1576,54916,3578767499,3578767513,14
1,1576,54917,3578767499,3578767514,15
1,1576,54918,3578767499,3578767515,16
1,1576,54919,3578767499,3578767517,18
1,1576,54920,3578767499,3578767519,20
1,1576,54921,3578767499,3578767520,21
1,1576,54922,3578767499,3578767520,21
1,1576,54923,3578767499,3578767520,21
1,1576,54924,3578767499,3578767520,21
1,1576,54925,3578767499,3578767521,22
1,1576,54926,3578767499,3578767521,22
1,1576,54927,3578767499,3578767521,22
1,1576,54928,3578767499,3578767522,23
1,1576,54929,3578767499,3578767522,23
1,1576,54930,3578767499,3578767524,25
1,1576,54931,3578767499,3578767525,26
1,1576,54932,3578767499,3578767526,27
1,1576,54933,3578767499,3578767526,27
1,1576,54934,3578767499,3578767527,28
1,1576,54935,3578767499,3578767527,28
1,1576,54936,3578767499,3578767529,30
1,1576,54937,3578767499,3578767529,30
1,1576,54938,3578767499,3578767530,31
1,1576,54939,3578767499,3578767530,31
1,1576,54940,3578767499,3578767531,32
1,1576,54941,3578767499,3578767531,32
1,1576,54942,3578767499,3578767531,32
1,1576,54943,3578767499,3578767531,32
1,1576,54944,3578767499,3578767533,34
1,1576,54945,3578767499,3578767534,35
1,1576,54946,3578767499,3578767534,35
1,1576,54947,3578767499,3578767534,35
1,1576,54948,3578767499,3578767536,37
1,1576,54949,3578767499,3578767536,37
1,1576,54950,3578767499,3578767537,38
1,1576,54951,3578767499,3578767537,38
1,1576,54952,3578767499,3578767539,40
1,1576,54953,3578767499,3578767540,41
1,1576,54954,3578767499,3578767542,43
1,1576,54955,3578767499,3578767545,46
1,1576,54956,3578767499,3578767545,46
1,1576,54957,3578767499,3578767546,47
1,1576,54958,3578767499,3578767547,48
1,1576,54959,3578767499,3578767548,49
1,1577,54960,3578767564,3578767564,0
1,1577,54961,3578767564,3578767564,0
1,1577,54962,3578767564,3578767564,0
1,1577,54963,3578767564,3578767564,0
1,1577,54964,3578767564,3578767564,0
1,1577,54965,3578767564,3578767564,0
1,1577,54966,3578767564,3578767564,0
1,1577,54967,3578767564,3578767564,0
1,1577,54968,3578767564,3578767564,0
1,1577,54969,3578767564,3578767564,0
1,1577,54970,3578767564,3578767564,0
1,1577,54971,3578767564,3578767564,0
1,1577,54972,3578767564,3578767564,0
1,1577,54973,3578767564,3578767565,1
1,1577,54974,3578767564,3578767565,1
1,1577,54975,3578767564,3578767565,1
1,1577,54976,3578767564,3578767566,2
1,1577,54977,3578767564,3578767566,2
1,1577,54978,3578767564,3578767567,3
1,1577,54979,3578767564,3578767568,4
1,1577,54980,3578767564,3578767568,4
1,1577,54981,3578767564,3578767568,4
1,1577,54982,3578767564,3578767569,5
1,1577,54983,3578767564,3578767572,8
1,1577,54984,3578767564,3578767572,8
1,1577,54985,3578767564,3578767575,11
1,1577,54986,3578767564,3578767576,12
1,1577,54987,3578767564,3578767576,12
1,1577,54988,3578767564,3578767576,12
1,1577,54989,3578767564,3578767577,13
1,1577,54990,3578767564,3578767579,15
1,1577,54991,3578767564,3578767580,16
1,1577,54992,3578767564,3578767580,16
1,1577,54993,3578767564,3578767580,16
1,1577,54994,3578767564,3578767581,17
1,1577,54995,3578767564,3578767581,17
1,1577,54996,3578767564,3578767581,17
1,1577,54997,3578767564,3578767582,18
1,1577,54998,3578767564,3578767585,21
1,1577,54999,3578767564,3578767588,24
1,1577,55000,3578767564,3578767590,26
1,1577,55001,3578767564,3578767591,27
1,1577,55002,3578767564,3578767592,28
1,1577,55003,3578767564,3578767593,29
1,1577,55004,3578767564,3578767593,29
1,1577,55005,3578767564,3578767594,30
1,1577,55006,3578767564,3578767596,32
1,1577,55007,3578767564,3578767596,32
1,1577,55008,3578767564,3578767596,32
1,1577,55009,3578767564,3578767596,32
1,1577,55010,3578767564,3578767597,33
1,1577,55011,3578767564,3578767598,34
1,1577,55012,3578767564,3578767599,35
1,1577,55013,3578767564,3578767599,35
1,1577,55014,3578767564,3578767600,36
1,1577,55015,3578767564,3578767601,37
1,1577,55016,3578767564,3578767603,39
1,1577,55017,3578767564,3578767603,39
1,1577,55018,3578767564,3578767605,41
1,1577,55019,3578767564,3578767609,45
1,1577,55020,3578767564,3578767609,45
1,1577,55021,3578767564,3578767610,46
1,1577,55022,3578767564,3578767612,48
1,1577,55023,3578767564,3578767612,48
1,1577,55024,3578767564,3578767612,48
1,1577,55025,3578767564,3578767612,48
1,1577,55026,3578767564,3578767613,49
1,1578,55027,3578767629,3578767629,0
1,1578,55028,3578767629,3578767629,0
1,1578,55029,3578767629,3578767629,0
1,1578,55030,3578767629,3578767629,0
1,1578,55031,3578767629,3578767629,0
1,1578,55032,3578767629,3578767629,0
1,1578,55033,3578767629,3578767629,0
1,1578,55034,3578767629,3578767629,0
1,1578,55035,3578767629,3578767629,0
1,1578,55036,3578767629,3578767629,0
1,1578,55037,3578767629,3578767629,0
1,1578,55038,3578767629,3578767629,0
1,1578,55039,3578767629,3578767629,0
1,1578,55040,3578767629,3578767629,0
1,1578,55041,3578767629,3578767629,0
1,1578,55042,3578767629,3578767629,0
1,1578,55043,3578767629,3578767629,0
1,1578,55044,3578767629,3578767629,0
1,1578,55045,3578767629,3578767629,0
1,1578,55046,3578767629,3578767629,0
1,1578,55047,3578767629,3578767629,0
1,1578,55048,3578767629,3578767629,0
1,1578,55049,3578767629,3578767629,0
1,1578,55050,3578767629,3578767631,2
1,1578,55051,3578767629,3578767631,2
1,1578,55052,3578767629,3578767631,2
1,1578,55053,3578767629,3578767633,4
1,1578,55054,3578767629,3578767635,6
1,1578,55055,3578767629,3578767635,6
1,1578,55056,3578767629,3578767636,7
1,1578,55057,3578767629,3578767637,8
1,1578,55058,3578767629,3578767637,8
1,1578,55059,3578767629,3578767637,8
1,1578,55060,3578767629,3578767639,10
1,1578,55061,3578767629,3578767640,11
1,1578,55062,3578767629,3578767646,17
1,1578,55063,3578767629,3578767646,17
1,1578,55064,3578767629,3578767648,19
1,1578,55065,3578767629,3578767652,23
1,1578,55066,3578767629,3578767653,24
1,1578,55067,3578767629,3578767653,24
1,1578,55068,3578767629,3578767654,25
1,1578,55069,3578767629,3578767656,27
1,1578,55070,3578767629,3578767656,27
1,1578,55071,3578767629,3578767657,28
1,1578,55072,3578767629,3578767657,28
1,1578,55073,3578767629,3578767657,28
1,1578,55074,3578767629,3578767659,30
1,1578,55075,3578767629,3578767660,31
1,1578,55076,3578767629,3578767662,33
1,1578,55077,3578767629,3578767662,33
1,1578,55078,3578767629,3578767663,34
1,1578,55079,3578767629,3578767667,38
1,1578,55080,3578767629,3578767668,39
1,1578,55081,3578767629,3578767669,40
1,1578,55082,3578767629,3578767669,40
1,1579,55083,3578767695,3578767695,0
1,1579,55084,3578767695,3578767695,0
1,1579,55085,3578767695,3578767695,0
1,1579,55086,3578767695,3578767695,0
1,1579,55087,3578767695,3578767695,0
1,1579,55088,3578767695,3578767695,0
1,1579,55089,3578767695,3578767695,0
1,1579,55090,3578767695,3578767695,0
1,1579,55091,3578767695,3578767695,0
1,1579,55092,3578767695,3578767695,0
1,1579,55093,3578767695,3578767695,0
1,1579,55094,3578767695,3578767695,0
1,1579,55095,3578767695,3578767695,0
1,1579,55096,3578767695,3578767695,0
1,1579,55097,3578767695,3578767695,0
1,1579,55098,3578767695,3578767695,0
1,1579,55099,3578767695,3578767695,0
1,1579,55100,3578767695,3578767695,0
1,1579,55101,3578767695,3578767696,1
1,1579,55102,3578767695,3578767697,2
1,1579,55103,3578767695,3578767697,2
1,1579,55104,3578767695,3578767698,3
1,1579,55105,3578767695,3578767698,3
1,1579,55106,3578767695,3578767698,3
1,1579,55107,3578767695,3578767699,4
1,1579,55108,3578767695,3578767700,5
1,1579,55109,3578767695,3578767702,7
1,1579,55110,3578767695,3578767702,7
1,1579,55111,3578767695,3578767702,7
1,1579,55112,3578767695,3578767703,8
1,1579,55113,3578767695,3578767703,8
1,1579,55114,3578767695,3578767703,8
1,1579,55115,3578767695,3578767704,9
1,1579,55116,3578767695,3578767705,10
1,1579,55117,3578767695,3578767705,10
1,1579,55118,3578767695,3578767707,12
1,1579,55119,3578767695,3578767707,12
1,1579,55120,3578767695,3578767708,13
1,1579,55121,3578767695,3578767708,13
1,1579,55122,3578767695,3578767709,14
1,1579,55123,3578767695,3578767710,15
1,1579,55124,3578767695,3578767711,16
1,1579,55125,3578767695,3578767712,17
1,1579,55126,3578767695,3578767712,17
1,1579,55127,3578767695,3578767712,17
1,1579,55128,3578767695,3578767713,18
1,1579,55129,3578767695,3578767713,18
1,1579,55130,3578767695,3578767713,18
1,1579,55131,3578767695,3578767714,19
1,1579,55132,3578767695,3578767715,20
1,1579,55133,3578767695,3578767718,23
1,1579,55134,3578767695,3578767719,24
1,1579,55135,3578767695,3578767720,25
1,1579,55136,3578767695,3578767720,25
1,1579,55137,3578767695,3578767720,25
1,1579,55138,3578767695,3578767720,25
1,1579,55139,3578767695,3578767721,26
1,1579,55140,3578767695,3578767721,26
1,1579,55141,3578767695,3578767721,26
1,1579,55142,3578767695,3578767722,27
1,1579,55143,3578767695,3578767723,28
1,1579,55144,3578767695,3578767724,29
1,1579,55145,3578767695,3578767724,29
1,1579,55146,3578767695,3578767725,30
1,1579,55147,3578767695,3578767725,30
1,1579,55148,3578767695,3578767726,31
1,1579,55149,3578767695,3578767727,32
1,1579,55150,3578767695,3578767728,33
1,1579,55151,3578767695,3578767728,33
1,1579,55152,3578767695,3578767729,34
1,1579,55153,3578767695,3578767730,35
1,1579,55154,3578767695,3578767730,35
1,1579,55155,3578767695,3578767730,35
1,1579,55156,3578767695,3578767731,36
1,1579,55157,3578767695,3578767731,36
1,1579,55158,3578767695,3578767731,36
1,1579,55159,3578767695,3578767732,37
1,1579,55160,3578767695,3578767733,38
1,1579,55161,3578767695,3578767734,39
1,1579,55162,3578767695,3578767735,40
1,1579,55163,3578767695,3578767735,40
1,1579,55164,3578767695,3578767736,41
1,1579,55165,3578767695,3578767736,41
1,1579,55166,3578767695,3578767737,42
1,1579,55167,3578767695,3578767740,45
1,1579,55168,3578767695,3578767740,45
1,1579,55169,3578767695,3578767740,45
1,1579,55170,3578767695,3578767745,50
1,1580,55171,3578767762,3578767762,0
1,1580,55172,3578767762,3578767762,0
1,1580,55173,3578767762,3578767762,0
1,1580,55174,3578767762,3578767762,0
1,1580,55175,3578767762,3578767762,0
1,1580,55176,3578767762,3578767762,0
1,1580,55177,3578767762,3578767762,0
1,1580,55178,3578767762,3578767762,0
1,1580,55179,3578767762,3578767762,0
1,1580,55180,3578767762,3578767762,0
1,1580,55181,3578767762,3578767762,0
1,1580,55182,3578767762,3578767762,0
1,1580,55183,3578767762,3578767762,0
1,1580,55184,3578767762,3578767762,0
1,1580,55185,3578767762,3578767763,1
1,1580,55186,3578767762,3578767764,2
1,1580,55187,3578767762,3578767765,3
1,1580,55188,3578767762,3578767765,3
1,1580,55189,3578767762,3578767765,3
1,1580,55190,3578767762,3578767767,5
1,1580,55191,3578767762,3578767767,5
1,1580,55192,3578767762,3578767767,5
1,1580,55193,3578767762,3578767768,6
1,1580,55194,3578767762,3578767769,7
1,1580,55195,3578767762,3578767772,10
1,1580,55196,3578767762,3578767773,11
1,1580,55197,3578767762,3578767775,13
1,1580,55198,3578767762,3578767776,14
1,1580,55199,3578767762,3578767777,15
1,1580,55200,3578767762,3578767777,15
1,1580,55201,3578767762,3578767778,16
1,1580,55202,3578767762,3578767779,17
1,1580,55203,3578767762,3578767779,17
1,1580,55204,3578767762,3578767780,18
1,1580,55205,3578767762,3578767781,19
1,1580,55206,3578767762,3578767781,19
1,1580,55207,3578767762,3578767782,20
1,1580,55208,3578767762,3578767782,20
1,1580,55209,3578767762,3578767784,22
1,1580,55210,3578767762,3578767786,24
1,1580,55211,3578767762,3578767789,27
1,1580,55212,3578767762,3578767791,29
1,1580,55213,3578767762,3578767791,29
1,1580,55214,3578767762,3578767792,30
1,1580,55215,3578767762,3578767793,31
1,1580,55216,3578767762,3578767793,31
1,1580,55217,3578767762,3578767795,33
1,1580,55218,3578767762,3578767795,33
1,1580,55219,3578767762,3578767796,34
1,1580,55220,3578767762,3578767797,35
1,1580,55221,3578767762,3578767797,35
1,1580,55222,3578767762,3578767799,37
1,1580,55223,3578767762,3578767799,37
1,1580,55224,3578767762,3578767800,38
1,1580,55225,3578767762,3578767801,39
1,1580,55226,3578767762,3578767803,41
1,1580,55227,3578767762,3578767803,41
1,1580,55228,3578767762,3578767806,44
1,1580,55229,3578767762,3578767810,48
1,1580,55230,3578767762,3578767810,48
1,1580,55231,3578767762,3578767811,49
1,1580,55232,3578767762,3578767812,50
1,1581,55233,3578767825,3578767826,1
1,1581,55234,3578767825,3578767826,1
1,1581,55235,3578767825,3578767826,1
1,1581,55236,3578767825,3578767826,1
1,1581,55237,3578767825,3578767826,1
1,1581,55238,3578767825,3578767826,1
1,1581,55239,3578767825,3578767826,1
1,1581,55240,3578767825,3578767826,1
1,1581,55241,3578767825,3578767826,1
1,1581,55242,3578767825,3578767826,1
1,1581,55243,3578767825,3578767826,1
1,1581,55244,3578767825,3578767826,1
1,1581,55245,3578767825,3578767826,1
1,1581,55246,3578767825,3578767826,1
1,1581,55247,3578767825,3578767826,1
1,1581,55248,3578767825,3578767826,1
1,1581,55249,3578767825,3578767826,1
1,1581,55250,3578767825,3578767826,1
1,1581,55251,3578767825,3578767826,1
1,1581,55252,3578767825,3578767826,1
1,1581,55253,3578767825,3578767826,1
1,1581,55254,3578767825,3578767826,1
1,1581,55255,3578767825,3578767826,1
1,1581,55256,3578767825,3578767826,1
1,1581,55257,3578767825,3578767828,3
1,1581,55258,3578767825,3578767828,3
1,1581,55259,3578767825,3578767830,5
1,1581,55260,3578767825,3578767831,6
1,1581,55261,3578767825,3578767831,6
1,1581,55262,3578767825,3578767832,7
1,1581,55263,3578767825,3578767833,8
1,1581,55264,3578767825,3578767834,9
1,1581,55265,3578767825,3578767835,10
1,1581,55266,3578767825,3578767837,12
1,1581,55267,3578767825,3578767837,12
1,1581,55268,3578767825,3578767837,12
1,1581,55269,3578767825,3578767837,12
1,1581,55270,3578767825,3578767839,14
1,1581,55271,3578767825,3578767841,16
1,1581,55272,3578767825,3578767846,21
1,1581,55273,3578767825,3578767847,22
1,1581,55274,3578767825,3578767849,24
1,1581,55275,3578767825,3578767851,26
1,1581,55276,3578767825,3578767852,27
1,1581,55277,3578767825,3578767852,27
1,1581,55278,3578767825,3578767853,28
1,1581,55279,3578767825,3578767856,31
1,1581,55280,3578767825,3578767856,31
1,1581,55281,3578767825,3578767856,31
1,1581,55282,3578767825,3578767857,32
1,1581,55283,3578767825,3578767857,32
1,1581,55284,3578767825,3578767859,34
1,1581,55285,3578767825,3578767860,35
1,1581,55286,3578767825,3578767861,36
1,1581,55287,3578767825,3578767862,37
1,1581,55288,3578767825,3578767862,37
1,1581,55289,3578767825,3578767865,40
1,1581,55290,3578767825,3578767867,42
1,1581,55291,3578767825,3578767867,42
1,1581,55292,3578767825,3578767868,43
1,1581,55293,3578767825,3578767869,44
1,1581,55294,3578767825,3578767869,44
1,1582,55295,3578767892,3578767892,0
1,1582,55296,3578767892,3578767892,0
1,1582,55297,3578767892,3578767892,0
1,1582,55298,3578767892,3578767892,0
1,1582,55299,3578767892,3578767892,0
1,1582,55300,3578767892,3578767892,0
1,1582,55301,3578767892,3578767892,0
1,1582,55302,3578767892,3578767892,0
1,1582,55303,3578767892,3578767892,0
1,1582,55304,3578767892,3578767892,0
1,1582,55305,3578767892,3578767892,0
1,1582,55306,3578767892,3578767893,1
1,1582,55307,3578767892,3578767893,1
1,1582,55308,3578767892,3578767894,2
1,1582,55309,3578767892,3578767894,2
1,1582,55310,3578767892,3578767896,4
1,1582,55311,3578767892,3578767896,4
1,1582,55312,3578767892,3578767896,4
1,1582,55313,3578767892,3578767897,5
1,1582,55314,3578767892,3578767897,5
1,1582,55315,3578767892,3578767898,6
1,1582,55316,3578767892,3578767898,6
1,1582,55317,3578767892,3578767898,6
1,1582,55318,3578767892,3578767899,7
1,1582,55319,3578767892,3578767899,7
1,1582,55320,3578767892,3578767900,8
1,1582,55321,3578767892,3578767902,10
1,1582,55322,3578767892,3578767902,10
1,1582,55323,3578767892,3578767902,10
1,1582,55324,3578767892,3578767902,10
1,1582,55325,3578767892,3578767903,11
1,1582,55326,3578767892,3578767904,12
1,1582,55327,3578767892,3578767904,12
1,1582,55328,3578767892,3578767906,14
1,1582,55329,3578767892,3578767907,15
1,1582,55330,3578767892,3578767907,15
1,1582,55331,3578767892,3578767907,15
1,1582,55332,3578767892,3578767908,16
1,1582,55333,3578767892,3578767909,17
1,1582,55334,3578767892,3578767910,18
1,1582,55335,3578767892,3578767910,18
1,1582,55336,3578767892,3578767911,19
1,1582,55337,3578767892,3578767912,20
1,1582,55338,3578767892,3578767912,20
1,1582,55339,3578767892,3578767912,20
1,1582,55340,3578767892,3578767914,22
1,1582,55341,3578767892,3578767914,22
1,1582,55342,3578767892,3578767915,23
1,1582,55343,3578767892,3578767915,23
1,1582,55344,3578767892,3578767919,27
1,1582,55345,3578767892,3578767919,27
1,1582,55346,3578767892,3578767920,28
1,1582,55347,3578767892,3578767920,28
1,1582,55348,3578767892,3578767920,28
1,1582,55349,3578767892,3578767920,28
1,1582,55350,3578767892,3578767921,29
1,1582,55351,3578767892,3578767921,29
1,1582,55352,3578767892,3578767921,29
1,1582,55353,3578767892,3578767922,30
1,1582,55354,3578767892,3578767923,31
1,1582,55355,3578767892,3578767924,32
1,1582,55356,3578767892,3578767924,32
1,1582,55357,3578767892,3578767926,34
1,1582,55358,3578767892,3578767926,34
1,1582,55359,3578767892,3578767926,34
1,1582,55360,3578767892,3578767928,36
1,1582,55361,3578767892,3578767928,36
1,1582,55362,3578767892,3578767929,37
1,1582,55363,3578767892,3578767930,38
1,1582,55364,3578767892,3578767930,38
1,1582,55365,3578767892,3578767930,38
1,1582,55366,3578767892,3578767931,39
1,1582,55367,3578767892,3578767932,40
1,1582,55368,3578767892,3578767932,40
1,1582,55369,3578767892,3578767933,41
1,1582,55370,3578767892,3578767933,41
1,1582,55371,3578767892,3578767934,42
1,1582,55372,3578767892,3578767935,43
1,1582,55373,3578767892,3578767935,43
1,1582,55374,3578767892,3578767935,43
1,1582,55375,3578767892,3578767935,43
1,1582,55376,3578767892,3578767936,44
1,1582,55377,3578767892,3578767937,45
1,1582,55378,3578767892,3578767939,47
1,1582,55379,3578767892,3578767940,48
1,1582,55380,3578767892,3578767941,49
1,1582,55381,3578767892,3578767942,50
1,1583,55382,3578767958,3578767958,0
1,1583,55383,3578767958,3578767958,0
1,1583,55384,3578767958,3578767958,0
1,1583,55385,3578767958,3578767958,0
1,1583,55386,3578767958,3578767958,0
1,1583,55387,3578767958,3578767958,0
1,1583,55388,3578767958,3578767958,0
1,1583,55389,3578767958,3578767958,0
1,1583,55390,3578767958,3578767958,0
1,1583,55391,3578767958,3578767962,4
1,1583,55392,3578767958,3578767963,5
1,1583,55393,3578767958,3578767963,5
1,1583,55394,3578767958,3578767964,6
1,1583,55395,3578767958,3578767965,7
1,1583,55396,3578767958,3578767965,7
1,1583,55397,3578767958,3578767965,7
1,1583,55398,3578767958,3578767966,8
1,1583,55399,3578767958,3578767966,8
1,1583,55400,3578767958,3578767967,9
1,1583,55401,3578767958,3578767967,9
1,1583,55402,3578767958,3578767968,10
1,1583,55403,3578767958,3578767969,11
1,1583,55404,3578767958,3578767969,11
1,1583,55405,3578767958,3578767972,14
1,1583,55406,3578767958,3578767972,14
1,1583,55407,3578767958,3578767973,15
1,1583,55408,3578767958,3578767975,17
1,1583,55409,3578767958,3578767976,18
1,1583,55410,3578767958,3578767977,19
1,1583,55411,3578767958,3578767978,20
1,1583,55412,3578767958,3578767978,20
1,1583,55413,3578767958,3578767979,21
1,1583,55414,3578767958,3578767979,21
1,1583,55415,3578767958,3578767981,23
1,1583,55416,3578767958,3578767981,23
1,1583,55417,3578767958,3578767981,23
1,1583,55418,3578767958,3578767982,24
1,1583,55419,3578767958,3578767982,24
1,1583,55420,3578767958,3578767984,26
1,1583,55421,3578767958,3578767986,28
1,1583,55422,3578767958,3578767989,31
1,1583,55423,3578767958,3578767992,34
1,1583,55424,3578767958,3578767992,34
1,1583,55425,3578767958,3578767992,34
1,1583,55426,3578767958,3578767993,35
1,1583,55427,3578767958,3578767994,36
1,1583,55428,3578767958,3578767994,36
1,1583,55429,3578767958,3578767995,37
1,1583,55430,3578767958,3578767996,38
1,1583,55431,3578767958,3578767997,39
1,1583,55432,3578767958,3578767997,39
1,1583,55433,3578767958,3578767997,39
1,1583,55434,3578767958,3578767999,41
1,1583,55435,3578767958,3578767999,41
1,1583,55436,3578767958,3578768000,42
1,1583,55437,3578767958,3578768000,42
1,1583,55438,3578767958,3578768001,43
1,1583,55439,3578767958,3578768001,43
1,1583,55440,3578767958,3578768002,44
1,1583,55441,3578767958,3578768003,45
1,1583,55442,3578767958,3578768006,48
1,1584,55443,3578768021,3578768021,0
1,1584,55444,3578768021,3578768021,0
1,1584,55445,3578768021,3578768021,0
1,1584,55446,3578768021,3578768021,0
1,1584,55447,3578768021,3578768021,0
1,1584,55448,3578768021,3578768021,0
1,1584,55449,3578768021,3578768021,0
1,1584,55450,3578768021,3578768021,0
1,1584,55451,3578768021,3578768021,0
1,1584,55452,3578768021,3578768021,0
1,1584,55453,3578768021,3578768021,0
1,1584,55454,3578768021,3578768021,0
1,1584,55455,3578768021,3578768021,0
1,1584,55456,3578768021,3578768021,0
1,1584,55457,3578768021,3578768021,0
1,1584,55458,3578768021,3578768021,0
1,1584,55459,3578768021,3578768021,0
1,1584,55460,3578768021,3578768021,0
1,1584,55461,3578768021,3578768021,0
1,1584,55462,3578768021,3578768021,0
1,1584,55463,3578768021,3578768021,0
1,1584,55464,3578768021,3578768023,2
1,1584,55465,3578768021,3578768023,2
1,1584,55466,3578768021,3578768026,5
1,1584,55467,3578768021,3578768026,5
1,1584,55468,3578768021,3578768026,5
1,1584,55469,3578768021,3578768026,5
1,1584,55470,3578768021,3578768028,7
1,1584,55471,3578768021,3578768029,8
1,1584,55472,3578768021,3578768029,8
1,1584,55473,3578768021,3578768031,10
1,1584,55474,3578768021,3578768031,10
1,1584,55475,3578768021,3578768032,11
1,1584,55476,3578768021,3578768033,12
1,1584,55477,3578768021,3578768035,14
1,1584,55478,3578768021,3578768036,15
1,1584,55479,3578768021,3578768036,15
1,1584,55480,3578768021,3578768037,16
1,1584,55481,3578768021,3578768037,16
1,1584,55482,3578768021,3578768038,17
1,1584,55483,3578768021,3578768039,18
1,1584,55484,3578768021,3578768041,20
1,1584,55485,3578768021,3578768046,25
1,1584,55486,3578768021,3578768047,26
1,1584,55487,3578768021,3578768049,28
1,1584,55488,3578768021,3578768050,29
1,1584,55489,3578768021,3578768051,30
1,1584,55490,3578768021,3578768052,31
1,1584,55491,3578768021,3578768056,35
1,1584,55492,3578768021,3578768056,35
1,1584,55493,3578768021,3578768057,36
1,1584,55494,3578768021,3578768057,36
1,1584,55495,3578768021,3578768057,36
1,1584,55496,3578768021,3578768060,39
1,1584,55497,3578768021,3578768060,39
1,1584,55498,3578768021,3578768062,41
1,1584,55499,3578768021,3578768063,42
1,1584,55500,3578768021,3578768065,44
1,1584,55501,3578768021,3578768066,45
1,1584,55502,3578768021,3578768068,47
1,1584,55503,3578768021,3578768069,48
1,1584,55504,3578768021,3578768069,48
1,1585,55505,3578768084,3578768084,0
1,1585,55506,3578768084,3578768084,0
1,1585,55507,3578768084,3578768084,0
1,1585,55508,3578768084,3578768085,1
1,1585,55509,3578768084,3578768085,1
1,1585,55510,3578768084,3578768085,1
1,1585,55511,3578768084,3578768087,3
1,1585,55512,3578768084,3578768088,4
1,1585,55513,3578768084,3578768089,5
1,1585,55514,3578768084,3578768091,7
1,1585,55515,3578768084,3578768093,9
1,1585,55516,3578768084,3578768093,9
1,1585,55517,3578768084,3578768093,9
1,1585,55518,3578768084,3578768093,9
1,1585,55519,3578768084,3578768094,10
1,1585,55520,3578768084,3578768095,11
1,1585,55521,3578768084,3578768095,11
1,1585,55522,3578768084,3578768096,12
1,1585,55523,3578768084,3578768097,13
1,1585,55524,3578768084,3578768097,13
1,1585,55525,3578768084,3578768098,14
1,1585,55526,3578768084,3578768098,14
1,1585,55527,3578768084,3578768099,15
1,1585,55528,3578768084,3578768100,16
1,1585,55529,3578768084,3578768101,17
1,1585,55530,3578768084,3578768101,17
1,1585,55531,3578768084,3578768102,18
1,1585,55532,3578768084,3578768102,18
1,1585,55533,3578768084,3578768102,18
1,1585,55534,3578768084,3578768102,18
1,1585,55535,3578768084,3578768102,18
1,1585,55536,3578768084,3578768102,18
1,1585,55537,3578768084,3578768103,19
1,1585,55538,3578768084,3578768103,19
1,1585,55539,3578768084,3578768104,20
1,1585,55540,3578768084,3578768106,22
1,1585,55541,3578768084,3578768107,23
1,1585,55542,3578768084,3578768107,23
1,1585,55543,3578768084,3578768108,24
1,1585,55544,3578768084,3578768108,24
1,1585,55545,3578768084,3578768109,25
1,1585,55546,3578768084,3578768110,26
1,1585,55547,3578768084,3578768110,26
1,1585,55548,3578768084,3578768112,28
1,1585,55549,3578768084,3578768112,28
1,1585,55550,3578768084,3578768113,29
1,1585,55551,3578768084,3578768113,29
1,1585,55552,3578768084,3578768114,30
1,1585,55553,3578768084,3578768114,30
1,1585,55554,3578768084,3578768115,31
1,1585,55555,3578768084,3578768119,35
1,1585,55556,3578768084,3578768120,36
1,1585,55557,3578768084,3578768120,36
1,1585,55558,3578768084,3578768120,36
1,1585,55559,3578768084,3578768121,37
1,1585,55560,3578768084,3578768121,37
1,1585,55561,3578768084,3578768121,37
1,1585,55562,3578768084,3578768121,37
1,1585,55563,3578768084,3578768122,38
1,1585,55564,3578768084,3578768123,39
1,1585,55565,3578768084,3578768124,40
1,1585,55566,3578768084,3578768125,41
1,1585,55567,3578768084,3578768125,41
1,1585,55568,3578768084,3578768127,43
1,1585,55569,3578768084,3578768127,43
1,1585,55570,3578768084,3578768128,44
1,1585,55571,3578768084,3578768129,45
1,1585,55572,3578768084,3578768130,46
1,1585,55573,3578768084,3578768130,46
1,1585,55574,3578768084,3578768130,46
1,1585,55575,3578768084,3578768131,47
1,1585,55576,3578768084,3578768131,47
1,1585,55577,3578768084,3578768132,48
1,1585,55578,3578768084,3578768134,50
1,1586,55579,3578768149,3578768149,0
1,1586,55580,3578768149,3578768149,0
1,1586,55581,3578768149,3578768149,0
1,1586,55582,3578768149,3578768149,0
1,1586,55583,3578768149,3578768149,0
1,1586,55584,3578768149,3578768149,0
1,1586,55585,3578768149,3578768149,0
1,1586,55586,3578768149,3578768149,0
1,1586,55587,3578768149,3578768149,0
1,1586,55588,3578768149,3578768149,0
1,1586,55589,3578768149,3578768149,0
1,1586,55590,3578768149,3578768149,0
1,1586,55591,3578768149,3578768149,0
1,1586,55592,3578768149,3578768150,1
1,1586,55593,3578768149,3578768150,1
1,1586,55594,3578768149,3578768152,3
1,1586,55595,3578768149,3578768153,4
1,1586,55596,3578768149,3578768154,5
1,1586,55597,3578768149,3578768155,6
1,1586,55598,3578768149,3578768156,7
1,1586,55599,3578768149,3578768161,12
1,1586,55600,3578768149,3578768163,14
1,1586,55601,3578768149,3578768163,14
1,1586,55602,3578768149,3578768163,14
1,1586,55603,3578768149,3578768164,15
1,1586,55604,3578768149,3578768165,16
1,1586,55605,3578768149,3578768165,16
1,1586,55606,3578768149,3578768165,16
1,1586,55607,3578768149,3578768167,18
1,1586,55608,3578768149,3578768167,18
1,1586,55609,3578768149,3578768167,18
1,1586,55610,3578768149,3578768168,19
1,1586,55611,3578768149,3578768169,20
1,1586,55612,3578768149,3578768169,20
1,1586,55613,3578768149,3578768169,20
1,1586,55614,3578768149,3578768172,23
1,1586,55615,3578768149,3578768172,23
1,1586,55616,3578768149,3578768173,24
1,1586,55617,3578768149,3578768175,26
1,1586,55618,3578768149,3578768176,27
1,1586,55619,3578768149,3578768177,28
1,1586,55620,3578768149,3578768178,29
1,1586,55621,3578768149,3578768180,31
1,1586,55622,3578768149,3578768180,31
1,1586,55623,3578768149,3578768181,32
1,1586,55624,3578768149,3578768181,32
1,1586,55625,3578768149,3578768182,33
1,1586,55626,3578768149,3578768184,35
1,1586,55627,3578768149,3578768185,36
1,1586,55628,3578768149,3578768186,37
1,1586,55629,3578768149,3578768188,39
1,1586,55630,3578768149,3578768191,42
1,1586,55631,3578768149,3578768192,43
1,1586,55632,3578768149,3578768192,43
1,1586,55633,3578768149,3578768192,43
1,1586,55634,3578768149,3578768193,44
1,1586,55635,3578768149,3578768194,45
1,1586,55636,3578768149,3578768195,46
1,1586,55637,3578768149,3578768196,47
1,1586,55638,3578768149,3578768196,47
1,1586,55639,3578768149,3578768197,48
1,1586,55640,3578768149,3578768198,49
1,1587,55641,3578768215,3578768215,0
1,1587,55642,3578768215,3578768215,0
1,1587,55643,3578768215,3578768215,0
1,1587,55644,3578768215,3578768215,0
1,1587,55645,3578768215,3578768215,0
1,1587,55646,3578768215,3578768215,0
1,1587,55647,3578768215,3578768215,0
1,1587,55648,3578768215,3578768215,0
1,1587,55649,3578768215,3578768215,0
1,1587,55650,3578768215,3578768215,0
1,1587,55651,3578768215,3578768215,0
1,1587,55652,3578768215,3578768215,0
1,1587,55653,3578768215,3578768215,0
1,1587,55654,3578768215,3578768215,0
1,1587,55655,3578768215,3578768215,0
1,1587,55656,3578768215,3578768215,0
1,1587,55657,3578768215,3578768215,0
1,1587,55658,3578768215,3578768215,0
1,1587,55659,3578768215,3578768216,1
1,1587,55660,3578768215,3578768217,2
1,1587,55661,3578768215,3578768217,2
1,1587,55662,3578768215,3578768217,2
1,1587,55663,3578768215,3578768218,3
1,1587,55664,3578768215,3578768218,3
1,1587,55665,3578768215,3578768219,4
1,1587,55666,3578768215,3578768219,4
1,1587,55667,3578768215,3578768219,4
1,1587,55668,3578768215,3578768222,7
1,1587,55669,3578768215,3578768223,8
1,1587,55670,3578768215,3578768223,8
1,1587,55671,3578768215,3578768225,10
1,1587,55672,3578768215,3578768226,11
1,1587,55673,3578768215,3578768226,11
1,1587,55674,3578768215,3578768226,11
1,1587,55675,3578768215,3578768226,11
1,1587,55676,3578768215,3578768228,13
1,1587,55677,3578768215,3578768228,13
1,1587,55678,3578768215,3578768229,14
1,1587,55679,3578768215,3578768230,15
1,1587,55680,3578768215,3578768231,16
1,1587,55681,3578768215,3578768232,17
1,1587,55682,3578768215,3578768232,17
1,1587,55683,3578768215,3578768233,18
1,1587,55684,3578768215,3578768235,20
1,1587,55685,3578768215,3578768235,20
1,1587,55686,3578768215,3578768236,21
1,1587,55687,3578768215,3578768237,22
1,1587,55688,3578768215,3578768238,23
1,1587,55689,3578768215,3578768238,23
1,1587,55690,3578768215,3578768240,25
1,1587,55691,3578768215,3578768241,26
1,1587,55692,3578768215,3578768244,29
1,1587,55693,3578768215,3578768246,31
1,1587,55694,3578768215,3578768248,33
1,1587,55695,3578768215,3578768250,35
1,1587,55696,3578768215,3578768250,35
1,1587,55697,3578768215,3578768252,37
1,1587,55698,3578768215,3578768253,38
1,1587,55699,3578768215,3578768254,39
1,1587,55700,3578768215,3578768255,40
1,1587,55701,3578768215,3578768256,41
1,1587,55702,3578768215,3578768257,42
1,1587,55703,3578768215,3578768257,42
1,1587,55704,3578768215,3578768258,43
1,1587,55705,3578768215,3578768260,45
1,1587,55706,3578768215,3578768260,45
1,1587,55707,3578768215,3578768261,46
1,1587,55708,3578768215,3578768263,48
1,1587,55709,3578768215,3578768263,48
1,1587,55710,3578768215,3578768263,48
1,1587,55711,3578768215,3578768264,49
1,1588,55712,3578768280,3578768280,0
1,1588,55713,3578768280,3578768280,0
1,1588,55714,3578768280,3578768280,0
1,1588,55715,3578768280,3578768282,2
1,1588,55716,3578768280,3578768282,2
1,1588,55717,3578768280,3578768283,3
1,1588,55718,3578768280,3578768284,4
1,1588,55719,3578768280,3578768285,5
1,1588,55720,3578768280,3578768285,5
1,1588,55721,3578768280,3578768287,7
1,1588,55722,3578768280,3578768288,8
1,1588,55723,3578768280,3578768288,8
1,1588,55724,3578768280,3578768289,9
1,1588,55725,3578768280,3578768291,11
1,1588,55726,3578768280,3578768293,13
1,1588,55727,3578768280,3578768293,13
1,1588,55728,3578768280,3578768294,14
1,1588,55729,3578768280,3578768294,14
1,1588,55730,3578768280,3578768294,14
1,1588,55731,3578768280,3578768295,15
1,1588,55732,3578768280,3578768296,16
1,1588,55733,3578768280,3578768296,16
1,1588,55734,3578768280,3578768297,17
1,1588,55735,3578768280,3578768298,18
1,1588,55736,3578768280,3578768298,18
1,1588,55737,3578768280,3578768299,19
1,1588,55738,3578768280,3578768300,20
1,1588,55739,3578768280,3578768301,21
1,1588,55740,3578768280,3578768301,21
1,1588,55741,3578768280,3578768302,22
1,1588,55742,3578768280,3578768302,22
1,1588,55743,3578768280,3578768302,22
1,1588,55744,3578768280,3578768302,22
1,1588,55745,3578768280,3578768303,23
1,1588,55746,3578768280,3578768303,23
1,1588,55747,3578768280,3578768304,24
1,1588,55748,3578768280,3578768304,24
1,1588,55749,3578768280,3578768305,25
1,1588,55750,3578768280,3578768307,27
1,1588,55751,3578768280,3578768307,27
1,1588,55752,3578768280,3578768307,27
1,1588,55753,3578768280,3578768309,29
1,1588,55754,3578768280,3578768309,29
1,1588,55755,3578768280,3578768310,30
1,1588,55756,3578768280,3578768312,32
1,1588,55757,3578768280,3578768313,33
1,1588,55758,3578768280,3578768313,33
1,1588,55759,3578768280,3578768313,33
1,1588,55760,3578768280,3578768313,33
1,1588,55761,3578768280,3578768314,34
1,1588,55762,3578768280,3578768314,34
1,1588,55763,3578768280,3578768319,39
1,1588,55764,3578768280,3578768320,40
1,1588,55765,3578768280,3578768320,40
1,1588,55766,3578768280,3578768320,40
1,1588,55767,3578768280,3578768321,41
1,1588,55768,3578768280,3578768321,41
1,1588,55769,3578768280,3578768322,42
1,1588,55770,3578768280,3578768322,42
1,1588,55771,3578768280,3578768322,42
1,1588,55772,3578768280,3578768323,43
1,1588,55773,3578768280,3578768324,44
1,1588,55774,3578768280,3578768325,45
1,1588,55775,3578768280,3578768326,46
1,1588,55776,3578768280,3578768327,47
1,1588,55777,3578768280,3578768327,47
1,1588,55778,3578768280,3578768329,49
1,1588,55779,3578768280,3578768329,49
1,1589,55780,3578768347,3578768347,0
1,1589,55781,3578768347,3578768347,0
1,1589,55782,3578768347,3578768347,0
1,1589,55783,3578768347,3578768347,0
1,1589,55784,3578768347,3578768347,0
1,1589,55785,3578768347,3578768347,0
1,1589,55786,3578768347,3578768347,0
1,1589,55787,3578768347,3578768347,0
1,1589,55788,3578768347,3578768347,0
1,1589,55789,3578768347,3578768347,0
1,1589,55790,3578768347,3578768347,0
1,1589,55791,3578768347,3578768347,0
1,1589,55792,3578768347,3578768347,0
1,1589,55793,3578768347,3578768347,0
1,1589,55794,3578768347,3578768347,0
1,1589,55795,3578768347,3578768347,0
1,1589,55796,3578768347,3578768348,1
1,1589,55797,3578768347,3578768348,1
1,1589,55798,3578768347,3578768350,3
1,1589,55799,3578768347,3578768351,4
1,1589,55800,3578768347,3578768355,8
1,1589,55801,3578768347,3578768356,9
1,1589,55802,3578768347,3578768356,9
1,1589,55803,3578768347,3578768362,15
1,1589,55804,3578768347,3578768363,16
1,1589,55805,3578768347,3578768363,16
1,1589,55806,3578768347,3578768365,18
1,1589,55807,3578768347,3578768365,18
1,1589,55808,3578768347,3578768365,18
1,1589,55809,3578768347,3578768366,19
1,1589,55810,3578768347,3578768367,20
1,1589,55811,3578768347,3578768367,20
1,1589,55812,3578768347,3578768367,20
1,1589,55813,3578768347,3578768368,21
1,1589,55814,3578768347,3578768369,22
1,1589,55815,3578768347,3578768369,22
1,1589,55816,3578768347,3578768370,23
1,1589,55817,3578768347,3578768370,23
1,1589,55818,3578768347,3578768372,25
1,1589,55819,3578768347,3578768372,25
1,1589,55820,3578768347,3578768372,25
1,1589,55821,3578768347,3578768375,28
1,1589,55822,3578768347,3578768376,29
1,1589,55823,3578768347,3578768376,29
1,1589,55824,3578768347,3578768376,29
1,1589,55825,3578768347,3578768378,31
1,1589,55826,3578768347,3578768380,33
1,1589,55827,3578768347,3578768380,33
1,1589,55828,3578768347,3578768381,34
1,1589,55829,3578768347,3578768381,34
1,1589,55830,3578768347,3578768382,35
1,1589,55831,3578768347,3578768382,35
1,1589,55832,3578768347,3578768382,35
1,1589,55833,3578768347,3578768384,37
1,1589,55834,3578768347,3578768385,38
1,1589,55835,3578768347,3578768387,40
1,1589,55836,3578768347,3578768390,43
1,1589,55837,3578768347,3578768391,44
1,1589,55838,3578768347,3578768392,45
1,1589,55839,3578768347,3578768393,46
1,1589,55840,3578768347,3578768394,47
1,1589,55841,3578768347,3578768394,47
1,1589,55842,3578768347,3578768396,49
1,1590,55843,3578768412,3578768412,0
1,1590,55844,3578768412,3578768412,0
1,1590,55845,3578768412,3578768412,0
1,1590,55846,3578768412,3578768412,0
1,1590,55847,3578768412,3578768412,0
1,1590,55848,3578768412,3578768412,0
1,1590,55849,3578768412,3578768412,0
1,1590,55850,3578768412,3578768412,0
1,1590,55851,3578768412,3578768412,0
1,1590,55852,3578768412,3578768412,0
1,1590,55853,3578768412,3578768412,0
1,1590,55854,3578768412,3578768412,0
1,1590,55855,3578768412,3578768412,0
1,1590,55856,3578768412,3578768412,0
1,1590,55857,3578768412,3578768412,0
1,1590,55858,3578768412,3578768412,0
1,1590,55859,3578768412,3578768413,1
1,1590,55860,3578768412,3578768413,1
1,1590,55861,3578768412,3578768413,1
1,1590,55862,3578768412,3578768415,3
1,1590,55863,3578768412,3578768415,3
1,1590,55864,3578768412,3578768417,5
1,1590,55865,3578768412,3578768417,5
1,1590,55866,3578768412,3578768417,5
1,1590,55867,3578768412,3578768417,5
1,1590,55868,3578768412,3578768418,6
1,1590,55869,3578768412,3578768418,6
1,1590,55870,3578768412,3578768419,7
1,1590,55871,3578768412,3578768419,7
1,1590,55872,3578768412,3578768419,7
1,1590,55873,3578768412,3578768422,10
1,1590,55874,3578768412,3578768423,11
1,1590,55875,3578768412,3578768423,11
1,1590,55876,3578768412,3578768425,13
1,1590,55877,3578768412,3578768425,13
1,1590,55878,3578768412,3578768426,14
1,1590,55879,3578768412,3578768426,14
1,1590,55880,3578768412,3578768427,15
1,1590,55881,3578768412,3578768427,15
1,1590,55882,3578768412,3578768429,17
1,1590,55883,3578768412,3578768429,17
1,1590,55884,3578768412,3578768429,17
1,1590,55885,3578768412,3578768431,19
1,1590,55886,3578768412,3578768432,20
1,1590,55887,3578768412,3578768432,20
1,1590,55888,3578768412,3578768432,20
1,1590,55889,3578768412,3578768433,21
1,1590,55890,3578768412,3578768435,23
1,1590,55891,3578768412,3578768435,23
1,1590,55892,3578768412,3578768436,24
1,1590,55893,3578768412,3578768438,26
1,1590,55894,3578768412,3578768438,26
1,1590,55895,3578768412,3578768439,27
1,1590,55896,3578768412,3578768440,28
1,1590,55897,3578768412,3578768442,30
1,1590,55898,3578768412,3578768445,33
1,1590,55899,3578768412,3578768446,34
1,1590,55900,3578768412,3578768449,37
1,1590,55901,3578768412,3578768450,38
1,1590,55902,3578768412,3578768451,39
1,1590,55903,3578768412,3578768453,41
1,1590,55904,3578768412,3578768455,43
1,1590,55905,3578768412,3578768455,43
1,1590,55906,3578768412,3578768456,44
1,1590,55907,3578768412,3578768457,45
1,1590,55908,3578768412,3578768457,45
1,1590,55909,3578768412,3578768458,46
1,1590,55910,3578768412,3578768458,46
1,1590,55911,3578768412,3578768459,47
1,1590,55912,3578768412,3578768461,49
1,1590,55913,3578768412,3578768461,49
1,1590,55914,3578768412,3578768462,50
1,1591,55915,3578768477,3578768477,0
1,1591,55916,3578768477,3578768477,0
1,1591,55917,3578768477,3578768477,0
1,1591,55918,3578768477,3578768477,0
1,1591,55919,3578768477,3578768477,0
1,1591,55920,3578768477,3578768477,0
1,1591,55921,3578768477,3578768482,5
1,1591,55922,3578768477,3578768482,5
1,1591,55923,3578768477,3578768484,7
1,1591,55924,3578768477,3578768485,8
1,1591,55925,3578768477,3578768485,8
1,1591,55926,3578768477,3578768485,8
1,1591,55927,3578768477,3578768487,10
1,1591,55928,3578768477,3578768488,11
1,1591,55929,3578768477,3578768488,11
1,1591,55930,3578768477,3578768489,12
1,1591,55931,3578768477,3578768491,14
1,1591,55932,3578768477,3578768492,15
1,1591,55933,3578768477,3578768493,16
1,1591,55934,3578768477,3578768494,17
1,1591,55935,3578768477,3578768494,17
1,1591,55936,3578768477,3578768494,17
1,1591,55937,3578768477,3578768494,17
1,1591,55938,3578768477,3578768495,18
1,1591,55939,3578768477,3578768495,18
1,1591,55940,3578768477,3578768497,20
1,1591,55941,3578768477,3578768497,20
1,1591,55942,3578768477,3578768497,20
1,1591,55943,3578768477,3578768498,21
1,1591,55944,3578768477,3578768498,21
1,1591,55945,3578768477,3578768499,22
1,1591,55946,3578768477,3578768499,22
1,1591,55947,3578768477,3578768500,23
1,1591,55948,3578768477,3578768501,24
1,1591,55949,3578768477,3578768502,25
1,1591,55950,3578768477,3578768502,25
1,1591,55951,3578768477,3578768502,25
1,1591,55952,3578768477,3578768502,25
1,1591,55953,3578768477,3578768502,25
1,1591,55954,3578768477,3578768503,26
1,1591,55955,3578768477,3578768504,27
1,1591,55956,3578768477,3578768504,27
1,1591,55957,3578768477,3578768506,29
1,1591,55958,3578768477,3578768507,30
1,1591,55959,3578768477,3578768507,30
1,1591,55960,3578768477,3578768507,30
1,1591,55961,3578768477,3578768508,31
1,1591,55962,3578768477,3578768508,31
1,1591,55963,3578768477,3578768509,32
1,1591,55964,3578768477,3578768510,33
1,1591,55965,3578768477,3578768512,35
1,1591,55966,3578768477,3578768513,36
1,1591,55967,3578768477,3578768513,36
1,1591,55968,3578768477,3578768513,36
1,1591,55969,3578768477,3578768513,36
1,1591,55970,3578768477,3578768513,36
1,1591,55971,3578768477,3578768513,36
1,1591,55972,3578768477,3578768515,38
1,1591,55973,3578768477,3578768518,41
1,1591,55974,3578768477,3578768519,42
1,1591,55975,3578768477,3578768520,43
1,1591,55976,3578768477,3578768520,43
1,1591,55977,3578768477,3578768520,43
1,1591,55978,3578768477,3578768521,44
1,1591,55979,3578768477,3578768521,44
1,1591,55980,3578768477,3578768521,44
1,1591,55981,3578768477,3578768521,44
1,1591,55982,3578768477,3578768522,45
1,1591,55983,3578768477,3578768523,46
1,1591,55984,3578768477,3578768523,46
1,1591,55985,3578768477,3578768526,49
1,1591,55986,3578768477,3578768526,49
1,1591,55987,3578768477,3578768526,49
1,1592,55988,3578768542,3578768542,0
1,1592,55989,3578768542,3578768542,0
1,1592,55990,3578768542,3578768542,0
1,1592,55991,3578768542,3578768542,0
1,1592,55992,3578768542,3578768542,0
1,1592,55993,3578768542,3578768542,0
1,1592,55994,3578768542,3578768542,0
1,1592,55995,3578768542,3578768542,0
1,1592,55996,3578768542,3578768542,0
1,1592,55997,3578768542,3578768542,0
1,1592,55998,3578768542,3578768542,0
1,1592,55999,3578768542,3578768542,0
1,1592,56000,3578768542,3578768542,0
1,1592,56001,3578768542,3578768542,0
1,1592,56002,3578768542,3578768542,0
1,1592,56003,3578768542,3578768542,0
1,1592,56004,3578768542,3578768542,0
1,1592,56005,3578768542,3578768542,0
1,1592,56006,3578768542,3578768542,0
1,1592,56007,3578768542,3578768542,0
1,1592,56008,3578768542,3578768545,3
1,1592,56009,3578768542,3578768545,3
1,1592,56010,3578768542,3578768547,5
1,1592,56011,3578768542,3578768547,5
1,1592,56012,3578768542,3578768549,7
1,1592,56013,3578768542,3578768549,7
1,1592,56014,3578768542,3578768553,11
1,1592,56015,3578768542,3578768555,13
1,1592,56016,3578768542,3578768556,14
1,1592,56017,3578768542,3578768556,14
1,1592,56018,3578768542,3578768559,17
1,1592,56019,3578768542,3578768560,18
1,1592,56020,3578768542,3578768562,20
1,1592,56021,3578768542,3578768563,21
1,1592,56022,3578768542,3578768564,22
1,1592,56023,3578768542,3578768564,22
1,1592,56024,3578768542,3578768565,23
1,1592,56025,3578768542,3578768566,24
1,1592,56026,3578768542,3578768566,24
1,1592,56027,3578768542,3578768567,25
1,1592,56028,3578768542,3578768567,25
1,1592,56029,3578768542,3578768568,26
1,1592,56030,3578768542,3578768569,27
1,1592,56031,3578768542,3578768571,29
1,1592,56032,3578768542,3578768572,30
1,1592,56033,3578768542,3578768572,30
1,1592,56034,3578768542,3578768575,33
1,1592,56035,3578768542,3578768576,34
1,1592,56036,3578768542,3578768577,35
1,1592,56037,3578768542,3578768579,37
1,1592,56038,3578768542,3578768579,37
1,1592,56039,3578768542,3578768580,38
1,1592,56040,3578768542,3578768580,38
1,1592,56041,3578768542,3578768580,38
1,1592,56042,3578768542,3578768581,39
1,1592,56043,3578768542,3578768581,39
1,1592,56044,3578768542,3578768583,41
1,1592,56045,3578768542,3578768584,42
1,1592,56046,3578768542,3578768585,43
1,1592,56047,3578768542,3578768591,49
1,1592,56048,3578768542,3578768592,50
1,1593,56049,3578768606,3578768606,0
1,1593,56050,3578768606,3578768606,0
1,1593,56051,3578768606,3578768606,0
1,1593,56052,3578768606,3578768606,0
1,1593,56053,3578768606,3578768606,0
1,1593,56054,3578768606,3578768606,0
1,1593,56055,3578768606,3578768606,0
1,1593,56056,3578768606,3578768606,0
1,1593,56057,3578768606,3578768606,0
1,1593,56058,3578768606,3578768606,0
1,1593,56059,3578768606,3578768606,0
1,1593,56060,3578768606,3578768606,0
1,1593,56061,3578768606,3578768606,0
1,1593,56062,3578768606,3578768610,4
1,1593,56063,3578768606,3578768610,4
1,1593,56064,3578768606,3578768610,4
1,1593,56065,3578768606,3578768611,5
1,1593,56066,3578768606,3578768611,5
1,1593,56067,3578768606,3578768612,6
1,1593,56068,3578768606,3578768612,6
1,1593,56069,3578768606,3578768612,6
1,1593,56070,3578768606,3578768614,8
1,1593,56071,3578768606,3578768614,8
1,1593,56072,3578768606,3578768614,8
1,1593,56073,3578768606,3578768615,9
1,1593,56074,3578768606,3578768615,9
1,1593,56075,3578768606,3578768616,10
1,1593,56076,3578768606,3578768616,10
1,1593,56077,3578768606,3578768616,10
1,1593,56078,3578768606,3578768617,11
1,1593,56079,3578768606,3578768617,11
1,1593,56080,3578768606,3578768618,12
1,1593,56081,3578768606,3578768618,12
1,1593,56082,3578768606,3578768619,13
1,1593,56083,3578768606,3578768621,15
1,1593,56084,3578768606,3578768622,16
1,1593,56085,3578768606,3578768623,17
1,1593,56086,3578768606,3578768623,17
1,1593,56087,3578768606,3578768625,19
1,1593,56088,3578768606,3578768625,19
1,1593,56089,3578768606,3578768625,19
1,1593,56090,3578768606,3578768626,20
1,1593,56091,3578768606,3578768627,21
1,1593,56092,3578768606,3578768628,22
1,1593,56093,3578768606,3578768628,22
1,1593,56094,3578768606,3578768628,22
1,1593,56095,3578768606,3578768631,25
1,1593,56096,3578768606,3578768631,25
1,1593,56097,3578768606,3578768631,25
1,1593,56098,3578768606,3578768633,27
1,1593,56099,3578768606,3578768634,28
1,1593,56100,3578768606,3578768634,28
1,1593,56101,3578768606,3578768634,28
1,1593,56102,3578768606,3578768636,30
1,1593,56103,3578768606,3578768637,31
1,1593,56104,3578768606,3578768637,31
1,1593,56105,3578768606,3578768639,33
1,1593,56106,3578768606,3578768640,34
1,1593,56107,3578768606,3578768644,38
1,1593,56108,3578768606,3578768646,40
1,1593,56109,3578768606,3578768648,42
1,1593,56110,3578768606,3578768649,43
1,1593,56111,3578768606,3578768650,44
1,1593,56112,3578768606,3578768652,46
1,1593,56113,3578768606,3578768652,46
1,1593,56114,3578768606,3578768654,48
1,1593,56115,3578768606,3578768654,48
1,1593,56116,3578768606,3578768655,49
1,1594,56117,3578768671,3578768671,0
1,1594,56118,3578768671,3578768671,0
1,1594,56119,3578768671,3578768671,0
1,1594,56120,3578768671,3578768671,0
1,1594,56121,3578768671,3578768671,0
1,1594,56122,3578768671,3578768671,0
1,1594,56123,3578768671,3578768671,0
1,1594,56124,3578768671,3578768671,0
1,1594,56125,3578768671,3578768671,0
1,1594,56126,3578768671,3578768671,0
1,1594,56127,3578768671,3578768671,0
1,1594,56128,3578768671,3578768671,0
1,1594,56129,3578768671,3578768682,11
1,1594,56130,3578768671,3578768682,11
1,1594,56131,3578768671,3578768684,13
1,1594,56132,3578768671,3578768685,14
1,1594,56133,3578768671,3578768685,14
1,1594,56134,3578768671,3578768686,15
1,1594,56135,3578768671,3578768687,16
1,1594,56136,3578768671,3578768687,16
1,1594,56137,3578768671,3578768688,17
1,1594,56138,3578768671,3578768690,19
1,1594,56139,3578768671,3578768690,19
1,1594,56140,3578768671,3578768693,22
1,1594,56141,3578768671,3578768693,22
1,1594,56142,3578768671,3578768693,22
1,1594,56143,3578768671,3578768694,23
1,1594,56144,3578768671,3578768694,23
1,1594,56145,3578768671,3578768695,24
1,1594,56146,3578768671,3578768695,24
1,1594,56147,3578768671,3578768696,25
1,1594,56148,3578768671,3578768696,25
1,1594,56149,3578768671,3578768696,25
1,1594,56150,3578768671,3578768697,26
1,1594,56151,3578768671,3578768698,27
1,1594,56152,3578768671,3578768698,27
1,1594,56153,3578768671,3578768698,27
1,1594,56154,3578768671,3578768698,27
1,1594,56155,3578768671,3578768700,29
1,1594,56156,3578768671,3578768700,29
1,1594,56157,3578768671,3578768702,31
1,1594,56158,3578768671,3578768702,31
1,1594,56159,3578768671,3578768702,31
1,1594,56160,3578768671,3578768702,31
1,1594,56161,3578768671,3578768702,31
1,1594,56162,3578768671,3578768703,32
1,1594,56163,3578768671,3578768704,33
1,1594,56164,3578768671,3578768705,34
1,1594,56165,3578768671,3578768705,34
1,1594,56166,3578768671,3578768705,34
1,1594,56167,3578768671,3578768707,36
1,1594,56168,3578768671,3578768707,36
1,1594,56169,3578768671,3578768707,36
1,1594,56170,3578768671,3578768708,37
1,1594,56171,3578768671,3578768709,38
1,1594,56172,3578768671,3578768709,38
1,1594,56173,3578768671,3578768710,39
1,1594,56174,3578768671,3578768712,41
1,1594,56175,3578768671,3578768712,41
1,1594,56176,3578768671,3578768713,42
1,1594,56177,3578768671,3578768713,42
1,1594,56178,3578768671,3578768713,42
1,1594,56179,3578768671,3578768713,42
1,1594,56180,3578768671,3578768714,43
1,1594,56181,3578768671,3578768714,43
1,1594,56182,3578768671,3578768719,48
1,1594,56183,3578768671,3578768720,49
1,1594,56184,3578768671,3578768720,49
1,1594,56185,3578768671,3578768720,49
1,1594,56186,3578768671,3578768720,49
1,1594,56187,3578768671,3578768721,50
1,1594,56188,3578768671,3578768721,50
1,1595,56189,3578768736,3578768736,0
1,1595,56190,3578768736,3578768736,0
1,1595,56191,3578768736,3578768736,0
1,1595,56192,3578768736,3578768736,0
1,1595,56193,3578768736,3578768736,0
1,1595,56194,3578768736,3578768736,0
1,1595,56195,3578768736,3578768736,0
1,1595,56196,3578768736,3578768736,0
1,1595,56197,3578768736,3578768736,0
1,1595,56198,3578768736,3578768736,0
1,1595,56199,3578768736,3578768736,0
1,1595,56200,3578768736,3578768736,0
1,1595,56201,3578768736,3578768736,0
1,1595,56202,3578768736,3578768736,0
1,1595,56203,3578768736,3578768736,0
1,1595,56204,3578768736,3578768736,0
1,1595,56205,3578768736,3578768736,0
1,1595,56206,3578768736,3578768736,0
1,1595,56207,3578768736,3578768736,0
1,1595,56208,3578768736,3578768736,0
1,1595,56209,3578768736,3578768736,0
1,1595,56210,3578768736,3578768736,0
1,1595,56211,3578768736,3578768736,0
1,1595,56212,3578768736,3578768737,1
1,1595,56213,3578768736,3578768737,1
1,1595,56214,3578768736,3578768737,1
1,1595,56215,3578768736,3578768737,1
1,1595,56216,3578768736,3578768740,4
1,1595,56217,3578768736,3578768740,4
1,1595,56218,3578768736,3578768742,6
1,1595,56219,3578768736,3578768745,9
1,1595,56220,3578768736,3578768745,9
1,1595,56221,3578768736,3578768748,12
1,1595,56222,3578768736,3578768748,12
1,1595,56223,3578768736,3578768749,13
1,1595,56224,3578768736,3578768749,13
1,1595,56225,3578768736,3578768752,16
1,1595,56226,3578768736,3578768755,19
1,1595,56227,3578768736,3578768755,19
1,1595,56228,3578768736,3578768756,20
1,1595,56229,3578768736,3578768756,20
1,1595,56230,3578768736,3578768759,23
1,1595,56231,3578768736,3578768761,25
1,1595,56232,3578768736,3578768762,26
1,1595,56233,3578768736,3578768763,27
1,1595,56234,3578768736,3578768764,28
1,1595,56235,3578768736,3578768764,28
1,1595,56236,3578768736,3578768765,29
1,1595,56237,3578768736,3578768765,29
1,1595,56238,3578768736,3578768767,31
1,1595,56239,3578768736,3578768767,31
1,1595,56240,3578768736,3578768767,31
1,1595,56241,3578768736,3578768768,32
1,1595,56242,3578768736,3578768768,32
1,1595,56243,3578768736,3578768769,33
1,1595,56244,3578768736,3578768772,36
1,1595,56245,3578768736,3578768772,36
1,1595,56246,3578768736,3578768775,39
1,1595,56247,3578768736,3578768776,40
1,1595,56248,3578768736,3578768776,40
1,1595,56249,3578768736,3578768778,42
1,1595,56250,3578768736,3578768778,42
1,1595,56251,3578768736,3578768779,43
1,1595,56252,3578768736,3578768779,43
1,1595,56253,3578768736,3578768781,45
1,1595,56254,3578768736,3578768781,45
1,1595,56255,3578768736,3578768781,45
1,1595,56256,3578768736,3578768781,45
1,1595,56257,3578768736,3578768782,46
1,1595,56258,3578768736,3578768783,47
1,1595,56259,3578768736,3578768784,48
1,1595,56260,3578768736,3578768786,50
1,1596,56261,3578768801,3578768801,0
1,1596,56262,3578768801,3578768801,0
1,1596,56263,3578768801,3578768801,0
1,1596,56264,3578768801,3578768801,0
1,1596,56265,3578768801,3578768801,0
1,1596,56266,3578768801,3578768801,0
1,1596,56267,3578768801,3578768801,0
1,1596,56268,3578768801,3578768801,0
1,1596,56269,3578768801,3578768801,0
1,1596,56270,3578768801,3578768801,0
1,1596,56271,3578768801,3578768801,0
1,1596,56272,3578768801,3578768801,0
1,1596,56273,3578768801,3578768801,0
1,1596,56274,3578768801,3578768801,0
1,1596,56275,3578768801,3578768801,0
1,1596,56276,3578768801,3578768801,0
1,1596,56277,3578768801,3578768805,4
1,1596,56278,3578768801,3578768805,4
1,1596,56279,3578768801,3578768806,5
1,1596,56280,3578768801,3578768809,8
1,1596,56281,3578768801,3578768810,9
1,1596,56282,3578768801,3578768810,9
1,1596,56283,3578768801,3578768810,9
1,1596,56284,3578768801,3578768811,10
1,1596,56285,3578768801,3578768813,12
1,1596,56286,3578768801,3578768813,12
1,1596,56287,3578768801,3578768813,12
1,1596,56288,3578768801,3578768813,12
1,1596,56289,3578768801,3578768814,13
1,1596,56290,3578768801,3578768814,13
1,1596,56291,3578768801,3578768815,14
1,1596,56292,3578768801,3578768815,14
1,1596,56293,3578768801,3578768816,15
1,1596,56294,3578768801,3578768816,15
1,1596,56295,3578768801,3578768817,16
1,1596,56296,3578768801,3578768817,16
1,1596,56297,3578768801,3578768817,16
1,1596,56298,3578768801,3578768818,17
1,1596,56299,3578768801,3578768818,17
1,1596,56300,3578768801,3578768819,18
1,1596,56301,3578768801,3578768821,20
1,1596,56302,3578768801,3578768822,21
1,1596,56303,3578768801,3578768823,22
1,1596,56304,3578768801,3578768825,24
1,1596,56305,3578768801,3578768826,25
1,1596,56306,3578768801,3578768826,25
1,1596,56307,3578768801,3578768827,26
1,1596,56308,3578768801,3578768828,27
1,1596,56309,3578768801,3578768830,29
1,1596,56310,3578768801,3578768830,29
1,1596,56311,3578768801,3578768832,31
1,1596,56312,3578768801,3578768832,31
1,1596,56313,3578768801,3578768833,32
1,1596,56314,3578768801,3578768834,33
1,1596,56315,3578768801,3578768834,33
1,1596,56316,3578768801,3578768836,35
1,1596,56317,3578768801,3578768837,36
1,1596,56318,3578768801,3578768837,36
1,1596,56319,3578768801,3578768838,37
1,1596,56320,3578768801,3578768839,38
1,1596,56321,3578768801,3578768844,43
1,1596,56322,3578768801,3578768846,45
1,1596,56323,3578768801,3578768849,48
1,1596,56324,3578768801,3578768849,48
1,1596,56325,3578768801,3578768850,49
1,1597,56326,3578768866,3578768866,0
1,1597,56327,3578768866,3578768866,0
1,1597,56328,3578768866,3578768866,0
1,1597,56329,3578768866,3578768866,0
1,1597,56330,3578768866,3578768866,0
1,1597,56331,3578768866,3578768866,0
1,1597,56332,3578768866,3578768866,0
1,1597,56333,3578768866,3578768866,0
1,1597,56334,3578768866,3578768866,0
1,1597,56335,3578768866,3578768866,0
1,1597,56336,3578768866,3578768866,0
1,1597,56337,3578768866,3578768866,0
1,1597,56338,3578768866,3578768866,0
1,1597,56339,3578768866,3578768866,0
1,1597,56340,3578768866,3578768866,0
1,1597,56341,3578768866,3578768866,0
1,1597,56342,3578768866,3578768870,4
1,1597,56343,3578768866,3578768881,15
1,1597,56344,3578768866,3578768882,16
1,1597,56345,3578768866,3578768883,17
1,1597,56346,3578768866,3578768885,19
1,1597,56347,3578768866,3578768886,20
1,1597,56348,3578768866,3578768887,21
1,1597,56349,3578768866,3578768887,21
1,1597,56350,3578768866,3578768888,22
1,1597,56351,3578768866,3578768889,23
1,1597,56352,3578768866,3578768891,25
1,1597,56353,3578768866,3578768893,27
1,1597,56354,3578768866,3578768893,27
1,1597,56355,3578768866,3578768894,28
1,1597,56356,3578768866,3578768894,28
1,1597,56357,3578768866,3578768895,29
1,1597,56358,3578768866,3578768896,30
1,1597,56359,3578768866,3578768896,30
1,1597,56360,3578768866,3578768896,30
1,1597,56361,3578768866,3578768897,31
1,1597,56362,3578768866,3578768897,31
1,1597,56363,3578768866,3578768898,32
1,1597,56364,3578768866,3578768898,32
1,1597,56365,3578768866,3578768898,32
1,1597,56366,3578768866,3578768898,32
1,1597,56367,3578768866,3578768900,34
1,1597,56368,3578768866,3578768902,36
1,1597,56369,3578768866,3578768902,36
1,1597,56370,3578768866,3578768902,36
1,1597,56371,3578768866,3578768902,36
1,1597,56372,3578768866,3578768902,36
1,1597,56373,3578768866,3578768903,37
1,1597,56374,3578768866,3578768904,38
1,1597,56375,3578768866,3578768904,38
1,1597,56376,3578768866,3578768905,39
1,1597,56377,3578768866,3578768905,39
1,1597,56378,3578768866,3578768907,41
1,1597,56379,3578768866,3578768907,41
1,1597,56380,3578768866,3578768908,42
1,1597,56381,3578768866,3578768908,42
1,1597,56382,3578768866,3578768908,42
1,1597,56383,3578768866,3578768910,44
1,1597,56384,3578768866,3578768910,44
1,1597,56385,3578768866,3578768912,46
1,1597,56386,3578768866,3578768913,47
1,1597,56387,3578768866,3578768913,47
1,1597,56388,3578768866,3578768913,47
1,1597,56389,3578768866,3578768913,47
1,1597,56390,3578768866,3578768914,48
1,1597,56391,3578768866,3578768916,50
1,1598,56392,3578768932,3578768932,0
1,1598,56393,3578768932,3578768932,0
1,1598,56394,3578768932,3578768932,0
1,1598,56395,3578768932,3578768932,0
1,1598,56396,3578768932,3578768932,0
1,1598,56397,3578768932,3578768932,0
1,1598,56398,3578768932,3578768932,0
1,1598,56399,3578768932,3578768932,0
1,1598,56400,3578768932,3578768932,0
1,1598,56401,3578768932,3578768932,0
1,1598,56402,3578768932,3578768932,0
1,1598,56403,3578768932,3578768932,0
1,1598,56404,3578768932,3578768932,0
1,1598,56405,3578768932,3578768932,0
1,1598,56406,3578768932,3578768932,0
1,1598,56407,3578768932,3578768932,0
1,1598,56408,3578768932,3578768933,1
1,1598,56409,3578768932,3578768933,1
1,1598,56410,3578768932,3578768933,1
1,1598,56411,3578768932,3578768933,1
1,1598,56412,3578768932,3578768933,1
1,1598,56413,3578768932,3578768933,1
1,1598,56414,3578768932,3578768933,1
1,1598,56415,3578768932,3578768933,1
1,1598,56416,3578768932,3578768933,1
1,1598,56417,3578768932,3578768933,1
1,1598,56418,3578768932,3578768934,2
1,1598,56419,3578768932,3578768934,2
1,1598,56420,3578768932,3578768935,3
1,1598,56421,3578768932,3578768937,5
1,1598,56422,3578768932,3578768937,5
1,1598,56423,3578768932,3578768939,7
1,1598,56424,3578768932,3578768940,8
1,1598,56425,3578768932,3578768942,10
1,1598,56426,3578768932,3578768945,13
1,1598,56427,3578768932,3578768946,14
1,1598,56428,3578768932,3578768948,16
1,1598,56429,3578768932,3578768949,17
1,1598,56430,3578768932,3578768951,19
1,1598,56431,3578768932,3578768951,19
1,1598,56432,3578768932,3578768952,20
1,1598,56433,3578768932,3578768953,21
1,1598,56434,3578768932,3578768955,23
1,1598,56435,3578768932,3578768955,23
1,1598,56436,3578768932,3578768956,24
1,1598,56437,3578768932,3578768959,27
1,1598,56438,3578768932,3578768961,29
1,1598,56439,3578768932,3578768962,30
1,1598,56440,3578768932,3578768963,31
1,1598,56441,3578768932,3578768963,31
1,1598,56442,3578768932,3578768964,32
1,1598,56443,3578768932,3578768965,33
1,1598,56444,3578768932,3578768965,33
1,1598,56445,3578768932,3578768965,33
1,1598,56446,3578768932,3578768965,33
1,1598,56447,3578768932,3578768966,34
1,1598,56448,3578768932,3578768967,35
1,1598,56449,3578768932,3578768967,35
1,1598,56450,3578768932,3578768968,36
1,1598,56451,3578768932,3578768969,37
1,1598,56452,3578768932,3578768970,38
1,1598,56453,3578768932,3578768972,40
1,1598,56454,3578768932,3578768974,42
1,1598,56455,3578768932,3578768975,43
1,1598,56456,3578768932,3578768976,44
1,1598,56457,3578768932,3578768977,45
1,1598,56458,3578768932,3578768978,46
1,1598,56459,3578768932,3578768979,47
1,1598,56460,3578768932,3578768979,47
1,1598,56461,3578768932,3578768979,47
1,1598,56462,3578768932,3578768980,48
1,1598,56463,3578768932,3578768981,49
1,1598,56464,3578768932,3578768981,49
1,1598,56465,3578768932,3578768981,49
1,1598,56466,3578768932,3578768982,50
1,1599,56467,3578768997,3578768997,0
1,1599,56468,3578768997,3578768997,0
1,1599,56469,3578768997,3578768997,0
1,1599,56470,3578768997,3578768997,0
1,1599,56471,3578768997,3578768997,0
1,1599,56472,3578768997,3578768997,0
1,1599,56473,3578768997,3578768997,0
1,1599,56474,3578768997,3578768997,0
1,1599,56475,3578768997,3578768997,0
1,1599,56476,3578768997,3578768997,0
1,1599,56477,3578768997,3578768997,0
1,1599,56478,3578768997,3578768997,0
1,1599,56479,3578768997,3578768997,0
1,1599,56480,3578768997,3578768999,2
1,1599,56481,3578768997,3578768999,2
1,1599,56482,3578768997,3578769000,3
1,1599,56483,3578768997,3578769000,3
1,1599,56484,3578768997,3578769001,4
1,1599,56485,3578768997,3578769002,5
1,1599,56486,3578768997,3578769005,8
1,1599,56487,3578768997,3578769005,8
1,1599,56488,3578768997,3578769006,9
1,1599,56489,3578768997,3578769010,13
1,1599,56490,3578768997,3578769010,13
1,1599,56491,3578768997,3578769011,14
1,1599,56492,3578768997,3578769011,14
1,1599,56493,3578768997,3578769012,15
1,1599,56494,3578768997,3578769013,16
1,1599,56495,3578768997,3578769013,16
1,1599,56496,3578768997,3578769015,18
1,1599,56497,3578768997,3578769015,18
1,1599,56498,3578768997,3578769016,19
1,1599,56499,3578768997,3578769016,19
1,1599,56500,3578768997,3578769016,19
1,1599,56501,3578768997,3578769017,20
1,1599,56502,3578768997,3578769018,21
1,1599,56503,3578768997,3578769018,21
1,1599,56504,3578768997,3578769019,22
1,1599,56505,3578768997,3578769022,25
1,1599,56506,3578768997,3578769022,25
1,1599,56507,3578768997,3578769023,26
1,1599,56508,3578768997,3578769024,27
1,1599,56509,3578768997,3578769026,29
1,1599,56510,3578768997,3578769026,29
1,1599,56511,3578768997,3578769027,30
1,1599,56512,3578768997,3578769028,31
1,1599,56513,3578768997,3578769028,31
1,1599,56514,3578768997,3578769030,33
1,1599,56515,3578768997,3578769031,34
1,1599,56516,3578768997,3578769032,35
1,1599,56517,3578768997,3578769032,35
1,1599,56518,3578768997,3578769034,37
1,1599,56519,3578768997,3578769034,37
1,1599,56520,3578768997,3578769035,38
1,1599,56521,3578768997,3578769035,38
1,1599,56522,3578768997,3578769036,39
1,1599,56523,3578768997,3578769037,40
1,1599,56524,3578768997,3578769037,40
1,1599,56525,3578768997,3578769038,41
1,1599,56526,3578768997,3578769039,42
1,1599,56527,3578768997,3578769044,47
1,1599,56528,3578768997,3578769045,48
1,1600,56529,3578769062,3578769062,0
1,1600,56530,3578769062,3578769062,0
1,1600,56531,3578769062,3578769062,0
1,1600,56532,3578769062,3578769062,0
1,1600,56533,3578769062,3578769062,0
1,1600,56534,3578769062,3578769062,0
1,1600,56535,3578769062,3578769062,0
1,1600,56536,3578769062,3578769062,0
1,1600,56537,3578769062,3578769062,0
1,1600,56538,3578769062,3578769062,0
1,1600,56539,3578769062,3578769062,0
1,1600,56540,3578769062,3578769062,0
1,1600,56541,3578769062,3578769062,0
1,1600,56542,3578769062,3578769062,0
1,1600,56543,3578769062,3578769062,0
1,1600,56544,3578769062,3578769062,0
1,1600,56545,3578769062,3578769062,0
1,1600,56546,3578769062,3578769062,0
1,1600,56547,3578769062,3578769063,1
1,1600,56548,3578769062,3578769065,3
1,1600,56549,3578769062,3578769067,5
1,1600,56550,3578769062,3578769068,6
1,1600,56551,3578769062,3578769070,8
1,1600,56552,3578769062,3578769083,21
1,1600,56553,3578769062,3578769083,21
1,1600,56554,3578769062,3578769085,23
1,1600,56555,3578769062,3578769085,23
1,1600,56556,3578769062,3578769086,24
1,1600,56557,3578769062,3578769088,26
1,1600,56558,3578769062,3578769088,26
1,1600,56559,3578769062,3578769091,29
1,1600,56560,3578769062,3578769092,30
1,1600,56561,3578769062,3578769094,32
1,1600,56562,3578769062,3578769094,32
1,1600,56563,3578769062,3578769094,32
1,1600,56564,3578769062,3578769095,33
1,1600,56565,3578769062,3578769096,34
1,1600,56566,3578769062,3578769097,35
1,1600,56567,3578769062,3578769098,36
1,1600,56568,3578769062,3578769098,36
1,1600,56569,3578769062,3578769101,39
1,1600,56570,3578769062,3578769101,39
1,1600,56571,3578769062,3578769102,40
1,1600,56572,3578769062,3578769102,40
1,1600,56573,3578769062,3578769102,40
1,1600,56574,3578769062,3578769103,41
1,1600,56575,3578769062,3578769103,41
1,1600,56576,3578769062,3578769104,42
1,1600,56577,3578769062,3578769104,42
1,1600,56578,3578769062,3578769105,43
1,1600,56579,3578769062,3578769105,43
1,1600,56580,3578769062,3578769107,45
1,1600,56581,3578769062,3578769107,45
1,1600,56582,3578769062,3578769107,45
1,1600,56583,3578769062,3578769108,46
1,1600,56584,3578769062,3578769108,46
1,1600,56585,3578769062,3578769110,48
1,1600,56586,3578769062,3578769110,48
1,1600,56587,3578769062,3578769111,49
1,1601,56588,3578769128,3578769128,0
1,1601,56589,3578769128,3578769128,0
1,1601,56590,3578769128,3578769128,0
1,1601,56591,3578769128,3578769128,0
1,1601,56592,3578769128,3578769128,0
1,1601,56593,3578769128,3578769128,0
1,1601,56594,3578769128,3578769128,0
1,1601,56595,3578769128,3578769128,0
1,1601,56596,3578769128,3578769128,0
1,1601,56597,3578769128,3578769128,0
1,1601,56598,3578769128,3578769128,0
1,1601,56599,3578769128,3578769128,0
1,1601,56600,3578769128,3578769128,0
1,1601,56601,3578769128,3578769128,0
1,1601,56602,3578769128,3578769128,0
1,1601,56603,3578769128,3578769128,0
1,1601,56604,3578769128,3578769128,0
1,1601,56605,3578769128,3578769128,0
1,1601,56606,3578769128,3578769128,0
1,1601,56607,3578769128,3578769128,0
1,1601,56608,3578769128,3578769128,0
1,1601,56609,3578769128,3578769128,0
1,1601,56610,3578769128,3578769128,0
1,1601,56611,3578769128,3578769128,0
1,1601,56612,3578769128,3578769128,0
1,1601,56613,3578769128,3578769128,0
1,1601,56614,3578769128,3578769129,1
1,1601,56615,3578769128,3578769129,1
1,1601,56616,3578769128,3578769131,3
1,1601,56617,3578769128,3578769131,3
1,1601,56618,3578769128,3578769132,4
1,1601,56619,3578769128,3578769132,4
1,1601,56620,3578769128,3578769132,4
1,1601,56621,3578769128,3578769133,5
1,1601,56622,3578769128,3578769133,5
1,1601,56623,3578769128,3578769134,6
1,1601,56624,3578769128,3578769134,6
1,1601,56625,3578769128,3578769135,7
1,1601,56626,3578769128,3578769137,9
1,1601,56627,3578769128,3578769137,9
1,1601,56628,3578769128,3578769139,11
1,1601,56629,3578769128,3578769140,12
1,1601,56630,3578769128,3578769142,14
1,1601,56631,3578769128,3578769146,18
1,1601,56632,3578769128,3578769146,18
1,1601,56633,3578769128,3578769148,20
1,1601,56634,3578769128,3578769149,21
1,1601,56635,3578769128,3578769150,22
1,1601,56636,3578769128,3578769151,23
1,1601,56637,3578769128,3578769151,23
1,1601,56638,3578769128,3578769152,24
1,1601,56639,3578769128,3578769153,25
1,1601,56640,3578769128,3578769155,27
1,1601,56641,3578769128,3578769155,27
1,1601,56642,3578769128,3578769155,27
1,1601,56643,3578769128,3578769159,31
1,1601,56644,3578769128,3578769161,33
1,1601,56645,3578769128,3578769163,35
1,1601,56646,3578769128,3578769164,36
1,1601,56647,3578769128,3578769165,37
1,1601,56648,3578769128,3578769165,37
1,1601,56649,3578769128,3578769165,37
1,1601,56650,3578769128,3578769165,37
1,1601,56651,3578769128,3578769166,38
1,1601,56652,3578769128,3578769166,38
1,1601,56653,3578769128,3578769166,38
1,1601,56654,3578769128,3578769166,38
1,1601,56655,3578769128,3578769167,39
1,1601,56656,3578769128,3578769168,40
1,1601,56657,3578769128,3578769169,41
1,1601,56658,3578769128,3578769170,42
1,1601,56659,3578769128,3578769170,42
1,1601,56660,3578769128,3578769172,44
1,1601,56661,3578769128,3578769174,46
1,1601,56662,3578769128,3578769175,47
1,1601,56663,3578769128,3578769177,49
1,1601,56664,3578769128,3578769177,49
1,1602,56665,3578769193,3578769193,0
1,1602,56666,3578769193,3578769193,0
1,1602,56667,3578769193,3578769193,0
1,1602,56668,3578769193,3578769193,0
1,1602,56669,3578769193,3578769193,0
1,1602,56670,3578769193,3578769193,0
1,1602,56671,3578769193,3578769193,0
1,1602,56672,3578769193,3578769193,0
1,1602,56673,3578769193,3578769193,0
1,1602,56674,3578769193,3578769193,0
1,1602,56675,3578769193,3578769193,0
1,1602,56676,3578769193,3578769193,0
1,1602,56677,3578769193,3578769193,0
1,1602,56678,3578769193,3578769193,0
1,1602,56679,3578769193,3578769193,0
1,1602,56680,3578769193,3578769193,0
1,1602,56681,3578769193,3578769193,0
1,1602,56682,3578769193,3578769193,0
1,1602,56683,3578769193,3578769193,0
1,1602,56684,3578769193,3578769194,1
1,1602,56685,3578769193,3578769195,2
1,1602,56686,3578769193,3578769196,3
1,1602,56687,3578769193,3578769197,4
1,1602,56688,3578769193,3578769197,4
1,1602,56689,3578769193,3578769197,4
1,1602,56690,3578769193,3578769199,6
1,1602,56691,3578769193,3578769199,6
1,1602,56692,3578769193,3578769200,7
1,1602,56693,3578769193,3578769200,7
1,1602,56694,3578769193,3578769201,8
1,1602,56695,3578769193,3578769203,10
1,1602,56696,3578769193,3578769204,11
1,1602,56697,3578769193,3578769205,12
1,1602,56698,3578769193,3578769205,12
1,1602,56699,3578769193,3578769206,13
1,1602,56700,3578769193,3578769210,17
1,1602,56701,3578769193,3578769210,17
1,1602,56702,3578769193,3578769211,18
1,1602,56703,3578769193,3578769211,18
1,1602,56704,3578769193,3578769211,18
1,1602,56705,3578769193,3578769213,20
1,1602,56706,3578769193,3578769213,20
1,1602,56707,3578769193,3578769215,22
1,1602,56708,3578769193,3578769216,23
1,1602,56709,3578769193,3578769216,23
1,1602,56710,3578769193,3578769217,24
1,1602,56711,3578769193,3578769217,24
1,1602,56712,3578769193,3578769217,24
1,1602,56713,3578769193,3578769218,25
1,1602,56714,3578769193,3578769218,25
1,1602,56715,3578769193,3578769219,26
1,1602,56716,3578769193,3578769220,27
1,1602,56717,3578769193,3578769222,29
1,1602,56718,3578769193,3578769223,30
1,1602,56719,3578769193,3578769223,30
1,1602,56720,3578769193,3578769224,31
1,1602,56721,3578769193,3578769225,32
1,1602,56722,3578769193,3578769225,32
1,1602,56723,3578769193,3578769227,34
1,1602,56724,3578769193,3578769228,35
1,1602,56725,3578769193,3578769228,35
1,1602,56726,3578769193,3578769229,36
1,1602,56727,3578769193,3578769229,36
1,1602,56728,3578769193,3578769230,37
1,1602,56729,3578769193,3578769232,39
1,1602,56730,3578769193,3578769232,39
1,1602,56731,3578769193,3578769232,39
1,1602,56732,3578769193,3578769234,41
1,1602,56733,3578769193,3578769235,42
1,1602,56734,3578769193,3578769235,42
1,1602,56735,3578769193,3578769236,43
1,1602,56736,3578769193,3578769237,44
1,1602,56737,3578769193,3578769237,44
1,1602,56738,3578769193,3578769237,44
1,1602,56739,3578769193,3578769238,45
1,1602,56740,3578769193,3578769239,46
1,1603,56741,3578769257,3578769257,0
1,1603,56742,3578769257,3578769257,0
1,1603,56743,3578769257,3578769257,0
1,1603,56744,3578769257,3578769258,1
1,1603,56745,3578769257,3578769258,1
1,1603,56746,3578769257,3578769258,1
1,1603,56747,3578769257,3578769258,1
1,1603,56748,3578769257,3578769258,1
1,1603,56749,3578769257,3578769258,1
1,1603,56750,3578769257,3578769258,1
1,1603,56751,3578769257,3578769258,1
1,1603,56752,3578769257,3578769258,1
1,1603,56753,3578769257,3578769258,1
1,1603,56754,3578769257,3578769259,2
1,1603,56755,3578769257,3578769259,2
1,1603,56756,3578769257,3578769262,5
1,1603,56757,3578769257,3578769263,6
1,1603,56758,3578769257,3578769263,6
1,1603,56759,3578769257,3578769264,7
1,1603,56760,3578769257,3578769267,10
1,1603,56761,3578769257,3578769268,11
1,1603,56762,3578769257,3578769268,11
1,1603,56763,3578769257,3578769269,12
1,1603,56764,3578769257,3578769269,12
1,1603,56765,3578769257,3578769283,26
1,1603,56766,3578769257,3578769284,27
1,1603,56767,3578769257,3578769285,28
1,1603,56768,3578769257,3578769286,29
1,1603,56769,3578769257,3578769287,30
1,1603,56770,3578769257,3578769287,30
1,1603,56771,3578769257,3578769288,31
1,1603,56772,3578769257,3578769290,33
1,1603,56773,3578769257,3578769291,34
1,1603,56774,3578769257,3578769292,35
1,1603,56775,3578769257,3578769293,36
1,1603,56776,3578769257,3578769293,36
1,1603,56777,3578769257,3578769293,36
1,1603,56778,3578769257,3578769294,37
1,1603,56779,3578769257,3578769295,38
1,1603,56780,3578769257,3578769295,38
1,1603,56781,3578769257,3578769296,39
1,1603,56782,3578769257,3578769297,40
1,1603,56783,3578769257,3578769297,40
1,1603,56784,3578769257,3578769298,41
1,1603,56785,3578769257,3578769298,41
1,1603,56786,3578769257,3578769301,44
1,1603,56787,3578769257,3578769301,44
1,1603,56788,3578769257,3578769301,44
1,1603,56789,3578769257,3578769302,45
1,1603,56790,3578769257,3578769302,45
1,1603,56791,3578769257,3578769302,45
1,1603,56792,3578769257,3578769303,46
1,1603,56793,3578769257,3578769303,46
1,1603,56794,3578769257,3578769303,46
1,1603,56795,3578769257,3578769304,47
1,1603,56796,3578769257,3578769305,48
1,1603,56797,3578769257,3578769305,48
1,1603,56798,3578769257,3578769305,48
1,1603,56799,3578769257,3578769307,50
1,1604,56800,3578769322,3578769322,0
1,1604,56801,3578769322,3578769322,0
1,1604,56802,3578769322,3578769322,0
1,1604,56803,3578769322,3578769322,0
1,1604,56804,3578769322,3578769322,0
1,1604,56805,3578769322,3578769322,0
1,1604,56806,3578769322,3578769322,0
1,1604,56807,3578769322,3578769322,0
1,1604,56808,3578769322,3578769322,0
1,1604,56809,3578769322,3578769322,0
1,1604,56810,3578769322,3578769322,0
1,1604,56811,3578769322,3578769322,0
1,1604,56812,3578769322,3578769322,0
1,1604,56813,3578769322,3578769322,0
1,1604,56814,3578769322,3578769322,0
1,1604,56815,3578769322,3578769322,0
1,1604,56816,3578769322,3578769322,0
1,1604,56817,3578769322,3578769322,0
1,1604,56818,3578769322,3578769322,0
1,1604,56819,3578769322,3578769322,0
1,1604,56820,3578769322,3578769322,0
1,1604,56821,3578769322,3578769322,0
1,1604,56822,3578769322,3578769325,3
1,1604,56823,3578769322,3578769325,3
1,1604,56824,3578769322,3578769327,5
1,1604,56825,3578769322,3578769327,5
1,1604,56826,3578769322,3578769328,6
1,1604,56827,3578769322,3578769328,6
1,1604,56828,3578769322,3578769328,6
1,1604,56829,3578769322,3578769329,7
1,1604,56830,3578769322,3578769329,7
1,1604,56831,3578769322,3578769331,9
1,1604,56832,3578769322,3578769332,10
1,1604,56833,3578769322,3578769332,10
1,1604,56834,3578769322,3578769332,10
1,1604,56835,3578769322,3578769332,10
1,1604,56836,3578769322,3578769332,10
1,1604,56837,3578769322,3578769333,11
1,1604,56838,3578769322,3578769334,12
1,1604,56839,3578769322,3578769334,12
1,1604,56840,3578769322,3578769334,12
1,1604,56841,3578769322,3578769336,14
1,1604,56842,3578769322,3578769337,15
1,1604,56843,3578769322,3578769337,15
1,1604,56844,3578769322,3578769339,17
1,1604,56845,3578769322,3578769342,20
1,1604,56846,3578769322,3578769346,24
1,1604,56847,3578769322,3578769346,24
1,1604,56848,3578769322,3578769348,26
1,1604,56849,3578769322,3578769348,26
1,1604,56850,3578769322,3578769350,28
1,1604,56851,3578769322,3578769351,29
1,1604,56852,3578769322,3578769351,29
1,1604,56853,3578769322,3578769353,31
1,1604,56854,3578769322,3578769354,32
1,1604,56855,3578769322,3578769355,33
1,1604,56856,3578769322,3578769355,33
1,1604,56857,3578769322,3578769358,36
1,1604,56858,3578769322,3578769363,41
1,1604,56859,3578769322,3578769363,41
1,1604,56860,3578769322,3578769364,42
1,1604,56861,3578769322,3578769365,43
1,1604,56862,3578769322,3578769366,44
1,1604,56863,3578769322,3578769366,44
1,1604,56864,3578769322,3578769366,44
1,1604,56865,3578769322,3578769366,44
1,1604,56866,3578769322,3578769366,44
1,1604,56867,3578769322,3578769367,45
1,1604,56868,3578769322,3578769368,46
1,1604,56869,3578769322,3578769368,46
1,1604,56870,3578769322,3578769369,47
1,1604,56871,3578769322,3578769370,48
1,1604,56872,3578769322,3578769370,48
1,1605,56873,3578769388,3578769388,0
1,1605,56874,3578769388,3578769388,0
1,1605,56875,3578769388,3578769388,0
1,1605,56876,3578769388,3578769388,0
1,1605,56877,3578769388,3578769388,0
1,1605,56878,3578769388,3578769388,0
1,1605,56879,3578769388,3578769388,0
1,1605,56880,3578769388,3578769388,0
1,1605,56881,3578769388,3578769388,0
1,1605,56882,3578769388,3578769388,0
1,1605,56883,3578769388,3578769388,0
1,1605,56884,3578769388,3578769388,0
1,1605,56885,3578769388,3578769388,0
1,1605,56886,3578769388,3578769388,0
1,1605,56887,3578769388,3578769388,0
1,1605,56888,3578769388,3578769388,0
1,1605,56889,3578769388,3578769388,0
1,1605,56890,3578769388,3578769389,1
1,1605,56891,3578769388,3578769391,3
1,1605,56892,3578769388,3578769391,3
1,1605,56893,3578769388,3578769391,3
1,1605,56894,3578769388,3578769392,4
1,1605,56895,3578769388,3578769392,4
1,1605,56896,3578769388,3578769394,6
1,1605,56897,3578769388,3578769394,6
1,1605,56898,3578769388,3578769396,8
1,1605,56899,3578769388,3578769397,9
1,1605,56900,3578769388,3578769397,9
1,1605,56901,3578769388,3578769397,9
1,1605,56902,3578769388,3578769397,9
1,1605,56903,3578769388,3578769399,11
1,1605,56904,3578769388,3578769400,12
1,1605,56905,3578769388,3578769400,12
1,1605,56906,3578769388,3578769400,12
1,1605,56907,3578769388,3578769402,14
1,1605,56908,3578769388,3578769404,16
1,1605,56909,3578769388,3578769405,17
1,1605,56910,3578769388,3578769405,17
1,1605,56911,3578769388,3578769406,18
1,1605,56912,3578769388,3578769410,22
1,1605,56913,3578769388,3578769411,23
1,1605,56914,3578769388,3578769411,23
1,1605,56915,3578769388,3578769411,23
1,1605,56916,3578769388,3578769412,24
1,1605,56917,3578769388,3578769413,25
1,1605,56918,3578769388,3578769414,26
1,1605,56919,3578769388,3578769415,27
1,1605,56920,3578769388,3578769416,28
1,1605,56921,3578769388,3578769416,28
1,1605,56922,3578769388,3578769417,29
1,1605,56923,3578769388,3578769417,29
1,1605,56924,3578769388,3578769418,30
1,1605,56925,3578769388,3578769418,30
1,1605,56926,3578769388,3578769418,30
1,1605,56927,3578769388,3578769419,31
1,1605,56928,3578769388,3578769419,31
1,1605,56929,3578769388,3578769419,31
1,1605,56930,3578769388,3578769422,34
1,1605,56931,3578769388,3578769423,35
1,1605,56932,3578769388,3578769423,35
1,1605,56933,3578769388,3578769425,37
1,1605,56934,3578769388,3578769425,37
1,1605,56935,3578769388,3578769425,37
1,1605,56936,3578769388,3578769425,37
1,1605,56937,3578769388,3578769427,39
1,1605,56938,3578769388,3578769428,40
1,1605,56939,3578769388,3578769428,40
1,1605,56940,3578769388,3578769429,41
1,1605,56941,3578769388,3578769429,41
1,1605,56942,3578769388,3578769431,43
1,1605,56943,3578769388,3578769431,43
1,1605,56944,3578769388,3578769432,44
1,1605,56945,3578769388,3578769433,45
1,1605,56946,3578769388,3578769433,45
1,1605,56947,3578769388,3578769435,47
1,1605,56948,3578769388,3578769435,47
1,1605,56949,3578769388,3578769436,48
1,1605,56950,3578769388,3578769437,49
1,1605,56951,3578769388,3578769437,49
1,1605,56952,3578769388,3578769438,50
1,1606,56953,3578769453,3578769453,0
1,1606,56954,3578769453,3578769453,0
1,1606,56955,3578769453,3578769453,0
1,1606,56956,3578769453,3578769453,0
1,1606,56957,3578769453,3578769453,0
1,1606,56958,3578769453,3578769453,0
1,1606,56959,3578769453,3578769453,0
1,1606,56960,3578769453,3578769453,0
1,1606,56961,3578769453,3578769454,1
1,1606,56962,3578769453,3578769455,2
1,1606,56963,3578769453,3578769455,2
1,1606,56964,3578769453,3578769456,3
1,1606,56965,3578769453,3578769457,4
1,1606,56966,3578769453,3578769457,4
1,1606,56967,3578769453,3578769457,4
1,1606,56968,3578769453,3578769458,5
1,1606,56969,3578769453,3578769459,6
1,1606,56970,3578769453,3578769460,7
1,1606,56971,3578769453,3578769462,9
1,1606,56972,3578769453,3578769463,10
1,1606,56973,3578769453,3578769464,11
1,1606,56974,3578769453,3578769465,12
1,1606,56975,3578769453,3578769467,14
1,1606,56976,3578769453,3578769468,15
1,1606,56977,3578769453,3578769468,15
1,1606,56978,3578769453,3578769469,16
1,1606,56979,3578769453,3578769470,17
1,1606,56980,3578769453,3578769481,28
1,1606,56981,3578769453,3578769483,30
1,1606,56982,3578769453,3578769484,31
1,1606,56983,3578769453,3578769485,32
1,1606,56984,3578769453,3578769486,33
1,1606,56985,3578769453,3578769488,35
1,1606,56986,3578769453,3578769488,35
1,1606,56987,3578769453,3578769489,36
1,1606,56988,3578769453,3578769490,37
1,1606,56989,3578769453,3578769491,38
1,1606,56990,3578769453,3578769491,38
1,1606,56991,3578769453,3578769493,40
1,1606,56992,3578769453,3578769493,40
1,1606,56993,3578769453,3578769494,41
1,1606,56994,3578769453,3578769494,41
1,1606,56995,3578769453,3578769495,42
1,1606,56996,3578769453,3578769495,42
1,1606,56997,3578769453,3578769495,42
1,1606,56998,3578769453,3578769496,43
1,1606,56999,3578769453,3578769496,43
1,1606,57000,3578769453,3578769496,43
1,1606,57001,3578769453,3578769497,44
1,1606,57002,3578769453,3578769498,45
1,1606,57003,3578769453,3578769500,47
1,1606,57004,3578769453,3578769501,48
1,1606,57005,3578769453,3578769501,48
1,1606,57006,3578769453,3578769502,49
1,1606,57007,3578769453,3578769502,49
1,1606,57008,3578769453,3578769502,49
1,1606,57009,3578769453,3578769502,49
1,1606,57010,3578769453,3578769502,49
1,1606,57011,3578769453,3578769503,50
1,1607,57012,3578769520,3578769520,0
1,1607,57013,3578769520,3578769520,0
1,1607,57014,3578769520,3578769520,0
1,1607,57015,3578769520,3578769520,0
1,1607,57016,3578769520,3578769520,0
1,1607,57017,3578769520,3578769520,0
1,1607,57018,3578769520,3578769520,0
1,1607,57019,3578769520,3578769520,0
1,1607,57020,3578769520,3578769520,0
1,1607,57021,3578769520,3578769520,0
1,1607,57022,3578769520,3578769520,0
1,1607,57023,3578769520,3578769520,0
1,1607,57024,3578769520,3578769520,0
1,1607,57025,3578769520,3578769520,0
1,1607,57026,3578769520,3578769520,0
1,1607,57027,3578769520,3578769520,0
1,1607,57028,3578769520,3578769520,0
1,1607,57029,3578769520,3578769520,0
1,1607,57030,3578769520,3578769520,0
1,1607,57031,3578769520,3578769520,0
1,1607,57032,3578769520,3578769520,0
1,1607,57033,3578769520,3578769520,0
1,1607,57034,3578769520,3578769520,0
1,1607,57035,3578769520,3578769520,0
1,1607,57036,3578769520,3578769520,0
1,1607,57037,3578769520,3578769520,0
1,1607,57038,3578769520,3578769520,0
1,1607,57039,3578769520,3578769520,0
1,1607,57040,3578769520,3578769521,1
1,1607,57041,3578769520,3578769521,1
1,1607,57042,3578769520,3578769521,1
1,1607,57043,3578769520,3578769524,4
1,1607,57044,3578769520,3578769524,4
1,1607,57045,3578769520,3578769526,6
1,1607,57046,3578769520,3578769526,6
1,1607,57047,3578769520,3578769527,7
1,1607,57048,3578769520,3578769527,7
1,1607,57049,3578769520,3578769528,8
1,1607,57050,3578769520,3578769528,8
1,1607,57051,3578769520,3578769528,8
1,1607,57052,3578769520,3578769530,10
1,1607,57053,3578769520,3578769530,10
1,1607,57054,3578769520,3578769531,11
1,1607,57055,3578769520,3578769531,11
1,1607,57056,3578769520,3578769531,11
1,1607,57057,3578769520,3578769532,12
1,1607,57058,3578769520,3578769532,12
1,1607,57059,3578769520,3578769533,13
1,1607,57060,3578769520,3578769533,13
1,1607,57061,3578769520,3578769534,14
1,1607,57062,3578769520,3578769536,16
1,1607,57063,3578769520,3578769536,16
1,1607,57064,3578769520,3578769536,16
1,1607,57065,3578769520,3578769540,20
1,1607,57066,3578769520,3578769541,21
1,1607,57067,3578769520,3578769542,22
1,1607,57068,3578769520,3578769545,25
1,1607,57069,3578769520,3578769545,25
1,1607,57070,3578769520,3578769547,27
1,1607,57071,3578769520,3578769548,28
1,1607,57072,3578769520,3578769549,29
1,1607,57073,3578769520,3578769550,30
1,1607,57074,3578769520,3578769551,31
1,1607,57075,3578769520,3578769553,33
1,1607,57076,3578769520,3578769554,34
1,1607,57077,3578769520,3578769555,35
1,1607,57078,3578769520,3578769555,35
1,1607,57079,3578769520,3578769556,36
1,1607,57080,3578769520,3578769556,36
1,1607,57081,3578769520,3578769562,42
1,1607,57082,3578769520,3578769563,43
1,1607,57083,3578769520,3578769564,44
1,1607,57084,3578769520,3578769564,44
1,1607,57085,3578769520,3578769565,45
1,1607,57086,3578769520,3578769565,45
1,1607,57087,3578769520,3578769565,45
1,1607,57088,3578769520,3578769565,45
1,1607,57089,3578769520,3578769566,46
1,1607,57090,3578769520,3578769566,46
1,1607,57091,3578769520,3578769567,47
1,1607,57092,3578769520,3578769568,48
1,1607,57093,3578769520,3578769568,48
1,1607,57094,3578769520,3578769568,48
1,1607,57095,3578769520,3578769569,49
1,1607,57096,3578769520,3578769569,49
1,1608,57097,3578769586,3578769586,0
1,1608,57098,3578769586,3578769586,0
1,1608,57099,3578769586,3578769586,0
1,1608,57100,3578769586,3578769586,0
1,1608,57101,3578769586,3578769586,0
1,1608,57102,3578769586,3578769586,0
1,1608,57103,3578769586,3578769586,0
1,1608,57104,3578769586,3578769586,0
1,1608,57105,3578769586,3578769586,0
1,1608,57106,3578769586,3578769586,0
1,1608,57107,3578769586,3578769586,0
1,1608,57108,3578769586,3578769586,0
1,1608,57109,3578769586,3578769586,0
1,1608,57110,3578769586,3578769586,0
1,1608,57111,3578769586,3578769586,0
1,1608,57112,3578769586,3578769590,4
1,1608,57113,3578769586,3578769590,4
1,1608,57114,3578769586,3578769591,5
1,1608,57115,3578769586,3578769591,5
1,1608,57116,3578769586,3578769592,6
1,1608,57117,3578769586,3578769593,7
1,1608,57118,3578769586,3578769594,8
1,1608,57119,3578769586,3578769596,10
1,1608,57120,3578769586,3578769596,10
1,1608,57121,3578769586,3578769596,10
1,1608,57122,3578769586,3578769596,10
1,1608,57123,3578769586,3578769598,12
1,1608,57124,3578769586,3578769598,12
1,1608,57125,3578769586,3578769599,13
1,1608,57126,3578769586,3578769601,15
1,1608,57127,3578769586,3578769604,18
1,1608,57128,3578769586,3578769604,18
1,1608,57129,3578769586,3578769604,18
1,1608,57130,3578769586,3578769604,18
1,1608,57131,3578769586,3578769609,23
1,1608,57132,3578769586,3578769610,24
1,1608,57133,3578769586,3578769610,24
1,1608,57134,3578769586,3578769611,25
1,1608,57135,3578769586,3578769612,26
1,1608,57136,3578769586,3578769613,27
1,1608,57137,3578769586,3578769613,27
1,1608,57138,3578769586,3578769614,28
1,1608,57139,3578769586,3578769615,29
1,1608,57140,3578769586,3578769615,29
1,1608,57141,3578769586,3578769616,30
1,1608,57142,3578769586,3578769616,30
1,1608,57143,3578769586,3578769616,30
1,1608,57144,3578769586,3578769616,30
1,1608,57145,3578769586,3578769618,32
1,1608,57146,3578769586,3578769619,33
1,1608,57147,3578769586,3578769621,35
1,1608,57148,3578769586,3578769622,36
1,1608,57149,3578769586,3578769622,36
1,1608,57150,3578769586,3578769624,38
1,1608,57151,3578769586,3578769624,38
1,1608,57152,3578769586,3578769625,39
1,1608,57153,3578769586,3578769625,39
1,1608,57154,3578769586,3578769628,42
1,1608,57155,3578769586,3578769628,42
1,1608,57156,3578769586,3578769628,42
1,1608,57157,3578769586,3578769628,42
1,1608,57158,3578769586,3578769630,44
1,1608,57159,3578769586,3578769630,44
1,1608,57160,3578769586,3578769631,45
1,1608,57161,3578769586,3578769632,46
1,1608,57162,3578769586,3578769632,46
1,1608,57163,3578769586,3578769634,48
1,1608,57164,3578769586,3578769634,48
1,1608,57165,3578769586,3578769635,49
1,1609,57166,3578769650,3578769650,0
1,1609,57167,3578769650,3578769650,0
1,1609,57168,3578769650,3578769650,0
1,1609,57169,3578769650,3578769650,0
1,1609,57170,3578769650,3578769650,0
1,1609,57171,3578769650,3578769650,0
1,1609,57172,3578769650,3578769650,0
1,1609,57173,3578769650,3578769650,0
1,1609,57174,3578769650,3578769650,0
1,1609,57175,3578769650,3578769650,0
1,1609,57176,3578769650,3578769650,0
1,1609,57177,3578769650,3578769651,1
1,1609,57178,3578769650,3578769652,2
1,1609,57179,3578769650,3578769653,3
1,1609,57180,3578769650,3578769654,4
1,1609,57181,3578769650,3578769654,4
1,1609,57182,3578769650,3578769656,6
1,1609,57183,3578769650,3578769656,6
1,1609,57184,3578769650,3578769657,7
1,1609,57185,3578769650,3578769657,7
1,1609,57186,3578769650,3578769657,7
1,1609,57187,3578769650,3578769658,8
1,1609,57188,3578769650,3578769659,9
1,1609,57189,3578769650,3578769661,11
1,1609,57190,3578769650,3578769662,12
1,1609,57191,3578769650,3578769663,13
1,1609,57192,3578769650,3578769666,16
1,1609,57193,3578769650,3578769667,17
1,1609,57194,3578769650,3578769667,17
1,1609,57195,3578769650,3578769668,18
1,1609,57196,3578769650,3578769670,20
1,1609,57197,3578769650,3578769685,35
1,1609,57198,3578769650,3578769686,36
1,1609,57199,3578769650,3578769686,36
1,1609,57200,3578769650,3578769688,38
1,1609,57201,3578769650,3578769688,38
1,1609,57202,3578769650,3578769688,38
1,1609,57203,3578769650,3578769691,41
1,1609,57204,3578769650,3578769691,41
1,1609,57205,3578769650,3578769693,43
1,1609,57206,3578769650,3578769694,44
1,1609,57207,3578769650,3578769695,45
1,1609,57208,3578769650,3578769695,45
1,1609,57209,3578769650,3578769695,45
1,1609,57210,3578769650,3578769696,46
1,1609,57211,3578769650,3578769696,46
1,1609,57212,3578769650,3578769696,46
1,1609,57213,3578769650,3578769696,46
1,1609,57214,3578769650,3578769698,48
1,1609,57215,3578769650,3578769698,48
1,1609,57216,3578769650,3578769699,49
1,1609,57217,3578769650,3578769699,49
1,1610,57218,3578769716,3578769716,0
1,1610,57219,3578769716,3578769716,0
1,1610,57220,3578769716,3578769716,0
1,1610,57221,3578769716,3578769716,0
1,1610,57222,3578769716,3578769716,0
1,1610,57223,3578769716,3578769716,0
1,1610,57224,3578769716,3578769716,0
1,1610,57225,3578769716,3578769716,0
1,1610,57226,3578769716,3578769716,0
1,1610,57227,3578769716,3578769716,0
1,1610,57228,3578769716,3578769716,0
1,1610,57229,3578769716,3578769716,0
1,1610,57230,3578769716,3578769716,0
1,1610,57231,3578769716,3578769716,0
1,1610,57232,3578769716,3578769716,0
1,1610,57233,3578769716,3578769716,0
1,1610,57234,3578769716,3578769716,0
1,1610,57235,3578769716,3578769716,0
1,1610,57236,3578769716,3578769716,0
1,1610,57237,3578769716,3578769716,0
1,1610,57238,3578769716,3578769716,0
1,1610,57239,3578769716,3578769716,0
1,1610,57240,3578769716,3578769716,0
1,1610,57241,3578769716,3578769716,0
1,1610,57242,3578769716,3578769716,0
1,1610,57243,3578769716,3578769716,0
1,1610,57244,3578769716,3578769716,0
1,1610,57245,3578769716,3578769716,0
1,1610,57246,3578769716,3578769718,2
1,1610,57247,3578769716,3578769719,3
1,1610,57248,3578769716,3578769719,3
1,1610,57249,3578769716,3578769720,4
1,1610,57250,3578769716,3578769720,4
1,1610,57251,3578769716,3578769721,5
1,1610,57252,3578769716,3578769721,5
1,1610,57253,3578769716,3578769721,5
1,1610,57254,3578769716,3578769721,5
1,1610,57255,3578769716,3578769721,5
1,1610,57256,3578769716,3578769724,8
1,1610,57257,3578769716,3578769725,9
1,1610,57258,3578769716,3578769726,10
1,1610,57259,3578769716,3578769726,10
1,1610,57260,3578769716,3578769727,11
1,1610,57261,3578769716,3578769728,12
1,1610,57262,3578769716,3578769728,12
1,1610,57263,3578769716,3578769728,12
1,1610,57264,3578769716,3578769729,13
1,1610,57265,3578769716,3578769730,14
1,1610,57266,3578769716,3578769731,15
1,1610,57267,3578769716,3578769732,16
1,1610,57268,3578769716,3578769732,16
1,1610,57269,3578769716,3578769732,16
1,1610,57270,3578769716,3578769733,17
1,1610,57271,3578769716,3578769733,17
1,1610,57272,3578769716,3578769733,17
1,1610,57273,3578769716,3578769734,18
1,1610,57274,3578769716,3578769735,19
1,1610,57275,3578769716,3578769736,20
1,1610,57276,3578769716,3578769737,21
1,1610,57277,3578769716,3578769737,21
1,1610,57278,3578769716,3578769740,24
1,1610,57279,3578769716,3578769741,25
1,1610,57280,3578769716,3578769743,27
1,1610,57281,3578769716,3578769745,29
1,1610,57282,3578769716,3578769745,29
1,1610,57283,3578769716,3578769748,32
1,1610,57284,3578769716,3578769748,32
1,1610,57285,3578769716,3578769750,34
1,1610,57286,3578769716,3578769750,34
1,1610,57287,3578769716,3578769755,39
1,1610,57288,3578769716,3578769755,39
1,1610,57289,3578769716,3578769756,40
1,1610,57290,3578769716,3578769756,40
1,1610,57291,3578769716,3578769762,46
1,1610,57292,3578769716,3578769762,46
1,1610,57293,3578769716,3578769762,46
1,1610,57294,3578769716,3578769764,48
1,1610,57295,3578769716,3578769764,48
1,1610,57296,3578769716,3578769765,49
1,1610,57297,3578769716,3578769765,49
1,1610,57298,3578769716,3578769765,49
1,1610,57299,3578769716,3578769765,49
1,1610,57300,3578769716,3578769766,50
1,1611,57301,3578769781,3578769781,0
1,1611,57302,3578769781,3578769781,0
1,1611,57303,3578769781,3578769781,0
1,1611,57304,3578769781,3578769781,0
1,1611,57305,3578769781,3578769781,0
1,1611,57306,3578769781,3578769781,0
1,1611,57307,3578769781,3578769781,0
1,1611,57308,3578769781,3578769781,0
1,1611,57309,3578769781,3578769781,0
1,1611,57310,3578769781,3578769781,0
1,1611,57311,3578769781,3578769781,0
1,1611,57312,3578769781,3578769781,0
1,1611,57313,3578769781,3578769781,0
1,1611,57314,3578769781,3578769781,0
1,1611,57315,3578769781,3578769781,0
1,1611,57316,3578769781,3578769781,0
1,1611,57317,3578769781,3578769781,0
1,1611,57318,3578769781,3578769781,0
1,1611,57319,3578769781,3578769781,0
1,1611,57320,3578769781,3578769781,0
1,1611,57321,3578769781,3578769785,4
1,1611,57322,3578769781,3578769785,4
1,1611,57323,3578769781,3578769790,9
1,1611,57324,3578769781,3578769791,10
1,1611,57325,3578769781,3578769791,10
1,1611,57326,3578769781,3578769791,10
1,1611,57327,3578769781,3578769793,12
1,1611,57328,3578769781,3578769793,12
1,1611,57329,3578769781,3578769795,14
1,1611,57330,3578769781,3578769796,15
1,1611,57331,3578769781,3578769796,15
1,1611,57332,3578769781,3578769796,15
1,1611,57333,3578769781,3578769798,17
1,1611,57334,3578769781,3578769798,17
1,1611,57335,3578769781,3578769798,17
1,1611,57336,3578769781,3578769799,18
1,1611,57337,3578769781,3578769801,20
1,1611,57338,3578769781,3578769804,23
1,1611,57339,3578769781,3578769804,23
1,1611,57340,3578769781,3578769805,24
1,1611,57341,3578769781,3578769809,28
1,1611,57342,3578769781,3578769810,29
1,1611,57343,3578769781,3578769810,29
1,1611,57344,3578769781,3578769811,30
1,1611,57345,3578769781,3578769812,31
1,1611,57346,3578769781,3578769813,32
1,1611,57347,3578769781,3578769813,32
1,1611,57348,3578769781,3578769813,32
1,1611,57349,3578769781,3578769813,32
1,1611,57350,3578769781,3578769815,34
1,1611,57351,3578769781,3578769815,34
1,1611,57352,3578769781,3578769816,35
1,1611,57353,3578769781,3578769816,35
1,1611,57354,3578769781,3578769817,36
1,1611,57355,3578769781,3578769817,36
1,1611,57356,3578769781,3578769818,37
1,1611,57357,3578769781,3578769819,38
1,1611,57358,3578769781,3578769819,38
1,1611,57359,3578769781,3578769822,41
1,1611,57360,3578769781,3578769822,41
1,1611,57361,3578769781,3578769824,43
1,1611,57362,3578769781,3578769825,44
1,1611,57363,3578769781,3578769826,45
1,1611,57364,3578769781,3578769827,46
1,1611,57365,3578769781,3578769827,46
1,1611,57366,3578769781,3578769828,47
1,1611,57367,3578769781,3578769830,49
1,1611,57368,3578769781,3578769830,49
1,1611,57369,3578769781,3578769830,49
1,1612,57370,3578769847,3578769847,0
1,1612,57371,3578769847,3578769847,0
1,1612,57372,3578769847,3578769847,0
1,1612,57373,3578769847,3578769847,0
1,1612,57374,3578769847,3578769848,1
1,1612,57375,3578769847,3578769848,1
1,1612,57376,3578769847,3578769848,1
1,1612,57377,3578769847,3578769848,1
1,1612,57378,3578769847,3578769848,1
1,1612,57379,3578769847,3578769848,1
1,1612,57380,3578769847,3578769848,1
1,1612,57381,3578769847,3578769848,1
1,1612,57382,3578769847,3578769848,1
1,1612,57383,3578769847,3578769848,1
1,1612,57384,3578769847,3578769849,2
1,1612,57385,3578769847,3578769849,2
1,1612,57386,3578769847,3578769849,2
1,1612,57387,3578769847,3578769852,5
1,1612,57388,3578769847,3578769852,5
1,1612,57389,3578769847,3578769853,6
1,1612,57390,3578769847,3578769854,7
1,1612,57391,3578769847,3578769854,7
1,1612,57392,3578769847,3578769854,7
1,1612,57393,3578769847,3578769856,9
1,1612,57394,3578769847,3578769857,10
1,1612,57395,3578769847,3578769857,10
1,1612,57396,3578769847,3578769859,12
1,1612,57397,3578769847,3578769861,14
1,1612,57398,3578769847,3578769862,15
1,1612,57399,3578769847,3578769863,16
1,1612,57400,3578769847,3578769867,20
1,1612,57401,3578769847,3578769867,20
1,1612,57402,3578769847,3578769867,20
1,1612,57403,3578769847,3578769869,22
1,1612,57404,3578769847,3578769869,22
1,1612,57405,3578769847,3578769870,23
1,1612,57406,3578769847,3578769884,37
1,1612,57407,3578769847,3578769886,39
1,1612,57408,3578769847,3578769886,39
1,1612,57409,3578769847,3578769887,40
1,1612,57410,3578769847,3578769888,41
1,1612,57411,3578769847,3578769888,41
1,1612,57412,3578769847,3578769888,41
1,1612,57413,3578769847,3578769890,43
1,1612,57414,3578769847,3578769891,44
1,1612,57415,3578769847,3578769892,45
1,1612,57416,3578769847,3578769893,46
1,1612,57417,3578769847,3578769893,46
1,1612,57418,3578769847,3578769895,48
1,1612,57419,3578769847,3578769895,48
1,1612,57420,3578769847,3578769895,48
1,1612,57421,3578769847,3578769895,48
1,1612,57422,3578769847,3578769896,49
1,1612,57423,3578769847,3578769897,50
1,1613,57424,3578769913,3578769913,0
1,1613,57425,3578769913,3578769913,0
1,1613,57426,3578769913,3578769913,0
1,1613,57427,3578769913,3578769913,0
1,1613,57428,3578769913,3578769913,0
1,1613,57429,3578769913,3578769913,0
1,1613,57430,3578769913,3578769913,0
1,1613,57431,3578769913,3578769913,0
1,1613,57432,3578769913,3578769913,0
1,1613,57433,3578769913,3578769913,0
1,1613,57434,3578769913,3578769913,0
1,1613,57435,3578769913,3578769913,0
1,1613,57436,3578769913,3578769913,0
1,1613,57437,3578769913,3578769913,0
1,1613,57438,3578769913,3578769913,0
1,1613,57439,3578769913,3578769913,0
1,1613,57440,3578769913,3578769913,0
1,1613,57441,3578769913,3578769913,0
1,1613,57442,3578769913,3578769913,0
1,1613,57443,3578769913,3578769913,0
1,1613,57444,3578769913,3578769913,0
1,1613,57445,3578769913,3578769913,0
1,1613,57446,3578769913,3578769913,0
1,1613,57447,3578769913,3578769913,0
1,1613,57448,3578769913,3578769913,0
1,1613,57449,3578769913,3578769914,1
1,1613,57450,3578769913,3578769914,1
1,1613,57451,3578769913,3578769917,4
1,1613,57452,3578769913,3578769919,6
1,1613,57453,3578769913,3578769919,6
1,1613,57454,3578769913,3578769920,7
1,1613,57455,3578769913,3578769921,8
1,1613,57456,3578769913,3578769921,8
1,1613,57457,3578769913,3578769921,8
1,1613,57458,3578769913,3578769921,8
1,1613,57459,3578769913,3578769921,8
1,1613,57460,3578769913,3578769921,8
1,1613,57461,3578769913,3578769923,10
1,1613,57462,3578769913,3578769924,11
1,1613,57463,3578769913,3578769926,13
1,1613,57464,3578769913,3578769926,13
1,1613,57465,3578769913,3578769926,13
1,1613,57466,3578769913,3578769928,15
1,1613,57467,3578769913,3578769928,15
1,1613,57468,3578769913,3578769929,16
1,1613,57469,3578769913,3578769929,16
1,1613,57470,3578769913,3578769931,18
1,1613,57471,3578769913,3578769931,18
1,1613,57472,3578769913,3578769931,18
1,1613,57473,3578769913,3578769932,19
1,1613,57474,3578769913,3578769933,20
1,1613,57475,3578769913,3578769933,20
1,1613,57476,3578769913,3578769934,21
1,1613,57477,3578769913,3578769934,21
1,1613,57478,3578769913,3578769935,22
1,1613,57479,3578769913,3578769935,22
1,1613,57480,3578769913,3578769936,23
1,1613,57481,3578769913,3578769937,24
1,1613,57482,3578769913,3578769940,27
1,1613,57483,3578769913,3578769941,28
1,1613,57484,3578769913,3578769944,31
1,1613,57485,3578769913,3578769945,32
1,1613,57486,3578769913,3578769947,34
1,1613,57487,3578769913,3578769948,35
1,1613,57488,3578769913,3578769948,35
1,1613,57489,3578769913,3578769950,37
1,1613,57490,3578769913,3578769950,37
1,1613,57491,3578769913,3578769954,41
1,1613,57492,3578769913,3578769954,41
1,1613,57493,3578769913,3578769955,42
1,1613,57494,3578769913,3578769955,42
1,1613,57495,3578769913,3578769956,43
1,1613,57496,3578769913,3578769956,43
1,1613,57497,3578769913,3578769958,45
1,1613,57498,3578769913,3578769960,47
1,1614,57499,3578769979,3578769979,0
1,1614,57500,3578769979,3578769979,0
1,1614,57501,3578769979,3578769979,0
1,1614,57502,3578769979,3578769979,0
1,1614,57503,3578769979,3578769979,0
1,1614,57504,3578769979,3578769979,0
1,1614,57505,3578769979,3578769979,0
1,1614,57506,3578769979,3578769979,0
1,1614,57507,3578769979,3578769979,0
1,1614,57508,3578769979,3578769979,0
1,1614,57509,3578769979,3578769979,0
1,1614,57510,3578769979,3578769979,0
1,1614,57511,3578769979,3578769979,0
1,1614,57512,3578769979,3578769979,0
1,1614,57513,3578769979,3578769979,0
1,1614,57514,3578769979,3578769979,0
1,1614,57515,3578769979,3578769979,0
1,1614,57516,3578769979,3578769979,0
1,1614,57517,3578769979,3578769979,0
1,1614,57518,3578769979,3578769979,0
1,1614,57519,3578769979,3578769979,0
1,1614,57520,3578769979,3578769980,1
1,1614,57521,3578769979,3578769981,2
1,1614,57522,3578769979,3578769981,2
1,1614,57523,3578769979,3578769981,2
1,1614,57524,3578769979,3578769982,3
1,1614,57525,3578769979,3578769984,5
1,1614,57526,3578769979,3578769986,7
1,1614,57527,3578769979,3578769986,7
1,1614,57528,3578769979,3578769990,11
1,1614,57529,3578769979,3578769990,11
1,1614,57530,3578769979,3578769991,12
1,1614,57531,3578769979,3578769991,12
1,1614,57532,3578769979,3578769992,13
1,1614,57533,3578769979,3578769993,14
1,1614,57534,3578769979,3578769993,14
1,1614,57535,3578769979,3578769995,16
1,1614,57536,3578769979,3578769996,17
1,1614,57537,3578769979,3578769996,17
1,1614,57538,3578769979,3578769997,18
1,1614,57539,3578769979,3578769998,19
1,1614,57540,3578769979,3578769999,20
1,1614,57541,3578769979,3578769999,20
1,1614,57542,3578769979,3578770000,21
1,1614,57543,3578769979,3578770001,22
1,1614,57544,3578769979,3578770002,23
1,1614,57545,3578769979,3578770004,25
1,1614,57546,3578769979,3578770004,25
1,1614,57547,3578769979,3578770005,26
1,1614,57548,3578769979,3578770006,27
1,1614,57549,3578769979,3578770010,31
1,1614,57550,3578769979,3578770010,31
1,1614,57551,3578769979,3578770011,32
1,1614,57552,3578769979,3578770012,33
1,1614,57553,3578769979,3578770013,34
1,1614,57554,3578769979,3578770014,35
1,1614,57555,3578769979,3578770014,35
1,1614,57556,3578769979,3578770014,35
1,1614,57557,3578769979,3578770015,36
1,1614,57558,3578769979,3578770016,37
1,1614,57559,3578769979,3578770016,37
1,1614,57560,3578769979,3578770016,37
1,1614,57561,3578769979,3578770017,38
1,1614,57562,3578769979,3578770018,39
1,1614,57563,3578769979,3578770018,39
1,1614,57564,3578769979,3578770019,40
1,1614,57565,3578769979,3578770021,42
1,1614,57566,3578769979,3578770022,43
1,1614,57567,3578769979,3578770022,43
1,1614,57568,3578769979,3578770024,45
1,1614,57569,3578769979,3578770024,45
1,1614,57570,3578769979,3578770025,46
1,1614,57571,3578769979,3578770028,49
1,1614,57572,3578769979,3578770028,49
1,1614,57573,3578769979,3578770028,49
1,1615,57574,3578770044,3578770044,0
1,1615,57575,3578770044,3578770044,0
1,1615,57576,3578770044,3578770044,0
1,1615,57577,3578770044,3578770044,0
1,1615,57578,3578770044,3578770044,0
1,1615,57579,3578770044,3578770044,0
1,1615,57580,3578770044,3578770044,0
1,1615,57581,3578770044,3578770044,0
1,1615,57582,3578770044,3578770044,0
1,1615,57583,3578770044,3578770044,0
1,1615,57584,3578770044,3578770044,0
1,1615,57585,3578770044,3578770044,0
1,1615,57586,3578770044,3578770044,0
1,1615,57587,3578770044,3578770044,0
1,1615,57588,3578770044,3578770046,2
1,1615,57589,3578770044,3578770049,5
1,1615,57590,3578770044,3578770049,5
1,1615,57591,3578770044,3578770049,5
1,1615,57592,3578770044,3578770051,7
1,1615,57593,3578770044,3578770051,7
1,1615,57594,3578770044,3578770052,8
1,1615,57595,3578770044,3578770053,9
1,1615,57596,3578770044,3578770055,11
1,1615,57597,3578770044,3578770056,12
1,1615,57598,3578770044,3578770056,12
1,1615,57599,3578770044,3578770057,13
1,1615,57600,3578770044,3578770057,13
1,1615,57601,3578770044,3578770062,18
1,1615,57602,3578770044,3578770063,19
1,1615,57603,3578770044,3578770063,19
1,1615,57604,3578770044,3578770065,21
1,1615,57605,3578770044,3578770066,22
1,1615,57606,3578770044,3578770066,22
1,1615,57607,3578770044,3578770067,23
1,1615,57608,3578770044,3578770068,24
1,1615,57609,3578770044,3578770068,24
1,1615,57610,3578770044,3578770069,25
1,1615,57611,3578770044,3578770071,27
1,1615,57612,3578770044,3578770084,40
1,1615,57613,3578770044,3578770084,40
1,1615,57614,3578770044,3578770086,42
1,1615,57615,3578770044,3578770087,43
1,1615,57616,3578770044,3578770087,43
1,1615,57617,3578770044,3578770088,44
1,1615,57618,3578770044,3578770088,44
1,1615,57619,3578770044,3578770088,44
1,1615,57620,3578770044,3578770090,46
1,1615,57621,3578770044,3578770091,47
1,1615,57622,3578770044,3578770093,49
1,1615,57623,3578770044,3578770093,49
1,1616,57624,3578770109,3578770109,0
1,1616,57625,3578770109,3578770109,0
1,1616,57626,3578770109,3578770109,0
1,1616,57627,3578770109,3578770109,0
1,1616,57628,3578770109,3578770109,0
1,1616,57629,3578770109,3578770109,0
1,1616,57630,3578770109,3578770109,0
1,1616,57631,3578770109,3578770109,0
1,1616,57632,3578770109,3578770109,0
1,1616,57633,3578770109,3578770109,0
1,1616,57634,3578770109,3578770109,0
1,1616,57635,3578770109,3578770109,0
1,1616,57636,3578770109,3578770109,0
1,1616,57637,3578770109,3578770109,0
1,1616,57638,3578770109,3578770109,0
1,1616,57639,3578770109,3578770109,0
1,1616,57640,3578770109,3578770109,0
1,1616,57641,3578770109,3578770109,0
1,1616,57642,3578770109,3578770109,0
1,1616,57643,3578770109,3578770109,0
1,1616,57644,3578770109,3578770109,0
1,1616,57645,3578770109,3578770109,0
1,1616,57646,3578770109,3578770109,0
1,1616,57647,3578770109,3578770109,0
1,1616,57648,3578770109,3578770110,1
1,1616,57649,3578770109,3578770110,1
1,1616,57650,3578770109,3578770110,1
1,1616,57651,3578770109,3578770112,3
1,1616,57652,3578770109,3578770112,3
1,1616,57653,3578770109,3578770113,4
1,1616,57654,3578770109,3578770114,5
1,1616,57655,3578770109,3578770114,5
1,1616,57656,3578770109,3578770115,6
1,1616,57657,3578770109,3578770117,8
1,1616,57658,3578770109,3578770120,11
1,1616,57659,3578770109,3578770120,11
1,1616,57660,3578770109,3578770121,12
1,1616,57661,3578770109,3578770121,12
1,1616,57662,3578770109,3578770121,12
1,1616,57663,3578770109,3578770121,12
1,1616,57664,3578770109,3578770122,13
1,1616,57665,3578770109,3578770123,14
1,1616,57666,3578770109,3578770124,15
1,1616,57667,3578770109,3578770126,17
1,1616,57668,3578770109,3578770126,17
1,1616,57669,3578770109,3578770127,18
1,1616,57670,3578770109,3578770127,18
1,1616,57671,3578770109,3578770127,18
1,1616,57672,3578770109,3578770128,19
1,1616,57673,3578770109,3578770128,19
1,1616,57674,3578770109,3578770129,20
1,1616,57675,3578770109,3578770131,22
1,1616,57676,3578770109,3578770131,22
1,1616,57677,3578770109,3578770132,23
1,1616,57678,3578770109,3578770132,23
1,1616,57679,3578770109,3578770133,24
1,1616,57680,3578770109,3578770133,24
1,1616,57681,3578770109,3578770134,25
1,1616,57682,3578770109,3578770134,25
1,1616,57683,3578770109,3578770136,27
1,1616,57684,3578770109,3578770137,28
1,1616,57685,3578770109,3578770138,29
1,1616,57686,3578770109,3578770138,29
1,1616,57687,3578770109,3578770139,30
1,1616,57688,3578770109,3578770140,31
1,1616,57689,3578770109,3578770141,32
1,1616,57690,3578770109,3578770143,34
1,1616,57691,3578770109,3578770148,39
1,1616,57692,3578770109,3578770148,39
1,1616,57693,3578770109,3578770150,41
1,1616,57694,3578770109,3578770150,41
1,1616,57695,3578770109,3578770151,42
1,1616,57696,3578770109,3578770151,42
1,1616,57697,3578770109,3578770153,44
1,1616,57698,3578770109,3578770154,45
1,1616,57699,3578770109,3578770155,46
1,1616,57700,3578770109,3578770156,47
1,1616,57701,3578770109,3578770156,47
1,1616,57702,3578770109,3578770156,47
1,1616,57703,3578770109,3578770158,49
1,1617,57704,3578770173,3578770173,0
1,1617,57705,3578770173,3578770173,0
1,1617,57706,3578770173,3578770173,0
1,1617,57707,3578770173,3578770173,0
1,1617,57708,3578770173,3578770173,0
1,1617,57709,3578770173,3578770173,0
1,1617,57710,3578770173,3578770173,0
1,1617,57711,3578770173,3578770173,0
1,1617,57712,3578770173,3578770173,0
1,1617,57713,3578770173,3578770173,0
1,1617,57714,3578770173,3578770173,0
1,1617,57715,3578770173,3578770173,0
1,1617,57716,3578770173,3578770173,0
1,1617,57717,3578770173,3578770173,0
1,1617,57718,3578770173,3578770173,0
1,1617,57719,3578770173,3578770173,0
1,1617,57720,3578770173,3578770174,1
1,1617,57721,3578770173,3578770175,2
1,1617,57722,3578770173,3578770176,3
1,1617,57723,3578770173,3578770176,3
1,1617,57724,3578770173,3578770177,4
1,1617,57725,3578770173,3578770178,5
1,1617,57726,3578770173,3578770178,5
1,1617,57727,3578770173,3578770179,6
1,1617,57728,3578770173,3578770181,8
1,1617,57729,3578770173,3578770181,8
1,1617,57730,3578770173,3578770181,8
1,1617,57731,3578770173,3578770181,8
1,1617,57732,3578770173,3578770181,8
1,1617,57733,3578770173,3578770182,9
1,1617,57734,3578770173,3578770184,11
1,1617,57735,3578770173,3578770186,13
1,1617,57736,3578770173,3578770186,13
1,1617,57737,3578770173,3578770188,15
1,1617,57738,3578770173,3578770189,16
1,1617,57739,3578770173,3578770190,17
1,1617,57740,3578770173,3578770191,18
1,1617,57741,3578770173,3578770192,19
1,1617,57742,3578770173,3578770193,20
1,1617,57743,3578770173,3578770195,22
1,1617,57744,3578770173,3578770196,23
1,1617,57745,3578770173,3578770196,23
1,1617,57746,3578770173,3578770197,24
1,1617,57747,3578770173,3578770199,26
1,1617,57748,3578770173,3578770199,26
1,1617,57749,3578770173,3578770199,26
1,1617,57750,3578770173,3578770200,27
1,1617,57751,3578770173,3578770200,27
1,1617,57752,3578770173,3578770201,28
1,1617,57753,3578770173,3578770202,29
1,1617,57754,3578770173,3578770203,30
1,1617,57755,3578770173,3578770204,31
1,1617,57756,3578770173,3578770204,31
1,1617,57757,3578770173,3578770205,32
1,1617,57758,3578770173,3578770210,37
1,1617,57759,3578770173,3578770210,37
1,1617,57760,3578770173,3578770212,39
1,1617,57761,3578770173,3578770213,40
1,1617,57762,3578770173,3578770214,41
1,1617,57763,3578770173,3578770214,41
1,1617,57764,3578770173,3578770215,42
1,1617,57765,3578770173,3578770216,43
1,1617,57766,3578770173,3578770216,43
1,1617,57767,3578770173,3578770216,43
1,1617,57768,3578770173,3578770217,44
1,1617,57769,3578770173,3578770217,44
1,1617,57770,3578770173,3578770218,45
1,1617,57771,3578770173,3578770219,46
1,1617,57772,3578770173,3578770222,49
1,1617,57773,3578770173,3578770222,49
1,1617,57774,3578770173,3578770222,49
1,1618,57775,3578770239,3578770239,0
1,1618,57776,3578770239,3578770239,0
1,1618,57777,3578770239,3578770239,0
1,1618,57778,3578770239,3578770239,0
1,1618,57779,3578770239,3578770239,0
1,1618,57780,3578770239,3578770239,0
1,1618,57781,3578770239,3578770239,0
1,1618,57782,3578770239,3578770239,0
1,1618,57783,3578770239,3578770239,0
1,1618,57784,3578770239,3578770239,0
1,1618,57785,3578770239,3578770239,0
1,1618,57786,3578770239,3578770239,0
1,1618,57787,3578770239,3578770239,0
1,1618,57788,3578770239,3578770239,0
1,1618,57789,3578770239,3578770239,0
1,1618,57790,3578770239,3578770239,0
1,1618,57791,3578770239,3578770239,0
1,1618,57792,3578770239,3578770239,0
1,1618,57793,3578770239,3578770239,0
1,1618,57794,3578770239,3578770241,2
1,1618,57795,3578770239,3578770244,5
1,1618,57796,3578770239,3578770249,10
1,1618,57797,3578770239,3578770249,10
1,1618,57798,3578770239,3578770250,11
1,1618,57799,3578770239,3578770251,12
1,1618,57800,3578770239,3578770252,13
1,1618,57801,3578770239,3578770253,14
1,1618,57802,3578770239,3578770254,15
1,1618,57803,3578770239,3578770254,15
1,1618,57804,3578770239,3578770257,18
1,1618,57805,3578770239,3578770257,18
1,1618,57806,3578770239,3578770257,18
1,1618,57807,3578770239,3578770257,18
1,1618,57808,3578770239,3578770260,21
1,1618,57809,3578770239,3578770263,24
1,1618,57810,3578770239,3578770263,24
1,1618,57811,3578770239,3578770264,25
1,1618,57812,3578770239,3578770265,26
1,1618,57813,3578770239,3578770266,27
1,1618,57814,3578770239,3578770267,28
1,1618,57815,3578770239,3578770268,29
1,1618,57816,3578770239,3578770268,29
1,1618,57817,3578770239,3578770268,29
1,1618,57818,3578770239,3578770269,30
1,1618,57819,3578770239,3578770270,31
1,1618,57820,3578770239,3578770281,42
1,1618,57821,3578770239,3578770283,44
1,1618,57822,3578770239,3578770284,45
1,1618,57823,3578770239,3578770285,46
1,1618,57824,3578770239,3578770287,48
1,1618,57825,3578770239,3578770287,48
1,1618,57826,3578770239,3578770288,49
1,1618,57827,3578770239,3578770288,49
1,1618,57828,3578770239,3578770289,50
1,1619,57829,3578770305,3578770305,0
1,1619,57830,3578770305,3578770305,0
1,1619,57831,3578770305,3578770305,0
1,1619,57832,3578770305,3578770305,0
1,1619,57833,3578770305,3578770305,0
1,1619,57834,3578770305,3578770305,0
1,1619,57835,3578770305,3578770305,0
1,1619,57836,3578770305,3578770305,0
1,1619,57837,3578770305,3578770305,0
1,1619,57838,3578770305,3578770305,0
1,1619,57839,3578770305,3578770305,0
1,1619,57840,3578770305,3578770305,0
1,1619,57841,3578770305,3578770305,0
1,1619,57842,3578770305,3578770305,0
1,1619,57843,3578770305,3578770305,0
1,1619,57844,3578770305,3578770305,0
1,1619,57845,3578770305,3578770305,0
1,1619,57846,3578770305,3578770305,0
1,1619,57847,3578770305,3578770305,0
1,1619,57848,3578770305,3578770305,0
1,1619,57849,3578770305,3578770305,0
1,1619,57850,3578770305,3578770305,0
1,1619,57851,3578770305,3578770305,0
1,1619,57852,3578770305,3578770305,0
1,1619,57853,3578770305,3578770305,0
1,1619,57854,3578770305,3578770305,0
1,1619,57855,3578770305,3578770306,1
1,1619,57856,3578770305,3578770308,3
1,1619,57857,3578770305,3578770308,3
1,1619,57858,3578770305,3578770310,5
1,1619,57859,3578770305,3578770311,6
1,1619,57860,3578770305,3578770311,6
1,1619,57861,3578770305,3578770312,7
1,1619,57862,3578770305,3578770312,7
1,1619,57863,3578770305,3578770313,8
1,1619,57864,3578770305,3578770313,8
1,1619,57865,3578770305,3578770314,9
1,1619,57866,3578770305,3578770314,9
1,1619,57867,3578770305,3578770314,9
1,1619,57868,3578770305,3578770314,9
1,1619,57869,3578770305,3578770317,12
1,1619,57870,3578770305,3578770320,15
1,1619,57871,3578770305,3578770321,16
1,1619,57872,3578770305,3578770321,16
1,1619,57873,3578770305,3578770321,16
1,1619,57874,3578770305,3578770321,16
1,1619,57875,3578770305,3578770323,18
1,1619,57876,3578770305,3578770324,19
1,1619,57877,3578770305,3578770326,21
1,1619,57878,3578770305,3578770326,21
1,1619,57879,3578770305,3578770326,21
1,1619,57880,3578770305,3578770327,22
1,1619,57881,3578770305,3578770327,22
1,1619,57882,3578770305,3578770328,23
1,1619,57883,3578770305,3578770328,23
1,1619,57884,3578770305,3578770329,24
1,1619,57885,3578770305,3578770331,26
1,1619,57886,3578770305,3578770331,26
1,1619,57887,3578770305,3578770331,26
1,1619,57888,3578770305,3578770331,26
1,1619,57889,3578770305,3578770332,27
1,1619,57890,3578770305,3578770333,28
1,1619,57891,3578770305,3578770334,29
1,1619,57892,3578770305,3578770334,29
1,1619,57893,3578770305,3578770334,29
1,1619,57894,3578770305,3578770335,30
1,1619,57895,3578770305,3578770337,32
1,1619,57896,3578770305,3578770338,33
1,1619,57897,3578770305,3578770338,33
1,1619,57898,3578770305,3578770339,34
1,1619,57899,3578770305,3578770341,36
1,1619,57900,3578770305,3578770343,38
1,1619,57901,3578770305,3578770348,43
1,1619,57902,3578770305,3578770348,43
1,1619,57903,3578770305,3578770350,45
1,1619,57904,3578770305,3578770350,45
1,1619,57905,3578770305,3578770350,45
1,1619,57906,3578770305,3578770351,46
1,1619,57907,3578770305,3578770354,49
1,1619,57908,3578770305,3578770354,49
1,1620,57909,3578770369,3578770369,0
1,1620,57910,3578770369,3578770369,0
1,1620,57911,3578770369,3578770369,0
1,1620,57912,3578770369,3578770369,0
1,1620,57913,3578770369,3578770369,0
1,1620,57914,3578770369,3578770369,0
1,1620,57915,3578770369,3578770369,0
1,1620,57916,3578770369,3578770369,0
1,1620,57917,3578770369,3578770369,0
1,1620,57918,3578770369,3578770369,0
1,1620,57919,3578770369,3578770369,0
1,1620,57920,3578770369,3578770369,0
1,1620,57921,3578770369,3578770369,0
1,1620,57922,3578770369,3578770369,0
1,1620,57923,3578770369,3578770369,0
1,1620,57924,3578770369,3578770369,0
1,1620,57925,3578770369,3578770369,0
1,1620,57926,3578770369,3578770369,0
1,1620,57927,3578770369,3578770369,0
1,1620,57928,3578770369,3578770369,0
1,1620,57929,3578770369,3578770370,1
1,1620,57930,3578770369,3578770370,1
1,1620,57931,3578770369,3578770371,2
1,1620,57932,3578770369,3578770374,5
1,1620,57933,3578770369,3578770375,6
1,1620,57934,3578770369,3578770375,6
1,1620,57935,3578770369,3578770377,8
1,1620,57936,3578770369,3578770377,8
1,1620,57937,3578770369,3578770378,9
1,1620,57938,3578770369,3578770378,9
1,1620,57939,3578770369,3578770380,11
1,1620,57940,3578770369,3578770381,12
1,1620,57941,3578770369,3578770381,12
1,1620,57942,3578770369,3578770381,12
1,1620,57943,3578770369,3578770382,13
1,1620,57944,3578770369,3578770382,13
1,1620,57945,3578770369,3578770382,13
1,1620,57946,3578770369,3578770384,15
1,1620,57947,3578770369,3578770386,17
1,1620,57948,3578770369,3578770386,17
1,1620,57949,3578770369,3578770389,20
1,1620,57950,3578770369,3578770389,20
1,1620,57951,3578770369,3578770390,21
1,1620,57952,3578770369,3578770391,22
1,1620,57953,3578770369,3578770392,23
1,1620,57954,3578770369,3578770393,24
1,1620,57955,3578770369,3578770393,24
1,1620,57956,3578770369,3578770396,27
1,1620,57957,3578770369,3578770397,28
1,1620,57958,3578770369,3578770397,28
1,1620,57959,3578770369,3578770398,29
1,1620,57960,3578770369,3578770399,30
1,1620,57961,3578770369,3578770399,30
1,1620,57962,3578770369,3578770400,31
1,1620,57963,3578770369,3578770400,31
1,1620,57964,3578770369,3578770401,32
1,1620,57965,3578770369,3578770403,34
1,1620,57966,3578770369,3578770404,35
1,1620,57967,3578770369,3578770404,35
1,1620,57968,3578770369,3578770406,37
1,1620,57969,3578770369,3578770406,37
1,1620,57970,3578770369,3578770406,37
1,1620,57971,3578770369,3578770410,41
1,1620,57972,3578770369,3578770410,41
1,1620,57973,3578770369,3578770412,43
1,1620,57974,3578770369,3578770412,43
1,1620,57975,3578770369,3578770415,46
1,1620,57976,3578770369,3578770415,46
1,1620,57977,3578770369,3578770416,47
1,1620,57978,3578770369,3578770417,48
1,1620,57979,3578770369,3578770417,48
1,1620,57980,3578770369,3578770417,48
1,1620,57981,3578770369,3578770418,49
1,1620,57982,3578770369,3578770418,49
1,1620,57983,3578770369,3578770418,49
1,1620,57984,3578770369,3578770419,50
1,1621,57985,3578770434,3578770434,0
1,1621,57986,3578770434,3578770434,0
1,1621,57987,3578770434,3578770434,0
1,1621,57988,3578770434,3578770434,0
1,1621,57989,3578770434,3578770434,0
1,1621,57990,3578770434,3578770434,0
1,1621,57991,3578770434,3578770434,0
1,1621,57992,3578770434,3578770434,0
1,1621,57993,3578770434,3578770434,0
1,1621,57994,3578770434,3578770434,0
1,1621,57995,3578770434,3578770434,0
1,1621,57996,3578770434,3578770434,0
1,1621,57997,3578770434,3578770434,0
1,1621,57998,3578770434,3578770434,0
1,1621,57999,3578770434,3578770434,0
1,1621,58000,3578770434,3578770434,0
1,1621,58001,3578770434,3578770435,1
1,1621,58002,3578770434,3578770436,2
1,1621,58003,3578770434,3578770438,4
1,1621,58004,3578770434,3578770438,4
1,1621,58005,3578770434,3578770439,5
1,1621,58006,3578770434,3578770440,6
1,1621,58007,3578770434,3578770442,8
1,1621,58008,3578770434,3578770445,11
1,1621,58009,3578770434,3578770446,12
1,1621,58010,3578770434,3578770448,14
1,1621,58011,3578770434,3578770449,15
1,1621,58012,3578770434,3578770452,18
1,1621,58013,3578770434,3578770453,19
1,1621,58014,3578770434,3578770453,19
1,1621,58015,3578770434,3578770454,20
1,1621,58016,3578770434,3578770454,20
1,1621,58017,3578770434,3578770457,23
1,1621,58018,3578770434,3578770457,23
1,1621,58019,3578770434,3578770457,23
1,1621,58020,3578770434,3578770457,23
1,1621,58021,3578770434,3578770458,24
1,1621,58022,3578770434,3578770459,25
1,1621,58023,3578770434,3578770463,29
1,1621,58024,3578770434,3578770463,29
1,1621,58025,3578770434,3578770464,30
1,1621,58026,3578770434,3578770464,30
1,1621,58027,3578770434,3578770466,32
1,1621,58028,3578770434,3578770467,33
1,1621,58029,3578770434,3578770468,34
1,1621,58030,3578770434,3578770468,34
1,1621,58031,3578770434,3578770469,35
1,1621,58032,3578770434,3578770469,35
1,1621,58033,3578770434,3578770470,36
1,1621,58034,3578770434,3578770482,48
1,1621,58035,3578770434,3578770483,49
1,1621,58036,3578770434,3578770484,50
1,1622,58037,3578770500,3578770500,0
1,1622,58038,3578770500,3578770500,0
1,1622,58039,3578770500,3578770500,0
1,1622,58040,3578770500,3578770500,0
1,1622,58041,3578770500,3578770500,0
1,1622,58042,3578770500,3578770500,0
1,1622,58043,3578770500,3578770500,0
1,1622,58044,3578770500,3578770500,0
1,1622,58045,3578770500,3578770500,0
1,1622,58046,3578770500,3578770500,0
1,1622,58047,3578770500,3578770500,0
1,1622,58048,3578770500,3578770500,0
1,1622,58049,3578770500,3578770500,0
1,1622,58050,3578770500,3578770500,0
1,1622,58051,3578770500,3578770500,0
1,1622,58052,3578770500,3578770500,0
1,1622,58053,3578770500,3578770500,0
1,1622,58054,3578770500,3578770500,0
1,1622,58055,3578770500,3578770500,0
1,1622,58056,3578770500,3578770500,0
1,1622,58057,3578770500,3578770500,0
1,1622,58058,3578770500,3578770501,1
1,1622,58059,3578770500,3578770501,1
1,1622,58060,3578770500,3578770502,2
1,1622,58061,3578770500,3578770502,2
1,1622,58062,3578770500,3578770502,2
1,1622,58063,3578770500,3578770503,3
1,1622,58064,3578770500,3578770503,3
1,1622,58065,3578770500,3578770504,4
1,1622,58066,3578770500,3578770504,4
1,1622,58067,3578770500,3578770504,4
1,1622,58068,3578770500,3578770504,4
1,1622,58069,3578770500,3578770505,5
1,1622,58070,3578770500,3578770508,8
1,1622,58071,3578770500,3578770509,9
1,1622,58072,3578770500,3578770509,9
1,1622,58073,3578770500,3578770510,10
1,1622,58074,3578770500,3578770510,10
1,1622,58075,3578770500,3578770511,11
1,1622,58076,3578770500,3578770512,12
1,1622,58077,3578770500,3578770512,12
1,1622,58078,3578770500,3578770513,13
1,1622,58079,3578770500,3578770513,13
1,1622,58080,3578770500,3578770513,13
1,1622,58081,3578770500,3578770513,13
1,1622,58082,3578770500,3578770514,14
1,1622,58083,3578770500,3578770517,17
1,1622,58084,3578770500,3578770518,18
1,1622,58085,3578770500,3578770519,19
1,1622,58086,3578770500,3578770520,20
1,1622,58087,3578770500,3578770520,20
1,1622,58088,3578770500,3578770521,21
1,1622,58089,3578770500,3578770521,21
1,1622,58090,3578770500,3578770521,21
1,1622,58091,3578770500,3578770522,22
1,1622,58092,3578770500,3578770523,23
1,1622,58093,3578770500,3578770525,25
1,1622,58094,3578770500,3578770525,25
1,1622,58095,3578770500,3578770526,26
1,1622,58096,3578770500,3578770526,26
1,1622,58097,3578770500,3578770527,27
1,1622,58098,3578770500,3578770527,27
1,1622,58099,3578770500,3578770527,27
1,1622,58100,3578770500,3578770529,29
1,1622,58101,3578770500,3578770529,29
1,1622,58102,3578770500,3578770530,30
1,1622,58103,3578770500,3578770530,30
1,1622,58104,3578770500,3578770532,32
1,1622,58105,3578770500,3578770533,33
1,1622,58106,3578770500,3578770533,33
1,1622,58107,3578770500,3578770533,33
1,1622,58108,3578770500,3578770534,34
1,1622,58109,3578770500,3578770536,36
1,1622,58110,3578770500,3578770537,37
1,1622,58111,3578770500,3578770537,37
1,1622,58112,3578770500,3578770538,38
1,1622,58113,3578770500,3578770540,40
1,1622,58114,3578770500,3578770542,42
1,1622,58115,3578770500,3578770547,47
1,1622,58116,3578770500,3578770547,47
1,1622,58117,3578770500,3578770548,48
1,1622,58118,3578770500,3578770549,49
1,1622,58119,3578770500,3578770549,49
1,1622,58120,3578770500,3578770550,50
1,1623,58121,3578770565,3578770565,0
1,1623,58122,3578770565,3578770565,0
1,1623,58123,3578770565,3578770565,0
1,1623,58124,3578770565,3578770565,0
1,1623,58125,3578770565,3578770565,0
1,1623,58126,3578770565,3578770565,0
1,1623,58127,3578770565,3578770565,0
1,1623,58128,3578770565,3578770565,0
1,1623,58129,3578770565,3578770565,0
1,1623,58130,3578770565,3578770565,0
1,1623,58131,3578770565,3578770565,0
1,1623,58132,3578770565,3578770565,0
1,1623,58133,3578770565,3578770565,0
1,1623,58134,3578770565,3578770565,0
1,1623,58135,3578770565,3578770565,0
1,1623,58136,3578770565,3578770566,1
1,1623,58137,3578770565,3578770566,1
1,1623,58138,3578770565,3578770567,2
1,1623,58139,3578770565,3578770567,2
1,1623,58140,3578770565,3578770568,3
1,1623,58141,3578770565,3578770568,3
1,1623,58142,3578770565,3578770569,4
1,1623,58143,3578770565,3578770569,4
1,1623,58144,3578770565,3578770569,4
1,1623,58145,3578770565,3578770571,6
1,1623,58146,3578770565,3578770573,8
1,1623,58147,3578770565,3578770574,9
1,1623,58148,3578770565,3578770575,10
1,1623,58149,3578770565,3578770575,10
1,1623,58150,3578770565,3578770576,11
1,1623,58151,3578770565,3578770577,12
1,1623,58152,3578770565,3578770577,12
1,1623,58153,3578770565,3578770578,13
1,1623,58154,3578770565,3578770580,15
1,1623,58155,3578770565,3578770580,15
1,1623,58156,3578770565,3578770580,15
1,1623,58157,3578770565,3578770580,15
1,1623,58158,3578770565,3578770581,16
1,1623,58159,3578770565,3578770581,16
1,1623,58160,3578770565,3578770583,18
1,1623,58161,3578770565,3578770585,20
1,1623,58162,3578770565,3578770588,23
1,1623,58163,3578770565,3578770588,23
1,1623,58164,3578770565,3578770590,25
1,1623,58165,3578770565,3578770590,25
1,1623,58166,3578770565,3578770592,27
1,1623,58167,3578770565,3578770593,28
1,1623,58168,3578770565,3578770594,29
1,1623,58169,3578770565,3578770595,30
1,1623,58170,3578770565,3578770596,31
1,1623,58171,3578770565,3578770596,31
1,1623,58172,3578770565,3578770597,32
1,1623,58173,3578770565,3578770598,33
1,1623,58174,3578770565,3578770599,34
1,1623,58175,3578770565,3578770599,34
1,1623,58176,3578770565,3578770600,35
1,1623,58177,3578770565,3578770601,36
1,1623,58178,3578770565,3578770603,38
1,1623,58179,3578770565,3578770603,38
1,1623,58180,3578770565,3578770603,38
1,1623,58181,3578770565,3578770604,39
1,1623,58182,3578770565,3578770604,39
1,1623,58183,3578770565,3578770606,41
1,1623,58184,3578770565,3578770608,43
1,1623,58185,3578770565,3578770609,44
1,1623,58186,3578770565,3578770611,46
1,1623,58187,3578770565,3578770612,47
1,1623,58188,3578770565,3578770613,48
1,1623,58189,3578770565,3578770614,49
1,1623,58190,3578770565,3578770614,49
1,1623,58191,3578770565,3578770615,50
1,1624,58192,3578770631,3578770631,0
1,1624,58193,3578770631,3578770631,0
1,1624,58194,3578770631,3578770631,0
1,1624,58195,3578770631,3578770631,0
1,1624,58196,3578770631,3578770631,0
1,1624,58197,3578770631,3578770631,0
1,1624,58198,3578770631,3578770631,0
1,1624,58199,3578770631,3578770631,0
1,1624,58200,3578770631,3578770631,0
1,1624,58201,3578770631,3578770631,0
1,1624,58202,3578770631,3578770631,0
1,1624,58203,3578770631,3578770631,0
1,1624,58204,3578770631,3578770631,0
1,1624,58205,3578770631,3578770631,0
1,1624,58206,3578770631,3578770631,0
1,1624,58207,3578770631,3578770631,0
1,1624,58208,3578770631,3578770631,0
1,1624,58209,3578770631,3578770631,0
1,1624,58210,3578770631,3578770631,0
1,1624,58211,3578770631,3578770631,0
1,1624,58212,3578770631,3578770631,0
1,1624,58213,3578770631,3578770631,0
1,1624,58214,3578770631,3578770633,2
1,1624,58215,3578770631,3578770634,3
1,1624,58216,3578770631,3578770636,5
1,1624,58217,3578770631,3578770636,5
1,1624,58218,3578770631,3578770637,6
1,1624,58219,3578770631,3578770638,7
1,1624,58220,3578770631,3578770638,7
1,1624,58221,3578770631,3578770639,8
1,1624,58222,3578770631,3578770641,10
1,1624,58223,3578770631,3578770644,13
1,1624,58224,3578770631,3578770645,14
1,1624,58225,3578770631,3578770648,17
1,1624,58226,3578770631,3578770650,19
1,1624,58227,3578770631,3578770651,20
1,1624,58228,3578770631,3578770651,20
1,1624,58229,3578770631,3578770653,22
1,1624,58230,3578770631,3578770653,22
1,1624,58231,3578770631,3578770653,22
1,1624,58232,3578770631,3578770654,23
1,1624,58233,3578770631,3578770656,25
1,1624,58234,3578770631,3578770656,25
1,1624,58235,3578770631,3578770656,25
1,1624,58236,3578770631,3578770657,26
1,1624,58237,3578770631,3578770657,26
1,1624,58238,3578770631,3578770659,28
1,1624,58239,3578770631,3578770662,31
1,1624,58240,3578770631,3578770662,31
1,1624,58241,3578770631,3578770664,33
1,1624,58242,3578770631,3578770666,35
1,1624,58243,3578770631,3578770668,37
1,1624,58244,3578770631,3578770668,37
1,1624,58245,3578770631,3578770669,38
1,1624,58246,3578770631,3578770669,38
1,1624,58247,3578770631,3578770681,50
1,1625,58248,3578770697,3578770697,0
1,1625,58249,3578770697,3578770697,0
1,1625,58250,3578770697,3578770697,0
1,1625,58251,3578770697,3578770697,0
1,1625,58252,3578770697,3578770697,0
1,1625,58253,3578770697,3578770697,0
1,1625,58254,3578770697,3578770697,0
1,1625,58255,3578770697,3578770697,0
1,1625,58256,3578770697,3578770697,0
1,1625,58257,3578770697,3578770697,0
1,1625,58258,3578770697,3578770697,0
1,1625,58259,3578770697,3578770697,0
1,1625,58260,3578770697,3578770697,0
1,1625,58261,3578770697,3578770697,0
1,1625,58262,3578770697,3578770697,0
1,1625,58263,3578770697,3578770697,0
1,1625,58264,3578770697,3578770697,0
1,1625,58265,3578770697,3578770697,0
1,1625,58266,3578770697,3578770697,0
1,1625,58267,3578770697,3578770697,0
1,1625,58268,3578770697,3578770701,4
1,1625,58269,3578770697,3578770701,4
1,1625,58270,3578770697,3578770701,4
1,1625,58271,3578770697,3578770702,5
1,1625,58272,3578770697,3578770702,5
1,1625,58273,3578770697,3578770702,5
1,1625,58274,3578770697,3578770702,5
1,1625,58275,3578770697,3578770703,6
1,1625,58276,3578770697,3578770704,7
1,1625,58277,3578770697,3578770704,7
1,1625,58278,3578770697,3578770704,7
1,1625,58279,3578770697,3578770704,7
1,1625,58280,3578770697,3578770704,7
1,1625,58281,3578770697,3578770705,8
1,1625,58282,3578770697,3578770707,10
1,1625,58283,3578770697,3578770707,10
1,1625,58284,3578770697,3578770710,13
1,1625,58285,3578770697,3578770710,13
1,1625,58286,3578770697,3578770710,13
1,1625,58287,3578770697,3578770711,14
1,1625,58288,3578770697,3578770711,14
1,1625,58289,3578770697,3578770712,15
1,1625,58290,3578770697,3578770712,15
1,1625,58291,3578770697,3578770712,15
1,1625,58292,3578770697,3578770713,16
1,1625,58293,3578770697,3578770714,17
1,1625,58294,3578770697,3578770714,17
1,1625,58295,3578770697,3578770714,17
1,1625,58296,3578770697,3578770717,20
1,1625,58297,3578770697,3578770719,22
1,1625,58298,3578770697,3578770719,22
1,1625,58299,3578770697,3578770720,23
1,1625,58300,3578770697,3578770721,24
1,1625,58301,3578770697,3578770721,24
1,1625,58302,3578770697,3578770721,24
1,1625,58303,3578770697,3578770721,24
1,1625,58304,3578770697,3578770721,24
1,1625,58305,3578770697,3578770721,24
1,1625,58306,3578770697,3578770721,24
1,1625,58307,3578770697,3578770723,26
1,1625,58308,3578770697,3578770725,28
1,1625,58309,3578770697,3578770726,29
1,1625,58310,3578770697,3578770726,29
1,1625,58311,3578770697,3578770726,29
1,1625,58312,3578770697,3578770727,30
1,1625,58313,3578770697,3578770728,31
1,1625,58314,3578770697,3578770729,32
1,1625,58315,3578770697,3578770729,32
1,1625,58316,3578770697,3578770730,33
1,1625,58317,3578770697,3578770730,33
1,1625,58318,3578770697,3578770733,36
1,1625,58319,3578770697,3578770733,36
1,1625,58320,3578770697,3578770733,36
1,1625,58321,3578770697,3578770734,37
1,1625,58322,3578770697,3578770734,37
1,1625,58323,3578770697,3578770736,39
1,1625,58324,3578770697,3578770737,40
1,1625,58325,3578770697,3578770737,40
1,1625,58326,3578770697,3578770739,42
1,1625,58327,3578770697,3578770740,43
1,1625,58328,3578770697,3578770743,46
1,1625,58329,3578770697,3578770744,47
1,1625,58330,3578770697,3578770747,50
1,1626,58331,3578770762,3578770762,0
1,1626,58332,3578770762,3578770762,0
1,1626,58333,3578770762,3578770762,0
1,1626,58334,3578770762,3578770762,0
1,1626,58335,3578770762,3578770762,0
1,1626,58336,3578770762,3578770762,0
1,1626,58337,3578770762,3578770762,0
1,1626,58338,3578770762,3578770762,0
1,1626,58339,3578770762,3578770762,0
1,1626,58340,3578770762,3578770762,0
1,1626,58341,3578770762,3578770762,0
1,1626,58342,3578770762,3578770762,0
1,1626,58343,3578770762,3578770762,0
1,1626,58344,3578770762,3578770762,0
1,1626,58345,3578770762,3578770763,1
1,1626,58346,3578770762,3578770763,1
1,1626,58347,3578770762,3578770765,3
1,1626,58348,3578770762,3578770765,3
1,1626,58349,3578770762,3578770765,3
1,1626,58350,3578770762,3578770765,3
1,1626,58351,3578770762,3578770765,3
1,1626,58352,3578770762,3578770767,5
1,1626,58353,3578770762,3578770767,5
1,1626,58354,3578770762,3578770768,6
1,1626,58355,3578770762,3578770768,6
1,1626,58356,3578770762,3578770768,6
1,1626,58357,3578770762,3578770769,7
1,1626,58358,3578770762,3578770769,7
1,1626,58359,3578770762,3578770769,7
1,1626,58360,3578770762,3578770771,9
1,1626,58361,3578770762,3578770772,10
1,1626,58362,3578770762,3578770774,12
1,1626,58363,3578770762,3578770774,12
1,1626,58364,3578770762,3578770777,15
1,1626,58365,3578770762,3578770777,15
1,1626,58366,3578770762,3578770778,16
1,1626,58367,3578770762,3578770778,16
1,1626,58368,3578770762,3578770779,17
1,1626,58369,3578770762,3578770780,18
1,1626,58370,3578770762,3578770781,19
1,1626,58371,3578770762,3578770781,19
1,1626,58372,3578770762,3578770781,19
1,1626,58373,3578770762,3578770782,20
1,1626,58374,3578770762,3578770783,21
1,1626,58375,3578770762,3578770784,22
1,1626,58376,3578770762,3578770785,23
1,1626,58377,3578770762,3578770790,28
1,1626,58378,3578770762,3578770790,28
1,1626,58379,3578770762,3578770790,28
1,1626,58380,3578770762,3578770791,29
1,1626,58381,3578770762,3578770793,31
1,1626,58382,3578770762,3578770794,32
1,1626,58383,3578770762,3578770796,34
1,1626,58384,3578770762,3578770796,34
1,1626,58385,3578770762,3578770796,34
1,1626,58386,3578770762,3578770797,35
1,1626,58387,3578770762,3578770798,36
1,1626,58388,3578770762,3578770799,37
1,1626,58389,3578770762,3578770800,38
1,1626,58390,3578770762,3578770800,38
1,1626,58391,3578770762,3578770800,38
1,1626,58392,3578770762,3578770801,39
1,1626,58393,3578770762,3578770802,40
1,1626,58394,3578770762,3578770803,41
1,1626,58395,3578770762,3578770803,41
1,1626,58396,3578770762,3578770804,42
1,1626,58397,3578770762,3578770805,43
1,1626,58398,3578770762,3578770805,43
1,1626,58399,3578770762,3578770809,47
1,1626,58400,3578770762,3578770810,48
1,1626,58401,3578770762,3578770811,49
1,1627,58402,3578770827,3578770828,1
1,1627,58403,3578770827,3578770828,1
1,1627,58404,3578770827,3578770828,1
1,1627,58405,3578770827,3578770828,1
1,1627,58406,3578770827,3578770828,1
1,1627,58407,3578770827,3578770828,1
1,1627,58408,3578770827,3578770828,1
1,1627,58409,3578770827,3578770828,1
1,1627,58410,3578770827,3578770828,1
1,1627,58411,3578770827,3578770828,1
1,1627,58412,3578770827,3578770828,1
1,1627,58413,3578770827,3578770828,1
1,1627,58414,3578770827,3578770828,1
1,1627,58415,3578770827,3578770828,1
1,1627,58416,3578770827,3578770828,1
1,1627,58417,3578770827,3578770828,1
1,1627,58418,3578770827,3578770828,1
1,1627,58419,3578770827,3578770828,1
1,1627,58420,3578770827,3578770828,1
1,1627,58421,3578770827,3578770828,1
1,1627,58422,3578770827,3578770828,1
1,1627,58423,3578770827,3578770828,1
1,1627,58424,3578770827,3578770828,1
1,1627,58425,3578770827,3578770828,1
1,1627,58426,3578770827,3578770829,2
1,1627,58427,3578770827,3578770829,2
1,1627,58428,3578770827,3578770830,3
1,1627,58429,3578770827,3578770832,5
1,1627,58430,3578770827,3578770832,5
1,1627,58431,3578770827,3578770833,6
1,1627,58432,3578770827,3578770833,6
1,1627,58433,3578770827,3578770835,8
1,1627,58434,3578770827,3578770836,9
1,1627,58435,3578770827,3578770837,10
1,1627,58436,3578770827,3578770837,10
1,1627,58437,3578770827,3578770838,11
1,1627,58438,3578770827,3578770839,12
1,1627,58439,3578770827,3578770840,13
1,1627,58440,3578770827,3578770846,19
1,1627,58441,3578770827,3578770847,20
1,1627,58442,3578770827,3578770849,22
1,1627,58443,3578770827,3578770850,23
1,1627,58444,3578770827,3578770851,24
1,1627,58445,3578770827,3578770852,25
1,1627,58446,3578770827,3578770852,25
1,1627,58447,3578770827,3578770853,26
1,1627,58448,3578770827,3578770854,27
1,1627,58449,3578770827,3578770856,29
1,1627,58450,3578770827,3578770857,30
1,1627,58451,3578770827,3578770857,30
1,1627,58452,3578770827,3578770857,30
1,1627,58453,3578770827,3578770857,30
1,1627,58454,3578770827,3578770859,32
1,1627,58455,3578770827,3578770862,35
1,1627,58456,3578770827,3578770862,35
1,1627,58457,3578770827,3578770864,37
1,1627,58458,3578770827,3578770866,39
1,1627,58459,3578770827,3578770866,39
1,1627,58460,3578770827,3578770867,40
1,1627,58461,3578770827,3578770868,41
1,1627,58462,3578770827,3578770869,42
1,1627,58463,3578770827,3578770869,42
1,1627,58464,3578770827,3578770870,43
1,1628,58465,3578770896,3578770896,0
1,1628,58466,3578770896,3578770896,0
1,1628,58467,3578770896,3578770896,0
1,1628,58468,3578770896,3578770896,0
1,1628,58469,3578770896,3578770896,0
1,1628,58470,3578770896,3578770896,0
1,1628,58471,3578770896,3578770896,0
1,1628,58472,3578770896,3578770896,0
1,1628,58473,3578770896,3578770896,0
1,1628,58474,3578770896,3578770896,0
1,1628,58475,3578770896,3578770896,0
1,1628,58476,3578770896,3578770896,0
1,1628,58477,3578770896,3578770896,0
1,1628,58478,3578770896,3578770896,0
1,1628,58479,3578770896,3578770896,0
1,1628,58480,3578770896,3578770896,0
1,1628,58481,3578770896,3578770896,0
1,1628,58482,3578770896,3578770896,0
1,1628,58483,3578770896,3578770896,0
1,1628,58484,3578770896,3578770896,0
1,1628,58485,3578770896,3578770897,1
1,1628,58486,3578770896,3578770897,1
1,1628,58487,3578770896,3578770897,1
1,1628,58488,3578770896,3578770898,2
1,1628,58489,3578770896,3578770898,2
1,1628,58490,3578770896,3578770901,5
1,1628,58491,3578770896,3578770902,6
1,1628,58492,3578770896,3578770902,6
1,1628,58493,3578770896,3578770902,6
1,1628,58494,3578770896,3578770902,6
1,1628,58495,3578770896,3578770904,8
1,1628,58496,3578770896,3578770904,8
1,1628,58497,3578770896,3578770904,8
1,1628,58498,3578770896,3578770904,8
1,1628,58499,3578770896,3578770904,8
1,1628,58500,3578770896,3578770905,9
1,1628,58501,3578770896,3578770906,10
1,1628,58502,3578770896,3578770906,10
1,1628,58503,3578770896,3578770906,10
1,1628,58504,3578770896,3578770907,11
1,1628,58505,3578770896,3578770909,13
1,1628,58506,3578770896,3578770910,14
1,1628,58507,3578770896,3578770911,15
1,1628,58508,3578770896,3578770911,15
1,1628,58509,3578770896,3578770911,15
1,1628,58510,3578770896,3578770912,16
1,1628,58511,3578770896,3578770912,16
1,1628,58512,3578770896,3578770913,17
1,1628,58513,3578770896,3578770913,17
1,1628,58514,3578770896,3578770914,18
1,1628,58515,3578770896,3578770914,18
1,1628,58516,3578770896,3578770914,18
1,1628,58517,3578770896,3578770918,22
1,1628,58518,3578770896,3578770918,22
1,1628,58519,3578770896,3578770919,23
1,1628,58520,3578770896,3578770920,24
1,1628,58521,3578770896,3578770921,25
1,1628,58522,3578770896,3578770921,25
1,1628,58523,3578770896,3578770921,25
1,1628,58524,3578770896,3578770921,25
1,1628,58525,3578770896,3578770921,25
1,1628,58526,3578770896,3578770922,26
1,1628,58527,3578770896,3578770923,27
1,1628,58528,3578770896,3578770925,29
1,1628,58529,3578770896,3578770925,29
1,1628,58530,3578770896,3578770925,29
1,1628,58531,3578770896,3578770926,30
1,1628,58532,3578770896,3578770926,30
1,1628,58533,3578770896,3578770927,31
1,1628,58534,3578770896,3578770929,33
1,1628,58535,3578770896,3578770929,33
1,1628,58536,3578770896,3578770931,35
1,1628,58537,3578770896,3578770933,37
1,1628,58538,3578770896,3578770934,38
1,1628,58539,3578770896,3578770934,38
1,1628,58540,3578770896,3578770934,38
1,1628,58541,3578770896,3578770935,39
1,1628,58542,3578770896,3578770936,40
1,1628,58543,3578770896,3578770937,41
1,1628,58544,3578770896,3578770938,42
1,1628,58545,3578770896,3578770938,42
1,1628,58546,3578770896,3578770940,44
1,1628,58547,3578770896,3578770941,45
1,1628,58548,3578770896,3578770944,48
1,1628,58549,3578770896,3578770944,48
1,1629,58550,3578770963,3578770963,0
1,1629,58551,3578770963,3578770963,0
1,1629,58552,3578770963,3578770963,0
1,1629,58553,3578770963,3578770963,0
1,1629,58554,3578770963,3578770963,0
1,1629,58555,3578770963,3578770963,0
1,1629,58556,3578770963,3578770963,0
1,1629,58557,3578770963,3578770963,0
1,1629,58558,3578770963,3578770963,0
1,1629,58559,3578770963,3578770963,0
1,1629,58560,3578770963,3578770963,0
1,1629,58561,3578770963,3578770963,0
1,1629,58562,3578770963,3578770963,0
1,1629,58563,3578770963,3578770963,0
1,1629,58564,3578770963,3578770963,0
1,1629,58565,3578770963,3578770963,0
1,1629,58566,3578770963,3578770964,1
1,1629,58567,3578770963,3578770965,2
1,1629,58568,3578770963,3578770965,2
1,1629,58569,3578770963,3578770967,4
1,1629,58570,3578770963,3578770967,4
1,1629,58571,3578770963,3578770967,4
1,1629,58572,3578770963,3578770969,6
1,1629,58573,3578770963,3578770969,6
1,1629,58574,3578770963,3578770971,8
1,1629,58575,3578770963,3578770973,10
1,1629,58576,3578770963,3578770974,11
1,1629,58577,3578770963,3578770975,12
1,1629,58578,3578770963,3578770976,13
1,1629,58579,3578770963,3578770977,14
1,1629,58580,3578770963,3578770977,14
1,1629,58581,3578770963,3578770977,14
1,1629,58582,3578770963,3578770979,16
1,1629,58583,3578770963,3578770980,17
1,1629,58584,3578770963,3578770981,18
1,1629,58585,3578770963,3578770981,18
1,1629,58586,3578770963,3578770981,18
1,1629,58587,3578770963,3578770981,18
1,1629,58588,3578770963,3578770982,19
1,1629,58589,3578770963,3578770983,20
1,1629,58590,3578770963,3578770984,21
1,1629,58591,3578770963,3578770985,22
1,1629,58592,3578770963,3578770989,26
1,1629,58593,3578770963,3578770990,27
1,1629,58594,3578770963,3578770991,28
1,1629,58595,3578770963,3578770992,29
1,1629,58596,3578770963,3578770993,30
1,1629,58597,3578770963,3578770994,31
1,1629,58598,3578770963,3578770995,32
1,1629,58599,3578770963,3578770996,33
1,1629,58600,3578770963,3578770996,33
1,1629,58601,3578770963,3578770997,34
1,1629,58602,3578770963,3578770999,36
1,1629,58603,3578770963,3578771000,37
1,1629,58604,3578770963,3578771000,37
1,1629,58605,3578770963,3578771001,38
1,1629,58606,3578770963,3578771001,38
1,1629,58607,3578770963,3578771001,38
1,1629,58608,3578770963,3578771003,40
1,1629,58609,3578770963,3578771003,40
1,1629,58610,3578770963,3578771004,41
1,1629,58611,3578770963,3578771006,43
1,1629,58612,3578770963,3578771008,45
1,1629,58613,3578770963,3578771011,48
1,1629,58614,3578770963,3578771012,49
1,1629,58615,3578770963,3578771013,50
1,1630,58616,3578771030,3578771030,0
1,1630,58617,3578771030,3578771030,0
1,1630,58618,3578771030,3578771030,0
1,1630,58619,3578771030,3578771030,0
1,1630,58620,3578771030,3578771030,0
1,1630,58621,3578771030,3578771030,0
1,1630,58622,3578771030,3578771030,0
1,1630,58623,3578771030,3578771030,0
1,1630,58624,3578771030,3578771030,0
1,1630,58625,3578771030,3578771030,0
1,1630,58626,3578771030,3578771030,0
1,1630,58627,3578771030,3578771030,0
1,1630,58628,3578771030,3578771030,0
1,1630,58629,3578771030,3578771030,0
1,1630,58630,3578771030,3578771030,0
1,1630,58631,3578771030,3578771030,0
1,1630,58632,3578771030,3578771030,0
1,1630,58633,3578771030,3578771030,0
1,1630,58634,3578771030,3578771030,0
1,1630,58635,3578771030,3578771030,0
1,1630,58636,3578771030,3578771030,0
1,1630,58637,3578771030,3578771030,0
1,1630,58638,3578771030,3578771030,0
1,1630,58639,3578771030,3578771030,0
1,1630,58640,3578771030,3578771031,1
1,1630,58641,3578771030,3578771032,2
1,1630,58642,3578771030,3578771032,2
1,1630,58643,3578771030,3578771033,3
1,1630,58644,3578771030,3578771034,4
1,1630,58645,3578771030,3578771035,5
1,1630,58646,3578771030,3578771037,7
1,1630,58647,3578771030,3578771037,7
1,1630,58648,3578771030,3578771038,8
1,1630,58649,3578771030,3578771038,8
1,1630,58650,3578771030,3578771039,9
1,1630,58651,3578771030,3578771041,11
1,1630,58652,3578771030,3578771046,16
1,1630,58653,3578771030,3578771048,18
1,1630,58654,3578771030,3578771050,20
1,1630,58655,3578771030,3578771050,20
1,1630,58656,3578771030,3578771051,21
1,1630,58657,3578771030,3578771052,22
1,1630,58658,3578771030,3578771053,23
1,1630,58659,3578771030,3578771054,24
1,1630,58660,3578771030,3578771056,26
1,1630,58661,3578771030,3578771056,26
1,1630,58662,3578771030,3578771057,27
1,1630,58663,3578771030,3578771057,27
1,1630,58664,3578771030,3578771057,27
1,1630,58665,3578771030,3578771060,30
1,1630,58666,3578771030,3578771063,33
1,1630,58667,3578771030,3578771065,35
1,1630,58668,3578771030,3578771066,36
1,1630,58669,3578771030,3578771067,37
1,1630,58670,3578771030,3578771068,38
1,1630,58671,3578771030,3578771069,39
1,1630,58672,3578771030,3578771069,39
1,1630,58673,3578771030,3578771069,39
1,1631,58674,3578771096,3578771096,0
1,1631,58675,3578771096,3578771096,0
1,1631,58676,3578771096,3578771096,0
1,1631,58677,3578771096,3578771096,0
1,1631,58678,3578771096,3578771096,0
1,1631,58679,3578771096,3578771096,0
1,1631,58680,3578771096,3578771096,0
1,1631,58681,3578771096,3578771096,0
1,1631,58682,3578771096,3578771096,0
1,1631,58683,3578771096,3578771096,0
1,1631,58684,3578771096,3578771096,0
1,1631,58685,3578771096,3578771096,0
1,1631,58686,3578771096,3578771096,0
1,1631,58687,3578771096,3578771096,0
1,1631,58688,3578771096,3578771096,0
1,1631,58689,3578771096,3578771096,0
1,1631,58690,3578771096,3578771096,0
1,1631,58691,3578771096,3578771096,0
1,1631,58692,3578771096,3578771096,0
1,1631,58693,3578771096,3578771096,0
1,1631,58694,3578771096,3578771097,1
1,1631,58695,3578771096,3578771097,1
1,1631,58696,3578771096,3578771097,1
1,1631,58697,3578771096,3578771099,3
1,1631,58698,3578771096,3578771099,3
1,1631,58699,3578771096,3578771100,4
1,1631,58700,3578771096,3578771101,5
1,1631,58701,3578771096,3578771102,6
1,1631,58702,3578771096,3578771103,7
1,1631,58703,3578771096,3578771104,8
1,1631,58704,3578771096,3578771104,8
1,1631,58705,3578771096,3578771104,8
1,1631,58706,3578771096,3578771104,8
1,1631,58707,3578771096,3578771104,8
1,1631,58708,3578771096,3578771105,9
1,1631,58709,3578771096,3578771105,9
1,1631,58710,3578771096,3578771106,10
1,1631,58711,3578771096,3578771106,10
1,1631,58712,3578771096,3578771108,12
1,1631,58713,3578771096,3578771110,14
1,1631,58714,3578771096,3578771111,15
1,1631,58715,3578771096,3578771112,16
1,1631,58716,3578771096,3578771112,16
1,1631,58717,3578771096,3578771113,17
1,1631,58718,3578771096,3578771113,17
1,1631,58719,3578771096,3578771113,17
1,1631,58720,3578771096,3578771113,17
1,1631,58721,3578771096,3578771114,18
1,1631,58722,3578771096,3578771115,19
1,1631,58723,3578771096,3578771115,19
1,1631,58724,3578771096,3578771118,22
1,1631,58725,3578771096,3578771119,23
1,1631,58726,3578771096,3578771119,23
1,1631,58727,3578771096,3578771121,25
1,1631,58728,3578771096,3578771121,25
1,1631,58729,3578771096,3578771121,25
1,1631,58730,3578771096,3578771121,25
1,1631,58731,3578771096,3578771121,25
1,1631,58732,3578771096,3578771122,26
1,1631,58733,3578771096,3578771124,28
1,1631,58734,3578771096,3578771125,29
1,1631,58735,3578771096,3578771125,29
1,1631,58736,3578771096,3578771126,30
1,1631,58737,3578771096,3578771127,31
1,1631,58738,3578771096,3578771127,31
1,1631,58739,3578771096,3578771128,32
1,1631,58740,3578771096,3578771128,32
1,1631,58741,3578771096,3578771129,33
1,1631,58742,3578771096,3578771130,34
1,1631,58743,3578771096,3578771130,34
1,1631,58744,3578771096,3578771131,35
1,1631,58745,3578771096,3578771132,36
1,1631,58746,3578771096,3578771133,37
1,1631,58747,3578771096,3578771135,39
1,1631,58748,3578771096,3578771135,39
1,1631,58749,3578771096,3578771135,39
1,1631,58750,3578771096,3578771136,40
1,1631,58751,3578771096,3578771137,41
1,1631,58752,3578771096,3578771138,42
1,1631,58753,3578771096,3578771139,43
1,1631,58754,3578771096,3578771140,44
1,1631,58755,3578771096,3578771141,45
1,1631,58756,3578771096,3578771143,47
1,1631,58757,3578771096,3578771144,48
1,1632,58758,3578771160,3578771160,0
1,1632,58759,3578771160,3578771160,0
1,1632,58760,3578771160,3578771160,0
1,1632,58761,3578771160,3578771160,0
1,1632,58762,3578771160,3578771160,0
1,1632,58763,3578771160,3578771160,0
1,1632,58764,3578771160,3578771160,0
1,1632,58765,3578771160,3578771160,0
1,1632,58766,3578771160,3578771160,0
1,1632,58767,3578771160,3578771160,0
1,1632,58768,3578771160,3578771160,0
1,1632,58769,3578771160,3578771161,1
1,1632,58770,3578771160,3578771163,3
1,1632,58771,3578771160,3578771164,4
1,1632,58772,3578771160,3578771164,4
1,1632,58773,3578771160,3578771165,5
1,1632,58774,3578771160,3578771165,5
1,1632,58775,3578771160,3578771165,5
1,1632,58776,3578771160,3578771166,6
1,1632,58777,3578771160,3578771166,6
1,1632,58778,3578771160,3578771167,7
1,1632,58779,3578771160,3578771167,7
1,1632,58780,3578771160,3578771168,8
1,1632,58781,3578771160,3578771168,8
1,1632,58782,3578771160,3578771170,10
1,1632,58783,3578771160,3578771170,10
1,1632,58784,3578771160,3578771170,10
1,1632,58785,3578771160,3578771172,12
1,1632,58786,3578771160,3578771174,14
1,1632,58787,3578771160,3578771175,15
1,1632,58788,3578771160,3578771177,17
1,1632,58789,3578771160,3578771178,18
1,1632,58790,3578771160,3578771178,18
1,1632,58791,3578771160,3578771179,19
1,1632,58792,3578771160,3578771181,21
1,1632,58793,3578771160,3578771181,21
1,1632,58794,3578771160,3578771181,21
1,1632,58795,3578771160,3578771181,21
1,1632,58796,3578771160,3578771182,22
1,1632,58797,3578771160,3578771182,22
1,1632,58798,3578771160,3578771184,24
1,1632,58799,3578771160,3578771187,27
1,1632,58800,3578771160,3578771190,30
1,1632,58801,3578771160,3578771190,30
1,1632,58802,3578771160,3578771190,30
1,1632,58803,3578771160,3578771191,31
1,1632,58804,3578771160,3578771194,34
1,1632,58805,3578771160,3578771196,36
1,1632,58806,3578771160,3578771196,36
1,1632,58807,3578771160,3578771196,36
1,1632,58808,3578771160,3578771198,38
1,1632,58809,3578771160,3578771199,39
1,1632,58810,3578771160,3578771200,40
1,1632,58811,3578771160,3578771200,40
1,1632,58812,3578771160,3578771201,41
1,1632,58813,3578771160,3578771201,41
1,1632,58814,3578771160,3578771203,43
1,1632,58815,3578771160,3578771203,43
1,1632,58816,3578771160,3578771203,43
1,1632,58817,3578771160,3578771206,46
1,1632,58818,3578771160,3578771209,49
1,1633,58819,3578771226,3578771226,0
1,1633,58820,3578771226,3578771226,0
1,1633,58821,3578771226,3578771226,0
1,1633,58822,3578771226,3578771226,0
1,1633,58823,3578771226,3578771226,0
1,1633,58824,3578771226,3578771226,0
1,1633,58825,3578771226,3578771226,0
1,1633,58826,3578771226,3578771226,0
1,1633,58827,3578771226,3578771226,0
1,1633,58828,3578771226,3578771226,0
1,1633,58829,3578771226,3578771226,0
1,1633,58830,3578771226,3578771226,0
1,1633,58831,3578771226,3578771226,0
1,1633,58832,3578771226,3578771226,0
1,1633,58833,3578771226,3578771226,0
1,1633,58834,3578771226,3578771226,0
1,1633,58835,3578771226,3578771226,0
1,1633,58836,3578771226,3578771226,0
1,1633,58837,3578771226,3578771226,0
1,1633,58838,3578771226,3578771226,0
1,1633,58839,3578771226,3578771226,0
1,1633,58840,3578771226,3578771227,1
1,1633,58841,3578771226,3578771227,1
1,1633,58842,3578771226,3578771228,2
1,1633,58843,3578771226,3578771228,2
1,1633,58844,3578771226,3578771229,3
1,1633,58845,3578771226,3578771230,4
1,1633,58846,3578771226,3578771230,4
1,1633,58847,3578771226,3578771232,6
1,1633,58848,3578771226,3578771232,6
1,1633,58849,3578771226,3578771233,7
1,1633,58850,3578771226,3578771234,8
1,1633,58851,3578771226,3578771236,10
1,1633,58852,3578771226,3578771236,10
1,1633,58853,3578771226,3578771237,11
1,1633,58854,3578771226,3578771237,11
1,1633,58855,3578771226,3578771238,12
1,1633,58856,3578771226,3578771239,13
1,1633,58857,3578771226,3578771241,15
1,1633,58858,3578771226,3578771244,18
1,1633,58859,3578771226,3578771246,20
1,1633,58860,3578771226,3578771248,22
1,1633,58861,3578771226,3578771249,23
1,1633,58862,3578771226,3578771250,24
1,1633,58863,3578771226,3578771252,26
1,1633,58864,3578771226,3578771252,26
1,1633,58865,3578771226,3578771253,27
1,1633,58866,3578771226,3578771254,28
1,1633,58867,3578771226,3578771254,28
1,1633,58868,3578771226,3578771256,30
1,1633,58869,3578771226,3578771257,31
1,1633,58870,3578771226,3578771257,31
1,1633,58871,3578771226,3578771257,31
1,1633,58872,3578771226,3578771258,32
1,1633,58873,3578771226,3578771261,35
1,1633,58874,3578771226,3578771263,37
1,1633,58875,3578771226,3578771265,39
1,1633,58876,3578771226,3578771267,41
1,1633,58877,3578771226,3578771268,42
1,1633,58878,3578771226,3578771268,42
1,1633,58879,3578771226,3578771269,43
1,1633,58880,3578771226,3578771270,44
1,1634,58881,3578771292,3578771292,0
1,1634,58882,3578771292,3578771292,0
1,1634,58883,3578771292,3578771292,0
1,1634,58884,3578771292,3578771292,0
1,1634,58885,3578771292,3578771292,0
1,1634,58886,3578771292,3578771292,0
1,1634,58887,3578771292,3578771292,0
1,1634,58888,3578771292,3578771292,0
1,1634,58889,3578771292,3578771292,0
1,1634,58890,3578771292,3578771293,1
1,1634,58891,3578771292,3578771293,1
1,1634,58892,3578771292,3578771294,2
1,1634,58893,3578771292,3578771294,2
1,1634,58894,3578771292,3578771294,2
1,1634,58895,3578771292,3578771295,3
1,1634,58896,3578771292,3578771296,4
1,1634,58897,3578771292,3578771296,4
1,1634,58898,3578771292,3578771297,5
1,1634,58899,3578771292,3578771298,6
1,1634,58900,3578771292,3578771299,7
1,1634,58901,3578771292,3578771299,7
1,1634,58902,3578771292,3578771301,9
1,1634,58903,3578771292,3578771301,9
1,1634,58904,3578771292,3578771301,9
1,1634,58905,3578771292,3578771302,10
1,1634,58906,3578771292,3578771303,11
1,1634,58907,3578771292,3578771303,11
1,1634,58908,3578771292,3578771303,11
1,1634,58909,3578771292,3578771304,12
1,1634,58910,3578771292,3578771304,12
1,1634,58911,3578771292,3578771305,13
1,1634,58912,3578771292,3578771305,13
1,1634,58913,3578771292,3578771306,14
1,1634,58914,3578771292,3578771306,14
1,1634,58915,3578771292,3578771307,15
1,1634,58916,3578771292,3578771308,16
1,1634,58917,3578771292,3578771310,18
1,1634,58918,3578771292,3578771311,19
1,1634,58919,3578771292,3578771311,19
1,1634,58920,3578771292,3578771312,20
1,1634,58921,3578771292,3578771312,20
1,1634,58922,3578771292,3578771313,21
1,1634,58923,3578771292,3578771313,21
1,1634,58924,3578771292,3578771313,21
1,1634,58925,3578771292,3578771314,22
1,1634,58926,3578771292,3578771315,23
1,1634,58927,3578771292,3578771315,23
1,1634,58928,3578771292,3578771317,25
1,1634,58929,3578771292,3578771319,27
1,1634,58930,3578771292,3578771320,28
1,1634,58931,3578771292,3578771320,28
1,1634,58932,3578771292,3578771321,29
1,1634,58933,3578771292,3578771321,29
1,1634,58934,3578771292,3578771323,31
1,1634,58935,3578771292,3578771324,32
1,1634,58936,3578771292,3578771325,33
1,1634,58937,3578771292,3578771326,34
1,1634,58938,3578771292,3578771326,34
1,1634,58939,3578771292,3578771326,34
1,1634,58940,3578771292,3578771327,35
1,1634,58941,3578771292,3578771328,36
1,1634,58942,3578771292,3578771329,37
1,1634,58943,3578771292,3578771330,38
1,1634,58944,3578771292,3578771330,38
1,1634,58945,3578771292,3578771331,39
1,1634,58946,3578771292,3578771331,39
1,1634,58947,3578771292,3578771332,40
1,1634,58948,3578771292,3578771333,41
1,1634,58949,3578771292,3578771333,41
1,1634,58950,3578771292,3578771334,42
1,1634,58951,3578771292,3578771334,42
1,1634,58952,3578771292,3578771335,43
1,1634,58953,3578771292,3578771335,43
1,1634,58954,3578771292,3578771337,45
1,1634,58955,3578771292,3578771337,45
1,1634,58956,3578771292,3578771339,47
1,1634,58957,3578771292,3578771341,49
1,1634,58958,3578771292,3578771341,49
1,1635,58959,3578771359,3578771359,0
1,1635,58960,3578771359,3578771359,0
1,1635,58961,3578771359,3578771359,0
1,1635,58962,3578771359,3578771359,0
1,1635,58963,3578771359,3578771359,0
1,1635,58964,3578771359,3578771359,0
1,1635,58965,3578771359,3578771359,0
1,1635,58966,3578771359,3578771359,0
1,1635,58967,3578771359,3578771359,0
1,1635,58968,3578771359,3578771359,0
1,1635,58969,3578771359,3578771359,0
1,1635,58970,3578771359,3578771359,0
1,1635,58971,3578771359,3578771361,2
1,1635,58972,3578771359,3578771363,4
1,1635,58973,3578771359,3578771363,4
1,1635,58974,3578771359,3578771364,5
1,1635,58975,3578771359,3578771366,7
1,1635,58976,3578771359,3578771366,7
1,1635,58977,3578771359,3578771366,7
1,1635,58978,3578771359,3578771366,7
1,1635,58979,3578771359,3578771366,7
1,1635,58980,3578771359,3578771367,8
1,1635,58981,3578771359,3578771367,8
1,1635,58982,3578771359,3578771368,9
1,1635,58983,3578771359,3578771369,10
1,1635,58984,3578771359,3578771370,11
1,1635,58985,3578771359,3578771370,11
1,1635,58986,3578771359,3578771371,12
1,1635,58987,3578771359,3578771373,14
1,1635,58988,3578771359,3578771375,16
1,1635,58989,3578771359,3578771376,17
1,1635,58990,3578771359,3578771377,18
1,1635,58991,3578771359,3578771378,19
1,1635,58992,3578771359,3578771378,19
1,1635,58993,3578771359,3578771380,21
1,1635,58994,3578771359,3578771380,21
1,1635,58995,3578771359,3578771381,22
1,1635,58996,3578771359,3578771381,22
1,1635,58997,3578771359,3578771381,22
1,1635,58998,3578771359,3578771382,23
1,1635,58999,3578771359,3578771382,23
1,1635,59000,3578771359,3578771383,24
1,1635,59001,3578771359,3578771386,27
1,1635,59002,3578771359,3578771390,31
1,1635,59003,3578771359,3578771390,31
1,1635,59004,3578771359,3578771391,32
1,1635,59005,3578771359,3578771392,33
1,1635,59006,3578771359,3578771392,33
1,1635,59007,3578771359,3578771394,35
1,1635,59008,3578771359,3578771396,37
1,1635,59009,3578771359,3578771397,38
1,1635,59010,3578771359,3578771397,38
1,1635,59011,3578771359,3578771397,38
1,1635,59012,3578771359,3578771399,40
1,1635,59013,3578771359,3578771400,41
1,1635,59014,3578771359,3578771401,42
1,1635,59015,3578771359,3578771401,42
1,1635,59016,3578771359,3578771401,42
1,1635,59017,3578771359,3578771403,44
1,1635,59018,3578771359,3578771403,44
1,1635,59019,3578771359,3578771404,45
1,1635,59020,3578771359,3578771405,46
1,1635,59021,3578771359,3578771406,47
1,1635,59022,3578771359,3578771408,49
1,1636,59023,3578771425,3578771425,0
1,1636,59024,3578771425,3578771425,0
1,1636,59025,3578771425,3578771425,0
1,1636,59026,3578771425,3578771425,0
1,1636,59027,3578771425,3578771425,0
1,1636,59028,3578771425,3578771425,0
1,1636,59029,3578771425,3578771425,0
1,1636,59030,3578771425,3578771425,0
1,1636,59031,3578771425,3578771425,0
1,1636,59032,3578771425,3578771425,0
1,1636,59033,3578771425,3578771425,0
1,1636,59034,3578771425,3578771425,0
1,1636,59035,3578771425,3578771425,0
1,1636,59036,3578771425,3578771425,0
1,1636,59037,3578771425,3578771425,0
1,1636,59038,3578771425,3578771425,0
1,1636,59039,3578771425,3578771425,0
1,1636,59040,3578771425,3578771425,0
1,1636,59041,3578771425,3578771426,1
1,1636,59042,3578771425,3578771427,2
1,1636,59043,3578771425,3578771427,2
1,1636,59044,3578771425,3578771428,3
1,1636,59045,3578771425,3578771429,4
1,1636,59046,3578771425,3578771430,5
1,1636,59047,3578771425,3578771430,5
1,1636,59048,3578771425,3578771431,6
1,1636,59049,3578771425,3578771431,6
1,1636,59050,3578771425,3578771433,8
1,1636,59051,3578771425,3578771433,8
1,1636,59052,3578771425,3578771434,9
1,1636,59053,3578771425,3578771434,9
1,1636,59054,3578771425,3578771435,10
1,1636,59055,3578771425,3578771437,12
1,1636,59056,3578771425,3578771437,12
1,1636,59057,3578771425,3578771438,13
1,1636,59058,3578771425,3578771440,15
1,1636,59059,3578771425,3578771441,16
1,1636,59060,3578771425,3578771445,20
1,1636,59061,3578771425,3578771446,21
1,1636,59062,3578771425,3578771448,23
1,1636,59063,3578771425,3578771450,25
1,1636,59064,3578771425,3578771450,25
1,1636,59065,3578771425,3578771451,26
1,1636,59066,3578771425,3578771453,28
1,1636,59067,3578771425,3578771454,29
1,1636,59068,3578771425,3578771454,29
1,1636,59069,3578771425,3578771454,29
1,1636,59070,3578771425,3578771454,29
1,1636,59071,3578771425,3578771455,30
1,1636,59072,3578771425,3578771456,31
1,1636,59073,3578771425,3578771456,31
1,1636,59074,3578771425,3578771457,32
1,1636,59075,3578771425,3578771457,32
1,1636,59076,3578771425,3578771458,33
1,1636,59077,3578771425,3578771460,35
1,1636,59078,3578771425,3578771463,38
1,1636,59079,3578771425,3578771463,38
1,1636,59080,3578771425,3578771464,39
1,1636,59081,3578771425,3578771467,42
1,1636,59082,3578771425,3578771468,43
1,1636,59083,3578771425,3578771469,44
1,1636,59084,3578771425,3578771470,45
1,1637,59085,3578771489,3578771489,0
1,1637,59086,3578771489,3578771489,0
1,1637,59087,3578771489,3578771489,0
1,1637,59088,3578771489,3578771489,0
1,1637,59089,3578771489,3578771490,1
1,1637,59090,3578771489,3578771490,1
1,1637,59091,3578771489,3578771490,1
1,1637,59092,3578771489,3578771490,1
1,1637,59093,3578771489,3578771491,2
1,1637,59094,3578771489,3578771492,3
1,1637,59095,3578771489,3578771493,4
1,1637,59096,3578771489,3578771493,4
1,1637,59097,3578771489,3578771493,4
1,1637,59098,3578771489,3578771495,6
1,1637,59099,3578771489,3578771495,6
1,1637,59100,3578771489,3578771496,7
1,1637,59101,3578771489,3578771496,7
1,1637,59102,3578771489,3578771497,8
1,1637,59103,3578771489,3578771498,9
1,1637,59104,3578771489,3578771499,10
1,1637,59105,3578771489,3578771500,11
1,1637,59106,3578771489,3578771500,11
1,1637,59107,3578771489,3578771501,12
1,1637,59108,3578771489,3578771502,13
1,1637,59109,3578771489,3578771502,13
1,1637,59110,3578771489,3578771503,14
1,1637,59111,3578771489,3578771503,14
1,1637,59112,3578771489,3578771503,14
1,1637,59113,3578771489,3578771504,15
1,1637,59114,3578771489,3578771504,15
1,1637,59115,3578771489,3578771504,15
1,1637,59116,3578771489,3578771505,16
1,1637,59117,3578771489,3578771505,16
1,1637,59118,3578771489,3578771506,17
1,1637,59119,3578771489,3578771506,17
1,1637,59120,3578771489,3578771507,18
1,1637,59121,3578771489,3578771508,19
1,1637,59122,3578771489,3578771509,20
1,1637,59123,3578771489,3578771510,21
1,1637,59124,3578771489,3578771511,22
1,1637,59125,3578771489,3578771511,22
1,1637,59126,3578771489,3578771512,23
1,1637,59127,3578771489,3578771512,23
1,1637,59128,3578771489,3578771512,23
1,1637,59129,3578771489,3578771512,23
1,1637,59130,3578771489,3578771513,24
1,1637,59131,3578771489,3578771514,25
1,1637,59132,3578771489,3578771515,26
1,1637,59133,3578771489,3578771517,28
1,1637,59134,3578771489,3578771518,29
1,1637,59135,3578771489,3578771519,30
1,1637,59136,3578771489,3578771519,30
1,1637,59137,3578771489,3578771520,31
1,1637,59138,3578771489,3578771520,31
1,1637,59139,3578771489,3578771520,31
1,1637,59140,3578771489,3578771523,34
1,1637,59141,3578771489,3578771523,34
1,1637,59142,3578771489,3578771524,35
1,1637,59143,3578771489,3578771524,35
1,1637,59144,3578771489,3578771525,36
1,1637,59145,3578771489,3578771526,37
1,1637,59146,3578771489,3578771526,37
1,1637,59147,3578771489,3578771527,38
1,1637,59148,3578771489,3578771528,39
1,1637,59149,3578771489,3578771529,40
1,1637,59150,3578771489,3578771529,40
1,1637,59151,3578771489,3578771530,41
1,1637,59152,3578771489,3578771530,41
1,1637,59153,3578771489,3578771530,41
1,1637,59154,3578771489,3578771531,42
1,1637,59155,3578771489,3578771532,43
1,1637,59156,3578771489,3578771532,43
1,1637,59157,3578771489,3578771534,45
1,1637,59158,3578771489,3578771534,45
1,1637,59159,3578771489,3578771534,45
1,1637,59160,3578771489,3578771536,47
1,1637,59161,3578771489,3578771536,47
1,1637,59162,3578771489,3578771537,48
1,1637,59163,3578771489,3578771537,48
1,1638,59164,3578771555,3578771556,1
1,1638,59165,3578771555,3578771556,1
1,1638,59166,3578771555,3578771556,1
1,1638,59167,3578771555,3578771556,1
1,1638,59168,3578771555,3578771556,1
1,1638,59169,3578771555,3578771556,1
1,1638,59170,3578771555,3578771556,1
1,1638,59171,3578771555,3578771556,1
1,1638,59172,3578771555,3578771556,1
1,1638,59173,3578771555,3578771556,1
1,1638,59174,3578771555,3578771556,1
1,1638,59175,3578771555,3578771556,1
1,1638,59176,3578771555,3578771556,1
1,1638,59177,3578771555,3578771556,1
1,1638,59178,3578771555,3578771556,1
1,1638,59179,3578771555,3578771556,1
1,1638,59180,3578771555,3578771556,1
1,1638,59181,3578771555,3578771560,5
1,1638,59182,3578771555,3578771562,7
1,1638,59183,3578771555,3578771562,7
1,1638,59184,3578771555,3578771563,8
1,1638,59185,3578771555,3578771564,9
1,1638,59186,3578771555,3578771564,9
1,1638,59187,3578771555,3578771565,10
1,1638,59188,3578771555,3578771565,10
1,1638,59189,3578771555,3578771565,10
1,1638,59190,3578771555,3578771566,11
1,1638,59191,3578771555,3578771566,11
1,1638,59192,3578771555,3578771567,12
1,1638,59193,3578771555,3578771567,12
1,1638,59194,3578771555,3578771567,12
1,1638,59195,3578771555,3578771568,13
1,1638,59196,3578771555,3578771568,13
1,1638,59197,3578771555,3578771569,14
1,1638,59198,3578771555,3578771569,14
1,1638,59199,3578771555,3578771569,14
1,1638,59200,3578771555,3578771572,17
1,1638,59201,3578771555,3578771574,19
1,1638,59202,3578771555,3578771575,20
1,1638,59203,3578771555,3578771575,20
1,1638,59204,3578771555,3578771577,22
1,1638,59205,3578771555,3578771578,23
1,1638,59206,3578771555,3578771579,24
1,1638,59207,3578771555,3578771580,25
1,1638,59208,3578771555,3578771580,25
1,1638,59209,3578771555,3578771581,26
1,1638,59210,3578771555,3578771581,26
1,1638,59211,3578771555,3578771581,26
1,1638,59212,3578771555,3578771581,26
1,1638,59213,3578771555,3578771583,28
1,1638,59214,3578771555,3578771589,34
1,1638,59215,3578771555,3578771589,34
1,1638,59216,3578771555,3578771590,35
1,1638,59217,3578771555,3578771591,36
1,1638,59218,3578771555,3578771591,36
1,1638,59219,3578771555,3578771592,37
1,1638,59220,3578771555,3578771595,40
1,1638,59221,3578771555,3578771595,40
1,1638,59222,3578771555,3578771596,41
1,1638,59223,3578771555,3578771596,41
1,1638,59224,3578771555,3578771597,42
1,1638,59225,3578771555,3578771598,43
1,1638,59226,3578771555,3578771599,44
1,1638,59227,3578771555,3578771600,45
1,1638,59228,3578771555,3578771601,46
1,1638,59229,3578771555,3578771601,46
1,1638,59230,3578771555,3578771602,47
1,1638,59231,3578771555,3578771602,47
1,1638,59232,3578771555,3578771605,50
1,1639,59233,3578771621,3578771621,0
1,1639,59234,3578771621,3578771621,0
1,1639,59235,3578771621,3578771621,0
1,1639,59236,3578771621,3578771621,0
1,1639,59237,3578771621,3578771621,0
1,1639,59238,3578771621,3578771621,0
1,1639,59239,3578771621,3578771621,0
1,1639,59240,3578771621,3578771621,0
1,1639,59241,3578771621,3578771621,0
1,1639,59242,3578771621,3578771621,0
1,1639,59243,3578771621,3578771621,0
1,1639,59244,3578771621,3578771621,0
1,1639,59245,3578771621,3578771621,0
1,1639,59246,3578771621,3578771621,0
1,1639,59247,3578771621,3578771621,0
1,1639,59248,3578771621,3578771621,0
1,1639,59249,3578771621,3578771622,1
1,1639,59250,3578771621,3578771624,3
1,1639,59251,3578771621,3578771624,3
1,1639,59252,3578771621,3578771624,3
1,1639,59253,3578771621,3578771625,4
1,1639,59254,3578771621,3578771625,4
1,1639,59255,3578771621,3578771626,5
1,1639,59256,3578771621,3578771627,6
1,1639,59257,3578771621,3578771628,7
1,1639,59258,3578771621,3578771628,7
1,1639,59259,3578771621,3578771628,7
1,1639,59260,3578771621,3578771630,9
1,1639,59261,3578771621,3578771631,10
1,1639,59262,3578771621,3578771632,11
1,1639,59263,3578771621,3578771632,11
1,1639,59264,3578771621,3578771633,12
1,1639,59265,3578771621,3578771634,13
1,1639,59266,3578771621,3578771634,13
1,1639,59267,3578771621,3578771635,14
1,1639,59268,3578771621,3578771637,16
1,1639,59269,3578771621,3578771637,16
1,1639,59270,3578771621,3578771638,17
1,1639,59271,3578771621,3578771640,19
1,1639,59272,3578771621,3578771644,23
1,1639,59273,3578771621,3578771646,25
1,1639,59274,3578771621,3578771647,26
1,1639,59275,3578771621,3578771649,28
1,1639,59276,3578771621,3578771649,28
1,1639,59277,3578771621,3578771649,28
1,1639,59278,3578771621,3578771650,29
1,1639,59279,3578771621,3578771652,31
1,1639,59280,3578771621,3578771652,31
1,1639,59281,3578771621,3578771652,31
1,1639,59282,3578771621,3578771653,32
1,1639,59283,3578771621,3578771654,33
1,1639,59284,3578771621,3578771655,34
1,1639,59285,3578771621,3578771656,35
1,1639,59286,3578771621,3578771657,36
1,1639,59287,3578771621,3578771657,36
1,1639,59288,3578771621,3578771657,36
1,1639,59289,3578771621,3578771659,38
1,1639,59290,3578771621,3578771662,41
1,1639,59291,3578771621,3578771662,41
1,1639,59292,3578771621,3578771666,45
1,1639,59293,3578771621,3578771666,45
1,1639,59294,3578771621,3578771667,46
1,1639,59295,3578771621,3578771667,46
1,1639,59296,3578771621,3578771668,47
1,1639,59297,3578771621,3578771670,49
1,1640,59298,3578771686,3578771686,0
1,1640,59299,3578771686,3578771686,0
1,1640,59300,3578771686,3578771686,0
1,1640,59301,3578771686,3578771686,0
1,1640,59302,3578771686,3578771688,2
1,1640,59303,3578771686,3578771688,2
1,1640,59304,3578771686,3578771688,2
1,1640,59305,3578771686,3578771689,3
1,1640,59306,3578771686,3578771690,4
1,1640,59307,3578771686,3578771691,5
1,1640,59308,3578771686,3578771692,6
1,1640,59309,3578771686,3578771693,7
1,1640,59310,3578771686,3578771693,7
1,1640,59311,3578771686,3578771693,7
1,1640,59312,3578771686,3578771695,9
1,1640,59313,3578771686,3578771695,9
1,1640,59314,3578771686,3578771696,10
1,1640,59315,3578771686,3578771696,10
1,1640,59316,3578771686,3578771696,10
1,1640,59317,3578771686,3578771697,11
1,1640,59318,3578771686,3578771697,11
1,1640,59319,3578771686,3578771697,11
1,1640,59320,3578771686,3578771699,13
1,1640,59321,3578771686,3578771700,14
1,1640,59322,3578771686,3578771700,14
1,1640,59323,3578771686,3578771700,14
1,1640,59324,3578771686,3578771702,16
1,1640,59325,3578771686,3578771702,16
1,1640,59326,3578771686,3578771702,16
1,1640,59327,3578771686,3578771703,17
1,1640,59328,3578771686,3578771703,17
1,1640,59329,3578771686,3578771704,18
1,1640,59330,3578771686,3578771704,18
1,1640,59331,3578771686,3578771704,18
1,1640,59332,3578771686,3578771704,18
1,1640,59333,3578771686,3578771705,19
1,1640,59334,3578771686,3578771705,19
1,1640,59335,3578771686,3578771706,20
1,1640,59336,3578771686,3578771708,22
1,1640,59337,3578771686,3578771708,22
1,1640,59338,3578771686,3578771709,23
1,1640,59339,3578771686,3578771710,24
1,1640,59340,3578771686,3578771711,25
1,1640,59341,3578771686,3578771711,25
1,1640,59342,3578771686,3578771711,25
1,1640,59343,3578771686,3578771712,26
1,1640,59344,3578771686,3578771712,26
1,1640,59345,3578771686,3578771713,27
1,1640,59346,3578771686,3578771713,27
1,1640,59347,3578771686,3578771714,28
1,1640,59348,3578771686,3578771718,32
1,1640,59349,3578771686,3578771718,32
1,1640,59350,3578771686,3578771718,32
1,1640,59351,3578771686,3578771719,33
1,1640,59352,3578771686,3578771720,34
1,1640,59353,3578771686,3578771720,34
1,1640,59354,3578771686,3578771721,35
1,1640,59355,3578771686,3578771721,35
1,1640,59356,3578771686,3578771722,36
1,1640,59357,3578771686,3578771723,37
1,1640,59358,3578771686,3578771724,38
1,1640,59359,3578771686,3578771725,39
1,1640,59360,3578771686,3578771726,40
1,1640,59361,3578771686,3578771726,40
1,1640,59362,3578771686,3578771726,40
1,1640,59363,3578771686,3578771727,41
1,1640,59364,3578771686,3578771728,42
1,1640,59365,3578771686,3578771729,43
1,1640,59366,3578771686,3578771729,43
1,1640,59367,3578771686,3578771730,44
1,1640,59368,3578771686,3578771730,44
1,1640,59369,3578771686,3578771731,45
1,1640,59370,3578771686,3578771733,47
1,1640,59371,3578771686,3578771733,47
1,1640,59372,3578771686,3578771733,47
1,1640,59373,3578771686,3578771733,47
1,1640,59374,3578771686,3578771734,48
1,1640,59375,3578771686,3578771735,49
1,1640,59376,3578771686,3578771736,50
1,1641,59377,3578771752,3578771752,0
1,1641,59378,3578771752,3578771752,0
1,1641,59379,3578771752,3578771752,0
1,1641,59380,3578771752,3578771752,0
1,1641,59381,3578771752,3578771752,0
1,1641,59382,3578771752,3578771752,0
1,1641,59383,3578771752,3578771752,0
1,1641,59384,3578771752,3578771752,0
1,1641,59385,3578771752,3578771752,0
1,1641,59386,3578771752,3578771752,0
1,1641,59387,3578771752,3578771752,0
1,1641,59388,3578771752,3578771752,0
1,1641,59389,3578771752,3578771752,0
1,1641,59390,3578771752,3578771752,0
1,1641,59391,3578771752,3578771753,1
1,1641,59392,3578771752,3578771753,1
1,1641,59393,3578771752,3578771754,2
1,1641,59394,3578771752,3578771755,3
1,1641,59395,3578771752,3578771756,4
1,1641,59396,3578771752,3578771756,4
1,1641,59397,3578771752,3578771756,4
1,1641,59398,3578771752,3578771760,8
1,1641,59399,3578771752,3578771762,10
1,1641,59400,3578771752,3578771763,11
1,1641,59401,3578771752,3578771763,11
1,1641,59402,3578771752,3578771764,12
1,1641,59403,3578771752,3578771765,13
1,1641,59404,3578771752,3578771765,13
1,1641,59405,3578771752,3578771765,13
1,1641,59406,3578771752,3578771765,13
1,1641,59407,3578771752,3578771766,14
1,1641,59408,3578771752,3578771767,15
1,1641,59409,3578771752,3578771767,15
1,1641,59410,3578771752,3578771768,16
1,1641,59411,3578771752,3578771769,17
1,1641,59412,3578771752,3578771769,17
1,1641,59413,3578771752,3578771769,17
1,1641,59414,3578771752,3578771770,18
1,1641,59415,3578771752,3578771772,20
1,1641,59416,3578771752,3578771774,22
1,1641,59417,3578771752,3578771775,23
1,1641,59418,3578771752,3578771776,24
1,1641,59419,3578771752,3578771777,25
1,1641,59420,3578771752,3578771778,26
1,1641,59421,3578771752,3578771779,27
1,1641,59422,3578771752,3578771781,29
1,1641,59423,3578771752,3578771781,29
1,1641,59424,3578771752,3578771781,29
1,1641,59425,3578771752,3578771782,30
1,1641,59426,3578771752,3578771783,31
1,1641,59427,3578771752,3578771785,33
1,1641,59428,3578771752,3578771788,36
1,1641,59429,3578771752,3578771788,36
1,1641,59430,3578771752,3578771789,37
1,1641,59431,3578771752,3578771790,38
1,1641,59432,3578771752,3578771790,38
1,1641,59433,3578771752,3578771791,39
1,1641,59434,3578771752,3578771792,40
1,1641,59435,3578771752,3578771794,42
1,1641,59436,3578771752,3578771795,43
1,1641,59437,3578771752,3578771795,43
1,1641,59438,3578771752,3578771796,44
1,1641,59439,3578771752,3578771796,44
1,1641,59440,3578771752,3578771796,44
1,1641,59441,3578771752,3578771797,45
1,1641,59442,3578771752,3578771798,46
1,1641,59443,3578771752,3578771799,47
1,1641,59444,3578771752,3578771800,48
1,1641,59445,3578771752,3578771800,48
1,1641,59446,3578771752,3578771801,49
1,1642,59447,3578771819,3578771819,0
1,1642,59448,3578771819,3578771820,1
1,1642,59449,3578771819,3578771820,1
1,1642,59450,3578771819,3578771820,1
1,1642,59451,3578771819,3578771820,1
1,1642,59452,3578771819,3578771820,1
1,1642,59453,3578771819,3578771820,1
1,1642,59454,3578771819,3578771820,1
1,1642,59455,3578771819,3578771820,1
1,1642,59456,3578771819,3578771820,1
1,1642,59457,3578771819,3578771820,1
1,1642,59458,3578771819,3578771820,1
1,1642,59459,3578771819,3578771820,1
1,1642,59460,3578771819,3578771820,1
1,1642,59461,3578771819,3578771820,1
1,1642,59462,3578771819,3578771820,1
1,1642,59463,3578771819,3578771820,1
1,1642,59464,3578771819,3578771820,1
1,1642,59465,3578771819,3578771820,1
1,1642,59466,3578771819,3578771823,4
1,1642,59467,3578771819,3578771823,4
1,1642,59468,3578771819,3578771823,4
1,1642,59469,3578771819,3578771824,5
1,1642,59470,3578771819,3578771825,6
1,1642,59471,3578771819,3578771825,6
1,1642,59472,3578771819,3578771826,7
1,1642,59473,3578771819,3578771826,7
1,1642,59474,3578771819,3578771828,9
1,1642,59475,3578771819,3578771828,9
1,1642,59476,3578771819,3578771829,10
1,1642,59477,3578771819,3578771830,11
1,1642,59478,3578771819,3578771830,11
1,1642,59479,3578771819,3578771831,12
1,1642,59480,3578771819,3578771832,13
1,1642,59481,3578771819,3578771833,14
1,1642,59482,3578771819,3578771834,15
1,1642,59483,3578771819,3578771836,17
1,1642,59484,3578771819,3578771837,18
1,1642,59485,3578771819,3578771837,18
1,1642,59486,3578771819,3578771838,19
1,1642,59487,3578771819,3578771840,21
1,1642,59488,3578771819,3578771844,25
1,1642,59489,3578771819,3578771846,27
1,1642,59490,3578771819,3578771849,30
1,1642,59491,3578771819,3578771849,30
1,1642,59492,3578771819,3578771850,31
1,1642,59493,3578771819,3578771852,33
1,1642,59494,3578771819,3578771852,33
1,1642,59495,3578771819,3578771853,34
1,1642,59496,3578771819,3578771854,35
1,1642,59497,3578771819,3578771854,35
1,1642,59498,3578771819,3578771855,36
1,1642,59499,3578771819,3578771856,37
1,1642,59500,3578771819,3578771857,38
1,1642,59501,3578771819,3578771857,38
1,1642,59502,3578771819,3578771857,38
1,1642,59503,3578771819,3578771860,41
1,1642,59504,3578771819,3578771862,43
1,1642,59505,3578771819,3578771863,44
1,1642,59506,3578771819,3578771866,47
1,1642,59507,3578771819,3578771866,47
1,1642,59508,3578771819,3578771867,48
1,1642,59509,3578771819,3578771867,48
1,1642,59510,3578771819,3578771868,49
1,1642,59511,3578771819,3578771868,49
1,1643,59512,3578771884,3578771884,0
1,1643,59513,3578771884,3578771884,0
1,1643,59514,3578771884,3578771884,0
1,1643,59515,3578771884,3578771885,1
1,1643,59516,3578771884,3578771888,4
1,1643,59517,3578771884,3578771888,4
1,1643,59518,3578771884,3578771889,5
1,1643,59519,3578771884,3578771889,5
1,1643,59520,3578771884,3578771890,6
1,1643,59521,3578771884,3578771890,6
1,1643,59522,3578771884,3578771890,6
1,1643,59523,3578771884,3578771890,6
1,1643,59524,3578771884,3578771892,8
1,1643,59525,3578771884,3578771893,9
1,1643,59526,3578771884,3578771893,9
1,1643,59527,3578771884,3578771894,10
1,1643,59528,3578771884,3578771894,10
1,1643,59529,3578771884,3578771896,12
1,1643,59530,3578771884,3578771896,12
1,1643,59531,3578771884,3578771896,12
1,1643,59532,3578771884,3578771897,13
1,1643,59533,3578771884,3578771898,14
1,1643,59534,3578771884,3578771899,15
1,1643,59535,3578771884,3578771900,16
1,1643,59536,3578771884,3578771900,16
1,1643,59537,3578771884,3578771901,17
1,1643,59538,3578771884,3578771902,18
1,1643,59539,3578771884,3578771902,18
1,1643,59540,3578771884,3578771903,19
1,1643,59541,3578771884,3578771903,19
1,1643,59542,3578771884,3578771903,19
1,1643,59543,3578771884,3578771904,20
1,1643,59544,3578771884,3578771904,20
1,1643,59545,3578771884,3578771904,20
1,1643,59546,3578771884,3578771905,21
1,1643,59547,3578771884,3578771905,21
1,1643,59548,3578771884,3578771906,22
1,1643,59549,3578771884,3578771906,22
1,1643,59550,3578771884,3578771907,23
1,1643,59551,3578771884,3578771909,25
1,1643,59552,3578771884,3578771909,25
1,1643,59553,3578771884,3578771910,26
1,1643,59554,3578771884,3578771911,27
1,1643,59555,3578771884,3578771911,27
1,1643,59556,3578771884,3578771912,28
1,1643,59557,3578771884,3578771912,28
1,1643,59558,3578771884,3578771912,28
1,1643,59559,3578771884,3578771913,29
1,1643,59560,3578771884,3578771914,30
1,1643,59561,3578771884,3578771915,31
1,1643,59562,3578771884,3578771918,34
1,1643,59563,3578771884,3578771918,34
1,1643,59564,3578771884,3578771918,34
1,1643,59565,3578771884,3578771919,35
1,1643,59566,3578771884,3578771920,36
1,1643,59567,3578771884,3578771920,36
1,1643,59568,3578771884,3578771922,38
1,1643,59569,3578771884,3578771922,38
1,1643,59570,3578771884,3578771922,38
1,1643,59571,3578771884,3578771923,39
1,1643,59572,3578771884,3578771924,40
1,1643,59573,3578771884,3578771924,40
1,1643,59574,3578771884,3578771924,40
1,1643,59575,3578771884,3578771925,41
1,1643,59576,3578771884,3578771926,42
1,1643,59577,3578771884,3578771929,45
1,1643,59578,3578771884,3578771929,45
1,1643,59579,3578771884,3578771930,46
1,1643,59580,3578771884,3578771930,46
1,1643,59581,3578771884,3578771931,47
1,1643,59582,3578771884,3578771931,47
1,1643,59583,3578771884,3578771933,49
1,1643,59584,3578771884,3578771933,49
1,1643,59585,3578771884,3578771933,49
1,1643,59586,3578771884,3578771934,50
1,1644,59587,3578771950,3578771950,0
1,1644,59588,3578771950,3578771950,0
1,1644,59589,3578771950,3578771950,0
1,1644,59590,3578771950,3578771950,0
1,1644,59591,3578771950,3578771950,0
1,1644,59592,3578771950,3578771950,0
1,1644,59593,3578771950,3578771950,0
1,1644,59594,3578771950,3578771950,0
1,1644,59595,3578771950,3578771950,0
1,1644,59596,3578771950,3578771950,0
1,1644,59597,3578771950,3578771950,0
1,1644,59598,3578771950,3578771950,0
1,1644,59599,3578771950,3578771950,0
1,1644,59600,3578771950,3578771950,0
1,1644,59601,3578771950,3578771950,0
1,1644,59602,3578771950,3578771951,1
1,1644,59603,3578771950,3578771952,2
1,1644,59604,3578771950,3578771953,3
1,1644,59605,3578771950,3578771954,4
1,1644,59606,3578771950,3578771954,4
1,1644,59607,3578771950,3578771955,5
1,1644,59608,3578771950,3578771956,6
1,1644,59609,3578771950,3578771956,6
1,1644,59610,3578771950,3578771960,10
1,1644,59611,3578771950,3578771962,12
1,1644,59612,3578771950,3578771963,13
1,1644,59613,3578771950,3578771963,13
1,1644,59614,3578771950,3578771964,14
1,1644,59615,3578771950,3578771965,15
1,1644,59616,3578771950,3578771965,15
1,1644,59617,3578771950,3578771965,15
1,1644,59618,3578771950,3578771965,15
1,1644,59619,3578771950,3578771965,15
1,1644,59620,3578771950,3578771966,16
1,1644,59621,3578771950,3578771967,17
1,1644,59622,3578771950,3578771968,18
1,1644,59623,3578771950,3578771968,18
1,1644,59624,3578771950,3578771968,18
1,1644,59625,3578771950,3578771968,18
1,1644,59626,3578771950,3578771969,19
1,1644,59627,3578771950,3578771969,19
1,1644,59628,3578771950,3578771971,21
1,1644,59629,3578771950,3578771975,25
1,1644,59630,3578771950,3578771975,25
1,1644,59631,3578771950,3578771977,27
1,1644,59632,3578771950,3578771977,27
1,1644,59633,3578771950,3578771978,28
1,1644,59634,3578771950,3578771979,29
1,1644,59635,3578771950,3578771979,29
1,1644,59636,3578771950,3578771980,30
1,1644,59637,3578771950,3578771981,31
1,1644,59638,3578771950,3578771981,31
1,1644,59639,3578771950,3578771981,31
1,1644,59640,3578771950,3578771982,32
1,1644,59641,3578771950,3578771983,33
1,1644,59642,3578771950,3578771985,35
1,1644,59643,3578771950,3578771988,38
1,1644,59644,3578771950,3578771989,39
1,1644,59645,3578771950,3578771990,40
1,1644,59646,3578771950,3578771991,41
1,1644,59647,3578771950,3578771991,41
1,1644,59648,3578771950,3578771992,42
1,1644,59649,3578771950,3578771994,44
1,1644,59650,3578771950,3578771995,45
1,1644,59651,3578771950,3578771995,45
1,1644,59652,3578771950,3578771996,46
1,1644,59653,3578771950,3578771996,46
1,1644,59654,3578771950,3578771997,47
1,1644,59655,3578771950,3578771997,47
1,1644,59656,3578771950,3578771999,49
1,1644,59657,3578771950,3578771999,49
1,1644,59658,3578771950,3578771999,49
1,1644,59659,3578771950,3578772000,50
1,1645,59660,3578772014,3578772014,0
1,1645,59661,3578772014,3578772014,0
1,1645,59662,3578772014,3578772014,0
1,1645,59663,3578772014,3578772014,0
1,1645,59664,3578772014,3578772014,0
1,1645,59665,3578772014,3578772014,0
1,1645,59666,3578772014,3578772015,1
1,1645,59667,3578772014,3578772015,1
1,1645,59668,3578772014,3578772015,1
1,1645,59669,3578772014,3578772015,1
1,1645,59670,3578772014,3578772015,1
1,1645,59671,3578772014,3578772015,1
1,1645,59672,3578772014,3578772015,1
1,1645,59673,3578772014,3578772015,1
1,1645,59674,3578772014,3578772015,1
1,1645,59675,3578772014,3578772015,1
1,1645,59676,3578772014,3578772016,2
1,1645,59677,3578772014,3578772016,2
1,1645,59678,3578772014,3578772016,2
1,1645,59679,3578772014,3578772017,3
1,1645,59680,3578772014,3578772018,4
1,1645,59681,3578772014,3578772019,5
1,1645,59682,3578772014,3578772019,5
1,1645,59683,3578772014,3578772022,8
1,1645,59684,3578772014,3578772023,9
1,1645,59685,3578772014,3578772024,10
1,1645,59686,3578772014,3578772025,11
1,1645,59687,3578772014,3578772025,11
1,1645,59688,3578772014,3578772025,11
1,1645,59689,3578772014,3578772026,12
1,1645,59690,3578772014,3578772027,13
1,1645,59691,3578772014,3578772027,13
1,1645,59692,3578772014,3578772028,14
1,1645,59693,3578772014,3578772028,14
1,1645,59694,3578772014,3578772030,16
1,1645,59695,3578772014,3578772030,16
1,1645,59696,3578772014,3578772030,16
1,1645,59697,3578772014,3578772031,17
1,1645,59698,3578772014,3578772033,19
1,1645,59699,3578772014,3578772033,19
1,1645,59700,3578772014,3578772035,21
1,1645,59701,3578772014,3578772037,23
1,1645,59702,3578772014,3578772037,23
1,1645,59703,3578772014,3578772037,23
1,1645,59704,3578772014,3578772037,23
1,1645,59705,3578772014,3578772039,25
1,1645,59706,3578772014,3578772041,27
1,1645,59707,3578772014,3578772044,30
1,1645,59708,3578772014,3578772046,32
1,1645,59709,3578772014,3578772048,34
1,1645,59710,3578772014,3578772049,35
1,1645,59711,3578772014,3578772050,36
1,1645,59712,3578772014,3578772051,37
1,1645,59713,3578772014,3578772052,38
1,1645,59714,3578772014,3578772053,39
1,1645,59715,3578772014,3578772053,39
1,1645,59716,3578772014,3578772055,41
1,1645,59717,3578772014,3578772055,41
1,1645,59718,3578772014,3578772056,42
1,1645,59719,3578772014,3578772057,43
1,1645,59720,3578772014,3578772057,43
1,1645,59721,3578772014,3578772057,43
1,1645,59722,3578772014,3578772061,47
1,1645,59723,3578772014,3578772063,49
1,1645,59724,3578772014,3578772063,49
1,1646,59725,3578772080,3578772080,0
1,1646,59726,3578772080,3578772080,0
1,1646,59727,3578772080,3578772080,0
1,1646,59728,3578772080,3578772080,0
1,1646,59729,3578772080,3578772080,0
1,1646,59730,3578772080,3578772080,0
1,1646,59731,3578772080,3578772083,3
1,1646,59732,3578772080,3578772084,4
1,1646,59733,3578772080,3578772084,4
1,1646,59734,3578772080,3578772086,6
1,1646,59735,3578772080,3578772088,8
1,1646,59736,3578772080,3578772088,8
1,1646,59737,3578772080,3578772088,8
1,1646,59738,3578772080,3578772089,9
1,1646,59739,3578772080,3578772091,11
1,1646,59740,3578772080,3578772091,11
1,1646,59741,3578772080,3578772091,11
1,1646,59742,3578772080,3578772091,11
1,1646,59743,3578772080,3578772092,12
1,1646,59744,3578772080,3578772093,13
1,1646,59745,3578772080,3578772093,13
1,1646,59746,3578772080,3578772093,13
1,1646,59747,3578772080,3578772094,14
1,1646,59748,3578772080,3578772096,16
1,1646,59749,3578772080,3578772096,16
1,1646,59750,3578772080,3578772097,17
1,1646,59751,3578772080,3578772098,18
1,1646,59752,3578772080,3578772099,19
1,1646,59753,3578772080,3578772099,19
1,1646,59754,3578772080,3578772101,21
1,1646,59755,3578772080,3578772101,21
1,1646,59756,3578772080,3578772103,23
1,1646,59757,3578772080,3578772103,23
1,1646,59758,3578772080,3578772103,23
1,1646,59759,3578772080,3578772104,24
1,1646,59760,3578772080,3578772104,24
1,1646,59761,3578772080,3578772104,24
1,1646,59762,3578772080,3578772104,24
1,1646,59763,3578772080,3578772104,24
1,1646,59764,3578772080,3578772104,24
1,1646,59765,3578772080,3578772105,25
1,1646,59766,3578772080,3578772105,25
1,1646,59767,3578772080,3578772107,27
1,1646,59768,3578772080,3578772108,28
1,1646,59769,3578772080,3578772110,30
1,1646,59770,3578772080,3578772110,30
1,1646,59771,3578772080,3578772112,32
1,1646,59772,3578772080,3578772112,32
1,1646,59773,3578772080,3578772112,32
1,1646,59774,3578772080,3578772113,33
1,1646,59775,3578772080,3578772114,34
1,1646,59776,3578772080,3578772116,36
1,1646,59777,3578772080,3578772118,38
1,1646,59778,3578772080,3578772118,38
1,1646,59779,3578772080,3578772118,38
1,1646,59780,3578772080,3578772120,40
1,1646,59781,3578772080,3578772120,40
1,1646,59782,3578772080,3578772121,41
1,1646,59783,3578772080,3578772121,41
1,1646,59784,3578772080,3578772122,42
1,1646,59785,3578772080,3578772123,43
1,1646,59786,3578772080,3578772123,43
1,1646,59787,3578772080,3578772123,43
1,1646,59788,3578772080,3578772125,45
1,1646,59789,3578772080,3578772125,45
1,1646,59790,3578772080,3578772125,45
1,1646,59791,3578772080,3578772125,45
1,1646,59792,3578772080,3578772126,46
1,1646,59793,3578772080,3578772127,47
1,1646,59794,3578772080,3578772129,49
1,1646,59795,3578772080,3578772129,49
1,1646,59796,3578772080,3578772129,49
1,1646,59797,3578772080,3578772130,50
1,1647,59798,3578772144,3578772144,0
1,1647,59799,3578772144,3578772144,0
1,1647,59800,3578772144,3578772144,0
1,1647,59801,3578772144,3578772144,0
1,1647,59802,3578772144,3578772144,0
1,1647,59803,3578772144,3578772144,0
1,1647,59804,3578772144,3578772144,0
1,1647,59805,3578772144,3578772144,0
1,1647,59806,3578772144,3578772144,0
1,1647,59807,3578772144,3578772144,0
1,1647,59808,3578772144,3578772144,0
1,1647,59809,3578772144,3578772147,3
1,1647,59810,3578772144,3578772148,4
1,1647,59811,3578772144,3578772149,5
1,1647,59812,3578772144,3578772150,6
1,1647,59813,3578772144,3578772150,6
1,1647,59814,3578772144,3578772151,7
1,1647,59815,3578772144,3578772153,9
1,1647,59816,3578772144,3578772153,9
1,1647,59817,3578772144,3578772154,10
1,1647,59818,3578772144,3578772154,10
1,1647,59819,3578772144,3578772155,11
1,1647,59820,3578772144,3578772156,12
1,1647,59821,3578772144,3578772156,12
1,1647,59822,3578772144,3578772160,16
1,1647,59823,3578772144,3578772163,19
1,1647,59824,3578772144,3578772163,19
1,1647,59825,3578772144,3578772164,20
1,1647,59826,3578772144,3578772164,20
1,1647,59827,3578772144,3578772164,20
1,1647,59828,3578772144,3578772165,21
1,1647,59829,3578772144,3578772165,21
1,1647,59830,3578772144,3578772166,22
1,1647,59831,3578772144,3578772166,22
1,1647,59832,3578772144,3578772166,22
1,1647,59833,3578772144,3578772167,23
1,1647,59834,3578772144,3578772168,24
1,1647,59835,3578772144,3578772168,24
1,1647,59836,3578772144,3578772169,25
1,1647,59837,3578772144,3578772169,25
1,1647,59838,3578772144,3578772169,25
1,1647,59839,3578772144,3578772169,25
1,1647,59840,3578772144,3578772171,27
1,1647,59841,3578772144,3578772175,31
1,1647,59842,3578772144,3578772176,32
1,1647,59843,3578772144,3578772177,33
1,1647,59844,3578772144,3578772179,35
1,1647,59845,3578772144,3578772179,35
1,1647,59846,3578772144,3578772180,36
1,1647,59847,3578772144,3578772181,37
1,1647,59848,3578772144,3578772181,37
1,1647,59849,3578772144,3578772181,37
1,1647,59850,3578772144,3578772182,38
1,1647,59851,3578772144,3578772184,40
1,1647,59852,3578772144,3578772185,41
1,1647,59853,3578772144,3578772189,45
1,1647,59854,3578772144,3578772189,45
1,1647,59855,3578772144,3578772190,46
1,1647,59856,3578772144,3578772190,46
1,1647,59857,3578772144,3578772191,47
1,1647,59858,3578772144,3578772192,48
1,1648,59859,3578772208,3578772208,0
1,1648,59860,3578772208,3578772208,0
1,1648,59861,3578772208,3578772208,0
1,1648,59862,3578772208,3578772208,0
1,1648,59863,3578772208,3578772208,0
1,1648,59864,3578772208,3578772208,0
1,1648,59865,3578772208,3578772208,0
1,1648,59866,3578772208,3578772208,0
1,1648,59867,3578772208,3578772208,0
1,1648,59868,3578772208,3578772208,0
1,1648,59869,3578772208,3578772208,0
1,1648,59870,3578772208,3578772208,0
1,1648,59871,3578772208,3578772208,0
1,1648,59872,3578772208,3578772208,0
1,1648,59873,3578772208,3578772208,0
1,1648,59874,3578772208,3578772208,0
1,1648,59875,3578772208,3578772208,0
1,1648,59876,3578772208,3578772208,0
1,1648,59877,3578772208,3578772208,0
1,1648,59878,3578772208,3578772210,2
1,1648,59879,3578772208,3578772213,5
1,1648,59880,3578772208,3578772213,5
1,1648,59881,3578772208,3578772213,5
1,1648,59882,3578772208,3578772214,6
1,1648,59883,3578772208,3578772215,7
1,1648,59884,3578772208,3578772216,8
1,1648,59885,3578772208,3578772217,9
1,1648,59886,3578772208,3578772217,9
1,1648,59887,3578772208,3578772217,9
1,1648,59888,3578772208,3578772217,9
1,1648,59889,3578772208,3578772218,10
1,1648,59890,3578772208,3578772219,11
1,1648,59891,3578772208,3578772220,12
1,1648,59892,3578772208,3578772222,14
1,1648,59893,3578772208,3578772224,16
1,1648,59894,3578772208,3578772224,16
1,1648,59895,3578772208,3578772225,17
1,1648,59896,3578772208,3578772225,17
1,1648,59897,3578772208,3578772227,19
1,1648,59898,3578772208,3578772228,20
1,1648,59899,3578772208,3578772228,20
1,1648,59900,3578772208,3578772228,20
1,1648,59901,3578772208,3578772229,21
1,1648,59902,3578772208,3578772230,22
1,1648,59903,3578772208,3578772231,23
1,1648,59904,3578772208,3578772231,23
1,1648,59905,3578772208,3578772232,24
1,1648,59906,3578772208,3578772232,24
1,1648,59907,3578772208,3578772233,25
1,1648,59908,3578772208,3578772236,28
1,1648,59909,3578772208,3578772237,29
1,1648,59910,3578772208,3578772237,29
1,1648,59911,3578772208,3578772237,29
1,1648,59912,3578772208,3578772237,29
1,1648,59913,3578772208,3578772239,31
1,1648,59914,3578772208,3578772241,33
1,1648,59915,3578772208,3578772244,36
1,1648,59916,3578772208,3578772246,38
1,1648,59917,3578772208,3578772249,41
1,1648,59918,3578772208,3578772249,41
1,1648,59919,3578772208,3578772250,42
1,1648,59920,3578772208,3578772251,43
1,1648,59921,3578772208,3578772252,44
1,1648,59922,3578772208,3578772253,45
1,1648,59923,3578772208,3578772254,46
1,1648,59924,3578772208,3578772254,46
1,1648,59925,3578772208,3578772255,47
1,1648,59926,3578772208,3578772256,48
1,1648,59927,3578772208,3578772257,49
1,1648,59928,3578772208,3578772257,49
1,1648,59929,3578772208,3578772257,49
1,1649,59930,3578772274,3578772274,0
1,1649,59931,3578772274,3578772274,0
1,1649,59932,3578772274,3578772274,0
1,1649,59933,3578772274,3578772274,0
1,1649,59934,3578772274,3578772274,0
1,1649,59935,3578772274,3578772274,0
1,1649,59936,3578772274,3578772274,0
1,1649,59937,3578772274,3578772274,0
1,1649,59938,3578772274,3578772274,0
1,1649,59939,3578772274,3578772283,9
1,1649,59940,3578772274,3578772283,9
1,1649,59941,3578772274,3578772284,10
1,1649,59942,3578772274,3578772285,11
1,1649,59943,3578772274,3578772288,14
1,1649,59944,3578772274,3578772288,14
1,1649,59945,3578772274,3578772288,14
1,1649,59946,3578772274,3578772289,15
1,1649,59947,3578772274,3578772289,15
1,1649,59948,3578772274,3578772291,17
1,1649,59949,3578772274,3578772291,17
1,1649,59950,3578772274,3578772291,17
1,1649,59951,3578772274,3578772291,17
1,1649,59952,3578772274,3578772291,17
1,1649,59953,3578772274,3578772293,19
1,1649,59954,3578772274,3578772293,19
1,1649,59955,3578772274,3578772293,19
1,1649,59956,3578772274,3578772294,20
1,1649,59957,3578772274,3578772294,20
1,1649,59958,3578772274,3578772295,21
1,1649,59959,3578772274,3578772297,23
1,1649,59960,3578772274,3578772298,24
1,1649,59961,3578772274,3578772299,25
1,1649,59962,3578772274,3578772300,26
1,1649,59963,3578772274,3578772301,27
1,1649,59964,3578772274,3578772302,28
1,1649,59965,3578772274,3578772303,29
1,1649,59966,3578772274,3578772303,29
1,1649,59967,3578772274,3578772303,29
1,1649,59968,3578772274,3578772304,30
1,1649,59969,3578772274,3578772304,30
1,1649,59970,3578772274,3578772305,31
1,1649,59971,3578772274,3578772305,31
1,1649,59972,3578772274,3578772306,32
1,1649,59973,3578772274,3578772306,32
1,1649,59974,3578772274,3578772308,34
1,1649,59975,3578772274,3578772308,34
1,1649,59976,3578772274,3578772309,35
1,1649,59977,3578772274,3578772310,36
1,1649,59978,3578772274,3578772312,38
1,1649,59979,3578772274,3578772312,38
1,1649,59980,3578772274,3578772312,38
1,1649,59981,3578772274,3578772312,38
1,1649,59982,3578772274,3578772312,38
1,1649,59983,3578772274,3578772313,39
1,1649,59984,3578772274,3578772315,41
1,1649,59985,3578772274,3578772315,41
1,1649,59986,3578772274,3578772315,41
1,1649,59987,3578772274,3578772317,43
1,1649,59988,3578772274,3578772318,44
1,1649,59989,3578772274,3578772318,44
1,1649,59990,3578772274,3578772319,45
1,1649,59991,3578772274,3578772320,46
1,1649,59992,3578772274,3578772321,47
1,1649,59993,3578772274,3578772321,47
1,1649,59994,3578772274,3578772323,49
1,1649,59995,3578772274,3578772323,49
1,1650,59996,3578772340,3578772340,0
1,1650,59997,3578772340,3578772340,0
1,1650,59998,3578772340,3578772340,0
1,1650,59999,3578772340,3578772340,0
1,1650,60000,3578772340,3578772340,0
1,1650,60001,3578772340,3578772340,0
1,1650,60002,3578772340,3578772340,0
1,1650,60003,3578772340,3578772340,0
1,1650,60004,3578772340,3578772340,0
1,1650,60005,3578772340,3578772340,0
1,1650,60006,3578772340,3578772340,0
1,1650,60007,3578772340,3578772340,0
1,1650,60008,3578772340,3578772340,0
1,1650,60009,3578772340,3578772340,0
1,1650,60010,3578772340,3578772340,0
1,1650,60011,3578772340,3578772340,0
1,1650,60012,3578772340,3578772340,0
1,1650,60013,3578772340,3578772340,0
1,1650,60014,3578772340,3578772340,0
1,1650,60015,3578772340,3578772341,1
1,1650,60016,3578772340,3578772341,1
1,1650,60017,3578772340,3578772343,3
1,1650,60018,3578772340,3578772348,8
1,1650,60019,3578772340,3578772348,8
1,1650,60020,3578772340,3578772348,8
1,1650,60021,3578772340,3578772348,8
1,1650,60022,3578772340,3578772350,10
1,1650,60023,3578772340,3578772350,10
1,1650,60024,3578772340,3578772351,11
1,1650,60025,3578772340,3578772352,12
1,1650,60026,3578772340,3578772352,12
1,1650,60027,3578772340,3578772354,14
1,1650,60028,3578772340,3578772355,15
1,1650,60029,3578772340,3578772356,16
1,1650,60030,3578772340,3578772360,20
1,1650,60031,3578772340,3578772363,23
1,1650,60032,3578772340,3578772363,23
1,1650,60033,3578772340,3578772364,24
1,1650,60034,3578772340,3578772364,24
1,1650,60035,3578772340,3578772364,24
1,1650,60036,3578772340,3578772366,26
1,1650,60037,3578772340,3578772366,26
1,1650,60038,3578772340,3578772366,26
1,1650,60039,3578772340,3578772367,27
1,1650,60040,3578772340,3578772368,28
1,1650,60041,3578772340,3578772368,28
1,1650,60042,3578772340,3578772369,29
1,1650,60043,3578772340,3578772370,30
1,1650,60044,3578772340,3578772370,30
1,1650,60045,3578772340,3578772370,30
1,1650,60046,3578772340,3578772373,33
1,1650,60047,3578772340,3578772376,36
1,1650,60048,3578772340,3578772377,37
1,1650,60049,3578772340,3578772377,37
1,1650,60050,3578772340,3578772378,38
1,1650,60051,3578772340,3578772379,39
1,1650,60052,3578772340,3578772379,39
1,1650,60053,3578772340,3578772380,40
1,1650,60054,3578772340,3578772381,41
1,1650,60055,3578772340,3578772381,41
1,1650,60056,3578772340,3578772381,41
1,1650,60057,3578772340,3578772381,41
1,1650,60058,3578772340,3578772382,42
1,1650,60059,3578772340,3578772382,42
1,1650,60060,3578772340,3578772383,43
1,1650,60061,3578772340,3578772389,49
1,1651,60062,3578772405,3578772405,0
1,1651,60063,3578772405,3578772405,0
1,1651,60064,3578772405,3578772405,0
1,1651,60065,3578772405,3578772405,0
1,1651,60066,3578772405,3578772405,0
1,1651,60067,3578772405,3578772405,0
1,1651,60068,3578772405,3578772405,0
1,1651,60069,3578772405,3578772405,0
1,1651,60070,3578772405,3578772405,0
1,1651,60071,3578772405,3578772405,0
1,1651,60072,3578772405,3578772405,0
1,1651,60073,3578772405,3578772405,0
1,1651,60074,3578772405,3578772405,0
1,1651,60075,3578772405,3578772405,0
1,1651,60076,3578772405,3578772405,0
1,1651,60077,3578772405,3578772405,0
1,1651,60078,3578772405,3578772405,0
1,1651,60079,3578772405,3578772405,0
1,1651,60080,3578772405,3578772405,0
1,1651,60081,3578772405,3578772406,1
1,1651,60082,3578772405,3578772406,1
1,1651,60083,3578772405,3578772409,4
1,1651,60084,3578772405,3578772410,5
1,1651,60085,3578772405,3578772412,7
1,1651,60086,3578772405,3578772412,7
1,1651,60087,3578772405,3578772413,8
1,1651,60088,3578772405,3578772413,8
1,1651,60089,3578772405,3578772414,9
1,1651,60090,3578772405,3578772416,11
1,1651,60091,3578772405,3578772417,12
1,1651,60092,3578772405,3578772417,12
1,1651,60093,3578772405,3578772417,12
1,1651,60094,3578772405,3578772417,12
1,1651,60095,3578772405,3578772418,13
1,1651,60096,3578772405,3578772418,13
1,1651,60097,3578772405,3578772419,14
1,1651,60098,3578772405,3578772421,16
1,1651,60099,3578772405,3578772424,19
1,1651,60100,3578772405,3578772424,19
1,1651,60101,3578772405,3578772424,19
1,1651,60102,3578772405,3578772425,20
1,1651,60103,3578772405,3578772426,21
1,1651,60104,3578772405,3578772427,22
1,1651,60105,3578772405,3578772429,24
1,1651,60106,3578772405,3578772429,24
1,1651,60107,3578772405,3578772430,25
1,1651,60108,3578772405,3578772430,25
1,1651,60109,3578772405,3578772431,26
1,1651,60110,3578772405,3578772431,26
1,1651,60111,3578772405,3578772433,28
1,1651,60112,3578772405,3578772433,28
1,1651,60113,3578772405,3578772433,28
1,1651,60114,3578772405,3578772433,28
1,1651,60115,3578772405,3578772436,31
1,1651,60116,3578772405,3578772437,32
1,1651,60117,3578772405,3578772437,32
1,1651,60118,3578772405,3578772437,32
1,1651,60119,3578772405,3578772437,32
1,1651,60120,3578772405,3578772440,35
1,1651,60121,3578772405,3578772441,36
1,1651,60122,3578772405,3578772445,40
1,1651,60123,3578772405,3578772446,41
1,1651,60124,3578772405,3578772449,44
1,1651,60125,3578772405,3578772449,44
1,1651,60126,3578772405,3578772450,45
1,1651,60127,3578772405,3578772450,45
1,1651,60128,3578772405,3578772451,46
1,1651,60129,3578772405,3578772453,48
1,1651,60130,3578772405,3578772454,49
1,1651,60131,3578772405,3578772454,49
1,1651,60132,3578772405,3578772454,49
1,1651,60133,3578772405,3578772455,50
1,1652,60134,3578772471,3578772471,0
1,1652,60135,3578772471,3578772471,0
1,1652,60136,3578772471,3578772471,0
1,1652,60137,3578772471,3578772471,0
1,1652,60138,3578772471,3578772471,0
1,1652,60139,3578772471,3578772471,0
1,1652,60140,3578772471,3578772471,0
1,1652,60141,3578772471,3578772471,0
1,1652,60142,3578772471,3578772471,0
1,1652,60143,3578772471,3578772471,0
1,1652,60144,3578772471,3578772471,0
1,1652,60145,3578772471,3578772471,0
1,1652,60146,3578772471,3578772471,0
1,1652,60147,3578772471,3578772482,11
1,1652,60148,3578772471,3578772484,13
1,1652,60149,3578772471,3578772484,13
1,1652,60150,3578772471,3578772486,15
1,1652,60151,3578772471,3578772487,16
1,1652,60152,3578772471,3578772488,17
1,1652,60153,3578772471,3578772488,17
1,1652,60154,3578772471,3578772489,18
1,1652,60155,3578772471,3578772489,18
1,1652,60156,3578772471,3578772490,19
1,1652,60157,3578772471,3578772491,20
1,1652,60158,3578772471,3578772491,20
1,1652,60159,3578772471,3578772491,20
1,1652,60160,3578772471,3578772492,21
1,1652,60161,3578772471,3578772493,22
1,1652,60162,3578772471,3578772493,22
1,1652,60163,3578772471,3578772493,22
1,1652,60164,3578772471,3578772495,24
1,1652,60165,3578772471,3578772496,25
1,1652,60166,3578772471,3578772496,25
1,1652,60167,3578772471,3578772496,25
1,1652,60168,3578772471,3578772496,25
1,1652,60169,3578772471,3578772496,25
1,1652,60170,3578772471,3578772499,28
1,1652,60171,3578772471,3578772500,29
1,1652,60172,3578772471,3578772501,30
1,1652,60173,3578772471,3578772502,31
1,1652,60174,3578772471,3578772503,32
1,1652,60175,3578772471,3578772503,32
1,1652,60176,3578772471,3578772504,33
1,1652,60177,3578772471,3578772504,33
1,1652,60178,3578772471,3578772504,33
1,1652,60179,3578772471,3578772505,34
1,1652,60180,3578772471,3578772505,34
1,1652,60181,3578772471,3578772506,35
1,1652,60182,3578772471,3578772507,36
1,1652,60183,3578772471,3578772509,38
1,1652,60184,3578772471,3578772509,38
1,1652,60185,3578772471,3578772510,39
1,1652,60186,3578772471,3578772512,41
1,1652,60187,3578772471,3578772512,41
1,1652,60188,3578772471,3578772512,41
1,1652,60189,3578772471,3578772512,41
1,1652,60190,3578772471,3578772512,41
1,1652,60191,3578772471,3578772512,41
1,1652,60192,3578772471,3578772514,43
1,1652,60193,3578772471,3578772515,44
1,1652,60194,3578772471,3578772515,44
1,1652,60195,3578772471,3578772520,49
1,1652,60196,3578772471,3578772520,49
1,1652,60197,3578772471,3578772520,49
1,1653,60198,3578772538,3578772538,0
1,1653,60199,3578772538,3578772538,0
1,1653,60200,3578772538,3578772538,0
1,1653,60201,3578772538,3578772538,0
1,1653,60202,3578772538,3578772538,0
1,1653,60203,3578772538,3578772538,0
1,1653,60204,3578772538,3578772538,0
1,1653,60205,3578772538,3578772538,0
1,1653,60206,3578772538,3578772538,0
1,1653,60207,3578772538,3578772538,0
1,1653,60208,3578772538,3578772538,0
1,1653,60209,3578772538,3578772538,0
1,1653,60210,3578772538,3578772538,0
1,1653,60211,3578772538,3578772538,0
1,1653,60212,3578772538,3578772538,0
1,1653,60213,3578772538,3578772538,0
1,1653,60214,3578772538,3578772538,0
1,1653,60215,3578772538,3578772538,0
1,1653,60216,3578772538,3578772538,0
1,1653,60217,3578772538,3578772538,0
1,1653,60218,3578772538,3578772538,0
1,1653,60219,3578772538,3578772540,2
1,1653,60220,3578772538,3578772540,2
1,1653,60221,3578772538,3578772542,4
1,1653,60222,3578772538,3578772547,9
1,1653,60223,3578772538,3578772547,9
1,1653,60224,3578772538,3578772548,10
1,1653,60225,3578772538,3578772548,10
1,1653,60226,3578772538,3578772549,11
1,1653,60227,3578772538,3578772550,12
1,1653,60228,3578772538,3578772550,12
1,1653,60229,3578772538,3578772550,12
1,1653,60230,3578772538,3578772551,13
1,1653,60231,3578772538,3578772552,14
1,1653,60232,3578772538,3578772553,15
1,1653,60233,3578772538,3578772555,17
1,1653,60234,3578772538,3578772555,17
1,1653,60235,3578772538,3578772556,18
1,1653,60236,3578772538,3578772559,21
1,1653,60237,3578772538,3578772562,24
1,1653,60238,3578772538,3578772562,24
1,1653,60239,3578772538,3578772562,24
1,1653,60240,3578772538,3578772563,25
1,1653,60241,3578772538,3578772564,26
1,1653,60242,3578772538,3578772565,27
1,1653,60243,3578772538,3578772565,27
1,1653,60244,3578772538,3578772565,27
1,1653,60245,3578772538,3578772567,29
1,1653,60246,3578772538,3578772568,30
1,1653,60247,3578772538,3578772568,30
1,1653,60248,3578772538,3578772569,31
1,1653,60249,3578772538,3578772571,33
1,1653,60250,3578772538,3578772574,36
1,1653,60251,3578772538,3578772576,38
1,1653,60252,3578772538,3578772577,39
1,1653,60253,3578772538,3578772578,40
1,1653,60254,3578772538,3578772578,40
1,1653,60255,3578772538,3578772579,41
1,1653,60256,3578772538,3578772580,42
1,1653,60257,3578772538,3578772580,42
1,1653,60258,3578772538,3578772581,43
1,1653,60259,3578772538,3578772581,43
1,1653,60260,3578772538,3578772581,43
1,1653,60261,3578772538,3578772581,43
1,1653,60262,3578772538,3578772582,44
1,1653,60263,3578772538,3578772588,50
1,1654,60264,3578772605,3578772605,0
1,1654,60265,3578772605,3578772605,0
1,1654,60266,3578772605,3578772605,0
1,1654,60267,3578772605,3578772605,0
1,1654,60268,3578772605,3578772605,0
1,1654,60269,3578772605,3578772605,0
1,1654,60270,3578772605,3578772605,0
1,1654,60271,3578772605,3578772605,0
1,1654,60272,3578772605,3578772605,0
1,1654,60273,3578772605,3578772605,0
1,1654,60274,3578772605,3578772605,0
1,1654,60275,3578772605,3578772605,0
1,1654,60276,3578772605,3578772605,0
1,1654,60277,3578772605,3578772605,0
1,1654,60278,3578772605,3578772605,0
1,1654,60279,3578772605,3578772605,0
1,1654,60280,3578772605,3578772605,0
1,1654,60281,3578772605,3578772605,0
1,1654,60282,3578772605,3578772606,1
1,1654,60283,3578772605,3578772609,4
1,1654,60284,3578772605,3578772609,4
1,1654,60285,3578772605,3578772612,7
1,1654,60286,3578772605,3578772612,7
1,1654,60287,3578772605,3578772613,8
1,1654,60288,3578772605,3578772613,8
1,1654,60289,3578772605,3578772614,9
1,1654,60290,3578772605,3578772615,10
1,1654,60291,3578772605,3578772616,11
1,1654,60292,3578772605,3578772616,11
1,1654,60293,3578772605,3578772616,11
1,1654,60294,3578772605,3578772616,11
1,1654,60295,3578772605,3578772617,12
1,1654,60296,3578772605,3578772617,12
1,1654,60297,3578772605,3578772617,12
1,1654,60298,3578772605,3578772618,13
1,1654,60299,3578772605,3578772619,14
1,1654,60300,3578772605,3578772619,14
1,1654,60301,3578772605,3578772623,18
1,1654,60302,3578772605,3578772623,18
1,1654,60303,3578772605,3578772624,19
1,1654,60304,3578772605,3578772624,19
1,1654,60305,3578772605,3578772626,21
1,1654,60306,3578772605,3578772628,23
1,1654,60307,3578772605,3578772628,23
1,1654,60308,3578772605,3578772628,23
1,1654,60309,3578772605,3578772628,23
1,1654,60310,3578772605,3578772630,25
1,1654,60311,3578772605,3578772631,26
1,1654,60312,3578772605,3578772631,26
1,1654,60313,3578772605,3578772631,26
1,1654,60314,3578772605,3578772632,27
1,1654,60315,3578772605,3578772632,27
1,1654,60316,3578772605,3578772634,29
1,1654,60317,3578772605,3578772635,30
1,1654,60318,3578772605,3578772636,31
1,1654,60319,3578772605,3578772636,31
1,1654,60320,3578772605,3578772637,32
1,1654,60321,3578772605,3578772637,32
1,1654,60322,3578772605,3578772639,34
1,1654,60323,3578772605,3578772646,41
1,1654,60324,3578772605,3578772647,42
1,1654,60325,3578772605,3578772649,44
1,1654,60326,3578772605,3578772650,45
1,1654,60327,3578772605,3578772650,45
1,1654,60328,3578772605,3578772651,46
1,1654,60329,3578772605,3578772652,47
1,1654,60330,3578772605,3578772652,47
1,1654,60331,3578772605,3578772653,48
1,1654,60332,3578772605,3578772654,49
1,1654,60333,3578772605,3578772654,49
1,1654,60334,3578772605,3578772655,50
1,1655,60335,3578772672,3578772672,0
1,1655,60336,3578772672,3578772672,0
1,1655,60337,3578772672,3578772672,0
1,1655,60338,3578772672,3578772672,0
1,1655,60339,3578772672,3578772672,0
1,1655,60340,3578772672,3578772672,0
1,1655,60341,3578772672,3578772672,0
1,1655,60342,3578772672,3578772672,0
1,1655,60343,3578772672,3578772672,0
1,1655,60344,3578772672,3578772672,0
1,1655,60345,3578772672,3578772672,0
1,1655,60346,3578772672,3578772672,0
1,1655,60347,3578772672,3578772682,10
1,1655,60348,3578772672,3578772684,12
1,1655,60349,3578772672,3578772684,12
1,1655,60350,3578772672,3578772687,15
1,1655,60351,3578772672,3578772687,15
1,1655,60352,3578772672,3578772688,16
1,1655,60353,3578772672,3578772689,17
1,1655,60354,3578772672,3578772689,17
1,1655,60355,3578772672,3578772690,18
1,1655,60356,3578772672,3578772690,18
1,1655,60357,3578772672,3578772690,18
1,1655,60358,3578772672,3578772691,19
1,1655,60359,3578772672,3578772691,19
1,1655,60360,3578772672,3578772692,20
1,1655,60361,3578772672,3578772692,20
1,1655,60362,3578772672,3578772693,21
1,1655,60363,3578772672,3578772693,21
1,1655,60364,3578772672,3578772694,22
1,1655,60365,3578772672,3578772696,24
1,1655,60366,3578772672,3578772696,24
1,1655,60367,3578772672,3578772696,24
1,1655,60368,3578772672,3578772696,24
1,1655,60369,3578772672,3578772697,25
1,1655,60370,3578772672,3578772699,27
1,1655,60371,3578772672,3578772700,28
1,1655,60372,3578772672,3578772701,29
1,1655,60373,3578772672,3578772702,30
1,1655,60374,3578772672,3578772702,30
1,1655,60375,3578772672,3578772703,31
1,1655,60376,3578772672,3578772703,31
1,1655,60377,3578772672,3578772703,31
1,1655,60378,3578772672,3578772704,32
1,1655,60379,3578772672,3578772704,32
1,1655,60380,3578772672,3578772704,32
1,1655,60381,3578772672,3578772704,32
1,1655,60382,3578772672,3578772705,33
1,1655,60383,3578772672,3578772706,34
1,1655,60384,3578772672,3578772706,34
1,1655,60385,3578772672,3578772707,35
1,1655,60386,3578772672,3578772710,38
1,1655,60387,3578772672,3578772710,38
1,1655,60388,3578772672,3578772712,40
1,1655,60389,3578772672,3578772712,40
1,1655,60390,3578772672,3578772712,40
1,1655,60391,3578772672,3578772712,40
1,1655,60392,3578772672,3578772713,41
1,1655,60393,3578772672,3578772713,41
1,1655,60394,3578772672,3578772714,42
1,1655,60395,3578772672,3578772716,44
1,1655,60396,3578772672,3578772719,47
1,1655,60397,3578772672,3578772719,47
1,1655,60398,3578772672,3578772719,47
1,1655,60399,3578772672,3578772720,48
1,1655,60400,3578772672,3578772720,48
1,1655,60401,3578772672,3578772721,49
1,1656,60402,3578772738,3578772738,0
1,1656,60403,3578772738,3578772738,0
1,1656,60404,3578772738,3578772738,0
1,1656,60405,3578772738,3578772738,0
1,1656,60406,3578772738,3578772738,0
1,1656,60407,3578772738,3578772738,0
1,1656,60408,3578772738,3578772738,0
1,1656,60409,3578772738,3578772738,0
1,1656,60410,3578772738,3578772738,0
1,1656,60411,3578772738,3578772738,0
1,1656,60412,3578772738,3578772738,0
1,1656,60413,3578772738,3578772738,0
1,1656,60414,3578772738,3578772738,0
1,1656,60415,3578772738,3578772738,0
1,1656,60416,3578772738,3578772738,0
1,1656,60417,3578772738,3578772739,1
1,1656,60418,3578772738,3578772741,3
1,1656,60419,3578772738,3578772741,3
1,1656,60420,3578772738,3578772742,4
1,1656,60421,3578772738,3578772742,4
1,1656,60422,3578772738,3578772747,9
1,1656,60423,3578772738,3578772747,9
1,1656,60424,3578772738,3578772748,10
1,1656,60425,3578772738,3578772748,10
1,1656,60426,3578772738,3578772750,12
1,1656,60427,3578772738,3578772750,12
1,1656,60428,3578772738,3578772750,12
1,1656,60429,3578772738,3578772750,12
1,1656,60430,3578772738,3578772750,12
1,1656,60431,3578772738,3578772752,14
1,1656,60432,3578772738,3578772753,15
1,1656,60433,3578772738,3578772754,16
1,1656,60434,3578772738,3578772755,17
1,1656,60435,3578772738,3578772755,17
1,1656,60436,3578772738,3578772756,18
1,1656,60437,3578772738,3578772759,21
1,1656,60438,3578772738,3578772762,24
1,1656,60439,3578772738,3578772763,25
1,1656,60440,3578772738,3578772764,26
1,1656,60441,3578772738,3578772764,26
1,1656,60442,3578772738,3578772764,26
1,1656,60443,3578772738,3578772764,26
1,1656,60444,3578772738,3578772765,27
1,1656,60445,3578772738,3578772765,27
1,1656,60446,3578772738,3578772766,28
1,1656,60447,3578772738,3578772767,29
1,1656,60448,3578772738,3578772768,30
1,1656,60449,3578772738,3578772768,30
1,1656,60450,3578772738,3578772769,31
1,1656,60451,3578772738,3578772769,31
1,1656,60452,3578772738,3578772770,32
1,1656,60453,3578772738,3578772774,36
1,1656,60454,3578772738,3578772776,38
1,1656,60455,3578772738,3578772777,39
1,1656,60456,3578772738,3578772778,40
1,1656,60457,3578772738,3578772778,40
1,1656,60458,3578772738,3578772780,42
1,1656,60459,3578772738,3578772780,42
1,1656,60460,3578772738,3578772780,42
1,1656,60461,3578772738,3578772781,43
1,1656,60462,3578772738,3578772781,43
1,1656,60463,3578772738,3578772781,43
1,1656,60464,3578772738,3578772784,46
1,1656,60465,3578772738,3578772788,50
1,1657,60466,3578772803,3578772803,0
1,1657,60467,3578772803,3578772803,0
1,1657,60468,3578772803,3578772803,0
1,1657,60469,3578772803,3578772803,0
1,1657,60470,3578772803,3578772803,0
1,1657,60471,3578772803,3578772803,0
1,1657,60472,3578772803,3578772803,0
1,1657,60473,3578772803,3578772803,0
1,1657,60474,3578772803,3578772803,0
1,1657,60475,3578772803,3578772803,0
1,1657,60476,3578772803,3578772803,0
1,1657,60477,3578772803,3578772803,0
1,1657,60478,3578772803,3578772803,0
1,1657,60479,3578772803,3578772803,0
1,1657,60480,3578772803,3578772803,0
1,1657,60481,3578772803,3578772803,0
1,1657,60482,3578772803,3578772803,0
1,1657,60483,3578772803,3578772805,2
1,1657,60484,3578772803,3578772806,3
1,1657,60485,3578772803,3578772806,3
1,1657,60486,3578772803,3578772809,6
1,1657,60487,3578772803,3578772810,7
1,1657,60488,3578772803,3578772812,9
1,1657,60489,3578772803,3578772813,10
1,1657,60490,3578772803,3578772813,10
1,1657,60491,3578772803,3578772813,10
1,1657,60492,3578772803,3578772813,10
1,1657,60493,3578772803,3578772815,12
1,1657,60494,3578772803,3578772815,12
1,1657,60495,3578772803,3578772816,13
1,1657,60496,3578772803,3578772816,13
1,1657,60497,3578772803,3578772817,14
1,1657,60498,3578772803,3578772817,14
1,1657,60499,3578772803,3578772817,14
1,1657,60500,3578772803,3578772818,15
1,1657,60501,3578772803,3578772819,16
1,1657,60502,3578772803,3578772819,16
1,1657,60503,3578772803,3578772823,20
1,1657,60504,3578772803,3578772824,21
1,1657,60505,3578772803,3578772824,21
1,1657,60506,3578772803,3578772825,22
1,1657,60507,3578772803,3578772825,22
1,1657,60508,3578772803,3578772826,23
1,1657,60509,3578772803,3578772827,24
1,1657,60510,3578772803,3578772828,25
1,1657,60511,3578772803,3578772829,26
1,1657,60512,3578772803,3578772830,27
1,1657,60513,3578772803,3578772831,28
1,1657,60514,3578772803,3578772831,28
1,1657,60515,3578772803,3578772831,28
1,1657,60516,3578772803,3578772832,29
1,1657,60517,3578772803,3578772833,30
1,1657,60518,3578772803,3578772833,30
1,1657,60519,3578772803,3578772835,32
1,1657,60520,3578772803,3578772836,33
1,1657,60521,3578772803,3578772836,33
1,1657,60522,3578772803,3578772837,34
1,1657,60523,3578772803,3578772838,35
1,1657,60524,3578772803,3578772839,36
1,1657,60525,3578772803,3578772844,41
1,1657,60526,3578772803,3578772846,43
1,1657,60527,3578772803,3578772846,43
1,1657,60528,3578772803,3578772848,45
1,1657,60529,3578772803,3578772850,47
1,1657,60530,3578772803,3578772850,47
1,1658,60531,3578772869,3578772869,0
1,1658,60532,3578772869,3578772869,0
1,1658,60533,3578772869,3578772869,0
1,1658,60534,3578772869,3578772869,0
1,1658,60535,3578772869,3578772869,0
1,1658,60536,3578772869,3578772869,0
1,1658,60537,3578772869,3578772869,0
1,1658,60538,3578772869,3578772869,0
1,1658,60539,3578772869,3578772869,0
1,1658,60540,3578772869,3578772869,0
1,1658,60541,3578772869,3578772869,0
1,1658,60542,3578772869,3578772869,0
1,1658,60543,3578772869,3578772869,0
1,1658,60544,3578772869,3578772869,0
1,1658,60545,3578772869,3578772869,0
1,1658,60546,3578772869,3578772869,0
1,1658,60547,3578772869,3578772869,0
1,1658,60548,3578772869,3578772869,0
1,1658,60549,3578772869,3578772870,1
1,1658,60550,3578772869,3578772883,14
1,1658,60551,3578772869,3578772884,15
1,1658,60552,3578772869,3578772884,15
1,1658,60553,3578772869,3578772887,18
1,1658,60554,3578772869,3578772888,19
1,1658,60555,3578772869,3578772890,21
1,1658,60556,3578772869,3578772890,21
1,1658,60557,3578772869,3578772890,21
1,1658,60558,3578772869,3578772890,21
1,1658,60559,3578772869,3578772891,22
1,1658,60560,3578772869,3578772891,22
1,1658,60561,3578772869,3578772892,23
1,1658,60562,3578772869,3578772893,24
1,1658,60563,3578772869,3578772893,24
1,1658,60564,3578772869,3578772893,24
1,1658,60565,3578772869,3578772894,25
1,1658,60566,3578772869,3578772895,26
1,1658,60567,3578772869,3578772896,27
1,1658,60568,3578772869,3578772896,27
1,1658,60569,3578772869,3578772897,28
1,1658,60570,3578772869,3578772897,28
1,1658,60571,3578772869,3578772901,32
1,1658,60572,3578772869,3578772901,32
1,1658,60573,3578772869,3578772902,33
1,1658,60574,3578772869,3578772903,34
1,1658,60575,3578772869,3578772904,35
1,1658,60576,3578772869,3578772904,35
1,1658,60577,3578772869,3578772904,35
1,1658,60578,3578772869,3578772906,37
1,1658,60579,3578772869,3578772908,39
1,1658,60580,3578772869,3578772910,41
1,1658,60581,3578772869,3578772910,41
1,1658,60582,3578772869,3578772912,43
1,1658,60583,3578772869,3578772912,43
1,1658,60584,3578772869,3578772912,43
1,1658,60585,3578772869,3578772912,43
1,1658,60586,3578772869,3578772913,44
1,1658,60587,3578772869,3578772914,45
1,1658,60588,3578772869,3578772914,45
1,1658,60589,3578772869,3578772915,46
1,1658,60590,3578772869,3578772919,50
1,1659,60591,3578772936,3578772936,0
1,1659,60592,3578772936,3578772936,0
1,1659,60593,3578772936,3578772936,0
1,1659,60594,3578772936,3578772936,0
1,1659,60595,3578772936,3578772936,0
1,1659,60596,3578772936,3578772936,0
1,1659,60597,3578772936,3578772936,0
1,1659,60598,3578772936,3578772936,0
1,1659,60599,3578772936,3578772936,0
1,1659,60600,3578772936,3578772936,0
1,1659,60601,3578772936,3578772936,0
1,1659,60602,3578772936,3578772936,0
1,1659,60603,3578772936,3578772936,0
1,1659,60604,3578772936,3578772936,0
1,1659,60605,3578772936,3578772936,0
1,1659,60606,3578772936,3578772936,0
1,1659,60607,3578772936,3578772936,0
1,1659,60608,3578772936,3578772936,0
1,1659,60609,3578772936,3578772936,0
1,1659,60610,3578772936,3578772936,0
1,1659,60611,3578772936,3578772936,0
1,1659,60612,3578772936,3578772936,0
1,1659,60613,3578772936,3578772936,0
1,1659,60614,3578772936,3578772936,0
1,1659,60615,3578772936,3578772936,0
1,1659,60616,3578772936,3578772936,0
1,1659,60617,3578772936,3578772936,0
1,1659,60618,3578772936,3578772937,1
1,1659,60619,3578772936,3578772938,2
1,1659,60620,3578772936,3578772941,5
1,1659,60621,3578772936,3578772941,5
1,1659,60622,3578772936,3578772942,6
1,1659,60623,3578772936,3578772942,6
1,1659,60624,3578772936,3578772947,11
1,1659,60625,3578772936,3578772948,12
1,1659,60626,3578772936,3578772948,12
1,1659,60627,3578772936,3578772948,12
1,1659,60628,3578772936,3578772950,14
1,1659,60629,3578772936,3578772950,14
1,1659,60630,3578772936,3578772950,14
1,1659,60631,3578772936,3578772951,15
1,1659,60632,3578772936,3578772951,15
1,1659,60633,3578772936,3578772953,17
1,1659,60634,3578772936,3578772953,17
1,1659,60635,3578772936,3578772953,17
1,1659,60636,3578772936,3578772954,18
1,1659,60637,3578772936,3578772955,19
1,1659,60638,3578772936,3578772955,19
1,1659,60639,3578772936,3578772955,19
1,1659,60640,3578772936,3578772958,22
1,1659,60641,3578772936,3578772963,27
1,1659,60642,3578772936,3578772963,27
1,1659,60643,3578772936,3578772964,28
1,1659,60644,3578772936,3578772964,28
1,1659,60645,3578772936,3578772964,28
1,1659,60646,3578772936,3578772964,28
1,1659,60647,3578772936,3578772965,29
1,1659,60648,3578772936,3578772965,29
1,1659,60649,3578772936,3578772966,30
1,1659,60650,3578772936,3578772966,30
1,1659,60651,3578772936,3578772967,31
1,1659,60652,3578772936,3578772968,32
1,1659,60653,3578772936,3578772968,32
1,1659,60654,3578772936,3578772969,33
1,1659,60655,3578772936,3578772970,34
1,1659,60656,3578772936,3578772976,40
1,1659,60657,3578772936,3578772977,41
1,1659,60658,3578772936,3578772978,42
1,1659,60659,3578772936,3578772978,42
1,1659,60660,3578772936,3578772980,44
1,1659,60661,3578772936,3578772980,44
1,1659,60662,3578772936,3578772981,45
1,1659,60663,3578772936,3578772981,45
1,1659,60664,3578772936,3578772981,45
1,1659,60665,3578772936,3578772981,45
1,1659,60666,3578772936,3578772982,46
1,1659,60667,3578772936,3578772984,48
1,1659,60668,3578772936,3578772985,49
1,1660,60669,3578773002,3578773002,0
1,1660,60670,3578773002,3578773002,0
1,1660,60671,3578773002,3578773002,0
1,1660,60672,3578773002,3578773002,0
1,1660,60673,3578773002,3578773002,0
1,1660,60674,3578773002,3578773002,0
1,1660,60675,3578773002,3578773002,0
1,1660,60676,3578773002,3578773002,0
1,1660,60677,3578773002,3578773002,0
1,1660,60678,3578773002,3578773002,0
1,1660,60679,3578773002,3578773002,0
1,1660,60680,3578773002,3578773002,0
1,1660,60681,3578773002,3578773002,0
1,1660,60682,3578773002,3578773002,0
1,1660,60683,3578773002,3578773002,0
1,1660,60684,3578773002,3578773002,0
1,1660,60685,3578773002,3578773002,0
1,1660,60686,3578773002,3578773003,1
1,1660,60687,3578773002,3578773004,2
1,1660,60688,3578773002,3578773005,3
1,1660,60689,3578773002,3578773006,4
1,1660,60690,3578773002,3578773007,5
1,1660,60691,3578773002,3578773009,7
1,1660,60692,3578773002,3578773010,8
1,1660,60693,3578773002,3578773012,10
1,1660,60694,3578773002,3578773012,10
1,1660,60695,3578773002,3578773013,11
1,1660,60696,3578773002,3578773013,11
1,1660,60697,3578773002,3578773013,11
1,1660,60698,3578773002,3578773015,13
1,1660,60699,3578773002,3578773016,14
1,1660,60700,3578773002,3578773016,14
1,1660,60701,3578773002,3578773016,14
1,1660,60702,3578773002,3578773017,15
1,1660,60703,3578773002,3578773017,15
1,1660,60704,3578773002,3578773018,16
1,1660,60705,3578773002,3578773018,16
1,1660,60706,3578773002,3578773019,17
1,1660,60707,3578773002,3578773020,18
1,1660,60708,3578773002,3578773023,21
1,1660,60709,3578773002,3578773024,22
1,1660,60710,3578773002,3578773024,22
1,1660,60711,3578773002,3578773025,23
1,1660,60712,3578773002,3578773025,23
1,1660,60713,3578773002,3578773026,24
1,1660,60714,3578773002,3578773027,25
1,1660,60715,3578773002,3578773028,26
1,1660,60716,3578773002,3578773029,27
1,1660,60717,3578773002,3578773029,27
1,1660,60718,3578773002,3578773030,28
1,1660,60719,3578773002,3578773031,29
1,1660,60720,3578773002,3578773031,29
1,1660,60721,3578773002,3578773032,30
1,1660,60722,3578773002,3578773032,30
1,1660,60723,3578773002,3578773032,30
1,1660,60724,3578773002,3578773034,32
1,1660,60725,3578773002,3578773035,33
1,1660,60726,3578773002,3578773036,34
1,1660,60727,3578773002,3578773036,34
1,1660,60728,3578773002,3578773037,35
1,1660,60729,3578773002,3578773038,36
1,1660,60730,3578773002,3578773038,36
1,1660,60731,3578773002,3578773044,42
1,1660,60732,3578773002,3578773046,44
1,1660,60733,3578773002,3578773047,45
1,1660,60734,3578773002,3578773048,46
1,1660,60735,3578773002,3578773049,47
1,1660,60736,3578773002,3578773049,47
1,1660,60737,3578773002,3578773050,48
1,1661,60738,3578773069,3578773069,0
1,1661,60739,3578773069,3578773069,0
1,1661,60740,3578773069,3578773069,0
1,1661,60741,3578773069,3578773069,0
1,1661,60742,3578773069,3578773069,0
1,1661,60743,3578773069,3578773069,0
1,1661,60744,3578773069,3578773069,0
1,1661,60745,3578773069,3578773069,0
1,1661,60746,3578773069,3578773069,0
1,1661,60747,3578773069,3578773069,0
1,1661,60748,3578773069,3578773069,0
1,1661,60749,3578773069,3578773069,0
1,1661,60750,3578773069,3578773069,0
1,1661,60751,3578773069,3578773069,0
1,1661,60752,3578773069,3578773069,0
1,1661,60753,3578773069,3578773069,0
1,1661,60754,3578773069,3578773069,0
1,1661,60755,3578773069,3578773082,13
1,1661,60756,3578773069,3578773084,15
1,1661,60757,3578773069,3578773084,15
1,1661,60758,3578773069,3578773087,18
1,1661,60759,3578773069,3578773089,20
1,1661,60760,3578773069,3578773090,21
1,1661,60761,3578773069,3578773090,21
1,1661,60762,3578773069,3578773090,21
1,1661,60763,3578773069,3578773090,21
1,1661,60764,3578773069,3578773092,23
1,1661,60765,3578773069,3578773092,23
1,1661,60766,3578773069,3578773092,23
1,1661,60767,3578773069,3578773092,23
1,1661,60768,3578773069,3578773093,24
1,1661,60769,3578773069,3578773093,24
1,1661,60770,3578773069,3578773095,26
1,1661,60771,3578773069,3578773096,27
1,1661,60772,3578773069,3578773096,27
1,1661,60773,3578773069,3578773097,28
1,1661,60774,3578773069,3578773097,28
1,1661,60775,3578773069,3578773101,32
1,1661,60776,3578773069,3578773101,32
1,1661,60777,3578773069,3578773101,32
1,1661,60778,3578773069,3578773102,33
1,1661,60779,3578773069,3578773103,34
1,1661,60780,3578773069,3578773103,34
1,1661,60781,3578773069,3578773104,35
1,1661,60782,3578773069,3578773104,35
1,1661,60783,3578773069,3578773104,35
1,1661,60784,3578773069,3578773104,35
1,1661,60785,3578773069,3578773105,36
1,1661,60786,3578773069,3578773106,37
1,1661,60787,3578773069,3578773106,37
1,1661,60788,3578773069,3578773108,39
1,1661,60789,3578773069,3578773109,40
1,1661,60790,3578773069,3578773109,40
1,1661,60791,3578773069,3578773110,41
1,1661,60792,3578773069,3578773112,43
1,1661,60793,3578773069,3578773112,43
1,1661,60794,3578773069,3578773112,43
1,1661,60795,3578773069,3578773112,43
1,1661,60796,3578773069,3578773113,44
1,1661,60797,3578773069,3578773113,44
1,1661,60798,3578773069,3578773114,45
1,1661,60799,3578773069,3578773116,47
1,1662,60800,3578773135,3578773135,0
1,1662,60801,3578773135,3578773135,0
1,1662,60802,3578773135,3578773135,0
1,1662,60803,3578773135,3578773135,0
1,1662,60804,3578773135,3578773135,0
1,1662,60805,3578773135,3578773135,0
1,1662,60806,3578773135,3578773135,0
1,1662,60807,3578773135,3578773135,0
1,1662,60808,3578773135,3578773135,0
1,1662,60809,3578773135,3578773135,0
1,1662,60810,3578773135,3578773135,0
1,1662,60811,3578773135,3578773135,0
1,1662,60812,3578773135,3578773135,0
1,1662,60813,3578773135,3578773135,0
1,1662,60814,3578773135,3578773135,0
1,1662,60815,3578773135,3578773135,0
1,1662,60816,3578773135,3578773135,0
1,1662,60817,3578773135,3578773135,0
1,1662,60818,3578773135,3578773135,0
1,1662,60819,3578773135,3578773135,0
1,1662,60820,3578773135,3578773135,0
1,1662,60821,3578773135,3578773135,0
1,1662,60822,3578773135,3578773135,0
1,1662,60823,3578773135,3578773136,1
1,1662,60824,3578773135,3578773136,1
1,1662,60825,3578773135,3578773136,1
1,1662,60826,3578773135,3578773136,1
1,1662,60827,3578773135,3578773136,1
1,1662,60828,3578773135,3578773137,2
1,1662,60829,3578773135,3578773139,4
1,1662,60830,3578773135,3578773140,5
1,1662,60831,3578773135,3578773141,6
1,1662,60832,3578773135,3578773141,6
1,1662,60833,3578773135,3578773142,7
1,1662,60834,3578773135,3578773143,8
1,1662,60835,3578773135,3578773147,12
1,1662,60836,3578773135,3578773147,12
1,1662,60837,3578773135,3578773148,13
1,1662,60838,3578773135,3578773148,13
1,1662,60839,3578773135,3578773149,14
1,1662,60840,3578773135,3578773150,15
1,1662,60841,3578773135,3578773150,15
1,1662,60842,3578773135,3578773150,15
1,1662,60843,3578773135,3578773151,16
1,1662,60844,3578773135,3578773152,17
1,1662,60845,3578773135,3578773153,18
1,1662,60846,3578773135,3578773153,18
1,1662,60847,3578773135,3578773154,19
1,1662,60848,3578773135,3578773155,20
1,1662,60849,3578773135,3578773155,20
1,1662,60850,3578773135,3578773156,21
1,1662,60851,3578773135,3578773156,21
1,1662,60852,3578773135,3578773159,24
1,1662,60853,3578773135,3578773163,28
1,1662,60854,3578773135,3578773163,28
1,1662,60855,3578773135,3578773163,28
1,1662,60856,3578773135,3578773164,29
1,1662,60857,3578773135,3578773165,30
1,1662,60858,3578773135,3578773165,30
1,1662,60859,3578773135,3578773165,30
1,1662,60860,3578773135,3578773166,31
1,1662,60861,3578773135,3578773167,32
1,1662,60862,3578773135,3578773167,32
1,1662,60863,3578773135,3578773168,33
1,1662,60864,3578773135,3578773168,33
1,1662,60865,3578773135,3578773169,34
1,1662,60866,3578773135,3578773169,34
1,1662,60867,3578773135,3578773169,34
1,1662,60868,3578773135,3578773170,35
1,1662,60869,3578773135,3578773177,42
1,1662,60870,3578773135,3578773178,43
1,1662,60871,3578773135,3578773178,43
1,1662,60872,3578773135,3578773178,43
1,1662,60873,3578773135,3578773179,44
1,1662,60874,3578773135,3578773180,45
1,1662,60875,3578773135,3578773180,45
1,1662,60876,3578773135,3578773180,45
1,1662,60877,3578773135,3578773181,46
1,1662,60878,3578773135,3578773181,46
1,1662,60879,3578773135,3578773181,46
1,1662,60880,3578773135,3578773185,50
1,1663,60881,3578773200,3578773200,0
1,1663,60882,3578773200,3578773200,0
1,1663,60883,3578773200,3578773200,0
1,1663,60884,3578773200,3578773200,0
1,1663,60885,3578773200,3578773200,0
1,1663,60886,3578773200,3578773200,0
1,1663,60887,3578773200,3578773200,0
1,1663,60888,3578773200,3578773200,0
1,1663,60889,3578773200,3578773200,0
1,1663,60890,3578773200,3578773200,0
1,1663,60891,3578773200,3578773200,0
1,1663,60892,3578773200,3578773200,0
1,1663,60893,3578773200,3578773200,0
1,1663,60894,3578773200,3578773200,0
1,1663,60895,3578773200,3578773200,0
1,1663,60896,3578773200,3578773200,0
1,1663,60897,3578773200,3578773200,0
1,1663,60898,3578773200,3578773201,1
1,1663,60899,3578773200,3578773202,2
1,1663,60900,3578773200,3578773203,3
1,1663,60901,3578773200,3578773203,3
1,1663,60902,3578773200,3578773205,5
1,1663,60903,3578773200,3578773206,6
1,1663,60904,3578773200,3578773208,8
1,1663,60905,3578773200,3578773209,9
1,1663,60906,3578773200,3578773211,11
1,1663,60907,3578773200,3578773212,12
1,1663,60908,3578773200,3578773213,13
1,1663,60909,3578773200,3578773214,14
1,1663,60910,3578773200,3578773214,14
1,1663,60911,3578773200,3578773215,15
1,1663,60912,3578773200,3578773216,16
1,1663,60913,3578773200,3578773216,16
1,1663,60914,3578773200,3578773217,17
1,1663,60915,3578773200,3578773217,17
1,1663,60916,3578773200,3578773217,17
1,1663,60917,3578773200,3578773218,18
1,1663,60918,3578773200,3578773220,20
1,1663,60919,3578773200,3578773220,20
1,1663,60920,3578773200,3578773220,20
1,1663,60921,3578773200,3578773223,23
1,1663,60922,3578773200,3578773224,24
1,1663,60923,3578773200,3578773224,24
1,1663,60924,3578773200,3578773225,25
1,1663,60925,3578773200,3578773227,27
1,1663,60926,3578773200,3578773227,27
1,1663,60927,3578773200,3578773229,29
1,1663,60928,3578773200,3578773229,29
1,1663,60929,3578773200,3578773230,30
1,1663,60930,3578773200,3578773230,30
1,1663,60931,3578773200,3578773231,31
1,1663,60932,3578773200,3578773232,32
1,1663,60933,3578773200,3578773232,32
1,1663,60934,3578773200,3578773232,32
1,1663,60935,3578773200,3578773235,35
1,1663,60936,3578773200,3578773237,37
1,1663,60937,3578773200,3578773237,37
1,1663,60938,3578773200,3578773237,37
1,1663,60939,3578773200,3578773237,37
1,1663,60940,3578773200,3578773239,39
1,1663,60941,3578773200,3578773244,44
1,1663,60942,3578773200,3578773246,46
1,1663,60943,3578773200,3578773246,46
1,1663,60944,3578773200,3578773248,48
1,1663,60945,3578773200,3578773249,49
1,1663,60946,3578773200,3578773250,50
1,1664,60947,3578773266,3578773266,0
1,1664,60948,3578773266,3578773266,0
1,1664,60949,3578773266,3578773266,0
1,1664,60950,3578773266,3578773266,0
1,1664,60951,3578773266,3578773266,0
1,1664,60952,3578773266,3578773266,0
1,1664,60953,3578773266,3578773266,0
1,1664,60954,3578773266,3578773266,0
1,1664,60955,3578773266,3578773266,0
1,1664,60956,3578773266,3578773267,1
1,1664,60957,3578773266,3578773267,1
1,1664,60958,3578773266,3578773267,1
1,1664,60959,3578773266,3578773267,1
1,1664,60960,3578773266,3578773267,1
1,1664,60961,3578773266,3578773267,1
1,1664,60962,3578773266,3578773268,2
1,1664,60963,3578773266,3578773269,3
1,1664,60964,3578773266,3578773270,4
1,1664,60965,3578773266,3578773282,16
1,1664,60966,3578773266,3578773284,18
1,1664,60967,3578773266,3578773285,19
1,1664,60968,3578773266,3578773285,19
1,1664,60969,3578773266,3578773286,20
1,1664,60970,3578773266,3578773288,22
1,1664,60971,3578773266,3578773289,23
1,1664,60972,3578773266,3578773290,24
1,1664,60973,3578773266,3578773290,24
1,1664,60974,3578773266,3578773290,24
1,1664,60975,3578773266,3578773291,25
1,1664,60976,3578773266,3578773291,25
1,1664,60977,3578773266,3578773292,26
1,1664,60978,3578773266,3578773293,27
1,1664,60979,3578773266,3578773293,27
1,1664,60980,3578773266,3578773296,30
1,1664,60981,3578773266,3578773296,30
1,1664,60982,3578773266,3578773297,31
1,1664,60983,3578773266,3578773297,31
1,1664,60984,3578773266,3578773298,32
1,1664,60985,3578773266,3578773301,35
1,1664,60986,3578773266,3578773301,35
1,1664,60987,3578773266,3578773302,36
1,1664,60988,3578773266,3578773302,36
1,1664,60989,3578773266,3578773303,37
1,1664,60990,3578773266,3578773303,37
1,1664,60991,3578773266,3578773303,37
1,1664,60992,3578773266,3578773304,38
1,1664,60993,3578773266,3578773304,38
1,1664,60994,3578773266,3578773304,38
1,1664,60995,3578773266,3578773305,39
1,1664,60996,3578773266,3578773305,39
1,1664,60997,3578773266,3578773306,40
1,1664,60998,3578773266,3578773308,42
1,1664,60999,3578773266,3578773309,43
1,1664,61000,3578773266,3578773310,44
1,1664,61001,3578773266,3578773310,44
1,1664,61002,3578773266,3578773312,46
1,1664,61003,3578773266,3578773312,46
1,1664,61004,3578773266,3578773312,46
1,1664,61005,3578773266,3578773312,46
1,1664,61006,3578773266,3578773313,47
1,1664,61007,3578773266,3578773314,48
1,1664,61008,3578773266,3578773314,48
1,1664,61009,3578773266,3578773314,48
1,1664,61010,3578773266,3578773315,49
1,1664,61011,3578773266,3578773316,50
1,1665,61012,3578773334,3578773334,0
1,1665,61013,3578773334,3578773334,0
1,1665,61014,3578773334,3578773334,0
1,1665,61015,3578773334,3578773334,0
1,1665,61016,3578773334,3578773334,0
1,1665,61017,3578773334,3578773334,0
1,1665,61018,3578773334,3578773334,0
1,1665,61019,3578773334,3578773334,0
1,1665,61020,3578773334,3578773334,0
1,1665,61021,3578773334,3578773334,0
1,1665,61022,3578773334,3578773334,0
1,1665,61023,3578773334,3578773334,0
1,1665,61024,3578773334,3578773334,0
1,1665,61025,3578773334,3578773334,0
1,1665,61026,3578773334,3578773334,0
1,1665,61027,3578773334,3578773334,0
1,1665,61028,3578773334,3578773334,0
1,1665,61029,3578773334,3578773334,0
1,1665,61030,3578773334,3578773334,0
1,1665,61031,3578773334,3578773334,0
1,1665,61032,3578773334,3578773334,0
1,1665,61033,3578773334,3578773334,0
1,1665,61034,3578773334,3578773334,0
1,1665,61035,3578773334,3578773334,0
1,1665,61036,3578773334,3578773335,1
1,1665,61037,3578773334,3578773336,2
1,1665,61038,3578773334,3578773336,2
1,1665,61039,3578773334,3578773336,2
1,1665,61040,3578773334,3578773337,3
1,1665,61041,3578773334,3578773337,3
1,1665,61042,3578773334,3578773340,6
1,1665,61043,3578773334,3578773341,7
1,1665,61044,3578773334,3578773343,9
1,1665,61045,3578773334,3578773347,13
1,1665,61046,3578773334,3578773348,14
1,1665,61047,3578773334,3578773348,14
1,1665,61048,3578773334,3578773348,14
1,1665,61049,3578773334,3578773350,16
1,1665,61050,3578773334,3578773350,16
1,1665,61051,3578773334,3578773351,17
1,1665,61052,3578773334,3578773353,19
1,1665,61053,3578773334,3578773353,19
1,1665,61054,3578773334,3578773354,20
1,1665,61055,3578773334,3578773355,21
1,1665,61056,3578773334,3578773355,21
1,1665,61057,3578773334,3578773355,21
1,1665,61058,3578773334,3578773356,22
1,1665,61059,3578773334,3578773357,23
1,1665,61060,3578773334,3578773359,25
1,1665,61061,3578773334,3578773363,29
1,1665,61062,3578773334,3578773363,29
1,1665,61063,3578773334,3578773363,29
1,1665,61064,3578773334,3578773364,30
1,1665,61065,3578773334,3578773365,31
1,1665,61066,3578773334,3578773366,32
1,1665,61067,3578773334,3578773367,33
1,1665,61068,3578773334,3578773368,34
1,1665,61069,3578773334,3578773368,34
1,1665,61070,3578773334,3578773368,34
1,1665,61071,3578773334,3578773368,34
1,1665,61072,3578773334,3578773369,35
1,1665,61073,3578773334,3578773370,36
1,1665,61074,3578773334,3578773371,37
1,1665,61075,3578773334,3578773373,39
1,1665,61076,3578773334,3578773376,42
1,1665,61077,3578773334,3578773377,43
1,1665,61078,3578773334,3578773378,44
1,1665,61079,3578773334,3578773379,45
1,1665,61080,3578773334,3578773379,45
1,1665,61081,3578773334,3578773380,46
1,1665,61082,3578773334,3578773380,46
1,1665,61083,3578773334,3578773381,47
1,1665,61084,3578773334,3578773382,48
1,1665,61085,3578773334,3578773382,48
1,1666,61086,3578773400,3578773400,0
1,1666,61087,3578773400,3578773400,0
1,1666,61088,3578773400,3578773400,0
1,1666,61089,3578773400,3578773400,0
1,1666,61090,3578773400,3578773400,0
1,1666,61091,3578773400,3578773400,0
1,1666,61092,3578773400,3578773400,0
1,1666,61093,3578773400,3578773400,0
1,1666,61094,3578773400,3578773400,0
1,1666,61095,3578773400,3578773400,0
1,1666,61096,3578773400,3578773400,0
1,1666,61097,3578773400,3578773400,0
1,1666,61098,3578773400,3578773400,0
1,1666,61099,3578773400,3578773400,0
1,1666,61100,3578773400,3578773400,0
1,1666,61101,3578773400,3578773400,0
1,1666,61102,3578773400,3578773400,0
1,1666,61103,3578773400,3578773401,1
1,1666,61104,3578773400,3578773402,2
1,1666,61105,3578773400,3578773403,3
1,1666,61106,3578773400,3578773403,3
1,1666,61107,3578773400,3578773406,6
1,1666,61108,3578773400,3578773407,7
1,1666,61109,3578773400,3578773409,9
1,1666,61110,3578773400,3578773411,11
1,1666,61111,3578773400,3578773413,13
1,1666,61112,3578773400,3578773413,13
1,1666,61113,3578773400,3578773414,14
1,1666,61114,3578773400,3578773415,15
1,1666,61115,3578773400,3578773416,16
1,1666,61116,3578773400,3578773416,16
1,1666,61117,3578773400,3578773416,16
1,1666,61118,3578773400,3578773417,17
1,1666,61119,3578773400,3578773417,17
1,1666,61120,3578773400,3578773420,20
1,1666,61121,3578773400,3578773420,20
1,1666,61122,3578773400,3578773420,20
1,1666,61123,3578773400,3578773423,23
1,1666,61124,3578773400,3578773424,24
1,1666,61125,3578773400,3578773424,24
1,1666,61126,3578773400,3578773425,25
1,1666,61127,3578773400,3578773427,27
1,1666,61128,3578773400,3578773428,28
1,1666,61129,3578773400,3578773429,29
1,1666,61130,3578773400,3578773430,30
1,1666,61131,3578773400,3578773430,30
1,1666,61132,3578773400,3578773430,30
1,1666,61133,3578773400,3578773431,31
1,1666,61134,3578773400,3578773431,31
1,1666,61135,3578773400,3578773432,32
1,1666,61136,3578773400,3578773432,32
1,1666,61137,3578773400,3578773433,33
1,1666,61138,3578773400,3578773436,36
1,1666,61139,3578773400,3578773437,37
1,1666,61140,3578773400,3578773437,37
1,1666,61141,3578773400,3578773437,37
1,1666,61142,3578773400,3578773437,37
1,1666,61143,3578773400,3578773440,40
1,1666,61144,3578773400,3578773445,45
1,1666,61145,3578773400,3578773446,46
1,1666,61146,3578773400,3578773446,46
1,1666,61147,3578773400,3578773448,48
1,1666,61148,3578773400,3578773449,49
1,1666,61149,3578773400,3578773450,50
1,1667,61150,3578773466,3578773466,0
1,1667,61151,3578773466,3578773466,0
1,1667,61152,3578773466,3578773466,0
1,1667,61153,3578773466,3578773466,0
1,1667,61154,3578773466,3578773466,0
1,1667,61155,3578773466,3578773466,0
1,1667,61156,3578773466,3578773466,0
1,1667,61157,3578773466,3578773466,0
1,1667,61158,3578773466,3578773466,0
1,1667,61159,3578773466,3578773466,0
1,1667,61160,3578773466,3578773466,0
1,1667,61161,3578773466,3578773466,0
1,1667,61162,3578773466,3578773467,1
1,1667,61163,3578773466,3578773467,1
1,1667,61164,3578773466,3578773467,1
1,1667,61165,3578773466,3578773467,1
1,1667,61166,3578773466,3578773467,1
1,1667,61167,3578773466,3578773469,3
1,1667,61168,3578773466,3578773469,3
1,1667,61169,3578773466,3578773471,5
1,1667,61170,3578773466,3578773483,17
1,1667,61171,3578773466,3578773485,19
1,1667,61172,3578773466,3578773486,20
1,1667,61173,3578773466,3578773486,20
1,1667,61174,3578773466,3578773488,22
1,1667,61175,3578773466,3578773489,23
1,1667,61176,3578773466,3578773489,23
1,1667,61177,3578773466,3578773490,24
1,1667,61178,3578773466,3578773490,24
1,1667,61179,3578773466,3578773491,25
1,1667,61180,3578773466,3578773491,25
1,1667,61181,3578773466,3578773491,25
1,1667,61182,3578773466,3578773492,26
1,1667,61183,3578773466,3578773492,26
1,1667,61184,3578773466,3578773493,27
1,1667,61185,3578773466,3578773493,27
1,1667,61186,3578773466,3578773496,30
1,1667,61187,3578773466,3578773496,30
1,1667,61188,3578773466,3578773496,30
1,1667,61189,3578773466,3578773497,31
1,1667,61190,3578773466,3578773497,31
1,1667,61191,3578773466,3578773498,32
1,1667,61192,3578773466,3578773499,33
1,1667,61193,3578773466,3578773501,35
1,1667,61194,3578773466,3578773501,35
1,1667,61195,3578773466,3578773501,35
1,1667,61196,3578773466,3578773503,37
1,1667,61197,3578773466,3578773503,37
1,1667,61198,3578773466,3578773503,37
1,1667,61199,3578773466,3578773503,37
1,1667,61200,3578773466,3578773504,38
1,1667,61201,3578773466,3578773504,38
1,1667,61202,3578773466,3578773504,38
1,1667,61203,3578773466,3578773504,38
1,1667,61204,3578773466,3578773505,39
1,1667,61205,3578773466,3578773505,39
1,1667,61206,3578773466,3578773505,39
1,1667,61207,3578773466,3578773506,40
1,1667,61208,3578773466,3578773508,42
1,1667,61209,3578773466,3578773508,42
1,1667,61210,3578773466,3578773510,44
1,1667,61211,3578773466,3578773512,46
1,1667,61212,3578773466,3578773512,46
1,1667,61213,3578773466,3578773512,46
1,1667,61214,3578773466,3578773513,47
1,1667,61215,3578773466,3578773513,47
1,1667,61216,3578773466,3578773513,47
1,1667,61217,3578773466,3578773514,48
1,1667,61218,3578773466,3578773514,48
1,1667,61219,3578773466,3578773515,49
1,1667,61220,3578773466,3578773515,49
1,1668,61221,3578773531,3578773531,0
1,1668,61222,3578773531,3578773531,0
1,1668,61223,3578773531,3578773531,0
1,1668,61224,3578773531,3578773531,0
1,1668,61225,3578773531,3578773531,0
1,1668,61226,3578773531,3578773531,0
1,1668,61227,3578773531,3578773531,0
1,1668,61228,3578773531,3578773531,0
1,1668,61229,3578773531,3578773531,0
1,1668,61230,3578773531,3578773531,0
1,1668,61231,3578773531,3578773531,0
1,1668,61232,3578773531,3578773531,0
1,1668,61233,3578773531,3578773531,0
1,1668,61234,3578773531,3578773531,0
1,1668,61235,3578773531,3578773531,0
1,1668,61236,3578773531,3578773531,0
1,1668,61237,3578773531,3578773531,0
1,1668,61238,3578773531,3578773531,0
1,1668,61239,3578773531,3578773531,0
1,1668,61240,3578773531,3578773533,2
1,1668,61241,3578773531,3578773535,4
1,1668,61242,3578773531,3578773535,4
1,1668,61243,3578773531,3578773535,4
1,1668,61244,3578773531,3578773536,5
1,1668,61245,3578773531,3578773536,5
1,1668,61246,3578773531,3578773537,6
1,1668,61247,3578773531,3578773539,8
1,1668,61248,3578773531,3578773541,10
1,1668,61249,3578773531,3578773541,10
1,1668,61250,3578773531,3578773547,16
1,1668,61251,3578773531,3578773547,16
1,1668,61252,3578773531,3578773547,16
1,1668,61253,3578773531,3578773548,17
1,1668,61254,3578773531,3578773549,18
1,1668,61255,3578773531,3578773549,18
1,1668,61256,3578773531,3578773550,19
1,1668,61257,3578773531,3578773550,19
1,1668,61258,3578773531,3578773552,21
1,1668,61259,3578773531,3578773552,21
1,1668,61260,3578773531,3578773553,22
1,1668,61261,3578773531,3578773554,23
1,1668,61262,3578773531,3578773554,23
1,1668,61263,3578773531,3578773555,24
1,1668,61264,3578773531,3578773555,24
1,1668,61265,3578773531,3578773555,24
1,1668,61266,3578773531,3578773556,25
1,1668,61267,3578773531,3578773562,31
1,1668,61268,3578773531,3578773563,32
1,1668,61269,3578773531,3578773563,32
1,1668,61270,3578773531,3578773564,33
1,1668,61271,3578773531,3578773565,34
1,1668,61272,3578773531,3578773566,35
1,1668,61273,3578773531,3578773567,36
1,1668,61274,3578773531,3578773567,36
1,1668,61275,3578773531,3578773568,37
1,1668,61276,3578773531,3578773568,37
1,1668,61277,3578773531,3578773568,37
1,1668,61278,3578773531,3578773569,38
1,1668,61279,3578773531,3578773571,40
1,1668,61280,3578773531,3578773572,41
1,1668,61281,3578773531,3578773575,44
1,1668,61282,3578773531,3578773577,46
1,1668,61283,3578773531,3578773577,46
1,1668,61284,3578773531,3578773578,47
1,1668,61285,3578773531,3578773579,48
1,1668,61286,3578773531,3578773580,49
1,1668,61287,3578773531,3578773580,49
1,1668,61288,3578773531,3578773581,50
1,1669,61289,3578773598,3578773598,0
1,1669,61290,3578773598,3578773598,0
1,1669,61291,3578773598,3578773598,0
1,1669,61292,3578773598,3578773598,0
1,1669,61293,3578773598,3578773598,0
1,1669,61294,3578773598,3578773598,0
1,1669,61295,3578773598,3578773598,0
1,1669,61296,3578773598,3578773598,0
1,1669,61297,3578773598,3578773598,0
1,1669,61298,3578773598,3578773598,0
1,1669,61299,3578773598,3578773598,0
1,1669,61300,3578773598,3578773598,0
1,1669,61301,3578773598,3578773598,0
1,1669,61302,3578773598,3578773598,0
1,1669,61303,3578773598,3578773598,0
1,1669,61304,3578773598,3578773599,1
1,1669,61305,3578773598,3578773599,1
1,1669,61306,3578773598,3578773599,1
1,1669,61307,3578773598,3578773600,2
1,1669,61308,3578773598,3578773600,2
1,1669,61309,3578773598,3578773601,3
1,1669,61310,3578773598,3578773602,4
1,1669,61311,3578773598,3578773603,5
1,1669,61312,3578773598,3578773605,7
1,1669,61313,3578773598,3578773607,9
1,1669,61314,3578773598,3578773609,11
1,1669,61315,3578773598,3578773611,13
1,1669,61316,3578773598,3578773612,14
1,1669,61317,3578773598,3578773613,15
1,1669,61318,3578773598,3578773613,15
1,1669,61319,3578773598,3578773614,16
1,1669,61320,3578773598,3578773615,17
1,1669,61321,3578773598,3578773615,17
1,1669,61322,3578773598,3578773616,18
1,1669,61323,3578773598,3578773616,18
1,1669,61324,3578773598,3578773616,18
1,1669,61325,3578773598,3578773619,21
1,1669,61326,3578773598,3578773620,22
1,1669,61327,3578773598,3578773622,24
1,1669,61328,3578773598,3578773623,25
1,1669,61329,3578773598,3578773624,26
1,1669,61330,3578773598,3578773624,26
1,1669,61331,3578773598,3578773624,26
1,1669,61332,3578773598,3578773626,28
1,1669,61333,3578773598,3578773626,28
1,1669,61334,3578773598,3578773629,31
1,1669,61335,3578773598,3578773629,31
1,1669,61336,3578773598,3578773629,31
1,1669,61337,3578773598,3578773629,31
1,1669,61338,3578773598,3578773630,32
1,1669,61339,3578773598,3578773630,32
1,1669,61340,3578773598,3578773631,33
1,1669,61341,3578773598,3578773632,34
1,1669,61342,3578773598,3578773635,37
1,1669,61343,3578773598,3578773637,39
1,1669,61344,3578773598,3578773639,41
1,1669,61345,3578773598,3578773644,46
1,1669,61346,3578773598,3578773645,47
1,1669,61347,3578773598,3578773646,48
1,1669,61348,3578773598,3578773647,49
1,1670,61349,3578773665,3578773665,0
1,1670,61350,3578773665,3578773665,0
1,1670,61351,3578773665,3578773665,0
1,1670,61352,3578773665,3578773665,0
1,1670,61353,3578773665,3578773665,0
1,1670,61354,3578773665,3578773665,0
1,1670,61355,3578773665,3578773665,0
1,1670,61356,3578773665,3578773665,0
1,1670,61357,3578773665,3578773665,0
1,1670,61358,3578773665,3578773665,0
1,1670,61359,3578773665,3578773665,0
1,1670,61360,3578773665,3578773665,0
1,1670,61361,3578773665,3578773665,0
1,1670,61362,3578773665,3578773665,0
1,1670,61363,3578773665,3578773665,0
1,1670,61364,3578773665,3578773665,0
1,1670,61365,3578773665,3578773665,0
1,1670,61366,3578773665,3578773665,0
1,1670,61367,3578773665,3578773665,0
1,1670,61368,3578773665,3578773665,0
1,1670,61369,3578773665,3578773665,0
1,1670,61370,3578773665,3578773665,0
1,1670,61371,3578773665,3578773666,1
1,1670,61372,3578773665,3578773668,3
1,1670,61373,3578773665,3578773668,3
1,1670,61374,3578773665,3578773670,5
1,1670,61375,3578773665,3578773683,18
1,1670,61376,3578773665,3578773683,18
1,1670,61377,3578773665,3578773685,20
1,1670,61378,3578773665,3578773685,20
1,1670,61379,3578773665,3578773686,21
1,1670,61380,3578773665,3578773688,23
1,1670,61381,3578773665,3578773689,24
1,1670,61382,3578773665,3578773689,24
1,1670,61383,3578773665,3578773689,24
1,1670,61384,3578773665,3578773690,25
1,1670,61385,3578773665,3578773690,25
1,1670,61386,3578773665,3578773691,26
1,1670,61387,3578773665,3578773692,27
1,1670,61388,3578773665,3578773692,27
1,1670,61389,3578773665,3578773693,28
1,1670,61390,3578773665,3578773693,28
1,1670,61391,3578773665,3578773694,29
1,1670,61392,3578773665,3578773696,31
1,1670,61393,3578773665,3578773696,31
1,1670,61394,3578773665,3578773696,31
1,1670,61395,3578773665,3578773697,32
1,1670,61396,3578773665,3578773697,32
1,1670,61397,3578773665,3578773698,33
1,1670,61398,3578773665,3578773700,35
1,1670,61399,3578773665,3578773701,36
1,1670,61400,3578773665,3578773701,36
1,1670,61401,3578773665,3578773701,36
1,1670,61402,3578773665,3578773703,38
1,1670,61403,3578773665,3578773703,38
1,1670,61404,3578773665,3578773703,38
1,1670,61405,3578773665,3578773704,39
1,1670,61406,3578773665,3578773704,39
1,1670,61407,3578773665,3578773704,39
1,1670,61408,3578773665,3578773705,40
1,1670,61409,3578773665,3578773705,40
1,1670,61410,3578773665,3578773705,40
1,1670,61411,3578773665,3578773706,41
1,1670,61412,3578773665,3578773706,41
1,1670,61413,3578773665,3578773706,41
1,1670,61414,3578773665,3578773708,43
1,1670,61415,3578773665,3578773709,44
1,1670,61416,3578773665,3578773710,45
1,1670,61417,3578773665,3578773712,47
1,1670,61418,3578773665,3578773712,47
1,1670,61419,3578773665,3578773712,47
1,1670,61420,3578773665,3578773712,47
1,1670,61421,3578773665,3578773713,48
1,1670,61422,3578773665,3578773713,48
1,1670,61423,3578773665,3578773713,48
1,1670,61424,3578773665,3578773714,49
1,1670,61425,3578773665,3578773714,49
1,1671,61426,3578773731,3578773731,0
1,1671,61427,3578773731,3578773731,0
1,1671,61428,3578773731,3578773731,0
1,1671,61429,3578773731,3578773731,0
1,1671,61430,3578773731,3578773731,0
1,1671,61431,3578773731,3578773731,0
1,1671,61432,3578773731,3578773731,0
1,1671,61433,3578773731,3578773731,0
1,1671,61434,3578773731,3578773731,0
1,1671,61435,3578773731,3578773731,0
1,1671,61436,3578773731,3578773731,0
1,1671,61437,3578773731,3578773731,0
1,1671,61438,3578773731,3578773731,0
1,1671,61439,3578773731,3578773731,0
1,1671,61440,3578773731,3578773731,0
1,1671,61441,3578773731,3578773731,0
1,1671,61442,3578773731,3578773731,0
1,1671,61443,3578773731,3578773731,0
1,1671,61444,3578773731,3578773732,1
1,1671,61445,3578773731,3578773735,4
1,1671,61446,3578773731,3578773735,4
1,1671,61447,3578773731,3578773735,4
1,1671,61448,3578773731,3578773736,5
1,1671,61449,3578773731,3578773736,5
1,1671,61450,3578773731,3578773737,6
1,1671,61451,3578773731,3578773739,8
1,1671,61452,3578773731,3578773741,10
1,1671,61453,3578773731,3578773741,10
1,1671,61454,3578773731,3578773741,10
1,1671,61455,3578773731,3578773747,16
1,1671,61456,3578773731,3578773748,17
1,1671,61457,3578773731,3578773748,17
1,1671,61458,3578773731,3578773749,18
1,1671,61459,3578773731,3578773749,18
1,1671,61460,3578773731,3578773750,19
1,1671,61461,3578773731